MittausID;Pvm;Vuosi;Kuukausi;Tunti;Viikonpäivä;PP_1;PP_2;PP_YHT
94;30.06.2014;2014;06;00;Maanantai;1;0;1
94;30.06.2014;2014;06;01;Maanantai;1;0;1
94;30.06.2014;2014;06;02;Maanantai;0;0;0
94;30.06.2014;2014;06;03;Maanantai;0;0;0
94;30.06.2014;2014;06;04;Maanantai;0;0;0
94;30.06.2014;2014;06;05;Maanantai;4;0;4
94;30.06.2014;2014;06;06;Maanantai;16;4;20
94;30.06.2014;2014;06;07;Maanantai;30;3;33
94;30.06.2014;2014;06;08;Maanantai;13;5;18
94;30.06.2014;2014;06;09;Maanantai;7;8;15
94;30.06.2014;2014;06;10;Maanantai;10;2;12
94;30.06.2014;2014;06;11;Maanantai;4;3;7
94;30.06.2014;2014;06;12;Maanantai;9;5;14
94;30.06.2014;2014;06;13;Maanantai;11;6;17
94;30.06.2014;2014;06;14;Maanantai;4;11;15
94;30.06.2014;2014;06;15;Maanantai;4;18;22
94;30.06.2014;2014;06;16;Maanantai;10;37;47
94;30.06.2014;2014;06;17;Maanantai;7;19;26
94;30.06.2014;2014;06;18;Maanantai;11;10;21
94;30.06.2014;2014;06;19;Maanantai;14;18;32
94;30.06.2014;2014;06;20;Maanantai;4;7;11
94;30.06.2014;2014;06;21;Maanantai;6;7;13
94;30.06.2014;2014;06;22;Maanantai;5;11;16
94;30.06.2014;2014;06;23;Maanantai;1;2;3
94;01.07.2014;2014;07;00;Tiistai;0;0;0
94;01.07.2014;2014;07;01;Tiistai;0;0;0
94;01.07.2014;2014;07;02;Tiistai;0;0;0
94;01.07.2014;2014;07;03;Tiistai;0;0;0
94;01.07.2014;2014;07;04;Tiistai;1;0;1
94;01.07.2014;2014;07;05;Tiistai;5;1;6
94;01.07.2014;2014;07;06;Tiistai;24;4;28
94;01.07.2014;2014;07;07;Tiistai;35;5;40
94;01.07.2014;2014;07;08;Tiistai;11;4;15
94;01.07.2014;2014;07;09;Tiistai;10;7;17
94;01.07.2014;2014;07;10;Tiistai;12;6;18
94;01.07.2014;2014;07;11;Tiistai;9;15;24
94;01.07.2014;2014;07;12;Tiistai;28;13;41
94;01.07.2014;2014;07;13;Tiistai;17;11;28
94;01.07.2014;2014;07;14;Tiistai;12;18;30
94;01.07.2014;2014;07;15;Tiistai;14;42;56
94;01.07.2014;2014;07;16;Tiistai;18;41;59
94;01.07.2014;2014;07;17;Tiistai;17;22;39
94;01.07.2014;2014;07;18;Tiistai;11;19;30
94;01.07.2014;2014;07;19;Tiistai;17;13;30
94;01.07.2014;2014;07;20;Tiistai;9;13;22
94;01.07.2014;2014;07;21;Tiistai;7;10;17
94;01.07.2014;2014;07;22;Tiistai;3;5;8
94;01.07.2014;2014;07;23;Tiistai;1;2;3
94;02.07.2014;2014;07;00;Keskiviikko;4;3;7
94;02.07.2014;2014;07;01;Keskiviikko;1;0;1
94;02.07.2014;2014;07;02;Keskiviikko;0;0;0
94;02.07.2014;2014;07;03;Keskiviikko;0;1;1
94;02.07.2014;2014;07;04;Keskiviikko;0;3;3
94;02.07.2014;2014;07;05;Keskiviikko;5;2;7
94;02.07.2014;2014;07;06;Keskiviikko;12;1;13
94;02.07.2014;2014;07;07;Keskiviikko;19;4;23
94;02.07.2014;2014;07;08;Keskiviikko;10;4;14
94;02.07.2014;2014;07;09;Keskiviikko;5;2;7
94;02.07.2014;2014;07;10;Keskiviikko;1;1;2
94;02.07.2014;2014;07;11;Keskiviikko;2;0;2
94;02.07.2014;2014;07;12;Keskiviikko;2;4;6
94;02.07.2014;2014;07;13;Keskiviikko;2;3;5
94;02.07.2014;2014;07;14;Keskiviikko;2;3;5
94;02.07.2014;2014;07;15;Keskiviikko;0;9;9
94;02.07.2014;2014;07;16;Keskiviikko;3;13;16
94;02.07.2014;2014;07;17;Keskiviikko;6;8;14
94;02.07.2014;2014;07;18;Keskiviikko;1;2;3
94;02.07.2014;2014;07;19;Keskiviikko;1;2;3
94;02.07.2014;2014;07;20;Keskiviikko;2;7;9
94;02.07.2014;2014;07;21;Keskiviikko;2;7;9
94;02.07.2014;2014;07;22;Keskiviikko;0;0;0
94;02.07.2014;2014;07;23;Keskiviikko;1;0;1
94;03.07.2014;2014;07;00;Torstai;0;2;2
94;03.07.2014;2014;07;01;Torstai;0;2;2
94;03.07.2014;2014;07;02;Torstai;0;0;0
94;03.07.2014;2014;07;03;Torstai;0;0;0
94;03.07.2014;2014;07;04;Torstai;1;1;2
94;03.07.2014;2014;07;05;Torstai;1;0;1
94;03.07.2014;2014;07;06;Torstai;12;1;13
94;03.07.2014;2014;07;07;Torstai;22;2;24
94;03.07.2014;2014;07;08;Torstai;11;4;15
94;03.07.2014;2014;07;09;Torstai;10;4;14
94;03.07.2014;2014;07;10;Torstai;1;2;3
94;03.07.2014;2014;07;11;Torstai;1;3;4
94;03.07.2014;2014;07;12;Torstai;4;3;7
94;03.07.2014;2014;07;13;Torstai;6;4;10
94;03.07.2014;2014;07;14;Torstai;7;12;19
94;03.07.2014;2014;07;15;Torstai;4;13;17
94;03.07.2014;2014;07;16;Torstai;6;18;24
94;03.07.2014;2014;07;17;Torstai;3;20;23
94;03.07.2014;2014;07;18;Torstai;3;11;14
94;03.07.2014;2014;07;19;Torstai;6;14;20
94;03.07.2014;2014;07;20;Torstai;4;4;8
94;03.07.2014;2014;07;21;Torstai;3;3;6
94;03.07.2014;2014;07;22;Torstai;0;1;1
94;03.07.2014;2014;07;23;Torstai;0;1;1
94;04.07.2014;2014;07;00;Perjantai;0;1;1
94;04.07.2014;2014;07;01;Perjantai;0;1;1
94;04.07.2014;2014;07;02;Perjantai;0;0;0
94;04.07.2014;2014;07;03;Perjantai;0;1;1
94;04.07.2014;2014;07;04;Perjantai;1;1;2
94;04.07.2014;2014;07;05;Perjantai;5;1;6
94;04.07.2014;2014;07;06;Perjantai;14;4;18
94;04.07.2014;2014;07;07;Perjantai;21;4;25
94;04.07.2014;2014;07;08;Perjantai;10;3;13
94;04.07.2014;2014;07;09;Perjantai;5;2;7
94;04.07.2014;2014;07;10;Perjantai;8;3;11
94;04.07.2014;2014;07;11;Perjantai;9;8;17
94;04.07.2014;2014;07;12;Perjantai;8;7;15
94;04.07.2014;2014;07;13;Perjantai;7;9;16
94;04.07.2014;2014;07;14;Perjantai;10;26;36
94;04.07.2014;2014;07;15;Perjantai;4;19;23
94;04.07.2014;2014;07;16;Perjantai;9;13;22
94;04.07.2014;2014;07;17;Perjantai;4;7;11
94;04.07.2014;2014;07;18;Perjantai;1;2;3
94;04.07.2014;2014;07;19;Perjantai;7;4;11
94;04.07.2014;2014;07;20;Perjantai;0;1;1
94;04.07.2014;2014;07;21;Perjantai;0;4;4
94;04.07.2014;2014;07;22;Perjantai;2;3;5
94;04.07.2014;2014;07;23;Perjantai;2;2;4
94;05.07.2014;2014;07;00;Lauantai;0;0;0
94;05.07.2014;2014;07;01;Lauantai;0;2;2
94;05.07.2014;2014;07;02;Lauantai;0;0;0
94;05.07.2014;2014;07;03;Lauantai;0;0;0
94;05.07.2014;2014;07;04;Lauantai;1;0;1
94;05.07.2014;2014;07;05;Lauantai;0;0;0
94;05.07.2014;2014;07;06;Lauantai;2;1;3
94;05.07.2014;2014;07;07;Lauantai;1;2;3
94;05.07.2014;2014;07;08;Lauantai;1;5;6
94;05.07.2014;2014;07;09;Lauantai;5;7;12
94;05.07.2014;2014;07;10;Lauantai;4;6;10
94;05.07.2014;2014;07;11;Lauantai;5;12;17
94;05.07.2014;2014;07;12;Lauantai;13;14;27
94;05.07.2014;2014;07;13;Lauantai;15;14;29
94;05.07.2014;2014;07;14;Lauantai;19;15;34
94;05.07.2014;2014;07;15;Lauantai;19;13;32
94;05.07.2014;2014;07;16;Lauantai;10;8;18
94;05.07.2014;2014;07;17;Lauantai;15;13;28
94;05.07.2014;2014;07;18;Lauantai;9;14;23
94;05.07.2014;2014;07;19;Lauantai;16;13;29
94;05.07.2014;2014;07;20;Lauantai;4;7;11
94;05.07.2014;2014;07;21;Lauantai;8;6;14
94;05.07.2014;2014;07;22;Lauantai;6;2;8
94;05.07.2014;2014;07;23;Lauantai;1;0;1
94;06.07.2014;2014;07;00;Sunnuntai;0;3;3
94;06.07.2014;2014;07;01;Sunnuntai;2;2;4
94;06.07.2014;2014;07;02;Sunnuntai;0;4;4
94;06.07.2014;2014;07;03;Sunnuntai;0;1;1
94;06.07.2014;2014;07;04;Sunnuntai;0;1;1
94;06.07.2014;2014;07;05;Sunnuntai;0;0;0
94;06.07.2014;2014;07;06;Sunnuntai;0;0;0
94;06.07.2014;2014;07;07;Sunnuntai;2;1;3
94;06.07.2014;2014;07;08;Sunnuntai;6;3;9
94;06.07.2014;2014;07;09;Sunnuntai;1;9;10
94;06.07.2014;2014;07;10;Sunnuntai;12;6;18
94;06.07.2014;2014;07;11;Sunnuntai;13;14;27
94;06.07.2014;2014;07;12;Sunnuntai;23;12;35
94;06.07.2014;2014;07;13;Sunnuntai;17;16;33
94;06.07.2014;2014;07;14;Sunnuntai;17;19;36
94;06.07.2014;2014;07;15;Sunnuntai;21;23;44
94;06.07.2014;2014;07;16;Sunnuntai;23;18;41
94;06.07.2014;2014;07;17;Sunnuntai;19;16;35
94;06.07.2014;2014;07;18;Sunnuntai;7;21;28
94;06.07.2014;2014;07;19;Sunnuntai;13;7;20
94;06.07.2014;2014;07;20;Sunnuntai;5;13;18
94;06.07.2014;2014;07;21;Sunnuntai;13;3;16
94;06.07.2014;2014;07;22;Sunnuntai;4;5;9
94;06.07.2014;2014;07;23;Sunnuntai;1;2;3
94;07.07.2014;2014;07;00;Maanantai;0;0;0
94;07.07.2014;2014;07;01;Maanantai;1;1;2
94;07.07.2014;2014;07;02;Maanantai;1;0;1
94;07.07.2014;2014;07;03;Maanantai;0;1;1
94;07.07.2014;2014;07;04;Maanantai;0;0;0
94;07.07.2014;2014;07;05;Maanantai;3;0;3
94;07.07.2014;2014;07;06;Maanantai;20;3;23
94;07.07.2014;2014;07;07;Maanantai;22;7;29
94;07.07.2014;2014;07;08;Maanantai;16;7;23
94;07.07.2014;2014;07;09;Maanantai;10;6;16
94;07.07.2014;2014;07;10;Maanantai;11;11;22
94;07.07.2014;2014;07;11;Maanantai;13;10;23
94;07.07.2014;2014;07;12;Maanantai;8;15;23
94;07.07.2014;2014;07;13;Maanantai;28;14;42
94;07.07.2014;2014;07;14;Maanantai;9;24;33
94;07.07.2014;2014;07;15;Maanantai;13;39;52
94;07.07.2014;2014;07;16;Maanantai;13;34;47
94;07.07.2014;2014;07;17;Maanantai;24;22;46
94;07.07.2014;2014;07;18;Maanantai;16;14;30
94;07.07.2014;2014;07;19;Maanantai;15;17;32
94;07.07.2014;2014;07;20;Maanantai;11;16;27
94;07.07.2014;2014;07;21;Maanantai;12;9;21
94;07.07.2014;2014;07;22;Maanantai;3;8;11
94;07.07.2014;2014;07;23;Maanantai;4;5;9
94;08.07.2014;2014;07;00;Tiistai;0;2;2
94;08.07.2014;2014;07;01;Tiistai;0;0;0
94;08.07.2014;2014;07;02;Tiistai;1;0;1
94;08.07.2014;2014;07;03;Tiistai;0;0;0
94;08.07.2014;2014;07;04;Tiistai;0;0;0
94;08.07.2014;2014;07;05;Tiistai;3;0;3
94;08.07.2014;2014;07;06;Tiistai;24;4;28
94;08.07.2014;2014;07;07;Tiistai;33;6;39
94;08.07.2014;2014;07;08;Tiistai;13;4;17
94;08.07.2014;2014;07;09;Tiistai;9;7;16
94;08.07.2014;2014;07;10;Tiistai;8;22;30
94;08.07.2014;2014;07;11;Tiistai;12;13;25
94;08.07.2014;2014;07;12;Tiistai;13;5;18
94;08.07.2014;2014;07;13;Tiistai;22;12;34
94;08.07.2014;2014;07;14;Tiistai;14;12;26
94;08.07.2014;2014;07;15;Tiistai;6;42;48
94;08.07.2014;2014;07;16;Tiistai;13;49;62
94;08.07.2014;2014;07;17;Tiistai;22;22;44
94;08.07.2014;2014;07;18;Tiistai;29;26;55
94;08.07.2014;2014;07;19;Tiistai;24;20;44
94;08.07.2014;2014;07;20;Tiistai;20;12;32
94;08.07.2014;2014;07;21;Tiistai;8;9;17
94;08.07.2014;2014;07;22;Tiistai;6;12;18
94;08.07.2014;2014;07;23;Tiistai;8;1;9
94;09.07.2014;2014;07;00;Keskiviikko;0;0;0
94;09.07.2014;2014;07;01;Keskiviikko;0;2;2
94;09.07.2014;2014;07;02;Keskiviikko;2;0;2
94;09.07.2014;2014;07;03;Keskiviikko;0;0;0
94;09.07.2014;2014;07;04;Keskiviikko;0;0;0
94;09.07.2014;2014;07;05;Keskiviikko;4;1;5
94;09.07.2014;2014;07;06;Keskiviikko;18;1;19
94;09.07.2014;2014;07;07;Keskiviikko;25;4;29
94;09.07.2014;2014;07;08;Keskiviikko;13;7;20
94;09.07.2014;2014;07;09;Keskiviikko;9;9;18
94;09.07.2014;2014;07;10;Keskiviikko;8;6;14
94;09.07.2014;2014;07;11;Keskiviikko;12;10;22
94;09.07.2014;2014;07;12;Keskiviikko;9;6;15
94;09.07.2014;2014;07;13;Keskiviikko;20;17;37
94;09.07.2014;2014;07;14;Keskiviikko;5;13;18
94;09.07.2014;2014;07;15;Keskiviikko;7;35;42
94;09.07.2014;2014;07;16;Keskiviikko;5;23;28
94;09.07.2014;2014;07;17;Keskiviikko;21;17;38
94;09.07.2014;2014;07;18;Keskiviikko;5;11;16
94;09.07.2014;2014;07;19;Keskiviikko;3;14;17
94;09.07.2014;2014;07;20;Keskiviikko;7;12;19
94;09.07.2014;2014;07;21;Keskiviikko;5;12;17
94;09.07.2014;2014;07;22;Keskiviikko;8;10;18
94;09.07.2014;2014;07;23;Keskiviikko;3;3;6
94;10.07.2014;2014;07;00;Torstai;1;0;1
94;10.07.2014;2014;07;01;Torstai;0;0;0
94;10.07.2014;2014;07;02;Torstai;0;3;3
94;10.07.2014;2014;07;03;Torstai;1;0;1
94;10.07.2014;2014;07;04;Torstai;0;2;2
94;10.07.2014;2014;07;05;Torstai;5;1;6
94;10.07.2014;2014;07;06;Torstai;21;1;22
94;10.07.2014;2014;07;07;Torstai;20;4;24
94;10.07.2014;2014;07;08;Torstai;9;2;11
94;10.07.2014;2014;07;09;Torstai;7;3;10
94;10.07.2014;2014;07;10;Torstai;4;5;9
94;10.07.2014;2014;07;11;Torstai;13;6;19
94;10.07.2014;2014;07;12;Torstai;7;10;17
94;10.07.2014;2014;07;13;Torstai;21;7;28
94;10.07.2014;2014;07;14;Torstai;10;20;30
94;10.07.2014;2014;07;15;Torstai;10;29;39
94;10.07.2014;2014;07;16;Torstai;12;31;43
94;10.07.2014;2014;07;17;Torstai;14;33;47
94;10.07.2014;2014;07;18;Torstai;15;21;36
94;10.07.2014;2014;07;19;Torstai;16;25;41
94;10.07.2014;2014;07;20;Torstai;8;11;19
94;10.07.2014;2014;07;21;Torstai;11;11;22
94;10.07.2014;2014;07;22;Torstai;2;9;11
94;10.07.2014;2014;07;23;Torstai;1;2;3
94;11.07.2014;2014;07;00;Perjantai;1;0;1
94;11.07.2014;2014;07;01;Perjantai;0;1;1
94;11.07.2014;2014;07;02;Perjantai;1;0;1
94;11.07.2014;2014;07;03;Perjantai;0;0;0
94;11.07.2014;2014;07;04;Perjantai;0;1;1
94;11.07.2014;2014;07;05;Perjantai;4;0;4
94;11.07.2014;2014;07;06;Perjantai;22;2;24
94;11.07.2014;2014;07;07;Perjantai;20;9;29
94;11.07.2014;2014;07;08;Perjantai;6;6;12
94;11.07.2014;2014;07;09;Perjantai;9;5;14
94;11.07.2014;2014;07;10;Perjantai;8;9;17
94;11.07.2014;2014;07;11;Perjantai;10;8;18
94;11.07.2014;2014;07;12;Perjantai;8;7;15
94;11.07.2014;2014;07;13;Perjantai;24;8;32
94;11.07.2014;2014;07;14;Perjantai;20;19;39
94;11.07.2014;2014;07;15;Perjantai;14;31;45
94;11.07.2014;2014;07;16;Perjantai;20;37;57
94;11.07.2014;2014;07;17;Perjantai;17;20;37
94;11.07.2014;2014;07;18;Perjantai;19;16;35
94;11.07.2014;2014;07;19;Perjantai;12;20;32
94;11.07.2014;2014;07;20;Perjantai;11;3;14
94;11.07.2014;2014;07;21;Perjantai;7;6;13
94;11.07.2014;2014;07;22;Perjantai;5;5;10
94;11.07.2014;2014;07;23;Perjantai;1;3;4
94;12.07.2014;2014;07;00;Lauantai;4;11;15
94;12.07.2014;2014;07;01;Lauantai;0;2;2
94;12.07.2014;2014;07;02;Lauantai;0;5;5
94;12.07.2014;2014;07;03;Lauantai;1;1;2
94;12.07.2014;2014;07;04;Lauantai;0;2;2
94;12.07.2014;2014;07;05;Lauantai;0;1;1
94;12.07.2014;2014;07;06;Lauantai;3;1;4
94;12.07.2014;2014;07;07;Lauantai;3;3;6
94;12.07.2014;2014;07;08;Lauantai;3;1;4
94;12.07.2014;2014;07;09;Lauantai;7;12;19
94;12.07.2014;2014;07;10;Lauantai;7;4;11
94;12.07.2014;2014;07;11;Lauantai;16;14;30
94;12.07.2014;2014;07;12;Lauantai;23;11;34
94;12.07.2014;2014;07;13;Lauantai;18;14;32
94;12.07.2014;2014;07;14;Lauantai;19;15;34
94;12.07.2014;2014;07;15;Lauantai;20;29;49
94;12.07.2014;2014;07;16;Lauantai;20;11;31
94;12.07.2014;2014;07;17;Lauantai;10;17;27
94;12.07.2014;2014;07;18;Lauantai;22;8;30
94;12.07.2014;2014;07;19;Lauantai;12;15;27
94;12.07.2014;2014;07;20;Lauantai;18;14;32
94;12.07.2014;2014;07;21;Lauantai;8;6;14
94;12.07.2014;2014;07;22;Lauantai;0;8;8
94;12.07.2014;2014;07;23;Lauantai;0;2;2
94;13.07.2014;2014;07;00;Sunnuntai;2;7;9
94;13.07.2014;2014;07;01;Sunnuntai;1;2;3
94;13.07.2014;2014;07;02;Sunnuntai;1;2;3
94;13.07.2014;2014;07;03;Sunnuntai;0;2;2
94;13.07.2014;2014;07;04;Sunnuntai;0;1;1
94;13.07.2014;2014;07;05;Sunnuntai;1;0;1
94;13.07.2014;2014;07;06;Sunnuntai;3;1;4
94;13.07.2014;2014;07;07;Sunnuntai;1;3;4
94;13.07.2014;2014;07;08;Sunnuntai;0;2;2
94;13.07.2014;2014;07;09;Sunnuntai;4;2;6
94;13.07.2014;2014;07;10;Sunnuntai;9;5;14
94;13.07.2014;2014;07;11;Sunnuntai;15;12;27
94;13.07.2014;2014;07;12;Sunnuntai;24;14;38
94;13.07.2014;2014;07;13;Sunnuntai;10;12;22
94;13.07.2014;2014;07;14;Sunnuntai;18;27;45
94;13.07.2014;2014;07;15;Sunnuntai;23;16;39
94;13.07.2014;2014;07;16;Sunnuntai;18;15;33
94;13.07.2014;2014;07;17;Sunnuntai;18;7;25
94;13.07.2014;2014;07;18;Sunnuntai;14;16;30
94;13.07.2014;2014;07;19;Sunnuntai;21;16;37
94;13.07.2014;2014;07;20;Sunnuntai;18;13;31
94;13.07.2014;2014;07;21;Sunnuntai;6;10;16
94;13.07.2014;2014;07;22;Sunnuntai;2;3;5
94;13.07.2014;2014;07;23;Sunnuntai;0;2;2
94;14.07.2014;2014;07;00;Maanantai;0;1;1
94;14.07.2014;2014;07;01;Maanantai;1;0;1
94;14.07.2014;2014;07;02;Maanantai;0;0;0
94;14.07.2014;2014;07;03;Maanantai;0;0;0
94;14.07.2014;2014;07;04;Maanantai;1;1;2
94;14.07.2014;2014;07;05;Maanantai;3;0;3
94;14.07.2014;2014;07;06;Maanantai;21;4;25
94;14.07.2014;2014;07;07;Maanantai;16;3;19
94;14.07.2014;2014;07;08;Maanantai;11;5;16
94;14.07.2014;2014;07;09;Maanantai;6;7;13
94;14.07.2014;2014;07;10;Maanantai;8;5;13
94;14.07.2014;2014;07;11;Maanantai;9;5;14
94;14.07.2014;2014;07;12;Maanantai;16;13;29
94;14.07.2014;2014;07;13;Maanantai;9;17;26
94;14.07.2014;2014;07;14;Maanantai;12;24;36
94;14.07.2014;2014;07;15;Maanantai;7;13;20
94;14.07.2014;2014;07;16;Maanantai;12;33;45
94;14.07.2014;2014;07;17;Maanantai;11;21;32
94;14.07.2014;2014;07;18;Maanantai;11;24;35
94;14.07.2014;2014;07;19;Maanantai;21;9;30
94;14.07.2014;2014;07;20;Maanantai;5;7;12
94;14.07.2014;2014;07;21;Maanantai;4;5;9
94;14.07.2014;2014;07;22;Maanantai;10;1;11
94;14.07.2014;2014;07;23;Maanantai;1;0;1
94;15.07.2014;2014;07;00;Tiistai;1;3;4
94;15.07.2014;2014;07;01;Tiistai;0;1;1
94;15.07.2014;2014;07;02;Tiistai;0;1;1
94;15.07.2014;2014;07;03;Tiistai;0;0;0
94;15.07.2014;2014;07;04;Tiistai;0;1;1
94;15.07.2014;2014;07;05;Tiistai;4;0;4
94;15.07.2014;2014;07;06;Tiistai;18;3;21
94;15.07.2014;2014;07;07;Tiistai;21;5;26
94;15.07.2014;2014;07;08;Tiistai;10;7;17
94;15.07.2014;2014;07;09;Tiistai;11;5;16
94;15.07.2014;2014;07;10;Tiistai;8;7;15
94;15.07.2014;2014;07;11;Tiistai;3;4;7
94;15.07.2014;2014;07;12;Tiistai;17;8;25
94;15.07.2014;2014;07;13;Tiistai;13;14;27
94;15.07.2014;2014;07;14;Tiistai;16;31;47
94;15.07.2014;2014;07;15;Tiistai;8;26;34
94;15.07.2014;2014;07;16;Tiistai;14;24;38
94;15.07.2014;2014;07;17;Tiistai;20;29;49
94;15.07.2014;2014;07;18;Tiistai;19;17;36
94;15.07.2014;2014;07;19;Tiistai;20;17;37
94;15.07.2014;2014;07;20;Tiistai;13;9;22
94;15.07.2014;2014;07;21;Tiistai;3;2;5
94;15.07.2014;2014;07;22;Tiistai;1;8;9
94;15.07.2014;2014;07;23;Tiistai;1;6;7
94;16.07.2014;2014;07;00;Keskiviikko;1;1;2
94;16.07.2014;2014;07;01;Keskiviikko;0;2;2
94;16.07.2014;2014;07;02;Keskiviikko;0;0;0
94;16.07.2014;2014;07;03;Keskiviikko;0;0;0
94;16.07.2014;2014;07;04;Keskiviikko;0;0;0
94;16.07.2014;2014;07;05;Keskiviikko;7;1;8
94;16.07.2014;2014;07;06;Keskiviikko;16;1;17
94;16.07.2014;2014;07;07;Keskiviikko;21;6;27
94;16.07.2014;2014;07;08;Keskiviikko;9;7;16
94;16.07.2014;2014;07;09;Keskiviikko;10;2;12
94;16.07.2014;2014;07;10;Keskiviikko;8;9;17
94;16.07.2014;2014;07;11;Keskiviikko;13;10;23
94;16.07.2014;2014;07;12;Keskiviikko;3;9;12
94;16.07.2014;2014;07;13;Keskiviikko;6;14;20
94;16.07.2014;2014;07;14;Keskiviikko;11;18;29
94;16.07.2014;2014;07;15;Keskiviikko;8;25;33
94;16.07.2014;2014;07;16;Keskiviikko;9;20;29
94;16.07.2014;2014;07;17;Keskiviikko;7;17;24
94;16.07.2014;2014;07;18;Keskiviikko;2;7;9
94;16.07.2014;2014;07;19;Keskiviikko;7;5;12
94;16.07.2014;2014;07;20;Keskiviikko;4;9;13
94;16.07.2014;2014;07;21;Keskiviikko;3;3;6
94;16.07.2014;2014;07;22;Keskiviikko;3;4;7
94;16.07.2014;2014;07;23;Keskiviikko;0;3;3
94;17.07.2014;2014;07;00;Torstai;1;1;2
94;17.07.2014;2014;07;01;Torstai;1;4;5
94;17.07.2014;2014;07;02;Torstai;0;0;0
94;17.07.2014;2014;07;03;Torstai;0;0;0
94;17.07.2014;2014;07;04;Torstai;0;1;1
94;17.07.2014;2014;07;05;Torstai;7;0;7
94;17.07.2014;2014;07;06;Torstai;13;2;15
94;17.07.2014;2014;07;07;Torstai;19;3;22
94;17.07.2014;2014;07;08;Torstai;6;2;8
94;17.07.2014;2014;07;09;Torstai;9;4;13
94;17.07.2014;2014;07;10;Torstai;6;6;12
94;17.07.2014;2014;07;11;Torstai;9;4;13
94;17.07.2014;2014;07;12;Torstai;7;14;21
94;17.07.2014;2014;07;13;Torstai;5;11;16
94;17.07.2014;2014;07;14;Torstai;11;15;26
94;17.07.2014;2014;07;15;Torstai;2;19;21
94;17.07.2014;2014;07;16;Torstai;7;9;16
94;17.07.2014;2014;07;17;Torstai;21;15;36
94;17.07.2014;2014;07;18;Torstai;7;7;14
94;17.07.2014;2014;07;19;Torstai;0;8;8
94;17.07.2014;2014;07;20;Torstai;8;7;15
94;17.07.2014;2014;07;21;Torstai;1;2;3
94;17.07.2014;2014;07;22;Torstai;4;3;7
94;17.07.2014;2014;07;23;Torstai;0;4;4
94;18.07.2014;2014;07;00;Perjantai;0;1;1
94;18.07.2014;2014;07;01;Perjantai;0;1;1
94;18.07.2014;2014;07;02;Perjantai;1;0;1
94;18.07.2014;2014;07;03;Perjantai;0;0;0
94;18.07.2014;2014;07;04;Perjantai;0;1;1
94;18.07.2014;2014;07;05;Perjantai;6;0;6
94;18.07.2014;2014;07;06;Perjantai;9;1;10
94;18.07.2014;2014;07;07;Perjantai;18;3;21
94;18.07.2014;2014;07;08;Perjantai;6;6;12
94;18.07.2014;2014;07;09;Perjantai;11;5;16
94;18.07.2014;2014;07;10;Perjantai;5;4;9
94;18.07.2014;2014;07;11;Perjantai;6;3;9
94;18.07.2014;2014;07;12;Perjantai;11;19;30
94;18.07.2014;2014;07;13;Perjantai;11;9;20
94;18.07.2014;2014;07;14;Perjantai;5;6;11
94;18.07.2014;2014;07;15;Perjantai;12;14;26
94;18.07.2014;2014;07;16;Perjantai;2;23;25
94;18.07.2014;2014;07;17;Perjantai;11;9;20
94;18.07.2014;2014;07;18;Perjantai;13;14;27
94;18.07.2014;2014;07;19;Perjantai;6;7;13
94;18.07.2014;2014;07;20;Perjantai;4;3;7
94;18.07.2014;2014;07;21;Perjantai;1;10;11
94;18.07.2014;2014;07;22;Perjantai;1;3;4
94;18.07.2014;2014;07;23;Perjantai;1;2;3
94;19.07.2014;2014;07;00;Lauantai;0;1;1
94;19.07.2014;2014;07;01;Lauantai;2;0;2
94;19.07.2014;2014;07;02;Lauantai;0;1;1
94;19.07.2014;2014;07;03;Lauantai;0;1;1
94;19.07.2014;2014;07;04;Lauantai;0;0;0
94;19.07.2014;2014;07;05;Lauantai;0;2;2
94;19.07.2014;2014;07;06;Lauantai;3;0;3
94;19.07.2014;2014;07;07;Lauantai;4;4;8
94;19.07.2014;2014;07;08;Lauantai;6;7;13
94;19.07.2014;2014;07;09;Lauantai;3;12;15
94;19.07.2014;2014;07;10;Lauantai;6;14;20
94;19.07.2014;2014;07;11;Lauantai;11;9;20
94;19.07.2014;2014;07;12;Lauantai;13;14;27
94;19.07.2014;2014;07;13;Lauantai;15;13;28
94;19.07.2014;2014;07;14;Lauantai;9;4;13
94;19.07.2014;2014;07;15;Lauantai;7;7;14
94;19.07.2014;2014;07;16;Lauantai;6;3;9
94;19.07.2014;2014;07;17;Lauantai;5;4;9
94;19.07.2014;2014;07;18;Lauantai;6;7;13
94;19.07.2014;2014;07;19;Lauantai;6;5;11
94;19.07.2014;2014;07;20;Lauantai;13;9;22
94;19.07.2014;2014;07;21;Lauantai;4;8;12
94;19.07.2014;2014;07;22;Lauantai;1;8;9
94;19.07.2014;2014;07;23;Lauantai;2;4;6
94;20.07.2014;2014;07;00;Sunnuntai;0;4;4
94;20.07.2014;2014;07;01;Sunnuntai;2;2;4
94;20.07.2014;2014;07;02;Sunnuntai;0;0;0
94;20.07.2014;2014;07;03;Sunnuntai;0;0;0
94;20.07.2014;2014;07;04;Sunnuntai;0;1;1
94;20.07.2014;2014;07;05;Sunnuntai;1;1;2
94;20.07.2014;2014;07;06;Sunnuntai;7;1;8
94;20.07.2014;2014;07;07;Sunnuntai;2;4;6
94;20.07.2014;2014;07;08;Sunnuntai;5;6;11
94;20.07.2014;2014;07;09;Sunnuntai;7;9;16
94;20.07.2014;2014;07;10;Sunnuntai;12;20;32
94;20.07.2014;2014;07;11;Sunnuntai;24;31;55
94;20.07.2014;2014;07;12;Sunnuntai;17;13;30
94;20.07.2014;2014;07;13;Sunnuntai;13;23;36
94;20.07.2014;2014;07;14;Sunnuntai;16;11;27
94;20.07.2014;2014;07;15;Sunnuntai;16;12;28
94;20.07.2014;2014;07;16;Sunnuntai;18;13;31
94;20.07.2014;2014;07;17;Sunnuntai;18;12;30
94;20.07.2014;2014;07;18;Sunnuntai;16;7;23
94;20.07.2014;2014;07;19;Sunnuntai;18;11;29
94;20.07.2014;2014;07;20;Sunnuntai;10;4;14
94;20.07.2014;2014;07;21;Sunnuntai;9;7;16
94;20.07.2014;2014;07;22;Sunnuntai;2;2;4
94;20.07.2014;2014;07;23;Sunnuntai;1;4;5
94;21.07.2014;2014;07;00;Maanantai;1;1;2
94;21.07.2014;2014;07;01;Maanantai;0;1;1
94;21.07.2014;2014;07;02;Maanantai;1;0;1
94;21.07.2014;2014;07;03;Maanantai;0;0;0
94;21.07.2014;2014;07;04;Maanantai;0;3;3
94;21.07.2014;2014;07;05;Maanantai;9;2;11
94;21.07.2014;2014;07;06;Maanantai;21;4;25
94;21.07.2014;2014;07;07;Maanantai;26;7;33
94;21.07.2014;2014;07;08;Maanantai;11;5;16
94;21.07.2014;2014;07;09;Maanantai;8;14;22
94;21.07.2014;2014;07;10;Maanantai;15;10;25
94;21.07.2014;2014;07;11;Maanantai;14;10;24
94;21.07.2014;2014;07;12;Maanantai;17;7;24
94;21.07.2014;2014;07;13;Maanantai;29;20;49
94;21.07.2014;2014;07;14;Maanantai;12;18;30
94;21.07.2014;2014;07;15;Maanantai;9;32;41
94;21.07.2014;2014;07;16;Maanantai;6;32;38
94;21.07.2014;2014;07;17;Maanantai;36;24;60
94;21.07.2014;2014;07;18;Maanantai;11;19;30
94;21.07.2014;2014;07;19;Maanantai;14;13;27
94;21.07.2014;2014;07;20;Maanantai;13;15;28
94;21.07.2014;2014;07;21;Maanantai;9;20;29
94;21.07.2014;2014;07;22;Maanantai;2;7;9
94;21.07.2014;2014;07;23;Maanantai;4;2;6
94;22.07.2014;2014;07;00;Tiistai;1;1;2
94;22.07.2014;2014;07;01;Tiistai;0;0;0
94;22.07.2014;2014;07;02;Tiistai;0;2;2
94;22.07.2014;2014;07;03;Tiistai;0;1;1
94;22.07.2014;2014;07;04;Tiistai;1;2;3
94;22.07.2014;2014;07;05;Tiistai;4;3;7
94;22.07.2014;2014;07;06;Tiistai;29;4;33
94;22.07.2014;2014;07;07;Tiistai;23;4;27
94;22.07.2014;2014;07;08;Tiistai;10;7;17
94;22.07.2014;2014;07;09;Tiistai;12;4;16
94;22.07.2014;2014;07;10;Tiistai;20;13;33
94;22.07.2014;2014;07;11;Tiistai;11;11;22
94;22.07.2014;2014;07;12;Tiistai;15;10;25
94;22.07.2014;2014;07;13;Tiistai;15;20;35
94;22.07.2014;2014;07;14;Tiistai;16;21;37
94;22.07.2014;2014;07;15;Tiistai;16;49;65
94;22.07.2014;2014;07;16;Tiistai;5;37;42
94;22.07.2014;2014;07;17;Tiistai;22;25;47
94;22.07.2014;2014;07;18;Tiistai;24;22;46
94;22.07.2014;2014;07;19;Tiistai;12;16;28
94;22.07.2014;2014;07;20;Tiistai;12;13;25
94;22.07.2014;2014;07;21;Tiistai;7;7;14
94;22.07.2014;2014;07;22;Tiistai;6;6;12
94;22.07.2014;2014;07;23;Tiistai;0;5;5
94;23.07.2014;2014;07;00;Keskiviikko;1;2;3
94;23.07.2014;2014;07;01;Keskiviikko;1;1;2
94;23.07.2014;2014;07;02;Keskiviikko;0;1;1
94;23.07.2014;2014;07;03;Keskiviikko;0;1;1
94;23.07.2014;2014;07;04;Keskiviikko;1;2;3
94;23.07.2014;2014;07;05;Keskiviikko;7;3;10
94;23.07.2014;2014;07;06;Keskiviikko;21;3;24
94;23.07.2014;2014;07;07;Keskiviikko;21;4;25
94;23.07.2014;2014;07;08;Keskiviikko;17;8;25
94;23.07.2014;2014;07;09;Keskiviikko;6;18;24
94;23.07.2014;2014;07;10;Keskiviikko;20;11;31
94;23.07.2014;2014;07;11;Keskiviikko;13;11;24
94;23.07.2014;2014;07;12;Keskiviikko;17;14;31
94;23.07.2014;2014;07;13;Keskiviikko;27;18;45
94;23.07.2014;2014;07;14;Keskiviikko;19;24;43
94;23.07.2014;2014;07;15;Keskiviikko;10;31;41
94;23.07.2014;2014;07;16;Keskiviikko;10;37;47
94;23.07.2014;2014;07;17;Keskiviikko;18;10;28
94;23.07.2014;2014;07;18;Keskiviikko;18;9;27
94;23.07.2014;2014;07;19;Keskiviikko;18;17;35
94;23.07.2014;2014;07;20;Keskiviikko;6;16;22
94;23.07.2014;2014;07;21;Keskiviikko;4;10;14
94;23.07.2014;2014;07;22;Keskiviikko;4;7;11
94;23.07.2014;2014;07;23;Keskiviikko;2;0;2
94;24.07.2014;2014;07;00;Torstai;0;3;3
94;24.07.2014;2014;07;01;Torstai;0;0;0
94;24.07.2014;2014;07;02;Torstai;0;3;3
94;24.07.2014;2014;07;03;Torstai;0;0;0
94;24.07.2014;2014;07;04;Torstai;1;1;2
94;24.07.2014;2014;07;05;Torstai;4;3;7
94;24.07.2014;2014;07;06;Torstai;22;4;26
94;24.07.2014;2014;07;07;Torstai;19;6;25
94;24.07.2014;2014;07;08;Torstai;10;6;16
94;24.07.2014;2014;07;09;Torstai;9;11;20
94;24.07.2014;2014;07;10;Torstai;7;4;11
94;24.07.2014;2014;07;11;Torstai;15;13;28
94;24.07.2014;2014;07;12;Torstai;9;10;19
94;24.07.2014;2014;07;13;Torstai;13;1;14
94;24.07.2014;2014;07;14;Torstai;16;20;36
94;24.07.2014;2014;07;15;Torstai;11;28;39
94;24.07.2014;2014;07;16;Torstai;13;23;36
94;24.07.2014;2014;07;17;Torstai;9;15;24
94;24.07.2014;2014;07;18;Torstai;12;17;29
94;24.07.2014;2014;07;19;Torstai;13;22;35
94;24.07.2014;2014;07;20;Torstai;18;10;28
94;24.07.2014;2014;07;21;Torstai;16;13;29
94;24.07.2014;2014;07;22;Torstai;3;8;11
94;24.07.2014;2014;07;23;Torstai;5;0;5
94;25.07.2014;2014;07;00;Perjantai;1;2;3
94;25.07.2014;2014;07;01;Perjantai;0;1;1
94;25.07.2014;2014;07;02;Perjantai;0;2;2
94;25.07.2014;2014;07;03;Perjantai;1;1;2
94;25.07.2014;2014;07;04;Perjantai;0;2;2
94;25.07.2014;2014;07;05;Perjantai;5;0;5
94;25.07.2014;2014;07;06;Perjantai;19;3;22
94;25.07.2014;2014;07;07;Perjantai;20;4;24
94;25.07.2014;2014;07;08;Perjantai;7;5;12
94;25.07.2014;2014;07;09;Perjantai;11;8;19
94;25.07.2014;2014;07;10;Perjantai;15;8;23
94;25.07.2014;2014;07;11;Perjantai;15;13;28
94;25.07.2014;2014;07;12;Perjantai;13;12;25
94;25.07.2014;2014;07;13;Perjantai;15;12;27
94;25.07.2014;2014;07;14;Perjantai;22;13;35
94;25.07.2014;2014;07;15;Perjantai;10;18;28
94;25.07.2014;2014;07;16;Perjantai;10;18;28
94;25.07.2014;2014;07;17;Perjantai;11;20;31
94;25.07.2014;2014;07;18;Perjantai;17;19;36
94;25.07.2014;2014;07;19;Perjantai;13;9;22
94;25.07.2014;2014;07;20;Perjantai;6;12;18
94;25.07.2014;2014;07;21;Perjantai;12;7;19
94;25.07.2014;2014;07;22;Perjantai;6;5;11
94;25.07.2014;2014;07;23;Perjantai;3;3;6
94;26.07.2014;2014;07;00;Lauantai;0;4;4
94;26.07.2014;2014;07;01;Lauantai;0;4;4
94;26.07.2014;2014;07;02;Lauantai;0;3;3
94;26.07.2014;2014;07;03;Lauantai;0;4;4
94;26.07.2014;2014;07;04;Lauantai;1;5;6
94;26.07.2014;2014;07;05;Lauantai;1;3;4
94;26.07.2014;2014;07;06;Lauantai;6;1;7
94;26.07.2014;2014;07;07;Lauantai;1;6;7
94;26.07.2014;2014;07;08;Lauantai;7;3;10
94;26.07.2014;2014;07;09;Lauantai;4;11;15
94;26.07.2014;2014;07;10;Lauantai;15;11;26
94;26.07.2014;2014;07;11;Lauantai;16;8;24
94;26.07.2014;2014;07;12;Lauantai;20;24;44
94;26.07.2014;2014;07;13;Lauantai;19;12;31
94;26.07.2014;2014;07;14;Lauantai;18;10;28
94;26.07.2014;2014;07;15;Lauantai;10;12;22
94;26.07.2014;2014;07;16;Lauantai;29;11;40
94;26.07.2014;2014;07;17;Lauantai;13;27;40
94;26.07.2014;2014;07;18;Lauantai;15;11;26
94;26.07.2014;2014;07;19;Lauantai;17;8;25
94;26.07.2014;2014;07;20;Lauantai;22;13;35
94;26.07.2014;2014;07;21;Lauantai;8;23;31
94;26.07.2014;2014;07;22;Lauantai;4;14;18
94;26.07.2014;2014;07;23;Lauantai;1;3;4
94;27.07.2014;2014;07;00;Sunnuntai;2;5;7
94;27.07.2014;2014;07;01;Sunnuntai;0;1;1
94;27.07.2014;2014;07;02;Sunnuntai;0;6;6
94;27.07.2014;2014;07;03;Sunnuntai;0;6;6
94;27.07.2014;2014;07;04;Sunnuntai;0;5;5
94;27.07.2014;2014;07;05;Sunnuntai;1;1;2
94;27.07.2014;2014;07;06;Sunnuntai;2;1;3
94;27.07.2014;2014;07;07;Sunnuntai;3;5;8
94;27.07.2014;2014;07;08;Sunnuntai;5;9;14
94;27.07.2014;2014;07;09;Sunnuntai;8;5;13
94;27.07.2014;2014;07;10;Sunnuntai;16;10;26
94;27.07.2014;2014;07;11;Sunnuntai;8;11;19
94;27.07.2014;2014;07;12;Sunnuntai;8;16;24
94;27.07.2014;2014;07;13;Sunnuntai;10;12;22
94;27.07.2014;2014;07;14;Sunnuntai;10;11;21
94;27.07.2014;2014;07;15;Sunnuntai;17;10;27
94;27.07.2014;2014;07;16;Sunnuntai;11;17;28
94;27.07.2014;2014;07;17;Sunnuntai;12;11;23
94;27.07.2014;2014;07;18;Sunnuntai;11;15;26
94;27.07.2014;2014;07;19;Sunnuntai;11;13;24
94;27.07.2014;2014;07;20;Sunnuntai;15;4;19
94;27.07.2014;2014;07;21;Sunnuntai;5;10;15
94;27.07.2014;2014;07;22;Sunnuntai;12;4;16
94;27.07.2014;2014;07;23;Sunnuntai;3;2;5
94;28.07.2014;2014;07;00;Maanantai;1;1;2
94;28.07.2014;2014;07;01;Maanantai;0;0;0
94;28.07.2014;2014;07;02;Maanantai;0;0;0
94;28.07.2014;2014;07;03;Maanantai;0;0;0
94;28.07.2014;2014;07;04;Maanantai;1;1;2
94;28.07.2014;2014;07;05;Maanantai;3;0;3
94;28.07.2014;2014;07;06;Maanantai;20;3;23
94;28.07.2014;2014;07;07;Maanantai;21;2;23
94;28.07.2014;2014;07;08;Maanantai;9;13;22
94;28.07.2014;2014;07;09;Maanantai;3;2;5
94;28.07.2014;2014;07;10;Maanantai;2;0;2
94;28.07.2014;2014;07;11;Maanantai;0;2;2
94;28.07.2014;2014;07;12;Maanantai;2;4;6
94;28.07.2014;2014;07;13;Maanantai;9;2;11
94;28.07.2014;2014;07;14;Maanantai;8;9;17
94;28.07.2014;2014;07;15;Maanantai;3;21;24
94;28.07.2014;2014;07;16;Maanantai;4;17;21
94;28.07.2014;2014;07;17;Maanantai;9;10;19
94;28.07.2014;2014;07;18;Maanantai;11;12;23
94;28.07.2014;2014;07;19;Maanantai;10;16;26
94;28.07.2014;2014;07;20;Maanantai;6;11;17
94;28.07.2014;2014;07;21;Maanantai;5;14;19
94;28.07.2014;2014;07;22;Maanantai;1;3;4
94;28.07.2014;2014;07;23;Maanantai;4;3;7
94;29.07.2014;2014;07;00;Tiistai;2;1;3
94;29.07.2014;2014;07;01;Tiistai;0;0;0
94;29.07.2014;2014;07;02;Tiistai;0;0;0
94;29.07.2014;2014;07;03;Tiistai;0;0;0
94;29.07.2014;2014;07;04;Tiistai;0;0;0
94;29.07.2014;2014;07;05;Tiistai;4;0;4
94;29.07.2014;2014;07;06;Tiistai;17;0;17
94;29.07.2014;2014;07;07;Tiistai;15;2;17
94;29.07.2014;2014;07;08;Tiistai;12;5;17
94;29.07.2014;2014;07;09;Tiistai;11;3;14
94;29.07.2014;2014;07;10;Tiistai;3;6;9
94;29.07.2014;2014;07;11;Tiistai;7;8;15
94;29.07.2014;2014;07;12;Tiistai;6;8;14
94;29.07.2014;2014;07;13;Tiistai;10;8;18
94;29.07.2014;2014;07;14;Tiistai;9;20;29
94;29.07.2014;2014;07;15;Tiistai;10;34;44
94;29.07.2014;2014;07;16;Tiistai;16;31;47
94;29.07.2014;2014;07;17;Tiistai;13;25;38
94;29.07.2014;2014;07;18;Tiistai;23;19;42
94;29.07.2014;2014;07;19;Tiistai;10;13;23
94;29.07.2014;2014;07;20;Tiistai;16;7;23
94;29.07.2014;2014;07;21;Tiistai;7;10;17
94;29.07.2014;2014;07;22;Tiistai;3;11;14
94;29.07.2014;2014;07;23;Tiistai;3;1;4
94;30.07.2014;2014;07;00;Keskiviikko;0;2;2
94;30.07.2014;2014;07;01;Keskiviikko;3;1;4
94;30.07.2014;2014;07;02;Keskiviikko;0;1;1
94;30.07.2014;2014;07;03;Keskiviikko;0;2;2
94;30.07.2014;2014;07;04;Keskiviikko;1;1;2
94;30.07.2014;2014;07;05;Keskiviikko;3;1;4
94;30.07.2014;2014;07;06;Keskiviikko;23;1;24
94;30.07.2014;2014;07;07;Keskiviikko;21;4;25
94;30.07.2014;2014;07;08;Keskiviikko;8;9;17
94;30.07.2014;2014;07;09;Keskiviikko;8;3;11
94;30.07.2014;2014;07;10;Keskiviikko;8;4;12
94;30.07.2014;2014;07;11;Keskiviikko;7;11;18
94;30.07.2014;2014;07;12;Keskiviikko;2;8;10
94;30.07.2014;2014;07;13;Keskiviikko;14;11;25
94;30.07.2014;2014;07;14;Keskiviikko;16;15;31
94;30.07.2014;2014;07;15;Keskiviikko;14;39;53
94;30.07.2014;2014;07;16;Keskiviikko;16;30;46
94;30.07.2014;2014;07;17;Keskiviikko;10;20;30
94;30.07.2014;2014;07;18;Keskiviikko;14;11;25
94;30.07.2014;2014;07;19;Keskiviikko;29;7;36
94;30.07.2014;2014;07;20;Keskiviikko;13;19;32
94;30.07.2014;2014;07;21;Keskiviikko;4;10;14
94;30.07.2014;2014;07;22;Keskiviikko;4;4;8
94;30.07.2014;2014;07;23;Keskiviikko;7;3;10
94;31.07.2014;2014;07;00;Torstai;4;2;6
94;31.07.2014;2014;07;01;Torstai;1;1;2
94;31.07.2014;2014;07;02;Torstai;2;0;2
94;31.07.2014;2014;07;03;Torstai;0;0;0
94;31.07.2014;2014;07;04;Torstai;0;0;0
94;31.07.2014;2014;07;05;Torstai;4;1;5
94;31.07.2014;2014;07;06;Torstai;9;1;10
94;31.07.2014;2014;07;07;Torstai;12;1;13
94;31.07.2014;2014;07;08;Torstai;7;4;11
94;31.07.2014;2014;07;09;Torstai;3;3;6
94;31.07.2014;2014;07;10;Torstai;6;4;10
94;31.07.2014;2014;07;11;Torstai;3;2;5
94;31.07.2014;2014;07;12;Torstai;4;2;6
94;31.07.2014;2014;07;13;Torstai;1;0;1
94;31.07.2014;2014;07;14;Torstai;1;2;3
94;31.07.2014;2014;07;15;Torstai;1;6;7
94;31.07.2014;2014;07;16;Torstai;0;4;4
94;31.07.2014;2014;07;17;Torstai;2;3;5
94;31.07.2014;2014;07;18;Torstai;0;2;2
94;31.07.2014;2014;07;19;Torstai;0;1;1
94;31.07.2014;2014;07;20;Torstai;0;2;2
94;31.07.2014;2014;07;21;Torstai;1;2;3
94;31.07.2014;2014;07;22;Torstai;0;5;5
94;31.07.2014;2014;07;23;Torstai;1;0;1
94;01.08.2014;2014;08;00;Perjantai;0;0;0
94;01.08.2014;2014;08;01;Perjantai;1;0;1
94;01.08.2014;2014;08;02;Perjantai;0;0;0
94;01.08.2014;2014;08;03;Perjantai;0;1;1
94;01.08.2014;2014;08;04;Perjantai;1;0;1
94;01.08.2014;2014;08;05;Perjantai;3;1;4
94;01.08.2014;2014;08;06;Perjantai;12;1;13
94;01.08.2014;2014;08;07;Perjantai;19;1;20
94;01.08.2014;2014;08;08;Perjantai;15;2;17
94;01.08.2014;2014;08;09;Perjantai;4;5;9
94;01.08.2014;2014;08;10;Perjantai;8;5;13
94;01.08.2014;2014;08;11;Perjantai;10;8;18
94;01.08.2014;2014;08;12;Perjantai;14;19;33
94;01.08.2014;2014;08;13;Perjantai;9;10;19
94;01.08.2014;2014;08;14;Perjantai;14;28;42
94;01.08.2014;2014;08;15;Perjantai;10;47;57
94;01.08.2014;2014;08;16;Perjantai;12;18;30
94;01.08.2014;2014;08;17;Perjantai;17;11;28
94;01.08.2014;2014;08;18;Perjantai;9;15;24
94;01.08.2014;2014;08;19;Perjantai;14;9;23
94;01.08.2014;2014;08;20;Perjantai;3;12;15
94;01.08.2014;2014;08;21;Perjantai;1;8;9
94;01.08.2014;2014;08;22;Perjantai;1;3;4
94;01.08.2014;2014;08;23;Perjantai;1;2;3
94;02.08.2014;2014;08;00;Lauantai;0;4;4
94;02.08.2014;2014;08;01;Lauantai;2;1;3
94;02.08.2014;2014;08;02;Lauantai;0;2;2
94;02.08.2014;2014;08;03;Lauantai;0;0;0
94;02.08.2014;2014;08;04;Lauantai;1;0;1
94;02.08.2014;2014;08;05;Lauantai;0;0;0
94;02.08.2014;2014;08;06;Lauantai;4;3;7
94;02.08.2014;2014;08;07;Lauantai;0;5;5
94;02.08.2014;2014;08;08;Lauantai;5;6;11
94;02.08.2014;2014;08;09;Lauantai;6;14;20
94;02.08.2014;2014;08;10;Lauantai;8;7;15
94;02.08.2014;2014;08;11;Lauantai;8;15;23
94;02.08.2014;2014;08;12;Lauantai;20;5;25
94;02.08.2014;2014;08;13;Lauantai;9;14;23
94;02.08.2014;2014;08;14;Lauantai;3;6;9
94;02.08.2014;2014;08;15;Lauantai;13;4;17
94;02.08.2014;2014;08;16;Lauantai;17;10;27
94;02.08.2014;2014;08;17;Lauantai;13;11;24
94;02.08.2014;2014;08;18;Lauantai;10;7;17
94;02.08.2014;2014;08;19;Lauantai;10;11;21
94;02.08.2014;2014;08;20;Lauantai;14;4;18
94;02.08.2014;2014;08;21;Lauantai;7;4;11
94;02.08.2014;2014;08;22;Lauantai;1;5;6
94;02.08.2014;2014;08;23;Lauantai;1;5;6
94;03.08.2014;2014;08;00;Sunnuntai;1;2;3
94;03.08.2014;2014;08;01;Sunnuntai;0;0;0
94;03.08.2014;2014;08;02;Sunnuntai;0;0;0
94;03.08.2014;2014;08;03;Sunnuntai;0;1;1
94;03.08.2014;2014;08;04;Sunnuntai;0;2;2
94;03.08.2014;2014;08;05;Sunnuntai;1;0;1
94;03.08.2014;2014;08;06;Sunnuntai;2;1;3
94;03.08.2014;2014;08;07;Sunnuntai;4;1;5
94;03.08.2014;2014;08;08;Sunnuntai;5;5;10
94;03.08.2014;2014;08;09;Sunnuntai;8;12;20
94;03.08.2014;2014;08;10;Sunnuntai;11;7;18
94;03.08.2014;2014;08;11;Sunnuntai;16;11;27
94;03.08.2014;2014;08;12;Sunnuntai;12;24;36
94;03.08.2014;2014;08;13;Sunnuntai;19;24;43
94;03.08.2014;2014;08;14;Sunnuntai;15;15;30
94;03.08.2014;2014;08;15;Sunnuntai;26;18;44
94;03.08.2014;2014;08;16;Sunnuntai;20;24;44
94;03.08.2014;2014;08;17;Sunnuntai;13;25;38
94;03.08.2014;2014;08;18;Sunnuntai;13;2;15
94;03.08.2014;2014;08;19;Sunnuntai;18;13;31
94;03.08.2014;2014;08;20;Sunnuntai;25;11;36
94;03.08.2014;2014;08;21;Sunnuntai;8;11;19
94;03.08.2014;2014;08;22;Sunnuntai;2;3;5
94;03.08.2014;2014;08;23;Sunnuntai;2;4;6
94;04.08.2014;2014;08;00;Maanantai;1;0;1
94;04.08.2014;2014;08;01;Maanantai;0;2;2
94;04.08.2014;2014;08;02;Maanantai;0;2;2
94;04.08.2014;2014;08;03;Maanantai;0;0;0
94;04.08.2014;2014;08;04;Maanantai;0;1;1
94;04.08.2014;2014;08;05;Maanantai;7;4;11
94;04.08.2014;2014;08;06;Maanantai;27;2;29
94;04.08.2014;2014;08;07;Maanantai;43;5;48
94;04.08.2014;2014;08;08;Maanantai;10;5;15
94;04.08.2014;2014;08;09;Maanantai;6;9;15
94;04.08.2014;2014;08;10;Maanantai;11;10;21
94;04.08.2014;2014;08;11;Maanantai;12;13;25
94;04.08.2014;2014;08;12;Maanantai;29;13;42
94;04.08.2014;2014;08;13;Maanantai;16;11;27
94;04.08.2014;2014;08;14;Maanantai;15;17;32
94;04.08.2014;2014;08;15;Maanantai;15;45;60
94;04.08.2014;2014;08;16;Maanantai;21;41;62
94;04.08.2014;2014;08;17;Maanantai;10;25;35
94;04.08.2014;2014;08;18;Maanantai;23;22;45
94;04.08.2014;2014;08;19;Maanantai;21;24;45
94;04.08.2014;2014;08;20;Maanantai;17;29;46
94;04.08.2014;2014;08;21;Maanantai;11;18;29
94;04.08.2014;2014;08;22;Maanantai;4;15;19
94;04.08.2014;2014;08;23;Maanantai;2;1;3
94;05.08.2014;2014;08;00;Tiistai;1;0;1
94;05.08.2014;2014;08;01;Tiistai;0;2;2
94;05.08.2014;2014;08;02;Tiistai;2;0;2
94;05.08.2014;2014;08;03;Tiistai;0;0;0
94;05.08.2014;2014;08;04;Tiistai;1;1;2
94;05.08.2014;2014;08;05;Tiistai;10;1;11
94;05.08.2014;2014;08;06;Tiistai;28;5;33
94;05.08.2014;2014;08;07;Tiistai;46;6;52
94;05.08.2014;2014;08;08;Tiistai;15;6;21
94;05.08.2014;2014;08;09;Tiistai;4;7;11
94;05.08.2014;2014;08;10;Tiistai;6;8;14
94;05.08.2014;2014;08;11;Tiistai;13;11;24
94;05.08.2014;2014;08;12;Tiistai;18;24;42
94;05.08.2014;2014;08;13;Tiistai;9;5;14
94;05.08.2014;2014;08;14;Tiistai;14;26;40
94;05.08.2014;2014;08;15;Tiistai;9;40;49
94;05.08.2014;2014;08;16;Tiistai;25;55;80
94;05.08.2014;2014;08;17;Tiistai;26;27;53
94;05.08.2014;2014;08;18;Tiistai;27;19;46
94;05.08.2014;2014;08;19;Tiistai;18;22;40
94;05.08.2014;2014;08;20;Tiistai;17;26;43
94;05.08.2014;2014;08;21;Tiistai;11;12;23
94;05.08.2014;2014;08;22;Tiistai;8;12;20
94;05.08.2014;2014;08;23;Tiistai;1;5;6
94;06.08.2014;2014;08;00;Keskiviikko;1;1;2
94;06.08.2014;2014;08;01;Keskiviikko;0;0;0
94;06.08.2014;2014;08;02;Keskiviikko;1;0;1
94;06.08.2014;2014;08;03;Keskiviikko;0;0;0
94;06.08.2014;2014;08;04;Keskiviikko;0;1;1
94;06.08.2014;2014;08;05;Keskiviikko;9;1;10
94;06.08.2014;2014;08;06;Keskiviikko;29;5;34
94;06.08.2014;2014;08;07;Keskiviikko;43;5;48
94;06.08.2014;2014;08;08;Keskiviikko;15;16;31
94;06.08.2014;2014;08;09;Keskiviikko;10;6;16
94;06.08.2014;2014;08;10;Keskiviikko;10;8;18
94;06.08.2014;2014;08;11;Keskiviikko;14;11;25
94;06.08.2014;2014;08;12;Keskiviikko;4;10;14
94;06.08.2014;2014;08;13;Keskiviikko;15;10;25
94;06.08.2014;2014;08;14;Keskiviikko;15;21;36
94;06.08.2014;2014;08;15;Keskiviikko;13;33;46
94;06.08.2014;2014;08;16;Keskiviikko;23;46;69
94;06.08.2014;2014;08;17;Keskiviikko;12;23;35
94;06.08.2014;2014;08;18;Keskiviikko;13;31;44
94;06.08.2014;2014;08;19;Keskiviikko;12;21;33
94;06.08.2014;2014;08;20;Keskiviikko;9;19;28
94;06.08.2014;2014;08;21;Keskiviikko;11;10;21
94;06.08.2014;2014;08;22;Keskiviikko;6;10;16
94;06.08.2014;2014;08;23;Keskiviikko;6;2;8
94;07.08.2014;2014;08;00;Torstai;0;0;0
94;07.08.2014;2014;08;01;Torstai;0;0;0
94;07.08.2014;2014;08;02;Torstai;2;0;2
94;07.08.2014;2014;08;03;Torstai;0;1;1
94;07.08.2014;2014;08;04;Torstai;1;0;1
94;07.08.2014;2014;08;05;Torstai;6;2;8
94;07.08.2014;2014;08;06;Torstai;22;4;26
94;07.08.2014;2014;08;07;Torstai;41;7;48
94;07.08.2014;2014;08;08;Torstai;14;9;23
94;07.08.2014;2014;08;09;Torstai;17;8;25
94;07.08.2014;2014;08;10;Torstai;6;9;15
94;07.08.2014;2014;08;11;Torstai;0;0;0
94;07.08.2014;2014;08;12;Torstai;4;9;13
94;07.08.2014;2014;08;13;Torstai;13;32;45
94;07.08.2014;2014;08;14;Torstai;8;33;41
94;07.08.2014;2014;08;15;Torstai;15;28;43
94;07.08.2014;2014;08;16;Torstai;17;48;65
94;07.08.2014;2014;08;17;Torstai;20;20;40
94;07.08.2014;2014;08;18;Torstai;24;17;41
94;07.08.2014;2014;08;19;Torstai;15;20;35
94;07.08.2014;2014;08;20;Torstai;10;16;26
94;07.08.2014;2014;08;21;Torstai;7;10;17
94;07.08.2014;2014;08;22;Torstai;2;4;6
94;07.08.2014;2014;08;23;Torstai;0;0;0
94;08.08.2014;2014;08;00;Perjantai;0;1;1
94;08.08.2014;2014;08;01;Perjantai;1;0;1
94;08.08.2014;2014;08;02;Perjantai;0;0;0
94;08.08.2014;2014;08;03;Perjantai;0;0;0
94;08.08.2014;2014;08;04;Perjantai;1;0;1
94;08.08.2014;2014;08;05;Perjantai;6;2;8
94;08.08.2014;2014;08;06;Perjantai;11;2;13
94;08.08.2014;2014;08;07;Perjantai;39;8;47
94;08.08.2014;2014;08;08;Perjantai;17;3;20
94;08.08.2014;2014;08;09;Perjantai;13;8;21
94;08.08.2014;2014;08;10;Perjantai;3;4;7
94;08.08.2014;2014;08;11;Perjantai;6;12;18
94;08.08.2014;2014;08;12;Perjantai;8;9;17
94;08.08.2014;2014;08;13;Perjantai;8;12;20
94;08.08.2014;2014;08;14;Perjantai;5;22;27
94;08.08.2014;2014;08;15;Perjantai;11;21;32
94;08.08.2014;2014;08;16;Perjantai;8;18;26
94;08.08.2014;2014;08;17;Perjantai;10;17;27
94;08.08.2014;2014;08;18;Perjantai;9;17;26
94;08.08.2014;2014;08;19;Perjantai;7;7;14
94;08.08.2014;2014;08;20;Perjantai;8;11;19
94;08.08.2014;2014;08;21;Perjantai;9;8;17
94;08.08.2014;2014;08;22;Perjantai;6;4;10
94;08.08.2014;2014;08;23;Perjantai;2;3;5
94;09.08.2014;2014;08;00;Lauantai;0;6;6
94;09.08.2014;2014;08;01;Lauantai;2;0;2
94;09.08.2014;2014;08;02;Lauantai;0;0;0
94;09.08.2014;2014;08;03;Lauantai;0;4;4
94;09.08.2014;2014;08;04;Lauantai;0;0;0
94;09.08.2014;2014;08;05;Lauantai;2;0;2
94;09.08.2014;2014;08;06;Lauantai;1;0;1
94;09.08.2014;2014;08;07;Lauantai;2;2;4
94;09.08.2014;2014;08;08;Lauantai;3;3;6
94;09.08.2014;2014;08;09;Lauantai;4;15;19
94;09.08.2014;2014;08;10;Lauantai;12;11;23
94;09.08.2014;2014;08;11;Lauantai;13;9;22
94;09.08.2014;2014;08;12;Lauantai;12;15;27
94;09.08.2014;2014;08;13;Lauantai;11;24;35
94;09.08.2014;2014;08;14;Lauantai;9;9;18
94;09.08.2014;2014;08;15;Lauantai;15;15;30
94;09.08.2014;2014;08;16;Lauantai;11;7;18
94;09.08.2014;2014;08;17;Lauantai;4;16;20
94;09.08.2014;2014;08;18;Lauantai;14;4;18
94;09.08.2014;2014;08;19;Lauantai;16;2;18
94;09.08.2014;2014;08;20;Lauantai;10;7;17
94;09.08.2014;2014;08;21;Lauantai;2;4;6
94;09.08.2014;2014;08;22;Lauantai;1;1;2
94;09.08.2014;2014;08;23;Lauantai;0;1;1
94;10.08.2014;2014;08;00;Sunnuntai;0;2;2
94;10.08.2014;2014;08;01;Sunnuntai;1;0;1
94;10.08.2014;2014;08;02;Sunnuntai;0;0;0
94;10.08.2014;2014;08;03;Sunnuntai;0;0;0
94;10.08.2014;2014;08;04;Sunnuntai;0;1;1
94;10.08.2014;2014;08;05;Sunnuntai;1;0;1
94;10.08.2014;2014;08;06;Sunnuntai;1;2;3
94;10.08.2014;2014;08;07;Sunnuntai;0;1;1
94;10.08.2014;2014;08;08;Sunnuntai;1;1;2
94;10.08.2014;2014;08;09;Sunnuntai;2;8;10
94;10.08.2014;2014;08;10;Sunnuntai;5;0;5
94;10.08.2014;2014;08;11;Sunnuntai;1;15;16
94;10.08.2014;2014;08;12;Sunnuntai;9;26;35
94;10.08.2014;2014;08;13;Sunnuntai;17;7;24
94;10.08.2014;2014;08;14;Sunnuntai;11;17;28
94;10.08.2014;2014;08;15;Sunnuntai;17;12;29
94;10.08.2014;2014;08;16;Sunnuntai;15;10;25
94;10.08.2014;2014;08;17;Sunnuntai;24;8;32
94;10.08.2014;2014;08;18;Sunnuntai;22;9;31
94;10.08.2014;2014;08;19;Sunnuntai;6;14;20
94;10.08.2014;2014;08;20;Sunnuntai;9;9;18
94;10.08.2014;2014;08;21;Sunnuntai;4;2;6
94;10.08.2014;2014;08;22;Sunnuntai;13;6;19
94;10.08.2014;2014;08;23;Sunnuntai;0;2;2
94;11.08.2014;2014;08;00;Maanantai;0;0;0
94;11.08.2014;2014;08;01;Maanantai;0;0;0
94;11.08.2014;2014;08;02;Maanantai;0;0;0
94;11.08.2014;2014;08;03;Maanantai;0;0;0
94;11.08.2014;2014;08;04;Maanantai;2;1;3
94;11.08.2014;2014;08;05;Maanantai;10;1;11
94;11.08.2014;2014;08;06;Maanantai;38;4;42
94;11.08.2014;2014;08;07;Maanantai;46;5;51
94;11.08.2014;2014;08;08;Maanantai;15;11;26
94;11.08.2014;2014;08;09;Maanantai;10;8;18
94;11.08.2014;2014;08;10;Maanantai;8;10;18
94;11.08.2014;2014;08;11;Maanantai;8;6;14
94;11.08.2014;2014;08;12;Maanantai;16;8;24
94;11.08.2014;2014;08;13;Maanantai;7;11;18
94;11.08.2014;2014;08;14;Maanantai;6;21;27
94;11.08.2014;2014;08;15;Maanantai;11;31;42
94;11.08.2014;2014;08;16;Maanantai;16;65;81
94;11.08.2014;2014;08;17;Maanantai;17;34;51
94;11.08.2014;2014;08;18;Maanantai;27;17;44
94;11.08.2014;2014;08;19;Maanantai;17;19;36
94;11.08.2014;2014;08;20;Maanantai;17;17;34
94;11.08.2014;2014;08;21;Maanantai;5;11;16
94;11.08.2014;2014;08;22;Maanantai;1;8;9
94;11.08.2014;2014;08;23;Maanantai;0;0;0
94;12.08.2014;2014;08;00;Tiistai;0;0;0
94;12.08.2014;2014;08;01;Tiistai;0;2;2
94;12.08.2014;2014;08;02;Tiistai;0;0;0
94;12.08.2014;2014;08;03;Tiistai;0;0;0
94;12.08.2014;2014;08;04;Tiistai;0;0;0
94;12.08.2014;2014;08;05;Tiistai;8;1;9
94;12.08.2014;2014;08;06;Tiistai;21;4;25
94;12.08.2014;2014;08;07;Tiistai;37;5;42
94;12.08.2014;2014;08;08;Tiistai;18;5;23
94;12.08.2014;2014;08;09;Tiistai;8;5;13
94;12.08.2014;2014;08;10;Tiistai;1;6;7
94;12.08.2014;2014;08;11;Tiistai;1;1;2
94;12.08.2014;2014;08;12;Tiistai;1;1;2
94;12.08.2014;2014;08;13;Tiistai;1;2;3
94;12.08.2014;2014;08;14;Tiistai;2;8;10
94;12.08.2014;2014;08;15;Tiistai;5;13;18
94;12.08.2014;2014;08;16;Tiistai;12;41;53
94;12.08.2014;2014;08;17;Tiistai;9;23;32
94;12.08.2014;2014;08;18;Tiistai;12;12;24
94;12.08.2014;2014;08;19;Tiistai;10;13;23
94;12.08.2014;2014;08;20;Tiistai;9;8;17
94;12.08.2014;2014;08;21;Tiistai;3;9;12
94;12.08.2014;2014;08;22;Tiistai;0;3;3
94;12.08.2014;2014;08;23;Tiistai;0;0;0
94;13.08.2014;2014;08;00;Keskiviikko;0;0;0
94;13.08.2014;2014;08;01;Keskiviikko;0;0;0
94;13.08.2014;2014;08;02;Keskiviikko;0;0;0
94;13.08.2014;2014;08;03;Keskiviikko;0;0;0
94;13.08.2014;2014;08;04;Keskiviikko;0;1;1
94;13.08.2014;2014;08;05;Keskiviikko;8;1;9
94;13.08.2014;2014;08;06;Keskiviikko;28;3;31
94;13.08.2014;2014;08;07;Keskiviikko;47;3;50
94;13.08.2014;2014;08;08;Keskiviikko;12;5;17
94;13.08.2014;2014;08;09;Keskiviikko;14;4;18
94;13.08.2014;2014;08;10;Keskiviikko;2;5;7
94;13.08.2014;2014;08;11;Keskiviikko;5;3;8
94;13.08.2014;2014;08;12;Keskiviikko;9;3;12
94;13.08.2014;2014;08;13;Keskiviikko;11;7;18
94;13.08.2014;2014;08;14;Keskiviikko;4;15;19
94;13.08.2014;2014;08;15;Keskiviikko;8;25;33
94;13.08.2014;2014;08;16;Keskiviikko;7;46;53
94;13.08.2014;2014;08;17;Keskiviikko;1;31;32
94;13.08.2014;2014;08;18;Keskiviikko;12;11;23
94;13.08.2014;2014;08;19;Keskiviikko;12;7;19
94;13.08.2014;2014;08;20;Keskiviikko;10;16;26
94;13.08.2014;2014;08;21;Keskiviikko;5;7;12
94;13.08.2014;2014;08;22;Keskiviikko;1;4;5
94;13.08.2014;2014;08;23;Keskiviikko;0;1;1
94;14.08.2014;2014;08;00;Torstai;0;0;0
94;14.08.2014;2014;08;01;Torstai;0;0;0
94;14.08.2014;2014;08;02;Torstai;0;0;0
94;14.08.2014;2014;08;03;Torstai;0;0;0
94;14.08.2014;2014;08;04;Torstai;0;1;1
94;14.08.2014;2014;08;05;Torstai;7;0;7
94;14.08.2014;2014;08;06;Torstai;25;7;32
94;14.08.2014;2014;08;07;Torstai;37;6;43
94;14.08.2014;2014;08;08;Torstai;13;5;18
94;14.08.2014;2014;08;09;Torstai;11;8;19
94;14.08.2014;2014;08;10;Torstai;11;7;18
94;14.08.2014;2014;08;11;Torstai;7;5;12
94;14.08.2014;2014;08;12;Torstai;8;6;14
94;14.08.2014;2014;08;13;Torstai;9;10;19
94;14.08.2014;2014;08;14;Torstai;5;12;17
94;14.08.2014;2014;08;15;Torstai;18;31;49
94;14.08.2014;2014;08;16;Torstai;6;41;47
94;14.08.2014;2014;08;17;Torstai;6;10;16
94;14.08.2014;2014;08;18;Torstai;9;9;18
94;14.08.2014;2014;08;19;Torstai;4;11;15
94;14.08.2014;2014;08;20;Torstai;6;16;22
94;14.08.2014;2014;08;21;Torstai;3;10;13
94;14.08.2014;2014;08;22;Torstai;2;2;4
94;14.08.2014;2014;08;23;Torstai;0;5;5
94;15.08.2014;2014;08;00;Perjantai;0;0;0
94;15.08.2014;2014;08;01;Perjantai;0;1;1
94;15.08.2014;2014;08;02;Perjantai;0;0;0
94;15.08.2014;2014;08;03;Perjantai;0;0;0
94;15.08.2014;2014;08;04;Perjantai;2;0;2
94;15.08.2014;2014;08;05;Perjantai;7;1;8
94;15.08.2014;2014;08;06;Perjantai;14;3;17
94;15.08.2014;2014;08;07;Perjantai;30;3;33
94;15.08.2014;2014;08;08;Perjantai;19;4;23
94;15.08.2014;2014;08;09;Perjantai;9;5;14
94;15.08.2014;2014;08;10;Perjantai;2;3;5
94;15.08.2014;2014;08;11;Perjantai;13;9;22
94;15.08.2014;2014;08;12;Perjantai;6;9;15
94;15.08.2014;2014;08;13;Perjantai;3;5;8
94;15.08.2014;2014;08;14;Perjantai;3;22;25
94;15.08.2014;2014;08;15;Perjantai;11;25;36
94;15.08.2014;2014;08;16;Perjantai;15;26;41
94;15.08.2014;2014;08;17;Perjantai;6;7;13
94;15.08.2014;2014;08;18;Perjantai;7;9;16
94;15.08.2014;2014;08;19;Perjantai;19;14;33
94;15.08.2014;2014;08;20;Perjantai;8;11;19
94;15.08.2014;2014;08;21;Perjantai;3;10;13
94;15.08.2014;2014;08;22;Perjantai;2;3;5
94;15.08.2014;2014;08;23;Perjantai;1;3;4
94;16.08.2014;2014;08;00;Lauantai;2;0;2
94;16.08.2014;2014;08;01;Lauantai;1;0;1
94;16.08.2014;2014;08;02;Lauantai;0;0;0
94;16.08.2014;2014;08;03;Lauantai;0;0;0
94;16.08.2014;2014;08;04;Lauantai;1;0;1
94;16.08.2014;2014;08;05;Lauantai;1;0;1
94;16.08.2014;2014;08;06;Lauantai;2;0;2
94;16.08.2014;2014;08;07;Lauantai;4;2;6
94;16.08.2014;2014;08;08;Lauantai;1;1;2
94;16.08.2014;2014;08;09;Lauantai;7;12;19
94;16.08.2014;2014;08;10;Lauantai;5;11;16
94;16.08.2014;2014;08;11;Lauantai;19;9;28
94;16.08.2014;2014;08;12;Lauantai;7;10;17
94;16.08.2014;2014;08;13;Lauantai;12;13;25
94;16.08.2014;2014;08;14;Lauantai;8;9;17
94;16.08.2014;2014;08;15;Lauantai;12;14;26
94;16.08.2014;2014;08;16;Lauantai;12;16;28
94;16.08.2014;2014;08;17;Lauantai;8;9;17
94;16.08.2014;2014;08;18;Lauantai;9;15;24
94;16.08.2014;2014;08;19;Lauantai;9;6;15
94;16.08.2014;2014;08;20;Lauantai;8;6;14
94;16.08.2014;2014;08;21;Lauantai;15;10;25
94;16.08.2014;2014;08;22;Lauantai;3;6;9
94;16.08.2014;2014;08;23;Lauantai;0;3;3
94;17.08.2014;2014;08;00;Sunnuntai;6;2;8
94;17.08.2014;2014;08;01;Sunnuntai;2;0;2
94;17.08.2014;2014;08;02;Sunnuntai;5;1;6
94;17.08.2014;2014;08;03;Sunnuntai;0;0;0
94;17.08.2014;2014;08;04;Sunnuntai;2;1;3
94;17.08.2014;2014;08;05;Sunnuntai;0;0;0
94;17.08.2014;2014;08;06;Sunnuntai;0;0;0
94;17.08.2014;2014;08;07;Sunnuntai;1;1;2
94;17.08.2014;2014;08;08;Sunnuntai;2;0;2
94;17.08.2014;2014;08;09;Sunnuntai;3;6;9
94;17.08.2014;2014;08;10;Sunnuntai;5;4;9
94;17.08.2014;2014;08;11;Sunnuntai;9;5;14
94;17.08.2014;2014;08;12;Sunnuntai;15;9;24
94;17.08.2014;2014;08;13;Sunnuntai;11;13;24
94;17.08.2014;2014;08;14;Sunnuntai;15;11;26
94;17.08.2014;2014;08;15;Sunnuntai;13;14;27
94;17.08.2014;2014;08;16;Sunnuntai;17;12;29
94;17.08.2014;2014;08;17;Sunnuntai;6;10;16
94;17.08.2014;2014;08;18;Sunnuntai;5;6;11
94;17.08.2014;2014;08;19;Sunnuntai;9;10;19
94;17.08.2014;2014;08;20;Sunnuntai;7;9;16
94;17.08.2014;2014;08;21;Sunnuntai;7;3;10
94;17.08.2014;2014;08;22;Sunnuntai;2;2;4
94;17.08.2014;2014;08;23;Sunnuntai;0;0;0
94;18.08.2014;2014;08;00;Maanantai;0;0;0
94;18.08.2014;2014;08;01;Maanantai;0;0;0
94;18.08.2014;2014;08;02;Maanantai;0;0;0
94;18.08.2014;2014;08;03;Maanantai;0;0;0
94;18.08.2014;2014;08;04;Maanantai;3;0;3
94;18.08.2014;2014;08;05;Maanantai;7;1;8
94;18.08.2014;2014;08;06;Maanantai;26;7;33
94;18.08.2014;2014;08;07;Maanantai;36;5;41
94;18.08.2014;2014;08;08;Maanantai;12;7;19
94;18.08.2014;2014;08;09;Maanantai;7;4;11
94;18.08.2014;2014;08;10;Maanantai;9;5;14
94;18.08.2014;2014;08;11;Maanantai;9;5;14
94;18.08.2014;2014;08;12;Maanantai;6;3;9
94;18.08.2014;2014;08;13;Maanantai;7;8;15
94;18.08.2014;2014;08;14;Maanantai;2;20;22
94;18.08.2014;2014;08;15;Maanantai;8;18;26
94;18.08.2014;2014;08;16;Maanantai;10;38;48
94;18.08.2014;2014;08;17;Maanantai;3;19;22
94;18.08.2014;2014;08;18;Maanantai;2;1;3
94;18.08.2014;2014;08;19;Maanantai;3;5;8
94;18.08.2014;2014;08;20;Maanantai;2;5;7
94;18.08.2014;2014;08;21;Maanantai;2;6;8
94;18.08.2014;2014;08;22;Maanantai;1;2;3
94;18.08.2014;2014;08;23;Maanantai;0;1;1
94;19.08.2014;2014;08;00;Tiistai;0;1;1
94;19.08.2014;2014;08;01;Tiistai;0;0;0
94;19.08.2014;2014;08;02;Tiistai;0;0;0
94;19.08.2014;2014;08;03;Tiistai;0;0;0
94;19.08.2014;2014;08;04;Tiistai;0;0;0
94;19.08.2014;2014;08;05;Tiistai;3;0;3
94;19.08.2014;2014;08;06;Tiistai;20;5;25
94;19.08.2014;2014;08;07;Tiistai;32;1;33
94;19.08.2014;2014;08;08;Tiistai;10;6;16
94;19.08.2014;2014;08;09;Tiistai;6;2;8
94;19.08.2014;2014;08;10;Tiistai;1;5;6
94;19.08.2014;2014;08;11;Tiistai;1;0;1
94;19.08.2014;2014;08;12;Tiistai;5;7;12
94;19.08.2014;2014;08;13;Tiistai;6;9;15
94;19.08.2014;2014;08;14;Tiistai;3;7;10
94;19.08.2014;2014;08;15;Tiistai;7;23;30
94;19.08.2014;2014;08;16;Tiistai;7;32;39
94;19.08.2014;2014;08;17;Tiistai;10;17;27
94;19.08.2014;2014;08;18;Tiistai;8;9;17
94;19.08.2014;2014;08;19;Tiistai;4;9;13
94;19.08.2014;2014;08;20;Tiistai;6;13;19
94;19.08.2014;2014;08;21;Tiistai;6;7;13
94;19.08.2014;2014;08;22;Tiistai;1;1;2
94;19.08.2014;2014;08;23;Tiistai;1;1;2
94;20.08.2014;2014;08;00;Keskiviikko;0;0;0
94;20.08.2014;2014;08;01;Keskiviikko;0;0;0
94;20.08.2014;2014;08;02;Keskiviikko;0;0;0
94;20.08.2014;2014;08;03;Keskiviikko;0;1;1
94;20.08.2014;2014;08;04;Keskiviikko;0;0;0
94;20.08.2014;2014;08;05;Keskiviikko;7;0;7
94;20.08.2014;2014;08;06;Keskiviikko;22;4;26
94;20.08.2014;2014;08;07;Keskiviikko;32;3;35
94;20.08.2014;2014;08;08;Keskiviikko;15;3;18
94;20.08.2014;2014;08;09;Keskiviikko;9;4;13
94;20.08.2014;2014;08;10;Keskiviikko;4;7;11
94;20.08.2014;2014;08;11;Keskiviikko;4;7;11
94;20.08.2014;2014;08;12;Keskiviikko;5;5;10
94;20.08.2014;2014;08;13;Keskiviikko;4;3;7
94;20.08.2014;2014;08;14;Keskiviikko;5;16;21
94;20.08.2014;2014;08;15;Keskiviikko;10;18;28
94;20.08.2014;2014;08;16;Keskiviikko;9;30;39
94;20.08.2014;2014;08;17;Keskiviikko;12;17;29
94;20.08.2014;2014;08;18;Keskiviikko;8;9;17
94;20.08.2014;2014;08;19;Keskiviikko;7;7;14
94;20.08.2014;2014;08;20;Keskiviikko;1;6;7
94;20.08.2014;2014;08;21;Keskiviikko;6;8;14
94;20.08.2014;2014;08;22;Keskiviikko;1;1;2
94;20.08.2014;2014;08;23;Keskiviikko;0;0;0
94;21.08.2014;2014;08;00;Torstai;0;1;1
94;21.08.2014;2014;08;01;Torstai;0;0;0
94;21.08.2014;2014;08;02;Torstai;0;0;0
94;21.08.2014;2014;08;03;Torstai;0;0;0
94;21.08.2014;2014;08;04;Torstai;0;0;0
94;21.08.2014;2014;08;05;Torstai;8;1;9
94;21.08.2014;2014;08;06;Torstai;19;2;21
94;21.08.2014;2014;08;07;Torstai;24;7;31
94;21.08.2014;2014;08;08;Torstai;7;9;16
94;21.08.2014;2014;08;09;Torstai;8;5;13
94;21.08.2014;2014;08;10;Torstai;9;1;10
94;21.08.2014;2014;08;11;Torstai;2;1;3
94;21.08.2014;2014;08;12;Torstai;3;4;7
94;21.08.2014;2014;08;13;Torstai;8;6;14
94;21.08.2014;2014;08;14;Torstai;4;10;14
94;21.08.2014;2014;08;15;Torstai;7;21;28
94;21.08.2014;2014;08;16;Torstai;5;33;38
94;21.08.2014;2014;08;17;Torstai;3;15;18
94;21.08.2014;2014;08;18;Torstai;5;8;13
94;21.08.2014;2014;08;19;Torstai;9;6;15
94;21.08.2014;2014;08;20;Torstai;8;9;17
94;21.08.2014;2014;08;21;Torstai;0;2;2
94;21.08.2014;2014;08;22;Torstai;1;3;4
94;21.08.2014;2014;08;23;Torstai;0;1;1
94;22.08.2014;2014;08;00;Perjantai;0;0;0
94;22.08.2014;2014;08;01;Perjantai;0;1;1
94;22.08.2014;2014;08;02;Perjantai;0;0;0
94;22.08.2014;2014;08;03;Perjantai;0;0;0
94;22.08.2014;2014;08;04;Perjantai;0;0;0
94;22.08.2014;2014;08;05;Perjantai;10;1;11
94;22.08.2014;2014;08;06;Perjantai;12;2;14
94;22.08.2014;2014;08;07;Perjantai;23;3;26
94;22.08.2014;2014;08;08;Perjantai;8;6;14
94;22.08.2014;2014;08;09;Perjantai;8;7;15
94;22.08.2014;2014;08;10;Perjantai;6;1;7
94;22.08.2014;2014;08;11;Perjantai;5;2;7
94;22.08.2014;2014;08;12;Perjantai;3;11;14
94;22.08.2014;2014;08;13;Perjantai;11;7;18
94;22.08.2014;2014;08;14;Perjantai;5;13;18
94;22.08.2014;2014;08;15;Perjantai;10;14;24
94;22.08.2014;2014;08;16;Perjantai;7;19;26
94;22.08.2014;2014;08;17;Perjantai;3;11;14
94;22.08.2014;2014;08;18;Perjantai;5;13;18
94;22.08.2014;2014;08;19;Perjantai;4;2;6
94;22.08.2014;2014;08;20;Perjantai;10;8;18
94;22.08.2014;2014;08;21;Perjantai;3;5;8
94;22.08.2014;2014;08;22;Perjantai;0;7;7
94;22.08.2014;2014;08;23;Perjantai;1;1;2
94;23.08.2014;2014;08;00;Lauantai;0;0;0
94;23.08.2014;2014;08;01;Lauantai;0;0;0
94;23.08.2014;2014;08;02;Lauantai;0;0;0
94;23.08.2014;2014;08;03;Lauantai;1;0;1
94;23.08.2014;2014;08;04;Lauantai;0;0;0
94;23.08.2014;2014;08;05;Lauantai;0;1;1
94;23.08.2014;2014;08;06;Lauantai;3;0;3
94;23.08.2014;2014;08;07;Lauantai;1;3;4
94;23.08.2014;2014;08;08;Lauantai;4;6;10
94;23.08.2014;2014;08;09;Lauantai;5;10;15
94;23.08.2014;2014;08;10;Lauantai;8;3;11
94;23.08.2014;2014;08;11;Lauantai;5;6;11
94;23.08.2014;2014;08;12;Lauantai;16;9;25
94;23.08.2014;2014;08;13;Lauantai;8;6;14
94;23.08.2014;2014;08;14;Lauantai;5;8;13
94;23.08.2014;2014;08;15;Lauantai;11;4;15
94;23.08.2014;2014;08;16;Lauantai;6;12;18
94;23.08.2014;2014;08;17;Lauantai;6;8;14
94;23.08.2014;2014;08;18;Lauantai;4;14;18
94;23.08.2014;2014;08;19;Lauantai;7;3;10
94;23.08.2014;2014;08;20;Lauantai;3;2;5
94;23.08.2014;2014;08;21;Lauantai;0;6;6
94;23.08.2014;2014;08;22;Lauantai;0;2;2
94;23.08.2014;2014;08;23;Lauantai;1;0;1
94;24.08.2014;2014;08;00;Sunnuntai;1;0;1
94;24.08.2014;2014;08;01;Sunnuntai;3;2;5
94;24.08.2014;2014;08;02;Sunnuntai;0;0;0
94;24.08.2014;2014;08;03;Sunnuntai;3;4;7
94;24.08.2014;2014;08;04;Sunnuntai;0;0;0
94;24.08.2014;2014;08;05;Sunnuntai;1;0;1
94;24.08.2014;2014;08;06;Sunnuntai;3;1;4
94;24.08.2014;2014;08;07;Sunnuntai;2;4;6
94;24.08.2014;2014;08;08;Sunnuntai;1;2;3
94;24.08.2014;2014;08;09;Sunnuntai;3;2;5
94;24.08.2014;2014;08;10;Sunnuntai;9;10;19
94;24.08.2014;2014;08;11;Sunnuntai;10;11;21
94;24.08.2014;2014;08;12;Sunnuntai;10;11;21
94;24.08.2014;2014;08;13;Sunnuntai;14;13;27
94;24.08.2014;2014;08;14;Sunnuntai;12;4;16
94;24.08.2014;2014;08;15;Sunnuntai;6;11;17
94;24.08.2014;2014;08;16;Sunnuntai;6;6;12
94;24.08.2014;2014;08;17;Sunnuntai;10;12;22
94;24.08.2014;2014;08;18;Sunnuntai;6;4;10
94;24.08.2014;2014;08;19;Sunnuntai;11;4;15
94;24.08.2014;2014;08;20;Sunnuntai;9;3;12
94;24.08.2014;2014;08;21;Sunnuntai;2;4;6
94;24.08.2014;2014;08;22;Sunnuntai;0;0;0
94;24.08.2014;2014;08;23;Sunnuntai;0;0;0
94;25.08.2014;2014;08;00;Maanantai;0;1;1
94;25.08.2014;2014;08;01;Maanantai;0;0;0
94;25.08.2014;2014;08;02;Maanantai;0;0;0
94;25.08.2014;2014;08;03;Maanantai;0;0;0
94;25.08.2014;2014;08;04;Maanantai;0;0;0
94;25.08.2014;2014;08;05;Maanantai;2;4;6
94;25.08.2014;2014;08;06;Maanantai;26;10;36
94;25.08.2014;2014;08;07;Maanantai;46;37;83
94;25.08.2014;2014;08;08;Maanantai;17;41;58
94;25.08.2014;2014;08;09;Maanantai;6;11;17
94;25.08.2014;2014;08;10;Maanantai;14;11;25
94;25.08.2014;2014;08;11;Maanantai;7;14;21
94;25.08.2014;2014;08;12;Maanantai;12;10;22
94;25.08.2014;2014;08;13;Maanantai;11;13;24
94;25.08.2014;2014;08;14;Maanantai;25;24;49
94;25.08.2014;2014;08;15;Maanantai;30;28;58
94;25.08.2014;2014;08;16;Maanantai;43;48;91
94;25.08.2014;2014;08;17;Maanantai;15;29;44
94;25.08.2014;2014;08;18;Maanantai;18;26;44
94;25.08.2014;2014;08;19;Maanantai;13;21;34
94;25.08.2014;2014;08;20;Maanantai;13;7;20
94;25.08.2014;2014;08;21;Maanantai;6;6;12
94;25.08.2014;2014;08;22;Maanantai;3;4;7
94;25.08.2014;2014;08;23;Maanantai;0;0;0
94;26.08.2014;2014;08;00;Tiistai;0;1;1
94;26.08.2014;2014;08;01;Tiistai;0;1;1
94;26.08.2014;2014;08;02;Tiistai;0;1;1
94;26.08.2014;2014;08;03;Tiistai;0;0;0
94;26.08.2014;2014;08;04;Tiistai;2;0;2
94;26.08.2014;2014;08;05;Tiistai;3;3;6
94;26.08.2014;2014;08;06;Tiistai;16;11;27
94;26.08.2014;2014;08;07;Tiistai;31;37;68
94;26.08.2014;2014;08;08;Tiistai;11;20;31
94;26.08.2014;2014;08;09;Tiistai;7;17;24
94;26.08.2014;2014;08;10;Tiistai;4;7;11
94;26.08.2014;2014;08;11;Tiistai;7;8;15
94;26.08.2014;2014;08;12;Tiistai;15;3;18
94;26.08.2014;2014;08;13;Tiistai;7;13;20
94;26.08.2014;2014;08;14;Tiistai;12;21;33
94;26.08.2014;2014;08;15;Tiistai;29;22;51
94;26.08.2014;2014;08;16;Tiistai;37;27;64
94;26.08.2014;2014;08;17;Tiistai;22;16;38
94;26.08.2014;2014;08;18;Tiistai;5;21;26
94;26.08.2014;2014;08;19;Tiistai;7;7;14
94;26.08.2014;2014;08;20;Tiistai;5;9;14
94;26.08.2014;2014;08;21;Tiistai;6;1;7
94;26.08.2014;2014;08;22;Tiistai;0;2;2
94;26.08.2014;2014;08;23;Tiistai;1;0;1
94;27.08.2014;2014;08;00;Keskiviikko;0;1;1
94;27.08.2014;2014;08;01;Keskiviikko;0;0;0
94;27.08.2014;2014;08;02;Keskiviikko;0;1;1
94;27.08.2014;2014;08;03;Keskiviikko;0;0;0
94;27.08.2014;2014;08;04;Keskiviikko;1;1;2
94;27.08.2014;2014;08;05;Keskiviikko;2;1;3
94;27.08.2014;2014;08;06;Keskiviikko;14;9;23
94;27.08.2014;2014;08;07;Keskiviikko;23;20;43
94;27.08.2014;2014;08;08;Keskiviikko;9;21;30
94;27.08.2014;2014;08;09;Keskiviikko;4;4;8
94;27.08.2014;2014;08;10;Keskiviikko;1;4;5
94;27.08.2014;2014;08;11;Keskiviikko;2;5;7
94;27.08.2014;2014;08;12;Keskiviikko;3;6;9
94;27.08.2014;2014;08;13;Keskiviikko;12;11;23
94;27.08.2014;2014;08;14;Keskiviikko;12;18;30
94;27.08.2014;2014;08;15;Keskiviikko;22;23;45
94;27.08.2014;2014;08;16;Keskiviikko;24;20;44
94;27.08.2014;2014;08;17;Keskiviikko;14;9;23
94;27.08.2014;2014;08;18;Keskiviikko;4;8;12
94;27.08.2014;2014;08;19;Keskiviikko;11;12;23
94;27.08.2014;2014;08;20;Keskiviikko;2;9;11
94;27.08.2014;2014;08;21;Keskiviikko;3;3;6
94;27.08.2014;2014;08;22;Keskiviikko;0;2;2
94;27.08.2014;2014;08;23;Keskiviikko;0;0;0
94;28.08.2014;2014;08;00;Torstai;0;0;0
94;28.08.2014;2014;08;01;Torstai;0;0;0
94;28.08.2014;2014;08;02;Torstai;0;0;0
94;28.08.2014;2014;08;03;Torstai;0;1;1
94;28.08.2014;2014;08;04;Torstai;3;1;4
94;28.08.2014;2014;08;05;Torstai;4;3;7
94;28.08.2014;2014;08;06;Torstai;15;15;30
94;28.08.2014;2014;08;07;Torstai;39;32;71
94;28.08.2014;2014;08;08;Torstai;9;31;40
94;28.08.2014;2014;08;09;Torstai;10;13;23
94;28.08.2014;2014;08;10;Torstai;7;7;14
94;28.08.2014;2014;08;11;Torstai;5;12;17
94;28.08.2014;2014;08;12;Torstai;3;7;10
94;28.08.2014;2014;08;13;Torstai;14;10;24
94;28.08.2014;2014;08;14;Torstai;14;17;31
94;28.08.2014;2014;08;15;Torstai;24;26;50
94;28.08.2014;2014;08;16;Torstai;30;31;61
94;28.08.2014;2014;08;17;Torstai;17;16;33
94;28.08.2014;2014;08;18;Torstai;13;14;27
94;28.08.2014;2014;08;19;Torstai;15;13;28
94;28.08.2014;2014;08;20;Torstai;5;13;18
94;28.08.2014;2014;08;21;Torstai;5;6;11
94;28.08.2014;2014;08;22;Torstai;1;0;1
94;28.08.2014;2014;08;23;Torstai;0;1;1
94;29.08.2014;2014;08;00;Perjantai;0;0;0
94;29.08.2014;2014;08;01;Perjantai;0;0;0
94;29.08.2014;2014;08;02;Perjantai;0;0;0
94;29.08.2014;2014;08;03;Perjantai;0;0;0
94;29.08.2014;2014;08;04;Perjantai;0;0;0
94;29.08.2014;2014;08;05;Perjantai;6;4;10
94;29.08.2014;2014;08;06;Perjantai;21;14;35
94;29.08.2014;2014;08;07;Perjantai;27;41;68
94;29.08.2014;2014;08;08;Perjantai;9;27;36
94;29.08.2014;2014;08;09;Perjantai;12;11;23
94;29.08.2014;2014;08;10;Perjantai;9;5;14
94;29.08.2014;2014;08;11;Perjantai;7;7;14
94;29.08.2014;2014;08;12;Perjantai;10;14;24
94;29.08.2014;2014;08;13;Perjantai;17;13;30
94;29.08.2014;2014;08;14;Perjantai;22;24;46
94;29.08.2014;2014;08;15;Perjantai;32;31;63
94;29.08.2014;2014;08;16;Perjantai;33;32;65
94;29.08.2014;2014;08;17;Perjantai;18;17;35
94;29.08.2014;2014;08;18;Perjantai;12;21;33
94;29.08.2014;2014;08;19;Perjantai;17;11;28
94;29.08.2014;2014;08;20;Perjantai;8;16;24
94;29.08.2014;2014;08;21;Perjantai;28;7;35
94;29.08.2014;2014;08;22;Perjantai;6;5;11
94;29.08.2014;2014;08;23;Perjantai;1;1;2
94;30.08.2014;2014;08;00;Lauantai;1;4;5
94;30.08.2014;2014;08;01;Lauantai;0;0;0
94;30.08.2014;2014;08;02;Lauantai;1;1;2
94;30.08.2014;2014;08;03;Lauantai;0;1;1
94;30.08.2014;2014;08;04;Lauantai;0;0;0
94;30.08.2014;2014;08;05;Lauantai;0;2;2
94;30.08.2014;2014;08;06;Lauantai;2;4;6
94;30.08.2014;2014;08;07;Lauantai;3;2;5
94;30.08.2014;2014;08;08;Lauantai;2;13;15
94;30.08.2014;2014;08;09;Lauantai;5;12;17
94;30.08.2014;2014;08;10;Lauantai;8;4;12
94;30.08.2014;2014;08;11;Lauantai;6;12;18
94;30.08.2014;2014;08;12;Lauantai;14;26;40
94;30.08.2014;2014;08;13;Lauantai;5;14;19
94;30.08.2014;2014;08;14;Lauantai;14;11;25
94;30.08.2014;2014;08;15;Lauantai;18;17;35
94;30.08.2014;2014;08;16;Lauantai;20;13;33
94;30.08.2014;2014;08;17;Lauantai;24;18;42
94;30.08.2014;2014;08;18;Lauantai;16;11;27
94;30.08.2014;2014;08;19;Lauantai;13;22;35
94;30.08.2014;2014;08;20;Lauantai;5;14;19
94;30.08.2014;2014;08;21;Lauantai;7;8;15
94;30.08.2014;2014;08;22;Lauantai;2;2;4
94;30.08.2014;2014;08;23;Lauantai;1;0;1
94;31.08.2014;2014;08;00;Sunnuntai;0;3;3
94;31.08.2014;2014;08;01;Sunnuntai;0;1;1
94;31.08.2014;2014;08;02;Sunnuntai;0;0;0
94;31.08.2014;2014;08;03;Sunnuntai;0;0;0
94;31.08.2014;2014;08;04;Sunnuntai;0;0;0
94;31.08.2014;2014;08;05;Sunnuntai;0;0;0
94;31.08.2014;2014;08;06;Sunnuntai;1;1;2
94;31.08.2014;2014;08;07;Sunnuntai;3;4;7
94;31.08.2014;2014;08;08;Sunnuntai;5;4;9
94;31.08.2014;2014;08;09;Sunnuntai;9;4;13
94;31.08.2014;2014;08;10;Sunnuntai;6;12;18
94;31.08.2014;2014;08;11;Sunnuntai;24;21;45
94;31.08.2014;2014;08;12;Sunnuntai;42;26;68
94;31.08.2014;2014;08;13;Sunnuntai;23;17;40
94;31.08.2014;2014;08;14;Sunnuntai;19;28;47
94;31.08.2014;2014;08;15;Sunnuntai;18;21;39
94;31.08.2014;2014;08;16;Sunnuntai;16;17;33
94;31.08.2014;2014;08;17;Sunnuntai;21;16;37
94;31.08.2014;2014;08;18;Sunnuntai;25;20;45
94;31.08.2014;2014;08;19;Sunnuntai;18;20;38
94;31.08.2014;2014;08;20;Sunnuntai;13;18;31
94;31.08.2014;2014;08;21;Sunnuntai;5;7;12
94;31.08.2014;2014;08;22;Sunnuntai;1;1;2
94;31.08.2014;2014;08;23;Sunnuntai;0;0;0
94;01.09.2014;2014;09;00;Maanantai;0;0;0
94;01.09.2014;2014;09;01;Maanantai;0;0;0
94;01.09.2014;2014;09;02;Maanantai;0;0;0
94;01.09.2014;2014;09;03;Maanantai;0;2;2
94;01.09.2014;2014;09;04;Maanantai;0;0;0
94;01.09.2014;2014;09;05;Maanantai;2;4;6
94;01.09.2014;2014;09;06;Maanantai;25;10;35
94;01.09.2014;2014;09;07;Maanantai;40;35;75
94;01.09.2014;2014;09;08;Maanantai;21;34;55
94;01.09.2014;2014;09;09;Maanantai;16;34;50
94;01.09.2014;2014;09;10;Maanantai;13;11;24
94;01.09.2014;2014;09;11;Maanantai;9;5;14
94;01.09.2014;2014;09;12;Maanantai;9;14;23
94;01.09.2014;2014;09;13;Maanantai;16;18;34
94;01.09.2014;2014;09;14;Maanantai;21;16;37
94;01.09.2014;2014;09;15;Maanantai;37;32;69
94;01.09.2014;2014;09;16;Maanantai;40;38;78
94;01.09.2014;2014;09;17;Maanantai;32;31;63
94;01.09.2014;2014;09;18;Maanantai;16;28;44
94;01.09.2014;2014;09;19;Maanantai;18;17;35
94;01.09.2014;2014;09;20;Maanantai;7;19;26
94;01.09.2014;2014;09;21;Maanantai;6;9;15
94;01.09.2014;2014;09;22;Maanantai;3;3;6
94;01.09.2014;2014;09;23;Maanantai;0;1;1
94;02.09.2014;2014;09;00;Tiistai;1;0;1
94;02.09.2014;2014;09;01;Tiistai;0;0;0
94;02.09.2014;2014;09;02;Tiistai;0;0;0
94;02.09.2014;2014;09;03;Tiistai;0;0;0
94;02.09.2014;2014;09;04;Tiistai;2;0;2
94;02.09.2014;2014;09;05;Tiistai;3;1;4
94;02.09.2014;2014;09;06;Tiistai;19;12;31
94;02.09.2014;2014;09;07;Tiistai;41;38;79
94;02.09.2014;2014;09;08;Tiistai;12;25;37
94;02.09.2014;2014;09;09;Tiistai;12;14;26
94;02.09.2014;2014;09;10;Tiistai;11;8;19
94;02.09.2014;2014;09;11;Tiistai;10;8;18
94;02.09.2014;2014;09;12;Tiistai;11;7;18
94;02.09.2014;2014;09;13;Tiistai;65;16;81
94;02.09.2014;2014;09;14;Tiistai;14;18;32
94;02.09.2014;2014;09;15;Tiistai;34;35;69
94;02.09.2014;2014;09;16;Tiistai;49;56;105
94;02.09.2014;2014;09;17;Tiistai;26;21;47
94;02.09.2014;2014;09;18;Tiistai;24;27;51
94;02.09.2014;2014;09;19;Tiistai;12;20;32
94;02.09.2014;2014;09;20;Tiistai;14;5;19
94;02.09.2014;2014;09;21;Tiistai;3;10;13
94;02.09.2014;2014;09;22;Tiistai;2;0;2
94;02.09.2014;2014;09;23;Tiistai;1;1;2
94;03.09.2014;2014;09;00;Keskiviikko;1;1;2
94;03.09.2014;2014;09;01;Keskiviikko;0;0;0
94;03.09.2014;2014;09;02;Keskiviikko;0;2;2
94;03.09.2014;2014;09;03;Keskiviikko;0;0;0
94;03.09.2014;2014;09;04;Keskiviikko;0;0;0
94;03.09.2014;2014;09;05;Keskiviikko;4;5;9
94;03.09.2014;2014;09;06;Keskiviikko;28;9;37
94;03.09.2014;2014;09;07;Keskiviikko;35;36;71
94;03.09.2014;2014;09;08;Keskiviikko;17;51;68
94;03.09.2014;2014;09;09;Keskiviikko;14;14;28
94;03.09.2014;2014;09;10;Keskiviikko;29;8;37
94;03.09.2014;2014;09;11;Keskiviikko;7;11;18
94;03.09.2014;2014;09;12;Keskiviikko;9;19;28
94;03.09.2014;2014;09;13;Keskiviikko;10;12;22
94;03.09.2014;2014;09;14;Keskiviikko;16;19;35
94;03.09.2014;2014;09;15;Keskiviikko;27;26;53
94;03.09.2014;2014;09;16;Keskiviikko;52;44;96
94;03.09.2014;2014;09;17;Keskiviikko;19;28;47
94;03.09.2014;2014;09;18;Keskiviikko;11;19;30
94;03.09.2014;2014;09;19;Keskiviikko;17;13;30
94;03.09.2014;2014;09;20;Keskiviikko;8;14;22
94;03.09.2014;2014;09;21;Keskiviikko;6;5;11
94;03.09.2014;2014;09;22;Keskiviikko;0;3;3
94;03.09.2014;2014;09;23;Keskiviikko;1;1;2
94;04.09.2014;2014;09;00;Torstai;1;0;1
94;04.09.2014;2014;09;01;Torstai;0;0;0
94;04.09.2014;2014;09;02;Torstai;1;1;2
94;04.09.2014;2014;09;03;Torstai;0;0;0
94;04.09.2014;2014;09;04;Torstai;0;1;1
94;04.09.2014;2014;09;05;Torstai;3;3;6
94;04.09.2014;2014;09;06;Torstai;22;11;33
94;04.09.2014;2014;09;07;Torstai;37;37;74
94;04.09.2014;2014;09;08;Torstai;12;23;35
94;04.09.2014;2014;09;09;Torstai;10;11;21
94;04.09.2014;2014;09;10;Torstai;6;10;16
94;04.09.2014;2014;09;11;Torstai;5;12;17
94;04.09.2014;2014;09;12;Torstai;13;9;22
94;04.09.2014;2014;09;13;Torstai;6;16;22
94;04.09.2014;2014;09;14;Torstai;17;15;32
94;04.09.2014;2014;09;15;Torstai;29;29;58
94;04.09.2014;2014;09;16;Torstai;37;40;77
94;04.09.2014;2014;09;17;Torstai;19;25;44
94;04.09.2014;2014;09;18;Torstai;17;20;37
94;04.09.2014;2014;09;19;Torstai;14;10;24
94;04.09.2014;2014;09;20;Torstai;15;10;25
94;04.09.2014;2014;09;21;Torstai;5;7;12
94;04.09.2014;2014;09;22;Torstai;4;5;9
94;04.09.2014;2014;09;23;Torstai;1;2;3
94;05.09.2014;2014;09;00;Perjantai;0;2;2
94;05.09.2014;2014;09;01;Perjantai;1;0;1
94;05.09.2014;2014;09;02;Perjantai;0;0;0
94;05.09.2014;2014;09;03;Perjantai;0;0;0
94;05.09.2014;2014;09;04;Perjantai;2;0;2
94;05.09.2014;2014;09;05;Perjantai;2;2;4
94;05.09.2014;2014;09;06;Perjantai;18;12;30
94;05.09.2014;2014;09;07;Perjantai;21;31;52
94;05.09.2014;2014;09;08;Perjantai;12;18;30
94;05.09.2014;2014;09;09;Perjantai;8;8;16
94;05.09.2014;2014;09;10;Perjantai;6;5;11
94;05.09.2014;2014;09;11;Perjantai;37;14;51
94;05.09.2014;2014;09;12;Perjantai;14;12;26
94;05.09.2014;2014;09;13;Perjantai;13;15;28
94;05.09.2014;2014;09;14;Perjantai;22;30;52
94;05.09.2014;2014;09;15;Perjantai;25;25;50
94;05.09.2014;2014;09;16;Perjantai;29;26;55
94;05.09.2014;2014;09;17;Perjantai;28;24;52
94;05.09.2014;2014;09;18;Perjantai;19;18;37
94;05.09.2014;2014;09;19;Perjantai;13;18;31
94;05.09.2014;2014;09;20;Perjantai;14;18;32
94;05.09.2014;2014;09;21;Perjantai;5;10;15
94;05.09.2014;2014;09;22;Perjantai;0;3;3
94;05.09.2014;2014;09;23;Perjantai;4;4;8
94;06.09.2014;2014;09;00;Lauantai;0;3;3
94;06.09.2014;2014;09;01;Lauantai;0;0;0
94;06.09.2014;2014;09;02;Lauantai;0;1;1
94;06.09.2014;2014;09;03;Lauantai;2;0;2
94;06.09.2014;2014;09;04;Lauantai;1;1;2
94;06.09.2014;2014;09;05;Lauantai;0;1;1
94;06.09.2014;2014;09;06;Lauantai;4;0;4
94;06.09.2014;2014;09;07;Lauantai;2;1;3
94;06.09.2014;2014;09;08;Lauantai;2;4;6
94;06.09.2014;2014;09;09;Lauantai;12;8;20
94;06.09.2014;2014;09;10;Lauantai;6;10;16
94;06.09.2014;2014;09;11;Lauantai;14;13;27
94;06.09.2014;2014;09;12;Lauantai;21;8;29
94;06.09.2014;2014;09;13;Lauantai;11;14;25
94;06.09.2014;2014;09;14;Lauantai;19;16;35
94;06.09.2014;2014;09;15;Lauantai;21;21;42
94;06.09.2014;2014;09;16;Lauantai;15;13;28
94;06.09.2014;2014;09;17;Lauantai;21;14;35
94;06.09.2014;2014;09;18;Lauantai;11;27;38
94;06.09.2014;2014;09;19;Lauantai;13;15;28
94;06.09.2014;2014;09;20;Lauantai;8;7;15
94;06.09.2014;2014;09;21;Lauantai;6;16;22
94;06.09.2014;2014;09;22;Lauantai;2;4;6
94;06.09.2014;2014;09;23;Lauantai;3;2;5
94;07.09.2014;2014;09;00;Sunnuntai;2;2;4
94;07.09.2014;2014;09;01;Sunnuntai;1;0;1
94;07.09.2014;2014;09;02;Sunnuntai;0;1;1
94;07.09.2014;2014;09;03;Sunnuntai;0;4;4
94;07.09.2014;2014;09;04;Sunnuntai;0;0;0
94;07.09.2014;2014;09;05;Sunnuntai;3;0;3
94;07.09.2014;2014;09;06;Sunnuntai;3;0;3
94;07.09.2014;2014;09;07;Sunnuntai;4;6;10
94;07.09.2014;2014;09;08;Sunnuntai;4;4;8
94;07.09.2014;2014;09;09;Sunnuntai;7;8;15
94;07.09.2014;2014;09;10;Sunnuntai;19;24;43
94;07.09.2014;2014;09;11;Sunnuntai;21;17;38
94;07.09.2014;2014;09;12;Sunnuntai;26;14;40
94;07.09.2014;2014;09;13;Sunnuntai;24;29;53
94;07.09.2014;2014;09;14;Sunnuntai;18;18;36
94;07.09.2014;2014;09;15;Sunnuntai;10;19;29
94;07.09.2014;2014;09;16;Sunnuntai;32;26;58
94;07.09.2014;2014;09;17;Sunnuntai;17;15;32
94;07.09.2014;2014;09;18;Sunnuntai;26;25;51
94;07.09.2014;2014;09;19;Sunnuntai;14;18;32
94;07.09.2014;2014;09;20;Sunnuntai;9;14;23
94;07.09.2014;2014;09;21;Sunnuntai;3;2;5
94;07.09.2014;2014;09;22;Sunnuntai;1;1;2
94;07.09.2014;2014;09;23;Sunnuntai;1;0;1
94;08.09.2014;2014;09;00;Maanantai;0;0;0
94;08.09.2014;2014;09;01;Maanantai;0;0;0
94;08.09.2014;2014;09;02;Maanantai;0;0;0
94;08.09.2014;2014;09;03;Maanantai;0;0;0
94;08.09.2014;2014;09;04;Maanantai;0;1;1
94;08.09.2014;2014;09;05;Maanantai;3;4;7
94;08.09.2014;2014;09;06;Maanantai;25;10;35
94;08.09.2014;2014;09;07;Maanantai;36;38;74
94;08.09.2014;2014;09;08;Maanantai;15;20;35
94;08.09.2014;2014;09;09;Maanantai;12;14;26
94;08.09.2014;2014;09;10;Maanantai;11;6;17
94;08.09.2014;2014;09;11;Maanantai;10;6;16
94;08.09.2014;2014;09;12;Maanantai;12;8;20
94;08.09.2014;2014;09;13;Maanantai;7;18;25
94;08.09.2014;2014;09;14;Maanantai;16;20;36
94;08.09.2014;2014;09;15;Maanantai;34;20;54
94;08.09.2014;2014;09;16;Maanantai;43;51;94
94;08.09.2014;2014;09;17;Maanantai;15;31;46
94;08.09.2014;2014;09;18;Maanantai;14;22;36
94;08.09.2014;2014;09;19;Maanantai;16;14;30
94;08.09.2014;2014;09;20;Maanantai;7;11;18
94;08.09.2014;2014;09;21;Maanantai;4;4;8
94;08.09.2014;2014;09;22;Maanantai;3;3;6
94;08.09.2014;2014;09;23;Maanantai;0;0;0
94;09.09.2014;2014;09;00;Tiistai;0;0;0
94;09.09.2014;2014;09;01;Tiistai;0;0;0
94;09.09.2014;2014;09;02;Tiistai;0;1;1
94;09.09.2014;2014;09;03;Tiistai;0;0;0
94;09.09.2014;2014;09;04;Tiistai;1;1;2
94;09.09.2014;2014;09;05;Tiistai;5;2;7
94;09.09.2014;2014;09;06;Tiistai;22;14;36
94;09.09.2014;2014;09;07;Tiistai;35;38;73
94;09.09.2014;2014;09;08;Tiistai;21;30;51
94;09.09.2014;2014;09;09;Tiistai;11;9;20
94;09.09.2014;2014;09;10;Tiistai;11;9;20
94;09.09.2014;2014;09;11;Tiistai;8;10;18
94;09.09.2014;2014;09;12;Tiistai;13;9;22
94;09.09.2014;2014;09;13;Tiistai;10;5;15
94;09.09.2014;2014;09;14;Tiistai;15;10;25
94;09.09.2014;2014;09;15;Tiistai;36;39;75
94;09.09.2014;2014;09;16;Tiistai;29;38;67
94;09.09.2014;2014;09;17;Tiistai;27;33;60
94;09.09.2014;2014;09;18;Tiistai;11;22;33
94;09.09.2014;2014;09;19;Tiistai;21;16;37
94;09.09.2014;2014;09;20;Tiistai;14;15;29
94;09.09.2014;2014;09;21;Tiistai;3;9;12
94;09.09.2014;2014;09;22;Tiistai;1;2;3
94;09.09.2014;2014;09;23;Tiistai;2;1;3
94;10.09.2014;2014;09;00;Keskiviikko;0;0;0
94;10.09.2014;2014;09;01;Keskiviikko;0;0;0
94;10.09.2014;2014;09;02;Keskiviikko;2;0;2
94;10.09.2014;2014;09;03;Keskiviikko;0;0;0
94;10.09.2014;2014;09;04;Keskiviikko;2;1;3
94;10.09.2014;2014;09;05;Keskiviikko;1;5;6
94;10.09.2014;2014;09;06;Keskiviikko;23;12;35
94;10.09.2014;2014;09;07;Keskiviikko;40;35;75
94;10.09.2014;2014;09;08;Keskiviikko;13;18;31
94;10.09.2014;2014;09;09;Keskiviikko;11;9;20
94;10.09.2014;2014;09;10;Keskiviikko;9;9;18
94;10.09.2014;2014;09;11;Keskiviikko;9;9;18
94;10.09.2014;2014;09;12;Keskiviikko;8;10;18
94;10.09.2014;2014;09;13;Keskiviikko;13;19;32
94;10.09.2014;2014;09;14;Keskiviikko;18;25;43
94;10.09.2014;2014;09;15;Keskiviikko;38;34;72
94;10.09.2014;2014;09;16;Keskiviikko;44;45;89
94;10.09.2014;2014;09;17;Keskiviikko;18;25;43
94;10.09.2014;2014;09;18;Keskiviikko;19;22;41
94;10.09.2014;2014;09;19;Keskiviikko;11;21;32
94;10.09.2014;2014;09;20;Keskiviikko;10;18;28
94;10.09.2014;2014;09;21;Keskiviikko;8;7;15
94;10.09.2014;2014;09;22;Keskiviikko;1;4;5
94;10.09.2014;2014;09;23;Keskiviikko;1;1;2
94;11.09.2014;2014;09;00;Torstai;1;0;1
94;11.09.2014;2014;09;01;Torstai;0;1;1
94;11.09.2014;2014;09;02;Torstai;0;0;0
94;11.09.2014;2014;09;03;Torstai;0;0;0
94;11.09.2014;2014;09;04;Torstai;1;0;1
94;11.09.2014;2014;09;05;Torstai;2;4;6
94;11.09.2014;2014;09;06;Torstai;17;13;30
94;11.09.2014;2014;09;07;Torstai;47;34;81
94;11.09.2014;2014;09;08;Torstai;9;27;36
94;11.09.2014;2014;09;09;Torstai;8;9;17
94;11.09.2014;2014;09;10;Torstai;10;11;21
94;11.09.2014;2014;09;11;Torstai;8;9;17
94;11.09.2014;2014;09;12;Torstai;10;11;21
94;11.09.2014;2014;09;13;Torstai;9;12;21
94;11.09.2014;2014;09;14;Torstai;13;32;45
94;11.09.2014;2014;09;15;Torstai;32;22;54
94;11.09.2014;2014;09;16;Torstai;32;37;69
94;11.09.2014;2014;09;17;Torstai;12;13;25
94;11.09.2014;2014;09;18;Torstai;19;15;34
94;11.09.2014;2014;09;19;Torstai;15;5;20
94;11.09.2014;2014;09;20;Torstai;6;9;15
94;11.09.2014;2014;09;21;Torstai;0;6;6
94;11.09.2014;2014;09;22;Torstai;5;3;8
94;11.09.2014;2014;09;23;Torstai;0;0;0
94;12.09.2014;2014;09;00;Perjantai;0;2;2
94;12.09.2014;2014;09;01;Perjantai;0;0;0
94;12.09.2014;2014;09;02;Perjantai;0;0;0
94;12.09.2014;2014;09;03;Perjantai;0;0;0
94;12.09.2014;2014;09;04;Perjantai;1;1;2
94;12.09.2014;2014;09;05;Perjantai;3;3;6
94;12.09.2014;2014;09;06;Perjantai;18;7;25
94;12.09.2014;2014;09;07;Perjantai;30;32;62
94;12.09.2014;2014;09;08;Perjantai;9;25;34
94;12.09.2014;2014;09;09;Perjantai;7;8;15
94;12.09.2014;2014;09;10;Perjantai;8;1;9
94;12.09.2014;2014;09;11;Perjantai;1;6;7
94;12.09.2014;2014;09;12;Perjantai;13;8;21
94;12.09.2014;2014;09;13;Perjantai;9;14;23
94;12.09.2014;2014;09;14;Perjantai;21;26;47
94;12.09.2014;2014;09;15;Perjantai;32;25;57
94;12.09.2014;2014;09;16;Perjantai;36;26;62
94;12.09.2014;2014;09;17;Perjantai;16;19;35
94;12.09.2014;2014;09;18;Perjantai;14;15;29
94;12.09.2014;2014;09;19;Perjantai;13;13;26
94;12.09.2014;2014;09;20;Perjantai;8;20;28
94;12.09.2014;2014;09;21;Perjantai;6;10;16
94;12.09.2014;2014;09;22;Perjantai;5;5;10
94;12.09.2014;2014;09;23;Perjantai;2;2;4
94;13.09.2014;2014;09;00;Lauantai;0;0;0
94;13.09.2014;2014;09;01;Lauantai;1;2;3
94;13.09.2014;2014;09;02;Lauantai;0;0;0
94;13.09.2014;2014;09;03;Lauantai;2;0;2
94;13.09.2014;2014;09;04;Lauantai;0;0;0
94;13.09.2014;2014;09;05;Lauantai;2;1;3
94;13.09.2014;2014;09;06;Lauantai;1;0;1
94;13.09.2014;2014;09;07;Lauantai;2;4;6
94;13.09.2014;2014;09;08;Lauantai;5;12;17
94;13.09.2014;2014;09;09;Lauantai;9;7;16
94;13.09.2014;2014;09;10;Lauantai;11;17;28
94;13.09.2014;2014;09;11;Lauantai;11;16;27
94;13.09.2014;2014;09;12;Lauantai;27;20;47
94;13.09.2014;2014;09;13;Lauantai;36;22;58
94;13.09.2014;2014;09;14;Lauantai;14;16;30
94;13.09.2014;2014;09;15;Lauantai;17;24;41
94;13.09.2014;2014;09;16;Lauantai;16;13;29
94;13.09.2014;2014;09;17;Lauantai;12;13;25
94;13.09.2014;2014;09;18;Lauantai;15;16;31
94;13.09.2014;2014;09;19;Lauantai;14;8;22
94;13.09.2014;2014;09;20;Lauantai;10;17;27
94;13.09.2014;2014;09;21;Lauantai;3;10;13
94;13.09.2014;2014;09;22;Lauantai;3;5;8
94;13.09.2014;2014;09;23;Lauantai;1;1;2
94;14.09.2014;2014;09;00;Sunnuntai;3;2;5
94;14.09.2014;2014;09;01;Sunnuntai;0;0;0
94;14.09.2014;2014;09;02;Sunnuntai;2;1;3
94;14.09.2014;2014;09;03;Sunnuntai;0;0;0
94;14.09.2014;2014;09;04;Sunnuntai;0;1;1
94;14.09.2014;2014;09;05;Sunnuntai;0;0;0
94;14.09.2014;2014;09;06;Sunnuntai;1;2;3
94;14.09.2014;2014;09;07;Sunnuntai;1;5;6
94;14.09.2014;2014;09;08;Sunnuntai;5;8;13
94;14.09.2014;2014;09;09;Sunnuntai;9;12;21
94;14.09.2014;2014;09;10;Sunnuntai;19;5;24
94;14.09.2014;2014;09;11;Sunnuntai;20;15;35
94;14.09.2014;2014;09;12;Sunnuntai;13;27;40
94;14.09.2014;2014;09;13;Sunnuntai;18;24;42
94;14.09.2014;2014;09;14;Sunnuntai;24;13;37
94;14.09.2014;2014;09;15;Sunnuntai;17;25;42
94;14.09.2014;2014;09;16;Sunnuntai;23;9;32
94;14.09.2014;2014;09;17;Sunnuntai;11;4;15
94;14.09.2014;2014;09;18;Sunnuntai;11;14;25
94;14.09.2014;2014;09;19;Sunnuntai;14;10;24
94;14.09.2014;2014;09;20;Sunnuntai;10;3;13
94;14.09.2014;2014;09;21;Sunnuntai;4;1;5
94;14.09.2014;2014;09;22;Sunnuntai;1;1;2
94;14.09.2014;2014;09;23;Sunnuntai;0;0;0
94;15.09.2014;2014;09;00;Maanantai;1;0;1
94;15.09.2014;2014;09;01;Maanantai;0;0;0
94;15.09.2014;2014;09;02;Maanantai;0;0;0
94;15.09.2014;2014;09;03;Maanantai;0;0;0
94;15.09.2014;2014;09;04;Maanantai;0;0;0
94;15.09.2014;2014;09;05;Maanantai;3;6;9
94;15.09.2014;2014;09;06;Maanantai;25;7;32
94;15.09.2014;2014;09;07;Maanantai;29;38;67
94;15.09.2014;2014;09;08;Maanantai;14;21;35
94;15.09.2014;2014;09;09;Maanantai;17;12;29
94;15.09.2014;2014;09;10;Maanantai;15;10;25
94;15.09.2014;2014;09;11;Maanantai;9;6;15
94;15.09.2014;2014;09;12;Maanantai;9;9;18
94;15.09.2014;2014;09;13;Maanantai;13;14;27
94;15.09.2014;2014;09;14;Maanantai;12;14;26
94;15.09.2014;2014;09;15;Maanantai;33;29;62
94;15.09.2014;2014;09;16;Maanantai;40;40;80
94;15.09.2014;2014;09;17;Maanantai;18;21;39
94;15.09.2014;2014;09;18;Maanantai;19;22;41
94;15.09.2014;2014;09;19;Maanantai;15;17;32
94;15.09.2014;2014;09;20;Maanantai;8;11;19
94;15.09.2014;2014;09;21;Maanantai;3;2;5
94;15.09.2014;2014;09;22;Maanantai;1;1;2
94;15.09.2014;2014;09;23;Maanantai;2;0;2
94;16.09.2014;2014;09;00;Tiistai;0;1;1
94;16.09.2014;2014;09;01;Tiistai;0;0;0
94;16.09.2014;2014;09;02;Tiistai;0;0;0
94;16.09.2014;2014;09;03;Tiistai;1;0;1
94;16.09.2014;2014;09;04;Tiistai;1;0;1
94;16.09.2014;2014;09;05;Tiistai;4;2;6
94;16.09.2014;2014;09;06;Tiistai;20;13;33
94;16.09.2014;2014;09;07;Tiistai;38;34;72
94;16.09.2014;2014;09;08;Tiistai;13;23;36
94;16.09.2014;2014;09;09;Tiistai;13;8;21
94;16.09.2014;2014;09;10;Tiistai;6;10;16
94;16.09.2014;2014;09;11;Tiistai;8;14;22
94;16.09.2014;2014;09;12;Tiistai;13;5;18
94;16.09.2014;2014;09;13;Tiistai;14;7;21
94;16.09.2014;2014;09;14;Tiistai;19;18;37
94;16.09.2014;2014;09;15;Tiistai;35;34;69
94;16.09.2014;2014;09;16;Tiistai;23;49;72
94;16.09.2014;2014;09;17;Tiistai;17;21;38
94;16.09.2014;2014;09;18;Tiistai;18;19;37
94;16.09.2014;2014;09;19;Tiistai;19;18;37
94;16.09.2014;2014;09;20;Tiistai;10;14;24
94;16.09.2014;2014;09;21;Tiistai;3;5;8
94;16.09.2014;2014;09;22;Tiistai;1;2;3
94;16.09.2014;2014;09;23;Tiistai;1;2;3
94;17.09.2014;2014;09;00;Keskiviikko;0;1;1
94;17.09.2014;2014;09;01;Keskiviikko;0;0;0
94;17.09.2014;2014;09;02;Keskiviikko;2;0;2
94;17.09.2014;2014;09;03;Keskiviikko;0;0;0
94;17.09.2014;2014;09;04;Keskiviikko;1;0;1
94;17.09.2014;2014;09;05;Keskiviikko;5;5;10
94;17.09.2014;2014;09;06;Keskiviikko;19;12;31
94;17.09.2014;2014;09;07;Keskiviikko;35;33;68
94;17.09.2014;2014;09;08;Keskiviikko;17;27;44
94;17.09.2014;2014;09;09;Keskiviikko;11;15;26
94;17.09.2014;2014;09;10;Keskiviikko;12;8;20
94;17.09.2014;2014;09;11;Keskiviikko;7;6;13
94;17.09.2014;2014;09;12;Keskiviikko;11;13;24
94;17.09.2014;2014;09;13;Keskiviikko;12;10;22
94;17.09.2014;2014;09;14;Keskiviikko;22;17;39
94;17.09.2014;2014;09;15;Keskiviikko;31;27;58
94;17.09.2014;2014;09;16;Keskiviikko;37;38;75
94;17.09.2014;2014;09;17;Keskiviikko;24;25;49
94;17.09.2014;2014;09;18;Keskiviikko;11;18;29
94;17.09.2014;2014;09;19;Keskiviikko;16;17;33
94;17.09.2014;2014;09;20;Keskiviikko;4;11;15
94;17.09.2014;2014;09;21;Keskiviikko;3;3;6
94;17.09.2014;2014;09;22;Keskiviikko;2;0;2
94;17.09.2014;2014;09;23;Keskiviikko;0;2;2
94;18.09.2014;2014;09;00;Torstai;0;1;1
94;18.09.2014;2014;09;01;Torstai;0;0;0
94;18.09.2014;2014;09;02;Torstai;0;0;0
94;18.09.2014;2014;09;03;Torstai;0;0;0
94;18.09.2014;2014;09;04;Torstai;1;0;1
94;18.09.2014;2014;09;05;Torstai;4;2;6
94;18.09.2014;2014;09;06;Torstai;18;12;30
94;18.09.2014;2014;09;07;Torstai;34;27;61
94;18.09.2014;2014;09;08;Torstai;16;21;37
94;18.09.2014;2014;09;09;Torstai;8;12;20
94;18.09.2014;2014;09;10;Torstai;6;5;11
94;18.09.2014;2014;09;11;Torstai;13;3;16
94;18.09.2014;2014;09;12;Torstai;10;15;25
94;18.09.2014;2014;09;13;Torstai;8;13;21
94;18.09.2014;2014;09;14;Torstai;11;16;27
94;18.09.2014;2014;09;15;Torstai;22;33;55
94;18.09.2014;2014;09;16;Torstai;25;30;55
94;18.09.2014;2014;09;17;Torstai;12;18;30
94;18.09.2014;2014;09;18;Torstai;18;20;38
94;18.09.2014;2014;09;19;Torstai;8;11;19
94;18.09.2014;2014;09;20;Torstai;5;4;9
94;18.09.2014;2014;09;21;Torstai;1;6;7
94;18.09.2014;2014;09;22;Torstai;1;4;5
94;18.09.2014;2014;09;23;Torstai;0;0;0
94;19.09.2014;2014;09;00;Perjantai;0;0;0
94;19.09.2014;2014;09;01;Perjantai;0;2;2
94;19.09.2014;2014;09;02;Perjantai;0;0;0
94;19.09.2014;2014;09;03;Perjantai;0;0;0
94;19.09.2014;2014;09;04;Perjantai;1;0;1
94;19.09.2014;2014;09;05;Perjantai;5;4;9
94;19.09.2014;2014;09;06;Perjantai;13;6;19
94;19.09.2014;2014;09;07;Perjantai;23;29;52
94;19.09.2014;2014;09;08;Perjantai;15;15;30
94;19.09.2014;2014;09;09;Perjantai;6;7;13
94;19.09.2014;2014;09;10;Perjantai;7;6;13
94;19.09.2014;2014;09;11;Perjantai;9;8;17
94;19.09.2014;2014;09;12;Perjantai;12;7;19
94;19.09.2014;2014;09;13;Perjantai;13;13;26
94;19.09.2014;2014;09;14;Perjantai;9;20;29
94;19.09.2014;2014;09;15;Perjantai;18;25;43
94;19.09.2014;2014;09;16;Perjantai;15;12;27
94;19.09.2014;2014;09;17;Perjantai;20;8;28
94;19.09.2014;2014;09;18;Perjantai;13;15;28
94;19.09.2014;2014;09;19;Perjantai;12;9;21
94;19.09.2014;2014;09;20;Perjantai;2;12;14
94;19.09.2014;2014;09;21;Perjantai;6;6;12
94;19.09.2014;2014;09;22;Perjantai;1;6;7
94;19.09.2014;2014;09;23;Perjantai;1;8;9
94;20.09.2014;2014;09;00;Lauantai;0;0;0
94;20.09.2014;2014;09;01;Lauantai;3;1;4
94;20.09.2014;2014;09;02;Lauantai;0;1;1
94;20.09.2014;2014;09;03;Lauantai;0;2;2
94;20.09.2014;2014;09;04;Lauantai;0;0;0
94;20.09.2014;2014;09;05;Lauantai;1;1;2
94;20.09.2014;2014;09;06;Lauantai;2;1;3
94;20.09.2014;2014;09;07;Lauantai;1;3;4
94;20.09.2014;2014;09;08;Lauantai;7;4;11
94;20.09.2014;2014;09;09;Lauantai;6;21;27
94;20.09.2014;2014;09;10;Lauantai;11;22;33
94;20.09.2014;2014;09;11;Lauantai;6;13;19
94;20.09.2014;2014;09;12;Lauantai;19;11;30
94;20.09.2014;2014;09;13;Lauantai;13;15;28
94;20.09.2014;2014;09;14;Lauantai;15;14;29
94;20.09.2014;2014;09;15;Lauantai;19;17;36
94;20.09.2014;2014;09;16;Lauantai;16;11;27
94;20.09.2014;2014;09;17;Lauantai;7;12;19
94;20.09.2014;2014;09;18;Lauantai;23;10;33
94;20.09.2014;2014;09;19;Lauantai;6;7;13
94;20.09.2014;2014;09;20;Lauantai;3;16;19
94;20.09.2014;2014;09;21;Lauantai;7;9;16
94;20.09.2014;2014;09;22;Lauantai;4;2;6
94;20.09.2014;2014;09;23;Lauantai;0;5;5
94;21.09.2014;2014;09;00;Sunnuntai;2;0;2
94;21.09.2014;2014;09;01;Sunnuntai;0;1;1
94;21.09.2014;2014;09;02;Sunnuntai;1;0;1
94;21.09.2014;2014;09;03;Sunnuntai;0;0;0
94;21.09.2014;2014;09;04;Sunnuntai;0;0;0
94;21.09.2014;2014;09;05;Sunnuntai;4;0;4
94;21.09.2014;2014;09;06;Sunnuntai;2;3;5
94;21.09.2014;2014;09;07;Sunnuntai;5;3;8
94;21.09.2014;2014;09;08;Sunnuntai;2;5;7
94;21.09.2014;2014;09;09;Sunnuntai;9;6;15
94;21.09.2014;2014;09;10;Sunnuntai;10;3;13
94;21.09.2014;2014;09;11;Sunnuntai;8;9;17
94;21.09.2014;2014;09;12;Sunnuntai;14;13;27
94;21.09.2014;2014;09;13;Sunnuntai;10;10;20
94;21.09.2014;2014;09;14;Sunnuntai;14;14;28
94;21.09.2014;2014;09;15;Sunnuntai;13;19;32
94;21.09.2014;2014;09;16;Sunnuntai;18;16;34
94;21.09.2014;2014;09;17;Sunnuntai;16;11;27
94;21.09.2014;2014;09;18;Sunnuntai;12;6;18
94;21.09.2014;2014;09;19;Sunnuntai;9;9;18
94;21.09.2014;2014;09;20;Sunnuntai;1;2;3
94;21.09.2014;2014;09;21;Sunnuntai;0;4;4
94;21.09.2014;2014;09;22;Sunnuntai;3;1;4
94;21.09.2014;2014;09;23;Sunnuntai;1;0;1
94;22.09.2014;2014;09;00;Maanantai;0;0;0
94;22.09.2014;2014;09;01;Maanantai;0;0;0
94;22.09.2014;2014;09;02;Maanantai;0;0;0
94;22.09.2014;2014;09;03;Maanantai;0;0;0
94;22.09.2014;2014;09;04;Maanantai;1;1;2
94;22.09.2014;2014;09;05;Maanantai;8;0;8
94;22.09.2014;2014;09;06;Maanantai;16;1;17
94;22.09.2014;2014;09;07;Maanantai;16;1;17
94;22.09.2014;2014;09;08;Maanantai;9;3;12
94;22.09.2014;2014;09;09;Maanantai;5;3;8
94;22.09.2014;2014;09;10;Maanantai;2;1;3
94;22.09.2014;2014;09;11;Maanantai;2;3;5
94;22.09.2014;2014;09;12;Maanantai;2;3;5
94;22.09.2014;2014;09;13;Maanantai;5;2;7
94;22.09.2014;2014;09;14;Maanantai;5;13;18
94;22.09.2014;2014;09;15;Maanantai;5;17;22
94;22.09.2014;2014;09;16;Maanantai;8;20;28
94;22.09.2014;2014;09;17;Maanantai;6;8;14
94;22.09.2014;2014;09;18;Maanantai;5;7;12
94;22.09.2014;2014;09;19;Maanantai;3;8;11
94;22.09.2014;2014;09;20;Maanantai;0;4;4
94;22.09.2014;2014;09;21;Maanantai;4;2;6
94;22.09.2014;2014;09;22;Maanantai;0;0;0
94;22.09.2014;2014;09;23;Maanantai;2;0;2
94;23.09.2014;2014;09;00;Tiistai;0;0;0
94;23.09.2014;2014;09;01;Tiistai;0;0;0
94;23.09.2014;2014;09;02;Tiistai;0;0;0
94;23.09.2014;2014;09;03;Tiistai;0;0;0
94;23.09.2014;2014;09;04;Tiistai;0;0;0
94;23.09.2014;2014;09;05;Tiistai;5;1;6
94;23.09.2014;2014;09;06;Tiistai;13;1;14
94;23.09.2014;2014;09;07;Tiistai;25;1;26
94;23.09.2014;2014;09;08;Tiistai;10;3;13
94;23.09.2014;2014;09;09;Tiistai;3;2;5
94;23.09.2014;2014;09;10;Tiistai;1;0;1
94;23.09.2014;2014;09;11;Tiistai;5;2;7
94;23.09.2014;2014;09;12;Tiistai;6;4;10
94;23.09.2014;2014;09;13;Tiistai;6;4;10
94;23.09.2014;2014;09;14;Tiistai;1;8;9
94;23.09.2014;2014;09;15;Tiistai;5;10;15
94;23.09.2014;2014;09;16;Tiistai;4;18;22
94;23.09.2014;2014;09;17;Tiistai;2;8;10
94;23.09.2014;2014;09;18;Tiistai;1;7;8
94;23.09.2014;2014;09;19;Tiistai;5;5;10
94;23.09.2014;2014;09;20;Tiistai;2;2;4
94;23.09.2014;2014;09;21;Tiistai;2;5;7
94;23.09.2014;2014;09;22;Tiistai;0;2;2
94;23.09.2014;2014;09;23;Tiistai;1;0;1
94;24.09.2014;2014;09;00;Keskiviikko;0;0;0
94;24.09.2014;2014;09;01;Keskiviikko;0;0;0
94;24.09.2014;2014;09;02;Keskiviikko;0;0;0
94;24.09.2014;2014;09;03;Keskiviikko;0;0;0
94;24.09.2014;2014;09;04;Keskiviikko;0;0;0
94;24.09.2014;2014;09;05;Keskiviikko;5;1;6
94;24.09.2014;2014;09;06;Keskiviikko;8;0;8
94;24.09.2014;2014;09;07;Keskiviikko;14;0;14
94;24.09.2014;2014;09;08;Keskiviikko;7;1;8
94;24.09.2014;2014;09;09;Keskiviikko;3;0;3
94;24.09.2014;2014;09;10;Keskiviikko;1;0;1
94;24.09.2014;2014;09;11;Keskiviikko;0;1;1
94;24.09.2014;2014;09;12;Keskiviikko;2;2;4
94;24.09.2014;2014;09;13;Keskiviikko;1;4;5
94;24.09.2014;2014;09;14;Keskiviikko;1;7;8
94;24.09.2014;2014;09;15;Keskiviikko;1;10;11
94;24.09.2014;2014;09;16;Keskiviikko;0;13;13
94;24.09.2014;2014;09;17;Keskiviikko;4;5;9
94;24.09.2014;2014;09;18;Keskiviikko;2;5;7
94;24.09.2014;2014;09;19;Keskiviikko;1;0;1
94;24.09.2014;2014;09;20;Keskiviikko;0;2;2
94;24.09.2014;2014;09;21;Keskiviikko;1;1;2
94;24.09.2014;2014;09;22;Keskiviikko;0;0;0
94;24.09.2014;2014;09;23;Keskiviikko;0;1;1
94;25.09.2014;2014;09;00;Torstai;0;0;0
94;25.09.2014;2014;09;01;Torstai;0;0;0
94;25.09.2014;2014;09;02;Torstai;0;0;0
94;25.09.2014;2014;09;03;Torstai;0;0;0
94;25.09.2014;2014;09;04;Torstai;0;0;0
94;25.09.2014;2014;09;05;Torstai;4;2;6
94;25.09.2014;2014;09;06;Torstai;6;1;7
94;25.09.2014;2014;09;07;Torstai;13;1;14
94;25.09.2014;2014;09;08;Torstai;4;2;6
94;25.09.2014;2014;09;09;Torstai;1;1;2
94;25.09.2014;2014;09;10;Torstai;3;1;4
94;25.09.2014;2014;09;11;Torstai;5;0;5
94;25.09.2014;2014;09;12;Torstai;3;2;5
94;25.09.2014;2014;09;13;Torstai;2;2;4
94;25.09.2014;2014;09;14;Torstai;3;8;11
94;25.09.2014;2014;09;15;Torstai;1;8;9
94;25.09.2014;2014;09;16;Torstai;5;10;15
94;25.09.2014;2014;09;17;Torstai;2;5;7
94;25.09.2014;2014;09;18;Torstai;6;7;13
94;25.09.2014;2014;09;19;Torstai;0;2;2
94;25.09.2014;2014;09;20;Torstai;3;6;9
94;25.09.2014;2014;09;21;Torstai;1;0;1
94;25.09.2014;2014;09;22;Torstai;0;4;4
94;25.09.2014;2014;09;23;Torstai;0;1;1
94;26.09.2014;2014;09;00;Perjantai;0;0;0
94;26.09.2014;2014;09;01;Perjantai;0;0;0
94;26.09.2014;2014;09;02;Perjantai;0;0;0
94;26.09.2014;2014;09;03;Perjantai;0;0;0
94;26.09.2014;2014;09;04;Perjantai;0;0;0
94;26.09.2014;2014;09;05;Perjantai;4;2;6
94;26.09.2014;2014;09;06;Perjantai;7;0;7
94;26.09.2014;2014;09;07;Perjantai;15;0;15
94;26.09.2014;2014;09;08;Perjantai;8;4;12
94;26.09.2014;2014;09;09;Perjantai;4;0;4
94;26.09.2014;2014;09;10;Perjantai;5;1;6
94;26.09.2014;2014;09;11;Perjantai;4;2;6
94;26.09.2014;2014;09;12;Perjantai;5;4;9
94;26.09.2014;2014;09;13;Perjantai;2;5;7
94;26.09.2014;2014;09;14;Perjantai;2;8;10
94;26.09.2014;2014;09;15;Perjantai;3;9;12
94;26.09.2014;2014;09;16;Perjantai;4;20;24
94;26.09.2014;2014;09;17;Perjantai;1;6;7
94;26.09.2014;2014;09;18;Perjantai;3;2;5
94;26.09.2014;2014;09;19;Perjantai;1;1;2
94;26.09.2014;2014;09;20;Perjantai;1;0;1
94;26.09.2014;2014;09;21;Perjantai;0;0;0
94;26.09.2014;2014;09;22;Perjantai;0;2;2
94;26.09.2014;2014;09;23;Perjantai;0;1;1
94;27.09.2014;2014;09;00;Lauantai;0;0;0
94;27.09.2014;2014;09;01;Lauantai;0;0;0
94;27.09.2014;2014;09;02;Lauantai;0;0;0
94;27.09.2014;2014;09;03;Lauantai;0;0;0
94;27.09.2014;2014;09;04;Lauantai;0;0;0
94;27.09.2014;2014;09;05;Lauantai;1;0;1
94;27.09.2014;2014;09;06;Lauantai;0;1;1
94;27.09.2014;2014;09;07;Lauantai;1;3;4
94;27.09.2014;2014;09;08;Lauantai;0;1;1
94;27.09.2014;2014;09;09;Lauantai;1;2;3
94;27.09.2014;2014;09;10;Lauantai;4;1;5
94;27.09.2014;2014;09;11;Lauantai;6;3;9
94;27.09.2014;2014;09;12;Lauantai;5;6;11
94;27.09.2014;2014;09;13;Lauantai;2;0;2
94;27.09.2014;2014;09;14;Lauantai;1;3;4
94;27.09.2014;2014;09;15;Lauantai;2;0;2
94;27.09.2014;2014;09;16;Lauantai;4;5;9
94;27.09.2014;2014;09;17;Lauantai;3;1;4
94;27.09.2014;2014;09;18;Lauantai;2;6;8
94;27.09.2014;2014;09;19;Lauantai;2;2;4
94;27.09.2014;2014;09;20;Lauantai;0;3;3
94;27.09.2014;2014;09;21;Lauantai;0;1;1
94;27.09.2014;2014;09;22;Lauantai;5;1;6
94;27.09.2014;2014;09;23;Lauantai;0;1;1
94;28.09.2014;2014;09;00;Sunnuntai;0;0;0
94;28.09.2014;2014;09;01;Sunnuntai;0;0;0
94;28.09.2014;2014;09;02;Sunnuntai;0;0;0
94;28.09.2014;2014;09;03;Sunnuntai;0;0;0
94;28.09.2014;2014;09;04;Sunnuntai;1;0;1
94;28.09.2014;2014;09;05;Sunnuntai;1;0;1
94;28.09.2014;2014;09;06;Sunnuntai;1;0;1
94;28.09.2014;2014;09;07;Sunnuntai;2;0;2
94;28.09.2014;2014;09;08;Sunnuntai;1;1;2
94;28.09.2014;2014;09;09;Sunnuntai;1;1;2
94;28.09.2014;2014;09;10;Sunnuntai;1;1;2
94;28.09.2014;2014;09;11;Sunnuntai;9;8;17
94;28.09.2014;2014;09;12;Sunnuntai;8;8;16
94;28.09.2014;2014;09;13;Sunnuntai;7;4;11
94;28.09.2014;2014;09;14;Sunnuntai;6;6;12
94;28.09.2014;2014;09;15;Sunnuntai;2;5;7
94;28.09.2014;2014;09;16;Sunnuntai;6;9;15
94;28.09.2014;2014;09;17;Sunnuntai;5;1;6
94;28.09.2014;2014;09;18;Sunnuntai;4;1;5
94;28.09.2014;2014;09;19;Sunnuntai;0;3;3
94;28.09.2014;2014;09;20;Sunnuntai;0;1;1
94;28.09.2014;2014;09;21;Sunnuntai;1;1;2
94;28.09.2014;2014;09;22;Sunnuntai;0;1;1
94;28.09.2014;2014;09;23;Sunnuntai;0;0;0
94;29.09.2014;2014;09;00;Maanantai;0;0;0
94;29.09.2014;2014;09;01;Maanantai;0;0;0
94;29.09.2014;2014;09;02;Maanantai;0;0;0
94;29.09.2014;2014;09;03;Maanantai;0;0;0
94;29.09.2014;2014;09;04;Maanantai;0;0;0
94;29.09.2014;2014;09;05;Maanantai;5;0;5
94;29.09.2014;2014;09;06;Maanantai;11;1;12
94;29.09.2014;2014;09;07;Maanantai;24;2;26
94;29.09.2014;2014;09;08;Maanantai;11;3;14
94;29.09.2014;2014;09;09;Maanantai;5;1;6
94;29.09.2014;2014;09;10;Maanantai;3;2;5
94;29.09.2014;2014;09;11;Maanantai;6;4;10
94;29.09.2014;2014;09;12;Maanantai;5;3;8
94;29.09.2014;2014;09;13;Maanantai;3;2;5
94;29.09.2014;2014;09;14;Maanantai;1;4;5
94;29.09.2014;2014;09;15;Maanantai;3;15;18
94;29.09.2014;2014;09;16;Maanantai;2;23;25
94;29.09.2014;2014;09;17;Maanantai;3;10;13
94;29.09.2014;2014;09;18;Maanantai;5;5;10
94;29.09.2014;2014;09;19;Maanantai;5;6;11
94;29.09.2014;2014;09;20;Maanantai;1;3;4
94;29.09.2014;2014;09;21;Maanantai;1;5;6
94;29.09.2014;2014;09;22;Maanantai;0;2;2
94;29.09.2014;2014;09;23;Maanantai;0;0;0
94;30.09.2014;2014;09;00;Tiistai;0;0;0
94;30.09.2014;2014;09;01;Tiistai;0;0;0
94;30.09.2014;2014;09;02;Tiistai;0;0;0
94;30.09.2014;2014;09;03;Tiistai;0;0;0
94;30.09.2014;2014;09;04;Tiistai;2;0;2
94;30.09.2014;2014;09;05;Tiistai;9;0;9
94;30.09.2014;2014;09;06;Tiistai;12;0;12
94;30.09.2014;2014;09;07;Tiistai;24;1;25
94;30.09.2014;2014;09;08;Tiistai;10;1;11
94;30.09.2014;2014;09;09;Tiistai;8;1;9
94;30.09.2014;2014;09;10;Tiistai;5;1;6
94;30.09.2014;2014;09;11;Tiistai;2;1;3
94;30.09.2014;2014;09;12;Tiistai;3;1;4
94;30.09.2014;2014;09;13;Tiistai;2;8;10
94;30.09.2014;2014;09;14;Tiistai;0;7;7
94;30.09.2014;2014;09;15;Tiistai;2;11;13
94;30.09.2014;2014;09;16;Tiistai;8;15;23
94;30.09.2014;2014;09;17;Tiistai;10;20;30
94;30.09.2014;2014;09;18;Tiistai;9;7;16
94;30.09.2014;2014;09;19;Tiistai;4;11;15
94;30.09.2014;2014;09;20;Tiistai;3;4;7
94;30.09.2014;2014;09;21;Tiistai;0;7;7
94;30.09.2014;2014;09;22;Tiistai;0;1;1
94;30.09.2014;2014;09;23;Tiistai;0;0;0
94;01.10.2014;2014;10;00;Keskiviikko;0;0;0
94;01.10.2014;2014;10;01;Keskiviikko;0;0;0
94;01.10.2014;2014;10;02;Keskiviikko;0;0;0
94;01.10.2014;2014;10;03;Keskiviikko;0;0;0
94;01.10.2014;2014;10;04;Keskiviikko;0;1;1
94;01.10.2014;2014;10;05;Keskiviikko;7;0;7
94;01.10.2014;2014;10;06;Keskiviikko;9;0;9
94;01.10.2014;2014;10;07;Keskiviikko;29;0;29
94;01.10.2014;2014;10;08;Keskiviikko;10;1;11
94;01.10.2014;2014;10;09;Keskiviikko;3;0;3
94;01.10.2014;2014;10;10;Keskiviikko;1;2;3
94;01.10.2014;2014;10;11;Keskiviikko;3;5;8
94;01.10.2014;2014;10;12;Keskiviikko;2;2;4
94;01.10.2014;2014;10;13;Keskiviikko;3;1;4
94;01.10.2014;2014;10;14;Keskiviikko;1;10;11
94;01.10.2014;2014;10;15;Keskiviikko;7;13;20
94;01.10.2014;2014;10;16;Keskiviikko;5;21;26
94;01.10.2014;2014;10;17;Keskiviikko;7;16;23
94;01.10.2014;2014;10;18;Keskiviikko;4;12;16
94;01.10.2014;2014;10;19;Keskiviikko;2;3;5
94;01.10.2014;2014;10;20;Keskiviikko;4;2;6
94;01.10.2014;2014;10;21;Keskiviikko;1;2;3
94;01.10.2014;2014;10;22;Keskiviikko;0;1;1
94;01.10.2014;2014;10;23;Keskiviikko;0;0;0
94;02.10.2014;2014;10;00;Torstai;0;1;1
94;02.10.2014;2014;10;01;Torstai;0;0;0
94;02.10.2014;2014;10;02;Torstai;0;0;0
94;02.10.2014;2014;10;03;Torstai;0;0;0
94;02.10.2014;2014;10;04;Torstai;0;0;0
94;02.10.2014;2014;10;05;Torstai;5;0;5
94;02.10.2014;2014;10;06;Torstai;8;1;9
94;02.10.2014;2014;10;07;Torstai;17;2;19
94;02.10.2014;2014;10;08;Torstai;11;1;12
94;02.10.2014;2014;10;09;Torstai;3;0;3
94;02.10.2014;2014;10;10;Torstai;0;0;0
94;02.10.2014;2014;10;11;Torstai;1;1;2
94;02.10.2014;2014;10;12;Torstai;4;1;5
94;02.10.2014;2014;10;13;Torstai;3;1;4
94;02.10.2014;2014;10;14;Torstai;0;7;7
94;02.10.2014;2014;10;15;Torstai;0;17;17
94;02.10.2014;2014;10;16;Torstai;6;23;29
94;02.10.2014;2014;10;17;Torstai;4;5;9
94;02.10.2014;2014;10;18;Torstai;3;3;6
94;02.10.2014;2014;10;19;Torstai;4;7;11
94;02.10.2014;2014;10;20;Torstai;5;1;6
94;02.10.2014;2014;10;21;Torstai;1;6;7
94;02.10.2014;2014;10;22;Torstai;0;1;1
94;02.10.2014;2014;10;23;Torstai;0;1;1
94;03.10.2014;2014;10;00;Perjantai;0;0;0
94;03.10.2014;2014;10;01;Perjantai;0;0;0
94;03.10.2014;2014;10;02;Perjantai;0;0;0
94;03.10.2014;2014;10;03;Perjantai;0;0;0
94;03.10.2014;2014;10;04;Perjantai;0;0;0
94;03.10.2014;2014;10;05;Perjantai;7;0;7
94;03.10.2014;2014;10;06;Perjantai;6;1;7
94;03.10.2014;2014;10;07;Perjantai;20;0;20
94;03.10.2014;2014;10;08;Perjantai;6;1;7
94;03.10.2014;2014;10;09;Perjantai;7;2;9
94;03.10.2014;2014;10;10;Perjantai;3;4;7
94;03.10.2014;2014;10;11;Perjantai;1;4;5
94;03.10.2014;2014;10;12;Perjantai;2;2;4
94;03.10.2014;2014;10;13;Perjantai;0;5;5
94;03.10.2014;2014;10;14;Perjantai;4;15;19
94;03.10.2014;2014;10;15;Perjantai;8;15;23
94;03.10.2014;2014;10;16;Perjantai;5;13;18
94;03.10.2014;2014;10;17;Perjantai;9;10;19
94;03.10.2014;2014;10;18;Perjantai;7;4;11
94;03.10.2014;2014;10;19;Perjantai;5;3;8
94;03.10.2014;2014;10;20;Perjantai;1;5;6
94;03.10.2014;2014;10;21;Perjantai;0;2;2
94;03.10.2014;2014;10;22;Perjantai;0;2;2
94;03.10.2014;2014;10;23;Perjantai;1;1;2
94;04.10.2014;2014;10;00;Lauantai;0;0;0
94;04.10.2014;2014;10;01;Lauantai;0;0;0
94;04.10.2014;2014;10;02;Lauantai;0;2;2
94;04.10.2014;2014;10;03;Lauantai;1;0;1
94;04.10.2014;2014;10;04;Lauantai;0;0;0
94;04.10.2014;2014;10;05;Lauantai;0;0;0
94;04.10.2014;2014;10;06;Lauantai;0;1;1
94;04.10.2014;2014;10;07;Lauantai;1;0;1
94;04.10.2014;2014;10;08;Lauantai;1;0;1
94;04.10.2014;2014;10;09;Lauantai;6;2;8
94;04.10.2014;2014;10;10;Lauantai;4;5;9
94;04.10.2014;2014;10;11;Lauantai;4;4;8
94;04.10.2014;2014;10;12;Lauantai;3;6;9
94;04.10.2014;2014;10;13;Lauantai;3;1;4
94;04.10.2014;2014;10;14;Lauantai;5;4;9
94;04.10.2014;2014;10;15;Lauantai;4;5;9
94;04.10.2014;2014;10;16;Lauantai;9;13;22
94;04.10.2014;2014;10;17;Lauantai;2;5;7
94;04.10.2014;2014;10;18;Lauantai;4;3;7
94;04.10.2014;2014;10;19;Lauantai;4;2;6
94;04.10.2014;2014;10;20;Lauantai;1;2;3
94;04.10.2014;2014;10;21;Lauantai;2;0;2
94;04.10.2014;2014;10;22;Lauantai;1;1;2
94;04.10.2014;2014;10;23;Lauantai;0;3;3
94;05.10.2014;2014;10;00;Sunnuntai;0;0;0
94;05.10.2014;2014;10;01;Sunnuntai;0;0;0
94;05.10.2014;2014;10;02;Sunnuntai;0;0;0
94;05.10.2014;2014;10;03;Sunnuntai;0;0;0
94;05.10.2014;2014;10;04;Sunnuntai;0;0;0
94;05.10.2014;2014;10;05;Sunnuntai;0;0;0
94;05.10.2014;2014;10;06;Sunnuntai;1;1;2
94;05.10.2014;2014;10;07;Sunnuntai;0;1;1
94;05.10.2014;2014;10;08;Sunnuntai;1;0;1
94;05.10.2014;2014;10;09;Sunnuntai;0;1;1
94;05.10.2014;2014;10;10;Sunnuntai;2;2;4
94;05.10.2014;2014;10;11;Sunnuntai;4;1;5
94;05.10.2014;2014;10;12;Sunnuntai;4;6;10
94;05.10.2014;2014;10;13;Sunnuntai;10;5;15
94;05.10.2014;2014;10;14;Sunnuntai;6;7;13
94;05.10.2014;2014;10;15;Sunnuntai;4;5;9
94;05.10.2014;2014;10;16;Sunnuntai;11;8;19
94;05.10.2014;2014;10;17;Sunnuntai;2;7;9
94;05.10.2014;2014;10;18;Sunnuntai;7;7;14
94;05.10.2014;2014;10;19;Sunnuntai;3;2;5
94;05.10.2014;2014;10;20;Sunnuntai;2;1;3
94;05.10.2014;2014;10;21;Sunnuntai;0;2;2
94;05.10.2014;2014;10;22;Sunnuntai;1;1;2
94;05.10.2014;2014;10;23;Sunnuntai;0;0;0
94;06.10.2014;2014;10;00;Maanantai;0;1;1
94;06.10.2014;2014;10;01;Maanantai;0;0;0
94;06.10.2014;2014;10;02;Maanantai;0;0;0
94;06.10.2014;2014;10;03;Maanantai;0;0;0
94;06.10.2014;2014;10;04;Maanantai;0;1;1
94;06.10.2014;2014;10;05;Maanantai;6;0;6
94;06.10.2014;2014;10;06;Maanantai;15;0;15
94;06.10.2014;2014;10;07;Maanantai;20;0;20
94;06.10.2014;2014;10;08;Maanantai;12;3;15
94;06.10.2014;2014;10;09;Maanantai;1;3;4
94;06.10.2014;2014;10;10;Maanantai;4;1;5
94;06.10.2014;2014;10;11;Maanantai;1;2;3
94;06.10.2014;2014;10;12;Maanantai;4;2;6
94;06.10.2014;2014;10;13;Maanantai;2;2;4
94;06.10.2014;2014;10;14;Maanantai;2;6;8
94;06.10.2014;2014;10;15;Maanantai;1;10;11
94;06.10.2014;2014;10;16;Maanantai;5;20;25
94;06.10.2014;2014;10;17;Maanantai;0;16;16
94;06.10.2014;2014;10;18;Maanantai;1;3;4
94;06.10.2014;2014;10;19;Maanantai;1;2;3
94;06.10.2014;2014;10;20;Maanantai;3;4;7
94;06.10.2014;2014;10;21;Maanantai;0;1;1
94;06.10.2014;2014;10;22;Maanantai;0;2;2
94;06.10.2014;2014;10;23;Maanantai;0;0;0
94;07.10.2014;2014;10;00;Tiistai;0;0;0
94;07.10.2014;2014;10;01;Tiistai;0;0;0
94;07.10.2014;2014;10;02;Tiistai;0;0;0
94;07.10.2014;2014;10;03;Tiistai;0;0;0
94;07.10.2014;2014;10;04;Tiistai;1;0;1
94;07.10.2014;2014;10;05;Tiistai;9;0;9
94;07.10.2014;2014;10;06;Tiistai;16;0;16
94;07.10.2014;2014;10;07;Tiistai;19;3;22
94;07.10.2014;2014;10;08;Tiistai;7;1;8
94;07.10.2014;2014;10;09;Tiistai;4;1;5
94;07.10.2014;2014;10;10;Tiistai;3;0;3
94;07.10.2014;2014;10;11;Tiistai;2;2;4
94;07.10.2014;2014;10;12;Tiistai;5;0;5
94;07.10.2014;2014;10;13;Tiistai;1;2;3
94;07.10.2014;2014;10;14;Tiistai;2;8;10
94;07.10.2014;2014;10;15;Tiistai;3;12;15
94;07.10.2014;2014;10;16;Tiistai;3;27;30
94;07.10.2014;2014;10;17;Tiistai;7;13;20
94;07.10.2014;2014;10;18;Tiistai;4;6;10
94;07.10.2014;2014;10;19;Tiistai;6;5;11
94;07.10.2014;2014;10;20;Tiistai;0;6;6
94;07.10.2014;2014;10;21;Tiistai;1;4;5
94;07.10.2014;2014;10;22;Tiistai;0;1;1
94;07.10.2014;2014;10;23;Tiistai;0;0;0
94;08.10.2014;2014;10;00;Keskiviikko;0;0;0
94;08.10.2014;2014;10;01;Keskiviikko;0;0;0
94;08.10.2014;2014;10;02;Keskiviikko;0;0;0
94;08.10.2014;2014;10;03;Keskiviikko;0;0;0
94;08.10.2014;2014;10;04;Keskiviikko;0;0;0
94;08.10.2014;2014;10;05;Keskiviikko;6;1;7
94;08.10.2014;2014;10;06;Keskiviikko;16;0;16
94;08.10.2014;2014;10;07;Keskiviikko;19;2;21
94;08.10.2014;2014;10;08;Keskiviikko;10;1;11
94;08.10.2014;2014;10;09;Keskiviikko;2;0;2
94;08.10.2014;2014;10;10;Keskiviikko;3;2;5
94;08.10.2014;2014;10;11;Keskiviikko;4;2;6
94;08.10.2014;2014;10;12;Keskiviikko;2;3;5
94;08.10.2014;2014;10;13;Keskiviikko;2;6;8
94;08.10.2014;2014;10;14;Keskiviikko;4;12;16
94;08.10.2014;2014;10;15;Keskiviikko;2;13;15
94;08.10.2014;2014;10;16;Keskiviikko;7;24;31
94;08.10.2014;2014;10;17;Keskiviikko;6;12;18
94;08.10.2014;2014;10;18;Keskiviikko;4;3;7
94;08.10.2014;2014;10;19;Keskiviikko;0;3;3
94;08.10.2014;2014;10;20;Keskiviikko;7;1;8
94;08.10.2014;2014;10;21;Keskiviikko;1;5;6
94;08.10.2014;2014;10;22;Keskiviikko;0;2;2
94;08.10.2014;2014;10;23;Keskiviikko;0;1;1
94;09.10.2014;2014;10;00;Torstai;0;0;0
94;09.10.2014;2014;10;01;Torstai;0;0;0
94;09.10.2014;2014;10;02;Torstai;0;0;0
94;09.10.2014;2014;10;03;Torstai;0;0;0
94;09.10.2014;2014;10;04;Torstai;1;0;1
94;09.10.2014;2014;10;05;Torstai;3;2;5
94;09.10.2014;2014;10;06;Torstai;5;0;5
94;09.10.2014;2014;10;07;Torstai;13;0;13
94;09.10.2014;2014;10;08;Torstai;10;1;11
94;09.10.2014;2014;10;09;Torstai;4;0;4
94;09.10.2014;2014;10;10;Torstai;1;0;1
94;09.10.2014;2014;10;11;Torstai;1;3;4
94;09.10.2014;2014;10;12;Torstai;1;2;3
94;09.10.2014;2014;10;13;Torstai;4;2;6
94;09.10.2014;2014;10;14;Torstai;1;6;7
94;09.10.2014;2014;10;15;Torstai;1;6;7
94;09.10.2014;2014;10;16;Torstai;0;11;11
94;09.10.2014;2014;10;17;Torstai;1;8;9
94;09.10.2014;2014;10;18;Torstai;2;4;6
94;09.10.2014;2014;10;19;Torstai;2;2;4
94;09.10.2014;2014;10;20;Torstai;2;3;5
94;09.10.2014;2014;10;21;Torstai;0;2;2
94;09.10.2014;2014;10;22;Torstai;0;1;1
94;09.10.2014;2014;10;23;Torstai;0;0;0
94;10.10.2014;2014;10;00;Perjantai;0;0;0
94;10.10.2014;2014;10;01;Perjantai;0;0;0
94;10.10.2014;2014;10;02;Perjantai;0;0;0
94;10.10.2014;2014;10;03;Perjantai;0;0;0
94;10.10.2014;2014;10;04;Perjantai;1;0;1
94;10.10.2014;2014;10;05;Perjantai;2;0;2
94;10.10.2014;2014;10;06;Perjantai;0;0;0
94;10.10.2014;2014;10;07;Perjantai;9;1;10
94;10.10.2014;2014;10;08;Perjantai;6;3;9
94;10.10.2014;2014;10;09;Perjantai;0;0;0
94;10.10.2014;2014;10;10;Perjantai;0;0;0
94;10.10.2014;2014;10;11;Perjantai;1;0;1
94;10.10.2014;2014;10;12;Perjantai;2;0;2
94;10.10.2014;2014;10;13;Perjantai;1;1;2
94;10.10.2014;2014;10;14;Perjantai;1;3;4
94;10.10.2014;2014;10;15;Perjantai;1;4;5
94;10.10.2014;2014;10;16;Perjantai;0;8;8
94;10.10.2014;2014;10;17;Perjantai;0;1;1
94;10.10.2014;2014;10;18;Perjantai;0;5;5
94;10.10.2014;2014;10;19;Perjantai;1;1;2
94;10.10.2014;2014;10;20;Perjantai;2;1;3
94;10.10.2014;2014;10;21;Perjantai;1;1;2
94;10.10.2014;2014;10;22;Perjantai;0;0;0
94;10.10.2014;2014;10;23;Perjantai;0;1;1
94;11.10.2014;2014;10;00;Lauantai;0;0;0
94;11.10.2014;2014;10;01;Lauantai;0;0;0
94;11.10.2014;2014;10;02;Lauantai;0;0;0
94;11.10.2014;2014;10;03;Lauantai;0;0;0
94;11.10.2014;2014;10;04;Lauantai;1;0;1
94;11.10.2014;2014;10;05;Lauantai;0;0;0
94;11.10.2014;2014;10;06;Lauantai;0;0;0
94;11.10.2014;2014;10;07;Lauantai;0;0;0
94;11.10.2014;2014;10;08;Lauantai;1;1;2
94;11.10.2014;2014;10;09;Lauantai;1;0;1
94;11.10.2014;2014;10;10;Lauantai;2;1;3
94;11.10.2014;2014;10;11;Lauantai;0;1;1
94;11.10.2014;2014;10;12;Lauantai;2;0;2
94;11.10.2014;2014;10;13;Lauantai;3;5;8
94;11.10.2014;2014;10;14;Lauantai;1;2;3
94;11.10.2014;2014;10;15;Lauantai;9;2;11
94;11.10.2014;2014;10;16;Lauantai;1;5;6
94;11.10.2014;2014;10;17;Lauantai;3;3;6
94;11.10.2014;2014;10;18;Lauantai;1;1;2
94;11.10.2014;2014;10;19;Lauantai;1;1;2
94;11.10.2014;2014;10;20;Lauantai;3;1;4
94;11.10.2014;2014;10;21;Lauantai;1;0;1
94;11.10.2014;2014;10;22;Lauantai;0;1;1
94;11.10.2014;2014;10;23;Lauantai;0;1;1
94;12.10.2014;2014;10;00;Sunnuntai;0;1;1
94;12.10.2014;2014;10;01;Sunnuntai;0;0;0
94;12.10.2014;2014;10;02;Sunnuntai;0;0;0
94;12.10.2014;2014;10;03;Sunnuntai;0;0;0
94;12.10.2014;2014;10;04;Sunnuntai;0;0;0
94;12.10.2014;2014;10;05;Sunnuntai;0;0;0
94;12.10.2014;2014;10;06;Sunnuntai;0;1;1
94;12.10.2014;2014;10;07;Sunnuntai;2;2;4
94;12.10.2014;2014;10;08;Sunnuntai;1;1;2
94;12.10.2014;2014;10;09;Sunnuntai;3;0;3
94;12.10.2014;2014;10;10;Sunnuntai;1;1;2
94;12.10.2014;2014;10;11;Sunnuntai;20;2;22
94;12.10.2014;2014;10;12;Sunnuntai;8;4;12
94;12.10.2014;2014;10;13;Sunnuntai;0;5;5
94;12.10.2014;2014;10;14;Sunnuntai;1;5;6
94;12.10.2014;2014;10;15;Sunnuntai;7;2;9
94;12.10.2014;2014;10;16;Sunnuntai;1;3;4
94;12.10.2014;2014;10;17;Sunnuntai;1;1;2
94;12.10.2014;2014;10;18;Sunnuntai;2;1;3
94;12.10.2014;2014;10;19;Sunnuntai;3;4;7
94;12.10.2014;2014;10;20;Sunnuntai;1;0;1
94;12.10.2014;2014;10;21;Sunnuntai;1;1;2
94;12.10.2014;2014;10;22;Sunnuntai;0;4;4
94;12.10.2014;2014;10;23;Sunnuntai;0;0;0
94;13.10.2014;2014;10;00;Maanantai;0;0;0
94;13.10.2014;2014;10;01;Maanantai;0;0;0
94;13.10.2014;2014;10;02;Maanantai;0;1;1
94;13.10.2014;2014;10;03;Maanantai;0;0;0
94;13.10.2014;2014;10;04;Maanantai;0;0;0
94;13.10.2014;2014;10;05;Maanantai;4;1;5
94;13.10.2014;2014;10;06;Maanantai;11;1;12
94;13.10.2014;2014;10;07;Maanantai;19;2;21
94;13.10.2014;2014;10;08;Maanantai;8;1;9
94;13.10.2014;2014;10;09;Maanantai;3;2;5
94;13.10.2014;2014;10;10;Maanantai;1;1;2
94;13.10.2014;2014;10;11;Maanantai;4;0;4
94;13.10.2014;2014;10;12;Maanantai;1;0;1
94;13.10.2014;2014;10;13;Maanantai;3;5;8
94;13.10.2014;2014;10;14;Maanantai;1;5;6
94;13.10.2014;2014;10;15;Maanantai;4;14;18
94;13.10.2014;2014;10;16;Maanantai;1;16;17
94;13.10.2014;2014;10;17;Maanantai;0;11;11
94;13.10.2014;2014;10;18;Maanantai;1;5;6
94;13.10.2014;2014;10;19;Maanantai;0;0;0
94;13.10.2014;2014;10;20;Maanantai;2;2;4
94;13.10.2014;2014;10;21;Maanantai;2;1;3
94;13.10.2014;2014;10;22;Maanantai;0;2;2
94;13.10.2014;2014;10;23;Maanantai;0;0;0
94;14.10.2014;2014;10;00;Tiistai;0;0;0
94;14.10.2014;2014;10;01;Tiistai;0;0;0
94;14.10.2014;2014;10;02;Tiistai;0;0;0
94;14.10.2014;2014;10;03;Tiistai;0;0;0
94;14.10.2014;2014;10;04;Tiistai;0;0;0
94;14.10.2014;2014;10;05;Tiistai;5;2;7
94;14.10.2014;2014;10;06;Tiistai;6;0;6
94;14.10.2014;2014;10;07;Tiistai;17;1;18
94;14.10.2014;2014;10;08;Tiistai;12;1;13
94;14.10.2014;2014;10;09;Tiistai;3;1;4
94;14.10.2014;2014;10;10;Tiistai;2;1;3
94;14.10.2014;2014;10;11;Tiistai;1;1;2
94;14.10.2014;2014;10;12;Tiistai;2;1;3
94;14.10.2014;2014;10;13;Tiistai;2;3;5
94;14.10.2014;2014;10;14;Tiistai;2;7;9
94;14.10.2014;2014;10;15;Tiistai;3;9;12
94;14.10.2014;2014;10;16;Tiistai;10;23;33
94;14.10.2014;2014;10;17;Tiistai;6;10;16
94;14.10.2014;2014;10;18;Tiistai;2;7;9
94;14.10.2014;2014;10;19;Tiistai;2;0;2
94;14.10.2014;2014;10;20;Tiistai;3;2;5
94;14.10.2014;2014;10;21;Tiistai;3;1;4
94;14.10.2014;2014;10;22;Tiistai;0;2;2
94;14.10.2014;2014;10;23;Tiistai;0;0;0
94;15.10.2014;2014;10;00;Keskiviikko;0;0;0
94;15.10.2014;2014;10;01;Keskiviikko;0;0;0
94;15.10.2014;2014;10;02;Keskiviikko;0;0;0
94;15.10.2014;2014;10;03;Keskiviikko;0;0;0
94;15.10.2014;2014;10;04;Keskiviikko;0;0;0
94;15.10.2014;2014;10;05;Keskiviikko;3;1;4
94;15.10.2014;2014;10;06;Keskiviikko;12;1;13
94;15.10.2014;2014;10;07;Keskiviikko;20;4;24
94;15.10.2014;2014;10;08;Keskiviikko;9;1;10
94;15.10.2014;2014;10;09;Keskiviikko;2;0;2
94;15.10.2014;2014;10;10;Keskiviikko;1;0;1
94;15.10.2014;2014;10;11;Keskiviikko;3;1;4
94;15.10.2014;2014;10;12;Keskiviikko;1;0;1
94;15.10.2014;2014;10;13;Keskiviikko;3;3;6
94;15.10.2014;2014;10;14;Keskiviikko;4;8;12
94;15.10.2014;2014;10;15;Keskiviikko;5;8;13
94;15.10.2014;2014;10;16;Keskiviikko;2;19;21
94;15.10.2014;2014;10;17;Keskiviikko;0;9;9
94;15.10.2014;2014;10;18;Keskiviikko;4;6;10
94;15.10.2014;2014;10;19;Keskiviikko;2;3;5
94;15.10.2014;2014;10;20;Keskiviikko;1;1;2
94;15.10.2014;2014;10;21;Keskiviikko;1;2;3
94;15.10.2014;2014;10;22;Keskiviikko;0;2;2
94;15.10.2014;2014;10;23;Keskiviikko;0;0;0
94;16.10.2014;2014;10;00;Torstai;0;0;0
94;16.10.2014;2014;10;01;Torstai;0;0;0
94;16.10.2014;2014;10;02;Torstai;0;0;0
94;16.10.2014;2014;10;03;Torstai;0;0;0
94;16.10.2014;2014;10;04;Torstai;0;1;1
94;16.10.2014;2014;10;05;Torstai;3;1;4
94;16.10.2014;2014;10;06;Torstai;13;1;14
94;16.10.2014;2014;10;07;Torstai;16;0;16
94;16.10.2014;2014;10;08;Torstai;2;1;3
94;16.10.2014;2014;10;09;Torstai;2;1;3
94;16.10.2014;2014;10;10;Torstai;1;1;2
94;16.10.2014;2014;10;11;Torstai;2;0;2
94;16.10.2014;2014;10;12;Torstai;0;0;0
94;16.10.2014;2014;10;13;Torstai;1;1;2
94;16.10.2014;2014;10;14;Torstai;4;8;12
94;16.10.2014;2014;10;15;Torstai;4;11;15
94;16.10.2014;2014;10;16;Torstai;2;12;14
94;16.10.2014;2014;10;17;Torstai;4;6;10
94;16.10.2014;2014;10;18;Torstai;2;4;6
94;16.10.2014;2014;10;19;Torstai;2;6;8
94;16.10.2014;2014;10;20;Torstai;0;2;2
94;16.10.2014;2014;10;21;Torstai;2;2;4
94;16.10.2014;2014;10;22;Torstai;0;0;0
94;16.10.2014;2014;10;23;Torstai;0;0;0
94;17.10.2014;2014;10;00;Perjantai;0;2;2
94;17.10.2014;2014;10;01;Perjantai;0;0;0
94;17.10.2014;2014;10;02;Perjantai;0;0;0
94;17.10.2014;2014;10;03;Perjantai;0;0;0
94;17.10.2014;2014;10;04;Perjantai;0;0;0
94;17.10.2014;2014;10;05;Perjantai;2;1;3
94;17.10.2014;2014;10;06;Perjantai;6;1;7
94;17.10.2014;2014;10;07;Perjantai;13;1;14
94;17.10.2014;2014;10;08;Perjantai;7;1;8
94;17.10.2014;2014;10;09;Perjantai;5;1;6
94;17.10.2014;2014;10;10;Perjantai;5;0;5
94;17.10.2014;2014;10;11;Perjantai;1;1;2
94;17.10.2014;2014;10;12;Perjantai;3;4;7
94;17.10.2014;2014;10;13;Perjantai;7;2;9
94;17.10.2014;2014;10;14;Perjantai;2;7;9
94;17.10.2014;2014;10;15;Perjantai;3;9;12
94;17.10.2014;2014;10;16;Perjantai;2;17;19
94;17.10.2014;2014;10;17;Perjantai;2;4;6
94;17.10.2014;2014;10;18;Perjantai;2;4;6
94;17.10.2014;2014;10;19;Perjantai;0;4;4
94;17.10.2014;2014;10;20;Perjantai;1;1;2
94;17.10.2014;2014;10;21;Perjantai;1;2;3
94;17.10.2014;2014;10;22;Perjantai;2;4;6
94;17.10.2014;2014;10;23;Perjantai;0;0;0
94;18.10.2014;2014;10;00;Lauantai;0;0;0
94;18.10.2014;2014;10;01;Lauantai;0;0;0
94;18.10.2014;2014;10;02;Lauantai;0;0;0
94;18.10.2014;2014;10;03;Lauantai;0;0;0
94;18.10.2014;2014;10;04;Lauantai;0;0;0
94;18.10.2014;2014;10;05;Lauantai;0;0;0
94;18.10.2014;2014;10;06;Lauantai;1;0;1
94;18.10.2014;2014;10;07;Lauantai;1;2;3
94;18.10.2014;2014;10;08;Lauantai;0;1;1
94;18.10.2014;2014;10;09;Lauantai;2;0;2
94;18.10.2014;2014;10;10;Lauantai;3;1;4
94;18.10.2014;2014;10;11;Lauantai;6;3;9
94;18.10.2014;2014;10;12;Lauantai;0;3;3
94;18.10.2014;2014;10;13;Lauantai;4;4;8
94;18.10.2014;2014;10;14;Lauantai;9;3;12
94;18.10.2014;2014;10;15;Lauantai;10;1;11
94;18.10.2014;2014;10;16;Lauantai;1;11;12
94;18.10.2014;2014;10;17;Lauantai;2;1;3
94;18.10.2014;2014;10;18;Lauantai;4;1;5
94;18.10.2014;2014;10;19;Lauantai;1;0;1
94;18.10.2014;2014;10;20;Lauantai;0;0;0
94;18.10.2014;2014;10;21;Lauantai;0;5;5
94;18.10.2014;2014;10;22;Lauantai;2;2;4
94;18.10.2014;2014;10;23;Lauantai;0;1;1
94;19.10.2014;2014;10;00;Sunnuntai;0;0;0
94;19.10.2014;2014;10;01;Sunnuntai;0;1;1
94;19.10.2014;2014;10;02;Sunnuntai;0;0;0
94;19.10.2014;2014;10;03;Sunnuntai;0;0;0
94;19.10.2014;2014;10;04;Sunnuntai;1;0;1
94;19.10.2014;2014;10;05;Sunnuntai;0;0;0
94;19.10.2014;2014;10;06;Sunnuntai;0;0;0
94;19.10.2014;2014;10;07;Sunnuntai;2;1;3
94;19.10.2014;2014;10;08;Sunnuntai;0;0;0
94;19.10.2014;2014;10;09;Sunnuntai;0;0;0
94;19.10.2014;2014;10;10;Sunnuntai;0;0;0
94;19.10.2014;2014;10;11;Sunnuntai;1;0;1
94;19.10.2014;2014;10;12;Sunnuntai;2;3;5
94;19.10.2014;2014;10;13;Sunnuntai;1;1;2
94;19.10.2014;2014;10;14;Sunnuntai;0;0;0
94;19.10.2014;2014;10;15;Sunnuntai;1;0;1
94;19.10.2014;2014;10;16;Sunnuntai;3;4;7
94;19.10.2014;2014;10;17;Sunnuntai;4;0;4
94;19.10.2014;2014;10;18;Sunnuntai;2;2;4
94;19.10.2014;2014;10;19;Sunnuntai;0;2;2
94;19.10.2014;2014;10;20;Sunnuntai;0;0;0
94;19.10.2014;2014;10;21;Sunnuntai;0;1;1
94;19.10.2014;2014;10;22;Sunnuntai;0;1;1
94;19.10.2014;2014;10;23;Sunnuntai;0;0;0
94;20.10.2014;2014;10;00;Maanantai;0;0;0
94;20.10.2014;2014;10;01;Maanantai;0;0;0
94;20.10.2014;2014;10;02;Maanantai;0;0;0
94;20.10.2014;2014;10;03;Maanantai;0;3;3
94;20.10.2014;2014;10;04;Maanantai;1;0;1
94;20.10.2014;2014;10;05;Maanantai;4;1;5
94;20.10.2014;2014;10;06;Maanantai;5;1;6
94;20.10.2014;2014;10;07;Maanantai;12;1;13
94;20.10.2014;2014;10;08;Maanantai;4;0;4
94;20.10.2014;2014;10;09;Maanantai;2;1;3
94;20.10.2014;2014;10;10;Maanantai;1;2;3
94;20.10.2014;2014;10;11;Maanantai;1;3;4
94;20.10.2014;2014;10;12;Maanantai;2;3;5
94;20.10.2014;2014;10;13;Maanantai;3;2;5
94;20.10.2014;2014;10;14;Maanantai;1;4;5
94;20.10.2014;2014;10;15;Maanantai;4;11;15
94;20.10.2014;2014;10;16;Maanantai;4;9;13
94;20.10.2014;2014;10;17;Maanantai;3;9;12
94;20.10.2014;2014;10;18;Maanantai;2;2;4
94;20.10.2014;2014;10;19;Maanantai;4;2;6
94;20.10.2014;2014;10;20;Maanantai;3;3;6
94;20.10.2014;2014;10;21;Maanantai;0;3;3
94;20.10.2014;2014;10;22;Maanantai;0;2;2
94;20.10.2014;2014;10;23;Maanantai;1;0;1
94;21.10.2014;2014;10;00;Tiistai;0;0;0
94;21.10.2014;2014;10;01;Tiistai;0;0;0
94;21.10.2014;2014;10;02;Tiistai;0;0;0
94;21.10.2014;2014;10;03;Tiistai;0;0;0
94;21.10.2014;2014;10;04;Tiistai;0;0;0
94;21.10.2014;2014;10;05;Tiistai;3;1;4
94;21.10.2014;2014;10;06;Tiistai;6;1;7
94;21.10.2014;2014;10;07;Tiistai;12;2;14
94;21.10.2014;2014;10;08;Tiistai;2;2;4
94;21.10.2014;2014;10;09;Tiistai;2;1;3
94;21.10.2014;2014;10;10;Tiistai;1;0;1
94;21.10.2014;2014;10;11;Tiistai;1;1;2
94;21.10.2014;2014;10;12;Tiistai;3;1;4
94;21.10.2014;2014;10;13;Tiistai;2;3;5
94;21.10.2014;2014;10;14;Tiistai;4;6;10
94;21.10.2014;2014;10;15;Tiistai;1;5;6
94;21.10.2014;2014;10;16;Tiistai;3;12;15
94;21.10.2014;2014;10;17;Tiistai;5;5;10
94;21.10.2014;2014;10;18;Tiistai;3;2;5
94;21.10.2014;2014;10;19;Tiistai;1;4;5
94;21.10.2014;2014;10;20;Tiistai;1;1;2
94;21.10.2014;2014;10;21;Tiistai;0;2;2
94;21.10.2014;2014;10;22;Tiistai;0;2;2
94;21.10.2014;2014;10;23;Tiistai;1;0;1
94;22.10.2014;2014;10;00;Keskiviikko;0;0;0
94;22.10.2014;2014;10;01;Keskiviikko;0;0;0
94;22.10.2014;2014;10;02;Keskiviikko;0;0;0
94;22.10.2014;2014;10;03;Keskiviikko;0;0;0
94;22.10.2014;2014;10;04;Keskiviikko;0;0;0
94;22.10.2014;2014;10;05;Keskiviikko;2;0;2
94;22.10.2014;2014;10;06;Keskiviikko;5;2;7
94;22.10.2014;2014;10;07;Keskiviikko;10;0;10
94;22.10.2014;2014;10;08;Keskiviikko;5;0;5
94;22.10.2014;2014;10;09;Keskiviikko;1;0;1
94;22.10.2014;2014;10;10;Keskiviikko;2;0;2
94;22.10.2014;2014;10;11;Keskiviikko;4;1;5
94;22.10.2014;2014;10;12;Keskiviikko;3;0;3
94;22.10.2014;2014;10;13;Keskiviikko;2;4;6
94;22.10.2014;2014;10;14;Keskiviikko;0;2;2
94;22.10.2014;2014;10;15;Keskiviikko;2;5;7
94;22.10.2014;2014;10;16;Keskiviikko;2;10;12
94;22.10.2014;2014;10;17;Keskiviikko;0;6;6
94;22.10.2014;2014;10;18;Keskiviikko;3;1;4
94;22.10.2014;2014;10;19;Keskiviikko;1;3;4
94;22.10.2014;2014;10;20;Keskiviikko;1;2;3
94;22.10.2014;2014;10;21;Keskiviikko;0;1;1
94;22.10.2014;2014;10;22;Keskiviikko;1;2;3
94;22.10.2014;2014;10;23;Keskiviikko;0;1;1
94;23.10.2014;2014;10;00;Torstai;0;0;0
94;23.10.2014;2014;10;01;Torstai;0;1;1
94;23.10.2014;2014;10;02;Torstai;0;0;0
94;23.10.2014;2014;10;03;Torstai;0;0;0
94;23.10.2014;2014;10;04;Torstai;0;0;0
94;23.10.2014;2014;10;05;Torstai;2;0;2
94;23.10.2014;2014;10;06;Torstai;4;1;5
94;23.10.2014;2014;10;07;Torstai;10;0;10
94;23.10.2014;2014;10;08;Torstai;1;0;1
94;23.10.2014;2014;10;09;Torstai;1;0;1
94;23.10.2014;2014;10;10;Torstai;1;0;1
94;23.10.2014;2014;10;11;Torstai;0;1;1
94;23.10.2014;2014;10;12;Torstai;0;4;4
94;23.10.2014;2014;10;13;Torstai;1;2;3
94;23.10.2014;2014;10;14;Torstai;1;1;2
94;23.10.2014;2014;10;15;Torstai;3;6;9
94;23.10.2014;2014;10;16;Torstai;1;7;8
94;23.10.2014;2014;10;17;Torstai;2;5;7
94;23.10.2014;2014;10;18;Torstai;2;3;5
94;23.10.2014;2014;10;19;Torstai;1;1;2
94;23.10.2014;2014;10;20;Torstai;1;0;1
94;23.10.2014;2014;10;21;Torstai;0;1;1
94;23.10.2014;2014;10;22;Torstai;0;0;0
94;23.10.2014;2014;10;23;Torstai;1;2;3
94;24.10.2014;2014;10;00;Perjantai;0;0;0
94;24.10.2014;2014;10;01;Perjantai;0;0;0
94;24.10.2014;2014;10;02;Perjantai;0;0;0
94;24.10.2014;2014;10;03;Perjantai;0;0;0
94;24.10.2014;2014;10;04;Perjantai;0;0;0
94;24.10.2014;2014;10;05;Perjantai;2;0;2
94;24.10.2014;2014;10;06;Perjantai;4;2;6
94;24.10.2014;2014;10;07;Perjantai;7;1;8
94;24.10.2014;2014;10;08;Perjantai;3;0;3
94;24.10.2014;2014;10;09;Perjantai;0;0;0
94;24.10.2014;2014;10;10;Perjantai;1;0;1
94;24.10.2014;2014;10;11;Perjantai;0;0;0
94;24.10.2014;2014;10;12;Perjantai;1;0;1
94;24.10.2014;2014;10;13;Perjantai;0;0;0
94;24.10.2014;2014;10;14;Perjantai;0;2;2
94;24.10.2014;2014;10;15;Perjantai;2;4;6
94;24.10.2014;2014;10;16;Perjantai;0;7;7
94;24.10.2014;2014;10;17;Perjantai;0;3;3
94;24.10.2014;2014;10;18;Perjantai;1;2;3
94;24.10.2014;2014;10;19;Perjantai;0;0;0
94;24.10.2014;2014;10;20;Perjantai;2;0;2
94;24.10.2014;2014;10;21;Perjantai;0;0;0
94;24.10.2014;2014;10;22;Perjantai;0;0;0
94;24.10.2014;2014;10;23;Perjantai;0;1;1
94;25.10.2014;2014;10;00;Lauantai;0;0;0
94;25.10.2014;2014;10;01;Lauantai;0;0;0
94;25.10.2014;2014;10;02;Lauantai;0;0;0
94;25.10.2014;2014;10;03;Lauantai;0;0;0
94;25.10.2014;2014;10;04;Lauantai;0;0;0
94;25.10.2014;2014;10;05;Lauantai;0;0;0
94;25.10.2014;2014;10;06;Lauantai;0;0;0
94;25.10.2014;2014;10;07;Lauantai;0;1;1
94;25.10.2014;2014;10;08;Lauantai;0;1;1
94;25.10.2014;2014;10;09;Lauantai;0;0;0
94;25.10.2014;2014;10;10;Lauantai;0;0;0
94;25.10.2014;2014;10;11;Lauantai;0;0;0
94;25.10.2014;2014;10;12;Lauantai;0;0;0
94;25.10.2014;2014;10;13;Lauantai;0;0;0
94;25.10.2014;2014;10;14;Lauantai;0;0;0
94;25.10.2014;2014;10;15;Lauantai;0;0;0
94;25.10.2014;2014;10;16;Lauantai;0;0;0
94;25.10.2014;2014;10;17;Lauantai;0;0;0
94;25.10.2014;2014;10;18;Lauantai;0;1;1
94;25.10.2014;2014;10;19;Lauantai;0;0;0
94;25.10.2014;2014;10;20;Lauantai;0;0;0
94;25.10.2014;2014;10;21;Lauantai;1;2;3
94;25.10.2014;2014;10;22;Lauantai;0;0;0
94;25.10.2014;2014;10;23;Lauantai;0;0;0
94;26.10.2014;2014;10;00;Sunnuntai;0;1;1
94;26.10.2014;2014;10;01;Sunnuntai;0;0;0
94;26.10.2014;2014;10;02;Sunnuntai;0;0;0
94;26.10.2014;2014;10;03;Sunnuntai;0;0;0
94;26.10.2014;2014;10;04;Sunnuntai;0;0;0
94;26.10.2014;2014;10;05;Sunnuntai;0;0;0
94;26.10.2014;2014;10;06;Sunnuntai;0;0;0
94;26.10.2014;2014;10;07;Sunnuntai;1;1;2
94;26.10.2014;2014;10;08;Sunnuntai;1;1;2
94;26.10.2014;2014;10;09;Sunnuntai;0;0;0
94;26.10.2014;2014;10;10;Sunnuntai;1;0;1
94;26.10.2014;2014;10;11;Sunnuntai;4;2;6
94;26.10.2014;2014;10;12;Sunnuntai;2;1;3
94;26.10.2014;2014;10;13;Sunnuntai;0;2;2
94;26.10.2014;2014;10;14;Sunnuntai;3;2;5
94;26.10.2014;2014;10;15;Sunnuntai;2;1;3
94;26.10.2014;2014;10;16;Sunnuntai;2;0;2
94;26.10.2014;2014;10;17;Sunnuntai;0;1;1
94;26.10.2014;2014;10;18;Sunnuntai;2;0;2
94;26.10.2014;2014;10;19;Sunnuntai;2;0;2
94;26.10.2014;2014;10;20;Sunnuntai;0;2;2
94;26.10.2014;2014;10;21;Sunnuntai;0;1;1
94;26.10.2014;2014;10;22;Sunnuntai;0;0;0
94;26.10.2014;2014;10;23;Sunnuntai;0;0;0
94;27.10.2014;2014;10;00;Maanantai;0;0;0
94;27.10.2014;2014;10;01;Maanantai;0;0;0
94;27.10.2014;2014;10;02;Maanantai;0;0;0
94;27.10.2014;2014;10;03;Maanantai;0;0;0
94;27.10.2014;2014;10;04;Maanantai;0;0;0
94;27.10.2014;2014;10;05;Maanantai;4;1;5
94;27.10.2014;2014;10;06;Maanantai;10;1;11
94;27.10.2014;2014;10;07;Maanantai;10;1;11
94;27.10.2014;2014;10;08;Maanantai;10;1;11
94;27.10.2014;2014;10;09;Maanantai;1;3;4
94;27.10.2014;2014;10;10;Maanantai;0;0;0
94;27.10.2014;2014;10;11;Maanantai;3;2;5
94;27.10.2014;2014;10;12;Maanantai;4;2;6
94;27.10.2014;2014;10;13;Maanantai;0;8;8
94;27.10.2014;2014;10;14;Maanantai;1;5;6
94;27.10.2014;2014;10;15;Maanantai;3;8;11
94;27.10.2014;2014;10;16;Maanantai;5;18;23
94;27.10.2014;2014;10;17;Maanantai;1;9;10
94;27.10.2014;2014;10;18;Maanantai;2;3;5
94;27.10.2014;2014;10;19;Maanantai;3;6;9
94;27.10.2014;2014;10;20;Maanantai;2;3;5
94;27.10.2014;2014;10;21;Maanantai;0;2;2
94;27.10.2014;2014;10;22;Maanantai;0;1;1
94;27.10.2014;2014;10;23;Maanantai;0;0;0
94;28.10.2014;2014;10;00;Tiistai;0;0;0
94;28.10.2014;2014;10;01;Tiistai;0;0;0
94;28.10.2014;2014;10;02;Tiistai;0;0;0
94;28.10.2014;2014;10;03;Tiistai;1;0;1
94;28.10.2014;2014;10;04;Tiistai;0;0;0
94;28.10.2014;2014;10;05;Tiistai;0;0;0
94;28.10.2014;2014;10;06;Tiistai;14;3;17
94;28.10.2014;2014;10;07;Tiistai;15;2;17
94;28.10.2014;2014;10;08;Tiistai;5;1;6
94;28.10.2014;2014;10;09;Tiistai;5;1;6
94;28.10.2014;2014;10;10;Tiistai;1;0;1
94;28.10.2014;2014;10;11;Tiistai;1;1;2
94;28.10.2014;2014;10;12;Tiistai;2;0;2
94;28.10.2014;2014;10;13;Tiistai;1;2;3
94;28.10.2014;2014;10;14;Tiistai;1;6;7
94;28.10.2014;2014;10;15;Tiistai;3;11;14
94;28.10.2014;2014;10;16;Tiistai;5;19;24
94;28.10.2014;2014;10;17;Tiistai;1;3;4
94;28.10.2014;2014;10;18;Tiistai;2;4;6
94;28.10.2014;2014;10;19;Tiistai;2;3;5
94;28.10.2014;2014;10;20;Tiistai;0;3;3
94;28.10.2014;2014;10;21;Tiistai;2;4;6
94;28.10.2014;2014;10;22;Tiistai;0;0;0
94;28.10.2014;2014;10;23;Tiistai;0;0;0
94;29.10.2014;2014;10;00;Keskiviikko;0;0;0
94;29.10.2014;2014;10;01;Keskiviikko;0;0;0
94;29.10.2014;2014;10;02;Keskiviikko;0;0;0
94;29.10.2014;2014;10;03;Keskiviikko;0;0;0
94;29.10.2014;2014;10;04;Keskiviikko;2;0;2
94;29.10.2014;2014;10;05;Keskiviikko;5;0;5
94;29.10.2014;2014;10;06;Keskiviikko;8;1;9
94;29.10.2014;2014;10;07;Keskiviikko;10;1;11
94;29.10.2014;2014;10;08;Keskiviikko;4;0;4
94;29.10.2014;2014;10;09;Keskiviikko;1;0;1
94;29.10.2014;2014;10;10;Keskiviikko;2;0;2
94;29.10.2014;2014;10;11;Keskiviikko;1;2;3
94;29.10.2014;2014;10;12;Keskiviikko;3;1;4
94;29.10.2014;2014;10;13;Keskiviikko;1;2;3
94;29.10.2014;2014;10;14;Keskiviikko;2;11;13
94;29.10.2014;2014;10;15;Keskiviikko;3;3;6
94;29.10.2014;2014;10;16;Keskiviikko;4;9;13
94;29.10.2014;2014;10;17;Keskiviikko;4;7;11
94;29.10.2014;2014;10;18;Keskiviikko;2;4;6
94;29.10.2014;2014;10;19;Keskiviikko;2;3;5
94;29.10.2014;2014;10;20;Keskiviikko;2;0;2
94;29.10.2014;2014;10;21;Keskiviikko;1;5;6
94;29.10.2014;2014;10;22;Keskiviikko;0;1;1
94;29.10.2014;2014;10;23;Keskiviikko;0;0;0
94;30.10.2014;2014;10;00;Torstai;0;0;0
94;30.10.2014;2014;10;01;Torstai;0;0;0
94;30.10.2014;2014;10;02;Torstai;0;0;0
94;30.10.2014;2014;10;03;Torstai;0;0;0
94;30.10.2014;2014;10;04;Torstai;1;0;1
94;30.10.2014;2014;10;05;Torstai;2;1;3
94;30.10.2014;2014;10;06;Torstai;9;2;11
94;30.10.2014;2014;10;07;Torstai;23;3;26
94;30.10.2014;2014;10;08;Torstai;11;2;13
94;30.10.2014;2014;10;09;Torstai;3;0;3
94;30.10.2014;2014;10;10;Torstai;2;2;4
94;30.10.2014;2014;10;11;Torstai;2;2;4
94;30.10.2014;2014;10;12;Torstai;3;0;3
94;30.10.2014;2014;10;13;Torstai;0;1;1
94;30.10.2014;2014;10;14;Torstai;5;2;7
94;30.10.2014;2014;10;15;Torstai;0;17;17
94;30.10.2014;2014;10;16;Torstai;2;19;21
94;30.10.2014;2014;10;17;Torstai;4;7;11
94;30.10.2014;2014;10;18;Torstai;2;3;5
94;30.10.2014;2014;10;19;Torstai;0;2;2
94;30.10.2014;2014;10;20;Torstai;2;0;2
94;30.10.2014;2014;10;21;Torstai;0;4;4
94;30.10.2014;2014;10;22;Torstai;0;2;2
94;30.10.2014;2014;10;23;Torstai;0;0;0
94;31.10.2014;2014;10;00;Perjantai;0;0;0
94;31.10.2014;2014;10;01;Perjantai;0;0;0
94;31.10.2014;2014;10;02;Perjantai;0;0;0
94;31.10.2014;2014;10;03;Perjantai;0;0;0
94;31.10.2014;2014;10;04;Perjantai;0;0;0
94;31.10.2014;2014;10;05;Perjantai;4;0;4
94;31.10.2014;2014;10;06;Perjantai;6;1;7
94;31.10.2014;2014;10;07;Perjantai;13;0;13
94;31.10.2014;2014;10;08;Perjantai;7;1;8
94;31.10.2014;2014;10;09;Perjantai;3;0;3
94;31.10.2014;2014;10;10;Perjantai;2;1;3
94;31.10.2014;2014;10;11;Perjantai;2;1;3
94;31.10.2014;2014;10;12;Perjantai;1;2;3
94;31.10.2014;2014;10;13;Perjantai;2;3;5
94;31.10.2014;2014;10;14;Perjantai;2;6;8
94;31.10.2014;2014;10;15;Perjantai;2;7;9
94;31.10.2014;2014;10;16;Perjantai;3;13;16
94;31.10.2014;2014;10;17;Perjantai;1;8;9
94;31.10.2014;2014;10;18;Perjantai;1;0;1
94;31.10.2014;2014;10;19;Perjantai;3;2;5
94;31.10.2014;2014;10;20;Perjantai;2;1;3
94;31.10.2014;2014;10;21;Perjantai;0;7;7
94;31.10.2014;2014;10;22;Perjantai;1;1;2
94;31.10.2014;2014;10;23;Perjantai;0;1;1
94;01.11.2014;2014;11;00;Lauantai;1;0;1
94;01.11.2014;2014;11;01;Lauantai;0;2;2
94;01.11.2014;2014;11;02;Lauantai;0;0;0
94;01.11.2014;2014;11;03;Lauantai;0;0;0
94;01.11.2014;2014;11;04;Lauantai;0;0;0
94;01.11.2014;2014;11;05;Lauantai;0;0;0
94;01.11.2014;2014;11;06;Lauantai;0;1;1
94;01.11.2014;2014;11;07;Lauantai;0;0;0
94;01.11.2014;2014;11;08;Lauantai;2;2;4
94;01.11.2014;2014;11;09;Lauantai;4;1;5
94;01.11.2014;2014;11;10;Lauantai;0;2;2
94;01.11.2014;2014;11;11;Lauantai;4;2;6
94;01.11.2014;2014;11;12;Lauantai;4;0;4
94;01.11.2014;2014;11;13;Lauantai;7;4;11
94;01.11.2014;2014;11;14;Lauantai;5;3;8
94;01.11.2014;2014;11;15;Lauantai;2;3;5
94;01.11.2014;2014;11;16;Lauantai;2;4;6
94;01.11.2014;2014;11;17;Lauantai;4;0;4
94;01.11.2014;2014;11;18;Lauantai;0;2;2
94;01.11.2014;2014;11;19;Lauantai;1;1;2
94;01.11.2014;2014;11;20;Lauantai;0;0;0
94;01.11.2014;2014;11;21;Lauantai;1;2;3
94;01.11.2014;2014;11;22;Lauantai;0;1;1
94;01.11.2014;2014;11;23;Lauantai;0;1;1
94;02.11.2014;2014;11;00;Sunnuntai;0;0;0
94;02.11.2014;2014;11;01;Sunnuntai;0;0;0
94;02.11.2014;2014;11;02;Sunnuntai;0;0;0
94;02.11.2014;2014;11;03;Sunnuntai;0;0;0
94;02.11.2014;2014;11;04;Sunnuntai;0;0;0
94;02.11.2014;2014;11;05;Sunnuntai;0;0;0
94;02.11.2014;2014;11;06;Sunnuntai;0;0;0
94;02.11.2014;2014;11;07;Sunnuntai;1;0;1
94;02.11.2014;2014;11;08;Sunnuntai;1;10;11
94;02.11.2014;2014;11;09;Sunnuntai;0;0;0
94;02.11.2014;2014;11;10;Sunnuntai;10;0;10
94;02.11.2014;2014;11;11;Sunnuntai;0;0;0
94;02.11.2014;2014;11;12;Sunnuntai;1;0;1
94;02.11.2014;2014;11;13;Sunnuntai;1;0;1
94;02.11.2014;2014;11;14;Sunnuntai;0;1;1
94;02.11.2014;2014;11;15;Sunnuntai;1;0;1
94;02.11.2014;2014;11;16;Sunnuntai;3;0;3
94;02.11.2014;2014;11;17;Sunnuntai;1;0;1
94;02.11.2014;2014;11;18;Sunnuntai;0;0;0
94;02.11.2014;2014;11;19;Sunnuntai;1;1;2
94;02.11.2014;2014;11;20;Sunnuntai;0;1;1
94;02.11.2014;2014;11;21;Sunnuntai;0;2;2
94;02.11.2014;2014;11;22;Sunnuntai;0;1;1
94;02.11.2014;2014;11;23;Sunnuntai;0;0;0
94;03.11.2014;2014;11;00;Maanantai;0;0;0
94;03.11.2014;2014;11;01;Maanantai;0;0;0
94;03.11.2014;2014;11;02;Maanantai;0;0;0
94;03.11.2014;2014;11;03;Maanantai;0;0;0
94;03.11.2014;2014;11;04;Maanantai;0;0;0
94;03.11.2014;2014;11;05;Maanantai;4;0;4
94;03.11.2014;2014;11;06;Maanantai;11;1;12
94;03.11.2014;2014;11;07;Maanantai;15;4;19
94;03.11.2014;2014;11;08;Maanantai;4;0;4
94;03.11.2014;2014;11;09;Maanantai;1;0;1
94;03.11.2014;2014;11;10;Maanantai;1;0;1
94;03.11.2014;2014;11;11;Maanantai;0;0;0
94;03.11.2014;2014;11;12;Maanantai;0;0;0
94;03.11.2014;2014;11;13;Maanantai;1;0;1
94;03.11.2014;2014;11;14;Maanantai;1;8;9
94;03.11.2014;2014;11;15;Maanantai;2;7;9
94;03.11.2014;2014;11;16;Maanantai;1;9;10
94;03.11.2014;2014;11;17;Maanantai;1;7;8
94;03.11.2014;2014;11;18;Maanantai;1;1;2
94;03.11.2014;2014;11;19;Maanantai;1;1;2
94;03.11.2014;2014;11;20;Maanantai;2;2;4
94;03.11.2014;2014;11;21;Maanantai;0;0;0
94;03.11.2014;2014;11;22;Maanantai;0;0;0
94;03.11.2014;2014;11;23;Maanantai;0;0;0
94;04.11.2014;2014;11;00;Tiistai;0;0;0
94;04.11.2014;2014;11;01;Tiistai;0;0;0
94;04.11.2014;2014;11;02;Tiistai;0;0;0
94;04.11.2014;2014;11;03;Tiistai;0;0;0
94;04.11.2014;2014;11;04;Tiistai;1;0;1
94;04.11.2014;2014;11;05;Tiistai;3;0;3
94;04.11.2014;2014;11;06;Tiistai;12;3;15
94;04.11.2014;2014;11;07;Tiistai;13;1;14
94;04.11.2014;2014;11;08;Tiistai;2;3;5
94;04.11.2014;2014;11;09;Tiistai;7;0;7
94;04.11.2014;2014;11;10;Tiistai;2;1;3
94;04.11.2014;2014;11;11;Tiistai;2;4;6
94;04.11.2014;2014;11;12;Tiistai;3;0;3
94;04.11.2014;2014;11;13;Tiistai;1;3;4
94;04.11.2014;2014;11;14;Tiistai;1;5;6
94;04.11.2014;2014;11;15;Tiistai;5;5;10
94;04.11.2014;2014;11;16;Tiistai;2;16;18
94;04.11.2014;2014;11;17;Tiistai;1;8;9
94;04.11.2014;2014;11;18;Tiistai;0;3;3
94;04.11.2014;2014;11;19;Tiistai;0;0;0
94;04.11.2014;2014;11;20;Tiistai;0;1;1
94;04.11.2014;2014;11;21;Tiistai;0;1;1
94;04.11.2014;2014;11;22;Tiistai;1;0;1
94;04.11.2014;2014;11;23;Tiistai;0;0;0
94;05.11.2014;2014;11;00;Keskiviikko;0;0;0
94;05.11.2014;2014;11;01;Keskiviikko;0;0;0
94;05.11.2014;2014;11;02;Keskiviikko;0;0;0
94;05.11.2014;2014;11;03;Keskiviikko;1;0;1
94;05.11.2014;2014;11;04;Keskiviikko;0;0;0
94;05.11.2014;2014;11;05;Keskiviikko;3;0;3
94;05.11.2014;2014;11;06;Keskiviikko;4;0;4
94;05.11.2014;2014;11;07;Keskiviikko;15;1;16
94;05.11.2014;2014;11;08;Keskiviikko;3;3;6
94;05.11.2014;2014;11;09;Keskiviikko;1;0;1
94;05.11.2014;2014;11;10;Keskiviikko;1;0;1
94;05.11.2014;2014;11;11;Keskiviikko;0;2;2
94;05.11.2014;2014;11;12;Keskiviikko;2;1;3
94;05.11.2014;2014;11;13;Keskiviikko;1;2;3
94;05.11.2014;2014;11;14;Keskiviikko;1;4;5
94;05.11.2014;2014;11;15;Keskiviikko;2;6;8
94;05.11.2014;2014;11;16;Keskiviikko;0;13;13
94;05.11.2014;2014;11;17;Keskiviikko;0;6;6
94;05.11.2014;2014;11;18;Keskiviikko;1;5;6
94;05.11.2014;2014;11;19;Keskiviikko;1;0;1
94;05.11.2014;2014;11;20;Keskiviikko;4;1;5
94;05.11.2014;2014;11;21;Keskiviikko;2;2;4
94;05.11.2014;2014;11;22;Keskiviikko;0;1;1
94;05.11.2014;2014;11;23;Keskiviikko;0;0;0
94;06.11.2014;2014;11;00;Torstai;0;0;0
94;06.11.2014;2014;11;01;Torstai;0;0;0
94;06.11.2014;2014;11;02;Torstai;0;0;0
94;06.11.2014;2014;11;03;Torstai;0;0;0
94;06.11.2014;2014;11;04;Torstai;0;0;0
94;06.11.2014;2014;11;05;Torstai;3;0;3
94;06.11.2014;2014;11;06;Torstai;9;0;9
94;06.11.2014;2014;11;07;Torstai;7;0;7
94;06.11.2014;2014;11;08;Torstai;8;1;9
94;06.11.2014;2014;11;09;Torstai;3;0;3
94;06.11.2014;2014;11;10;Torstai;0;0;0
94;06.11.2014;2014;11;11;Torstai;0;2;2
94;06.11.2014;2014;11;12;Torstai;2;2;4
94;06.11.2014;2014;11;13;Torstai;1;4;5
94;06.11.2014;2014;11;14;Torstai;0;1;1
94;06.11.2014;2014;11;15;Torstai;2;5;7
94;06.11.2014;2014;11;16;Torstai;0;9;9
94;06.11.2014;2014;11;17;Torstai;0;7;7
94;06.11.2014;2014;11;18;Torstai;2;3;5
94;06.11.2014;2014;11;19;Torstai;0;0;0
94;06.11.2014;2014;11;20;Torstai;2;3;5
94;06.11.2014;2014;11;21;Torstai;1;0;1
94;06.11.2014;2014;11;22;Torstai;0;2;2
94;06.11.2014;2014;11;23;Torstai;0;1;1
94;07.11.2014;2014;11;00;Perjantai;0;0;0
94;07.11.2014;2014;11;01;Perjantai;0;0;0
94;07.11.2014;2014;11;02;Perjantai;0;0;0
94;07.11.2014;2014;11;03;Perjantai;0;0;0
94;07.11.2014;2014;11;04;Perjantai;0;0;0
94;07.11.2014;2014;11;05;Perjantai;1;0;1
94;07.11.2014;2014;11;06;Perjantai;3;0;3
94;07.11.2014;2014;11;07;Perjantai;7;0;7
94;07.11.2014;2014;11;08;Perjantai;3;0;3
94;07.11.2014;2014;11;09;Perjantai;1;1;2
94;07.11.2014;2014;11;10;Perjantai;2;0;2
94;07.11.2014;2014;11;11;Perjantai;1;0;1
94;07.11.2014;2014;11;12;Perjantai;2;1;3
94;07.11.2014;2014;11;13;Perjantai;2;1;3
94;07.11.2014;2014;11;14;Perjantai;0;4;4
94;07.11.2014;2014;11;15;Perjantai;4;6;10
94;07.11.2014;2014;11;16;Perjantai;2;3;5
94;07.11.2014;2014;11;17;Perjantai;1;4;5
94;07.11.2014;2014;11;18;Perjantai;0;2;2
94;07.11.2014;2014;11;19;Perjantai;0;2;2
94;07.11.2014;2014;11;20;Perjantai;0;2;2
94;07.11.2014;2014;11;21;Perjantai;0;0;0
94;07.11.2014;2014;11;22;Perjantai;0;1;1
94;07.11.2014;2014;11;23;Perjantai;0;0;0
94;08.11.2014;2014;11;00;Lauantai;0;0;0
94;08.11.2014;2014;11;01;Lauantai;0;0;0
94;08.11.2014;2014;11;02;Lauantai;0;0;0
94;08.11.2014;2014;11;03;Lauantai;0;0;0
94;08.11.2014;2014;11;04;Lauantai;1;0;1
94;08.11.2014;2014;11;05;Lauantai;0;0;0
94;08.11.2014;2014;11;06;Lauantai;0;0;0
94;08.11.2014;2014;11;07;Lauantai;0;0;0
94;08.11.2014;2014;11;08;Lauantai;0;1;1
94;08.11.2014;2014;11;09;Lauantai;1;0;1
94;08.11.2014;2014;11;10;Lauantai;1;2;3
94;08.11.2014;2014;11;11;Lauantai;1;1;2
94;08.11.2014;2014;11;12;Lauantai;1;1;2
94;08.11.2014;2014;11;13;Lauantai;1;1;2
94;08.11.2014;2014;11;14;Lauantai;3;2;5
94;08.11.2014;2014;11;15;Lauantai;0;1;1
94;08.11.2014;2014;11;16;Lauantai;0;1;1
94;08.11.2014;2014;11;17;Lauantai;0;1;1
94;08.11.2014;2014;11;18;Lauantai;1;0;1
94;08.11.2014;2014;11;19;Lauantai;2;1;3
94;08.11.2014;2014;11;20;Lauantai;0;2;2
94;08.11.2014;2014;11;21;Lauantai;1;0;1
94;08.11.2014;2014;11;22;Lauantai;0;3;3
94;08.11.2014;2014;11;23;Lauantai;0;1;1
94;09.11.2014;2014;11;00;Sunnuntai;0;0;0
94;09.11.2014;2014;11;01;Sunnuntai;0;0;0
94;09.11.2014;2014;11;02;Sunnuntai;0;0;0
94;09.11.2014;2014;11;03;Sunnuntai;0;0;0
94;09.11.2014;2014;11;04;Sunnuntai;1;0;1
94;09.11.2014;2014;11;05;Sunnuntai;0;0;0
94;09.11.2014;2014;11;06;Sunnuntai;0;0;0
94;09.11.2014;2014;11;07;Sunnuntai;1;0;1
94;09.11.2014;2014;11;08;Sunnuntai;2;0;2
94;09.11.2014;2014;11;09;Sunnuntai;0;1;1
94;09.11.2014;2014;11;10;Sunnuntai;0;1;1
94;09.11.2014;2014;11;11;Sunnuntai;0;1;1
94;09.11.2014;2014;11;12;Sunnuntai;2;1;3
94;09.11.2014;2014;11;13;Sunnuntai;1;2;3
94;09.11.2014;2014;11;14;Sunnuntai;0;2;2
94;09.11.2014;2014;11;15;Sunnuntai;1;2;3
94;09.11.2014;2014;11;16;Sunnuntai;2;0;2
94;09.11.2014;2014;11;17;Sunnuntai;2;0;2
94;09.11.2014;2014;11;18;Sunnuntai;1;0;1
94;09.11.2014;2014;11;19;Sunnuntai;2;2;4
94;09.11.2014;2014;11;20;Sunnuntai;0;0;0
94;09.11.2014;2014;11;21;Sunnuntai;0;0;0
94;09.11.2014;2014;11;22;Sunnuntai;0;2;2
94;09.11.2014;2014;11;23;Sunnuntai;0;0;0
94;10.11.2014;2014;11;00;Maanantai;0;0;0
94;10.11.2014;2014;11;01;Maanantai;0;0;0
94;10.11.2014;2014;11;02;Maanantai;0;0;0
94;10.11.2014;2014;11;03;Maanantai;0;0;0
94;10.11.2014;2014;11;04;Maanantai;1;0;1
94;10.11.2014;2014;11;05;Maanantai;1;1;2
94;10.11.2014;2014;11;06;Maanantai;8;0;8
94;10.11.2014;2014;11;07;Maanantai;17;0;17
94;10.11.2014;2014;11;08;Maanantai;2;1;3
94;10.11.2014;2014;11;09;Maanantai;4;1;5
94;10.11.2014;2014;11;10;Maanantai;1;0;1
94;10.11.2014;2014;11;11;Maanantai;0;2;2
94;10.11.2014;2014;11;12;Maanantai;5;0;5
94;10.11.2014;2014;11;13;Maanantai;2;7;9
94;10.11.2014;2014;11;14;Maanantai;2;7;9
94;10.11.2014;2014;11;15;Maanantai;0;8;8
94;10.11.2014;2014;11;16;Maanantai;0;10;10
94;10.11.2014;2014;11;17;Maanantai;3;3;6
94;10.11.2014;2014;11;18;Maanantai;0;3;3
94;10.11.2014;2014;11;19;Maanantai;0;1;1
94;10.11.2014;2014;11;20;Maanantai;1;2;3
94;10.11.2014;2014;11;21;Maanantai;0;2;2
94;10.11.2014;2014;11;22;Maanantai;0;1;1
94;10.11.2014;2014;11;23;Maanantai;0;0;0
94;11.11.2014;2014;11;00;Tiistai;0;0;0
94;11.11.2014;2014;11;01;Tiistai;0;0;0
94;11.11.2014;2014;11;02;Tiistai;0;0;0
94;11.11.2014;2014;11;03;Tiistai;0;0;0
94;11.11.2014;2014;11;04;Tiistai;0;0;0
94;11.11.2014;2014;11;05;Tiistai;4;1;5
94;11.11.2014;2014;11;06;Tiistai;6;0;6
94;11.11.2014;2014;11;07;Tiistai;11;1;12
94;11.11.2014;2014;11;08;Tiistai;7;0;7
94;11.11.2014;2014;11;09;Tiistai;1;0;1
94;11.11.2014;2014;11;10;Tiistai;2;1;3
94;11.11.2014;2014;11;11;Tiistai;0;1;1
94;11.11.2014;2014;11;12;Tiistai;2;2;4
94;11.11.2014;2014;11;13;Tiistai;0;0;0
94;11.11.2014;2014;11;14;Tiistai;1;2;3
94;11.11.2014;2014;11;15;Tiistai;1;5;6
94;11.11.2014;2014;11;16;Tiistai;2;15;17
94;11.11.2014;2014;11;17;Tiistai;2;4;6
94;11.11.2014;2014;11;18;Tiistai;0;2;2
94;11.11.2014;2014;11;19;Tiistai;0;0;0
94;11.11.2014;2014;11;20;Tiistai;1;0;1
94;11.11.2014;2014;11;21;Tiistai;1;2;3
94;11.11.2014;2014;11;22;Tiistai;0;0;0
94;11.11.2014;2014;11;23;Tiistai;0;1;1
94;12.11.2014;2014;11;00;Keskiviikko;0;0;0
94;12.11.2014;2014;11;01;Keskiviikko;0;0;0
94;12.11.2014;2014;11;02;Keskiviikko;0;0;0
94;12.11.2014;2014;11;03;Keskiviikko;0;0;0
94;12.11.2014;2014;11;04;Keskiviikko;0;0;0
94;12.11.2014;2014;11;05;Keskiviikko;2;0;2
94;12.11.2014;2014;11;06;Keskiviikko;8;0;8
94;12.11.2014;2014;11;07;Keskiviikko;17;1;18
94;12.11.2014;2014;11;08;Keskiviikko;7;1;8
94;12.11.2014;2014;11;09;Keskiviikko;3;1;4
94;12.11.2014;2014;11;10;Keskiviikko;2;1;3
94;12.11.2014;2014;11;11;Keskiviikko;4;0;4
94;12.11.2014;2014;11;12;Keskiviikko;2;0;2
94;12.11.2014;2014;11;13;Keskiviikko;2;4;6
94;12.11.2014;2014;11;14;Keskiviikko;0;4;4
94;12.11.2014;2014;11;15;Keskiviikko;0;6;6
94;12.11.2014;2014;11;16;Keskiviikko;2;11;13
94;12.11.2014;2014;11;17;Keskiviikko;1;7;8
94;12.11.2014;2014;11;18;Keskiviikko;2;2;4
94;12.11.2014;2014;11;19;Keskiviikko;0;1;1
94;12.11.2014;2014;11;20;Keskiviikko;2;3;5
94;12.11.2014;2014;11;21;Keskiviikko;0;3;3
94;12.11.2014;2014;11;22;Keskiviikko;1;0;1
94;12.11.2014;2014;11;23;Keskiviikko;0;0;0
94;13.11.2014;2014;11;00;Torstai;0;0;0
94;13.11.2014;2014;11;01;Torstai;0;0;0
94;13.11.2014;2014;11;02;Torstai;0;0;0
94;13.11.2014;2014;11;03;Torstai;0;0;0
94;13.11.2014;2014;11;04;Torstai;0;0;0
94;13.11.2014;2014;11;05;Torstai;1;2;3
94;13.11.2014;2014;11;06;Torstai;9;1;10
94;13.11.2014;2014;11;07;Torstai;14;2;16
94;13.11.2014;2014;11;08;Torstai;6;0;6
94;13.11.2014;2014;11;09;Torstai;1;2;3
94;13.11.2014;2014;11;10;Torstai;1;0;1
94;13.11.2014;2014;11;11;Torstai;2;1;3
94;13.11.2014;2014;11;12;Torstai;0;0;0
94;13.11.2014;2014;11;13;Torstai;0;1;1
94;13.11.2014;2014;11;14;Torstai;2;4;6
94;13.11.2014;2014;11;15;Torstai;0;6;6
94;13.11.2014;2014;11;16;Torstai;4;9;13
94;13.11.2014;2014;11;17;Torstai;1;8;9
94;13.11.2014;2014;11;18;Torstai;0;5;5
94;13.11.2014;2014;11;19;Torstai;0;2;2
94;13.11.2014;2014;11;20;Torstai;1;0;1
94;13.11.2014;2014;11;21;Torstai;0;2;2
94;13.11.2014;2014;11;22;Torstai;0;0;0
94;13.11.2014;2014;11;23;Torstai;0;0;0
94;14.11.2014;2014;11;00;Perjantai;0;0;0
94;14.11.2014;2014;11;01;Perjantai;0;0;0
94;14.11.2014;2014;11;02;Perjantai;0;0;0
94;14.11.2014;2014;11;03;Perjantai;0;0;0
94;14.11.2014;2014;11;04;Perjantai;0;0;0
94;14.11.2014;2014;11;05;Perjantai;3;1;4
94;14.11.2014;2014;11;06;Perjantai;6;0;6
94;14.11.2014;2014;11;07;Perjantai;12;1;13
94;14.11.2014;2014;11;08;Perjantai;5;1;6
94;14.11.2014;2014;11;09;Perjantai;3;1;4
94;14.11.2014;2014;11;10;Perjantai;2;1;3
94;14.11.2014;2014;11;11;Perjantai;1;2;3
94;14.11.2014;2014;11;12;Perjantai;0;0;0
94;14.11.2014;2014;11;13;Perjantai;3;2;5
94;14.11.2014;2014;11;14;Perjantai;1;5;6
94;14.11.2014;2014;11;15;Perjantai;1;8;9
94;14.11.2014;2014;11;16;Perjantai;2;10;12
94;14.11.2014;2014;11;17;Perjantai;3;2;5
94;14.11.2014;2014;11;18;Perjantai;2;1;3
94;14.11.2014;2014;11;19;Perjantai;0;1;1
94;14.11.2014;2014;11;20;Perjantai;1;1;2
94;14.11.2014;2014;11;21;Perjantai;0;3;3
94;14.11.2014;2014;11;22;Perjantai;0;1;1
94;14.11.2014;2014;11;23;Perjantai;0;0;0
94;15.11.2014;2014;11;00;Lauantai;0;0;0
94;15.11.2014;2014;11;01;Lauantai;0;0;0
94;15.11.2014;2014;11;02;Lauantai;0;0;0
94;15.11.2014;2014;11;03;Lauantai;0;0;0
94;15.11.2014;2014;11;04;Lauantai;0;0;0
94;15.11.2014;2014;11;05;Lauantai;0;0;0
94;15.11.2014;2014;11;06;Lauantai;0;0;0
94;15.11.2014;2014;11;07;Lauantai;0;1;1
94;15.11.2014;2014;11;08;Lauantai;1;0;1
94;15.11.2014;2014;11;09;Lauantai;0;1;1
94;15.11.2014;2014;11;10;Lauantai;1;0;1
94;15.11.2014;2014;11;11;Lauantai;2;2;4
94;15.11.2014;2014;11;12;Lauantai;1;1;2
94;15.11.2014;2014;11;13;Lauantai;2;1;3
94;15.11.2014;2014;11;14;Lauantai;1;1;2
94;15.11.2014;2014;11;15;Lauantai;2;3;5
94;15.11.2014;2014;11;16;Lauantai;3;1;4
94;15.11.2014;2014;11;17;Lauantai;0;1;1
94;15.11.2014;2014;11;18;Lauantai;0;0;0
94;15.11.2014;2014;11;19;Lauantai;0;1;1
94;15.11.2014;2014;11;20;Lauantai;1;0;1
94;15.11.2014;2014;11;21;Lauantai;0;0;0
94;15.11.2014;2014;11;22;Lauantai;1;1;2
94;15.11.2014;2014;11;23;Lauantai;0;0;0
94;16.11.2014;2014;11;00;Sunnuntai;0;0;0
94;16.11.2014;2014;11;01;Sunnuntai;0;0;0
94;16.11.2014;2014;11;02;Sunnuntai;0;0;0
94;16.11.2014;2014;11;03;Sunnuntai;0;0;0
94;16.11.2014;2014;11;04;Sunnuntai;0;0;0
94;16.11.2014;2014;11;05;Sunnuntai;0;0;0
94;16.11.2014;2014;11;06;Sunnuntai;0;0;0
94;16.11.2014;2014;11;07;Sunnuntai;0;0;0
94;16.11.2014;2014;11;08;Sunnuntai;1;0;1
94;16.11.2014;2014;11;09;Sunnuntai;1;0;1
94;16.11.2014;2014;11;10;Sunnuntai;0;0;0
94;16.11.2014;2014;11;11;Sunnuntai;0;3;3
94;16.11.2014;2014;11;12;Sunnuntai;1;2;3
94;16.11.2014;2014;11;13;Sunnuntai;3;2;5
94;16.11.2014;2014;11;14;Sunnuntai;4;1;5
94;16.11.2014;2014;11;15;Sunnuntai;0;2;2
94;16.11.2014;2014;11;16;Sunnuntai;0;1;1
94;16.11.2014;2014;11;17;Sunnuntai;1;1;2
94;16.11.2014;2014;11;18;Sunnuntai;0;0;0
94;16.11.2014;2014;11;19;Sunnuntai;1;2;3
94;16.11.2014;2014;11;20;Sunnuntai;3;3;6
94;16.11.2014;2014;11;21;Sunnuntai;1;0;1
94;16.11.2014;2014;11;22;Sunnuntai;1;1;2
94;16.11.2014;2014;11;23;Sunnuntai;0;0;0
94;17.11.2014;2014;11;00;Maanantai;0;0;0
94;17.11.2014;2014;11;01;Maanantai;0;0;0
94;17.11.2014;2014;11;02;Maanantai;0;0;0
94;17.11.2014;2014;11;03;Maanantai;0;0;0
94;17.11.2014;2014;11;04;Maanantai;0;0;0
94;17.11.2014;2014;11;05;Maanantai;4;0;4
94;17.11.2014;2014;11;06;Maanantai;7;0;7
94;17.11.2014;2014;11;07;Maanantai;18;1;19
94;17.11.2014;2014;11;08;Maanantai;10;0;10
94;17.11.2014;2014;11;09;Maanantai;2;1;3
94;17.11.2014;2014;11;10;Maanantai;1;0;1
94;17.11.2014;2014;11;11;Maanantai;1;0;1
94;17.11.2014;2014;11;12;Maanantai;1;0;1
94;17.11.2014;2014;11;13;Maanantai;2;2;4
94;17.11.2014;2014;11;14;Maanantai;0;3;3
94;17.11.2014;2014;11;15;Maanantai;0;11;11
94;17.11.2014;2014;11;16;Maanantai;1;10;11
94;17.11.2014;2014;11;17;Maanantai;1;13;14
94;17.11.2014;2014;11;18;Maanantai;0;5;5
94;17.11.2014;2014;11;19;Maanantai;0;2;2
94;17.11.2014;2014;11;20;Maanantai;0;2;2
94;17.11.2014;2014;11;21;Maanantai;0;0;0
94;17.11.2014;2014;11;22;Maanantai;0;1;1
94;17.11.2014;2014;11;23;Maanantai;0;0;0
94;18.11.2014;2014;11;00;Tiistai;0;0;0
94;18.11.2014;2014;11;01;Tiistai;0;0;0
94;18.11.2014;2014;11;02;Tiistai;0;0;0
94;18.11.2014;2014;11;03;Tiistai;0;0;0
94;18.11.2014;2014;11;04;Tiistai;1;0;1
94;18.11.2014;2014;11;05;Tiistai;2;0;2
94;18.11.2014;2014;11;06;Tiistai;12;1;13
94;18.11.2014;2014;11;07;Tiistai;10;1;11
94;18.11.2014;2014;11;08;Tiistai;3;1;4
94;18.11.2014;2014;11;09;Tiistai;4;1;5
94;18.11.2014;2014;11;10;Tiistai;2;0;2
94;18.11.2014;2014;11;11;Tiistai;2;0;2
94;18.11.2014;2014;11;12;Tiistai;0;2;2
94;18.11.2014;2014;11;13;Tiistai;1;0;1
94;18.11.2014;2014;11;14;Tiistai;1;4;5
94;18.11.2014;2014;11;15;Tiistai;0;8;8
94;18.11.2014;2014;11;16;Tiistai;1;14;15
94;18.11.2014;2014;11;17;Tiistai;1;4;5
94;18.11.2014;2014;11;18;Tiistai;0;1;1
94;18.11.2014;2014;11;19;Tiistai;7;2;9
94;18.11.2014;2014;11;20;Tiistai;1;1;2
94;18.11.2014;2014;11;21;Tiistai;0;2;2
94;18.11.2014;2014;11;22;Tiistai;0;1;1
94;18.11.2014;2014;11;23;Tiistai;0;0;0
94;19.11.2014;2014;11;00;Keskiviikko;0;0;0
94;19.11.2014;2014;11;01;Keskiviikko;0;0;0
94;19.11.2014;2014;11;02;Keskiviikko;0;0;0
94;19.11.2014;2014;11;03;Keskiviikko;0;0;0
94;19.11.2014;2014;11;04;Keskiviikko;1;0;1
94;19.11.2014;2014;11;05;Keskiviikko;3;0;3
94;19.11.2014;2014;11;06;Keskiviikko;11;1;12
94;19.11.2014;2014;11;07;Keskiviikko;12;0;12
94;19.11.2014;2014;11;08;Keskiviikko;8;1;9
94;19.11.2014;2014;11;09;Keskiviikko;6;5;11
94;19.11.2014;2014;11;10;Keskiviikko;1;2;3
94;19.11.2014;2014;11;11;Keskiviikko;2;1;3
94;19.11.2014;2014;11;12;Keskiviikko;4;0;4
94;19.11.2014;2014;11;13;Keskiviikko;1;2;3
94;19.11.2014;2014;11;14;Keskiviikko;1;5;6
94;19.11.2014;2014;11;15;Keskiviikko;1;8;9
94;19.11.2014;2014;11;16;Keskiviikko;2;9;11
94;19.11.2014;2014;11;17;Keskiviikko;0;8;8
94;19.11.2014;2014;11;18;Keskiviikko;3;3;6
94;19.11.2014;2014;11;19;Keskiviikko;3;2;5
94;19.11.2014;2014;11;20;Keskiviikko;1;3;4
94;19.11.2014;2014;11;21;Keskiviikko;0;2;2
94;19.11.2014;2014;11;22;Keskiviikko;0;1;1
94;19.11.2014;2014;11;23;Keskiviikko;1;0;1
94;20.11.2014;2014;11;00;Torstai;0;0;0
94;20.11.2014;2014;11;01;Torstai;0;0;0
94;20.11.2014;2014;11;02;Torstai;0;0;0
94;20.11.2014;2014;11;03;Torstai;0;0;0
94;20.11.2014;2014;11;04;Torstai;1;1;2
94;20.11.2014;2014;11;05;Torstai;3;1;4
94;20.11.2014;2014;11;06;Torstai;8;1;9
94;20.11.2014;2014;11;07;Torstai;14;0;14
94;20.11.2014;2014;11;08;Torstai;6;2;8
94;20.11.2014;2014;11;09;Torstai;1;1;2
94;20.11.2014;2014;11;10;Torstai;1;1;2
94;20.11.2014;2014;11;11;Torstai;3;2;5
94;20.11.2014;2014;11;12;Torstai;2;0;2
94;20.11.2014;2014;11;13;Torstai;0;1;1
94;20.11.2014;2014;11;14;Torstai;3;5;8
94;20.11.2014;2014;11;15;Torstai;3;11;14
94;20.11.2014;2014;11;16;Torstai;2;11;13
94;20.11.2014;2014;11;17;Torstai;0;9;9
94;20.11.2014;2014;11;18;Torstai;0;2;2
94;20.11.2014;2014;11;19;Torstai;1;0;1
94;20.11.2014;2014;11;20;Torstai;1;0;1
94;20.11.2014;2014;11;21;Torstai;0;1;1
94;20.11.2014;2014;11;22;Torstai;0;2;2
94;20.11.2014;2014;11;23;Torstai;0;0;0
94;21.11.2014;2014;11;00;Perjantai;0;0;0
94;21.11.2014;2014;11;01;Perjantai;0;1;1
94;21.11.2014;2014;11;02;Perjantai;0;0;0
94;21.11.2014;2014;11;03;Perjantai;0;0;0
94;21.11.2014;2014;11;04;Perjantai;0;0;0
94;21.11.2014;2014;11;05;Perjantai;2;1;3
94;21.11.2014;2014;11;06;Perjantai;9;2;11
94;21.11.2014;2014;11;07;Perjantai;14;2;16
94;21.11.2014;2014;11;08;Perjantai;4;0;4
94;21.11.2014;2014;11;09;Perjantai;1;1;2
94;21.11.2014;2014;11;10;Perjantai;2;0;2
94;21.11.2014;2014;11;11;Perjantai;0;1;1
94;21.11.2014;2014;11;12;Perjantai;4;0;4
94;21.11.2014;2014;11;13;Perjantai;1;2;3
94;21.11.2014;2014;11;14;Perjantai;1;4;5
94;21.11.2014;2014;11;15;Perjantai;2;7;9
94;21.11.2014;2014;11;16;Perjantai;1;6;7
94;21.11.2014;2014;11;17;Perjantai;1;5;6
94;21.11.2014;2014;11;18;Perjantai;0;1;1
94;21.11.2014;2014;11;19;Perjantai;2;1;3
94;21.11.2014;2014;11;20;Perjantai;1;1;2
94;21.11.2014;2014;11;21;Perjantai;0;0;0
94;21.11.2014;2014;11;22;Perjantai;0;1;1
94;21.11.2014;2014;11;23;Perjantai;0;0;0
94;22.11.2014;2014;11;00;Lauantai;0;0;0
94;22.11.2014;2014;11;01;Lauantai;0;1;1
94;22.11.2014;2014;11;02;Lauantai;0;0;0
94;22.11.2014;2014;11;03;Lauantai;0;0;0
94;22.11.2014;2014;11;04;Lauantai;0;0;0
94;22.11.2014;2014;11;05;Lauantai;0;0;0
94;22.11.2014;2014;11;06;Lauantai;1;2;3
94;22.11.2014;2014;11;07;Lauantai;0;0;0
94;22.11.2014;2014;11;08;Lauantai;0;1;1
94;22.11.2014;2014;11;09;Lauantai;1;1;2
94;22.11.2014;2014;11;10;Lauantai;2;0;2
94;22.11.2014;2014;11;11;Lauantai;1;0;1
94;22.11.2014;2014;11;12;Lauantai;1;2;3
94;22.11.2014;2014;11;13;Lauantai;0;1;1
94;22.11.2014;2014;11;14;Lauantai;0;2;2
94;22.11.2014;2014;11;15;Lauantai;2;2;4
94;22.11.2014;2014;11;16;Lauantai;0;0;0
94;22.11.2014;2014;11;17;Lauantai;2;2;4
94;22.11.2014;2014;11;18;Lauantai;0;1;1
94;22.11.2014;2014;11;19;Lauantai;2;0;2
94;22.11.2014;2014;11;20;Lauantai;1;0;1
94;22.11.2014;2014;11;21;Lauantai;0;0;0
94;22.11.2014;2014;11;22;Lauantai;0;1;1
94;22.11.2014;2014;11;23;Lauantai;0;1;1
94;23.11.2014;2014;11;00;Sunnuntai;0;0;0
94;23.11.2014;2014;11;01;Sunnuntai;0;0;0
94;23.11.2014;2014;11;02;Sunnuntai;0;0;0
94;23.11.2014;2014;11;03;Sunnuntai;0;0;0
94;23.11.2014;2014;11;04;Sunnuntai;0;0;0
94;23.11.2014;2014;11;05;Sunnuntai;0;0;0
94;23.11.2014;2014;11;06;Sunnuntai;0;0;0
94;23.11.2014;2014;11;07;Sunnuntai;1;2;3
94;23.11.2014;2014;11;08;Sunnuntai;0;0;0
94;23.11.2014;2014;11;09;Sunnuntai;3;2;5
94;23.11.2014;2014;11;10;Sunnuntai;1;2;3
94;23.11.2014;2014;11;11;Sunnuntai;2;0;2
94;23.11.2014;2014;11;12;Sunnuntai;0;1;1
94;23.11.2014;2014;11;13;Sunnuntai;3;1;4
94;23.11.2014;2014;11;14;Sunnuntai;2;3;5
94;23.11.2014;2014;11;15;Sunnuntai;1;2;3
94;23.11.2014;2014;11;16;Sunnuntai;1;1;2
94;23.11.2014;2014;11;17;Sunnuntai;4;0;4
94;23.11.2014;2014;11;18;Sunnuntai;2;2;4
94;23.11.2014;2014;11;19;Sunnuntai;0;0;0
94;23.11.2014;2014;11;20;Sunnuntai;1;0;1
94;23.11.2014;2014;11;21;Sunnuntai;0;0;0
94;23.11.2014;2014;11;22;Sunnuntai;1;1;2
94;23.11.2014;2014;11;23;Sunnuntai;0;0;0
94;24.11.2014;2014;11;00;Maanantai;0;0;0
94;24.11.2014;2014;11;01;Maanantai;0;0;0
94;24.11.2014;2014;11;02;Maanantai;0;0;0
94;24.11.2014;2014;11;03;Maanantai;0;0;0
94;24.11.2014;2014;11;04;Maanantai;0;0;0
94;24.11.2014;2014;11;05;Maanantai;4;1;5
94;24.11.2014;2014;11;06;Maanantai;10;0;10
94;24.11.2014;2014;11;07;Maanantai;12;2;14
94;24.11.2014;2014;11;08;Maanantai;5;0;5
94;24.11.2014;2014;11;09;Maanantai;0;1;1
94;24.11.2014;2014;11;10;Maanantai;0;3;3
94;24.11.2014;2014;11;11;Maanantai;1;0;1
94;24.11.2014;2014;11;12;Maanantai;2;4;6
94;24.11.2014;2014;11;13;Maanantai;2;0;2
94;24.11.2014;2014;11;14;Maanantai;2;2;4
94;24.11.2014;2014;11;15;Maanantai;2;7;9
94;24.11.2014;2014;11;16;Maanantai;1;12;13
94;24.11.2014;2014;11;17;Maanantai;1;8;9
94;24.11.2014;2014;11;18;Maanantai;2;6;8
94;24.11.2014;2014;11;19;Maanantai;2;1;3
94;24.11.2014;2014;11;20;Maanantai;0;1;1
94;24.11.2014;2014;11;21;Maanantai;0;1;1
94;24.11.2014;2014;11;22;Maanantai;0;3;3
94;24.11.2014;2014;11;23;Maanantai;0;0;0
94;25.11.2014;2014;11;00;Tiistai;0;0;0
94;25.11.2014;2014;11;01;Tiistai;0;0;0
94;25.11.2014;2014;11;02;Tiistai;0;0;0
94;25.11.2014;2014;11;03;Tiistai;0;0;0
94;25.11.2014;2014;11;04;Tiistai;0;0;0
94;25.11.2014;2014;11;05;Tiistai;2;0;2
94;25.11.2014;2014;11;06;Tiistai;8;0;8
94;25.11.2014;2014;11;07;Tiistai;11;0;11
94;25.11.2014;2014;11;08;Tiistai;10;0;10
94;25.11.2014;2014;11;09;Tiistai;0;0;0
94;25.11.2014;2014;11;10;Tiistai;2;0;2
94;25.11.2014;2014;11;11;Tiistai;2;0;2
94;25.11.2014;2014;11;12;Tiistai;1;0;1
94;25.11.2014;2014;11;13;Tiistai;0;1;1
94;25.11.2014;2014;11;14;Tiistai;0;5;5
94;25.11.2014;2014;11;15;Tiistai;0;8;8
94;25.11.2014;2014;11;16;Tiistai;2;6;8
94;25.11.2014;2014;11;17;Tiistai;1;11;12
94;25.11.2014;2014;11;18;Tiistai;2;2;4
94;25.11.2014;2014;11;19;Tiistai;0;2;2
94;25.11.2014;2014;11;20;Tiistai;0;0;0
94;25.11.2014;2014;11;21;Tiistai;0;0;0
94;25.11.2014;2014;11;22;Tiistai;0;2;2
94;25.11.2014;2014;11;23;Tiistai;0;0;0
94;26.11.2014;2014;11;00;Keskiviikko;0;0;0
94;26.11.2014;2014;11;01;Keskiviikko;0;0;0
94;26.11.2014;2014;11;02;Keskiviikko;0;0;0
94;26.11.2014;2014;11;03;Keskiviikko;0;0;0
94;26.11.2014;2014;11;04;Keskiviikko;0;0;0
94;26.11.2014;2014;11;05;Keskiviikko;3;0;3
94;26.11.2014;2014;11;06;Keskiviikko;6;1;7
94;26.11.2014;2014;11;07;Keskiviikko;12;0;12
94;26.11.2014;2014;11;08;Keskiviikko;6;2;8
94;26.11.2014;2014;11;09;Keskiviikko;2;1;3
94;26.11.2014;2014;11;10;Keskiviikko;3;0;3
94;26.11.2014;2014;11;11;Keskiviikko;1;0;1
94;26.11.2014;2014;11;12;Keskiviikko;1;0;1
94;26.11.2014;2014;11;13;Keskiviikko;1;4;5
94;26.11.2014;2014;11;14;Keskiviikko;1;6;7
94;26.11.2014;2014;11;15;Keskiviikko;0;5;5
94;26.11.2014;2014;11;16;Keskiviikko;2;9;11
94;26.11.2014;2014;11;17;Keskiviikko;1;6;7
94;26.11.2014;2014;11;18;Keskiviikko;0;4;4
94;26.11.2014;2014;11;19;Keskiviikko;0;4;4
94;26.11.2014;2014;11;20;Keskiviikko;0;1;1
94;26.11.2014;2014;11;21;Keskiviikko;0;1;1
94;26.11.2014;2014;11;22;Keskiviikko;1;0;1
94;26.11.2014;2014;11;23;Keskiviikko;0;0;0
94;27.11.2014;2014;11;00;Torstai;0;0;0
94;27.11.2014;2014;11;01;Torstai;0;0;0
94;27.11.2014;2014;11;02;Torstai;0;0;0
94;27.11.2014;2014;11;03;Torstai;0;0;0
94;27.11.2014;2014;11;04;Torstai;0;0;0
94;27.11.2014;2014;11;05;Torstai;5;0;5
94;27.11.2014;2014;11;06;Torstai;8;0;8
94;27.11.2014;2014;11;07;Torstai;8;0;8
94;27.11.2014;2014;11;08;Torstai;7;3;10
94;27.11.2014;2014;11;09;Torstai;1;0;1
94;27.11.2014;2014;11;10;Torstai;0;0;0
94;27.11.2014;2014;11;11;Torstai;0;1;1
94;27.11.2014;2014;11;12;Torstai;0;0;0
94;27.11.2014;2014;11;13;Torstai;1;2;3
94;27.11.2014;2014;11;14;Torstai;0;7;7
94;27.11.2014;2014;11;15;Torstai;3;6;9
94;27.11.2014;2014;11;16;Torstai;2;9;11
94;27.11.2014;2014;11;17;Torstai;1;2;3
94;27.11.2014;2014;11;18;Torstai;0;5;5
94;27.11.2014;2014;11;19;Torstai;0;2;2
94;27.11.2014;2014;11;20;Torstai;2;4;6
94;27.11.2014;2014;11;21;Torstai;0;0;0
94;27.11.2014;2014;11;22;Torstai;0;1;1
94;27.11.2014;2014;11;23;Torstai;0;0;0
94;28.11.2014;2014;11;00;Perjantai;0;0;0
94;28.11.2014;2014;11;01;Perjantai;0;0;0
94;28.11.2014;2014;11;02;Perjantai;0;0;0
94;28.11.2014;2014;11;03;Perjantai;0;0;0
94;28.11.2014;2014;11;04;Perjantai;0;0;0
94;28.11.2014;2014;11;05;Perjantai;4;0;4
94;28.11.2014;2014;11;06;Perjantai;4;1;5
94;28.11.2014;2014;11;07;Perjantai;8;0;8
94;28.11.2014;2014;11;08;Perjantai;5;0;5
94;28.11.2014;2014;11;09;Perjantai;4;0;4
94;28.11.2014;2014;11;10;Perjantai;2;0;2
94;28.11.2014;2014;11;11;Perjantai;1;2;3
94;28.11.2014;2014;11;12;Perjantai;1;1;2
94;28.11.2014;2014;11;13;Perjantai;2;3;5
94;28.11.2014;2014;11;14;Perjantai;0;4;4
94;28.11.2014;2014;11;15;Perjantai;2;4;6
94;28.11.2014;2014;11;16;Perjantai;2;6;8
94;28.11.2014;2014;11;17;Perjantai;0;4;4
94;28.11.2014;2014;11;18;Perjantai;2;1;3
94;28.11.2014;2014;11;19;Perjantai;0;2;2
94;28.11.2014;2014;11;20;Perjantai;0;0;0
94;28.11.2014;2014;11;21;Perjantai;0;1;1
94;28.11.2014;2014;11;22;Perjantai;0;2;2
94;28.11.2014;2014;11;23;Perjantai;0;0;0
94;29.11.2014;2014;11;00;Lauantai;0;2;2
94;29.11.2014;2014;11;01;Lauantai;0;0;0
94;29.11.2014;2014;11;02;Lauantai;0;0;0
94;29.11.2014;2014;11;03;Lauantai;0;0;0
94;29.11.2014;2014;11;04;Lauantai;0;0;0
94;29.11.2014;2014;11;05;Lauantai;0;0;0
94;29.11.2014;2014;11;06;Lauantai;0;0;0
94;29.11.2014;2014;11;07;Lauantai;1;0;1
94;29.11.2014;2014;11;08;Lauantai;0;0;0
94;29.11.2014;2014;11;09;Lauantai;1;1;2
94;29.11.2014;2014;11;10;Lauantai;3;3;6
94;29.11.2014;2014;11;11;Lauantai;2;2;4
94;29.11.2014;2014;11;12;Lauantai;4;2;6
94;29.11.2014;2014;11;13;Lauantai;5;1;6
94;29.11.2014;2014;11;14;Lauantai;1;0;1
94;29.11.2014;2014;11;15;Lauantai;1;0;1
94;29.11.2014;2014;11;16;Lauantai;0;0;0
94;29.11.2014;2014;11;17;Lauantai;0;2;2
94;29.11.2014;2014;11;18;Lauantai;1;1;2
94;29.11.2014;2014;11;19;Lauantai;0;1;1
94;29.11.2014;2014;11;20;Lauantai;1;2;3
94;29.11.2014;2014;11;21;Lauantai;0;0;0
94;29.11.2014;2014;11;22;Lauantai;0;1;1
94;29.11.2014;2014;11;23;Lauantai;0;2;2
94;30.11.2014;2014;11;00;Sunnuntai;0;0;0
94;30.11.2014;2014;11;01;Sunnuntai;0;0;0
94;30.11.2014;2014;11;02;Sunnuntai;0;0;0
94;30.11.2014;2014;11;03;Sunnuntai;0;0;0
94;30.11.2014;2014;11;04;Sunnuntai;1;0;1
94;30.11.2014;2014;11;05;Sunnuntai;0;0;0
94;30.11.2014;2014;11;06;Sunnuntai;0;0;0
94;30.11.2014;2014;11;07;Sunnuntai;0;0;0
94;30.11.2014;2014;11;08;Sunnuntai;0;0;0
94;30.11.2014;2014;11;09;Sunnuntai;0;1;1
94;30.11.2014;2014;11;10;Sunnuntai;1;0;1
94;30.11.2014;2014;11;11;Sunnuntai;1;1;2
94;30.11.2014;2014;11;12;Sunnuntai;1;1;2
94;30.11.2014;2014;11;13;Sunnuntai;1;4;5
94;30.11.2014;2014;11;14;Sunnuntai;0;1;1
94;30.11.2014;2014;11;15;Sunnuntai;0;0;0
94;30.11.2014;2014;11;16;Sunnuntai;3;0;3
94;30.11.2014;2014;11;17;Sunnuntai;3;0;3
94;30.11.2014;2014;11;18;Sunnuntai;1;0;1
94;30.11.2014;2014;11;19;Sunnuntai;1;2;3
94;30.11.2014;2014;11;20;Sunnuntai;0;0;0
94;30.11.2014;2014;11;21;Sunnuntai;0;0;0
94;30.11.2014;2014;11;22;Sunnuntai;0;0;0
94;30.11.2014;2014;11;23;Sunnuntai;0;0;0
94;01.12.2014;2014;12;00;Maanantai;0;0;0
94;01.12.2014;2014;12;01;Maanantai;0;0;0
94;01.12.2014;2014;12;02;Maanantai;0;0;0
94;01.12.2014;2014;12;03;Maanantai;0;0;0
94;01.12.2014;2014;12;04;Maanantai;0;0;0
94;01.12.2014;2014;12;05;Maanantai;2;0;2
94;01.12.2014;2014;12;06;Maanantai;8;1;9
94;01.12.2014;2014;12;07;Maanantai;17;1;18
94;01.12.2014;2014;12;08;Maanantai;7;0;7
94;01.12.2014;2014;12;09;Maanantai;3;1;4
94;01.12.2014;2014;12;10;Maanantai;0;0;0
94;01.12.2014;2014;12;11;Maanantai;2;0;2
94;01.12.2014;2014;12;12;Maanantai;3;1;4
94;01.12.2014;2014;12;13;Maanantai;3;3;6
94;01.12.2014;2014;12;14;Maanantai;1;3;4
94;01.12.2014;2014;12;15;Maanantai;2;10;12
94;01.12.2014;2014;12;16;Maanantai;1;13;14
94;01.12.2014;2014;12;17;Maanantai;1;8;9
94;01.12.2014;2014;12;18;Maanantai;0;2;2
94;01.12.2014;2014;12;19;Maanantai;0;2;2
94;01.12.2014;2014;12;20;Maanantai;1;1;2
94;01.12.2014;2014;12;21;Maanantai;0;2;2
94;01.12.2014;2014;12;22;Maanantai;0;1;1
94;01.12.2014;2014;12;23;Maanantai;0;0;0
94;02.12.2014;2014;12;00;Tiistai;0;0;0
94;02.12.2014;2014;12;01;Tiistai;0;0;0
94;02.12.2014;2014;12;02;Tiistai;0;0;0
94;02.12.2014;2014;12;03;Tiistai;0;0;0
94;02.12.2014;2014;12;04;Tiistai;0;0;0
94;02.12.2014;2014;12;05;Tiistai;3;0;3
94;02.12.2014;2014;12;06;Tiistai;8;1;9
94;02.12.2014;2014;12;07;Tiistai;12;0;12
94;02.12.2014;2014;12;08;Tiistai;8;0;8
94;02.12.2014;2014;12;09;Tiistai;4;1;5
94;02.12.2014;2014;12;10;Tiistai;2;2;4
94;02.12.2014;2014;12;11;Tiistai;4;0;4
94;02.12.2014;2014;12;12;Tiistai;0;0;0
94;02.12.2014;2014;12;13;Tiistai;1;3;4
94;02.12.2014;2014;12;14;Tiistai;3;7;10
94;02.12.2014;2014;12;15;Tiistai;2;6;8
94;02.12.2014;2014;12;16;Tiistai;0;9;9
94;02.12.2014;2014;12;17;Tiistai;1;9;10
94;02.12.2014;2014;12;18;Tiistai;0;4;4
94;02.12.2014;2014;12;19;Tiistai;6;1;7
94;02.12.2014;2014;12;20;Tiistai;0;0;0
94;02.12.2014;2014;12;21;Tiistai;0;3;3
94;02.12.2014;2014;12;22;Tiistai;0;0;0
94;02.12.2014;2014;12;23;Tiistai;0;0;0
94;03.12.2014;2014;12;00;Keskiviikko;0;0;0
94;03.12.2014;2014;12;01;Keskiviikko;0;0;0
94;03.12.2014;2014;12;02;Keskiviikko;0;0;0
94;03.12.2014;2014;12;03;Keskiviikko;0;0;0
94;03.12.2014;2014;12;04;Keskiviikko;0;1;1
94;03.12.2014;2014;12;05;Keskiviikko;0;1;1
94;03.12.2014;2014;12;06;Keskiviikko;12;1;13
94;03.12.2014;2014;12;07;Keskiviikko;8;0;8
94;03.12.2014;2014;12;08;Keskiviikko;8;0;8
94;03.12.2014;2014;12;09;Keskiviikko;1;1;2
94;03.12.2014;2014;12;10;Keskiviikko;1;0;1
94;03.12.2014;2014;12;11;Keskiviikko;0;1;1
94;03.12.2014;2014;12;12;Keskiviikko;1;0;1
94;03.12.2014;2014;12;13;Keskiviikko;2;3;5
94;03.12.2014;2014;12;14;Keskiviikko;0;2;2
94;03.12.2014;2014;12;15;Keskiviikko;4;8;12
94;03.12.2014;2014;12;16;Keskiviikko;1;11;12
94;03.12.2014;2014;12;17;Keskiviikko;1;3;4
94;03.12.2014;2014;12;18;Keskiviikko;2;2;4
94;03.12.2014;2014;12;19;Keskiviikko;2;1;3
94;03.12.2014;2014;12;20;Keskiviikko;0;3;3
94;03.12.2014;2014;12;21;Keskiviikko;0;2;2
94;03.12.2014;2014;12;22;Keskiviikko;0;0;0
94;03.12.2014;2014;12;23;Keskiviikko;0;0;0
94;04.12.2014;2014;12;00;Torstai;0;0;0
94;04.12.2014;2014;12;01;Torstai;0;0;0
94;04.12.2014;2014;12;02;Torstai;0;0;0
94;04.12.2014;2014;12;03;Torstai;0;0;0
94;04.12.2014;2014;12;04;Torstai;0;0;0
94;04.12.2014;2014;12;05;Torstai;3;1;4
94;04.12.2014;2014;12;06;Torstai;5;0;5
94;04.12.2014;2014;12;07;Torstai;12;0;12
94;04.12.2014;2014;12;08;Torstai;9;0;9
94;04.12.2014;2014;12;09;Torstai;5;1;6
94;04.12.2014;2014;12;10;Torstai;0;1;1
94;04.12.2014;2014;12;11;Torstai;0;4;4
94;04.12.2014;2014;12;12;Torstai;1;1;2
94;04.12.2014;2014;12;13;Torstai;0;0;0
94;04.12.2014;2014;12;14;Torstai;0;5;5
94;04.12.2014;2014;12;15;Torstai;2;9;11
94;04.12.2014;2014;12;16;Torstai;0;11;11
94;04.12.2014;2014;12;17;Torstai;2;4;6
94;04.12.2014;2014;12;18;Torstai;0;3;3
94;04.12.2014;2014;12;19;Torstai;1;1;2
94;04.12.2014;2014;12;20;Torstai;1;2;3
94;04.12.2014;2014;12;21;Torstai;0;0;0
94;04.12.2014;2014;12;22;Torstai;0;2;2
94;04.12.2014;2014;12;23;Torstai;0;0;0
94;05.12.2014;2014;12;00;Perjantai;0;0;0
94;05.12.2014;2014;12;01;Perjantai;0;0;0
94;05.12.2014;2014;12;02;Perjantai;0;0;0
94;05.12.2014;2014;12;03;Perjantai;0;0;0
94;05.12.2014;2014;12;04;Perjantai;0;0;0
94;05.12.2014;2014;12;05;Perjantai;0;2;2
94;05.12.2014;2014;12;06;Perjantai;6;1;7
94;05.12.2014;2014;12;07;Perjantai;11;0;11
94;05.12.2014;2014;12;08;Perjantai;5;1;6
94;05.12.2014;2014;12;09;Perjantai;5;1;6
94;05.12.2014;2014;12;10;Perjantai;2;0;2
94;05.12.2014;2014;12;11;Perjantai;1;2;3
94;05.12.2014;2014;12;12;Perjantai;0;1;1
94;05.12.2014;2014;12;13;Perjantai;0;0;0
94;05.12.2014;2014;12;14;Perjantai;2;9;11
94;05.12.2014;2014;12;15;Perjantai;0;10;10
94;05.12.2014;2014;12;16;Perjantai;1;3;4
94;05.12.2014;2014;12;17;Perjantai;2;3;5
94;05.12.2014;2014;12;18;Perjantai;0;1;1
94;05.12.2014;2014;12;19;Perjantai;4;2;6
94;05.12.2014;2014;12;20;Perjantai;3;0;3
94;05.12.2014;2014;12;21;Perjantai;0;4;4
94;05.12.2014;2014;12;22;Perjantai;0;1;1
94;05.12.2014;2014;12;23;Perjantai;0;0;0
94;06.12.2014;2014;12;00;Lauantai;0;0;0
94;06.12.2014;2014;12;01;Lauantai;0;0;0
94;06.12.2014;2014;12;02;Lauantai;0;0;0
94;06.12.2014;2014;12;03;Lauantai;0;0;0
94;06.12.2014;2014;12;04;Lauantai;0;0;0
94;06.12.2014;2014;12;05;Lauantai;0;0;0
94;06.12.2014;2014;12;06;Lauantai;1;1;2
94;06.12.2014;2014;12;07;Lauantai;0;0;0
94;06.12.2014;2014;12;08;Lauantai;1;1;2
94;06.12.2014;2014;12;09;Lauantai;0;0;0
94;06.12.2014;2014;12;10;Lauantai;0;1;1
94;06.12.2014;2014;12;11;Lauantai;2;0;2
94;06.12.2014;2014;12;12;Lauantai;1;3;4
94;06.12.2014;2014;12;13;Lauantai;0;1;1
94;06.12.2014;2014;12;14;Lauantai;1;1;2
94;06.12.2014;2014;12;15;Lauantai;0;2;2
94;06.12.2014;2014;12;16;Lauantai;0;5;5
94;06.12.2014;2014;12;17;Lauantai;4;1;5
94;06.12.2014;2014;12;18;Lauantai;0;1;1
94;06.12.2014;2014;12;19;Lauantai;0;1;1
94;06.12.2014;2014;12;20;Lauantai;0;0;0
94;06.12.2014;2014;12;21;Lauantai;0;0;0
94;06.12.2014;2014;12;22;Lauantai;0;0;0
94;06.12.2014;2014;12;23;Lauantai;0;0;0
94;07.12.2014;2014;12;00;Sunnuntai;0;0;0
94;07.12.2014;2014;12;01;Sunnuntai;0;0;0
94;07.12.2014;2014;12;02;Sunnuntai;0;0;0
94;07.12.2014;2014;12;03;Sunnuntai;0;0;0
94;07.12.2014;2014;12;04;Sunnuntai;0;0;0
94;07.12.2014;2014;12;05;Sunnuntai;0;0;0
94;07.12.2014;2014;12;06;Sunnuntai;0;0;0
94;07.12.2014;2014;12;07;Sunnuntai;2;1;3
94;07.12.2014;2014;12;08;Sunnuntai;2;1;3
94;07.12.2014;2014;12;09;Sunnuntai;2;0;2
94;07.12.2014;2014;12;10;Sunnuntai;0;1;1
94;07.12.2014;2014;12;11;Sunnuntai;2;4;6
94;07.12.2014;2014;12;12;Sunnuntai;2;1;3
94;07.12.2014;2014;12;13;Sunnuntai;2;1;3
94;07.12.2014;2014;12;14;Sunnuntai;0;0;0
94;07.12.2014;2014;12;15;Sunnuntai;0;2;2
94;07.12.2014;2014;12;16;Sunnuntai;2;0;2
94;07.12.2014;2014;12;17;Sunnuntai;0;1;1
94;07.12.2014;2014;12;18;Sunnuntai;1;0;1
94;07.12.2014;2014;12;19;Sunnuntai;3;2;5
94;07.12.2014;2014;12;20;Sunnuntai;1;0;1
94;07.12.2014;2014;12;21;Sunnuntai;1;0;1
94;07.12.2014;2014;12;22;Sunnuntai;0;0;0
94;07.12.2014;2014;12;23;Sunnuntai;0;0;0
94;08.12.2014;2014;12;00;Maanantai;0;0;0
94;08.12.2014;2014;12;01;Maanantai;0;0;0
94;08.12.2014;2014;12;02;Maanantai;0;0;0
94;08.12.2014;2014;12;03;Maanantai;0;0;0
94;08.12.2014;2014;12;04;Maanantai;0;0;0
94;08.12.2014;2014;12;05;Maanantai;1;0;1
94;08.12.2014;2014;12;06;Maanantai;5;0;5
94;08.12.2014;2014;12;07;Maanantai;9;3;12
94;08.12.2014;2014;12;08;Maanantai;9;1;10
94;08.12.2014;2014;12;09;Maanantai;1;2;3
94;08.12.2014;2014;12;10;Maanantai;2;0;2
94;08.12.2014;2014;12;11;Maanantai;0;0;0
94;08.12.2014;2014;12;12;Maanantai;0;0;0
94;08.12.2014;2014;12;13;Maanantai;0;1;1
94;08.12.2014;2014;12;14;Maanantai;1;3;4
94;08.12.2014;2014;12;15;Maanantai;1;3;4
94;08.12.2014;2014;12;16;Maanantai;3;14;17
94;08.12.2014;2014;12;17;Maanantai;2;5;7
94;08.12.2014;2014;12;18;Maanantai;0;4;4
94;08.12.2014;2014;12;19;Maanantai;0;0;0
94;08.12.2014;2014;12;20;Maanantai;0;0;0
94;08.12.2014;2014;12;21;Maanantai;0;0;0
94;08.12.2014;2014;12;22;Maanantai;0;0;0
94;08.12.2014;2014;12;23;Maanantai;0;0;0
94;09.12.2014;2014;12;00;Tiistai;0;0;0
94;09.12.2014;2014;12;01;Tiistai;0;0;0
94;09.12.2014;2014;12;02;Tiistai;0;0;0
94;09.12.2014;2014;12;03;Tiistai;0;0;0
94;09.12.2014;2014;12;04;Tiistai;0;0;0
94;09.12.2014;2014;12;05;Tiistai;2;0;2
94;09.12.2014;2014;12;06;Tiistai;9;0;9
94;09.12.2014;2014;12;07;Tiistai;12;1;13
94;09.12.2014;2014;12;08;Tiistai;6;0;6
94;09.12.2014;2014;12;09;Tiistai;3;3;6
94;09.12.2014;2014;12;10;Tiistai;2;1;3
94;09.12.2014;2014;12;11;Tiistai;2;2;4
94;09.12.2014;2014;12;12;Tiistai;2;0;2
94;09.12.2014;2014;12;13;Tiistai;4;6;10
94;09.12.2014;2014;12;14;Tiistai;1;4;5
94;09.12.2014;2014;12;15;Tiistai;0;6;6
94;09.12.2014;2014;12;16;Tiistai;4;9;13
94;09.12.2014;2014;12;17;Tiistai;0;4;4
94;09.12.2014;2014;12;18;Tiistai;0;6;6
94;09.12.2014;2014;12;19;Tiistai;0;0;0
94;09.12.2014;2014;12;20;Tiistai;0;1;1
94;09.12.2014;2014;12;21;Tiistai;0;1;1
94;09.12.2014;2014;12;22;Tiistai;0;4;4
94;09.12.2014;2014;12;23;Tiistai;0;0;0
94;10.12.2014;2014;12;00;Keskiviikko;0;0;0
94;10.12.2014;2014;12;01;Keskiviikko;0;0;0
94;10.12.2014;2014;12;02;Keskiviikko;0;0;0
94;10.12.2014;2014;12;03;Keskiviikko;0;0;0
94;10.12.2014;2014;12;04;Keskiviikko;2;0;2
94;10.12.2014;2014;12;05;Keskiviikko;4;0;4
94;10.12.2014;2014;12;06;Keskiviikko;8;0;8
94;10.12.2014;2014;12;07;Keskiviikko;4;0;4
94;10.12.2014;2014;12;08;Keskiviikko;9;0;9
94;10.12.2014;2014;12;09;Keskiviikko;1;1;2
94;10.12.2014;2014;12;10;Keskiviikko;0;0;0
94;10.12.2014;2014;12;11;Keskiviikko;1;2;3
94;10.12.2014;2014;12;12;Keskiviikko;3;3;6
94;10.12.2014;2014;12;13;Keskiviikko;0;1;1
94;10.12.2014;2014;12;14;Keskiviikko;3;4;7
94;10.12.2014;2014;12;15;Keskiviikko;1;8;9
94;10.12.2014;2014;12;16;Keskiviikko;0;5;5
94;10.12.2014;2014;12;17;Keskiviikko;1;2;3
94;10.12.2014;2014;12;18;Keskiviikko;0;4;4
94;10.12.2014;2014;12;19;Keskiviikko;0;1;1
94;10.12.2014;2014;12;20;Keskiviikko;1;0;1
94;10.12.2014;2014;12;21;Keskiviikko;0;1;1
94;10.12.2014;2014;12;22;Keskiviikko;0;1;1
94;10.12.2014;2014;12;23;Keskiviikko;0;0;0
94;11.12.2014;2014;12;00;Torstai;0;0;0
94;11.12.2014;2014;12;01;Torstai;0;0;0
94;11.12.2014;2014;12;02;Torstai;0;0;0
94;11.12.2014;2014;12;03;Torstai;0;0;0
94;11.12.2014;2014;12;04;Torstai;0;0;0
94;11.12.2014;2014;12;05;Torstai;3;0;3
94;11.12.2014;2014;12;06;Torstai;5;0;5
94;11.12.2014;2014;12;07;Torstai;9;1;10
94;11.12.2014;2014;12;08;Torstai;3;0;3
94;11.12.2014;2014;12;09;Torstai;1;0;1
94;11.12.2014;2014;12;10;Torstai;1;0;1
94;11.12.2014;2014;12;11;Torstai;1;1;2
94;11.12.2014;2014;12;12;Torstai;2;1;3
94;11.12.2014;2014;12;13;Torstai;1;1;2
94;11.12.2014;2014;12;14;Torstai;0;3;3
94;11.12.2014;2014;12;15;Torstai;0;12;12
94;11.12.2014;2014;12;16;Torstai;1;9;10
94;11.12.2014;2014;12;17;Torstai;1;3;4
94;11.12.2014;2014;12;18;Torstai;0;1;1
94;11.12.2014;2014;12;19;Torstai;1;2;3
94;11.12.2014;2014;12;20;Torstai;2;1;3
94;11.12.2014;2014;12;21;Torstai;0;0;0
94;11.12.2014;2014;12;22;Torstai;0;2;2
94;11.12.2014;2014;12;23;Torstai;0;0;0
94;12.12.2014;2014;12;00;Perjantai;0;0;0
94;12.12.2014;2014;12;01;Perjantai;0;0;0
94;12.12.2014;2014;12;02;Perjantai;0;0;0
94;12.12.2014;2014;12;03;Perjantai;0;0;0
94;12.12.2014;2014;12;04;Perjantai;0;0;0
94;12.12.2014;2014;12;05;Perjantai;3;0;3
94;12.12.2014;2014;12;06;Perjantai;4;0;4
94;12.12.2014;2014;12;07;Perjantai;10;1;11
94;12.12.2014;2014;12;08;Perjantai;5;0;5
94;12.12.2014;2014;12;09;Perjantai;0;0;0
94;12.12.2014;2014;12;10;Perjantai;2;0;2
94;12.12.2014;2014;12;11;Perjantai;2;1;3
94;12.12.2014;2014;12;12;Perjantai;0;2;2
94;12.12.2014;2014;12;13;Perjantai;1;0;1
94;12.12.2014;2014;12;14;Perjantai;0;2;2
94;12.12.2014;2014;12;15;Perjantai;1;5;6
94;12.12.2014;2014;12;16;Perjantai;2;4;6
94;12.12.2014;2014;12;17;Perjantai;3;9;12
94;12.12.2014;2014;12;18;Perjantai;1;0;1
94;12.12.2014;2014;12;19;Perjantai;3;4;7
94;12.12.2014;2014;12;20;Perjantai;1;5;6
94;12.12.2014;2014;12;21;Perjantai;2;0;2
94;12.12.2014;2014;12;22;Perjantai;0;0;0
94;12.12.2014;2014;12;23;Perjantai;0;0;0
94;13.12.2014;2014;12;00;Lauantai;0;0;0
94;13.12.2014;2014;12;01;Lauantai;0;0;0
94;13.12.2014;2014;12;02;Lauantai;0;0;0
94;13.12.2014;2014;12;03;Lauantai;0;1;1
94;13.12.2014;2014;12;04;Lauantai;0;1;1
94;13.12.2014;2014;12;05;Lauantai;0;0;0
94;13.12.2014;2014;12;06;Lauantai;1;0;1
94;13.12.2014;2014;12;07;Lauantai;0;1;1
94;13.12.2014;2014;12;08;Lauantai;1;2;3
94;13.12.2014;2014;12;09;Lauantai;1;2;3
94;13.12.2014;2014;12;10;Lauantai;4;0;4
94;13.12.2014;2014;12;11;Lauantai;2;0;2
94;13.12.2014;2014;12;12;Lauantai;1;0;1
94;13.12.2014;2014;12;13;Lauantai;0;2;2
94;13.12.2014;2014;12;14;Lauantai;3;3;6
94;13.12.2014;2014;12;15;Lauantai;1;3;4
94;13.12.2014;2014;12;16;Lauantai;0;0;0
94;13.12.2014;2014;12;17;Lauantai;1;0;1
94;13.12.2014;2014;12;18;Lauantai;0;2;2
94;13.12.2014;2014;12;19;Lauantai;0;1;1
94;13.12.2014;2014;12;20;Lauantai;0;0;0
94;13.12.2014;2014;12;21;Lauantai;0;0;0
94;13.12.2014;2014;12;22;Lauantai;0;0;0
94;13.12.2014;2014;12;23;Lauantai;0;0;0
94;14.12.2014;2014;12;00;Sunnuntai;0;0;0
94;14.12.2014;2014;12;01;Sunnuntai;0;0;0
94;14.12.2014;2014;12;02;Sunnuntai;0;0;0
94;14.12.2014;2014;12;03;Sunnuntai;0;0;0
94;14.12.2014;2014;12;04;Sunnuntai;0;0;0
94;14.12.2014;2014;12;05;Sunnuntai;1;1;2
94;14.12.2014;2014;12;06;Sunnuntai;0;0;0
94;14.12.2014;2014;12;07;Sunnuntai;0;1;1
94;14.12.2014;2014;12;08;Sunnuntai;0;0;0
94;14.12.2014;2014;12;09;Sunnuntai;2;1;3
94;14.12.2014;2014;12;10;Sunnuntai;0;0;0
94;14.12.2014;2014;12;11;Sunnuntai;3;2;5
94;14.12.2014;2014;12;12;Sunnuntai;0;0;0
94;14.12.2014;2014;12;13;Sunnuntai;3;1;4
94;14.12.2014;2014;12;14;Sunnuntai;0;0;0
94;14.12.2014;2014;12;15;Sunnuntai;1;4;5
94;14.12.2014;2014;12;16;Sunnuntai;2;1;3
94;14.12.2014;2014;12;17;Sunnuntai;1;0;1
94;14.12.2014;2014;12;18;Sunnuntai;0;0;0
94;14.12.2014;2014;12;19;Sunnuntai;2;0;2
94;14.12.2014;2014;12;20;Sunnuntai;0;0;0
94;14.12.2014;2014;12;21;Sunnuntai;0;0;0
94;14.12.2014;2014;12;22;Sunnuntai;0;0;0
94;14.12.2014;2014;12;23;Sunnuntai;0;0;0
94;15.12.2014;2014;12;00;Maanantai;0;0;0
94;15.12.2014;2014;12;01;Maanantai;0;0;0
94;15.12.2014;2014;12;02;Maanantai;0;0;0
94;15.12.2014;2014;12;03;Maanantai;0;0;0
94;15.12.2014;2014;12;04;Maanantai;0;0;0
94;15.12.2014;2014;12;05;Maanantai;1;1;2
94;15.12.2014;2014;12;06;Maanantai;10;0;10
94;15.12.2014;2014;12;07;Maanantai;12;1;13
94;15.12.2014;2014;12;08;Maanantai;6;0;6
94;15.12.2014;2014;12;09;Maanantai;3;1;4
94;15.12.2014;2014;12;10;Maanantai;1;0;1
94;15.12.2014;2014;12;11;Maanantai;2;0;2
94;15.12.2014;2014;12;12;Maanantai;0;0;0
94;15.12.2014;2014;12;13;Maanantai;0;1;1
94;15.12.2014;2014;12;14;Maanantai;3;1;4
94;15.12.2014;2014;12;15;Maanantai;0;8;8
94;15.12.2014;2014;12;16;Maanantai;0;8;8
94;15.12.2014;2014;12;17;Maanantai;2;11;13
94;15.12.2014;2014;12;18;Maanantai;0;2;2
94;15.12.2014;2014;12;19;Maanantai;0;1;1
94;15.12.2014;2014;12;20;Maanantai;0;1;1
94;15.12.2014;2014;12;21;Maanantai;0;0;0
94;15.12.2014;2014;12;22;Maanantai;0;0;0
94;15.12.2014;2014;12;23;Maanantai;0;0;0
94;16.12.2014;2014;12;00;Tiistai;0;0;0
94;16.12.2014;2014;12;01;Tiistai;0;0;0
94;16.12.2014;2014;12;02;Tiistai;0;0;0
94;16.12.2014;2014;12;03;Tiistai;0;0;0
94;16.12.2014;2014;12;04;Tiistai;0;0;0
94;16.12.2014;2014;12;05;Tiistai;2;0;2
94;16.12.2014;2014;12;06;Tiistai;7;1;8
94;16.12.2014;2014;12;07;Tiistai;12;1;13
94;16.12.2014;2014;12;08;Tiistai;6;3;9
94;16.12.2014;2014;12;09;Tiistai;0;1;1
94;16.12.2014;2014;12;10;Tiistai;0;0;0
94;16.12.2014;2014;12;11;Tiistai;0;0;0
94;16.12.2014;2014;12;12;Tiistai;2;0;2
94;16.12.2014;2014;12;13;Tiistai;1;0;1
94;16.12.2014;2014;12;14;Tiistai;1;3;4
94;16.12.2014;2014;12;15;Tiistai;0;7;7
94;16.12.2014;2014;12;16;Tiistai;3;10;13
94;16.12.2014;2014;12;17;Tiistai;0;8;8
94;16.12.2014;2014;12;18;Tiistai;1;4;5
94;16.12.2014;2014;12;19;Tiistai;0;0;0
94;16.12.2014;2014;12;20;Tiistai;1;0;1
94;16.12.2014;2014;12;21;Tiistai;0;0;0
94;16.12.2014;2014;12;22;Tiistai;0;0;0
94;16.12.2014;2014;12;23;Tiistai;0;0;0
94;17.12.2014;2014;12;00;Keskiviikko;0;0;0
94;17.12.2014;2014;12;01;Keskiviikko;0;0;0
94;17.12.2014;2014;12;02;Keskiviikko;0;0;0
94;17.12.2014;2014;12;03;Keskiviikko;0;0;0
94;17.12.2014;2014;12;04;Keskiviikko;0;0;0
94;17.12.2014;2014;12;05;Keskiviikko;1;1;2
94;17.12.2014;2014;12;06;Keskiviikko;8;1;9
94;17.12.2014;2014;12;07;Keskiviikko;10;0;10
94;17.12.2014;2014;12;08;Keskiviikko;5;0;5
94;17.12.2014;2014;12;09;Keskiviikko;1;1;2
94;17.12.2014;2014;12;10;Keskiviikko;0;1;1
94;17.12.2014;2014;12;11;Keskiviikko;1;1;2
94;17.12.2014;2014;12;12;Keskiviikko;1;0;1
94;17.12.2014;2014;12;13;Keskiviikko;2;3;5
94;17.12.2014;2014;12;14;Keskiviikko;0;3;3
94;17.12.2014;2014;12;15;Keskiviikko;2;9;11
94;17.12.2014;2014;12;16;Keskiviikko;0;7;7
94;17.12.2014;2014;12;17;Keskiviikko;3;7;10
94;17.12.2014;2014;12;18;Keskiviikko;0;2;2
94;17.12.2014;2014;12;19;Keskiviikko;2;1;3
94;17.12.2014;2014;12;20;Keskiviikko;2;0;2
94;17.12.2014;2014;12;21;Keskiviikko;0;1;1
94;17.12.2014;2014;12;22;Keskiviikko;0;2;2
94;17.12.2014;2014;12;23;Keskiviikko;0;0;0
94;18.12.2014;2014;12;00;Torstai;0;0;0
94;18.12.2014;2014;12;01;Torstai;0;0;0
94;18.12.2014;2014;12;02;Torstai;0;1;1
94;18.12.2014;2014;12;03;Torstai;0;0;0
94;18.12.2014;2014;12;04;Torstai;1;0;1
94;18.12.2014;2014;12;05;Torstai;1;1;2
94;18.12.2014;2014;12;06;Torstai;5;1;6
94;18.12.2014;2014;12;07;Torstai;14;0;14
94;18.12.2014;2014;12;08;Torstai;6;0;6
94;18.12.2014;2014;12;09;Torstai;0;1;1
94;18.12.2014;2014;12;10;Torstai;0;1;1
94;18.12.2014;2014;12;11;Torstai;1;0;1
94;18.12.2014;2014;12;12;Torstai;0;3;3
94;18.12.2014;2014;12;13;Torstai;1;0;1
94;18.12.2014;2014;12;14;Torstai;4;2;6
94;18.12.2014;2014;12;15;Torstai;1;7;8
94;18.12.2014;2014;12;16;Torstai;1;11;12
94;18.12.2014;2014;12;17;Torstai;2;8;10
94;18.12.2014;2014;12;18;Torstai;1;1;2
94;18.12.2014;2014;12;19;Torstai;0;3;3
94;18.12.2014;2014;12;20;Torstai;1;0;1
94;18.12.2014;2014;12;21;Torstai;1;0;1
94;18.12.2014;2014;12;22;Torstai;0;2;2
94;18.12.2014;2014;12;23;Torstai;0;0;0
94;19.12.2014;2014;12;00;Perjantai;0;0;0
94;19.12.2014;2014;12;01;Perjantai;0;0;0
94;19.12.2014;2014;12;02;Perjantai;0;0;0
94;19.12.2014;2014;12;03;Perjantai;0;0;0
94;19.12.2014;2014;12;04;Perjantai;1;0;1
94;19.12.2014;2014;12;05;Perjantai;2;1;3
94;19.12.2014;2014;12;06;Perjantai;3;0;3
94;19.12.2014;2014;12;07;Perjantai;10;1;11
94;19.12.2014;2014;12;08;Perjantai;7;0;7
94;19.12.2014;2014;12;09;Perjantai;0;0;0
94;19.12.2014;2014;12;10;Perjantai;4;0;4
94;19.12.2014;2014;12;11;Perjantai;1;1;2
94;19.12.2014;2014;12;12;Perjantai;0;4;4
94;19.12.2014;2014;12;13;Perjantai;1;5;6
94;19.12.2014;2014;12;14;Perjantai;1;2;3
94;19.12.2014;2014;12;15;Perjantai;1;8;9
94;19.12.2014;2014;12;16;Perjantai;0;4;4
94;19.12.2014;2014;12;17;Perjantai;0;3;3
94;19.12.2014;2014;12;18;Perjantai;2;2;4
94;19.12.2014;2014;12;19;Perjantai;0;3;3
94;19.12.2014;2014;12;20;Perjantai;0;0;0
94;19.12.2014;2014;12;21;Perjantai;0;0;0
94;19.12.2014;2014;12;22;Perjantai;0;1;1
94;19.12.2014;2014;12;23;Perjantai;0;0;0
94;20.12.2014;2014;12;00;Lauantai;0;0;0
94;20.12.2014;2014;12;01;Lauantai;0;0;0
94;20.12.2014;2014;12;02;Lauantai;0;0;0
94;20.12.2014;2014;12;03;Lauantai;0;0;0
94;20.12.2014;2014;12;04;Lauantai;0;0;0
94;20.12.2014;2014;12;05;Lauantai;1;1;2
94;20.12.2014;2014;12;06;Lauantai;1;0;1
94;20.12.2014;2014;12;07;Lauantai;0;0;0
94;20.12.2014;2014;12;08;Lauantai;0;2;2
94;20.12.2014;2014;12;09;Lauantai;0;0;0
94;20.12.2014;2014;12;10;Lauantai;3;3;6
94;20.12.2014;2014;12;11;Lauantai;1;2;3
94;20.12.2014;2014;12;12;Lauantai;2;0;2
94;20.12.2014;2014;12;13;Lauantai;0;0;0
94;20.12.2014;2014;12;14;Lauantai;0;0;0
94;20.12.2014;2014;12;15;Lauantai;0;0;0
94;20.12.2014;2014;12;16;Lauantai;0;2;2
94;20.12.2014;2014;12;17;Lauantai;2;1;3
94;20.12.2014;2014;12;18;Lauantai;1;0;1
94;20.12.2014;2014;12;19;Lauantai;0;0;0
94;20.12.2014;2014;12;20;Lauantai;1;2;3
94;20.12.2014;2014;12;21;Lauantai;0;1;1
94;20.12.2014;2014;12;22;Lauantai;0;0;0
94;20.12.2014;2014;12;23;Lauantai;0;1;1
94;21.12.2014;2014;12;00;Sunnuntai;0;0;0
94;21.12.2014;2014;12;01;Sunnuntai;0;0;0
94;21.12.2014;2014;12;02;Sunnuntai;0;0;0
94;21.12.2014;2014;12;03;Sunnuntai;0;0;0
94;21.12.2014;2014;12;04;Sunnuntai;0;0;0
94;21.12.2014;2014;12;05;Sunnuntai;0;0;0
94;21.12.2014;2014;12;06;Sunnuntai;0;0;0
94;21.12.2014;2014;12;07;Sunnuntai;1;1;2
94;21.12.2014;2014;12;08;Sunnuntai;2;1;3
94;21.12.2014;2014;12;09;Sunnuntai;2;0;2
94;21.12.2014;2014;12;10;Sunnuntai;0;0;0
94;21.12.2014;2014;12;11;Sunnuntai;0;0;0
94;21.12.2014;2014;12;12;Sunnuntai;3;0;3
94;21.12.2014;2014;12;13;Sunnuntai;0;1;1
94;21.12.2014;2014;12;14;Sunnuntai;0;2;2
94;21.12.2014;2014;12;15;Sunnuntai;2;1;3
94;21.12.2014;2014;12;16;Sunnuntai;0;1;1
94;21.12.2014;2014;12;17;Sunnuntai;0;0;0
94;21.12.2014;2014;12;18;Sunnuntai;2;2;4
94;21.12.2014;2014;12;19;Sunnuntai;0;1;1
94;21.12.2014;2014;12;20;Sunnuntai;1;0;1
94;21.12.2014;2014;12;21;Sunnuntai;0;0;0
94;21.12.2014;2014;12;22;Sunnuntai;0;2;2
94;21.12.2014;2014;12;23;Sunnuntai;0;0;0
94;22.12.2014;2014;12;00;Maanantai;0;0;0
94;22.12.2014;2014;12;01;Maanantai;0;0;0
94;22.12.2014;2014;12;02;Maanantai;0;0;0
94;22.12.2014;2014;12;03;Maanantai;0;0;0
94;22.12.2014;2014;12;04;Maanantai;0;0;0
94;22.12.2014;2014;12;05;Maanantai;1;0;1
94;22.12.2014;2014;12;06;Maanantai;4;1;5
94;22.12.2014;2014;12;07;Maanantai;5;0;5
94;22.12.2014;2014;12;08;Maanantai;4;0;4
94;22.12.2014;2014;12;09;Maanantai;0;1;1
94;22.12.2014;2014;12;10;Maanantai;0;0;0
94;22.12.2014;2014;12;11;Maanantai;0;0;0
94;22.12.2014;2014;12;12;Maanantai;4;0;4
94;22.12.2014;2014;12;13;Maanantai;0;3;3
94;22.12.2014;2014;12;14;Maanantai;1;3;4
94;22.12.2014;2014;12;15;Maanantai;0;3;3
94;22.12.2014;2014;12;16;Maanantai;1;2;3
94;22.12.2014;2014;12;17;Maanantai;1;7;8
94;22.12.2014;2014;12;18;Maanantai;1;0;1
94;22.12.2014;2014;12;19;Maanantai;1;0;1
94;22.12.2014;2014;12;20;Maanantai;1;2;3
94;22.12.2014;2014;12;21;Maanantai;0;0;0
94;22.12.2014;2014;12;22;Maanantai;0;1;1
94;22.12.2014;2014;12;23;Maanantai;0;1;1
94;23.12.2014;2014;12;00;Tiistai;0;0;0
94;23.12.2014;2014;12;01;Tiistai;0;0;0
94;23.12.2014;2014;12;02;Tiistai;0;0;0
94;23.12.2014;2014;12;03;Tiistai;0;0;0
94;23.12.2014;2014;12;04;Tiistai;0;0;0
94;23.12.2014;2014;12;05;Tiistai;0;0;0
94;23.12.2014;2014;12;06;Tiistai;2;0;2
94;23.12.2014;2014;12;07;Tiistai;2;0;2
94;23.12.2014;2014;12;08;Tiistai;0;0;0
94;23.12.2014;2014;12;09;Tiistai;0;0;0
94;23.12.2014;2014;12;10;Tiistai;0;0;0
94;23.12.2014;2014;12;11;Tiistai;0;0;0
94;23.12.2014;2014;12;12;Tiistai;0;0;0
94;23.12.2014;2014;12;13;Tiistai;1;2;3
94;23.12.2014;2014;12;14;Tiistai;0;1;1
94;23.12.2014;2014;12;15;Tiistai;1;1;2
94;23.12.2014;2014;12;16;Tiistai;0;1;1
94;23.12.2014;2014;12;17;Tiistai;0;0;0
94;23.12.2014;2014;12;18;Tiistai;0;1;1
94;23.12.2014;2014;12;19;Tiistai;1;0;1
94;23.12.2014;2014;12;20;Tiistai;1;1;2
94;23.12.2014;2014;12;21;Tiistai;0;1;1
94;23.12.2014;2014;12;22;Tiistai;1;0;1
94;23.12.2014;2014;12;23;Tiistai;0;0;0
94;24.12.2014;2014;12;00;Keskiviikko;0;1;1
94;24.12.2014;2014;12;01;Keskiviikko;1;0;1
94;24.12.2014;2014;12;02;Keskiviikko;0;0;0
94;24.12.2014;2014;12;03;Keskiviikko;0;0;0
94;24.12.2014;2014;12;04;Keskiviikko;0;0;0
94;24.12.2014;2014;12;05;Keskiviikko;0;0;0
94;24.12.2014;2014;12;06;Keskiviikko;0;0;0
94;24.12.2014;2014;12;07;Keskiviikko;0;1;1
94;24.12.2014;2014;12;08;Keskiviikko;0;0;0
94;24.12.2014;2014;12;09;Keskiviikko;0;0;0
94;24.12.2014;2014;12;10;Keskiviikko;0;0;0
94;24.12.2014;2014;12;11;Keskiviikko;0;0;0
94;24.12.2014;2014;12;12;Keskiviikko;0;1;1
94;24.12.2014;2014;12;13;Keskiviikko;0;0;0
94;24.12.2014;2014;12;14;Keskiviikko;0;0;0
94;24.12.2014;2014;12;15;Keskiviikko;0;0;0
94;24.12.2014;2014;12;16;Keskiviikko;1;0;1
94;24.12.2014;2014;12;17;Keskiviikko;0;0;0
94;24.12.2014;2014;12;18;Keskiviikko;0;0;0
94;24.12.2014;2014;12;19;Keskiviikko;1;0;1
94;24.12.2014;2014;12;20;Keskiviikko;0;0;0
94;24.12.2014;2014;12;21;Keskiviikko;0;0;0
94;24.12.2014;2014;12;22;Keskiviikko;0;0;0
94;24.12.2014;2014;12;23;Keskiviikko;0;0;0
94;25.12.2014;2014;12;00;Torstai;0;0;0
94;25.12.2014;2014;12;01;Torstai;0;0;0
94;25.12.2014;2014;12;02;Torstai;0;0;0
94;25.12.2014;2014;12;03;Torstai;0;0;0
94;25.12.2014;2014;12;04;Torstai;0;0;0
94;25.12.2014;2014;12;05;Torstai;0;0;0
94;25.12.2014;2014;12;06;Torstai;0;0;0
94;25.12.2014;2014;12;07;Torstai;0;1;1
94;25.12.2014;2014;12;08;Torstai;0;0;0
94;25.12.2014;2014;12;09;Torstai;0;0;0
94;25.12.2014;2014;12;10;Torstai;0;1;1
94;25.12.2014;2014;12;11;Torstai;0;0;0
94;25.12.2014;2014;12;12;Torstai;0;1;1
94;25.12.2014;2014;12;13;Torstai;0;0;0
94;25.12.2014;2014;12;14;Torstai;0;0;0
94;25.12.2014;2014;12;15;Torstai;1;1;2
94;25.12.2014;2014;12;16;Torstai;0;1;1
94;25.12.2014;2014;12;17;Torstai;0;0;0
94;25.12.2014;2014;12;18;Torstai;0;0;0
94;25.12.2014;2014;12;19;Torstai;1;0;1
94;25.12.2014;2014;12;20;Torstai;0;2;2
94;25.12.2014;2014;12;21;Torstai;1;0;1
94;25.12.2014;2014;12;22;Torstai;0;0;0
94;25.12.2014;2014;12;23;Torstai;0;0;0
94;26.12.2014;2014;12;00;Perjantai;0;0;0
94;26.12.2014;2014;12;01;Perjantai;0;0;0
94;26.12.2014;2014;12;02;Perjantai;0;0;0
94;26.12.2014;2014;12;03;Perjantai;0;0;0
94;26.12.2014;2014;12;04;Perjantai;0;0;0
94;26.12.2014;2014;12;05;Perjantai;0;0;0
94;26.12.2014;2014;12;06;Perjantai;0;0;0
94;26.12.2014;2014;12;07;Perjantai;0;0;0
94;26.12.2014;2014;12;08;Perjantai;0;0;0
94;26.12.2014;2014;12;09;Perjantai;1;1;2
94;26.12.2014;2014;12;10;Perjantai;0;1;1
94;26.12.2014;2014;12;11;Perjantai;1;0;1
94;26.12.2014;2014;12;12;Perjantai;0;0;0
94;26.12.2014;2014;12;13;Perjantai;0;0;0
94;26.12.2014;2014;12;14;Perjantai;1;0;1
94;26.12.2014;2014;12;15;Perjantai;1;0;1
94;26.12.2014;2014;12;16;Perjantai;0;0;0
94;26.12.2014;2014;12;17;Perjantai;1;0;1
94;26.12.2014;2014;12;18;Perjantai;0;0;0
94;26.12.2014;2014;12;19;Perjantai;0;0;0
94;26.12.2014;2014;12;20;Perjantai;0;0;0
94;26.12.2014;2014;12;21;Perjantai;0;0;0
94;26.12.2014;2014;12;22;Perjantai;0;0;0
94;26.12.2014;2014;12;23;Perjantai;0;0;0
94;27.12.2014;2014;12;00;Lauantai;0;0;0
94;27.12.2014;2014;12;01;Lauantai;0;0;0
94;27.12.2014;2014;12;02;Lauantai;0;0;0
94;27.12.2014;2014;12;03;Lauantai;0;0;0
94;27.12.2014;2014;12;04;Lauantai;0;0;0
94;27.12.2014;2014;12;05;Lauantai;0;0;0
94;27.12.2014;2014;12;06;Lauantai;0;0;0
94;27.12.2014;2014;12;07;Lauantai;0;0;0
94;27.12.2014;2014;12;08;Lauantai;0;0;0
94;27.12.2014;2014;12;09;Lauantai;0;0;0
94;27.12.2014;2014;12;10;Lauantai;1;0;1
94;27.12.2014;2014;12;11;Lauantai;1;0;1
94;27.12.2014;2014;12;12;Lauantai;0;0;0
94;27.12.2014;2014;12;13;Lauantai;0;1;1
94;27.12.2014;2014;12;14;Lauantai;0;1;1
94;27.12.2014;2014;12;15;Lauantai;1;1;2
94;27.12.2014;2014;12;16;Lauantai;1;0;1
94;27.12.2014;2014;12;17;Lauantai;0;1;1
94;27.12.2014;2014;12;18;Lauantai;0;0;0
94;27.12.2014;2014;12;19;Lauantai;0;0;0
94;27.12.2014;2014;12;20;Lauantai;0;1;1
94;27.12.2014;2014;12;21;Lauantai;1;0;1
94;27.12.2014;2014;12;22;Lauantai;0;1;1
94;27.12.2014;2014;12;23;Lauantai;0;0;0
94;28.12.2014;2014;12;00;Sunnuntai;0;0;0
94;28.12.2014;2014;12;01;Sunnuntai;0;0;0
94;28.12.2014;2014;12;02;Sunnuntai;0;0;0
94;28.12.2014;2014;12;03;Sunnuntai;0;0;0
94;28.12.2014;2014;12;04;Sunnuntai;0;0;0
94;28.12.2014;2014;12;05;Sunnuntai;0;0;0
94;28.12.2014;2014;12;06;Sunnuntai;0;0;0
94;28.12.2014;2014;12;07;Sunnuntai;0;0;0
94;28.12.2014;2014;12;08;Sunnuntai;0;0;0
94;28.12.2014;2014;12;09;Sunnuntai;0;0;0
94;28.12.2014;2014;12;10;Sunnuntai;0;0;0
94;28.12.2014;2014;12;11;Sunnuntai;0;0;0
94;28.12.2014;2014;12;12;Sunnuntai;0;0;0
94;28.12.2014;2014;12;13;Sunnuntai;1;0;1
94;28.12.2014;2014;12;14;Sunnuntai;0;0;0
94;28.12.2014;2014;12;15;Sunnuntai;0;0;0
94;28.12.2014;2014;12;16;Sunnuntai;0;0;0
94;28.12.2014;2014;12;17;Sunnuntai;0;0;0
94;28.12.2014;2014;12;18;Sunnuntai;0;0;0
94;28.12.2014;2014;12;19;Sunnuntai;1;1;2
94;28.12.2014;2014;12;20;Sunnuntai;0;0;0
94;28.12.2014;2014;12;21;Sunnuntai;0;0;0
94;28.12.2014;2014;12;22;Sunnuntai;0;0;0
94;28.12.2014;2014;12;23;Sunnuntai;0;0;0
94;29.12.2014;2014;12;00;Maanantai;0;0;0
94;29.12.2014;2014;12;01;Maanantai;0;0;0
94;29.12.2014;2014;12;02;Maanantai;0;0;0
94;29.12.2014;2014;12;03;Maanantai;0;0;0
94;29.12.2014;2014;12;04;Maanantai;1;0;1
94;29.12.2014;2014;12;05;Maanantai;0;1;1
94;29.12.2014;2014;12;06;Maanantai;3;0;3
94;29.12.2014;2014;12;07;Maanantai;5;2;7
94;29.12.2014;2014;12;08;Maanantai;4;2;6
94;29.12.2014;2014;12;09;Maanantai;0;0;0
94;29.12.2014;2014;12;10;Maanantai;0;0;0
94;29.12.2014;2014;12;11;Maanantai;0;0;0
94;29.12.2014;2014;12;12;Maanantai;0;1;1
94;29.12.2014;2014;12;13;Maanantai;0;0;0
94;29.12.2014;2014;12;14;Maanantai;2;0;2
94;29.12.2014;2014;12;15;Maanantai;3;4;7
94;29.12.2014;2014;12;16;Maanantai;0;4;4
94;29.12.2014;2014;12;17;Maanantai;0;3;3
94;29.12.2014;2014;12;18;Maanantai;0;1;1
94;29.12.2014;2014;12;19;Maanantai;0;1;1
94;29.12.2014;2014;12;20;Maanantai;0;1;1
94;29.12.2014;2014;12;21;Maanantai;0;0;0
94;29.12.2014;2014;12;22;Maanantai;0;0;0
94;29.12.2014;2014;12;23;Maanantai;0;0;0
94;30.12.2014;2014;12;00;Tiistai;0;0;0
94;30.12.2014;2014;12;01;Tiistai;0;0;0
94;30.12.2014;2014;12;02;Tiistai;0;0;0
94;30.12.2014;2014;12;03;Tiistai;0;0;0
94;30.12.2014;2014;12;04;Tiistai;0;0;0
94;30.12.2014;2014;12;05;Tiistai;0;0;0
94;30.12.2014;2014;12;06;Tiistai;5;0;5
94;30.12.2014;2014;12;07;Tiistai;5;0;5
94;30.12.2014;2014;12;08;Tiistai;4;0;4
94;30.12.2014;2014;12;09;Tiistai;2;0;2
94;30.12.2014;2014;12;10;Tiistai;1;0;1
94;30.12.2014;2014;12;11;Tiistai;0;0;0
94;30.12.2014;2014;12;12;Tiistai;1;0;1
94;30.12.2014;2014;12;13;Tiistai;0;0;0
94;30.12.2014;2014;12;14;Tiistai;2;1;3
94;30.12.2014;2014;12;15;Tiistai;0;6;6
94;30.12.2014;2014;12;16;Tiistai;0;3;3
94;30.12.2014;2014;12;17;Tiistai;1;6;7
94;30.12.2014;2014;12;18;Tiistai;0;1;1
94;30.12.2014;2014;12;19;Tiistai;3;1;4
94;30.12.2014;2014;12;20;Tiistai;0;0;0
94;30.12.2014;2014;12;21;Tiistai;0;0;0
94;30.12.2014;2014;12;22;Tiistai;0;1;1
94;30.12.2014;2014;12;23;Tiistai;0;0;0
94;31.12.2014;2014;12;00;Keskiviikko;0;0;0
94;31.12.2014;2014;12;01;Keskiviikko;0;0;0
94;31.12.2014;2014;12;02;Keskiviikko;0;0;0
94;31.12.2014;2014;12;03;Keskiviikko;0;0;0
94;31.12.2014;2014;12;04;Keskiviikko;0;0;0
94;31.12.2014;2014;12;05;Keskiviikko;1;1;2
94;31.12.2014;2014;12;06;Keskiviikko;3;0;3
94;31.12.2014;2014;12;07;Keskiviikko;5;0;5
94;31.12.2014;2014;12;08;Keskiviikko;3;0;3
94;31.12.2014;2014;12;09;Keskiviikko;2;0;2
94;31.12.2014;2014;12;10;Keskiviikko;2;0;2
94;31.12.2014;2014;12;11;Keskiviikko;0;0;0
94;31.12.2014;2014;12;12;Keskiviikko;2;1;3
94;31.12.2014;2014;12;13;Keskiviikko;1;2;3
94;31.12.2014;2014;12;14;Keskiviikko;3;5;8
94;31.12.2014;2014;12;15;Keskiviikko;4;3;7
94;31.12.2014;2014;12;16;Keskiviikko;1;1;2
94;31.12.2014;2014;12;17;Keskiviikko;1;2;3
94;31.12.2014;2014;12;18;Keskiviikko;0;2;2
94;31.12.2014;2014;12;19;Keskiviikko;1;1;2
94;31.12.2014;2014;12;20;Keskiviikko;2;0;2
94;31.12.2014;2014;12;21;Keskiviikko;0;1;1
94;31.12.2014;2014;12;22;Keskiviikko;0;0;0
94;31.12.2014;2014;12;23;Keskiviikko;0;0;0
94;01.01.2015;2015;01;00;Torstai;0;0;0
94;01.01.2015;2015;01;01;Torstai;0;0;0
94;01.01.2015;2015;01;02;Torstai;0;0;0
94;01.01.2015;2015;01;03;Torstai;0;0;0
94;01.01.2015;2015;01;04;Torstai;0;1;1
94;01.01.2015;2015;01;05;Torstai;1;0;1
94;01.01.2015;2015;01;06;Torstai;0;0;0
94;01.01.2015;2015;01;07;Torstai;0;0;0
94;01.01.2015;2015;01;08;Torstai;0;1;1
94;01.01.2015;2015;01;09;Torstai;0;0;0
94;01.01.2015;2015;01;10;Torstai;0;1;1
94;01.01.2015;2015;01;11;Torstai;3;1;4
94;01.01.2015;2015;01;12;Torstai;1;0;1
94;01.01.2015;2015;01;13;Torstai;1;2;3
94;01.01.2015;2015;01;14;Torstai;2;3;5
94;01.01.2015;2015;01;15;Torstai;3;1;4
94;01.01.2015;2015;01;16;Torstai;0;1;1
94;01.01.2015;2015;01;17;Torstai;1;0;1
94;01.01.2015;2015;01;18;Torstai;1;0;1
94;01.01.2015;2015;01;19;Torstai;1;0;1
94;01.01.2015;2015;01;20;Torstai;1;0;1
94;01.01.2015;2015;01;21;Torstai;0;0;0
94;01.01.2015;2015;01;22;Torstai;0;0;0
94;01.01.2015;2015;01;23;Torstai;0;0;0
94;02.01.2015;2015;01;00;Perjantai;0;0;0
94;02.01.2015;2015;01;01;Perjantai;0;0;0
94;02.01.2015;2015;01;02;Perjantai;0;0;0
94;02.01.2015;2015;01;03;Perjantai;0;0;0
94;02.01.2015;2015;01;04;Perjantai;0;0;0
94;02.01.2015;2015;01;05;Perjantai;2;0;2
94;02.01.2015;2015;01;06;Perjantai;2;0;2
94;02.01.2015;2015;01;07;Perjantai;2;0;2
94;02.01.2015;2015;01;08;Perjantai;3;1;4
94;02.01.2015;2015;01;09;Perjantai;0;0;0
94;02.01.2015;2015;01;10;Perjantai;0;0;0
94;02.01.2015;2015;01;11;Perjantai;1;0;1
94;02.01.2015;2015;01;12;Perjantai;0;1;1
94;02.01.2015;2015;01;13;Perjantai;0;0;0
94;02.01.2015;2015;01;14;Perjantai;0;3;3
94;02.01.2015;2015;01;15;Perjantai;1;1;2
94;02.01.2015;2015;01;16;Perjantai;0;2;2
94;02.01.2015;2015;01;17;Perjantai;0;5;5
94;02.01.2015;2015;01;18;Perjantai;0;0;0
94;02.01.2015;2015;01;19;Perjantai;0;0;0
94;02.01.2015;2015;01;20;Perjantai;2;0;2
94;02.01.2015;2015;01;21;Perjantai;0;0;0
94;02.01.2015;2015;01;22;Perjantai;0;0;0
94;02.01.2015;2015;01;23;Perjantai;0;0;0
94;03.01.2015;2015;01;00;Lauantai;0;0;0
94;03.01.2015;2015;01;01;Lauantai;0;0;0
94;03.01.2015;2015;01;02;Lauantai;0;0;0
94;03.01.2015;2015;01;03;Lauantai;0;0;0
94;03.01.2015;2015;01;04;Lauantai;0;0;0
94;03.01.2015;2015;01;05;Lauantai;0;0;0
94;03.01.2015;2015;01;06;Lauantai;1;1;2
94;03.01.2015;2015;01;07;Lauantai;2;1;3
94;03.01.2015;2015;01;08;Lauantai;0;0;0
94;03.01.2015;2015;01;09;Lauantai;0;0;0
94;03.01.2015;2015;01;10;Lauantai;0;0;0
94;03.01.2015;2015;01;11;Lauantai;0;3;3
94;03.01.2015;2015;01;12;Lauantai;2;0;2
94;03.01.2015;2015;01;13;Lauantai;3;0;3
94;03.01.2015;2015;01;14;Lauantai;2;0;2
94;03.01.2015;2015;01;15;Lauantai;3;2;5
94;03.01.2015;2015;01;16;Lauantai;0;0;0
94;03.01.2015;2015;01;17;Lauantai;0;0;0
94;03.01.2015;2015;01;18;Lauantai;0;0;0
94;03.01.2015;2015;01;19;Lauantai;1;0;1
94;03.01.2015;2015;01;20;Lauantai;1;0;1
94;03.01.2015;2015;01;21;Lauantai;0;1;1
94;03.01.2015;2015;01;22;Lauantai;0;0;0
94;03.01.2015;2015;01;23;Lauantai;0;0;0
94;04.01.2015;2015;01;00;Sunnuntai;0;0;0
94;04.01.2015;2015;01;01;Sunnuntai;0;0;0
94;04.01.2015;2015;01;02;Sunnuntai;0;0;0
94;04.01.2015;2015;01;03;Sunnuntai;0;0;0
94;04.01.2015;2015;01;04;Sunnuntai;0;0;0
94;04.01.2015;2015;01;05;Sunnuntai;1;2;3
94;04.01.2015;2015;01;06;Sunnuntai;0;0;0
94;04.01.2015;2015;01;07;Sunnuntai;1;1;2
94;04.01.2015;2015;01;08;Sunnuntai;0;0;0
94;04.01.2015;2015;01;09;Sunnuntai;0;0;0
94;04.01.2015;2015;01;10;Sunnuntai;0;0;0
94;04.01.2015;2015;01;11;Sunnuntai;1;1;2
94;04.01.2015;2015;01;12;Sunnuntai;2;1;3
94;04.01.2015;2015;01;13;Sunnuntai;2;0;2
94;04.01.2015;2015;01;14;Sunnuntai;0;3;3
94;04.01.2015;2015;01;15;Sunnuntai;0;2;2
94;04.01.2015;2015;01;16;Sunnuntai;0;1;1
94;04.01.2015;2015;01;17;Sunnuntai;0;0;0
94;04.01.2015;2015;01;18;Sunnuntai;0;0;0
94;04.01.2015;2015;01;19;Sunnuntai;0;0;0
94;04.01.2015;2015;01;20;Sunnuntai;1;0;1
94;04.01.2015;2015;01;21;Sunnuntai;0;0;0
94;04.01.2015;2015;01;22;Sunnuntai;0;1;1
94;04.01.2015;2015;01;23;Sunnuntai;0;0;0
94;05.01.2015;2015;01;00;Maanantai;0;0;0
94;05.01.2015;2015;01;01;Maanantai;0;0;0
94;05.01.2015;2015;01;02;Maanantai;0;0;0
94;05.01.2015;2015;01;03;Maanantai;0;0;0
94;05.01.2015;2015;01;04;Maanantai;0;0;0
94;05.01.2015;2015;01;05;Maanantai;0;0;0
94;05.01.2015;2015;01;06;Maanantai;2;0;2
94;05.01.2015;2015;01;07;Maanantai;4;0;4
94;05.01.2015;2015;01;08;Maanantai;1;0;1
94;05.01.2015;2015;01;09;Maanantai;0;0;0
94;05.01.2015;2015;01;10;Maanantai;0;0;0
94;05.01.2015;2015;01;11;Maanantai;0;0;0
94;05.01.2015;2015;01;12;Maanantai;0;0;0
94;05.01.2015;2015;01;13;Maanantai;0;0;0
94;05.01.2015;2015;01;14;Maanantai;0;2;2
94;05.01.2015;2015;01;15;Maanantai;0;1;1
94;05.01.2015;2015;01;16;Maanantai;0;2;2
94;05.01.2015;2015;01;17;Maanantai;0;2;2
94;05.01.2015;2015;01;18;Maanantai;0;1;1
94;05.01.2015;2015;01;19;Maanantai;0;0;0
94;05.01.2015;2015;01;20;Maanantai;0;0;0
94;05.01.2015;2015;01;21;Maanantai;0;0;0
94;05.01.2015;2015;01;22;Maanantai;0;0;0
94;05.01.2015;2015;01;23;Maanantai;0;0;0
94;06.01.2015;2015;01;00;Tiistai;0;0;0
94;06.01.2015;2015;01;01;Tiistai;0;0;0
94;06.01.2015;2015;01;02;Tiistai;0;0;0
94;06.01.2015;2015;01;03;Tiistai;0;0;0
94;06.01.2015;2015;01;04;Tiistai;0;0;0
94;06.01.2015;2015;01;05;Tiistai;0;0;0
94;06.01.2015;2015;01;06;Tiistai;0;0;0
94;06.01.2015;2015;01;07;Tiistai;0;0;0
94;06.01.2015;2015;01;08;Tiistai;0;0;0
94;06.01.2015;2015;01;09;Tiistai;0;0;0
94;06.01.2015;2015;01;10;Tiistai;0;0;0
94;06.01.2015;2015;01;11;Tiistai;0;0;0
94;06.01.2015;2015;01;12;Tiistai;0;0;0
94;06.01.2015;2015;01;13;Tiistai;0;0;0
94;06.01.2015;2015;01;14;Tiistai;0;0;0
94;06.01.2015;2015;01;15;Tiistai;0;0;0
94;06.01.2015;2015;01;16;Tiistai;1;0;1
94;06.01.2015;2015;01;17;Tiistai;1;0;1
94;06.01.2015;2015;01;18;Tiistai;0;0;0
94;06.01.2015;2015;01;19;Tiistai;2;1;3
94;06.01.2015;2015;01;20;Tiistai;0;2;2
94;06.01.2015;2015;01;21;Tiistai;0;0;0
94;06.01.2015;2015;01;22;Tiistai;0;0;0
94;06.01.2015;2015;01;23;Tiistai;0;0;0
94;07.01.2015;2015;01;00;Keskiviikko;0;0;0
94;07.01.2015;2015;01;01;Keskiviikko;0;0;0
94;07.01.2015;2015;01;02;Keskiviikko;0;2;2
94;07.01.2015;2015;01;03;Keskiviikko;0;0;0
94;07.01.2015;2015;01;04;Keskiviikko;0;0;0
94;07.01.2015;2015;01;05;Keskiviikko;1;0;1
94;07.01.2015;2015;01;06;Keskiviikko;8;0;8
94;07.01.2015;2015;01;07;Keskiviikko;9;1;10
94;07.01.2015;2015;01;08;Keskiviikko;3;0;3
94;07.01.2015;2015;01;09;Keskiviikko;0;1;1
94;07.01.2015;2015;01;10;Keskiviikko;0;0;0
94;07.01.2015;2015;01;11;Keskiviikko;0;0;0
94;07.01.2015;2015;01;12;Keskiviikko;0;0;0
94;07.01.2015;2015;01;13;Keskiviikko;1;2;3
94;07.01.2015;2015;01;14;Keskiviikko;1;1;2
94;07.01.2015;2015;01;15;Keskiviikko;2;10;12
94;07.01.2015;2015;01;16;Keskiviikko;0;8;8
94;07.01.2015;2015;01;17;Keskiviikko;2;5;7
94;07.01.2015;2015;01;18;Keskiviikko;0;0;0
94;07.01.2015;2015;01;19;Keskiviikko;1;2;3
94;07.01.2015;2015;01;20;Keskiviikko;0;0;0
94;07.01.2015;2015;01;21;Keskiviikko;0;1;1
94;07.01.2015;2015;01;22;Keskiviikko;0;0;0
94;07.01.2015;2015;01;23;Keskiviikko;0;0;0
94;08.01.2015;2015;01;00;Torstai;0;0;0
94;08.01.2015;2015;01;01;Torstai;0;0;0
94;08.01.2015;2015;01;02;Torstai;0;0;0
94;08.01.2015;2015;01;03;Torstai;0;0;0
94;08.01.2015;2015;01;04;Torstai;0;0;0
94;08.01.2015;2015;01;05;Torstai;2;0;2
94;08.01.2015;2015;01;06;Torstai;7;0;7
94;08.01.2015;2015;01;07;Torstai;10;0;10
94;08.01.2015;2015;01;08;Torstai;1;1;2
94;08.01.2015;2015;01;09;Torstai;4;1;5
94;08.01.2015;2015;01;10;Torstai;1;0;1
94;08.01.2015;2015;01;11;Torstai;2;1;3
94;08.01.2015;2015;01;12;Torstai;0;0;0
94;08.01.2015;2015;01;13;Torstai;2;0;2
94;08.01.2015;2015;01;14;Torstai;1;4;5
94;08.01.2015;2015;01;15;Torstai;0;10;10
94;08.01.2015;2015;01;16;Torstai;0;7;7
94;08.01.2015;2015;01;17;Torstai;3;8;11
94;08.01.2015;2015;01;18;Torstai;0;2;2
94;08.01.2015;2015;01;19;Torstai;0;0;0
94;08.01.2015;2015;01;20;Torstai;2;1;3
94;08.01.2015;2015;01;21;Torstai;0;2;2
94;08.01.2015;2015;01;22;Torstai;0;1;1
94;08.01.2015;2015;01;23;Torstai;0;0;0
94;09.01.2015;2015;01;00;Perjantai;0;0;0
94;09.01.2015;2015;01;01;Perjantai;0;0;0
94;09.01.2015;2015;01;02;Perjantai;0;0;0
94;09.01.2015;2015;01;03;Perjantai;0;0;0
94;09.01.2015;2015;01;04;Perjantai;0;0;0
94;09.01.2015;2015;01;05;Perjantai;1;0;1
94;09.01.2015;2015;01;06;Perjantai;4;0;4
94;09.01.2015;2015;01;07;Perjantai;10;0;10
94;09.01.2015;2015;01;08;Perjantai;4;1;5
94;09.01.2015;2015;01;09;Perjantai;1;0;1
94;09.01.2015;2015;01;10;Perjantai;0;0;0
94;09.01.2015;2015;01;11;Perjantai;0;0;0
94;09.01.2015;2015;01;12;Perjantai;0;1;1
94;09.01.2015;2015;01;13;Perjantai;2;1;3
94;09.01.2015;2015;01;14;Perjantai;1;2;3
94;09.01.2015;2015;01;15;Perjantai;0;5;5
94;09.01.2015;2015;01;16;Perjantai;1;7;8
94;09.01.2015;2015;01;17;Perjantai;0;4;4
94;09.01.2015;2015;01;18;Perjantai;2;0;2
94;09.01.2015;2015;01;19;Perjantai;1;2;3
94;09.01.2015;2015;01;20;Perjantai;0;0;0
94;09.01.2015;2015;01;21;Perjantai;1;1;2
94;09.01.2015;2015;01;22;Perjantai;0;2;2
94;09.01.2015;2015;01;23;Perjantai;0;0;0
94;10.01.2015;2015;01;00;Lauantai;0;0;0
94;10.01.2015;2015;01;01;Lauantai;0;0;0
94;10.01.2015;2015;01;02;Lauantai;0;0;0
94;10.01.2015;2015;01;03;Lauantai;0;0;0
94;10.01.2015;2015;01;04;Lauantai;0;0;0
94;10.01.2015;2015;01;05;Lauantai;1;0;1
94;10.01.2015;2015;01;06;Lauantai;0;0;0
94;10.01.2015;2015;01;07;Lauantai;0;0;0
94;10.01.2015;2015;01;08;Lauantai;0;0;0
94;10.01.2015;2015;01;09;Lauantai;1;0;1
94;10.01.2015;2015;01;10;Lauantai;0;1;1
94;10.01.2015;2015;01;11;Lauantai;0;0;0
94;10.01.2015;2015;01;12;Lauantai;1;0;1
94;10.01.2015;2015;01;13;Lauantai;2;3;5
94;10.01.2015;2015;01;14;Lauantai;1;0;1
94;10.01.2015;2015;01;15;Lauantai;0;1;1
94;10.01.2015;2015;01;16;Lauantai;0;1;1
94;10.01.2015;2015;01;17;Lauantai;1;1;2
94;10.01.2015;2015;01;18;Lauantai;1;0;1
94;10.01.2015;2015;01;19;Lauantai;0;0;0
94;10.01.2015;2015;01;20;Lauantai;0;1;1
94;10.01.2015;2015;01;21;Lauantai;0;0;0
94;10.01.2015;2015;01;22;Lauantai;0;0;0
94;10.01.2015;2015;01;23;Lauantai;0;0;0
94;11.01.2015;2015;01;00;Sunnuntai;0;0;0
94;11.01.2015;2015;01;01;Sunnuntai;0;0;0
94;11.01.2015;2015;01;02;Sunnuntai;0;0;0
94;11.01.2015;2015;01;03;Sunnuntai;1;0;1
94;11.01.2015;2015;01;04;Sunnuntai;0;0;0
94;11.01.2015;2015;01;05;Sunnuntai;0;0;0
94;11.01.2015;2015;01;06;Sunnuntai;0;0;0
94;11.01.2015;2015;01;07;Sunnuntai;0;1;1
94;11.01.2015;2015;01;08;Sunnuntai;0;8;8
94;11.01.2015;2015;01;09;Sunnuntai;0;0;0
94;11.01.2015;2015;01;10;Sunnuntai;0;1;1
94;11.01.2015;2015;01;11;Sunnuntai;1;2;3
94;11.01.2015;2015;01;12;Sunnuntai;0;0;0
94;11.01.2015;2015;01;13;Sunnuntai;2;0;2
94;11.01.2015;2015;01;14;Sunnuntai;0;0;0
94;11.01.2015;2015;01;15;Sunnuntai;0;0;0
94;11.01.2015;2015;01;16;Sunnuntai;0;0;0
94;11.01.2015;2015;01;17;Sunnuntai;0;0;0
94;11.01.2015;2015;01;18;Sunnuntai;1;2;3
94;11.01.2015;2015;01;19;Sunnuntai;0;0;0
94;11.01.2015;2015;01;20;Sunnuntai;1;0;1
94;11.01.2015;2015;01;21;Sunnuntai;0;0;0
94;11.01.2015;2015;01;22;Sunnuntai;0;0;0
94;11.01.2015;2015;01;23;Sunnuntai;0;0;0
94;12.01.2015;2015;01;00;Maanantai;0;0;0
94;12.01.2015;2015;01;01;Maanantai;0;0;0
94;12.01.2015;2015;01;02;Maanantai;0;0;0
94;12.01.2015;2015;01;03;Maanantai;0;0;0
94;12.01.2015;2015;01;04;Maanantai;0;0;0
94;12.01.2015;2015;01;05;Maanantai;1;0;1
94;12.01.2015;2015;01;06;Maanantai;7;1;8
94;12.01.2015;2015;01;07;Maanantai;7;0;7
94;12.01.2015;2015;01;08;Maanantai;2;0;2
94;12.01.2015;2015;01;09;Maanantai;0;0;0
94;12.01.2015;2015;01;10;Maanantai;0;0;0
94;12.01.2015;2015;01;11;Maanantai;0;0;0
94;12.01.2015;2015;01;12;Maanantai;0;1;1
94;12.01.2015;2015;01;13;Maanantai;1;0;1
94;12.01.2015;2015;01;14;Maanantai;1;1;2
94;12.01.2015;2015;01;15;Maanantai;1;5;6
94;12.01.2015;2015;01;16;Maanantai;0;6;6
94;12.01.2015;2015;01;17;Maanantai;0;5;5
94;12.01.2015;2015;01;18;Maanantai;0;0;0
94;12.01.2015;2015;01;19;Maanantai;0;0;0
94;12.01.2015;2015;01;20;Maanantai;1;2;3
94;12.01.2015;2015;01;21;Maanantai;0;0;0
94;12.01.2015;2015;01;22;Maanantai;0;1;1
94;12.01.2015;2015;01;23;Maanantai;0;0;0
94;13.01.2015;2015;01;00;Tiistai;0;0;0
94;13.01.2015;2015;01;01;Tiistai;0;0;0
94;13.01.2015;2015;01;02;Tiistai;0;0;0
94;13.01.2015;2015;01;03;Tiistai;0;0;0
94;13.01.2015;2015;01;04;Tiistai;0;0;0
94;13.01.2015;2015;01;05;Tiistai;2;2;4
94;13.01.2015;2015;01;06;Tiistai;8;0;8
94;13.01.2015;2015;01;07;Tiistai;8;0;8
94;13.01.2015;2015;01;08;Tiistai;3;0;3
94;13.01.2015;2015;01;09;Tiistai;2;0;2
94;13.01.2015;2015;01;10;Tiistai;0;1;1
94;13.01.2015;2015;01;11;Tiistai;0;0;0
94;13.01.2015;2015;01;12;Tiistai;0;0;0
94;13.01.2015;2015;01;13;Tiistai;1;4;5
94;13.01.2015;2015;01;14;Tiistai;1;3;4
94;13.01.2015;2015;01;15;Tiistai;1;7;8
94;13.01.2015;2015;01;16;Tiistai;1;5;6
94;13.01.2015;2015;01;17;Tiistai;0;8;8
94;13.01.2015;2015;01;18;Tiistai;2;3;5
94;13.01.2015;2015;01;19;Tiistai;0;0;0
94;13.01.2015;2015;01;20;Tiistai;4;0;4
94;13.01.2015;2015;01;21;Tiistai;0;1;1
94;13.01.2015;2015;01;22;Tiistai;0;2;2
94;13.01.2015;2015;01;23;Tiistai;0;0;0
94;14.01.2015;2015;01;00;Keskiviikko;0;0;0
94;14.01.2015;2015;01;01;Keskiviikko;0;0;0
94;14.01.2015;2015;01;02;Keskiviikko;0;0;0
94;14.01.2015;2015;01;03;Keskiviikko;0;0;0
94;14.01.2015;2015;01;04;Keskiviikko;0;0;0
94;14.01.2015;2015;01;05;Keskiviikko;2;1;3
94;14.01.2015;2015;01;06;Keskiviikko;8;0;8
94;14.01.2015;2015;01;07;Keskiviikko;9;1;10
94;14.01.2015;2015;01;08;Keskiviikko;7;0;7
94;14.01.2015;2015;01;09;Keskiviikko;1;0;1
94;14.01.2015;2015;01;10;Keskiviikko;0;0;0
94;14.01.2015;2015;01;11;Keskiviikko;0;1;1
94;14.01.2015;2015;01;12;Keskiviikko;0;0;0
94;14.01.2015;2015;01;13;Keskiviikko;0;1;1
94;14.01.2015;2015;01;14;Keskiviikko;1;3;4
94;14.01.2015;2015;01;15;Keskiviikko;2;3;5
94;14.01.2015;2015;01;16;Keskiviikko;1;9;10
94;14.01.2015;2015;01;17;Keskiviikko;0;8;8
94;14.01.2015;2015;01;18;Keskiviikko;0;3;3
94;14.01.2015;2015;01;19;Keskiviikko;0;0;0
94;14.01.2015;2015;01;20;Keskiviikko;1;0;1
94;14.01.2015;2015;01;21;Keskiviikko;0;1;1
94;14.01.2015;2015;01;22;Keskiviikko;0;0;0
94;14.01.2015;2015;01;23;Keskiviikko;0;0;0
94;15.01.2015;2015;01;00;Torstai;0;0;0
94;15.01.2015;2015;01;01;Torstai;0;0;0
94;15.01.2015;2015;01;02;Torstai;0;0;0
94;15.01.2015;2015;01;03;Torstai;0;0;0
94;15.01.2015;2015;01;04;Torstai;0;0;0
94;15.01.2015;2015;01;05;Torstai;2;0;2
94;15.01.2015;2015;01;06;Torstai;11;0;11
94;15.01.2015;2015;01;07;Torstai;11;0;11
94;15.01.2015;2015;01;08;Torstai;8;0;8
94;15.01.2015;2015;01;09;Torstai;1;0;1
94;15.01.2015;2015;01;10;Torstai;0;0;0
94;15.01.2015;2015;01;11;Torstai;0;1;1
94;15.01.2015;2015;01;12;Torstai;2;1;3
94;15.01.2015;2015;01;13;Torstai;0;0;0
94;15.01.2015;2015;01;14;Torstai;0;4;4
94;15.01.2015;2015;01;15;Torstai;0;8;8
94;15.01.2015;2015;01;16;Torstai;1;9;10
94;15.01.2015;2015;01;17;Torstai;1;4;5
94;15.01.2015;2015;01;18;Torstai;0;5;5
94;15.01.2015;2015;01;19;Torstai;2;1;3
94;15.01.2015;2015;01;20;Torstai;0;0;0
94;15.01.2015;2015;01;21;Torstai;0;1;1
94;15.01.2015;2015;01;22;Torstai;0;0;0
94;15.01.2015;2015;01;23;Torstai;0;0;0
94;16.01.2015;2015;01;00;Perjantai;0;0;0
94;16.01.2015;2015;01;01;Perjantai;0;0;0
94;16.01.2015;2015;01;02;Perjantai;0;0;0
94;16.01.2015;2015;01;03;Perjantai;0;0;0
94;16.01.2015;2015;01;04;Perjantai;0;0;0
94;16.01.2015;2015;01;05;Perjantai;3;0;3
94;16.01.2015;2015;01;06;Perjantai;3;0;3
94;16.01.2015;2015;01;07;Perjantai;10;0;10
94;16.01.2015;2015;01;08;Perjantai;6;0;6
94;16.01.2015;2015;01;09;Perjantai;1;1;2
94;16.01.2015;2015;01;10;Perjantai;0;0;0
94;16.01.2015;2015;01;11;Perjantai;0;1;1
94;16.01.2015;2015;01;12;Perjantai;2;1;3
94;16.01.2015;2015;01;13;Perjantai;0;1;1
94;16.01.2015;2015;01;14;Perjantai;1;2;3
94;16.01.2015;2015;01;15;Perjantai;0;3;3
94;16.01.2015;2015;01;16;Perjantai;0;7;7
94;16.01.2015;2015;01;17;Perjantai;1;3;4
94;16.01.2015;2015;01;18;Perjantai;1;2;3
94;16.01.2015;2015;01;19;Perjantai;0;0;0
94;16.01.2015;2015;01;20;Perjantai;1;1;2
94;16.01.2015;2015;01;21;Perjantai;3;0;3
94;16.01.2015;2015;01;22;Perjantai;0;0;0
94;16.01.2015;2015;01;23;Perjantai;0;0;0
94;17.01.2015;2015;01;00;Lauantai;0;0;0
94;17.01.2015;2015;01;01;Lauantai;0;0;0
94;17.01.2015;2015;01;02;Lauantai;0;0;0
94;17.01.2015;2015;01;03;Lauantai;0;0;0
94;17.01.2015;2015;01;04;Lauantai;0;0;0
94;17.01.2015;2015;01;05;Lauantai;0;0;0
94;17.01.2015;2015;01;06;Lauantai;0;0;0
94;17.01.2015;2015;01;07;Lauantai;0;1;1
94;17.01.2015;2015;01;08;Lauantai;1;1;2
94;17.01.2015;2015;01;09;Lauantai;0;1;1
94;17.01.2015;2015;01;10;Lauantai;0;1;1
94;17.01.2015;2015;01;11;Lauantai;0;0;0
94;17.01.2015;2015;01;12;Lauantai;0;0;0
94;17.01.2015;2015;01;13;Lauantai;1;0;1
94;17.01.2015;2015;01;14;Lauantai;0;2;2
94;17.01.2015;2015;01;15;Lauantai;0;0;0
94;17.01.2015;2015;01;16;Lauantai;0;0;0
94;17.01.2015;2015;01;17;Lauantai;0;2;2
94;17.01.2015;2015;01;18;Lauantai;0;0;0
94;17.01.2015;2015;01;19;Lauantai;2;0;2
94;17.01.2015;2015;01;20;Lauantai;0;0;0
94;17.01.2015;2015;01;21;Lauantai;0;0;0
94;17.01.2015;2015;01;22;Lauantai;0;0;0
94;17.01.2015;2015;01;23;Lauantai;0;0;0
94;18.01.2015;2015;01;00;Sunnuntai;0;0;0
94;18.01.2015;2015;01;01;Sunnuntai;0;0;0
94;18.01.2015;2015;01;02;Sunnuntai;0;0;0
94;18.01.2015;2015;01;03;Sunnuntai;0;0;0
94;18.01.2015;2015;01;04;Sunnuntai;1;0;1
94;18.01.2015;2015;01;05;Sunnuntai;0;0;0
94;18.01.2015;2015;01;06;Sunnuntai;0;0;0
94;18.01.2015;2015;01;07;Sunnuntai;2;2;4
94;18.01.2015;2015;01;08;Sunnuntai;0;0;0
94;18.01.2015;2015;01;09;Sunnuntai;2;1;3
94;18.01.2015;2015;01;10;Sunnuntai;2;2;4
94;18.01.2015;2015;01;11;Sunnuntai;4;1;5
94;18.01.2015;2015;01;12;Sunnuntai;3;1;4
94;18.01.2015;2015;01;13;Sunnuntai;0;1;1
94;18.01.2015;2015;01;14;Sunnuntai;0;3;3
94;18.01.2015;2015;01;15;Sunnuntai;0;1;1
94;18.01.2015;2015;01;16;Sunnuntai;1;1;2
94;18.01.2015;2015;01;17;Sunnuntai;0;1;1
94;18.01.2015;2015;01;18;Sunnuntai;2;0;2
94;18.01.2015;2015;01;19;Sunnuntai;0;1;1
94;18.01.2015;2015;01;20;Sunnuntai;2;0;2
94;18.01.2015;2015;01;21;Sunnuntai;0;0;0
94;18.01.2015;2015;01;22;Sunnuntai;0;0;0
94;18.01.2015;2015;01;23;Sunnuntai;0;0;0
94;19.01.2015;2015;01;00;Maanantai;0;0;0
94;19.01.2015;2015;01;01;Maanantai;0;0;0
94;19.01.2015;2015;01;02;Maanantai;0;0;0
94;19.01.2015;2015;01;03;Maanantai;0;0;0
94;19.01.2015;2015;01;04;Maanantai;1;0;1
94;19.01.2015;2015;01;05;Maanantai;3;0;3
94;19.01.2015;2015;01;06;Maanantai;8;1;9
94;19.01.2015;2015;01;07;Maanantai;11;1;12
94;19.01.2015;2015;01;08;Maanantai;6;1;7
94;19.01.2015;2015;01;09;Maanantai;2;0;2
94;19.01.2015;2015;01;10;Maanantai;0;0;0
94;19.01.2015;2015;01;11;Maanantai;0;0;0
94;19.01.2015;2015;01;12;Maanantai;1;0;1
94;19.01.2015;2015;01;13;Maanantai;1;1;2
94;19.01.2015;2015;01;14;Maanantai;2;4;6
94;19.01.2015;2015;01;15;Maanantai;2;5;7
94;19.01.2015;2015;01;16;Maanantai;0;6;6
94;19.01.2015;2015;01;17;Maanantai;0;13;13
94;19.01.2015;2015;01;18;Maanantai;1;1;2
94;19.01.2015;2015;01;19;Maanantai;0;0;0
94;19.01.2015;2015;01;20;Maanantai;0;2;2
94;19.01.2015;2015;01;21;Maanantai;0;1;1
94;19.01.2015;2015;01;22;Maanantai;0;0;0
94;19.01.2015;2015;01;23;Maanantai;0;0;0
94;20.01.2015;2015;01;00;Tiistai;0;1;1
94;20.01.2015;2015;01;01;Tiistai;0;0;0
94;20.01.2015;2015;01;02;Tiistai;0;0;0
94;20.01.2015;2015;01;03;Tiistai;0;0;0
94;20.01.2015;2015;01;04;Tiistai;0;0;0
94;20.01.2015;2015;01;05;Tiistai;1;0;1
94;20.01.2015;2015;01;06;Tiistai;9;2;11
94;20.01.2015;2015;01;07;Tiistai;5;1;6
94;20.01.2015;2015;01;08;Tiistai;3;0;3
94;20.01.2015;2015;01;09;Tiistai;1;0;1
94;20.01.2015;2015;01;10;Tiistai;0;0;0
94;20.01.2015;2015;01;11;Tiistai;0;0;0
94;20.01.2015;2015;01;12;Tiistai;1;0;1
94;20.01.2015;2015;01;13;Tiistai;0;0;0
94;20.01.2015;2015;01;14;Tiistai;1;2;3
94;20.01.2015;2015;01;15;Tiistai;2;5;7
94;20.01.2015;2015;01;16;Tiistai;0;6;6
94;20.01.2015;2015;01;17;Tiistai;0;4;4
94;20.01.2015;2015;01;18;Tiistai;0;0;0
94;20.01.2015;2015;01;19;Tiistai;1;2;3
94;20.01.2015;2015;01;20;Tiistai;0;0;0
94;20.01.2015;2015;01;21;Tiistai;0;0;0
94;20.01.2015;2015;01;22;Tiistai;0;1;1
94;20.01.2015;2015;01;23;Tiistai;0;0;0
94;21.01.2015;2015;01;00;Keskiviikko;0;1;1
94;21.01.2015;2015;01;01;Keskiviikko;0;0;0
94;21.01.2015;2015;01;02;Keskiviikko;0;0;0
94;21.01.2015;2015;01;03;Keskiviikko;0;0;0
94;21.01.2015;2015;01;04;Keskiviikko;0;0;0
94;21.01.2015;2015;01;05;Keskiviikko;2;0;2
94;21.01.2015;2015;01;06;Keskiviikko;5;1;6
94;21.01.2015;2015;01;07;Keskiviikko;3;0;3
94;21.01.2015;2015;01;08;Keskiviikko;3;1;4
94;21.01.2015;2015;01;09;Keskiviikko;2;1;3
94;21.01.2015;2015;01;10;Keskiviikko;0;0;0
94;21.01.2015;2015;01;11;Keskiviikko;1;0;1
94;21.01.2015;2015;01;12;Keskiviikko;2;0;2
94;21.01.2015;2015;01;13;Keskiviikko;0;1;1
94;21.01.2015;2015;01;14;Keskiviikko;1;4;5
94;21.01.2015;2015;01;15;Keskiviikko;2;4;6
94;21.01.2015;2015;01;16;Keskiviikko;0;4;4
94;21.01.2015;2015;01;17;Keskiviikko;0;5;5
94;21.01.2015;2015;01;18;Keskiviikko;1;3;4
94;21.01.2015;2015;01;19;Keskiviikko;2;3;5
94;21.01.2015;2015;01;20;Keskiviikko;1;0;1
94;21.01.2015;2015;01;21;Keskiviikko;0;2;2
94;21.01.2015;2015;01;22;Keskiviikko;0;0;0
94;21.01.2015;2015;01;23;Keskiviikko;0;0;0
94;22.01.2015;2015;01;00;Torstai;0;0;0
94;22.01.2015;2015;01;01;Torstai;0;0;0
94;22.01.2015;2015;01;02;Torstai;0;0;0
94;22.01.2015;2015;01;03;Torstai;0;0;0
94;22.01.2015;2015;01;04;Torstai;0;0;0
94;22.01.2015;2015;01;05;Torstai;2;0;2
94;22.01.2015;2015;01;06;Torstai;5;1;6
94;22.01.2015;2015;01;07;Torstai;7;1;8
94;22.01.2015;2015;01;08;Torstai;6;0;6
94;22.01.2015;2015;01;09;Torstai;1;0;1
94;22.01.2015;2015;01;10;Torstai;0;0;0
94;22.01.2015;2015;01;11;Torstai;0;0;0
94;22.01.2015;2015;01;12;Torstai;1;1;2
94;22.01.2015;2015;01;13;Torstai;2;1;3
94;22.01.2015;2015;01;14;Torstai;1;2;3
94;22.01.2015;2015;01;15;Torstai;0;4;4
94;22.01.2015;2015;01;16;Torstai;1;9;10
94;22.01.2015;2015;01;17;Torstai;0;5;5
94;22.01.2015;2015;01;18;Torstai;0;1;1
94;22.01.2015;2015;01;19;Torstai;0;1;1
94;22.01.2015;2015;01;20;Torstai;1;0;1
94;22.01.2015;2015;01;21;Torstai;0;2;2
94;22.01.2015;2015;01;22;Torstai;0;0;0
94;22.01.2015;2015;01;23;Torstai;0;0;0
94;23.01.2015;2015;01;00;Perjantai;0;0;0
94;23.01.2015;2015;01;01;Perjantai;0;0;0
94;23.01.2015;2015;01;02;Perjantai;0;0;0
94;23.01.2015;2015;01;03;Perjantai;0;0;0
94;23.01.2015;2015;01;04;Perjantai;0;0;0
94;23.01.2015;2015;01;05;Perjantai;2;0;2
94;23.01.2015;2015;01;06;Perjantai;6;0;6
94;23.01.2015;2015;01;07;Perjantai;6;0;6
94;23.01.2015;2015;01;08;Perjantai;4;0;4
94;23.01.2015;2015;01;09;Perjantai;0;0;0
94;23.01.2015;2015;01;10;Perjantai;1;0;1
94;23.01.2015;2015;01;11;Perjantai;0;0;0
94;23.01.2015;2015;01;12;Perjantai;0;0;0
94;23.01.2015;2015;01;13;Perjantai;0;0;0
94;23.01.2015;2015;01;14;Perjantai;1;1;2
94;23.01.2015;2015;01;15;Perjantai;0;7;7
94;23.01.2015;2015;01;16;Perjantai;0;4;4
94;23.01.2015;2015;01;17;Perjantai;1;4;5
94;23.01.2015;2015;01;18;Perjantai;0;0;0
94;23.01.2015;2015;01;19;Perjantai;0;0;0
94;23.01.2015;2015;01;20;Perjantai;0;0;0
94;23.01.2015;2015;01;21;Perjantai;0;1;1
94;23.01.2015;2015;01;22;Perjantai;0;0;0
94;23.01.2015;2015;01;23;Perjantai;0;1;1
94;24.01.2015;2015;01;00;Lauantai;0;0;0
94;24.01.2015;2015;01;01;Lauantai;0;0;0
94;24.01.2015;2015;01;02;Lauantai;0;0;0
94;24.01.2015;2015;01;03;Lauantai;0;0;0
94;24.01.2015;2015;01;04;Lauantai;0;0;0
94;24.01.2015;2015;01;05;Lauantai;0;0;0
94;24.01.2015;2015;01;06;Lauantai;0;0;0
94;24.01.2015;2015;01;07;Lauantai;0;0;0
94;24.01.2015;2015;01;08;Lauantai;1;1;2
94;24.01.2015;2015;01;09;Lauantai;0;0;0
94;24.01.2015;2015;01;10;Lauantai;0;2;2
94;24.01.2015;2015;01;11;Lauantai;0;0;0
94;24.01.2015;2015;01;12;Lauantai;1;0;1
94;24.01.2015;2015;01;13;Lauantai;0;1;1
94;24.01.2015;2015;01;14;Lauantai;0;1;1
94;24.01.2015;2015;01;15;Lauantai;0;0;0
94;24.01.2015;2015;01;16;Lauantai;0;0;0
94;24.01.2015;2015;01;17;Lauantai;1;0;1
94;24.01.2015;2015;01;18;Lauantai;0;2;2
94;24.01.2015;2015;01;19;Lauantai;0;1;1
94;24.01.2015;2015;01;20;Lauantai;1;0;1
94;24.01.2015;2015;01;21;Lauantai;0;0;0
94;24.01.2015;2015;01;22;Lauantai;0;0;0
94;24.01.2015;2015;01;23;Lauantai;0;0;0
94;25.01.2015;2015;01;00;Sunnuntai;0;0;0
94;25.01.2015;2015;01;01;Sunnuntai;0;0;0
94;25.01.2015;2015;01;02;Sunnuntai;0;0;0
94;25.01.2015;2015;01;03;Sunnuntai;0;0;0
94;25.01.2015;2015;01;04;Sunnuntai;0;0;0
94;25.01.2015;2015;01;05;Sunnuntai;0;0;0
94;25.01.2015;2015;01;06;Sunnuntai;1;0;1
94;25.01.2015;2015;01;07;Sunnuntai;0;2;2
94;25.01.2015;2015;01;08;Sunnuntai;0;0;0
94;25.01.2015;2015;01;09;Sunnuntai;2;0;2
94;25.01.2015;2015;01;10;Sunnuntai;1;3;4
94;25.01.2015;2015;01;11;Sunnuntai;2;1;3
94;25.01.2015;2015;01;12;Sunnuntai;1;2;3
94;25.01.2015;2015;01;13;Sunnuntai;1;6;7
94;25.01.2015;2015;01;14;Sunnuntai;1;0;1
94;25.01.2015;2015;01;15;Sunnuntai;1;2;3
94;25.01.2015;2015;01;16;Sunnuntai;1;3;4
94;25.01.2015;2015;01;17;Sunnuntai;2;0;2
94;25.01.2015;2015;01;18;Sunnuntai;0;1;1
94;25.01.2015;2015;01;19;Sunnuntai;3;0;3
94;25.01.2015;2015;01;20;Sunnuntai;1;1;2
94;25.01.2015;2015;01;21;Sunnuntai;1;1;2
94;25.01.2015;2015;01;22;Sunnuntai;0;0;0
94;25.01.2015;2015;01;23;Sunnuntai;0;0;0
94;26.01.2015;2015;01;00;Maanantai;0;0;0
94;26.01.2015;2015;01;01;Maanantai;0;0;0
94;26.01.2015;2015;01;02;Maanantai;0;0;0
94;26.01.2015;2015;01;03;Maanantai;0;0;0
94;26.01.2015;2015;01;04;Maanantai;0;0;0
94;26.01.2015;2015;01;05;Maanantai;2;3;5
94;26.01.2015;2015;01;06;Maanantai;11;2;13
94;26.01.2015;2015;01;07;Maanantai;10;0;10
94;26.01.2015;2015;01;08;Maanantai;7;0;7
94;26.01.2015;2015;01;09;Maanantai;1;3;4
94;26.01.2015;2015;01;10;Maanantai;0;1;1
94;26.01.2015;2015;01;11;Maanantai;0;3;3
94;26.01.2015;2015;01;12;Maanantai;1;2;3
94;26.01.2015;2015;01;13;Maanantai;3;0;3
94;26.01.2015;2015;01;14;Maanantai;1;5;6
94;26.01.2015;2015;01;15;Maanantai;3;6;9
94;26.01.2015;2015;01;16;Maanantai;0;14;14
94;26.01.2015;2015;01;17;Maanantai;1;6;7
94;26.01.2015;2015;01;18;Maanantai;0;1;1
94;26.01.2015;2015;01;19;Maanantai;0;1;1
94;26.01.2015;2015;01;20;Maanantai;0;1;1
94;26.01.2015;2015;01;21;Maanantai;0;0;0
94;26.01.2015;2015;01;22;Maanantai;0;0;0
94;26.01.2015;2015;01;23;Maanantai;0;1;1
94;27.01.2015;2015;01;00;Tiistai;0;0;0
94;27.01.2015;2015;01;01;Tiistai;0;0;0
94;27.01.2015;2015;01;02;Tiistai;0;0;0
94;27.01.2015;2015;01;03;Tiistai;0;0;0
94;27.01.2015;2015;01;04;Tiistai;1;0;1
94;27.01.2015;2015;01;05;Tiistai;2;2;4
94;27.01.2015;2015;01;06;Tiistai;6;1;7
94;27.01.2015;2015;01;07;Tiistai;5;0;5
94;27.01.2015;2015;01;08;Tiistai;9;0;9
94;27.01.2015;2015;01;09;Tiistai;1;0;1
94;27.01.2015;2015;01;10;Tiistai;1;0;1
94;27.01.2015;2015;01;11;Tiistai;0;1;1
94;27.01.2015;2015;01;12;Tiistai;2;0;2
94;27.01.2015;2015;01;13;Tiistai;0;2;2
94;27.01.2015;2015;01;14;Tiistai;1;3;4
94;27.01.2015;2015;01;15;Tiistai;2;8;10
94;27.01.2015;2015;01;16;Tiistai;0;7;7
94;27.01.2015;2015;01;17;Tiistai;0;9;9
94;27.01.2015;2015;01;18;Tiistai;0;1;1
94;27.01.2015;2015;01;19;Tiistai;0;0;0
94;27.01.2015;2015;01;20;Tiistai;1;1;2
94;27.01.2015;2015;01;21;Tiistai;2;0;2
94;27.01.2015;2015;01;22;Tiistai;0;2;2
94;27.01.2015;2015;01;23;Tiistai;0;2;2
94;28.01.2015;2015;01;00;Keskiviikko;0;0;0
94;28.01.2015;2015;01;01;Keskiviikko;0;0;0
94;28.01.2015;2015;01;02;Keskiviikko;0;0;0
94;28.01.2015;2015;01;03;Keskiviikko;0;0;0
94;28.01.2015;2015;01;04;Keskiviikko;1;0;1
94;28.01.2015;2015;01;05;Keskiviikko;3;1;4
94;28.01.2015;2015;01;06;Keskiviikko;4;1;5
94;28.01.2015;2015;01;07;Keskiviikko;7;1;8
94;28.01.2015;2015;01;08;Keskiviikko;3;0;3
94;28.01.2015;2015;01;09;Keskiviikko;2;0;2
94;28.01.2015;2015;01;10;Keskiviikko;2;4;6
94;28.01.2015;2015;01;11;Keskiviikko;2;0;2
94;28.01.2015;2015;01;12;Keskiviikko;0;1;1
94;28.01.2015;2015;01;13;Keskiviikko;0;0;0
94;28.01.2015;2015;01;14;Keskiviikko;0;1;1
94;28.01.2015;2015;01;15;Keskiviikko;0;5;5
94;28.01.2015;2015;01;16;Keskiviikko;0;8;8
94;28.01.2015;2015;01;17;Keskiviikko;0;2;2
94;28.01.2015;2015;01;18;Keskiviikko;0;5;5
94;28.01.2015;2015;01;19;Keskiviikko;2;1;3
94;28.01.2015;2015;01;20;Keskiviikko;0;0;0
94;28.01.2015;2015;01;21;Keskiviikko;0;0;0
94;28.01.2015;2015;01;22;Keskiviikko;0;0;0
94;28.01.2015;2015;01;23;Keskiviikko;0;0;0
94;29.01.2015;2015;01;00;Torstai;0;0;0
94;29.01.2015;2015;01;01;Torstai;0;0;0
94;29.01.2015;2015;01;02;Torstai;0;0;0
94;29.01.2015;2015;01;03;Torstai;0;0;0
94;29.01.2015;2015;01;04;Torstai;0;0;0
94;29.01.2015;2015;01;05;Torstai;0;0;0
94;29.01.2015;2015;01;06;Torstai;4;1;5
94;29.01.2015;2015;01;07;Torstai;4;0;4
94;29.01.2015;2015;01;08;Torstai;2;1;3
94;29.01.2015;2015;01;09;Torstai;1;0;1
94;29.01.2015;2015;01;10;Torstai;0;0;0
94;29.01.2015;2015;01;11;Torstai;0;0;0
94;29.01.2015;2015;01;12;Torstai;0;0;0
94;29.01.2015;2015;01;13;Torstai;2;0;2
94;29.01.2015;2015;01;14;Torstai;0;0;0
94;29.01.2015;2015;01;15;Torstai;0;6;6
94;29.01.2015;2015;01;16;Torstai;0;4;4
94;29.01.2015;2015;01;17;Torstai;0;1;1
94;29.01.2015;2015;01;18;Torstai;1;0;1
94;29.01.2015;2015;01;19;Torstai;0;0;0
94;29.01.2015;2015;01;20;Torstai;0;2;2
94;29.01.2015;2015;01;21;Torstai;1;1;2
94;29.01.2015;2015;01;22;Torstai;0;1;1
94;29.01.2015;2015;01;23;Torstai;0;0;0
94;30.01.2015;2015;01;00;Perjantai;0;0;0
94;30.01.2015;2015;01;01;Perjantai;0;0;0
94;30.01.2015;2015;01;02;Perjantai;0;0;0
94;30.01.2015;2015;01;03;Perjantai;0;0;0
94;30.01.2015;2015;01;04;Perjantai;0;1;1
94;30.01.2015;2015;01;05;Perjantai;2;0;2
94;30.01.2015;2015;01;06;Perjantai;4;2;6
94;30.01.2015;2015;01;07;Perjantai;6;2;8
94;30.01.2015;2015;01;08;Perjantai;4;1;5
94;30.01.2015;2015;01;09;Perjantai;1;0;1
94;30.01.2015;2015;01;10;Perjantai;0;0;0
94;30.01.2015;2015;01;11;Perjantai;1;1;2
94;30.01.2015;2015;01;12;Perjantai;0;0;0
94;30.01.2015;2015;01;13;Perjantai;1;1;2
94;30.01.2015;2015;01;14;Perjantai;0;2;2
94;30.01.2015;2015;01;15;Perjantai;6;7;13
94;30.01.2015;2015;01;16;Perjantai;0;6;6
94;30.01.2015;2015;01;17;Perjantai;2;5;7
94;30.01.2015;2015;01;18;Perjantai;2;0;2
94;30.01.2015;2015;01;19;Perjantai;1;0;1
94;30.01.2015;2015;01;20;Perjantai;0;4;4
94;30.01.2015;2015;01;21;Perjantai;0;0;0
94;30.01.2015;2015;01;22;Perjantai;0;2;2
94;30.01.2015;2015;01;23;Perjantai;0;1;1
94;31.01.2015;2015;01;00;Lauantai;0;0;0
94;31.01.2015;2015;01;01;Lauantai;0;0;0
94;31.01.2015;2015;01;02;Lauantai;0;0;0
94;31.01.2015;2015;01;03;Lauantai;0;0;0
94;31.01.2015;2015;01;04;Lauantai;0;0;0
94;31.01.2015;2015;01;05;Lauantai;0;0;0
94;31.01.2015;2015;01;06;Lauantai;0;0;0
94;31.01.2015;2015;01;07;Lauantai;0;0;0
94;31.01.2015;2015;01;08;Lauantai;0;0;0
94;31.01.2015;2015;01;09;Lauantai;0;0;0
94;31.01.2015;2015;01;10;Lauantai;0;0;0
94;31.01.2015;2015;01;11;Lauantai;2;1;3
94;31.01.2015;2015;01;12;Lauantai;1;1;2
94;31.01.2015;2015;01;13;Lauantai;1;1;2
94;31.01.2015;2015;01;14;Lauantai;0;2;2
94;31.01.2015;2015;01;15;Lauantai;0;0;0
94;31.01.2015;2015;01;16;Lauantai;0;0;0
94;31.01.2015;2015;01;17;Lauantai;1;0;1
94;31.01.2015;2015;01;18;Lauantai;0;2;2
94;31.01.2015;2015;01;19;Lauantai;0;2;2
94;31.01.2015;2015;01;20;Lauantai;3;0;3
94;31.01.2015;2015;01;21;Lauantai;0;0;0
94;31.01.2015;2015;01;22;Lauantai;0;0;0
94;31.01.2015;2015;01;23;Lauantai;1;0;1
94;01.02.2015;2015;02;00;Sunnuntai;0;0;0
94;01.02.2015;2015;02;01;Sunnuntai;0;0;0
94;01.02.2015;2015;02;02;Sunnuntai;0;0;0
94;01.02.2015;2015;02;03;Sunnuntai;0;0;0
94;01.02.2015;2015;02;04;Sunnuntai;0;0;0
94;01.02.2015;2015;02;05;Sunnuntai;0;0;0
94;01.02.2015;2015;02;06;Sunnuntai;0;1;1
94;01.02.2015;2015;02;07;Sunnuntai;0;0;0
94;01.02.2015;2015;02;08;Sunnuntai;1;14;15
94;01.02.2015;2015;02;09;Sunnuntai;0;0;0
94;01.02.2015;2015;02;10;Sunnuntai;0;0;0
94;01.02.2015;2015;02;11;Sunnuntai;0;0;0
94;01.02.2015;2015;02;12;Sunnuntai;0;0;0
94;01.02.2015;2015;02;13;Sunnuntai;0;0;0
94;01.02.2015;2015;02;14;Sunnuntai;1;0;1
94;01.02.2015;2015;02;15;Sunnuntai;0;0;0
94;01.02.2015;2015;02;16;Sunnuntai;0;0;0
94;01.02.2015;2015;02;17;Sunnuntai;0;0;0
94;01.02.2015;2015;02;18;Sunnuntai;0;0;0
94;01.02.2015;2015;02;19;Sunnuntai;0;0;0
94;01.02.2015;2015;02;20;Sunnuntai;1;0;1
94;01.02.2015;2015;02;21;Sunnuntai;0;0;0
94;01.02.2015;2015;02;22;Sunnuntai;0;0;0
94;01.02.2015;2015;02;23;Sunnuntai;0;0;0
94;02.02.2015;2015;02;00;Maanantai;0;0;0
94;02.02.2015;2015;02;01;Maanantai;0;0;0
94;02.02.2015;2015;02;02;Maanantai;0;0;0
94;02.02.2015;2015;02;03;Maanantai;0;0;0
94;02.02.2015;2015;02;04;Maanantai;0;0;0
94;02.02.2015;2015;02;05;Maanantai;2;0;2
94;02.02.2015;2015;02;06;Maanantai;2;1;3
94;02.02.2015;2015;02;07;Maanantai;8;1;9
94;02.02.2015;2015;02;08;Maanantai;10;0;10
94;02.02.2015;2015;02;09;Maanantai;0;0;0
94;02.02.2015;2015;02;10;Maanantai;0;0;0
94;02.02.2015;2015;02;11;Maanantai;0;1;1
94;02.02.2015;2015;02;12;Maanantai;0;0;0
94;02.02.2015;2015;02;13;Maanantai;0;0;0
94;02.02.2015;2015;02;14;Maanantai;2;3;5
94;02.02.2015;2015;02;15;Maanantai;2;5;7
94;02.02.2015;2015;02;16;Maanantai;0;8;8
94;02.02.2015;2015;02;17;Maanantai;0;7;7
94;02.02.2015;2015;02;18;Maanantai;1;1;2
94;02.02.2015;2015;02;19;Maanantai;1;1;2
94;02.02.2015;2015;02;20;Maanantai;0;2;2
94;02.02.2015;2015;02;21;Maanantai;1;0;1
94;02.02.2015;2015;02;22;Maanantai;0;0;0
94;02.02.2015;2015;02;23;Maanantai;0;1;1
94;03.02.2015;2015;02;00;Tiistai;0;0;0
94;03.02.2015;2015;02;01;Tiistai;0;0;0
94;03.02.2015;2015;02;02;Tiistai;0;0;0
94;03.02.2015;2015;02;03;Tiistai;0;0;0
94;03.02.2015;2015;02;04;Tiistai;0;0;0
94;03.02.2015;2015;02;05;Tiistai;2;0;2
94;03.02.2015;2015;02;06;Tiistai;5;0;5
94;03.02.2015;2015;02;07;Tiistai;12;0;12
94;03.02.2015;2015;02;08;Tiistai;4;1;5
94;03.02.2015;2015;02;09;Tiistai;3;0;3
94;03.02.2015;2015;02;10;Tiistai;1;0;1
94;03.02.2015;2015;02;11;Tiistai;0;1;1
94;03.02.2015;2015;02;12;Tiistai;0;0;0
94;03.02.2015;2015;02;13;Tiistai;0;0;0
94;03.02.2015;2015;02;14;Tiistai;0;2;2
94;03.02.2015;2015;02;15;Tiistai;1;6;7
94;03.02.2015;2015;02;16;Tiistai;0;9;9
94;03.02.2015;2015;02;17;Tiistai;1;7;8
94;03.02.2015;2015;02;18;Tiistai;1;4;5
94;03.02.2015;2015;02;19;Tiistai;3;6;9
94;03.02.2015;2015;02;20;Tiistai;1;0;1
94;03.02.2015;2015;02;21;Tiistai;0;0;0
94;03.02.2015;2015;02;22;Tiistai;0;0;0
94;03.02.2015;2015;02;23;Tiistai;0;0;0
94;04.02.2015;2015;02;00;Keskiviikko;0;0;0
94;04.02.2015;2015;02;01;Keskiviikko;0;0;0
94;04.02.2015;2015;02;02;Keskiviikko;0;0;0
94;04.02.2015;2015;02;03;Keskiviikko;0;0;0
94;04.02.2015;2015;02;04;Keskiviikko;0;0;0
94;04.02.2015;2015;02;05;Keskiviikko;2;1;3
94;04.02.2015;2015;02;06;Keskiviikko;3;1;4
94;04.02.2015;2015;02;07;Keskiviikko;12;1;13
94;04.02.2015;2015;02;08;Keskiviikko;6;0;6
94;04.02.2015;2015;02;09;Keskiviikko;2;0;2
94;04.02.2015;2015;02;10;Keskiviikko;0;0;0
94;04.02.2015;2015;02;11;Keskiviikko;0;0;0
94;04.02.2015;2015;02;12;Keskiviikko;1;0;1
94;04.02.2015;2015;02;13;Keskiviikko;3;0;3
94;04.02.2015;2015;02;14;Keskiviikko;2;6;8
94;04.02.2015;2015;02;15;Keskiviikko;3;3;6
94;04.02.2015;2015;02;16;Keskiviikko;0;9;9
94;04.02.2015;2015;02;17;Keskiviikko;1;7;8
94;04.02.2015;2015;02;18;Keskiviikko;0;3;3
94;04.02.2015;2015;02;19;Keskiviikko;0;0;0
94;04.02.2015;2015;02;20;Keskiviikko;0;0;0
94;04.02.2015;2015;02;21;Keskiviikko;0;0;0
94;04.02.2015;2015;02;22;Keskiviikko;0;2;2
94;04.02.2015;2015;02;23;Keskiviikko;0;0;0
94;05.02.2015;2015;02;00;Torstai;0;0;0
94;05.02.2015;2015;02;01;Torstai;0;0;0
94;05.02.2015;2015;02;02;Torstai;0;0;0
94;05.02.2015;2015;02;03;Torstai;0;0;0
94;05.02.2015;2015;02;04;Torstai;0;0;0
94;05.02.2015;2015;02;05;Torstai;2;1;3
94;05.02.2015;2015;02;06;Torstai;3;1;4
94;05.02.2015;2015;02;07;Torstai;10;0;10
94;05.02.2015;2015;02;08;Torstai;4;1;5
94;05.02.2015;2015;02;09;Torstai;6;0;6
94;05.02.2015;2015;02;10;Torstai;0;1;1
94;05.02.2015;2015;02;11;Torstai;0;0;0
94;05.02.2015;2015;02;12;Torstai;1;0;1
94;05.02.2015;2015;02;13;Torstai;0;0;0
94;05.02.2015;2015;02;14;Torstai;4;3;7
94;05.02.2015;2015;02;15;Torstai;1;9;10
94;05.02.2015;2015;02;16;Torstai;1;13;14
94;05.02.2015;2015;02;17;Torstai;1;5;6
94;05.02.2015;2015;02;18;Torstai;0;2;2
94;05.02.2015;2015;02;19;Torstai;1;1;2
94;05.02.2015;2015;02;20;Torstai;0;0;0
94;05.02.2015;2015;02;21;Torstai;0;1;1
94;05.02.2015;2015;02;22;Torstai;0;0;0
94;05.02.2015;2015;02;23;Torstai;0;1;1
94;06.02.2015;2015;02;00;Perjantai;0;0;0
94;06.02.2015;2015;02;01;Perjantai;0;0;0
94;06.02.2015;2015;02;02;Perjantai;0;0;0
94;06.02.2015;2015;02;03;Perjantai;0;0;0
94;06.02.2015;2015;02;04;Perjantai;0;0;0
94;06.02.2015;2015;02;05;Perjantai;4;1;5
94;06.02.2015;2015;02;06;Perjantai;2;0;2
94;06.02.2015;2015;02;07;Perjantai;11;0;11
94;06.02.2015;2015;02;08;Perjantai;9;1;10
94;06.02.2015;2015;02;09;Perjantai;1;0;1
94;06.02.2015;2015;02;10;Perjantai;1;0;1
94;06.02.2015;2015;02;11;Perjantai;2;0;2
94;06.02.2015;2015;02;12;Perjantai;0;1;1
94;06.02.2015;2015;02;13;Perjantai;1;1;2
94;06.02.2015;2015;02;14;Perjantai;1;7;8
94;06.02.2015;2015;02;15;Perjantai;1;8;9
94;06.02.2015;2015;02;16;Perjantai;2;8;10
94;06.02.2015;2015;02;17;Perjantai;0;4;4
94;06.02.2015;2015;02;18;Perjantai;1;0;1
94;06.02.2015;2015;02;19;Perjantai;1;1;2
94;06.02.2015;2015;02;20;Perjantai;0;1;1
94;06.02.2015;2015;02;21;Perjantai;0;0;0
94;06.02.2015;2015;02;22;Perjantai;0;0;0
94;06.02.2015;2015;02;23;Perjantai;0;0;0
94;07.02.2015;2015;02;00;Lauantai;0;0;0
94;07.02.2015;2015;02;01;Lauantai;0;0;0
94;07.02.2015;2015;02;02;Lauantai;0;0;0
94;07.02.2015;2015;02;03;Lauantai;0;0;0
94;07.02.2015;2015;02;04;Lauantai;0;0;0
94;07.02.2015;2015;02;05;Lauantai;0;0;0
94;07.02.2015;2015;02;06;Lauantai;0;0;0
94;07.02.2015;2015;02;07;Lauantai;0;0;0
94;07.02.2015;2015;02;08;Lauantai;1;0;1
94;07.02.2015;2015;02;09;Lauantai;0;1;1
94;07.02.2015;2015;02;10;Lauantai;1;0;1
94;07.02.2015;2015;02;11;Lauantai;0;0;0
94;07.02.2015;2015;02;12;Lauantai;0;0;0
94;07.02.2015;2015;02;13;Lauantai;0;0;0
94;07.02.2015;2015;02;14;Lauantai;0;0;0
94;07.02.2015;2015;02;15;Lauantai;0;1;1
94;07.02.2015;2015;02;16;Lauantai;1;2;3
94;07.02.2015;2015;02;17;Lauantai;1;0;1
94;07.02.2015;2015;02;18;Lauantai;1;1;2
94;07.02.2015;2015;02;19;Lauantai;0;1;1
94;07.02.2015;2015;02;20;Lauantai;0;0;0
94;07.02.2015;2015;02;21;Lauantai;0;0;0
94;07.02.2015;2015;02;22;Lauantai;0;0;0
94;07.02.2015;2015;02;23;Lauantai;0;0;0
94;08.02.2015;2015;02;00;Sunnuntai;0;0;0
94;08.02.2015;2015;02;01;Sunnuntai;0;0;0
94;08.02.2015;2015;02;02;Sunnuntai;0;0;0
94;08.02.2015;2015;02;03;Sunnuntai;0;0;0
94;08.02.2015;2015;02;04;Sunnuntai;0;0;0
94;08.02.2015;2015;02;05;Sunnuntai;0;0;0
94;08.02.2015;2015;02;06;Sunnuntai;0;0;0
94;08.02.2015;2015;02;07;Sunnuntai;0;2;2
94;08.02.2015;2015;02;08;Sunnuntai;0;0;0
94;08.02.2015;2015;02;09;Sunnuntai;1;0;1
94;08.02.2015;2015;02;10;Sunnuntai;0;0;0
94;08.02.2015;2015;02;11;Sunnuntai;1;0;1
94;08.02.2015;2015;02;12;Sunnuntai;0;1;1
94;08.02.2015;2015;02;13;Sunnuntai;0;1;1
94;08.02.2015;2015;02;14;Sunnuntai;1;1;2
94;08.02.2015;2015;02;15;Sunnuntai;2;0;2
94;08.02.2015;2015;02;16;Sunnuntai;2;1;3
94;08.02.2015;2015;02;17;Sunnuntai;0;0;0
94;08.02.2015;2015;02;18;Sunnuntai;0;1;1
94;08.02.2015;2015;02;19;Sunnuntai;1;0;1
94;08.02.2015;2015;02;20;Sunnuntai;0;0;0
94;08.02.2015;2015;02;21;Sunnuntai;0;0;0
94;08.02.2015;2015;02;22;Sunnuntai;0;0;0
94;08.02.2015;2015;02;23;Sunnuntai;0;0;0
94;09.02.2015;2015;02;00;Maanantai;0;0;0
94;09.02.2015;2015;02;01;Maanantai;0;0;0
94;09.02.2015;2015;02;02;Maanantai;0;0;0
94;09.02.2015;2015;02;03;Maanantai;0;0;0
94;09.02.2015;2015;02;04;Maanantai;0;0;0
94;09.02.2015;2015;02;05;Maanantai;1;0;1
94;09.02.2015;2015;02;06;Maanantai;5;1;6
94;09.02.2015;2015;02;07;Maanantai;12;0;12
94;09.02.2015;2015;02;08;Maanantai;8;1;9
94;09.02.2015;2015;02;09;Maanantai;3;0;3
94;09.02.2015;2015;02;10;Maanantai;4;1;5
94;09.02.2015;2015;02;11;Maanantai;2;1;3
94;09.02.2015;2015;02;12;Maanantai;0;1;1
94;09.02.2015;2015;02;13;Maanantai;3;1;4
94;09.02.2015;2015;02;14;Maanantai;2;3;5
94;09.02.2015;2015;02;15;Maanantai;0;7;7
94;09.02.2015;2015;02;16;Maanantai;0;10;10
94;09.02.2015;2015;02;17;Maanantai;1;7;8
94;09.02.2015;2015;02;18;Maanantai;1;1;2
94;09.02.2015;2015;02;19;Maanantai;1;1;2
94;09.02.2015;2015;02;20;Maanantai;1;1;2
94;09.02.2015;2015;02;21;Maanantai;0;1;1
94;09.02.2015;2015;02;22;Maanantai;0;0;0
94;09.02.2015;2015;02;23;Maanantai;0;1;1
94;10.02.2015;2015;02;00;Tiistai;0;0;0
94;10.02.2015;2015;02;01;Tiistai;0;0;0
94;10.02.2015;2015;02;02;Tiistai;0;0;0
94;10.02.2015;2015;02;03;Tiistai;0;0;0
94;10.02.2015;2015;02;04;Tiistai;0;0;0
94;10.02.2015;2015;02;05;Tiistai;3;0;3
94;10.02.2015;2015;02;06;Tiistai;7;0;7
94;10.02.2015;2015;02;07;Tiistai;14;0;14
94;10.02.2015;2015;02;08;Tiistai;3;3;6
94;10.02.2015;2015;02;09;Tiistai;4;0;4
94;10.02.2015;2015;02;10;Tiistai;2;0;2
94;10.02.2015;2015;02;11;Tiistai;1;2;3
94;10.02.2015;2015;02;12;Tiistai;1;0;1
94;10.02.2015;2015;02;13;Tiistai;1;0;1
94;10.02.2015;2015;02;14;Tiistai;0;3;3
94;10.02.2015;2015;02;15;Tiistai;0;11;11
94;10.02.2015;2015;02;16;Tiistai;2;16;18
94;10.02.2015;2015;02;17;Tiistai;1;6;7
94;10.02.2015;2015;02;18;Tiistai;0;2;2
94;10.02.2015;2015;02;19;Tiistai;0;1;1
94;10.02.2015;2015;02;20;Tiistai;1;1;2
94;10.02.2015;2015;02;21;Tiistai;0;1;1
94;10.02.2015;2015;02;22;Tiistai;0;2;2
94;10.02.2015;2015;02;23;Tiistai;0;0;0
94;11.02.2015;2015;02;00;Keskiviikko;0;0;0
94;11.02.2015;2015;02;01;Keskiviikko;0;0;0
94;11.02.2015;2015;02;02;Keskiviikko;0;0;0
94;11.02.2015;2015;02;03;Keskiviikko;0;0;0
94;11.02.2015;2015;02;04;Keskiviikko;0;0;0
94;11.02.2015;2015;02;05;Keskiviikko;2;0;2
94;11.02.2015;2015;02;06;Keskiviikko;5;0;5
94;11.02.2015;2015;02;07;Keskiviikko;8;0;8
94;11.02.2015;2015;02;08;Keskiviikko;4;0;4
94;11.02.2015;2015;02;09;Keskiviikko;0;0;0
94;11.02.2015;2015;02;10;Keskiviikko;0;0;0
94;11.02.2015;2015;02;11;Keskiviikko;0;0;0
94;11.02.2015;2015;02;12;Keskiviikko;0;1;1
94;11.02.2015;2015;02;13;Keskiviikko;2;0;2
94;11.02.2015;2015;02;14;Keskiviikko;4;6;10
94;11.02.2015;2015;02;15;Keskiviikko;2;5;7
94;11.02.2015;2015;02;16;Keskiviikko;2;4;6
94;11.02.2015;2015;02;17;Keskiviikko;0;5;5
94;11.02.2015;2015;02;18;Keskiviikko;0;2;2
94;11.02.2015;2015;02;19;Keskiviikko;0;1;1
94;11.02.2015;2015;02;20;Keskiviikko;0;0;0
94;11.02.2015;2015;02;21;Keskiviikko;0;3;3
94;11.02.2015;2015;02;22;Keskiviikko;0;0;0
94;11.02.2015;2015;02;23;Keskiviikko;0;0;0
94;12.02.2015;2015;02;00;Torstai;1;0;1
94;12.02.2015;2015;02;01;Torstai;0;0;0
94;12.02.2015;2015;02;02;Torstai;0;0;0
94;12.02.2015;2015;02;03;Torstai;0;0;0
94;12.02.2015;2015;02;04;Torstai;0;2;2
94;12.02.2015;2015;02;05;Torstai;1;0;1
94;12.02.2015;2015;02;06;Torstai;4;2;6
94;12.02.2015;2015;02;07;Torstai;8;1;9
94;12.02.2015;2015;02;08;Torstai;4;0;4
94;12.02.2015;2015;02;09;Torstai;2;0;2
94;12.02.2015;2015;02;10;Torstai;0;0;0
94;12.02.2015;2015;02;11;Torstai;0;0;0
94;12.02.2015;2015;02;12;Torstai;0;3;3
94;12.02.2015;2015;02;13;Torstai;2;0;2
94;12.02.2015;2015;02;14;Torstai;0;1;1
94;12.02.2015;2015;02;15;Torstai;0;6;6
94;12.02.2015;2015;02;16;Torstai;2;8;10
94;12.02.2015;2015;02;17;Torstai;2;5;7
94;12.02.2015;2015;02;18;Torstai;0;0;0
94;12.02.2015;2015;02;19;Torstai;0;2;2
94;12.02.2015;2015;02;20;Torstai;1;1;2
94;12.02.2015;2015;02;21;Torstai;1;1;2
94;12.02.2015;2015;02;22;Torstai;0;0;0
94;12.02.2015;2015;02;23;Torstai;0;0;0
94;13.02.2015;2015;02;00;Perjantai;0;0;0
94;13.02.2015;2015;02;01;Perjantai;0;0;0
94;13.02.2015;2015;02;02;Perjantai;0;0;0
94;13.02.2015;2015;02;03;Perjantai;0;0;0
94;13.02.2015;2015;02;04;Perjantai;0;0;0
94;13.02.2015;2015;02;05;Perjantai;1;0;1
94;13.02.2015;2015;02;06;Perjantai;9;0;9
94;13.02.2015;2015;02;07;Perjantai;12;0;12
94;13.02.2015;2015;02;08;Perjantai;7;1;8
94;13.02.2015;2015;02;09;Perjantai;0;0;0
94;13.02.2015;2015;02;10;Perjantai;3;0;3
94;13.02.2015;2015;02;11;Perjantai;0;0;0
94;13.02.2015;2015;02;12;Perjantai;0;1;1
94;13.02.2015;2015;02;13;Perjantai;1;1;2
94;13.02.2015;2015;02;14;Perjantai;1;7;8
94;13.02.2015;2015;02;15;Perjantai;0;4;4
94;13.02.2015;2015;02;16;Perjantai;2;8;10
94;13.02.2015;2015;02;17;Perjantai;1;5;6
94;13.02.2015;2015;02;18;Perjantai;1;1;2
94;13.02.2015;2015;02;19;Perjantai;0;0;0
94;13.02.2015;2015;02;20;Perjantai;0;0;0
94;13.02.2015;2015;02;21;Perjantai;0;1;1
94;13.02.2015;2015;02;22;Perjantai;0;0;0
94;13.02.2015;2015;02;23;Perjantai;0;1;1
94;14.02.2015;2015;02;00;Lauantai;0;0;0
94;14.02.2015;2015;02;01;Lauantai;0;0;0
94;14.02.2015;2015;02;02;Lauantai;0;0;0
94;14.02.2015;2015;02;03;Lauantai;0;0;0
94;14.02.2015;2015;02;04;Lauantai;0;0;0
94;14.02.2015;2015;02;05;Lauantai;0;0;0
94;14.02.2015;2015;02;06;Lauantai;0;0;0
94;14.02.2015;2015;02;07;Lauantai;0;2;2
94;14.02.2015;2015;02;08;Lauantai;0;0;0
94;14.02.2015;2015;02;09;Lauantai;2;0;2
94;14.02.2015;2015;02;10;Lauantai;0;1;1
94;14.02.2015;2015;02;11;Lauantai;0;2;2
94;14.02.2015;2015;02;12;Lauantai;1;1;2
94;14.02.2015;2015;02;13;Lauantai;0;0;0
94;14.02.2015;2015;02;14;Lauantai;1;0;1
94;14.02.2015;2015;02;15;Lauantai;0;2;2
94;14.02.2015;2015;02;16;Lauantai;0;0;0
94;14.02.2015;2015;02;17;Lauantai;2;0;2
94;14.02.2015;2015;02;18;Lauantai;1;0;1
94;14.02.2015;2015;02;19;Lauantai;0;0;0
94;14.02.2015;2015;02;20;Lauantai;2;0;2
94;14.02.2015;2015;02;21;Lauantai;0;0;0
94;14.02.2015;2015;02;22;Lauantai;0;0;0
94;14.02.2015;2015;02;23;Lauantai;0;0;0
94;15.02.2015;2015;02;00;Sunnuntai;0;0;0
94;15.02.2015;2015;02;01;Sunnuntai;0;0;0
94;15.02.2015;2015;02;02;Sunnuntai;0;0;0
94;15.02.2015;2015;02;03;Sunnuntai;0;0;0
94;15.02.2015;2015;02;04;Sunnuntai;0;0;0
94;15.02.2015;2015;02;05;Sunnuntai;0;0;0
94;15.02.2015;2015;02;06;Sunnuntai;0;0;0
94;15.02.2015;2015;02;07;Sunnuntai;0;0;0
94;15.02.2015;2015;02;08;Sunnuntai;0;0;0
94;15.02.2015;2015;02;09;Sunnuntai;0;0;0
94;15.02.2015;2015;02;10;Sunnuntai;0;0;0
94;15.02.2015;2015;02;11;Sunnuntai;0;0;0
94;15.02.2015;2015;02;12;Sunnuntai;0;0;0
94;15.02.2015;2015;02;13;Sunnuntai;0;0;0
94;15.02.2015;2015;02;14;Sunnuntai;0;0;0
94;15.02.2015;2015;02;15;Sunnuntai;0;0;0
94;15.02.2015;2015;02;16;Sunnuntai;0;1;1
94;15.02.2015;2015;02;17;Sunnuntai;0;0;0
94;15.02.2015;2015;02;18;Sunnuntai;0;0;0
94;15.02.2015;2015;02;19;Sunnuntai;0;1;1
94;15.02.2015;2015;02;20;Sunnuntai;0;1;1
94;15.02.2015;2015;02;21;Sunnuntai;0;0;0
94;15.02.2015;2015;02;22;Sunnuntai;1;0;1
94;15.02.2015;2015;02;23;Sunnuntai;0;0;0
94;16.02.2015;2015;02;00;Maanantai;0;0;0
94;16.02.2015;2015;02;01;Maanantai;0;0;0
94;16.02.2015;2015;02;02;Maanantai;0;0;0
94;16.02.2015;2015;02;03;Maanantai;0;0;0
94;16.02.2015;2015;02;04;Maanantai;0;0;0
94;16.02.2015;2015;02;05;Maanantai;1;0;1
94;16.02.2015;2015;02;06;Maanantai;7;1;8
94;16.02.2015;2015;02;07;Maanantai;13;1;14
94;16.02.2015;2015;02;08;Maanantai;5;0;5
94;16.02.2015;2015;02;09;Maanantai;0;0;0
94;16.02.2015;2015;02;10;Maanantai;0;1;1
94;16.02.2015;2015;02;11;Maanantai;0;0;0
94;16.02.2015;2015;02;12;Maanantai;0;1;1
94;16.02.2015;2015;02;13;Maanantai;0;1;1
94;16.02.2015;2015;02;14;Maanantai;1;2;3
94;16.02.2015;2015;02;15;Maanantai;1;6;7
94;16.02.2015;2015;02;16;Maanantai;1;8;9
94;16.02.2015;2015;02;17;Maanantai;1;3;4
94;16.02.2015;2015;02;18;Maanantai;0;1;1
94;16.02.2015;2015;02;19;Maanantai;0;1;1
94;16.02.2015;2015;02;20;Maanantai;0;1;1
94;16.02.2015;2015;02;21;Maanantai;0;0;0
94;16.02.2015;2015;02;22;Maanantai;0;0;0
94;16.02.2015;2015;02;23;Maanantai;0;0;0
94;17.02.2015;2015;02;00;Tiistai;0;0;0
94;17.02.2015;2015;02;01;Tiistai;0;0;0
94;17.02.2015;2015;02;02;Tiistai;0;0;0
94;17.02.2015;2015;02;03;Tiistai;0;0;0
94;17.02.2015;2015;02;04;Tiistai;0;0;0
94;17.02.2015;2015;02;05;Tiistai;1;0;1
94;17.02.2015;2015;02;06;Tiistai;5;2;7
94;17.02.2015;2015;02;07;Tiistai;13;2;15
94;17.02.2015;2015;02;08;Tiistai;7;2;9
94;17.02.2015;2015;02;09;Tiistai;1;0;1
94;17.02.2015;2015;02;10;Tiistai;2;0;2
94;17.02.2015;2015;02;11;Tiistai;0;1;1
94;17.02.2015;2015;02;12;Tiistai;1;1;2
94;17.02.2015;2015;02;13;Tiistai;1;2;3
94;17.02.2015;2015;02;14;Tiistai;2;2;4
94;17.02.2015;2015;02;15;Tiistai;1;6;7
94;17.02.2015;2015;02;16;Tiistai;2;11;13
94;17.02.2015;2015;02;17;Tiistai;0;9;9
94;17.02.2015;2015;02;18;Tiistai;1;1;2
94;17.02.2015;2015;02;19;Tiistai;0;1;1
94;17.02.2015;2015;02;20;Tiistai;0;1;1
94;17.02.2015;2015;02;21;Tiistai;0;0;0
94;17.02.2015;2015;02;22;Tiistai;0;1;1
94;17.02.2015;2015;02;23;Tiistai;0;0;0
94;18.02.2015;2015;02;00;Keskiviikko;0;0;0
94;18.02.2015;2015;02;01;Keskiviikko;0;0;0
94;18.02.2015;2015;02;02;Keskiviikko;0;0;0
94;18.02.2015;2015;02;03;Keskiviikko;0;0;0
94;18.02.2015;2015;02;04;Keskiviikko;0;0;0
94;18.02.2015;2015;02;05;Keskiviikko;1;0;1
94;18.02.2015;2015;02;06;Keskiviikko;3;4;7
94;18.02.2015;2015;02;07;Keskiviikko;17;0;17
94;18.02.2015;2015;02;08;Keskiviikko;5;0;5
94;18.02.2015;2015;02;09;Keskiviikko;1;0;1
94;18.02.2015;2015;02;10;Keskiviikko;0;2;2
94;18.02.2015;2015;02;11;Keskiviikko;0;2;2
94;18.02.2015;2015;02;12;Keskiviikko;3;2;5
94;18.02.2015;2015;02;13;Keskiviikko;1;1;2
94;18.02.2015;2015;02;14;Keskiviikko;3;2;5
94;18.02.2015;2015;02;15;Keskiviikko;4;6;10
94;18.02.2015;2015;02;16;Keskiviikko;3;7;10
94;18.02.2015;2015;02;17;Keskiviikko;1;3;4
94;18.02.2015;2015;02;18;Keskiviikko;0;1;1
94;18.02.2015;2015;02;19;Keskiviikko;0;3;3
94;18.02.2015;2015;02;20;Keskiviikko;2;1;3
94;18.02.2015;2015;02;21;Keskiviikko;0;1;1
94;18.02.2015;2015;02;22;Keskiviikko;0;0;0
94;18.02.2015;2015;02;23;Keskiviikko;0;0;0
94;19.02.2015;2015;02;00;Torstai;0;0;0
94;19.02.2015;2015;02;01;Torstai;0;0;0
94;19.02.2015;2015;02;02;Torstai;0;0;0
94;19.02.2015;2015;02;03;Torstai;0;0;0
94;19.02.2015;2015;02;04;Torstai;0;0;0
94;19.02.2015;2015;02;05;Torstai;2;1;3
94;19.02.2015;2015;02;06;Torstai;3;1;4
94;19.02.2015;2015;02;07;Torstai;17;2;19
94;19.02.2015;2015;02;08;Torstai;2;0;2
94;19.02.2015;2015;02;09;Torstai;2;2;4
94;19.02.2015;2015;02;10;Torstai;1;0;1
94;19.02.2015;2015;02;11;Torstai;0;1;1
94;19.02.2015;2015;02;12;Torstai;0;1;1
94;19.02.2015;2015;02;13;Torstai;0;1;1
94;19.02.2015;2015;02;14;Torstai;4;2;6
94;19.02.2015;2015;02;15;Torstai;0;7;7
94;19.02.2015;2015;02;16;Torstai;1;10;11
94;19.02.2015;2015;02;17;Torstai;1;5;6
94;19.02.2015;2015;02;18;Torstai;1;2;3
94;19.02.2015;2015;02;19;Torstai;0;2;2
94;19.02.2015;2015;02;20;Torstai;0;0;0
94;19.02.2015;2015;02;21;Torstai;3;0;3
94;19.02.2015;2015;02;22;Torstai;0;0;0
94;19.02.2015;2015;02;23;Torstai;0;0;0
94;20.02.2015;2015;02;00;Perjantai;0;0;0
94;20.02.2015;2015;02;01;Perjantai;0;0;0
94;20.02.2015;2015;02;02;Perjantai;0;0;0
94;20.02.2015;2015;02;03;Perjantai;0;0;0
94;20.02.2015;2015;02;04;Perjantai;0;0;0
94;20.02.2015;2015;02;05;Perjantai;1;1;2
94;20.02.2015;2015;02;06;Perjantai;3;1;4
94;20.02.2015;2015;02;07;Perjantai;9;1;10
94;20.02.2015;2015;02;08;Perjantai;4;0;4
94;20.02.2015;2015;02;09;Perjantai;1;0;1
94;20.02.2015;2015;02;10;Perjantai;0;0;0
94;20.02.2015;2015;02;11;Perjantai;0;0;0
94;20.02.2015;2015;02;12;Perjantai;1;1;2
94;20.02.2015;2015;02;13;Perjantai;0;1;1
94;20.02.2015;2015;02;14;Perjantai;2;3;5
94;20.02.2015;2015;02;15;Perjantai;3;4;7
94;20.02.2015;2015;02;16;Perjantai;0;8;8
94;20.02.2015;2015;02;17;Perjantai;0;4;4
94;20.02.2015;2015;02;18;Perjantai;1;0;1
94;20.02.2015;2015;02;19;Perjantai;0;2;2
94;20.02.2015;2015;02;20;Perjantai;0;0;0
94;20.02.2015;2015;02;21;Perjantai;0;0;0
94;20.02.2015;2015;02;22;Perjantai;0;0;0
94;20.02.2015;2015;02;23;Perjantai;1;0;1
94;21.02.2015;2015;02;00;Lauantai;0;0;0
94;21.02.2015;2015;02;01;Lauantai;0;0;0
94;21.02.2015;2015;02;02;Lauantai;0;0;0
94;21.02.2015;2015;02;03;Lauantai;0;0;0
94;21.02.2015;2015;02;04;Lauantai;0;0;0
94;21.02.2015;2015;02;05;Lauantai;0;0;0
94;21.02.2015;2015;02;06;Lauantai;0;0;0
94;21.02.2015;2015;02;07;Lauantai;0;2;2
94;21.02.2015;2015;02;08;Lauantai;2;0;2
94;21.02.2015;2015;02;09;Lauantai;0;2;2
94;21.02.2015;2015;02;10;Lauantai;2;2;4
94;21.02.2015;2015;02;11;Lauantai;3;3;6
94;21.02.2015;2015;02;12;Lauantai;6;2;8
94;21.02.2015;2015;02;13;Lauantai;3;5;8
94;21.02.2015;2015;02;14;Lauantai;3;1;4
94;21.02.2015;2015;02;15;Lauantai;2;0;2
94;21.02.2015;2015;02;16;Lauantai;0;0;0
94;21.02.2015;2015;02;17;Lauantai;0;2;2
94;21.02.2015;2015;02;18;Lauantai;1;0;1
94;21.02.2015;2015;02;19;Lauantai;1;2;3
94;21.02.2015;2015;02;20;Lauantai;2;0;2
94;21.02.2015;2015;02;21;Lauantai;0;0;0
94;21.02.2015;2015;02;22;Lauantai;0;0;0
94;21.02.2015;2015;02;23;Lauantai;0;0;0
94;22.02.2015;2015;02;00;Sunnuntai;0;0;0
94;22.02.2015;2015;02;01;Sunnuntai;0;0;0
94;22.02.2015;2015;02;02;Sunnuntai;0;0;0
94;22.02.2015;2015;02;03;Sunnuntai;0;0;0
94;22.02.2015;2015;02;04;Sunnuntai;0;0;0
94;22.02.2015;2015;02;05;Sunnuntai;0;0;0
94;22.02.2015;2015;02;06;Sunnuntai;2;0;2
94;22.02.2015;2015;02;07;Sunnuntai;0;1;1
94;22.02.2015;2015;02;08;Sunnuntai;0;0;0
94;22.02.2015;2015;02;09;Sunnuntai;1;2;3
94;22.02.2015;2015;02;10;Sunnuntai;1;1;2
94;22.02.2015;2015;02;11;Sunnuntai;2;0;2
94;22.02.2015;2015;02;12;Sunnuntai;0;1;1
94;22.02.2015;2015;02;13;Sunnuntai;1;1;2
94;22.02.2015;2015;02;14;Sunnuntai;1;2;3
94;22.02.2015;2015;02;15;Sunnuntai;2;2;4
94;22.02.2015;2015;02;16;Sunnuntai;0;1;1
94;22.02.2015;2015;02;17;Sunnuntai;1;0;1
94;22.02.2015;2015;02;18;Sunnuntai;1;5;6
94;22.02.2015;2015;02;19;Sunnuntai;1;2;3
94;22.02.2015;2015;02;20;Sunnuntai;3;0;3
94;22.02.2015;2015;02;21;Sunnuntai;2;0;2
94;22.02.2015;2015;02;22;Sunnuntai;0;0;0
94;22.02.2015;2015;02;23;Sunnuntai;0;0;0
94;23.02.2015;2015;02;00;Maanantai;0;0;0
94;23.02.2015;2015;02;01;Maanantai;0;0;0
94;23.02.2015;2015;02;02;Maanantai;0;0;0
94;23.02.2015;2015;02;03;Maanantai;0;0;0
94;23.02.2015;2015;02;04;Maanantai;1;0;1
94;23.02.2015;2015;02;05;Maanantai;1;0;1
94;23.02.2015;2015;02;06;Maanantai;9;0;9
94;23.02.2015;2015;02;07;Maanantai;12;0;12
94;23.02.2015;2015;02;08;Maanantai;8;0;8
94;23.02.2015;2015;02;09;Maanantai;0;0;0
94;23.02.2015;2015;02;10;Maanantai;0;3;3
94;23.02.2015;2015;02;11;Maanantai;1;0;1
94;23.02.2015;2015;02;12;Maanantai;0;0;0
94;23.02.2015;2015;02;13;Maanantai;1;1;2
94;23.02.2015;2015;02;14;Maanantai;4;4;8
94;23.02.2015;2015;02;15;Maanantai;2;7;9
94;23.02.2015;2015;02;16;Maanantai;3;13;16
94;23.02.2015;2015;02;17;Maanantai;0;7;7
94;23.02.2015;2015;02;18;Maanantai;2;1;3
94;23.02.2015;2015;02;19;Maanantai;1;0;1
94;23.02.2015;2015;02;20;Maanantai;0;2;2
94;23.02.2015;2015;02;21;Maanantai;0;1;1
94;23.02.2015;2015;02;22;Maanantai;0;0;0
94;23.02.2015;2015;02;23;Maanantai;0;0;0
94;24.02.2015;2015;02;00;Tiistai;0;0;0
94;24.02.2015;2015;02;01;Tiistai;0;0;0
94;24.02.2015;2015;02;02;Tiistai;0;0;0
94;24.02.2015;2015;02;03;Tiistai;0;0;0
94;24.02.2015;2015;02;04;Tiistai;0;0;0
94;24.02.2015;2015;02;05;Tiistai;2;0;2
94;24.02.2015;2015;02;06;Tiistai;5;0;5
94;24.02.2015;2015;02;07;Tiistai;9;1;10
94;24.02.2015;2015;02;08;Tiistai;2;1;3
94;24.02.2015;2015;02;09;Tiistai;0;0;0
94;24.02.2015;2015;02;10;Tiistai;0;1;1
94;24.02.2015;2015;02;11;Tiistai;2;1;3
94;24.02.2015;2015;02;12;Tiistai;3;0;3
94;24.02.2015;2015;02;13;Tiistai;0;1;1
94;24.02.2015;2015;02;14;Tiistai;1;4;5
94;24.02.2015;2015;02;15;Tiistai;2;4;6
94;24.02.2015;2015;02;16;Tiistai;0;6;6
94;24.02.2015;2015;02;17;Tiistai;1;3;4
94;24.02.2015;2015;02;18;Tiistai;0;4;4
94;24.02.2015;2015;02;19;Tiistai;0;0;0
94;24.02.2015;2015;02;20;Tiistai;3;0;3
94;24.02.2015;2015;02;21;Tiistai;0;2;2
94;24.02.2015;2015;02;22;Tiistai;0;0;0
94;24.02.2015;2015;02;23;Tiistai;0;0;0
94;25.02.2015;2015;02;00;Keskiviikko;0;0;0
94;25.02.2015;2015;02;01;Keskiviikko;0;0;0
94;25.02.2015;2015;02;02;Keskiviikko;0;0;0
94;25.02.2015;2015;02;03;Keskiviikko;0;0;0
94;25.02.2015;2015;02;04;Keskiviikko;0;0;0
94;25.02.2015;2015;02;05;Keskiviikko;1;0;1
94;25.02.2015;2015;02;06;Keskiviikko;4;1;5
94;25.02.2015;2015;02;07;Keskiviikko;13;0;13
94;25.02.2015;2015;02;08;Keskiviikko;8;0;8
94;25.02.2015;2015;02;09;Keskiviikko;4;0;4
94;25.02.2015;2015;02;10;Keskiviikko;1;2;3
94;25.02.2015;2015;02;11;Keskiviikko;0;0;0
94;25.02.2015;2015;02;12;Keskiviikko;1;0;1
94;25.02.2015;2015;02;13;Keskiviikko;0;2;2
94;25.02.2015;2015;02;14;Keskiviikko;1;4;5
94;25.02.2015;2015;02;15;Keskiviikko;1;6;7
94;25.02.2015;2015;02;16;Keskiviikko;3;9;12
94;25.02.2015;2015;02;17;Keskiviikko;0;7;7
94;25.02.2015;2015;02;18;Keskiviikko;1;2;3
94;25.02.2015;2015;02;19;Keskiviikko;0;3;3
94;25.02.2015;2015;02;20;Keskiviikko;1;0;1
94;25.02.2015;2015;02;21;Keskiviikko;0;3;3
94;25.02.2015;2015;02;22;Keskiviikko;0;0;0
94;25.02.2015;2015;02;23;Keskiviikko;0;0;0
94;26.02.2015;2015;02;00;Torstai;0;0;0
94;26.02.2015;2015;02;01;Torstai;0;0;0
94;26.02.2015;2015;02;02;Torstai;0;0;0
94;26.02.2015;2015;02;03;Torstai;0;0;0
94;26.02.2015;2015;02;04;Torstai;0;0;0
94;26.02.2015;2015;02;05;Torstai;2;0;2
94;26.02.2015;2015;02;06;Torstai;9;2;11
94;26.02.2015;2015;02;07;Torstai;11;0;11
94;26.02.2015;2015;02;08;Torstai;5;0;5
94;26.02.2015;2015;02;09;Torstai;2;2;4
94;26.02.2015;2015;02;10;Torstai;0;0;0
94;26.02.2015;2015;02;11;Torstai;0;1;1
94;26.02.2015;2015;02;12;Torstai;3;1;4
94;26.02.2015;2015;02;13;Torstai;2;1;3
94;26.02.2015;2015;02;14;Torstai;0;7;7
94;26.02.2015;2015;02;15;Torstai;1;4;5
94;26.02.2015;2015;02;16;Torstai;0;16;16
94;26.02.2015;2015;02;17;Torstai;2;4;6
94;26.02.2015;2015;02;18;Torstai;1;0;1
94;26.02.2015;2015;02;19;Torstai;0;2;2
94;26.02.2015;2015;02;20;Torstai;1;2;3
94;26.02.2015;2015;02;21;Torstai;0;1;1
94;26.02.2015;2015;02;22;Torstai;0;1;1
94;26.02.2015;2015;02;23;Torstai;0;0;0
94;27.02.2015;2015;02;00;Perjantai;0;0;0
94;27.02.2015;2015;02;01;Perjantai;0;0;0
94;27.02.2015;2015;02;02;Perjantai;0;0;0
94;27.02.2015;2015;02;03;Perjantai;0;0;0
94;27.02.2015;2015;02;04;Perjantai;1;0;1
94;27.02.2015;2015;02;05;Perjantai;1;3;4
94;27.02.2015;2015;02;06;Perjantai;6;1;7
94;27.02.2015;2015;02;07;Perjantai;11;1;12
94;27.02.2015;2015;02;08;Perjantai;8;1;9
94;27.02.2015;2015;02;09;Perjantai;2;0;2
94;27.02.2015;2015;02;10;Perjantai;1;0;1
94;27.02.2015;2015;02;11;Perjantai;0;1;1
94;27.02.2015;2015;02;12;Perjantai;0;0;0
94;27.02.2015;2015;02;13;Perjantai;0;3;3
94;27.02.2015;2015;02;14;Perjantai;2;4;6
94;27.02.2015;2015;02;15;Perjantai;0;9;9
94;27.02.2015;2015;02;16;Perjantai;2;8;10
94;27.02.2015;2015;02;17;Perjantai;0;1;1
94;27.02.2015;2015;02;18;Perjantai;1;2;3
94;27.02.2015;2015;02;19;Perjantai;0;2;2
94;27.02.2015;2015;02;20;Perjantai;2;2;4
94;27.02.2015;2015;02;21;Perjantai;0;0;0
94;27.02.2015;2015;02;22;Perjantai;0;0;0
94;27.02.2015;2015;02;23;Perjantai;0;0;0
94;28.02.2015;2015;02;00;Lauantai;0;0;0
94;28.02.2015;2015;02;01;Lauantai;0;0;0
94;28.02.2015;2015;02;02;Lauantai;0;0;0
94;28.02.2015;2015;02;03;Lauantai;0;0;0
94;28.02.2015;2015;02;04;Lauantai;0;0;0
94;28.02.2015;2015;02;05;Lauantai;0;0;0
94;28.02.2015;2015;02;06;Lauantai;1;0;1
94;28.02.2015;2015;02;07;Lauantai;0;1;1
94;28.02.2015;2015;02;08;Lauantai;0;0;0
94;28.02.2015;2015;02;09;Lauantai;0;0;0
94;28.02.2015;2015;02;10;Lauantai;3;0;3
94;28.02.2015;2015;02;11;Lauantai;2;1;3
94;28.02.2015;2015;02;12;Lauantai;3;2;5
94;28.02.2015;2015;02;13;Lauantai;1;0;1
94;28.02.2015;2015;02;14;Lauantai;1;0;1
94;28.02.2015;2015;02;15;Lauantai;1;0;1
94;28.02.2015;2015;02;16;Lauantai;1;3;4
94;28.02.2015;2015;02;17;Lauantai;1;0;1
94;28.02.2015;2015;02;18;Lauantai;0;0;0
94;28.02.2015;2015;02;19;Lauantai;0;0;0
94;28.02.2015;2015;02;20;Lauantai;0;1;1
94;28.02.2015;2015;02;21;Lauantai;1;0;1
94;28.02.2015;2015;02;22;Lauantai;0;2;2
94;28.02.2015;2015;02;23;Lauantai;0;0;0
94;01.03.2015;2015;03;00;Sunnuntai;0;0;0
94;01.03.2015;2015;03;01;Sunnuntai;0;0;0
94;01.03.2015;2015;03;02;Sunnuntai;0;0;0
94;01.03.2015;2015;03;03;Sunnuntai;0;0;0
94;01.03.2015;2015;03;04;Sunnuntai;0;0;0
94;01.03.2015;2015;03;05;Sunnuntai;0;0;0
94;01.03.2015;2015;03;06;Sunnuntai;1;0;1
94;01.03.2015;2015;03;07;Sunnuntai;1;1;2
94;01.03.2015;2015;03;08;Sunnuntai;0;0;0
94;01.03.2015;2015;03;09;Sunnuntai;2;0;2
94;01.03.2015;2015;03;10;Sunnuntai;0;2;2
94;01.03.2015;2015;03;11;Sunnuntai;0;1;1
94;01.03.2015;2015;03;12;Sunnuntai;1;0;1
94;01.03.2015;2015;03;13;Sunnuntai;1;1;2
94;01.03.2015;2015;03;14;Sunnuntai;2;2;4
94;01.03.2015;2015;03;15;Sunnuntai;2;1;3
94;01.03.2015;2015;03;16;Sunnuntai;1;3;4
94;01.03.2015;2015;03;17;Sunnuntai;0;0;0
94;01.03.2015;2015;03;18;Sunnuntai;0;0;0
94;01.03.2015;2015;03;19;Sunnuntai;1;2;3
94;01.03.2015;2015;03;20;Sunnuntai;3;0;3
94;01.03.2015;2015;03;21;Sunnuntai;0;3;3
94;01.03.2015;2015;03;22;Sunnuntai;0;0;0
94;01.03.2015;2015;03;23;Sunnuntai;2;1;3
94;02.03.2015;2015;03;00;Maanantai;0;0;0
94;02.03.2015;2015;03;01;Maanantai;0;0;0
94;02.03.2015;2015;03;02;Maanantai;0;0;0
94;02.03.2015;2015;03;03;Maanantai;0;0;0
94;02.03.2015;2015;03;04;Maanantai;0;0;0
94;02.03.2015;2015;03;05;Maanantai;6;1;7
94;02.03.2015;2015;03;06;Maanantai;11;0;11
94;02.03.2015;2015;03;07;Maanantai;5;0;5
94;02.03.2015;2015;03;08;Maanantai;3;1;4
94;02.03.2015;2015;03;09;Maanantai;0;0;0
94;02.03.2015;2015;03;10;Maanantai;2;0;2
94;02.03.2015;2015;03;11;Maanantai;3;1;4
94;02.03.2015;2015;03;12;Maanantai;0;2;2
94;02.03.2015;2015;03;13;Maanantai;0;1;1
94;02.03.2015;2015;03;14;Maanantai;2;4;6
94;02.03.2015;2015;03;15;Maanantai;0;3;3
94;02.03.2015;2015;03;16;Maanantai;1;7;8
94;02.03.2015;2015;03;17;Maanantai;0;2;2
94;02.03.2015;2015;03;18;Maanantai;0;2;2
94;02.03.2015;2015;03;19;Maanantai;1;0;1
94;02.03.2015;2015;03;20;Maanantai;0;1;1
94;02.03.2015;2015;03;21;Maanantai;0;0;0
94;02.03.2015;2015;03;22;Maanantai;0;0;0
94;02.03.2015;2015;03;23;Maanantai;0;0;0
94;03.03.2015;2015;03;00;Tiistai;0;0;0
94;03.03.2015;2015;03;01;Tiistai;0;0;0
94;03.03.2015;2015;03;02;Tiistai;0;0;0
94;03.03.2015;2015;03;03;Tiistai;0;0;0
94;03.03.2015;2015;03;04;Tiistai;0;0;0
94;03.03.2015;2015;03;05;Tiistai;1;0;1
94;03.03.2015;2015;03;06;Tiistai;4;0;4
94;03.03.2015;2015;03;07;Tiistai;2;0;2
94;03.03.2015;2015;03;08;Tiistai;2;0;2
94;03.03.2015;2015;03;09;Tiistai;2;1;3
94;03.03.2015;2015;03;10;Tiistai;2;1;3
94;03.03.2015;2015;03;11;Tiistai;0;1;1
94;03.03.2015;2015;03;12;Tiistai;1;0;1
94;03.03.2015;2015;03;13;Tiistai;2;0;2
94;03.03.2015;2015;03;14;Tiistai;0;1;1
94;03.03.2015;2015;03;15;Tiistai;0;4;4
94;03.03.2015;2015;03;16;Tiistai;3;6;9
94;03.03.2015;2015;03;17;Tiistai;0;2;2
94;03.03.2015;2015;03;18;Tiistai;4;5;9
94;03.03.2015;2015;03;19;Tiistai;5;0;5
94;03.03.2015;2015;03;20;Tiistai;1;3;4
94;03.03.2015;2015;03;21;Tiistai;0;1;1
94;03.03.2015;2015;03;22;Tiistai;0;0;0
94;03.03.2015;2015;03;23;Tiistai;0;0;0
94;04.03.2015;2015;03;00;Keskiviikko;0;0;0
94;04.03.2015;2015;03;01;Keskiviikko;0;0;0
94;04.03.2015;2015;03;02;Keskiviikko;0;0;0
94;04.03.2015;2015;03;03;Keskiviikko;0;0;0
94;04.03.2015;2015;03;04;Keskiviikko;2;0;2
94;04.03.2015;2015;03;05;Keskiviikko;2;0;2
94;04.03.2015;2015;03;06;Keskiviikko;2;1;3
94;04.03.2015;2015;03;07;Keskiviikko;3;0;3
94;04.03.2015;2015;03;08;Keskiviikko;3;0;3
94;04.03.2015;2015;03;09;Keskiviikko;2;0;2
94;04.03.2015;2015;03;10;Keskiviikko;2;0;2
94;04.03.2015;2015;03;11;Keskiviikko;0;0;0
94;04.03.2015;2015;03;12;Keskiviikko;0;0;0
94;04.03.2015;2015;03;13;Keskiviikko;1;0;1
94;04.03.2015;2015;03;14;Keskiviikko;0;2;2
94;04.03.2015;2015;03;15;Keskiviikko;5;2;7
94;04.03.2015;2015;03;16;Keskiviikko;0;3;3
94;04.03.2015;2015;03;17;Keskiviikko;0;5;5
94;04.03.2015;2015;03;18;Keskiviikko;0;2;2
94;04.03.2015;2015;03;19;Keskiviikko;1;1;2
94;04.03.2015;2015;03;20;Keskiviikko;0;2;2
94;04.03.2015;2015;03;21;Keskiviikko;0;2;2
94;04.03.2015;2015;03;22;Keskiviikko;0;0;0
94;04.03.2015;2015;03;23;Keskiviikko;0;0;0
94;05.03.2015;2015;03;00;Torstai;0;0;0
94;05.03.2015;2015;03;01;Torstai;0;0;0
94;05.03.2015;2015;03;02;Torstai;0;0;0
94;05.03.2015;2015;03;03;Torstai;0;0;0
94;05.03.2015;2015;03;04;Torstai;1;0;1
94;05.03.2015;2015;03;05;Torstai;1;0;1
94;05.03.2015;2015;03;06;Torstai;3;0;3
94;05.03.2015;2015;03;07;Torstai;4;0;4
94;05.03.2015;2015;03;08;Torstai;2;0;2
94;05.03.2015;2015;03;09;Torstai;2;1;3
94;05.03.2015;2015;03;10;Torstai;1;0;1
94;05.03.2015;2015;03;11;Torstai;1;0;1
94;05.03.2015;2015;03;12;Torstai;3;1;4
94;05.03.2015;2015;03;13;Torstai;3;0;3
94;05.03.2015;2015;03;14;Torstai;0;2;2
94;05.03.2015;2015;03;15;Torstai;0;2;2
94;05.03.2015;2015;03;16;Torstai;0;6;6
94;05.03.2015;2015;03;17;Torstai;0;5;5
94;05.03.2015;2015;03;18;Torstai;3;1;4
94;05.03.2015;2015;03;19;Torstai;0;0;0
94;05.03.2015;2015;03;20;Torstai;0;1;1
94;05.03.2015;2015;03;21;Torstai;1;1;2
94;05.03.2015;2015;03;22;Torstai;0;1;1
94;05.03.2015;2015;03;23;Torstai;0;0;0
94;06.03.2015;2015;03;00;Perjantai;0;0;0
94;06.03.2015;2015;03;01;Perjantai;0;0;0
94;06.03.2015;2015;03;02;Perjantai;0;0;0
94;06.03.2015;2015;03;03;Perjantai;0;0;0
94;06.03.2015;2015;03;04;Perjantai;0;0;0
94;06.03.2015;2015;03;05;Perjantai;1;1;2
94;06.03.2015;2015;03;06;Perjantai;3;0;3
94;06.03.2015;2015;03;07;Perjantai;2;1;3
94;06.03.2015;2015;03;08;Perjantai;2;0;2
94;06.03.2015;2015;03;09;Perjantai;1;1;2
94;06.03.2015;2015;03;10;Perjantai;0;0;0
94;06.03.2015;2015;03;11;Perjantai;0;0;0
94;06.03.2015;2015;03;12;Perjantai;1;0;1
94;06.03.2015;2015;03;13;Perjantai;2;1;3
94;06.03.2015;2015;03;14;Perjantai;2;0;2
94;06.03.2015;2015;03;15;Perjantai;1;3;4
94;06.03.2015;2015;03;16;Perjantai;1;3;4
94;06.03.2015;2015;03;17;Perjantai;1;0;1
94;06.03.2015;2015;03;18;Perjantai;0;0;0
94;06.03.2015;2015;03;19;Perjantai;2;2;4
94;06.03.2015;2015;03;20;Perjantai;1;1;2
94;06.03.2015;2015;03;21;Perjantai;0;1;1
94;06.03.2015;2015;03;22;Perjantai;0;0;0
94;06.03.2015;2015;03;23;Perjantai;0;1;1
94;07.03.2015;2015;03;00;Lauantai;0;0;0
94;07.03.2015;2015;03;01;Lauantai;0;0;0
94;07.03.2015;2015;03;02;Lauantai;0;0;0
94;07.03.2015;2015;03;03;Lauantai;0;0;0
94;07.03.2015;2015;03;04;Lauantai;0;0;0
94;07.03.2015;2015;03;05;Lauantai;0;0;0
94;07.03.2015;2015;03;06;Lauantai;1;0;1
94;07.03.2015;2015;03;07;Lauantai;1;0;1
94;07.03.2015;2015;03;08;Lauantai;0;0;0
94;07.03.2015;2015;03;09;Lauantai;1;0;1
94;07.03.2015;2015;03;10;Lauantai;3;2;5
94;07.03.2015;2015;03;11;Lauantai;3;1;4
94;07.03.2015;2015;03;12;Lauantai;1;1;2
94;07.03.2015;2015;03;13;Lauantai;2;3;5
94;07.03.2015;2015;03;14;Lauantai;0;1;1
94;07.03.2015;2015;03;15;Lauantai;1;1;2
94;07.03.2015;2015;03;16;Lauantai;0;1;1
94;07.03.2015;2015;03;17;Lauantai;0;0;0
94;07.03.2015;2015;03;18;Lauantai;0;0;0
94;07.03.2015;2015;03;19;Lauantai;0;1;1
94;07.03.2015;2015;03;20;Lauantai;2;2;4
94;07.03.2015;2015;03;21;Lauantai;0;0;0
94;07.03.2015;2015;03;22;Lauantai;0;0;0
94;07.03.2015;2015;03;23;Lauantai;0;1;1
94;08.03.2015;2015;03;00;Sunnuntai;0;0;0
94;08.03.2015;2015;03;01;Sunnuntai;0;0;0
94;08.03.2015;2015;03;02;Sunnuntai;0;0;0
94;08.03.2015;2015;03;03;Sunnuntai;0;0;0
94;08.03.2015;2015;03;04;Sunnuntai;0;0;0
94;08.03.2015;2015;03;05;Sunnuntai;0;0;0
94;08.03.2015;2015;03;06;Sunnuntai;0;0;0
94;08.03.2015;2015;03;07;Sunnuntai;0;0;0
94;08.03.2015;2015;03;08;Sunnuntai;0;0;0
94;08.03.2015;2015;03;09;Sunnuntai;1;0;1
94;08.03.2015;2015;03;10;Sunnuntai;0;0;0
94;08.03.2015;2015;03;11;Sunnuntai;0;0;0
94;08.03.2015;2015;03;12;Sunnuntai;1;0;1
94;08.03.2015;2015;03;13;Sunnuntai;0;1;1
94;08.03.2015;2015;03;14;Sunnuntai;0;0;0
94;08.03.2015;2015;03;15;Sunnuntai;1;0;1
94;08.03.2015;2015;03;16;Sunnuntai;1;2;3
94;08.03.2015;2015;03;17;Sunnuntai;1;1;2
94;08.03.2015;2015;03;18;Sunnuntai;1;0;1
94;08.03.2015;2015;03;19;Sunnuntai;2;1;3
94;08.03.2015;2015;03;20;Sunnuntai;2;2;4
94;08.03.2015;2015;03;21;Sunnuntai;0;1;1
94;08.03.2015;2015;03;22;Sunnuntai;0;0;0
94;08.03.2015;2015;03;23;Sunnuntai;0;0;0
94;09.03.2015;2015;03;00;Maanantai;0;0;0
94;09.03.2015;2015;03;01;Maanantai;0;0;0
94;09.03.2015;2015;03;02;Maanantai;0;0;0
94;09.03.2015;2015;03;03;Maanantai;0;0;0
94;09.03.2015;2015;03;04;Maanantai;0;0;0
94;09.03.2015;2015;03;05;Maanantai;1;0;1
94;09.03.2015;2015;03;06;Maanantai;11;3;14
94;09.03.2015;2015;03;07;Maanantai;13;1;14
94;09.03.2015;2015;03;08;Maanantai;4;0;4
94;09.03.2015;2015;03;09;Maanantai;2;4;6
94;09.03.2015;2015;03;10;Maanantai;0;0;0
94;09.03.2015;2015;03;11;Maanantai;0;0;0
94;09.03.2015;2015;03;12;Maanantai;2;0;2
94;09.03.2015;2015;03;13;Maanantai;1;1;2
94;09.03.2015;2015;03;14;Maanantai;1;5;6
94;09.03.2015;2015;03;15;Maanantai;2;5;7
94;09.03.2015;2015;03;16;Maanantai;3;12;15
94;09.03.2015;2015;03;17;Maanantai;0;3;3
94;09.03.2015;2015;03;18;Maanantai;0;4;4
94;09.03.2015;2015;03;19;Maanantai;0;1;1
94;09.03.2015;2015;03;20;Maanantai;0;1;1
94;09.03.2015;2015;03;21;Maanantai;0;1;1
94;09.03.2015;2015;03;22;Maanantai;0;0;0
94;09.03.2015;2015;03;23;Maanantai;0;0;0
94;10.03.2015;2015;03;00;Tiistai;0;0;0
94;10.03.2015;2015;03;01;Tiistai;0;0;0
94;10.03.2015;2015;03;02;Tiistai;0;0;0
94;10.03.2015;2015;03;03;Tiistai;0;0;0
94;10.03.2015;2015;03;04;Tiistai;0;0;0
94;10.03.2015;2015;03;05;Tiistai;1;0;1
94;10.03.2015;2015;03;06;Tiistai;7;0;7
94;10.03.2015;2015;03;07;Tiistai;8;0;8
94;10.03.2015;2015;03;08;Tiistai;7;2;9
94;10.03.2015;2015;03;09;Tiistai;4;1;5
94;10.03.2015;2015;03;10;Tiistai;1;0;1
94;10.03.2015;2015;03;11;Tiistai;0;0;0
94;10.03.2015;2015;03;12;Tiistai;0;0;0
94;10.03.2015;2015;03;13;Tiistai;0;2;2
94;10.03.2015;2015;03;14;Tiistai;0;3;3
94;10.03.2015;2015;03;15;Tiistai;1;4;5
94;10.03.2015;2015;03;16;Tiistai;0;10;10
94;10.03.2015;2015;03;17;Tiistai;0;4;4
94;10.03.2015;2015;03;18;Tiistai;0;1;1
94;10.03.2015;2015;03;19;Tiistai;0;0;0
94;10.03.2015;2015;03;20;Tiistai;3;0;3
94;10.03.2015;2015;03;21;Tiistai;0;0;0
94;10.03.2015;2015;03;22;Tiistai;0;0;0
94;10.03.2015;2015;03;23;Tiistai;0;1;1
94;11.03.2015;2015;03;00;Keskiviikko;0;0;0
94;11.03.2015;2015;03;01;Keskiviikko;0;0;0
94;11.03.2015;2015;03;02;Keskiviikko;0;0;0
94;11.03.2015;2015;03;03;Keskiviikko;0;0;0
94;11.03.2015;2015;03;04;Keskiviikko;0;0;0
94;11.03.2015;2015;03;05;Keskiviikko;2;0;2
94;11.03.2015;2015;03;06;Keskiviikko;8;1;9
94;11.03.2015;2015;03;07;Keskiviikko;10;0;10
94;11.03.2015;2015;03;08;Keskiviikko;5;0;5
94;11.03.2015;2015;03;09;Keskiviikko;1;0;1
94;11.03.2015;2015;03;10;Keskiviikko;1;0;1
94;11.03.2015;2015;03;11;Keskiviikko;0;1;1
94;11.03.2015;2015;03;12;Keskiviikko;4;2;6
94;11.03.2015;2015;03;13;Keskiviikko;2;4;6
94;11.03.2015;2015;03;14;Keskiviikko;2;5;7
94;11.03.2015;2015;03;15;Keskiviikko;1;7;8
94;11.03.2015;2015;03;16;Keskiviikko;1;10;11
94;11.03.2015;2015;03;17;Keskiviikko;0;4;4
94;11.03.2015;2015;03;18;Keskiviikko;0;3;3
94;11.03.2015;2015;03;19;Keskiviikko;1;1;2
94;11.03.2015;2015;03;20;Keskiviikko;2;0;2
94;11.03.2015;2015;03;21;Keskiviikko;0;2;2
94;11.03.2015;2015;03;22;Keskiviikko;0;1;1
94;11.03.2015;2015;03;23;Keskiviikko;0;0;0
94;12.03.2015;2015;03;00;Torstai;0;0;0
94;12.03.2015;2015;03;01;Torstai;0;0;0
94;12.03.2015;2015;03;02;Torstai;0;1;1
94;12.03.2015;2015;03;03;Torstai;0;0;0
94;12.03.2015;2015;03;04;Torstai;0;0;0
94;12.03.2015;2015;03;05;Torstai;3;0;3
94;12.03.2015;2015;03;06;Torstai;3;0;3
94;12.03.2015;2015;03;07;Torstai;12;1;13
94;12.03.2015;2015;03;08;Torstai;3;1;4
94;12.03.2015;2015;03;09;Torstai;1;0;1
94;12.03.2015;2015;03;10;Torstai;4;0;4
94;12.03.2015;2015;03;11;Torstai;0;1;1
94;12.03.2015;2015;03;12;Torstai;1;0;1
94;12.03.2015;2015;03;13;Torstai;0;1;1
94;12.03.2015;2015;03;14;Torstai;0;4;4
94;12.03.2015;2015;03;15;Torstai;1;10;11
94;12.03.2015;2015;03;16;Torstai;2;8;10
94;12.03.2015;2015;03;17;Torstai;1;1;2
94;12.03.2015;2015;03;18;Torstai;1;0;1
94;12.03.2015;2015;03;19;Torstai;0;0;0
94;12.03.2015;2015;03;20;Torstai;0;1;1
94;12.03.2015;2015;03;21;Torstai;0;1;1
94;12.03.2015;2015;03;22;Torstai;0;1;1
94;12.03.2015;2015;03;23;Torstai;0;0;0
94;13.03.2015;2015;03;00;Perjantai;0;0;0
94;13.03.2015;2015;03;01;Perjantai;0;0;0
94;13.03.2015;2015;03;02;Perjantai;0;0;0
94;13.03.2015;2015;03;03;Perjantai;0;0;0
94;13.03.2015;2015;03;04;Perjantai;0;0;0
94;13.03.2015;2015;03;05;Perjantai;3;0;3
94;13.03.2015;2015;03;06;Perjantai;5;1;6
94;13.03.2015;2015;03;07;Perjantai;14;1;15
94;13.03.2015;2015;03;08;Perjantai;3;0;3
94;13.03.2015;2015;03;09;Perjantai;1;1;2
94;13.03.2015;2015;03;10;Perjantai;1;1;2
94;13.03.2015;2015;03;11;Perjantai;2;0;2
94;13.03.2015;2015;03;12;Perjantai;0;0;0
94;13.03.2015;2015;03;13;Perjantai;0;1;1
94;13.03.2015;2015;03;14;Perjantai;0;4;4
94;13.03.2015;2015;03;15;Perjantai;2;7;9
94;13.03.2015;2015;03;16;Perjantai;3;9;12
94;13.03.2015;2015;03;17;Perjantai;3;8;11
94;13.03.2015;2015;03;18;Perjantai;0;1;1
94;13.03.2015;2015;03;19;Perjantai;0;3;3
94;13.03.2015;2015;03;20;Perjantai;0;1;1
94;13.03.2015;2015;03;21;Perjantai;0;0;0
94;13.03.2015;2015;03;22;Perjantai;0;0;0
94;13.03.2015;2015;03;23;Perjantai;0;1;1
94;14.03.2015;2015;03;00;Lauantai;0;0;0
94;14.03.2015;2015;03;01;Lauantai;0;0;0
94;14.03.2015;2015;03;02;Lauantai;0;0;0
94;14.03.2015;2015;03;03;Lauantai;0;0;0
94;14.03.2015;2015;03;04;Lauantai;1;0;1
94;14.03.2015;2015;03;05;Lauantai;0;0;0
94;14.03.2015;2015;03;06;Lauantai;0;0;0
94;14.03.2015;2015;03;07;Lauantai;0;1;1
94;14.03.2015;2015;03;08;Lauantai;1;0;1
94;14.03.2015;2015;03;09;Lauantai;3;3;6
94;14.03.2015;2015;03;10;Lauantai;0;1;1
94;14.03.2015;2015;03;11;Lauantai;2;2;4
94;14.03.2015;2015;03;12;Lauantai;1;1;2
94;14.03.2015;2015;03;13;Lauantai;1;0;1
94;14.03.2015;2015;03;14;Lauantai;0;1;1
94;14.03.2015;2015;03;15;Lauantai;7;2;9
94;14.03.2015;2015;03;16;Lauantai;1;2;3
94;14.03.2015;2015;03;17;Lauantai;1;6;7
94;14.03.2015;2015;03;18;Lauantai;4;1;5
94;14.03.2015;2015;03;19;Lauantai;1;7;8
94;14.03.2015;2015;03;20;Lauantai;1;0;1
94;14.03.2015;2015;03;21;Lauantai;0;1;1
94;14.03.2015;2015;03;22;Lauantai;0;2;2
94;14.03.2015;2015;03;23;Lauantai;0;1;1
94;15.03.2015;2015;03;00;Sunnuntai;0;0;0
94;15.03.2015;2015;03;01;Sunnuntai;0;1;1
94;15.03.2015;2015;03;02;Sunnuntai;0;0;0
94;15.03.2015;2015;03;03;Sunnuntai;0;0;0
94;15.03.2015;2015;03;04;Sunnuntai;1;0;1
94;15.03.2015;2015;03;05;Sunnuntai;0;0;0
94;15.03.2015;2015;03;06;Sunnuntai;0;0;0
94;15.03.2015;2015;03;07;Sunnuntai;0;0;0
94;15.03.2015;2015;03;08;Sunnuntai;1;1;2
94;15.03.2015;2015;03;09;Sunnuntai;2;4;6
94;15.03.2015;2015;03;10;Sunnuntai;2;1;3
94;15.03.2015;2015;03;11;Sunnuntai;3;2;5
94;15.03.2015;2015;03;12;Sunnuntai;4;2;6
94;15.03.2015;2015;03;13;Sunnuntai;2;1;3
94;15.03.2015;2015;03;14;Sunnuntai;3;5;8
94;15.03.2015;2015;03;15;Sunnuntai;5;3;8
94;15.03.2015;2015;03;16;Sunnuntai;1;3;4
94;15.03.2015;2015;03;17;Sunnuntai;1;3;4
94;15.03.2015;2015;03;18;Sunnuntai;6;1;7
94;15.03.2015;2015;03;19;Sunnuntai;0;0;0
94;15.03.2015;2015;03;20;Sunnuntai;2;2;4
94;15.03.2015;2015;03;21;Sunnuntai;1;1;2
94;15.03.2015;2015;03;22;Sunnuntai;0;0;0
94;15.03.2015;2015;03;23;Sunnuntai;0;0;0
94;16.03.2015;2015;03;00;Maanantai;0;0;0
94;16.03.2015;2015;03;01;Maanantai;0;0;0
94;16.03.2015;2015;03;02;Maanantai;0;0;0
94;16.03.2015;2015;03;03;Maanantai;0;0;0
94;16.03.2015;2015;03;04;Maanantai;0;0;0
94;16.03.2015;2015;03;05;Maanantai;0;0;0
94;16.03.2015;2015;03;06;Maanantai;14;2;16
94;16.03.2015;2015;03;07;Maanantai;15;0;15
94;16.03.2015;2015;03;08;Maanantai;5;0;5
94;16.03.2015;2015;03;09;Maanantai;2;0;2
94;16.03.2015;2015;03;10;Maanantai;1;0;1
94;16.03.2015;2015;03;11;Maanantai;1;2;3
94;16.03.2015;2015;03;12;Maanantai;1;0;1
94;16.03.2015;2015;03;13;Maanantai;2;3;5
94;16.03.2015;2015;03;14;Maanantai;1;2;3
94;16.03.2015;2015;03;15;Maanantai;2;9;11
94;16.03.2015;2015;03;16;Maanantai;3;9;12
94;16.03.2015;2015;03;17;Maanantai;0;8;8
94;16.03.2015;2015;03;18;Maanantai;0;5;5
94;16.03.2015;2015;03;19;Maanantai;1;2;3
94;16.03.2015;2015;03;20;Maanantai;1;2;3
94;16.03.2015;2015;03;21;Maanantai;0;2;2
94;16.03.2015;2015;03;22;Maanantai;0;0;0
94;16.03.2015;2015;03;23;Maanantai;0;1;1
94;17.03.2015;2015;03;00;Tiistai;0;0;0
94;17.03.2015;2015;03;01;Tiistai;0;0;0
94;17.03.2015;2015;03;02;Tiistai;0;0;0
94;17.03.2015;2015;03;03;Tiistai;0;0;0
94;17.03.2015;2015;03;04;Tiistai;0;0;0
94;17.03.2015;2015;03;05;Tiistai;2;0;2
94;17.03.2015;2015;03;06;Tiistai;11;0;11
94;17.03.2015;2015;03;07;Tiistai;15;0;15
94;17.03.2015;2015;03;08;Tiistai;6;1;7
94;17.03.2015;2015;03;09;Tiistai;2;5;7
94;17.03.2015;2015;03;10;Tiistai;4;1;5
94;17.03.2015;2015;03;11;Tiistai;2;1;3
94;17.03.2015;2015;03;12;Tiistai;8;3;11
94;17.03.2015;2015;03;13;Tiistai;0;4;4
94;17.03.2015;2015;03;14;Tiistai;1;6;7
94;17.03.2015;2015;03;15;Tiistai;2;10;12
94;17.03.2015;2015;03;16;Tiistai;2;14;16
94;17.03.2015;2015;03;17;Tiistai;2;6;8
94;17.03.2015;2015;03;18;Tiistai;0;2;2
94;17.03.2015;2015;03;19;Tiistai;5;0;5
94;17.03.2015;2015;03;20;Tiistai;2;3;5
94;17.03.2015;2015;03;21;Tiistai;0;1;1
94;17.03.2015;2015;03;22;Tiistai;0;3;3
94;17.03.2015;2015;03;23;Tiistai;0;1;1
94;18.03.2015;2015;03;00;Keskiviikko;0;0;0
94;18.03.2015;2015;03;01;Keskiviikko;0;0;0
94;18.03.2015;2015;03;02;Keskiviikko;0;0;0
94;18.03.2015;2015;03;03;Keskiviikko;0;0;0
94;18.03.2015;2015;03;04;Keskiviikko;0;0;0
94;18.03.2015;2015;03;05;Keskiviikko;5;0;5
94;18.03.2015;2015;03;06;Keskiviikko;9;0;9
94;18.03.2015;2015;03;07;Keskiviikko;10;0;10
94;18.03.2015;2015;03;08;Keskiviikko;6;0;6
94;18.03.2015;2015;03;09;Keskiviikko;2;0;2
94;18.03.2015;2015;03;10;Keskiviikko;3;2;5
94;18.03.2015;2015;03;11;Keskiviikko;2;1;3
94;18.03.2015;2015;03;12;Keskiviikko;1;2;3
94;18.03.2015;2015;03;13;Keskiviikko;1;8;9
94;18.03.2015;2015;03;14;Keskiviikko;5;7;12
94;18.03.2015;2015;03;15;Keskiviikko;3;7;10
94;18.03.2015;2015;03;16;Keskiviikko;1;9;10
94;18.03.2015;2015;03;17;Keskiviikko;0;5;5
94;18.03.2015;2015;03;18;Keskiviikko;3;5;8
94;18.03.2015;2015;03;19;Keskiviikko;1;2;3
94;18.03.2015;2015;03;20;Keskiviikko;3;2;5
94;18.03.2015;2015;03;21;Keskiviikko;3;2;5
94;18.03.2015;2015;03;22;Keskiviikko;0;1;1
94;18.03.2015;2015;03;23;Keskiviikko;0;0;0
94;19.03.2015;2015;03;00;Torstai;0;0;0
94;19.03.2015;2015;03;01;Torstai;0;0;0
94;19.03.2015;2015;03;02;Torstai;0;0;0
94;19.03.2015;2015;03;03;Torstai;0;0;0
94;19.03.2015;2015;03;04;Torstai;0;0;0
94;19.03.2015;2015;03;05;Torstai;4;0;4
94;19.03.2015;2015;03;06;Torstai;7;0;7
94;19.03.2015;2015;03;07;Torstai;7;1;8
94;19.03.2015;2015;03;08;Torstai;6;0;6
94;19.03.2015;2015;03;09;Torstai;0;0;0
94;19.03.2015;2015;03;10;Torstai;2;0;2
94;19.03.2015;2015;03;11;Torstai;1;1;2
94;19.03.2015;2015;03;12;Torstai;2;0;2
94;19.03.2015;2015;03;13;Torstai;2;0;2
94;19.03.2015;2015;03;14;Torstai;0;5;5
94;19.03.2015;2015;03;15;Torstai;0;7;7
94;19.03.2015;2015;03;16;Torstai;0;8;8
94;19.03.2015;2015;03;17;Torstai;1;6;7
94;19.03.2015;2015;03;18;Torstai;1;2;3
94;19.03.2015;2015;03;19;Torstai;3;2;5
94;19.03.2015;2015;03;20;Torstai;3;1;4
94;19.03.2015;2015;03;21;Torstai;0;3;3
94;19.03.2015;2015;03;22;Torstai;0;1;1
94;19.03.2015;2015;03;23;Torstai;0;0;0
94;20.03.2015;2015;03;00;Perjantai;1;0;1
94;20.03.2015;2015;03;01;Perjantai;0;0;0
94;20.03.2015;2015;03;02;Perjantai;0;0;0
94;20.03.2015;2015;03;03;Perjantai;0;3;3
94;20.03.2015;2015;03;04;Perjantai;0;0;0
94;20.03.2015;2015;03;05;Perjantai;3;0;3
94;20.03.2015;2015;03;06;Perjantai;7;0;7
94;20.03.2015;2015;03;07;Perjantai;7;0;7
94;20.03.2015;2015;03;08;Perjantai;7;2;9
94;20.03.2015;2015;03;09;Perjantai;3;0;3
94;20.03.2015;2015;03;10;Perjantai;1;1;2
94;20.03.2015;2015;03;11;Perjantai;4;0;4
94;20.03.2015;2015;03;12;Perjantai;0;0;0
94;20.03.2015;2015;03;13;Perjantai;0;2;2
94;20.03.2015;2015;03;14;Perjantai;2;7;9
94;20.03.2015;2015;03;15;Perjantai;2;11;13
94;20.03.2015;2015;03;16;Perjantai;2;8;10
94;20.03.2015;2015;03;17;Perjantai;2;3;5
94;20.03.2015;2015;03;18;Perjantai;0;3;3
94;20.03.2015;2015;03;19;Perjantai;1;2;3
94;20.03.2015;2015;03;20;Perjantai;0;0;0
94;20.03.2015;2015;03;21;Perjantai;0;3;3
94;20.03.2015;2015;03;22;Perjantai;1;0;1
94;20.03.2015;2015;03;23;Perjantai;0;0;0
94;21.03.2015;2015;03;00;Lauantai;0;0;0
94;21.03.2015;2015;03;01;Lauantai;0;0;0
94;21.03.2015;2015;03;02;Lauantai;0;0;0
94;21.03.2015;2015;03;03;Lauantai;0;0;0
94;21.03.2015;2015;03;04;Lauantai;0;0;0
94;21.03.2015;2015;03;05;Lauantai;0;0;0
94;21.03.2015;2015;03;06;Lauantai;1;0;1
94;21.03.2015;2015;03;07;Lauantai;1;0;1
94;21.03.2015;2015;03;08;Lauantai;0;0;0
94;21.03.2015;2015;03;09;Lauantai;1;2;3
94;21.03.2015;2015;03;10;Lauantai;1;4;5
94;21.03.2015;2015;03;11;Lauantai;5;0;5
94;21.03.2015;2015;03;12;Lauantai;1;0;1
94;21.03.2015;2015;03;13;Lauantai;0;0;0
94;21.03.2015;2015;03;14;Lauantai;0;2;2
94;21.03.2015;2015;03;15;Lauantai;1;3;4
94;21.03.2015;2015;03;16;Lauantai;0;0;0
94;21.03.2015;2015;03;17;Lauantai;1;0;1
94;21.03.2015;2015;03;18;Lauantai;0;3;3
94;21.03.2015;2015;03;19;Lauantai;0;0;0
94;21.03.2015;2015;03;20;Lauantai;1;0;1
94;21.03.2015;2015;03;21;Lauantai;0;1;1
94;21.03.2015;2015;03;22;Lauantai;0;0;0
94;21.03.2015;2015;03;23;Lauantai;0;0;0
94;22.03.2015;2015;03;00;Sunnuntai;0;0;0
94;22.03.2015;2015;03;01;Sunnuntai;0;0;0
94;22.03.2015;2015;03;02;Sunnuntai;0;0;0
94;22.03.2015;2015;03;03;Sunnuntai;0;0;0
94;22.03.2015;2015;03;04;Sunnuntai;0;0;0
94;22.03.2015;2015;03;05;Sunnuntai;0;0;0
94;22.03.2015;2015;03;06;Sunnuntai;0;1;1
94;22.03.2015;2015;03;07;Sunnuntai;0;0;0
94;22.03.2015;2015;03;08;Sunnuntai;1;0;1
94;22.03.2015;2015;03;09;Sunnuntai;0;0;0
94;22.03.2015;2015;03;10;Sunnuntai;0;0;0
94;22.03.2015;2015;03;11;Sunnuntai;0;2;2
94;22.03.2015;2015;03;12;Sunnuntai;2;0;2
94;22.03.2015;2015;03;13;Sunnuntai;0;1;1
94;22.03.2015;2015;03;14;Sunnuntai;1;0;1
94;22.03.2015;2015;03;15;Sunnuntai;0;0;0
94;22.03.2015;2015;03;16;Sunnuntai;0;2;2
94;22.03.2015;2015;03;17;Sunnuntai;0;0;0
94;22.03.2015;2015;03;18;Sunnuntai;0;0;0
94;22.03.2015;2015;03;19;Sunnuntai;0;0;0
94;22.03.2015;2015;03;20;Sunnuntai;0;0;0
94;22.03.2015;2015;03;21;Sunnuntai;0;0;0
94;22.03.2015;2015;03;22;Sunnuntai;0;0;0
94;22.03.2015;2015;03;23;Sunnuntai;0;0;0
94;23.03.2015;2015;03;00;Maanantai;0;0;0
94;23.03.2015;2015;03;01;Maanantai;0;0;0
94;23.03.2015;2015;03;02;Maanantai;0;0;0
94;23.03.2015;2015;03;03;Maanantai;0;0;0
94;23.03.2015;2015;03;04;Maanantai;0;0;0
94;23.03.2015;2015;03;05;Maanantai;1;0;1
94;23.03.2015;2015;03;06;Maanantai;7;1;8
94;23.03.2015;2015;03;07;Maanantai;6;1;7
94;23.03.2015;2015;03;08;Maanantai;6;0;6
94;23.03.2015;2015;03;09;Maanantai;1;0;1
94;23.03.2015;2015;03;10;Maanantai;0;0;0
94;23.03.2015;2015;03;11;Maanantai;0;1;1
94;23.03.2015;2015;03;12;Maanantai;0;1;1
94;23.03.2015;2015;03;13;Maanantai;1;2;3
94;23.03.2015;2015;03;14;Maanantai;2;2;4
94;23.03.2015;2015;03;15;Maanantai;2;5;7
94;23.03.2015;2015;03;16;Maanantai;2;9;11
94;23.03.2015;2015;03;17;Maanantai;0;3;3
94;23.03.2015;2015;03;18;Maanantai;2;2;4
94;23.03.2015;2015;03;19;Maanantai;1;0;1
94;23.03.2015;2015;03;20;Maanantai;0;1;1
94;23.03.2015;2015;03;21;Maanantai;0;2;2
94;23.03.2015;2015;03;22;Maanantai;0;0;0
94;23.03.2015;2015;03;23;Maanantai;0;0;0
94;24.03.2015;2015;03;00;Tiistai;0;0;0
94;24.03.2015;2015;03;01;Tiistai;0;0;0
94;24.03.2015;2015;03;02;Tiistai;0;0;0
94;24.03.2015;2015;03;03;Tiistai;0;0;0
94;24.03.2015;2015;03;04;Tiistai;1;0;1
94;24.03.2015;2015;03;05;Tiistai;2;1;3
94;24.03.2015;2015;03;06;Tiistai;4;0;4
94;24.03.2015;2015;03;07;Tiistai;7;0;7
94;24.03.2015;2015;03;08;Tiistai;4;0;4
94;24.03.2015;2015;03;09;Tiistai;2;0;2
94;24.03.2015;2015;03;10;Tiistai;0;0;0
94;24.03.2015;2015;03;11;Tiistai;1;0;1
94;24.03.2015;2015;03;12;Tiistai;0;1;1
94;24.03.2015;2015;03;13;Tiistai;0;1;1
94;24.03.2015;2015;03;14;Tiistai;1;3;4
94;24.03.2015;2015;03;15;Tiistai;0;3;3
94;24.03.2015;2015;03;16;Tiistai;0;6;6
94;24.03.2015;2015;03;17;Tiistai;0;7;7
94;24.03.2015;2015;03;18;Tiistai;0;3;3
94;24.03.2015;2015;03;19;Tiistai;1;0;1
94;24.03.2015;2015;03;20;Tiistai;1;1;2
94;24.03.2015;2015;03;21;Tiistai;0;0;0
94;24.03.2015;2015;03;22;Tiistai;0;0;0
94;24.03.2015;2015;03;23;Tiistai;0;1;1
94;25.03.2015;2015;03;00;Keskiviikko;0;0;0
94;25.03.2015;2015;03;01;Keskiviikko;0;0;0
94;25.03.2015;2015;03;02;Keskiviikko;0;0;0
94;25.03.2015;2015;03;03;Keskiviikko;0;0;0
94;25.03.2015;2015;03;04;Keskiviikko;1;0;1
94;25.03.2015;2015;03;05;Keskiviikko;2;0;2
94;25.03.2015;2015;03;06;Keskiviikko;3;1;4
94;25.03.2015;2015;03;07;Keskiviikko;6;1;7
94;25.03.2015;2015;03;08;Keskiviikko;1;0;1
94;25.03.2015;2015;03;09;Keskiviikko;1;0;1
94;25.03.2015;2015;03;10;Keskiviikko;0;0;0
94;25.03.2015;2015;03;11;Keskiviikko;2;0;2
94;25.03.2015;2015;03;12;Keskiviikko;2;0;2
94;25.03.2015;2015;03;13;Keskiviikko;0;0;0
94;25.03.2015;2015;03;14;Keskiviikko;0;4;4
94;25.03.2015;2015;03;15;Keskiviikko;2;8;10
94;25.03.2015;2015;03;16;Keskiviikko;0;5;5
94;25.03.2015;2015;03;17;Keskiviikko;0;2;2
94;25.03.2015;2015;03;18;Keskiviikko;1;1;2
94;25.03.2015;2015;03;19;Keskiviikko;0;0;0
94;25.03.2015;2015;03;20;Keskiviikko;1;0;1
94;25.03.2015;2015;03;21;Keskiviikko;0;1;1
94;25.03.2015;2015;03;22;Keskiviikko;0;1;1
94;25.03.2015;2015;03;23;Keskiviikko;0;1;1
94;26.03.2015;2015;03;00;Torstai;0;0;0
94;26.03.2015;2015;03;01;Torstai;0;0;0
94;26.03.2015;2015;03;02;Torstai;0;0;0
94;26.03.2015;2015;03;03;Torstai;0;0;0
94;26.03.2015;2015;03;04;Torstai;0;0;0
94;26.03.2015;2015;03;05;Torstai;3;0;3
94;26.03.2015;2015;03;06;Torstai;3;1;4
94;26.03.2015;2015;03;07;Torstai;9;0;9
94;26.03.2015;2015;03;08;Torstai;3;0;3
94;26.03.2015;2015;03;09;Torstai;1;0;1
94;26.03.2015;2015;03;10;Torstai;0;0;0
94;26.03.2015;2015;03;11;Torstai;0;1;1
94;26.03.2015;2015;03;12;Torstai;2;1;3
94;26.03.2015;2015;03;13;Torstai;2;0;2
94;26.03.2015;2015;03;14;Torstai;0;1;1
94;26.03.2015;2015;03;15;Torstai;3;11;14
94;26.03.2015;2015;03;16;Torstai;1;8;9
94;26.03.2015;2015;03;17;Torstai;0;1;1
94;26.03.2015;2015;03;18;Torstai;0;2;2
94;26.03.2015;2015;03;19;Torstai;1;1;2
94;26.03.2015;2015;03;20;Torstai;1;0;1
94;26.03.2015;2015;03;21;Torstai;0;4;4
94;26.03.2015;2015;03;22;Torstai;0;1;1
94;26.03.2015;2015;03;23;Torstai;0;1;1
94;27.03.2015;2015;03;00;Perjantai;0;0;0
94;27.03.2015;2015;03;01;Perjantai;0;0;0
94;27.03.2015;2015;03;02;Perjantai;0;0;0
94;27.03.2015;2015;03;03;Perjantai;0;0;0
94;27.03.2015;2015;03;04;Perjantai;0;0;0
94;27.03.2015;2015;03;05;Perjantai;4;1;5
94;27.03.2015;2015;03;06;Perjantai;9;0;9
94;27.03.2015;2015;03;07;Perjantai;9;0;9
94;27.03.2015;2015;03;08;Perjantai;6;1;7
94;27.03.2015;2015;03;09;Perjantai;2;2;4
94;27.03.2015;2015;03;10;Perjantai;4;0;4
94;27.03.2015;2015;03;11;Perjantai;0;0;0
94;27.03.2015;2015;03;12;Perjantai;1;2;3
94;27.03.2015;2015;03;13;Perjantai;0;0;0
94;27.03.2015;2015;03;14;Perjantai;4;6;10
94;27.03.2015;2015;03;15;Perjantai;3;11;14
94;27.03.2015;2015;03;16;Perjantai;2;15;17
94;27.03.2015;2015;03;17;Perjantai;1;4;5
94;27.03.2015;2015;03;18;Perjantai;4;3;7
94;27.03.2015;2015;03;19;Perjantai;1;1;2
94;27.03.2015;2015;03;20;Perjantai;0;0;0
94;27.03.2015;2015;03;21;Perjantai;0;1;1
94;27.03.2015;2015;03;22;Perjantai;0;1;1
94;27.03.2015;2015;03;23;Perjantai;0;0;0
94;28.03.2015;2015;03;00;Lauantai;0;0;0
94;28.03.2015;2015;03;01;Lauantai;0;0;0
94;28.03.2015;2015;03;02;Lauantai;0;0;0
94;28.03.2015;2015;03;03;Lauantai;0;0;0
94;28.03.2015;2015;03;04;Lauantai;0;0;0
94;28.03.2015;2015;03;05;Lauantai;0;0;0
94;28.03.2015;2015;03;06;Lauantai;0;0;0
94;28.03.2015;2015;03;07;Lauantai;1;1;2
94;28.03.2015;2015;03;08;Lauantai;0;0;0
94;28.03.2015;2015;03;09;Lauantai;0;0;0
94;28.03.2015;2015;03;10;Lauantai;0;0;0
94;28.03.2015;2015;03;11;Lauantai;0;0;0
94;28.03.2015;2015;03;12;Lauantai;0;0;0
94;28.03.2015;2015;03;13;Lauantai;0;0;0
94;28.03.2015;2015;03;14;Lauantai;0;0;0
94;28.03.2015;2015;03;15;Lauantai;0;0;0
94;28.03.2015;2015;03;16;Lauantai;1;1;2
94;28.03.2015;2015;03;17;Lauantai;0;0;0
94;28.03.2015;2015;03;18;Lauantai;1;0;1
94;28.03.2015;2015;03;19;Lauantai;0;0;0
94;28.03.2015;2015;03;20;Lauantai;1;0;1
94;28.03.2015;2015;03;21;Lauantai;0;1;1
94;28.03.2015;2015;03;22;Lauantai;0;0;0
94;28.03.2015;2015;03;23;Lauantai;0;0;0
94;29.03.2015;2015;03;00;Sunnuntai;0;0;0
94;29.03.2015;2015;03;01;Sunnuntai;0;0;0
94;29.03.2015;2015;03;02;Sunnuntai;0;0;0
94;29.03.2015;2015;03;03;Sunnuntai;0;0;0
94;29.03.2015;2015;03;04;Sunnuntai;0;0;0
94;29.03.2015;2015;03;05;Sunnuntai;0;0;0
94;29.03.2015;2015;03;06;Sunnuntai;0;0;0
94;29.03.2015;2015;03;07;Sunnuntai;0;0;0
94;29.03.2015;2015;03;08;Sunnuntai;0;0;0
94;29.03.2015;2015;03;09;Sunnuntai;0;0;0
94;29.03.2015;2015;03;10;Sunnuntai;0;0;0
94;29.03.2015;2015;03;11;Sunnuntai;0;1;1
94;29.03.2015;2015;03;12;Sunnuntai;2;1;3
94;29.03.2015;2015;03;13;Sunnuntai;1;1;2
94;29.03.2015;2015;03;14;Sunnuntai;0;0;0
94;29.03.2015;2015;03;15;Sunnuntai;1;1;2
94;29.03.2015;2015;03;16;Sunnuntai;0;0;0
94;29.03.2015;2015;03;17;Sunnuntai;0;2;2
94;29.03.2015;2015;03;18;Sunnuntai;0;0;0
94;29.03.2015;2015;03;19;Sunnuntai;0;2;2
94;29.03.2015;2015;03;20;Sunnuntai;1;0;1
94;29.03.2015;2015;03;21;Sunnuntai;1;0;1
94;29.03.2015;2015;03;22;Sunnuntai;0;0;0
94;29.03.2015;2015;03;23;Sunnuntai;0;0;0
94;30.03.2015;2015;03;00;Maanantai;0;0;0
94;30.03.2015;2015;03;01;Maanantai;0;0;0
94;30.03.2015;2015;03;02;Maanantai;0;0;0
94;30.03.2015;2015;03;03;Maanantai;0;0;0
94;30.03.2015;2015;03;04;Maanantai;0;0;0
94;30.03.2015;2015;03;05;Maanantai;1;0;1
94;30.03.2015;2015;03;06;Maanantai;5;0;5
94;30.03.2015;2015;03;07;Maanantai;11;1;12
94;30.03.2015;2015;03;08;Maanantai;4;0;4
94;30.03.2015;2015;03;09;Maanantai;1;0;1
94;30.03.2015;2015;03;10;Maanantai;0;0;0
94;30.03.2015;2015;03;11;Maanantai;0;0;0
94;30.03.2015;2015;03;12;Maanantai;0;0;0
94;30.03.2015;2015;03;13;Maanantai;1;1;2
94;30.03.2015;2015;03;14;Maanantai;0;2;2
94;30.03.2015;2015;03;15;Maanantai;1;7;8
94;30.03.2015;2015;03;16;Maanantai;0;6;6
94;30.03.2015;2015;03;17;Maanantai;0;5;5
94;30.03.2015;2015;03;18;Maanantai;1;2;3
94;30.03.2015;2015;03;19;Maanantai;0;1;1
94;30.03.2015;2015;03;20;Maanantai;0;0;0
94;30.03.2015;2015;03;21;Maanantai;0;1;1
94;30.03.2015;2015;03;22;Maanantai;0;0;0
94;30.03.2015;2015;03;23;Maanantai;0;0;0
94;31.03.2015;2015;03;00;Tiistai;0;0;0
94;31.03.2015;2015;03;01;Tiistai;0;0;0
94;31.03.2015;2015;03;02;Tiistai;0;0;0
94;31.03.2015;2015;03;03;Tiistai;0;0;0
94;31.03.2015;2015;03;04;Tiistai;0;0;0
94;31.03.2015;2015;03;05;Tiistai;1;0;1
94;31.03.2015;2015;03;06;Tiistai;2;0;2
94;31.03.2015;2015;03;07;Tiistai;7;0;7
94;31.03.2015;2015;03;08;Tiistai;2;0;2
94;31.03.2015;2015;03;09;Tiistai;3;0;3
94;31.03.2015;2015;03;10;Tiistai;0;0;0
94;31.03.2015;2015;03;11;Tiistai;2;1;3
94;31.03.2015;2015;03;12;Tiistai;0;2;2
94;31.03.2015;2015;03;13;Tiistai;0;3;3
94;31.03.2015;2015;03;14;Tiistai;0;2;2
94;31.03.2015;2015;03;15;Tiistai;2;6;8
94;31.03.2015;2015;03;16;Tiistai;1;5;6
94;31.03.2015;2015;03;17;Tiistai;0;5;5
94;31.03.2015;2015;03;18;Tiistai;0;2;2
94;31.03.2015;2015;03;19;Tiistai;0;4;4
94;31.03.2015;2015;03;20;Tiistai;0;2;2
94;31.03.2015;2015;03;21;Tiistai;0;2;2
94;31.03.2015;2015;03;22;Tiistai;1;1;2
94;31.03.2015;2015;03;23;Tiistai;0;0;0
94;01.04.2015;2015;04;00;Keskiviikko;0;0;0
94;01.04.2015;2015;04;01;Keskiviikko;0;0;0
94;01.04.2015;2015;04;02;Keskiviikko;0;0;0
94;01.04.2015;2015;04;03;Keskiviikko;0;0;0
94;01.04.2015;2015;04;04;Keskiviikko;0;0;0
94;01.04.2015;2015;04;05;Keskiviikko;2;1;3
94;01.04.2015;2015;04;06;Keskiviikko;6;0;6
94;01.04.2015;2015;04;07;Keskiviikko;9;0;9
94;01.04.2015;2015;04;08;Keskiviikko;4;2;6
94;01.04.2015;2015;04;09;Keskiviikko;0;0;0
94;01.04.2015;2015;04;10;Keskiviikko;1;0;1
94;01.04.2015;2015;04;11;Keskiviikko;0;0;0
94;01.04.2015;2015;04;12;Keskiviikko;2;1;3
94;01.04.2015;2015;04;13;Keskiviikko;1;2;3
94;01.04.2015;2015;04;14;Keskiviikko;3;9;12
94;01.04.2015;2015;04;15;Keskiviikko;3;8;11
94;01.04.2015;2015;04;16;Keskiviikko;0;6;6
94;01.04.2015;2015;04;17;Keskiviikko;5;4;9
94;01.04.2015;2015;04;18;Keskiviikko;1;2;3
94;01.04.2015;2015;04;19;Keskiviikko;1;2;3
94;01.04.2015;2015;04;20;Keskiviikko;2;2;4
94;01.04.2015;2015;04;21;Keskiviikko;0;2;2
94;01.04.2015;2015;04;22;Keskiviikko;0;1;1
94;01.04.2015;2015;04;23;Keskiviikko;0;0;0
94;02.04.2015;2015;04;00;Torstai;0;0;0
94;02.04.2015;2015;04;01;Torstai;0;0;0
94;02.04.2015;2015;04;02;Torstai;0;0;0
94;02.04.2015;2015;04;03;Torstai;0;0;0
94;02.04.2015;2015;04;04;Torstai;0;0;0
94;02.04.2015;2015;04;05;Torstai;2;0;2
94;02.04.2015;2015;04;06;Torstai;5;0;5
94;02.04.2015;2015;04;07;Torstai;8;0;8
94;02.04.2015;2015;04;08;Torstai;6;1;7
94;02.04.2015;2015;04;09;Torstai;2;0;2
94;02.04.2015;2015;04;10;Torstai;4;1;5
94;02.04.2015;2015;04;11;Torstai;1;1;2
94;02.04.2015;2015;04;12;Torstai;1;0;1
94;02.04.2015;2015;04;13;Torstai;2;3;5
94;02.04.2015;2015;04;14;Torstai;1;3;4
94;02.04.2015;2015;04;15;Torstai;0;9;9
94;02.04.2015;2015;04;16;Torstai;0;7;7
94;02.04.2015;2015;04;17;Torstai;1;2;3
94;02.04.2015;2015;04;18;Torstai;3;2;5
94;02.04.2015;2015;04;19;Torstai;4;3;7
94;02.04.2015;2015;04;20;Torstai;0;5;5
94;02.04.2015;2015;04;21;Torstai;1;4;5
94;02.04.2015;2015;04;22;Torstai;2;0;2
94;02.04.2015;2015;04;23;Torstai;0;0;0
94;03.04.2015;2015;04;00;Perjantai;0;0;0
94;03.04.2015;2015;04;01;Perjantai;0;0;0
94;03.04.2015;2015;04;02;Perjantai;0;0;0
94;03.04.2015;2015;04;03;Perjantai;0;1;1
94;03.04.2015;2015;04;04;Perjantai;1;0;1
94;03.04.2015;2015;04;05;Perjantai;0;0;0
94;03.04.2015;2015;04;06;Perjantai;1;0;1
94;03.04.2015;2015;04;07;Perjantai;0;0;0
94;03.04.2015;2015;04;08;Perjantai;0;0;0
94;03.04.2015;2015;04;09;Perjantai;0;0;0
94;03.04.2015;2015;04;10;Perjantai;0;1;1
94;03.04.2015;2015;04;11;Perjantai;0;0;0
94;03.04.2015;2015;04;12;Perjantai;0;0;0
94;03.04.2015;2015;04;13;Perjantai;2;2;4
94;03.04.2015;2015;04;14;Perjantai;3;1;4
94;03.04.2015;2015;04;15;Perjantai;2;2;4
94;03.04.2015;2015;04;16;Perjantai;0;4;4
94;03.04.2015;2015;04;17;Perjantai;3;2;5
94;03.04.2015;2015;04;18;Perjantai;3;3;6
94;03.04.2015;2015;04;19;Perjantai;1;0;1
94;03.04.2015;2015;04;20;Perjantai;0;1;1
94;03.04.2015;2015;04;21;Perjantai;0;0;0
94;03.04.2015;2015;04;22;Perjantai;0;0;0
94;03.04.2015;2015;04;23;Perjantai;0;0;0
94;04.04.2015;2015;04;00;Lauantai;0;0;0
94;04.04.2015;2015;04;01;Lauantai;0;0;0
94;04.04.2015;2015;04;02;Lauantai;0;0;0
94;04.04.2015;2015;04;03;Lauantai;0;0;0
94;04.04.2015;2015;04;04;Lauantai;1;0;1
94;04.04.2015;2015;04;05;Lauantai;0;0;0
94;04.04.2015;2015;04;06;Lauantai;0;0;0
94;04.04.2015;2015;04;07;Lauantai;0;1;1
94;04.04.2015;2015;04;08;Lauantai;0;0;0
94;04.04.2015;2015;04;09;Lauantai;0;0;0
94;04.04.2015;2015;04;10;Lauantai;3;2;5
94;04.04.2015;2015;04;11;Lauantai;1;0;1
94;04.04.2015;2015;04;12;Lauantai;2;2;4
94;04.04.2015;2015;04;13;Lauantai;5;2;7
94;04.04.2015;2015;04;14;Lauantai;3;4;7
94;04.04.2015;2015;04;15;Lauantai;4;3;7
94;04.04.2015;2015;04;16;Lauantai;3;2;5
94;04.04.2015;2015;04;17;Lauantai;1;3;4
94;04.04.2015;2015;04;18;Lauantai;4;4;8
94;04.04.2015;2015;04;19;Lauantai;3;1;4
94;04.04.2015;2015;04;20;Lauantai;1;1;2
94;04.04.2015;2015;04;21;Lauantai;0;0;0
94;04.04.2015;2015;04;22;Lauantai;0;0;0
94;04.04.2015;2015;04;23;Lauantai;0;1;1
94;05.04.2015;2015;04;00;Sunnuntai;0;0;0
94;05.04.2015;2015;04;01;Sunnuntai;0;0;0
94;05.04.2015;2015;04;02;Sunnuntai;0;0;0
94;05.04.2015;2015;04;03;Sunnuntai;0;0;0
94;05.04.2015;2015;04;04;Sunnuntai;0;0;0
94;05.04.2015;2015;04;05;Sunnuntai;0;0;0
94;05.04.2015;2015;04;06;Sunnuntai;0;0;0
94;05.04.2015;2015;04;07;Sunnuntai;0;0;0
94;05.04.2015;2015;04;08;Sunnuntai;2;1;3
94;05.04.2015;2015;04;09;Sunnuntai;3;0;3
94;05.04.2015;2015;04;10;Sunnuntai;3;2;5
94;05.04.2015;2015;04;11;Sunnuntai;3;7;10
94;05.04.2015;2015;04;12;Sunnuntai;2;10;12
94;05.04.2015;2015;04;13;Sunnuntai;5;4;9
94;05.04.2015;2015;04;14;Sunnuntai;7;8;15
94;05.04.2015;2015;04;15;Sunnuntai;7;2;9
94;05.04.2015;2015;04;16;Sunnuntai;4;0;4
94;05.04.2015;2015;04;17;Sunnuntai;5;2;7
94;05.04.2015;2015;04;18;Sunnuntai;5;6;11
94;05.04.2015;2015;04;19;Sunnuntai;6;5;11
94;05.04.2015;2015;04;20;Sunnuntai;0;0;0
94;05.04.2015;2015;04;21;Sunnuntai;0;3;3
94;05.04.2015;2015;04;22;Sunnuntai;0;0;0
94;05.04.2015;2015;04;23;Sunnuntai;0;2;2
94;06.04.2015;2015;04;00;Maanantai;0;0;0
94;06.04.2015;2015;04;01;Maanantai;0;0;0
94;06.04.2015;2015;04;02;Maanantai;0;0;0
94;06.04.2015;2015;04;03;Maanantai;0;0;0
94;06.04.2015;2015;04;04;Maanantai;0;0;0
94;06.04.2015;2015;04;05;Maanantai;0;0;0
94;06.04.2015;2015;04;06;Maanantai;0;0;0
94;06.04.2015;2015;04;07;Maanantai;0;0;0
94;06.04.2015;2015;04;08;Maanantai;1;2;3
94;06.04.2015;2015;04;09;Maanantai;0;4;4
94;06.04.2015;2015;04;10;Maanantai;1;2;3
94;06.04.2015;2015;04;11;Maanantai;4;1;5
94;06.04.2015;2015;04;12;Maanantai;3;1;4
94;06.04.2015;2015;04;13;Maanantai;5;4;9
94;06.04.2015;2015;04;14;Maanantai;1;0;1
94;06.04.2015;2015;04;15;Maanantai;0;0;0
94;06.04.2015;2015;04;16;Maanantai;1;0;1
94;06.04.2015;2015;04;17;Maanantai;0;0;0
94;06.04.2015;2015;04;18;Maanantai;1;0;1
94;06.04.2015;2015;04;19;Maanantai;4;2;6
94;06.04.2015;2015;04;20;Maanantai;2;3;5
94;06.04.2015;2015;04;21;Maanantai;1;4;5
94;06.04.2015;2015;04;22;Maanantai;0;1;1
94;06.04.2015;2015;04;23;Maanantai;0;0;0
94;07.04.2015;2015;04;00;Tiistai;0;0;0
94;07.04.2015;2015;04;01;Tiistai;0;0;0
94;07.04.2015;2015;04;02;Tiistai;0;0;0
94;07.04.2015;2015;04;03;Tiistai;0;0;0
94;07.04.2015;2015;04;04;Tiistai;0;0;0
94;07.04.2015;2015;04;05;Tiistai;3;1;4
94;07.04.2015;2015;04;06;Tiistai;8;1;9
94;07.04.2015;2015;04;07;Tiistai;12;3;15
94;07.04.2015;2015;04;08;Tiistai;3;1;4
94;07.04.2015;2015;04;09;Tiistai;2;1;3
94;07.04.2015;2015;04;10;Tiistai;1;1;2
94;07.04.2015;2015;04;11;Tiistai;1;0;1
94;07.04.2015;2015;04;12;Tiistai;2;0;2
94;07.04.2015;2015;04;13;Tiistai;3;2;5
94;07.04.2015;2015;04;14;Tiistai;3;4;7
94;07.04.2015;2015;04;15;Tiistai;1;5;6
94;07.04.2015;2015;04;16;Tiistai;3;15;18
94;07.04.2015;2015;04;17;Tiistai;4;2;6
94;07.04.2015;2015;04;18;Tiistai;1;5;6
94;07.04.2015;2015;04;19;Tiistai;1;1;2
94;07.04.2015;2015;04;20;Tiistai;1;3;4
94;07.04.2015;2015;04;21;Tiistai;2;4;6
94;07.04.2015;2015;04;22;Tiistai;0;0;0
94;07.04.2015;2015;04;23;Tiistai;0;1;1
94;08.04.2015;2015;04;00;Keskiviikko;0;0;0
94;08.04.2015;2015;04;01;Keskiviikko;0;0;0
94;08.04.2015;2015;04;02;Keskiviikko;0;0;0
94;08.04.2015;2015;04;03;Keskiviikko;0;0;0
94;08.04.2015;2015;04;04;Keskiviikko;0;0;0
94;08.04.2015;2015;04;05;Keskiviikko;3;0;3
94;08.04.2015;2015;04;06;Keskiviikko;6;2;8
94;08.04.2015;2015;04;07;Keskiviikko;16;3;19
94;08.04.2015;2015;04;08;Keskiviikko;2;1;3
94;08.04.2015;2015;04;09;Keskiviikko;0;0;0
94;08.04.2015;2015;04;10;Keskiviikko;1;0;1
94;08.04.2015;2015;04;11;Keskiviikko;0;2;2
94;08.04.2015;2015;04;12;Keskiviikko;1;1;2
94;08.04.2015;2015;04;13;Keskiviikko;4;0;4
94;08.04.2015;2015;04;14;Keskiviikko;4;3;7
94;08.04.2015;2015;04;15;Keskiviikko;7;12;19
94;08.04.2015;2015;04;16;Keskiviikko;1;12;13
94;08.04.2015;2015;04;17;Keskiviikko;6;2;8
94;08.04.2015;2015;04;18;Keskiviikko;1;6;7
94;08.04.2015;2015;04;19;Keskiviikko;4;2;6
94;08.04.2015;2015;04;20;Keskiviikko;1;1;2
94;08.04.2015;2015;04;21;Keskiviikko;1;5;6
94;08.04.2015;2015;04;22;Keskiviikko;0;2;2
94;08.04.2015;2015;04;23;Keskiviikko;0;0;0
94;09.04.2015;2015;04;00;Torstai;0;0;0
94;09.04.2015;2015;04;01;Torstai;0;0;0
94;09.04.2015;2015;04;02;Torstai;0;0;0
94;09.04.2015;2015;04;03;Torstai;1;0;1
94;09.04.2015;2015;04;04;Torstai;0;0;0
94;09.04.2015;2015;04;05;Torstai;5;1;6
94;09.04.2015;2015;04;06;Torstai;8;1;9
94;09.04.2015;2015;04;07;Torstai;13;2;15
94;09.04.2015;2015;04;08;Torstai;7;2;9
94;09.04.2015;2015;04;09;Torstai;5;1;6
94;09.04.2015;2015;04;10;Torstai;2;1;3
94;09.04.2015;2015;04;11;Torstai;3;2;5
94;09.04.2015;2015;04;12;Torstai;2;1;3
94;09.04.2015;2015;04;13;Torstai;5;2;7
94;09.04.2015;2015;04;14;Torstai;3;9;12
94;09.04.2015;2015;04;15;Torstai;3;10;13
94;09.04.2015;2015;04;16;Torstai;5;14;19
94;09.04.2015;2015;04;17;Torstai;0;5;5
94;09.04.2015;2015;04;18;Torstai;2;2;4
94;09.04.2015;2015;04;19;Torstai;0;6;6
94;09.04.2015;2015;04;20;Torstai;0;2;2
94;09.04.2015;2015;04;21;Torstai;1;4;5
94;09.04.2015;2015;04;22;Torstai;0;1;1
94;09.04.2015;2015;04;23;Torstai;1;0;1
94;10.04.2015;2015;04;00;Perjantai;0;0;0
94;10.04.2015;2015;04;01;Perjantai;0;0;0
94;10.04.2015;2015;04;02;Perjantai;0;0;0
94;10.04.2015;2015;04;03;Perjantai;0;0;0
94;10.04.2015;2015;04;04;Perjantai;0;0;0
94;10.04.2015;2015;04;05;Perjantai;5;0;5
94;10.04.2015;2015;04;06;Perjantai;8;1;9
94;10.04.2015;2015;04;07;Perjantai;9;0;9
94;10.04.2015;2015;04;08;Perjantai;5;4;9
94;10.04.2015;2015;04;09;Perjantai;3;0;3
94;10.04.2015;2015;04;10;Perjantai;2;1;3
94;10.04.2015;2015;04;11;Perjantai;3;2;5
94;10.04.2015;2015;04;12;Perjantai;1;2;3
94;10.04.2015;2015;04;13;Perjantai;0;4;4
94;10.04.2015;2015;04;14;Perjantai;3;5;8
94;10.04.2015;2015;04;15;Perjantai;1;12;13
94;10.04.2015;2015;04;16;Perjantai;1;7;8
94;10.04.2015;2015;04;17;Perjantai;0;1;1
94;10.04.2015;2015;04;18;Perjantai;1;3;4
94;10.04.2015;2015;04;19;Perjantai;2;3;5
94;10.04.2015;2015;04;20;Perjantai;4;1;5
94;10.04.2015;2015;04;21;Perjantai;1;5;6
94;10.04.2015;2015;04;22;Perjantai;0;1;1
94;10.04.2015;2015;04;23;Perjantai;0;0;0
94;11.04.2015;2015;04;00;Lauantai;0;0;0
94;11.04.2015;2015;04;01;Lauantai;0;0;0
94;11.04.2015;2015;04;02;Lauantai;0;0;0
94;11.04.2015;2015;04;03;Lauantai;0;0;0
94;11.04.2015;2015;04;04;Lauantai;0;0;0
94;11.04.2015;2015;04;05;Lauantai;0;0;0
94;11.04.2015;2015;04;06;Lauantai;0;1;1
94;11.04.2015;2015;04;07;Lauantai;0;0;0
94;11.04.2015;2015;04;08;Lauantai;2;2;4
94;11.04.2015;2015;04;09;Lauantai;3;3;6
94;11.04.2015;2015;04;10;Lauantai;4;1;5
94;11.04.2015;2015;04;11;Lauantai;14;6;20
94;11.04.2015;2015;04;12;Lauantai;4;3;7
94;11.04.2015;2015;04;13;Lauantai;2;11;13
94;11.04.2015;2015;04;14;Lauantai;6;2;8
94;11.04.2015;2015;04;15;Lauantai;7;6;13
94;11.04.2015;2015;04;16;Lauantai;6;6;12
94;11.04.2015;2015;04;17;Lauantai;6;4;10
94;11.04.2015;2015;04;18;Lauantai;5;7;12
94;11.04.2015;2015;04;19;Lauantai;3;1;4
94;11.04.2015;2015;04;20;Lauantai;4;4;8
94;11.04.2015;2015;04;21;Lauantai;1;2;3
94;11.04.2015;2015;04;22;Lauantai;0;3;3
94;11.04.2015;2015;04;23;Lauantai;1;0;1
94;12.04.2015;2015;04;00;Sunnuntai;0;1;1
94;12.04.2015;2015;04;01;Sunnuntai;0;0;0
94;12.04.2015;2015;04;02;Sunnuntai;0;0;0
94;12.04.2015;2015;04;03;Sunnuntai;1;0;1
94;12.04.2015;2015;04;04;Sunnuntai;0;0;0
94;12.04.2015;2015;04;05;Sunnuntai;1;0;1
94;12.04.2015;2015;04;06;Sunnuntai;0;0;0
94;12.04.2015;2015;04;07;Sunnuntai;2;1;3
94;12.04.2015;2015;04;08;Sunnuntai;1;1;2
94;12.04.2015;2015;04;09;Sunnuntai;6;2;8
94;12.04.2015;2015;04;10;Sunnuntai;4;5;9
94;12.04.2015;2015;04;11;Sunnuntai;16;8;24
94;12.04.2015;2015;04;12;Sunnuntai;17;5;22
94;12.04.2015;2015;04;13;Sunnuntai;12;9;21
94;12.04.2015;2015;04;14;Sunnuntai;4;16;20
94;12.04.2015;2015;04;15;Sunnuntai;11;21;32
94;12.04.2015;2015;04;16;Sunnuntai;11;4;15
94;12.04.2015;2015;04;17;Sunnuntai;10;9;19
94;12.04.2015;2015;04;18;Sunnuntai;2;14;16
94;12.04.2015;2015;04;19;Sunnuntai;10;8;18
94;12.04.2015;2015;04;20;Sunnuntai;3;3;6
94;12.04.2015;2015;04;21;Sunnuntai;1;2;3
94;12.04.2015;2015;04;22;Sunnuntai;0;3;3
94;12.04.2015;2015;04;23;Sunnuntai;0;0;0
94;13.04.2015;2015;04;00;Maanantai;0;0;0
94;13.04.2015;2015;04;01;Maanantai;0;0;0
94;13.04.2015;2015;04;02;Maanantai;0;0;0
94;13.04.2015;2015;04;03;Maanantai;0;0;0
94;13.04.2015;2015;04;04;Maanantai;1;0;1
94;13.04.2015;2015;04;05;Maanantai;4;0;4
94;13.04.2015;2015;04;06;Maanantai;10;1;11
94;13.04.2015;2015;04;07;Maanantai;14;4;18
94;13.04.2015;2015;04;08;Maanantai;5;0;5
94;13.04.2015;2015;04;09;Maanantai;3;2;5
94;13.04.2015;2015;04;10;Maanantai;2;1;3
94;13.04.2015;2015;04;11;Maanantai;4;1;5
94;13.04.2015;2015;04;12;Maanantai;3;1;4
94;13.04.2015;2015;04;13;Maanantai;1;0;1
94;13.04.2015;2015;04;14;Maanantai;3;4;7
94;13.04.2015;2015;04;15;Maanantai;3;11;14
94;13.04.2015;2015;04;16;Maanantai;3;14;17
94;13.04.2015;2015;04;17;Maanantai;2;4;6
94;13.04.2015;2015;04;18;Maanantai;1;3;4
94;13.04.2015;2015;04;19;Maanantai;2;0;2
94;13.04.2015;2015;04;20;Maanantai;0;3;3
94;13.04.2015;2015;04;21;Maanantai;2;3;5
94;13.04.2015;2015;04;22;Maanantai;0;1;1
94;13.04.2015;2015;04;23;Maanantai;0;0;0
94;14.04.2015;2015;04;00;Tiistai;0;0;0
94;14.04.2015;2015;04;01;Tiistai;0;0;0
94;14.04.2015;2015;04;02;Tiistai;0;0;0
94;14.04.2015;2015;04;03;Tiistai;0;1;1
94;14.04.2015;2015;04;04;Tiistai;1;0;1
94;14.04.2015;2015;04;05;Tiistai;4;1;5
94;14.04.2015;2015;04;06;Tiistai;14;2;16
94;14.04.2015;2015;04;07;Tiistai;22;5;27
94;14.04.2015;2015;04;08;Tiistai;8;0;8
94;14.04.2015;2015;04;09;Tiistai;5;2;7
94;14.04.2015;2015;04;10;Tiistai;3;2;5
94;14.04.2015;2015;04;11;Tiistai;6;1;7
94;14.04.2015;2015;04;12;Tiistai;1;2;3
94;14.04.2015;2015;04;13;Tiistai;6;3;9
94;14.04.2015;2015;04;14;Tiistai;7;9;16
94;14.04.2015;2015;04;15;Tiistai;7;17;24
94;14.04.2015;2015;04;16;Tiistai;10;21;31
94;14.04.2015;2015;04;17;Tiistai;5;19;24
94;14.04.2015;2015;04;18;Tiistai;0;6;6
94;14.04.2015;2015;04;19;Tiistai;6;4;10
94;14.04.2015;2015;04;20;Tiistai;3;3;6
94;14.04.2015;2015;04;21;Tiistai;1;3;4
94;14.04.2015;2015;04;22;Tiistai;0;1;1
94;14.04.2015;2015;04;23;Tiistai;0;0;0
94;15.04.2015;2015;04;00;Keskiviikko;0;0;0
94;15.04.2015;2015;04;01;Keskiviikko;0;0;0
94;15.04.2015;2015;04;02;Keskiviikko;0;1;1
94;15.04.2015;2015;04;03;Keskiviikko;0;0;0
94;15.04.2015;2015;04;04;Keskiviikko;0;0;0
94;15.04.2015;2015;04;05;Keskiviikko;4;1;5
94;15.04.2015;2015;04;06;Keskiviikko;8;2;10
94;15.04.2015;2015;04;07;Keskiviikko;15;4;19
94;15.04.2015;2015;04;08;Keskiviikko;9;1;10
94;15.04.2015;2015;04;09;Keskiviikko;2;1;3
94;15.04.2015;2015;04;10;Keskiviikko;1;2;3
94;15.04.2015;2015;04;11;Keskiviikko;1;1;2
94;15.04.2015;2015;04;12;Keskiviikko;1;1;2
94;15.04.2015;2015;04;13;Keskiviikko;2;2;4
94;15.04.2015;2015;04;14;Keskiviikko;6;7;13
94;15.04.2015;2015;04;15;Keskiviikko;5;11;16
94;15.04.2015;2015;04;16;Keskiviikko;2;11;13
94;15.04.2015;2015;04;17;Keskiviikko;1;17;18
94;15.04.2015;2015;04;18;Keskiviikko;5;8;13
94;15.04.2015;2015;04;19;Keskiviikko;8;3;11
94;15.04.2015;2015;04;20;Keskiviikko;1;0;1
94;15.04.2015;2015;04;21;Keskiviikko;1;3;4
94;15.04.2015;2015;04;22;Keskiviikko;0;1;1
94;15.04.2015;2015;04;23;Keskiviikko;0;1;1
94;16.04.2015;2015;04;00;Torstai;0;0;0
94;16.04.2015;2015;04;01;Torstai;0;0;0
94;16.04.2015;2015;04;02;Torstai;0;0;0
94;16.04.2015;2015;04;03;Torstai;0;0;0
94;16.04.2015;2015;04;04;Torstai;0;0;0
94;16.04.2015;2015;04;05;Torstai;2;1;3
94;16.04.2015;2015;04;06;Torstai;5;0;5
94;16.04.2015;2015;04;07;Torstai;15;4;19
94;16.04.2015;2015;04;08;Torstai;5;2;7
94;16.04.2015;2015;04;09;Torstai;2;1;3
94;16.04.2015;2015;04;10;Torstai;4;1;5
94;16.04.2015;2015;04;11;Torstai;2;2;4
94;16.04.2015;2015;04;12;Torstai;4;0;4
94;16.04.2015;2015;04;13;Torstai;6;3;9
94;16.04.2015;2015;04;14;Torstai;3;6;9
94;16.04.2015;2015;04;15;Torstai;2;9;11
94;16.04.2015;2015;04;16;Torstai;7;13;20
94;16.04.2015;2015;04;17;Torstai;3;9;12
94;16.04.2015;2015;04;18;Torstai;6;9;15
94;16.04.2015;2015;04;19;Torstai;4;8;12
94;16.04.2015;2015;04;20;Torstai;1;4;5
94;16.04.2015;2015;04;21;Torstai;0;5;5
94;16.04.2015;2015;04;22;Torstai;0;2;2
94;16.04.2015;2015;04;23;Torstai;0;0;0
94;17.04.2015;2015;04;00;Perjantai;0;0;0
94;17.04.2015;2015;04;01;Perjantai;0;0;0
94;17.04.2015;2015;04;02;Perjantai;0;0;0
94;17.04.2015;2015;04;03;Perjantai;0;0;0
94;17.04.2015;2015;04;04;Perjantai;0;0;0
94;17.04.2015;2015;04;05;Perjantai;3;0;3
94;17.04.2015;2015;04;06;Perjantai;13;1;14
94;17.04.2015;2015;04;07;Perjantai;13;4;17
94;17.04.2015;2015;04;08;Perjantai;7;3;10
94;17.04.2015;2015;04;09;Perjantai;3;2;5
94;17.04.2015;2015;04;10;Perjantai;4;2;6
94;17.04.2015;2015;04;11;Perjantai;2;4;6
94;17.04.2015;2015;04;12;Perjantai;7;4;11
94;17.04.2015;2015;04;13;Perjantai;5;9;14
94;17.04.2015;2015;04;14;Perjantai;4;12;16
94;17.04.2015;2015;04;15;Perjantai;18;21;39
94;17.04.2015;2015;04;16;Perjantai;6;15;21
94;17.04.2015;2015;04;17;Perjantai;5;10;15
94;17.04.2015;2015;04;18;Perjantai;3;5;8
94;17.04.2015;2015;04;19;Perjantai;3;2;5
94;17.04.2015;2015;04;20;Perjantai;4;3;7
94;17.04.2015;2015;04;21;Perjantai;0;1;1
94;17.04.2015;2015;04;22;Perjantai;1;0;1
94;17.04.2015;2015;04;23;Perjantai;0;1;1
94;18.04.2015;2015;04;00;Lauantai;0;0;0
94;18.04.2015;2015;04;01;Lauantai;1;0;1
94;18.04.2015;2015;04;02;Lauantai;0;0;0
94;18.04.2015;2015;04;03;Lauantai;0;0;0
94;18.04.2015;2015;04;04;Lauantai;1;0;1
94;18.04.2015;2015;04;05;Lauantai;1;0;1
94;18.04.2015;2015;04;06;Lauantai;3;2;5
94;18.04.2015;2015;04;07;Lauantai;1;0;1
94;18.04.2015;2015;04;08;Lauantai;2;2;4
94;18.04.2015;2015;04;09;Lauantai;5;3;8
94;18.04.2015;2015;04;10;Lauantai;4;4;8
94;18.04.2015;2015;04;11;Lauantai;7;4;11
94;18.04.2015;2015;04;12;Lauantai;10;6;16
94;18.04.2015;2015;04;13;Lauantai;5;12;17
94;18.04.2015;2015;04;14;Lauantai;9;8;17
94;18.04.2015;2015;04;15;Lauantai;7;6;13
94;18.04.2015;2015;04;16;Lauantai;3;6;9
94;18.04.2015;2015;04;17;Lauantai;5;1;6
94;18.04.2015;2015;04;18;Lauantai;6;3;9
94;18.04.2015;2015;04;19;Lauantai;3;6;9
94;18.04.2015;2015;04;20;Lauantai;1;2;3
94;18.04.2015;2015;04;21;Lauantai;2;6;8
94;18.04.2015;2015;04;22;Lauantai;2;4;6
94;18.04.2015;2015;04;23;Lauantai;0;1;1
94;19.04.2015;2015;04;00;Sunnuntai;0;1;1
94;19.04.2015;2015;04;01;Sunnuntai;1;0;1
94;19.04.2015;2015;04;02;Sunnuntai;0;0;0
94;19.04.2015;2015;04;03;Sunnuntai;0;0;0
94;19.04.2015;2015;04;04;Sunnuntai;2;0;2
94;19.04.2015;2015;04;05;Sunnuntai;2;0;2
94;19.04.2015;2015;04;06;Sunnuntai;1;1;2
94;19.04.2015;2015;04;07;Sunnuntai;0;1;1
94;19.04.2015;2015;04;08;Sunnuntai;0;1;1
94;19.04.2015;2015;04;09;Sunnuntai;1;2;3
94;19.04.2015;2015;04;10;Sunnuntai;4;4;8
94;19.04.2015;2015;04;11;Sunnuntai;7;0;7
94;19.04.2015;2015;04;12;Sunnuntai;3;3;6
94;19.04.2015;2015;04;13;Sunnuntai;11;11;22
94;19.04.2015;2015;04;14;Sunnuntai;7;9;16
94;19.04.2015;2015;04;15;Sunnuntai;17;6;23
94;19.04.2015;2015;04;16;Sunnuntai;8;9;17
94;19.04.2015;2015;04;17;Sunnuntai;3;6;9
94;19.04.2015;2015;04;18;Sunnuntai;4;9;13
94;19.04.2015;2015;04;19;Sunnuntai;4;5;9
94;19.04.2015;2015;04;20;Sunnuntai;2;1;3
94;19.04.2015;2015;04;21;Sunnuntai;0;1;1
94;19.04.2015;2015;04;22;Sunnuntai;1;0;1
94;19.04.2015;2015;04;23;Sunnuntai;0;0;0
94;20.04.2015;2015;04;00;Maanantai;0;0;0
94;20.04.2015;2015;04;01;Maanantai;0;0;0
94;20.04.2015;2015;04;02;Maanantai;0;0;0
94;20.04.2015;2015;04;03;Maanantai;0;0;0
94;20.04.2015;2015;04;04;Maanantai;0;0;0
94;20.04.2015;2015;04;05;Maanantai;3;1;4
94;20.04.2015;2015;04;06;Maanantai;18;1;19
94;20.04.2015;2015;04;07;Maanantai;22;3;25
94;20.04.2015;2015;04;08;Maanantai;12;3;15
94;20.04.2015;2015;04;09;Maanantai;2;1;3
94;20.04.2015;2015;04;10;Maanantai;5;4;9
94;20.04.2015;2015;04;11;Maanantai;2;2;4
94;20.04.2015;2015;04;12;Maanantai;4;4;8
94;20.04.2015;2015;04;13;Maanantai;6;6;12
94;20.04.2015;2015;04;14;Maanantai;6;7;13
94;20.04.2015;2015;04;15;Maanantai;4;20;24
94;20.04.2015;2015;04;16;Maanantai;9;25;34
94;20.04.2015;2015;04;17;Maanantai;4;11;15
94;20.04.2015;2015;04;18;Maanantai;8;7;15
94;20.04.2015;2015;04;19;Maanantai;1;5;6
94;20.04.2015;2015;04;20;Maanantai;1;4;5
94;20.04.2015;2015;04;21;Maanantai;1;5;6
94;20.04.2015;2015;04;22;Maanantai;0;5;5
94;20.04.2015;2015;04;23;Maanantai;0;2;2
94;21.04.2015;2015;04;00;Tiistai;0;3;3
94;21.04.2015;2015;04;01;Tiistai;0;0;0
94;21.04.2015;2015;04;02;Tiistai;0;0;0
94;21.04.2015;2015;04;03;Tiistai;0;0;0
94;21.04.2015;2015;04;04;Tiistai;0;0;0
94;21.04.2015;2015;04;05;Tiistai;3;0;3
94;21.04.2015;2015;04;06;Tiistai;15;1;16
94;21.04.2015;2015;04;07;Tiistai;21;2;23
94;21.04.2015;2015;04;08;Tiistai;10;2;12
94;21.04.2015;2015;04;09;Tiistai;4;1;5
94;21.04.2015;2015;04;10;Tiistai;6;5;11
94;21.04.2015;2015;04;11;Tiistai;10;5;15
94;21.04.2015;2015;04;12;Tiistai;12;2;14
94;21.04.2015;2015;04;13;Tiistai;6;6;12
94;21.04.2015;2015;04;14;Tiistai;9;6;15
94;21.04.2015;2015;04;15;Tiistai;12;17;29
94;21.04.2015;2015;04;16;Tiistai;10;34;44
94;21.04.2015;2015;04;17;Tiistai;2;30;32
94;21.04.2015;2015;04;18;Tiistai;8;9;17
94;21.04.2015;2015;04;19;Tiistai;8;7;15
94;21.04.2015;2015;04;20;Tiistai;2;6;8
94;21.04.2015;2015;04;21;Tiistai;5;6;11
94;21.04.2015;2015;04;22;Tiistai;0;4;4
94;21.04.2015;2015;04;23;Tiistai;0;0;0
94;22.04.2015;2015;04;00;Keskiviikko;0;0;0
94;22.04.2015;2015;04;01;Keskiviikko;0;0;0
94;22.04.2015;2015;04;02;Keskiviikko;0;0;0
94;22.04.2015;2015;04;03;Keskiviikko;0;0;0
94;22.04.2015;2015;04;04;Keskiviikko;0;0;0
94;22.04.2015;2015;04;05;Keskiviikko;4;1;5
94;22.04.2015;2015;04;06;Keskiviikko;18;0;18
94;22.04.2015;2015;04;07;Keskiviikko;21;6;27
94;22.04.2015;2015;04;08;Keskiviikko;7;3;10
94;22.04.2015;2015;04;09;Keskiviikko;3;2;5
94;22.04.2015;2015;04;10;Keskiviikko;5;1;6
94;22.04.2015;2015;04;11;Keskiviikko;4;9;13
94;22.04.2015;2015;04;12;Keskiviikko;10;6;16
94;22.04.2015;2015;04;13;Keskiviikko;5;6;11
94;22.04.2015;2015;04;14;Keskiviikko;7;7;14
94;22.04.2015;2015;04;15;Keskiviikko;5;20;25
94;22.04.2015;2015;04;16;Keskiviikko;5;21;26
94;22.04.2015;2015;04;17;Keskiviikko;1;12;13
94;22.04.2015;2015;04;18;Keskiviikko;8;9;17
94;22.04.2015;2015;04;19;Keskiviikko;3;4;7
94;22.04.2015;2015;04;20;Keskiviikko;2;14;16
94;22.04.2015;2015;04;21;Keskiviikko;3;3;6
94;22.04.2015;2015;04;22;Keskiviikko;0;5;5
94;22.04.2015;2015;04;23;Keskiviikko;0;0;0
94;23.04.2015;2015;04;00;Torstai;0;0;0
94;23.04.2015;2015;04;01;Torstai;0;0;0
94;23.04.2015;2015;04;02;Torstai;0;1;1
94;23.04.2015;2015;04;03;Torstai;0;0;0
94;23.04.2015;2015;04;04;Torstai;0;0;0
94;23.04.2015;2015;04;05;Torstai;1;1;2
94;23.04.2015;2015;04;06;Torstai;12;2;14
94;23.04.2015;2015;04;07;Torstai;18;1;19
94;23.04.2015;2015;04;08;Torstai;9;1;10
94;23.04.2015;2015;04;09;Torstai;6;1;7
94;23.04.2015;2015;04;10;Torstai;4;4;8
94;23.04.2015;2015;04;11;Torstai;3;3;6
94;23.04.2015;2015;04;12;Torstai;3;3;6
94;23.04.2015;2015;04;13;Torstai;1;4;5
94;23.04.2015;2015;04;14;Torstai;4;3;7
94;23.04.2015;2015;04;15;Torstai;3;19;22
94;23.04.2015;2015;04;16;Torstai;6;14;20
94;23.04.2015;2015;04;17;Torstai;5;7;12
94;23.04.2015;2015;04;18;Torstai;3;12;15
94;23.04.2015;2015;04;19;Torstai;5;8;13
94;23.04.2015;2015;04;20;Torstai;11;8;19
94;23.04.2015;2015;04;21;Torstai;3;0;3
94;23.04.2015;2015;04;22;Torstai;0;4;4
94;23.04.2015;2015;04;23;Torstai;0;0;0
94;24.04.2015;2015;04;00;Perjantai;0;0;0
94;24.04.2015;2015;04;01;Perjantai;0;0;0
94;24.04.2015;2015;04;02;Perjantai;0;0;0
94;24.04.2015;2015;04;03;Perjantai;0;0;0
94;24.04.2015;2015;04;04;Perjantai;0;0;0
94;24.04.2015;2015;04;05;Perjantai;1;0;1
94;24.04.2015;2015;04;06;Perjantai;13;1;14
94;24.04.2015;2015;04;07;Perjantai;22;0;22
94;24.04.2015;2015;04;08;Perjantai;7;8;15
94;24.04.2015;2015;04;09;Perjantai;10;1;11
94;24.04.2015;2015;04;10;Perjantai;7;5;12
94;24.04.2015;2015;04;11;Perjantai;3;6;9
94;24.04.2015;2015;04;12;Perjantai;4;3;7
94;24.04.2015;2015;04;13;Perjantai;3;2;5
94;24.04.2015;2015;04;14;Perjantai;1;10;11
94;24.04.2015;2015;04;15;Perjantai;5;8;13
94;24.04.2015;2015;04;16;Perjantai;6;20;26
94;24.04.2015;2015;04;17;Perjantai;9;7;16
94;24.04.2015;2015;04;18;Perjantai;3;9;12
94;24.04.2015;2015;04;19;Perjantai;3;3;6
94;24.04.2015;2015;04;20;Perjantai;1;4;5
94;24.04.2015;2015;04;21;Perjantai;2;2;4
94;24.04.2015;2015;04;22;Perjantai;2;2;4
94;24.04.2015;2015;04;23;Perjantai;0;1;1
94;25.04.2015;2015;04;00;Lauantai;0;0;0
94;25.04.2015;2015;04;01;Lauantai;0;0;0
94;25.04.2015;2015;04;02;Lauantai;1;0;1
94;25.04.2015;2015;04;03;Lauantai;0;0;0
94;25.04.2015;2015;04;04;Lauantai;0;0;0
94;25.04.2015;2015;04;05;Lauantai;1;0;1
94;25.04.2015;2015;04;06;Lauantai;1;0;1
94;25.04.2015;2015;04;07;Lauantai;1;0;1
94;25.04.2015;2015;04;08;Lauantai;0;2;2
94;25.04.2015;2015;04;09;Lauantai;5;2;7
94;25.04.2015;2015;04;10;Lauantai;2;18;20
94;25.04.2015;2015;04;11;Lauantai;14;4;18
94;25.04.2015;2015;04;12;Lauantai;12;11;23
94;25.04.2015;2015;04;13;Lauantai;6;6;12
94;25.04.2015;2015;04;14;Lauantai;6;2;8
94;25.04.2015;2015;04;15;Lauantai;7;10;17
94;25.04.2015;2015;04;16;Lauantai;9;12;21
94;25.04.2015;2015;04;17;Lauantai;10;3;13
94;25.04.2015;2015;04;18;Lauantai;3;3;6
94;25.04.2015;2015;04;19;Lauantai;0;2;2
94;25.04.2015;2015;04;20;Lauantai;2;4;6
94;25.04.2015;2015;04;21;Lauantai;7;5;12
94;25.04.2015;2015;04;22;Lauantai;0;1;1
94;25.04.2015;2015;04;23;Lauantai;2;0;2
94;26.04.2015;2015;04;00;Sunnuntai;0;0;0
94;26.04.2015;2015;04;01;Sunnuntai;1;6;7
94;26.04.2015;2015;04;02;Sunnuntai;0;1;1
94;26.04.2015;2015;04;03;Sunnuntai;0;0;0
94;26.04.2015;2015;04;04;Sunnuntai;0;0;0
94;26.04.2015;2015;04;05;Sunnuntai;0;0;0
94;26.04.2015;2015;04;06;Sunnuntai;1;1;2
94;26.04.2015;2015;04;07;Sunnuntai;2;0;2
94;26.04.2015;2015;04;08;Sunnuntai;0;3;3
94;26.04.2015;2015;04;09;Sunnuntai;4;4;8
94;26.04.2015;2015;04;10;Sunnuntai;5;5;10
94;26.04.2015;2015;04;11;Sunnuntai;6;9;15
94;26.04.2015;2015;04;12;Sunnuntai;16;7;23
94;26.04.2015;2015;04;13;Sunnuntai;4;8;12
94;26.04.2015;2015;04;14;Sunnuntai;13;6;19
94;26.04.2015;2015;04;15;Sunnuntai;16;15;31
94;26.04.2015;2015;04;16;Sunnuntai;15;11;26
94;26.04.2015;2015;04;17;Sunnuntai;13;15;28
94;26.04.2015;2015;04;18;Sunnuntai;8;5;13
94;26.04.2015;2015;04;19;Sunnuntai;5;10;15
94;26.04.2015;2015;04;20;Sunnuntai;2;4;6
94;26.04.2015;2015;04;21;Sunnuntai;0;4;4
94;26.04.2015;2015;04;22;Sunnuntai;0;0;0
94;26.04.2015;2015;04;23;Sunnuntai;0;0;0
94;27.04.2015;2015;04;00;Maanantai;0;0;0
94;27.04.2015;2015;04;01;Maanantai;0;0;0
94;27.04.2015;2015;04;02;Maanantai;0;1;1
94;27.04.2015;2015;04;03;Maanantai;0;0;0
94;27.04.2015;2015;04;04;Maanantai;1;0;1
94;27.04.2015;2015;04;05;Maanantai;5;1;6
94;27.04.2015;2015;04;06;Maanantai;13;1;14
94;27.04.2015;2015;04;07;Maanantai;15;1;16
94;27.04.2015;2015;04;08;Maanantai;3;1;4
94;27.04.2015;2015;04;09;Maanantai;1;2;3
94;27.04.2015;2015;04;10;Maanantai;2;3;5
94;27.04.2015;2015;04;11;Maanantai;1;2;3
94;27.04.2015;2015;04;12;Maanantai;4;1;5
94;27.04.2015;2015;04;13;Maanantai;5;2;7
94;27.04.2015;2015;04;14;Maanantai;4;7;11
94;27.04.2015;2015;04;15;Maanantai;3;17;20
94;27.04.2015;2015;04;16;Maanantai;7;20;27
94;27.04.2015;2015;04;17;Maanantai;3;7;10
94;27.04.2015;2015;04;18;Maanantai;6;4;10
94;27.04.2015;2015;04;19;Maanantai;4;7;11
94;27.04.2015;2015;04;20;Maanantai;2;5;7
94;27.04.2015;2015;04;21;Maanantai;2;2;4
94;27.04.2015;2015;04;22;Maanantai;0;0;0
94;27.04.2015;2015;04;23;Maanantai;0;0;0
94;28.04.2015;2015;04;00;Tiistai;1;0;1
94;28.04.2015;2015;04;01;Tiistai;0;0;0
94;28.04.2015;2015;04;02;Tiistai;0;0;0
94;28.04.2015;2015;04;03;Tiistai;0;0;0
94;28.04.2015;2015;04;04;Tiistai;2;0;2
94;28.04.2015;2015;04;05;Tiistai;5;0;5
94;28.04.2015;2015;04;06;Tiistai;16;0;16
94;28.04.2015;2015;04;07;Tiistai;23;1;24
94;28.04.2015;2015;04;08;Tiistai;7;4;11
94;28.04.2015;2015;04;09;Tiistai;8;2;10
94;28.04.2015;2015;04;10;Tiistai;3;6;9
94;28.04.2015;2015;04;11;Tiistai;6;4;10
94;28.04.2015;2015;04;12;Tiistai;1;6;7
94;28.04.2015;2015;04;13;Tiistai;10;6;16
94;28.04.2015;2015;04;14;Tiistai;4;7;11
94;28.04.2015;2015;04;15;Tiistai;6;18;24
94;28.04.2015;2015;04;16;Tiistai;8;23;31
94;28.04.2015;2015;04;17;Tiistai;10;21;31
94;28.04.2015;2015;04;18;Tiistai;8;11;19
94;28.04.2015;2015;04;19;Tiistai;1;15;16
94;28.04.2015;2015;04;20;Tiistai;11;10;21
94;28.04.2015;2015;04;21;Tiistai;0;5;5
94;28.04.2015;2015;04;22;Tiistai;0;2;2
94;28.04.2015;2015;04;23;Tiistai;0;0;0
94;29.04.2015;2015;04;00;Keskiviikko;0;0;0
94;29.04.2015;2015;04;01;Keskiviikko;0;0;0
94;29.04.2015;2015;04;02;Keskiviikko;0;0;0
94;29.04.2015;2015;04;03;Keskiviikko;0;0;0
94;29.04.2015;2015;04;04;Keskiviikko;3;1;4
94;29.04.2015;2015;04;05;Keskiviikko;5;0;5
94;29.04.2015;2015;04;06;Keskiviikko;13;0;13
94;29.04.2015;2015;04;07;Keskiviikko;23;3;26
94;29.04.2015;2015;04;08;Keskiviikko;5;4;9
94;29.04.2015;2015;04;09;Keskiviikko;4;3;7
94;29.04.2015;2015;04;10;Keskiviikko;3;4;7
94;29.04.2015;2015;04;11;Keskiviikko;4;3;7
94;29.04.2015;2015;04;12;Keskiviikko;3;4;7
94;29.04.2015;2015;04;13;Keskiviikko;3;3;6
94;29.04.2015;2015;04;14;Keskiviikko;4;15;19
94;29.04.2015;2015;04;15;Keskiviikko;7;20;27
94;29.04.2015;2015;04;16;Keskiviikko;4;13;17
94;29.04.2015;2015;04;17;Keskiviikko;5;5;10
94;29.04.2015;2015;04;18;Keskiviikko;2;9;11
94;29.04.2015;2015;04;19;Keskiviikko;5;8;13
94;29.04.2015;2015;04;20;Keskiviikko;1;3;4
94;29.04.2015;2015;04;21;Keskiviikko;0;7;7
94;29.04.2015;2015;04;22;Keskiviikko;2;0;2
94;29.04.2015;2015;04;23;Keskiviikko;0;1;1
94;30.04.2015;2015;04;00;Torstai;0;0;0
94;30.04.2015;2015;04;01;Torstai;0;0;0
94;30.04.2015;2015;04;02;Torstai;0;0;0
94;30.04.2015;2015;04;03;Torstai;0;0;0
94;30.04.2015;2015;04;04;Torstai;1;0;1
94;30.04.2015;2015;04;05;Torstai;1;0;1
94;30.04.2015;2015;04;06;Torstai;7;0;7
94;30.04.2015;2015;04;07;Torstai;16;1;17
94;30.04.2015;2015;04;08;Torstai;4;3;7
94;30.04.2015;2015;04;09;Torstai;3;1;4
94;30.04.2015;2015;04;10;Torstai;4;3;7
94;30.04.2015;2015;04;11;Torstai;3;0;3
94;30.04.2015;2015;04;12;Torstai;1;2;3
94;30.04.2015;2015;04;13;Torstai;4;9;13
94;30.04.2015;2015;04;14;Torstai;7;11;18
94;30.04.2015;2015;04;15;Torstai;4;16;20
94;30.04.2015;2015;04;16;Torstai;9;12;21
94;30.04.2015;2015;04;17;Torstai;4;14;18
94;30.04.2015;2015;04;18;Torstai;6;7;13
94;30.04.2015;2015;04;19;Torstai;4;4;8
94;30.04.2015;2015;04;20;Torstai;2;4;6
94;30.04.2015;2015;04;21;Torstai;6;3;9
94;30.04.2015;2015;04;22;Torstai;0;1;1
94;30.04.2015;2015;04;23;Torstai;2;3;5
94;01.05.2015;2015;05;00;Perjantai;1;0;1
94;01.05.2015;2015;05;01;Perjantai;0;0;0
94;01.05.2015;2015;05;02;Perjantai;1;0;1
94;01.05.2015;2015;05;03;Perjantai;0;0;0
94;01.05.2015;2015;05;04;Perjantai;0;0;0
94;01.05.2015;2015;05;05;Perjantai;1;0;1
94;01.05.2015;2015;05;06;Perjantai;2;1;3
94;01.05.2015;2015;05;07;Perjantai;0;1;1
94;01.05.2015;2015;05;08;Perjantai;1;3;4
94;01.05.2015;2015;05;09;Perjantai;1;0;1
94;01.05.2015;2015;05;10;Perjantai;4;5;9
94;01.05.2015;2015;05;11;Perjantai;4;18;22
94;01.05.2015;2015;05;12;Perjantai;3;8;11
94;01.05.2015;2015;05;13;Perjantai;6;6;12
94;01.05.2015;2015;05;14;Perjantai;5;4;9
94;01.05.2015;2015;05;15;Perjantai;13;6;19
94;01.05.2015;2015;05;16;Perjantai;2;2;4
94;01.05.2015;2015;05;17;Perjantai;3;3;6
94;01.05.2015;2015;05;18;Perjantai;5;2;7
94;01.05.2015;2015;05;19;Perjantai;2;1;3
94;01.05.2015;2015;05;20;Perjantai;2;4;6
94;01.05.2015;2015;05;21;Perjantai;1;4;5
94;01.05.2015;2015;05;22;Perjantai;1;1;2
94;01.05.2015;2015;05;23;Perjantai;0;0;0
94;02.05.2015;2015;05;00;Lauantai;0;0;0
94;02.05.2015;2015;05;01;Lauantai;0;0;0
94;02.05.2015;2015;05;02;Lauantai;0;0;0
94;02.05.2015;2015;05;03;Lauantai;0;0;0
94;02.05.2015;2015;05;04;Lauantai;0;0;0
94;02.05.2015;2015;05;05;Lauantai;1;1;2
94;02.05.2015;2015;05;06;Lauantai;1;0;1
94;02.05.2015;2015;05;07;Lauantai;3;1;4
94;02.05.2015;2015;05;08;Lauantai;4;2;6
94;02.05.2015;2015;05;09;Lauantai;7;3;10
94;02.05.2015;2015;05;10;Lauantai;7;6;13
94;02.05.2015;2015;05;11;Lauantai;3;17;20
94;02.05.2015;2015;05;12;Lauantai;10;5;15
94;02.05.2015;2015;05;13;Lauantai;12;15;27
94;02.05.2015;2015;05;14;Lauantai;11;8;19
94;02.05.2015;2015;05;15;Lauantai;9;16;25
94;02.05.2015;2015;05;16;Lauantai;15;4;19
94;02.05.2015;2015;05;17;Lauantai;8;6;14
94;02.05.2015;2015;05;18;Lauantai;16;7;23
94;02.05.2015;2015;05;19;Lauantai;3;2;5
94;02.05.2015;2015;05;20;Lauantai;2;3;5
94;02.05.2015;2015;05;21;Lauantai;0;1;1
94;02.05.2015;2015;05;22;Lauantai;1;3;4
94;02.05.2015;2015;05;23;Lauantai;0;0;0
94;03.05.2015;2015;05;00;Sunnuntai;0;0;0
94;03.05.2015;2015;05;01;Sunnuntai;1;0;1
94;03.05.2015;2015;05;02;Sunnuntai;0;0;0
94;03.05.2015;2015;05;03;Sunnuntai;0;0;0
94;03.05.2015;2015;05;04;Sunnuntai;0;0;0
94;03.05.2015;2015;05;05;Sunnuntai;0;0;0
94;03.05.2015;2015;05;06;Sunnuntai;1;0;1
94;03.05.2015;2015;05;07;Sunnuntai;0;0;0
94;03.05.2015;2015;05;08;Sunnuntai;0;1;1
94;03.05.2015;2015;05;09;Sunnuntai;2;2;4
94;03.05.2015;2015;05;10;Sunnuntai;2;0;2
94;03.05.2015;2015;05;11;Sunnuntai;2;1;3
94;03.05.2015;2015;05;12;Sunnuntai;1;1;2
94;03.05.2015;2015;05;13;Sunnuntai;4;6;10
94;03.05.2015;2015;05;14;Sunnuntai;2;6;8
94;03.05.2015;2015;05;15;Sunnuntai;7;7;14
94;03.05.2015;2015;05;16;Sunnuntai;11;3;14
94;03.05.2015;2015;05;17;Sunnuntai;2;8;10
94;03.05.2015;2015;05;18;Sunnuntai;6;5;11
94;03.05.2015;2015;05;19;Sunnuntai;5;6;11
94;03.05.2015;2015;05;20;Sunnuntai;5;1;6
94;03.05.2015;2015;05;21;Sunnuntai;1;2;3
94;03.05.2015;2015;05;22;Sunnuntai;0;0;0
94;03.05.2015;2015;05;23;Sunnuntai;0;0;0
94;04.05.2015;2015;05;00;Maanantai;0;0;0
94;04.05.2015;2015;05;01;Maanantai;0;0;0
94;04.05.2015;2015;05;02;Maanantai;0;0;0
94;04.05.2015;2015;05;03;Maanantai;0;0;0
94;04.05.2015;2015;05;04;Maanantai;0;0;0
94;04.05.2015;2015;05;05;Maanantai;4;1;5
94;04.05.2015;2015;05;06;Maanantai;22;0;22
94;04.05.2015;2015;05;07;Maanantai;25;7;32
94;04.05.2015;2015;05;08;Maanantai;18;7;25
94;04.05.2015;2015;05;09;Maanantai;6;4;10
94;04.05.2015;2015;05;10;Maanantai;5;5;10
94;04.05.2015;2015;05;11;Maanantai;5;6;11
94;04.05.2015;2015;05;12;Maanantai;3;6;9
94;04.05.2015;2015;05;13;Maanantai;8;7;15
94;04.05.2015;2015;05;14;Maanantai;7;15;22
94;04.05.2015;2015;05;15;Maanantai;3;30;33
94;04.05.2015;2015;05;16;Maanantai;11;26;37
94;04.05.2015;2015;05;17;Maanantai;5;21;26
94;04.05.2015;2015;05;18;Maanantai;14;13;27
94;04.05.2015;2015;05;19;Maanantai;13;13;26
94;04.05.2015;2015;05;20;Maanantai;5;14;19
94;04.05.2015;2015;05;21;Maanantai;4;6;10
94;04.05.2015;2015;05;22;Maanantai;0;2;2
94;04.05.2015;2015;05;23;Maanantai;1;0;1
94;05.05.2015;2015;05;00;Tiistai;1;0;1
94;05.05.2015;2015;05;01;Tiistai;0;0;0
94;05.05.2015;2015;05;02;Tiistai;0;1;1
94;05.05.2015;2015;05;03;Tiistai;0;0;0
94;05.05.2015;2015;05;04;Tiistai;0;0;0
94;05.05.2015;2015;05;05;Tiistai;10;1;11
94;05.05.2015;2015;05;06;Tiistai;23;0;23
94;05.05.2015;2015;05;07;Tiistai;33;6;39
94;05.05.2015;2015;05;08;Tiistai;13;5;18
94;05.05.2015;2015;05;09;Tiistai;5;3;8
94;05.05.2015;2015;05;10;Tiistai;3;3;6
94;05.05.2015;2015;05;11;Tiistai;4;5;9
94;05.05.2015;2015;05;12;Tiistai;6;3;9
94;05.05.2015;2015;05;13;Tiistai;7;9;16
94;05.05.2015;2015;05;14;Tiistai;6;10;16
94;05.05.2015;2015;05;15;Tiistai;8;23;31
94;05.05.2015;2015;05;16;Tiistai;10;27;37
94;05.05.2015;2015;05;17;Tiistai;8;24;32
94;05.05.2015;2015;05;18;Tiistai;6;8;14
94;05.05.2015;2015;05;19;Tiistai;15;6;21
94;05.05.2015;2015;05;20;Tiistai;3;8;11
94;05.05.2015;2015;05;21;Tiistai;2;2;4
94;05.05.2015;2015;05;22;Tiistai;0;1;1
94;05.05.2015;2015;05;23;Tiistai;0;2;2
94;06.05.2015;2015;05;00;Keskiviikko;1;0;1
94;06.05.2015;2015;05;01;Keskiviikko;0;0;0
94;06.05.2015;2015;05;02;Keskiviikko;0;0;0
94;06.05.2015;2015;05;03;Keskiviikko;0;0;0
94;06.05.2015;2015;05;04;Keskiviikko;0;2;2
94;06.05.2015;2015;05;05;Keskiviikko;3;1;4
94;06.05.2015;2015;05;06;Keskiviikko;24;1;25
94;06.05.2015;2015;05;07;Keskiviikko;27;4;31
94;06.05.2015;2015;05;08;Keskiviikko;8;4;12
94;06.05.2015;2015;05;09;Keskiviikko;6;4;10
94;06.05.2015;2015;05;10;Keskiviikko;9;4;13
94;06.05.2015;2015;05;11;Keskiviikko;6;3;9
94;06.05.2015;2015;05;12;Keskiviikko;5;5;10
94;06.05.2015;2015;05;13;Keskiviikko;2;11;13
94;06.05.2015;2015;05;14;Keskiviikko;6;16;22
94;06.05.2015;2015;05;15;Keskiviikko;4;25;29
94;06.05.2015;2015;05;16;Keskiviikko;9;27;36
94;06.05.2015;2015;05;17;Keskiviikko;8;13;21
94;06.05.2015;2015;05;18;Keskiviikko;6;7;13
94;06.05.2015;2015;05;19;Keskiviikko;7;11;18
94;06.05.2015;2015;05;20;Keskiviikko;2;6;8
94;06.05.2015;2015;05;21;Keskiviikko;1;2;3
94;06.05.2015;2015;05;22;Keskiviikko;0;2;2
94;06.05.2015;2015;05;23;Keskiviikko;0;0;0
94;07.05.2015;2015;05;00;Torstai;0;0;0
94;07.05.2015;2015;05;01;Torstai;0;0;0
94;07.05.2015;2015;05;02;Torstai;0;0;0
94;07.05.2015;2015;05;03;Torstai;0;0;0
94;07.05.2015;2015;05;04;Torstai;1;1;2
94;07.05.2015;2015;05;05;Torstai;3;1;4
94;07.05.2015;2015;05;06;Torstai;22;3;25
94;07.05.2015;2015;05;07;Torstai;22;3;25
94;07.05.2015;2015;05;08;Torstai;8;4;12
94;07.05.2015;2015;05;09;Torstai;5;0;5
94;07.05.2015;2015;05;10;Torstai;2;3;5
94;07.05.2015;2015;05;11;Torstai;1;3;4
94;07.05.2015;2015;05;12;Torstai;3;4;7
94;07.05.2015;2015;05;13;Torstai;2;3;5
94;07.05.2015;2015;05;14;Torstai;6;8;14
94;07.05.2015;2015;05;15;Torstai;8;20;28
94;07.05.2015;2015;05;16;Torstai;7;19;26
94;07.05.2015;2015;05;17;Torstai;8;18;26
94;07.05.2015;2015;05;18;Torstai;7;7;14
94;07.05.2015;2015;05;19;Torstai;8;5;13
94;07.05.2015;2015;05;20;Torstai;7;13;20
94;07.05.2015;2015;05;21;Torstai;2;8;10
94;07.05.2015;2015;05;22;Torstai;0;1;1
94;07.05.2015;2015;05;23;Torstai;0;1;1
94;08.05.2015;2015;05;00;Perjantai;0;0;0
94;08.05.2015;2015;05;01;Perjantai;0;0;0
94;08.05.2015;2015;05;02;Perjantai;0;1;1
94;08.05.2015;2015;05;03;Perjantai;0;0;0
94;08.05.2015;2015;05;04;Perjantai;2;0;2
94;08.05.2015;2015;05;05;Perjantai;3;1;4
94;08.05.2015;2015;05;06;Perjantai;24;0;24
94;08.05.2015;2015;05;07;Perjantai;29;5;34
94;08.05.2015;2015;05;08;Perjantai;9;3;12
94;08.05.2015;2015;05;09;Perjantai;9;5;14
94;08.05.2015;2015;05;10;Perjantai;1;1;2
94;08.05.2015;2015;05;11;Perjantai;2;3;5
94;08.05.2015;2015;05;12;Perjantai;1;0;1
94;08.05.2015;2015;05;13;Perjantai;8;5;13
94;08.05.2015;2015;05;14;Perjantai;4;11;15
94;08.05.2015;2015;05;15;Perjantai;4;26;30
94;08.05.2015;2015;05;16;Perjantai;5;31;36
94;08.05.2015;2015;05;17;Perjantai;10;13;23
94;08.05.2015;2015;05;18;Perjantai;5;9;14
94;08.05.2015;2015;05;19;Perjantai;10;1;11
94;08.05.2015;2015;05;20;Perjantai;3;0;3
94;08.05.2015;2015;05;21;Perjantai;0;8;8
94;08.05.2015;2015;05;22;Perjantai;0;1;1
94;08.05.2015;2015;05;23;Perjantai;0;0;0
94;09.05.2015;2015;05;00;Lauantai;4;0;4
94;09.05.2015;2015;05;01;Lauantai;0;5;5
94;09.05.2015;2015;05;02;Lauantai;0;0;0
94;09.05.2015;2015;05;03;Lauantai;0;0;0
94;09.05.2015;2015;05;04;Lauantai;0;1;1
94;09.05.2015;2015;05;05;Lauantai;2;0;2
94;09.05.2015;2015;05;06;Lauantai;3;1;4
94;09.05.2015;2015;05;07;Lauantai;0;2;2
94;09.05.2015;2015;05;08;Lauantai;0;2;2
94;09.05.2015;2015;05;09;Lauantai;6;4;10
94;09.05.2015;2015;05;10;Lauantai;5;6;11
94;09.05.2015;2015;05;11;Lauantai;5;3;8
94;09.05.2015;2015;05;12;Lauantai;5;5;10
94;09.05.2015;2015;05;13;Lauantai;4;3;7
94;09.05.2015;2015;05;14;Lauantai;3;3;6
94;09.05.2015;2015;05;15;Lauantai;5;9;14
94;09.05.2015;2015;05;16;Lauantai;5;4;9
94;09.05.2015;2015;05;17;Lauantai;0;1;1
94;09.05.2015;2015;05;18;Lauantai;1;0;1
94;09.05.2015;2015;05;19;Lauantai;0;0;0
94;09.05.2015;2015;05;20;Lauantai;2;1;3
94;09.05.2015;2015;05;21;Lauantai;1;2;3
94;09.05.2015;2015;05;22;Lauantai;1;0;1
94;09.05.2015;2015;05;23;Lauantai;0;0;0
94;10.05.2015;2015;05;00;Sunnuntai;1;4;5
94;10.05.2015;2015;05;01;Sunnuntai;0;1;1
94;10.05.2015;2015;05;02;Sunnuntai;0;0;0
94;10.05.2015;2015;05;03;Sunnuntai;0;0;0
94;10.05.2015;2015;05;04;Sunnuntai;0;0;0
94;10.05.2015;2015;05;05;Sunnuntai;2;1;3
94;10.05.2015;2015;05;06;Sunnuntai;0;0;0
94;10.05.2015;2015;05;07;Sunnuntai;1;1;2
94;10.05.2015;2015;05;08;Sunnuntai;5;3;8
94;10.05.2015;2015;05;09;Sunnuntai;5;13;18
94;10.05.2015;2015;05;10;Sunnuntai;10;7;17
94;10.05.2015;2015;05;11;Sunnuntai;8;6;14
94;10.05.2015;2015;05;12;Sunnuntai;14;16;30
94;10.05.2015;2015;05;13;Sunnuntai;16;8;24
94;10.05.2015;2015;05;14;Sunnuntai;10;7;17
94;10.05.2015;2015;05;15;Sunnuntai;11;10;21
94;10.05.2015;2015;05;16;Sunnuntai;20;18;38
94;10.05.2015;2015;05;17;Sunnuntai;17;3;20
94;10.05.2015;2015;05;18;Sunnuntai;15;13;28
94;10.05.2015;2015;05;19;Sunnuntai;11;17;28
94;10.05.2015;2015;05;20;Sunnuntai;5;7;12
94;10.05.2015;2015;05;21;Sunnuntai;2;5;7
94;10.05.2015;2015;05;22;Sunnuntai;1;1;2
94;10.05.2015;2015;05;23;Sunnuntai;0;0;0
94;11.05.2015;2015;05;00;Maanantai;0;2;2
94;11.05.2015;2015;05;01;Maanantai;0;0;0
94;11.05.2015;2015;05;02;Maanantai;0;0;0
94;11.05.2015;2015;05;03;Maanantai;0;0;0
94;11.05.2015;2015;05;04;Maanantai;0;0;0
94;11.05.2015;2015;05;05;Maanantai;4;0;4
94;11.05.2015;2015;05;06;Maanantai;12;0;12
94;11.05.2015;2015;05;07;Maanantai;21;6;27
94;11.05.2015;2015;05;08;Maanantai;9;4;13
94;11.05.2015;2015;05;09;Maanantai;5;1;6
94;11.05.2015;2015;05;10;Maanantai;6;6;12
94;11.05.2015;2015;05;11;Maanantai;7;5;12
94;11.05.2015;2015;05;12;Maanantai;9;4;13
94;11.05.2015;2015;05;13;Maanantai;5;5;10
94;11.05.2015;2015;05;14;Maanantai;8;12;20
94;11.05.2015;2015;05;15;Maanantai;9;20;29
94;11.05.2015;2015;05;16;Maanantai;15;34;49
94;11.05.2015;2015;05;17;Maanantai;6;14;20
94;11.05.2015;2015;05;18;Maanantai;7;5;12
94;11.05.2015;2015;05;19;Maanantai;9;11;20
94;11.05.2015;2015;05;20;Maanantai;6;12;18
94;11.05.2015;2015;05;21;Maanantai;1;4;5
94;11.05.2015;2015;05;22;Maanantai;0;4;4
94;11.05.2015;2015;05;23;Maanantai;0;0;0
94;12.05.2015;2015;05;00;Tiistai;1;0;1
94;12.05.2015;2015;05;01;Tiistai;0;0;0
94;12.05.2015;2015;05;02;Tiistai;0;0;0
94;12.05.2015;2015;05;03;Tiistai;0;0;0
94;12.05.2015;2015;05;04;Tiistai;0;0;0
94;12.05.2015;2015;05;05;Tiistai;3;0;3
94;12.05.2015;2015;05;06;Tiistai;10;0;10
94;12.05.2015;2015;05;07;Tiistai;17;4;21
94;12.05.2015;2015;05;08;Tiistai;5;1;6
94;12.05.2015;2015;05;09;Tiistai;0;3;3
94;12.05.2015;2015;05;10;Tiistai;4;0;4
94;12.05.2015;2015;05;11;Tiistai;2;0;2
94;12.05.2015;2015;05;12;Tiistai;2;0;2
94;12.05.2015;2015;05;13;Tiistai;1;4;5
94;12.05.2015;2015;05;14;Tiistai;1;2;3
94;12.05.2015;2015;05;15;Tiistai;1;13;14
94;12.05.2015;2015;05;16;Tiistai;3;13;16
94;12.05.2015;2015;05;17;Tiistai;7;15;22
94;12.05.2015;2015;05;18;Tiistai;1;4;5
94;12.05.2015;2015;05;19;Tiistai;7;7;14
94;12.05.2015;2015;05;20;Tiistai;6;7;13
94;12.05.2015;2015;05;21;Tiistai;2;3;5
94;12.05.2015;2015;05;22;Tiistai;0;1;1
94;12.05.2015;2015;05;23;Tiistai;0;0;0
94;13.05.2015;2015;05;00;Keskiviikko;0;0;0
94;13.05.2015;2015;05;01;Keskiviikko;0;0;0
94;13.05.2015;2015;05;02;Keskiviikko;0;1;1
94;13.05.2015;2015;05;03;Keskiviikko;0;0;0
94;13.05.2015;2015;05;04;Keskiviikko;0;0;0
94;13.05.2015;2015;05;05;Keskiviikko;4;0;4
94;13.05.2015;2015;05;06;Keskiviikko;15;0;15
94;13.05.2015;2015;05;07;Keskiviikko;9;5;14
94;13.05.2015;2015;05;08;Keskiviikko;3;2;5
94;13.05.2015;2015;05;09;Keskiviikko;4;2;6
94;13.05.2015;2015;05;10;Keskiviikko;2;1;3
94;13.05.2015;2015;05;11;Keskiviikko;2;2;4
94;13.05.2015;2015;05;12;Keskiviikko;0;0;0
94;13.05.2015;2015;05;13;Keskiviikko;0;2;2
94;13.05.2015;2015;05;14;Keskiviikko;1;3;4
94;13.05.2015;2015;05;15;Keskiviikko;1;11;12
94;13.05.2015;2015;05;16;Keskiviikko;3;6;9
94;13.05.2015;2015;05;17;Keskiviikko;0;5;5
94;13.05.2015;2015;05;18;Keskiviikko;0;2;2
94;13.05.2015;2015;05;19;Keskiviikko;0;1;1
94;13.05.2015;2015;05;20;Keskiviikko;4;2;6
94;13.05.2015;2015;05;21;Keskiviikko;1;3;4
94;13.05.2015;2015;05;22;Keskiviikko;1;3;4
94;13.05.2015;2015;05;23;Keskiviikko;1;0;1
94;14.05.2015;2015;05;00;Torstai;0;0;0
94;14.05.2015;2015;05;01;Torstai;0;0;0
94;14.05.2015;2015;05;02;Torstai;0;0;0
94;14.05.2015;2015;05;03;Torstai;0;0;0
94;14.05.2015;2015;05;04;Torstai;0;0;0
94;14.05.2015;2015;05;05;Torstai;0;1;1
94;14.05.2015;2015;05;06;Torstai;2;0;2
94;14.05.2015;2015;05;07;Torstai;1;1;2
94;14.05.2015;2015;05;08;Torstai;3;0;3
94;14.05.2015;2015;05;09;Torstai;6;3;9
94;14.05.2015;2015;05;10;Torstai;2;7;9
94;14.05.2015;2015;05;11;Torstai;8;2;10
94;14.05.2015;2015;05;12;Torstai;5;3;8
94;14.05.2015;2015;05;13;Torstai;7;4;11
94;14.05.2015;2015;05;14;Torstai;1;2;3
94;14.05.2015;2015;05;15;Torstai;7;6;13
94;14.05.2015;2015;05;16;Torstai;5;5;10
94;14.05.2015;2015;05;17;Torstai;9;5;14
94;14.05.2015;2015;05;18;Torstai;4;2;6
94;14.05.2015;2015;05;19;Torstai;1;2;3
94;14.05.2015;2015;05;20;Torstai;2;3;5
94;14.05.2015;2015;05;21;Torstai;2;1;3
94;14.05.2015;2015;05;22;Torstai;0;1;1
94;14.05.2015;2015;05;23;Torstai;0;0;0
94;15.05.2015;2015;05;00;Perjantai;0;0;0
94;15.05.2015;2015;05;01;Perjantai;0;0;0
94;15.05.2015;2015;05;02;Perjantai;0;1;1
94;15.05.2015;2015;05;03;Perjantai;0;0;0
94;15.05.2015;2015;05;04;Perjantai;0;0;0
94;15.05.2015;2015;05;05;Perjantai;2;0;2
94;15.05.2015;2015;05;06;Perjantai;7;1;8
94;15.05.2015;2015;05;07;Perjantai;8;4;12
94;15.05.2015;2015;05;08;Perjantai;7;2;9
94;15.05.2015;2015;05;09;Perjantai;0;1;1
94;15.05.2015;2015;05;10;Perjantai;8;1;9
94;15.05.2015;2015;05;11;Perjantai;1;1;2
94;15.05.2015;2015;05;12;Perjantai;0;4;4
94;15.05.2015;2015;05;13;Perjantai;3;1;4
94;15.05.2015;2015;05;14;Perjantai;5;1;6
94;15.05.2015;2015;05;15;Perjantai;3;11;14
94;15.05.2015;2015;05;16;Perjantai;6;15;21
94;15.05.2015;2015;05;17;Perjantai;2;3;5
94;15.05.2015;2015;05;18;Perjantai;1;5;6
94;15.05.2015;2015;05;19;Perjantai;6;3;9
94;15.05.2015;2015;05;20;Perjantai;3;6;9
94;15.05.2015;2015;05;21;Perjantai;2;2;4
94;15.05.2015;2015;05;22;Perjantai;2;3;5
94;15.05.2015;2015;05;23;Perjantai;0;3;3
94;16.05.2015;2015;05;00;Lauantai;0;0;0
94;16.05.2015;2015;05;01;Lauantai;0;0;0
94;16.05.2015;2015;05;02;Lauantai;0;0;0
94;16.05.2015;2015;05;03;Lauantai;0;0;0
94;16.05.2015;2015;05;04;Lauantai;0;0;0
94;16.05.2015;2015;05;05;Lauantai;3;0;3
94;16.05.2015;2015;05;06;Lauantai;2;0;2
94;16.05.2015;2015;05;07;Lauantai;2;4;6
94;16.05.2015;2015;05;08;Lauantai;4;2;6
94;16.05.2015;2015;05;09;Lauantai;5;4;9
94;16.05.2015;2015;05;10;Lauantai;7;8;15
94;16.05.2015;2015;05;11;Lauantai;4;9;13
94;16.05.2015;2015;05;12;Lauantai;8;5;13
94;16.05.2015;2015;05;13;Lauantai;15;7;22
94;16.05.2015;2015;05;14;Lauantai;10;9;19
94;16.05.2015;2015;05;15;Lauantai;15;7;22
94;16.05.2015;2015;05;16;Lauantai;8;11;19
94;16.05.2015;2015;05;17;Lauantai;2;7;9
94;16.05.2015;2015;05;18;Lauantai;10;7;17
94;16.05.2015;2015;05;19;Lauantai;4;13;17
94;16.05.2015;2015;05;20;Lauantai;6;5;11
94;16.05.2015;2015;05;21;Lauantai;6;3;9
94;16.05.2015;2015;05;22;Lauantai;0;2;2
94;16.05.2015;2015;05;23;Lauantai;7;2;9
94;17.05.2015;2015;05;00;Sunnuntai;0;0;0
94;17.05.2015;2015;05;01;Sunnuntai;0;0;0
94;17.05.2015;2015;05;02;Sunnuntai;0;1;1
94;17.05.2015;2015;05;03;Sunnuntai;0;0;0
94;17.05.2015;2015;05;04;Sunnuntai;0;0;0
94;17.05.2015;2015;05;05;Sunnuntai;1;0;1
94;17.05.2015;2015;05;06;Sunnuntai;1;0;1
94;17.05.2015;2015;05;07;Sunnuntai;4;2;6
94;17.05.2015;2015;05;08;Sunnuntai;0;4;4
94;17.05.2015;2015;05;09;Sunnuntai;6;3;9
94;17.05.2015;2015;05;10;Sunnuntai;3;8;11
94;17.05.2015;2015;05;11;Sunnuntai;10;5;15
94;17.05.2015;2015;05;12;Sunnuntai;7;7;14
94;17.05.2015;2015;05;13;Sunnuntai;16;11;27
94;17.05.2015;2015;05;14;Sunnuntai;11;10;21
94;17.05.2015;2015;05;15;Sunnuntai;7;4;11
94;17.05.2015;2015;05;16;Sunnuntai;6;6;12
94;17.05.2015;2015;05;17;Sunnuntai;9;12;21
94;17.05.2015;2015;05;18;Sunnuntai;5;5;10
94;17.05.2015;2015;05;19;Sunnuntai;5;2;7
94;17.05.2015;2015;05;20;Sunnuntai;3;11;14
94;17.05.2015;2015;05;21;Sunnuntai;5;3;8
94;17.05.2015;2015;05;22;Sunnuntai;0;1;1
94;17.05.2015;2015;05;23;Sunnuntai;1;0;1
94;18.05.2015;2015;05;00;Maanantai;0;0;0
94;18.05.2015;2015;05;01;Maanantai;0;0;0
94;18.05.2015;2015;05;02;Maanantai;0;0;0
94;18.05.2015;2015;05;03;Maanantai;0;0;0
94;18.05.2015;2015;05;04;Maanantai;1;1;2
94;18.05.2015;2015;05;05;Maanantai;5;1;6
94;18.05.2015;2015;05;06;Maanantai;26;2;28
94;18.05.2015;2015;05;07;Maanantai;31;6;37
94;18.05.2015;2015;05;08;Maanantai;13;4;17
94;18.05.2015;2015;05;09;Maanantai;3;2;5
94;18.05.2015;2015;05;10;Maanantai;5;4;9
94;18.05.2015;2015;05;11;Maanantai;6;9;15
94;18.05.2015;2015;05;12;Maanantai;10;3;13
94;18.05.2015;2015;05;13;Maanantai;9;3;12
94;18.05.2015;2015;05;14;Maanantai;7;11;18
94;18.05.2015;2015;05;15;Maanantai;7;30;37
94;18.05.2015;2015;05;16;Maanantai;8;35;43
94;18.05.2015;2015;05;17;Maanantai;9;11;20
94;18.05.2015;2015;05;18;Maanantai;3;7;10
94;18.05.2015;2015;05;19;Maanantai;9;14;23
94;18.05.2015;2015;05;20;Maanantai;2;5;7
94;18.05.2015;2015;05;21;Maanantai;0;4;4
94;18.05.2015;2015;05;22;Maanantai;0;3;3
94;18.05.2015;2015;05;23;Maanantai;0;0;0
94;19.05.2015;2015;05;00;Tiistai;0;0;0
94;19.05.2015;2015;05;01;Tiistai;0;0;0
94;19.05.2015;2015;05;02;Tiistai;0;0;0
94;19.05.2015;2015;05;03;Tiistai;0;0;0
94;19.05.2015;2015;05;04;Tiistai;0;1;1
94;19.05.2015;2015;05;05;Tiistai;5;1;6
94;19.05.2015;2015;05;06;Tiistai;16;4;20
94;19.05.2015;2015;05;07;Tiistai;18;4;22
94;19.05.2015;2015;05;08;Tiistai;8;2;10
94;19.05.2015;2015;05;09;Tiistai;5;1;6
94;19.05.2015;2015;05;10;Tiistai;7;0;7
94;19.05.2015;2015;05;11;Tiistai;2;0;2
94;19.05.2015;2015;05;12;Tiistai;2;2;4
94;19.05.2015;2015;05;13;Tiistai;3;4;7
94;19.05.2015;2015;05;14;Tiistai;6;13;19
94;19.05.2015;2015;05;15;Tiistai;7;15;22
94;19.05.2015;2015;05;16;Tiistai;7;25;32
94;19.05.2015;2015;05;17;Tiistai;2;15;17
94;19.05.2015;2015;05;18;Tiistai;4;5;9
94;19.05.2015;2015;05;19;Tiistai;4;9;13
94;19.05.2015;2015;05;20;Tiistai;3;6;9
94;19.05.2015;2015;05;21;Tiistai;0;1;1
94;19.05.2015;2015;05;22;Tiistai;0;3;3
94;19.05.2015;2015;05;23;Tiistai;0;0;0
94;20.05.2015;2015;05;00;Keskiviikko;0;0;0
94;20.05.2015;2015;05;01;Keskiviikko;0;0;0
94;20.05.2015;2015;05;02;Keskiviikko;0;0;0
94;20.05.2015;2015;05;03;Keskiviikko;0;0;0
94;20.05.2015;2015;05;04;Keskiviikko;2;1;3
94;20.05.2015;2015;05;05;Keskiviikko;11;1;12
94;20.05.2015;2015;05;06;Keskiviikko;21;2;23
94;20.05.2015;2015;05;07;Keskiviikko;27;9;36
94;20.05.2015;2015;05;08;Keskiviikko;13;3;16
94;20.05.2015;2015;05;09;Keskiviikko;11;7;18
94;20.05.2015;2015;05;10;Keskiviikko;2;5;7
94;20.05.2015;2015;05;11;Keskiviikko;7;4;11
94;20.05.2015;2015;05;12;Keskiviikko;1;4;5
94;20.05.2015;2015;05;13;Keskiviikko;3;1;4
94;20.05.2015;2015;05;14;Keskiviikko;4;10;14
94;20.05.2015;2015;05;15;Keskiviikko;2;20;22
94;20.05.2015;2015;05;16;Keskiviikko;4;23;27
94;20.05.2015;2015;05;17;Keskiviikko;7;9;16
94;20.05.2015;2015;05;18;Keskiviikko;9;8;17
94;20.05.2015;2015;05;19;Keskiviikko;4;3;7
94;20.05.2015;2015;05;20;Keskiviikko;3;6;9
94;20.05.2015;2015;05;21;Keskiviikko;1;2;3
94;20.05.2015;2015;05;22;Keskiviikko;1;1;2
94;20.05.2015;2015;05;23;Keskiviikko;0;0;0
94;21.05.2015;2015;05;00;Torstai;1;0;1
94;21.05.2015;2015;05;01;Torstai;0;0;0
94;21.05.2015;2015;05;02;Torstai;0;0;0
94;21.05.2015;2015;05;03;Torstai;0;0;0
94;21.05.2015;2015;05;04;Torstai;0;0;0
94;21.05.2015;2015;05;05;Torstai;6;1;7
94;21.05.2015;2015;05;06;Torstai;32;3;35
94;21.05.2015;2015;05;07;Torstai;27;1;28
94;21.05.2015;2015;05;08;Torstai;17;10;27
94;21.05.2015;2015;05;09;Torstai;4;1;5
94;21.05.2015;2015;05;10;Torstai;7;11;18
94;21.05.2015;2015;05;11;Torstai;5;5;10
94;21.05.2015;2015;05;12;Torstai;9;5;14
94;21.05.2015;2015;05;13;Torstai;5;5;10
94;21.05.2015;2015;05;14;Torstai;6;8;14
94;21.05.2015;2015;05;15;Torstai;6;24;30
94;21.05.2015;2015;05;16;Torstai;13;40;53
94;21.05.2015;2015;05;17;Torstai;6;23;29
94;21.05.2015;2015;05;18;Torstai;9;7;16
94;21.05.2015;2015;05;19;Torstai;10;5;15
94;21.05.2015;2015;05;20;Torstai;5;8;13
94;21.05.2015;2015;05;21;Torstai;4;8;12
94;21.05.2015;2015;05;22;Torstai;0;2;2
94;21.05.2015;2015;05;23;Torstai;0;2;2
94;22.05.2015;2015;05;00;Perjantai;0;0;0
94;22.05.2015;2015;05;01;Perjantai;0;0;0
94;22.05.2015;2015;05;02;Perjantai;0;0;0
94;22.05.2015;2015;05;03;Perjantai;0;0;0
94;22.05.2015;2015;05;04;Perjantai;0;0;0
94;22.05.2015;2015;05;05;Perjantai;8;0;8
94;22.05.2015;2015;05;06;Perjantai;18;2;20
94;22.05.2015;2015;05;07;Perjantai;28;4;32
94;22.05.2015;2015;05;08;Perjantai;9;3;12
94;22.05.2015;2015;05;09;Perjantai;6;6;12
94;22.05.2015;2015;05;10;Perjantai;8;4;12
94;22.05.2015;2015;05;11;Perjantai;9;8;17
94;22.05.2015;2015;05;12;Perjantai;6;4;10
94;22.05.2015;2015;05;13;Perjantai;5;5;10
94;22.05.2015;2015;05;14;Perjantai;9;25;34
94;22.05.2015;2015;05;15;Perjantai;6;19;25
94;22.05.2015;2015;05;16;Perjantai;2;32;34
94;22.05.2015;2015;05;17;Perjantai;22;14;36
94;22.05.2015;2015;05;18;Perjantai;18;12;30
94;22.05.2015;2015;05;19;Perjantai;7;10;17
94;22.05.2015;2015;05;20;Perjantai;12;10;22
94;22.05.2015;2015;05;21;Perjantai;6;9;15
94;22.05.2015;2015;05;22;Perjantai;3;7;10
94;22.05.2015;2015;05;23;Perjantai;3;6;9
94;23.05.2015;2015;05;00;Lauantai;2;2;4
94;23.05.2015;2015;05;01;Lauantai;0;1;1
94;23.05.2015;2015;05;02;Lauantai;1;0;1
94;23.05.2015;2015;05;03;Lauantai;0;2;2
94;23.05.2015;2015;05;04;Lauantai;1;1;2
94;23.05.2015;2015;05;05;Lauantai;0;1;1
94;23.05.2015;2015;05;06;Lauantai;0;0;0
94;23.05.2015;2015;05;07;Lauantai;2;4;6
94;23.05.2015;2015;05;08;Lauantai;2;0;2
94;23.05.2015;2015;05;09;Lauantai;2;3;5
94;23.05.2015;2015;05;10;Lauantai;2;6;8
94;23.05.2015;2015;05;11;Lauantai;0;0;0
94;23.05.2015;2015;05;12;Lauantai;4;0;4
94;23.05.2015;2015;05;13;Lauantai;0;2;2
94;23.05.2015;2015;05;14;Lauantai;3;2;5
94;23.05.2015;2015;05;15;Lauantai;3;1;4
94;23.05.2015;2015;05;16;Lauantai;3;6;9
94;23.05.2015;2015;05;17;Lauantai;2;1;3
94;23.05.2015;2015;05;18;Lauantai;1;3;4
94;23.05.2015;2015;05;19;Lauantai;0;2;2
94;23.05.2015;2015;05;20;Lauantai;3;2;5
94;23.05.2015;2015;05;21;Lauantai;1;4;5
94;23.05.2015;2015;05;22;Lauantai;0;1;1
94;23.05.2015;2015;05;23;Lauantai;2;0;2
94;24.05.2015;2015;05;00;Sunnuntai;2;0;2
94;24.05.2015;2015;05;01;Sunnuntai;0;0;0
94;24.05.2015;2015;05;02;Sunnuntai;1;0;1
94;24.05.2015;2015;05;03;Sunnuntai;0;1;1
94;24.05.2015;2015;05;04;Sunnuntai;0;1;1
94;24.05.2015;2015;05;05;Sunnuntai;0;0;0
94;24.05.2015;2015;05;06;Sunnuntai;3;0;3
94;24.05.2015;2015;05;07;Sunnuntai;3;1;4
94;24.05.2015;2015;05;08;Sunnuntai;4;4;8
94;24.05.2015;2015;05;09;Sunnuntai;7;6;13
94;24.05.2015;2015;05;10;Sunnuntai;5;12;17
94;24.05.2015;2015;05;11;Sunnuntai;14;11;25
94;24.05.2015;2015;05;12;Sunnuntai;13;13;26
94;24.05.2015;2015;05;13;Sunnuntai;16;10;26
94;24.05.2015;2015;05;14;Sunnuntai;14;11;25
94;24.05.2015;2015;05;15;Sunnuntai;10;10;20
94;24.05.2015;2015;05;16;Sunnuntai;7;11;18
94;24.05.2015;2015;05;17;Sunnuntai;14;6;20
94;24.05.2015;2015;05;18;Sunnuntai;14;8;22
94;24.05.2015;2015;05;19;Sunnuntai;5;4;9
94;24.05.2015;2015;05;20;Sunnuntai;5;7;12
94;24.05.2015;2015;05;21;Sunnuntai;3;1;4
94;24.05.2015;2015;05;22;Sunnuntai;0;1;1
94;24.05.2015;2015;05;23;Sunnuntai;0;0;0
94;25.05.2015;2015;05;00;Maanantai;0;0;0
94;25.05.2015;2015;05;01;Maanantai;0;0;0
94;25.05.2015;2015;05;02;Maanantai;0;0;0
94;25.05.2015;2015;05;03;Maanantai;0;0;0
94;25.05.2015;2015;05;04;Maanantai;1;0;1
94;25.05.2015;2015;05;05;Maanantai;10;1;11
94;25.05.2015;2015;05;06;Maanantai;26;3;29
94;25.05.2015;2015;05;07;Maanantai;31;8;39
94;25.05.2015;2015;05;08;Maanantai;19;6;25
94;25.05.2015;2015;05;09;Maanantai;8;3;11
94;25.05.2015;2015;05;10;Maanantai;4;7;11
94;25.05.2015;2015;05;11;Maanantai;10;9;19
94;25.05.2015;2015;05;12;Maanantai;7;1;8
94;25.05.2015;2015;05;13;Maanantai;9;9;18
94;25.05.2015;2015;05;14;Maanantai;6;10;16
94;25.05.2015;2015;05;15;Maanantai;7;20;27
94;25.05.2015;2015;05;16;Maanantai;8;38;46
94;25.05.2015;2015;05;17;Maanantai;11;27;38
94;25.05.2015;2015;05;18;Maanantai;7;7;14
94;25.05.2015;2015;05;19;Maanantai;3;7;10
94;25.05.2015;2015;05;20;Maanantai;4;11;15
94;25.05.2015;2015;05;21;Maanantai;2;4;6
94;25.05.2015;2015;05;22;Maanantai;3;3;6
94;25.05.2015;2015;05;23;Maanantai;0;0;0
94;26.05.2015;2015;05;00;Tiistai;0;1;1
94;26.05.2015;2015;05;01;Tiistai;0;0;0
94;26.05.2015;2015;05;02;Tiistai;0;1;1
94;26.05.2015;2015;05;03;Tiistai;0;0;0
94;26.05.2015;2015;05;04;Tiistai;1;0;1
94;26.05.2015;2015;05;05;Tiistai;6;0;6
94;26.05.2015;2015;05;06;Tiistai;21;1;22
94;26.05.2015;2015;05;07;Tiistai;25;4;29
94;26.05.2015;2015;05;08;Tiistai;10;2;12
94;26.05.2015;2015;05;09;Tiistai;2;3;5
94;26.05.2015;2015;05;10;Tiistai;4;4;8
94;26.05.2015;2015;05;11;Tiistai;10;19;29
94;26.05.2015;2015;05;12;Tiistai;4;4;8
94;26.05.2015;2015;05;13;Tiistai;4;13;17
94;26.05.2015;2015;05;14;Tiistai;6;8;14
94;26.05.2015;2015;05;15;Tiistai;10;27;37
94;26.05.2015;2015;05;16;Tiistai;9;31;40
94;26.05.2015;2015;05;17;Tiistai;12;28;40
94;26.05.2015;2015;05;18;Tiistai;10;7;17
94;26.05.2015;2015;05;19;Tiistai;4;5;9
94;26.05.2015;2015;05;20;Tiistai;8;6;14
94;26.05.2015;2015;05;21;Tiistai;2;4;6
94;26.05.2015;2015;05;22;Tiistai;0;1;1
94;26.05.2015;2015;05;23;Tiistai;0;1;1
94;27.05.2015;2015;05;00;Keskiviikko;0;0;0
94;27.05.2015;2015;05;01;Keskiviikko;0;0;0
94;27.05.2015;2015;05;02;Keskiviikko;0;0;0
94;27.05.2015;2015;05;03;Keskiviikko;0;0;0
94;27.05.2015;2015;05;04;Keskiviikko;0;1;1
94;27.05.2015;2015;05;05;Keskiviikko;8;1;9
94;27.05.2015;2015;05;06;Keskiviikko;16;1;17
94;27.05.2015;2015;05;07;Keskiviikko;15;4;19
94;27.05.2015;2015;05;08;Keskiviikko;12;3;15
94;27.05.2015;2015;05;09;Keskiviikko;2;3;5
94;27.05.2015;2015;05;10;Keskiviikko;4;6;10
94;27.05.2015;2015;05;11;Keskiviikko;6;2;8
94;27.05.2015;2015;05;12;Keskiviikko;2;4;6
94;27.05.2015;2015;05;13;Keskiviikko;3;0;3
94;27.05.2015;2015;05;14;Keskiviikko;4;7;11
94;27.05.2015;2015;05;15;Keskiviikko;4;15;19
94;27.05.2015;2015;05;16;Keskiviikko;7;29;36
94;27.05.2015;2015;05;17;Keskiviikko;7;5;12
94;27.05.2015;2015;05;18;Keskiviikko;4;10;14
94;27.05.2015;2015;05;19;Keskiviikko;2;9;11
94;27.05.2015;2015;05;20;Keskiviikko;4;8;12
94;27.05.2015;2015;05;21;Keskiviikko;6;4;10
94;27.05.2015;2015;05;22;Keskiviikko;0;1;1
94;27.05.2015;2015;05;23;Keskiviikko;1;1;2
94;28.05.2015;2015;05;00;Torstai;1;4;5
94;28.05.2015;2015;05;01;Torstai;1;1;2
94;28.05.2015;2015;05;02;Torstai;0;0;0
94;28.05.2015;2015;05;03;Torstai;0;0;0
94;28.05.2015;2015;05;04;Torstai;1;0;1
94;28.05.2015;2015;05;05;Torstai;9;1;10
94;28.05.2015;2015;05;06;Torstai;20;1;21
94;28.05.2015;2015;05;07;Torstai;31;4;35
94;28.05.2015;2015;05;08;Torstai;15;4;19
94;28.05.2015;2015;05;09;Torstai;8;4;12
94;28.05.2015;2015;05;10;Torstai;3;4;7
94;28.05.2015;2015;05;11;Torstai;9;7;16
94;28.05.2015;2015;05;12;Torstai;21;5;26
94;28.05.2015;2015;05;13;Torstai;14;6;20
94;28.05.2015;2015;05;14;Torstai;6;8;14
94;28.05.2015;2015;05;15;Torstai;10;27;37
94;28.05.2015;2015;05;16;Torstai;14;40;54
94;28.05.2015;2015;05;17;Torstai;10;26;36
94;28.05.2015;2015;05;18;Torstai;6;15;21
94;28.05.2015;2015;05;19;Torstai;13;11;24
94;28.05.2015;2015;05;20;Torstai;4;9;13
94;28.05.2015;2015;05;21;Torstai;5;9;14
94;28.05.2015;2015;05;22;Torstai;1;5;6
94;28.05.2015;2015;05;23;Torstai;0;1;1
94;29.05.2015;2015;05;00;Perjantai;0;1;1
94;29.05.2015;2015;05;01;Perjantai;0;0;0
94;29.05.2015;2015;05;02;Perjantai;0;0;0
94;29.05.2015;2015;05;03;Perjantai;0;0;0
94;29.05.2015;2015;05;04;Perjantai;0;0;0
94;29.05.2015;2015;05;05;Perjantai;6;2;8
94;29.05.2015;2015;05;06;Perjantai;16;3;19
94;29.05.2015;2015;05;07;Perjantai;23;7;30
94;29.05.2015;2015;05;08;Perjantai;14;7;21
94;29.05.2015;2015;05;09;Perjantai;4;5;9
94;29.05.2015;2015;05;10;Perjantai;5;3;8
94;29.05.2015;2015;05;11;Perjantai;5;7;12
94;29.05.2015;2015;05;12;Perjantai;5;11;16
94;29.05.2015;2015;05;13;Perjantai;11;11;22
94;29.05.2015;2015;05;14;Perjantai;11;10;21
94;29.05.2015;2015;05;15;Perjantai;13;22;35
94;29.05.2015;2015;05;16;Perjantai;11;17;28
94;29.05.2015;2015;05;17;Perjantai;3;11;14
94;29.05.2015;2015;05;18;Perjantai;1;3;4
94;29.05.2015;2015;05;19;Perjantai;4;10;14
94;29.05.2015;2015;05;20;Perjantai;1;5;6
94;29.05.2015;2015;05;21;Perjantai;1;2;3
94;29.05.2015;2015;05;22;Perjantai;0;1;1
94;29.05.2015;2015;05;23;Perjantai;0;1;1
94;30.05.2015;2015;05;00;Lauantai;1;0;1
94;30.05.2015;2015;05;01;Lauantai;0;0;0
94;30.05.2015;2015;05;02;Lauantai;0;0;0
94;30.05.2015;2015;05;03;Lauantai;0;1;1
94;30.05.2015;2015;05;04;Lauantai;1;0;1
94;30.05.2015;2015;05;05;Lauantai;1;0;1
94;30.05.2015;2015;05;06;Lauantai;2;0;2
94;30.05.2015;2015;05;07;Lauantai;2;3;5
94;30.05.2015;2015;05;08;Lauantai;4;2;6
94;30.05.2015;2015;05;09;Lauantai;10;7;17
94;30.05.2015;2015;05;10;Lauantai;6;8;14
94;30.05.2015;2015;05;11;Lauantai;8;9;17
94;30.05.2015;2015;05;12;Lauantai;17;9;26
94;30.05.2015;2015;05;13;Lauantai;7;10;17
94;30.05.2015;2015;05;14;Lauantai;8;10;18
94;30.05.2015;2015;05;15;Lauantai;12;12;24
94;30.05.2015;2015;05;16;Lauantai;5;6;11
94;30.05.2015;2015;05;17;Lauantai;8;6;14
94;30.05.2015;2015;05;18;Lauantai;11;14;25
94;30.05.2015;2015;05;19;Lauantai;9;6;15
94;30.05.2015;2015;05;20;Lauantai;2;5;7
94;30.05.2015;2015;05;21;Lauantai;6;4;10
94;30.05.2015;2015;05;22;Lauantai;1;6;7
94;30.05.2015;2015;05;23;Lauantai;0;1;1
94;31.05.2015;2015;05;00;Sunnuntai;1;3;4
94;31.05.2015;2015;05;01;Sunnuntai;4;5;9
94;31.05.2015;2015;05;02;Sunnuntai;0;2;2
94;31.05.2015;2015;05;03;Sunnuntai;0;0;0
94;31.05.2015;2015;05;04;Sunnuntai;2;2;4
94;31.05.2015;2015;05;05;Sunnuntai;0;1;1
94;31.05.2015;2015;05;06;Sunnuntai;0;1;1
94;31.05.2015;2015;05;07;Sunnuntai;2;1;3
94;31.05.2015;2015;05;08;Sunnuntai;4;0;4
94;31.05.2015;2015;05;09;Sunnuntai;3;6;9
94;31.05.2015;2015;05;10;Sunnuntai;8;16;24
94;31.05.2015;2015;05;11;Sunnuntai;9;8;17
94;31.05.2015;2015;05;12;Sunnuntai;6;4;10
94;31.05.2015;2015;05;13;Sunnuntai;5;5;10
94;31.05.2015;2015;05;14;Sunnuntai;1;1;2
94;31.05.2015;2015;05;15;Sunnuntai;5;3;8
94;31.05.2015;2015;05;16;Sunnuntai;2;5;7
94;31.05.2015;2015;05;17;Sunnuntai;2;5;7
94;31.05.2015;2015;05;18;Sunnuntai;11;7;18
94;31.05.2015;2015;05;19;Sunnuntai;11;11;22
94;31.05.2015;2015;05;20;Sunnuntai;6;1;7
94;31.05.2015;2015;05;21;Sunnuntai;1;5;6
94;31.05.2015;2015;05;22;Sunnuntai;0;1;1
94;31.05.2015;2015;05;23;Sunnuntai;1;1;2
94;01.06.2015;2015;06;00;Maanantai;0;0;0
94;01.06.2015;2015;06;01;Maanantai;0;0;0
94;01.06.2015;2015;06;02;Maanantai;0;1;1
94;01.06.2015;2015;06;03;Maanantai;0;0;0
94;01.06.2015;2015;06;04;Maanantai;0;0;0
94;01.06.2015;2015;06;05;Maanantai;11;1;12
94;01.06.2015;2015;06;06;Maanantai;19;3;22
94;01.06.2015;2015;06;07;Maanantai;26;3;29
94;01.06.2015;2015;06;08;Maanantai;9;6;15
94;01.06.2015;2015;06;09;Maanantai;2;5;7
94;01.06.2015;2015;06;10;Maanantai;2;1;3
94;01.06.2015;2015;06;11;Maanantai;4;4;8
94;01.06.2015;2015;06;12;Maanantai;2;3;5
94;01.06.2015;2015;06;13;Maanantai;9;5;14
94;01.06.2015;2015;06;14;Maanantai;6;12;18
94;01.06.2015;2015;06;15;Maanantai;7;32;39
94;01.06.2015;2015;06;16;Maanantai;8;29;37
94;01.06.2015;2015;06;17;Maanantai;5;9;14
94;01.06.2015;2015;06;18;Maanantai;2;6;8
94;01.06.2015;2015;06;19;Maanantai;3;3;6
94;01.06.2015;2015;06;20;Maanantai;3;3;6
94;01.06.2015;2015;06;21;Maanantai;3;1;4
94;01.06.2015;2015;06;22;Maanantai;2;2;4
94;01.06.2015;2015;06;23;Maanantai;0;0;0
94;02.06.2015;2015;06;00;Tiistai;1;0;1
94;02.06.2015;2015;06;01;Tiistai;0;0;0
94;02.06.2015;2015;06;02;Tiistai;0;2;2
94;02.06.2015;2015;06;03;Tiistai;1;0;1
94;02.06.2015;2015;06;04;Tiistai;0;0;0
94;02.06.2015;2015;06;05;Tiistai;8;2;10
94;02.06.2015;2015;06;06;Tiistai;24;2;26
94;02.06.2015;2015;06;07;Tiistai;45;3;48
94;02.06.2015;2015;06;08;Tiistai;13;4;17
94;02.06.2015;2015;06;09;Tiistai;10;3;13
94;02.06.2015;2015;06;10;Tiistai;9;5;14
94;02.06.2015;2015;06;11;Tiistai;9;3;12
94;02.06.2015;2015;06;12;Tiistai;9;4;13
94;02.06.2015;2015;06;13;Tiistai;4;6;10
94;02.06.2015;2015;06;14;Tiistai;3;8;11
94;02.06.2015;2015;06;15;Tiistai;11;27;38
94;02.06.2015;2015;06;16;Tiistai;11;36;47
94;02.06.2015;2015;06;17;Tiistai;7;26;33
94;02.06.2015;2015;06;18;Tiistai;15;15;30
94;02.06.2015;2015;06;19;Tiistai;10;14;24
94;02.06.2015;2015;06;20;Tiistai;5;11;16
94;02.06.2015;2015;06;21;Tiistai;3;7;10
94;02.06.2015;2015;06;22;Tiistai;1;2;3
94;02.06.2015;2015;06;23;Tiistai;1;1;2
94;03.06.2015;2015;06;00;Keskiviikko;0;0;0
94;03.06.2015;2015;06;01;Keskiviikko;0;0;0
94;03.06.2015;2015;06;02;Keskiviikko;0;0;0
94;03.06.2015;2015;06;03;Keskiviikko;0;0;0
94;03.06.2015;2015;06;04;Keskiviikko;1;0;1
94;03.06.2015;2015;06;05;Keskiviikko;3;1;4
94;03.06.2015;2015;06;06;Keskiviikko;13;0;13
94;03.06.2015;2015;06;07;Keskiviikko;10;1;11
94;03.06.2015;2015;06;08;Keskiviikko;2;2;4
94;03.06.2015;2015;06;09;Keskiviikko;2;0;2
94;03.06.2015;2015;06;10;Keskiviikko;3;0;3
94;03.06.2015;2015;06;11;Keskiviikko;0;3;3
94;03.06.2015;2015;06;12;Keskiviikko;2;0;2
94;03.06.2015;2015;06;13;Keskiviikko;3;1;4
94;03.06.2015;2015;06;14;Keskiviikko;2;2;4
94;03.06.2015;2015;06;15;Keskiviikko;3;9;12
94;03.06.2015;2015;06;16;Keskiviikko;5;11;16
94;03.06.2015;2015;06;17;Keskiviikko;3;12;15
94;03.06.2015;2015;06;18;Keskiviikko;5;6;11
94;03.06.2015;2015;06;19;Keskiviikko;4;6;10
94;03.06.2015;2015;06;20;Keskiviikko;3;5;8
94;03.06.2015;2015;06;21;Keskiviikko;1;0;1
94;03.06.2015;2015;06;22;Keskiviikko;0;1;1
94;03.06.2015;2015;06;23;Keskiviikko;2;0;2
94;04.06.2015;2015;06;00;Torstai;0;0;0
94;04.06.2015;2015;06;01;Torstai;2;0;2
94;04.06.2015;2015;06;02;Torstai;0;0;0
94;04.06.2015;2015;06;03;Torstai;0;0;0
94;04.06.2015;2015;06;04;Torstai;0;0;0
94;04.06.2015;2015;06;05;Torstai;4;1;5
94;04.06.2015;2015;06;06;Torstai;23;2;25
94;04.06.2015;2015;06;07;Torstai;21;2;23
94;04.06.2015;2015;06;08;Torstai;5;4;9
94;04.06.2015;2015;06;09;Torstai;10;1;11
94;04.06.2015;2015;06;10;Torstai;11;6;17
94;04.06.2015;2015;06;11;Torstai;5;10;15
94;04.06.2015;2015;06;12;Torstai;12;7;19
94;04.06.2015;2015;06;13;Torstai;10;5;15
94;04.06.2015;2015;06;14;Torstai;14;13;27
94;04.06.2015;2015;06;15;Torstai;11;25;36
94;04.06.2015;2015;06;16;Torstai;7;32;39
94;04.06.2015;2015;06;17;Torstai;13;26;39
94;04.06.2015;2015;06;18;Torstai;17;12;29
94;04.06.2015;2015;06;19;Torstai;8;19;27
94;04.06.2015;2015;06;20;Torstai;9;16;25
94;04.06.2015;2015;06;21;Torstai;5;8;13
94;04.06.2015;2015;06;22;Torstai;3;7;10
94;04.06.2015;2015;06;23;Torstai;2;3;5
94;05.06.2015;2015;06;00;Perjantai;0;2;2
94;05.06.2015;2015;06;01;Perjantai;0;0;0
94;05.06.2015;2015;06;02;Perjantai;0;0;0
94;05.06.2015;2015;06;03;Perjantai;0;2;2
94;05.06.2015;2015;06;04;Perjantai;1;0;1
94;05.06.2015;2015;06;05;Perjantai;5;0;5
94;05.06.2015;2015;06;06;Perjantai;29;4;33
94;05.06.2015;2015;06;07;Perjantai;25;4;29
94;05.06.2015;2015;06;08;Perjantai;14;3;17
94;05.06.2015;2015;06;09;Perjantai;9;4;13
94;05.06.2015;2015;06;10;Perjantai;2;9;11
94;05.06.2015;2015;06;11;Perjantai;6;5;11
94;05.06.2015;2015;06;12;Perjantai;7;3;10
94;05.06.2015;2015;06;13;Perjantai;5;1;6
94;05.06.2015;2015;06;14;Perjantai;5;9;14
94;05.06.2015;2015;06;15;Perjantai;12;23;35
94;05.06.2015;2015;06;16;Perjantai;8;32;40
94;05.06.2015;2015;06;17;Perjantai;4;7;11
94;05.06.2015;2015;06;18;Perjantai;8;12;20
94;05.06.2015;2015;06;19;Perjantai;7;9;16
94;05.06.2015;2015;06;20;Perjantai;5;9;14
94;05.06.2015;2015;06;21;Perjantai;6;6;12
94;05.06.2015;2015;06;22;Perjantai;3;10;13
94;05.06.2015;2015;06;23;Perjantai;3;1;4
94;06.06.2015;2015;06;00;Lauantai;3;1;4
94;06.06.2015;2015;06;01;Lauantai;0;2;2
94;06.06.2015;2015;06;02;Lauantai;0;2;2
94;06.06.2015;2015;06;03;Lauantai;0;1;1
94;06.06.2015;2015;06;04;Lauantai;0;0;0
94;06.06.2015;2015;06;05;Lauantai;2;0;2
94;06.06.2015;2015;06;06;Lauantai;2;1;3
94;06.06.2015;2015;06;07;Lauantai;1;4;5
94;06.06.2015;2015;06;08;Lauantai;6;7;13
94;06.06.2015;2015;06;09;Lauantai;5;6;11
94;06.06.2015;2015;06;10;Lauantai;10;26;36
94;06.06.2015;2015;06;11;Lauantai;21;7;28
94;06.06.2015;2015;06;12;Lauantai;14;14;28
94;06.06.2015;2015;06;13;Lauantai;23;12;35
94;06.06.2015;2015;06;14;Lauantai;10;18;28
94;06.06.2015;2015;06;15;Lauantai;6;9;15
94;06.06.2015;2015;06;16;Lauantai;12;9;21
94;06.06.2015;2015;06;17;Lauantai;2;1;3
94;06.06.2015;2015;06;18;Lauantai;2;2;4
94;06.06.2015;2015;06;19;Lauantai;2;2;4
94;06.06.2015;2015;06;20;Lauantai;1;3;4
94;06.06.2015;2015;06;21;Lauantai;0;0;0
94;06.06.2015;2015;06;22;Lauantai;1;2;3
94;06.06.2015;2015;06;23;Lauantai;0;0;0
94;07.06.2015;2015;06;00;Sunnuntai;0;0;0
94;07.06.2015;2015;06;01;Sunnuntai;0;0;0
94;07.06.2015;2015;06;02;Sunnuntai;0;0;0
94;07.06.2015;2015;06;03;Sunnuntai;0;0;0
94;07.06.2015;2015;06;04;Sunnuntai;1;0;1
94;07.06.2015;2015;06;05;Sunnuntai;1;0;1
94;07.06.2015;2015;06;06;Sunnuntai;1;0;1
94;07.06.2015;2015;06;07;Sunnuntai;1;1;2
94;07.06.2015;2015;06;08;Sunnuntai;1;0;1
94;07.06.2015;2015;06;09;Sunnuntai;1;6;7
94;07.06.2015;2015;06;10;Sunnuntai;0;0;0
94;07.06.2015;2015;06;11;Sunnuntai;2;0;2
94;07.06.2015;2015;06;12;Sunnuntai;3;2;5
94;07.06.2015;2015;06;13;Sunnuntai;1;0;1
94;07.06.2015;2015;06;14;Sunnuntai;2;3;5
94;07.06.2015;2015;06;15;Sunnuntai;1;3;4
94;07.06.2015;2015;06;16;Sunnuntai;2;1;3
94;07.06.2015;2015;06;17;Sunnuntai;1;0;1
94;07.06.2015;2015;06;18;Sunnuntai;1;1;2
94;07.06.2015;2015;06;19;Sunnuntai;1;1;2
94;07.06.2015;2015;06;20;Sunnuntai;1;2;3
94;07.06.2015;2015;06;21;Sunnuntai;0;2;2
94;07.06.2015;2015;06;22;Sunnuntai;0;0;0
94;07.06.2015;2015;06;23;Sunnuntai;1;0;1
94;08.06.2015;2015;06;00;Maanantai;0;2;2
94;08.06.2015;2015;06;01;Maanantai;1;0;1
94;08.06.2015;2015;06;02;Maanantai;0;0;0
94;08.06.2015;2015;06;03;Maanantai;0;0;0
94;08.06.2015;2015;06;04;Maanantai;1;0;1
94;08.06.2015;2015;06;05;Maanantai;7;0;7
94;08.06.2015;2015;06;06;Maanantai;20;4;24
94;08.06.2015;2015;06;07;Maanantai;25;1;26
94;08.06.2015;2015;06;08;Maanantai;8;2;10
94;08.06.2015;2015;06;09;Maanantai;6;2;8
94;08.06.2015;2015;06;10;Maanantai;9;3;12
94;08.06.2015;2015;06;11;Maanantai;3;9;12
94;08.06.2015;2015;06;12;Maanantai;7;8;15
94;08.06.2015;2015;06;13;Maanantai;8;6;14
94;08.06.2015;2015;06;14;Maanantai;7;13;20
94;08.06.2015;2015;06;15;Maanantai;11;19;30
94;08.06.2015;2015;06;16;Maanantai;8;29;37
94;08.06.2015;2015;06;17;Maanantai;5;26;31
94;08.06.2015;2015;06;18;Maanantai;8;17;25
94;08.06.2015;2015;06;19;Maanantai;7;12;19
94;08.06.2015;2015;06;20;Maanantai;18;15;33
94;08.06.2015;2015;06;21;Maanantai;3;6;9
94;08.06.2015;2015;06;22;Maanantai;2;6;8
94;08.06.2015;2015;06;23;Maanantai;1;1;2
94;09.06.2015;2015;06;00;Tiistai;1;1;2
94;09.06.2015;2015;06;01;Tiistai;0;1;1
94;09.06.2015;2015;06;02;Tiistai;0;0;0
94;09.06.2015;2015;06;03;Tiistai;0;0;0
94;09.06.2015;2015;06;04;Tiistai;0;0;0
94;09.06.2015;2015;06;05;Tiistai;10;1;11
94;09.06.2015;2015;06;06;Tiistai;26;2;28
94;09.06.2015;2015;06;07;Tiistai;33;4;37
94;09.06.2015;2015;06;08;Tiistai;11;8;19
94;09.06.2015;2015;06;09;Tiistai;3;5;8
94;09.06.2015;2015;06;10;Tiistai;11;8;19
94;09.06.2015;2015;06;11;Tiistai;10;6;16
94;09.06.2015;2015;06;12;Tiistai;13;10;23
94;09.06.2015;2015;06;13;Tiistai;7;7;14
94;09.06.2015;2015;06;14;Tiistai;9;9;18
94;09.06.2015;2015;06;15;Tiistai;15;27;42
94;09.06.2015;2015;06;16;Tiistai;3;41;44
94;09.06.2015;2015;06;17;Tiistai;9;17;26
94;09.06.2015;2015;06;18;Tiistai;5;25;30
94;09.06.2015;2015;06;19;Tiistai;11;6;17
94;09.06.2015;2015;06;20;Tiistai;5;10;15
94;09.06.2015;2015;06;21;Tiistai;3;8;11
94;09.06.2015;2015;06;22;Tiistai;2;6;8
94;09.06.2015;2015;06;23;Tiistai;1;5;6
94;10.06.2015;2015;06;00;Keskiviikko;2;0;2
94;10.06.2015;2015;06;01;Keskiviikko;0;1;1
94;10.06.2015;2015;06;02;Keskiviikko;0;0;0
94;10.06.2015;2015;06;03;Keskiviikko;0;0;0
94;10.06.2015;2015;06;04;Keskiviikko;0;0;0
94;10.06.2015;2015;06;05;Keskiviikko;7;2;9
94;10.06.2015;2015;06;06;Keskiviikko;16;4;20
94;10.06.2015;2015;06;07;Keskiviikko;34;2;36
94;10.06.2015;2015;06;08;Keskiviikko;6;3;9
94;10.06.2015;2015;06;09;Keskiviikko;3;3;6
94;10.06.2015;2015;06;10;Keskiviikko;2;2;4
94;10.06.2015;2015;06;11;Keskiviikko;4;2;6
94;10.06.2015;2015;06;12;Keskiviikko;2;0;2
94;10.06.2015;2015;06;13;Keskiviikko;5;5;10
94;10.06.2015;2015;06;14;Keskiviikko;9;9;18
94;10.06.2015;2015;06;15;Keskiviikko;6;19;25
94;10.06.2015;2015;06;16;Keskiviikko;2;31;33
94;10.06.2015;2015;06;17;Keskiviikko;7;28;35
94;10.06.2015;2015;06;18;Keskiviikko;6;9;15
94;10.06.2015;2015;06;19;Keskiviikko;7;9;16
94;10.06.2015;2015;06;20;Keskiviikko;4;2;6
94;10.06.2015;2015;06;21;Keskiviikko;2;3;5
94;10.06.2015;2015;06;22;Keskiviikko;0;4;4
94;10.06.2015;2015;06;23;Keskiviikko;1;1;2
94;11.06.2015;2015;06;00;Torstai;0;1;1
94;11.06.2015;2015;06;01;Torstai;2;0;2
94;11.06.2015;2015;06;02;Torstai;0;2;2
94;11.06.2015;2015;06;03;Torstai;0;0;0
94;11.06.2015;2015;06;04;Torstai;0;0;0
94;11.06.2015;2015;06;05;Torstai;8;1;9
94;11.06.2015;2015;06;06;Torstai;29;2;31
94;11.06.2015;2015;06;07;Torstai;20;1;21
94;11.06.2015;2015;06;08;Torstai;7;3;10
94;11.06.2015;2015;06;09;Torstai;8;5;13
94;11.06.2015;2015;06;10;Torstai;10;6;16
94;11.06.2015;2015;06;11;Torstai;9;8;17
94;11.06.2015;2015;06;12;Torstai;6;8;14
94;11.06.2015;2015;06;13;Torstai;12;8;20
94;11.06.2015;2015;06;14;Torstai;9;7;16
94;11.06.2015;2015;06;15;Torstai;12;21;33
94;11.06.2015;2015;06;16;Torstai;6;40;46
94;11.06.2015;2015;06;17;Torstai;7;20;27
94;11.06.2015;2015;06;18;Torstai;10;8;18
94;11.06.2015;2015;06;19;Torstai;4;7;11
94;11.06.2015;2015;06;20;Torstai;8;8;16
94;11.06.2015;2015;06;21;Torstai;1;11;12
94;11.06.2015;2015;06;22;Torstai;0;3;3
94;11.06.2015;2015;06;23;Torstai;1;1;2
94;12.06.2015;2015;06;00;Perjantai;0;0;0
94;12.06.2015;2015;06;01;Perjantai;0;0;0
94;12.06.2015;2015;06;02;Perjantai;0;0;0
94;12.06.2015;2015;06;03;Perjantai;0;0;0
94;12.06.2015;2015;06;04;Perjantai;0;0;0
94;12.06.2015;2015;06;05;Perjantai;8;1;9
94;12.06.2015;2015;06;06;Perjantai;17;3;20
94;12.06.2015;2015;06;07;Perjantai;28;4;32
94;12.06.2015;2015;06;08;Perjantai;9;4;13
94;12.06.2015;2015;06;09;Perjantai;7;1;8
94;12.06.2015;2015;06;10;Perjantai;13;3;16
94;12.06.2015;2015;06;11;Perjantai;3;3;6
94;12.06.2015;2015;06;12;Perjantai;4;2;6
94;12.06.2015;2015;06;13;Perjantai;7;11;18
94;12.06.2015;2015;06;14;Perjantai;12;13;25
94;12.06.2015;2015;06;15;Perjantai;9;21;30
94;12.06.2015;2015;06;16;Perjantai;5;25;30
94;12.06.2015;2015;06;17;Perjantai;7;14;21
94;12.06.2015;2015;06;18;Perjantai;11;20;31
94;12.06.2015;2015;06;19;Perjantai;4;6;10
94;12.06.2015;2015;06;20;Perjantai;5;8;13
94;12.06.2015;2015;06;21;Perjantai;3;6;9
94;12.06.2015;2015;06;22;Perjantai;5;1;6
94;12.06.2015;2015;06;23;Perjantai;0;5;5
94;13.06.2015;2015;06;00;Lauantai;2;3;5
94;13.06.2015;2015;06;01;Lauantai;0;1;1
94;13.06.2015;2015;06;02;Lauantai;0;0;0
94;13.06.2015;2015;06;03;Lauantai;0;0;0
94;13.06.2015;2015;06;04;Lauantai;1;1;2
94;13.06.2015;2015;06;05;Lauantai;2;0;2
94;13.06.2015;2015;06;06;Lauantai;4;0;4
94;13.06.2015;2015;06;07;Lauantai;4;7;11
94;13.06.2015;2015;06;08;Lauantai;4;2;6
94;13.06.2015;2015;06;09;Lauantai;7;5;12
94;13.06.2015;2015;06;10;Lauantai;2;7;9
94;13.06.2015;2015;06;11;Lauantai;1;2;3
94;13.06.2015;2015;06;12;Lauantai;6;1;7
94;13.06.2015;2015;06;13;Lauantai;7;5;12
94;13.06.2015;2015;06;14;Lauantai;5;6;11
94;13.06.2015;2015;06;15;Lauantai;8;10;18
94;13.06.2015;2015;06;16;Lauantai;2;17;19
94;13.06.2015;2015;06;17;Lauantai;7;12;19
94;13.06.2015;2015;06;18;Lauantai;7;6;13
94;13.06.2015;2015;06;19;Lauantai;6;6;12
94;13.06.2015;2015;06;20;Lauantai;7;5;12
94;13.06.2015;2015;06;21;Lauantai;3;3;6
94;13.06.2015;2015;06;22;Lauantai;0;4;4
94;13.06.2015;2015;06;23;Lauantai;2;0;2
94;14.06.2015;2015;06;00;Sunnuntai;8;1;9
94;14.06.2015;2015;06;01;Sunnuntai;3;1;4
94;14.06.2015;2015;06;02;Sunnuntai;1;0;1
94;14.06.2015;2015;06;03;Sunnuntai;1;1;2
94;14.06.2015;2015;06;04;Sunnuntai;1;1;2
94;14.06.2015;2015;06;05;Sunnuntai;3;0;3
94;14.06.2015;2015;06;06;Sunnuntai;2;0;2
94;14.06.2015;2015;06;07;Sunnuntai;2;2;4
94;14.06.2015;2015;06;08;Sunnuntai;6;5;11
94;14.06.2015;2015;06;09;Sunnuntai;9;8;17
94;14.06.2015;2015;06;10;Sunnuntai;6;9;15
94;14.06.2015;2015;06;11;Sunnuntai;6;12;18
94;14.06.2015;2015;06;12;Sunnuntai;12;15;27
94;14.06.2015;2015;06;13;Sunnuntai;24;20;44
94;14.06.2015;2015;06;14;Sunnuntai;24;9;33
94;14.06.2015;2015;06;15;Sunnuntai;11;13;24
94;14.06.2015;2015;06;16;Sunnuntai;17;14;31
94;14.06.2015;2015;06;17;Sunnuntai;15;14;29
94;14.06.2015;2015;06;18;Sunnuntai;12;15;27
94;14.06.2015;2015;06;19;Sunnuntai;13;19;32
94;14.06.2015;2015;06;20;Sunnuntai;6;4;10
94;14.06.2015;2015;06;21;Sunnuntai;1;1;2
94;14.06.2015;2015;06;22;Sunnuntai;1;4;5
94;14.06.2015;2015;06;23;Sunnuntai;3;2;5
94;15.06.2015;2015;06;00;Maanantai;0;0;0
94;15.06.2015;2015;06;01;Maanantai;0;1;1
94;15.06.2015;2015;06;02;Maanantai;0;2;2
94;15.06.2015;2015;06;03;Maanantai;0;0;0
94;15.06.2015;2015;06;04;Maanantai;1;0;1
94;15.06.2015;2015;06;05;Maanantai;7;0;7
94;15.06.2015;2015;06;06;Maanantai;8;2;10
94;15.06.2015;2015;06;07;Maanantai;8;1;9
94;15.06.2015;2015;06;08;Maanantai;5;1;6
94;15.06.2015;2015;06;09;Maanantai;2;1;3
94;15.06.2015;2015;06;10;Maanantai;0;0;0
94;15.06.2015;2015;06;11;Maanantai;0;1;1
94;15.06.2015;2015;06;12;Maanantai;3;2;5
94;15.06.2015;2015;06;13;Maanantai;2;3;5
94;15.06.2015;2015;06;14;Maanantai;2;4;6
94;15.06.2015;2015;06;15;Maanantai;2;5;7
94;15.06.2015;2015;06;16;Maanantai;1;16;17
94;15.06.2015;2015;06;17;Maanantai;0;6;6
94;15.06.2015;2015;06;18;Maanantai;6;2;8
94;15.06.2015;2015;06;19;Maanantai;0;1;1
94;15.06.2015;2015;06;20;Maanantai;0;1;1
94;15.06.2015;2015;06;21;Maanantai;1;1;2
94;15.06.2015;2015;06;22;Maanantai;0;0;0
94;15.06.2015;2015;06;23;Maanantai;0;0;0
94;16.06.2015;2015;06;00;Tiistai;0;0;0
94;16.06.2015;2015;06;01;Tiistai;0;1;1
94;16.06.2015;2015;06;02;Tiistai;0;0;0
94;16.06.2015;2015;06;03;Tiistai;0;0;0
94;16.06.2015;2015;06;04;Tiistai;0;0;0
94;16.06.2015;2015;06;05;Tiistai;5;0;5
94;16.06.2015;2015;06;06;Tiistai;7;0;7
94;16.06.2015;2015;06;07;Tiistai;13;1;14
94;16.06.2015;2015;06;08;Tiistai;1;2;3
94;16.06.2015;2015;06;09;Tiistai;3;4;7
94;16.06.2015;2015;06;10;Tiistai;6;2;8
94;16.06.2015;2015;06;11;Tiistai;24;3;27
94;16.06.2015;2015;06;12;Tiistai;6;3;9
94;16.06.2015;2015;06;13;Tiistai;3;1;4
94;16.06.2015;2015;06;14;Tiistai;3;3;6
94;16.06.2015;2015;06;15;Tiistai;2;9;11
94;16.06.2015;2015;06;16;Tiistai;1;33;34
94;16.06.2015;2015;06;17;Tiistai;7;8;15
94;16.06.2015;2015;06;18;Tiistai;15;6;21
94;16.06.2015;2015;06;19;Tiistai;0;8;8
94;16.06.2015;2015;06;20;Tiistai;2;4;6
94;16.06.2015;2015;06;21;Tiistai;4;9;13
94;16.06.2015;2015;06;22;Tiistai;0;4;4
94;16.06.2015;2015;06;23;Tiistai;0;0;0
94;17.06.2015;2015;06;00;Keskiviikko;0;2;2
94;17.06.2015;2015;06;01;Keskiviikko;0;0;0
94;17.06.2015;2015;06;02;Keskiviikko;2;0;2
94;17.06.2015;2015;06;03;Keskiviikko;0;3;3
94;17.06.2015;2015;06;04;Keskiviikko;1;0;1
94;17.06.2015;2015;06;05;Keskiviikko;8;0;8
94;17.06.2015;2015;06;06;Keskiviikko;12;2;14
94;17.06.2015;2015;06;07;Keskiviikko;21;2;23
94;17.06.2015;2015;06;08;Keskiviikko;4;2;6
94;17.06.2015;2015;06;09;Keskiviikko;7;5;12
94;17.06.2015;2015;06;10;Keskiviikko;3;2;5
94;17.06.2015;2015;06;11;Keskiviikko;6;3;9
94;17.06.2015;2015;06;12;Keskiviikko;5;3;8
94;17.06.2015;2015;06;13;Keskiviikko;7;8;15
94;17.06.2015;2015;06;14;Keskiviikko;3;12;15
94;17.06.2015;2015;06;15;Keskiviikko;10;21;31
94;17.06.2015;2015;06;16;Keskiviikko;8;19;27
94;17.06.2015;2015;06;17;Keskiviikko;14;20;34
94;17.06.2015;2015;06;18;Keskiviikko;8;11;19
94;17.06.2015;2015;06;19;Keskiviikko;6;12;18
94;17.06.2015;2015;06;20;Keskiviikko;6;8;14
94;17.06.2015;2015;06;21;Keskiviikko;4;8;12
94;17.06.2015;2015;06;22;Keskiviikko;1;5;6
94;17.06.2015;2015;06;23;Keskiviikko;5;1;6
94;18.06.2015;2015;06;00;Torstai;0;2;2
94;18.06.2015;2015;06;01;Torstai;1;1;2
94;18.06.2015;2015;06;02;Torstai;0;0;0
94;18.06.2015;2015;06;03;Torstai;0;1;1
94;18.06.2015;2015;06;04;Torstai;1;1;2
94;18.06.2015;2015;06;05;Torstai;5;4;9
94;18.06.2015;2015;06;06;Torstai;15;1;16
94;18.06.2015;2015;06;07;Torstai;20;4;24
94;18.06.2015;2015;06;08;Torstai;8;4;12
94;18.06.2015;2015;06;09;Torstai;4;2;6
94;18.06.2015;2015;06;10;Torstai;8;9;17
94;18.06.2015;2015;06;11;Torstai;17;9;26
94;18.06.2015;2015;06;12;Torstai;6;3;9
94;18.06.2015;2015;06;13;Torstai;9;6;15
94;18.06.2015;2015;06;14;Torstai;4;15;19
94;18.06.2015;2015;06;15;Torstai;8;18;26
94;18.06.2015;2015;06;16;Torstai;6;20;26
94;18.06.2015;2015;06;17;Torstai;6;8;14
94;18.06.2015;2015;06;18;Torstai;2;13;15
94;18.06.2015;2015;06;19;Torstai;10;7;17
94;18.06.2015;2015;06;20;Torstai;3;2;5
94;18.06.2015;2015;06;21;Torstai;2;8;10
94;18.06.2015;2015;06;22;Torstai;4;3;7
94;18.06.2015;2015;06;23;Torstai;2;4;6
94;19.06.2015;2015;06;00;Perjantai;0;0;0
94;19.06.2015;2015;06;01;Perjantai;0;3;3
94;19.06.2015;2015;06;02;Perjantai;0;0;0
94;19.06.2015;2015;06;03;Perjantai;0;0;0
94;19.06.2015;2015;06;04;Perjantai;1;0;1
94;19.06.2015;2015;06;05;Perjantai;1;1;2
94;19.06.2015;2015;06;06;Perjantai;0;0;0
94;19.06.2015;2015;06;07;Perjantai;1;2;3
94;19.06.2015;2015;06;08;Perjantai;3;3;6
94;19.06.2015;2015;06;09;Perjantai;4;8;12
94;19.06.2015;2015;06;10;Perjantai;4;5;9
94;19.06.2015;2015;06;11;Perjantai;5;8;13
94;19.06.2015;2015;06;12;Perjantai;7;15;22
94;19.06.2015;2015;06;13;Perjantai;4;7;11
94;19.06.2015;2015;06;14;Perjantai;7;6;13
94;19.06.2015;2015;06;15;Perjantai;8;5;13
94;19.06.2015;2015;06;16;Perjantai;13;6;19
94;19.06.2015;2015;06;17;Perjantai;14;3;17
94;19.06.2015;2015;06;18;Perjantai;8;7;15
94;19.06.2015;2015;06;19;Perjantai;7;2;9
94;19.06.2015;2015;06;20;Perjantai;2;3;5
94;19.06.2015;2015;06;21;Perjantai;0;7;7
94;19.06.2015;2015;06;22;Perjantai;2;2;4
94;19.06.2015;2015;06;23;Perjantai;4;1;5
94;20.06.2015;2015;06;00;Lauantai;1;4;5
94;20.06.2015;2015;06;01;Lauantai;0;0;0
94;20.06.2015;2015;06;02;Lauantai;0;0;0
94;20.06.2015;2015;06;03;Lauantai;0;0;0
94;20.06.2015;2015;06;04;Lauantai;3;2;5
94;20.06.2015;2015;06;05;Lauantai;2;0;2
94;20.06.2015;2015;06;06;Lauantai;1;1;2
94;20.06.2015;2015;06;07;Lauantai;0;1;1
94;20.06.2015;2015;06;08;Lauantai;1;0;1
94;20.06.2015;2015;06;09;Lauantai;2;3;5
94;20.06.2015;2015;06;10;Lauantai;5;3;8
94;20.06.2015;2015;06;11;Lauantai;8;5;13
94;20.06.2015;2015;06;12;Lauantai;10;16;26
94;20.06.2015;2015;06;13;Lauantai;11;7;18
94;20.06.2015;2015;06;14;Lauantai;8;8;16
94;20.06.2015;2015;06;15;Lauantai;12;14;26
94;20.06.2015;2015;06;16;Lauantai;11;6;17
94;20.06.2015;2015;06;17;Lauantai;7;8;15
94;20.06.2015;2015;06;18;Lauantai;14;11;25
94;20.06.2015;2015;06;19;Lauantai;10;5;15
94;20.06.2015;2015;06;20;Lauantai;6;7;13
94;20.06.2015;2015;06;21;Lauantai;6;3;9
94;20.06.2015;2015;06;22;Lauantai;1;4;5
94;20.06.2015;2015;06;23;Lauantai;0;2;2
94;21.06.2015;2015;06;00;Sunnuntai;1;0;1
94;21.06.2015;2015;06;01;Sunnuntai;0;1;1
94;21.06.2015;2015;06;02;Sunnuntai;0;1;1
94;21.06.2015;2015;06;03;Sunnuntai;2;0;2
94;21.06.2015;2015;06;04;Sunnuntai;0;3;3
94;21.06.2015;2015;06;05;Sunnuntai;2;0;2
94;21.06.2015;2015;06;06;Sunnuntai;2;0;2
94;21.06.2015;2015;06;07;Sunnuntai;0;0;0
94;21.06.2015;2015;06;08;Sunnuntai;1;0;1
94;21.06.2015;2015;06;09;Sunnuntai;2;1;3
94;21.06.2015;2015;06;10;Sunnuntai;1;0;1
94;21.06.2015;2015;06;11;Sunnuntai;0;0;0
94;21.06.2015;2015;06;12;Sunnuntai;7;3;10
94;21.06.2015;2015;06;13;Sunnuntai;5;6;11
94;21.06.2015;2015;06;14;Sunnuntai;3;4;7
94;21.06.2015;2015;06;15;Sunnuntai;8;11;19
94;21.06.2015;2015;06;16;Sunnuntai;16;9;25
94;21.06.2015;2015;06;17;Sunnuntai;12;9;21
94;21.06.2015;2015;06;18;Sunnuntai;20;16;36
94;21.06.2015;2015;06;19;Sunnuntai;24;6;30
94;21.06.2015;2015;06;20;Sunnuntai;4;8;12
94;21.06.2015;2015;06;21;Sunnuntai;4;8;12
94;21.06.2015;2015;06;22;Sunnuntai;5;3;8
94;21.06.2015;2015;06;23;Sunnuntai;2;3;5
94;22.06.2015;2015;06;00;Maanantai;0;1;1
94;22.06.2015;2015;06;01;Maanantai;0;0;0
94;22.06.2015;2015;06;02;Maanantai;0;2;2
94;22.06.2015;2015;06;03;Maanantai;0;0;0
94;22.06.2015;2015;06;04;Maanantai;0;0;0
94;22.06.2015;2015;06;05;Maanantai;6;1;7
94;22.06.2015;2015;06;06;Maanantai;23;2;25
94;22.06.2015;2015;06;07;Maanantai;26;5;31
94;22.06.2015;2015;06;08;Maanantai;17;4;21
94;22.06.2015;2015;06;09;Maanantai;3;6;9
94;22.06.2015;2015;06;10;Maanantai;5;3;8
94;22.06.2015;2015;06;11;Maanantai;15;6;21
94;22.06.2015;2015;06;12;Maanantai;10;14;24
94;22.06.2015;2015;06;13;Maanantai;11;11;22
94;22.06.2015;2015;06;14;Maanantai;5;21;26
94;22.06.2015;2015;06;15;Maanantai;16;18;34
94;22.06.2015;2015;06;16;Maanantai;3;34;37
94;22.06.2015;2015;06;17;Maanantai;10;23;33
94;22.06.2015;2015;06;18;Maanantai;13;13;26
94;22.06.2015;2015;06;19;Maanantai;18;15;33
94;22.06.2015;2015;06;20;Maanantai;14;10;24
94;22.06.2015;2015;06;21;Maanantai;1;7;8
94;22.06.2015;2015;06;22;Maanantai;2;5;7
94;22.06.2015;2015;06;23;Maanantai;0;3;3
94;23.06.2015;2015;06;00;Tiistai;0;1;1
94;23.06.2015;2015;06;01;Tiistai;0;1;1
94;23.06.2015;2015;06;02;Tiistai;0;0;0
94;23.06.2015;2015;06;03;Tiistai;0;0;0
94;23.06.2015;2015;06;04;Tiistai;0;0;0
94;23.06.2015;2015;06;05;Tiistai;3;0;3
94;23.06.2015;2015;06;06;Tiistai;17;0;17
94;23.06.2015;2015;06;07;Tiistai;8;1;9
94;23.06.2015;2015;06;08;Tiistai;7;2;9
94;23.06.2015;2015;06;09;Tiistai;2;1;3
94;23.06.2015;2015;06;10;Tiistai;4;1;5
94;23.06.2015;2015;06;11;Tiistai;2;1;3
94;23.06.2015;2015;06;12;Tiistai;2;4;6
94;23.06.2015;2015;06;13;Tiistai;0;0;0
94;23.06.2015;2015;06;14;Tiistai;0;2;2
94;23.06.2015;2015;06;15;Tiistai;3;9;12
94;23.06.2015;2015;06;16;Tiistai;2;20;22
94;23.06.2015;2015;06;17;Tiistai;1;7;8
94;23.06.2015;2015;06;18;Tiistai;1;7;8
94;23.06.2015;2015;06;19;Tiistai;1;1;2
94;23.06.2015;2015;06;20;Tiistai;1;2;3
94;23.06.2015;2015;06;21;Tiistai;1;1;2
94;23.06.2015;2015;06;22;Tiistai;1;3;4
94;23.06.2015;2015;06;23;Tiistai;1;1;2
94;24.06.2015;2015;06;00;Keskiviikko;0;0;0
94;24.06.2015;2015;06;01;Keskiviikko;0;0;0
94;24.06.2015;2015;06;02;Keskiviikko;0;0;0
94;24.06.2015;2015;06;03;Keskiviikko;0;0;0
94;24.06.2015;2015;06;04;Keskiviikko;0;0;0
94;24.06.2015;2015;06;05;Keskiviikko;6;2;8
94;24.06.2015;2015;06;06;Keskiviikko;13;1;14
94;24.06.2015;2015;06;07;Keskiviikko;13;4;17
94;24.06.2015;2015;06;08;Keskiviikko;9;3;12
94;24.06.2015;2015;06;09;Keskiviikko;4;3;7
94;24.06.2015;2015;06;10;Keskiviikko;7;8;15
94;24.06.2015;2015;06;11;Keskiviikko;9;4;13
94;24.06.2015;2015;06;12;Keskiviikko;4;7;11
94;24.06.2015;2015;06;13;Keskiviikko;5;0;5
94;24.06.2015;2015;06;14;Keskiviikko;2;6;8
94;24.06.2015;2015;06;15;Keskiviikko;3;13;16
94;24.06.2015;2015;06;16;Keskiviikko;1;11;12
94;24.06.2015;2015;06;17;Keskiviikko;4;8;12
94;24.06.2015;2015;06;18;Keskiviikko;1;0;1
94;24.06.2015;2015;06;19;Keskiviikko;2;5;7
94;24.06.2015;2015;06;20;Keskiviikko;4;7;11
94;24.06.2015;2015;06;21;Keskiviikko;0;3;3
94;24.06.2015;2015;06;22;Keskiviikko;0;3;3
94;24.06.2015;2015;06;23;Keskiviikko;2;1;3
94;25.06.2015;2015;06;00;Torstai;1;1;2
94;25.06.2015;2015;06;01;Torstai;1;1;2
94;25.06.2015;2015;06;02;Torstai;0;0;0
94;25.06.2015;2015;06;03;Torstai;0;0;0
94;25.06.2015;2015;06;04;Torstai;0;0;0
94;25.06.2015;2015;06;05;Torstai;8;0;8
94;25.06.2015;2015;06;06;Torstai;12;1;13
94;25.06.2015;2015;06;07;Torstai;8;0;8
94;25.06.2015;2015;06;08;Torstai;5;3;8
94;25.06.2015;2015;06;09;Torstai;2;3;5
94;25.06.2015;2015;06;10;Torstai;4;0;4
94;25.06.2015;2015;06;11;Torstai;2;1;3
94;25.06.2015;2015;06;12;Torstai;3;0;3
94;25.06.2015;2015;06;13;Torstai;4;2;6
94;25.06.2015;2015;06;14;Torstai;0;6;6
94;25.06.2015;2015;06;15;Torstai;1;9;10
94;25.06.2015;2015;06;16;Torstai;1;7;8
94;25.06.2015;2015;06;17;Torstai;2;6;8
94;25.06.2015;2015;06;18;Torstai;4;6;10
94;25.06.2015;2015;06;19;Torstai;5;4;9
94;25.06.2015;2015;06;20;Torstai;2;4;6
94;25.06.2015;2015;06;21;Torstai;0;2;2
94;25.06.2015;2015;06;22;Torstai;1;5;6
94;25.06.2015;2015;06;23;Torstai;0;0;0
94;26.06.2015;2015;06;00;Perjantai;0;0;0
94;26.06.2015;2015;06;01;Perjantai;0;0;0
94;26.06.2015;2015;06;02;Perjantai;2;0;2
94;26.06.2015;2015;06;03;Perjantai;0;0;0
94;26.06.2015;2015;06;04;Perjantai;0;0;0
94;26.06.2015;2015;06;05;Perjantai;3;1;4
94;26.06.2015;2015;06;06;Perjantai;15;3;18
94;26.06.2015;2015;06;07;Perjantai;21;1;22
94;26.06.2015;2015;06;08;Perjantai;4;3;7
94;26.06.2015;2015;06;09;Perjantai;5;2;7
94;26.06.2015;2015;06;10;Perjantai;11;6;17
94;26.06.2015;2015;06;11;Perjantai;4;8;12
94;26.06.2015;2015;06;12;Perjantai;11;2;13
94;26.06.2015;2015;06;13;Perjantai;5;9;14
94;26.06.2015;2015;06;14;Perjantai;3;10;13
94;26.06.2015;2015;06;15;Perjantai;4;16;20
94;26.06.2015;2015;06;16;Perjantai;6;20;26
94;26.06.2015;2015;06;17;Perjantai;7;5;12
94;26.06.2015;2015;06;18;Perjantai;7;12;19
94;26.06.2015;2015;06;19;Perjantai;13;8;21
94;26.06.2015;2015;06;20;Perjantai;1;5;6
94;26.06.2015;2015;06;21;Perjantai;2;5;7
94;26.06.2015;2015;06;22;Perjantai;2;3;5
94;26.06.2015;2015;06;23;Perjantai;4;0;4
94;27.06.2015;2015;06;00;Lauantai;0;3;3
94;27.06.2015;2015;06;01;Lauantai;0;1;1
94;27.06.2015;2015;06;02;Lauantai;0;1;1
94;27.06.2015;2015;06;03;Lauantai;0;2;2
94;27.06.2015;2015;06;04;Lauantai;0;1;1
94;27.06.2015;2015;06;05;Lauantai;4;0;4
94;27.06.2015;2015;06;06;Lauantai;2;0;2
94;27.06.2015;2015;06;07;Lauantai;0;1;1
94;27.06.2015;2015;06;08;Lauantai;0;2;2
94;27.06.2015;2015;06;09;Lauantai;5;3;8
94;27.06.2015;2015;06;10;Lauantai;8;4;12
94;27.06.2015;2015;06;11;Lauantai;4;7;11
94;27.06.2015;2015;06;12;Lauantai;13;10;23
94;27.06.2015;2015;06;13;Lauantai;1;7;8
94;27.06.2015;2015;06;14;Lauantai;4;8;12
94;27.06.2015;2015;06;15;Lauantai;5;4;9
94;27.06.2015;2015;06;16;Lauantai;8;4;12
94;27.06.2015;2015;06;17;Lauantai;8;7;15
94;27.06.2015;2015;06;18;Lauantai;6;2;8
94;27.06.2015;2015;06;19;Lauantai;7;5;12
94;27.06.2015;2015;06;20;Lauantai;3;5;8
94;27.06.2015;2015;06;21;Lauantai;1;3;4
94;27.06.2015;2015;06;22;Lauantai;4;2;6
94;27.06.2015;2015;06;23;Lauantai;0;7;7
94;28.06.2015;2015;06;00;Sunnuntai;4;0;4
94;28.06.2015;2015;06;01;Sunnuntai;0;2;2
94;28.06.2015;2015;06;02;Sunnuntai;0;0;0
94;28.06.2015;2015;06;03;Sunnuntai;0;0;0
94;28.06.2015;2015;06;04;Sunnuntai;2;0;2
94;28.06.2015;2015;06;05;Sunnuntai;2;0;2
94;28.06.2015;2015;06;06;Sunnuntai;2;0;2
94;28.06.2015;2015;06;07;Sunnuntai;2;1;3
94;28.06.2015;2015;06;08;Sunnuntai;2;2;4
94;28.06.2015;2015;06;09;Sunnuntai;5;10;15
94;28.06.2015;2015;06;10;Sunnuntai;12;10;22
94;28.06.2015;2015;06;11;Sunnuntai;21;20;41
94;28.06.2015;2015;06;12;Sunnuntai;18;22;40
94;28.06.2015;2015;06;13;Sunnuntai;17;14;31
94;28.06.2015;2015;06;14;Sunnuntai;9;10;19
94;28.06.2015;2015;06;15;Sunnuntai;12;31;43
94;28.06.2015;2015;06;16;Sunnuntai;20;10;30
94;28.06.2015;2015;06;17;Sunnuntai;16;20;36
94;28.06.2015;2015;06;18;Sunnuntai;16;9;25
94;28.06.2015;2015;06;19;Sunnuntai;13;17;30
94;28.06.2015;2015;06;20;Sunnuntai;11;7;18
94;28.06.2015;2015;06;21;Sunnuntai;9;7;16
94;28.06.2015;2015;06;22;Sunnuntai;3;5;8
94;28.06.2015;2015;06;23;Sunnuntai;1;1;2
94;29.06.2015;2015;06;00;Maanantai;0;0;0
94;29.06.2015;2015;06;01;Maanantai;0;0;0
94;29.06.2015;2015;06;02;Maanantai;2;0;2
94;29.06.2015;2015;06;03;Maanantai;0;0;0
94;29.06.2015;2015;06;04;Maanantai;1;0;1
94;29.06.2015;2015;06;05;Maanantai;15;0;15
94;29.06.2015;2015;06;06;Maanantai;12;3;15
94;29.06.2015;2015;06;07;Maanantai;27;6;33
94;29.06.2015;2015;06;08;Maanantai;8;2;10
94;29.06.2015;2015;06;09;Maanantai;6;1;7
94;29.06.2015;2015;06;10;Maanantai;4;11;15
94;29.06.2015;2015;06;11;Maanantai;3;10;13
94;29.06.2015;2015;06;12;Maanantai;10;10;20
94;29.06.2015;2015;06;13;Maanantai;7;6;13
94;29.06.2015;2015;06;14;Maanantai;14;21;35
94;29.06.2015;2015;06;15;Maanantai;19;20;39
94;29.06.2015;2015;06;16;Maanantai;10;32;42
94;29.06.2015;2015;06;17;Maanantai;10;24;34
94;29.06.2015;2015;06;18;Maanantai;20;14;34
94;29.06.2015;2015;06;19;Maanantai;15;13;28
94;29.06.2015;2015;06;20;Maanantai;9;12;21
94;29.06.2015;2015;06;21;Maanantai;9;7;16
94;29.06.2015;2015;06;22;Maanantai;1;5;6
94;29.06.2015;2015;06;23;Maanantai;0;2;2
94;30.06.2015;2015;06;00;Tiistai;0;1;1
94;30.06.2015;2015;06;01;Tiistai;1;1;2
94;30.06.2015;2015;06;02;Tiistai;0;0;0
94;30.06.2015;2015;06;03;Tiistai;0;0;0
94;30.06.2015;2015;06;04;Tiistai;0;1;1
94;30.06.2015;2015;06;05;Tiistai;8;1;9
94;30.06.2015;2015;06;06;Tiistai;14;2;16
94;30.06.2015;2015;06;07;Tiistai;19;5;24
94;30.06.2015;2015;06;08;Tiistai;9;5;14
94;30.06.2015;2015;06;09;Tiistai;6;3;9
94;30.06.2015;2015;06;10;Tiistai;8;5;13
94;30.06.2015;2015;06;11;Tiistai;5;0;5
94;30.06.2015;2015;06;12;Tiistai;1;5;6
94;30.06.2015;2015;06;13;Tiistai;3;8;11
94;30.06.2015;2015;06;14;Tiistai;18;10;28
94;30.06.2015;2015;06;15;Tiistai;9;21;30
94;30.06.2015;2015;06;16;Tiistai;4;28;32
94;30.06.2015;2015;06;17;Tiistai;12;19;31
94;30.06.2015;2015;06;18;Tiistai;8;15;23
94;30.06.2015;2015;06;19;Tiistai;14;10;24
94;30.06.2015;2015;06;20;Tiistai;4;7;11
94;30.06.2015;2015;06;21;Tiistai;2;5;7
94;30.06.2015;2015;06;22;Tiistai;0;1;1
94;30.06.2015;2015;06;23;Tiistai;0;0;0
94;01.07.2015;2015;07;00;Keskiviikko;0;2;2
94;01.07.2015;2015;07;01;Keskiviikko;1;1;2
94;01.07.2015;2015;07;02;Keskiviikko;1;1;2
94;01.07.2015;2015;07;03;Keskiviikko;0;0;0
94;01.07.2015;2015;07;04;Keskiviikko;2;1;3
94;01.07.2015;2015;07;05;Keskiviikko;7;2;9
94;01.07.2015;2015;07;06;Keskiviikko;16;3;19
94;01.07.2015;2015;07;07;Keskiviikko;28;8;36
94;01.07.2015;2015;07;08;Keskiviikko;14;5;19
94;01.07.2015;2015;07;09;Keskiviikko;15;5;20
94;01.07.2015;2015;07;10;Keskiviikko;16;11;27
94;01.07.2015;2015;07;11;Keskiviikko;8;9;17
94;01.07.2015;2015;07;12;Keskiviikko;16;16;32
94;01.07.2015;2015;07;13;Keskiviikko;15;10;25
94;01.07.2015;2015;07;14;Keskiviikko;25;26;51
94;01.07.2015;2015;07;15;Keskiviikko;18;29;47
94;01.07.2015;2015;07;16;Keskiviikko;12;39;51
94;01.07.2015;2015;07;17;Keskiviikko;17;27;44
94;01.07.2015;2015;07;18;Keskiviikko;16;23;39
94;01.07.2015;2015;07;19;Keskiviikko;21;21;42
94;01.07.2015;2015;07;20;Keskiviikko;12;12;24
94;01.07.2015;2015;07;21;Keskiviikko;11;11;22
94;01.07.2015;2015;07;22;Keskiviikko;1;7;8
94;01.07.2015;2015;07;23;Keskiviikko;0;4;4
94;02.07.2015;2015;07;00;Torstai;0;0;0
94;02.07.2015;2015;07;01;Torstai;2;1;3
94;02.07.2015;2015;07;02;Torstai;0;1;1
94;02.07.2015;2015;07;03;Torstai;0;0;0
94;02.07.2015;2015;07;04;Torstai;0;0;0
94;02.07.2015;2015;07;05;Torstai;9;1;10
94;02.07.2015;2015;07;06;Torstai;19;4;23
94;02.07.2015;2015;07;07;Torstai;21;6;27
94;02.07.2015;2015;07;08;Torstai;13;5;18
94;02.07.2015;2015;07;09;Torstai;7;5;12
94;02.07.2015;2015;07;10;Torstai;14;8;22
94;02.07.2015;2015;07;11;Torstai;17;5;22
94;02.07.2015;2015;07;12;Torstai;12;6;18
94;02.07.2015;2015;07;13;Torstai;11;5;16
94;02.07.2015;2015;07;14;Torstai;13;30;43
94;02.07.2015;2015;07;15;Torstai;11;33;44
94;02.07.2015;2015;07;16;Torstai;20;24;44
94;02.07.2015;2015;07;17;Torstai;10;16;26
94;02.07.2015;2015;07;18;Torstai;7;7;14
94;02.07.2015;2015;07;19;Torstai;4;6;10
94;02.07.2015;2015;07;20;Torstai;1;4;5
94;02.07.2015;2015;07;21;Torstai;0;4;4
94;02.07.2015;2015;07;22;Torstai;0;2;2
94;02.07.2015;2015;07;23;Torstai;0;0;0
94;03.07.2015;2015;07;00;Perjantai;0;1;1
94;03.07.2015;2015;07;01;Perjantai;0;2;2
94;03.07.2015;2015;07;02;Perjantai;0;0;0
94;03.07.2015;2015;07;03;Perjantai;0;0;0
94;03.07.2015;2015;07;04;Perjantai;0;1;1
94;03.07.2015;2015;07;05;Perjantai;10;0;10
94;03.07.2015;2015;07;06;Perjantai;11;2;13
94;03.07.2015;2015;07;07;Perjantai;18;4;22
94;03.07.2015;2015;07;08;Perjantai;7;7;14
94;03.07.2015;2015;07;09;Perjantai;5;6;11
94;03.07.2015;2015;07;10;Perjantai;6;1;7
94;03.07.2015;2015;07;11;Perjantai;8;7;15
94;03.07.2015;2015;07;12;Perjantai;12;19;31
94;03.07.2015;2015;07;13;Perjantai;11;16;27
94;03.07.2015;2015;07;14;Perjantai;15;15;30
94;03.07.2015;2015;07;15;Perjantai;26;20;46
94;03.07.2015;2015;07;16;Perjantai;15;29;44
94;03.07.2015;2015;07;17;Perjantai;13;8;21
94;03.07.2015;2015;07;18;Perjantai;13;21;34
94;03.07.2015;2015;07;19;Perjantai;12;5;17
94;03.07.2015;2015;07;20;Perjantai;3;7;10
94;03.07.2015;2015;07;21;Perjantai;2;2;4
94;03.07.2015;2015;07;22;Perjantai;1;3;4
94;03.07.2015;2015;07;23;Perjantai;0;2;2
94;04.07.2015;2015;07;00;Lauantai;1;0;1
94;04.07.2015;2015;07;01;Lauantai;0;0;0
94;04.07.2015;2015;07;02;Lauantai;0;0;0
94;04.07.2015;2015;07;03;Lauantai;0;0;0
94;04.07.2015;2015;07;04;Lauantai;0;0;0
94;04.07.2015;2015;07;05;Lauantai;2;1;3
94;04.07.2015;2015;07;06;Lauantai;1;2;3
94;04.07.2015;2015;07;07;Lauantai;3;3;6
94;04.07.2015;2015;07;08;Lauantai;1;2;3
94;04.07.2015;2015;07;09;Lauantai;1;0;1
94;04.07.2015;2015;07;10;Lauantai;1;2;3
94;04.07.2015;2015;07;11;Lauantai;4;0;4
94;04.07.2015;2015;07;12;Lauantai;1;2;3
94;04.07.2015;2015;07;13;Lauantai;2;2;4
94;04.07.2015;2015;07;14;Lauantai;5;2;7
94;04.07.2015;2015;07;15;Lauantai;3;2;5
94;04.07.2015;2015;07;16;Lauantai;10;7;17
94;04.07.2015;2015;07;17;Lauantai;7;23;30
94;04.07.2015;2015;07;18;Lauantai;11;5;16
94;04.07.2015;2015;07;19;Lauantai;6;4;10
94;04.07.2015;2015;07;20;Lauantai;15;6;21
94;04.07.2015;2015;07;21;Lauantai;4;1;5
94;04.07.2015;2015;07;22;Lauantai;1;2;3
94;04.07.2015;2015;07;23;Lauantai;0;4;4
94;05.07.2015;2015;07;00;Sunnuntai;0;0;0
94;05.07.2015;2015;07;01;Sunnuntai;0;2;2
94;05.07.2015;2015;07;02;Sunnuntai;1;0;1
94;05.07.2015;2015;07;03;Sunnuntai;0;0;0
94;05.07.2015;2015;07;04;Sunnuntai;0;1;1
94;05.07.2015;2015;07;05;Sunnuntai;1;0;1
94;05.07.2015;2015;07;06;Sunnuntai;3;1;4
94;05.07.2015;2015;07;07;Sunnuntai;2;1;3
94;05.07.2015;2015;07;08;Sunnuntai;4;3;7
94;05.07.2015;2015;07;09;Sunnuntai;6;10;16
94;05.07.2015;2015;07;10;Sunnuntai;13;8;21
94;05.07.2015;2015;07;11;Sunnuntai;13;16;29
94;05.07.2015;2015;07;12;Sunnuntai;13;21;34
94;05.07.2015;2015;07;13;Sunnuntai;10;16;26
94;05.07.2015;2015;07;14;Sunnuntai;16;8;24
94;05.07.2015;2015;07;15;Sunnuntai;13;12;25
94;05.07.2015;2015;07;16;Sunnuntai;15;10;25
94;05.07.2015;2015;07;17;Sunnuntai;15;17;32
94;05.07.2015;2015;07;18;Sunnuntai;5;14;19
94;05.07.2015;2015;07;19;Sunnuntai;13;9;22
94;05.07.2015;2015;07;20;Sunnuntai;7;5;12
94;05.07.2015;2015;07;21;Sunnuntai;6;3;9
94;05.07.2015;2015;07;22;Sunnuntai;0;1;1
94;05.07.2015;2015;07;23;Sunnuntai;0;1;1
94;06.07.2015;2015;07;00;Maanantai;0;0;0
94;06.07.2015;2015;07;01;Maanantai;0;1;1
94;06.07.2015;2015;07;02;Maanantai;1;1;2
94;06.07.2015;2015;07;03;Maanantai;0;0;0
94;06.07.2015;2015;07;04;Maanantai;2;0;2
94;06.07.2015;2015;07;05;Maanantai;6;1;7
94;06.07.2015;2015;07;06;Maanantai;22;0;22
94;06.07.2015;2015;07;07;Maanantai;21;7;28
94;06.07.2015;2015;07;08;Maanantai;11;3;14
94;06.07.2015;2015;07;09;Maanantai;7;7;14
94;06.07.2015;2015;07;10;Maanantai;4;12;16
94;06.07.2015;2015;07;11;Maanantai;8;8;16
94;06.07.2015;2015;07;12;Maanantai;11;11;22
94;06.07.2015;2015;07;13;Maanantai;11;11;22
94;06.07.2015;2015;07;14;Maanantai;8;21;29
94;06.07.2015;2015;07;15;Maanantai;15;28;43
94;06.07.2015;2015;07;16;Maanantai;13;39;52
94;06.07.2015;2015;07;17;Maanantai;11;22;33
94;06.07.2015;2015;07;18;Maanantai;21;18;39
94;06.07.2015;2015;07;19;Maanantai;18;13;31
94;06.07.2015;2015;07;20;Maanantai;9;15;24
94;06.07.2015;2015;07;21;Maanantai;14;8;22
94;06.07.2015;2015;07;22;Maanantai;0;5;5
94;06.07.2015;2015;07;23;Maanantai;0;3;3
94;07.07.2015;2015;07;00;Tiistai;2;2;4
94;07.07.2015;2015;07;01;Tiistai;0;1;1
94;07.07.2015;2015;07;02;Tiistai;0;1;1
94;07.07.2015;2015;07;03;Tiistai;0;0;0
94;07.07.2015;2015;07;04;Tiistai;2;0;2
94;07.07.2015;2015;07;05;Tiistai;7;2;9
94;07.07.2015;2015;07;06;Tiistai;21;2;23
94;07.07.2015;2015;07;07;Tiistai;24;8;32
94;07.07.2015;2015;07;08;Tiistai;9;6;15
94;07.07.2015;2015;07;09;Tiistai;8;6;14
94;07.07.2015;2015;07;10;Tiistai;3;5;8
94;07.07.2015;2015;07;11;Tiistai;6;5;11
94;07.07.2015;2015;07;12;Tiistai;13;10;23
94;07.07.2015;2015;07;13;Tiistai;9;12;21
94;07.07.2015;2015;07;14;Tiistai;13;14;27
94;07.07.2015;2015;07;15;Tiistai;10;21;31
94;07.07.2015;2015;07;16;Tiistai;12;29;41
94;07.07.2015;2015;07;17;Tiistai;11;17;28
94;07.07.2015;2015;07;18;Tiistai;11;18;29
94;07.07.2015;2015;07;19;Tiistai;9;14;23
94;07.07.2015;2015;07;20;Tiistai;6;8;14
94;07.07.2015;2015;07;21;Tiistai;7;7;14
94;07.07.2015;2015;07;22;Tiistai;3;4;7
94;07.07.2015;2015;07;23;Tiistai;2;2;4
94;08.07.2015;2015;07;00;Keskiviikko;1;1;2
94;08.07.2015;2015;07;01;Keskiviikko;1;0;1
94;08.07.2015;2015;07;02;Keskiviikko;1;0;1
94;08.07.2015;2015;07;03;Keskiviikko;1;0;1
94;08.07.2015;2015;07;04;Keskiviikko;1;0;1
94;08.07.2015;2015;07;05;Keskiviikko;2;1;3
94;08.07.2015;2015;07;06;Keskiviikko;6;6;12
94;08.07.2015;2015;07;07;Keskiviikko;12;11;23
94;08.07.2015;2015;07;08;Keskiviikko;8;8;16
94;08.07.2015;2015;07;09;Keskiviikko;6;5;11
94;08.07.2015;2015;07;10;Keskiviikko;8;7;15
94;08.07.2015;2015;07;11;Keskiviikko;9;8;17
94;08.07.2015;2015;07;12;Keskiviikko;10;9;19
94;08.07.2015;2015;07;13;Keskiviikko;10;9;19
94;08.07.2015;2015;07;14;Keskiviikko;12;11;23
94;08.07.2015;2015;07;15;Keskiviikko;17;17;34
94;08.07.2015;2015;07;16;Keskiviikko;19;19;38
94;08.07.2015;2015;07;17;Keskiviikko;16;15;31
94;08.07.2015;2015;07;18;Keskiviikko;14;14;28
94;08.07.2015;2015;07;19;Keskiviikko;15;14;29
94;08.07.2015;2015;07;20;Keskiviikko;11;10;21
94;08.07.2015;2015;07;21;Keskiviikko;6;6;12
94;08.07.2015;2015;07;22;Keskiviikko;4;4;8
94;08.07.2015;2015;07;23;Keskiviikko;2;2;4
94;09.07.2015;2015;07;00;Torstai;1;0;1
94;09.07.2015;2015;07;01;Torstai;0;0;0
94;09.07.2015;2015;07;02;Torstai;0;0;0
94;09.07.2015;2015;07;03;Torstai;0;0;0
94;09.07.2015;2015;07;04;Torstai;0;0;0
94;09.07.2015;2015;07;05;Torstai;1;0;1
94;09.07.2015;2015;07;06;Torstai;3;2;5
94;09.07.2015;2015;07;07;Torstai;5;5;10
94;09.07.2015;2015;07;08;Torstai;4;3;7
94;09.07.2015;2015;07;09;Torstai;3;2;5
94;09.07.2015;2015;07;10;Torstai;4;3;7
94;09.07.2015;2015;07;11;Torstai;4;3;7
94;09.07.2015;2015;07;12;Torstai;4;4;8
94;09.07.2015;2015;07;13;Torstai;4;4;8
94;09.07.2015;2015;07;14;Torstai;5;5;10
94;09.07.2015;2015;07;15;Torstai;8;7;15
94;09.07.2015;2015;07;16;Torstai;9;8;17
94;09.07.2015;2015;07;17;Torstai;7;6;13
94;09.07.2015;2015;07;18;Torstai;6;6;12
94;09.07.2015;2015;07;19;Torstai;6;6;12
94;09.07.2015;2015;07;20;Torstai;5;4;9
94;09.07.2015;2015;07;21;Torstai;3;2;5
94;09.07.2015;2015;07;22;Torstai;2;1;3
94;09.07.2015;2015;07;23;Torstai;1;1;2
94;10.07.2015;2015;07;00;Perjantai;1;1;2
94;10.07.2015;2015;07;01;Perjantai;1;0;1
94;10.07.2015;2015;07;02;Perjantai;1;0;1
94;10.07.2015;2015;07;03;Perjantai;0;0;0
94;10.07.2015;2015;07;04;Perjantai;1;0;1
94;10.07.2015;2015;07;05;Perjantai;1;1;2
94;10.07.2015;2015;07;06;Perjantai;5;4;9
94;10.07.2015;2015;07;07;Perjantai;9;8;17
94;10.07.2015;2015;07;08;Perjantai;6;6;12
94;10.07.2015;2015;07;09;Perjantai;4;4;8
94;10.07.2015;2015;07;10;Perjantai;6;5;11
94;10.07.2015;2015;07;11;Perjantai;7;6;13
94;10.07.2015;2015;07;12;Perjantai;7;7;14
94;10.07.2015;2015;07;13;Perjantai;7;7;14
94;10.07.2015;2015;07;14;Perjantai;9;8;17
94;10.07.2015;2015;07;15;Perjantai;13;12;25
94;10.07.2015;2015;07;16;Perjantai;15;14;29
94;10.07.2015;2015;07;17;Perjantai;12;11;23
94;10.07.2015;2015;07;18;Perjantai;11;10;21
94;10.07.2015;2015;07;19;Perjantai;11;11;22
94;10.07.2015;2015;07;20;Perjantai;8;8;16
94;10.07.2015;2015;07;21;Perjantai;5;4;9
94;10.07.2015;2015;07;22;Perjantai;3;3;6
94;10.07.2015;2015;07;23;Perjantai;2;1;3
94;11.07.2015;2015;07;00;Lauantai;3;2;5
94;11.07.2015;2015;07;01;Lauantai;2;1;3
94;11.07.2015;2015;07;02;Lauantai;2;1;3
94;11.07.2015;2015;07;03;Lauantai;1;0;1
94;11.07.2015;2015;07;04;Lauantai;1;1;2
94;11.07.2015;2015;07;05;Lauantai;1;0;1
94;11.07.2015;2015;07;06;Lauantai;1;1;2
94;11.07.2015;2015;07;07;Lauantai;2;1;3
94;11.07.2015;2015;07;08;Lauantai;2;2;4
94;11.07.2015;2015;07;09;Lauantai;4;4;8
94;11.07.2015;2015;07;10;Lauantai;6;6;12
94;11.07.2015;2015;07;11;Lauantai;10;9;19
94;11.07.2015;2015;07;12;Lauantai;10;10;20
94;11.07.2015;2015;07;13;Lauantai;12;11;23
94;11.07.2015;2015;07;14;Lauantai;13;12;25
94;11.07.2015;2015;07;15;Lauantai;9;9;18
94;11.07.2015;2015;07;16;Lauantai;10;9;19
94;11.07.2015;2015;07;17;Lauantai;10;9;19
94;11.07.2015;2015;07;18;Lauantai;10;9;19
94;11.07.2015;2015;07;19;Lauantai;9;8;17
94;11.07.2015;2015;07;20;Lauantai;7;6;13
94;11.07.2015;2015;07;21;Lauantai;5;4;9
94;11.07.2015;2015;07;22;Lauantai;3;3;6
94;11.07.2015;2015;07;23;Lauantai;2;2;4
94;12.07.2015;2015;07;00;Sunnuntai;3;3;6
94;12.07.2015;2015;07;01;Sunnuntai;2;2;4
94;12.07.2015;2015;07;02;Sunnuntai;2;1;3
94;12.07.2015;2015;07;03;Sunnuntai;1;0;1
94;12.07.2015;2015;07;04;Sunnuntai;1;1;2
94;12.07.2015;2015;07;05;Sunnuntai;1;0;1
94;12.07.2015;2015;07;06;Sunnuntai;1;1;2
94;12.07.2015;2015;07;07;Sunnuntai;2;2;4
94;12.07.2015;2015;07;08;Sunnuntai;3;2;5
94;12.07.2015;2015;07;09;Sunnuntai;5;4;9
94;12.07.2015;2015;07;10;Sunnuntai;7;7;14
94;12.07.2015;2015;07;11;Sunnuntai;11;11;22
94;12.07.2015;2015;07;12;Sunnuntai;12;11;23
94;12.07.2015;2015;07;13;Sunnuntai;13;13;26
94;12.07.2015;2015;07;14;Sunnuntai;15;14;29
94;12.07.2015;2015;07;15;Sunnuntai;11;10;21
94;12.07.2015;2015;07;16;Sunnuntai;11;11;22
94;12.07.2015;2015;07;17;Sunnuntai;11;11;22
94;12.07.2015;2015;07;18;Sunnuntai;11;11;22
94;12.07.2015;2015;07;19;Sunnuntai;10;10;20
94;12.07.2015;2015;07;20;Sunnuntai;8;7;15
94;12.07.2015;2015;07;21;Sunnuntai;5;5;10
94;12.07.2015;2015;07;22;Sunnuntai;4;3;7
94;12.07.2015;2015;07;23;Sunnuntai;3;2;5
94;13.07.2015;2015;07;00;Maanantai;1;1;2
94;13.07.2015;2015;07;01;Maanantai;1;0;1
94;13.07.2015;2015;07;02;Maanantai;1;0;1
94;13.07.2015;2015;07;03;Maanantai;1;0;1
94;13.07.2015;2015;07;04;Maanantai;1;0;1
94;13.07.2015;2015;07;05;Maanantai;2;1;3
94;13.07.2015;2015;07;06;Maanantai;6;6;12
94;13.07.2015;2015;07;07;Maanantai;12;11;23
94;13.07.2015;2015;07;08;Maanantai;8;7;15
94;13.07.2015;2015;07;09;Maanantai;6;5;11
94;13.07.2015;2015;07;10;Maanantai;8;7;15
94;13.07.2015;2015;07;11;Maanantai;9;8;17
94;13.07.2015;2015;07;12;Maanantai;10;9;19
94;13.07.2015;2015;07;13;Maanantai;10;9;19
94;13.07.2015;2015;07;14;Maanantai;11;11;22
94;13.07.2015;2015;07;15;Maanantai;17;16;33
94;13.07.2015;2015;07;16;Maanantai;19;19;38
94;13.07.2015;2015;07;17;Maanantai;16;15;31
94;13.07.2015;2015;07;18;Maanantai;14;14;28
94;13.07.2015;2015;07;19;Maanantai;14;14;28
94;13.07.2015;2015;07;20;Maanantai;11;10;21
94;13.07.2015;2015;07;21;Maanantai;6;6;12
94;13.07.2015;2015;07;22;Maanantai;4;4;8
94;13.07.2015;2015;07;23;Maanantai;2;2;4
94;14.07.2015;2015;07;00;Tiistai;1;1;2
94;14.07.2015;2015;07;01;Tiistai;1;0;1
94;14.07.2015;2015;07;02;Tiistai;1;0;1
94;14.07.2015;2015;07;03;Tiistai;1;0;1
94;14.07.2015;2015;07;04;Tiistai;1;0;1
94;14.07.2015;2015;07;05;Tiistai;2;2;4
94;14.07.2015;2015;07;06;Tiistai;7;7;14
94;14.07.2015;2015;07;07;Tiistai;13;13;26
94;14.07.2015;2015;07;08;Tiistai;9;9;18
94;14.07.2015;2015;07;09;Tiistai;7;6;13
94;14.07.2015;2015;07;10;Tiistai;9;8;17
94;14.07.2015;2015;07;11;Tiistai;10;9;19
94;14.07.2015;2015;07;12;Tiistai;11;10;21
94;14.07.2015;2015;07;13;Tiistai;11;11;22
94;14.07.2015;2015;07;14;Tiistai;13;13;26
94;14.07.2015;2015;07;15;Tiistai;19;19;38
94;14.07.2015;2015;07;16;Tiistai;22;21;43
94;14.07.2015;2015;07;17;Tiistai;18;17;35
94;14.07.2015;2015;07;18;Tiistai;16;16;32
94;14.07.2015;2015;07;19;Tiistai;17;16;33
94;14.07.2015;2015;07;20;Tiistai;12;12;24
94;14.07.2015;2015;07;21;Tiistai;7;6;13
94;14.07.2015;2015;07;22;Tiistai;5;4;9
94;14.07.2015;2015;07;23;Tiistai;2;2;4
94;15.07.2015;2015;07;00;Keskiviikko;1;1;2
94;15.07.2015;2015;07;01;Keskiviikko;1;0;1
94;15.07.2015;2015;07;02;Keskiviikko;1;0;1
94;15.07.2015;2015;07;03;Keskiviikko;1;0;1
94;15.07.2015;2015;07;04;Keskiviikko;1;0;1
94;15.07.2015;2015;07;05;Keskiviikko;2;2;4
94;15.07.2015;2015;07;06;Keskiviikko;7;7;14
94;15.07.2015;2015;07;07;Keskiviikko;13;12;25
94;15.07.2015;2015;07;08;Keskiviikko;9;8;17
94;15.07.2015;2015;07;09;Keskiviikko;6;6;12
94;15.07.2015;2015;07;10;Keskiviikko;9;8;17
94;15.07.2015;2015;07;11;Keskiviikko;10;9;19
94;15.07.2015;2015;07;12;Keskiviikko;11;10;21
94;15.07.2015;2015;07;13;Keskiviikko;11;10;21
94;15.07.2015;2015;07;14;Keskiviikko;13;12;25
94;15.07.2015;2015;07;15;Keskiviikko;19;18;37
94;15.07.2015;2015;07;16;Keskiviikko;21;21;42
94;15.07.2015;2015;07;17;Keskiviikko;17;17;34
94;15.07.2015;2015;07;18;Keskiviikko;16;15;31
94;15.07.2015;2015;07;19;Keskiviikko;16;16;32
94;15.07.2015;2015;07;20;Keskiviikko;12;11;23
94;15.07.2015;2015;07;21;Keskiviikko;7;6;13
94;15.07.2015;2015;07;22;Keskiviikko;4;4;8
94;15.07.2015;2015;07;23;Keskiviikko;2;2;4
94;16.07.2015;2015;07;00;Torstai;1;1;2
94;16.07.2015;2015;07;01;Torstai;1;0;1
94;16.07.2015;2015;07;02;Torstai;1;0;1
94;16.07.2015;2015;07;03;Torstai;0;0;0
94;16.07.2015;2015;07;04;Torstai;1;0;1
94;16.07.2015;2015;07;05;Torstai;1;1;2
94;16.07.2015;2015;07;06;Torstai;5;4;9
94;16.07.2015;2015;07;07;Torstai;9;8;17
94;16.07.2015;2015;07;08;Torstai;6;5;11
94;16.07.2015;2015;07;09;Torstai;4;4;8
94;16.07.2015;2015;07;10;Torstai;6;5;11
94;16.07.2015;2015;07;11;Torstai;6;6;12
94;16.07.2015;2015;07;12;Torstai;7;7;14
94;16.07.2015;2015;07;13;Torstai;7;7;14
94;16.07.2015;2015;07;14;Torstai;9;8;17
94;16.07.2015;2015;07;15;Torstai;13;12;25
94;16.07.2015;2015;07;16;Torstai;14;14;28
94;16.07.2015;2015;07;17;Torstai;12;11;23
94;16.07.2015;2015;07;18;Torstai;11;10;21
94;16.07.2015;2015;07;19;Torstai;11;10;21
94;16.07.2015;2015;07;20;Torstai;8;7;15
94;16.07.2015;2015;07;21;Torstai;5;4;9
94;16.07.2015;2015;07;22;Torstai;3;3;6
94;16.07.2015;2015;07;23;Torstai;2;1;3
94;17.07.2015;2015;07;00;Perjantai;1;1;2
94;17.07.2015;2015;07;01;Perjantai;1;0;1
94;17.07.2015;2015;07;02;Perjantai;1;0;1
94;17.07.2015;2015;07;03;Perjantai;1;0;1
94;17.07.2015;2015;07;04;Perjantai;1;0;1
94;17.07.2015;2015;07;05;Perjantai;2;2;4
94;17.07.2015;2015;07;06;Perjantai;7;7;14
94;17.07.2015;2015;07;07;Perjantai;13;13;26
94;17.07.2015;2015;07;08;Perjantai;9;8;17
94;17.07.2015;2015;07;09;Perjantai;6;6;12
94;17.07.2015;2015;07;10;Perjantai;9;8;17
94;17.07.2015;2015;07;11;Perjantai;10;9;19
94;17.07.2015;2015;07;12;Perjantai;11;10;21
94;17.07.2015;2015;07;13;Perjantai;11;10;21
94;17.07.2015;2015;07;14;Perjantai;13;12;25
94;17.07.2015;2015;07;15;Perjantai;19;19;38
94;17.07.2015;2015;07;16;Perjantai;22;21;43
94;17.07.2015;2015;07;17;Perjantai;18;17;35
94;17.07.2015;2015;07;18;Perjantai;16;16;32
94;17.07.2015;2015;07;19;Perjantai;16;16;32
94;17.07.2015;2015;07;20;Perjantai;12;11;23
94;17.07.2015;2015;07;21;Perjantai;7;6;13
94;17.07.2015;2015;07;22;Perjantai;5;4;9
94;17.07.2015;2015;07;23;Perjantai;2;2;4
94;18.07.2015;2015;07;00;Lauantai;4;4;8
94;18.07.2015;2015;07;01;Lauantai;2;2;4
94;18.07.2015;2015;07;02;Lauantai;2;2;4
94;18.07.2015;2015;07;03;Lauantai;1;1;2
94;18.07.2015;2015;07;04;Lauantai;2;1;3
94;18.07.2015;2015;07;05;Lauantai;1;0;1
94;18.07.2015;2015;07;06;Lauantai;2;1;3
94;18.07.2015;2015;07;07;Lauantai;3;2;5
94;18.07.2015;2015;07;08;Lauantai;3;3;6
94;18.07.2015;2015;07;09;Lauantai;6;5;11
94;18.07.2015;2015;07;10;Lauantai;9;8;17
94;18.07.2015;2015;07;11;Lauantai;13;13;26
94;18.07.2015;2015;07;12;Lauantai;14;13;27
94;18.07.2015;2015;07;13;Lauantai;16;15;31
94;18.07.2015;2015;07;14;Lauantai;17;17;34
94;18.07.2015;2015;07;15;Lauantai;12;12;24
94;18.07.2015;2015;07;16;Lauantai;13;13;26
94;18.07.2015;2015;07;17;Lauantai;13;13;26
94;18.07.2015;2015;07;18;Lauantai;13;13;26
94;18.07.2015;2015;07;19;Lauantai;12;12;24
94;18.07.2015;2015;07;20;Lauantai;9;9;18
94;18.07.2015;2015;07;21;Lauantai;6;6;12
94;18.07.2015;2015;07;22;Lauantai;4;4;8
94;18.07.2015;2015;07;23;Lauantai;3;2;5
94;19.07.2015;2015;07;00;Sunnuntai;2;2;4
94;19.07.2015;2015;07;01;Sunnuntai;1;1;2
94;19.07.2015;2015;07;02;Sunnuntai;1;1;2
94;19.07.2015;2015;07;03;Sunnuntai;1;0;1
94;19.07.2015;2015;07;04;Sunnuntai;1;0;1
94;19.07.2015;2015;07;05;Sunnuntai;1;0;1
94;19.07.2015;2015;07;06;Sunnuntai;1;0;1
94;19.07.2015;2015;07;07;Sunnuntai;1;1;2
94;19.07.2015;2015;07;08;Sunnuntai;2;1;3
94;19.07.2015;2015;07;09;Sunnuntai;3;3;6
94;19.07.2015;2015;07;10;Sunnuntai;5;4;9
94;19.07.2015;2015;07;11;Sunnuntai;7;7;14
94;19.07.2015;2015;07;12;Sunnuntai;7;7;14
94;19.07.2015;2015;07;13;Sunnuntai;8;8;16
94;19.07.2015;2015;07;14;Sunnuntai;9;9;18
94;19.07.2015;2015;07;15;Sunnuntai;7;6;13
94;19.07.2015;2015;07;16;Sunnuntai;7;7;14
94;19.07.2015;2015;07;17;Sunnuntai;7;7;14
94;19.07.2015;2015;07;18;Sunnuntai;7;7;14
94;19.07.2015;2015;07;19;Sunnuntai;6;6;12
94;19.07.2015;2015;07;20;Sunnuntai;5;4;9
94;19.07.2015;2015;07;21;Sunnuntai;3;3;6
94;19.07.2015;2015;07;22;Sunnuntai;2;2;4
94;19.07.2015;2015;07;23;Sunnuntai;2;1;3
94;20.07.2015;2015;07;00;Maanantai;2;1;3
94;20.07.2015;2015;07;01;Maanantai;1;0;1
94;20.07.2015;2015;07;02;Maanantai;1;0;1
94;20.07.2015;2015;07;03;Maanantai;1;0;1
94;20.07.2015;2015;07;04;Maanantai;1;0;1
94;20.07.2015;2015;07;05;Maanantai;2;2;4
94;20.07.2015;2015;07;06;Maanantai;9;8;17
94;20.07.2015;2015;07;07;Maanantai;16;16;32
94;20.07.2015;2015;07;08;Maanantai;11;11;22
94;20.07.2015;2015;07;09;Maanantai;8;8;16
94;20.07.2015;2015;07;10;Maanantai;11;10;21
94;20.07.2015;2015;07;11;Maanantai;12;12;24
94;20.07.2015;2015;07;12;Maanantai;13;13;26
94;20.07.2015;2015;07;13;Maanantai;14;13;27
94;20.07.2015;2015;07;14;Maanantai;16;16;32
94;20.07.2015;2015;07;15;Maanantai;24;23;47
94;20.07.2015;2015;07;16;Maanantai;27;26;53
94;20.07.2015;2015;07;17;Maanantai;22;21;43
94;20.07.2015;2015;07;18;Maanantai;20;19;39
94;20.07.2015;2015;07;19;Maanantai;20;20;40
94;20.07.2015;2015;07;20;Maanantai;15;14;29
94;20.07.2015;2015;07;21;Maanantai;8;8;16
94;20.07.2015;2015;07;22;Maanantai;6;5;11
94;20.07.2015;2015;07;23;Maanantai;3;2;5
94;21.07.2015;2015;07;00;Tiistai;1;1;2
94;21.07.2015;2015;07;01;Tiistai;1;0;1
94;21.07.2015;2015;07;02;Tiistai;1;0;1
94;21.07.2015;2015;07;03;Tiistai;1;0;1
94;21.07.2015;2015;07;04;Tiistai;1;0;1
94;21.07.2015;2015;07;05;Tiistai;2;2;4
94;21.07.2015;2015;07;06;Tiistai;7;7;14
94;21.07.2015;2015;07;07;Tiistai;13;13;26
94;21.07.2015;2015;07;08;Tiistai;9;8;17
94;21.07.2015;2015;07;09;Tiistai;6;6;12
94;21.07.2015;2015;07;10;Tiistai;9;8;17
94;21.07.2015;2015;07;11;Tiistai;10;9;19
94;21.07.2015;2015;07;12;Tiistai;11;10;21
94;21.07.2015;2015;07;13;Tiistai;11;10;21
94;21.07.2015;2015;07;14;Tiistai;13;12;25
94;21.07.2015;2015;07;15;Tiistai;19;18;37
94;21.07.2015;2015;07;16;Tiistai;21;21;42
94;21.07.2015;2015;07;17;Tiistai;17;17;34
94;21.07.2015;2015;07;18;Tiistai;16;15;31
94;21.07.2015;2015;07;19;Tiistai;16;16;32
94;21.07.2015;2015;07;20;Tiistai;12;11;23
94;21.07.2015;2015;07;21;Tiistai;7;6;13
94;21.07.2015;2015;07;22;Tiistai;4;4;8
94;21.07.2015;2015;07;23;Tiistai;2;2;4
94;22.07.2015;2015;07;00;Keskiviikko;1;1;2
94;22.07.2015;2015;07;01;Keskiviikko;1;0;1
94;22.07.2015;2015;07;02;Keskiviikko;1;0;1
94;22.07.2015;2015;07;03;Keskiviikko;1;0;1
94;22.07.2015;2015;07;04;Keskiviikko;1;0;1
94;22.07.2015;2015;07;05;Keskiviikko;2;2;4
94;22.07.2015;2015;07;06;Keskiviikko;8;7;15
94;22.07.2015;2015;07;07;Keskiviikko;14;14;28
94;22.07.2015;2015;07;08;Keskiviikko;10;9;19
94;22.07.2015;2015;07;09;Keskiviikko;7;6;13
94;22.07.2015;2015;07;10;Keskiviikko;9;9;18
94;22.07.2015;2015;07;11;Keskiviikko;10;10;20
94;22.07.2015;2015;07;12;Keskiviikko;11;11;22
94;22.07.2015;2015;07;13;Keskiviikko;12;11;23
94;22.07.2015;2015;07;14;Keskiviikko;14;13;27
94;22.07.2015;2015;07;15;Keskiviikko;20;20;40
94;22.07.2015;2015;07;16;Keskiviikko;23;23;46
94;22.07.2015;2015;07;17;Keskiviikko;19;18;37
94;22.07.2015;2015;07;18;Keskiviikko;17;17;34
94;22.07.2015;2015;07;19;Keskiviikko;17;17;34
94;22.07.2015;2015;07;20;Keskiviikko;13;12;25
94;22.07.2015;2015;07;21;Keskiviikko;7;7;14
94;22.07.2015;2015;07;22;Keskiviikko;5;4;9
94;22.07.2015;2015;07;23;Keskiviikko;3;2;5
94;23.07.2015;2015;07;00;Torstai;1;1;2
94;23.07.2015;2015;07;01;Torstai;1;0;1
94;23.07.2015;2015;07;02;Torstai;1;0;1
94;23.07.2015;2015;07;03;Torstai;1;0;1
94;23.07.2015;2015;07;04;Torstai;1;0;1
94;23.07.2015;2015;07;05;Torstai;2;1;3
94;23.07.2015;2015;07;06;Torstai;7;6;13
94;23.07.2015;2015;07;07;Torstai;13;12;25
94;23.07.2015;2015;07;08;Torstai;9;8;17
94;23.07.2015;2015;07;09;Torstai;6;6;12
94;23.07.2015;2015;07;10;Torstai;8;8;16
94;23.07.2015;2015;07;11;Torstai;9;9;18
94;23.07.2015;2015;07;12;Torstai;10;10;20
94;23.07.2015;2015;07;13;Torstai;11;10;21
94;23.07.2015;2015;07;14;Torstai;12;12;24
94;23.07.2015;2015;07;15;Torstai;18;18;36
94;23.07.2015;2015;07;16;Torstai;21;20;41
94;23.07.2015;2015;07;17;Torstai;17;16;33
94;23.07.2015;2015;07;18;Torstai;16;15;31
94;23.07.2015;2015;07;19;Torstai;16;15;31
94;23.07.2015;2015;07;20;Torstai;12;11;23
94;23.07.2015;2015;07;21;Torstai;7;6;13
94;23.07.2015;2015;07;22;Torstai;4;4;8
94;23.07.2015;2015;07;23;Torstai;2;2;4
94;24.07.2015;2015;07;00;Perjantai;1;0;1
94;24.07.2015;2015;07;01;Perjantai;0;0;0
94;24.07.2015;2015;07;02;Perjantai;0;0;0
94;24.07.2015;2015;07;03;Perjantai;0;0;0
94;24.07.2015;2015;07;04;Perjantai;0;0;0
94;24.07.2015;2015;07;05;Perjantai;1;1;2
94;24.07.2015;2015;07;06;Perjantai;3;3;6
94;24.07.2015;2015;07;07;Perjantai;6;5;11
94;24.07.2015;2015;07;08;Perjantai;4;3;7
94;24.07.2015;2015;07;09;Perjantai;3;2;5
94;24.07.2015;2015;07;10;Perjantai;4;3;7
94;24.07.2015;2015;07;11;Perjantai;4;4;8
94;24.07.2015;2015;07;12;Perjantai;5;4;9
94;24.07.2015;2015;07;13;Perjantai;5;4;9
94;24.07.2015;2015;07;14;Perjantai;6;5;11
94;24.07.2015;2015;07;15;Perjantai;8;8;16
94;24.07.2015;2015;07;16;Perjantai;9;9;18
94;24.07.2015;2015;07;17;Perjantai;8;7;15
94;24.07.2015;2015;07;18;Perjantai;7;6;13
94;24.07.2015;2015;07;19;Perjantai;7;7;14
94;24.07.2015;2015;07;20;Perjantai;5;5;10
94;24.07.2015;2015;07;21;Perjantai;3;3;6
94;24.07.2015;2015;07;22;Perjantai;2;2;4
94;24.07.2015;2015;07;23;Perjantai;1;1;2
94;25.07.2015;2015;07;00;Lauantai;4;3;7
94;25.07.2015;2015;07;01;Lauantai;2;2;4
94;25.07.2015;2015;07;02;Lauantai;2;1;3
94;25.07.2015;2015;07;03;Lauantai;1;0;1
94;25.07.2015;2015;07;04;Lauantai;1;1;2
94;25.07.2015;2015;07;05;Lauantai;1;0;1
94;25.07.2015;2015;07;06;Lauantai;1;1;2
94;25.07.2015;2015;07;07;Lauantai;2;2;4
94;25.07.2015;2015;07;08;Lauantai;3;2;5
94;25.07.2015;2015;07;09;Lauantai;5;5;10
94;25.07.2015;2015;07;10;Lauantai;8;7;15
94;25.07.2015;2015;07;11;Lauantai;12;11;23
94;25.07.2015;2015;07;12;Lauantai;12;12;24
94;25.07.2015;2015;07;13;Lauantai;14;13;27
94;25.07.2015;2015;07;14;Lauantai;15;15;30
94;25.07.2015;2015;07;15;Lauantai;11;10;21
94;25.07.2015;2015;07;16;Lauantai;12;11;23
94;25.07.2015;2015;07;17;Lauantai;12;11;23
94;25.07.2015;2015;07;18;Lauantai;12;11;23
94;25.07.2015;2015;07;19;Lauantai;11;10;21
94;25.07.2015;2015;07;20;Lauantai;8;8;16
94;25.07.2015;2015;07;21;Lauantai;6;5;11
94;25.07.2015;2015;07;22;Lauantai;4;3;7
94;25.07.2015;2015;07;23;Lauantai;3;2;5
94;26.07.2015;2015;07;00;Sunnuntai;2;2;4
94;26.07.2015;2015;07;01;Sunnuntai;2;1;3
94;26.07.2015;2015;07;02;Sunnuntai;1;1;2
94;26.07.2015;2015;07;03;Sunnuntai;1;0;1
94;26.07.2015;2015;07;04;Sunnuntai;1;1;2
94;26.07.2015;2015;07;05;Sunnuntai;1;0;1
94;26.07.2015;2015;07;06;Sunnuntai;1;1;2
94;26.07.2015;2015;07;07;Sunnuntai;2;1;3
94;26.07.2015;2015;07;08;Sunnuntai;2;1;3
94;26.07.2015;2015;07;09;Sunnuntai;4;3;7
94;26.07.2015;2015;07;10;Sunnuntai;5;5;10
94;26.07.2015;2015;07;11;Sunnuntai;8;8;16
94;26.07.2015;2015;07;12;Sunnuntai;8;8;16
94;26.07.2015;2015;07;13;Sunnuntai;9;9;18
94;26.07.2015;2015;07;14;Sunnuntai;10;10;20
94;26.07.2015;2015;07;15;Sunnuntai;8;7;15
94;26.07.2015;2015;07;16;Sunnuntai;8;8;16
94;26.07.2015;2015;07;17;Sunnuntai;8;8;16
94;26.07.2015;2015;07;18;Sunnuntai;8;8;16
94;26.07.2015;2015;07;19;Sunnuntai;7;7;14
94;26.07.2015;2015;07;20;Sunnuntai;6;5;11
94;26.07.2015;2015;07;21;Sunnuntai;4;3;7
94;26.07.2015;2015;07;22;Sunnuntai;3;2;5
94;26.07.2015;2015;07;23;Sunnuntai;2;1;3
94;27.07.2015;2015;07;00;Maanantai;1;1;2
94;27.07.2015;2015;07;01;Maanantai;1;0;1
94;27.07.2015;2015;07;02;Maanantai;1;0;1
94;27.07.2015;2015;07;03;Maanantai;0;0;0
94;27.07.2015;2015;07;04;Maanantai;1;0;1
94;27.07.2015;2015;07;05;Maanantai;1;1;2
94;27.07.2015;2015;07;06;Maanantai;5;4;9
94;27.07.2015;2015;07;07;Maanantai;9;8;17
94;27.07.2015;2015;07;08;Maanantai;6;6;12
94;27.07.2015;2015;07;09;Maanantai;4;4;8
94;27.07.2015;2015;07;10;Maanantai;6;5;11
94;27.07.2015;2015;07;11;Maanantai;7;6;13
94;27.07.2015;2015;07;12;Maanantai;7;7;14
94;27.07.2015;2015;07;13;Maanantai;7;7;14
94;27.07.2015;2015;07;14;Maanantai;9;8;17
94;27.07.2015;2015;07;15;Maanantai;13;12;25
94;27.07.2015;2015;07;16;Maanantai;15;14;29
94;27.07.2015;2015;07;17;Maanantai;12;11;23
94;27.07.2015;2015;07;18;Maanantai;11;10;21
94;27.07.2015;2015;07;19;Maanantai;11;11;22
94;27.07.2015;2015;07;20;Maanantai;8;8;16
94;27.07.2015;2015;07;21;Maanantai;5;4;9
94;27.07.2015;2015;07;22;Maanantai;3;3;6
94;27.07.2015;2015;07;23;Maanantai;2;1;3
94;28.07.2015;2015;07;00;Tiistai;2;1;3
94;28.07.2015;2015;07;01;Tiistai;1;0;1
94;28.07.2015;2015;07;02;Tiistai;1;0;1
94;28.07.2015;2015;07;03;Tiistai;1;0;1
94;28.07.2015;2015;07;04;Tiistai;1;0;1
94;28.07.2015;2015;07;05;Tiistai;2;2;4
94;28.07.2015;2015;07;06;Tiistai;8;7;15
94;28.07.2015;2015;07;07;Tiistai;15;14;29
94;28.07.2015;2015;07;08;Tiistai;10;9;19
94;28.07.2015;2015;07;09;Tiistai;7;7;14
94;28.07.2015;2015;07;10;Tiistai;10;9;19
94;28.07.2015;2015;07;11;Tiistai;11;10;21
94;28.07.2015;2015;07;12;Tiistai;12;11;23
94;28.07.2015;2015;07;13;Tiistai;12;12;24
94;28.07.2015;2015;07;14;Tiistai;14;14;28
94;28.07.2015;2015;07;15;Tiistai;21;21;42
94;28.07.2015;2015;07;16;Tiistai;24;23;47
94;28.07.2015;2015;07;17;Tiistai;19;19;38
94;28.07.2015;2015;07;18;Tiistai;18;17;35
94;28.07.2015;2015;07;19;Tiistai;18;18;36
94;28.07.2015;2015;07;20;Tiistai;13;13;26
94;28.07.2015;2015;07;21;Tiistai;7;7;14
94;28.07.2015;2015;07;22;Tiistai;5;5;10
94;28.07.2015;2015;07;23;Tiistai;3;2;5
94;29.07.2015;2015;07;00;Keskiviikko;1;1;2
94;29.07.2015;2015;07;01;Keskiviikko;1;0;1
94;29.07.2015;2015;07;02;Keskiviikko;1;0;1
94;29.07.2015;2015;07;03;Keskiviikko;1;0;1
94;29.07.2015;2015;07;04;Keskiviikko;1;0;1
94;29.07.2015;2015;07;05;Keskiviikko;2;1;3
94;29.07.2015;2015;07;06;Keskiviikko;6;6;12
94;29.07.2015;2015;07;07;Keskiviikko;11;11;22
94;29.07.2015;2015;07;08;Keskiviikko;8;7;15
94;29.07.2015;2015;07;09;Keskiviikko;6;5;11
94;29.07.2015;2015;07;10;Keskiviikko;7;7;14
94;29.07.2015;2015;07;11;Keskiviikko;8;8;16
94;29.07.2015;2015;07;12;Keskiviikko;9;9;18
94;29.07.2015;2015;07;13;Keskiviikko;9;9;18
94;29.07.2015;2015;07;14;Keskiviikko;11;11;22
94;29.07.2015;2015;07;15;Keskiviikko;16;16;32
94;29.07.2015;2015;07;16;Keskiviikko;18;18;36
94;29.07.2015;2015;07;17;Keskiviikko;15;15;30
94;29.07.2015;2015;07;18;Keskiviikko;14;13;27
94;29.07.2015;2015;07;19;Keskiviikko;14;13;27
94;29.07.2015;2015;07;20;Keskiviikko;10;10;20
94;29.07.2015;2015;07;21;Keskiviikko;6;5;11
94;29.07.2015;2015;07;22;Keskiviikko;4;3;7
94;29.07.2015;2015;07;23;Keskiviikko;2;2;4
94;30.07.2015;2015;07;00;Torstai;0;0;0
94;30.07.2015;2015;07;01;Torstai;0;1;1
94;30.07.2015;2015;07;02;Torstai;0;2;2
94;30.07.2015;2015;07;03;Torstai;2;0;2
94;30.07.2015;2015;07;04;Torstai;0;0;0
94;30.07.2015;2015;07;05;Torstai;5;1;6
94;30.07.2015;2015;07;06;Torstai;18;3;21
94;30.07.2015;2015;07;07;Torstai;19;2;21
94;30.07.2015;2015;07;08;Torstai;8;3;11
94;30.07.2015;2015;07;09;Torstai;2;3;5
94;30.07.2015;2015;07;10;Torstai;6;6;12
94;30.07.2015;2015;07;11;Torstai;7;5;12
94;30.07.2015;2015;07;12;Torstai;3;8;11
94;30.07.2015;2015;07;13;Torstai;4;9;13
94;30.07.2015;2015;07;14;Torstai;8;14;22
94;30.07.2015;2015;07;15;Torstai;13;24;37
94;30.07.2015;2015;07;16;Torstai;13;23;36
94;30.07.2015;2015;07;17;Torstai;21;25;46
94;30.07.2015;2015;07;18;Torstai;12;26;38
94;30.07.2015;2015;07;19;Torstai;26;21;47
94;30.07.2015;2015;07;20;Torstai;11;12;23
94;30.07.2015;2015;07;21;Torstai;4;13;17
94;30.07.2015;2015;07;22;Torstai;3;7;10
94;30.07.2015;2015;07;23;Torstai;6;1;7
94;31.07.2015;2015;07;00;Perjantai;0;0;0
94;31.07.2015;2015;07;01;Perjantai;0;1;1
94;31.07.2015;2015;07;02;Perjantai;0;2;2
94;31.07.2015;2015;07;03;Perjantai;2;0;2
94;31.07.2015;2015;07;04;Perjantai;0;0;0
94;31.07.2015;2015;07;05;Perjantai;5;1;6
94;31.07.2015;2015;07;06;Perjantai;18;3;21
94;31.07.2015;2015;07;07;Perjantai;19;2;21
94;31.07.2015;2015;07;08;Perjantai;8;3;11
94;31.07.2015;2015;07;09;Perjantai;2;3;5
94;31.07.2015;2015;07;10;Perjantai;6;6;12
94;31.07.2015;2015;07;11;Perjantai;9;9;18
94;31.07.2015;2015;07;12;Perjantai;7;5;12
94;31.07.2015;2015;07;13;Perjantai;3;8;11
94;31.07.2015;2015;07;14;Perjantai;4;9;13
94;31.07.2015;2015;07;15;Perjantai;8;14;22
94;31.07.2015;2015;07;16;Perjantai;9;14;23
94;31.07.2015;2015;07;17;Perjantai;10;9;19
94;31.07.2015;2015;07;18;Perjantai;24;14;38
94;31.07.2015;2015;07;19;Perjantai;11;15;26
94;31.07.2015;2015;07;20;Perjantai;5;12;17
94;31.07.2015;2015;07;21;Perjantai;4;5;9
94;31.07.2015;2015;07;22;Perjantai;2;6;8
94;31.07.2015;2015;07;23;Perjantai;1;0;1
94;01.08.2015;2015;08;00;Lauantai;0;0;0
94;01.08.2015;2015;08;01;Lauantai;0;1;1
94;01.08.2015;2015;08;02;Lauantai;0;0;0
94;01.08.2015;2015;08;03;Lauantai;0;0;0
94;01.08.2015;2015;08;04;Lauantai;0;0;0
94;01.08.2015;2015;08;05;Lauantai;0;0;0
94;01.08.2015;2015;08;06;Lauantai;0;1;1
94;01.08.2015;2015;08;07;Lauantai;1;3;4
94;01.08.2015;2015;08;08;Lauantai;3;3;6
94;01.08.2015;2015;08;09;Lauantai;1;2;3
94;01.08.2015;2015;08;10;Lauantai;3;3;6
94;01.08.2015;2015;08;11;Lauantai;4;4;8
94;01.08.2015;2015;08;12;Lauantai;0;4;4
94;01.08.2015;2015;08;13;Lauantai;6;3;9
94;01.08.2015;2015;08;14;Lauantai;7;1;8
94;01.08.2015;2015;08;15;Lauantai;6;10;16
94;01.08.2015;2015;08;16;Lauantai;1;5;6
94;01.08.2015;2015;08;17;Lauantai;5;5;10
94;01.08.2015;2015;08;18;Lauantai;2;1;3
94;01.08.2015;2015;08;19;Lauantai;2;2;4
94;01.08.2015;2015;08;20;Lauantai;4;2;6
94;01.08.2015;2015;08;21;Lauantai;3;4;7
94;01.08.2015;2015;08;22;Lauantai;1;4;5
94;01.08.2015;2015;08;23;Lauantai;1;1;2
94;02.08.2015;2015;08;00;Sunnuntai;0;0;0
94;02.08.2015;2015;08;01;Sunnuntai;1;1;2
94;02.08.2015;2015;08;02;Sunnuntai;2;0;2
94;02.08.2015;2015;08;03;Sunnuntai;0;0;0
94;02.08.2015;2015;08;04;Sunnuntai;0;1;1
94;02.08.2015;2015;08;05;Sunnuntai;0;1;1
94;02.08.2015;2015;08;06;Sunnuntai;1;2;3
94;02.08.2015;2015;08;07;Sunnuntai;1;0;1
94;02.08.2015;2015;08;08;Sunnuntai;2;2;4
94;02.08.2015;2015;08;09;Sunnuntai;3;2;5
94;02.08.2015;2015;08;10;Sunnuntai;5;3;8
94;02.08.2015;2015;08;11;Sunnuntai;10;6;16
94;02.08.2015;2015;08;12;Sunnuntai;9;7;16
94;02.08.2015;2015;08;13;Sunnuntai;9;8;17
94;02.08.2015;2015;08;14;Sunnuntai;12;3;15
94;02.08.2015;2015;08;15;Sunnuntai;12;8;20
94;02.08.2015;2015;08;16;Sunnuntai;12;8;20
94;02.08.2015;2015;08;17;Sunnuntai;6;16;22
94;02.08.2015;2015;08;18;Sunnuntai;10;9;19
94;02.08.2015;2015;08;19;Sunnuntai;6;12;18
94;02.08.2015;2015;08;20;Sunnuntai;4;3;7
94;02.08.2015;2015;08;21;Sunnuntai;7;1;8
94;02.08.2015;2015;08;22;Sunnuntai;1;2;3
94;02.08.2015;2015;08;23;Sunnuntai;0;1;1
94;03.08.2015;2015;08;00;Maanantai;0;0;0
94;03.08.2015;2015;08;01;Maanantai;0;0;0
94;03.08.2015;2015;08;02;Maanantai;0;0;0
94;03.08.2015;2015;08;03;Maanantai;0;0;0
94;03.08.2015;2015;08;04;Maanantai;0;1;1
94;03.08.2015;2015;08;05;Maanantai;7;0;7
94;03.08.2015;2015;08;06;Maanantai;21;0;21
94;03.08.2015;2015;08;07;Maanantai;19;2;21
94;03.08.2015;2015;08;08;Maanantai;8;3;11
94;03.08.2015;2015;08;09;Maanantai;7;0;7
94;03.08.2015;2015;08;10;Maanantai;4;4;8
94;03.08.2015;2015;08;11;Maanantai;3;3;6
94;03.08.2015;2015;08;12;Maanantai;14;14;28
94;03.08.2015;2015;08;13;Maanantai;11;4;15
94;03.08.2015;2015;08;14;Maanantai;16;15;31
94;03.08.2015;2015;08;15;Maanantai;8;18;26
94;03.08.2015;2015;08;16;Maanantai;12;40;52
94;03.08.2015;2015;08;17;Maanantai;10;14;24
94;03.08.2015;2015;08;18;Maanantai;8;16;24
94;03.08.2015;2015;08;19;Maanantai;5;11;16
94;03.08.2015;2015;08;20;Maanantai;6;3;9
94;03.08.2015;2015;08;21;Maanantai;1;6;7
94;03.08.2015;2015;08;22;Maanantai;3;8;11
94;03.08.2015;2015;08;23;Maanantai;1;0;1
94;04.08.2015;2015;08;00;Tiistai;1;1;2
94;04.08.2015;2015;08;01;Tiistai;0;0;0
94;04.08.2015;2015;08;02;Tiistai;0;0;0
94;04.08.2015;2015;08;03;Tiistai;1;0;1
94;04.08.2015;2015;08;04;Tiistai;0;0;0
94;04.08.2015;2015;08;05;Tiistai;5;0;5
94;04.08.2015;2015;08;06;Tiistai;22;2;24
94;04.08.2015;2015;08;07;Tiistai;35;5;40
94;04.08.2015;2015;08;08;Tiistai;18;3;21
94;04.08.2015;2015;08;09;Tiistai;8;4;12
94;04.08.2015;2015;08;10;Tiistai;8;3;11
94;04.08.2015;2015;08;11;Tiistai;10;5;15
94;04.08.2015;2015;08;12;Tiistai;8;8;16
94;04.08.2015;2015;08;13;Tiistai;16;9;25
94;04.08.2015;2015;08;14;Tiistai;9;17;26
94;04.08.2015;2015;08;15;Tiistai;8;38;46
94;04.08.2015;2015;08;16;Tiistai;11;51;62
94;04.08.2015;2015;08;17;Tiistai;13;24;37
94;04.08.2015;2015;08;18;Tiistai;12;25;37
94;04.08.2015;2015;08;19;Tiistai;10;17;27
94;04.08.2015;2015;08;20;Tiistai;14;12;26
94;04.08.2015;2015;08;21;Tiistai;11;8;19
94;04.08.2015;2015;08;22;Tiistai;1;6;7
94;04.08.2015;2015;08;23;Tiistai;0;2;2
94;05.08.2015;2015;08;00;Keskiviikko;0;3;3
94;05.08.2015;2015;08;01;Keskiviikko;1;0;1
94;05.08.2015;2015;08;02;Keskiviikko;0;0;0
94;05.08.2015;2015;08;03;Keskiviikko;0;0;0
94;05.08.2015;2015;08;04;Keskiviikko;1;0;1
94;05.08.2015;2015;08;05;Keskiviikko;6;0;6
94;05.08.2015;2015;08;06;Keskiviikko;28;5;33
94;05.08.2015;2015;08;07;Keskiviikko;44;3;47
94;05.08.2015;2015;08;08;Keskiviikko;19;4;23
94;05.08.2015;2015;08;09;Keskiviikko;10;11;21
94;05.08.2015;2015;08;10;Keskiviikko;8;8;16
94;05.08.2015;2015;08;11;Keskiviikko;15;9;24
94;05.08.2015;2015;08;12;Keskiviikko;13;12;25
94;05.08.2015;2015;08;13;Keskiviikko;18;12;30
94;05.08.2015;2015;08;14;Keskiviikko;14;17;31
94;05.08.2015;2015;08;15;Keskiviikko;15;36;51
94;05.08.2015;2015;08;16;Keskiviikko;23;52;75
94;05.08.2015;2015;08;17;Keskiviikko;25;32;57
94;05.08.2015;2015;08;18;Keskiviikko;6;20;26
94;05.08.2015;2015;08;19;Keskiviikko;15;19;34
94;05.08.2015;2015;08;20;Keskiviikko;18;11;29
94;05.08.2015;2015;08;21;Keskiviikko;5;7;12
94;05.08.2015;2015;08;22;Keskiviikko;2;8;10
94;05.08.2015;2015;08;23;Keskiviikko;4;2;6
94;06.08.2015;2015;08;00;Torstai;0;3;3
94;06.08.2015;2015;08;01;Torstai;1;4;5
94;06.08.2015;2015;08;02;Torstai;0;1;1
94;06.08.2015;2015;08;03;Torstai;0;0;0
94;06.08.2015;2015;08;04;Torstai;2;2;4
94;06.08.2015;2015;08;05;Torstai;7;1;8
94;06.08.2015;2015;08;06;Torstai;26;2;28
94;06.08.2015;2015;08;07;Torstai;19;5;24
94;06.08.2015;2015;08;08;Torstai;7;1;8
94;06.08.2015;2015;08;09;Torstai;8;2;10
94;06.08.2015;2015;08;10;Torstai;3;1;4
94;06.08.2015;2015;08;11;Torstai;3;2;5
94;06.08.2015;2015;08;12;Torstai;1;1;2
94;06.08.2015;2015;08;13;Torstai;10;5;15
94;06.08.2015;2015;08;14;Torstai;7;15;22
94;06.08.2015;2015;08;15;Torstai;3;18;21
94;06.08.2015;2015;08;16;Torstai;10;25;35
94;06.08.2015;2015;08;17;Torstai;4;8;12
94;06.08.2015;2015;08;18;Torstai;1;5;6
94;06.08.2015;2015;08;19;Torstai;2;2;4
94;06.08.2015;2015;08;20;Torstai;0;3;3
94;06.08.2015;2015;08;21;Torstai;0;4;4
94;06.08.2015;2015;08;22;Torstai;3;5;8
94;06.08.2015;2015;08;23;Torstai;1;0;1
94;07.08.2015;2015;08;00;Perjantai;0;1;1
94;07.08.2015;2015;08;01;Perjantai;0;0;0
94;07.08.2015;2015;08;02;Perjantai;0;0;0
94;07.08.2015;2015;08;03;Perjantai;0;0;0
94;07.08.2015;2015;08;04;Perjantai;1;1;2
94;07.08.2015;2015;08;05;Perjantai;8;0;8
94;07.08.2015;2015;08;06;Perjantai;14;0;14
94;07.08.2015;2015;08;07;Perjantai;17;2;19
94;07.08.2015;2015;08;08;Perjantai;9;5;14
94;07.08.2015;2015;08;09;Perjantai;6;5;11
94;07.08.2015;2015;08;10;Perjantai;5;2;7
94;07.08.2015;2015;08;11;Perjantai;5;3;8
94;07.08.2015;2015;08;12;Perjantai;9;7;16
94;07.08.2015;2015;08;13;Perjantai;9;14;23
94;07.08.2015;2015;08;14;Perjantai;13;19;32
94;07.08.2015;2015;08;15;Perjantai;4;19;23
94;07.08.2015;2015;08;16;Perjantai;12;24;36
94;07.08.2015;2015;08;17;Perjantai;5;14;19
94;07.08.2015;2015;08;18;Perjantai;10;18;28
94;07.08.2015;2015;08;19;Perjantai;8;15;23
94;07.08.2015;2015;08;20;Perjantai;4;9;13
94;07.08.2015;2015;08;21;Perjantai;1;3;4
94;07.08.2015;2015;08;22;Perjantai;2;3;5
94;07.08.2015;2015;08;23;Perjantai;1;3;4
94;08.08.2015;2015;08;00;Lauantai;0;1;1
94;08.08.2015;2015;08;01;Lauantai;1;0;1
94;08.08.2015;2015;08;02;Lauantai;0;2;2
94;08.08.2015;2015;08;03;Lauantai;0;0;0
94;08.08.2015;2015;08;04;Lauantai;1;0;1
94;08.08.2015;2015;08;05;Lauantai;0;1;1
94;08.08.2015;2015;08;06;Lauantai;1;2;3
94;08.08.2015;2015;08;07;Lauantai;2;1;3
94;08.08.2015;2015;08;08;Lauantai;3;3;6
94;08.08.2015;2015;08;09;Lauantai;1;5;6
94;08.08.2015;2015;08;10;Lauantai;11;3;14
94;08.08.2015;2015;08;11;Lauantai;5;6;11
94;08.08.2015;2015;08;12;Lauantai;7;6;13
94;08.08.2015;2015;08;13;Lauantai;7;5;12
94;08.08.2015;2015;08;14;Lauantai;9;4;13
94;08.08.2015;2015;08;15;Lauantai;5;3;8
94;08.08.2015;2015;08;16;Lauantai;6;7;13
94;08.08.2015;2015;08;17;Lauantai;6;9;15
94;08.08.2015;2015;08;18;Lauantai;5;3;8
94;08.08.2015;2015;08;19;Lauantai;10;10;20
94;08.08.2015;2015;08;20;Lauantai;3;3;6
94;08.08.2015;2015;08;21;Lauantai;2;3;5
94;08.08.2015;2015;08;22;Lauantai;3;5;8
94;08.08.2015;2015;08;23;Lauantai;3;2;5
94;09.08.2015;2015;08;00;Sunnuntai;0;1;1
94;09.08.2015;2015;08;01;Sunnuntai;1;4;5
94;09.08.2015;2015;08;02;Sunnuntai;0;0;0
94;09.08.2015;2015;08;03;Sunnuntai;0;1;1
94;09.08.2015;2015;08;04;Sunnuntai;0;0;0
94;09.08.2015;2015;08;05;Sunnuntai;0;3;3
94;09.08.2015;2015;08;06;Sunnuntai;1;1;2
94;09.08.2015;2015;08;07;Sunnuntai;3;0;3
94;09.08.2015;2015;08;08;Sunnuntai;1;2;3
94;09.08.2015;2015;08;09;Sunnuntai;0;3;3
94;09.08.2015;2015;08;10;Sunnuntai;11;12;23
94;09.08.2015;2015;08;11;Sunnuntai;8;9;17
94;09.08.2015;2015;08;12;Sunnuntai;24;19;43
94;09.08.2015;2015;08;13;Sunnuntai;10;9;19
94;09.08.2015;2015;08;14;Sunnuntai;28;9;37
94;09.08.2015;2015;08;15;Sunnuntai;19;14;33
94;09.08.2015;2015;08;16;Sunnuntai;15;22;37
94;09.08.2015;2015;08;17;Sunnuntai;10;9;19
94;09.08.2015;2015;08;18;Sunnuntai;8;9;17
94;09.08.2015;2015;08;19;Sunnuntai;11;6;17
94;09.08.2015;2015;08;20;Sunnuntai;10;13;23
94;09.08.2015;2015;08;21;Sunnuntai;2;5;7
94;09.08.2015;2015;08;22;Sunnuntai;1;1;2
94;09.08.2015;2015;08;23;Sunnuntai;0;4;4
94;10.08.2015;2015;08;00;Maanantai;0;0;0
94;10.08.2015;2015;08;01;Maanantai;0;0;0
94;10.08.2015;2015;08;02;Maanantai;0;0;0
94;10.08.2015;2015;08;03;Maanantai;0;0;0
94;10.08.2015;2015;08;04;Maanantai;1;0;1
94;10.08.2015;2015;08;05;Maanantai;10;0;10
94;10.08.2015;2015;08;06;Maanantai;29;1;30
94;10.08.2015;2015;08;07;Maanantai;36;4;40
94;10.08.2015;2015;08;08;Maanantai;16;6;22
94;10.08.2015;2015;08;09;Maanantai;4;8;12
94;10.08.2015;2015;08;10;Maanantai;8;6;14
94;10.08.2015;2015;08;11;Maanantai;4;8;12
94;10.08.2015;2015;08;12;Maanantai;10;3;13
94;10.08.2015;2015;08;13;Maanantai;7;6;13
94;10.08.2015;2015;08;14;Maanantai;15;13;28
94;10.08.2015;2015;08;15;Maanantai;10;40;50
94;10.08.2015;2015;08;16;Maanantai;17;41;58
94;10.08.2015;2015;08;17;Maanantai;11;26;37
94;10.08.2015;2015;08;18;Maanantai;17;16;33
94;10.08.2015;2015;08;19;Maanantai;16;18;34
94;10.08.2015;2015;08;20;Maanantai;20;27;47
94;10.08.2015;2015;08;21;Maanantai;10;4;14
94;10.08.2015;2015;08;22;Maanantai;0;7;7
94;10.08.2015;2015;08;23;Maanantai;0;1;1
94;11.08.2015;2015;08;00;Tiistai;0;2;2
94;11.08.2015;2015;08;01;Tiistai;0;2;2
94;11.08.2015;2015;08;02;Tiistai;0;0;0
94;11.08.2015;2015;08;03;Tiistai;0;1;1
94;11.08.2015;2015;08;04;Tiistai;0;1;1
94;11.08.2015;2015;08;05;Tiistai;8;0;8
94;11.08.2015;2015;08;06;Tiistai;34;3;37
94;11.08.2015;2015;08;07;Tiistai;34;6;40
94;11.08.2015;2015;08;08;Tiistai;23;5;28
94;11.08.2015;2015;08;09;Tiistai;6;8;14
94;11.08.2015;2015;08;10;Tiistai;16;14;30
94;11.08.2015;2015;08;11;Tiistai;12;7;19
94;11.08.2015;2015;08;12;Tiistai;10;11;21
94;11.08.2015;2015;08;13;Tiistai;9;15;24
94;11.08.2015;2015;08;14;Tiistai;13;18;31
94;11.08.2015;2015;08;15;Tiistai;17;32;49
94;11.08.2015;2015;08;16;Tiistai;13;50;63
94;11.08.2015;2015;08;17;Tiistai;8;24;32
94;11.08.2015;2015;08;18;Tiistai;7;10;17
94;11.08.2015;2015;08;19;Tiistai;7;14;21
94;11.08.2015;2015;08;20;Tiistai;5;5;10
94;11.08.2015;2015;08;21;Tiistai;2;3;5
94;11.08.2015;2015;08;22;Tiistai;5;3;8
94;11.08.2015;2015;08;23;Tiistai;0;2;2
94;12.08.2015;2015;08;00;Keskiviikko;0;0;0
94;12.08.2015;2015;08;01;Keskiviikko;0;0;0
94;12.08.2015;2015;08;02;Keskiviikko;0;0;0
94;12.08.2015;2015;08;03;Keskiviikko;0;0;0
94;12.08.2015;2015;08;04;Keskiviikko;0;0;0
94;12.08.2015;2015;08;05;Keskiviikko;10;0;10
94;12.08.2015;2015;08;06;Keskiviikko;26;2;28
94;12.08.2015;2015;08;07;Keskiviikko;23;5;28
94;12.08.2015;2015;08;08;Keskiviikko;12;7;19
94;12.08.2015;2015;08;09;Keskiviikko;20;3;23
94;12.08.2015;2015;08;10;Keskiviikko;4;3;7
94;12.08.2015;2015;08;11;Keskiviikko;1;7;8
94;12.08.2015;2015;08;12;Keskiviikko;5;6;11
94;12.08.2015;2015;08;13;Keskiviikko;9;9;18
94;12.08.2015;2015;08;14;Keskiviikko;7;13;20
94;12.08.2015;2015;08;15;Keskiviikko;7;17;24
94;12.08.2015;2015;08;16;Keskiviikko;8;47;55
94;12.08.2015;2015;08;17;Keskiviikko;8;22;30
94;12.08.2015;2015;08;18;Keskiviikko;9;16;25
94;12.08.2015;2015;08;19;Keskiviikko;14;15;29
94;12.08.2015;2015;08;20;Keskiviikko;4;10;14
94;12.08.2015;2015;08;21;Keskiviikko;6;7;13
94;12.08.2015;2015;08;22;Keskiviikko;2;2;4
94;12.08.2015;2015;08;23;Keskiviikko;0;0;0
94;13.08.2015;2015;08;00;Torstai;0;1;1
94;13.08.2015;2015;08;01;Torstai;0;0;0
94;13.08.2015;2015;08;02;Torstai;0;0;0
94;13.08.2015;2015;08;03;Torstai;0;0;0
94;13.08.2015;2015;08;04;Torstai;0;1;1
94;13.08.2015;2015;08;05;Torstai;13;0;13
94;13.08.2015;2015;08;06;Torstai;26;4;30
94;13.08.2015;2015;08;07;Torstai;42;9;51
94;13.08.2015;2015;08;08;Torstai;19;5;24
94;13.08.2015;2015;08;09;Torstai;13;10;23
94;13.08.2015;2015;08;10;Torstai;11;3;14
94;13.08.2015;2015;08;11;Torstai;6;9;15
94;13.08.2015;2015;08;12;Torstai;6;6;12
94;13.08.2015;2015;08;13;Torstai;9;5;14
94;13.08.2015;2015;08;14;Torstai;13;17;30
94;13.08.2015;2015;08;15;Torstai;6;33;39
94;13.08.2015;2015;08;16;Torstai;23;45;68
94;13.08.2015;2015;08;17;Torstai;9;27;36
94;13.08.2015;2015;08;18;Torstai;10;10;20
94;13.08.2015;2015;08;19;Torstai;14;7;21
94;13.08.2015;2015;08;20;Torstai;10;4;14
94;13.08.2015;2015;08;21;Torstai;5;12;17
94;13.08.2015;2015;08;22;Torstai;0;6;6
94;13.08.2015;2015;08;23;Torstai;0;3;3
94;14.08.2015;2015;08;00;Perjantai;0;0;0
94;14.08.2015;2015;08;01;Perjantai;0;0;0
94;14.08.2015;2015;08;02;Perjantai;0;0;0
94;14.08.2015;2015;08;03;Perjantai;0;0;0
94;14.08.2015;2015;08;04;Perjantai;1;0;1
94;14.08.2015;2015;08;05;Perjantai;3;0;3
94;14.08.2015;2015;08;06;Perjantai;25;2;27
94;14.08.2015;2015;08;07;Perjantai;23;4;27
94;14.08.2015;2015;08;08;Perjantai;15;5;20
94;14.08.2015;2015;08;09;Perjantai;12;7;19
94;14.08.2015;2015;08;10;Perjantai;5;3;8
94;14.08.2015;2015;08;11;Perjantai;6;5;11
94;14.08.2015;2015;08;12;Perjantai;15;11;26
94;14.08.2015;2015;08;13;Perjantai;4;7;11
94;14.08.2015;2015;08;14;Perjantai;16;23;39
94;14.08.2015;2015;08;15;Perjantai;12;27;39
94;14.08.2015;2015;08;16;Perjantai;11;26;37
94;14.08.2015;2015;08;17;Perjantai;9;19;28
94;14.08.2015;2015;08;18;Perjantai;5;21;26
94;14.08.2015;2015;08;19;Perjantai;8;13;21
94;14.08.2015;2015;08;20;Perjantai;9;7;16
94;14.08.2015;2015;08;21;Perjantai;4;6;10
94;14.08.2015;2015;08;22;Perjantai;0;2;2
94;14.08.2015;2015;08;23;Perjantai;2;3;5
94;15.08.2015;2015;08;00;Lauantai;1;0;1
94;15.08.2015;2015;08;01;Lauantai;0;0;0
94;15.08.2015;2015;08;02;Lauantai;0;0;0
94;15.08.2015;2015;08;03;Lauantai;0;1;1
94;15.08.2015;2015;08;04;Lauantai;0;1;1
94;15.08.2015;2015;08;05;Lauantai;0;0;0
94;15.08.2015;2015;08;06;Lauantai;2;0;2
94;15.08.2015;2015;08;07;Lauantai;2;1;3
94;15.08.2015;2015;08;08;Lauantai;5;4;9
94;15.08.2015;2015;08;09;Lauantai;7;8;15
94;15.08.2015;2015;08;10;Lauantai;8;5;13
94;15.08.2015;2015;08;11;Lauantai;5;13;18
94;15.08.2015;2015;08;12;Lauantai;7;7;14
94;15.08.2015;2015;08;13;Lauantai;13;8;21
94;15.08.2015;2015;08;14;Lauantai;13;20;33
94;15.08.2015;2015;08;15;Lauantai;15;12;27
94;15.08.2015;2015;08;16;Lauantai;10;16;26
94;15.08.2015;2015;08;17;Lauantai;15;13;28
94;15.08.2015;2015;08;18;Lauantai;19;12;31
94;15.08.2015;2015;08;19;Lauantai;10;10;20
94;15.08.2015;2015;08;20;Lauantai;4;7;11
94;15.08.2015;2015;08;21;Lauantai;0;2;2
94;15.08.2015;2015;08;22;Lauantai;5;8;13
94;15.08.2015;2015;08;23;Lauantai;2;4;6
94;16.08.2015;2015;08;00;Sunnuntai;2;1;3
94;16.08.2015;2015;08;01;Sunnuntai;2;0;2
94;16.08.2015;2015;08;02;Sunnuntai;4;3;7
94;16.08.2015;2015;08;03;Sunnuntai;0;0;0
94;16.08.2015;2015;08;04;Sunnuntai;0;1;1
94;16.08.2015;2015;08;05;Sunnuntai;0;1;1
94;16.08.2015;2015;08;06;Sunnuntai;1;0;1
94;16.08.2015;2015;08;07;Sunnuntai;3;1;4
94;16.08.2015;2015;08;08;Sunnuntai;1;3;4
94;16.08.2015;2015;08;09;Sunnuntai;3;8;11
94;16.08.2015;2015;08;10;Sunnuntai;6;23;29
94;16.08.2015;2015;08;11;Sunnuntai;18;15;33
94;16.08.2015;2015;08;12;Sunnuntai;23;6;29
94;16.08.2015;2015;08;13;Sunnuntai;20;17;37
94;16.08.2015;2015;08;14;Sunnuntai;21;12;33
94;16.08.2015;2015;08;15;Sunnuntai;21;9;30
94;16.08.2015;2015;08;16;Sunnuntai;13;16;29
94;16.08.2015;2015;08;17;Sunnuntai;15;29;44
94;16.08.2015;2015;08;18;Sunnuntai;18;17;35
94;16.08.2015;2015;08;19;Sunnuntai;14;15;29
94;16.08.2015;2015;08;20;Sunnuntai;10;2;12
94;16.08.2015;2015;08;21;Sunnuntai;4;6;10
94;16.08.2015;2015;08;22;Sunnuntai;3;3;6
94;16.08.2015;2015;08;23;Sunnuntai;0;0;0
94;17.08.2015;2015;08;00;Maanantai;0;0;0
94;17.08.2015;2015;08;01;Maanantai;0;0;0
94;17.08.2015;2015;08;02;Maanantai;0;0;0
94;17.08.2015;2015;08;03;Maanantai;0;0;0
94;17.08.2015;2015;08;04;Maanantai;0;1;1
94;17.08.2015;2015;08;05;Maanantai;8;1;9
94;17.08.2015;2015;08;06;Maanantai;20;2;22
94;17.08.2015;2015;08;07;Maanantai;39;4;43
94;17.08.2015;2015;08;08;Maanantai;16;8;24
94;17.08.2015;2015;08;09;Maanantai;10;1;11
94;17.08.2015;2015;08;10;Maanantai;9;3;12
94;17.08.2015;2015;08;11;Maanantai;11;4;15
94;17.08.2015;2015;08;12;Maanantai;3;4;7
94;17.08.2015;2015;08;13;Maanantai;12;12;24
94;17.08.2015;2015;08;14;Maanantai;14;15;29
94;17.08.2015;2015;08;15;Maanantai;7;33;40
94;17.08.2015;2015;08;16;Maanantai;11;49;60
94;17.08.2015;2015;08;17;Maanantai;10;23;33
94;17.08.2015;2015;08;18;Maanantai;14;17;31
94;17.08.2015;2015;08;19;Maanantai;12;17;29
94;17.08.2015;2015;08;20;Maanantai;9;11;20
94;17.08.2015;2015;08;21;Maanantai;8;5;13
94;17.08.2015;2015;08;22;Maanantai;0;5;5
94;17.08.2015;2015;08;23;Maanantai;0;1;1
94;18.08.2015;2015;08;00;Tiistai;0;0;0
94;18.08.2015;2015;08;01;Tiistai;0;0;0
94;18.08.2015;2015;08;02;Tiistai;0;0;0
94;18.08.2015;2015;08;03;Tiistai;0;0;0
94;18.08.2015;2015;08;04;Tiistai;0;0;0
94;18.08.2015;2015;08;05;Tiistai;7;1;8
94;18.08.2015;2015;08;06;Tiistai;30;3;33
94;18.08.2015;2015;08;07;Tiistai;42;7;49
94;18.08.2015;2015;08;08;Tiistai;14;7;21
94;18.08.2015;2015;08;09;Tiistai;10;3;13
94;18.08.2015;2015;08;10;Tiistai;14;7;21
94;18.08.2015;2015;08;11;Tiistai;9;9;18
94;18.08.2015;2015;08;12;Tiistai;6;7;13
94;18.08.2015;2015;08;13;Tiistai;7;9;16
94;18.08.2015;2015;08;14;Tiistai;9;13;22
94;18.08.2015;2015;08;15;Tiistai;12;34;46
94;18.08.2015;2015;08;16;Tiistai;14;59;73
94;18.08.2015;2015;08;17;Tiistai;11;19;30
94;18.08.2015;2015;08;18;Tiistai;16;28;44
94;18.08.2015;2015;08;19;Tiistai;30;22;52
94;18.08.2015;2015;08;20;Tiistai;10;8;18
94;18.08.2015;2015;08;21;Tiistai;1;8;9
94;18.08.2015;2015;08;22;Tiistai;0;6;6
94;18.08.2015;2015;08;23;Tiistai;1;0;1
94;19.08.2015;2015;08;00;Keskiviikko;0;1;1
94;19.08.2015;2015;08;01;Keskiviikko;0;0;0
94;19.08.2015;2015;08;02;Keskiviikko;0;0;0
94;19.08.2015;2015;08;03;Keskiviikko;0;0;0
94;19.08.2015;2015;08;04;Keskiviikko;0;0;0
94;19.08.2015;2015;08;05;Keskiviikko;8;1;9
94;19.08.2015;2015;08;06;Keskiviikko;31;2;33
94;19.08.2015;2015;08;07;Keskiviikko;39;5;44
94;19.08.2015;2015;08;08;Keskiviikko;19;5;24
94;19.08.2015;2015;08;09;Keskiviikko;7;5;12
94;19.08.2015;2015;08;10;Keskiviikko;8;7;15
94;19.08.2015;2015;08;11;Keskiviikko;10;8;18
94;19.08.2015;2015;08;12;Keskiviikko;5;6;11
94;19.08.2015;2015;08;13;Keskiviikko;13;8;21
94;19.08.2015;2015;08;14;Keskiviikko;12;14;26
94;19.08.2015;2015;08;15;Keskiviikko;3;40;43
94;19.08.2015;2015;08;16;Keskiviikko;10;52;62
94;19.08.2015;2015;08;17;Keskiviikko;8;21;29
94;19.08.2015;2015;08;18;Keskiviikko;20;12;32
94;19.08.2015;2015;08;19;Keskiviikko;21;19;40
94;19.08.2015;2015;08;20;Keskiviikko;12;9;21
94;19.08.2015;2015;08;21;Keskiviikko;4;10;14
94;19.08.2015;2015;08;22;Keskiviikko;0;2;2
94;19.08.2015;2015;08;23;Keskiviikko;0;0;0
94;20.08.2015;2015;08;00;Torstai;0;0;0
94;20.08.2015;2015;08;01;Torstai;0;0;0
94;20.08.2015;2015;08;02;Torstai;0;0;0
94;20.08.2015;2015;08;03;Torstai;0;0;0
94;20.08.2015;2015;08;04;Torstai;0;0;0
94;20.08.2015;2015;08;05;Torstai;9;1;10
94;20.08.2015;2015;08;06;Torstai;24;2;26
94;20.08.2015;2015;08;07;Torstai;33;4;37
94;20.08.2015;2015;08;08;Torstai;9;9;18
94;20.08.2015;2015;08;09;Torstai;11;4;15
94;20.08.2015;2015;08;10;Torstai;9;8;17
94;20.08.2015;2015;08;11;Torstai;7;6;13
94;20.08.2015;2015;08;12;Torstai;4;9;13
94;20.08.2015;2015;08;13;Torstai;10;11;21
94;20.08.2015;2015;08;14;Torstai;11;11;22
94;20.08.2015;2015;08;15;Torstai;20;31;51
94;20.08.2015;2015;08;16;Torstai;12;44;56
94;20.08.2015;2015;08;17;Torstai;12;21;33
94;20.08.2015;2015;08;18;Torstai;15;7;22
94;20.08.2015;2015;08;19;Torstai;10;15;25
94;20.08.2015;2015;08;20;Torstai;4;9;13
94;20.08.2015;2015;08;21;Torstai;4;11;15
94;20.08.2015;2015;08;22;Torstai;1;8;9
94;20.08.2015;2015;08;23;Torstai;0;0;0
94;21.08.2015;2015;08;00;Perjantai;0;0;0
94;21.08.2015;2015;08;01;Perjantai;0;1;1
94;21.08.2015;2015;08;02;Perjantai;0;0;0
94;21.08.2015;2015;08;03;Perjantai;0;1;1
94;21.08.2015;2015;08;04;Perjantai;0;0;0
94;21.08.2015;2015;08;05;Perjantai;10;1;11
94;21.08.2015;2015;08;06;Perjantai;17;2;19
94;21.08.2015;2015;08;07;Perjantai;32;4;36
94;21.08.2015;2015;08;08;Perjantai;14;8;22
94;21.08.2015;2015;08;09;Perjantai;8;5;13
94;21.08.2015;2015;08;10;Perjantai;11;3;14
94;21.08.2015;2015;08;11;Perjantai;4;7;11
94;21.08.2015;2015;08;12;Perjantai;4;7;11
94;21.08.2015;2015;08;13;Perjantai;8;14;22
94;21.08.2015;2015;08;14;Perjantai;15;16;31
94;21.08.2015;2015;08;15;Perjantai;5;45;50
94;21.08.2015;2015;08;16;Perjantai;8;27;35
94;21.08.2015;2015;08;17;Perjantai;9;25;34
94;21.08.2015;2015;08;18;Perjantai;11;14;25
94;21.08.2015;2015;08;19;Perjantai;11;9;20
94;21.08.2015;2015;08;20;Perjantai;4;8;12
94;21.08.2015;2015;08;21;Perjantai;7;2;9
94;21.08.2015;2015;08;22;Perjantai;1;0;1
94;21.08.2015;2015;08;23;Perjantai;0;0;0
94;22.08.2015;2015;08;00;Lauantai;1;1;2
94;22.08.2015;2015;08;01;Lauantai;0;1;1
94;22.08.2015;2015;08;02;Lauantai;0;2;2
94;22.08.2015;2015;08;03;Lauantai;0;0;0
94;22.08.2015;2015;08;04;Lauantai;0;1;1
94;22.08.2015;2015;08;05;Lauantai;3;0;3
94;22.08.2015;2015;08;06;Lauantai;1;0;1
94;22.08.2015;2015;08;07;Lauantai;1;3;4
94;22.08.2015;2015;08;08;Lauantai;4;0;4
94;22.08.2015;2015;08;09;Lauantai;6;5;11
94;22.08.2015;2015;08;10;Lauantai;9;6;15
94;22.08.2015;2015;08;11;Lauantai;11;15;26
94;22.08.2015;2015;08;12;Lauantai;11;9;20
94;22.08.2015;2015;08;13;Lauantai;10;14;24
94;22.08.2015;2015;08;14;Lauantai;10;29;39
94;22.08.2015;2015;08;15;Lauantai;5;19;24
94;22.08.2015;2015;08;16;Lauantai;15;10;25
94;22.08.2015;2015;08;17;Lauantai;21;14;35
94;22.08.2015;2015;08;18;Lauantai;22;9;31
94;22.08.2015;2015;08;19;Lauantai;11;14;25
94;22.08.2015;2015;08;20;Lauantai;13;3;16
94;22.08.2015;2015;08;21;Lauantai;10;5;15
94;22.08.2015;2015;08;22;Lauantai;3;10;13
94;22.08.2015;2015;08;23;Lauantai;4;3;7
94;23.08.2015;2015;08;00;Sunnuntai;0;2;2
94;23.08.2015;2015;08;01;Sunnuntai;1;0;1
94;23.08.2015;2015;08;02;Sunnuntai;0;1;1
94;23.08.2015;2015;08;03;Sunnuntai;0;0;0
94;23.08.2015;2015;08;04;Sunnuntai;0;2;2
94;23.08.2015;2015;08;05;Sunnuntai;1;0;1
94;23.08.2015;2015;08;06;Sunnuntai;0;0;0
94;23.08.2015;2015;08;07;Sunnuntai;2;0;2
94;23.08.2015;2015;08;08;Sunnuntai;3;4;7
94;23.08.2015;2015;08;09;Sunnuntai;5;11;16
94;23.08.2015;2015;08;10;Sunnuntai;12;8;20
94;23.08.2015;2015;08;11;Sunnuntai;8;18;26
94;23.08.2015;2015;08;12;Sunnuntai;26;17;43
94;23.08.2015;2015;08;13;Sunnuntai;19;13;32
94;23.08.2015;2015;08;14;Sunnuntai;15;30;45
94;23.08.2015;2015;08;15;Sunnuntai;17;12;29
94;23.08.2015;2015;08;16;Sunnuntai;11;17;28
94;23.08.2015;2015;08;17;Sunnuntai;13;9;22
94;23.08.2015;2015;08;18;Sunnuntai;15;15;30
94;23.08.2015;2015;08;19;Sunnuntai;19;8;27
94;23.08.2015;2015;08;20;Sunnuntai;17;8;25
94;23.08.2015;2015;08;21;Sunnuntai;7;5;12
94;23.08.2015;2015;08;22;Sunnuntai;2;1;3
94;23.08.2015;2015;08;23;Sunnuntai;4;0;4
94;24.08.2015;2015;08;00;Maanantai;0;0;0
94;24.08.2015;2015;08;01;Maanantai;0;0;0
94;24.08.2015;2015;08;02;Maanantai;0;0;0
94;24.08.2015;2015;08;03;Maanantai;0;0;0
94;24.08.2015;2015;08;04;Maanantai;0;0;0
94;24.08.2015;2015;08;05;Maanantai;5;2;7
94;24.08.2015;2015;08;06;Maanantai;31;4;35
94;24.08.2015;2015;08;07;Maanantai;36;2;38
94;24.08.2015;2015;08;08;Maanantai;22;7;29
94;24.08.2015;2015;08;09;Maanantai;6;1;7
94;24.08.2015;2015;08;10;Maanantai;7;3;10
94;24.08.2015;2015;08;11;Maanantai;8;1;9
94;24.08.2015;2015;08;12;Maanantai;6;8;14
94;24.08.2015;2015;08;13;Maanantai;9;7;16
94;24.08.2015;2015;08;14;Maanantai;13;11;24
94;24.08.2015;2015;08;15;Maanantai;12;25;37
94;24.08.2015;2015;08;16;Maanantai;9;60;69
94;24.08.2015;2015;08;17;Maanantai;8;25;33
94;24.08.2015;2015;08;18;Maanantai;16;9;25
94;24.08.2015;2015;08;19;Maanantai;10;15;25
94;24.08.2015;2015;08;20;Maanantai;7;11;18
94;24.08.2015;2015;08;21;Maanantai;4;7;11
94;24.08.2015;2015;08;22;Maanantai;1;5;6
94;24.08.2015;2015;08;23;Maanantai;0;0;0
94;25.08.2015;2015;08;00;Tiistai;0;0;0
94;25.08.2015;2015;08;01;Tiistai;0;0;0
94;25.08.2015;2015;08;02;Tiistai;0;0;0
94;25.08.2015;2015;08;03;Tiistai;0;0;0
94;25.08.2015;2015;08;04;Tiistai;1;0;1
94;25.08.2015;2015;08;05;Tiistai;7;1;8
94;25.08.2015;2015;08;06;Tiistai;28;1;29
94;25.08.2015;2015;08;07;Tiistai;40;5;45
94;25.08.2015;2015;08;08;Tiistai;11;6;17
94;25.08.2015;2015;08;09;Tiistai;12;5;17
94;25.08.2015;2015;08;10;Tiistai;12;9;21
94;25.08.2015;2015;08;11;Tiistai;10;5;15
94;25.08.2015;2015;08;12;Tiistai;4;10;14
94;25.08.2015;2015;08;13;Tiistai;10;7;17
94;25.08.2015;2015;08;14;Tiistai;2;12;14
94;25.08.2015;2015;08;15;Tiistai;8;32;40
94;25.08.2015;2015;08;16;Tiistai;21;57;78
94;25.08.2015;2015;08;17;Tiistai;11;24;35
94;25.08.2015;2015;08;18;Tiistai;13;22;35
94;25.08.2015;2015;08;19;Tiistai;10;11;21
94;25.08.2015;2015;08;20;Tiistai;14;9;23
94;25.08.2015;2015;08;21;Tiistai;1;4;5
94;25.08.2015;2015;08;22;Tiistai;0;4;4
94;25.08.2015;2015;08;23;Tiistai;1;1;2
94;26.08.2015;2015;08;00;Keskiviikko;1;0;1
94;26.08.2015;2015;08;01;Keskiviikko;0;0;0
94;26.08.2015;2015;08;02;Keskiviikko;1;0;1
94;26.08.2015;2015;08;03;Keskiviikko;1;0;1
94;26.08.2015;2015;08;04;Keskiviikko;0;0;0
94;26.08.2015;2015;08;05;Keskiviikko;8;2;10
94;26.08.2015;2015;08;06;Keskiviikko;34;1;35
94;26.08.2015;2015;08;07;Keskiviikko;30;4;34
94;26.08.2015;2015;08;08;Keskiviikko;24;6;30
94;26.08.2015;2015;08;09;Keskiviikko;6;6;12
94;26.08.2015;2015;08;10;Keskiviikko;11;4;15
94;26.08.2015;2015;08;11;Keskiviikko;10;6;16
94;26.08.2015;2015;08;12;Keskiviikko;5;6;11
94;26.08.2015;2015;08;13;Keskiviikko;8;14;22
94;26.08.2015;2015;08;14;Keskiviikko;4;9;13
94;26.08.2015;2015;08;15;Keskiviikko;8;18;26
94;26.08.2015;2015;08;16;Keskiviikko;10;59;69
94;26.08.2015;2015;08;17;Keskiviikko;5;21;26
94;26.08.2015;2015;08;18;Keskiviikko;9;16;25
94;26.08.2015;2015;08;19;Keskiviikko;12;11;23
94;26.08.2015;2015;08;20;Keskiviikko;10;10;20
94;26.08.2015;2015;08;21;Keskiviikko;6;11;17
94;26.08.2015;2015;08;22;Keskiviikko;2;3;5
94;26.08.2015;2015;08;23;Keskiviikko;0;0;0
94;27.08.2015;2015;08;00;Torstai;0;1;1
94;27.08.2015;2015;08;01;Torstai;0;0;0
94;27.08.2015;2015;08;02;Torstai;0;0;0
94;27.08.2015;2015;08;03;Torstai;0;0;0
94;27.08.2015;2015;08;04;Torstai;1;0;1
94;27.08.2015;2015;08;05;Torstai;7;2;9
94;27.08.2015;2015;08;06;Torstai;13;0;13
94;27.08.2015;2015;08;07;Torstai;23;7;30
94;27.08.2015;2015;08;08;Torstai;9;3;12
94;27.08.2015;2015;08;09;Torstai;4;2;6
94;27.08.2015;2015;08;10;Torstai;5;2;7
94;27.08.2015;2015;08;11;Torstai;6;6;12
94;27.08.2015;2015;08;12;Torstai;5;1;6
94;27.08.2015;2015;08;13;Torstai;13;9;22
94;27.08.2015;2015;08;14;Torstai;5;6;11
94;27.08.2015;2015;08;15;Torstai;3;21;24
94;27.08.2015;2015;08;16;Torstai;6;34;40
94;27.08.2015;2015;08;17;Torstai;9;18;27
94;27.08.2015;2015;08;18;Torstai;5;8;13
94;27.08.2015;2015;08;19;Torstai;5;5;10
94;27.08.2015;2015;08;20;Torstai;5;8;13
94;27.08.2015;2015;08;21;Torstai;1;4;5
94;27.08.2015;2015;08;22;Torstai;0;4;4
94;27.08.2015;2015;08;23;Torstai;0;0;0
94;28.08.2015;2015;08;00;Perjantai;0;0;0
94;28.08.2015;2015;08;01;Perjantai;0;0;0
94;28.08.2015;2015;08;02;Perjantai;0;0;0
94;28.08.2015;2015;08;03;Perjantai;0;0;0
94;28.08.2015;2015;08;04;Perjantai;0;0;0
94;28.08.2015;2015;08;05;Perjantai;8;1;9
94;28.08.2015;2015;08;06;Perjantai;13;0;13
94;28.08.2015;2015;08;07;Perjantai;9;1;10
94;28.08.2015;2015;08;08;Perjantai;9;4;13
94;28.08.2015;2015;08;09;Perjantai;1;3;4
94;28.08.2015;2015;08;10;Perjantai;0;1;1
94;28.08.2015;2015;08;11;Perjantai;2;0;2
94;28.08.2015;2015;08;12;Perjantai;0;1;1
94;28.08.2015;2015;08;13;Perjantai;3;3;6
94;28.08.2015;2015;08;14;Perjantai;2;4;6
94;28.08.2015;2015;08;15;Perjantai;1;10;11
94;28.08.2015;2015;08;16;Perjantai;7;14;21
94;28.08.2015;2015;08;17;Perjantai;4;8;12
94;28.08.2015;2015;08;18;Perjantai;0;2;2
94;28.08.2015;2015;08;19;Perjantai;1;0;1
94;28.08.2015;2015;08;20;Perjantai;0;3;3
94;28.08.2015;2015;08;21;Perjantai;1;1;2
94;28.08.2015;2015;08;22;Perjantai;0;1;1
94;28.08.2015;2015;08;23;Perjantai;1;1;2
94;29.08.2015;2015;08;00;Lauantai;1;1;2
94;29.08.2015;2015;08;01;Lauantai;0;0;0
94;29.08.2015;2015;08;02;Lauantai;1;0;1
94;29.08.2015;2015;08;03;Lauantai;0;0;0
94;29.08.2015;2015;08;04;Lauantai;0;0;0
94;29.08.2015;2015;08;05;Lauantai;1;0;1
94;29.08.2015;2015;08;06;Lauantai;2;0;2
94;29.08.2015;2015;08;07;Lauantai;2;3;5
94;29.08.2015;2015;08;08;Lauantai;2;3;5
94;29.08.2015;2015;08;09;Lauantai;2;2;4
94;29.08.2015;2015;08;10;Lauantai;5;7;12
94;29.08.2015;2015;08;11;Lauantai;6;2;8
94;29.08.2015;2015;08;12;Lauantai;10;6;16
94;29.08.2015;2015;08;13;Lauantai;10;6;16
94;29.08.2015;2015;08;14;Lauantai;7;13;20
94;29.08.2015;2015;08;15;Lauantai;11;9;20
94;29.08.2015;2015;08;16;Lauantai;15;6;21
94;29.08.2015;2015;08;17;Lauantai;6;14;20
94;29.08.2015;2015;08;18;Lauantai;9;9;18
94;29.08.2015;2015;08;19;Lauantai;9;3;12
94;29.08.2015;2015;08;20;Lauantai;5;5;10
94;29.08.2015;2015;08;21;Lauantai;1;10;11
94;29.08.2015;2015;08;22;Lauantai;0;3;3
94;29.08.2015;2015;08;23;Lauantai;2;2;4
94;30.08.2015;2015;08;00;Sunnuntai;0;1;1
94;30.08.2015;2015;08;01;Sunnuntai;0;0;0
94;30.08.2015;2015;08;02;Sunnuntai;0;0;0
94;30.08.2015;2015;08;03;Sunnuntai;1;0;1
94;30.08.2015;2015;08;04;Sunnuntai;0;1;1
94;30.08.2015;2015;08;05;Sunnuntai;1;1;2
94;30.08.2015;2015;08;06;Sunnuntai;1;0;1
94;30.08.2015;2015;08;07;Sunnuntai;0;3;3
94;30.08.2015;2015;08;08;Sunnuntai;5;2;7
94;30.08.2015;2015;08;09;Sunnuntai;1;11;12
94;30.08.2015;2015;08;10;Sunnuntai;17;6;23
94;30.08.2015;2015;08;11;Sunnuntai;16;7;23
94;30.08.2015;2015;08;12;Sunnuntai;10;13;23
94;30.08.2015;2015;08;13;Sunnuntai;12;14;26
94;30.08.2015;2015;08;14;Sunnuntai;12;15;27
94;30.08.2015;2015;08;15;Sunnuntai;8;13;21
94;30.08.2015;2015;08;16;Sunnuntai;17;8;25
94;30.08.2015;2015;08;17;Sunnuntai;15;10;25
94;30.08.2015;2015;08;18;Sunnuntai;13;19;32
94;30.08.2015;2015;08;19;Sunnuntai;6;6;12
94;30.08.2015;2015;08;20;Sunnuntai;6;8;14
94;30.08.2015;2015;08;21;Sunnuntai;2;4;6
94;30.08.2015;2015;08;22;Sunnuntai;1;2;3
94;30.08.2015;2015;08;23;Sunnuntai;0;0;0
94;31.08.2015;2015;08;00;Maanantai;0;0;0
94;31.08.2015;2015;08;01;Maanantai;0;0;0
94;31.08.2015;2015;08;02;Maanantai;0;0;0
94;31.08.2015;2015;08;03;Maanantai;0;0;0
94;31.08.2015;2015;08;04;Maanantai;1;1;2
94;31.08.2015;2015;08;05;Maanantai;10;0;10
94;31.08.2015;2015;08;06;Maanantai;20;1;21
94;31.08.2015;2015;08;07;Maanantai;33;7;40
94;31.08.2015;2015;08;08;Maanantai;10;4;14
94;31.08.2015;2015;08;09;Maanantai;6;4;10
94;31.08.2015;2015;08;10;Maanantai;9;2;11
94;31.08.2015;2015;08;11;Maanantai;5;1;6
94;31.08.2015;2015;08;12;Maanantai;4;6;10
94;31.08.2015;2015;08;13;Maanantai;11;9;20
94;31.08.2015;2015;08;14;Maanantai;9;15;24
94;31.08.2015;2015;08;15;Maanantai;13;18;31
94;31.08.2015;2015;08;16;Maanantai;10;42;52
94;31.08.2015;2015;08;17;Maanantai;9;17;26
94;31.08.2015;2015;08;18;Maanantai;12;8;20
94;31.08.2015;2015;08;19;Maanantai;6;4;10
94;31.08.2015;2015;08;20;Maanantai;5;6;11
94;31.08.2015;2015;08;21;Maanantai;0;1;1
94;31.08.2015;2015;08;22;Maanantai;0;4;4
94;31.08.2015;2015;08;23;Maanantai;0;0;0
94;01.09.2015;2015;09;00;Tiistai;0;0;0
94;01.09.2015;2015;09;01;Tiistai;0;0;0
94;01.09.2015;2015;09;02;Tiistai;0;0;0
94;01.09.2015;2015;09;03;Tiistai;0;0;0
94;01.09.2015;2015;09;04;Tiistai;0;0;0
94;01.09.2015;2015;09;05;Tiistai;8;2;10
94;01.09.2015;2015;09;06;Tiistai;24;1;25
94;01.09.2015;2015;09;07;Tiistai;31;3;34
94;01.09.2015;2015;09;08;Tiistai;12;5;17
94;01.09.2015;2015;09;09;Tiistai;9;8;17
94;01.09.2015;2015;09;10;Tiistai;3;3;6
94;01.09.2015;2015;09;11;Tiistai;6;6;12
94;01.09.2015;2015;09;12;Tiistai;5;3;8
94;01.09.2015;2015;09;13;Tiistai;4;9;13
94;01.09.2015;2015;09;14;Tiistai;4;15;19
94;01.09.2015;2015;09;15;Tiistai;13;25;38
94;01.09.2015;2015;09;16;Tiistai;8;35;43
94;01.09.2015;2015;09;17;Tiistai;3;20;23
94;01.09.2015;2015;09;18;Tiistai;9;11;20
94;01.09.2015;2015;09;19;Tiistai;8;7;15
94;01.09.2015;2015;09;20;Tiistai;4;4;8
94;01.09.2015;2015;09;21;Tiistai;2;3;5
94;01.09.2015;2015;09;22;Tiistai;1;3;4
94;01.09.2015;2015;09;23;Tiistai;1;0;1
94;02.09.2015;2015;09;00;Keskiviikko;0;0;0
94;02.09.2015;2015;09;01;Keskiviikko;0;0;0
94;02.09.2015;2015;09;02;Keskiviikko;0;0;0
94;02.09.2015;2015;09;03;Keskiviikko;0;0;0
94;02.09.2015;2015;09;04;Keskiviikko;0;0;0
94;02.09.2015;2015;09;05;Keskiviikko;8;1;9
94;02.09.2015;2015;09;06;Keskiviikko;18;1;19
94;02.09.2015;2015;09;07;Keskiviikko;28;3;31
94;02.09.2015;2015;09;08;Keskiviikko;16;6;22
94;02.09.2015;2015;09;09;Keskiviikko;5;2;7
94;02.09.2015;2015;09;10;Keskiviikko;5;5;10
94;02.09.2015;2015;09;11;Keskiviikko;2;2;4
94;02.09.2015;2015;09;12;Keskiviikko;3;8;11
94;02.09.2015;2015;09;13;Keskiviikko;5;6;11
94;02.09.2015;2015;09;14;Keskiviikko;5;10;15
94;02.09.2015;2015;09;15;Keskiviikko;6;23;29
94;02.09.2015;2015;09;16;Keskiviikko;7;40;47
94;02.09.2015;2015;09;17;Keskiviikko;8;22;30
94;02.09.2015;2015;09;18;Keskiviikko;7;6;13
94;02.09.2015;2015;09;19;Keskiviikko;5;18;23
94;02.09.2015;2015;09;20;Keskiviikko;6;3;9
94;02.09.2015;2015;09;21;Keskiviikko;8;1;9
94;02.09.2015;2015;09;22;Keskiviikko;0;2;2
94;02.09.2015;2015;09;23;Keskiviikko;0;0;0
94;03.09.2015;2015;09;00;Torstai;0;0;0
94;03.09.2015;2015;09;01;Torstai;0;0;0
94;03.09.2015;2015;09;02;Torstai;0;0;0
94;03.09.2015;2015;09;03;Torstai;0;0;0
94;03.09.2015;2015;09;04;Torstai;0;0;0
94;03.09.2015;2015;09;05;Torstai;5;2;7
94;03.09.2015;2015;09;06;Torstai;20;2;22
94;03.09.2015;2015;09;07;Torstai;28;2;30
94;03.09.2015;2015;09;08;Torstai;10;4;14
94;03.09.2015;2015;09;09;Torstai;6;2;8
94;03.09.2015;2015;09;10;Torstai;4;2;6
94;03.09.2015;2015;09;11;Torstai;5;6;11
94;03.09.2015;2015;09;12;Torstai;6;7;13
94;03.09.2015;2015;09;13;Torstai;7;5;12
94;03.09.2015;2015;09;14;Torstai;9;16;25
94;03.09.2015;2015;09;15;Torstai;9;19;28
94;03.09.2015;2015;09;16;Torstai;12;37;49
94;03.09.2015;2015;09;17;Torstai;0;20;20
94;03.09.2015;2015;09;18;Torstai;5;5;10
94;03.09.2015;2015;09;19;Torstai;7;6;13
94;03.09.2015;2015;09;20;Torstai;2;5;7
94;03.09.2015;2015;09;21;Torstai;8;0;8
94;03.09.2015;2015;09;22;Torstai;0;3;3
94;03.09.2015;2015;09;23;Torstai;0;0;0
94;04.09.2015;2015;09;00;Perjantai;0;0;0
94;04.09.2015;2015;09;01;Perjantai;0;0;0
94;04.09.2015;2015;09;02;Perjantai;0;0;0
94;04.09.2015;2015;09;03;Perjantai;0;0;0
94;04.09.2015;2015;09;04;Perjantai;0;0;0
94;04.09.2015;2015;09;05;Perjantai;6;1;7
94;04.09.2015;2015;09;06;Perjantai;13;3;16
94;04.09.2015;2015;09;07;Perjantai;23;3;26
94;04.09.2015;2015;09;08;Perjantai;12;4;16
94;04.09.2015;2015;09;09;Perjantai;2;5;7
94;04.09.2015;2015;09;10;Perjantai;9;3;12
94;04.09.2015;2015;09;11;Perjantai;2;6;8
94;04.09.2015;2015;09;12;Perjantai;6;6;12
94;04.09.2015;2015;09;13;Perjantai;9;11;20
94;04.09.2015;2015;09;14;Perjantai;10;15;25
94;04.09.2015;2015;09;15;Perjantai;5;20;25
94;04.09.2015;2015;09;16;Perjantai;5;28;33
94;04.09.2015;2015;09;17;Perjantai;2;12;14
94;04.09.2015;2015;09;18;Perjantai;9;13;22
94;04.09.2015;2015;09;19;Perjantai;7;4;11
94;04.09.2015;2015;09;20;Perjantai;1;4;5
94;04.09.2015;2015;09;21;Perjantai;3;5;8
94;04.09.2015;2015;09;22;Perjantai;0;3;3
94;04.09.2015;2015;09;23;Perjantai;0;0;0
94;05.09.2015;2015;09;00;Lauantai;1;0;1
94;05.09.2015;2015;09;01;Lauantai;1;0;1
94;05.09.2015;2015;09;02;Lauantai;0;0;0
94;05.09.2015;2015;09;03;Lauantai;0;0;0
94;05.09.2015;2015;09;04;Lauantai;3;0;3
94;05.09.2015;2015;09;05;Lauantai;0;0;0
94;05.09.2015;2015;09;06;Lauantai;0;1;1
94;05.09.2015;2015;09;07;Lauantai;3;1;4
94;05.09.2015;2015;09;08;Lauantai;2;5;7
94;05.09.2015;2015;09;09;Lauantai;5;3;8
94;05.09.2015;2015;09;10;Lauantai;6;7;13
94;05.09.2015;2015;09;11;Lauantai;2;2;4
94;05.09.2015;2015;09;12;Lauantai;10;6;16
94;05.09.2015;2015;09;13;Lauantai;3;5;8
94;05.09.2015;2015;09;14;Lauantai;4;5;9
94;05.09.2015;2015;09;15;Lauantai;8;11;19
94;05.09.2015;2015;09;16;Lauantai;5;6;11
94;05.09.2015;2015;09;17;Lauantai;7;3;10
94;05.09.2015;2015;09;18;Lauantai;2;7;9
94;05.09.2015;2015;09;19;Lauantai;6;5;11
94;05.09.2015;2015;09;20;Lauantai;3;3;6
94;05.09.2015;2015;09;21;Lauantai;1;7;8
94;05.09.2015;2015;09;22;Lauantai;0;1;1
94;05.09.2015;2015;09;23;Lauantai;1;0;1
94;06.09.2015;2015;09;00;Sunnuntai;0;0;0
94;06.09.2015;2015;09;01;Sunnuntai;2;1;3
94;06.09.2015;2015;09;02;Sunnuntai;0;1;1
94;06.09.2015;2015;09;03;Sunnuntai;0;0;0
94;06.09.2015;2015;09;04;Sunnuntai;2;0;2
94;06.09.2015;2015;09;05;Sunnuntai;0;0;0
94;06.09.2015;2015;09;06;Sunnuntai;1;1;2
94;06.09.2015;2015;09;07;Sunnuntai;0;1;1
94;06.09.2015;2015;09;08;Sunnuntai;0;3;3
94;06.09.2015;2015;09;09;Sunnuntai;5;0;5
94;06.09.2015;2015;09;10;Sunnuntai;2;3;5
94;06.09.2015;2015;09;11;Sunnuntai;4;1;5
94;06.09.2015;2015;09;12;Sunnuntai;0;2;2
94;06.09.2015;2015;09;13;Sunnuntai;3;2;5
94;06.09.2015;2015;09;14;Sunnuntai;0;3;3
94;06.09.2015;2015;09;15;Sunnuntai;2;3;5
94;06.09.2015;2015;09;16;Sunnuntai;1;2;3
94;06.09.2015;2015;09;17;Sunnuntai;0;0;0
94;06.09.2015;2015;09;18;Sunnuntai;2;1;3
94;06.09.2015;2015;09;19;Sunnuntai;3;1;4
94;06.09.2015;2015;09;20;Sunnuntai;0;0;0
94;06.09.2015;2015;09;21;Sunnuntai;2;3;5
94;06.09.2015;2015;09;22;Sunnuntai;0;0;0
94;06.09.2015;2015;09;23;Sunnuntai;0;0;0
94;07.09.2015;2015;09;00;Maanantai;0;0;0
94;07.09.2015;2015;09;01;Maanantai;0;0;0
94;07.09.2015;2015;09;02;Maanantai;0;0;0
94;07.09.2015;2015;09;03;Maanantai;0;0;0
94;07.09.2015;2015;09;04;Maanantai;0;0;0
94;07.09.2015;2015;09;05;Maanantai;8;0;8
94;07.09.2015;2015;09;06;Maanantai;15;1;16
94;07.09.2015;2015;09;07;Maanantai;20;7;27
94;07.09.2015;2015;09;08;Maanantai;4;7;11
94;07.09.2015;2015;09;09;Maanantai;5;0;5
94;07.09.2015;2015;09;10;Maanantai;0;1;1
94;07.09.2015;2015;09;11;Maanantai;3;2;5
94;07.09.2015;2015;09;12;Maanantai;2;2;4
94;07.09.2015;2015;09;13;Maanantai;5;1;6
94;07.09.2015;2015;09;14;Maanantai;2;4;6
94;07.09.2015;2015;09;15;Maanantai;8;17;25
94;07.09.2015;2015;09;16;Maanantai;6;25;31
94;07.09.2015;2015;09;17;Maanantai;8;17;25
94;07.09.2015;2015;09;18;Maanantai;5;6;11
94;07.09.2015;2015;09;19;Maanantai;7;7;14
94;07.09.2015;2015;09;20;Maanantai;5;1;6
94;07.09.2015;2015;09;21;Maanantai;1;4;5
94;07.09.2015;2015;09;22;Maanantai;0;4;4
94;07.09.2015;2015;09;23;Maanantai;0;0;0
94;08.09.2015;2015;09;00;Tiistai;0;0;0
94;08.09.2015;2015;09;01;Tiistai;0;0;0
94;08.09.2015;2015;09;02;Tiistai;0;0;0
94;08.09.2015;2015;09;03;Tiistai;0;0;0
94;08.09.2015;2015;09;04;Tiistai;0;0;0
94;08.09.2015;2015;09;05;Tiistai;5;0;5
94;08.09.2015;2015;09;06;Tiistai;18;1;19
94;08.09.2015;2015;09;07;Tiistai;25;0;25
94;08.09.2015;2015;09;08;Tiistai;6;7;13
94;08.09.2015;2015;09;09;Tiistai;5;2;7
94;08.09.2015;2015;09;10;Tiistai;12;4;16
94;08.09.2015;2015;09;11;Tiistai;1;4;5
94;08.09.2015;2015;09;12;Tiistai;10;3;13
94;08.09.2015;2015;09;13;Tiistai;7;2;9
94;08.09.2015;2015;09;14;Tiistai;5;5;10
94;08.09.2015;2015;09;15;Tiistai;5;23;28
94;08.09.2015;2015;09;16;Tiistai;12;32;44
94;08.09.2015;2015;09;17;Tiistai;5;17;22
94;08.09.2015;2015;09;18;Tiistai;11;11;22
94;08.09.2015;2015;09;19;Tiistai;2;4;6
94;08.09.2015;2015;09;20;Tiistai;2;9;11
94;08.09.2015;2015;09;21;Tiistai;6;4;10
94;08.09.2015;2015;09;22;Tiistai;1;3;4
94;08.09.2015;2015;09;23;Tiistai;0;0;0
94;09.09.2015;2015;09;00;Keskiviikko;1;0;1
94;09.09.2015;2015;09;01;Keskiviikko;0;0;0
94;09.09.2015;2015;09;02;Keskiviikko;0;0;0
94;09.09.2015;2015;09;03;Keskiviikko;0;0;0
94;09.09.2015;2015;09;04;Keskiviikko;0;0;0
94;09.09.2015;2015;09;05;Keskiviikko;6;1;7
94;09.09.2015;2015;09;06;Keskiviikko;19;3;22
94;09.09.2015;2015;09;07;Keskiviikko;24;2;26
94;09.09.2015;2015;09;08;Keskiviikko;11;4;15
94;09.09.2015;2015;09;09;Keskiviikko;4;5;9
94;09.09.2015;2015;09;10;Keskiviikko;3;0;3
94;09.09.2015;2015;09;11;Keskiviikko;3;5;8
94;09.09.2015;2015;09;12;Keskiviikko;3;6;9
94;09.09.2015;2015;09;13;Keskiviikko;7;4;11
94;09.09.2015;2015;09;14;Keskiviikko;5;7;12
94;09.09.2015;2015;09;15;Keskiviikko;5;25;30
94;09.09.2015;2015;09;16;Keskiviikko;8;25;33
94;09.09.2015;2015;09;17;Keskiviikko;8;25;33
94;09.09.2015;2015;09;18;Keskiviikko;5;12;17
94;09.09.2015;2015;09;19;Keskiviikko;8;9;17
94;09.09.2015;2015;09;20;Keskiviikko;7;5;12
94;09.09.2015;2015;09;21;Keskiviikko;3;4;7
94;09.09.2015;2015;09;22;Keskiviikko;0;1;1
94;09.09.2015;2015;09;23;Keskiviikko;1;0;1
94;10.09.2015;2015;09;00;Torstai;0;0;0
94;10.09.2015;2015;09;01;Torstai;0;0;0
94;10.09.2015;2015;09;02;Torstai;0;0;0
94;10.09.2015;2015;09;03;Torstai;0;0;0
94;10.09.2015;2015;09;04;Torstai;0;0;0
94;10.09.2015;2015;09;05;Torstai;8;1;9
94;10.09.2015;2015;09;06;Torstai;21;1;22
94;10.09.2015;2015;09;07;Torstai;21;3;24
94;10.09.2015;2015;09;08;Torstai;11;2;13
94;10.09.2015;2015;09;09;Torstai;8;2;10
94;10.09.2015;2015;09;10;Torstai;5;4;9
94;10.09.2015;2015;09;11;Torstai;10;3;13
94;10.09.2015;2015;09;12;Torstai;3;4;7
94;10.09.2015;2015;09;13;Torstai;5;4;9
94;10.09.2015;2015;09;14;Torstai;6;15;21
94;10.09.2015;2015;09;15;Torstai;7;20;27
94;10.09.2015;2015;09;16;Torstai;3;29;32
94;10.09.2015;2015;09;17;Torstai;8;16;24
94;10.09.2015;2015;09;18;Torstai;6;5;11
94;10.09.2015;2015;09;19;Torstai;15;10;25
94;10.09.2015;2015;09;20;Torstai;5;17;22
94;10.09.2015;2015;09;21;Torstai;5;4;9
94;10.09.2015;2015;09;22;Torstai;1;3;4
94;10.09.2015;2015;09;23;Torstai;0;1;1
94;11.09.2015;2015;09;00;Perjantai;0;0;0
94;11.09.2015;2015;09;01;Perjantai;0;0;0
94;11.09.2015;2015;09;02;Perjantai;0;0;0
94;11.09.2015;2015;09;03;Perjantai;0;0;0
94;11.09.2015;2015;09;04;Perjantai;0;0;0
94;11.09.2015;2015;09;05;Perjantai;6;1;7
94;11.09.2015;2015;09;06;Perjantai;17;2;19
94;11.09.2015;2015;09;07;Perjantai;20;4;24
94;11.09.2015;2015;09;08;Perjantai;11;4;15
94;11.09.2015;2015;09;09;Perjantai;3;3;6
94;11.09.2015;2015;09;10;Perjantai;5;3;8
94;11.09.2015;2015;09;11;Perjantai;5;5;10
94;11.09.2015;2015;09;12;Perjantai;3;7;10
94;11.09.2015;2015;09;13;Perjantai;7;6;13
94;11.09.2015;2015;09;14;Perjantai;10;12;22
94;11.09.2015;2015;09;15;Perjantai;7;19;26
94;11.09.2015;2015;09;16;Perjantai;7;28;35
94;11.09.2015;2015;09;17;Perjantai;0;4;4
94;11.09.2015;2015;09;18;Perjantai;7;4;11
94;11.09.2015;2015;09;19;Perjantai;5;5;10
94;11.09.2015;2015;09;20;Perjantai;8;1;9
94;11.09.2015;2015;09;21;Perjantai;1;4;5
94;11.09.2015;2015;09;22;Perjantai;1;1;2
94;11.09.2015;2015;09;23;Perjantai;1;1;2
94;12.09.2015;2015;09;00;Lauantai;0;4;4
94;12.09.2015;2015;09;01;Lauantai;4;1;5
94;12.09.2015;2015;09;02;Lauantai;1;0;1
94;12.09.2015;2015;09;03;Lauantai;0;0;0
94;12.09.2015;2015;09;04;Lauantai;1;0;1
94;12.09.2015;2015;09;05;Lauantai;1;1;2
94;12.09.2015;2015;09;06;Lauantai;1;2;3
94;12.09.2015;2015;09;07;Lauantai;1;0;1
94;12.09.2015;2015;09;08;Lauantai;1;0;1
94;12.09.2015;2015;09;09;Lauantai;6;2;8
94;12.09.2015;2015;09;10;Lauantai;5;4;9
94;12.09.2015;2015;09;11;Lauantai;12;8;20
94;12.09.2015;2015;09;12;Lauantai;10;8;18
94;12.09.2015;2015;09;13;Lauantai;23;3;26
94;12.09.2015;2015;09;14;Lauantai;10;18;28
94;12.09.2015;2015;09;15;Lauantai;16;12;28
94;12.09.2015;2015;09;16;Lauantai;12;21;33
94;12.09.2015;2015;09;17;Lauantai;4;10;14
94;12.09.2015;2015;09;18;Lauantai;6;14;20
94;12.09.2015;2015;09;19;Lauantai;10;5;15
94;12.09.2015;2015;09;20;Lauantai;2;4;6
94;12.09.2015;2015;09;21;Lauantai;0;3;3
94;12.09.2015;2015;09;22;Lauantai;1;3;4
94;12.09.2015;2015;09;23;Lauantai;0;1;1
94;13.09.2015;2015;09;00;Sunnuntai;0;0;0
94;13.09.2015;2015;09;01;Sunnuntai;1;0;1
94;13.09.2015;2015;09;02;Sunnuntai;1;0;1
94;13.09.2015;2015;09;03;Sunnuntai;0;0;0
94;13.09.2015;2015;09;04;Sunnuntai;0;1;1
94;13.09.2015;2015;09;05;Sunnuntai;0;0;0
94;13.09.2015;2015;09;06;Sunnuntai;0;0;0
94;13.09.2015;2015;09;07;Sunnuntai;0;2;2
94;13.09.2015;2015;09;08;Sunnuntai;0;0;0
94;13.09.2015;2015;09;09;Sunnuntai;2;1;3
94;13.09.2015;2015;09;10;Sunnuntai;4;6;10
94;13.09.2015;2015;09;11;Sunnuntai;10;9;19
94;13.09.2015;2015;09;12;Sunnuntai;8;13;21
94;13.09.2015;2015;09;13;Sunnuntai;11;19;30
94;13.09.2015;2015;09;14;Sunnuntai;16;6;22
94;13.09.2015;2015;09;15;Sunnuntai;10;15;25
94;13.09.2015;2015;09;16;Sunnuntai;33;18;51
94;13.09.2015;2015;09;17;Sunnuntai;8;9;17
94;13.09.2015;2015;09;18;Sunnuntai;8;7;15
94;13.09.2015;2015;09;19;Sunnuntai;8;5;13
94;13.09.2015;2015;09;20;Sunnuntai;5;3;8
94;13.09.2015;2015;09;21;Sunnuntai;1;2;3
94;13.09.2015;2015;09;22;Sunnuntai;0;1;1
94;13.09.2015;2015;09;23;Sunnuntai;1;0;1
94;14.09.2015;2015;09;00;Maanantai;0;1;1
94;14.09.2015;2015;09;01;Maanantai;0;0;0
94;14.09.2015;2015;09;02;Maanantai;0;0;0
94;14.09.2015;2015;09;03;Maanantai;0;0;0
94;14.09.2015;2015;09;04;Maanantai;1;0;1
94;14.09.2015;2015;09;05;Maanantai;8;1;9
94;14.09.2015;2015;09;06;Maanantai;17;1;18
94;14.09.2015;2015;09;07;Maanantai;24;5;29
94;14.09.2015;2015;09;08;Maanantai;9;3;12
94;14.09.2015;2015;09;09;Maanantai;3;2;5
94;14.09.2015;2015;09;10;Maanantai;4;1;5
94;14.09.2015;2015;09;11;Maanantai;3;2;5
94;14.09.2015;2015;09;12;Maanantai;1;5;6
94;14.09.2015;2015;09;13;Maanantai;3;2;5
94;14.09.2015;2015;09;14;Maanantai;7;14;21
94;14.09.2015;2015;09;15;Maanantai;7;22;29
94;14.09.2015;2015;09;16;Maanantai;5;34;39
94;14.09.2015;2015;09;17;Maanantai;9;11;20
94;14.09.2015;2015;09;18;Maanantai;9;8;17
94;14.09.2015;2015;09;19;Maanantai;4;6;10
94;14.09.2015;2015;09;20;Maanantai;3;6;9
94;14.09.2015;2015;09;21;Maanantai;0;1;1
94;14.09.2015;2015;09;22;Maanantai;0;3;3
94;14.09.2015;2015;09;23;Maanantai;0;0;0
94;15.09.2015;2015;09;00;Tiistai;0;0;0
94;15.09.2015;2015;09;01;Tiistai;0;0;0
94;15.09.2015;2015;09;02;Tiistai;0;0;0
94;15.09.2015;2015;09;03;Tiistai;0;0;0
94;15.09.2015;2015;09;04;Tiistai;2;0;2
94;15.09.2015;2015;09;05;Tiistai;8;1;9
94;15.09.2015;2015;09;06;Tiistai;21;1;22
94;15.09.2015;2015;09;07;Tiistai;29;7;36
94;15.09.2015;2015;09;08;Tiistai;12;4;16
94;15.09.2015;2015;09;09;Tiistai;3;1;4
94;15.09.2015;2015;09;10;Tiistai;8;0;8
94;15.09.2015;2015;09;11;Tiistai;8;4;12
94;15.09.2015;2015;09;12;Tiistai;4;3;7
94;15.09.2015;2015;09;13;Tiistai;3;2;5
94;15.09.2015;2015;09;14;Tiistai;5;8;13
94;15.09.2015;2015;09;15;Tiistai;9;32;41
94;15.09.2015;2015;09;16;Tiistai;9;34;43
94;15.09.2015;2015;09;17;Tiistai;7;18;25
94;15.09.2015;2015;09;18;Tiistai;10;6;16
94;15.09.2015;2015;09;19;Tiistai;3;10;13
94;15.09.2015;2015;09;20;Tiistai;3;9;12
94;15.09.2015;2015;09;21;Tiistai;1;5;6
94;15.09.2015;2015;09;22;Tiistai;1;6;7
94;15.09.2015;2015;09;23;Tiistai;5;0;5
94;16.09.2015;2015;09;00;Keskiviikko;0;0;0
94;16.09.2015;2015;09;01;Keskiviikko;0;0;0
94;16.09.2015;2015;09;02;Keskiviikko;0;0;0
94;16.09.2015;2015;09;03;Keskiviikko;0;0;0
94;16.09.2015;2015;09;04;Keskiviikko;0;0;0
94;16.09.2015;2015;09;05;Keskiviikko;9;0;9
94;16.09.2015;2015;09;06;Keskiviikko;14;0;14
94;16.09.2015;2015;09;07;Keskiviikko;19;6;25
94;16.09.2015;2015;09;08;Keskiviikko;12;2;14
94;16.09.2015;2015;09;09;Keskiviikko;3;2;5
94;16.09.2015;2015;09;10;Keskiviikko;3;0;3
94;16.09.2015;2015;09;11;Keskiviikko;1;2;3
94;16.09.2015;2015;09;12;Keskiviikko;3;3;6
94;16.09.2015;2015;09;13;Keskiviikko;1;2;3
94;16.09.2015;2015;09;14;Keskiviikko;4;4;8
94;16.09.2015;2015;09;15;Keskiviikko;4;19;23
94;16.09.2015;2015;09;16;Keskiviikko;10;17;27
94;16.09.2015;2015;09;17;Keskiviikko;7;18;25
94;16.09.2015;2015;09;18;Keskiviikko;1;7;8
94;16.09.2015;2015;09;19;Keskiviikko;4;7;11
94;16.09.2015;2015;09;20;Keskiviikko;2;2;4
94;16.09.2015;2015;09;21;Keskiviikko;0;7;7
94;16.09.2015;2015;09;22;Keskiviikko;0;1;1
94;16.09.2015;2015;09;23;Keskiviikko;0;1;1
94;17.09.2015;2015;09;00;Torstai;0;0;0
94;17.09.2015;2015;09;01;Torstai;0;0;0
94;17.09.2015;2015;09;02;Torstai;0;0;0
94;17.09.2015;2015;09;03;Torstai;0;0;0
94;17.09.2015;2015;09;04;Torstai;0;0;0
94;17.09.2015;2015;09;05;Torstai;5;2;7
94;17.09.2015;2015;09;06;Torstai;20;1;21
94;17.09.2015;2015;09;07;Torstai;19;4;23
94;17.09.2015;2015;09;08;Torstai;6;2;8
94;17.09.2015;2015;09;09;Torstai;7;5;12
94;17.09.2015;2015;09;10;Torstai;2;2;4
94;17.09.2015;2015;09;11;Torstai;3;0;3
94;17.09.2015;2015;09;12;Torstai;4;6;10
94;17.09.2015;2015;09;13;Torstai;4;10;14
94;17.09.2015;2015;09;14;Torstai;6;9;15
94;17.09.2015;2015;09;15;Torstai;8;22;30
94;17.09.2015;2015;09;16;Torstai;6;31;37
94;17.09.2015;2015;09;17;Torstai;6;12;18
94;17.09.2015;2015;09;18;Torstai;10;2;12
94;17.09.2015;2015;09;19;Torstai;4;8;12
94;17.09.2015;2015;09;20;Torstai;8;3;11
94;17.09.2015;2015;09;21;Torstai;1;6;7
94;17.09.2015;2015;09;22;Torstai;1;2;3
94;17.09.2015;2015;09;23;Torstai;0;1;1
94;18.09.2015;2015;09;00;Perjantai;0;0;0
94;18.09.2015;2015;09;01;Perjantai;0;0;0
94;18.09.2015;2015;09;02;Perjantai;0;0;0
94;18.09.2015;2015;09;03;Perjantai;0;0;0
94;18.09.2015;2015;09;04;Perjantai;0;1;1
94;18.09.2015;2015;09;05;Perjantai;4;0;4
94;18.09.2015;2015;09;06;Perjantai;3;1;4
94;18.09.2015;2015;09;07;Perjantai;6;1;7
94;18.09.2015;2015;09;08;Perjantai;6;1;7
94;18.09.2015;2015;09;09;Perjantai;0;2;2
94;18.09.2015;2015;09;10;Perjantai;1;0;1
94;18.09.2015;2015;09;11;Perjantai;0;1;1
94;18.09.2015;2015;09;12;Perjantai;1;0;1
94;18.09.2015;2015;09;13;Perjantai;0;3;3
94;18.09.2015;2015;09;14;Perjantai;1;3;4
94;18.09.2015;2015;09;15;Perjantai;1;3;4
94;18.09.2015;2015;09;16;Perjantai;2;7;9
94;18.09.2015;2015;09;17;Perjantai;0;5;5
94;18.09.2015;2015;09;18;Perjantai;2;4;6
94;18.09.2015;2015;09;19;Perjantai;3;4;7
94;18.09.2015;2015;09;20;Perjantai;4;2;6
94;18.09.2015;2015;09;21;Perjantai;0;1;1
94;18.09.2015;2015;09;22;Perjantai;1;1;2
94;18.09.2015;2015;09;23;Perjantai;0;0;0
94;19.09.2015;2015;09;00;Lauantai;1;1;2
94;19.09.2015;2015;09;01;Lauantai;0;0;0
94;19.09.2015;2015;09;02;Lauantai;0;0;0
94;19.09.2015;2015;09;03;Lauantai;1;0;1
94;19.09.2015;2015;09;04;Lauantai;0;0;0
94;19.09.2015;2015;09;05;Lauantai;0;0;0
94;19.09.2015;2015;09;06;Lauantai;0;1;1
94;19.09.2015;2015;09;07;Lauantai;0;1;1
94;19.09.2015;2015;09;08;Lauantai;1;0;1
94;19.09.2015;2015;09;09;Lauantai;3;1;4
94;19.09.2015;2015;09;10;Lauantai;4;7;11
94;19.09.2015;2015;09;11;Lauantai;4;4;8
94;19.09.2015;2015;09;12;Lauantai;2;9;11
94;19.09.2015;2015;09;13;Lauantai;11;3;14
94;19.09.2015;2015;09;14;Lauantai;3;9;12
94;19.09.2015;2015;09;15;Lauantai;9;1;10
94;19.09.2015;2015;09;16;Lauantai;7;4;11
94;19.09.2015;2015;09;17;Lauantai;3;4;7
94;19.09.2015;2015;09;18;Lauantai;3;9;12
94;19.09.2015;2015;09;19;Lauantai;2;2;4
94;19.09.2015;2015;09;20;Lauantai;2;5;7
94;19.09.2015;2015;09;21;Lauantai;0;1;1
94;19.09.2015;2015;09;22;Lauantai;1;0;1
94;19.09.2015;2015;09;23;Lauantai;1;0;1
94;20.09.2015;2015;09;00;Sunnuntai;3;0;3
94;20.09.2015;2015;09;01;Sunnuntai;0;2;2
94;20.09.2015;2015;09;02;Sunnuntai;0;1;1
94;20.09.2015;2015;09;03;Sunnuntai;1;1;2
94;20.09.2015;2015;09;04;Sunnuntai;0;0;0
94;20.09.2015;2015;09;05;Sunnuntai;1;0;1
94;20.09.2015;2015;09;06;Sunnuntai;0;1;1
94;20.09.2015;2015;09;07;Sunnuntai;0;1;1
94;20.09.2015;2015;09;08;Sunnuntai;1;1;2
94;20.09.2015;2015;09;09;Sunnuntai;2;4;6
94;20.09.2015;2015;09;10;Sunnuntai;3;6;9
94;20.09.2015;2015;09;11;Sunnuntai;8;2;10
94;20.09.2015;2015;09;12;Sunnuntai;7;6;13
94;20.09.2015;2015;09;13;Sunnuntai;5;4;9
94;20.09.2015;2015;09;14;Sunnuntai;7;11;18
94;20.09.2015;2015;09;15;Sunnuntai;9;10;19
94;20.09.2015;2015;09;16;Sunnuntai;2;7;9
94;20.09.2015;2015;09;17;Sunnuntai;7;1;8
94;20.09.2015;2015;09;18;Sunnuntai;3;2;5
94;20.09.2015;2015;09;19;Sunnuntai;2;8;10
94;20.09.2015;2015;09;20;Sunnuntai;5;0;5
94;20.09.2015;2015;09;21;Sunnuntai;0;2;2
94;20.09.2015;2015;09;22;Sunnuntai;0;1;1
94;20.09.2015;2015;09;23;Sunnuntai;0;0;0
94;21.09.2015;2015;09;00;Maanantai;0;0;0
94;21.09.2015;2015;09;01;Maanantai;1;0;1
94;21.09.2015;2015;09;02;Maanantai;0;0;0
94;21.09.2015;2015;09;03;Maanantai;0;0;0
94;21.09.2015;2015;09;04;Maanantai;0;0;0
94;21.09.2015;2015;09;05;Maanantai;5;0;5
94;21.09.2015;2015;09;06;Maanantai;21;1;22
94;21.09.2015;2015;09;07;Maanantai;23;7;30
94;21.09.2015;2015;09;08;Maanantai;9;2;11
94;21.09.2015;2015;09;09;Maanantai;2;1;3
94;21.09.2015;2015;09;10;Maanantai;3;0;3
94;21.09.2015;2015;09;11;Maanantai;3;4;7
94;21.09.2015;2015;09;12;Maanantai;4;5;9
94;21.09.2015;2015;09;13;Maanantai;5;7;12
94;21.09.2015;2015;09;14;Maanantai;2;5;7
94;21.09.2015;2015;09;15;Maanantai;3;30;33
94;21.09.2015;2015;09;16;Maanantai;10;29;39
94;21.09.2015;2015;09;17;Maanantai;5;19;24
94;21.09.2015;2015;09;18;Maanantai;5;13;18
94;21.09.2015;2015;09;19;Maanantai;10;2;12
94;21.09.2015;2015;09;20;Maanantai;0;2;2
94;21.09.2015;2015;09;21;Maanantai;1;0;1
94;21.09.2015;2015;09;22;Maanantai;0;3;3
94;21.09.2015;2015;09;23;Maanantai;0;0;0
94;22.09.2015;2015;09;00;Tiistai;2;0;2
94;22.09.2015;2015;09;01;Tiistai;0;0;0
94;22.09.2015;2015;09;02;Tiistai;0;0;0
94;22.09.2015;2015;09;03;Tiistai;0;0;0
94;22.09.2015;2015;09;04;Tiistai;0;0;0
94;22.09.2015;2015;09;05;Tiistai;4;0;4
94;22.09.2015;2015;09;06;Tiistai;14;0;14
94;22.09.2015;2015;09;07;Tiistai;18;3;21
94;22.09.2015;2015;09;08;Tiistai;6;4;10
94;22.09.2015;2015;09;09;Tiistai;1;2;3
94;22.09.2015;2015;09;10;Tiistai;4;2;6
94;22.09.2015;2015;09;11;Tiistai;0;1;1
94;22.09.2015;2015;09;12;Tiistai;1;0;1
94;22.09.2015;2015;09;13;Tiistai;2;5;7
94;22.09.2015;2015;09;14;Tiistai;3;6;9
94;22.09.2015;2015;09;15;Tiistai;1;6;7
94;22.09.2015;2015;09;16;Tiistai;8;23;31
94;22.09.2015;2015;09;17;Tiistai;6;7;13
94;22.09.2015;2015;09;18;Tiistai;2;2;4
94;22.09.2015;2015;09;19;Tiistai;2;0;2
94;22.09.2015;2015;09;20;Tiistai;1;3;4
94;22.09.2015;2015;09;21;Tiistai;0;2;2
94;22.09.2015;2015;09;22;Tiistai;0;0;0
94;22.09.2015;2015;09;23;Tiistai;0;0;0
94;23.09.2015;2015;09;00;Keskiviikko;0;0;0
94;23.09.2015;2015;09;01;Keskiviikko;0;0;0
94;23.09.2015;2015;09;02;Keskiviikko;0;0;0
94;23.09.2015;2015;09;03;Keskiviikko;0;1;1
94;23.09.2015;2015;09;04;Keskiviikko;1;0;1
94;23.09.2015;2015;09;05;Keskiviikko;3;0;3
94;23.09.2015;2015;09;06;Keskiviikko;12;1;13
94;23.09.2015;2015;09;07;Keskiviikko;15;3;18
94;23.09.2015;2015;09;08;Keskiviikko;12;4;16
94;23.09.2015;2015;09;09;Keskiviikko;3;1;4
94;23.09.2015;2015;09;10;Keskiviikko;4;1;5
94;23.09.2015;2015;09;11;Keskiviikko;0;4;4
94;23.09.2015;2015;09;12;Keskiviikko;1;0;1
94;23.09.2015;2015;09;13;Keskiviikko;3;1;4
94;23.09.2015;2015;09;14;Keskiviikko;3;4;7
94;23.09.2015;2015;09;15;Keskiviikko;1;16;17
94;23.09.2015;2015;09;16;Keskiviikko;5;9;14
94;23.09.2015;2015;09;17;Keskiviikko;2;7;9
94;23.09.2015;2015;09;18;Keskiviikko;1;4;5
94;23.09.2015;2015;09;19;Keskiviikko;0;5;5
94;23.09.2015;2015;09;20;Keskiviikko;0;1;1
94;23.09.2015;2015;09;21;Keskiviikko;0;2;2
94;23.09.2015;2015;09;22;Keskiviikko;0;0;0
94;23.09.2015;2015;09;23;Keskiviikko;0;0;0
94;24.09.2015;2015;09;00;Torstai;0;0;0
94;24.09.2015;2015;09;01;Torstai;0;0;0
94;24.09.2015;2015;09;02;Torstai;0;0;0
94;24.09.2015;2015;09;03;Torstai;0;0;0
94;24.09.2015;2015;09;04;Torstai;1;0;1
94;24.09.2015;2015;09;05;Torstai;2;0;2
94;24.09.2015;2015;09;06;Torstai;10;2;12
94;24.09.2015;2015;09;07;Torstai;19;4;23
94;24.09.2015;2015;09;08;Torstai;13;2;15
94;24.09.2015;2015;09;09;Torstai;3;1;4
94;24.09.2015;2015;09;10;Torstai;3;1;4
94;24.09.2015;2015;09;11;Torstai;2;2;4
94;24.09.2015;2015;09;12;Torstai;2;6;8
94;24.09.2015;2015;09;13;Torstai;3;5;8
94;24.09.2015;2015;09;14;Torstai;4;10;14
94;24.09.2015;2015;09;15;Torstai;7;10;17
94;24.09.2015;2015;09;16;Torstai;6;20;26
94;24.09.2015;2015;09;17;Torstai;8;10;18
94;24.09.2015;2015;09;18;Torstai;4;11;15
94;24.09.2015;2015;09;19;Torstai;7;5;12
94;24.09.2015;2015;09;20;Torstai;2;3;5
94;24.09.2015;2015;09;21;Torstai;2;3;5
94;24.09.2015;2015;09;22;Torstai;0;2;2
94;24.09.2015;2015;09;23;Torstai;0;0;0
94;25.09.2015;2015;09;00;Perjantai;0;1;1
94;25.09.2015;2015;09;01;Perjantai;0;1;1
94;25.09.2015;2015;09;02;Perjantai;0;0;0
94;25.09.2015;2015;09;03;Perjantai;0;0;0
94;25.09.2015;2015;09;04;Perjantai;1;0;1
94;25.09.2015;2015;09;05;Perjantai;4;0;4
94;25.09.2015;2015;09;06;Perjantai;9;1;10
94;25.09.2015;2015;09;07;Perjantai;18;5;23
94;25.09.2015;2015;09;08;Perjantai;9;2;11
94;25.09.2015;2015;09;09;Perjantai;2;2;4
94;25.09.2015;2015;09;10;Perjantai;6;2;8
94;25.09.2015;2015;09;11;Perjantai;4;2;6
94;25.09.2015;2015;09;12;Perjantai;3;0;3
94;25.09.2015;2015;09;13;Perjantai;2;8;10
94;25.09.2015;2015;09;14;Perjantai;17;13;30
94;25.09.2015;2015;09;15;Perjantai;7;12;19
94;25.09.2015;2015;09;16;Perjantai;6;19;25
94;25.09.2015;2015;09;17;Perjantai;3;3;6
94;25.09.2015;2015;09;18;Perjantai;3;3;6
94;25.09.2015;2015;09;19;Perjantai;1;6;7
94;25.09.2015;2015;09;20;Perjantai;1;3;4
94;25.09.2015;2015;09;21;Perjantai;1;6;7
94;25.09.2015;2015;09;22;Perjantai;5;4;9
94;25.09.2015;2015;09;23;Perjantai;0;0;0
94;26.09.2015;2015;09;00;Lauantai;0;0;0
94;26.09.2015;2015;09;01;Lauantai;0;0;0
94;26.09.2015;2015;09;02;Lauantai;1;1;2
94;26.09.2015;2015;09;03;Lauantai;0;0;0
94;26.09.2015;2015;09;04;Lauantai;1;0;1
94;26.09.2015;2015;09;05;Lauantai;1;0;1
94;26.09.2015;2015;09;06;Lauantai;0;0;0
94;26.09.2015;2015;09;07;Lauantai;1;3;4
94;26.09.2015;2015;09;08;Lauantai;3;2;5
94;26.09.2015;2015;09;09;Lauantai;3;5;8
94;26.09.2015;2015;09;10;Lauantai;5;2;7
94;26.09.2015;2015;09;11;Lauantai;6;2;8
94;26.09.2015;2015;09;12;Lauantai;6;5;11
94;26.09.2015;2015;09;13;Lauantai;6;6;12
94;26.09.2015;2015;09;14;Lauantai;8;5;13
94;26.09.2015;2015;09;15;Lauantai;7;8;15
94;26.09.2015;2015;09;16;Lauantai;10;5;15
94;26.09.2015;2015;09;17;Lauantai;6;8;14
94;26.09.2015;2015;09;18;Lauantai;7;9;16
94;26.09.2015;2015;09;19;Lauantai;7;6;13
94;26.09.2015;2015;09;20;Lauantai;2;1;3
94;26.09.2015;2015;09;21;Lauantai;0;2;2
94;26.09.2015;2015;09;22;Lauantai;1;0;1
94;26.09.2015;2015;09;23;Lauantai;0;1;1
94;27.09.2015;2015;09;00;Sunnuntai;0;1;1
94;27.09.2015;2015;09;01;Sunnuntai;1;0;1
94;27.09.2015;2015;09;02;Sunnuntai;0;0;0
94;27.09.2015;2015;09;03;Sunnuntai;0;0;0
94;27.09.2015;2015;09;04;Sunnuntai;0;0;0
94;27.09.2015;2015;09;05;Sunnuntai;1;0;1
94;27.09.2015;2015;09;06;Sunnuntai;0;0;0
94;27.09.2015;2015;09;07;Sunnuntai;1;1;2
94;27.09.2015;2015;09;08;Sunnuntai;1;0;1
94;27.09.2015;2015;09;09;Sunnuntai;3;1;4
94;27.09.2015;2015;09;10;Sunnuntai;4;4;8
94;27.09.2015;2015;09;11;Sunnuntai;4;1;5
94;27.09.2015;2015;09;12;Sunnuntai;1;6;7
94;27.09.2015;2015;09;13;Sunnuntai;4;6;10
94;27.09.2015;2015;09;14;Sunnuntai;3;3;6
94;27.09.2015;2015;09;15;Sunnuntai;6;3;9
94;27.09.2015;2015;09;16;Sunnuntai;2;3;5
94;27.09.2015;2015;09;17;Sunnuntai;7;2;9
94;27.09.2015;2015;09;18;Sunnuntai;7;2;9
94;27.09.2015;2015;09;19;Sunnuntai;3;5;8
94;27.09.2015;2015;09;20;Sunnuntai;1;2;3
94;27.09.2015;2015;09;21;Sunnuntai;0;0;0
94;27.09.2015;2015;09;22;Sunnuntai;0;0;0
94;27.09.2015;2015;09;23;Sunnuntai;1;0;1
94;28.09.2015;2015;09;00;Maanantai;0;0;0
94;28.09.2015;2015;09;01;Maanantai;0;0;0
94;28.09.2015;2015;09;02;Maanantai;0;0;0
94;28.09.2015;2015;09;03;Maanantai;0;0;0
94;28.09.2015;2015;09;04;Maanantai;0;0;0
94;28.09.2015;2015;09;05;Maanantai;7;1;8
94;28.09.2015;2015;09;06;Maanantai;15;2;17
94;28.09.2015;2015;09;07;Maanantai;22;8;30
94;28.09.2015;2015;09;08;Maanantai;13;3;16
94;28.09.2015;2015;09;09;Maanantai;1;4;5
94;28.09.2015;2015;09;10;Maanantai;1;3;4
94;28.09.2015;2015;09;11;Maanantai;5;0;5
94;28.09.2015;2015;09;12;Maanantai;5;2;7
94;28.09.2015;2015;09;13;Maanantai;2;2;4
94;28.09.2015;2015;09;14;Maanantai;4;6;10
94;28.09.2015;2015;09;15;Maanantai;7;17;24
94;28.09.2015;2015;09;16;Maanantai;9;23;32
94;28.09.2015;2015;09;17;Maanantai;4;10;14
94;28.09.2015;2015;09;18;Maanantai;9;7;16
94;28.09.2015;2015;09;19;Maanantai;2;4;6
94;28.09.2015;2015;09;20;Maanantai;0;2;2
94;28.09.2015;2015;09;21;Maanantai;0;1;1
94;28.09.2015;2015;09;22;Maanantai;0;1;1
94;28.09.2015;2015;09;23;Maanantai;0;0;0
94;29.09.2015;2015;09;00;Tiistai;0;0;0
94;29.09.2015;2015;09;01;Tiistai;0;0;0
94;29.09.2015;2015;09;02;Tiistai;0;0;0
94;29.09.2015;2015;09;03;Tiistai;0;0;0
94;29.09.2015;2015;09;04;Tiistai;0;0;0
94;29.09.2015;2015;09;05;Tiistai;7;1;8
94;29.09.2015;2015;09;06;Tiistai;10;1;11
94;29.09.2015;2015;09;07;Tiistai;25;7;32
94;29.09.2015;2015;09;08;Tiistai;8;3;11
94;29.09.2015;2015;09;09;Tiistai;1;0;1
94;29.09.2015;2015;09;10;Tiistai;5;0;5
94;29.09.2015;2015;09;11;Tiistai;0;2;2
94;29.09.2015;2015;09;12;Tiistai;2;4;6
94;29.09.2015;2015;09;13;Tiistai;8;5;13
94;29.09.2015;2015;09;14;Tiistai;4;11;15
94;29.09.2015;2015;09;15;Tiistai;5;13;18
94;29.09.2015;2015;09;16;Tiistai;4;18;22
94;29.09.2015;2015;09;17;Tiistai;6;14;20
94;29.09.2015;2015;09;18;Tiistai;1;5;6
94;29.09.2015;2015;09;19;Tiistai;5;4;9
94;29.09.2015;2015;09;20;Tiistai;0;4;4
94;29.09.2015;2015;09;21;Tiistai;2;2;4
94;29.09.2015;2015;09;22;Tiistai;0;2;2
94;29.09.2015;2015;09;23;Tiistai;0;0;0
94;30.09.2015;2015;09;00;Keskiviikko;1;2;3
94;30.09.2015;2015;09;01;Keskiviikko;0;0;0
94;30.09.2015;2015;09;02;Keskiviikko;0;0;0
94;30.09.2015;2015;09;03;Keskiviikko;0;0;0
94;30.09.2015;2015;09;04;Keskiviikko;0;0;0
94;30.09.2015;2015;09;05;Keskiviikko;6;1;7
94;30.09.2015;2015;09;06;Keskiviikko;13;2;15
94;30.09.2015;2015;09;07;Keskiviikko;18;5;23
94;30.09.2015;2015;09;08;Keskiviikko;8;6;14
94;30.09.2015;2015;09;09;Keskiviikko;3;0;3
94;30.09.2015;2015;09;10;Keskiviikko;5;0;5
94;30.09.2015;2015;09;11;Keskiviikko;2;2;4
94;30.09.2015;2015;09;12;Keskiviikko;1;8;9
94;30.09.2015;2015;09;13;Keskiviikko;3;9;12
94;30.09.2015;2015;09;14;Keskiviikko;2;9;11
94;30.09.2015;2015;09;15;Keskiviikko;9;8;17
94;30.09.2015;2015;09;16;Keskiviikko;7;19;26
94;30.09.2015;2015;09;17;Keskiviikko;7;6;13
94;30.09.2015;2015;09;18;Keskiviikko;8;12;20
94;30.09.2015;2015;09;19;Keskiviikko;6;10;16
94;30.09.2015;2015;09;20;Keskiviikko;1;1;2
94;30.09.2015;2015;09;21;Keskiviikko;0;0;0
94;30.09.2015;2015;09;22;Keskiviikko;0;0;0
94;30.09.2015;2015;09;23;Keskiviikko;0;0;0
94;01.10.2015;2015;10;00;Torstai;0;0;0
94;01.10.2015;2015;10;01;Torstai;0;1;1
94;01.10.2015;2015;10;02;Torstai;0;1;1
94;01.10.2015;2015;10;03;Torstai;0;0;0
94;01.10.2015;2015;10;04;Torstai;0;0;0
94;01.10.2015;2015;10;05;Torstai;4;1;5
94;01.10.2015;2015;10;06;Torstai;12;1;13
94;01.10.2015;2015;10;07;Torstai;18;6;24
94;01.10.2015;2015;10;08;Torstai;7;4;11
94;01.10.2015;2015;10;09;Torstai;2;4;6
94;01.10.2015;2015;10;10;Torstai;3;1;4
94;01.10.2015;2015;10;11;Torstai;2;0;2
94;01.10.2015;2015;10;12;Torstai;1;3;4
94;01.10.2015;2015;10;13;Torstai;3;1;4
94;01.10.2015;2015;10;14;Torstai;5;8;13
94;01.10.2015;2015;10;15;Torstai;6;14;20
94;01.10.2015;2015;10;16;Torstai;8;14;22
94;01.10.2015;2015;10;17;Torstai;3;15;18
94;01.10.2015;2015;10;18;Torstai;5;1;6
94;01.10.2015;2015;10;19;Torstai;3;6;9
94;01.10.2015;2015;10;20;Torstai;0;5;5
94;01.10.2015;2015;10;21;Torstai;0;0;0
94;01.10.2015;2015;10;22;Torstai;1;2;3
94;01.10.2015;2015;10;23;Torstai;0;1;1
94;02.10.2015;2015;10;00;Perjantai;0;0;0
94;02.10.2015;2015;10;01;Perjantai;0;0;0
94;02.10.2015;2015;10;02;Perjantai;0;0;0
94;02.10.2015;2015;10;03;Perjantai;0;0;0
94;02.10.2015;2015;10;04;Perjantai;0;0;0
94;02.10.2015;2015;10;05;Perjantai;2;0;2
94;02.10.2015;2015;10;06;Perjantai;2;0;2
94;02.10.2015;2015;10;07;Perjantai;7;2;9
94;02.10.2015;2015;10;08;Perjantai;6;2;8
94;02.10.2015;2015;10;09;Perjantai;0;0;0
94;02.10.2015;2015;10;10;Perjantai;1;2;3
94;02.10.2015;2015;10;11;Perjantai;2;1;3
94;02.10.2015;2015;10;12;Perjantai;1;1;2
94;02.10.2015;2015;10;13;Perjantai;0;4;4
94;02.10.2015;2015;10;14;Perjantai;3;2;5
94;02.10.2015;2015;10;15;Perjantai;1;10;11
94;02.10.2015;2015;10;16;Perjantai;2;12;14
94;02.10.2015;2015;10;17;Perjantai;0;1;1
94;02.10.2015;2015;10;18;Perjantai;0;1;1
94;02.10.2015;2015;10;19;Perjantai;0;1;1
94;02.10.2015;2015;10;20;Perjantai;2;0;2
94;02.10.2015;2015;10;21;Perjantai;0;0;0
94;02.10.2015;2015;10;22;Perjantai;0;1;1
94;02.10.2015;2015;10;23;Perjantai;1;0;1
94;03.10.2015;2015;10;00;Lauantai;0;0;0
94;03.10.2015;2015;10;01;Lauantai;0;0;0
94;03.10.2015;2015;10;02;Lauantai;1;1;2
94;03.10.2015;2015;10;03;Lauantai;0;0;0
94;03.10.2015;2015;10;04;Lauantai;0;0;0
94;03.10.2015;2015;10;05;Lauantai;0;1;1
94;03.10.2015;2015;10;06;Lauantai;1;0;1
94;03.10.2015;2015;10;07;Lauantai;1;1;2
94;03.10.2015;2015;10;08;Lauantai;1;3;4
94;03.10.2015;2015;10;09;Lauantai;2;3;5
94;03.10.2015;2015;10;10;Lauantai;5;4;9
94;03.10.2015;2015;10;11;Lauantai;6;2;8
94;03.10.2015;2015;10;12;Lauantai;8;5;13
94;03.10.2015;2015;10;13;Lauantai;2;3;5
94;03.10.2015;2015;10;14;Lauantai;8;5;13
94;03.10.2015;2015;10;15;Lauantai;5;7;12
94;03.10.2015;2015;10;16;Lauantai;5;10;15
94;03.10.2015;2015;10;17;Lauantai;11;5;16
94;03.10.2015;2015;10;18;Lauantai;1;2;3
94;03.10.2015;2015;10;19;Lauantai;2;1;3
94;03.10.2015;2015;10;20;Lauantai;0;0;0
94;03.10.2015;2015;10;21;Lauantai;0;3;3
94;03.10.2015;2015;10;22;Lauantai;0;1;1
94;03.10.2015;2015;10;23;Lauantai;1;1;2
94;04.10.2015;2015;10;00;Sunnuntai;0;0;0
94;04.10.2015;2015;10;01;Sunnuntai;1;0;1
94;04.10.2015;2015;10;02;Sunnuntai;1;3;4
94;04.10.2015;2015;10;03;Sunnuntai;0;0;0
94;04.10.2015;2015;10;04;Sunnuntai;1;0;1
94;04.10.2015;2015;10;05;Sunnuntai;0;0;0
94;04.10.2015;2015;10;06;Sunnuntai;1;0;1
94;04.10.2015;2015;10;07;Sunnuntai;0;0;0
94;04.10.2015;2015;10;08;Sunnuntai;2;2;4
94;04.10.2015;2015;10;09;Sunnuntai;3;2;5
94;04.10.2015;2015;10;10;Sunnuntai;1;1;2
94;04.10.2015;2015;10;11;Sunnuntai;4;2;6
94;04.10.2015;2015;10;12;Sunnuntai;4;7;11
94;04.10.2015;2015;10;13;Sunnuntai;4;1;5
94;04.10.2015;2015;10;14;Sunnuntai;4;2;6
94;04.10.2015;2015;10;15;Sunnuntai;8;3;11
94;04.10.2015;2015;10;16;Sunnuntai;6;2;8
94;04.10.2015;2015;10;17;Sunnuntai;4;2;6
94;04.10.2015;2015;10;18;Sunnuntai;1;6;7
94;04.10.2015;2015;10;19;Sunnuntai;0;1;1
94;04.10.2015;2015;10;20;Sunnuntai;0;2;2
94;04.10.2015;2015;10;21;Sunnuntai;1;2;3
94;04.10.2015;2015;10;22;Sunnuntai;0;0;0
94;04.10.2015;2015;10;23;Sunnuntai;0;0;0
94;05.10.2015;2015;10;00;Maanantai;0;0;0
94;05.10.2015;2015;10;01;Maanantai;0;0;0
94;05.10.2015;2015;10;02;Maanantai;0;0;0
94;05.10.2015;2015;10;03;Maanantai;0;0;0
94;05.10.2015;2015;10;04;Maanantai;2;0;2
94;05.10.2015;2015;10;05;Maanantai;5;2;7
94;05.10.2015;2015;10;06;Maanantai;15;0;15
94;05.10.2015;2015;10;07;Maanantai;18;4;22
94;05.10.2015;2015;10;08;Maanantai;7;7;14
94;05.10.2015;2015;10;09;Maanantai;1;0;1
94;05.10.2015;2015;10;10;Maanantai;0;2;2
94;05.10.2015;2015;10;11;Maanantai;4;5;9
94;05.10.2015;2015;10;12;Maanantai;6;1;7
94;05.10.2015;2015;10;13;Maanantai;3;1;4
94;05.10.2015;2015;10;14;Maanantai;1;9;10
94;05.10.2015;2015;10;15;Maanantai;5;7;12
94;05.10.2015;2015;10;16;Maanantai;5;16;21
94;05.10.2015;2015;10;17;Maanantai;4;11;15
94;05.10.2015;2015;10;18;Maanantai;0;6;6
94;05.10.2015;2015;10;19;Maanantai;1;5;6
94;05.10.2015;2015;10;20;Maanantai;0;1;1
94;05.10.2015;2015;10;21;Maanantai;0;0;0
94;05.10.2015;2015;10;22;Maanantai;0;2;2
94;05.10.2015;2015;10;23;Maanantai;0;0;0
94;06.10.2015;2015;10;00;Tiistai;0;0;0
94;06.10.2015;2015;10;01;Tiistai;0;0;0
94;06.10.2015;2015;10;02;Tiistai;0;0;0
94;06.10.2015;2015;10;03;Tiistai;0;0;0
94;06.10.2015;2015;10;04;Tiistai;0;0;0
94;06.10.2015;2015;10;05;Tiistai;3;2;5
94;06.10.2015;2015;10;06;Tiistai;19;0;19
94;06.10.2015;2015;10;07;Tiistai;14;3;17
94;06.10.2015;2015;10;08;Tiistai;5;4;9
94;06.10.2015;2015;10;09;Tiistai;1;2;3
94;06.10.2015;2015;10;10;Tiistai;5;1;6
94;06.10.2015;2015;10;11;Tiistai;2;0;2
94;06.10.2015;2015;10;12;Tiistai;4;3;7
94;06.10.2015;2015;10;13;Tiistai;8;5;13
94;06.10.2015;2015;10;14;Tiistai;7;6;13
94;06.10.2015;2015;10;15;Tiistai;5;14;19
94;06.10.2015;2015;10;16;Tiistai;9;15;24
94;06.10.2015;2015;10;17;Tiistai;4;14;18
94;06.10.2015;2015;10;18;Tiistai;2;5;7
94;06.10.2015;2015;10;19;Tiistai;1;8;9
94;06.10.2015;2015;10;20;Tiistai;0;1;1
94;06.10.2015;2015;10;21;Tiistai;0;2;2
94;06.10.2015;2015;10;22;Tiistai;0;2;2
94;06.10.2015;2015;10;23;Tiistai;0;0;0
94;07.10.2015;2015;10;00;Keskiviikko;1;0;1
94;07.10.2015;2015;10;01;Keskiviikko;0;0;0
94;07.10.2015;2015;10;02;Keskiviikko;0;0;0
94;07.10.2015;2015;10;03;Keskiviikko;0;0;0
94;07.10.2015;2015;10;04;Keskiviikko;0;0;0
94;07.10.2015;2015;10;05;Keskiviikko;5;1;6
94;07.10.2015;2015;10;06;Keskiviikko;14;1;15
94;07.10.2015;2015;10;07;Keskiviikko;13;3;16
94;07.10.2015;2015;10;08;Keskiviikko;2;3;5
94;07.10.2015;2015;10;09;Keskiviikko;2;1;3
94;07.10.2015;2015;10;10;Keskiviikko;2;1;3
94;07.10.2015;2015;10;11;Keskiviikko;5;2;7
94;07.10.2015;2015;10;12;Keskiviikko;2;2;4
94;07.10.2015;2015;10;13;Keskiviikko;7;3;10
94;07.10.2015;2015;10;14;Keskiviikko;4;7;11
94;07.10.2015;2015;10;15;Keskiviikko;4;19;23
94;07.10.2015;2015;10;16;Keskiviikko;6;7;13
94;07.10.2015;2015;10;17;Keskiviikko;4;9;13
94;07.10.2015;2015;10;18;Keskiviikko;3;10;13
94;07.10.2015;2015;10;19;Keskiviikko;1;6;7
94;07.10.2015;2015;10;20;Keskiviikko;5;3;8
94;07.10.2015;2015;10;21;Keskiviikko;1;4;5
94;07.10.2015;2015;10;22;Keskiviikko;0;0;0
94;07.10.2015;2015;10;23;Keskiviikko;0;0;0
94;08.10.2015;2015;10;00;Torstai;0;0;0
94;08.10.2015;2015;10;01;Torstai;0;0;0
94;08.10.2015;2015;10;02;Torstai;0;0;0
94;08.10.2015;2015;10;03;Torstai;0;0;0
94;08.10.2015;2015;10;04;Torstai;0;0;0
94;08.10.2015;2015;10;05;Torstai;5;0;5
94;08.10.2015;2015;10;06;Torstai;16;1;17
94;08.10.2015;2015;10;07;Torstai;14;1;15
94;08.10.2015;2015;10;08;Torstai;2;2;4
94;08.10.2015;2015;10;09;Torstai;3;2;5
94;08.10.2015;2015;10;10;Torstai;1;1;2
94;08.10.2015;2015;10;11;Torstai;2;4;6
94;08.10.2015;2015;10;12;Torstai;5;1;6
94;08.10.2015;2015;10;13;Torstai;2;4;6
94;08.10.2015;2015;10;14;Torstai;0;7;7
94;08.10.2015;2015;10;15;Torstai;0;12;12
94;08.10.2015;2015;10;16;Torstai;3;6;9
94;08.10.2015;2015;10;17;Torstai;2;10;12
94;08.10.2015;2015;10;18;Torstai;2;6;8
94;08.10.2015;2015;10;19;Torstai;4;2;6
94;08.10.2015;2015;10;20;Torstai;2;2;4
94;08.10.2015;2015;10;21;Torstai;2;1;3
94;08.10.2015;2015;10;22;Torstai;1;2;3
94;08.10.2015;2015;10;23;Torstai;0;0;0
94;09.10.2015;2015;10;00;Perjantai;0;0;0
94;09.10.2015;2015;10;01;Perjantai;0;0;0
94;09.10.2015;2015;10;02;Perjantai;0;0;0
94;09.10.2015;2015;10;03;Perjantai;0;0;0
94;09.10.2015;2015;10;04;Perjantai;0;0;0
94;09.10.2015;2015;10;05;Perjantai;2;0;2
94;09.10.2015;2015;10;06;Perjantai;12;0;12
94;09.10.2015;2015;10;07;Perjantai;8;2;10
94;09.10.2015;2015;10;08;Perjantai;4;2;6
94;09.10.2015;2015;10;09;Perjantai;3;3;6
94;09.10.2015;2015;10;10;Perjantai;3;0;3
94;09.10.2015;2015;10;11;Perjantai;1;1;2
94;09.10.2015;2015;10;12;Perjantai;2;1;3
94;09.10.2015;2015;10;13;Perjantai;2;4;6
94;09.10.2015;2015;10;14;Perjantai;8;16;24
94;09.10.2015;2015;10;15;Perjantai;1;9;10
94;09.10.2015;2015;10;16;Perjantai;4;11;15
94;09.10.2015;2015;10;17;Perjantai;2;12;14
94;09.10.2015;2015;10;18;Perjantai;2;4;6
94;09.10.2015;2015;10;19;Perjantai;4;5;9
94;09.10.2015;2015;10;20;Perjantai;3;2;5
94;09.10.2015;2015;10;21;Perjantai;0;1;1
94;09.10.2015;2015;10;22;Perjantai;3;1;4
94;09.10.2015;2015;10;23;Perjantai;0;0;0
94;10.10.2015;2015;10;00;Lauantai;0;1;1
94;10.10.2015;2015;10;01;Lauantai;0;1;1
94;10.10.2015;2015;10;02;Lauantai;1;1;2
94;10.10.2015;2015;10;03;Lauantai;0;0;0
94;10.10.2015;2015;10;04;Lauantai;0;0;0
94;10.10.2015;2015;10;05;Lauantai;0;0;0
94;10.10.2015;2015;10;06;Lauantai;0;0;0
94;10.10.2015;2015;10;07;Lauantai;3;0;3
94;10.10.2015;2015;10;08;Lauantai;0;1;1
94;10.10.2015;2015;10;09;Lauantai;1;1;2
94;10.10.2015;2015;10;10;Lauantai;1;2;3
94;10.10.2015;2015;10;11;Lauantai;2;4;6
94;10.10.2015;2015;10;12;Lauantai;4;3;7
94;10.10.2015;2015;10;13;Lauantai;2;1;3
94;10.10.2015;2015;10;14;Lauantai;4;1;5
94;10.10.2015;2015;10;15;Lauantai;2;5;7
94;10.10.2015;2015;10;16;Lauantai;5;4;9
94;10.10.2015;2015;10;17;Lauantai;1;2;3
94;10.10.2015;2015;10;18;Lauantai;6;2;8
94;10.10.2015;2015;10;19;Lauantai;1;1;2
94;10.10.2015;2015;10;20;Lauantai;0;3;3
94;10.10.2015;2015;10;21;Lauantai;0;1;1
94;10.10.2015;2015;10;22;Lauantai;0;0;0
94;10.10.2015;2015;10;23;Lauantai;0;0;0
94;11.10.2015;2015;10;00;Sunnuntai;0;0;0
94;11.10.2015;2015;10;01;Sunnuntai;0;0;0
94;11.10.2015;2015;10;02;Sunnuntai;1;1;2
94;11.10.2015;2015;10;03;Sunnuntai;1;0;1
94;11.10.2015;2015;10;04;Sunnuntai;0;0;0
94;11.10.2015;2015;10;05;Sunnuntai;0;0;0
94;11.10.2015;2015;10;06;Sunnuntai;0;0;0
94;11.10.2015;2015;10;07;Sunnuntai;1;0;1
94;11.10.2015;2015;10;08;Sunnuntai;1;1;2
94;11.10.2015;2015;10;09;Sunnuntai;1;0;1
94;11.10.2015;2015;10;10;Sunnuntai;2;0;2
94;11.10.2015;2015;10;11;Sunnuntai;5;2;7
94;11.10.2015;2015;10;12;Sunnuntai;0;4;4
94;11.10.2015;2015;10;13;Sunnuntai;4;8;12
94;11.10.2015;2015;10;14;Sunnuntai;3;2;5
94;11.10.2015;2015;10;15;Sunnuntai;5;3;8
94;11.10.2015;2015;10;16;Sunnuntai;8;7;15
94;11.10.2015;2015;10;17;Sunnuntai;7;2;9
94;11.10.2015;2015;10;18;Sunnuntai;6;1;7
94;11.10.2015;2015;10;19;Sunnuntai;5;1;6
94;11.10.2015;2015;10;20;Sunnuntai;1;1;2
94;11.10.2015;2015;10;21;Sunnuntai;0;2;2
94;11.10.2015;2015;10;22;Sunnuntai;0;0;0
94;11.10.2015;2015;10;23;Sunnuntai;0;0;0
94;12.10.2015;2015;10;00;Maanantai;0;0;0
94;12.10.2015;2015;10;01;Maanantai;0;0;0
94;12.10.2015;2015;10;02;Maanantai;0;0;0
94;12.10.2015;2015;10;03;Maanantai;0;0;0
94;12.10.2015;2015;10;04;Maanantai;0;0;0
94;12.10.2015;2015;10;05;Maanantai;3;1;4
94;12.10.2015;2015;10;06;Maanantai;16;1;17
94;12.10.2015;2015;10;07;Maanantai;18;2;20
94;12.10.2015;2015;10;08;Maanantai;8;2;10
94;12.10.2015;2015;10;09;Maanantai;1;2;3
94;12.10.2015;2015;10;10;Maanantai;1;3;4
94;12.10.2015;2015;10;11;Maanantai;5;0;5
94;12.10.2015;2015;10;12;Maanantai;2;1;3
94;12.10.2015;2015;10;13;Maanantai;4;3;7
94;12.10.2015;2015;10;14;Maanantai;2;6;8
94;12.10.2015;2015;10;15;Maanantai;5;15;20
94;12.10.2015;2015;10;16;Maanantai;5;15;20
94;12.10.2015;2015;10;17;Maanantai;6;15;21
94;12.10.2015;2015;10;18;Maanantai;3;4;7
94;12.10.2015;2015;10;19;Maanantai;1;2;3
94;12.10.2015;2015;10;20;Maanantai;1;4;5
94;12.10.2015;2015;10;21;Maanantai;0;2;2
94;12.10.2015;2015;10;22;Maanantai;0;1;1
94;12.10.2015;2015;10;23;Maanantai;0;0;0
94;13.10.2015;2015;10;00;Tiistai;0;0;0
94;13.10.2015;2015;10;01;Tiistai;0;0;0
94;13.10.2015;2015;10;02;Tiistai;0;0;0
94;13.10.2015;2015;10;03;Tiistai;0;0;0
94;13.10.2015;2015;10;04;Tiistai;0;0;0
94;13.10.2015;2015;10;05;Tiistai;3;2;5
94;13.10.2015;2015;10;06;Tiistai;20;0;20
94;13.10.2015;2015;10;07;Tiistai;15;2;17
94;13.10.2015;2015;10;08;Tiistai;6;3;9
94;13.10.2015;2015;10;09;Tiistai;3;1;4
94;13.10.2015;2015;10;10;Tiistai;5;1;6
94;13.10.2015;2015;10;11;Tiistai;4;1;5
94;13.10.2015;2015;10;12;Tiistai;0;4;4
94;13.10.2015;2015;10;13;Tiistai;6;5;11
94;13.10.2015;2015;10;14;Tiistai;6;11;17
94;13.10.2015;2015;10;15;Tiistai;1;11;12
94;13.10.2015;2015;10;16;Tiistai;8;14;22
94;13.10.2015;2015;10;17;Tiistai;7;13;20
94;13.10.2015;2015;10;18;Tiistai;1;5;6
94;13.10.2015;2015;10;19;Tiistai;3;5;8
94;13.10.2015;2015;10;20;Tiistai;0;6;6
94;13.10.2015;2015;10;21;Tiistai;0;2;2
94;13.10.2015;2015;10;22;Tiistai;0;1;1
94;13.10.2015;2015;10;23;Tiistai;0;0;0
94;14.10.2015;2015;10;00;Keskiviikko;0;0;0
94;14.10.2015;2015;10;01;Keskiviikko;0;0;0
94;14.10.2015;2015;10;02;Keskiviikko;0;0;0
94;14.10.2015;2015;10;03;Keskiviikko;0;0;0
94;14.10.2015;2015;10;04;Keskiviikko;2;0;2
94;14.10.2015;2015;10;05;Keskiviikko;6;1;7
94;14.10.2015;2015;10;06;Keskiviikko;10;1;11
94;14.10.2015;2015;10;07;Keskiviikko;13;2;15
94;14.10.2015;2015;10;08;Keskiviikko;8;4;12
94;14.10.2015;2015;10;09;Keskiviikko;4;3;7
94;14.10.2015;2015;10;10;Keskiviikko;3;0;3
94;14.10.2015;2015;10;11;Keskiviikko;2;4;6
94;14.10.2015;2015;10;12;Keskiviikko;2;6;8
94;14.10.2015;2015;10;13;Keskiviikko;5;1;6
94;14.10.2015;2015;10;14;Keskiviikko;1;7;8
94;14.10.2015;2015;10;15;Keskiviikko;4;14;18
94;14.10.2015;2015;10;16;Keskiviikko;5;10;15
94;14.10.2015;2015;10;17;Keskiviikko;6;8;14
94;14.10.2015;2015;10;18;Keskiviikko;2;11;13
94;14.10.2015;2015;10;19;Keskiviikko;1;3;4
94;14.10.2015;2015;10;20;Keskiviikko;2;2;4
94;14.10.2015;2015;10;21;Keskiviikko;0;1;1
94;14.10.2015;2015;10;22;Keskiviikko;0;3;3
94;14.10.2015;2015;10;23;Keskiviikko;0;0;0
94;15.10.2015;2015;10;00;Torstai;0;0;0
94;15.10.2015;2015;10;01;Torstai;0;0;0
94;15.10.2015;2015;10;02;Torstai;0;0;0
94;15.10.2015;2015;10;03;Torstai;0;0;0
94;15.10.2015;2015;10;04;Torstai;1;1;2
94;15.10.2015;2015;10;05;Torstai;4;1;5
94;15.10.2015;2015;10;06;Torstai;16;1;17
94;15.10.2015;2015;10;07;Torstai;12;2;14
94;15.10.2015;2015;10;08;Torstai;9;1;10
94;15.10.2015;2015;10;09;Torstai;4;2;6
94;15.10.2015;2015;10;10;Torstai;0;1;1
94;15.10.2015;2015;10;11;Torstai;5;2;7
94;15.10.2015;2015;10;12;Torstai;2;5;7
94;15.10.2015;2015;10;13;Torstai;3;3;6
94;15.10.2015;2015;10;14;Torstai;3;10;13
94;15.10.2015;2015;10;15;Torstai;3;9;12
94;15.10.2015;2015;10;16;Torstai;2;15;17
94;15.10.2015;2015;10;17;Torstai;5;13;18
94;15.10.2015;2015;10;18;Torstai;6;4;10
94;15.10.2015;2015;10;19;Torstai;3;6;9
94;15.10.2015;2015;10;20;Torstai;2;3;5
94;15.10.2015;2015;10;21;Torstai;3;2;5
94;15.10.2015;2015;10;22;Torstai;0;5;5
94;15.10.2015;2015;10;23;Torstai;0;0;0
94;16.10.2015;2015;10;00;Perjantai;0;0;0
94;16.10.2015;2015;10;01;Perjantai;0;0;0
94;16.10.2015;2015;10;02;Perjantai;0;0;0
94;16.10.2015;2015;10;03;Perjantai;0;0;0
94;16.10.2015;2015;10;04;Perjantai;0;0;0
94;16.10.2015;2015;10;05;Perjantai;4;1;5
94;16.10.2015;2015;10;06;Perjantai;7;1;8
94;16.10.2015;2015;10;07;Perjantai;14;0;14
94;16.10.2015;2015;10;08;Perjantai;9;2;11
94;16.10.2015;2015;10;09;Perjantai;2;0;2
94;16.10.2015;2015;10;10;Perjantai;4;1;5
94;16.10.2015;2015;10;11;Perjantai;1;2;3
94;16.10.2015;2015;10;12;Perjantai;4;4;8
94;16.10.2015;2015;10;13;Perjantai;6;7;13
94;16.10.2015;2015;10;14;Perjantai;2;8;10
94;16.10.2015;2015;10;15;Perjantai;2;10;12
94;16.10.2015;2015;10;16;Perjantai;4;10;14
94;16.10.2015;2015;10;17;Perjantai;3;4;7
94;16.10.2015;2015;10;18;Perjantai;5;4;9
94;16.10.2015;2015;10;19;Perjantai;2;2;4
94;16.10.2015;2015;10;20;Perjantai;1;1;2
94;16.10.2015;2015;10;21;Perjantai;0;1;1
94;16.10.2015;2015;10;22;Perjantai;1;2;3
94;16.10.2015;2015;10;23;Perjantai;0;0;0
94;17.10.2015;2015;10;00;Lauantai;0;1;1
94;17.10.2015;2015;10;01;Lauantai;0;0;0
94;17.10.2015;2015;10;02;Lauantai;0;0;0
94;17.10.2015;2015;10;03;Lauantai;0;0;0
94;17.10.2015;2015;10;04;Lauantai;1;0;1
94;17.10.2015;2015;10;05;Lauantai;0;0;0
94;17.10.2015;2015;10;06;Lauantai;1;0;1
94;17.10.2015;2015;10;07;Lauantai;2;0;2
94;17.10.2015;2015;10;08;Lauantai;2;0;2
94;17.10.2015;2015;10;09;Lauantai;0;0;0
94;17.10.2015;2015;10;10;Lauantai;4;2;6
94;17.10.2015;2015;10;11;Lauantai;6;3;9
94;17.10.2015;2015;10;12;Lauantai;3;4;7
94;17.10.2015;2015;10;13;Lauantai;6;3;9
94;17.10.2015;2015;10;14;Lauantai;4;3;7
94;17.10.2015;2015;10;15;Lauantai;3;4;7
94;17.10.2015;2015;10;16;Lauantai;13;3;16
94;17.10.2015;2015;10;17;Lauantai;0;9;9
94;17.10.2015;2015;10;18;Lauantai;5;1;6
94;17.10.2015;2015;10;19;Lauantai;2;2;4
94;17.10.2015;2015;10;20;Lauantai;3;5;8
94;17.10.2015;2015;10;21;Lauantai;1;1;2
94;17.10.2015;2015;10;22;Lauantai;0;2;2
94;17.10.2015;2015;10;23;Lauantai;0;1;1
94;18.10.2015;2015;10;00;Sunnuntai;1;2;3
94;18.10.2015;2015;10;01;Sunnuntai;0;0;0
94;18.10.2015;2015;10;02;Sunnuntai;0;0;0
94;18.10.2015;2015;10;03;Sunnuntai;0;0;0
94;18.10.2015;2015;10;04;Sunnuntai;0;0;0
94;18.10.2015;2015;10;05;Sunnuntai;0;0;0
94;18.10.2015;2015;10;06;Sunnuntai;1;1;2
94;18.10.2015;2015;10;07;Sunnuntai;1;0;1
94;18.10.2015;2015;10;08;Sunnuntai;0;1;1
94;18.10.2015;2015;10;09;Sunnuntai;0;0;0
94;18.10.2015;2015;10;10;Sunnuntai;2;2;4
94;18.10.2015;2015;10;11;Sunnuntai;7;5;12
94;18.10.2015;2015;10;12;Sunnuntai;2;6;8
94;18.10.2015;2015;10;13;Sunnuntai;5;3;8
94;18.10.2015;2015;10;14;Sunnuntai;1;8;9
94;18.10.2015;2015;10;15;Sunnuntai;9;1;10
94;18.10.2015;2015;10;16;Sunnuntai;3;1;4
94;18.10.2015;2015;10;17;Sunnuntai;3;6;9
94;18.10.2015;2015;10;18;Sunnuntai;7;4;11
94;18.10.2015;2015;10;19;Sunnuntai;1;2;3
94;18.10.2015;2015;10;20;Sunnuntai;1;1;2
94;18.10.2015;2015;10;21;Sunnuntai;0;4;4
94;18.10.2015;2015;10;22;Sunnuntai;0;0;0
94;18.10.2015;2015;10;23;Sunnuntai;1;1;2
94;19.10.2015;2015;10;00;Maanantai;0;0;0
94;19.10.2015;2015;10;01;Maanantai;1;0;1
94;19.10.2015;2015;10;02;Maanantai;0;0;0
94;19.10.2015;2015;10;03;Maanantai;0;0;0
94;19.10.2015;2015;10;04;Maanantai;0;0;0
94;19.10.2015;2015;10;05;Maanantai;3;0;3
94;19.10.2015;2015;10;06;Maanantai;11;2;13
94;19.10.2015;2015;10;07;Maanantai;14;0;14
94;19.10.2015;2015;10;08;Maanantai;4;2;6
94;19.10.2015;2015;10;09;Maanantai;4;2;6
94;19.10.2015;2015;10;10;Maanantai;3;2;5
94;19.10.2015;2015;10;11;Maanantai;3;0;3
94;19.10.2015;2015;10;12;Maanantai;4;3;7
94;19.10.2015;2015;10;13;Maanantai;5;4;9
94;19.10.2015;2015;10;14;Maanantai;3;3;6
94;19.10.2015;2015;10;15;Maanantai;10;6;16
94;19.10.2015;2015;10;16;Maanantai;2;12;14
94;19.10.2015;2015;10;17;Maanantai;5;12;17
94;19.10.2015;2015;10;18;Maanantai;7;9;16
94;19.10.2015;2015;10;19;Maanantai;5;7;12
94;19.10.2015;2015;10;20;Maanantai;1;4;5
94;19.10.2015;2015;10;21;Maanantai;0;3;3
94;19.10.2015;2015;10;22;Maanantai;1;1;2
94;19.10.2015;2015;10;23;Maanantai;0;3;3
94;20.10.2015;2015;10;00;Tiistai;0;0;0
94;20.10.2015;2015;10;01;Tiistai;0;0;0
94;20.10.2015;2015;10;02;Tiistai;0;0;0
94;20.10.2015;2015;10;03;Tiistai;0;0;0
94;20.10.2015;2015;10;04;Tiistai;0;0;0
94;20.10.2015;2015;10;05;Tiistai;1;1;2
94;20.10.2015;2015;10;06;Tiistai;11;0;11
94;20.10.2015;2015;10;07;Tiistai;11;0;11
94;20.10.2015;2015;10;08;Tiistai;6;5;11
94;20.10.2015;2015;10;09;Tiistai;1;0;1
94;20.10.2015;2015;10;10;Tiistai;4;0;4
94;20.10.2015;2015;10;11;Tiistai;1;0;1
94;20.10.2015;2015;10;12;Tiistai;1;1;2
94;20.10.2015;2015;10;13;Tiistai;4;2;6
94;20.10.2015;2015;10;14;Tiistai;2;5;7
94;20.10.2015;2015;10;15;Tiistai;0;11;11
94;20.10.2015;2015;10;16;Tiistai;4;8;12
94;20.10.2015;2015;10;17;Tiistai;2;10;12
94;20.10.2015;2015;10;18;Tiistai;0;5;5
94;20.10.2015;2015;10;19;Tiistai;1;0;1
94;20.10.2015;2015;10;20;Tiistai;0;1;1
94;20.10.2015;2015;10;21;Tiistai;0;1;1
94;20.10.2015;2015;10;22;Tiistai;0;0;0
94;20.10.2015;2015;10;23;Tiistai;0;2;2
94;21.10.2015;2015;10;00;Keskiviikko;0;0;0
94;21.10.2015;2015;10;01;Keskiviikko;0;0;0
94;21.10.2015;2015;10;02;Keskiviikko;0;0;0
94;21.10.2015;2015;10;03;Keskiviikko;0;0;0
94;21.10.2015;2015;10;04;Keskiviikko;0;0;0
94;21.10.2015;2015;10;05;Keskiviikko;2;1;3
94;21.10.2015;2015;10;06;Keskiviikko;9;1;10
94;21.10.2015;2015;10;07;Keskiviikko;10;0;10
94;21.10.2015;2015;10;08;Keskiviikko;3;1;4
94;21.10.2015;2015;10;09;Keskiviikko;1;0;1
94;21.10.2015;2015;10;10;Keskiviikko;3;0;3
94;21.10.2015;2015;10;11;Keskiviikko;0;3;3
94;21.10.2015;2015;10;12;Keskiviikko;2;1;3
94;21.10.2015;2015;10;13;Keskiviikko;4;0;4
94;21.10.2015;2015;10;14;Keskiviikko;2;5;7
94;21.10.2015;2015;10;15;Keskiviikko;0;5;5
94;21.10.2015;2015;10;16;Keskiviikko;0;6;6
94;21.10.2015;2015;10;17;Keskiviikko;1;4;5
94;21.10.2015;2015;10;18;Keskiviikko;0;3;3
94;21.10.2015;2015;10;19;Keskiviikko;2;6;8
94;21.10.2015;2015;10;20;Keskiviikko;0;0;0
94;21.10.2015;2015;10;21;Keskiviikko;1;3;4
94;21.10.2015;2015;10;22;Keskiviikko;0;0;0
94;21.10.2015;2015;10;23;Keskiviikko;0;1;1
94;22.10.2015;2015;10;00;Torstai;0;1;1
94;22.10.2015;2015;10;01;Torstai;0;0;0
94;22.10.2015;2015;10;02;Torstai;0;0;0
94;22.10.2015;2015;10;03;Torstai;0;0;0
94;22.10.2015;2015;10;04;Torstai;0;0;0
94;22.10.2015;2015;10;05;Torstai;0;2;2
94;22.10.2015;2015;10;06;Torstai;5;0;5
94;22.10.2015;2015;10;07;Torstai;7;0;7
94;22.10.2015;2015;10;08;Torstai;2;1;3
94;22.10.2015;2015;10;09;Torstai;2;0;2
94;22.10.2015;2015;10;10;Torstai;1;1;2
94;22.10.2015;2015;10;11;Torstai;3;1;4
94;22.10.2015;2015;10;12;Torstai;3;2;5
94;22.10.2015;2015;10;13;Torstai;4;3;7
94;22.10.2015;2015;10;14;Torstai;2;6;8
94;22.10.2015;2015;10;15;Torstai;1;4;5
94;22.10.2015;2015;10;16;Torstai;7;12;19
94;22.10.2015;2015;10;17;Torstai;1;4;5
94;22.10.2015;2015;10;18;Torstai;2;3;5
94;22.10.2015;2015;10;19;Torstai;1;1;2
94;22.10.2015;2015;10;20;Torstai;2;0;2
94;22.10.2015;2015;10;21;Torstai;0;0;0
94;22.10.2015;2015;10;22;Torstai;0;1;1
94;22.10.2015;2015;10;23;Torstai;0;0;0
94;23.10.2015;2015;10;00;Perjantai;1;0;1
94;23.10.2015;2015;10;01;Perjantai;1;0;1
94;23.10.2015;2015;10;02;Perjantai;0;1;1
94;23.10.2015;2015;10;03;Perjantai;1;0;1
94;23.10.2015;2015;10;04;Perjantai;0;0;0
94;23.10.2015;2015;10;05;Perjantai;3;1;4
94;23.10.2015;2015;10;06;Perjantai;3;2;5
94;23.10.2015;2015;10;07;Perjantai;10;0;10
94;23.10.2015;2015;10;08;Perjantai;5;1;6
94;23.10.2015;2015;10;09;Perjantai;2;0;2
94;23.10.2015;2015;10;10;Perjantai;1;3;4
94;23.10.2015;2015;10;11;Perjantai;2;1;3
94;23.10.2015;2015;10;12;Perjantai;1;0;1
94;23.10.2015;2015;10;13;Perjantai;3;1;4
94;23.10.2015;2015;10;14;Perjantai;2;2;4
94;23.10.2015;2015;10;15;Perjantai;2;9;11
94;23.10.2015;2015;10;16;Perjantai;1;9;10
94;23.10.2015;2015;10;17;Perjantai;4;3;7
94;23.10.2015;2015;10;18;Perjantai;2;0;2
94;23.10.2015;2015;10;19;Perjantai;0;3;3
94;23.10.2015;2015;10;20;Perjantai;2;2;4
94;23.10.2015;2015;10;21;Perjantai;1;0;1
94;23.10.2015;2015;10;22;Perjantai;0;0;0
94;23.10.2015;2015;10;23;Perjantai;0;0;0
94;24.10.2015;2015;10;00;Lauantai;0;1;1
94;24.10.2015;2015;10;01;Lauantai;2;0;2
94;24.10.2015;2015;10;02;Lauantai;1;1;2
94;24.10.2015;2015;10;03;Lauantai;0;0;0
94;24.10.2015;2015;10;04;Lauantai;1;0;1
94;24.10.2015;2015;10;05;Lauantai;0;0;0
94;24.10.2015;2015;10;06;Lauantai;0;1;1
94;24.10.2015;2015;10;07;Lauantai;1;0;1
94;24.10.2015;2015;10;08;Lauantai;0;2;2
94;24.10.2015;2015;10;09;Lauantai;2;0;2
94;24.10.2015;2015;10;10;Lauantai;0;2;2
94;24.10.2015;2015;10;11;Lauantai;2;9;11
94;24.10.2015;2015;10;12;Lauantai;2;2;4
94;24.10.2015;2015;10;13;Lauantai;4;1;5
94;24.10.2015;2015;10;14;Lauantai;1;2;3
94;24.10.2015;2015;10;15;Lauantai;6;1;7
94;24.10.2015;2015;10;16;Lauantai;2;3;5
94;24.10.2015;2015;10;17;Lauantai;5;0;5
94;24.10.2015;2015;10;18;Lauantai;1;3;4
94;24.10.2015;2015;10;19;Lauantai;0;2;2
94;24.10.2015;2015;10;20;Lauantai;1;2;3
94;24.10.2015;2015;10;21;Lauantai;0;1;1
94;24.10.2015;2015;10;22;Lauantai;1;1;2
94;24.10.2015;2015;10;23;Lauantai;0;1;1
94;25.10.2015;2015;10;00;Sunnuntai;13;0;13
94;25.10.2015;2015;10;01;Sunnuntai;0;0;0
94;25.10.2015;2015;10;02;Sunnuntai;1;1;2
94;25.10.2015;2015;10;03;Sunnuntai;0;0;0
94;25.10.2015;2015;10;04;Sunnuntai;0;0;0
94;25.10.2015;2015;10;05;Sunnuntai;0;0;0
94;25.10.2015;2015;10;06;Sunnuntai;0;0;0
94;25.10.2015;2015;10;07;Sunnuntai;0;1;1
94;25.10.2015;2015;10;08;Sunnuntai;0;0;0
94;25.10.2015;2015;10;09;Sunnuntai;1;0;1
94;25.10.2015;2015;10;10;Sunnuntai;1;0;1
94;25.10.2015;2015;10;11;Sunnuntai;0;3;3
94;25.10.2015;2015;10;12;Sunnuntai;1;1;2
94;25.10.2015;2015;10;13;Sunnuntai;2;3;5
94;25.10.2015;2015;10;14;Sunnuntai;0;0;0
94;25.10.2015;2015;10;15;Sunnuntai;0;1;1
94;25.10.2015;2015;10;16;Sunnuntai;0;2;2
94;25.10.2015;2015;10;17;Sunnuntai;1;1;2
94;25.10.2015;2015;10;18;Sunnuntai;0;4;4
94;25.10.2015;2015;10;19;Sunnuntai;2;0;2
94;25.10.2015;2015;10;20;Sunnuntai;3;0;3
94;25.10.2015;2015;10;21;Sunnuntai;0;0;0
94;25.10.2015;2015;10;22;Sunnuntai;0;0;0
94;25.10.2015;2015;10;23;Sunnuntai;0;0;0
94;26.10.2015;2015;10;00;Maanantai;0;0;0
94;26.10.2015;2015;10;01;Maanantai;0;0;0
94;26.10.2015;2015;10;02;Maanantai;0;0;0
94;26.10.2015;2015;10;03;Maanantai;0;0;0
94;26.10.2015;2015;10;04;Maanantai;0;0;0
94;26.10.2015;2015;10;05;Maanantai;4;1;5
94;26.10.2015;2015;10;06;Maanantai;16;2;18
94;26.10.2015;2015;10;07;Maanantai;10;6;16
94;26.10.2015;2015;10;08;Maanantai;7;1;8
94;26.10.2015;2015;10;09;Maanantai;2;0;2
94;26.10.2015;2015;10;10;Maanantai;1;1;2
94;26.10.2015;2015;10;11;Maanantai;1;3;4
94;26.10.2015;2015;10;12;Maanantai;1;2;3
94;26.10.2015;2015;10;13;Maanantai;3;1;4
94;26.10.2015;2015;10;14;Maanantai;6;8;14
94;26.10.2015;2015;10;15;Maanantai;6;10;16
94;26.10.2015;2015;10;16;Maanantai;5;13;18
94;26.10.2015;2015;10;17;Maanantai;0;7;7
94;26.10.2015;2015;10;18;Maanantai;1;4;5
94;26.10.2015;2015;10;19;Maanantai;2;5;7
94;26.10.2015;2015;10;20;Maanantai;2;1;3
94;26.10.2015;2015;10;21;Maanantai;0;2;2
94;26.10.2015;2015;10;22;Maanantai;2;3;5
94;26.10.2015;2015;10;23;Maanantai;1;0;1
94;27.10.2015;2015;10;00;Tiistai;1;1;2
94;27.10.2015;2015;10;01;Tiistai;0;0;0
94;27.10.2015;2015;10;02;Tiistai;0;0;0
94;27.10.2015;2015;10;03;Tiistai;0;0;0
94;27.10.2015;2015;10;04;Tiistai;0;0;0
94;27.10.2015;2015;10;05;Tiistai;0;0;0
94;27.10.2015;2015;10;06;Tiistai;17;4;21
94;27.10.2015;2015;10;07;Tiistai;13;3;16
94;27.10.2015;2015;10;08;Tiistai;5;0;5
94;27.10.2015;2015;10;09;Tiistai;0;1;1
94;27.10.2015;2015;10;10;Tiistai;4;0;4
94;27.10.2015;2015;10;11;Tiistai;4;1;5
94;27.10.2015;2015;10;12;Tiistai;4;1;5
94;27.10.2015;2015;10;13;Tiistai;2;3;5
94;27.10.2015;2015;10;14;Tiistai;4;5;9
94;27.10.2015;2015;10;15;Tiistai;4;10;14
94;27.10.2015;2015;10;16;Tiistai;4;9;13
94;27.10.2015;2015;10;17;Tiistai;3;7;10
94;27.10.2015;2015;10;18;Tiistai;0;4;4
94;27.10.2015;2015;10;19;Tiistai;1;2;3
94;27.10.2015;2015;10;20;Tiistai;0;3;3
94;27.10.2015;2015;10;21;Tiistai;0;5;5
94;27.10.2015;2015;10;22;Tiistai;0;4;4
94;27.10.2015;2015;10;23;Tiistai;0;0;0
94;28.10.2015;2015;10;00;Keskiviikko;1;0;1
94;28.10.2015;2015;10;01;Keskiviikko;0;0;0
94;28.10.2015;2015;10;02;Keskiviikko;0;0;0
94;28.10.2015;2015;10;03;Keskiviikko;0;0;0
94;28.10.2015;2015;10;04;Keskiviikko;0;0;0
94;28.10.2015;2015;10;05;Keskiviikko;2;2;4
94;28.10.2015;2015;10;06;Keskiviikko;13;1;14
94;28.10.2015;2015;10;07;Keskiviikko;12;0;12
94;28.10.2015;2015;10;08;Keskiviikko;8;2;10
94;28.10.2015;2015;10;09;Keskiviikko;0;0;0
94;28.10.2015;2015;10;10;Keskiviikko;2;0;2
94;28.10.2015;2015;10;11;Keskiviikko;2;2;4
94;28.10.2015;2015;10;12;Keskiviikko;3;1;4
94;28.10.2015;2015;10;13;Keskiviikko;5;3;8
94;28.10.2015;2015;10;14;Keskiviikko;3;6;9
94;28.10.2015;2015;10;15;Keskiviikko;1;9;10
94;28.10.2015;2015;10;16;Keskiviikko;2;14;16
94;28.10.2015;2015;10;17;Keskiviikko;0;4;4
94;28.10.2015;2015;10;18;Keskiviikko;2;4;6
94;28.10.2015;2015;10;19;Keskiviikko;6;7;13
94;28.10.2015;2015;10;20;Keskiviikko;1;0;1
94;28.10.2015;2015;10;21;Keskiviikko;0;1;1
94;28.10.2015;2015;10;22;Keskiviikko;0;3;3
94;28.10.2015;2015;10;23;Keskiviikko;0;1;1
94;29.10.2015;2015;10;00;Torstai;0;0;0
94;29.10.2015;2015;10;01;Torstai;0;0;0
94;29.10.2015;2015;10;02;Torstai;1;0;1
94;29.10.2015;2015;10;03;Torstai;0;0;0
94;29.10.2015;2015;10;04;Torstai;0;0;0
94;29.10.2015;2015;10;05;Torstai;3;1;4
94;29.10.2015;2015;10;06;Torstai;11;1;12
94;29.10.2015;2015;10;07;Torstai;12;2;14
94;29.10.2015;2015;10;08;Torstai;3;4;7
94;29.10.2015;2015;10;09;Torstai;1;0;1
94;29.10.2015;2015;10;10;Torstai;2;0;2
94;29.10.2015;2015;10;11;Torstai;2;2;4
94;29.10.2015;2015;10;12;Torstai;5;1;6
94;29.10.2015;2015;10;13;Torstai;4;3;7
94;29.10.2015;2015;10;14;Torstai;3;2;5
94;29.10.2015;2015;10;15;Torstai;2;14;16
94;29.10.2015;2015;10;16;Torstai;5;7;12
94;29.10.2015;2015;10;17;Torstai;2;6;8
94;29.10.2015;2015;10;18;Torstai;1;3;4
94;29.10.2015;2015;10;19;Torstai;0;0;0
94;29.10.2015;2015;10;20;Torstai;1;4;5
94;29.10.2015;2015;10;21;Torstai;0;1;1
94;29.10.2015;2015;10;22;Torstai;0;5;5
94;29.10.2015;2015;10;23;Torstai;0;0;0
94;30.10.2015;2015;10;00;Perjantai;0;0;0
94;30.10.2015;2015;10;01;Perjantai;0;0;0
94;30.10.2015;2015;10;02;Perjantai;0;0;0
94;30.10.2015;2015;10;03;Perjantai;0;0;0
94;30.10.2015;2015;10;04;Perjantai;0;0;0
94;30.10.2015;2015;10;05;Perjantai;2;0;2
94;30.10.2015;2015;10;06;Perjantai;4;1;5
94;30.10.2015;2015;10;07;Perjantai;15;1;16
94;30.10.2015;2015;10;08;Perjantai;7;1;8
94;30.10.2015;2015;10;09;Perjantai;3;1;4
94;30.10.2015;2015;10;10;Perjantai;3;2;5
94;30.10.2015;2015;10;11;Perjantai;2;0;2
94;30.10.2015;2015;10;12;Perjantai;2;1;3
94;30.10.2015;2015;10;13;Perjantai;6;2;8
94;30.10.2015;2015;10;14;Perjantai;2;7;9
94;30.10.2015;2015;10;15;Perjantai;2;6;8
94;30.10.2015;2015;10;16;Perjantai;2;8;10
94;30.10.2015;2015;10;17;Perjantai;3;5;8
94;30.10.2015;2015;10;18;Perjantai;1;6;7
94;30.10.2015;2015;10;19;Perjantai;1;3;4
94;30.10.2015;2015;10;20;Perjantai;0;2;2
94;30.10.2015;2015;10;21;Perjantai;1;2;3
94;30.10.2015;2015;10;22;Perjantai;0;4;4
94;30.10.2015;2015;10;23;Perjantai;0;0;0
94;31.10.2015;2015;10;00;Lauantai;1;0;1
94;31.10.2015;2015;10;01;Lauantai;0;0;0
94;31.10.2015;2015;10;02;Lauantai;0;0;0
94;31.10.2015;2015;10;03;Lauantai;0;0;0
94;31.10.2015;2015;10;04;Lauantai;0;0;0
94;31.10.2015;2015;10;05;Lauantai;0;0;0
94;31.10.2015;2015;10;06;Lauantai;1;0;1
94;31.10.2015;2015;10;07;Lauantai;1;2;3
94;31.10.2015;2015;10;08;Lauantai;0;2;2
94;31.10.2015;2015;10;09;Lauantai;1;1;2
94;31.10.2015;2015;10;10;Lauantai;0;2;2
94;31.10.2015;2015;10;11;Lauantai;2;3;5
94;31.10.2015;2015;10;12;Lauantai;1;0;1
94;31.10.2015;2015;10;13;Lauantai;2;0;2
94;31.10.2015;2015;10;14;Lauantai;1;3;4
94;31.10.2015;2015;10;15;Lauantai;10;3;13
94;31.10.2015;2015;10;16;Lauantai;1;3;4
94;31.10.2015;2015;10;17;Lauantai;3;3;6
94;31.10.2015;2015;10;18;Lauantai;1;1;2
94;31.10.2015;2015;10;19;Lauantai;3;0;3
94;31.10.2015;2015;10;20;Lauantai;0;1;1
94;31.10.2015;2015;10;21;Lauantai;0;0;0
94;31.10.2015;2015;10;22;Lauantai;0;0;0
94;31.10.2015;2015;10;23;Lauantai;0;0;0
94;01.11.2015;2015;11;00;Sunnuntai;0;0;0
94;01.11.2015;2015;11;01;Sunnuntai;0;0;0
94;01.11.2015;2015;11;02;Sunnuntai;0;0;0
94;01.11.2015;2015;11;03;Sunnuntai;0;0;0
94;01.11.2015;2015;11;04;Sunnuntai;0;0;0
94;01.11.2015;2015;11;05;Sunnuntai;0;0;0
94;01.11.2015;2015;11;06;Sunnuntai;1;0;1
94;01.11.2015;2015;11;07;Sunnuntai;0;0;0
94;01.11.2015;2015;11;08;Sunnuntai;1;4;5
94;01.11.2015;2015;11;09;Sunnuntai;1;1;2
94;01.11.2015;2015;11;10;Sunnuntai;1;2;3
94;01.11.2015;2015;11;11;Sunnuntai;6;1;7
94;01.11.2015;2015;11;12;Sunnuntai;1;0;1
94;01.11.2015;2015;11;13;Sunnuntai;1;3;4
94;01.11.2015;2015;11;14;Sunnuntai;4;8;12
94;01.11.2015;2015;11;15;Sunnuntai;9;3;12
94;01.11.2015;2015;11;16;Sunnuntai;3;4;7
94;01.11.2015;2015;11;17;Sunnuntai;2;2;4
94;01.11.2015;2015;11;18;Sunnuntai;2;7;9
94;01.11.2015;2015;11;19;Sunnuntai;2;1;3
94;01.11.2015;2015;11;20;Sunnuntai;1;1;2
94;01.11.2015;2015;11;21;Sunnuntai;0;1;1
94;01.11.2015;2015;11;22;Sunnuntai;0;0;0
94;01.11.2015;2015;11;23;Sunnuntai;0;0;0
94;02.11.2015;2015;11;00;Maanantai;0;0;0
94;02.11.2015;2015;11;01;Maanantai;0;0;0
94;02.11.2015;2015;11;02;Maanantai;0;0;0
94;02.11.2015;2015;11;03;Maanantai;0;0;0
94;02.11.2015;2015;11;04;Maanantai;0;0;0
94;02.11.2015;2015;11;05;Maanantai;3;2;5
94;02.11.2015;2015;11;06;Maanantai;12;1;13
94;02.11.2015;2015;11;07;Maanantai;16;2;18
94;02.11.2015;2015;11;08;Maanantai;5;2;7
94;02.11.2015;2015;11;09;Maanantai;1;2;3
94;02.11.2015;2015;11;10;Maanantai;2;1;3
94;02.11.2015;2015;11;11;Maanantai;3;3;6
94;02.11.2015;2015;11;12;Maanantai;3;4;7
94;02.11.2015;2015;11;13;Maanantai;1;1;2
94;02.11.2015;2015;11;14;Maanantai;5;5;10
94;02.11.2015;2015;11;15;Maanantai;3;14;17
94;02.11.2015;2015;11;16;Maanantai;3;16;19
94;02.11.2015;2015;11;17;Maanantai;0;5;5
94;02.11.2015;2015;11;18;Maanantai;3;5;8
94;02.11.2015;2015;11;19;Maanantai;0;1;1
94;02.11.2015;2015;11;20;Maanantai;2;4;6
94;02.11.2015;2015;11;21;Maanantai;1;3;4
94;02.11.2015;2015;11;22;Maanantai;0;0;0
94;02.11.2015;2015;11;23;Maanantai;0;0;0
94;03.11.2015;2015;11;00;Tiistai;0;0;0
94;03.11.2015;2015;11;01;Tiistai;0;0;0
94;03.11.2015;2015;11;02;Tiistai;0;0;0
94;03.11.2015;2015;11;03;Tiistai;0;0;0
94;03.11.2015;2015;11;04;Tiistai;2;1;3
94;03.11.2015;2015;11;05;Tiistai;5;1;6
94;03.11.2015;2015;11;06;Tiistai;10;1;11
94;03.11.2015;2015;11;07;Tiistai;16;2;18
94;03.11.2015;2015;11;08;Tiistai;4;4;8
94;03.11.2015;2015;11;09;Tiistai;2;2;4
94;03.11.2015;2015;11;10;Tiistai;4;0;4
94;03.11.2015;2015;11;11;Tiistai;3;1;4
94;03.11.2015;2015;11;12;Tiistai;2;3;5
94;03.11.2015;2015;11;13;Tiistai;5;4;9
94;03.11.2015;2015;11;14;Tiistai;4;4;8
94;03.11.2015;2015;11;15;Tiistai;4;15;19
94;03.11.2015;2015;11;16;Tiistai;8;13;21
94;03.11.2015;2015;11;17;Tiistai;1;9;10
94;03.11.2015;2015;11;18;Tiistai;2;3;5
94;03.11.2015;2015;11;19;Tiistai;0;3;3
94;03.11.2015;2015;11;20;Tiistai;2;2;4
94;03.11.2015;2015;11;21;Tiistai;0;1;1
94;03.11.2015;2015;11;22;Tiistai;0;1;1
94;03.11.2015;2015;11;23;Tiistai;0;0;0
94;04.11.2015;2015;11;00;Keskiviikko;0;0;0
94;04.11.2015;2015;11;01;Keskiviikko;0;0;0
94;04.11.2015;2015;11;02;Keskiviikko;0;0;0
94;04.11.2015;2015;11;03;Keskiviikko;0;0;0
94;04.11.2015;2015;11;04;Keskiviikko;1;1;2
94;04.11.2015;2015;11;05;Keskiviikko;4;1;5
94;04.11.2015;2015;11;06;Keskiviikko;15;1;16
94;04.11.2015;2015;11;07;Keskiviikko;12;2;14
94;04.11.2015;2015;11;08;Keskiviikko;7;2;9
94;04.11.2015;2015;11;09;Keskiviikko;1;1;2
94;04.11.2015;2015;11;10;Keskiviikko;4;3;7
94;04.11.2015;2015;11;11;Keskiviikko;2;3;5
94;04.11.2015;2015;11;12;Keskiviikko;7;1;8
94;04.11.2015;2015;11;13;Keskiviikko;5;1;6
94;04.11.2015;2015;11;14;Keskiviikko;4;9;13
94;04.11.2015;2015;11;15;Keskiviikko;1;9;10
94;04.11.2015;2015;11;16;Keskiviikko;7;11;18
94;04.11.2015;2015;11;17;Keskiviikko;0;13;13
94;04.11.2015;2015;11;18;Keskiviikko;1;3;4
94;04.11.2015;2015;11;19;Keskiviikko;2;3;5
94;04.11.2015;2015;11;20;Keskiviikko;2;2;4
94;04.11.2015;2015;11;21;Keskiviikko;1;3;4
94;04.11.2015;2015;11;22;Keskiviikko;0;1;1
94;04.11.2015;2015;11;23;Keskiviikko;0;0;0
94;05.11.2015;2015;11;00;Torstai;0;0;0
94;05.11.2015;2015;11;01;Torstai;0;0;0
94;05.11.2015;2015;11;02;Torstai;0;0;0
94;05.11.2015;2015;11;03;Torstai;0;0;0
94;05.11.2015;2015;11;04;Torstai;0;0;0
94;05.11.2015;2015;11;05;Torstai;3;0;3
94;05.11.2015;2015;11;06;Torstai;12;2;14
94;05.11.2015;2015;11;07;Torstai;12;2;14
94;05.11.2015;2015;11;08;Torstai;6;3;9
94;05.11.2015;2015;11;09;Torstai;0;1;1
94;05.11.2015;2015;11;10;Torstai;1;0;1
94;05.11.2015;2015;11;11;Torstai;1;1;2
94;05.11.2015;2015;11;12;Torstai;4;0;4
94;05.11.2015;2015;11;13;Torstai;0;2;2
94;05.11.2015;2015;11;14;Torstai;1;8;9
94;05.11.2015;2015;11;15;Torstai;4;10;14
94;05.11.2015;2015;11;16;Torstai;2;6;8
94;05.11.2015;2015;11;17;Torstai;2;3;5
94;05.11.2015;2015;11;18;Torstai;0;3;3
94;05.11.2015;2015;11;19;Torstai;0;1;1
94;05.11.2015;2015;11;20;Torstai;2;3;5
94;05.11.2015;2015;11;21;Torstai;0;3;3
94;05.11.2015;2015;11;22;Torstai;0;0;0
94;05.11.2015;2015;11;23;Torstai;0;0;0
94;06.11.2015;2015;11;00;Perjantai;0;0;0
94;06.11.2015;2015;11;01;Perjantai;0;0;0
94;06.11.2015;2015;11;02;Perjantai;0;1;1
94;06.11.2015;2015;11;03;Perjantai;0;0;0
94;06.11.2015;2015;11;04;Perjantai;0;0;0
94;06.11.2015;2015;11;05;Perjantai;5;0;5
94;06.11.2015;2015;11;06;Perjantai;8;2;10
94;06.11.2015;2015;11;07;Perjantai;10;0;10
94;06.11.2015;2015;11;08;Perjantai;4;3;7
94;06.11.2015;2015;11;09;Perjantai;1;0;1
94;06.11.2015;2015;11;10;Perjantai;3;1;4
94;06.11.2015;2015;11;11;Perjantai;1;2;3
94;06.11.2015;2015;11;12;Perjantai;2;1;3
94;06.11.2015;2015;11;13;Perjantai;1;1;2
94;06.11.2015;2015;11;14;Perjantai;4;8;12
94;06.11.2015;2015;11;15;Perjantai;6;11;17
94;06.11.2015;2015;11;16;Perjantai;2;8;10
94;06.11.2015;2015;11;17;Perjantai;1;3;4
94;06.11.2015;2015;11;18;Perjantai;2;3;5
94;06.11.2015;2015;11;19;Perjantai;0;3;3
94;06.11.2015;2015;11;20;Perjantai;0;0;0
94;06.11.2015;2015;11;21;Perjantai;0;1;1
94;06.11.2015;2015;11;22;Perjantai;0;0;0
94;06.11.2015;2015;11;23;Perjantai;0;0;0
94;07.11.2015;2015;11;00;Lauantai;0;0;0
94;07.11.2015;2015;11;01;Lauantai;0;0;0
94;07.11.2015;2015;11;02;Lauantai;0;0;0
94;07.11.2015;2015;11;03;Lauantai;0;0;0
94;07.11.2015;2015;11;04;Lauantai;0;0;0
94;07.11.2015;2015;11;05;Lauantai;0;0;0
94;07.11.2015;2015;11;06;Lauantai;0;0;0
94;07.11.2015;2015;11;07;Lauantai;1;0;1
94;07.11.2015;2015;11;08;Lauantai;0;0;0
94;07.11.2015;2015;11;09;Lauantai;0;0;0
94;07.11.2015;2015;11;10;Lauantai;2;4;6
94;07.11.2015;2015;11;11;Lauantai;4;3;7
94;07.11.2015;2015;11;12;Lauantai;1;1;2
94;07.11.2015;2015;11;13;Lauantai;2;0;2
94;07.11.2015;2015;11;14;Lauantai;0;1;1
94;07.11.2015;2015;11;15;Lauantai;1;1;2
94;07.11.2015;2015;11;16;Lauantai;2;1;3
94;07.11.2015;2015;11;17;Lauantai;1;0;1
94;07.11.2015;2015;11;18;Lauantai;1;2;3
94;07.11.2015;2015;11;19;Lauantai;0;0;0
94;07.11.2015;2015;11;20;Lauantai;0;1;1
94;07.11.2015;2015;11;21;Lauantai;0;1;1
94;07.11.2015;2015;11;22;Lauantai;0;0;0
94;07.11.2015;2015;11;23;Lauantai;0;0;0
94;08.11.2015;2015;11;00;Sunnuntai;0;0;0
94;08.11.2015;2015;11;01;Sunnuntai;0;0;0
94;08.11.2015;2015;11;02;Sunnuntai;0;0;0
94;08.11.2015;2015;11;03;Sunnuntai;0;0;0
94;08.11.2015;2015;11;04;Sunnuntai;0;0;0
94;08.11.2015;2015;11;05;Sunnuntai;0;0;0
94;08.11.2015;2015;11;06;Sunnuntai;0;1;1
94;08.11.2015;2015;11;07;Sunnuntai;0;1;1
94;08.11.2015;2015;11;08;Sunnuntai;1;0;1
94;08.11.2015;2015;11;09;Sunnuntai;3;1;4
94;08.11.2015;2015;11;10;Sunnuntai;0;4;4
94;08.11.2015;2015;11;11;Sunnuntai;0;0;0
94;08.11.2015;2015;11;12;Sunnuntai;3;4;7
94;08.11.2015;2015;11;13;Sunnuntai;1;1;2
94;08.11.2015;2015;11;14;Sunnuntai;4;6;10
94;08.11.2015;2015;11;15;Sunnuntai;1;3;4
94;08.11.2015;2015;11;16;Sunnuntai;4;1;5
94;08.11.2015;2015;11;17;Sunnuntai;1;1;2
94;08.11.2015;2015;11;18;Sunnuntai;1;0;1
94;08.11.2015;2015;11;19;Sunnuntai;3;1;4
94;08.11.2015;2015;11;20;Sunnuntai;1;2;3
94;08.11.2015;2015;11;21;Sunnuntai;0;0;0
94;08.11.2015;2015;11;22;Sunnuntai;0;1;1
94;08.11.2015;2015;11;23;Sunnuntai;0;0;0
94;09.11.2015;2015;11;00;Maanantai;0;0;0
94;09.11.2015;2015;11;01;Maanantai;0;0;0
94;09.11.2015;2015;11;02;Maanantai;0;0;0
94;09.11.2015;2015;11;03;Maanantai;0;0;0
94;09.11.2015;2015;11;04;Maanantai;0;1;1
94;09.11.2015;2015;11;05;Maanantai;6;0;6
94;09.11.2015;2015;11;06;Maanantai;10;1;11
94;09.11.2015;2015;11;07;Maanantai;14;2;16
94;09.11.2015;2015;11;08;Maanantai;11;3;14
94;09.11.2015;2015;11;09;Maanantai;0;1;1
94;09.11.2015;2015;11;10;Maanantai;2;1;3
94;09.11.2015;2015;11;11;Maanantai;3;2;5
94;09.11.2015;2015;11;12;Maanantai;4;2;6
94;09.11.2015;2015;11;13;Maanantai;4;4;8
94;09.11.2015;2015;11;14;Maanantai;3;3;6
94;09.11.2015;2015;11;15;Maanantai;1;15;16
94;09.11.2015;2015;11;16;Maanantai;3;14;17
94;09.11.2015;2015;11;17;Maanantai;1;7;8
94;09.11.2015;2015;11;18;Maanantai;2;6;8
94;09.11.2015;2015;11;19;Maanantai;1;3;4
94;09.11.2015;2015;11;20;Maanantai;0;1;1
94;09.11.2015;2015;11;21;Maanantai;1;2;3
94;09.11.2015;2015;11;22;Maanantai;0;1;1
94;09.11.2015;2015;11;23;Maanantai;0;0;0
94;10.11.2015;2015;11;00;Tiistai;0;0;0
94;10.11.2015;2015;11;01;Tiistai;0;0;0
94;10.11.2015;2015;11;02;Tiistai;0;0;0
94;10.11.2015;2015;11;03;Tiistai;0;0;0
94;10.11.2015;2015;11;04;Tiistai;0;0;0
94;10.11.2015;2015;11;05;Tiistai;6;1;7
94;10.11.2015;2015;11;06;Tiistai;8;1;9
94;10.11.2015;2015;11;07;Tiistai;7;3;10
94;10.11.2015;2015;11;08;Tiistai;4;3;7
94;10.11.2015;2015;11;09;Tiistai;0;0;0
94;10.11.2015;2015;11;10;Tiistai;2;1;3
94;10.11.2015;2015;11;11;Tiistai;1;2;3
94;10.11.2015;2015;11;12;Tiistai;1;0;1
94;10.11.2015;2015;11;13;Tiistai;2;0;2
94;10.11.2015;2015;11;14;Tiistai;3;3;6
94;10.11.2015;2015;11;15;Tiistai;0;8;8
94;10.11.2015;2015;11;16;Tiistai;2;8;10
94;10.11.2015;2015;11;17;Tiistai;0;4;4
94;10.11.2015;2015;11;18;Tiistai;1;1;2
94;10.11.2015;2015;11;19;Tiistai;3;2;5
94;10.11.2015;2015;11;20;Tiistai;0;2;2
94;10.11.2015;2015;11;21;Tiistai;1;1;2
94;10.11.2015;2015;11;22;Tiistai;0;0;0
94;10.11.2015;2015;11;23;Tiistai;0;0;0
94;11.11.2015;2015;11;00;Keskiviikko;0;0;0
94;11.11.2015;2015;11;01;Keskiviikko;0;0;0
94;11.11.2015;2015;11;02;Keskiviikko;0;0;0
94;11.11.2015;2015;11;03;Keskiviikko;0;0;0
94;11.11.2015;2015;11;04;Keskiviikko;0;0;0
94;11.11.2015;2015;11;05;Keskiviikko;6;1;7
94;11.11.2015;2015;11;06;Keskiviikko;5;1;6
94;11.11.2015;2015;11;07;Keskiviikko;9;1;10
94;11.11.2015;2015;11;08;Keskiviikko;5;3;8
94;11.11.2015;2015;11;09;Keskiviikko;1;0;1
94;11.11.2015;2015;11;10;Keskiviikko;1;2;3
94;11.11.2015;2015;11;11;Keskiviikko;2;3;5
94;11.11.2015;2015;11;12;Keskiviikko;2;2;4
94;11.11.2015;2015;11;13;Keskiviikko;4;2;6
94;11.11.2015;2015;11;14;Keskiviikko;5;7;12
94;11.11.2015;2015;11;15;Keskiviikko;1;6;7
94;11.11.2015;2015;11;16;Keskiviikko;2;4;6
94;11.11.2015;2015;11;17;Keskiviikko;1;3;4
94;11.11.2015;2015;11;18;Keskiviikko;2;3;5
94;11.11.2015;2015;11;19;Keskiviikko;5;2;7
94;11.11.2015;2015;11;20;Keskiviikko;0;2;2
94;11.11.2015;2015;11;21;Keskiviikko;0;2;2
94;11.11.2015;2015;11;22;Keskiviikko;0;1;1
94;11.11.2015;2015;11;23;Keskiviikko;0;0;0
94;12.11.2015;2015;11;00;Torstai;0;0;0
94;12.11.2015;2015;11;01;Torstai;0;0;0
94;12.11.2015;2015;11;02;Torstai;0;0;0
94;12.11.2015;2015;11;03;Torstai;0;0;0
94;12.11.2015;2015;11;04;Torstai;0;0;0
94;12.11.2015;2015;11;05;Torstai;3;0;3
94;12.11.2015;2015;11;06;Torstai;8;1;9
94;12.11.2015;2015;11;07;Torstai;13;2;15
94;12.11.2015;2015;11;08;Torstai;7;3;10
94;12.11.2015;2015;11;09;Torstai;2;0;2
94;12.11.2015;2015;11;10;Torstai;1;3;4
94;12.11.2015;2015;11;11;Torstai;2;1;3
94;12.11.2015;2015;11;12;Torstai;4;2;6
94;12.11.2015;2015;11;13;Torstai;1;0;1
94;12.11.2015;2015;11;14;Torstai;0;5;5
94;12.11.2015;2015;11;15;Torstai;2;9;11
94;12.11.2015;2015;11;16;Torstai;3;9;12
94;12.11.2015;2015;11;17;Torstai;0;7;7
94;12.11.2015;2015;11;18;Torstai;0;0;0
94;12.11.2015;2015;11;19;Torstai;1;1;2
94;12.11.2015;2015;11;20;Torstai;0;4;4
94;12.11.2015;2015;11;21;Torstai;0;3;3
94;12.11.2015;2015;11;22;Torstai;0;0;0
94;12.11.2015;2015;11;23;Torstai;0;0;0
94;13.11.2015;2015;11;00;Perjantai;0;1;1
94;13.11.2015;2015;11;01;Perjantai;0;0;0
94;13.11.2015;2015;11;02;Perjantai;0;0;0
94;13.11.2015;2015;11;03;Perjantai;0;0;0
94;13.11.2015;2015;11;04;Perjantai;1;0;1
94;13.11.2015;2015;11;05;Perjantai;5;1;6
94;13.11.2015;2015;11;06;Perjantai;3;2;5
94;13.11.2015;2015;11;07;Perjantai;6;1;7
94;13.11.2015;2015;11;08;Perjantai;7;0;7
94;13.11.2015;2015;11;09;Perjantai;2;1;3
94;13.11.2015;2015;11;10;Perjantai;1;0;1
94;13.11.2015;2015;11;11;Perjantai;4;1;5
94;13.11.2015;2015;11;12;Perjantai;1;0;1
94;13.11.2015;2015;11;13;Perjantai;2;4;6
94;13.11.2015;2015;11;14;Perjantai;5;6;11
94;13.11.2015;2015;11;15;Perjantai;1;6;7
94;13.11.2015;2015;11;16;Perjantai;2;9;11
94;13.11.2015;2015;11;17;Perjantai;1;2;3
94;13.11.2015;2015;11;18;Perjantai;1;4;5
94;13.11.2015;2015;11;19;Perjantai;0;1;1
94;13.11.2015;2015;11;20;Perjantai;0;1;1
94;13.11.2015;2015;11;21;Perjantai;0;0;0
94;13.11.2015;2015;11;22;Perjantai;0;1;1
94;13.11.2015;2015;11;23;Perjantai;0;1;1
94;14.11.2015;2015;11;00;Lauantai;0;0;0
94;14.11.2015;2015;11;01;Lauantai;0;0;0
94;14.11.2015;2015;11;02;Lauantai;0;0;0
94;14.11.2015;2015;11;03;Lauantai;0;0;0
94;14.11.2015;2015;11;04;Lauantai;1;0;1
94;14.11.2015;2015;11;05;Lauantai;0;0;0
94;14.11.2015;2015;11;06;Lauantai;0;1;1
94;14.11.2015;2015;11;07;Lauantai;0;2;2
94;14.11.2015;2015;11;08;Lauantai;0;0;0
94;14.11.2015;2015;11;09;Lauantai;0;0;0
94;14.11.2015;2015;11;10;Lauantai;1;0;1
94;14.11.2015;2015;11;11;Lauantai;2;1;3
94;14.11.2015;2015;11;12;Lauantai;0;1;1
94;14.11.2015;2015;11;13;Lauantai;5;0;5
94;14.11.2015;2015;11;14;Lauantai;2;1;3
94;14.11.2015;2015;11;15;Lauantai;0;2;2
94;14.11.2015;2015;11;16;Lauantai;4;5;9
94;14.11.2015;2015;11;17;Lauantai;2;2;4
94;14.11.2015;2015;11;18;Lauantai;2;2;4
94;14.11.2015;2015;11;19;Lauantai;4;0;4
94;14.11.2015;2015;11;20;Lauantai;1;1;2
94;14.11.2015;2015;11;21;Lauantai;0;3;3
94;14.11.2015;2015;11;22;Lauantai;0;0;0
94;14.11.2015;2015;11;23;Lauantai;0;0;0
94;15.11.2015;2015;11;00;Sunnuntai;0;0;0
94;15.11.2015;2015;11;01;Sunnuntai;0;0;0
94;15.11.2015;2015;11;02;Sunnuntai;0;0;0
94;15.11.2015;2015;11;03;Sunnuntai;0;0;0
94;15.11.2015;2015;11;04;Sunnuntai;0;0;0
94;15.11.2015;2015;11;05;Sunnuntai;1;0;1
94;15.11.2015;2015;11;06;Sunnuntai;0;0;0
94;15.11.2015;2015;11;07;Sunnuntai;0;1;1
94;15.11.2015;2015;11;08;Sunnuntai;0;0;0
94;15.11.2015;2015;11;09;Sunnuntai;2;1;3
94;15.11.2015;2015;11;10;Sunnuntai;1;0;1
94;15.11.2015;2015;11;11;Sunnuntai;3;0;3
94;15.11.2015;2015;11;12;Sunnuntai;1;5;6
94;15.11.2015;2015;11;13;Sunnuntai;4;1;5
94;15.11.2015;2015;11;14;Sunnuntai;4;1;5
94;15.11.2015;2015;11;15;Sunnuntai;4;4;8
94;15.11.2015;2015;11;16;Sunnuntai;2;4;6
94;15.11.2015;2015;11;17;Sunnuntai;0;6;6
94;15.11.2015;2015;11;18;Sunnuntai;2;1;3
94;15.11.2015;2015;11;19;Sunnuntai;1;3;4
94;15.11.2015;2015;11;20;Sunnuntai;0;0;0
94;15.11.2015;2015;11;21;Sunnuntai;0;0;0
94;15.11.2015;2015;11;22;Sunnuntai;0;0;0
94;15.11.2015;2015;11;23;Sunnuntai;0;0;0
94;16.11.2015;2015;11;00;Maanantai;0;0;0
94;16.11.2015;2015;11;01;Maanantai;0;0;0
94;16.11.2015;2015;11;02;Maanantai;0;0;0
94;16.11.2015;2015;11;03;Maanantai;0;0;0
94;16.11.2015;2015;11;04;Maanantai;0;1;1
94;16.11.2015;2015;11;05;Maanantai;2;1;3
94;16.11.2015;2015;11;06;Maanantai;12;0;12
94;16.11.2015;2015;11;07;Maanantai;7;1;8
94;16.11.2015;2015;11;08;Maanantai;5;2;7
94;16.11.2015;2015;11;09;Maanantai;1;1;2
94;16.11.2015;2015;11;10;Maanantai;1;0;1
94;16.11.2015;2015;11;11;Maanantai;3;0;3
94;16.11.2015;2015;11;12;Maanantai;2;2;4
94;16.11.2015;2015;11;13;Maanantai;3;1;4
94;16.11.2015;2015;11;14;Maanantai;3;6;9
94;16.11.2015;2015;11;15;Maanantai;2;9;11
94;16.11.2015;2015;11;16;Maanantai;3;10;13
94;16.11.2015;2015;11;17;Maanantai;2;5;7
94;16.11.2015;2015;11;18;Maanantai;1;1;2
94;16.11.2015;2015;11;19;Maanantai;1;1;2
94;16.11.2015;2015;11;20;Maanantai;0;0;0
94;16.11.2015;2015;11;21;Maanantai;0;3;3
94;16.11.2015;2015;11;22;Maanantai;0;2;2
94;16.11.2015;2015;11;23;Maanantai;0;0;0
94;17.11.2015;2015;11;00;Tiistai;0;0;0
94;17.11.2015;2015;11;01;Tiistai;0;0;0
94;17.11.2015;2015;11;02;Tiistai;0;0;0
94;17.11.2015;2015;11;03;Tiistai;0;0;0
94;17.11.2015;2015;11;04;Tiistai;0;0;0
94;17.11.2015;2015;11;05;Tiistai;2;2;4
94;17.11.2015;2015;11;06;Tiistai;9;0;9
94;17.11.2015;2015;11;07;Tiistai;5;2;7
94;17.11.2015;2015;11;08;Tiistai;9;3;12
94;17.11.2015;2015;11;09;Tiistai;2;0;2
94;17.11.2015;2015;11;10;Tiistai;1;1;2
94;17.11.2015;2015;11;11;Tiistai;2;1;3
94;17.11.2015;2015;11;12;Tiistai;1;1;2
94;17.11.2015;2015;11;13;Tiistai;2;0;2
94;17.11.2015;2015;11;14;Tiistai;3;6;9
94;17.11.2015;2015;11;15;Tiistai;0;10;10
94;17.11.2015;2015;11;16;Tiistai;3;6;9
94;17.11.2015;2015;11;17;Tiistai;1;5;6
94;17.11.2015;2015;11;18;Tiistai;0;2;2
94;17.11.2015;2015;11;19;Tiistai;1;2;3
94;17.11.2015;2015;11;20;Tiistai;2;3;5
94;17.11.2015;2015;11;21;Tiistai;0;1;1
94;17.11.2015;2015;11;22;Tiistai;0;3;3
94;17.11.2015;2015;11;23;Tiistai;0;0;0
94;18.11.2015;2015;11;00;Keskiviikko;0;0;0
94;18.11.2015;2015;11;01;Keskiviikko;0;0;0
94;18.11.2015;2015;11;02;Keskiviikko;0;0;0
94;18.11.2015;2015;11;03;Keskiviikko;0;0;0
94;18.11.2015;2015;11;04;Keskiviikko;0;0;0
94;18.11.2015;2015;11;05;Keskiviikko;3;1;4
94;18.11.2015;2015;11;06;Keskiviikko;8;0;8
94;18.11.2015;2015;11;07;Keskiviikko;11;1;12
94;18.11.2015;2015;11;08;Keskiviikko;6;1;7
94;18.11.2015;2015;11;09;Keskiviikko;5;0;5
94;18.11.2015;2015;11;10;Keskiviikko;3;2;5
94;18.11.2015;2015;11;11;Keskiviikko;2;0;2
94;18.11.2015;2015;11;12;Keskiviikko;1;2;3
94;18.11.2015;2015;11;13;Keskiviikko;3;3;6
94;18.11.2015;2015;11;14;Keskiviikko;3;4;7
94;18.11.2015;2015;11;15;Keskiviikko;1;10;11
94;18.11.2015;2015;11;16;Keskiviikko;5;12;17
94;18.11.2015;2015;11;17;Keskiviikko;1;3;4
94;18.11.2015;2015;11;18;Keskiviikko;1;3;4
94;18.11.2015;2015;11;19;Keskiviikko;1;2;3
94;18.11.2015;2015;11;20;Keskiviikko;1;3;4
94;18.11.2015;2015;11;21;Keskiviikko;0;3;3
94;18.11.2015;2015;11;22;Keskiviikko;0;2;2
94;18.11.2015;2015;11;23;Keskiviikko;0;0;0
94;19.11.2015;2015;11;00;Torstai;0;0;0
94;19.11.2015;2015;11;01;Torstai;0;0;0
94;19.11.2015;2015;11;02;Torstai;0;0;0
94;19.11.2015;2015;11;03;Torstai;0;0;0
94;19.11.2015;2015;11;04;Torstai;0;0;0
94;19.11.2015;2015;11;05;Torstai;3;1;4
94;19.11.2015;2015;11;06;Torstai;16;1;17
94;19.11.2015;2015;11;07;Torstai;5;4;9
94;19.11.2015;2015;11;08;Torstai;7;4;11
94;19.11.2015;2015;11;09;Torstai;1;1;2
94;19.11.2015;2015;11;10;Torstai;3;2;5
94;19.11.2015;2015;11;11;Torstai;3;1;4
94;19.11.2015;2015;11;12;Torstai;2;3;5
94;19.11.2015;2015;11;13;Torstai;2;1;3
94;19.11.2015;2015;11;14;Torstai;5;10;15
94;19.11.2015;2015;11;15;Torstai;3;5;8
94;19.11.2015;2015;11;16;Torstai;3;11;14
94;19.11.2015;2015;11;17;Torstai;1;7;8
94;19.11.2015;2015;11;18;Torstai;0;1;1
94;19.11.2015;2015;11;19;Torstai;0;2;2
94;19.11.2015;2015;11;20;Torstai;3;2;5
94;19.11.2015;2015;11;21;Torstai;0;1;1
94;19.11.2015;2015;11;22;Torstai;0;1;1
94;19.11.2015;2015;11;23;Torstai;0;0;0
94;20.11.2015;2015;11;00;Perjantai;0;0;0
94;20.11.2015;2015;11;01;Perjantai;0;0;0
94;20.11.2015;2015;11;02;Perjantai;0;0;0
94;20.11.2015;2015;11;03;Perjantai;0;0;0
94;20.11.2015;2015;11;04;Perjantai;0;0;0
94;20.11.2015;2015;11;05;Perjantai;4;0;4
94;20.11.2015;2015;11;06;Perjantai;10;0;10
94;20.11.2015;2015;11;07;Perjantai;7;2;9
94;20.11.2015;2015;11;08;Perjantai;5;2;7
94;20.11.2015;2015;11;09;Perjantai;1;0;1
94;20.11.2015;2015;11;10;Perjantai;3;1;4
94;20.11.2015;2015;11;11;Perjantai;1;3;4
94;20.11.2015;2015;11;12;Perjantai;0;1;1
94;20.11.2015;2015;11;13;Perjantai;0;2;2
94;20.11.2015;2015;11;14;Perjantai;3;8;11
94;20.11.2015;2015;11;15;Perjantai;0;6;6
94;20.11.2015;2015;11;16;Perjantai;2;10;12
94;20.11.2015;2015;11;17;Perjantai;1;3;4
94;20.11.2015;2015;11;18;Perjantai;1;3;4
94;20.11.2015;2015;11;19;Perjantai;0;0;0
94;20.11.2015;2015;11;20;Perjantai;2;0;2
94;20.11.2015;2015;11;21;Perjantai;0;0;0
94;20.11.2015;2015;11;22;Perjantai;0;1;1
94;20.11.2015;2015;11;23;Perjantai;0;0;0
94;21.11.2015;2015;11;00;Lauantai;0;0;0
94;21.11.2015;2015;11;01;Lauantai;0;0;0
94;21.11.2015;2015;11;02;Lauantai;0;0;0
94;21.11.2015;2015;11;03;Lauantai;0;2;2
94;21.11.2015;2015;11;04;Lauantai;0;0;0
94;21.11.2015;2015;11;05;Lauantai;1;0;1
94;21.11.2015;2015;11;06;Lauantai;0;0;0
94;21.11.2015;2015;11;07;Lauantai;1;0;1
94;21.11.2015;2015;11;08;Lauantai;0;2;2
94;21.11.2015;2015;11;09;Lauantai;3;0;3
94;21.11.2015;2015;11;10;Lauantai;0;2;2
94;21.11.2015;2015;11;11;Lauantai;2;0;2
94;21.11.2015;2015;11;12;Lauantai;0;1;1
94;21.11.2015;2015;11;13;Lauantai;0;0;0
94;21.11.2015;2015;11;14;Lauantai;1;1;2
94;21.11.2015;2015;11;15;Lauantai;1;1;2
94;21.11.2015;2015;11;16;Lauantai;1;0;1
94;21.11.2015;2015;11;17;Lauantai;1;1;2
94;21.11.2015;2015;11;18;Lauantai;0;1;1
94;21.11.2015;2015;11;19;Lauantai;1;2;3
94;21.11.2015;2015;11;20;Lauantai;0;0;0
94;21.11.2015;2015;11;21;Lauantai;1;1;2
94;21.11.2015;2015;11;22;Lauantai;0;0;0
94;21.11.2015;2015;11;23;Lauantai;0;0;0
94;22.11.2015;2015;11;00;Sunnuntai;0;1;1
94;22.11.2015;2015;11;01;Sunnuntai;0;0;0
94;22.11.2015;2015;11;02;Sunnuntai;0;0;0
94;22.11.2015;2015;11;03;Sunnuntai;0;0;0
94;22.11.2015;2015;11;04;Sunnuntai;0;0;0
94;22.11.2015;2015;11;05;Sunnuntai;0;0;0
94;22.11.2015;2015;11;06;Sunnuntai;1;0;1
94;22.11.2015;2015;11;07;Sunnuntai;0;0;0
94;22.11.2015;2015;11;08;Sunnuntai;1;0;1
94;22.11.2015;2015;11;09;Sunnuntai;1;0;1
94;22.11.2015;2015;11;10;Sunnuntai;1;0;1
94;22.11.2015;2015;11;11;Sunnuntai;0;1;1
94;22.11.2015;2015;11;12;Sunnuntai;1;1;2
94;22.11.2015;2015;11;13;Sunnuntai;2;2;4
94;22.11.2015;2015;11;14;Sunnuntai;3;1;4
94;22.11.2015;2015;11;15;Sunnuntai;0;4;4
94;22.11.2015;2015;11;16;Sunnuntai;0;1;1
94;22.11.2015;2015;11;17;Sunnuntai;1;2;3
94;22.11.2015;2015;11;18;Sunnuntai;0;0;0
94;22.11.2015;2015;11;19;Sunnuntai;0;1;1
94;22.11.2015;2015;11;20;Sunnuntai;0;0;0
94;22.11.2015;2015;11;21;Sunnuntai;0;0;0
94;22.11.2015;2015;11;22;Sunnuntai;0;0;0
94;22.11.2015;2015;11;23;Sunnuntai;0;0;0
94;23.11.2015;2015;11;00;Maanantai;0;0;0
94;23.11.2015;2015;11;01;Maanantai;0;0;0
94;23.11.2015;2015;11;02;Maanantai;0;0;0
94;23.11.2015;2015;11;03;Maanantai;0;0;0
94;23.11.2015;2015;11;04;Maanantai;0;0;0
94;23.11.2015;2015;11;05;Maanantai;3;0;3
94;23.11.2015;2015;11;06;Maanantai;8;0;8
94;23.11.2015;2015;11;07;Maanantai;8;0;8
94;23.11.2015;2015;11;08;Maanantai;7;1;8
94;23.11.2015;2015;11;09;Maanantai;1;0;1
94;23.11.2015;2015;11;10;Maanantai;1;0;1
94;23.11.2015;2015;11;11;Maanantai;0;0;0
94;23.11.2015;2015;11;12;Maanantai;2;1;3
94;23.11.2015;2015;11;13;Maanantai;0;1;1
94;23.11.2015;2015;11;14;Maanantai;1;4;5
94;23.11.2015;2015;11;15;Maanantai;4;9;13
94;23.11.2015;2015;11;16;Maanantai;2;9;11
94;23.11.2015;2015;11;17;Maanantai;0;3;3
94;23.11.2015;2015;11;18;Maanantai;1;3;4
94;23.11.2015;2015;11;19;Maanantai;0;2;2
94;23.11.2015;2015;11;20;Maanantai;0;1;1
94;23.11.2015;2015;11;21;Maanantai;0;1;1
94;23.11.2015;2015;11;22;Maanantai;0;0;0
94;23.11.2015;2015;11;23;Maanantai;0;1;1
94;24.11.2015;2015;11;00;Tiistai;0;0;0
94;24.11.2015;2015;11;01;Tiistai;0;0;0
94;24.11.2015;2015;11;02;Tiistai;0;0;0
94;24.11.2015;2015;11;03;Tiistai;0;0;0
94;24.11.2015;2015;11;04;Tiistai;0;0;0
94;24.11.2015;2015;11;05;Tiistai;2;1;3
94;24.11.2015;2015;11;06;Tiistai;10;1;11
94;24.11.2015;2015;11;07;Tiistai;9;1;10
94;24.11.2015;2015;11;08;Tiistai;5;3;8
94;24.11.2015;2015;11;09;Tiistai;1;1;2
94;24.11.2015;2015;11;10;Tiistai;3;0;3
94;24.11.2015;2015;11;11;Tiistai;1;0;1
94;24.11.2015;2015;11;12;Tiistai;1;1;2
94;24.11.2015;2015;11;13;Tiistai;2;1;3
94;24.11.2015;2015;11;14;Tiistai;3;7;10
94;24.11.2015;2015;11;15;Tiistai;0;13;13
94;24.11.2015;2015;11;16;Tiistai;3;7;10
94;24.11.2015;2015;11;17;Tiistai;0;7;7
94;24.11.2015;2015;11;18;Tiistai;1;2;3
94;24.11.2015;2015;11;19;Tiistai;1;6;7
94;24.11.2015;2015;11;20;Tiistai;1;2;3
94;24.11.2015;2015;11;21;Tiistai;2;2;4
94;24.11.2015;2015;11;22;Tiistai;0;1;1
94;24.11.2015;2015;11;23;Tiistai;1;0;1
94;25.11.2015;2015;11;00;Keskiviikko;0;0;0
94;25.11.2015;2015;11;01;Keskiviikko;0;0;0
94;25.11.2015;2015;11;02;Keskiviikko;0;0;0
94;25.11.2015;2015;11;03;Keskiviikko;0;0;0
94;25.11.2015;2015;11;04;Keskiviikko;0;0;0
94;25.11.2015;2015;11;05;Keskiviikko;2;1;3
94;25.11.2015;2015;11;06;Keskiviikko;9;0;9
94;25.11.2015;2015;11;07;Keskiviikko;9;1;10
94;25.11.2015;2015;11;08;Keskiviikko;3;2;5
94;25.11.2015;2015;11;09;Keskiviikko;2;0;2
94;25.11.2015;2015;11;10;Keskiviikko;2;1;3
94;25.11.2015;2015;11;11;Keskiviikko;1;0;1
94;25.11.2015;2015;11;12;Keskiviikko;0;0;0
94;25.11.2015;2015;11;13;Keskiviikko;2;2;4
94;25.11.2015;2015;11;14;Keskiviikko;1;4;5
94;25.11.2015;2015;11;15;Keskiviikko;1;13;14
94;25.11.2015;2015;11;16;Keskiviikko;3;10;13
94;25.11.2015;2015;11;17;Keskiviikko;1;4;5
94;25.11.2015;2015;11;18;Keskiviikko;0;4;4
94;25.11.2015;2015;11;19;Keskiviikko;1;0;1
94;25.11.2015;2015;11;20;Keskiviikko;0;4;4
94;25.11.2015;2015;11;21;Keskiviikko;0;1;1
94;25.11.2015;2015;11;22;Keskiviikko;0;0;0
94;25.11.2015;2015;11;23;Keskiviikko;0;1;1
94;26.11.2015;2015;11;00;Torstai;0;0;0
94;26.11.2015;2015;11;01;Torstai;0;0;0
94;26.11.2015;2015;11;02;Torstai;0;1;1
94;26.11.2015;2015;11;03;Torstai;0;0;0
94;26.11.2015;2015;11;04;Torstai;0;0;0
94;26.11.2015;2015;11;05;Torstai;3;1;4
94;26.11.2015;2015;11;06;Torstai;8;0;8
94;26.11.2015;2015;11;07;Torstai;12;0;12
94;26.11.2015;2015;11;08;Torstai;8;0;8
94;26.11.2015;2015;11;09;Torstai;0;0;0
94;26.11.2015;2015;11;10;Torstai;1;0;1
94;26.11.2015;2015;11;11;Torstai;1;3;4
94;26.11.2015;2015;11;12;Torstai;3;1;4
94;26.11.2015;2015;11;13;Torstai;4;0;4
94;26.11.2015;2015;11;14;Torstai;2;4;6
94;26.11.2015;2015;11;15;Torstai;3;13;16
94;26.11.2015;2015;11;16;Torstai;0;11;11
94;26.11.2015;2015;11;17;Torstai;1;7;8
94;26.11.2015;2015;11;18;Torstai;1;0;1
94;26.11.2015;2015;11;19;Torstai;1;3;4
94;26.11.2015;2015;11;20;Torstai;3;1;4
94;26.11.2015;2015;11;21;Torstai;1;1;2
94;26.11.2015;2015;11;22;Torstai;0;1;1
94;26.11.2015;2015;11;23;Torstai;0;1;1
94;27.11.2015;2015;11;00;Perjantai;0;0;0
94;27.11.2015;2015;11;01;Perjantai;0;0;0
94;27.11.2015;2015;11;02;Perjantai;0;0;0
94;27.11.2015;2015;11;03;Perjantai;0;0;0
94;27.11.2015;2015;11;04;Perjantai;0;0;0
94;27.11.2015;2015;11;05;Perjantai;0;1;1
94;27.11.2015;2015;11;06;Perjantai;2;0;2
94;27.11.2015;2015;11;07;Perjantai;5;2;7
94;27.11.2015;2015;11;08;Perjantai;2;2;4
94;27.11.2015;2015;11;09;Perjantai;2;1;3
94;27.11.2015;2015;11;10;Perjantai;3;1;4
94;27.11.2015;2015;11;11;Perjantai;1;1;2
94;27.11.2015;2015;11;12;Perjantai;3;0;3
94;27.11.2015;2015;11;13;Perjantai;1;3;4
94;27.11.2015;2015;11;14;Perjantai;2;8;10
94;27.11.2015;2015;11;15;Perjantai;2;5;7
94;27.11.2015;2015;11;16;Perjantai;4;9;13
94;27.11.2015;2015;11;17;Perjantai;4;3;7
94;27.11.2015;2015;11;18;Perjantai;3;1;4
94;27.11.2015;2015;11;19;Perjantai;0;3;3
94;27.11.2015;2015;11;20;Perjantai;0;0;0
94;27.11.2015;2015;11;21;Perjantai;0;0;0
94;27.11.2015;2015;11;22;Perjantai;2;1;3
94;27.11.2015;2015;11;23;Perjantai;0;1;1
94;28.11.2015;2015;11;00;Lauantai;0;1;1
94;28.11.2015;2015;11;01;Lauantai;0;0;0
94;28.11.2015;2015;11;02;Lauantai;0;0;0
94;28.11.2015;2015;11;03;Lauantai;0;1;1
94;28.11.2015;2015;11;04;Lauantai;0;0;0
94;28.11.2015;2015;11;05;Lauantai;1;0;1
94;28.11.2015;2015;11;06;Lauantai;0;1;1
94;28.11.2015;2015;11;07;Lauantai;0;0;0
94;28.11.2015;2015;11;08;Lauantai;0;0;0
94;28.11.2015;2015;11;09;Lauantai;1;0;1
94;28.11.2015;2015;11;10;Lauantai;1;0;1
94;28.11.2015;2015;11;11;Lauantai;1;0;1
94;28.11.2015;2015;11;12;Lauantai;0;1;1
94;28.11.2015;2015;11;13;Lauantai;0;0;0
94;28.11.2015;2015;11;14;Lauantai;0;0;0
94;28.11.2015;2015;11;15;Lauantai;0;1;1
94;28.11.2015;2015;11;16;Lauantai;0;3;3
94;28.11.2015;2015;11;17;Lauantai;1;0;1
94;28.11.2015;2015;11;18;Lauantai;1;1;2
94;28.11.2015;2015;11;19;Lauantai;0;0;0
94;28.11.2015;2015;11;20;Lauantai;0;1;1
94;28.11.2015;2015;11;21;Lauantai;0;0;0
94;28.11.2015;2015;11;22;Lauantai;0;0;0
94;28.11.2015;2015;11;23;Lauantai;0;0;0
94;29.11.2015;2015;11;00;Sunnuntai;0;0;0
94;29.11.2015;2015;11;01;Sunnuntai;0;0;0
94;29.11.2015;2015;11;02;Sunnuntai;0;0;0
94;29.11.2015;2015;11;03;Sunnuntai;0;0;0
94;29.11.2015;2015;11;04;Sunnuntai;0;0;0
94;29.11.2015;2015;11;05;Sunnuntai;0;0;0
94;29.11.2015;2015;11;06;Sunnuntai;0;0;0
94;29.11.2015;2015;11;07;Sunnuntai;1;0;1
94;29.11.2015;2015;11;08;Sunnuntai;0;0;0
94;29.11.2015;2015;11;09;Sunnuntai;2;0;2
94;29.11.2015;2015;11;10;Sunnuntai;1;1;2
94;29.11.2015;2015;11;11;Sunnuntai;5;0;5
94;29.11.2015;2015;11;12;Sunnuntai;3;1;4
94;29.11.2015;2015;11;13;Sunnuntai;1;3;4
94;29.11.2015;2015;11;14;Sunnuntai;2;9;11
94;29.11.2015;2015;11;15;Sunnuntai;2;2;4
94;29.11.2015;2015;11;16;Sunnuntai;6;1;7
94;29.11.2015;2015;11;17;Sunnuntai;2;0;2
94;29.11.2015;2015;11;18;Sunnuntai;0;2;2
94;29.11.2015;2015;11;19;Sunnuntai;0;0;0
94;29.11.2015;2015;11;20;Sunnuntai;0;0;0
94;29.11.2015;2015;11;21;Sunnuntai;0;0;0
94;29.11.2015;2015;11;22;Sunnuntai;1;0;1
94;29.11.2015;2015;11;23;Sunnuntai;0;0;0
94;30.11.2015;2015;11;00;Maanantai;0;1;1
94;30.11.2015;2015;11;01;Maanantai;0;0;0
94;30.11.2015;2015;11;02;Maanantai;0;0;0
94;30.11.2015;2015;11;03;Maanantai;0;0;0
94;30.11.2015;2015;11;04;Maanantai;0;0;0
94;30.11.2015;2015;11;05;Maanantai;4;2;6
94;30.11.2015;2015;11;06;Maanantai;10;0;10
94;30.11.2015;2015;11;07;Maanantai;10;0;10
94;30.11.2015;2015;11;08;Maanantai;6;1;7
94;30.11.2015;2015;11;09;Maanantai;0;0;0
94;30.11.2015;2015;11;10;Maanantai;1;0;1
94;30.11.2015;2015;11;11;Maanantai;3;1;4
94;30.11.2015;2015;11;12;Maanantai;2;1;3
94;30.11.2015;2015;11;13;Maanantai;2;0;2
94;30.11.2015;2015;11;14;Maanantai;3;5;8
94;30.11.2015;2015;11;15;Maanantai;1;11;12
94;30.11.2015;2015;11;16;Maanantai;2;11;13
94;30.11.2015;2015;11;17;Maanantai;1;2;3
94;30.11.2015;2015;11;18;Maanantai;0;1;1
94;30.11.2015;2015;11;19;Maanantai;1;2;3
94;30.11.2015;2015;11;20;Maanantai;3;1;4
94;30.11.2015;2015;11;21;Maanantai;0;1;1
94;30.11.2015;2015;11;22;Maanantai;0;0;0
94;30.11.2015;2015;11;23;Maanantai;0;0;0
94;01.12.2015;2015;12;00;Tiistai;0;0;0
94;01.12.2015;2015;12;01;Tiistai;0;0;0
94;01.12.2015;2015;12;02;Tiistai;0;1;1
94;01.12.2015;2015;12;03;Tiistai;0;0;0
94;01.12.2015;2015;12;04;Tiistai;0;0;0
94;01.12.2015;2015;12;05;Tiistai;6;2;8
94;01.12.2015;2015;12;06;Tiistai;5;0;5
94;01.12.2015;2015;12;07;Tiistai;12;2;14
94;01.12.2015;2015;12;08;Tiistai;5;3;8
94;01.12.2015;2015;12;09;Tiistai;1;0;1
94;01.12.2015;2015;12;10;Tiistai;1;1;2
94;01.12.2015;2015;12;11;Tiistai;2;2;4
94;01.12.2015;2015;12;12;Tiistai;0;0;0
94;01.12.2015;2015;12;13;Tiistai;3;2;5
94;01.12.2015;2015;12;14;Tiistai;1;4;5
94;01.12.2015;2015;12;15;Tiistai;1;9;10
94;01.12.2015;2015;12;16;Tiistai;6;9;15
94;01.12.2015;2015;12;17;Tiistai;2;5;7
94;01.12.2015;2015;12;18;Tiistai;0;3;3
94;01.12.2015;2015;12;19;Tiistai;1;1;2
94;01.12.2015;2015;12;20;Tiistai;0;1;1
94;01.12.2015;2015;12;21;Tiistai;0;0;0
94;01.12.2015;2015;12;22;Tiistai;1;1;2
94;01.12.2015;2015;12;23;Tiistai;0;1;1
94;02.12.2015;2015;12;00;Keskiviikko;0;0;0
94;02.12.2015;2015;12;01;Keskiviikko;0;0;0
94;02.12.2015;2015;12;02;Keskiviikko;0;0;0
94;02.12.2015;2015;12;03;Keskiviikko;0;0;0
94;02.12.2015;2015;12;04;Keskiviikko;0;0;0
94;02.12.2015;2015;12;05;Keskiviikko;5;1;6
94;02.12.2015;2015;12;06;Keskiviikko;10;0;10
94;02.12.2015;2015;12;07;Keskiviikko;5;1;6
94;02.12.2015;2015;12;08;Keskiviikko;4;1;5
94;02.12.2015;2015;12;09;Keskiviikko;2;2;4
94;02.12.2015;2015;12;10;Keskiviikko;2;1;3
94;02.12.2015;2015;12;11;Keskiviikko;2;1;3
94;02.12.2015;2015;12;12;Keskiviikko;1;2;3
94;02.12.2015;2015;12;13;Keskiviikko;1;3;4
94;02.12.2015;2015;12;14;Keskiviikko;1;4;5
94;02.12.2015;2015;12;15;Keskiviikko;0;3;3
94;02.12.2015;2015;12;16;Keskiviikko;3;10;13
94;02.12.2015;2015;12;17;Keskiviikko;1;3;4
94;02.12.2015;2015;12;18;Keskiviikko;0;2;2
94;02.12.2015;2015;12;19;Keskiviikko;1;6;7
94;02.12.2015;2015;12;20;Keskiviikko;0;3;3
94;02.12.2015;2015;12;21;Keskiviikko;0;2;2
94;02.12.2015;2015;12;22;Keskiviikko;0;0;0
94;02.12.2015;2015;12;23;Keskiviikko;0;0;0
94;03.12.2015;2015;12;00;Torstai;0;0;0
94;03.12.2015;2015;12;01;Torstai;0;0;0
94;03.12.2015;2015;12;02;Torstai;0;0;0
94;03.12.2015;2015;12;03;Torstai;0;0;0
94;03.12.2015;2015;12;04;Torstai;0;0;0
94;03.12.2015;2015;12;05;Torstai;5;1;6
94;03.12.2015;2015;12;06;Torstai;5;0;5
94;03.12.2015;2015;12;07;Torstai;11;1;12
94;03.12.2015;2015;12;08;Torstai;4;2;6
94;03.12.2015;2015;12;09;Torstai;1;0;1
94;03.12.2015;2015;12;10;Torstai;0;0;0
94;03.12.2015;2015;12;11;Torstai;1;1;2
94;03.12.2015;2015;12;12;Torstai;1;0;1
94;03.12.2015;2015;12;13;Torstai;1;1;2
94;03.12.2015;2015;12;14;Torstai;1;4;5
94;03.12.2015;2015;12;15;Torstai;1;3;4
94;03.12.2015;2015;12;16;Torstai;1;8;9
94;03.12.2015;2015;12;17;Torstai;0;3;3
94;03.12.2015;2015;12;18;Torstai;0;4;4
94;03.12.2015;2015;12;19;Torstai;1;1;2
94;03.12.2015;2015;12;20;Torstai;2;2;4
94;03.12.2015;2015;12;21;Torstai;0;1;1
94;03.12.2015;2015;12;22;Torstai;0;0;0
94;03.12.2015;2015;12;23;Torstai;0;0;0
94;04.12.2015;2015;12;00;Perjantai;0;0;0
94;04.12.2015;2015;12;01;Perjantai;0;0;0
94;04.12.2015;2015;12;02;Perjantai;0;0;0
94;04.12.2015;2015;12;03;Perjantai;0;0;0
94;04.12.2015;2015;12;04;Perjantai;0;0;0
94;04.12.2015;2015;12;05;Perjantai;4;0;4
94;04.12.2015;2015;12;06;Perjantai;4;1;5
94;04.12.2015;2015;12;07;Perjantai;5;1;6
94;04.12.2015;2015;12;08;Perjantai;6;0;6
94;04.12.2015;2015;12;09;Perjantai;1;1;2
94;04.12.2015;2015;12;10;Perjantai;1;2;3
94;04.12.2015;2015;12;11;Perjantai;1;0;1
94;04.12.2015;2015;12;12;Perjantai;1;1;2
94;04.12.2015;2015;12;13;Perjantai;1;0;1
94;04.12.2015;2015;12;14;Perjantai;5;3;8
94;04.12.2015;2015;12;15;Perjantai;4;7;11
94;04.12.2015;2015;12;16;Perjantai;1;7;8
94;04.12.2015;2015;12;17;Perjantai;1;5;6
94;04.12.2015;2015;12;18;Perjantai;0;5;5
94;04.12.2015;2015;12;19;Perjantai;1;0;1
94;04.12.2015;2015;12;20;Perjantai;0;0;0
94;04.12.2015;2015;12;21;Perjantai;0;0;0
94;04.12.2015;2015;12;22;Perjantai;0;1;1
94;04.12.2015;2015;12;23;Perjantai;0;0;0
94;05.12.2015;2015;12;00;Lauantai;0;0;0
94;05.12.2015;2015;12;01;Lauantai;0;0;0
94;05.12.2015;2015;12;02;Lauantai;0;0;0
94;05.12.2015;2015;12;03;Lauantai;0;0;0
94;05.12.2015;2015;12;04;Lauantai;0;0;0
94;05.12.2015;2015;12;05;Lauantai;0;0;0
94;05.12.2015;2015;12;06;Lauantai;0;1;1
94;05.12.2015;2015;12;07;Lauantai;0;0;0
94;05.12.2015;2015;12;08;Lauantai;1;0;1
94;05.12.2015;2015;12;09;Lauantai;2;0;2
94;05.12.2015;2015;12;10;Lauantai;0;1;1
94;05.12.2015;2015;12;11;Lauantai;2;0;2
94;05.12.2015;2015;12;12;Lauantai;0;0;0
94;05.12.2015;2015;12;13;Lauantai;1;0;1
94;05.12.2015;2015;12;14;Lauantai;2;2;4
94;05.12.2015;2015;12;15;Lauantai;3;7;10
94;05.12.2015;2015;12;16;Lauantai;2;3;5
94;05.12.2015;2015;12;17;Lauantai;1;1;2
94;05.12.2015;2015;12;18;Lauantai;1;0;1
94;05.12.2015;2015;12;19;Lauantai;1;0;1
94;05.12.2015;2015;12;20;Lauantai;0;0;0
94;05.12.2015;2015;12;21;Lauantai;0;0;0
94;05.12.2015;2015;12;22;Lauantai;0;0;0
94;05.12.2015;2015;12;23;Lauantai;0;2;2
94;06.12.2015;2015;12;00;Sunnuntai;0;0;0
94;06.12.2015;2015;12;01;Sunnuntai;0;0;0
94;06.12.2015;2015;12;02;Sunnuntai;0;0;0
94;06.12.2015;2015;12;03;Sunnuntai;0;0;0
94;06.12.2015;2015;12;04;Sunnuntai;0;0;0
94;06.12.2015;2015;12;05;Sunnuntai;0;0;0
94;06.12.2015;2015;12;06;Sunnuntai;0;0;0
94;06.12.2015;2015;12;07;Sunnuntai;0;0;0
94;06.12.2015;2015;12;08;Sunnuntai;0;0;0
94;06.12.2015;2015;12;09;Sunnuntai;2;1;3
94;06.12.2015;2015;12;10;Sunnuntai;1;0;1
94;06.12.2015;2015;12;11;Sunnuntai;1;0;1
94;06.12.2015;2015;12;12;Sunnuntai;2;0;2
94;06.12.2015;2015;12;13;Sunnuntai;0;1;1
94;06.12.2015;2015;12;14;Sunnuntai;0;1;1
94;06.12.2015;2015;12;15;Sunnuntai;1;1;2
94;06.12.2015;2015;12;16;Sunnuntai;0;0;0
94;06.12.2015;2015;12;17;Sunnuntai;1;0;1
94;06.12.2015;2015;12;18;Sunnuntai;0;1;1
94;06.12.2015;2015;12;19;Sunnuntai;0;0;0
94;06.12.2015;2015;12;20;Sunnuntai;0;1;1
94;06.12.2015;2015;12;21;Sunnuntai;1;0;1
94;06.12.2015;2015;12;22;Sunnuntai;0;1;1
94;06.12.2015;2015;12;23;Sunnuntai;0;0;0
94;07.12.2015;2015;12;00;Maanantai;0;0;0
94;07.12.2015;2015;12;01;Maanantai;0;0;0
94;07.12.2015;2015;12;02;Maanantai;0;0;0
94;07.12.2015;2015;12;03;Maanantai;0;0;0
94;07.12.2015;2015;12;04;Maanantai;0;0;0
94;07.12.2015;2015;12;05;Maanantai;2;2;4
94;07.12.2015;2015;12;06;Maanantai;6;1;7
94;07.12.2015;2015;12;07;Maanantai;5;0;5
94;07.12.2015;2015;12;08;Maanantai;7;1;8
94;07.12.2015;2015;12;09;Maanantai;2;0;2
94;07.12.2015;2015;12;10;Maanantai;1;0;1
94;07.12.2015;2015;12;11;Maanantai;1;0;1
94;07.12.2015;2015;12;12;Maanantai;0;0;0
94;07.12.2015;2015;12;13;Maanantai;3;1;4
94;07.12.2015;2015;12;14;Maanantai;3;3;6
94;07.12.2015;2015;12;15;Maanantai;0;7;7
94;07.12.2015;2015;12;16;Maanantai;3;3;6
94;07.12.2015;2015;12;17;Maanantai;0;5;5
94;07.12.2015;2015;12;18;Maanantai;1;1;2
94;07.12.2015;2015;12;19;Maanantai;0;2;2
94;07.12.2015;2015;12;20;Maanantai;0;0;0
94;07.12.2015;2015;12;21;Maanantai;0;3;3
94;07.12.2015;2015;12;22;Maanantai;0;2;2
94;07.12.2015;2015;12;23;Maanantai;0;0;0
94;08.12.2015;2015;12;00;Tiistai;0;0;0
94;08.12.2015;2015;12;01;Tiistai;0;0;0
94;08.12.2015;2015;12;02;Tiistai;0;0;0
94;08.12.2015;2015;12;03;Tiistai;0;0;0
94;08.12.2015;2015;12;04;Tiistai;0;0;0
94;08.12.2015;2015;12;05;Tiistai;2;0;2
94;08.12.2015;2015;12;06;Tiistai;5;0;5
94;08.12.2015;2015;12;07;Tiistai;8;0;8
94;08.12.2015;2015;12;08;Tiistai;4;1;5
94;08.12.2015;2015;12;09;Tiistai;0;1;1
94;08.12.2015;2015;12;10;Tiistai;0;0;0
94;08.12.2015;2015;12;11;Tiistai;3;0;3
94;08.12.2015;2015;12;12;Tiistai;1;0;1
94;08.12.2015;2015;12;13;Tiistai;3;1;4
94;08.12.2015;2015;12;14;Tiistai;0;4;4
94;08.12.2015;2015;12;15;Tiistai;2;6;8
94;08.12.2015;2015;12;16;Tiistai;1;3;4
94;08.12.2015;2015;12;17;Tiistai;0;4;4
94;08.12.2015;2015;12;18;Tiistai;0;3;3
94;08.12.2015;2015;12;19;Tiistai;2;0;2
94;08.12.2015;2015;12;20;Tiistai;0;2;2
94;08.12.2015;2015;12;21;Tiistai;0;2;2
94;08.12.2015;2015;12;22;Tiistai;0;2;2
94;08.12.2015;2015;12;23;Tiistai;0;0;0
94;09.12.2015;2015;12;00;Keskiviikko;0;0;0
94;09.12.2015;2015;12;01;Keskiviikko;0;0;0
94;09.12.2015;2015;12;02;Keskiviikko;0;0;0
94;09.12.2015;2015;12;03;Keskiviikko;0;0;0
94;09.12.2015;2015;12;04;Keskiviikko;0;0;0
94;09.12.2015;2015;12;05;Keskiviikko;2;1;3
94;09.12.2015;2015;12;06;Keskiviikko;6;0;6
94;09.12.2015;2015;12;07;Keskiviikko;6;0;6
94;09.12.2015;2015;12;08;Keskiviikko;5;0;5
94;09.12.2015;2015;12;09;Keskiviikko;1;0;1
94;09.12.2015;2015;12;10;Keskiviikko;1;0;1
94;09.12.2015;2015;12;11;Keskiviikko;0;0;0
94;09.12.2015;2015;12;12;Keskiviikko;2;1;3
94;09.12.2015;2015;12;13;Keskiviikko;3;0;3
94;09.12.2015;2015;12;14;Keskiviikko;1;4;5
94;09.12.2015;2015;12;15;Keskiviikko;2;4;6
94;09.12.2015;2015;12;16;Keskiviikko;0;7;7
94;09.12.2015;2015;12;17;Keskiviikko;0;3;3
94;09.12.2015;2015;12;18;Keskiviikko;0;1;1
94;09.12.2015;2015;12;19;Keskiviikko;1;1;2
94;09.12.2015;2015;12;20;Keskiviikko;0;1;1
94;09.12.2015;2015;12;21;Keskiviikko;0;3;3
94;09.12.2015;2015;12;22;Keskiviikko;0;1;1
94;09.12.2015;2015;12;23;Keskiviikko;0;0;0
94;10.12.2015;2015;12;00;Torstai;0;0;0
94;10.12.2015;2015;12;01;Torstai;0;0;0
94;10.12.2015;2015;12;02;Torstai;4;0;4
94;10.12.2015;2015;12;03;Torstai;0;0;0
94;10.12.2015;2015;12;04;Torstai;0;0;0
94;10.12.2015;2015;12;05;Torstai;1;1;2
94;10.12.2015;2015;12;06;Torstai;5;0;5
94;10.12.2015;2015;12;07;Torstai;10;0;10
94;10.12.2015;2015;12;08;Torstai;3;1;4
94;10.12.2015;2015;12;09;Torstai;0;0;0
94;10.12.2015;2015;12;10;Torstai;1;2;3
94;10.12.2015;2015;12;11;Torstai;2;2;4
94;10.12.2015;2015;12;12;Torstai;4;0;4
94;10.12.2015;2015;12;13;Torstai;2;0;2
94;10.12.2015;2015;12;14;Torstai;1;4;5
94;10.12.2015;2015;12;15;Torstai;1;3;4
94;10.12.2015;2015;12;16;Torstai;1;7;8
94;10.12.2015;2015;12;17;Torstai;0;2;2
94;10.12.2015;2015;12;18;Torstai;1;1;2
94;10.12.2015;2015;12;19;Torstai;0;2;2
94;10.12.2015;2015;12;20;Torstai;1;1;2
94;10.12.2015;2015;12;21;Torstai;0;4;4
94;10.12.2015;2015;12;22;Torstai;0;2;2
94;10.12.2015;2015;12;23;Torstai;0;0;0
94;11.12.2015;2015;12;00;Perjantai;0;0;0
94;11.12.2015;2015;12;01;Perjantai;0;0;0
94;11.12.2015;2015;12;02;Perjantai;0;0;0
94;11.12.2015;2015;12;03;Perjantai;0;0;0
94;11.12.2015;2015;12;04;Perjantai;0;0;0
94;11.12.2015;2015;12;05;Perjantai;1;0;1
94;11.12.2015;2015;12;06;Perjantai;2;0;2
94;11.12.2015;2015;12;07;Perjantai;10;0;10
94;11.12.2015;2015;12;08;Perjantai;4;1;5
94;11.12.2015;2015;12;09;Perjantai;1;1;2
94;11.12.2015;2015;12;10;Perjantai;1;0;1
94;11.12.2015;2015;12;11;Perjantai;1;2;3
94;11.12.2015;2015;12;12;Perjantai;2;1;3
94;11.12.2015;2015;12;13;Perjantai;2;2;4
94;11.12.2015;2015;12;14;Perjantai;2;3;5
94;11.12.2015;2015;12;15;Perjantai;0;2;2
94;11.12.2015;2015;12;16;Perjantai;0;4;4
94;11.12.2015;2015;12;17;Perjantai;2;4;6
94;11.12.2015;2015;12;18;Perjantai;0;2;2
94;11.12.2015;2015;12;19;Perjantai;0;2;2
94;11.12.2015;2015;12;20;Perjantai;4;0;4
94;11.12.2015;2015;12;21;Perjantai;0;1;1
94;11.12.2015;2015;12;22;Perjantai;0;2;2
94;11.12.2015;2015;12;23;Perjantai;0;0;0
94;12.12.2015;2015;12;00;Lauantai;0;0;0
94;12.12.2015;2015;12;01;Lauantai;0;0;0
94;12.12.2015;2015;12;02;Lauantai;0;0;0
94;12.12.2015;2015;12;03;Lauantai;0;0;0
94;12.12.2015;2015;12;04;Lauantai;0;0;0
94;12.12.2015;2015;12;05;Lauantai;0;0;0
94;12.12.2015;2015;12;06;Lauantai;0;1;1
94;12.12.2015;2015;12;07;Lauantai;1;1;2
94;12.12.2015;2015;12;08;Lauantai;0;0;0
94;12.12.2015;2015;12;09;Lauantai;0;0;0
94;12.12.2015;2015;12;10;Lauantai;1;1;2
94;12.12.2015;2015;12;11;Lauantai;1;1;2
94;12.12.2015;2015;12;12;Lauantai;1;0;1
94;12.12.2015;2015;12;13;Lauantai;4;2;6
94;12.12.2015;2015;12;14;Lauantai;4;3;7
94;12.12.2015;2015;12;15;Lauantai;1;4;5
94;12.12.2015;2015;12;16;Lauantai;0;2;2
94;12.12.2015;2015;12;17;Lauantai;1;1;2
94;12.12.2015;2015;12;18;Lauantai;0;1;1
94;12.12.2015;2015;12;19;Lauantai;0;0;0
94;12.12.2015;2015;12;20;Lauantai;0;0;0
94;12.12.2015;2015;12;21;Lauantai;0;0;0
94;12.12.2015;2015;12;22;Lauantai;1;0;1
94;12.12.2015;2015;12;23;Lauantai;0;0;0
94;13.12.2015;2015;12;00;Sunnuntai;0;0;0
94;13.12.2015;2015;12;01;Sunnuntai;0;0;0
94;13.12.2015;2015;12;02;Sunnuntai;0;0;0
94;13.12.2015;2015;12;03;Sunnuntai;0;0;0
94;13.12.2015;2015;12;04;Sunnuntai;1;0;1
94;13.12.2015;2015;12;05;Sunnuntai;0;0;0
94;13.12.2015;2015;12;06;Sunnuntai;0;0;0
94;13.12.2015;2015;12;07;Sunnuntai;0;0;0
94;13.12.2015;2015;12;08;Sunnuntai;0;0;0
94;13.12.2015;2015;12;09;Sunnuntai;1;0;1
94;13.12.2015;2015;12;10;Sunnuntai;1;0;1
94;13.12.2015;2015;12;11;Sunnuntai;1;0;1
94;13.12.2015;2015;12;12;Sunnuntai;3;0;3
94;13.12.2015;2015;12;13;Sunnuntai;0;0;0
94;13.12.2015;2015;12;14;Sunnuntai;0;0;0
94;13.12.2015;2015;12;15;Sunnuntai;3;0;3
94;13.12.2015;2015;12;16;Sunnuntai;0;0;0
94;13.12.2015;2015;12;17;Sunnuntai;0;1;1
94;13.12.2015;2015;12;18;Sunnuntai;0;0;0
94;13.12.2015;2015;12;19;Sunnuntai;0;0;0
94;13.12.2015;2015;12;20;Sunnuntai;0;0;0
94;13.12.2015;2015;12;21;Sunnuntai;0;0;0
94;13.12.2015;2015;12;22;Sunnuntai;0;0;0
94;13.12.2015;2015;12;23;Sunnuntai;0;0;0
94;14.12.2015;2015;12;00;Maanantai;0;0;0
94;14.12.2015;2015;12;01;Maanantai;0;0;0
94;14.12.2015;2015;12;02;Maanantai;0;0;0
94;14.12.2015;2015;12;03;Maanantai;0;1;1
94;14.12.2015;2015;12;04;Maanantai;1;0;1
94;14.12.2015;2015;12;05;Maanantai;2;1;3
94;14.12.2015;2015;12;06;Maanantai;7;0;7
94;14.12.2015;2015;12;07;Maanantai;4;1;5
94;14.12.2015;2015;12;08;Maanantai;9;0;9
94;14.12.2015;2015;12;09;Maanantai;0;0;0
94;14.12.2015;2015;12;10;Maanantai;1;0;1
94;14.12.2015;2015;12;11;Maanantai;0;0;0
94;14.12.2015;2015;12;12;Maanantai;0;0;0
94;14.12.2015;2015;12;13;Maanantai;1;0;1
94;14.12.2015;2015;12;14;Maanantai;0;2;2
94;14.12.2015;2015;12;15;Maanantai;2;5;7
94;14.12.2015;2015;12;16;Maanantai;0;10;10
94;14.12.2015;2015;12;17;Maanantai;1;6;7
94;14.12.2015;2015;12;18;Maanantai;1;1;2
94;14.12.2015;2015;12;19;Maanantai;0;1;1
94;14.12.2015;2015;12;20;Maanantai;0;3;3
94;14.12.2015;2015;12;21;Maanantai;0;2;2
94;14.12.2015;2015;12;22;Maanantai;0;0;0
94;14.12.2015;2015;12;23;Maanantai;0;0;0
94;15.12.2015;2015;12;00;Tiistai;0;0;0
94;15.12.2015;2015;12;01;Tiistai;0;0;0
94;15.12.2015;2015;12;02;Tiistai;0;0;0
94;15.12.2015;2015;12;03;Tiistai;0;0;0
94;15.12.2015;2015;12;04;Tiistai;0;0;0
94;15.12.2015;2015;12;05;Tiistai;2;3;5
94;15.12.2015;2015;12;06;Tiistai;6;0;6
94;15.12.2015;2015;12;07;Tiistai;5;1;6
94;15.12.2015;2015;12;08;Tiistai;5;0;5
94;15.12.2015;2015;12;09;Tiistai;0;0;0
94;15.12.2015;2015;12;10;Tiistai;1;0;1
94;15.12.2015;2015;12;11;Tiistai;1;0;1
94;15.12.2015;2015;12;12;Tiistai;2;1;3
94;15.12.2015;2015;12;13;Tiistai;0;1;1
94;15.12.2015;2015;12;14;Tiistai;1;3;4
94;15.12.2015;2015;12;15;Tiistai;2;3;5
94;15.12.2015;2015;12;16;Tiistai;0;6;6
94;15.12.2015;2015;12;17;Tiistai;0;7;7
94;15.12.2015;2015;12;18;Tiistai;0;1;1
94;15.12.2015;2015;12;19;Tiistai;1;1;2
94;15.12.2015;2015;12;20;Tiistai;0;1;1
94;15.12.2015;2015;12;21;Tiistai;0;1;1
94;15.12.2015;2015;12;22;Tiistai;1;1;2
94;15.12.2015;2015;12;23;Tiistai;0;0;0
94;16.12.2015;2015;12;00;Keskiviikko;0;1;1
94;16.12.2015;2015;12;01;Keskiviikko;0;0;0
94;16.12.2015;2015;12;02;Keskiviikko;0;0;0
94;16.12.2015;2015;12;03;Keskiviikko;0;0;0
94;16.12.2015;2015;12;04;Keskiviikko;0;0;0
94;16.12.2015;2015;12;05;Keskiviikko;2;2;4
94;16.12.2015;2015;12;06;Keskiviikko;5;0;5
94;16.12.2015;2015;12;07;Keskiviikko;7;0;7
94;16.12.2015;2015;12;08;Keskiviikko;5;0;5
94;16.12.2015;2015;12;09;Keskiviikko;0;0;0
94;16.12.2015;2015;12;10;Keskiviikko;1;0;1
94;16.12.2015;2015;12;11;Keskiviikko;0;1;1
94;16.12.2015;2015;12;12;Keskiviikko;1;1;2
94;16.12.2015;2015;12;13;Keskiviikko;1;1;2
94;16.12.2015;2015;12;14;Keskiviikko;2;1;3
94;16.12.2015;2015;12;15;Keskiviikko;1;8;9
94;16.12.2015;2015;12;16;Keskiviikko;0;4;4
94;16.12.2015;2015;12;17;Keskiviikko;0;1;1
94;16.12.2015;2015;12;18;Keskiviikko;0;4;4
94;16.12.2015;2015;12;19;Keskiviikko;2;2;4
94;16.12.2015;2015;12;20;Keskiviikko;0;1;1
94;16.12.2015;2015;12;21;Keskiviikko;0;1;1
94;16.12.2015;2015;12;22;Keskiviikko;0;0;0
94;16.12.2015;2015;12;23;Keskiviikko;0;0;0
94;17.12.2015;2015;12;00;Torstai;0;0;0
94;17.12.2015;2015;12;01;Torstai;0;0;0
94;17.12.2015;2015;12;02;Torstai;0;0;0
94;17.12.2015;2015;12;03;Torstai;0;0;0
94;17.12.2015;2015;12;04;Torstai;0;0;0
94;17.12.2015;2015;12;05;Torstai;1;1;2
94;17.12.2015;2015;12;06;Torstai;4;0;4
94;17.12.2015;2015;12;07;Torstai;10;1;11
94;17.12.2015;2015;12;08;Torstai;6;0;6
94;17.12.2015;2015;12;09;Torstai;1;0;1
94;17.12.2015;2015;12;10;Torstai;0;0;0
94;17.12.2015;2015;12;11;Torstai;2;0;2
94;17.12.2015;2015;12;12;Torstai;1;0;1
94;17.12.2015;2015;12;13;Torstai;0;1;1
94;17.12.2015;2015;12;14;Torstai;0;1;1
94;17.12.2015;2015;12;15;Torstai;1;7;8
94;17.12.2015;2015;12;16;Torstai;1;7;8
94;17.12.2015;2015;12;17;Torstai;0;6;6
94;17.12.2015;2015;12;18;Torstai;0;0;0
94;17.12.2015;2015;12;19;Torstai;0;1;1
94;17.12.2015;2015;12;20;Torstai;0;0;0
94;17.12.2015;2015;12;21;Torstai;0;1;1
94;17.12.2015;2015;12;22;Torstai;0;1;1
94;17.12.2015;2015;12;23;Torstai;0;0;0
94;18.12.2015;2015;12;00;Perjantai;0;0;0
94;18.12.2015;2015;12;01;Perjantai;0;0;0
94;18.12.2015;2015;12;02;Perjantai;0;0;0
94;18.12.2015;2015;12;03;Perjantai;0;0;0
94;18.12.2015;2015;12;04;Perjantai;0;0;0
94;18.12.2015;2015;12;05;Perjantai;1;0;1
94;18.12.2015;2015;12;06;Perjantai;5;0;5
94;18.12.2015;2015;12;07;Perjantai;6;0;6
94;18.12.2015;2015;12;08;Perjantai;7;0;7
94;18.12.2015;2015;12;09;Perjantai;0;0;0
94;18.12.2015;2015;12;10;Perjantai;0;0;0
94;18.12.2015;2015;12;11;Perjantai;0;1;1
94;18.12.2015;2015;12;12;Perjantai;0;0;0
94;18.12.2015;2015;12;13;Perjantai;1;0;1
94;18.12.2015;2015;12;14;Perjantai;1;1;2
94;18.12.2015;2015;12;15;Perjantai;0;9;9
94;18.12.2015;2015;12;16;Perjantai;0;8;8
94;18.12.2015;2015;12;17;Perjantai;0;1;1
94;18.12.2015;2015;12;18;Perjantai;0;0;0
94;18.12.2015;2015;12;19;Perjantai;0;1;1
94;18.12.2015;2015;12;20;Perjantai;0;0;0
94;18.12.2015;2015;12;21;Perjantai;0;0;0
94;18.12.2015;2015;12;22;Perjantai;0;0;0
94;18.12.2015;2015;12;23;Perjantai;0;0;0
94;19.12.2015;2015;12;00;Lauantai;0;0;0
94;19.12.2015;2015;12;01;Lauantai;0;0;0
94;19.12.2015;2015;12;02;Lauantai;0;0;0
94;19.12.2015;2015;12;03;Lauantai;0;0;0
94;19.12.2015;2015;12;04;Lauantai;0;0;0
94;19.12.2015;2015;12;05;Lauantai;0;0;0
94;19.12.2015;2015;12;06;Lauantai;0;1;1
94;19.12.2015;2015;12;07;Lauantai;0;0;0
94;19.12.2015;2015;12;08;Lauantai;0;1;1
94;19.12.2015;2015;12;09;Lauantai;0;0;0
94;19.12.2015;2015;12;10;Lauantai;2;1;3
94;19.12.2015;2015;12;11;Lauantai;1;0;1
94;19.12.2015;2015;12;12;Lauantai;1;0;1
94;19.12.2015;2015;12;13;Lauantai;1;3;4
94;19.12.2015;2015;12;14;Lauantai;1;0;1
94;19.12.2015;2015;12;15;Lauantai;2;1;3
94;19.12.2015;2015;12;16;Lauantai;0;0;0
94;19.12.2015;2015;12;17;Lauantai;0;2;2
94;19.12.2015;2015;12;18;Lauantai;0;2;2
94;19.12.2015;2015;12;19;Lauantai;0;0;0
94;19.12.2015;2015;12;20;Lauantai;1;1;2
94;19.12.2015;2015;12;21;Lauantai;0;0;0
94;19.12.2015;2015;12;22;Lauantai;0;0;0
94;19.12.2015;2015;12;23;Lauantai;0;0;0
94;20.12.2015;2015;12;00;Sunnuntai;0;0;0
94;20.12.2015;2015;12;01;Sunnuntai;0;0;0
94;20.12.2015;2015;12;02;Sunnuntai;0;0;0
94;20.12.2015;2015;12;03;Sunnuntai;0;0;0
94;20.12.2015;2015;12;04;Sunnuntai;0;0;0
94;20.12.2015;2015;12;05;Sunnuntai;0;0;0
94;20.12.2015;2015;12;06;Sunnuntai;0;0;0
94;20.12.2015;2015;12;07;Sunnuntai;1;0;1
94;20.12.2015;2015;12;08;Sunnuntai;0;0;0
94;20.12.2015;2015;12;09;Sunnuntai;1;0;1
94;20.12.2015;2015;12;10;Sunnuntai;1;2;3
94;20.12.2015;2015;12;11;Sunnuntai;0;1;1
94;20.12.2015;2015;12;12;Sunnuntai;2;0;2
94;20.12.2015;2015;12;13;Sunnuntai;0;5;5
94;20.12.2015;2015;12;14;Sunnuntai;1;0;1
94;20.12.2015;2015;12;15;Sunnuntai;0;0;0
94;20.12.2015;2015;12;16;Sunnuntai;0;0;0
94;20.12.2015;2015;12;17;Sunnuntai;1;0;1
94;20.12.2015;2015;12;18;Sunnuntai;0;0;0
94;20.12.2015;2015;12;19;Sunnuntai;0;0;0
94;20.12.2015;2015;12;20;Sunnuntai;0;1;1
94;20.12.2015;2015;12;21;Sunnuntai;0;0;0
94;20.12.2015;2015;12;22;Sunnuntai;0;0;0
94;20.12.2015;2015;12;23;Sunnuntai;0;2;2
94;21.12.2015;2015;12;00;Maanantai;0;0;0
94;21.12.2015;2015;12;01;Maanantai;0;0;0
94;21.12.2015;2015;12;02;Maanantai;0;1;1
94;21.12.2015;2015;12;03;Maanantai;0;0;0
94;21.12.2015;2015;12;04;Maanantai;0;0;0
94;21.12.2015;2015;12;05;Maanantai;0;1;1
94;21.12.2015;2015;12;06;Maanantai;0;0;0
94;21.12.2015;2015;12;07;Maanantai;5;1;6
94;21.12.2015;2015;12;08;Maanantai;5;0;5
94;21.12.2015;2015;12;09;Maanantai;3;0;3
94;21.12.2015;2015;12;10;Maanantai;1;0;1
94;21.12.2015;2015;12;11;Maanantai;0;0;0
94;21.12.2015;2015;12;12;Maanantai;0;0;0
94;21.12.2015;2015;12;13;Maanantai;0;0;0
94;21.12.2015;2015;12;14;Maanantai;1;0;1
94;21.12.2015;2015;12;15;Maanantai;0;2;2
94;21.12.2015;2015;12;16;Maanantai;1;6;7
94;21.12.2015;2015;12;17;Maanantai;0;4;4
94;21.12.2015;2015;12;18;Maanantai;3;1;4
94;21.12.2015;2015;12;19;Maanantai;0;0;0
94;21.12.2015;2015;12;20;Maanantai;1;0;1
94;21.12.2015;2015;12;21;Maanantai;1;1;2
94;21.12.2015;2015;12;22;Maanantai;0;0;0
94;21.12.2015;2015;12;23;Maanantai;0;0;0
94;22.12.2015;2015;12;00;Tiistai;0;0;0
94;22.12.2015;2015;12;01;Tiistai;0;0;0
94;22.12.2015;2015;12;02;Tiistai;0;1;1
94;22.12.2015;2015;12;03;Tiistai;0;0;0
94;22.12.2015;2015;12;04;Tiistai;0;0;0
94;22.12.2015;2015;12;05;Tiistai;0;0;0
94;22.12.2015;2015;12;06;Tiistai;1;0;1
94;22.12.2015;2015;12;07;Tiistai;5;1;6
94;22.12.2015;2015;12;08;Tiistai;1;1;2
94;22.12.2015;2015;12;09;Tiistai;3;0;3
94;22.12.2015;2015;12;10;Tiistai;1;0;1
94;22.12.2015;2015;12;11;Tiistai;0;0;0
94;22.12.2015;2015;12;12;Tiistai;1;0;1
94;22.12.2015;2015;12;13;Tiistai;0;0;0
94;22.12.2015;2015;12;14;Tiistai;0;3;3
94;22.12.2015;2015;12;15;Tiistai;0;3;3
94;22.12.2015;2015;12;16;Tiistai;2;6;8
94;22.12.2015;2015;12;17;Tiistai;1;5;6
94;22.12.2015;2015;12;18;Tiistai;0;0;0
94;22.12.2015;2015;12;19;Tiistai;2;0;2
94;22.12.2015;2015;12;20;Tiistai;0;0;0
94;22.12.2015;2015;12;21;Tiistai;0;0;0
94;22.12.2015;2015;12;22;Tiistai;0;1;1
94;22.12.2015;2015;12;23;Tiistai;0;0;0
94;23.12.2015;2015;12;00;Keskiviikko;0;0;0
94;23.12.2015;2015;12;01;Keskiviikko;0;0;0
94;23.12.2015;2015;12;02;Keskiviikko;0;0;0
94;23.12.2015;2015;12;03;Keskiviikko;0;1;1
94;23.12.2015;2015;12;04;Keskiviikko;0;0;0
94;23.12.2015;2015;12;05;Keskiviikko;1;0;1
94;23.12.2015;2015;12;06;Keskiviikko;0;0;0
94;23.12.2015;2015;12;07;Keskiviikko;3;0;3
94;23.12.2015;2015;12;08;Keskiviikko;1;0;1
94;23.12.2015;2015;12;09;Keskiviikko;2;0;2
94;23.12.2015;2015;12;10;Keskiviikko;0;0;0
94;23.12.2015;2015;12;11;Keskiviikko;1;1;2
94;23.12.2015;2015;12;12;Keskiviikko;0;1;1
94;23.12.2015;2015;12;13;Keskiviikko;0;3;3
94;23.12.2015;2015;12;14;Keskiviikko;0;3;3
94;23.12.2015;2015;12;15;Keskiviikko;2;3;5
94;23.12.2015;2015;12;16;Keskiviikko;0;0;0
94;23.12.2015;2015;12;17;Keskiviikko;1;0;1
94;23.12.2015;2015;12;18;Keskiviikko;0;0;0
94;23.12.2015;2015;12;19;Keskiviikko;0;0;0
94;23.12.2015;2015;12;20;Keskiviikko;1;1;2
94;23.12.2015;2015;12;21;Keskiviikko;0;0;0
94;23.12.2015;2015;12;22;Keskiviikko;0;0;0
94;23.12.2015;2015;12;23;Keskiviikko;0;0;0
94;24.12.2015;2015;12;00;Torstai;0;0;0
94;24.12.2015;2015;12;01;Torstai;0;0;0
94;24.12.2015;2015;12;02;Torstai;0;0;0
94;24.12.2015;2015;12;03;Torstai;0;0;0
94;24.12.2015;2015;12;04;Torstai;0;0;0
94;24.12.2015;2015;12;05;Torstai;0;0;0
94;24.12.2015;2015;12;06;Torstai;0;0;0
94;24.12.2015;2015;12;07;Torstai;1;0;1
94;24.12.2015;2015;12;08;Torstai;0;0;0
94;24.12.2015;2015;12;09;Torstai;1;0;1
94;24.12.2015;2015;12;10;Torstai;0;0;0
94;24.12.2015;2015;12;11;Torstai;1;2;3
94;24.12.2015;2015;12;12;Torstai;0;0;0
94;24.12.2015;2015;12;13;Torstai;1;0;1
94;24.12.2015;2015;12;14;Torstai;2;2;4
94;24.12.2015;2015;12;15;Torstai;0;0;0
94;24.12.2015;2015;12;16;Torstai;0;0;0
94;24.12.2015;2015;12;17;Torstai;0;0;0
94;24.12.2015;2015;12;18;Torstai;0;0;0
94;24.12.2015;2015;12;19;Torstai;0;0;0
94;24.12.2015;2015;12;20;Torstai;0;0;0
94;24.12.2015;2015;12;21;Torstai;0;0;0
94;24.12.2015;2015;12;22;Torstai;0;0;0
94;24.12.2015;2015;12;23;Torstai;0;0;0
94;25.12.2015;2015;12;00;Perjantai;0;0;0
94;25.12.2015;2015;12;01;Perjantai;0;0;0
94;25.12.2015;2015;12;02;Perjantai;0;0;0
94;25.12.2015;2015;12;03;Perjantai;0;0;0
94;25.12.2015;2015;12;04;Perjantai;0;0;0
94;25.12.2015;2015;12;05;Perjantai;0;0;0
94;25.12.2015;2015;12;06;Perjantai;0;0;0
94;25.12.2015;2015;12;07;Perjantai;0;0;0
94;25.12.2015;2015;12;08;Perjantai;0;0;0
94;25.12.2015;2015;12;09;Perjantai;0;0;0
94;25.12.2015;2015;12;10;Perjantai;0;0;0
94;25.12.2015;2015;12;11;Perjantai;0;0;0
94;25.12.2015;2015;12;12;Perjantai;0;0;0
94;25.12.2015;2015;12;13;Perjantai;0;0;0
94;25.12.2015;2015;12;14;Perjantai;0;0;0
94;25.12.2015;2015;12;15;Perjantai;0;0;0
94;25.12.2015;2015;12;16;Perjantai;0;0;0
94;25.12.2015;2015;12;17;Perjantai;0;1;1
94;25.12.2015;2015;12;18;Perjantai;1;1;2
94;25.12.2015;2015;12;19;Perjantai;1;0;1
94;25.12.2015;2015;12;20;Perjantai;0;0;0
94;25.12.2015;2015;12;21;Perjantai;0;0;0
94;25.12.2015;2015;12;22;Perjantai;0;0;0
94;25.12.2015;2015;12;23;Perjantai;0;0;0
94;26.12.2015;2015;12;00;Lauantai;0;0;0
94;26.12.2015;2015;12;01;Lauantai;0;0;0
94;26.12.2015;2015;12;02;Lauantai;0;0;0
94;26.12.2015;2015;12;03;Lauantai;0;0;0
94;26.12.2015;2015;12;04;Lauantai;0;0;0
94;26.12.2015;2015;12;05;Lauantai;0;0;0
94;26.12.2015;2015;12;06;Lauantai;0;0;0
94;26.12.2015;2015;12;07;Lauantai;0;0;0
94;26.12.2015;2015;12;08;Lauantai;0;0;0
94;26.12.2015;2015;12;09;Lauantai;1;0;1
94;26.12.2015;2015;12;10;Lauantai;1;2;3
94;26.12.2015;2015;12;11;Lauantai;2;3;5
94;26.12.2015;2015;12;12;Lauantai;3;2;5
94;26.12.2015;2015;12;13;Lauantai;0;0;0
94;26.12.2015;2015;12;14;Lauantai;1;2;3
94;26.12.2015;2015;12;15;Lauantai;0;0;0
94;26.12.2015;2015;12;16;Lauantai;1;0;1
94;26.12.2015;2015;12;17;Lauantai;1;0;1
94;26.12.2015;2015;12;18;Lauantai;0;0;0
94;26.12.2015;2015;12;19;Lauantai;0;0;0
94;26.12.2015;2015;12;20;Lauantai;0;0;0
94;26.12.2015;2015;12;21;Lauantai;0;0;0
94;26.12.2015;2015;12;22;Lauantai;0;0;0
94;26.12.2015;2015;12;23;Lauantai;0;0;0
94;27.12.2015;2015;12;00;Sunnuntai;0;0;0
94;27.12.2015;2015;12;01;Sunnuntai;0;0;0
94;27.12.2015;2015;12;02;Sunnuntai;0;0;0
94;27.12.2015;2015;12;03;Sunnuntai;0;0;0
94;27.12.2015;2015;12;04;Sunnuntai;0;0;0
94;27.12.2015;2015;12;05;Sunnuntai;0;0;0
94;27.12.2015;2015;12;06;Sunnuntai;1;0;1
94;27.12.2015;2015;12;07;Sunnuntai;0;0;0
94;27.12.2015;2015;12;08;Sunnuntai;0;0;0
94;27.12.2015;2015;12;09;Sunnuntai;1;0;1
94;27.12.2015;2015;12;10;Sunnuntai;0;0;0
94;27.12.2015;2015;12;11;Sunnuntai;0;0;0
94;27.12.2015;2015;12;12;Sunnuntai;0;1;1
94;27.12.2015;2015;12;13;Sunnuntai;1;1;2
94;27.12.2015;2015;12;14;Sunnuntai;0;0;0
94;27.12.2015;2015;12;15;Sunnuntai;1;2;3
94;27.12.2015;2015;12;16;Sunnuntai;0;0;0
94;27.12.2015;2015;12;17;Sunnuntai;0;0;0
94;27.12.2015;2015;12;18;Sunnuntai;2;0;2
94;27.12.2015;2015;12;19;Sunnuntai;2;0;2
94;27.12.2015;2015;12;20;Sunnuntai;0;3;3
94;27.12.2015;2015;12;21;Sunnuntai;0;0;0
94;27.12.2015;2015;12;22;Sunnuntai;0;0;0
94;27.12.2015;2015;12;23;Sunnuntai;0;0;0
94;28.12.2015;2015;12;00;Maanantai;0;0;0
94;28.12.2015;2015;12;01;Maanantai;0;0;0
94;28.12.2015;2015;12;02;Maanantai;0;0;0
94;28.12.2015;2015;12;03;Maanantai;0;0;0
94;28.12.2015;2015;12;04;Maanantai;0;0;0
94;28.12.2015;2015;12;05;Maanantai;1;0;1
94;28.12.2015;2015;12;06;Maanantai;4;0;4
94;28.12.2015;2015;12;07;Maanantai;3;0;3
94;28.12.2015;2015;12;08;Maanantai;3;0;3
94;28.12.2015;2015;12;09;Maanantai;2;0;2
94;28.12.2015;2015;12;10;Maanantai;2;0;2
94;28.12.2015;2015;12;11;Maanantai;0;0;0
94;28.12.2015;2015;12;12;Maanantai;0;0;0
94;28.12.2015;2015;12;13;Maanantai;1;0;1
94;28.12.2015;2015;12;14;Maanantai;0;1;1
94;28.12.2015;2015;12;15;Maanantai;0;2;2
94;28.12.2015;2015;12;16;Maanantai;0;4;4
94;28.12.2015;2015;12;17;Maanantai;1;2;3
94;28.12.2015;2015;12;18;Maanantai;0;0;0
94;28.12.2015;2015;12;19;Maanantai;1;1;2
94;28.12.2015;2015;12;20;Maanantai;0;2;2
94;28.12.2015;2015;12;21;Maanantai;1;0;1
94;28.12.2015;2015;12;22;Maanantai;0;0;0
94;28.12.2015;2015;12;23;Maanantai;0;0;0
94;29.12.2015;2015;12;00;Tiistai;0;0;0
94;29.12.2015;2015;12;01;Tiistai;0;0;0
94;29.12.2015;2015;12;02;Tiistai;0;0;0
94;29.12.2015;2015;12;03;Tiistai;0;0;0
94;29.12.2015;2015;12;04;Tiistai;0;0;0
94;29.12.2015;2015;12;05;Tiistai;1;0;1
94;29.12.2015;2015;12;06;Tiistai;3;0;3
94;29.12.2015;2015;12;07;Tiistai;3;0;3
94;29.12.2015;2015;12;08;Tiistai;2;0;2
94;29.12.2015;2015;12;09;Tiistai;0;0;0
94;29.12.2015;2015;12;10;Tiistai;2;0;2
94;29.12.2015;2015;12;11;Tiistai;0;0;0
94;29.12.2015;2015;12;12;Tiistai;1;0;1
94;29.12.2015;2015;12;13;Tiistai;0;0;0
94;29.12.2015;2015;12;14;Tiistai;0;1;1
94;29.12.2015;2015;12;15;Tiistai;0;2;2
94;29.12.2015;2015;12;16;Tiistai;0;3;3
94;29.12.2015;2015;12;17;Tiistai;0;2;2
94;29.12.2015;2015;12;18;Tiistai;0;1;1
94;29.12.2015;2015;12;19;Tiistai;0;1;1
94;29.12.2015;2015;12;20;Tiistai;1;0;1
94;29.12.2015;2015;12;21;Tiistai;0;1;1
94;29.12.2015;2015;12;22;Tiistai;0;0;0
94;29.12.2015;2015;12;23;Tiistai;0;1;1
94;30.12.2015;2015;12;00;Keskiviikko;0;0;0
94;30.12.2015;2015;12;01;Keskiviikko;0;0;0
94;30.12.2015;2015;12;02;Keskiviikko;0;0;0
94;30.12.2015;2015;12;03;Keskiviikko;0;0;0
94;30.12.2015;2015;12;04;Keskiviikko;0;0;0
94;30.12.2015;2015;12;05;Keskiviikko;1;1;2
94;30.12.2015;2015;12;06;Keskiviikko;5;0;5
94;30.12.2015;2015;12;07;Keskiviikko;4;0;4
94;30.12.2015;2015;12;08;Keskiviikko;4;0;4
94;30.12.2015;2015;12;09;Keskiviikko;1;0;1
94;30.12.2015;2015;12;10;Keskiviikko;2;1;3
94;30.12.2015;2015;12;11;Keskiviikko;1;4;5
94;30.12.2015;2015;12;12;Keskiviikko;2;2;4
94;30.12.2015;2015;12;13;Keskiviikko;2;1;3
94;30.12.2015;2015;12;14;Keskiviikko;1;0;1
94;30.12.2015;2015;12;15;Keskiviikko;2;3;5
94;30.12.2015;2015;12;16;Keskiviikko;2;6;8
94;30.12.2015;2015;12;17;Keskiviikko;0;2;2
94;30.12.2015;2015;12;18;Keskiviikko;0;1;1
94;30.12.2015;2015;12;19;Keskiviikko;2;3;5
94;30.12.2015;2015;12;20;Keskiviikko;2;0;2
94;30.12.2015;2015;12;21;Keskiviikko;0;0;0
94;30.12.2015;2015;12;22;Keskiviikko;0;1;1
94;30.12.2015;2015;12;23;Keskiviikko;0;0;0
94;31.12.2015;2015;12;00;Torstai;1;0;1
94;31.12.2015;2015;12;01;Torstai;0;0;0
94;31.12.2015;2015;12;02;Torstai;0;0;0
94;31.12.2015;2015;12;03;Torstai;0;0;0
94;31.12.2015;2015;12;04;Torstai;0;0;0
94;31.12.2015;2015;12;05;Torstai;2;1;3
94;31.12.2015;2015;12;06;Torstai;3;0;3
94;31.12.2015;2015;12;07;Torstai;4;1;5
94;31.12.2015;2015;12;08;Torstai;2;1;3
94;31.12.2015;2015;12;09;Torstai;0;1;1
94;31.12.2015;2015;12;10;Torstai;1;0;1
94;31.12.2015;2015;12;11;Torstai;0;0;0
94;31.12.2015;2015;12;12;Torstai;1;1;2
94;31.12.2015;2015;12;13;Torstai;0;3;3
94;31.12.2015;2015;12;14;Torstai;1;4;5
94;31.12.2015;2015;12;15;Torstai;0;3;3
94;31.12.2015;2015;12;16;Torstai;1;3;4
94;31.12.2015;2015;12;17;Torstai;1;2;3
94;31.12.2015;2015;12;18;Torstai;1;0;1
94;31.12.2015;2015;12;19;Torstai;0;0;0
94;31.12.2015;2015;12;20;Torstai;0;0;0
94;31.12.2015;2015;12;21;Torstai;0;0;0
94;31.12.2015;2015;12;22;Torstai;0;0;0
94;31.12.2015;2015;12;23;Torstai;0;1;1
94;01.01.2016;2016;01;00;Perjantai;0;0;0
94;01.01.2016;2016;01;01;Perjantai;1;0;1
94;01.01.2016;2016;01;02;Perjantai;0;1;1
94;01.01.2016;2016;01;03;Perjantai;0;0;0
94;01.01.2016;2016;01;04;Perjantai;0;0;0
94;01.01.2016;2016;01;05;Perjantai;0;0;0
94;01.01.2016;2016;01;06;Perjantai;0;0;0
94;01.01.2016;2016;01;07;Perjantai;0;0;0
94;01.01.2016;2016;01;08;Perjantai;1;0;1
94;01.01.2016;2016;01;09;Perjantai;2;1;3
94;01.01.2016;2016;01;10;Perjantai;0;0;0
94;01.01.2016;2016;01;11;Perjantai;1;2;3
94;01.01.2016;2016;01;12;Perjantai;2;2;4
94;01.01.2016;2016;01;13;Perjantai;1;1;2
94;01.01.2016;2016;01;14;Perjantai;1;1;2
94;01.01.2016;2016;01;15;Perjantai;0;2;2
94;01.01.2016;2016;01;16;Perjantai;3;0;3
94;01.01.2016;2016;01;17;Perjantai;0;1;1
94;01.01.2016;2016;01;18;Perjantai;1;0;1
94;01.01.2016;2016;01;19;Perjantai;0;0;0
94;01.01.2016;2016;01;20;Perjantai;0;0;0
94;01.01.2016;2016;01;21;Perjantai;0;0;0
94;01.01.2016;2016;01;22;Perjantai;1;1;2
94;01.01.2016;2016;01;23;Perjantai;0;0;0
94;02.01.2016;2016;01;00;Lauantai;0;0;0
94;02.01.2016;2016;01;01;Lauantai;0;0;0
94;02.01.2016;2016;01;02;Lauantai;0;0;0
94;02.01.2016;2016;01;03;Lauantai;0;0;0
94;02.01.2016;2016;01;04;Lauantai;0;0;0
94;02.01.2016;2016;01;05;Lauantai;0;0;0
94;02.01.2016;2016;01;06;Lauantai;0;1;1
94;02.01.2016;2016;01;07;Lauantai;0;0;0
94;02.01.2016;2016;01;08;Lauantai;0;0;0
94;02.01.2016;2016;01;09;Lauantai;0;0;0
94;02.01.2016;2016;01;10;Lauantai;1;0;1
94;02.01.2016;2016;01;11;Lauantai;0;2;2
94;02.01.2016;2016;01;12;Lauantai;0;0;0
94;02.01.2016;2016;01;13;Lauantai;0;0;0
94;02.01.2016;2016;01;14;Lauantai;0;0;0
94;02.01.2016;2016;01;15;Lauantai;0;0;0
94;02.01.2016;2016;01;16;Lauantai;2;0;2
94;02.01.2016;2016;01;17;Lauantai;0;0;0
94;02.01.2016;2016;01;18;Lauantai;0;0;0
94;02.01.2016;2016;01;19;Lauantai;0;0;0
94;02.01.2016;2016;01;20;Lauantai;0;0;0
94;02.01.2016;2016;01;21;Lauantai;0;0;0
94;02.01.2016;2016;01;22;Lauantai;0;0;0
94;02.01.2016;2016;01;23;Lauantai;0;0;0
94;03.01.2016;2016;01;00;Sunnuntai;0;0;0
94;03.01.2016;2016;01;01;Sunnuntai;0;0;0
94;03.01.2016;2016;01;02;Sunnuntai;0;0;0
94;03.01.2016;2016;01;03;Sunnuntai;0;0;0
94;03.01.2016;2016;01;04;Sunnuntai;0;0;0
94;03.01.2016;2016;01;05;Sunnuntai;0;0;0
94;03.01.2016;2016;01;06;Sunnuntai;0;0;0
94;03.01.2016;2016;01;07;Sunnuntai;0;0;0
94;03.01.2016;2016;01;08;Sunnuntai;0;0;0
94;03.01.2016;2016;01;09;Sunnuntai;0;0;0
94;03.01.2016;2016;01;10;Sunnuntai;2;1;3
94;03.01.2016;2016;01;11;Sunnuntai;3;0;3
94;03.01.2016;2016;01;12;Sunnuntai;0;1;1
94;03.01.2016;2016;01;13;Sunnuntai;1;1;2
94;03.01.2016;2016;01;14;Sunnuntai;0;1;1
94;03.01.2016;2016;01;15;Sunnuntai;1;0;1
94;03.01.2016;2016;01;16;Sunnuntai;0;2;2
94;03.01.2016;2016;01;17;Sunnuntai;1;0;1
94;03.01.2016;2016;01;18;Sunnuntai;2;1;3
94;03.01.2016;2016;01;19;Sunnuntai;2;0;2
94;03.01.2016;2016;01;20;Sunnuntai;0;0;0
94;03.01.2016;2016;01;21;Sunnuntai;1;2;3
94;03.01.2016;2016;01;22;Sunnuntai;0;0;0
94;03.01.2016;2016;01;23;Sunnuntai;0;0;0
94;04.01.2016;2016;01;00;Maanantai;0;0;0
94;04.01.2016;2016;01;01;Maanantai;0;0;0
94;04.01.2016;2016;01;02;Maanantai;0;0;0
94;04.01.2016;2016;01;03;Maanantai;0;0;0
94;04.01.2016;2016;01;04;Maanantai;0;0;0
94;04.01.2016;2016;01;05;Maanantai;1;1;2
94;04.01.2016;2016;01;06;Maanantai;3;0;3
94;04.01.2016;2016;01;07;Maanantai;5;0;5
94;04.01.2016;2016;01;08;Maanantai;3;0;3
94;04.01.2016;2016;01;09;Maanantai;1;0;1
94;04.01.2016;2016;01;10;Maanantai;1;0;1
94;04.01.2016;2016;01;11;Maanantai;0;0;0
94;04.01.2016;2016;01;12;Maanantai;0;0;0
94;04.01.2016;2016;01;13;Maanantai;0;0;0
94;04.01.2016;2016;01;14;Maanantai;0;0;0
94;04.01.2016;2016;01;15;Maanantai;1;6;7
94;04.01.2016;2016;01;16;Maanantai;0;3;3
94;04.01.2016;2016;01;17;Maanantai;0;0;0
94;04.01.2016;2016;01;18;Maanantai;1;0;1
94;04.01.2016;2016;01;19;Maanantai;0;0;0
94;04.01.2016;2016;01;20;Maanantai;0;2;2
94;04.01.2016;2016;01;21;Maanantai;0;0;0
94;04.01.2016;2016;01;22;Maanantai;0;0;0
94;04.01.2016;2016;01;23;Maanantai;0;0;0
94;05.01.2016;2016;01;00;Tiistai;0;0;0
94;05.01.2016;2016;01;01;Tiistai;0;0;0
94;05.01.2016;2016;01;02;Tiistai;0;0;0
94;05.01.2016;2016;01;03;Tiistai;0;0;0
94;05.01.2016;2016;01;04;Tiistai;1;0;1
94;05.01.2016;2016;01;05;Tiistai;0;0;0
94;05.01.2016;2016;01;06;Tiistai;7;0;7
94;05.01.2016;2016;01;07;Tiistai;3;0;3
94;05.01.2016;2016;01;08;Tiistai;5;0;5
94;05.01.2016;2016;01;09;Tiistai;3;0;3
94;05.01.2016;2016;01;10;Tiistai;0;2;2
94;05.01.2016;2016;01;11;Tiistai;0;0;0
94;05.01.2016;2016;01;12;Tiistai;0;0;0
94;05.01.2016;2016;01;13;Tiistai;0;0;0
94;05.01.2016;2016;01;14;Tiistai;0;0;0
94;05.01.2016;2016;01;15;Tiistai;0;2;2
94;05.01.2016;2016;01;16;Tiistai;1;5;6
94;05.01.2016;2016;01;17;Tiistai;0;4;4
94;05.01.2016;2016;01;18;Tiistai;0;1;1
94;05.01.2016;2016;01;19;Tiistai;1;0;1
94;05.01.2016;2016;01;20;Tiistai;0;0;0
94;05.01.2016;2016;01;21;Tiistai;0;0;0
94;05.01.2016;2016;01;22;Tiistai;0;0;0
94;05.01.2016;2016;01;23;Tiistai;0;0;0
94;06.01.2016;2016;01;00;Keskiviikko;0;0;0
94;06.01.2016;2016;01;01;Keskiviikko;0;0;0
94;06.01.2016;2016;01;02;Keskiviikko;0;0;0
94;06.01.2016;2016;01;03;Keskiviikko;0;0;0
94;06.01.2016;2016;01;04;Keskiviikko;0;0;0
94;06.01.2016;2016;01;05;Keskiviikko;0;0;0
94;06.01.2016;2016;01;06;Keskiviikko;0;0;0
94;06.01.2016;2016;01;07;Keskiviikko;0;0;0
94;06.01.2016;2016;01;08;Keskiviikko;0;0;0
94;06.01.2016;2016;01;09;Keskiviikko;0;0;0
94;06.01.2016;2016;01;10;Keskiviikko;0;0;0
94;06.01.2016;2016;01;11;Keskiviikko;1;0;1
94;06.01.2016;2016;01;12;Keskiviikko;1;0;1
94;06.01.2016;2016;01;13;Keskiviikko;0;0;0
94;06.01.2016;2016;01;14;Keskiviikko;0;0;0
94;06.01.2016;2016;01;15;Keskiviikko;0;0;0
94;06.01.2016;2016;01;16;Keskiviikko;0;0;0
94;06.01.2016;2016;01;17;Keskiviikko;0;2;2
94;06.01.2016;2016;01;18;Keskiviikko;0;1;1
94;06.01.2016;2016;01;19;Keskiviikko;0;0;0
94;06.01.2016;2016;01;20;Keskiviikko;0;0;0
94;06.01.2016;2016;01;21;Keskiviikko;0;0;0
94;06.01.2016;2016;01;22;Keskiviikko;0;0;0
94;06.01.2016;2016;01;23;Keskiviikko;0;0;0
94;07.01.2016;2016;01;00;Torstai;0;0;0
94;07.01.2016;2016;01;01;Torstai;0;0;0
94;07.01.2016;2016;01;02;Torstai;0;0;0
94;07.01.2016;2016;01;03;Torstai;0;0;0
94;07.01.2016;2016;01;04;Torstai;0;0;0
94;07.01.2016;2016;01;05;Torstai;0;0;0
94;07.01.2016;2016;01;06;Torstai;3;0;3
94;07.01.2016;2016;01;07;Torstai;2;0;2
94;07.01.2016;2016;01;08;Torstai;2;0;2
94;07.01.2016;2016;01;09;Torstai;0;0;0
94;07.01.2016;2016;01;10;Torstai;0;0;0
94;07.01.2016;2016;01;11;Torstai;0;0;0
94;07.01.2016;2016;01;12;Torstai;0;0;0
94;07.01.2016;2016;01;13;Torstai;0;0;0
94;07.01.2016;2016;01;14;Torstai;1;0;1
94;07.01.2016;2016;01;15;Torstai;2;1;3
94;07.01.2016;2016;01;16;Torstai;0;3;3
94;07.01.2016;2016;01;17;Torstai;1;1;2
94;07.01.2016;2016;01;18;Torstai;0;0;0
94;07.01.2016;2016;01;19;Torstai;0;0;0
94;07.01.2016;2016;01;20;Torstai;0;0;0
94;07.01.2016;2016;01;21;Torstai;0;0;0
94;07.01.2016;2016;01;22;Torstai;0;0;0
94;07.01.2016;2016;01;23;Torstai;0;0;0
94;08.01.2016;2016;01;00;Perjantai;0;0;0
94;08.01.2016;2016;01;01;Perjantai;0;0;0
94;08.01.2016;2016;01;02;Perjantai;0;0;0
94;08.01.2016;2016;01;03;Perjantai;0;0;0
94;08.01.2016;2016;01;04;Perjantai;0;0;0
94;08.01.2016;2016;01;05;Perjantai;0;0;0
94;08.01.2016;2016;01;06;Perjantai;4;0;4
94;08.01.2016;2016;01;07;Perjantai;5;0;5
94;08.01.2016;2016;01;08;Perjantai;4;0;4
94;08.01.2016;2016;01;09;Perjantai;0;0;0
94;08.01.2016;2016;01;10;Perjantai;0;0;0
94;08.01.2016;2016;01;11;Perjantai;0;0;0
94;08.01.2016;2016;01;12;Perjantai;0;0;0
94;08.01.2016;2016;01;13;Perjantai;0;0;0
94;08.01.2016;2016;01;14;Perjantai;1;1;2
94;08.01.2016;2016;01;15;Perjantai;0;4;4
94;08.01.2016;2016;01;16;Perjantai;0;6;6
94;08.01.2016;2016;01;17;Perjantai;0;3;3
94;08.01.2016;2016;01;18;Perjantai;0;0;0
94;08.01.2016;2016;01;19;Perjantai;1;0;1
94;08.01.2016;2016;01;20;Perjantai;0;0;0
94;08.01.2016;2016;01;21;Perjantai;0;0;0
94;08.01.2016;2016;01;22;Perjantai;0;0;0
94;08.01.2016;2016;01;23;Perjantai;0;0;0
94;09.01.2016;2016;01;00;Lauantai;0;0;0
94;09.01.2016;2016;01;01;Lauantai;0;1;1
94;09.01.2016;2016;01;02;Lauantai;0;0;0
94;09.01.2016;2016;01;03;Lauantai;0;0;0
94;09.01.2016;2016;01;04;Lauantai;0;0;0
94;09.01.2016;2016;01;05;Lauantai;0;0;0
94;09.01.2016;2016;01;06;Lauantai;0;1;1
94;09.01.2016;2016;01;07;Lauantai;0;0;0
94;09.01.2016;2016;01;08;Lauantai;0;0;0
94;09.01.2016;2016;01;09;Lauantai;0;1;1
94;09.01.2016;2016;01;10;Lauantai;0;0;0
94;09.01.2016;2016;01;11;Lauantai;0;0;0
94;09.01.2016;2016;01;12;Lauantai;0;0;0
94;09.01.2016;2016;01;13;Lauantai;0;0;0
94;09.01.2016;2016;01;14;Lauantai;1;1;2
94;09.01.2016;2016;01;15;Lauantai;0;0;0
94;09.01.2016;2016;01;16;Lauantai;1;0;1
94;09.01.2016;2016;01;17;Lauantai;0;0;0
94;09.01.2016;2016;01;18;Lauantai;0;0;0
94;09.01.2016;2016;01;19;Lauantai;1;2;3
94;09.01.2016;2016;01;20;Lauantai;1;1;2
94;09.01.2016;2016;01;21;Lauantai;1;0;1
94;09.01.2016;2016;01;22;Lauantai;0;0;0
94;09.01.2016;2016;01;23;Lauantai;0;0;0
94;10.01.2016;2016;01;00;Sunnuntai;0;0;0
94;10.01.2016;2016;01;01;Sunnuntai;0;0;0
94;10.01.2016;2016;01;02;Sunnuntai;0;0;0
94;10.01.2016;2016;01;03;Sunnuntai;0;0;0
94;10.01.2016;2016;01;04;Sunnuntai;0;1;1
94;10.01.2016;2016;01;05;Sunnuntai;0;0;0
94;10.01.2016;2016;01;06;Sunnuntai;0;0;0
94;10.01.2016;2016;01;07;Sunnuntai;0;0;0
94;10.01.2016;2016;01;08;Sunnuntai;1;0;1
94;10.01.2016;2016;01;09;Sunnuntai;0;1;1
94;10.01.2016;2016;01;10;Sunnuntai;3;3;6
94;10.01.2016;2016;01;11;Sunnuntai;1;1;2
94;10.01.2016;2016;01;12;Sunnuntai;0;0;0
94;10.01.2016;2016;01;13;Sunnuntai;2;1;3
94;10.01.2016;2016;01;14;Sunnuntai;2;0;2
94;10.01.2016;2016;01;15;Sunnuntai;0;1;1
94;10.01.2016;2016;01;16;Sunnuntai;0;0;0
94;10.01.2016;2016;01;17;Sunnuntai;0;0;0
94;10.01.2016;2016;01;18;Sunnuntai;0;1;1
94;10.01.2016;2016;01;19;Sunnuntai;0;0;0
94;10.01.2016;2016;01;20;Sunnuntai;0;0;0
94;10.01.2016;2016;01;21;Sunnuntai;0;0;0
94;10.01.2016;2016;01;22;Sunnuntai;0;0;0
94;10.01.2016;2016;01;23;Sunnuntai;0;0;0
94;11.01.2016;2016;01;00;Maanantai;0;0;0
94;11.01.2016;2016;01;01;Maanantai;0;0;0
94;11.01.2016;2016;01;02;Maanantai;0;0;0
94;11.01.2016;2016;01;03;Maanantai;0;0;0
94;11.01.2016;2016;01;04;Maanantai;0;0;0
94;11.01.2016;2016;01;05;Maanantai;1;2;3
94;11.01.2016;2016;01;06;Maanantai;5;1;6
94;11.01.2016;2016;01;07;Maanantai;8;0;8
94;11.01.2016;2016;01;08;Maanantai;2;2;4
94;11.01.2016;2016;01;09;Maanantai;3;0;3
94;11.01.2016;2016;01;10;Maanantai;0;0;0
94;11.01.2016;2016;01;11;Maanantai;1;0;1
94;11.01.2016;2016;01;12;Maanantai;0;0;0
94;11.01.2016;2016;01;13;Maanantai;1;4;5
94;11.01.2016;2016;01;14;Maanantai;2;3;5
94;11.01.2016;2016;01;15;Maanantai;1;3;4
94;11.01.2016;2016;01;16;Maanantai;1;10;11
94;11.01.2016;2016;01;17;Maanantai;0;2;2
94;11.01.2016;2016;01;18;Maanantai;0;1;1
94;11.01.2016;2016;01;19;Maanantai;0;2;2
94;11.01.2016;2016;01;20;Maanantai;0;0;0
94;11.01.2016;2016;01;21;Maanantai;0;1;1
94;11.01.2016;2016;01;22;Maanantai;0;0;0
94;11.01.2016;2016;01;23;Maanantai;0;0;0
94;12.01.2016;2016;01;00;Tiistai;0;0;0
94;12.01.2016;2016;01;01;Tiistai;0;0;0
94;12.01.2016;2016;01;02;Tiistai;0;0;0
94;12.01.2016;2016;01;03;Tiistai;0;0;0
94;12.01.2016;2016;01;04;Tiistai;0;0;0
94;12.01.2016;2016;01;05;Tiistai;1;2;3
94;12.01.2016;2016;01;06;Tiistai;3;1;4
94;12.01.2016;2016;01;07;Tiistai;8;1;9
94;12.01.2016;2016;01;08;Tiistai;4;0;4
94;12.01.2016;2016;01;09;Tiistai;1;0;1
94;12.01.2016;2016;01;10;Tiistai;2;0;2
94;12.01.2016;2016;01;11;Tiistai;0;0;0
94;12.01.2016;2016;01;12;Tiistai;0;0;0
94;12.01.2016;2016;01;13;Tiistai;1;1;2
94;12.01.2016;2016;01;14;Tiistai;0;1;1
94;12.01.2016;2016;01;15;Tiistai;1;3;4
94;12.01.2016;2016;01;16;Tiistai;3;5;8
94;12.01.2016;2016;01;17;Tiistai;0;3;3
94;12.01.2016;2016;01;18;Tiistai;0;1;1
94;12.01.2016;2016;01;19;Tiistai;0;1;1
94;12.01.2016;2016;01;20;Tiistai;0;1;1
94;12.01.2016;2016;01;21;Tiistai;0;0;0
94;12.01.2016;2016;01;22;Tiistai;0;2;2
94;12.01.2016;2016;01;23;Tiistai;0;0;0
94;13.01.2016;2016;01;00;Keskiviikko;0;0;0
94;13.01.2016;2016;01;01;Keskiviikko;0;0;0
94;13.01.2016;2016;01;02;Keskiviikko;0;0;0
94;13.01.2016;2016;01;03;Keskiviikko;0;0;0
94;13.01.2016;2016;01;04;Keskiviikko;0;0;0
94;13.01.2016;2016;01;05;Keskiviikko;1;2;3
94;13.01.2016;2016;01;06;Keskiviikko;5;0;5
94;13.01.2016;2016;01;07;Keskiviikko;6;1;7
94;13.01.2016;2016;01;08;Keskiviikko;2;0;2
94;13.01.2016;2016;01;09;Keskiviikko;1;0;1
94;13.01.2016;2016;01;10;Keskiviikko;0;2;2
94;13.01.2016;2016;01;11;Keskiviikko;0;1;1
94;13.01.2016;2016;01;12;Keskiviikko;0;0;0
94;13.01.2016;2016;01;13;Keskiviikko;3;0;3
94;13.01.2016;2016;01;14;Keskiviikko;2;2;4
94;13.01.2016;2016;01;15;Keskiviikko;2;4;6
94;13.01.2016;2016;01;16;Keskiviikko;0;6;6
94;13.01.2016;2016;01;17;Keskiviikko;2;2;4
94;13.01.2016;2016;01;18;Keskiviikko;0;1;1
94;13.01.2016;2016;01;19;Keskiviikko;0;0;0
94;13.01.2016;2016;01;20;Keskiviikko;1;3;4
94;13.01.2016;2016;01;21;Keskiviikko;0;1;1
94;13.01.2016;2016;01;22;Keskiviikko;0;1;1
94;13.01.2016;2016;01;23;Keskiviikko;0;0;0
94;14.01.2016;2016;01;00;Torstai;0;0;0
94;14.01.2016;2016;01;01;Torstai;0;0;0
94;14.01.2016;2016;01;02;Torstai;0;0;0
94;14.01.2016;2016;01;03;Torstai;0;0;0
94;14.01.2016;2016;01;04;Torstai;1;0;1
94;14.01.2016;2016;01;05;Torstai;1;0;1
94;14.01.2016;2016;01;06;Torstai;5;0;5
94;14.01.2016;2016;01;07;Torstai;8;1;9
94;14.01.2016;2016;01;08;Torstai;3;0;3
94;14.01.2016;2016;01;09;Torstai;1;0;1
94;14.01.2016;2016;01;10;Torstai;0;0;0
94;14.01.2016;2016;01;11;Torstai;0;0;0
94;14.01.2016;2016;01;12;Torstai;2;0;2
94;14.01.2016;2016;01;13;Torstai;0;0;0
94;14.01.2016;2016;01;14;Torstai;0;3;3
94;14.01.2016;2016;01;15;Torstai;0;7;7
94;14.01.2016;2016;01;16;Torstai;2;6;8
94;14.01.2016;2016;01;17;Torstai;2;4;6
94;14.01.2016;2016;01;18;Torstai;2;0;2
94;14.01.2016;2016;01;19;Torstai;0;4;4
94;14.01.2016;2016;01;20;Torstai;0;0;0
94;14.01.2016;2016;01;21;Torstai;0;0;0
94;14.01.2016;2016;01;22;Torstai;0;1;1
94;14.01.2016;2016;01;23;Torstai;0;0;0
94;15.01.2016;2016;01;00;Perjantai;0;0;0
94;15.01.2016;2016;01;01;Perjantai;0;0;0
94;15.01.2016;2016;01;02;Perjantai;0;0;0
94;15.01.2016;2016;01;03;Perjantai;0;0;0
94;15.01.2016;2016;01;04;Perjantai;1;2;3
94;15.01.2016;2016;01;05;Perjantai;2;0;2
94;15.01.2016;2016;01;06;Perjantai;4;0;4
94;15.01.2016;2016;01;07;Perjantai;7;0;7
94;15.01.2016;2016;01;08;Perjantai;1;0;1
94;15.01.2016;2016;01;09;Perjantai;2;0;2
94;15.01.2016;2016;01;10;Perjantai;2;0;2
94;15.01.2016;2016;01;11;Perjantai;1;0;1
94;15.01.2016;2016;01;12;Perjantai;0;0;0
94;15.01.2016;2016;01;13;Perjantai;0;1;1
94;15.01.2016;2016;01;14;Perjantai;1;1;2
94;15.01.2016;2016;01;15;Perjantai;0;5;5
94;15.01.2016;2016;01;16;Perjantai;0;5;5
94;15.01.2016;2016;01;17;Perjantai;1;3;4
94;15.01.2016;2016;01;18;Perjantai;0;2;2
94;15.01.2016;2016;01;19;Perjantai;1;1;2
94;15.01.2016;2016;01;20;Perjantai;0;0;0
94;15.01.2016;2016;01;21;Perjantai;1;1;2
94;15.01.2016;2016;01;22;Perjantai;0;0;0
94;15.01.2016;2016;01;23;Perjantai;0;0;0
94;16.01.2016;2016;01;00;Lauantai;0;0;0
94;16.01.2016;2016;01;01;Lauantai;0;0;0
94;16.01.2016;2016;01;02;Lauantai;0;0;0
94;16.01.2016;2016;01;03;Lauantai;0;0;0
94;16.01.2016;2016;01;04;Lauantai;0;0;0
94;16.01.2016;2016;01;05;Lauantai;0;0;0
94;16.01.2016;2016;01;06;Lauantai;0;0;0
94;16.01.2016;2016;01;07;Lauantai;0;0;0
94;16.01.2016;2016;01;08;Lauantai;0;0;0
94;16.01.2016;2016;01;09;Lauantai;0;0;0
94;16.01.2016;2016;01;10;Lauantai;0;0;0
94;16.01.2016;2016;01;11;Lauantai;0;1;1
94;16.01.2016;2016;01;12;Lauantai;2;0;2
94;16.01.2016;2016;01;13;Lauantai;0;0;0
94;16.01.2016;2016;01;14;Lauantai;0;0;0
94;16.01.2016;2016;01;15;Lauantai;1;1;2
94;16.01.2016;2016;01;16;Lauantai;0;0;0
94;16.01.2016;2016;01;17;Lauantai;0;0;0
94;16.01.2016;2016;01;18;Lauantai;0;0;0
94;16.01.2016;2016;01;19;Lauantai;1;1;2
94;16.01.2016;2016;01;20;Lauantai;0;0;0
94;16.01.2016;2016;01;21;Lauantai;0;0;0
94;16.01.2016;2016;01;22;Lauantai;0;2;2
94;16.01.2016;2016;01;23;Lauantai;0;0;0
94;17.01.2016;2016;01;00;Sunnuntai;0;0;0
94;17.01.2016;2016;01;01;Sunnuntai;0;0;0
94;17.01.2016;2016;01;02;Sunnuntai;0;0;0
94;17.01.2016;2016;01;03;Sunnuntai;0;0;0
94;17.01.2016;2016;01;04;Sunnuntai;0;0;0
94;17.01.2016;2016;01;05;Sunnuntai;0;0;0
94;17.01.2016;2016;01;06;Sunnuntai;0;0;0
94;17.01.2016;2016;01;07;Sunnuntai;0;0;0
94;17.01.2016;2016;01;08;Sunnuntai;1;0;1
94;17.01.2016;2016;01;09;Sunnuntai;0;0;0
94;17.01.2016;2016;01;10;Sunnuntai;0;0;0
94;17.01.2016;2016;01;11;Sunnuntai;0;1;1
94;17.01.2016;2016;01;12;Sunnuntai;0;0;0
94;17.01.2016;2016;01;13;Sunnuntai;0;0;0
94;17.01.2016;2016;01;14;Sunnuntai;0;0;0
94;17.01.2016;2016;01;15;Sunnuntai;0;0;0
94;17.01.2016;2016;01;16;Sunnuntai;0;2;2
94;17.01.2016;2016;01;17;Sunnuntai;2;0;2
94;17.01.2016;2016;01;18;Sunnuntai;0;0;0
94;17.01.2016;2016;01;19;Sunnuntai;0;1;1
94;17.01.2016;2016;01;20;Sunnuntai;0;0;0
94;17.01.2016;2016;01;21;Sunnuntai;0;0;0
94;17.01.2016;2016;01;22;Sunnuntai;0;0;0
94;17.01.2016;2016;01;23;Sunnuntai;0;0;0
94;18.01.2016;2016;01;00;Maanantai;0;0;0
94;18.01.2016;2016;01;01;Maanantai;0;0;0
94;18.01.2016;2016;01;02;Maanantai;0;2;2
94;18.01.2016;2016;01;03;Maanantai;0;0;0
94;18.01.2016;2016;01;04;Maanantai;0;1;1
94;18.01.2016;2016;01;05;Maanantai;1;1;2
94;18.01.2016;2016;01;06;Maanantai;2;0;2
94;18.01.2016;2016;01;07;Maanantai;5;0;5
94;18.01.2016;2016;01;08;Maanantai;2;1;3
94;18.01.2016;2016;01;09;Maanantai;0;0;0
94;18.01.2016;2016;01;10;Maanantai;0;0;0
94;18.01.2016;2016;01;11;Maanantai;0;0;0
94;18.01.2016;2016;01;12;Maanantai;0;0;0
94;18.01.2016;2016;01;13;Maanantai;2;0;2
94;18.01.2016;2016;01;14;Maanantai;3;1;4
94;18.01.2016;2016;01;15;Maanantai;1;5;6
94;18.01.2016;2016;01;16;Maanantai;1;3;4
94;18.01.2016;2016;01;17;Maanantai;0;3;3
94;18.01.2016;2016;01;18;Maanantai;0;0;0
94;18.01.2016;2016;01;19;Maanantai;0;1;1
94;18.01.2016;2016;01;20;Maanantai;1;0;1
94;18.01.2016;2016;01;21;Maanantai;0;0;0
94;18.01.2016;2016;01;22;Maanantai;0;1;1
94;18.01.2016;2016;01;23;Maanantai;0;0;0
94;19.01.2016;2016;01;00;Tiistai;0;0;0
94;19.01.2016;2016;01;01;Tiistai;0;0;0
94;19.01.2016;2016;01;02;Tiistai;0;0;0
94;19.01.2016;2016;01;03;Tiistai;0;0;0
94;19.01.2016;2016;01;04;Tiistai;0;1;1
94;19.01.2016;2016;01;05;Tiistai;1;0;1
94;19.01.2016;2016;01;06;Tiistai;3;0;3
94;19.01.2016;2016;01;07;Tiistai;3;0;3
94;19.01.2016;2016;01;08;Tiistai;0;0;0
94;19.01.2016;2016;01;09;Tiistai;1;0;1
94;19.01.2016;2016;01;10;Tiistai;0;0;0
94;19.01.2016;2016;01;11;Tiistai;0;0;0
94;19.01.2016;2016;01;12;Tiistai;0;0;0
94;19.01.2016;2016;01;13;Tiistai;1;0;1
94;19.01.2016;2016;01;14;Tiistai;0;1;1
94;19.01.2016;2016;01;15;Tiistai;0;3;3
94;19.01.2016;2016;01;16;Tiistai;1;3;4
94;19.01.2016;2016;01;17;Tiistai;0;1;1
94;19.01.2016;2016;01;18;Tiistai;0;0;0
94;19.01.2016;2016;01;19;Tiistai;0;1;1
94;19.01.2016;2016;01;20;Tiistai;2;1;3
94;19.01.2016;2016;01;21;Tiistai;0;0;0
94;19.01.2016;2016;01;22;Tiistai;0;1;1
94;19.01.2016;2016;01;23;Tiistai;0;0;0
94;20.01.2016;2016;01;00;Keskiviikko;0;0;0
94;20.01.2016;2016;01;01;Keskiviikko;0;0;0
94;20.01.2016;2016;01;02;Keskiviikko;0;0;0
94;20.01.2016;2016;01;03;Keskiviikko;0;0;0
94;20.01.2016;2016;01;04;Keskiviikko;0;1;1
94;20.01.2016;2016;01;05;Keskiviikko;1;1;2
94;20.01.2016;2016;01;06;Keskiviikko;3;0;3
94;20.01.2016;2016;01;07;Keskiviikko;4;1;5
94;20.01.2016;2016;01;08;Keskiviikko;3;0;3
94;20.01.2016;2016;01;09;Keskiviikko;0;0;0
94;20.01.2016;2016;01;10;Keskiviikko;0;0;0
94;20.01.2016;2016;01;11;Keskiviikko;2;1;3
94;20.01.2016;2016;01;12;Keskiviikko;0;0;0
94;20.01.2016;2016;01;13;Keskiviikko;1;2;3
94;20.01.2016;2016;01;14;Keskiviikko;1;1;2
94;20.01.2016;2016;01;15;Keskiviikko;2;2;4
94;20.01.2016;2016;01;16;Keskiviikko;0;5;5
94;20.01.2016;2016;01;17;Keskiviikko;0;1;1
94;20.01.2016;2016;01;18;Keskiviikko;1;1;2
94;20.01.2016;2016;01;19;Keskiviikko;1;2;3
94;20.01.2016;2016;01;20;Keskiviikko;0;0;0
94;20.01.2016;2016;01;21;Keskiviikko;0;1;1
94;20.01.2016;2016;01;22;Keskiviikko;0;0;0
94;20.01.2016;2016;01;23;Keskiviikko;0;0;0
94;21.01.2016;2016;01;00;Torstai;0;0;0
94;21.01.2016;2016;01;01;Torstai;0;0;0
94;21.01.2016;2016;01;02;Torstai;0;0;0
94;21.01.2016;2016;01;03;Torstai;0;0;0
94;21.01.2016;2016;01;04;Torstai;0;0;0
94;21.01.2016;2016;01;05;Torstai;1;0;1
94;21.01.2016;2016;01;06;Torstai;3;0;3
94;21.01.2016;2016;01;07;Torstai;6;0;6
94;21.01.2016;2016;01;08;Torstai;0;0;0
94;21.01.2016;2016;01;09;Torstai;0;0;0
94;21.01.2016;2016;01;10;Torstai;0;0;0
94;21.01.2016;2016;01;11;Torstai;0;0;0
94;21.01.2016;2016;01;12;Torstai;1;0;1
94;21.01.2016;2016;01;13;Torstai;0;0;0
94;21.01.2016;2016;01;14;Torstai;0;1;1
94;21.01.2016;2016;01;15;Torstai;0;3;3
94;21.01.2016;2016;01;16;Torstai;0;2;2
94;21.01.2016;2016;01;17;Torstai;0;0;0
94;21.01.2016;2016;01;18;Torstai;0;2;2
94;21.01.2016;2016;01;19;Torstai;0;0;0
94;21.01.2016;2016;01;20;Torstai;0;0;0
94;21.01.2016;2016;01;21;Torstai;0;0;0
94;21.01.2016;2016;01;22;Torstai;1;0;1
94;21.01.2016;2016;01;23;Torstai;0;0;0
94;22.01.2016;2016;01;00;Perjantai;0;0;0
94;22.01.2016;2016;01;01;Perjantai;0;0;0
94;22.01.2016;2016;01;02;Perjantai;0;0;0
94;22.01.2016;2016;01;03;Perjantai;0;0;0
94;22.01.2016;2016;01;04;Perjantai;0;0;0
94;22.01.2016;2016;01;05;Perjantai;2;1;3
94;22.01.2016;2016;01;06;Perjantai;2;0;2
94;22.01.2016;2016;01;07;Perjantai;3;1;4
94;22.01.2016;2016;01;08;Perjantai;2;0;2
94;22.01.2016;2016;01;09;Perjantai;1;0;1
94;22.01.2016;2016;01;10;Perjantai;1;1;2
94;22.01.2016;2016;01;11;Perjantai;2;1;3
94;22.01.2016;2016;01;12;Perjantai;0;0;0
94;22.01.2016;2016;01;13;Perjantai;0;2;2
94;22.01.2016;2016;01;14;Perjantai;1;2;3
94;22.01.2016;2016;01;15;Perjantai;2;2;4
94;22.01.2016;2016;01;16;Perjantai;0;4;4
94;22.01.2016;2016;01;17;Perjantai;1;3;4
94;22.01.2016;2016;01;18;Perjantai;0;1;1
94;22.01.2016;2016;01;19;Perjantai;0;0;0
94;22.01.2016;2016;01;20;Perjantai;2;1;3
94;22.01.2016;2016;01;21;Perjantai;1;4;5
94;22.01.2016;2016;01;22;Perjantai;0;0;0
94;22.01.2016;2016;01;23;Perjantai;0;0;0
94;23.01.2016;2016;01;00;Lauantai;0;0;0
94;23.01.2016;2016;01;01;Lauantai;0;0;0
94;23.01.2016;2016;01;02;Lauantai;0;0;0
94;23.01.2016;2016;01;03;Lauantai;0;0;0
94;23.01.2016;2016;01;04;Lauantai;0;0;0
94;23.01.2016;2016;01;05;Lauantai;0;0;0
94;23.01.2016;2016;01;06;Lauantai;0;1;1
94;23.01.2016;2016;01;07;Lauantai;2;0;2
94;23.01.2016;2016;01;08;Lauantai;0;0;0
94;23.01.2016;2016;01;09;Lauantai;1;3;4
94;23.01.2016;2016;01;10;Lauantai;2;1;3
94;23.01.2016;2016;01;11;Lauantai;4;1;5
94;23.01.2016;2016;01;12;Lauantai;2;1;3
94;23.01.2016;2016;01;13;Lauantai;2;2;4
94;23.01.2016;2016;01;14;Lauantai;0;2;2
94;23.01.2016;2016;01;15;Lauantai;1;2;3
94;23.01.2016;2016;01;16;Lauantai;2;3;5
94;23.01.2016;2016;01;17;Lauantai;0;1;1
94;23.01.2016;2016;01;18;Lauantai;1;0;1
94;23.01.2016;2016;01;19;Lauantai;1;0;1
94;23.01.2016;2016;01;20;Lauantai;0;0;0
94;23.01.2016;2016;01;21;Lauantai;0;1;1
94;23.01.2016;2016;01;22;Lauantai;0;0;0
94;23.01.2016;2016;01;23;Lauantai;0;0;0
94;24.01.2016;2016;01;00;Sunnuntai;0;0;0
94;24.01.2016;2016;01;01;Sunnuntai;0;0;0
94;24.01.2016;2016;01;02;Sunnuntai;0;0;0
94;24.01.2016;2016;01;03;Sunnuntai;0;0;0
94;24.01.2016;2016;01;04;Sunnuntai;2;0;2
94;24.01.2016;2016;01;05;Sunnuntai;0;0;0
94;24.01.2016;2016;01;06;Sunnuntai;0;0;0
94;24.01.2016;2016;01;07;Sunnuntai;1;2;3
94;24.01.2016;2016;01;08;Sunnuntai;1;1;2
94;24.01.2016;2016;01;09;Sunnuntai;1;0;1
94;24.01.2016;2016;01;10;Sunnuntai;1;0;1
94;24.01.2016;2016;01;11;Sunnuntai;0;1;1
94;24.01.2016;2016;01;12;Sunnuntai;2;0;2
94;24.01.2016;2016;01;13;Sunnuntai;1;3;4
94;24.01.2016;2016;01;14;Sunnuntai;1;2;3
94;24.01.2016;2016;01;15;Sunnuntai;1;1;2
94;24.01.2016;2016;01;16;Sunnuntai;2;1;3
94;24.01.2016;2016;01;17;Sunnuntai;1;0;1
94;24.01.2016;2016;01;18;Sunnuntai;2;0;2
94;24.01.2016;2016;01;19;Sunnuntai;2;1;3
94;24.01.2016;2016;01;20;Sunnuntai;2;1;3
94;24.01.2016;2016;01;21;Sunnuntai;0;1;1
94;24.01.2016;2016;01;22;Sunnuntai;0;0;0
94;24.01.2016;2016;01;23;Sunnuntai;0;0;0
94;25.01.2016;2016;01;00;Maanantai;0;0;0
94;25.01.2016;2016;01;01;Maanantai;0;0;0
94;25.01.2016;2016;01;02;Maanantai;0;0;0
94;25.01.2016;2016;01;03;Maanantai;0;0;0
94;25.01.2016;2016;01;04;Maanantai;0;0;0
94;25.01.2016;2016;01;05;Maanantai;2;1;3
94;25.01.2016;2016;01;06;Maanantai;4;0;4
94;25.01.2016;2016;01;07;Maanantai;10;2;12
94;25.01.2016;2016;01;08;Maanantai;5;2;7
94;25.01.2016;2016;01;09;Maanantai;3;1;4
94;25.01.2016;2016;01;10;Maanantai;0;0;0
94;25.01.2016;2016;01;11;Maanantai;1;0;1
94;25.01.2016;2016;01;12;Maanantai;0;0;0
94;25.01.2016;2016;01;13;Maanantai;1;3;4
94;25.01.2016;2016;01;14;Maanantai;2;2;4
94;25.01.2016;2016;01;15;Maanantai;0;8;8
94;25.01.2016;2016;01;16;Maanantai;4;7;11
94;25.01.2016;2016;01;17;Maanantai;0;2;2
94;25.01.2016;2016;01;18;Maanantai;0;1;1
94;25.01.2016;2016;01;19;Maanantai;0;2;2
94;25.01.2016;2016;01;20;Maanantai;1;1;2
94;25.01.2016;2016;01;21;Maanantai;1;1;2
94;25.01.2016;2016;01;22;Maanantai;0;2;2
94;25.01.2016;2016;01;23;Maanantai;0;0;0
94;26.01.2016;2016;01;00;Tiistai;0;0;0
94;26.01.2016;2016;01;01;Tiistai;0;0;0
94;26.01.2016;2016;01;02;Tiistai;0;0;0
94;26.01.2016;2016;01;03;Tiistai;0;0;0
94;26.01.2016;2016;01;04;Tiistai;0;0;0
94;26.01.2016;2016;01;05;Tiistai;2;1;3
94;26.01.2016;2016;01;06;Tiistai;7;0;7
94;26.01.2016;2016;01;07;Tiistai;8;1;9
94;26.01.2016;2016;01;08;Tiistai;3;1;4
94;26.01.2016;2016;01;09;Tiistai;1;0;1
94;26.01.2016;2016;01;10;Tiistai;0;0;0
94;26.01.2016;2016;01;11;Tiistai;0;0;0
94;26.01.2016;2016;01;12;Tiistai;0;0;0
94;26.01.2016;2016;01;13;Tiistai;2;0;2
94;26.01.2016;2016;01;14;Tiistai;2;1;3
94;26.01.2016;2016;01;15;Tiistai;0;12;12
94;26.01.2016;2016;01;16;Tiistai;1;9;10
94;26.01.2016;2016;01;17;Tiistai;0;2;2
94;26.01.2016;2016;01;18;Tiistai;0;5;5
94;26.01.2016;2016;01;19;Tiistai;4;2;6
94;26.01.2016;2016;01;20;Tiistai;1;2;3
94;26.01.2016;2016;01;21;Tiistai;0;3;3
94;26.01.2016;2016;01;22;Tiistai;0;1;1
94;26.01.2016;2016;01;23;Tiistai;0;0;0
94;27.01.2016;2016;01;00;Keskiviikko;0;0;0
94;27.01.2016;2016;01;01;Keskiviikko;0;0;0
94;27.01.2016;2016;01;02;Keskiviikko;0;0;0
94;27.01.2016;2016;01;03;Keskiviikko;0;0;0
94;27.01.2016;2016;01;04;Keskiviikko;0;0;0
94;27.01.2016;2016;01;05;Keskiviikko;2;0;2
94;27.01.2016;2016;01;06;Keskiviikko;8;0;8
94;27.01.2016;2016;01;07;Keskiviikko;7;2;9
94;27.01.2016;2016;01;08;Keskiviikko;5;0;5
94;27.01.2016;2016;01;09;Keskiviikko;0;2;2
94;27.01.2016;2016;01;10;Keskiviikko;0;0;0
94;27.01.2016;2016;01;11;Keskiviikko;2;1;3
94;27.01.2016;2016;01;12;Keskiviikko;0;0;0
94;27.01.2016;2016;01;13;Keskiviikko;0;0;0
94;27.01.2016;2016;01;14;Keskiviikko;2;2;4
94;27.01.2016;2016;01;15;Keskiviikko;0;16;16
94;27.01.2016;2016;01;16;Keskiviikko;2;6;8
94;27.01.2016;2016;01;17;Keskiviikko;1;3;4
94;27.01.2016;2016;01;18;Keskiviikko;1;3;4
94;27.01.2016;2016;01;19;Keskiviikko;0;3;3
94;27.01.2016;2016;01;20;Keskiviikko;2;1;3
94;27.01.2016;2016;01;21;Keskiviikko;0;0;0
94;27.01.2016;2016;01;22;Keskiviikko;0;1;1
94;27.01.2016;2016;01;23;Keskiviikko;0;0;0
94;28.01.2016;2016;01;00;Torstai;0;0;0
94;28.01.2016;2016;01;01;Torstai;0;0;0
94;28.01.2016;2016;01;02;Torstai;0;0;0
94;28.01.2016;2016;01;03;Torstai;0;0;0
94;28.01.2016;2016;01;04;Torstai;0;0;0
94;28.01.2016;2016;01;05;Torstai;3;0;3
94;28.01.2016;2016;01;06;Torstai;4;0;4
94;28.01.2016;2016;01;07;Torstai;7;0;7
94;28.01.2016;2016;01;08;Torstai;5;0;5
94;28.01.2016;2016;01;09;Torstai;1;0;1
94;28.01.2016;2016;01;10;Torstai;1;0;1
94;28.01.2016;2016;01;11;Torstai;0;0;0
94;28.01.2016;2016;01;12;Torstai;0;0;0
94;28.01.2016;2016;01;13;Torstai;2;1;3
94;28.01.2016;2016;01;14;Torstai;1;5;6
94;28.01.2016;2016;01;15;Torstai;0;8;8
94;28.01.2016;2016;01;16;Torstai;1;10;11
94;28.01.2016;2016;01;17;Torstai;1;1;2
94;28.01.2016;2016;01;18;Torstai;0;2;2
94;28.01.2016;2016;01;19;Torstai;0;5;5
94;28.01.2016;2016;01;20;Torstai;0;0;0
94;28.01.2016;2016;01;21;Torstai;0;0;0
94;28.01.2016;2016;01;22;Torstai;0;1;1
94;28.01.2016;2016;01;23;Torstai;0;0;0
94;29.01.2016;2016;01;00;Perjantai;0;0;0
94;29.01.2016;2016;01;01;Perjantai;0;0;0
94;29.01.2016;2016;01;02;Perjantai;0;0;0
94;29.01.2016;2016;01;03;Perjantai;0;0;0
94;29.01.2016;2016;01;04;Perjantai;0;0;0
94;29.01.2016;2016;01;05;Perjantai;2;1;3
94;29.01.2016;2016;01;06;Perjantai;5;1;6
94;29.01.2016;2016;01;07;Perjantai;6;2;8
94;29.01.2016;2016;01;08;Perjantai;2;0;2
94;29.01.2016;2016;01;09;Perjantai;0;2;2
94;29.01.2016;2016;01;10;Perjantai;0;0;0
94;29.01.2016;2016;01;11;Perjantai;0;1;1
94;29.01.2016;2016;01;12;Perjantai;0;1;1
94;29.01.2016;2016;01;13;Perjantai;2;0;2
94;29.01.2016;2016;01;14;Perjantai;1;4;5
94;29.01.2016;2016;01;15;Perjantai;2;2;4
94;29.01.2016;2016;01;16;Perjantai;4;6;10
94;29.01.2016;2016;01;17;Perjantai;1;3;4
94;29.01.2016;2016;01;18;Perjantai;0;3;3
94;29.01.2016;2016;01;19;Perjantai;2;2;4
94;29.01.2016;2016;01;20;Perjantai;2;2;4
94;29.01.2016;2016;01;21;Perjantai;0;1;1
94;29.01.2016;2016;01;22;Perjantai;0;2;2
94;29.01.2016;2016;01;23;Perjantai;2;0;2
94;30.01.2016;2016;01;00;Lauantai;0;0;0
94;30.01.2016;2016;01;01;Lauantai;0;0;0
94;30.01.2016;2016;01;02;Lauantai;0;0;0
94;30.01.2016;2016;01;03;Lauantai;0;0;0
94;30.01.2016;2016;01;04;Lauantai;0;0;0
94;30.01.2016;2016;01;05;Lauantai;0;0;0
94;30.01.2016;2016;01;06;Lauantai;0;0;0
94;30.01.2016;2016;01;07;Lauantai;0;0;0
94;30.01.2016;2016;01;08;Lauantai;0;0;0
94;30.01.2016;2016;01;09;Lauantai;2;1;3
94;30.01.2016;2016;01;10;Lauantai;0;1;1
94;30.01.2016;2016;01;11;Lauantai;3;3;6
94;30.01.2016;2016;01;12;Lauantai;2;0;2
94;30.01.2016;2016;01;13;Lauantai;0;1;1
94;30.01.2016;2016;01;14;Lauantai;1;1;2
94;30.01.2016;2016;01;15;Lauantai;0;2;2
94;30.01.2016;2016;01;16;Lauantai;0;1;1
94;30.01.2016;2016;01;17;Lauantai;1;0;1
94;30.01.2016;2016;01;18;Lauantai;0;2;2
94;30.01.2016;2016;01;19;Lauantai;0;0;0
94;30.01.2016;2016;01;20;Lauantai;0;1;1
94;30.01.2016;2016;01;21;Lauantai;0;0;0
94;30.01.2016;2016;01;22;Lauantai;0;0;0
94;30.01.2016;2016;01;23;Lauantai;0;0;0
94;31.01.2016;2016;01;00;Sunnuntai;0;0;0
94;31.01.2016;2016;01;01;Sunnuntai;0;0;0
94;31.01.2016;2016;01;02;Sunnuntai;0;0;0
94;31.01.2016;2016;01;03;Sunnuntai;0;0;0
94;31.01.2016;2016;01;04;Sunnuntai;0;0;0
94;31.01.2016;2016;01;05;Sunnuntai;0;0;0
94;31.01.2016;2016;01;06;Sunnuntai;0;0;0
94;31.01.2016;2016;01;07;Sunnuntai;2;0;2
94;31.01.2016;2016;01;08;Sunnuntai;0;0;0
94;31.01.2016;2016;01;09;Sunnuntai;1;0;1
94;31.01.2016;2016;01;10;Sunnuntai;1;1;2
94;31.01.2016;2016;01;11;Sunnuntai;1;0;1
94;31.01.2016;2016;01;12;Sunnuntai;0;0;0
94;31.01.2016;2016;01;13;Sunnuntai;3;5;8
94;31.01.2016;2016;01;14;Sunnuntai;0;1;1
94;31.01.2016;2016;01;15;Sunnuntai;3;1;4
94;31.01.2016;2016;01;16;Sunnuntai;2;0;2
94;31.01.2016;2016;01;17;Sunnuntai;0;2;2
94;31.01.2016;2016;01;18;Sunnuntai;1;2;3
94;31.01.2016;2016;01;19;Sunnuntai;0;3;3
94;31.01.2016;2016;01;20;Sunnuntai;1;0;1
94;31.01.2016;2016;01;21;Sunnuntai;0;0;0
94;31.01.2016;2016;01;22;Sunnuntai;0;0;0
94;31.01.2016;2016;01;23;Sunnuntai;0;0;0
94;01.02.2016;2016;02;00;Maanantai;0;0;0
94;01.02.2016;2016;02;01;Maanantai;0;0;0
94;01.02.2016;2016;02;02;Maanantai;0;0;0
94;01.02.2016;2016;02;03;Maanantai;0;0;0
94;01.02.2016;2016;02;04;Maanantai;0;0;0
94;01.02.2016;2016;02;05;Maanantai;1;1;2
94;01.02.2016;2016;02;06;Maanantai;5;0;5
94;01.02.2016;2016;02;07;Maanantai;9;2;11
94;01.02.2016;2016;02;08;Maanantai;8;2;10
94;01.02.2016;2016;02;09;Maanantai;1;1;2
94;01.02.2016;2016;02;10;Maanantai;1;0;1
94;01.02.2016;2016;02;11;Maanantai;0;0;0
94;01.02.2016;2016;02;12;Maanantai;3;1;4
94;01.02.2016;2016;02;13;Maanantai;0;1;1
94;01.02.2016;2016;02;14;Maanantai;2;6;8
94;01.02.2016;2016;02;15;Maanantai;1;9;10
94;01.02.2016;2016;02;16;Maanantai;3;11;14
94;01.02.2016;2016;02;17;Maanantai;0;4;4
94;01.02.2016;2016;02;18;Maanantai;1;3;4
94;01.02.2016;2016;02;19;Maanantai;0;2;2
94;01.02.2016;2016;02;20;Maanantai;1;0;1
94;01.02.2016;2016;02;21;Maanantai;0;0;0
94;01.02.2016;2016;02;22;Maanantai;0;0;0
94;01.02.2016;2016;02;23;Maanantai;0;0;0
94;02.02.2016;2016;02;00;Tiistai;0;0;0
94;02.02.2016;2016;02;01;Tiistai;0;0;0
94;02.02.2016;2016;02;02;Tiistai;0;0;0
94;02.02.2016;2016;02;03;Tiistai;0;0;0
94;02.02.2016;2016;02;04;Tiistai;0;0;0
94;02.02.2016;2016;02;05;Tiistai;3;1;4
94;02.02.2016;2016;02;06;Tiistai;6;2;8
94;02.02.2016;2016;02;07;Tiistai;9;2;11
94;02.02.2016;2016;02;08;Tiistai;2;0;2
94;02.02.2016;2016;02;09;Tiistai;2;0;2
94;02.02.2016;2016;02;10;Tiistai;0;0;0
94;02.02.2016;2016;02;11;Tiistai;0;2;2
94;02.02.2016;2016;02;12;Tiistai;1;0;1
94;02.02.2016;2016;02;13;Tiistai;1;0;1
94;02.02.2016;2016;02;14;Tiistai;1;2;3
94;02.02.2016;2016;02;15;Tiistai;2;7;9
94;02.02.2016;2016;02;16;Tiistai;2;14;16
94;02.02.2016;2016;02;17;Tiistai;2;1;3
94;02.02.2016;2016;02;18;Tiistai;1;1;2
94;02.02.2016;2016;02;19;Tiistai;1;4;5
94;02.02.2016;2016;02;20;Tiistai;1;1;2
94;02.02.2016;2016;02;21;Tiistai;0;1;1
94;02.02.2016;2016;02;22;Tiistai;0;0;0
94;02.02.2016;2016;02;23;Tiistai;0;0;0
94;03.02.2016;2016;02;00;Keskiviikko;0;0;0
94;03.02.2016;2016;02;01;Keskiviikko;0;0;0
94;03.02.2016;2016;02;02;Keskiviikko;0;0;0
94;03.02.2016;2016;02;03;Keskiviikko;0;0;0
94;03.02.2016;2016;02;04;Keskiviikko;1;0;1
94;03.02.2016;2016;02;05;Keskiviikko;2;0;2
94;03.02.2016;2016;02;06;Keskiviikko;6;1;7
94;03.02.2016;2016;02;07;Keskiviikko;5;0;5
94;03.02.2016;2016;02;08;Keskiviikko;6;1;7
94;03.02.2016;2016;02;09;Keskiviikko;2;0;2
94;03.02.2016;2016;02;10;Keskiviikko;1;0;1
94;03.02.2016;2016;02;11;Keskiviikko;0;1;1
94;03.02.2016;2016;02;12;Keskiviikko;2;0;2
94;03.02.2016;2016;02;13;Keskiviikko;2;1;3
94;03.02.2016;2016;02;14;Keskiviikko;1;3;4
94;03.02.2016;2016;02;15;Keskiviikko;1;8;9
94;03.02.2016;2016;02;16;Keskiviikko;1;6;7
94;03.02.2016;2016;02;17;Keskiviikko;0;3;3
94;03.02.2016;2016;02;18;Keskiviikko;0;2;2
94;03.02.2016;2016;02;19;Keskiviikko;0;1;1
94;03.02.2016;2016;02;20;Keskiviikko;1;2;3
94;03.02.2016;2016;02;21;Keskiviikko;0;2;2
94;03.02.2016;2016;02;22;Keskiviikko;0;1;1
94;03.02.2016;2016;02;23;Keskiviikko;0;0;0
94;04.02.2016;2016;02;00;Torstai;0;0;0
94;04.02.2016;2016;02;01;Torstai;0;0;0
94;04.02.2016;2016;02;02;Torstai;0;0;0
94;04.02.2016;2016;02;03;Torstai;0;0;0
94;04.02.2016;2016;02;04;Torstai;1;0;1
94;04.02.2016;2016;02;05;Torstai;1;1;2
94;04.02.2016;2016;02;06;Torstai;5;1;6
94;04.02.2016;2016;02;07;Torstai;12;1;13
94;04.02.2016;2016;02;08;Torstai;5;1;6
94;04.02.2016;2016;02;09;Torstai;0;0;0
94;04.02.2016;2016;02;10;Torstai;0;0;0
94;04.02.2016;2016;02;11;Torstai;0;4;4
94;04.02.2016;2016;02;12;Torstai;2;1;3
94;04.02.2016;2016;02;13;Torstai;1;0;1
94;04.02.2016;2016;02;14;Torstai;3;2;5
94;04.02.2016;2016;02;15;Torstai;1;6;7
94;04.02.2016;2016;02;16;Torstai;2;8;10
94;04.02.2016;2016;02;17;Torstai;0;3;3
94;04.02.2016;2016;02;18;Torstai;1;2;3
94;04.02.2016;2016;02;19;Torstai;2;2;4
94;04.02.2016;2016;02;20;Torstai;1;2;3
94;04.02.2016;2016;02;21;Torstai;0;1;1
94;04.02.2016;2016;02;22;Torstai;0;0;0
94;04.02.2016;2016;02;23;Torstai;0;0;0
94;05.02.2016;2016;02;00;Perjantai;0;0;0
94;05.02.2016;2016;02;01;Perjantai;0;0;0
94;05.02.2016;2016;02;02;Perjantai;0;0;0
94;05.02.2016;2016;02;03;Perjantai;0;0;0
94;05.02.2016;2016;02;04;Perjantai;0;0;0
94;05.02.2016;2016;02;05;Perjantai;3;0;3
94;05.02.2016;2016;02;06;Perjantai;4;1;5
94;05.02.2016;2016;02;07;Perjantai;8;0;8
94;05.02.2016;2016;02;08;Perjantai;4;0;4
94;05.02.2016;2016;02;09;Perjantai;1;0;1
94;05.02.2016;2016;02;10;Perjantai;0;1;1
94;05.02.2016;2016;02;11;Perjantai;0;0;0
94;05.02.2016;2016;02;12;Perjantai;1;1;2
94;05.02.2016;2016;02;13;Perjantai;1;1;2
94;05.02.2016;2016;02;14;Perjantai;0;3;3
94;05.02.2016;2016;02;15;Perjantai;1;4;5
94;05.02.2016;2016;02;16;Perjantai;1;9;10
94;05.02.2016;2016;02;17;Perjantai;1;2;3
94;05.02.2016;2016;02;18;Perjantai;0;1;1
94;05.02.2016;2016;02;19;Perjantai;1;0;1
94;05.02.2016;2016;02;20;Perjantai;0;0;0
94;05.02.2016;2016;02;21;Perjantai;0;0;0
94;05.02.2016;2016;02;22;Perjantai;0;2;2
94;05.02.2016;2016;02;23;Perjantai;0;1;1
94;06.02.2016;2016;02;00;Lauantai;0;0;0
94;06.02.2016;2016;02;01;Lauantai;0;0;0
94;06.02.2016;2016;02;02;Lauantai;0;0;0
94;06.02.2016;2016;02;03;Lauantai;0;0;0
94;06.02.2016;2016;02;04;Lauantai;0;0;0
94;06.02.2016;2016;02;05;Lauantai;0;0;0
94;06.02.2016;2016;02;06;Lauantai;0;1;1
94;06.02.2016;2016;02;07;Lauantai;0;0;0
94;06.02.2016;2016;02;08;Lauantai;0;0;0
94;06.02.2016;2016;02;09;Lauantai;0;1;1
94;06.02.2016;2016;02;10;Lauantai;2;0;2
94;06.02.2016;2016;02;11;Lauantai;2;1;3
94;06.02.2016;2016;02;12;Lauantai;3;0;3
94;06.02.2016;2016;02;13;Lauantai;1;2;3
94;06.02.2016;2016;02;14;Lauantai;2;3;5
94;06.02.2016;2016;02;15;Lauantai;1;0;1
94;06.02.2016;2016;02;16;Lauantai;0;2;2
94;06.02.2016;2016;02;17;Lauantai;0;0;0
94;06.02.2016;2016;02;18;Lauantai;1;0;1
94;06.02.2016;2016;02;19;Lauantai;1;0;1
94;06.02.2016;2016;02;20;Lauantai;0;0;0
94;06.02.2016;2016;02;21;Lauantai;0;0;0
94;06.02.2016;2016;02;22;Lauantai;0;1;1
94;06.02.2016;2016;02;23;Lauantai;0;0;0
94;07.02.2016;2016;02;00;Sunnuntai;0;0;0
94;07.02.2016;2016;02;01;Sunnuntai;0;0;0
94;07.02.2016;2016;02;02;Sunnuntai;0;0;0
94;07.02.2016;2016;02;03;Sunnuntai;0;0;0
94;07.02.2016;2016;02;04;Sunnuntai;0;0;0
94;07.02.2016;2016;02;05;Sunnuntai;0;0;0
94;07.02.2016;2016;02;06;Sunnuntai;0;0;0
94;07.02.2016;2016;02;07;Sunnuntai;0;0;0
94;07.02.2016;2016;02;08;Sunnuntai;0;0;0
94;07.02.2016;2016;02;09;Sunnuntai;2;2;4
94;07.02.2016;2016;02;10;Sunnuntai;0;0;0
94;07.02.2016;2016;02;11;Sunnuntai;1;0;1
94;07.02.2016;2016;02;12;Sunnuntai;3;1;4
94;07.02.2016;2016;02;13;Sunnuntai;0;2;2
94;07.02.2016;2016;02;14;Sunnuntai;0;2;2
94;07.02.2016;2016;02;15;Sunnuntai;1;1;2
94;07.02.2016;2016;02;16;Sunnuntai;0;0;0
94;07.02.2016;2016;02;17;Sunnuntai;0;1;1
94;07.02.2016;2016;02;18;Sunnuntai;1;0;1
94;07.02.2016;2016;02;19;Sunnuntai;1;0;1
94;07.02.2016;2016;02;20;Sunnuntai;0;0;0
94;07.02.2016;2016;02;21;Sunnuntai;0;0;0
94;07.02.2016;2016;02;22;Sunnuntai;0;0;0
94;07.02.2016;2016;02;23;Sunnuntai;0;0;0
94;08.02.2016;2016;02;00;Maanantai;0;0;0
94;08.02.2016;2016;02;01;Maanantai;0;0;0
94;08.02.2016;2016;02;02;Maanantai;0;1;1
94;08.02.2016;2016;02;03;Maanantai;0;0;0
94;08.02.2016;2016;02;04;Maanantai;0;0;0
94;08.02.2016;2016;02;05;Maanantai;2;1;3
94;08.02.2016;2016;02;06;Maanantai;6;1;7
94;08.02.2016;2016;02;07;Maanantai;4;4;8
94;08.02.2016;2016;02;08;Maanantai;5;0;5
94;08.02.2016;2016;02;09;Maanantai;3;1;4
94;08.02.2016;2016;02;10;Maanantai;0;0;0
94;08.02.2016;2016;02;11;Maanantai;0;0;0
94;08.02.2016;2016;02;12;Maanantai;0;0;0
94;08.02.2016;2016;02;13;Maanantai;1;0;1
94;08.02.2016;2016;02;14;Maanantai;2;4;6
94;08.02.2016;2016;02;15;Maanantai;1;4;5
94;08.02.2016;2016;02;16;Maanantai;1;8;9
94;08.02.2016;2016;02;17;Maanantai;2;4;6
94;08.02.2016;2016;02;18;Maanantai;2;4;6
94;08.02.2016;2016;02;19;Maanantai;1;3;4
94;08.02.2016;2016;02;20;Maanantai;0;0;0
94;08.02.2016;2016;02;21;Maanantai;0;0;0
94;08.02.2016;2016;02;22;Maanantai;0;0;0
94;08.02.2016;2016;02;23;Maanantai;0;0;0
94;09.02.2016;2016;02;00;Tiistai;0;0;0
94;09.02.2016;2016;02;01;Tiistai;0;0;0
94;09.02.2016;2016;02;02;Tiistai;0;1;1
94;09.02.2016;2016;02;03;Tiistai;0;0;0
94;09.02.2016;2016;02;04;Tiistai;0;0;0
94;09.02.2016;2016;02;05;Tiistai;2;0;2
94;09.02.2016;2016;02;06;Tiistai;5;2;7
94;09.02.2016;2016;02;07;Tiistai;3;0;3
94;09.02.2016;2016;02;08;Tiistai;3;0;3
94;09.02.2016;2016;02;09;Tiistai;0;0;0
94;09.02.2016;2016;02;10;Tiistai;0;1;1
94;09.02.2016;2016;02;11;Tiistai;0;0;0
94;09.02.2016;2016;02;12;Tiistai;0;0;0
94;09.02.2016;2016;02;13;Tiistai;1;0;1
94;09.02.2016;2016;02;14;Tiistai;0;3;3
94;09.02.2016;2016;02;15;Tiistai;1;2;3
94;09.02.2016;2016;02;16;Tiistai;0;4;4
94;09.02.2016;2016;02;17;Tiistai;0;3;3
94;09.02.2016;2016;02;18;Tiistai;0;0;0
94;09.02.2016;2016;02;19;Tiistai;0;2;2
94;09.02.2016;2016;02;20;Tiistai;0;2;2
94;09.02.2016;2016;02;21;Tiistai;0;1;1
94;09.02.2016;2016;02;22;Tiistai;0;1;1
94;09.02.2016;2016;02;23;Tiistai;0;0;0
94;10.02.2016;2016;02;00;Keskiviikko;0;0;0
94;10.02.2016;2016;02;01;Keskiviikko;0;0;0
94;10.02.2016;2016;02;02;Keskiviikko;0;1;1
94;10.02.2016;2016;02;03;Keskiviikko;0;0;0
94;10.02.2016;2016;02;04;Keskiviikko;0;0;0
94;10.02.2016;2016;02;05;Keskiviikko;2;0;2
94;10.02.2016;2016;02;06;Keskiviikko;7;2;9
94;10.02.2016;2016;02;07;Keskiviikko;3;0;3
94;10.02.2016;2016;02;08;Keskiviikko;8;0;8
94;10.02.2016;2016;02;09;Keskiviikko;2;0;2
94;10.02.2016;2016;02;10;Keskiviikko;0;0;0
94;10.02.2016;2016;02;11;Keskiviikko;1;1;2
94;10.02.2016;2016;02;12;Keskiviikko;0;0;0
94;10.02.2016;2016;02;13;Keskiviikko;3;2;5
94;10.02.2016;2016;02;14;Keskiviikko;1;5;6
94;10.02.2016;2016;02;15;Keskiviikko;1;3;4
94;10.02.2016;2016;02;16;Keskiviikko;1;8;9
94;10.02.2016;2016;02;17;Keskiviikko;0;4;4
94;10.02.2016;2016;02;18;Keskiviikko;3;4;7
94;10.02.2016;2016;02;19;Keskiviikko;1;3;4
94;10.02.2016;2016;02;20;Keskiviikko;1;0;1
94;10.02.2016;2016;02;21;Keskiviikko;0;2;2
94;10.02.2016;2016;02;22;Keskiviikko;0;1;1
94;10.02.2016;2016;02;23;Keskiviikko;0;0;0
94;11.02.2016;2016;02;00;Torstai;0;0;0
94;11.02.2016;2016;02;01;Torstai;0;0;0
94;11.02.2016;2016;02;02;Torstai;0;1;1
94;11.02.2016;2016;02;03;Torstai;0;0;0
94;11.02.2016;2016;02;04;Torstai;0;0;0
94;11.02.2016;2016;02;05;Torstai;3;2;5
94;11.02.2016;2016;02;06;Torstai;9;1;10
94;11.02.2016;2016;02;07;Torstai;6;1;7
94;11.02.2016;2016;02;08;Torstai;1;0;1
94;11.02.2016;2016;02;09;Torstai;3;0;3
94;11.02.2016;2016;02;10;Torstai;0;0;0
94;11.02.2016;2016;02;11;Torstai;0;2;2
94;11.02.2016;2016;02;12;Torstai;0;2;2
94;11.02.2016;2016;02;13;Torstai;1;3;4
94;11.02.2016;2016;02;14;Torstai;1;6;7
94;11.02.2016;2016;02;15;Torstai;2;7;9
94;11.02.2016;2016;02;16;Torstai;2;3;5
94;11.02.2016;2016;02;17;Torstai;1;5;6
94;11.02.2016;2016;02;18;Torstai;0;0;0
94;11.02.2016;2016;02;19;Torstai;1;2;3
94;11.02.2016;2016;02;20;Torstai;1;0;1
94;11.02.2016;2016;02;21;Torstai;0;1;1
94;11.02.2016;2016;02;22;Torstai;0;0;0
94;11.02.2016;2016;02;23;Torstai;0;0;0
94;12.02.2016;2016;02;00;Perjantai;0;0;0
94;12.02.2016;2016;02;01;Perjantai;0;0;0
94;12.02.2016;2016;02;02;Perjantai;0;0;0
94;12.02.2016;2016;02;03;Perjantai;0;0;0
94;12.02.2016;2016;02;04;Perjantai;0;0;0
94;12.02.2016;2016;02;05;Perjantai;2;0;2
94;12.02.2016;2016;02;06;Perjantai;3;1;4
94;12.02.2016;2016;02;07;Perjantai;5;0;5
94;12.02.2016;2016;02;08;Perjantai;1;1;2
94;12.02.2016;2016;02;09;Perjantai;2;0;2
94;12.02.2016;2016;02;10;Perjantai;1;0;1
94;12.02.2016;2016;02;11;Perjantai;0;0;0
94;12.02.2016;2016;02;12;Perjantai;1;2;3
94;12.02.2016;2016;02;13;Perjantai;1;2;3
94;12.02.2016;2016;02;14;Perjantai;0;2;2
94;12.02.2016;2016;02;15;Perjantai;2;2;4
94;12.02.2016;2016;02;16;Perjantai;0;3;3
94;12.02.2016;2016;02;17;Perjantai;0;1;1
94;12.02.2016;2016;02;18;Perjantai;0;1;1
94;12.02.2016;2016;02;19;Perjantai;0;0;0
94;12.02.2016;2016;02;20;Perjantai;0;0;0
94;12.02.2016;2016;02;21;Perjantai;0;0;0
94;12.02.2016;2016;02;22;Perjantai;0;1;1
94;12.02.2016;2016;02;23;Perjantai;0;0;0
94;13.02.2016;2016;02;00;Lauantai;0;0;0
94;13.02.2016;2016;02;01;Lauantai;0;0;0
94;13.02.2016;2016;02;02;Lauantai;0;0;0
94;13.02.2016;2016;02;03;Lauantai;0;0;0
94;13.02.2016;2016;02;04;Lauantai;1;0;1
94;13.02.2016;2016;02;05;Lauantai;0;0;0
94;13.02.2016;2016;02;06;Lauantai;1;0;1
94;13.02.2016;2016;02;07;Lauantai;1;0;1
94;13.02.2016;2016;02;08;Lauantai;1;1;2
94;13.02.2016;2016;02;09;Lauantai;1;1;2
94;13.02.2016;2016;02;10;Lauantai;0;2;2
94;13.02.2016;2016;02;11;Lauantai;3;0;3
94;13.02.2016;2016;02;12;Lauantai;1;1;2
94;13.02.2016;2016;02;13;Lauantai;2;0;2
94;13.02.2016;2016;02;14;Lauantai;0;1;1
94;13.02.2016;2016;02;15;Lauantai;0;0;0
94;13.02.2016;2016;02;16;Lauantai;0;2;2
94;13.02.2016;2016;02;17;Lauantai;1;0;1
94;13.02.2016;2016;02;18;Lauantai;0;0;0
94;13.02.2016;2016;02;19;Lauantai;0;1;1
94;13.02.2016;2016;02;20;Lauantai;1;1;2
94;13.02.2016;2016;02;21;Lauantai;1;1;2
94;13.02.2016;2016;02;22;Lauantai;0;0;0
94;13.02.2016;2016;02;23;Lauantai;0;0;0
94;14.02.2016;2016;02;00;Sunnuntai;0;0;0
94;14.02.2016;2016;02;01;Sunnuntai;0;0;0
94;14.02.2016;2016;02;02;Sunnuntai;0;0;0
94;14.02.2016;2016;02;03;Sunnuntai;0;0;0
94;14.02.2016;2016;02;04;Sunnuntai;1;0;1
94;14.02.2016;2016;02;05;Sunnuntai;0;0;0
94;14.02.2016;2016;02;06;Sunnuntai;0;0;0
94;14.02.2016;2016;02;07;Sunnuntai;2;1;3
94;14.02.2016;2016;02;08;Sunnuntai;0;0;0
94;14.02.2016;2016;02;09;Sunnuntai;0;2;2
94;14.02.2016;2016;02;10;Sunnuntai;0;0;0
94;14.02.2016;2016;02;11;Sunnuntai;2;3;5
94;14.02.2016;2016;02;12;Sunnuntai;2;1;3
94;14.02.2016;2016;02;13;Sunnuntai;0;0;0
94;14.02.2016;2016;02;14;Sunnuntai;1;1;2
94;14.02.2016;2016;02;15;Sunnuntai;3;0;3
94;14.02.2016;2016;02;16;Sunnuntai;1;3;4
94;14.02.2016;2016;02;17;Sunnuntai;0;4;4
94;14.02.2016;2016;02;18;Sunnuntai;1;1;2
94;14.02.2016;2016;02;19;Sunnuntai;0;0;0
94;14.02.2016;2016;02;20;Sunnuntai;1;0;1
94;14.02.2016;2016;02;21;Sunnuntai;0;0;0
94;14.02.2016;2016;02;22;Sunnuntai;0;0;0
94;14.02.2016;2016;02;23;Sunnuntai;0;0;0
94;15.02.2016;2016;02;00;Maanantai;0;0;0
94;15.02.2016;2016;02;01;Maanantai;0;0;0
94;15.02.2016;2016;02;02;Maanantai;0;0;0
94;15.02.2016;2016;02;03;Maanantai;0;0;0
94;15.02.2016;2016;02;04;Maanantai;1;1;2
94;15.02.2016;2016;02;05;Maanantai;2;0;2
94;15.02.2016;2016;02;06;Maanantai;6;1;7
94;15.02.2016;2016;02;07;Maanantai;7;0;7
94;15.02.2016;2016;02;08;Maanantai;6;0;6
94;15.02.2016;2016;02;09;Maanantai;1;0;1
94;15.02.2016;2016;02;10;Maanantai;0;0;0
94;15.02.2016;2016;02;11;Maanantai;0;1;1
94;15.02.2016;2016;02;12;Maanantai;2;1;3
94;15.02.2016;2016;02;13;Maanantai;1;0;1
94;15.02.2016;2016;02;14;Maanantai;0;4;4
94;15.02.2016;2016;02;15;Maanantai;2;5;7
94;15.02.2016;2016;02;16;Maanantai;2;12;14
94;15.02.2016;2016;02;17;Maanantai;0;4;4
94;15.02.2016;2016;02;18;Maanantai;1;2;3
94;15.02.2016;2016;02;19;Maanantai;1;1;2
94;15.02.2016;2016;02;20;Maanantai;0;0;0
94;15.02.2016;2016;02;21;Maanantai;0;1;1
94;15.02.2016;2016;02;22;Maanantai;0;1;1
94;15.02.2016;2016;02;23;Maanantai;0;0;0
94;16.02.2016;2016;02;00;Tiistai;0;0;0
94;16.02.2016;2016;02;01;Tiistai;0;0;0
94;16.02.2016;2016;02;02;Tiistai;0;0;0
94;16.02.2016;2016;02;03;Tiistai;0;0;0
94;16.02.2016;2016;02;04;Tiistai;1;0;1
94;16.02.2016;2016;02;05;Tiistai;3;0;3
94;16.02.2016;2016;02;06;Tiistai;8;2;10
94;16.02.2016;2016;02;07;Tiistai;8;0;8
94;16.02.2016;2016;02;08;Tiistai;5;1;6
94;16.02.2016;2016;02;09;Tiistai;0;0;0
94;16.02.2016;2016;02;10;Tiistai;2;0;2
94;16.02.2016;2016;02;11;Tiistai;0;0;0
94;16.02.2016;2016;02;12;Tiistai;1;2;3
94;16.02.2016;2016;02;13;Tiistai;2;0;2
94;16.02.2016;2016;02;14;Tiistai;1;3;4
94;16.02.2016;2016;02;15;Tiistai;2;7;9
94;16.02.2016;2016;02;16;Tiistai;4;5;9
94;16.02.2016;2016;02;17;Tiistai;2;6;8
94;16.02.2016;2016;02;18;Tiistai;0;3;3
94;16.02.2016;2016;02;19;Tiistai;1;0;1
94;16.02.2016;2016;02;20;Tiistai;0;1;1
94;16.02.2016;2016;02;21;Tiistai;0;1;1
94;16.02.2016;2016;02;22;Tiistai;0;1;1
94;16.02.2016;2016;02;23;Tiistai;0;0;0
94;17.02.2016;2016;02;00;Keskiviikko;0;0;0
94;17.02.2016;2016;02;01;Keskiviikko;0;0;0
94;17.02.2016;2016;02;02;Keskiviikko;0;0;0
94;17.02.2016;2016;02;03;Keskiviikko;0;0;0
94;17.02.2016;2016;02;04;Keskiviikko;0;1;1
94;17.02.2016;2016;02;05;Keskiviikko;3;1;4
94;17.02.2016;2016;02;06;Keskiviikko;5;1;6
94;17.02.2016;2016;02;07;Keskiviikko;4;2;6
94;17.02.2016;2016;02;08;Keskiviikko;8;1;9
94;17.02.2016;2016;02;09;Keskiviikko;1;0;1
94;17.02.2016;2016;02;10;Keskiviikko;1;0;1
94;17.02.2016;2016;02;11;Keskiviikko;0;1;1
94;17.02.2016;2016;02;12;Keskiviikko;1;0;1
94;17.02.2016;2016;02;13;Keskiviikko;2;1;3
94;17.02.2016;2016;02;14;Keskiviikko;2;4;6
94;17.02.2016;2016;02;15;Keskiviikko;2;5;7
94;17.02.2016;2016;02;16;Keskiviikko;2;5;7
94;17.02.2016;2016;02;17;Keskiviikko;0;7;7
94;17.02.2016;2016;02;18;Keskiviikko;1;3;4
94;17.02.2016;2016;02;19;Keskiviikko;3;2;5
94;17.02.2016;2016;02;20;Keskiviikko;1;0;1
94;17.02.2016;2016;02;21;Keskiviikko;0;1;1
94;17.02.2016;2016;02;22;Keskiviikko;0;0;0
94;17.02.2016;2016;02;23;Keskiviikko;0;0;0
94;18.02.2016;2016;02;00;Torstai;0;0;0
94;18.02.2016;2016;02;01;Torstai;0;0;0
94;18.02.2016;2016;02;02;Torstai;0;0;0
94;18.02.2016;2016;02;03;Torstai;0;0;0
94;18.02.2016;2016;02;04;Torstai;0;1;1
94;18.02.2016;2016;02;05;Torstai;2;1;3
94;18.02.2016;2016;02;06;Torstai;5;2;7
94;18.02.2016;2016;02;07;Torstai;9;1;10
94;18.02.2016;2016;02;08;Torstai;8;0;8
94;18.02.2016;2016;02;09;Torstai;1;0;1
94;18.02.2016;2016;02;10;Torstai;1;0;1
94;18.02.2016;2016;02;11;Torstai;0;3;3
94;18.02.2016;2016;02;12;Torstai;0;0;0
94;18.02.2016;2016;02;13;Torstai;0;2;2
94;18.02.2016;2016;02;14;Torstai;3;4;7
94;18.02.2016;2016;02;15;Torstai;2;4;6
94;18.02.2016;2016;02;16;Torstai;1;13;14
94;18.02.2016;2016;02;17;Torstai;0;5;5
94;18.02.2016;2016;02;18;Torstai;1;3;4
94;18.02.2016;2016;02;19;Torstai;1;3;4
94;18.02.2016;2016;02;20;Torstai;1;0;1
94;18.02.2016;2016;02;21;Torstai;0;1;1
94;18.02.2016;2016;02;22;Torstai;0;0;0
94;18.02.2016;2016;02;23;Torstai;0;0;0
94;19.02.2016;2016;02;00;Perjantai;0;0;0
94;19.02.2016;2016;02;01;Perjantai;0;0;0
94;19.02.2016;2016;02;02;Perjantai;0;0;0
94;19.02.2016;2016;02;03;Perjantai;0;0;0
94;19.02.2016;2016;02;04;Perjantai;0;0;0
94;19.02.2016;2016;02;05;Perjantai;4;1;5
94;19.02.2016;2016;02;06;Perjantai;5;2;7
94;19.02.2016;2016;02;07;Perjantai;7;2;9
94;19.02.2016;2016;02;08;Perjantai;11;0;11
94;19.02.2016;2016;02;09;Perjantai;1;0;1
94;19.02.2016;2016;02;10;Perjantai;0;0;0
94;19.02.2016;2016;02;11;Perjantai;1;0;1
94;19.02.2016;2016;02;12;Perjantai;1;2;3
94;19.02.2016;2016;02;13;Perjantai;1;5;6
94;19.02.2016;2016;02;14;Perjantai;1;4;5
94;19.02.2016;2016;02;15;Perjantai;3;4;7
94;19.02.2016;2016;02;16;Perjantai;0;3;3
94;19.02.2016;2016;02;17;Perjantai;0;8;8
94;19.02.2016;2016;02;18;Perjantai;0;1;1
94;19.02.2016;2016;02;19;Perjantai;3;1;4
94;19.02.2016;2016;02;20;Perjantai;1;3;4
94;19.02.2016;2016;02;21;Perjantai;0;1;1
94;19.02.2016;2016;02;22;Perjantai;0;1;1
94;19.02.2016;2016;02;23;Perjantai;0;0;0
94;20.02.2016;2016;02;00;Lauantai;0;0;0
94;20.02.2016;2016;02;01;Lauantai;0;0;0
94;20.02.2016;2016;02;02;Lauantai;0;0;0
94;20.02.2016;2016;02;03;Lauantai;0;0;0
94;20.02.2016;2016;02;04;Lauantai;0;0;0
94;20.02.2016;2016;02;05;Lauantai;0;0;0
94;20.02.2016;2016;02;06;Lauantai;0;0;0
94;20.02.2016;2016;02;07;Lauantai;0;0;0
94;20.02.2016;2016;02;08;Lauantai;0;1;1
94;20.02.2016;2016;02;09;Lauantai;0;1;1
94;20.02.2016;2016;02;10;Lauantai;3;4;7
94;20.02.2016;2016;02;11;Lauantai;2;0;2
94;20.02.2016;2016;02;12;Lauantai;2;3;5
94;20.02.2016;2016;02;13;Lauantai;2;4;6
94;20.02.2016;2016;02;14;Lauantai;2;1;3
94;20.02.2016;2016;02;15;Lauantai;1;0;1
94;20.02.2016;2016;02;16;Lauantai;0;2;2
94;20.02.2016;2016;02;17;Lauantai;0;2;2
94;20.02.2016;2016;02;18;Lauantai;1;0;1
94;20.02.2016;2016;02;19;Lauantai;0;0;0
94;20.02.2016;2016;02;20;Lauantai;0;0;0
94;20.02.2016;2016;02;21;Lauantai;1;0;1
94;20.02.2016;2016;02;22;Lauantai;0;0;0
94;20.02.2016;2016;02;23;Lauantai;0;0;0
94;21.02.2016;2016;02;00;Sunnuntai;0;0;0
94;21.02.2016;2016;02;01;Sunnuntai;0;0;0
94;21.02.2016;2016;02;02;Sunnuntai;0;0;0
94;21.02.2016;2016;02;03;Sunnuntai;0;0;0
94;21.02.2016;2016;02;04;Sunnuntai;0;0;0
94;21.02.2016;2016;02;05;Sunnuntai;0;0;0
94;21.02.2016;2016;02;06;Sunnuntai;0;0;0
94;21.02.2016;2016;02;07;Sunnuntai;0;0;0
94;21.02.2016;2016;02;08;Sunnuntai;0;0;0
94;21.02.2016;2016;02;09;Sunnuntai;1;0;1
94;21.02.2016;2016;02;10;Sunnuntai;1;1;2
94;21.02.2016;2016;02;11;Sunnuntai;1;2;3
94;21.02.2016;2016;02;12;Sunnuntai;0;0;0
94;21.02.2016;2016;02;13;Sunnuntai;0;0;0
94;21.02.2016;2016;02;14;Sunnuntai;1;0;1
94;21.02.2016;2016;02;15;Sunnuntai;2;0;2
94;21.02.2016;2016;02;16;Sunnuntai;0;1;1
94;21.02.2016;2016;02;17;Sunnuntai;0;0;0
94;21.02.2016;2016;02;18;Sunnuntai;0;2;2
94;21.02.2016;2016;02;19;Sunnuntai;0;0;0
94;21.02.2016;2016;02;20;Sunnuntai;0;0;0
94;21.02.2016;2016;02;21;Sunnuntai;0;0;0
94;21.02.2016;2016;02;22;Sunnuntai;0;1;1
94;21.02.2016;2016;02;23;Sunnuntai;0;0;0
94;22.02.2016;2016;02;00;Maanantai;0;0;0
94;22.02.2016;2016;02;01;Maanantai;0;0;0
94;22.02.2016;2016;02;02;Maanantai;0;0;0
94;22.02.2016;2016;02;03;Maanantai;0;0;0
94;22.02.2016;2016;02;04;Maanantai;0;0;0
94;22.02.2016;2016;02;05;Maanantai;4;0;4
94;22.02.2016;2016;02;06;Maanantai;4;1;5
94;22.02.2016;2016;02;07;Maanantai;11;0;11
94;22.02.2016;2016;02;08;Maanantai;7;0;7
94;22.02.2016;2016;02;09;Maanantai;3;0;3
94;22.02.2016;2016;02;10;Maanantai;0;0;0
94;22.02.2016;2016;02;11;Maanantai;0;0;0
94;22.02.2016;2016;02;12;Maanantai;1;0;1
94;22.02.2016;2016;02;13;Maanantai;1;1;2
94;22.02.2016;2016;02;14;Maanantai;1;1;2
94;22.02.2016;2016;02;15;Maanantai;1;5;6
94;22.02.2016;2016;02;16;Maanantai;1;7;8
94;22.02.2016;2016;02;17;Maanantai;0;2;2
94;22.02.2016;2016;02;18;Maanantai;2;4;6
94;22.02.2016;2016;02;19;Maanantai;0;4;4
94;22.02.2016;2016;02;20;Maanantai;1;0;1
94;22.02.2016;2016;02;21;Maanantai;0;0;0
94;22.02.2016;2016;02;22;Maanantai;0;0;0
94;22.02.2016;2016;02;23;Maanantai;0;0;0
94;23.02.2016;2016;02;00;Tiistai;0;0;0
94;23.02.2016;2016;02;01;Tiistai;0;0;0
94;23.02.2016;2016;02;02;Tiistai;0;1;1
94;23.02.2016;2016;02;03;Tiistai;0;0;0
94;23.02.2016;2016;02;04;Tiistai;1;0;1
94;23.02.2016;2016;02;05;Tiistai;3;1;4
94;23.02.2016;2016;02;06;Tiistai;9;2;11
94;23.02.2016;2016;02;07;Tiistai;12;0;12
94;23.02.2016;2016;02;08;Tiistai;5;0;5
94;23.02.2016;2016;02;09;Tiistai;4;3;7
94;23.02.2016;2016;02;10;Tiistai;0;0;0
94;23.02.2016;2016;02;11;Tiistai;0;0;0
94;23.02.2016;2016;02;12;Tiistai;1;2;3
94;23.02.2016;2016;02;13;Tiistai;0;0;0
94;23.02.2016;2016;02;14;Tiistai;2;2;4
94;23.02.2016;2016;02;15;Tiistai;1;6;7
94;23.02.2016;2016;02;16;Tiistai;3;11;14
94;23.02.2016;2016;02;17;Tiistai;1;6;7
94;23.02.2016;2016;02;18;Tiistai;0;1;1
94;23.02.2016;2016;02;19;Tiistai;0;1;1
94;23.02.2016;2016;02;20;Tiistai;0;5;5
94;23.02.2016;2016;02;21;Tiistai;1;1;2
94;23.02.2016;2016;02;22;Tiistai;0;0;0
94;23.02.2016;2016;02;23;Tiistai;0;0;0
94;24.02.2016;2016;02;00;Keskiviikko;1;0;1
94;24.02.2016;2016;02;01;Keskiviikko;0;0;0
94;24.02.2016;2016;02;02;Keskiviikko;0;0;0
94;24.02.2016;2016;02;03;Keskiviikko;0;0;0
94;24.02.2016;2016;02;04;Keskiviikko;1;0;1
94;24.02.2016;2016;02;05;Keskiviikko;2;1;3
94;24.02.2016;2016;02;06;Keskiviikko;4;1;5
94;24.02.2016;2016;02;07;Keskiviikko;7;0;7
94;24.02.2016;2016;02;08;Keskiviikko;5;0;5
94;24.02.2016;2016;02;09;Keskiviikko;3;0;3
94;24.02.2016;2016;02;10;Keskiviikko;1;0;1
94;24.02.2016;2016;02;11;Keskiviikko;0;0;0
94;24.02.2016;2016;02;12;Keskiviikko;1;0;1
94;24.02.2016;2016;02;13;Keskiviikko;2;1;3
94;24.02.2016;2016;02;14;Keskiviikko;2;1;3
94;24.02.2016;2016;02;15;Keskiviikko;2;4;6
94;24.02.2016;2016;02;16;Keskiviikko;0;10;10
94;24.02.2016;2016;02;17;Keskiviikko;1;5;6
94;24.02.2016;2016;02;18;Keskiviikko;0;2;2
94;24.02.2016;2016;02;19;Keskiviikko;0;6;6
94;24.02.2016;2016;02;20;Keskiviikko;0;0;0
94;24.02.2016;2016;02;21;Keskiviikko;0;2;2
94;24.02.2016;2016;02;22;Keskiviikko;0;1;1
94;24.02.2016;2016;02;23;Keskiviikko;1;0;1
94;25.02.2016;2016;02;00;Torstai;0;0;0
94;25.02.2016;2016;02;01;Torstai;0;0;0
94;25.02.2016;2016;02;02;Torstai;0;0;0
94;25.02.2016;2016;02;03;Torstai;0;0;0
94;25.02.2016;2016;02;04;Torstai;0;0;0
94;25.02.2016;2016;02;05;Torstai;2;0;2
94;25.02.2016;2016;02;06;Torstai;7;1;8
94;25.02.2016;2016;02;07;Torstai;7;0;7
94;25.02.2016;2016;02;08;Torstai;6;1;7
94;25.02.2016;2016;02;09;Torstai;1;0;1
94;25.02.2016;2016;02;10;Torstai;1;0;1
94;25.02.2016;2016;02;11;Torstai;0;1;1
94;25.02.2016;2016;02;12;Torstai;2;0;2
94;25.02.2016;2016;02;13;Torstai;0;0;0
94;25.02.2016;2016;02;14;Torstai;0;3;3
94;25.02.2016;2016;02;15;Torstai;2;9;11
94;25.02.2016;2016;02;16;Torstai;1;6;7
94;25.02.2016;2016;02;17;Torstai;0;5;5
94;25.02.2016;2016;02;18;Torstai;0;1;1
94;25.02.2016;2016;02;19;Torstai;1;4;5
94;25.02.2016;2016;02;20;Torstai;0;2;2
94;25.02.2016;2016;02;21;Torstai;0;0;0
94;25.02.2016;2016;02;22;Torstai;0;1;1
94;25.02.2016;2016;02;23;Torstai;0;0;0
94;26.02.2016;2016;02;00;Perjantai;1;0;1
94;26.02.2016;2016;02;01;Perjantai;0;0;0
94;26.02.2016;2016;02;02;Perjantai;0;0;0
94;26.02.2016;2016;02;03;Perjantai;0;0;0
94;26.02.2016;2016;02;04;Perjantai;0;0;0
94;26.02.2016;2016;02;05;Perjantai;2;1;3
94;26.02.2016;2016;02;06;Perjantai;4;1;5
94;26.02.2016;2016;02;07;Perjantai;7;0;7
94;26.02.2016;2016;02;08;Perjantai;4;0;4
94;26.02.2016;2016;02;09;Perjantai;0;0;0
94;26.02.2016;2016;02;10;Perjantai;0;0;0
94;26.02.2016;2016;02;11;Perjantai;1;0;1
94;26.02.2016;2016;02;12;Perjantai;1;0;1
94;26.02.2016;2016;02;13;Perjantai;0;0;0
94;26.02.2016;2016;02;14;Perjantai;0;4;4
94;26.02.2016;2016;02;15;Perjantai;2;3;5
94;26.02.2016;2016;02;16;Perjantai;1;4;5
94;26.02.2016;2016;02;17;Perjantai;0;4;4
94;26.02.2016;2016;02;18;Perjantai;1;0;1
94;26.02.2016;2016;02;19;Perjantai;1;1;2
94;26.02.2016;2016;02;20;Perjantai;0;0;0
94;26.02.2016;2016;02;21;Perjantai;0;0;0
94;26.02.2016;2016;02;22;Perjantai;0;0;0
94;26.02.2016;2016;02;23;Perjantai;0;0;0
94;27.02.2016;2016;02;00;Lauantai;0;0;0
94;27.02.2016;2016;02;01;Lauantai;0;0;0
94;27.02.2016;2016;02;02;Lauantai;0;0;0
94;27.02.2016;2016;02;03;Lauantai;0;0;0
94;27.02.2016;2016;02;04;Lauantai;0;0;0
94;27.02.2016;2016;02;05;Lauantai;1;0;1
94;27.02.2016;2016;02;06;Lauantai;0;0;0
94;27.02.2016;2016;02;07;Lauantai;1;0;1
94;27.02.2016;2016;02;08;Lauantai;0;2;2
94;27.02.2016;2016;02;09;Lauantai;0;0;0
94;27.02.2016;2016;02;10;Lauantai;1;0;1
94;27.02.2016;2016;02;11;Lauantai;1;0;1
94;27.02.2016;2016;02;12;Lauantai;2;0;2
94;27.02.2016;2016;02;13;Lauantai;0;1;1
94;27.02.2016;2016;02;14;Lauantai;0;2;2
94;27.02.2016;2016;02;15;Lauantai;0;0;0
94;27.02.2016;2016;02;16;Lauantai;0;1;1
94;27.02.2016;2016;02;17;Lauantai;0;0;0
94;27.02.2016;2016;02;18;Lauantai;0;0;0
94;27.02.2016;2016;02;19;Lauantai;0;1;1
94;27.02.2016;2016;02;20;Lauantai;0;0;0
94;27.02.2016;2016;02;21;Lauantai;0;1;1
94;27.02.2016;2016;02;22;Lauantai;0;2;2
94;27.02.2016;2016;02;23;Lauantai;0;0;0
94;28.02.2016;2016;02;00;Sunnuntai;0;0;0
94;28.02.2016;2016;02;01;Sunnuntai;0;0;0
94;28.02.2016;2016;02;02;Sunnuntai;0;0;0
94;28.02.2016;2016;02;03;Sunnuntai;0;0;0
94;28.02.2016;2016;02;04;Sunnuntai;0;0;0
94;28.02.2016;2016;02;05;Sunnuntai;1;0;1
94;28.02.2016;2016;02;06;Sunnuntai;1;0;1
94;28.02.2016;2016;02;07;Sunnuntai;1;1;2
94;28.02.2016;2016;02;08;Sunnuntai;1;0;1
94;28.02.2016;2016;02;09;Sunnuntai;1;0;1
94;28.02.2016;2016;02;10;Sunnuntai;0;2;2
94;28.02.2016;2016;02;11;Sunnuntai;0;1;1
94;28.02.2016;2016;02;12;Sunnuntai;1;0;1
94;28.02.2016;2016;02;13;Sunnuntai;3;1;4
94;28.02.2016;2016;02;14;Sunnuntai;1;0;1
94;28.02.2016;2016;02;15;Sunnuntai;1;1;2
94;28.02.2016;2016;02;16;Sunnuntai;0;1;1
94;28.02.2016;2016;02;17;Sunnuntai;0;1;1
94;28.02.2016;2016;02;18;Sunnuntai;0;1;1
94;28.02.2016;2016;02;19;Sunnuntai;0;0;0
94;28.02.2016;2016;02;20;Sunnuntai;0;1;1
94;28.02.2016;2016;02;21;Sunnuntai;0;0;0
94;28.02.2016;2016;02;22;Sunnuntai;0;0;0
94;28.02.2016;2016;02;23;Sunnuntai;0;0;0
94;29.02.2016;2016;02;00;Maanantai;0;0;0
94;29.02.2016;2016;02;01;Maanantai;0;0;0
94;29.02.2016;2016;02;02;Maanantai;0;0;0
94;29.02.2016;2016;02;03;Maanantai;0;0;0
94;29.02.2016;2016;02;04;Maanantai;0;0;0
94;29.02.2016;2016;02;05;Maanantai;2;0;2
94;29.02.2016;2016;02;06;Maanantai;2;2;4
94;29.02.2016;2016;02;07;Maanantai;5;0;5
94;29.02.2016;2016;02;08;Maanantai;1;0;1
94;29.02.2016;2016;02;09;Maanantai;0;2;2
94;29.02.2016;2016;02;10;Maanantai;1;0;1
94;29.02.2016;2016;02;11;Maanantai;0;0;0
94;29.02.2016;2016;02;12;Maanantai;0;0;0
94;29.02.2016;2016;02;13;Maanantai;1;0;1
94;29.02.2016;2016;02;14;Maanantai;1;0;1
94;29.02.2016;2016;02;15;Maanantai;2;2;4
94;29.02.2016;2016;02;16;Maanantai;0;5;5
94;29.02.2016;2016;02;17;Maanantai;0;2;2
94;29.02.2016;2016;02;18;Maanantai;1;2;3
94;29.02.2016;2016;02;19;Maanantai;0;1;1
94;29.02.2016;2016;02;20;Maanantai;0;2;2
94;29.02.2016;2016;02;21;Maanantai;0;0;0
94;29.02.2016;2016;02;22;Maanantai;0;0;0
94;29.02.2016;2016;02;23;Maanantai;0;0;0
94;01.03.2016;2016;03;00;Tiistai;0;0;0
94;01.03.2016;2016;03;01;Tiistai;0;0;0
94;01.03.2016;2016;03;02;Tiistai;0;0;0
94;01.03.2016;2016;03;03;Tiistai;0;1;1
94;01.03.2016;2016;03;04;Tiistai;0;0;0
94;01.03.2016;2016;03;05;Tiistai;2;0;2
94;01.03.2016;2016;03;06;Tiistai;7;2;9
94;01.03.2016;2016;03;07;Tiistai;9;0;9
94;01.03.2016;2016;03;08;Tiistai;7;0;7
94;01.03.2016;2016;03;09;Tiistai;1;0;1
94;01.03.2016;2016;03;10;Tiistai;2;0;2
94;01.03.2016;2016;03;11;Tiistai;0;2;2
94;01.03.2016;2016;03;12;Tiistai;1;0;1
94;01.03.2016;2016;03;13;Tiistai;2;2;4
94;01.03.2016;2016;03;14;Tiistai;1;5;6
94;01.03.2016;2016;03;15;Tiistai;4;3;7
94;01.03.2016;2016;03;16;Tiistai;0;6;6
94;01.03.2016;2016;03;17;Tiistai;1;5;6
94;01.03.2016;2016;03;18;Tiistai;0;4;4
94;01.03.2016;2016;03;19;Tiistai;0;1;1
94;01.03.2016;2016;03;20;Tiistai;0;3;3
94;01.03.2016;2016;03;21;Tiistai;1;1;2
94;01.03.2016;2016;03;22;Tiistai;1;0;1
94;01.03.2016;2016;03;23;Tiistai;0;0;0
94;02.03.2016;2016;03;00;Keskiviikko;0;0;0
94;02.03.2016;2016;03;01;Keskiviikko;0;0;0
94;02.03.2016;2016;03;02;Keskiviikko;0;0;0
94;02.03.2016;2016;03;03;Keskiviikko;0;0;0
94;02.03.2016;2016;03;04;Keskiviikko;0;0;0
94;02.03.2016;2016;03;05;Keskiviikko;1;0;1
94;02.03.2016;2016;03;06;Keskiviikko;4;1;5
94;02.03.2016;2016;03;07;Keskiviikko;9;0;9
94;02.03.2016;2016;03;08;Keskiviikko;7;1;8
94;02.03.2016;2016;03;09;Keskiviikko;1;0;1
94;02.03.2016;2016;03;10;Keskiviikko;1;0;1
94;02.03.2016;2016;03;11;Keskiviikko;0;1;1
94;02.03.2016;2016;03;12;Keskiviikko;0;1;1
94;02.03.2016;2016;03;13;Keskiviikko;2;1;3
94;02.03.2016;2016;03;14;Keskiviikko;1;2;3
94;02.03.2016;2016;03;15;Keskiviikko;2;4;6
94;02.03.2016;2016;03;16;Keskiviikko;1;10;11
94;02.03.2016;2016;03;17;Keskiviikko;0;3;3
94;02.03.2016;2016;03;18;Keskiviikko;1;1;2
94;02.03.2016;2016;03;19;Keskiviikko;3;5;8
94;02.03.2016;2016;03;20;Keskiviikko;1;2;3
94;02.03.2016;2016;03;21;Keskiviikko;0;2;2
94;02.03.2016;2016;03;22;Keskiviikko;0;1;1
94;02.03.2016;2016;03;23;Keskiviikko;1;0;1
94;03.03.2016;2016;03;00;Torstai;0;0;0
94;03.03.2016;2016;03;01;Torstai;0;0;0
94;03.03.2016;2016;03;02;Torstai;0;0;0
94;03.03.2016;2016;03;03;Torstai;0;0;0
94;03.03.2016;2016;03;04;Torstai;0;0;0
94;03.03.2016;2016;03;05;Torstai;3;0;3
94;03.03.2016;2016;03;06;Torstai;7;1;8
94;03.03.2016;2016;03;07;Torstai;11;2;13
94;03.03.2016;2016;03;08;Torstai;6;0;6
94;03.03.2016;2016;03;09;Torstai;6;2;8
94;03.03.2016;2016;03;10;Torstai;0;1;1
94;03.03.2016;2016;03;11;Torstai;2;1;3
94;03.03.2016;2016;03;12;Torstai;1;0;1
94;03.03.2016;2016;03;13;Torstai;1;1;2
94;03.03.2016;2016;03;14;Torstai;2;4;6
94;03.03.2016;2016;03;15;Torstai;0;8;8
94;03.03.2016;2016;03;16;Torstai;2;9;11
94;03.03.2016;2016;03;17;Torstai;0;7;7
94;03.03.2016;2016;03;18;Torstai;1;3;4
94;03.03.2016;2016;03;19;Torstai;0;1;1
94;03.03.2016;2016;03;20;Torstai;0;2;2
94;03.03.2016;2016;03;21;Torstai;0;1;1
94;03.03.2016;2016;03;22;Torstai;0;1;1
94;03.03.2016;2016;03;23;Torstai;0;0;0
94;04.03.2016;2016;03;00;Perjantai;0;0;0
94;04.03.2016;2016;03;01;Perjantai;0;0;0
94;04.03.2016;2016;03;02;Perjantai;0;1;1
94;04.03.2016;2016;03;03;Perjantai;0;0;0
94;04.03.2016;2016;03;04;Perjantai;0;0;0
94;04.03.2016;2016;03;05;Perjantai;2;1;3
94;04.03.2016;2016;03;06;Perjantai;2;1;3
94;04.03.2016;2016;03;07;Perjantai;8;0;8
94;04.03.2016;2016;03;08;Perjantai;2;0;2
94;04.03.2016;2016;03;09;Perjantai;0;0;0
94;04.03.2016;2016;03;10;Perjantai;1;1;2
94;04.03.2016;2016;03;11;Perjantai;1;1;2
94;04.03.2016;2016;03;12;Perjantai;0;1;1
94;04.03.2016;2016;03;13;Perjantai;1;0;1
94;04.03.2016;2016;03;14;Perjantai;2;3;5
94;04.03.2016;2016;03;15;Perjantai;1;10;11
94;04.03.2016;2016;03;16;Perjantai;1;3;4
94;04.03.2016;2016;03;17;Perjantai;1;2;3
94;04.03.2016;2016;03;18;Perjantai;1;1;2
94;04.03.2016;2016;03;19;Perjantai;0;2;2
94;04.03.2016;2016;03;20;Perjantai;1;0;1
94;04.03.2016;2016;03;21;Perjantai;0;2;2
94;04.03.2016;2016;03;22;Perjantai;0;0;0
94;04.03.2016;2016;03;23;Perjantai;0;0;0
94;05.03.2016;2016;03;00;Lauantai;0;0;0
94;05.03.2016;2016;03;01;Lauantai;0;0;0
94;05.03.2016;2016;03;02;Lauantai;0;0;0
94;05.03.2016;2016;03;03;Lauantai;0;0;0
94;05.03.2016;2016;03;04;Lauantai;0;0;0
94;05.03.2016;2016;03;05;Lauantai;0;0;0
94;05.03.2016;2016;03;06;Lauantai;0;0;0
94;05.03.2016;2016;03;07;Lauantai;1;0;1
94;05.03.2016;2016;03;08;Lauantai;0;0;0
94;05.03.2016;2016;03;09;Lauantai;1;1;2
94;05.03.2016;2016;03;10;Lauantai;1;0;1
94;05.03.2016;2016;03;11;Lauantai;1;1;2
94;05.03.2016;2016;03;12;Lauantai;2;0;2
94;05.03.2016;2016;03;13;Lauantai;1;0;1
94;05.03.2016;2016;03;14;Lauantai;0;0;0
94;05.03.2016;2016;03;15;Lauantai;0;3;3
94;05.03.2016;2016;03;16;Lauantai;0;0;0
94;05.03.2016;2016;03;17;Lauantai;2;0;2
94;05.03.2016;2016;03;18;Lauantai;0;0;0
94;05.03.2016;2016;03;19;Lauantai;0;0;0
94;05.03.2016;2016;03;20;Lauantai;1;0;1
94;05.03.2016;2016;03;21;Lauantai;0;0;0
94;05.03.2016;2016;03;22;Lauantai;0;1;1
94;05.03.2016;2016;03;23;Lauantai;0;0;0
94;06.03.2016;2016;03;00;Sunnuntai;0;0;0
94;06.03.2016;2016;03;01;Sunnuntai;0;0;0
94;06.03.2016;2016;03;02;Sunnuntai;0;0;0
94;06.03.2016;2016;03;03;Sunnuntai;0;0;0
94;06.03.2016;2016;03;04;Sunnuntai;0;0;0
94;06.03.2016;2016;03;05;Sunnuntai;0;0;0
94;06.03.2016;2016;03;06;Sunnuntai;1;0;1
94;06.03.2016;2016;03;07;Sunnuntai;0;0;0
94;06.03.2016;2016;03;08;Sunnuntai;2;0;2
94;06.03.2016;2016;03;09;Sunnuntai;1;0;1
94;06.03.2016;2016;03;10;Sunnuntai;0;2;2
94;06.03.2016;2016;03;11;Sunnuntai;0;1;1
94;06.03.2016;2016;03;12;Sunnuntai;2;2;4
94;06.03.2016;2016;03;13;Sunnuntai;0;0;0
94;06.03.2016;2016;03;14;Sunnuntai;2;1;3
94;06.03.2016;2016;03;15;Sunnuntai;2;4;6
94;06.03.2016;2016;03;16;Sunnuntai;0;2;2
94;06.03.2016;2016;03;17;Sunnuntai;0;1;1
94;06.03.2016;2016;03;18;Sunnuntai;2;1;3
94;06.03.2016;2016;03;19;Sunnuntai;0;0;0
94;06.03.2016;2016;03;20;Sunnuntai;0;0;0
94;06.03.2016;2016;03;21;Sunnuntai;0;1;1
94;06.03.2016;2016;03;22;Sunnuntai;0;1;1
94;06.03.2016;2016;03;23;Sunnuntai;1;0;1
94;07.03.2016;2016;03;00;Maanantai;0;0;0
94;07.03.2016;2016;03;01;Maanantai;0;0;0
94;07.03.2016;2016;03;02;Maanantai;0;0;0
94;07.03.2016;2016;03;03;Maanantai;0;0;0
94;07.03.2016;2016;03;04;Maanantai;0;0;0
94;07.03.2016;2016;03;05;Maanantai;1;0;1
94;07.03.2016;2016;03;06;Maanantai;5;1;6
94;07.03.2016;2016;03;07;Maanantai;2;4;6
94;07.03.2016;2016;03;08;Maanantai;0;0;0
94;07.03.2016;2016;03;09;Maanantai;1;0;1
94;07.03.2016;2016;03;10;Maanantai;1;0;1
94;07.03.2016;2016;03;11;Maanantai;0;0;0
94;07.03.2016;2016;03;12;Maanantai;0;1;1
94;07.03.2016;2016;03;13;Maanantai;1;2;3
94;07.03.2016;2016;03;14;Maanantai;1;1;2
94;07.03.2016;2016;03;15;Maanantai;1;6;7
94;07.03.2016;2016;03;16;Maanantai;1;3;4
94;07.03.2016;2016;03;17;Maanantai;3;2;5
94;07.03.2016;2016;03;18;Maanantai;2;1;3
94;07.03.2016;2016;03;19;Maanantai;0;2;2
94;07.03.2016;2016;03;20;Maanantai;0;1;1
94;07.03.2016;2016;03;21;Maanantai;1;2;3
94;07.03.2016;2016;03;22;Maanantai;0;0;0
94;07.03.2016;2016;03;23;Maanantai;0;0;0
94;08.03.2016;2016;03;00;Tiistai;0;0;0
94;08.03.2016;2016;03;01;Tiistai;0;0;0
94;08.03.2016;2016;03;02;Tiistai;0;0;0
94;08.03.2016;2016;03;03;Tiistai;0;0;0
94;08.03.2016;2016;03;04;Tiistai;0;0;0
94;08.03.2016;2016;03;05;Tiistai;2;2;4
94;08.03.2016;2016;03;06;Tiistai;5;3;8
94;08.03.2016;2016;03;07;Tiistai;1;0;1
94;08.03.2016;2016;03;08;Tiistai;5;0;5
94;08.03.2016;2016;03;09;Tiistai;1;0;1
94;08.03.2016;2016;03;10;Tiistai;3;3;6
94;08.03.2016;2016;03;11;Tiistai;1;0;1
94;08.03.2016;2016;03;12;Tiistai;1;3;4
94;08.03.2016;2016;03;13;Tiistai;3;0;3
94;08.03.2016;2016;03;14;Tiistai;1;5;6
94;08.03.2016;2016;03;15;Tiistai;1;11;12
94;08.03.2016;2016;03;16;Tiistai;0;5;5
94;08.03.2016;2016;03;17;Tiistai;3;4;7
94;08.03.2016;2016;03;18;Tiistai;4;2;6
94;08.03.2016;2016;03;19;Tiistai;0;3;3
94;08.03.2016;2016;03;20;Tiistai;0;0;0
94;08.03.2016;2016;03;21;Tiistai;0;4;4
94;08.03.2016;2016;03;22;Tiistai;0;0;0
94;08.03.2016;2016;03;23;Tiistai;0;0;0
94;09.03.2016;2016;03;00;Keskiviikko;0;0;0
94;09.03.2016;2016;03;01;Keskiviikko;0;0;0
94;09.03.2016;2016;03;02;Keskiviikko;0;1;1
94;09.03.2016;2016;03;03;Keskiviikko;0;0;0
94;09.03.2016;2016;03;04;Keskiviikko;1;2;3
94;09.03.2016;2016;03;05;Keskiviikko;2;1;3
94;09.03.2016;2016;03;06;Keskiviikko;4;2;6
94;09.03.2016;2016;03;07;Keskiviikko;2;1;3
94;09.03.2016;2016;03;08;Keskiviikko;2;0;2
94;09.03.2016;2016;03;09;Keskiviikko;3;0;3
94;09.03.2016;2016;03;10;Keskiviikko;1;0;1
94;09.03.2016;2016;03;11;Keskiviikko;0;0;0
94;09.03.2016;2016;03;12;Keskiviikko;0;0;0
94;09.03.2016;2016;03;13;Keskiviikko;1;0;1
94;09.03.2016;2016;03;14;Keskiviikko;3;5;8
94;09.03.2016;2016;03;15;Keskiviikko;2;5;7
94;09.03.2016;2016;03;16;Keskiviikko;0;8;8
94;09.03.2016;2016;03;17;Keskiviikko;0;7;7
94;09.03.2016;2016;03;18;Keskiviikko;1;1;2
94;09.03.2016;2016;03;19;Keskiviikko;1;2;3
94;09.03.2016;2016;03;20;Keskiviikko;1;1;2
94;09.03.2016;2016;03;21;Keskiviikko;0;1;1
94;09.03.2016;2016;03;22;Keskiviikko;0;0;0
94;09.03.2016;2016;03;23;Keskiviikko;0;0;0
94;10.03.2016;2016;03;00;Torstai;0;0;0
94;10.03.2016;2016;03;01;Torstai;0;0;0
94;10.03.2016;2016;03;02;Torstai;0;0;0
94;10.03.2016;2016;03;03;Torstai;1;0;1
94;10.03.2016;2016;03;04;Torstai;1;0;1
94;10.03.2016;2016;03;05;Torstai;1;1;2
94;10.03.2016;2016;03;06;Torstai;4;1;5
94;10.03.2016;2016;03;07;Torstai;4;1;5
94;10.03.2016;2016;03;08;Torstai;2;0;2
94;10.03.2016;2016;03;09;Torstai;2;0;2
94;10.03.2016;2016;03;10;Torstai;1;1;2
94;10.03.2016;2016;03;11;Torstai;4;0;4
94;10.03.2016;2016;03;12;Torstai;0;0;0
94;10.03.2016;2016;03;13;Torstai;1;3;4
94;10.03.2016;2016;03;14;Torstai;2;2;4
94;10.03.2016;2016;03;15;Torstai;2;4;6
94;10.03.2016;2016;03;16;Torstai;0;7;7
94;10.03.2016;2016;03;17;Torstai;0;2;2
94;10.03.2016;2016;03;18;Torstai;3;1;4
94;10.03.2016;2016;03;19;Torstai;0;2;2
94;10.03.2016;2016;03;20;Torstai;0;0;0
94;10.03.2016;2016;03;21;Torstai;0;1;1
94;10.03.2016;2016;03;22;Torstai;0;1;1
94;10.03.2016;2016;03;23;Torstai;1;0;1
94;11.03.2016;2016;03;00;Perjantai;0;0;0
94;11.03.2016;2016;03;01;Perjantai;0;1;1
94;11.03.2016;2016;03;02;Perjantai;0;0;0
94;11.03.2016;2016;03;03;Perjantai;0;0;0
94;11.03.2016;2016;03;04;Perjantai;1;0;1
94;11.03.2016;2016;03;05;Perjantai;2;1;3
94;11.03.2016;2016;03;06;Perjantai;1;1;2
94;11.03.2016;2016;03;07;Perjantai;6;0;6
94;11.03.2016;2016;03;08;Perjantai;1;0;1
94;11.03.2016;2016;03;09;Perjantai;0;0;0
94;11.03.2016;2016;03;10;Perjantai;0;0;0
94;11.03.2016;2016;03;11;Perjantai;1;0;1
94;11.03.2016;2016;03;12;Perjantai;2;2;4
94;11.03.2016;2016;03;13;Perjantai;0;1;1
94;11.03.2016;2016;03;14;Perjantai;1;1;2
94;11.03.2016;2016;03;15;Perjantai;1;0;1
94;11.03.2016;2016;03;16;Perjantai;0;2;2
94;11.03.2016;2016;03;17;Perjantai;1;4;5
94;11.03.2016;2016;03;18;Perjantai;2;2;4
94;11.03.2016;2016;03;19;Perjantai;1;1;2
94;11.03.2016;2016;03;20;Perjantai;1;0;1
94;11.03.2016;2016;03;21;Perjantai;0;1;1
94;11.03.2016;2016;03;22;Perjantai;0;1;1
94;11.03.2016;2016;03;23;Perjantai;0;0;0
94;12.03.2016;2016;03;00;Lauantai;0;0;0
94;12.03.2016;2016;03;01;Lauantai;0;0;0
94;12.03.2016;2016;03;02;Lauantai;0;0;0
94;12.03.2016;2016;03;03;Lauantai;0;0;0
94;12.03.2016;2016;03;04;Lauantai;0;0;0
94;12.03.2016;2016;03;05;Lauantai;0;0;0
94;12.03.2016;2016;03;06;Lauantai;1;0;1
94;12.03.2016;2016;03;07;Lauantai;0;2;2
94;12.03.2016;2016;03;08;Lauantai;0;4;4
94;12.03.2016;2016;03;09;Lauantai;0;1;1
94;12.03.2016;2016;03;10;Lauantai;5;1;6
94;12.03.2016;2016;03;11;Lauantai;3;1;4
94;12.03.2016;2016;03;12;Lauantai;2;3;5
94;12.03.2016;2016;03;13;Lauantai;0;6;6
94;12.03.2016;2016;03;14;Lauantai;2;3;5
94;12.03.2016;2016;03;15;Lauantai;2;1;3
94;12.03.2016;2016;03;16;Lauantai;1;0;1
94;12.03.2016;2016;03;17;Lauantai;1;0;1
94;12.03.2016;2016;03;18;Lauantai;0;1;1
94;12.03.2016;2016;03;19;Lauantai;1;0;1
94;12.03.2016;2016;03;20;Lauantai;0;1;1
94;12.03.2016;2016;03;21;Lauantai;1;0;1
94;12.03.2016;2016;03;22;Lauantai;0;0;0
94;12.03.2016;2016;03;23;Lauantai;0;0;0
94;13.03.2016;2016;03;00;Sunnuntai;0;0;0
94;13.03.2016;2016;03;01;Sunnuntai;0;0;0
94;13.03.2016;2016;03;02;Sunnuntai;0;0;0
94;13.03.2016;2016;03;03;Sunnuntai;0;0;0
94;13.03.2016;2016;03;04;Sunnuntai;0;0;0
94;13.03.2016;2016;03;05;Sunnuntai;0;0;0
94;13.03.2016;2016;03;06;Sunnuntai;0;0;0
94;13.03.2016;2016;03;07;Sunnuntai;0;0;0
94;13.03.2016;2016;03;08;Sunnuntai;1;0;1
94;13.03.2016;2016;03;09;Sunnuntai;0;0;0
94;13.03.2016;2016;03;10;Sunnuntai;3;0;3
94;13.03.2016;2016;03;11;Sunnuntai;0;2;2
94;13.03.2016;2016;03;12;Sunnuntai;0;1;1
94;13.03.2016;2016;03;13;Sunnuntai;6;0;6
94;13.03.2016;2016;03;14;Sunnuntai;1;0;1
94;13.03.2016;2016;03;15;Sunnuntai;1;1;2
94;13.03.2016;2016;03;16;Sunnuntai;0;2;2
94;13.03.2016;2016;03;17;Sunnuntai;0;1;1
94;13.03.2016;2016;03;18;Sunnuntai;2;0;2
94;13.03.2016;2016;03;19;Sunnuntai;1;1;2
94;13.03.2016;2016;03;20;Sunnuntai;2;0;2
94;13.03.2016;2016;03;21;Sunnuntai;0;0;0
94;13.03.2016;2016;03;22;Sunnuntai;0;0;0
94;13.03.2016;2016;03;23;Sunnuntai;0;0;0
94;14.03.2016;2016;03;00;Maanantai;0;0;0
94;14.03.2016;2016;03;01;Maanantai;0;0;0
94;14.03.2016;2016;03;02;Maanantai;0;0;0
94;14.03.2016;2016;03;03;Maanantai;0;0;0
94;14.03.2016;2016;03;04;Maanantai;0;0;0
94;14.03.2016;2016;03;05;Maanantai;2;0;2
94;14.03.2016;2016;03;06;Maanantai;5;1;6
94;14.03.2016;2016;03;07;Maanantai;13;0;13
94;14.03.2016;2016;03;08;Maanantai;9;0;9
94;14.03.2016;2016;03;09;Maanantai;2;1;3
94;14.03.2016;2016;03;10;Maanantai;0;0;0
94;14.03.2016;2016;03;11;Maanantai;2;0;2
94;14.03.2016;2016;03;12;Maanantai;0;4;4
94;14.03.2016;2016;03;13;Maanantai;2;0;2
94;14.03.2016;2016;03;14;Maanantai;0;4;4
94;14.03.2016;2016;03;15;Maanantai;2;8;10
94;14.03.2016;2016;03;16;Maanantai;1;8;9
94;14.03.2016;2016;03;17;Maanantai;2;7;9
94;14.03.2016;2016;03;18;Maanantai;2;4;6
94;14.03.2016;2016;03;19;Maanantai;0;2;2
94;14.03.2016;2016;03;20;Maanantai;1;1;2
94;14.03.2016;2016;03;21;Maanantai;1;1;2
94;14.03.2016;2016;03;22;Maanantai;0;0;0
94;14.03.2016;2016;03;23;Maanantai;0;0;0
94;15.03.2016;2016;03;00;Tiistai;0;0;0
94;15.03.2016;2016;03;01;Tiistai;0;0;0
94;15.03.2016;2016;03;02;Tiistai;0;0;0
94;15.03.2016;2016;03;03;Tiistai;0;0;0
94;15.03.2016;2016;03;04;Tiistai;0;0;0
94;15.03.2016;2016;03;05;Tiistai;3;0;3
94;15.03.2016;2016;03;06;Tiistai;8;1;9
94;15.03.2016;2016;03;07;Tiistai;7;3;10
94;15.03.2016;2016;03;08;Tiistai;3;0;3
94;15.03.2016;2016;03;09;Tiistai;1;0;1
94;15.03.2016;2016;03;10;Tiistai;2;0;2
94;15.03.2016;2016;03;11;Tiistai;0;2;2
94;15.03.2016;2016;03;12;Tiistai;1;1;2
94;15.03.2016;2016;03;13;Tiistai;0;1;1
94;15.03.2016;2016;03;14;Tiistai;0;6;6
94;15.03.2016;2016;03;15;Tiistai;3;16;19
94;15.03.2016;2016;03;16;Tiistai;5;5;10
94;15.03.2016;2016;03;17;Tiistai;0;1;1
94;15.03.2016;2016;03;18;Tiistai;0;2;2
94;15.03.2016;2016;03;19;Tiistai;1;3;4
94;15.03.2016;2016;03;20;Tiistai;0;1;1
94;15.03.2016;2016;03;21;Tiistai;1;1;2
94;15.03.2016;2016;03;22;Tiistai;0;1;1
94;15.03.2016;2016;03;23;Tiistai;0;0;0
94;16.03.2016;2016;03;00;Keskiviikko;0;0;0
94;16.03.2016;2016;03;01;Keskiviikko;1;0;1
94;16.03.2016;2016;03;02;Keskiviikko;0;0;0
94;16.03.2016;2016;03;03;Keskiviikko;0;0;0
94;16.03.2016;2016;03;04;Keskiviikko;0;0;0
94;16.03.2016;2016;03;05;Keskiviikko;1;0;1
94;16.03.2016;2016;03;06;Keskiviikko;6;3;9
94;16.03.2016;2016;03;07;Keskiviikko;8;0;8
94;16.03.2016;2016;03;08;Keskiviikko;6;0;6
94;16.03.2016;2016;03;09;Keskiviikko;2;0;2
94;16.03.2016;2016;03;10;Keskiviikko;2;2;4
94;16.03.2016;2016;03;11;Keskiviikko;0;0;0
94;16.03.2016;2016;03;12;Keskiviikko;0;0;0
94;16.03.2016;2016;03;13;Keskiviikko;1;2;3
94;16.03.2016;2016;03;14;Keskiviikko;0;2;2
94;16.03.2016;2016;03;15;Keskiviikko;3;11;14
94;16.03.2016;2016;03;16;Keskiviikko;0;11;11
94;16.03.2016;2016;03;17;Keskiviikko;0;4;4
94;16.03.2016;2016;03;18;Keskiviikko;0;1;1
94;16.03.2016;2016;03;19;Keskiviikko;2;4;6
94;16.03.2016;2016;03;20;Keskiviikko;0;2;2
94;16.03.2016;2016;03;21;Keskiviikko;0;2;2
94;16.03.2016;2016;03;22;Keskiviikko;0;0;0
94;16.03.2016;2016;03;23;Keskiviikko;0;0;0
94;17.03.2016;2016;03;00;Torstai;0;0;0
94;17.03.2016;2016;03;01;Torstai;0;0;0
94;17.03.2016;2016;03;02;Torstai;0;0;0
94;17.03.2016;2016;03;03;Torstai;0;0;0
94;17.03.2016;2016;03;04;Torstai;0;2;2
94;17.03.2016;2016;03;05;Torstai;3;1;4
94;17.03.2016;2016;03;06;Torstai;5;1;6
94;17.03.2016;2016;03;07;Torstai;7;2;9
94;17.03.2016;2016;03;08;Torstai;5;0;5
94;17.03.2016;2016;03;09;Torstai;4;0;4
94;17.03.2016;2016;03;10;Torstai;1;0;1
94;17.03.2016;2016;03;11;Torstai;2;0;2
94;17.03.2016;2016;03;12;Torstai;1;0;1
94;17.03.2016;2016;03;13;Torstai;2;1;3
94;17.03.2016;2016;03;14;Torstai;2;7;9
94;17.03.2016;2016;03;15;Torstai;2;5;7
94;17.03.2016;2016;03;16;Torstai;0;6;6
94;17.03.2016;2016;03;17;Torstai;0;3;3
94;17.03.2016;2016;03;18;Torstai;3;5;8
94;17.03.2016;2016;03;19;Torstai;2;1;3
94;17.03.2016;2016;03;20;Torstai;1;0;1
94;17.03.2016;2016;03;21;Torstai;0;1;1
94;17.03.2016;2016;03;22;Torstai;0;3;3
94;17.03.2016;2016;03;23;Torstai;0;0;0
94;18.03.2016;2016;03;00;Perjantai;0;0;0
94;18.03.2016;2016;03;01;Perjantai;0;0;0
94;18.03.2016;2016;03;02;Perjantai;0;0;0
94;18.03.2016;2016;03;03;Perjantai;0;0;0
94;18.03.2016;2016;03;04;Perjantai;0;1;1
94;18.03.2016;2016;03;05;Perjantai;1;1;2
94;18.03.2016;2016;03;06;Perjantai;2;2;4
94;18.03.2016;2016;03;07;Perjantai;10;1;11
94;18.03.2016;2016;03;08;Perjantai;4;0;4
94;18.03.2016;2016;03;09;Perjantai;3;0;3
94;18.03.2016;2016;03;10;Perjantai;1;2;3
94;18.03.2016;2016;03;11;Perjantai;0;0;0
94;18.03.2016;2016;03;12;Perjantai;0;0;0
94;18.03.2016;2016;03;13;Perjantai;0;1;1
94;18.03.2016;2016;03;14;Perjantai;1;2;3
94;18.03.2016;2016;03;15;Perjantai;1;2;3
94;18.03.2016;2016;03;16;Perjantai;0;7;7
94;18.03.2016;2016;03;17;Perjantai;1;3;4
94;18.03.2016;2016;03;18;Perjantai;0;1;1
94;18.03.2016;2016;03;19;Perjantai;1;0;1
94;18.03.2016;2016;03;20;Perjantai;1;3;4
94;18.03.2016;2016;03;21;Perjantai;0;3;3
94;18.03.2016;2016;03;22;Perjantai;1;1;2
94;18.03.2016;2016;03;23;Perjantai;0;0;0
94;19.03.2016;2016;03;00;Lauantai;0;0;0
94;19.03.2016;2016;03;01;Lauantai;0;0;0
94;19.03.2016;2016;03;02;Lauantai;0;0;0
94;19.03.2016;2016;03;03;Lauantai;0;0;0
94;19.03.2016;2016;03;04;Lauantai;0;0;0
94;19.03.2016;2016;03;05;Lauantai;0;0;0
94;19.03.2016;2016;03;06;Lauantai;0;0;0
94;19.03.2016;2016;03;07;Lauantai;0;0;0
94;19.03.2016;2016;03;08;Lauantai;1;2;3
94;19.03.2016;2016;03;09;Lauantai;0;0;0
94;19.03.2016;2016;03;10;Lauantai;3;3;6
94;19.03.2016;2016;03;11;Lauantai;1;0;1
94;19.03.2016;2016;03;12;Lauantai;0;1;1
94;19.03.2016;2016;03;13;Lauantai;0;0;0
94;19.03.2016;2016;03;14;Lauantai;1;2;3
94;19.03.2016;2016;03;15;Lauantai;0;4;4
94;19.03.2016;2016;03;16;Lauantai;0;1;1
94;19.03.2016;2016;03;17;Lauantai;0;1;1
94;19.03.2016;2016;03;18;Lauantai;0;1;1
94;19.03.2016;2016;03;19;Lauantai;2;0;2
94;19.03.2016;2016;03;20;Lauantai;0;1;1
94;19.03.2016;2016;03;21;Lauantai;0;0;0
94;19.03.2016;2016;03;22;Lauantai;0;0;0
94;19.03.2016;2016;03;23;Lauantai;0;0;0
94;20.03.2016;2016;03;00;Sunnuntai;0;0;0
94;20.03.2016;2016;03;01;Sunnuntai;0;0;0
94;20.03.2016;2016;03;02;Sunnuntai;0;0;0
94;20.03.2016;2016;03;03;Sunnuntai;0;0;0
94;20.03.2016;2016;03;04;Sunnuntai;0;0;0
94;20.03.2016;2016;03;05;Sunnuntai;0;0;0
94;20.03.2016;2016;03;06;Sunnuntai;0;0;0
94;20.03.2016;2016;03;07;Sunnuntai;0;0;0
94;20.03.2016;2016;03;08;Sunnuntai;3;0;3
94;20.03.2016;2016;03;09;Sunnuntai;0;0;0
94;20.03.2016;2016;03;10;Sunnuntai;1;1;2
94;20.03.2016;2016;03;11;Sunnuntai;3;2;5
94;20.03.2016;2016;03;12;Sunnuntai;0;2;2
94;20.03.2016;2016;03;13;Sunnuntai;1;2;3
94;20.03.2016;2016;03;14;Sunnuntai;2;1;3
94;20.03.2016;2016;03;15;Sunnuntai;0;1;1
94;20.03.2016;2016;03;16;Sunnuntai;1;1;2
94;20.03.2016;2016;03;17;Sunnuntai;2;1;3
94;20.03.2016;2016;03;18;Sunnuntai;1;2;3
94;20.03.2016;2016;03;19;Sunnuntai;2;1;3
94;20.03.2016;2016;03;20;Sunnuntai;0;0;0
94;20.03.2016;2016;03;21;Sunnuntai;0;2;2
94;20.03.2016;2016;03;22;Sunnuntai;0;1;1
94;20.03.2016;2016;03;23;Sunnuntai;0;1;1
94;21.03.2016;2016;03;00;Maanantai;0;0;0
94;21.03.2016;2016;03;01;Maanantai;0;0;0
94;21.03.2016;2016;03;02;Maanantai;0;0;0
94;21.03.2016;2016;03;03;Maanantai;0;0;0
94;21.03.2016;2016;03;04;Maanantai;0;0;0
94;21.03.2016;2016;03;05;Maanantai;2;0;2
94;21.03.2016;2016;03;06;Maanantai;5;1;6
94;21.03.2016;2016;03;07;Maanantai;8;0;8
94;21.03.2016;2016;03;08;Maanantai;5;0;5
94;21.03.2016;2016;03;09;Maanantai;0;1;1
94;21.03.2016;2016;03;10;Maanantai;0;0;0
94;21.03.2016;2016;03;11;Maanantai;0;1;1
94;21.03.2016;2016;03;12;Maanantai;1;0;1
94;21.03.2016;2016;03;13;Maanantai;1;1;2
94;21.03.2016;2016;03;14;Maanantai;1;5;6
94;21.03.2016;2016;03;15;Maanantai;1;5;6
94;21.03.2016;2016;03;16;Maanantai;2;9;11
94;21.03.2016;2016;03;17;Maanantai;1;5;6
94;21.03.2016;2016;03;18;Maanantai;1;2;3
94;21.03.2016;2016;03;19;Maanantai;1;4;5
94;21.03.2016;2016;03;20;Maanantai;0;1;1
94;21.03.2016;2016;03;21;Maanantai;0;1;1
94;21.03.2016;2016;03;22;Maanantai;0;0;0
94;21.03.2016;2016;03;23;Maanantai;0;0;0
94;22.03.2016;2016;03;00;Tiistai;0;0;0
94;22.03.2016;2016;03;01;Tiistai;0;0;0
94;22.03.2016;2016;03;02;Tiistai;0;0;0
94;22.03.2016;2016;03;03;Tiistai;0;0;0
94;22.03.2016;2016;03;04;Tiistai;0;0;0
94;22.03.2016;2016;03;05;Tiistai;3;0;3
94;22.03.2016;2016;03;06;Tiistai;3;2;5
94;22.03.2016;2016;03;07;Tiistai;4;0;4
94;22.03.2016;2016;03;08;Tiistai;3;0;3
94;22.03.2016;2016;03;09;Tiistai;3;0;3
94;22.03.2016;2016;03;10;Tiistai;1;0;1
94;22.03.2016;2016;03;11;Tiistai;0;0;0
94;22.03.2016;2016;03;12;Tiistai;0;0;0
94;22.03.2016;2016;03;13;Tiistai;0;2;2
94;22.03.2016;2016;03;14;Tiistai;0;2;2
94;22.03.2016;2016;03;15;Tiistai;1;3;4
94;22.03.2016;2016;03;16;Tiistai;2;4;6
94;22.03.2016;2016;03;17;Tiistai;1;5;6
94;22.03.2016;2016;03;18;Tiistai;0;3;3
94;22.03.2016;2016;03;19;Tiistai;1;2;3
94;22.03.2016;2016;03;20;Tiistai;1;1;2
94;22.03.2016;2016;03;21;Tiistai;0;1;1
94;22.03.2016;2016;03;22;Tiistai;0;0;0
94;22.03.2016;2016;03;23;Tiistai;2;1;3
94;23.03.2016;2016;03;00;Keskiviikko;0;0;0
94;23.03.2016;2016;03;01;Keskiviikko;0;0;0
94;23.03.2016;2016;03;02;Keskiviikko;0;0;0
94;23.03.2016;2016;03;03;Keskiviikko;0;0;0
94;23.03.2016;2016;03;04;Keskiviikko;0;0;0
94;23.03.2016;2016;03;05;Keskiviikko;2;1;3
94;23.03.2016;2016;03;06;Keskiviikko;6;1;7
94;23.03.2016;2016;03;07;Keskiviikko;6;0;6
94;23.03.2016;2016;03;08;Keskiviikko;4;0;4
94;23.03.2016;2016;03;09;Keskiviikko;3;1;4
94;23.03.2016;2016;03;10;Keskiviikko;2;0;2
94;23.03.2016;2016;03;11;Keskiviikko;1;1;2
94;23.03.2016;2016;03;12;Keskiviikko;0;1;1
94;23.03.2016;2016;03;13;Keskiviikko;1;1;2
94;23.03.2016;2016;03;14;Keskiviikko;2;3;5
94;23.03.2016;2016;03;15;Keskiviikko;1;3;4
94;23.03.2016;2016;03;16;Keskiviikko;0;5;5
94;23.03.2016;2016;03;17;Keskiviikko;0;3;3
94;23.03.2016;2016;03;18;Keskiviikko;2;4;6
94;23.03.2016;2016;03;19;Keskiviikko;0;1;1
94;23.03.2016;2016;03;20;Keskiviikko;1;1;2
94;23.03.2016;2016;03;21;Keskiviikko;0;1;1
94;23.03.2016;2016;03;22;Keskiviikko;0;0;0
94;23.03.2016;2016;03;23;Keskiviikko;0;0;0
94;24.03.2016;2016;03;00;Torstai;0;0;0
94;24.03.2016;2016;03;01;Torstai;0;0;0
94;24.03.2016;2016;03;02;Torstai;0;0;0
94;24.03.2016;2016;03;03;Torstai;0;0;0
94;24.03.2016;2016;03;04;Torstai;0;0;0
94;24.03.2016;2016;03;05;Torstai;2;0;2
94;24.03.2016;2016;03;06;Torstai;4;2;6
94;24.03.2016;2016;03;07;Torstai;8;0;8
94;24.03.2016;2016;03;08;Torstai;1;1;2
94;24.03.2016;2016;03;09;Torstai;1;0;1
94;24.03.2016;2016;03;10;Torstai;1;0;1
94;24.03.2016;2016;03;11;Torstai;0;2;2
94;24.03.2016;2016;03;12;Torstai;1;3;4
94;24.03.2016;2016;03;13;Torstai;0;4;4
94;24.03.2016;2016;03;14;Torstai;1;1;2
94;24.03.2016;2016;03;15;Torstai;1;9;10
94;24.03.2016;2016;03;16;Torstai;0;1;1
94;24.03.2016;2016;03;17;Torstai;1;1;2
94;24.03.2016;2016;03;18;Torstai;0;2;2
94;24.03.2016;2016;03;19;Torstai;0;0;0
94;24.03.2016;2016;03;20;Torstai;1;1;2
94;24.03.2016;2016;03;21;Torstai;1;0;1
94;24.03.2016;2016;03;22;Torstai;0;0;0
94;24.03.2016;2016;03;23;Torstai;0;0;0
94;25.03.2016;2016;03;00;Perjantai;0;0;0
94;25.03.2016;2016;03;01;Perjantai;0;0;0
94;25.03.2016;2016;03;02;Perjantai;0;0;0
94;25.03.2016;2016;03;03;Perjantai;0;0;0
94;25.03.2016;2016;03;04;Perjantai;0;0;0
94;25.03.2016;2016;03;05;Perjantai;0;0;0
94;25.03.2016;2016;03;06;Perjantai;0;0;0
94;25.03.2016;2016;03;07;Perjantai;0;0;0
94;25.03.2016;2016;03;08;Perjantai;0;0;0
94;25.03.2016;2016;03;09;Perjantai;0;0;0
94;25.03.2016;2016;03;10;Perjantai;0;0;0
94;25.03.2016;2016;03;11;Perjantai;0;0;0
94;25.03.2016;2016;03;12;Perjantai;1;0;1
94;25.03.2016;2016;03;13;Perjantai;0;0;0
94;25.03.2016;2016;03;14;Perjantai;0;0;0
94;25.03.2016;2016;03;15;Perjantai;0;0;0
94;25.03.2016;2016;03;16;Perjantai;0;0;0
94;25.03.2016;2016;03;17;Perjantai;0;0;0
94;25.03.2016;2016;03;18;Perjantai;1;1;2
94;25.03.2016;2016;03;19;Perjantai;0;1;1
94;25.03.2016;2016;03;20;Perjantai;0;1;1
94;25.03.2016;2016;03;21;Perjantai;3;2;5
94;25.03.2016;2016;03;22;Perjantai;1;1;2
94;25.03.2016;2016;03;23;Perjantai;0;0;0
94;26.03.2016;2016;03;00;Lauantai;0;0;0
94;26.03.2016;2016;03;01;Lauantai;0;1;1
94;26.03.2016;2016;03;02;Lauantai;0;0;0
94;26.03.2016;2016;03;03;Lauantai;0;0;0
94;26.03.2016;2016;03;04;Lauantai;0;0;0
94;26.03.2016;2016;03;05;Lauantai;0;0;0
94;26.03.2016;2016;03;06;Lauantai;2;0;2
94;26.03.2016;2016;03;07;Lauantai;0;0;0
94;26.03.2016;2016;03;08;Lauantai;1;0;1
94;26.03.2016;2016;03;09;Lauantai;0;0;0
94;26.03.2016;2016;03;10;Lauantai;2;1;3
94;26.03.2016;2016;03;11;Lauantai;1;0;1
94;26.03.2016;2016;03;12;Lauantai;0;3;3
94;26.03.2016;2016;03;13;Lauantai;0;0;0
94;26.03.2016;2016;03;14;Lauantai;4;3;7
94;26.03.2016;2016;03;15;Lauantai;0;3;3
94;26.03.2016;2016;03;16;Lauantai;3;1;4
94;26.03.2016;2016;03;17;Lauantai;0;0;0
94;26.03.2016;2016;03;18;Lauantai;0;1;1
94;26.03.2016;2016;03;19;Lauantai;0;0;0
94;26.03.2016;2016;03;20;Lauantai;1;0;1
94;26.03.2016;2016;03;21;Lauantai;0;0;0
94;26.03.2016;2016;03;22;Lauantai;0;0;0
94;26.03.2016;2016;03;23;Lauantai;0;2;2
94;27.03.2016;2016;03;00;Sunnuntai;0;0;0
94;27.03.2016;2016;03;01;Sunnuntai;0;0;0
94;27.03.2016;2016;03;02;Sunnuntai;0;0;0
94;27.03.2016;2016;03;03;Sunnuntai;0;0;0
94;27.03.2016;2016;03;04;Sunnuntai;0;0;0
94;27.03.2016;2016;03;05;Sunnuntai;0;0;0
94;27.03.2016;2016;03;06;Sunnuntai;0;0;0
94;27.03.2016;2016;03;07;Sunnuntai;0;0;0
94;27.03.2016;2016;03;08;Sunnuntai;1;1;2
94;27.03.2016;2016;03;09;Sunnuntai;0;5;5
94;27.03.2016;2016;03;10;Sunnuntai;1;0;1
94;27.03.2016;2016;03;11;Sunnuntai;1;0;1
94;27.03.2016;2016;03;12;Sunnuntai;3;0;3
94;27.03.2016;2016;03;13;Sunnuntai;2;4;6
94;27.03.2016;2016;03;14;Sunnuntai;0;1;1
94;27.03.2016;2016;03;15;Sunnuntai;0;2;2
94;27.03.2016;2016;03;16;Sunnuntai;2;0;2
94;27.03.2016;2016;03;17;Sunnuntai;3;3;6
94;27.03.2016;2016;03;18;Sunnuntai;3;3;6
94;27.03.2016;2016;03;19;Sunnuntai;0;0;0
94;27.03.2016;2016;03;20;Sunnuntai;3;2;5
94;27.03.2016;2016;03;21;Sunnuntai;1;2;3
94;27.03.2016;2016;03;22;Sunnuntai;0;0;0
94;27.03.2016;2016;03;23;Sunnuntai;0;0;0
94;28.03.2016;2016;03;00;Maanantai;0;0;0
94;28.03.2016;2016;03;01;Maanantai;0;0;0
94;28.03.2016;2016;03;02;Maanantai;0;0;0
94;28.03.2016;2016;03;03;Maanantai;0;0;0
94;28.03.2016;2016;03;04;Maanantai;0;0;0
94;28.03.2016;2016;03;05;Maanantai;0;0;0
94;28.03.2016;2016;03;06;Maanantai;1;0;1
94;28.03.2016;2016;03;07;Maanantai;0;0;0
94;28.03.2016;2016;03;08;Maanantai;1;1;2
94;28.03.2016;2016;03;09;Maanantai;0;2;2
94;28.03.2016;2016;03;10;Maanantai;3;1;4
94;28.03.2016;2016;03;11;Maanantai;5;2;7
94;28.03.2016;2016;03;12;Maanantai;0;1;1
94;28.03.2016;2016;03;13;Maanantai;3;2;5
94;28.03.2016;2016;03;14;Maanantai;2;3;5
94;28.03.2016;2016;03;15;Maanantai;2;4;6
94;28.03.2016;2016;03;16;Maanantai;8;1;9
94;28.03.2016;2016;03;17;Maanantai;5;1;6
94;28.03.2016;2016;03;18;Maanantai;3;2;5
94;28.03.2016;2016;03;19;Maanantai;5;5;10
94;28.03.2016;2016;03;20;Maanantai;0;0;0
94;28.03.2016;2016;03;21;Maanantai;0;1;1
94;28.03.2016;2016;03;22;Maanantai;0;0;0
94;28.03.2016;2016;03;23;Maanantai;0;0;0
94;29.03.2016;2016;03;00;Tiistai;0;0;0
94;29.03.2016;2016;03;01;Tiistai;0;0;0
94;29.03.2016;2016;03;02;Tiistai;0;0;0
94;29.03.2016;2016;03;03;Tiistai;0;0;0
94;29.03.2016;2016;03;04;Tiistai;0;0;0
94;29.03.2016;2016;03;05;Tiistai;1;0;1
94;29.03.2016;2016;03;06;Tiistai;5;1;6
94;29.03.2016;2016;03;07;Tiistai;14;2;16
94;29.03.2016;2016;03;08;Tiistai;6;1;7
94;29.03.2016;2016;03;09;Tiistai;1;1;2
94;29.03.2016;2016;03;10;Tiistai;2;3;5
94;29.03.2016;2016;03;11;Tiistai;5;1;6
94;29.03.2016;2016;03;12;Tiistai;1;3;4
94;29.03.2016;2016;03;13;Tiistai;3;3;6
94;29.03.2016;2016;03;14;Tiistai;4;9;13
94;29.03.2016;2016;03;15;Tiistai;2;7;9
94;29.03.2016;2016;03;16;Tiistai;5;6;11
94;29.03.2016;2016;03;17;Tiistai;5;14;19
94;29.03.2016;2016;03;18;Tiistai;3;3;6
94;29.03.2016;2016;03;19;Tiistai;1;1;2
94;29.03.2016;2016;03;20;Tiistai;1;5;6
94;29.03.2016;2016;03;21;Tiistai;0;3;3
94;29.03.2016;2016;03;22;Tiistai;0;0;0
94;29.03.2016;2016;03;23;Tiistai;0;0;0
94;30.03.2016;2016;03;00;Keskiviikko;0;0;0
94;30.03.2016;2016;03;01;Keskiviikko;0;0;0
94;30.03.2016;2016;03;02;Keskiviikko;0;0;0
94;30.03.2016;2016;03;03;Keskiviikko;0;0;0
94;30.03.2016;2016;03;04;Keskiviikko;0;0;0
94;30.03.2016;2016;03;05;Keskiviikko;1;1;2
94;30.03.2016;2016;03;06;Keskiviikko;7;1;8
94;30.03.2016;2016;03;07;Keskiviikko;9;1;10
94;30.03.2016;2016;03;08;Keskiviikko;6;1;7
94;30.03.2016;2016;03;09;Keskiviikko;5;0;5
94;30.03.2016;2016;03;10;Keskiviikko;1;1;2
94;30.03.2016;2016;03;11;Keskiviikko;0;1;1
94;30.03.2016;2016;03;12;Keskiviikko;3;0;3
94;30.03.2016;2016;03;13;Keskiviikko;2;0;2
94;30.03.2016;2016;03;14;Keskiviikko;2;7;9
94;30.03.2016;2016;03;15;Keskiviikko;2;9;11
94;30.03.2016;2016;03;16;Keskiviikko;1;10;11
94;30.03.2016;2016;03;17;Keskiviikko;1;4;5
94;30.03.2016;2016;03;18;Keskiviikko;4;5;9
94;30.03.2016;2016;03;19;Keskiviikko;3;3;6
94;30.03.2016;2016;03;20;Keskiviikko;1;7;8
94;30.03.2016;2016;03;21;Keskiviikko;2;1;3
94;30.03.2016;2016;03;22;Keskiviikko;0;2;2
94;30.03.2016;2016;03;23;Keskiviikko;0;0;0
94;31.03.2016;2016;03;00;Torstai;0;0;0
94;31.03.2016;2016;03;01;Torstai;0;0;0
94;31.03.2016;2016;03;02;Torstai;0;0;0
94;31.03.2016;2016;03;03;Torstai;0;0;0
94;31.03.2016;2016;03;04;Torstai;0;0;0
94;31.03.2016;2016;03;05;Torstai;1;1;2
94;31.03.2016;2016;03;06;Torstai;8;1;9
94;31.03.2016;2016;03;07;Torstai;12;1;13
94;31.03.2016;2016;03;08;Torstai;4;2;6
94;31.03.2016;2016;03;09;Torstai;2;0;2
94;31.03.2016;2016;03;10;Torstai;0;1;1
94;31.03.2016;2016;03;11;Torstai;5;2;7
94;31.03.2016;2016;03;12;Torstai;1;0;1
94;31.03.2016;2016;03;13;Torstai;0;2;2
94;31.03.2016;2016;03;14;Torstai;4;5;9
94;31.03.2016;2016;03;15;Torstai;2;12;14
94;31.03.2016;2016;03;16;Torstai;0;9;9
94;31.03.2016;2016;03;17;Torstai;1;6;7
94;31.03.2016;2016;03;18;Torstai;3;7;10
94;31.03.2016;2016;03;19;Torstai;6;0;6
94;31.03.2016;2016;03;20;Torstai;0;1;1
94;31.03.2016;2016;03;21;Torstai;0;1;1
94;31.03.2016;2016;03;22;Torstai;0;2;2
94;31.03.2016;2016;03;23;Torstai;0;0;0
94;01.04.2016;2016;04;00;Perjantai;0;0;0
94;01.04.2016;2016;04;01;Perjantai;0;0;0
94;01.04.2016;2016;04;02;Perjantai;0;0;0
94;01.04.2016;2016;04;03;Perjantai;0;0;0
94;01.04.2016;2016;04;04;Perjantai;0;0;0
94;01.04.2016;2016;04;05;Perjantai;1;0;1
94;01.04.2016;2016;04;06;Perjantai;6;1;7
94;01.04.2016;2016;04;07;Perjantai;9;1;10
94;01.04.2016;2016;04;08;Perjantai;8;2;10
94;01.04.2016;2016;04;09;Perjantai;7;0;7
94;01.04.2016;2016;04;10;Perjantai;6;0;6
94;01.04.2016;2016;04;11;Perjantai;6;4;10
94;01.04.2016;2016;04;12;Perjantai;1;3;4
94;01.04.2016;2016;04;13;Perjantai;1;4;5
94;01.04.2016;2016;04;14;Perjantai;5;9;14
94;01.04.2016;2016;04;15;Perjantai;3;9;12
94;01.04.2016;2016;04;16;Perjantai;1;7;8
94;01.04.2016;2016;04;17;Perjantai;6;7;13
94;01.04.2016;2016;04;18;Perjantai;6;10;16
94;01.04.2016;2016;04;19;Perjantai;0;2;2
94;01.04.2016;2016;04;20;Perjantai;1;4;5
94;01.04.2016;2016;04;21;Perjantai;0;1;1
94;01.04.2016;2016;04;22;Perjantai;0;3;3
94;01.04.2016;2016;04;23;Perjantai;0;0;0
94;02.04.2016;2016;04;00;Lauantai;1;0;1
94;02.04.2016;2016;04;01;Lauantai;0;0;0
94;02.04.2016;2016;04;02;Lauantai;0;0;0
94;02.04.2016;2016;04;03;Lauantai;0;0;0
94;02.04.2016;2016;04;04;Lauantai;0;0;0
94;02.04.2016;2016;04;05;Lauantai;0;0;0
94;02.04.2016;2016;04;06;Lauantai;0;0;0
94;02.04.2016;2016;04;07;Lauantai;1;0;1
94;02.04.2016;2016;04;08;Lauantai;2;2;4
94;02.04.2016;2016;04;09;Lauantai;1;4;5
94;02.04.2016;2016;04;10;Lauantai;3;3;6
94;02.04.2016;2016;04;11;Lauantai;1;4;5
94;02.04.2016;2016;04;12;Lauantai;0;1;1
94;02.04.2016;2016;04;13;Lauantai;1;0;1
94;02.04.2016;2016;04;14;Lauantai;7;4;11
94;02.04.2016;2016;04;15;Lauantai;4;3;7
94;02.04.2016;2016;04;16;Lauantai;4;2;6
94;02.04.2016;2016;04;17;Lauantai;7;4;11
94;02.04.2016;2016;04;18;Lauantai;3;4;7
94;02.04.2016;2016;04;19;Lauantai;0;1;1
94;02.04.2016;2016;04;20;Lauantai;2;3;5
94;02.04.2016;2016;04;21;Lauantai;0;3;3
94;02.04.2016;2016;04;22;Lauantai;0;2;2
94;02.04.2016;2016;04;23;Lauantai;2;0;2
94;03.04.2016;2016;04;00;Sunnuntai;0;0;0
94;03.04.2016;2016;04;01;Sunnuntai;0;1;1
94;03.04.2016;2016;04;02;Sunnuntai;0;0;0
94;03.04.2016;2016;04;03;Sunnuntai;0;0;0
94;03.04.2016;2016;04;04;Sunnuntai;0;0;0
94;03.04.2016;2016;04;05;Sunnuntai;0;0;0
94;03.04.2016;2016;04;06;Sunnuntai;0;0;0
94;03.04.2016;2016;04;07;Sunnuntai;0;0;0
94;03.04.2016;2016;04;08;Sunnuntai;0;0;0
94;03.04.2016;2016;04;09;Sunnuntai;2;3;5
94;03.04.2016;2016;04;10;Sunnuntai;6;3;9
94;03.04.2016;2016;04;11;Sunnuntai;6;1;7
94;03.04.2016;2016;04;12;Sunnuntai;7;11;18
94;03.04.2016;2016;04;13;Sunnuntai;2;3;5
94;03.04.2016;2016;04;14;Sunnuntai;9;7;16
94;03.04.2016;2016;04;15;Sunnuntai;5;9;14
94;03.04.2016;2016;04;16;Sunnuntai;9;4;13
94;03.04.2016;2016;04;17;Sunnuntai;2;4;6
94;03.04.2016;2016;04;18;Sunnuntai;5;2;7
94;03.04.2016;2016;04;19;Sunnuntai;3;1;4
94;03.04.2016;2016;04;20;Sunnuntai;5;3;8
94;03.04.2016;2016;04;21;Sunnuntai;1;0;1
94;03.04.2016;2016;04;22;Sunnuntai;0;0;0
94;03.04.2016;2016;04;23;Sunnuntai;0;0;0
94;04.04.2016;2016;04;00;Maanantai;0;0;0
94;04.04.2016;2016;04;01;Maanantai;0;0;0
94;04.04.2016;2016;04;02;Maanantai;0;0;0
94;04.04.2016;2016;04;03;Maanantai;0;0;0
94;04.04.2016;2016;04;04;Maanantai;0;0;0
94;04.04.2016;2016;04;05;Maanantai;5;0;5
94;04.04.2016;2016;04;06;Maanantai;11;2;13
94;04.04.2016;2016;04;07;Maanantai;11;5;16
94;04.04.2016;2016;04;08;Maanantai;10;3;13
94;04.04.2016;2016;04;09;Maanantai;4;0;4
94;04.04.2016;2016;04;10;Maanantai;0;3;3
94;04.04.2016;2016;04;11;Maanantai;5;0;5
94;04.04.2016;2016;04;12;Maanantai;3;3;6
94;04.04.2016;2016;04;13;Maanantai;4;5;9
94;04.04.2016;2016;04;14;Maanantai;1;4;5
94;04.04.2016;2016;04;15;Maanantai;12;17;29
94;04.04.2016;2016;04;16;Maanantai;3;12;15
94;04.04.2016;2016;04;17;Maanantai;5;17;22
94;04.04.2016;2016;04;18;Maanantai;2;8;10
94;04.04.2016;2016;04;19;Maanantai;1;6;7
94;04.04.2016;2016;04;20;Maanantai;2;3;5
94;04.04.2016;2016;04;21;Maanantai;2;2;4
94;04.04.2016;2016;04;22;Maanantai;1;3;4
94;04.04.2016;2016;04;23;Maanantai;0;0;0
94;05.04.2016;2016;04;00;Tiistai;0;0;0
94;05.04.2016;2016;04;01;Tiistai;0;0;0
94;05.04.2016;2016;04;02;Tiistai;0;0;0
94;05.04.2016;2016;04;03;Tiistai;0;0;0
94;05.04.2016;2016;04;04;Tiistai;1;0;1
94;05.04.2016;2016;04;05;Tiistai;4;1;5
94;05.04.2016;2016;04;06;Tiistai;7;1;8
94;05.04.2016;2016;04;07;Tiistai;10;1;11
94;05.04.2016;2016;04;08;Tiistai;5;3;8
94;05.04.2016;2016;04;09;Tiistai;1;2;3
94;05.04.2016;2016;04;10;Tiistai;2;0;2
94;05.04.2016;2016;04;11;Tiistai;3;2;5
94;05.04.2016;2016;04;12;Tiistai;0;1;1
94;05.04.2016;2016;04;13;Tiistai;1;2;3
94;05.04.2016;2016;04;14;Tiistai;2;5;7
94;05.04.2016;2016;04;15;Tiistai;1;7;8
94;05.04.2016;2016;04;16;Tiistai;2;8;10
94;05.04.2016;2016;04;17;Tiistai;1;6;7
94;05.04.2016;2016;04;18;Tiistai;0;2;2
94;05.04.2016;2016;04;19;Tiistai;3;4;7
94;05.04.2016;2016;04;20;Tiistai;2;4;6
94;05.04.2016;2016;04;21;Tiistai;0;3;3
94;05.04.2016;2016;04;22;Tiistai;0;0;0
94;05.04.2016;2016;04;23;Tiistai;0;0;0
94;06.04.2016;2016;04;00;Keskiviikko;0;0;0
94;06.04.2016;2016;04;01;Keskiviikko;0;0;0
94;06.04.2016;2016;04;02;Keskiviikko;0;0;0
94;06.04.2016;2016;04;03;Keskiviikko;0;0;0
94;06.04.2016;2016;04;04;Keskiviikko;1;0;1
94;06.04.2016;2016;04;05;Keskiviikko;2;1;3
94;06.04.2016;2016;04;06;Keskiviikko;7;1;8
94;06.04.2016;2016;04;07;Keskiviikko;8;1;9
94;06.04.2016;2016;04;08;Keskiviikko;4;3;7
94;06.04.2016;2016;04;09;Keskiviikko;5;0;5
94;06.04.2016;2016;04;10;Keskiviikko;2;2;4
94;06.04.2016;2016;04;11;Keskiviikko;1;2;3
94;06.04.2016;2016;04;12;Keskiviikko;1;2;3
94;06.04.2016;2016;04;13;Keskiviikko;2;2;4
94;06.04.2016;2016;04;14;Keskiviikko;1;7;8
94;06.04.2016;2016;04;15;Keskiviikko;3;6;9
94;06.04.2016;2016;04;16;Keskiviikko;0;7;7
94;06.04.2016;2016;04;17;Keskiviikko;0;2;2
94;06.04.2016;2016;04;18;Keskiviikko;0;1;1
94;06.04.2016;2016;04;19;Keskiviikko;0;1;1
94;06.04.2016;2016;04;20;Keskiviikko;1;2;3
94;06.04.2016;2016;04;21;Keskiviikko;0;2;2
94;06.04.2016;2016;04;22;Keskiviikko;0;1;1
94;06.04.2016;2016;04;23;Keskiviikko;0;0;0
94;07.04.2016;2016;04;00;Torstai;0;0;0
94;07.04.2016;2016;04;01;Torstai;0;0;0
94;07.04.2016;2016;04;02;Torstai;0;0;0
94;07.04.2016;2016;04;03;Torstai;0;2;2
94;07.04.2016;2016;04;04;Torstai;0;0;0
94;07.04.2016;2016;04;05;Torstai;3;2;5
94;07.04.2016;2016;04;06;Torstai;8;0;8
94;07.04.2016;2016;04;07;Torstai;12;1;13
94;07.04.2016;2016;04;08;Torstai;5;0;5
94;07.04.2016;2016;04;09;Torstai;0;2;2
94;07.04.2016;2016;04;10;Torstai;1;0;1
94;07.04.2016;2016;04;11;Torstai;1;2;3
94;07.04.2016;2016;04;12;Torstai;0;2;2
94;07.04.2016;2016;04;13;Torstai;4;0;4
94;07.04.2016;2016;04;14;Torstai;4;5;9
94;07.04.2016;2016;04;15;Torstai;2;4;6
94;07.04.2016;2016;04;16;Torstai;1;11;12
94;07.04.2016;2016;04;17;Torstai;3;2;5
94;07.04.2016;2016;04;18;Torstai;3;7;10
94;07.04.2016;2016;04;19;Torstai;2;1;3
94;07.04.2016;2016;04;20;Torstai;4;1;5
94;07.04.2016;2016;04;21;Torstai;1;1;2
94;07.04.2016;2016;04;22;Torstai;0;2;2
94;07.04.2016;2016;04;23;Torstai;0;0;0
94;08.04.2016;2016;04;00;Perjantai;0;0;0
94;08.04.2016;2016;04;01;Perjantai;0;0;0
94;08.04.2016;2016;04;02;Perjantai;0;0;0
94;08.04.2016;2016;04;03;Perjantai;0;0;0
94;08.04.2016;2016;04;04;Perjantai;0;0;0
94;08.04.2016;2016;04;05;Perjantai;4;2;6
94;08.04.2016;2016;04;06;Perjantai;4;2;6
94;08.04.2016;2016;04;07;Perjantai;8;1;9
94;08.04.2016;2016;04;08;Perjantai;4;0;4
94;08.04.2016;2016;04;09;Perjantai;3;0;3
94;08.04.2016;2016;04;10;Perjantai;3;0;3
94;08.04.2016;2016;04;11;Perjantai;3;2;5
94;08.04.2016;2016;04;12;Perjantai;0;3;3
94;08.04.2016;2016;04;13;Perjantai;1;3;4
94;08.04.2016;2016;04;14;Perjantai;4;7;11
94;08.04.2016;2016;04;15;Perjantai;1;2;3
94;08.04.2016;2016;04;16;Perjantai;3;8;11
94;08.04.2016;2016;04;17;Perjantai;4;7;11
94;08.04.2016;2016;04;18;Perjantai;2;4;6
94;08.04.2016;2016;04;19;Perjantai;3;2;5
94;08.04.2016;2016;04;20;Perjantai;2;0;2
94;08.04.2016;2016;04;21;Perjantai;1;1;2
94;08.04.2016;2016;04;22;Perjantai;1;2;3
94;08.04.2016;2016;04;23;Perjantai;0;0;0
94;09.04.2016;2016;04;00;Lauantai;0;0;0
94;09.04.2016;2016;04;01;Lauantai;0;0;0
94;09.04.2016;2016;04;02;Lauantai;0;0;0
94;09.04.2016;2016;04;03;Lauantai;0;1;1
94;09.04.2016;2016;04;04;Lauantai;0;0;0
94;09.04.2016;2016;04;05;Lauantai;2;0;2
94;09.04.2016;2016;04;06;Lauantai;0;0;0
94;09.04.2016;2016;04;07;Lauantai;2;1;3
94;09.04.2016;2016;04;08;Lauantai;0;2;2
94;09.04.2016;2016;04;09;Lauantai;3;7;10
94;09.04.2016;2016;04;10;Lauantai;3;4;7
94;09.04.2016;2016;04;11;Lauantai;5;8;13
94;09.04.2016;2016;04;12;Lauantai;13;6;19
94;09.04.2016;2016;04;13;Lauantai;7;7;14
94;09.04.2016;2016;04;14;Lauantai;4;13;17
94;09.04.2016;2016;04;15;Lauantai;8;10;18
94;09.04.2016;2016;04;16;Lauantai;7;9;16
94;09.04.2016;2016;04;17;Lauantai;1;3;4
94;09.04.2016;2016;04;18;Lauantai;4;3;7
94;09.04.2016;2016;04;19;Lauantai;2;2;4
94;09.04.2016;2016;04;20;Lauantai;2;3;5
94;09.04.2016;2016;04;21;Lauantai;1;0;1
94;09.04.2016;2016;04;22;Lauantai;0;0;0
94;09.04.2016;2016;04;23;Lauantai;0;0;0
94;10.04.2016;2016;04;00;Sunnuntai;0;0;0
94;10.04.2016;2016;04;01;Sunnuntai;0;0;0
94;10.04.2016;2016;04;02;Sunnuntai;0;0;0
94;10.04.2016;2016;04;03;Sunnuntai;0;0;0
94;10.04.2016;2016;04;04;Sunnuntai;0;0;0
94;10.04.2016;2016;04;05;Sunnuntai;1;0;1
94;10.04.2016;2016;04;06;Sunnuntai;1;0;1
94;10.04.2016;2016;04;07;Sunnuntai;0;0;0
94;10.04.2016;2016;04;08;Sunnuntai;2;0;2
94;10.04.2016;2016;04;09;Sunnuntai;1;4;5
94;10.04.2016;2016;04;10;Sunnuntai;3;4;7
94;10.04.2016;2016;04;11;Sunnuntai;12;4;16
94;10.04.2016;2016;04;12;Sunnuntai;4;9;13
94;10.04.2016;2016;04;13;Sunnuntai;6;7;13
94;10.04.2016;2016;04;14;Sunnuntai;5;11;16
94;10.04.2016;2016;04;15;Sunnuntai;8;6;14
94;10.04.2016;2016;04;16;Sunnuntai;7;4;11
94;10.04.2016;2016;04;17;Sunnuntai;8;3;11
94;10.04.2016;2016;04;18;Sunnuntai;3;2;5
94;10.04.2016;2016;04;19;Sunnuntai;7;5;12
94;10.04.2016;2016;04;20;Sunnuntai;3;3;6
94;10.04.2016;2016;04;21;Sunnuntai;1;1;2
94;10.04.2016;2016;04;22;Sunnuntai;1;0;1
94;10.04.2016;2016;04;23;Sunnuntai;0;0;0
94;11.04.2016;2016;04;00;Maanantai;0;0;0
94;11.04.2016;2016;04;01;Maanantai;0;0;0
94;11.04.2016;2016;04;02;Maanantai;0;0;0
94;11.04.2016;2016;04;03;Maanantai;0;2;2
94;11.04.2016;2016;04;04;Maanantai;0;0;0
94;11.04.2016;2016;04;05;Maanantai;3;1;4
94;11.04.2016;2016;04;06;Maanantai;11;1;12
94;11.04.2016;2016;04;07;Maanantai;20;2;22
94;11.04.2016;2016;04;08;Maanantai;5;1;6
94;11.04.2016;2016;04;09;Maanantai;2;1;3
94;11.04.2016;2016;04;10;Maanantai;2;2;4
94;11.04.2016;2016;04;11;Maanantai;8;4;12
94;11.04.2016;2016;04;12;Maanantai;4;8;12
94;11.04.2016;2016;04;13;Maanantai;3;5;8
94;11.04.2016;2016;04;14;Maanantai;3;9;12
94;11.04.2016;2016;04;15;Maanantai;10;21;31
94;11.04.2016;2016;04;16;Maanantai;13;17;30
94;11.04.2016;2016;04;17;Maanantai;3;11;14
94;11.04.2016;2016;04;18;Maanantai;6;3;9
94;11.04.2016;2016;04;19;Maanantai;6;6;12
94;11.04.2016;2016;04;20;Maanantai;5;5;10
94;11.04.2016;2016;04;21;Maanantai;1;9;10
94;11.04.2016;2016;04;22;Maanantai;2;2;4
94;11.04.2016;2016;04;23;Maanantai;0;0;0
94;12.04.2016;2016;04;00;Tiistai;0;0;0
94;12.04.2016;2016;04;01;Tiistai;0;0;0
94;12.04.2016;2016;04;02;Tiistai;0;0;0
94;12.04.2016;2016;04;03;Tiistai;2;3;5
94;12.04.2016;2016;04;04;Tiistai;0;0;0
94;12.04.2016;2016;04;05;Tiistai;3;0;3
94;12.04.2016;2016;04;06;Tiistai;8;2;10
94;12.04.2016;2016;04;07;Tiistai;14;2;16
94;12.04.2016;2016;04;08;Tiistai;5;3;8
94;12.04.2016;2016;04;09;Tiistai;5;2;7
94;12.04.2016;2016;04;10;Tiistai;4;2;6
94;12.04.2016;2016;04;11;Tiistai;3;2;5
94;12.04.2016;2016;04;12;Tiistai;1;0;1
94;12.04.2016;2016;04;13;Tiistai;3;6;9
94;12.04.2016;2016;04;14;Tiistai;2;3;5
94;12.04.2016;2016;04;15;Tiistai;4;12;16
94;12.04.2016;2016;04;16;Tiistai;7;14;21
94;12.04.2016;2016;04;17;Tiistai;8;8;16
94;12.04.2016;2016;04;18;Tiistai;3;6;9
94;12.04.2016;2016;04;19;Tiistai;1;4;5
94;12.04.2016;2016;04;20;Tiistai;3;4;7
94;12.04.2016;2016;04;21;Tiistai;1;2;3
94;12.04.2016;2016;04;22;Tiistai;1;0;1
94;12.04.2016;2016;04;23;Tiistai;1;0;1
94;13.04.2016;2016;04;00;Keskiviikko;0;1;1
94;13.04.2016;2016;04;01;Keskiviikko;1;0;1
94;13.04.2016;2016;04;02;Keskiviikko;0;0;0
94;13.04.2016;2016;04;03;Keskiviikko;0;0;0
94;13.04.2016;2016;04;04;Keskiviikko;0;0;0
94;13.04.2016;2016;04;05;Keskiviikko;2;2;4
94;13.04.2016;2016;04;06;Keskiviikko;15;1;16
94;13.04.2016;2016;04;07;Keskiviikko;17;4;21
94;13.04.2016;2016;04;08;Keskiviikko;5;2;7
94;13.04.2016;2016;04;09;Keskiviikko;3;4;7
94;13.04.2016;2016;04;10;Keskiviikko;6;4;10
94;13.04.2016;2016;04;11;Keskiviikko;1;0;1
94;13.04.2016;2016;04;12;Keskiviikko;1;2;3
94;13.04.2016;2016;04;13;Keskiviikko;3;6;9
94;13.04.2016;2016;04;14;Keskiviikko;11;4;15
94;13.04.2016;2016;04;15;Keskiviikko;6;10;16
94;13.04.2016;2016;04;16;Keskiviikko;5;12;17
94;13.04.2016;2016;04;17;Keskiviikko;3;9;12
94;13.04.2016;2016;04;18;Keskiviikko;2;9;11
94;13.04.2016;2016;04;19;Keskiviikko;0;2;2
94;13.04.2016;2016;04;20;Keskiviikko;0;3;3
94;13.04.2016;2016;04;21;Keskiviikko;2;1;3
94;13.04.2016;2016;04;22;Keskiviikko;1;0;1
94;13.04.2016;2016;04;23;Keskiviikko;1;0;1
94;14.04.2016;2016;04;00;Torstai;0;0;0
94;14.04.2016;2016;04;01;Torstai;0;0;0
94;14.04.2016;2016;04;02;Torstai;0;0;0
94;14.04.2016;2016;04;03;Torstai;0;0;0
94;14.04.2016;2016;04;04;Torstai;0;0;0
94;14.04.2016;2016;04;05;Torstai;2;1;3
94;14.04.2016;2016;04;06;Torstai;8;2;10
94;14.04.2016;2016;04;07;Torstai;14;1;15
94;14.04.2016;2016;04;08;Torstai;2;3;5
94;14.04.2016;2016;04;09;Torstai;2;0;2
94;14.04.2016;2016;04;10;Torstai;1;2;3
94;14.04.2016;2016;04;11;Torstai;3;5;8
94;14.04.2016;2016;04;12;Torstai;6;1;7
94;14.04.2016;2016;04;13;Torstai;7;2;9
94;14.04.2016;2016;04;14;Torstai;4;8;12
94;14.04.2016;2016;04;15;Torstai;6;10;16
94;14.04.2016;2016;04;16;Torstai;7;11;18
94;14.04.2016;2016;04;17;Torstai;1;11;12
94;14.04.2016;2016;04;18;Torstai;2;5;7
94;14.04.2016;2016;04;19;Torstai;7;5;12
94;14.04.2016;2016;04;20;Torstai;2;5;7
94;14.04.2016;2016;04;21;Torstai;0;4;4
94;14.04.2016;2016;04;22;Torstai;0;4;4
94;14.04.2016;2016;04;23;Torstai;0;0;0
94;15.04.2016;2016;04;00;Perjantai;0;0;0
94;15.04.2016;2016;04;01;Perjantai;0;0;0
94;15.04.2016;2016;04;02;Perjantai;0;0;0
94;15.04.2016;2016;04;03;Perjantai;0;0;0
94;15.04.2016;2016;04;04;Perjantai;1;0;1
94;15.04.2016;2016;04;05;Perjantai;2;1;3
94;15.04.2016;2016;04;06;Perjantai;5;1;6
94;15.04.2016;2016;04;07;Perjantai;14;1;15
94;15.04.2016;2016;04;08;Perjantai;4;3;7
94;15.04.2016;2016;04;09;Perjantai;4;2;6
94;15.04.2016;2016;04;10;Perjantai;4;2;6
94;15.04.2016;2016;04;11;Perjantai;8;1;9
94;15.04.2016;2016;04;12;Perjantai;3;2;5
94;15.04.2016;2016;04;13;Perjantai;2;6;8
94;15.04.2016;2016;04;14;Perjantai;10;16;26
94;15.04.2016;2016;04;15;Perjantai;3;9;12
94;15.04.2016;2016;04;16;Perjantai;6;4;10
94;15.04.2016;2016;04;17;Perjantai;2;9;11
94;15.04.2016;2016;04;18;Perjantai;5;4;9
94;15.04.2016;2016;04;19;Perjantai;4;8;12
94;15.04.2016;2016;04;20;Perjantai;1;4;5
94;15.04.2016;2016;04;21;Perjantai;4;1;5
94;15.04.2016;2016;04;22;Perjantai;0;2;2
94;15.04.2016;2016;04;23;Perjantai;0;0;0
94;16.04.2016;2016;04;00;Lauantai;0;0;0
94;16.04.2016;2016;04;01;Lauantai;0;1;1
94;16.04.2016;2016;04;02;Lauantai;0;0;0
94;16.04.2016;2016;04;03;Lauantai;0;0;0
94;16.04.2016;2016;04;04;Lauantai;1;0;1
94;16.04.2016;2016;04;05;Lauantai;0;0;0
94;16.04.2016;2016;04;06;Lauantai;1;0;1
94;16.04.2016;2016;04;07;Lauantai;0;1;1
94;16.04.2016;2016;04;08;Lauantai;0;1;1
94;16.04.2016;2016;04;09;Lauantai;6;2;8
94;16.04.2016;2016;04;10;Lauantai;3;2;5
94;16.04.2016;2016;04;11;Lauantai;4;6;10
94;16.04.2016;2016;04;12;Lauantai;13;8;21
94;16.04.2016;2016;04;13;Lauantai;12;6;18
94;16.04.2016;2016;04;14;Lauantai;5;6;11
94;16.04.2016;2016;04;15;Lauantai;7;11;18
94;16.04.2016;2016;04;16;Lauantai;3;3;6
94;16.04.2016;2016;04;17;Lauantai;0;6;6
94;16.04.2016;2016;04;18;Lauantai;1;3;4
94;16.04.2016;2016;04;19;Lauantai;1;3;4
94;16.04.2016;2016;04;20;Lauantai;6;1;7
94;16.04.2016;2016;04;21;Lauantai;1;3;4
94;16.04.2016;2016;04;22;Lauantai;0;0;0
94;16.04.2016;2016;04;23;Lauantai;1;1;2
94;17.04.2016;2016;04;00;Sunnuntai;0;0;0
94;17.04.2016;2016;04;01;Sunnuntai;0;0;0
94;17.04.2016;2016;04;02;Sunnuntai;0;0;0
94;17.04.2016;2016;04;03;Sunnuntai;0;0;0
94;17.04.2016;2016;04;04;Sunnuntai;0;0;0
94;17.04.2016;2016;04;05;Sunnuntai;0;0;0
94;17.04.2016;2016;04;06;Sunnuntai;1;0;1
94;17.04.2016;2016;04;07;Sunnuntai;0;0;0
94;17.04.2016;2016;04;08;Sunnuntai;3;3;6
94;17.04.2016;2016;04;09;Sunnuntai;0;1;1
94;17.04.2016;2016;04;10;Sunnuntai;3;0;3
94;17.04.2016;2016;04;11;Sunnuntai;2;0;2
94;17.04.2016;2016;04;12;Sunnuntai;1;3;4
94;17.04.2016;2016;04;13;Sunnuntai;0;1;1
94;17.04.2016;2016;04;14;Sunnuntai;2;8;10
94;17.04.2016;2016;04;15;Sunnuntai;2;4;6
94;17.04.2016;2016;04;16;Sunnuntai;4;2;6
94;17.04.2016;2016;04;17;Sunnuntai;3;0;3
94;17.04.2016;2016;04;18;Sunnuntai;3;9;12
94;17.04.2016;2016;04;19;Sunnuntai;1;4;5
94;17.04.2016;2016;04;20;Sunnuntai;2;3;5
94;17.04.2016;2016;04;21;Sunnuntai;1;0;1
94;17.04.2016;2016;04;22;Sunnuntai;0;0;0
94;17.04.2016;2016;04;23;Sunnuntai;0;0;0
94;18.04.2016;2016;04;00;Maanantai;0;0;0
94;18.04.2016;2016;04;01;Maanantai;0;0;0
94;18.04.2016;2016;04;02;Maanantai;0;0;0
94;18.04.2016;2016;04;03;Maanantai;0;0;0
94;18.04.2016;2016;04;04;Maanantai;1;0;1
94;18.04.2016;2016;04;05;Maanantai;4;0;4
94;18.04.2016;2016;04;06;Maanantai;13;1;14
94;18.04.2016;2016;04;07;Maanantai;15;2;17
94;18.04.2016;2016;04;08;Maanantai;5;3;8
94;18.04.2016;2016;04;09;Maanantai;2;1;3
94;18.04.2016;2016;04;10;Maanantai;3;0;3
94;18.04.2016;2016;04;11;Maanantai;2;3;5
94;18.04.2016;2016;04;12;Maanantai;3;3;6
94;18.04.2016;2016;04;13;Maanantai;3;5;8
94;18.04.2016;2016;04;14;Maanantai;6;8;14
94;18.04.2016;2016;04;15;Maanantai;5;8;13
94;18.04.2016;2016;04;16;Maanantai;3;19;22
94;18.04.2016;2016;04;17;Maanantai;6;12;18
94;18.04.2016;2016;04;18;Maanantai;11;5;16
94;18.04.2016;2016;04;19;Maanantai;2;4;6
94;18.04.2016;2016;04;20;Maanantai;1;4;5
94;18.04.2016;2016;04;21;Maanantai;0;5;5
94;18.04.2016;2016;04;22;Maanantai;0;2;2
94;18.04.2016;2016;04;23;Maanantai;0;0;0
94;19.04.2016;2016;04;00;Tiistai;0;0;0
94;19.04.2016;2016;04;01;Tiistai;0;0;0
94;19.04.2016;2016;04;02;Tiistai;0;0;0
94;19.04.2016;2016;04;03;Tiistai;0;0;0
94;19.04.2016;2016;04;04;Tiistai;0;0;0
94;19.04.2016;2016;04;05;Tiistai;2;0;2
94;19.04.2016;2016;04;06;Tiistai;9;2;11
94;19.04.2016;2016;04;07;Tiistai;11;4;15
94;19.04.2016;2016;04;08;Tiistai;6;2;8
94;19.04.2016;2016;04;09;Tiistai;2;0;2
94;19.04.2016;2016;04;10;Tiistai;5;0;5
94;19.04.2016;2016;04;11;Tiistai;0;3;3
94;19.04.2016;2016;04;12;Tiistai;1;2;3
94;19.04.2016;2016;04;13;Tiistai;2;3;5
94;19.04.2016;2016;04;14;Tiistai;2;6;8
94;19.04.2016;2016;04;15;Tiistai;4;12;16
94;19.04.2016;2016;04;16;Tiistai;2;8;10
94;19.04.2016;2016;04;17;Tiistai;2;9;11
94;19.04.2016;2016;04;18;Tiistai;7;2;9
94;19.04.2016;2016;04;19;Tiistai;0;5;5
94;19.04.2016;2016;04;20;Tiistai;1;1;2
94;19.04.2016;2016;04;21;Tiistai;0;2;2
94;19.04.2016;2016;04;22;Tiistai;0;1;1
94;19.04.2016;2016;04;23;Tiistai;0;0;0
94;20.04.2016;2016;04;00;Keskiviikko;1;0;1
94;20.04.2016;2016;04;01;Keskiviikko;0;0;0
94;20.04.2016;2016;04;02;Keskiviikko;0;0;0
94;20.04.2016;2016;04;03;Keskiviikko;0;0;0
94;20.04.2016;2016;04;04;Keskiviikko;0;0;0
94;20.04.2016;2016;04;05;Keskiviikko;4;0;4
94;20.04.2016;2016;04;06;Keskiviikko;9;1;10
94;20.04.2016;2016;04;07;Keskiviikko;10;4;14
94;20.04.2016;2016;04;08;Keskiviikko;10;4;14
94;20.04.2016;2016;04;09;Keskiviikko;2;5;7
94;20.04.2016;2016;04;10;Keskiviikko;1;1;2
94;20.04.2016;2016;04;11;Keskiviikko;4;0;4
94;20.04.2016;2016;04;12;Keskiviikko;1;0;1
94;20.04.2016;2016;04;13;Keskiviikko;3;2;5
94;20.04.2016;2016;04;14;Keskiviikko;3;5;8
94;20.04.2016;2016;04;15;Keskiviikko;6;9;15
94;20.04.2016;2016;04;16;Keskiviikko;6;10;16
94;20.04.2016;2016;04;17;Keskiviikko;4;12;16
94;20.04.2016;2016;04;18;Keskiviikko;2;8;10
94;20.04.2016;2016;04;19;Keskiviikko;1;3;4
94;20.04.2016;2016;04;20;Keskiviikko;2;3;5
94;20.04.2016;2016;04;21;Keskiviikko;0;3;3
94;20.04.2016;2016;04;22;Keskiviikko;0;1;1
94;20.04.2016;2016;04;23;Keskiviikko;0;0;0
94;21.04.2016;2016;04;00;Torstai;1;0;1
94;21.04.2016;2016;04;01;Torstai;0;0;0
94;21.04.2016;2016;04;02;Torstai;0;0;0
94;21.04.2016;2016;04;03;Torstai;0;0;0
94;21.04.2016;2016;04;04;Torstai;0;0;0
94;21.04.2016;2016;04;05;Torstai;2;1;3
94;21.04.2016;2016;04;06;Torstai;14;0;14
94;21.04.2016;2016;04;07;Torstai;13;1;14
94;21.04.2016;2016;04;08;Torstai;4;4;8
94;21.04.2016;2016;04;09;Torstai;2;0;2
94;21.04.2016;2016;04;10;Torstai;2;1;3
94;21.04.2016;2016;04;11;Torstai;2;4;6
94;21.04.2016;2016;04;12;Torstai;1;5;6
94;21.04.2016;2016;04;13;Torstai;5;4;9
94;21.04.2016;2016;04;14;Torstai;3;11;14
94;21.04.2016;2016;04;15;Torstai;9;7;16
94;21.04.2016;2016;04;16;Torstai;5;18;23
94;21.04.2016;2016;04;17;Torstai;3;7;10
94;21.04.2016;2016;04;18;Torstai;4;4;8
94;21.04.2016;2016;04;19;Torstai;3;8;11
94;21.04.2016;2016;04;20;Torstai;8;3;11
94;21.04.2016;2016;04;21;Torstai;0;0;0
94;21.04.2016;2016;04;22;Torstai;0;4;4
94;21.04.2016;2016;04;23;Torstai;0;1;1
94;22.04.2016;2016;04;00;Perjantai;0;0;0
94;22.04.2016;2016;04;01;Perjantai;0;0;0
94;22.04.2016;2016;04;02;Perjantai;0;0;0
94;22.04.2016;2016;04;03;Perjantai;0;0;0
94;22.04.2016;2016;04;04;Perjantai;0;0;0
94;22.04.2016;2016;04;05;Perjantai;3;0;3
94;22.04.2016;2016;04;06;Perjantai;12;1;13
94;22.04.2016;2016;04;07;Perjantai;7;4;11
94;22.04.2016;2016;04;08;Perjantai;5;3;8
94;22.04.2016;2016;04;09;Perjantai;4;1;5
94;22.04.2016;2016;04;10;Perjantai;1;3;4
94;22.04.2016;2016;04;11;Perjantai;6;1;7
94;22.04.2016;2016;04;12;Perjantai;1;4;5
94;22.04.2016;2016;04;13;Perjantai;1;5;6
94;22.04.2016;2016;04;14;Perjantai;7;7;14
94;22.04.2016;2016;04;15;Perjantai;3;11;14
94;22.04.2016;2016;04;16;Perjantai;6;13;19
94;22.04.2016;2016;04;17;Perjantai;3;6;9
94;22.04.2016;2016;04;18;Perjantai;4;6;10
94;22.04.2016;2016;04;19;Perjantai;0;5;5
94;22.04.2016;2016;04;20;Perjantai;1;3;4
94;22.04.2016;2016;04;21;Perjantai;0;1;1
94;22.04.2016;2016;04;22;Perjantai;0;1;1
94;22.04.2016;2016;04;23;Perjantai;0;0;0
94;23.04.2016;2016;04;00;Lauantai;0;0;0
94;23.04.2016;2016;04;01;Lauantai;0;0;0
94;23.04.2016;2016;04;02;Lauantai;0;0;0
94;23.04.2016;2016;04;03;Lauantai;0;0;0
94;23.04.2016;2016;04;04;Lauantai;0;0;0
94;23.04.2016;2016;04;05;Lauantai;1;0;1
94;23.04.2016;2016;04;06;Lauantai;0;0;0
94;23.04.2016;2016;04;07;Lauantai;2;2;4
94;23.04.2016;2016;04;08;Lauantai;0;0;0
94;23.04.2016;2016;04;09;Lauantai;6;2;8
94;23.04.2016;2016;04;10;Lauantai;3;2;5
94;23.04.2016;2016;04;11;Lauantai;2;4;6
94;23.04.2016;2016;04;12;Lauantai;7;5;12
94;23.04.2016;2016;04;13;Lauantai;8;8;16
94;23.04.2016;2016;04;14;Lauantai;5;5;10
94;23.04.2016;2016;04;15;Lauantai;5;11;16
94;23.04.2016;2016;04;16;Lauantai;1;5;6
94;23.04.2016;2016;04;17;Lauantai;8;2;10
94;23.04.2016;2016;04;18;Lauantai;7;4;11
94;23.04.2016;2016;04;19;Lauantai;3;5;8
94;23.04.2016;2016;04;20;Lauantai;4;7;11
94;23.04.2016;2016;04;21;Lauantai;2;7;9
94;23.04.2016;2016;04;22;Lauantai;1;1;2
94;23.04.2016;2016;04;23;Lauantai;0;1;1
94;24.04.2016;2016;04;00;Sunnuntai;2;0;2
94;24.04.2016;2016;04;01;Sunnuntai;1;0;1
94;24.04.2016;2016;04;02;Sunnuntai;0;1;1
94;24.04.2016;2016;04;03;Sunnuntai;0;0;0
94;24.04.2016;2016;04;04;Sunnuntai;0;0;0
94;24.04.2016;2016;04;05;Sunnuntai;2;0;2
94;24.04.2016;2016;04;06;Sunnuntai;1;0;1
94;24.04.2016;2016;04;07;Sunnuntai;1;0;1
94;24.04.2016;2016;04;08;Sunnuntai;6;7;13
94;24.04.2016;2016;04;09;Sunnuntai;2;4;6
94;24.04.2016;2016;04;10;Sunnuntai;6;10;16
94;24.04.2016;2016;04;11;Sunnuntai;13;9;22
94;24.04.2016;2016;04;12;Sunnuntai;17;6;23
94;24.04.2016;2016;04;13;Sunnuntai;7;19;26
94;24.04.2016;2016;04;14;Sunnuntai;10;12;22
94;24.04.2016;2016;04;15;Sunnuntai;7;10;17
94;24.04.2016;2016;04;16;Sunnuntai;16;9;25
94;24.04.2016;2016;04;17;Sunnuntai;11;5;16
94;24.04.2016;2016;04;18;Sunnuntai;2;7;9
94;24.04.2016;2016;04;19;Sunnuntai;5;6;11
94;24.04.2016;2016;04;20;Sunnuntai;6;3;9
94;24.04.2016;2016;04;21;Sunnuntai;0;4;4
94;24.04.2016;2016;04;22;Sunnuntai;0;2;2
94;24.04.2016;2016;04;23;Sunnuntai;0;0;0
94;25.04.2016;2016;04;00;Maanantai;0;0;0
94;25.04.2016;2016;04;01;Maanantai;0;0;0
94;25.04.2016;2016;04;02;Maanantai;0;0;0
94;25.04.2016;2016;04;03;Maanantai;0;0;0
94;25.04.2016;2016;04;04;Maanantai;0;0;0
94;25.04.2016;2016;04;05;Maanantai;5;2;7
94;25.04.2016;2016;04;06;Maanantai;18;2;20
94;25.04.2016;2016;04;07;Maanantai;21;5;26
94;25.04.2016;2016;04;08;Maanantai;9;3;12
94;25.04.2016;2016;04;09;Maanantai;4;3;7
94;25.04.2016;2016;04;10;Maanantai;2;0;2
94;25.04.2016;2016;04;11;Maanantai;2;1;3
94;25.04.2016;2016;04;12;Maanantai;1;1;2
94;25.04.2016;2016;04;13;Maanantai;3;0;3
94;25.04.2016;2016;04;14;Maanantai;3;9;12
94;25.04.2016;2016;04;15;Maanantai;2;6;8
94;25.04.2016;2016;04;16;Maanantai;3;12;15
94;25.04.2016;2016;04;17;Maanantai;2;14;16
94;25.04.2016;2016;04;18;Maanantai;0;2;2
94;25.04.2016;2016;04;19;Maanantai;0;1;1
94;25.04.2016;2016;04;20;Maanantai;2;5;7
94;25.04.2016;2016;04;21;Maanantai;5;3;8
94;25.04.2016;2016;04;22;Maanantai;0;0;0
94;25.04.2016;2016;04;23;Maanantai;0;0;0
94;26.04.2016;2016;04;00;Tiistai;0;0;0
94;26.04.2016;2016;04;01;Tiistai;0;0;0
94;26.04.2016;2016;04;02;Tiistai;0;0;0
94;26.04.2016;2016;04;03;Tiistai;0;0;0
94;26.04.2016;2016;04;04;Tiistai;1;0;1
94;26.04.2016;2016;04;05;Tiistai;4;1;5
94;26.04.2016;2016;04;06;Tiistai;13;2;15
94;26.04.2016;2016;04;07;Tiistai;7;5;12
94;26.04.2016;2016;04;08;Tiistai;4;4;8
94;26.04.2016;2016;04;09;Tiistai;5;0;5
94;26.04.2016;2016;04;10;Tiistai;2;1;3
94;26.04.2016;2016;04;11;Tiistai;2;1;3
94;26.04.2016;2016;04;12;Tiistai;3;2;5
94;26.04.2016;2016;04;13;Tiistai;2;2;4
94;26.04.2016;2016;04;14;Tiistai;5;8;13
94;26.04.2016;2016;04;15;Tiistai;6;10;16
94;26.04.2016;2016;04;16;Tiistai;4;9;13
94;26.04.2016;2016;04;17;Tiistai;2;7;9
94;26.04.2016;2016;04;18;Tiistai;3;4;7
94;26.04.2016;2016;04;19;Tiistai;3;7;10
94;26.04.2016;2016;04;20;Tiistai;1;6;7
94;26.04.2016;2016;04;21;Tiistai;0;2;2
94;26.04.2016;2016;04;22;Tiistai;0;2;2
94;26.04.2016;2016;04;23;Tiistai;0;0;0
94;27.04.2016;2016;04;00;Keskiviikko;0;0;0
94;27.04.2016;2016;04;01;Keskiviikko;0;0;0
94;27.04.2016;2016;04;02;Keskiviikko;0;0;0
94;27.04.2016;2016;04;03;Keskiviikko;0;0;0
94;27.04.2016;2016;04;04;Keskiviikko;2;0;2
94;27.04.2016;2016;04;05;Keskiviikko;4;2;6
94;27.04.2016;2016;04;06;Keskiviikko;13;1;14
94;27.04.2016;2016;04;07;Keskiviikko;20;3;23
94;27.04.2016;2016;04;08;Keskiviikko;9;1;10
94;27.04.2016;2016;04;09;Keskiviikko;3;2;5
94;27.04.2016;2016;04;10;Keskiviikko;2;4;6
94;27.04.2016;2016;04;11;Keskiviikko;2;5;7
94;27.04.2016;2016;04;12;Keskiviikko;4;2;6
94;27.04.2016;2016;04;13;Keskiviikko;4;5;9
94;27.04.2016;2016;04;14;Keskiviikko;7;11;18
94;27.04.2016;2016;04;15;Keskiviikko;5;12;17
94;27.04.2016;2016;04;16;Keskiviikko;2;18;20
94;27.04.2016;2016;04;17;Keskiviikko;0;12;12
94;27.04.2016;2016;04;18;Keskiviikko;1;3;4
94;27.04.2016;2016;04;19;Keskiviikko;2;4;6
94;27.04.2016;2016;04;20;Keskiviikko;1;1;2
94;27.04.2016;2016;04;21;Keskiviikko;1;3;4
94;27.04.2016;2016;04;22;Keskiviikko;0;1;1
94;27.04.2016;2016;04;23;Keskiviikko;0;2;2
94;28.04.2016;2016;04;00;Torstai;0;0;0
94;28.04.2016;2016;04;01;Torstai;0;0;0
94;28.04.2016;2016;04;02;Torstai;0;0;0
94;28.04.2016;2016;04;03;Torstai;0;0;0
94;28.04.2016;2016;04;04;Torstai;1;0;1
94;28.04.2016;2016;04;05;Torstai;5;1;6
94;28.04.2016;2016;04;06;Torstai;17;2;19
94;28.04.2016;2016;04;07;Torstai;13;3;16
94;28.04.2016;2016;04;08;Torstai;5;2;7
94;28.04.2016;2016;04;09;Torstai;5;1;6
94;28.04.2016;2016;04;10;Torstai;4;5;9
94;28.04.2016;2016;04;11;Torstai;3;4;7
94;28.04.2016;2016;04;12;Torstai;5;6;11
94;28.04.2016;2016;04;13;Torstai;2;1;3
94;28.04.2016;2016;04;14;Torstai;2;11;13
94;28.04.2016;2016;04;15;Torstai;8;11;19
94;28.04.2016;2016;04;16;Torstai;12;19;31
94;28.04.2016;2016;04;17;Torstai;9;12;21
94;28.04.2016;2016;04;18;Torstai;4;19;23
94;28.04.2016;2016;04;19;Torstai;5;8;13
94;28.04.2016;2016;04;20;Torstai;4;6;10
94;28.04.2016;2016;04;21;Torstai;0;5;5
94;28.04.2016;2016;04;22;Torstai;1;0;1
94;28.04.2016;2016;04;23;Torstai;0;1;1
94;29.04.2016;2016;04;00;Perjantai;0;0;0
94;29.04.2016;2016;04;01;Perjantai;0;0;0
94;29.04.2016;2016;04;02;Perjantai;0;0;0
94;29.04.2016;2016;04;03;Perjantai;0;0;0
94;29.04.2016;2016;04;04;Perjantai;0;0;0
94;29.04.2016;2016;04;05;Perjantai;5;2;7
94;29.04.2016;2016;04;06;Perjantai;7;1;8
94;29.04.2016;2016;04;07;Perjantai;15;3;18
94;29.04.2016;2016;04;08;Perjantai;8;6;14
94;29.04.2016;2016;04;09;Perjantai;7;5;12
94;29.04.2016;2016;04;10;Perjantai;9;2;11
94;29.04.2016;2016;04;11;Perjantai;4;7;11
94;29.04.2016;2016;04;12;Perjantai;3;9;12
94;29.04.2016;2016;04;13;Perjantai;7;5;12
94;29.04.2016;2016;04;14;Perjantai;4;13;17
94;29.04.2016;2016;04;15;Perjantai;3;11;14
94;29.04.2016;2016;04;16;Perjantai;4;11;15
94;29.04.2016;2016;04;17;Perjantai;4;3;7
94;29.04.2016;2016;04;18;Perjantai;2;4;6
94;29.04.2016;2016;04;19;Perjantai;4;4;8
94;29.04.2016;2016;04;20;Perjantai;5;8;13
94;29.04.2016;2016;04;21;Perjantai;2;7;9
94;29.04.2016;2016;04;22;Perjantai;0;1;1
94;29.04.2016;2016;04;23;Perjantai;0;0;0
94;30.04.2016;2016;04;00;Lauantai;0;0;0
94;30.04.2016;2016;04;01;Lauantai;0;0;0
94;30.04.2016;2016;04;02;Lauantai;0;0;0
94;30.04.2016;2016;04;03;Lauantai;0;0;0
94;30.04.2016;2016;04;04;Lauantai;0;0;0
94;30.04.2016;2016;04;05;Lauantai;0;0;0
94;30.04.2016;2016;04;06;Lauantai;0;0;0
94;30.04.2016;2016;04;07;Lauantai;2;3;5
94;30.04.2016;2016;04;08;Lauantai;2;2;4
94;30.04.2016;2016;04;09;Lauantai;4;3;7
94;30.04.2016;2016;04;10;Lauantai;7;4;11
94;30.04.2016;2016;04;11;Lauantai;12;7;19
94;30.04.2016;2016;04;12;Lauantai;18;5;23
94;30.04.2016;2016;04;13;Lauantai;8;12;20
94;30.04.2016;2016;04;14;Lauantai;13;17;30
94;30.04.2016;2016;04;15;Lauantai;11;8;19
94;30.04.2016;2016;04;16;Lauantai;7;9;16
94;30.04.2016;2016;04;17;Lauantai;13;12;25
94;30.04.2016;2016;04;18;Lauantai;5;5;10
94;30.04.2016;2016;04;19;Lauantai;3;7;10
94;30.04.2016;2016;04;20;Lauantai;7;2;9
94;30.04.2016;2016;04;21;Lauantai;3;4;7
94;30.04.2016;2016;04;22;Lauantai;1;3;4
94;30.04.2016;2016;04;23;Lauantai;3;6;9
94;01.05.2016;2016;05;00;Sunnuntai;0;0;0
94;01.05.2016;2016;05;01;Sunnuntai;0;0;0
94;01.05.2016;2016;05;02;Sunnuntai;1;1;2
94;01.05.2016;2016;05;03;Sunnuntai;0;1;1
94;01.05.2016;2016;05;04;Sunnuntai;0;0;0
94;01.05.2016;2016;05;05;Sunnuntai;1;0;1
94;01.05.2016;2016;05;06;Sunnuntai;2;1;3
94;01.05.2016;2016;05;07;Sunnuntai;0;2;2
94;01.05.2016;2016;05;08;Sunnuntai;1;3;4
94;01.05.2016;2016;05;09;Sunnuntai;8;2;10
94;01.05.2016;2016;05;10;Sunnuntai;14;15;29
94;01.05.2016;2016;05;11;Sunnuntai;9;19;28
94;01.05.2016;2016;05;12;Sunnuntai;5;9;14
94;01.05.2016;2016;05;13;Sunnuntai;18;13;31
94;01.05.2016;2016;05;14;Sunnuntai;15;13;28
94;01.05.2016;2016;05;15;Sunnuntai;8;20;28
94;01.05.2016;2016;05;16;Sunnuntai;17;19;36
94;01.05.2016;2016;05;17;Sunnuntai;9;12;21
94;01.05.2016;2016;05;18;Sunnuntai;8;15;23
94;01.05.2016;2016;05;19;Sunnuntai;10;6;16
94;01.05.2016;2016;05;20;Sunnuntai;8;6;14
94;01.05.2016;2016;05;21;Sunnuntai;4;4;8
94;01.05.2016;2016;05;22;Sunnuntai;0;2;2
94;01.05.2016;2016;05;23;Sunnuntai;0;0;0
94;02.05.2016;2016;05;00;Maanantai;0;0;0
94;02.05.2016;2016;05;01;Maanantai;0;0;0
94;02.05.2016;2016;05;02;Maanantai;0;0;0
94;02.05.2016;2016;05;03;Maanantai;0;0;0
94;02.05.2016;2016;05;04;Maanantai;1;0;1
94;02.05.2016;2016;05;05;Maanantai;8;1;9
94;02.05.2016;2016;05;06;Maanantai;20;4;24
94;02.05.2016;2016;05;07;Maanantai;29;7;36
94;02.05.2016;2016;05;08;Maanantai;11;3;14
94;02.05.2016;2016;05;09;Maanantai;6;7;13
94;02.05.2016;2016;05;10;Maanantai;4;13;17
94;02.05.2016;2016;05;11;Maanantai;7;2;9
94;02.05.2016;2016;05;12;Maanantai;2;4;6
94;02.05.2016;2016;05;13;Maanantai;3;0;3
94;02.05.2016;2016;05;14;Maanantai;3;11;14
94;02.05.2016;2016;05;15;Maanantai;10;22;32
94;02.05.2016;2016;05;16;Maanantai;6;27;33
94;02.05.2016;2016;05;17;Maanantai;5;15;20
94;02.05.2016;2016;05;18;Maanantai;12;6;18
94;02.05.2016;2016;05;19;Maanantai;15;8;23
94;02.05.2016;2016;05;20;Maanantai;5;8;13
94;02.05.2016;2016;05;21;Maanantai;1;4;5
94;02.05.2016;2016;05;22;Maanantai;0;1;1
94;02.05.2016;2016;05;23;Maanantai;0;0;0
94;03.05.2016;2016;05;00;Tiistai;0;0;0
94;03.05.2016;2016;05;01;Tiistai;0;0;0
94;03.05.2016;2016;05;02;Tiistai;0;0;0
94;03.05.2016;2016;05;03;Tiistai;0;0;0
94;03.05.2016;2016;05;04;Tiistai;3;0;3
94;03.05.2016;2016;05;05;Tiistai;7;2;9
94;03.05.2016;2016;05;06;Tiistai;19;2;21
94;03.05.2016;2016;05;07;Tiistai;29;3;32
94;03.05.2016;2016;05;08;Tiistai;11;3;14
94;03.05.2016;2016;05;09;Tiistai;6;5;11
94;03.05.2016;2016;05;10;Tiistai;4;8;12
94;03.05.2016;2016;05;11;Tiistai;5;6;11
94;03.05.2016;2016;05;12;Tiistai;4;4;8
94;03.05.2016;2016;05;13;Tiistai;6;7;13
94;03.05.2016;2016;05;14;Tiistai;7;10;17
94;03.05.2016;2016;05;15;Tiistai;11;17;28
94;03.05.2016;2016;05;16;Tiistai;4;34;38
94;03.05.2016;2016;05;17;Tiistai;9;26;35
94;03.05.2016;2016;05;18;Tiistai;10;12;22
94;03.05.2016;2016;05;19;Tiistai;6;7;13
94;03.05.2016;2016;05;20;Tiistai;2;4;6
94;03.05.2016;2016;05;21;Tiistai;0;6;6
94;03.05.2016;2016;05;22;Tiistai;1;2;3
94;03.05.2016;2016;05;23;Tiistai;0;0;0
94;04.05.2016;2016;05;00;Keskiviikko;0;0;0
94;04.05.2016;2016;05;01;Keskiviikko;0;0;0
94;04.05.2016;2016;05;02;Keskiviikko;0;0;0
94;04.05.2016;2016;05;03;Keskiviikko;0;0;0
94;04.05.2016;2016;05;04;Keskiviikko;1;0;1
94;04.05.2016;2016;05;05;Keskiviikko;7;2;9
94;04.05.2016;2016;05;06;Keskiviikko;19;2;21
94;04.05.2016;2016;05;07;Keskiviikko;31;6;37
94;04.05.2016;2016;05;08;Keskiviikko;9;5;14
94;04.05.2016;2016;05;09;Keskiviikko;3;3;6
94;04.05.2016;2016;05;10;Keskiviikko;6;6;12
94;04.05.2016;2016;05;11;Keskiviikko;6;7;13
94;04.05.2016;2016;05;12;Keskiviikko;12;0;12
94;04.05.2016;2016;05;13;Keskiviikko;6;3;9
94;04.05.2016;2016;05;14;Keskiviikko;10;15;25
94;04.05.2016;2016;05;15;Keskiviikko;5;18;23
94;04.05.2016;2016;05;16;Keskiviikko;9;32;41
94;04.05.2016;2016;05;17;Keskiviikko;4;19;23
94;04.05.2016;2016;05;18;Keskiviikko;11;16;27
94;04.05.2016;2016;05;19;Keskiviikko;10;11;21
94;04.05.2016;2016;05;20;Keskiviikko;7;19;26
94;04.05.2016;2016;05;21;Keskiviikko;4;6;10
94;04.05.2016;2016;05;22;Keskiviikko;0;6;6
94;04.05.2016;2016;05;23;Keskiviikko;2;1;3
94;05.05.2016;2016;05;00;Torstai;0;1;1
94;05.05.2016;2016;05;01;Torstai;0;0;0
94;05.05.2016;2016;05;02;Torstai;0;0;0
94;05.05.2016;2016;05;03;Torstai;0;0;0
94;05.05.2016;2016;05;04;Torstai;1;1;2
94;05.05.2016;2016;05;05;Torstai;2;2;4
94;05.05.2016;2016;05;06;Torstai;3;1;4
94;05.05.2016;2016;05;07;Torstai;4;4;8
94;05.05.2016;2016;05;08;Torstai;7;3;10
94;05.05.2016;2016;05;09;Torstai;3;4;7
94;05.05.2016;2016;05;10;Torstai;15;9;24
94;05.05.2016;2016;05;11;Torstai;14;16;30
94;05.05.2016;2016;05;12;Torstai;13;21;34
94;05.05.2016;2016;05;13;Torstai;26;21;47
94;05.05.2016;2016;05;14;Torstai;25;14;39
94;05.05.2016;2016;05;15;Torstai;17;20;37
94;05.05.2016;2016;05;16;Torstai;9;14;23
94;05.05.2016;2016;05;17;Torstai;17;9;26
94;05.05.2016;2016;05;18;Torstai;17;15;32
94;05.05.2016;2016;05;19;Torstai;6;7;13
94;05.05.2016;2016;05;20;Torstai;9;9;18
94;05.05.2016;2016;05;21;Torstai;0;3;3
94;05.05.2016;2016;05;22;Torstai;1;5;6
94;05.05.2016;2016;05;23;Torstai;0;1;1
94;06.05.2016;2016;05;00;Perjantai;1;2;3
94;06.05.2016;2016;05;01;Perjantai;0;0;0
94;06.05.2016;2016;05;02;Perjantai;0;0;0
94;06.05.2016;2016;05;03;Perjantai;0;1;1
94;06.05.2016;2016;05;04;Perjantai;2;0;2
94;06.05.2016;2016;05;05;Perjantai;4;0;4
94;06.05.2016;2016;05;06;Perjantai;12;2;14
94;06.05.2016;2016;05;07;Perjantai;19;5;24
94;06.05.2016;2016;05;08;Perjantai;5;3;8
94;06.05.2016;2016;05;09;Perjantai;4;6;10
94;06.05.2016;2016;05;10;Perjantai;3;4;7
94;06.05.2016;2016;05;11;Perjantai;9;4;13
94;06.05.2016;2016;05;12;Perjantai;9;5;14
94;06.05.2016;2016;05;13;Perjantai;9;13;22
94;06.05.2016;2016;05;14;Perjantai;16;21;37
94;06.05.2016;2016;05;15;Perjantai;5;10;15
94;06.05.2016;2016;05;16;Perjantai;12;22;34
94;06.05.2016;2016;05;17;Perjantai;12;11;23
94;06.05.2016;2016;05;18;Perjantai;12;10;22
94;06.05.2016;2016;05;19;Perjantai;9;10;19
94;06.05.2016;2016;05;20;Perjantai;6;8;14
94;06.05.2016;2016;05;21;Perjantai;0;5;5
94;06.05.2016;2016;05;22;Perjantai;1;3;4
94;06.05.2016;2016;05;23;Perjantai;0;1;1
94;07.05.2016;2016;05;00;Lauantai;1;0;1
94;07.05.2016;2016;05;01;Lauantai;0;0;0
94;07.05.2016;2016;05;02;Lauantai;1;0;1
94;07.05.2016;2016;05;03;Lauantai;0;1;1
94;07.05.2016;2016;05;04;Lauantai;1;0;1
94;07.05.2016;2016;05;05;Lauantai;1;0;1
94;07.05.2016;2016;05;06;Lauantai;2;1;3
94;07.05.2016;2016;05;07;Lauantai;1;2;3
94;07.05.2016;2016;05;08;Lauantai;0;3;3
94;07.05.2016;2016;05;09;Lauantai;2;1;3
94;07.05.2016;2016;05;10;Lauantai;8;9;17
94;07.05.2016;2016;05;11;Lauantai;8;4;12
94;07.05.2016;2016;05;12;Lauantai;13;13;26
94;07.05.2016;2016;05;13;Lauantai;5;15;20
94;07.05.2016;2016;05;14;Lauantai;16;11;27
94;07.05.2016;2016;05;15;Lauantai;14;14;28
94;07.05.2016;2016;05;16;Lauantai;4;10;14
94;07.05.2016;2016;05;17;Lauantai;9;5;14
94;07.05.2016;2016;05;18;Lauantai;6;10;16
94;07.05.2016;2016;05;19;Lauantai;12;13;25
94;07.05.2016;2016;05;20;Lauantai;12;5;17
94;07.05.2016;2016;05;21;Lauantai;5;8;13
94;07.05.2016;2016;05;22;Lauantai;4;4;8
94;07.05.2016;2016;05;23;Lauantai;0;1;1
94;08.05.2016;2016;05;00;Sunnuntai;0;2;2
94;08.05.2016;2016;05;01;Sunnuntai;0;0;0
94;08.05.2016;2016;05;02;Sunnuntai;0;0;0
94;08.05.2016;2016;05;03;Sunnuntai;0;0;0
94;08.05.2016;2016;05;04;Sunnuntai;0;0;0
94;08.05.2016;2016;05;05;Sunnuntai;1;0;1
94;08.05.2016;2016;05;06;Sunnuntai;1;2;3
94;08.05.2016;2016;05;07;Sunnuntai;1;2;3
94;08.05.2016;2016;05;08;Sunnuntai;1;4;5
94;08.05.2016;2016;05;09;Sunnuntai;7;2;9
94;08.05.2016;2016;05;10;Sunnuntai;2;12;14
94;08.05.2016;2016;05;11;Sunnuntai;13;8;21
94;08.05.2016;2016;05;12;Sunnuntai;11;8;19
94;08.05.2016;2016;05;13;Sunnuntai;10;9;19
94;08.05.2016;2016;05;14;Sunnuntai;13;14;27
94;08.05.2016;2016;05;15;Sunnuntai;8;22;30
94;08.05.2016;2016;05;16;Sunnuntai;21;8;29
94;08.05.2016;2016;05;17;Sunnuntai;8;4;12
94;08.05.2016;2016;05;18;Sunnuntai;9;11;20
94;08.05.2016;2016;05;19;Sunnuntai;15;16;31
94;08.05.2016;2016;05;20;Sunnuntai;3;4;7
94;08.05.2016;2016;05;21;Sunnuntai;1;2;3
94;08.05.2016;2016;05;22;Sunnuntai;1;4;5
94;08.05.2016;2016;05;23;Sunnuntai;0;0;0
94;09.05.2016;2016;05;00;Maanantai;0;0;0
94;09.05.2016;2016;05;01;Maanantai;0;0;0
94;09.05.2016;2016;05;02;Maanantai;0;0;0
94;09.05.2016;2016;05;03;Maanantai;0;0;0
94;09.05.2016;2016;05;04;Maanantai;2;0;2
94;09.05.2016;2016;05;05;Maanantai;11;2;13
94;09.05.2016;2016;05;06;Maanantai;27;3;30
94;09.05.2016;2016;05;07;Maanantai;39;8;47
94;09.05.2016;2016;05;08;Maanantai;13;3;16
94;09.05.2016;2016;05;09;Maanantai;8;6;14
94;09.05.2016;2016;05;10;Maanantai;5;3;8
94;09.05.2016;2016;05;11;Maanantai;8;6;14
94;09.05.2016;2016;05;12;Maanantai;4;6;10
94;09.05.2016;2016;05;13;Maanantai;3;3;6
94;09.05.2016;2016;05;14;Maanantai;9;18;27
94;09.05.2016;2016;05;15;Maanantai;12;23;35
94;09.05.2016;2016;05;16;Maanantai;11;32;43
94;09.05.2016;2016;05;17;Maanantai;6;15;21
94;09.05.2016;2016;05;18;Maanantai;8;15;23
94;09.05.2016;2016;05;19;Maanantai;7;6;13
94;09.05.2016;2016;05;20;Maanantai;5;4;9
94;09.05.2016;2016;05;21;Maanantai;2;6;8
94;09.05.2016;2016;05;22;Maanantai;0;0;0
94;09.05.2016;2016;05;23;Maanantai;1;0;1
94;10.05.2016;2016;05;00;Tiistai;2;0;2
94;10.05.2016;2016;05;01;Tiistai;0;0;0
94;10.05.2016;2016;05;02;Tiistai;0;0;0
94;10.05.2016;2016;05;03;Tiistai;0;0;0
94;10.05.2016;2016;05;04;Tiistai;1;0;1
94;10.05.2016;2016;05;05;Tiistai;3;0;3
94;10.05.2016;2016;05;06;Tiistai;12;2;14
94;10.05.2016;2016;05;07;Tiistai;7;4;11
94;10.05.2016;2016;05;08;Tiistai;6;1;7
94;10.05.2016;2016;05;09;Tiistai;2;0;2
94;10.05.2016;2016;05;10;Tiistai;2;0;2
94;10.05.2016;2016;05;11;Tiistai;1;0;1
94;10.05.2016;2016;05;12;Tiistai;0;0;0
94;10.05.2016;2016;05;13;Tiistai;4;0;4
94;10.05.2016;2016;05;14;Tiistai;2;6;8
94;10.05.2016;2016;05;15;Tiistai;5;10;15
94;10.05.2016;2016;05;16;Tiistai;3;7;10
94;10.05.2016;2016;05;17;Tiistai;2;5;7
94;10.05.2016;2016;05;18;Tiistai;1;5;6
94;10.05.2016;2016;05;19;Tiistai;1;10;11
94;10.05.2016;2016;05;20;Tiistai;2;0;2
94;10.05.2016;2016;05;21;Tiistai;1;3;4
94;10.05.2016;2016;05;22;Tiistai;1;4;5
94;10.05.2016;2016;05;23;Tiistai;0;0;0
94;11.05.2016;2016;05;00;Keskiviikko;0;0;0
94;11.05.2016;2016;05;01;Keskiviikko;0;0;0
94;11.05.2016;2016;05;02;Keskiviikko;0;0;0
94;11.05.2016;2016;05;03;Keskiviikko;0;0;0
94;11.05.2016;2016;05;04;Keskiviikko;2;0;2
94;11.05.2016;2016;05;05;Keskiviikko;6;4;10
94;11.05.2016;2016;05;06;Keskiviikko;26;1;27
94;11.05.2016;2016;05;07;Keskiviikko;26;6;32
94;11.05.2016;2016;05;08;Keskiviikko;11;5;16
94;11.05.2016;2016;05;09;Keskiviikko;9;3;12
94;11.05.2016;2016;05;10;Keskiviikko;7;1;8
94;11.05.2016;2016;05;11;Keskiviikko;3;3;6
94;11.05.2016;2016;05;12;Keskiviikko;10;7;17
94;11.05.2016;2016;05;13;Keskiviikko;5;1;6
94;11.05.2016;2016;05;14;Keskiviikko;11;16;27
94;11.05.2016;2016;05;15;Keskiviikko;8;15;23
94;11.05.2016;2016;05;16;Keskiviikko;10;32;42
94;11.05.2016;2016;05;17;Keskiviikko;8;22;30
94;11.05.2016;2016;05;18;Keskiviikko;10;7;17
94;11.05.2016;2016;05;19;Keskiviikko;9;18;27
94;11.05.2016;2016;05;20;Keskiviikko;9;10;19
94;11.05.2016;2016;05;21;Keskiviikko;3;7;10
94;11.05.2016;2016;05;22;Keskiviikko;0;4;4
94;11.05.2016;2016;05;23;Keskiviikko;0;0;0
94;12.05.2016;2016;05;00;Torstai;2;0;2
94;12.05.2016;2016;05;01;Torstai;1;1;2
94;12.05.2016;2016;05;02;Torstai;0;0;0
94;12.05.2016;2016;05;03;Torstai;0;0;0
94;12.05.2016;2016;05;04;Torstai;1;0;1
94;12.05.2016;2016;05;05;Torstai;8;1;9
94;12.05.2016;2016;05;06;Torstai;23;3;26
94;12.05.2016;2016;05;07;Torstai;24;2;26
94;12.05.2016;2016;05;08;Torstai;11;5;16
94;12.05.2016;2016;05;09;Torstai;5;0;5
94;12.05.2016;2016;05;10;Torstai;3;1;4
94;12.05.2016;2016;05;11;Torstai;6;10;16
94;12.05.2016;2016;05;12;Torstai;7;5;12
94;12.05.2016;2016;05;13;Torstai;8;6;14
94;12.05.2016;2016;05;14;Torstai;10;15;25
94;12.05.2016;2016;05;15;Torstai;10;27;37
94;12.05.2016;2016;05;16;Torstai;6;28;34
94;12.05.2016;2016;05;17;Torstai;9;18;27
94;12.05.2016;2016;05;18;Torstai;8;13;21
94;12.05.2016;2016;05;19;Torstai;8;16;24
94;12.05.2016;2016;05;20;Torstai;8;9;17
94;12.05.2016;2016;05;21;Torstai;1;4;5
94;12.05.2016;2016;05;22;Torstai;0;2;2
94;12.05.2016;2016;05;23;Torstai;0;1;1
94;13.05.2016;2016;05;00;Perjantai;0;1;1
94;13.05.2016;2016;05;01;Perjantai;0;1;1
94;13.05.2016;2016;05;02;Perjantai;0;0;0
94;13.05.2016;2016;05;03;Perjantai;0;0;0
94;13.05.2016;2016;05;04;Perjantai;2;0;2
94;13.05.2016;2016;05;05;Perjantai;7;3;10
94;13.05.2016;2016;05;06;Perjantai;10;6;16
94;13.05.2016;2016;05;07;Perjantai;15;3;18
94;13.05.2016;2016;05;08;Perjantai;7;4;11
94;13.05.2016;2016;05;09;Perjantai;2;2;4
94;13.05.2016;2016;05;10;Perjantai;2;2;4
94;13.05.2016;2016;05;11;Perjantai;3;2;5
94;13.05.2016;2016;05;12;Perjantai;5;7;12
94;13.05.2016;2016;05;13;Perjantai;7;11;18
94;13.05.2016;2016;05;14;Perjantai;10;8;18
94;13.05.2016;2016;05;15;Perjantai;7;23;30
94;13.05.2016;2016;05;16;Perjantai;7;12;19
94;13.05.2016;2016;05;17;Perjantai;3;8;11
94;13.05.2016;2016;05;18;Perjantai;4;4;8
94;13.05.2016;2016;05;19;Perjantai;2;6;8
94;13.05.2016;2016;05;20;Perjantai;4;4;8
94;13.05.2016;2016;05;21;Perjantai;3;2;5
94;13.05.2016;2016;05;22;Perjantai;4;4;8
94;13.05.2016;2016;05;23;Perjantai;0;0;0
94;14.05.2016;2016;05;00;Lauantai;1;0;1
94;14.05.2016;2016;05;01;Lauantai;0;3;3
94;14.05.2016;2016;05;02;Lauantai;0;0;0
94;14.05.2016;2016;05;03;Lauantai;0;1;1
94;14.05.2016;2016;05;04;Lauantai;1;0;1
94;14.05.2016;2016;05;05;Lauantai;0;0;0
94;14.05.2016;2016;05;06;Lauantai;1;1;2
94;14.05.2016;2016;05;07;Lauantai;2;3;5
94;14.05.2016;2016;05;08;Lauantai;2;4;6
94;14.05.2016;2016;05;09;Lauantai;3;1;4
94;14.05.2016;2016;05;10;Lauantai;4;8;12
94;14.05.2016;2016;05;11;Lauantai;7;5;12
94;14.05.2016;2016;05;12;Lauantai;12;5;17
94;14.05.2016;2016;05;13;Lauantai;5;1;6
94;14.05.2016;2016;05;14;Lauantai;2;3;5
94;14.05.2016;2016;05;15;Lauantai;4;4;8
94;14.05.2016;2016;05;16;Lauantai;12;4;16
94;14.05.2016;2016;05;17;Lauantai;2;1;3
94;14.05.2016;2016;05;18;Lauantai;5;7;12
94;14.05.2016;2016;05;19;Lauantai;4;7;11
94;14.05.2016;2016;05;20;Lauantai;8;8;16
94;14.05.2016;2016;05;21;Lauantai;4;4;8
94;14.05.2016;2016;05;22;Lauantai;0;6;6
94;14.05.2016;2016;05;23;Lauantai;0;0;0
94;15.05.2016;2016;05;00;Sunnuntai;0;0;0
94;15.05.2016;2016;05;01;Sunnuntai;0;0;0
94;15.05.2016;2016;05;02;Sunnuntai;0;0;0
94;15.05.2016;2016;05;03;Sunnuntai;0;0;0
94;15.05.2016;2016;05;04;Sunnuntai;1;0;1
94;15.05.2016;2016;05;05;Sunnuntai;0;0;0
94;15.05.2016;2016;05;06;Sunnuntai;0;0;0
94;15.05.2016;2016;05;07;Sunnuntai;1;3;4
94;15.05.2016;2016;05;08;Sunnuntai;2;0;2
94;15.05.2016;2016;05;09;Sunnuntai;2;3;5
94;15.05.2016;2016;05;10;Sunnuntai;4;4;8
94;15.05.2016;2016;05;11;Sunnuntai;4;4;8
94;15.05.2016;2016;05;12;Sunnuntai;7;5;12
94;15.05.2016;2016;05;13;Sunnuntai;9;5;14
94;15.05.2016;2016;05;14;Sunnuntai;9;6;15
94;15.05.2016;2016;05;15;Sunnuntai;5;3;8
94;15.05.2016;2016;05;16;Sunnuntai;9;3;12
94;15.05.2016;2016;05;17;Sunnuntai;3;3;6
94;15.05.2016;2016;05;18;Sunnuntai;1;2;3
94;15.05.2016;2016;05;19;Sunnuntai;8;5;13
94;15.05.2016;2016;05;20;Sunnuntai;4;2;6
94;15.05.2016;2016;05;21;Sunnuntai;1;4;5
94;15.05.2016;2016;05;22;Sunnuntai;0;1;1
94;15.05.2016;2016;05;23;Sunnuntai;0;1;1
94;16.05.2016;2016;05;00;Maanantai;0;0;0
94;16.05.2016;2016;05;01;Maanantai;0;0;0
94;16.05.2016;2016;05;02;Maanantai;0;0;0
94;16.05.2016;2016;05;03;Maanantai;0;0;0
94;16.05.2016;2016;05;04;Maanantai;2;0;2
94;16.05.2016;2016;05;05;Maanantai;5;1;6
94;16.05.2016;2016;05;06;Maanantai;20;3;23
94;16.05.2016;2016;05;07;Maanantai;22;6;28
94;16.05.2016;2016;05;08;Maanantai;18;2;20
94;16.05.2016;2016;05;09;Maanantai;5;2;7
94;16.05.2016;2016;05;10;Maanantai;3;6;9
94;16.05.2016;2016;05;11;Maanantai;5;9;14
94;16.05.2016;2016;05;12;Maanantai;3;5;8
94;16.05.2016;2016;05;13;Maanantai;5;5;10
94;16.05.2016;2016;05;14;Maanantai;6;15;21
94;16.05.2016;2016;05;15;Maanantai;10;15;25
94;16.05.2016;2016;05;16;Maanantai;6;32;38
94;16.05.2016;2016;05;17;Maanantai;17;23;40
94;16.05.2016;2016;05;18;Maanantai;11;13;24
94;16.05.2016;2016;05;19;Maanantai;10;20;30
94;16.05.2016;2016;05;20;Maanantai;11;13;24
94;16.05.2016;2016;05;21;Maanantai;1;6;7
94;16.05.2016;2016;05;22;Maanantai;0;3;3
94;16.05.2016;2016;05;23;Maanantai;0;2;2
94;17.05.2016;2016;05;00;Tiistai;0;0;0
94;17.05.2016;2016;05;01;Tiistai;0;0;0
94;17.05.2016;2016;05;02;Tiistai;0;0;0
94;17.05.2016;2016;05;03;Tiistai;0;0;0
94;17.05.2016;2016;05;04;Tiistai;1;0;1
94;17.05.2016;2016;05;05;Tiistai;6;1;7
94;17.05.2016;2016;05;06;Tiistai;14;3;17
94;17.05.2016;2016;05;07;Tiistai;13;3;16
94;17.05.2016;2016;05;08;Tiistai;6;3;9
94;17.05.2016;2016;05;09;Tiistai;1;1;2
94;17.05.2016;2016;05;10;Tiistai;3;2;5
94;17.05.2016;2016;05;11;Tiistai;2;2;4
94;17.05.2016;2016;05;12;Tiistai;1;0;1
94;17.05.2016;2016;05;13;Tiistai;2;2;4
94;17.05.2016;2016;05;14;Tiistai;2;6;8
94;17.05.2016;2016;05;15;Tiistai;6;13;19
94;17.05.2016;2016;05;16;Tiistai;3;15;18
94;17.05.2016;2016;05;17;Tiistai;5;8;13
94;17.05.2016;2016;05;18;Tiistai;6;8;14
94;17.05.2016;2016;05;19;Tiistai;5;6;11
94;17.05.2016;2016;05;20;Tiistai;2;4;6
94;17.05.2016;2016;05;21;Tiistai;0;4;4
94;17.05.2016;2016;05;22;Tiistai;2;1;3
94;17.05.2016;2016;05;23;Tiistai;0;1;1
94;18.05.2016;2016;05;00;Keskiviikko;0;1;1
94;18.05.2016;2016;05;01;Keskiviikko;0;0;0
94;18.05.2016;2016;05;02;Keskiviikko;0;1;1
94;18.05.2016;2016;05;03;Keskiviikko;0;0;0
94;18.05.2016;2016;05;04;Keskiviikko;1;0;1
94;18.05.2016;2016;05;05;Keskiviikko;6;2;8
94;18.05.2016;2016;05;06;Keskiviikko;17;2;19
94;18.05.2016;2016;05;07;Keskiviikko;28;4;32
94;18.05.2016;2016;05;08;Keskiviikko;12;7;19
94;18.05.2016;2016;05;09;Keskiviikko;4;2;6
94;18.05.2016;2016;05;10;Keskiviikko;3;3;6
94;18.05.2016;2016;05;11;Keskiviikko;4;5;9
94;18.05.2016;2016;05;12;Keskiviikko;7;1;8
94;18.05.2016;2016;05;13;Keskiviikko;6;9;15
94;18.05.2016;2016;05;14;Keskiviikko;8;12;20
94;18.05.2016;2016;05;15;Keskiviikko;6;23;29
94;18.05.2016;2016;05;16;Keskiviikko;4;20;24
94;18.05.2016;2016;05;17;Keskiviikko;3;7;10
94;18.05.2016;2016;05;18;Keskiviikko;2;3;5
94;18.05.2016;2016;05;19;Keskiviikko;5;12;17
94;18.05.2016;2016;05;20;Keskiviikko;1;4;5
94;18.05.2016;2016;05;21;Keskiviikko;0;3;3
94;18.05.2016;2016;05;22;Keskiviikko;0;4;4
94;18.05.2016;2016;05;23;Keskiviikko;0;0;0
94;19.05.2016;2016;05;00;Torstai;0;0;0
94;19.05.2016;2016;05;01;Torstai;0;0;0
94;19.05.2016;2016;05;02;Torstai;0;0;0
94;19.05.2016;2016;05;03;Torstai;0;0;0
94;19.05.2016;2016;05;04;Torstai;1;0;1
94;19.05.2016;2016;05;05;Torstai;7;0;7
94;19.05.2016;2016;05;06;Torstai;8;2;10
94;19.05.2016;2016;05;07;Torstai;7;5;12
94;19.05.2016;2016;05;08;Torstai;4;1;5
94;19.05.2016;2016;05;09;Torstai;5;2;7
94;19.05.2016;2016;05;10;Torstai;2;0;2
94;19.05.2016;2016;05;11;Torstai;1;3;4
94;19.05.2016;2016;05;12;Torstai;1;2;3
94;19.05.2016;2016;05;13;Torstai;6;2;8
94;19.05.2016;2016;05;14;Torstai;3;11;14
94;19.05.2016;2016;05;15;Torstai;6;19;25
94;19.05.2016;2016;05;16;Torstai;8;17;25
94;19.05.2016;2016;05;17;Torstai;5;9;14
94;19.05.2016;2016;05;18;Torstai;7;5;12
94;19.05.2016;2016;05;19;Torstai;9;12;21
94;19.05.2016;2016;05;20;Torstai;6;4;10
94;19.05.2016;2016;05;21;Torstai;0;1;1
94;19.05.2016;2016;05;22;Torstai;1;3;4
94;19.05.2016;2016;05;23;Torstai;1;0;1
94;20.05.2016;2016;05;00;Perjantai;0;0;0
94;20.05.2016;2016;05;01;Perjantai;0;0;0
94;20.05.2016;2016;05;02;Perjantai;0;0;0
94;20.05.2016;2016;05;03;Perjantai;0;0;0
94;20.05.2016;2016;05;04;Perjantai;1;0;1
94;20.05.2016;2016;05;05;Perjantai;9;2;11
94;20.05.2016;2016;05;06;Perjantai;20;3;23
94;20.05.2016;2016;05;07;Perjantai;20;5;25
94;20.05.2016;2016;05;08;Perjantai;14;2;16
94;20.05.2016;2016;05;09;Perjantai;14;11;25
94;20.05.2016;2016;05;10;Perjantai;4;4;8
94;20.05.2016;2016;05;11;Perjantai;7;1;8
94;20.05.2016;2016;05;12;Perjantai;5;9;14
94;20.05.2016;2016;05;13;Perjantai;4;15;19
94;20.05.2016;2016;05;14;Perjantai;17;22;39
94;20.05.2016;2016;05;15;Perjantai;9;26;35
94;20.05.2016;2016;05;16;Perjantai;5;26;31
94;20.05.2016;2016;05;17;Perjantai;21;12;33
94;20.05.2016;2016;05;18;Perjantai;12;20;32
94;20.05.2016;2016;05;19;Perjantai;11;11;22
94;20.05.2016;2016;05;20;Perjantai;13;10;23
94;20.05.2016;2016;05;21;Perjantai;3;9;12
94;20.05.2016;2016;05;22;Perjantai;2;2;4
94;20.05.2016;2016;05;23;Perjantai;1;4;5
94;21.05.2016;2016;05;00;Lauantai;0;1;1
94;21.05.2016;2016;05;01;Lauantai;2;0;2
94;21.05.2016;2016;05;02;Lauantai;1;1;2
94;21.05.2016;2016;05;03;Lauantai;0;0;0
94;21.05.2016;2016;05;04;Lauantai;0;0;0
94;21.05.2016;2016;05;05;Lauantai;0;1;1
94;21.05.2016;2016;05;06;Lauantai;2;1;3
94;21.05.2016;2016;05;07;Lauantai;1;4;5
94;21.05.2016;2016;05;08;Lauantai;1;9;10
94;21.05.2016;2016;05;09;Lauantai;10;13;23
94;21.05.2016;2016;05;10;Lauantai;9;9;18
94;21.05.2016;2016;05;11;Lauantai;10;16;26
94;21.05.2016;2016;05;12;Lauantai;17;6;23
94;21.05.2016;2016;05;13;Lauantai;14;17;31
94;21.05.2016;2016;05;14;Lauantai;8;8;16
94;21.05.2016;2016;05;15;Lauantai;10;7;17
94;21.05.2016;2016;05;16;Lauantai;7;8;15
94;21.05.2016;2016;05;17;Lauantai;6;5;11
94;21.05.2016;2016;05;18;Lauantai;4;1;5
94;21.05.2016;2016;05;19;Lauantai;6;5;11
94;21.05.2016;2016;05;20;Lauantai;3;5;8
94;21.05.2016;2016;05;21;Lauantai;2;6;8
94;21.05.2016;2016;05;22;Lauantai;0;0;0
94;21.05.2016;2016;05;23;Lauantai;1;5;6
94;22.05.2016;2016;05;00;Sunnuntai;0;0;0
94;22.05.2016;2016;05;01;Sunnuntai;0;0;0
94;22.05.2016;2016;05;02;Sunnuntai;0;0;0
94;22.05.2016;2016;05;03;Sunnuntai;0;0;0
94;22.05.2016;2016;05;04;Sunnuntai;0;0;0
94;22.05.2016;2016;05;05;Sunnuntai;1;0;1
94;22.05.2016;2016;05;06;Sunnuntai;2;0;2
94;22.05.2016;2016;05;07;Sunnuntai;0;2;2
94;22.05.2016;2016;05;08;Sunnuntai;0;0;0
94;22.05.2016;2016;05;09;Sunnuntai;2;1;3
94;22.05.2016;2016;05;10;Sunnuntai;1;4;5
94;22.05.2016;2016;05;11;Sunnuntai;5;15;20
94;22.05.2016;2016;05;12;Sunnuntai;16;5;21
94;22.05.2016;2016;05;13;Sunnuntai;10;14;24
94;22.05.2016;2016;05;14;Sunnuntai;22;22;44
94;22.05.2016;2016;05;15;Sunnuntai;13;12;25
94;22.05.2016;2016;05;16;Sunnuntai;16;12;28
94;22.05.2016;2016;05;17;Sunnuntai;14;14;28
94;22.05.2016;2016;05;18;Sunnuntai;14;11;25
94;22.05.2016;2016;05;19;Sunnuntai;12;10;22
94;22.05.2016;2016;05;20;Sunnuntai;9;2;11
94;22.05.2016;2016;05;21;Sunnuntai;5;2;7
94;22.05.2016;2016;05;22;Sunnuntai;1;3;4
94;22.05.2016;2016;05;23;Sunnuntai;0;3;3
94;23.05.2016;2016;05;00;Maanantai;0;0;0
94;23.05.2016;2016;05;01;Maanantai;0;0;0
94;23.05.2016;2016;05;02;Maanantai;0;0;0
94;23.05.2016;2016;05;03;Maanantai;0;0;0
94;23.05.2016;2016;05;04;Maanantai;3;0;3
94;23.05.2016;2016;05;05;Maanantai;7;2;9
94;23.05.2016;2016;05;06;Maanantai;27;3;30
94;23.05.2016;2016;05;07;Maanantai;27;7;34
94;23.05.2016;2016;05;08;Maanantai;15;6;21
94;23.05.2016;2016;05;09;Maanantai;12;7;19
94;23.05.2016;2016;05;10;Maanantai;8;6;14
94;23.05.2016;2016;05;11;Maanantai;8;7;15
94;23.05.2016;2016;05;12;Maanantai;10;5;15
94;23.05.2016;2016;05;13;Maanantai;4;5;9
94;23.05.2016;2016;05;14;Maanantai;4;20;24
94;23.05.2016;2016;05;15;Maanantai;17;27;44
94;23.05.2016;2016;05;16;Maanantai;7;33;40
94;23.05.2016;2016;05;17;Maanantai;10;23;33
94;23.05.2016;2016;05;18;Maanantai;12;15;27
94;23.05.2016;2016;05;19;Maanantai;8;12;20
94;23.05.2016;2016;05;20;Maanantai;5;10;15
94;23.05.2016;2016;05;21;Maanantai;6;5;11
94;23.05.2016;2016;05;22;Maanantai;0;4;4
94;23.05.2016;2016;05;23;Maanantai;1;1;2
94;24.05.2016;2016;05;00;Tiistai;0;0;0
94;24.05.2016;2016;05;01;Tiistai;0;0;0
94;24.05.2016;2016;05;02;Tiistai;0;0;0
94;24.05.2016;2016;05;03;Tiistai;0;0;0
94;24.05.2016;2016;05;04;Tiistai;2;0;2
94;24.05.2016;2016;05;05;Tiistai;7;2;9
94;24.05.2016;2016;05;06;Tiistai;24;3;27
94;24.05.2016;2016;05;07;Tiistai;41;8;49
94;24.05.2016;2016;05;08;Tiistai;12;0;12
94;24.05.2016;2016;05;09;Tiistai;6;10;16
94;24.05.2016;2016;05;10;Tiistai;8;4;12
94;24.05.2016;2016;05;11;Tiistai;7;5;12
94;24.05.2016;2016;05;12;Tiistai;15;9;24
94;24.05.2016;2016;05;13;Tiistai;9;8;17
94;24.05.2016;2016;05;14;Tiistai;5;18;23
94;24.05.2016;2016;05;15;Tiistai;11;37;48
94;24.05.2016;2016;05;16;Tiistai;9;29;38
94;24.05.2016;2016;05;17;Tiistai;4;12;16
94;24.05.2016;2016;05;18;Tiistai;0;4;4
94;24.05.2016;2016;05;19;Tiistai;2;6;8
94;24.05.2016;2016;05;20;Tiistai;1;3;4
94;24.05.2016;2016;05;21;Tiistai;3;8;11
94;24.05.2016;2016;05;22;Tiistai;1;2;3
94;24.05.2016;2016;05;23;Tiistai;0;1;1
94;25.05.2016;2016;05;00;Keskiviikko;0;0;0
94;25.05.2016;2016;05;01;Keskiviikko;0;0;0
94;25.05.2016;2016;05;02;Keskiviikko;0;0;0
94;25.05.2016;2016;05;03;Keskiviikko;0;0;0
94;25.05.2016;2016;05;04;Keskiviikko;3;0;3
94;25.05.2016;2016;05;05;Keskiviikko;5;1;6
94;25.05.2016;2016;05;06;Keskiviikko;20;2;22
94;25.05.2016;2016;05;07;Keskiviikko;16;2;18
94;25.05.2016;2016;05;08;Keskiviikko;13;1;14
94;25.05.2016;2016;05;09;Keskiviikko;4;2;6
94;25.05.2016;2016;05;10;Keskiviikko;8;2;10
94;25.05.2016;2016;05;11;Keskiviikko;4;2;6
94;25.05.2016;2016;05;12;Keskiviikko;8;0;8
94;25.05.2016;2016;05;13;Keskiviikko;1;4;5
94;25.05.2016;2016;05;14;Keskiviikko;0;10;10
94;25.05.2016;2016;05;15;Keskiviikko;3;17;20
94;25.05.2016;2016;05;16;Keskiviikko;2;22;24
94;25.05.2016;2016;05;17;Keskiviikko;3;13;16
94;25.05.2016;2016;05;18;Keskiviikko;1;5;6
94;25.05.2016;2016;05;19;Keskiviikko;2;3;5
94;25.05.2016;2016;05;20;Keskiviikko;2;3;5
94;25.05.2016;2016;05;21;Keskiviikko;2;5;7
94;25.05.2016;2016;05;22;Keskiviikko;0;2;2
94;25.05.2016;2016;05;23;Keskiviikko;0;0;0
94;26.05.2016;2016;05;00;Torstai;0;0;0
94;26.05.2016;2016;05;01;Torstai;0;0;0
94;26.05.2016;2016;05;02;Torstai;0;0;0
94;26.05.2016;2016;05;03;Torstai;0;0;0
94;26.05.2016;2016;05;04;Torstai;1;0;1
94;26.05.2016;2016;05;05;Torstai;6;1;7
94;26.05.2016;2016;05;06;Torstai;26;5;31
94;26.05.2016;2016;05;07;Torstai;20;6;26
94;26.05.2016;2016;05;08;Torstai;13;3;16
94;26.05.2016;2016;05;09;Torstai;5;5;10
94;26.05.2016;2016;05;10;Torstai;5;12;17
94;26.05.2016;2016;05;11;Torstai;8;9;17
94;26.05.2016;2016;05;12;Torstai;5;5;10
94;26.05.2016;2016;05;13;Torstai;6;3;9
94;26.05.2016;2016;05;14;Torstai;2;4;6
94;26.05.2016;2016;05;15;Torstai;9;24;33
94;26.05.2016;2016;05;16;Torstai;8;17;25
94;26.05.2016;2016;05;17;Torstai;1;24;25
94;26.05.2016;2016;05;18;Torstai;9;9;18
94;26.05.2016;2016;05;19;Torstai;8;14;22
94;26.05.2016;2016;05;20;Torstai;13;3;16
94;26.05.2016;2016;05;21;Torstai;3;9;12
94;26.05.2016;2016;05;22;Torstai;0;2;2
94;26.05.2016;2016;05;23;Torstai;0;1;1
94;27.05.2016;2016;05;00;Perjantai;1;0;1
94;27.05.2016;2016;05;01;Perjantai;0;0;0
94;27.05.2016;2016;05;02;Perjantai;0;0;0
94;27.05.2016;2016;05;03;Perjantai;0;0;0
94;27.05.2016;2016;05;04;Perjantai;1;0;1
94;27.05.2016;2016;05;05;Perjantai;7;3;10
94;27.05.2016;2016;05;06;Perjantai;20;4;24
94;27.05.2016;2016;05;07;Perjantai;23;7;30
94;27.05.2016;2016;05;08;Perjantai;16;4;20
94;27.05.2016;2016;05;09;Perjantai;5;7;12
94;27.05.2016;2016;05;10;Perjantai;6;6;12
94;27.05.2016;2016;05;11;Perjantai;9;4;13
94;27.05.2016;2016;05;12;Perjantai;11;8;19
94;27.05.2016;2016;05;13;Perjantai;4;12;16
94;27.05.2016;2016;05;14;Perjantai;6;12;18
94;27.05.2016;2016;05;15;Perjantai;19;24;43
94;27.05.2016;2016;05;16;Perjantai;4;29;33
94;27.05.2016;2016;05;17;Perjantai;17;17;34
94;27.05.2016;2016;05;18;Perjantai;10;9;19
94;27.05.2016;2016;05;19;Perjantai;13;11;24
94;27.05.2016;2016;05;20;Perjantai;7;10;17
94;27.05.2016;2016;05;21;Perjantai;6;9;15
94;27.05.2016;2016;05;22;Perjantai;4;8;12
94;27.05.2016;2016;05;23;Perjantai;0;6;6
94;28.05.2016;2016;05;00;Lauantai;3;6;9
94;28.05.2016;2016;05;01;Lauantai;0;2;2
94;28.05.2016;2016;05;02;Lauantai;1;1;2
94;28.05.2016;2016;05;03;Lauantai;2;5;7
94;28.05.2016;2016;05;04;Lauantai;1;1;2
94;28.05.2016;2016;05;05;Lauantai;6;0;6
94;28.05.2016;2016;05;06;Lauantai;2;3;5
94;28.05.2016;2016;05;07;Lauantai;1;1;2
94;28.05.2016;2016;05;08;Lauantai;3;3;6
94;28.05.2016;2016;05;09;Lauantai;9;6;15
94;28.05.2016;2016;05;10;Lauantai;12;9;21
94;28.05.2016;2016;05;11;Lauantai;7;12;19
94;28.05.2016;2016;05;12;Lauantai;18;8;26
94;28.05.2016;2016;05;13;Lauantai;17;10;27
94;28.05.2016;2016;05;14;Lauantai;13;11;24
94;28.05.2016;2016;05;15;Lauantai;13;14;27
94;28.05.2016;2016;05;16;Lauantai;21;21;42
94;28.05.2016;2016;05;17;Lauantai;16;17;33
94;28.05.2016;2016;05;18;Lauantai;10;13;23
94;28.05.2016;2016;05;19;Lauantai;11;7;18
94;28.05.2016;2016;05;20;Lauantai;11;5;16
94;28.05.2016;2016;05;21;Lauantai;2;7;9
94;28.05.2016;2016;05;22;Lauantai;3;6;9
94;28.05.2016;2016;05;23;Lauantai;4;1;5
94;29.05.2016;2016;05;00;Sunnuntai;2;3;5
94;29.05.2016;2016;05;01;Sunnuntai;0;0;0
94;29.05.2016;2016;05;02;Sunnuntai;0;0;0
94;29.05.2016;2016;05;03;Sunnuntai;0;5;5
94;29.05.2016;2016;05;04;Sunnuntai;0;0;0
94;29.05.2016;2016;05;05;Sunnuntai;6;1;7
94;29.05.2016;2016;05;06;Sunnuntai;1;2;3
94;29.05.2016;2016;05;07;Sunnuntai;1;4;5
94;29.05.2016;2016;05;08;Sunnuntai;3;2;5
94;29.05.2016;2016;05;09;Sunnuntai;3;5;8
94;29.05.2016;2016;05;10;Sunnuntai;18;10;28
94;29.05.2016;2016;05;11;Sunnuntai;14;17;31
94;29.05.2016;2016;05;12;Sunnuntai;23;29;52
94;29.05.2016;2016;05;13;Sunnuntai;23;28;51
94;29.05.2016;2016;05;14;Sunnuntai;32;23;55
94;29.05.2016;2016;05;15;Sunnuntai;12;30;42
94;29.05.2016;2016;05;16;Sunnuntai;27;16;43
94;29.05.2016;2016;05;17;Sunnuntai;15;13;28
94;29.05.2016;2016;05;18;Sunnuntai;9;16;25
94;29.05.2016;2016;05;19;Sunnuntai;11;9;20
94;29.05.2016;2016;05;20;Sunnuntai;14;11;25
94;29.05.2016;2016;05;21;Sunnuntai;1;6;7
94;29.05.2016;2016;05;22;Sunnuntai;2;5;7
94;29.05.2016;2016;05;23;Sunnuntai;0;0;0
94;30.05.2016;2016;05;00;Maanantai;0;2;2
94;30.05.2016;2016;05;01;Maanantai;0;0;0
94;30.05.2016;2016;05;02;Maanantai;0;0;0
94;30.05.2016;2016;05;03;Maanantai;0;0;0
94;30.05.2016;2016;05;04;Maanantai;2;0;2
94;30.05.2016;2016;05;05;Maanantai;7;1;8
94;30.05.2016;2016;05;06;Maanantai;37;3;40
94;30.05.2016;2016;05;07;Maanantai;36;5;41
94;30.05.2016;2016;05;08;Maanantai;24;3;27
94;30.05.2016;2016;05;09;Maanantai;8;5;13
94;30.05.2016;2016;05;10;Maanantai;9;4;13
94;30.05.2016;2016;05;11;Maanantai;9;9;18
94;30.05.2016;2016;05;12;Maanantai;9;5;14
94;30.05.2016;2016;05;13;Maanantai;3;9;12
94;30.05.2016;2016;05;14;Maanantai;9;25;34
94;30.05.2016;2016;05;15;Maanantai;27;44;71
94;30.05.2016;2016;05;16;Maanantai;15;57;72
94;30.05.2016;2016;05;17;Maanantai;15;34;49
94;30.05.2016;2016;05;18;Maanantai;20;22;42
94;30.05.2016;2016;05;19;Maanantai;14;13;27
94;30.05.2016;2016;05;20;Maanantai;16;17;33
94;30.05.2016;2016;05;21;Maanantai;7;11;18
94;30.05.2016;2016;05;22;Maanantai;1;1;2
94;30.05.2016;2016;05;23;Maanantai;0;1;1
94;31.05.2016;2016;05;00;Tiistai;0;0;0
94;31.05.2016;2016;05;01;Tiistai;0;1;1
94;31.05.2016;2016;05;02;Tiistai;0;0;0
94;31.05.2016;2016;05;03;Tiistai;0;0;0
94;31.05.2016;2016;05;04;Tiistai;1;0;1
94;31.05.2016;2016;05;05;Tiistai;11;3;14
94;31.05.2016;2016;05;06;Tiistai;33;4;37
94;31.05.2016;2016;05;07;Tiistai;41;7;48
94;31.05.2016;2016;05;08;Tiistai;23;4;27
94;31.05.2016;2016;05;09;Tiistai;12;5;17
94;31.05.2016;2016;05;10;Tiistai;8;8;16
94;31.05.2016;2016;05;11;Tiistai;9;9;18
94;31.05.2016;2016;05;12;Tiistai;5;14;19
94;31.05.2016;2016;05;13;Tiistai;8;10;18
94;31.05.2016;2016;05;14;Tiistai;6;24;30
94;31.05.2016;2016;05;15;Tiistai;18;38;56
94;31.05.2016;2016;05;16;Tiistai;10;35;45
94;31.05.2016;2016;05;17;Tiistai;19;20;39
94;31.05.2016;2016;05;18;Tiistai;14;16;30
94;31.05.2016;2016;05;19;Tiistai;20;21;41
94;31.05.2016;2016;05;20;Tiistai;17;21;38
94;31.05.2016;2016;05;21;Tiistai;7;23;30
94;31.05.2016;2016;05;22;Tiistai;3;2;5
94;31.05.2016;2016;05;23;Tiistai;0;3;3
94;01.06.2016;2016;06;00;Keskiviikko;0;1;1
94;01.06.2016;2016;06;01;Keskiviikko;0;0;0
94;01.06.2016;2016;06;02;Keskiviikko;0;0;0
94;01.06.2016;2016;06;03;Keskiviikko;0;2;2
94;01.06.2016;2016;06;04;Keskiviikko;1;1;2
94;01.06.2016;2016;06;05;Keskiviikko;9;1;10
94;01.06.2016;2016;06;06;Keskiviikko;29;4;33
94;01.06.2016;2016;06;07;Keskiviikko;26;3;29
94;01.06.2016;2016;06;08;Keskiviikko;15;6;21
94;01.06.2016;2016;06;09;Keskiviikko;5;1;6
94;01.06.2016;2016;06;10;Keskiviikko;5;0;5
94;01.06.2016;2016;06;11;Keskiviikko;4;3;7
94;01.06.2016;2016;06;12;Keskiviikko;6;2;8
94;01.06.2016;2016;06;13;Keskiviikko;5;9;14
94;01.06.2016;2016;06;14;Keskiviikko;1;17;18
94;01.06.2016;2016;06;15;Keskiviikko;10;26;36
94;01.06.2016;2016;06;16;Keskiviikko;17;35;52
94;01.06.2016;2016;06;17;Keskiviikko;9;20;29
94;01.06.2016;2016;06;18;Keskiviikko;4;19;23
94;01.06.2016;2016;06;19;Keskiviikko;14;14;28
94;01.06.2016;2016;06;20;Keskiviikko;12;8;20
94;01.06.2016;2016;06;21;Keskiviikko;9;8;17
94;01.06.2016;2016;06;22;Keskiviikko;3;5;8
94;01.06.2016;2016;06;23;Keskiviikko;2;1;3
94;02.06.2016;2016;06;00;Torstai;0;0;0
94;02.06.2016;2016;06;01;Torstai;1;0;1
94;02.06.2016;2016;06;02;Torstai;0;0;0
94;02.06.2016;2016;06;03;Torstai;0;1;1
94;02.06.2016;2016;06;04;Torstai;1;0;1
94;02.06.2016;2016;06;05;Torstai;8;2;10
94;02.06.2016;2016;06;06;Torstai;30;5;35
94;02.06.2016;2016;06;07;Torstai;27;6;33
94;02.06.2016;2016;06;08;Torstai;19;5;24
94;02.06.2016;2016;06;09;Torstai;14;6;20
94;02.06.2016;2016;06;10;Torstai;12;8;20
94;02.06.2016;2016;06;11;Torstai;6;12;18
94;02.06.2016;2016;06;12;Torstai;8;8;16
94;02.06.2016;2016;06;13;Torstai;6;9;15
94;02.06.2016;2016;06;14;Torstai;19;19;38
94;02.06.2016;2016;06;15;Torstai;14;33;47
94;02.06.2016;2016;06;16;Torstai;15;40;55
94;02.06.2016;2016;06;17;Torstai;22;31;53
94;02.06.2016;2016;06;18;Torstai;10;22;32
94;02.06.2016;2016;06;19;Torstai;19;12;31
94;02.06.2016;2016;06;20;Torstai;16;17;33
94;02.06.2016;2016;06;21;Torstai;5;16;21
94;02.06.2016;2016;06;22;Torstai;0;13;13
94;02.06.2016;2016;06;23;Torstai;1;2;3
94;03.06.2016;2016;06;00;Perjantai;0;3;3
94;03.06.2016;2016;06;01;Perjantai;0;0;0
94;03.06.2016;2016;06;02;Perjantai;0;0;0
94;03.06.2016;2016;06;03;Perjantai;0;1;1
94;03.06.2016;2016;06;04;Perjantai;0;0;0
94;03.06.2016;2016;06;05;Perjantai;8;2;10
94;03.06.2016;2016;06;06;Perjantai;10;3;13
94;03.06.2016;2016;06;07;Perjantai;22;3;25
94;03.06.2016;2016;06;08;Perjantai;14;3;17
94;03.06.2016;2016;06;09;Perjantai;5;1;6
94;03.06.2016;2016;06;10;Perjantai;5;3;8
94;03.06.2016;2016;06;11;Perjantai;8;3;11
94;03.06.2016;2016;06;12;Perjantai;12;8;20
94;03.06.2016;2016;06;13;Perjantai;9;8;17
94;03.06.2016;2016;06;14;Perjantai;5;11;16
94;03.06.2016;2016;06;15;Perjantai;10;23;33
94;03.06.2016;2016;06;16;Perjantai;1;20;21
94;03.06.2016;2016;06;17;Perjantai;3;10;13
94;03.06.2016;2016;06;18;Perjantai;10;5;15
94;03.06.2016;2016;06;19;Perjantai;5;15;20
94;03.06.2016;2016;06;20;Perjantai;3;5;8
94;03.06.2016;2016;06;21;Perjantai;5;7;12
94;03.06.2016;2016;06;22;Perjantai;1;6;7
94;03.06.2016;2016;06;23;Perjantai;1;1;2
94;04.06.2016;2016;06;00;Lauantai;0;4;4
94;04.06.2016;2016;06;01;Lauantai;1;0;1
94;04.06.2016;2016;06;02;Lauantai;0;2;2
94;04.06.2016;2016;06;03;Lauantai;0;0;0
94;04.06.2016;2016;06;04;Lauantai;0;0;0
94;04.06.2016;2016;06;05;Lauantai;4;0;4
94;04.06.2016;2016;06;06;Lauantai;1;3;4
94;04.06.2016;2016;06;07;Lauantai;1;2;3
94;04.06.2016;2016;06;08;Lauantai;2;2;4
94;04.06.2016;2016;06;09;Lauantai;4;4;8
94;04.06.2016;2016;06;10;Lauantai;12;2;14
94;04.06.2016;2016;06;11;Lauantai;6;12;18
94;04.06.2016;2016;06;12;Lauantai;10;6;16
94;04.06.2016;2016;06;13;Lauantai;5;9;14
94;04.06.2016;2016;06;14;Lauantai;6;6;12
94;04.06.2016;2016;06;15;Lauantai;8;7;15
94;04.06.2016;2016;06;16;Lauantai;7;5;12
94;04.06.2016;2016;06;17;Lauantai;7;5;12
94;04.06.2016;2016;06;18;Lauantai;4;7;11
94;04.06.2016;2016;06;19;Lauantai;6;1;7
94;04.06.2016;2016;06;20;Lauantai;4;3;7
94;04.06.2016;2016;06;21;Lauantai;4;4;8
94;04.06.2016;2016;06;22;Lauantai;2;0;2
94;04.06.2016;2016;06;23;Lauantai;1;1;2
94;05.06.2016;2016;06;00;Sunnuntai;0;0;0
94;05.06.2016;2016;06;01;Sunnuntai;0;1;1
94;05.06.2016;2016;06;02;Sunnuntai;0;1;1
94;05.06.2016;2016;06;03;Sunnuntai;0;1;1
94;05.06.2016;2016;06;04;Sunnuntai;0;1;1
94;05.06.2016;2016;06;05;Sunnuntai;3;0;3
94;05.06.2016;2016;06;06;Sunnuntai;1;2;3
94;05.06.2016;2016;06;07;Sunnuntai;1;3;4
94;05.06.2016;2016;06;08;Sunnuntai;1;1;2
94;05.06.2016;2016;06;09;Sunnuntai;2;8;10
94;05.06.2016;2016;06;10;Sunnuntai;3;7;10
94;05.06.2016;2016;06;11;Sunnuntai;7;10;17
94;05.06.2016;2016;06;12;Sunnuntai;7;9;16
94;05.06.2016;2016;06;13;Sunnuntai;13;6;19
94;05.06.2016;2016;06;14;Sunnuntai;5;4;9
94;05.06.2016;2016;06;15;Sunnuntai;4;4;8
94;05.06.2016;2016;06;16;Sunnuntai;5;4;9
94;05.06.2016;2016;06;17;Sunnuntai;6;6;12
94;05.06.2016;2016;06;18;Sunnuntai;4;14;18
94;05.06.2016;2016;06;19;Sunnuntai;7;2;9
94;05.06.2016;2016;06;20;Sunnuntai;7;5;12
94;05.06.2016;2016;06;21;Sunnuntai;0;1;1
94;05.06.2016;2016;06;22;Sunnuntai;3;12;15
94;05.06.2016;2016;06;23;Sunnuntai;6;0;6
94;06.06.2016;2016;06;00;Maanantai;0;0;0
94;06.06.2016;2016;06;01;Maanantai;0;0;0
94;06.06.2016;2016;06;02;Maanantai;0;0;0
94;06.06.2016;2016;06;03;Maanantai;0;1;1
94;06.06.2016;2016;06;04;Maanantai;1;0;1
94;06.06.2016;2016;06;05;Maanantai;8;1;9
94;06.06.2016;2016;06;06;Maanantai;18;1;19
94;06.06.2016;2016;06;07;Maanantai;22;9;31
94;06.06.2016;2016;06;08;Maanantai;12;8;20
94;06.06.2016;2016;06;09;Maanantai;12;7;19
94;06.06.2016;2016;06;10;Maanantai;4;5;9
94;06.06.2016;2016;06;11;Maanantai;4;4;8
94;06.06.2016;2016;06;12;Maanantai;6;2;8
94;06.06.2016;2016;06;13;Maanantai;8;7;15
94;06.06.2016;2016;06;14;Maanantai;5;11;16
94;06.06.2016;2016;06;15;Maanantai;8;23;31
94;06.06.2016;2016;06;16;Maanantai;13;38;51
94;06.06.2016;2016;06;17;Maanantai;9;18;27
94;06.06.2016;2016;06;18;Maanantai;7;6;13
94;06.06.2016;2016;06;19;Maanantai;7;14;21
94;06.06.2016;2016;06;20;Maanantai;5;4;9
94;06.06.2016;2016;06;21;Maanantai;1;3;4
94;06.06.2016;2016;06;22;Maanantai;3;8;11
94;06.06.2016;2016;06;23;Maanantai;0;1;1
94;07.06.2016;2016;06;00;Tiistai;0;2;2
94;07.06.2016;2016;06;01;Tiistai;0;0;0
94;07.06.2016;2016;06;02;Tiistai;0;0;0
94;07.06.2016;2016;06;03;Tiistai;0;1;1
94;07.06.2016;2016;06;04;Tiistai;1;0;1
94;07.06.2016;2016;06;05;Tiistai;10;2;12
94;07.06.2016;2016;06;06;Tiistai;28;4;32
94;07.06.2016;2016;06;07;Tiistai;28;9;37
94;07.06.2016;2016;06;08;Tiistai;15;6;21
94;07.06.2016;2016;06;09;Tiistai;6;6;12
94;07.06.2016;2016;06;10;Tiistai;6;5;11
94;07.06.2016;2016;06;11;Tiistai;4;4;8
94;07.06.2016;2016;06;12;Tiistai;9;3;12
94;07.06.2016;2016;06;13;Tiistai;8;8;16
94;07.06.2016;2016;06;14;Tiistai;15;11;26
94;07.06.2016;2016;06;15;Tiistai;16;29;45
94;07.06.2016;2016;06;16;Tiistai;9;41;50
94;07.06.2016;2016;06;17;Tiistai;12;17;29
94;07.06.2016;2016;06;18;Tiistai;11;17;28
94;07.06.2016;2016;06;19;Tiistai;12;13;25
94;07.06.2016;2016;06;20;Tiistai;8;6;14
94;07.06.2016;2016;06;21;Tiistai;7;5;12
94;07.06.2016;2016;06;22;Tiistai;2;7;9
94;07.06.2016;2016;06;23;Tiistai;0;0;0
94;08.06.2016;2016;06;00;Keskiviikko;0;0;0
94;08.06.2016;2016;06;01;Keskiviikko;0;0;0
94;08.06.2016;2016;06;02;Keskiviikko;0;0;0
94;08.06.2016;2016;06;03;Keskiviikko;0;0;0
94;08.06.2016;2016;06;04;Keskiviikko;0;0;0
94;08.06.2016;2016;06;05;Keskiviikko;6;0;6
94;08.06.2016;2016;06;06;Keskiviikko;13;1;14
94;08.06.2016;2016;06;07;Keskiviikko;9;1;10
94;08.06.2016;2016;06;08;Keskiviikko;5;3;8
94;08.06.2016;2016;06;09;Keskiviikko;5;1;6
94;08.06.2016;2016;06;10;Keskiviikko;0;0;0
94;08.06.2016;2016;06;11;Keskiviikko;0;1;1
94;08.06.2016;2016;06;12;Keskiviikko;3;1;4
94;08.06.2016;2016;06;13;Keskiviikko;0;4;4
94;08.06.2016;2016;06;14;Keskiviikko;1;4;5
94;08.06.2016;2016;06;15;Keskiviikko;2;7;9
94;08.06.2016;2016;06;16;Keskiviikko;0;12;12
94;08.06.2016;2016;06;17;Keskiviikko;0;2;2
94;08.06.2016;2016;06;18;Keskiviikko;1;4;5
94;08.06.2016;2016;06;19;Keskiviikko;1;2;3
94;08.06.2016;2016;06;20;Keskiviikko;1;4;5
94;08.06.2016;2016;06;21;Keskiviikko;5;1;6
94;08.06.2016;2016;06;22;Keskiviikko;1;3;4
94;08.06.2016;2016;06;23;Keskiviikko;1;0;1
94;09.06.2016;2016;06;00;Torstai;0;0;0
94;09.06.2016;2016;06;01;Torstai;0;0;0
94;09.06.2016;2016;06;02;Torstai;0;0;0
94;09.06.2016;2016;06;03;Torstai;0;0;0
94;09.06.2016;2016;06;04;Torstai;1;0;1
94;09.06.2016;2016;06;05;Torstai;4;1;5
94;09.06.2016;2016;06;06;Torstai;15;2;17
94;09.06.2016;2016;06;07;Torstai;12;3;15
94;09.06.2016;2016;06;08;Torstai;10;1;11
94;09.06.2016;2016;06;09;Torstai;4;2;6
94;09.06.2016;2016;06;10;Torstai;2;2;4
94;09.06.2016;2016;06;11;Torstai;1;1;2
94;09.06.2016;2016;06;12;Torstai;4;0;4
94;09.06.2016;2016;06;13;Torstai;4;4;8
94;09.06.2016;2016;06;14;Torstai;7;7;14
94;09.06.2016;2016;06;15;Torstai;5;16;21
94;09.06.2016;2016;06;16;Torstai;5;21;26
94;09.06.2016;2016;06;17;Torstai;12;12;24
94;09.06.2016;2016;06;18;Torstai;8;9;17
94;09.06.2016;2016;06;19;Torstai;4;6;10
94;09.06.2016;2016;06;20;Torstai;3;9;12
94;09.06.2016;2016;06;21;Torstai;4;5;9
94;09.06.2016;2016;06;22;Torstai;0;2;2
94;09.06.2016;2016;06;23;Torstai;0;0;0
94;10.06.2016;2016;06;00;Perjantai;1;0;1
94;10.06.2016;2016;06;01;Perjantai;0;1;1
94;10.06.2016;2016;06;02;Perjantai;0;0;0
94;10.06.2016;2016;06;03;Perjantai;0;0;0
94;10.06.2016;2016;06;04;Perjantai;2;0;2
94;10.06.2016;2016;06;05;Perjantai;7;0;7
94;10.06.2016;2016;06;06;Perjantai;21;1;22
94;10.06.2016;2016;06;07;Perjantai;14;1;15
94;10.06.2016;2016;06;08;Perjantai;8;0;8
94;10.06.2016;2016;06;09;Perjantai;4;1;5
94;10.06.2016;2016;06;10;Perjantai;4;1;5
94;10.06.2016;2016;06;11;Perjantai;1;0;1
94;10.06.2016;2016;06;12;Perjantai;7;2;9
94;10.06.2016;2016;06;13;Perjantai;4;2;6
94;10.06.2016;2016;06;14;Perjantai;6;10;16
94;10.06.2016;2016;06;15;Perjantai;3;20;23
94;10.06.2016;2016;06;16;Perjantai;5;18;23
94;10.06.2016;2016;06;17;Perjantai;5;13;18
94;10.06.2016;2016;06;18;Perjantai;7;4;11
94;10.06.2016;2016;06;19;Perjantai;1;8;9
94;10.06.2016;2016;06;20;Perjantai;1;4;5
94;10.06.2016;2016;06;21;Perjantai;1;3;4
94;10.06.2016;2016;06;22;Perjantai;0;7;7
94;10.06.2016;2016;06;23;Perjantai;0;1;1
94;11.06.2016;2016;06;00;Lauantai;0;4;4
94;11.06.2016;2016;06;01;Lauantai;0;0;0
94;11.06.2016;2016;06;02;Lauantai;0;0;0
94;11.06.2016;2016;06;03;Lauantai;0;0;0
94;11.06.2016;2016;06;04;Lauantai;2;0;2
94;11.06.2016;2016;06;05;Lauantai;3;0;3
94;11.06.2016;2016;06;06;Lauantai;2;1;3
94;11.06.2016;2016;06;07;Lauantai;3;2;5
94;11.06.2016;2016;06;08;Lauantai;3;2;5
94;11.06.2016;2016;06;09;Lauantai;4;1;5
94;11.06.2016;2016;06;10;Lauantai;2;6;8
94;11.06.2016;2016;06;11;Lauantai;9;5;14
94;11.06.2016;2016;06;12;Lauantai;3;5;8
94;11.06.2016;2016;06;13;Lauantai;11;5;16
94;11.06.2016;2016;06;14;Lauantai;7;11;18
94;11.06.2016;2016;06;15;Lauantai;6;4;10
94;11.06.2016;2016;06;16;Lauantai;7;4;11
94;11.06.2016;2016;06;17;Lauantai;7;4;11
94;11.06.2016;2016;06;18;Lauantai;2;6;8
94;11.06.2016;2016;06;19;Lauantai;5;2;7
94;11.06.2016;2016;06;20;Lauantai;6;6;12
94;11.06.2016;2016;06;21;Lauantai;3;4;7
94;11.06.2016;2016;06;22;Lauantai;3;2;5
94;11.06.2016;2016;06;23;Lauantai;1;2;3
94;12.06.2016;2016;06;00;Sunnuntai;0;3;3
94;12.06.2016;2016;06;01;Sunnuntai;0;2;2
94;12.06.2016;2016;06;02;Sunnuntai;0;1;1
94;12.06.2016;2016;06;03;Sunnuntai;0;0;0
94;12.06.2016;2016;06;04;Sunnuntai;0;0;0
94;12.06.2016;2016;06;05;Sunnuntai;3;0;3
94;12.06.2016;2016;06;06;Sunnuntai;1;2;3
94;12.06.2016;2016;06;07;Sunnuntai;0;1;1
94;12.06.2016;2016;06;08;Sunnuntai;3;1;4
94;12.06.2016;2016;06;09;Sunnuntai;5;8;13
94;12.06.2016;2016;06;10;Sunnuntai;5;7;12
94;12.06.2016;2016;06;11;Sunnuntai;8;14;22
94;12.06.2016;2016;06;12;Sunnuntai;14;11;25
94;12.06.2016;2016;06;13;Sunnuntai;22;11;33
94;12.06.2016;2016;06;14;Sunnuntai;20;11;31
94;12.06.2016;2016;06;15;Sunnuntai;12;16;28
94;12.06.2016;2016;06;16;Sunnuntai;5;8;13
94;12.06.2016;2016;06;17;Sunnuntai;4;8;12
94;12.06.2016;2016;06;18;Sunnuntai;7;15;22
94;12.06.2016;2016;06;19;Sunnuntai;14;7;21
94;12.06.2016;2016;06;20;Sunnuntai;7;4;11
94;12.06.2016;2016;06;21;Sunnuntai;5;2;7
94;12.06.2016;2016;06;22;Sunnuntai;2;2;4
94;12.06.2016;2016;06;23;Sunnuntai;1;0;1
94;13.06.2016;2016;06;00;Maanantai;0;1;1
94;13.06.2016;2016;06;01;Maanantai;0;0;0
94;13.06.2016;2016;06;02;Maanantai;0;0;0
94;13.06.2016;2016;06;03;Maanantai;0;0;0
94;13.06.2016;2016;06;04;Maanantai;0;0;0
94;13.06.2016;2016;06;05;Maanantai;9;2;11
94;13.06.2016;2016;06;06;Maanantai;25;3;28
94;13.06.2016;2016;06;07;Maanantai;32;4;36
94;13.06.2016;2016;06;08;Maanantai;12;2;14
94;13.06.2016;2016;06;09;Maanantai;6;4;10
94;13.06.2016;2016;06;10;Maanantai;7;4;11
94;13.06.2016;2016;06;11;Maanantai;8;5;13
94;13.06.2016;2016;06;12;Maanantai;8;5;13
94;13.06.2016;2016;06;13;Maanantai;7;9;16
94;13.06.2016;2016;06;14;Maanantai;11;3;14
94;13.06.2016;2016;06;15;Maanantai;10;41;51
94;13.06.2016;2016;06;16;Maanantai;8;37;45
94;13.06.2016;2016;06;17;Maanantai;9;20;29
94;13.06.2016;2016;06;18;Maanantai;4;11;15
94;13.06.2016;2016;06;19;Maanantai;8;10;18
94;13.06.2016;2016;06;20;Maanantai;13;8;21
94;13.06.2016;2016;06;21;Maanantai;4;12;16
94;13.06.2016;2016;06;22;Maanantai;3;3;6
94;13.06.2016;2016;06;23;Maanantai;0;0;0
94;14.06.2016;2016;06;00;Tiistai;0;0;0
94;14.06.2016;2016;06;01;Tiistai;0;0;0
94;14.06.2016;2016;06;02;Tiistai;0;0;0
94;14.06.2016;2016;06;03;Tiistai;0;0;0
94;14.06.2016;2016;06;04;Tiistai;0;0;0
94;14.06.2016;2016;06;05;Tiistai;9;2;11
94;14.06.2016;2016;06;06;Tiistai;25;3;28
94;14.06.2016;2016;06;07;Tiistai;34;5;39
94;14.06.2016;2016;06;08;Tiistai;18;5;23
94;14.06.2016;2016;06;09;Tiistai;9;5;14
94;14.06.2016;2016;06;10;Tiistai;7;4;11
94;14.06.2016;2016;06;11;Tiistai;5;7;12
94;14.06.2016;2016;06;12;Tiistai;14;6;20
94;14.06.2016;2016;06;13;Tiistai;7;6;13
94;14.06.2016;2016;06;14;Tiistai;14;12;26
94;14.06.2016;2016;06;15;Tiistai;12;37;49
94;14.06.2016;2016;06;16;Tiistai;13;37;50
94;14.06.2016;2016;06;17;Tiistai;20;23;43
94;14.06.2016;2016;06;18;Tiistai;12;13;25
94;14.06.2016;2016;06;19;Tiistai;4;15;19
94;14.06.2016;2016;06;20;Tiistai;6;9;15
94;14.06.2016;2016;06;21;Tiistai;6;5;11
94;14.06.2016;2016;06;22;Tiistai;1;11;12
94;14.06.2016;2016;06;23;Tiistai;0;2;2
94;15.06.2016;2016;06;00;Keskiviikko;1;0;1
94;15.06.2016;2016;06;01;Keskiviikko;0;0;0
94;15.06.2016;2016;06;02;Keskiviikko;0;0;0
94;15.06.2016;2016;06;03;Keskiviikko;0;0;0
94;15.06.2016;2016;06;04;Keskiviikko;0;0;0
94;15.06.2016;2016;06;05;Keskiviikko;12;2;14
94;15.06.2016;2016;06;06;Keskiviikko;24;3;27
94;15.06.2016;2016;06;07;Keskiviikko;28;8;36
94;15.06.2016;2016;06;08;Keskiviikko;19;1;20
94;15.06.2016;2016;06;09;Keskiviikko;6;1;7
94;15.06.2016;2016;06;10;Keskiviikko;4;3;7
94;15.06.2016;2016;06;11;Keskiviikko;11;7;18
94;15.06.2016;2016;06;12;Keskiviikko;8;14;22
94;15.06.2016;2016;06;13;Keskiviikko;14;13;27
94;15.06.2016;2016;06;14;Keskiviikko;13;14;27
94;15.06.2016;2016;06;15;Keskiviikko;17;28;45
94;15.06.2016;2016;06;16;Keskiviikko;11;39;50
94;15.06.2016;2016;06;17;Keskiviikko;11;30;41
94;15.06.2016;2016;06;18;Keskiviikko;17;22;39
94;15.06.2016;2016;06;19;Keskiviikko;12;17;29
94;15.06.2016;2016;06;20;Keskiviikko;14;9;23
94;15.06.2016;2016;06;21;Keskiviikko;4;9;13
94;15.06.2016;2016;06;22;Keskiviikko;1;9;10
94;15.06.2016;2016;06;23;Keskiviikko;1;1;2
94;16.06.2016;2016;06;00;Torstai;0;3;3
94;16.06.2016;2016;06;01;Torstai;0;0;0
94;16.06.2016;2016;06;02;Torstai;1;0;1
94;16.06.2016;2016;06;03;Torstai;0;1;1
94;16.06.2016;2016;06;04;Torstai;1;0;1
94;16.06.2016;2016;06;05;Torstai;10;2;12
94;16.06.2016;2016;06;06;Torstai;18;4;22
94;16.06.2016;2016;06;07;Torstai;29;1;30
94;16.06.2016;2016;06;08;Torstai;10;4;14
94;16.06.2016;2016;06;09;Torstai;2;7;9
94;16.06.2016;2016;06;10;Torstai;5;9;14
94;16.06.2016;2016;06;11;Torstai;13;3;16
94;16.06.2016;2016;06;12;Torstai;4;6;10
94;16.06.2016;2016;06;13;Torstai;6;13;19
94;16.06.2016;2016;06;14;Torstai;4;7;11
94;16.06.2016;2016;06;15;Torstai;2;20;22
94;16.06.2016;2016;06;16;Torstai;3;22;25
94;16.06.2016;2016;06;17;Torstai;5;9;14
94;16.06.2016;2016;06;18;Torstai;3;7;10
94;16.06.2016;2016;06;19;Torstai;3;4;7
94;16.06.2016;2016;06;20;Torstai;3;4;7
94;16.06.2016;2016;06;21;Torstai;1;4;5
94;16.06.2016;2016;06;22;Torstai;0;2;2
94;16.06.2016;2016;06;23;Torstai;1;0;1
94;17.06.2016;2016;06;00;Perjantai;1;1;2
94;17.06.2016;2016;06;01;Perjantai;0;0;0
94;17.06.2016;2016;06;02;Perjantai;0;0;0
94;17.06.2016;2016;06;03;Perjantai;0;0;0
94;17.06.2016;2016;06;04;Perjantai;0;0;0
94;17.06.2016;2016;06;05;Perjantai;4;0;4
94;17.06.2016;2016;06;06;Perjantai;7;1;8
94;17.06.2016;2016;06;07;Perjantai;12;0;12
94;17.06.2016;2016;06;08;Perjantai;5;1;6
94;17.06.2016;2016;06;09;Perjantai;3;1;4
94;17.06.2016;2016;06;10;Perjantai;5;0;5
94;17.06.2016;2016;06;11;Perjantai;4;3;7
94;17.06.2016;2016;06;12;Perjantai;4;5;9
94;17.06.2016;2016;06;13;Perjantai;3;2;5
94;17.06.2016;2016;06;14;Perjantai;1;6;7
94;17.06.2016;2016;06;15;Perjantai;2;5;7
94;17.06.2016;2016;06;16;Perjantai;3;15;18
94;17.06.2016;2016;06;17;Perjantai;4;3;7
94;17.06.2016;2016;06;18;Perjantai;6;10;16
94;17.06.2016;2016;06;19;Perjantai;7;7;14
94;17.06.2016;2016;06;20;Perjantai;2;5;7
94;17.06.2016;2016;06;21;Perjantai;1;1;2
94;17.06.2016;2016;06;22;Perjantai;3;2;5
94;17.06.2016;2016;06;23;Perjantai;0;2;2
94;18.06.2016;2016;06;00;Lauantai;1;0;1
94;18.06.2016;2016;06;01;Lauantai;0;3;3
94;18.06.2016;2016;06;02;Lauantai;0;0;0
94;18.06.2016;2016;06;03;Lauantai;0;0;0
94;18.06.2016;2016;06;04;Lauantai;0;0;0
94;18.06.2016;2016;06;05;Lauantai;3;0;3
94;18.06.2016;2016;06;06;Lauantai;0;1;1
94;18.06.2016;2016;06;07;Lauantai;3;4;7
94;18.06.2016;2016;06;08;Lauantai;5;3;8
94;18.06.2016;2016;06;09;Lauantai;9;10;19
94;18.06.2016;2016;06;10;Lauantai;6;17;23
94;18.06.2016;2016;06;11;Lauantai;4;9;13
94;18.06.2016;2016;06;12;Lauantai;5;9;14
94;18.06.2016;2016;06;13;Lauantai;0;4;4
94;18.06.2016;2016;06;14;Lauantai;3;3;6
94;18.06.2016;2016;06;15;Lauantai;5;8;13
94;18.06.2016;2016;06;16;Lauantai;6;0;6
94;18.06.2016;2016;06;17;Lauantai;4;4;8
94;18.06.2016;2016;06;18;Lauantai;1;2;3
94;18.06.2016;2016;06;19;Lauantai;1;3;4
94;18.06.2016;2016;06;20;Lauantai;0;4;4
94;18.06.2016;2016;06;21;Lauantai;3;0;3
94;18.06.2016;2016;06;22;Lauantai;1;2;3
94;18.06.2016;2016;06;23;Lauantai;2;0;2
94;19.06.2016;2016;06;00;Sunnuntai;0;2;2
94;19.06.2016;2016;06;01;Sunnuntai;2;2;4
94;19.06.2016;2016;06;02;Sunnuntai;0;0;0
94;19.06.2016;2016;06;03;Sunnuntai;0;0;0
94;19.06.2016;2016;06;04;Sunnuntai;2;0;2
94;19.06.2016;2016;06;05;Sunnuntai;0;0;0
94;19.06.2016;2016;06;06;Sunnuntai;1;0;1
94;19.06.2016;2016;06;07;Sunnuntai;2;3;5
94;19.06.2016;2016;06;08;Sunnuntai;2;2;4
94;19.06.2016;2016;06;09;Sunnuntai;1;1;2
94;19.06.2016;2016;06;10;Sunnuntai;5;3;8
94;19.06.2016;2016;06;11;Sunnuntai;14;10;24
94;19.06.2016;2016;06;12;Sunnuntai;16;9;25
94;19.06.2016;2016;06;13;Sunnuntai;13;14;27
94;19.06.2016;2016;06;14;Sunnuntai;9;17;26
94;19.06.2016;2016;06;15;Sunnuntai;7;7;14
94;19.06.2016;2016;06;16;Sunnuntai;12;4;16
94;19.06.2016;2016;06;17;Sunnuntai;5;4;9
94;19.06.2016;2016;06;18;Sunnuntai;4;1;5
94;19.06.2016;2016;06;19;Sunnuntai;8;8;16
94;19.06.2016;2016;06;20;Sunnuntai;2;5;7
94;19.06.2016;2016;06;21;Sunnuntai;5;8;13
94;19.06.2016;2016;06;22;Sunnuntai;1;0;1
94;19.06.2016;2016;06;23;Sunnuntai;2;2;4
94;20.06.2016;2016;06;00;Maanantai;0;0;0
94;20.06.2016;2016;06;01;Maanantai;0;0;0
94;20.06.2016;2016;06;02;Maanantai;0;1;1
94;20.06.2016;2016;06;03;Maanantai;0;0;0
94;20.06.2016;2016;06;04;Maanantai;2;0;2
94;20.06.2016;2016;06;05;Maanantai;6;1;7
94;20.06.2016;2016;06;06;Maanantai;24;3;27
94;20.06.2016;2016;06;07;Maanantai;25;2;27
94;20.06.2016;2016;06;08;Maanantai;13;4;17
94;20.06.2016;2016;06;09;Maanantai;6;7;13
94;20.06.2016;2016;06;10;Maanantai;4;26;30
94;20.06.2016;2016;06;11;Maanantai;8;8;16
94;20.06.2016;2016;06;12;Maanantai;21;6;27
94;20.06.2016;2016;06;13;Maanantai;15;7;22
94;20.06.2016;2016;06;14;Maanantai;6;15;21
94;20.06.2016;2016;06;15;Maanantai;11;37;48
94;20.06.2016;2016;06;16;Maanantai;8;33;41
94;20.06.2016;2016;06;17;Maanantai;8;21;29
94;20.06.2016;2016;06;18;Maanantai;3;10;13
94;20.06.2016;2016;06;19;Maanantai;16;12;28
94;20.06.2016;2016;06;20;Maanantai;10;4;14
94;20.06.2016;2016;06;21;Maanantai;5;8;13
94;20.06.2016;2016;06;22;Maanantai;1;6;7
94;20.06.2016;2016;06;23;Maanantai;1;0;1
94;21.06.2016;2016;06;00;Tiistai;1;0;1
94;21.06.2016;2016;06;01;Tiistai;0;1;1
94;21.06.2016;2016;06;02;Tiistai;0;0;0
94;21.06.2016;2016;06;03;Tiistai;0;0;0
94;21.06.2016;2016;06;04;Tiistai;2;0;2
94;21.06.2016;2016;06;05;Tiistai;10;2;12
94;21.06.2016;2016;06;06;Tiistai;29;2;31
94;21.06.2016;2016;06;07;Tiistai;23;2;25
94;21.06.2016;2016;06;08;Tiistai;18;2;20
94;21.06.2016;2016;06;09;Tiistai;8;4;12
94;21.06.2016;2016;06;10;Tiistai;7;8;15
94;21.06.2016;2016;06;11;Tiistai;13;7;20
94;21.06.2016;2016;06;12;Tiistai;9;9;18
94;21.06.2016;2016;06;13;Tiistai;14;8;22
94;21.06.2016;2016;06;14;Tiistai;4;9;13
94;21.06.2016;2016;06;15;Tiistai;6;42;48
94;21.06.2016;2016;06;16;Tiistai;15;37;52
94;21.06.2016;2016;06;17;Tiistai;13;25;38
94;21.06.2016;2016;06;18;Tiistai;21;16;37
94;21.06.2016;2016;06;19;Tiistai;14;12;26
94;21.06.2016;2016;06;20;Tiistai;11;14;25
94;21.06.2016;2016;06;21;Tiistai;5;8;13
94;21.06.2016;2016;06;22;Tiistai;5;6;11
94;21.06.2016;2016;06;23;Tiistai;0;3;3
94;22.06.2016;2016;06;00;Keskiviikko;1;1;2
94;22.06.2016;2016;06;01;Keskiviikko;0;1;1
94;22.06.2016;2016;06;02;Keskiviikko;0;0;0
94;22.06.2016;2016;06;03;Keskiviikko;0;2;2
94;22.06.2016;2016;06;04;Keskiviikko;0;0;0
94;22.06.2016;2016;06;05;Keskiviikko;9;2;11
94;22.06.2016;2016;06;06;Keskiviikko;26;3;29
94;22.06.2016;2016;06;07;Keskiviikko;30;5;35
94;22.06.2016;2016;06;08;Keskiviikko;12;1;13
94;22.06.2016;2016;06;09;Keskiviikko;2;7;9
94;22.06.2016;2016;06;10;Keskiviikko;7;2;9
94;22.06.2016;2016;06;11;Keskiviikko;2;7;9
94;22.06.2016;2016;06;12;Keskiviikko;4;7;11
94;22.06.2016;2016;06;13;Keskiviikko;9;8;17
94;22.06.2016;2016;06;14;Keskiviikko;10;10;20
94;22.06.2016;2016;06;15;Keskiviikko;8;33;41
94;22.06.2016;2016;06;16;Keskiviikko;6;34;40
94;22.06.2016;2016;06;17;Keskiviikko;9;14;23
94;22.06.2016;2016;06;18;Keskiviikko;12;12;24
94;22.06.2016;2016;06;19;Keskiviikko;9;13;22
94;22.06.2016;2016;06;20;Keskiviikko;5;3;8
94;22.06.2016;2016;06;21;Keskiviikko;4;7;11
94;22.06.2016;2016;06;22;Keskiviikko;1;3;4
94;22.06.2016;2016;06;23;Keskiviikko;0;3;3
94;23.06.2016;2016;06;00;Torstai;0;0;0
94;23.06.2016;2016;06;01;Torstai;1;2;3
94;23.06.2016;2016;06;02;Torstai;0;0;0
94;23.06.2016;2016;06;03;Torstai;0;0;0
94;23.06.2016;2016;06;04;Torstai;0;1;1
94;23.06.2016;2016;06;05;Torstai;11;2;13
94;23.06.2016;2016;06;06;Torstai;15;3;18
94;23.06.2016;2016;06;07;Torstai;22;4;26
94;23.06.2016;2016;06;08;Torstai;10;3;13
94;23.06.2016;2016;06;09;Torstai;3;6;9
94;23.06.2016;2016;06;10;Torstai;5;6;11
94;23.06.2016;2016;06;11;Torstai;8;5;13
94;23.06.2016;2016;06;12;Torstai;11;12;23
94;23.06.2016;2016;06;13;Torstai;8;15;23
94;23.06.2016;2016;06;14;Torstai;11;22;33
94;23.06.2016;2016;06;15;Torstai;11;31;42
94;23.06.2016;2016;06;16;Torstai;16;26;42
94;23.06.2016;2016;06;17;Torstai;10;18;28
94;23.06.2016;2016;06;18;Torstai;12;12;24
94;23.06.2016;2016;06;19;Torstai;8;8;16
94;23.06.2016;2016;06;20;Torstai;5;7;12
94;23.06.2016;2016;06;21;Torstai;2;10;12
94;23.06.2016;2016;06;22;Torstai;1;5;6
94;23.06.2016;2016;06;23;Torstai;1;6;7
94;24.06.2016;2016;06;00;Perjantai;2;3;5
94;24.06.2016;2016;06;01;Perjantai;0;0;0
94;24.06.2016;2016;06;02;Perjantai;0;1;1
94;24.06.2016;2016;06;03;Perjantai;0;0;0
94;24.06.2016;2016;06;04;Perjantai;0;0;0
94;24.06.2016;2016;06;05;Perjantai;0;1;1
94;24.06.2016;2016;06;06;Perjantai;1;2;3
94;24.06.2016;2016;06;07;Perjantai;2;2;4
94;24.06.2016;2016;06;08;Perjantai;2;2;4
94;24.06.2016;2016;06;09;Perjantai;10;0;10
94;24.06.2016;2016;06;10;Perjantai;6;10;16
94;24.06.2016;2016;06;11;Perjantai;13;11;24
94;24.06.2016;2016;06;12;Perjantai;20;17;37
94;24.06.2016;2016;06;13;Perjantai;10;15;25
94;24.06.2016;2016;06;14;Perjantai;22;29;51
94;24.06.2016;2016;06;15;Perjantai;12;4;16
94;24.06.2016;2016;06;16;Perjantai;11;13;24
94;24.06.2016;2016;06;17;Perjantai;18;17;35
94;24.06.2016;2016;06;18;Perjantai;5;14;19
94;24.06.2016;2016;06;19;Perjantai;5;8;13
94;24.06.2016;2016;06;20;Perjantai;5;4;9
94;24.06.2016;2016;06;21;Perjantai;6;2;8
94;24.06.2016;2016;06;22;Perjantai;1;4;5
94;24.06.2016;2016;06;23;Perjantai;5;2;7
94;25.06.2016;2016;06;00;Lauantai;1;1;2
94;25.06.2016;2016;06;01;Lauantai;2;2;4
94;25.06.2016;2016;06;02;Lauantai;0;2;2
94;25.06.2016;2016;06;03;Lauantai;2;2;4
94;25.06.2016;2016;06;04;Lauantai;0;0;0
94;25.06.2016;2016;06;05;Lauantai;3;0;3
94;25.06.2016;2016;06;06;Lauantai;0;2;2
94;25.06.2016;2016;06;07;Lauantai;0;5;5
94;25.06.2016;2016;06;08;Lauantai;1;2;3
94;25.06.2016;2016;06;09;Lauantai;3;3;6
94;25.06.2016;2016;06;10;Lauantai;3;3;6
94;25.06.2016;2016;06;11;Lauantai;7;8;15
94;25.06.2016;2016;06;12;Lauantai;1;3;4
94;25.06.2016;2016;06;13;Lauantai;2;0;2
94;25.06.2016;2016;06;14;Lauantai;0;0;0
94;25.06.2016;2016;06;15;Lauantai;4;3;7
94;25.06.2016;2016;06;16;Lauantai;2;5;7
94;25.06.2016;2016;06;17;Lauantai;5;2;7
94;25.06.2016;2016;06;18;Lauantai;4;2;6
94;25.06.2016;2016;06;19;Lauantai;7;5;12
94;25.06.2016;2016;06;20;Lauantai;6;4;10
94;25.06.2016;2016;06;21;Lauantai;1;4;5
94;25.06.2016;2016;06;22;Lauantai;1;2;3
94;25.06.2016;2016;06;23;Lauantai;5;0;5
94;26.06.2016;2016;06;00;Sunnuntai;0;1;1
94;26.06.2016;2016;06;01;Sunnuntai;0;0;0
94;26.06.2016;2016;06;02;Sunnuntai;0;0;0
94;26.06.2016;2016;06;03;Sunnuntai;0;0;0
94;26.06.2016;2016;06;04;Sunnuntai;0;0;0
94;26.06.2016;2016;06;05;Sunnuntai;1;0;1
94;26.06.2016;2016;06;06;Sunnuntai;4;1;5
94;26.06.2016;2016;06;07;Sunnuntai;1;1;2
94;26.06.2016;2016;06;08;Sunnuntai;2;2;4
94;26.06.2016;2016;06;09;Sunnuntai;7;2;9
94;26.06.2016;2016;06;10;Sunnuntai;4;6;10
94;26.06.2016;2016;06;11;Sunnuntai;16;8;24
94;26.06.2016;2016;06;12;Sunnuntai;18;4;22
94;26.06.2016;2016;06;13;Sunnuntai;10;9;19
94;26.06.2016;2016;06;14;Sunnuntai;7;21;28
94;26.06.2016;2016;06;15;Sunnuntai;20;23;43
94;26.06.2016;2016;06;16;Sunnuntai;15;6;21
94;26.06.2016;2016;06;17;Sunnuntai;13;8;21
94;26.06.2016;2016;06;18;Sunnuntai;13;18;31
94;26.06.2016;2016;06;19;Sunnuntai;26;11;37
94;26.06.2016;2016;06;20;Sunnuntai;13;13;26
94;26.06.2016;2016;06;21;Sunnuntai;5;16;21
94;26.06.2016;2016;06;22;Sunnuntai;4;2;6
94;26.06.2016;2016;06;23;Sunnuntai;0;3;3
94;27.06.2016;2016;06;00;Maanantai;1;1;2
94;27.06.2016;2016;06;01;Maanantai;0;2;2
94;27.06.2016;2016;06;02;Maanantai;0;0;0
94;27.06.2016;2016;06;03;Maanantai;0;0;0
94;27.06.2016;2016;06;04;Maanantai;1;0;1
94;27.06.2016;2016;06;05;Maanantai;8;3;11
94;27.06.2016;2016;06;06;Maanantai;28;2;30
94;27.06.2016;2016;06;07;Maanantai;24;2;26
94;27.06.2016;2016;06;08;Maanantai;12;3;15
94;27.06.2016;2016;06;09;Maanantai;7;1;8
94;27.06.2016;2016;06;10;Maanantai;5;3;8
94;27.06.2016;2016;06;11;Maanantai;9;9;18
94;27.06.2016;2016;06;12;Maanantai;5;8;13
94;27.06.2016;2016;06;13;Maanantai;10;11;21
94;27.06.2016;2016;06;14;Maanantai;17;20;37
94;27.06.2016;2016;06;15;Maanantai;20;26;46
94;27.06.2016;2016;06;16;Maanantai;10;34;44
94;27.06.2016;2016;06;17;Maanantai;3;16;19
94;27.06.2016;2016;06;18;Maanantai;8;12;20
94;27.06.2016;2016;06;19;Maanantai;6;12;18
94;27.06.2016;2016;06;20;Maanantai;6;12;18
94;27.06.2016;2016;06;21;Maanantai;5;6;11
94;27.06.2016;2016;06;22;Maanantai;1;3;4
94;27.06.2016;2016;06;23;Maanantai;0;2;2
94;28.06.2016;2016;06;00;Tiistai;0;0;0
94;28.06.2016;2016;06;01;Tiistai;2;0;2
94;28.06.2016;2016;06;02;Tiistai;0;0;0
94;28.06.2016;2016;06;03;Tiistai;0;1;1
94;28.06.2016;2016;06;04;Tiistai;0;0;0
94;28.06.2016;2016;06;05;Tiistai;5;0;5
94;28.06.2016;2016;06;06;Tiistai;14;0;14
94;28.06.2016;2016;06;07;Tiistai;12;0;12
94;28.06.2016;2016;06;08;Tiistai;7;1;8
94;28.06.2016;2016;06;09;Tiistai;2;0;2
94;28.06.2016;2016;06;10;Tiistai;6;2;8
94;28.06.2016;2016;06;11;Tiistai;4;5;9
94;28.06.2016;2016;06;12;Tiistai;3;4;7
94;28.06.2016;2016;06;13;Tiistai;3;3;6
94;28.06.2016;2016;06;14;Tiistai;2;9;11
94;28.06.2016;2016;06;15;Tiistai;3;12;15
94;28.06.2016;2016;06;16;Tiistai;5;14;19
94;28.06.2016;2016;06;17;Tiistai;7;14;21
94;28.06.2016;2016;06;18;Tiistai;12;17;29
94;28.06.2016;2016;06;19;Tiistai;11;12;23
94;28.06.2016;2016;06;20;Tiistai;18;4;22
94;28.06.2016;2016;06;21;Tiistai;1;5;6
94;28.06.2016;2016;06;22;Tiistai;4;6;10
94;28.06.2016;2016;06;23;Tiistai;1;3;4
94;29.06.2016;2016;06;00;Keskiviikko;0;2;2
94;29.06.2016;2016;06;01;Keskiviikko;0;1;1
94;29.06.2016;2016;06;02;Keskiviikko;0;0;0
94;29.06.2016;2016;06;03;Keskiviikko;0;0;0
94;29.06.2016;2016;06;04;Keskiviikko;1;1;2
94;29.06.2016;2016;06;05;Keskiviikko;5;3;8
94;29.06.2016;2016;06;06;Keskiviikko;28;2;30
94;29.06.2016;2016;06;07;Keskiviikko;24;4;28
94;29.06.2016;2016;06;08;Keskiviikko;14;8;22
94;29.06.2016;2016;06;09;Keskiviikko;4;3;7
94;29.06.2016;2016;06;10;Keskiviikko;4;5;9
94;29.06.2016;2016;06;11;Keskiviikko;7;5;12
94;29.06.2016;2016;06;12;Keskiviikko;11;10;21
94;29.06.2016;2016;06;13;Keskiviikko;9;12;21
94;29.06.2016;2016;06;14;Keskiviikko;8;9;17
94;29.06.2016;2016;06;15;Keskiviikko;21;22;43
94;29.06.2016;2016;06;16;Keskiviikko;6;29;35
94;29.06.2016;2016;06;17;Keskiviikko;4;20;24
94;29.06.2016;2016;06;18;Keskiviikko;6;9;15
94;29.06.2016;2016;06;19;Keskiviikko;7;15;22
94;29.06.2016;2016;06;20;Keskiviikko;14;6;20
94;29.06.2016;2016;06;21;Keskiviikko;5;11;16
94;29.06.2016;2016;06;22;Keskiviikko;5;3;8
94;29.06.2016;2016;06;23;Keskiviikko;1;1;2
94;30.06.2016;2016;06;00;Torstai;0;0;0
94;30.06.2016;2016;06;01;Torstai;0;0;0
94;30.06.2016;2016;06;02;Torstai;0;0;0
94;30.06.2016;2016;06;03;Torstai;0;1;1
94;30.06.2016;2016;06;04;Torstai;1;0;1
94;30.06.2016;2016;06;05;Torstai;8;3;11
94;30.06.2016;2016;06;06;Torstai;14;1;15
94;30.06.2016;2016;06;07;Torstai;19;5;24
94;30.06.2016;2016;06;08;Torstai;7;1;8
94;30.06.2016;2016;06;09;Torstai;9;4;13
94;30.06.2016;2016;06;10;Torstai;12;11;23
94;30.06.2016;2016;06;11;Torstai;14;12;26
94;30.06.2016;2016;06;12;Torstai;11;7;18
94;30.06.2016;2016;06;13;Torstai;11;16;27
94;30.06.2016;2016;06;14;Torstai;10;13;23
94;30.06.2016;2016;06;15;Torstai;9;24;33
94;30.06.2016;2016;06;16;Torstai;2;11;13
94;30.06.2016;2016;06;17;Torstai;0;6;6
94;30.06.2016;2016;06;18;Torstai;1;2;3
94;30.06.2016;2016;06;19;Torstai;5;7;12
94;30.06.2016;2016;06;20;Torstai;3;3;6
94;30.06.2016;2016;06;21;Torstai;3;9;12
94;30.06.2016;2016;06;22;Torstai;2;5;7
94;30.06.2016;2016;06;23;Torstai;1;1;2
94;01.07.2016;2016;07;00;Perjantai;0;0;0
94;01.07.2016;2016;07;01;Perjantai;1;0;1
94;01.07.2016;2016;07;02;Perjantai;0;0;0
94;01.07.2016;2016;07;03;Perjantai;0;0;0
94;01.07.2016;2016;07;04;Perjantai;2;0;2
94;01.07.2016;2016;07;05;Perjantai;6;1;7
94;01.07.2016;2016;07;06;Perjantai;10;2;12
94;01.07.2016;2016;07;07;Perjantai;21;4;25
94;01.07.2016;2016;07;08;Perjantai;7;2;9
94;01.07.2016;2016;07;09;Perjantai;6;2;8
94;01.07.2016;2016;07;10;Perjantai;3;1;4
94;01.07.2016;2016;07;11;Perjantai;1;4;5
94;01.07.2016;2016;07;12;Perjantai;3;4;7
94;01.07.2016;2016;07;13;Perjantai;6;5;11
94;01.07.2016;2016;07;14;Perjantai;2;19;21
94;01.07.2016;2016;07;15;Perjantai;6;14;20
94;01.07.2016;2016;07;16;Perjantai;4;18;22
94;01.07.2016;2016;07;17;Perjantai;1;6;7
94;01.07.2016;2016;07;18;Perjantai;7;6;13
94;01.07.2016;2016;07;19;Perjantai;10;8;18
94;01.07.2016;2016;07;20;Perjantai;6;5;11
94;01.07.2016;2016;07;21;Perjantai;5;8;13
94;01.07.2016;2016;07;22;Perjantai;2;4;6
94;01.07.2016;2016;07;23;Perjantai;3;2;5
94;02.07.2016;2016;07;00;Lauantai;2;0;2
94;02.07.2016;2016;07;01;Lauantai;0;0;0
94;02.07.2016;2016;07;02;Lauantai;0;1;1
94;02.07.2016;2016;07;03;Lauantai;0;0;0
94;02.07.2016;2016;07;04;Lauantai;1;0;1
94;02.07.2016;2016;07;05;Lauantai;1;2;3
94;02.07.2016;2016;07;06;Lauantai;1;1;2
94;02.07.2016;2016;07;07;Lauantai;1;0;1
94;02.07.2016;2016;07;08;Lauantai;3;13;16
94;02.07.2016;2016;07;09;Lauantai;5;0;5
94;02.07.2016;2016;07;10;Lauantai;17;14;31
94;02.07.2016;2016;07;11;Lauantai;10;5;15
94;02.07.2016;2016;07;12;Lauantai;17;7;24
94;02.07.2016;2016;07;13;Lauantai;16;11;27
94;02.07.2016;2016;07;14;Lauantai;15;11;26
94;02.07.2016;2016;07;15;Lauantai;14;11;25
94;02.07.2016;2016;07;16;Lauantai;4;7;11
94;02.07.2016;2016;07;17;Lauantai;9;7;16
94;02.07.2016;2016;07;18;Lauantai;2;11;13
94;02.07.2016;2016;07;19;Lauantai;9;8;17
94;02.07.2016;2016;07;20;Lauantai;5;7;12
94;02.07.2016;2016;07;21;Lauantai;7;7;14
94;02.07.2016;2016;07;22;Lauantai;0;4;4
94;02.07.2016;2016;07;23;Lauantai;2;0;2
94;03.07.2016;2016;07;00;Sunnuntai;1;0;1
94;03.07.2016;2016;07;01;Sunnuntai;2;2;4
94;03.07.2016;2016;07;02;Sunnuntai;0;0;0
94;03.07.2016;2016;07;03;Sunnuntai;1;0;1
94;03.07.2016;2016;07;04;Sunnuntai;0;0;0
94;03.07.2016;2016;07;05;Sunnuntai;0;0;0
94;03.07.2016;2016;07;06;Sunnuntai;0;1;1
94;03.07.2016;2016;07;07;Sunnuntai;1;1;2
94;03.07.2016;2016;07;08;Sunnuntai;1;6;7
94;03.07.2016;2016;07;09;Sunnuntai;3;3;6
94;03.07.2016;2016;07;10;Sunnuntai;2;2;4
94;03.07.2016;2016;07;11;Sunnuntai;8;0;8
94;03.07.2016;2016;07;12;Sunnuntai;2;0;2
94;03.07.2016;2016;07;13;Sunnuntai;3;6;9
94;03.07.2016;2016;07;14;Sunnuntai;0;4;4
94;03.07.2016;2016;07;15;Sunnuntai;2;2;4
94;03.07.2016;2016;07;16;Sunnuntai;2;5;7
94;03.07.2016;2016;07;17;Sunnuntai;9;7;16
94;03.07.2016;2016;07;18;Sunnuntai;15;10;25
94;03.07.2016;2016;07;19;Sunnuntai;10;8;18
94;03.07.2016;2016;07;20;Sunnuntai;10;7;17
94;03.07.2016;2016;07;21;Sunnuntai;4;6;10
94;03.07.2016;2016;07;22;Sunnuntai;1;2;3
94;03.07.2016;2016;07;23;Sunnuntai;0;0;0
94;04.07.2016;2016;07;00;Maanantai;1;0;1
94;04.07.2016;2016;07;01;Maanantai;0;0;0
94;04.07.2016;2016;07;02;Maanantai;0;0;0
94;04.07.2016;2016;07;03;Maanantai;0;0;0
94;04.07.2016;2016;07;04;Maanantai;0;0;0
94;04.07.2016;2016;07;05;Maanantai;6;3;9
94;04.07.2016;2016;07;06;Maanantai;12;2;14
94;04.07.2016;2016;07;07;Maanantai;10;1;11
94;04.07.2016;2016;07;08;Maanantai;8;1;9
94;04.07.2016;2016;07;09;Maanantai;1;1;2
94;04.07.2016;2016;07;10;Maanantai;1;0;1
94;04.07.2016;2016;07;11;Maanantai;5;3;8
94;04.07.2016;2016;07;12;Maanantai;2;2;4
94;04.07.2016;2016;07;13;Maanantai;0;1;1
94;04.07.2016;2016;07;14;Maanantai;5;6;11
94;04.07.2016;2016;07;15;Maanantai;3;13;16
94;04.07.2016;2016;07;16;Maanantai;3;14;17
94;04.07.2016;2016;07;17;Maanantai;6;11;17
94;04.07.2016;2016;07;18;Maanantai;4;6;10
94;04.07.2016;2016;07;19;Maanantai;2;5;7
94;04.07.2016;2016;07;20;Maanantai;3;3;6
94;04.07.2016;2016;07;21;Maanantai;1;4;5
94;04.07.2016;2016;07;22;Maanantai;0;1;1
94;04.07.2016;2016;07;23;Maanantai;0;0;0
94;05.07.2016;2016;07;00;Tiistai;0;1;1
94;05.07.2016;2016;07;01;Tiistai;0;0;0
94;05.07.2016;2016;07;02;Tiistai;0;0;0
94;05.07.2016;2016;07;03;Tiistai;0;0;0
94;05.07.2016;2016;07;04;Tiistai;0;0;0
94;05.07.2016;2016;07;05;Tiistai;4;1;5
94;05.07.2016;2016;07;06;Tiistai;10;2;12
94;05.07.2016;2016;07;07;Tiistai;10;1;11
94;05.07.2016;2016;07;08;Tiistai;4;1;5
94;05.07.2016;2016;07;09;Tiistai;6;1;7
94;05.07.2016;2016;07;10;Tiistai;2;2;4
94;05.07.2016;2016;07;11;Tiistai;8;3;11
94;05.07.2016;2016;07;12;Tiistai;8;2;10
94;05.07.2016;2016;07;13;Tiistai;3;6;9
94;05.07.2016;2016;07;14;Tiistai;2;12;14
94;05.07.2016;2016;07;15;Tiistai;4;14;18
94;05.07.2016;2016;07;16;Tiistai;5;9;14
94;05.07.2016;2016;07;17;Tiistai;0;3;3
94;05.07.2016;2016;07;18;Tiistai;2;1;3
94;05.07.2016;2016;07;19;Tiistai;2;3;5
94;05.07.2016;2016;07;20;Tiistai;2;7;9
94;05.07.2016;2016;07;21;Tiistai;0;3;3
94;05.07.2016;2016;07;22;Tiistai;2;0;2
94;05.07.2016;2016;07;23;Tiistai;3;1;4
94;06.07.2016;2016;07;00;Keskiviikko;0;0;0
94;06.07.2016;2016;07;01;Keskiviikko;0;0;0
94;06.07.2016;2016;07;02;Keskiviikko;0;0;0
94;06.07.2016;2016;07;03;Keskiviikko;0;0;0
94;06.07.2016;2016;07;04;Keskiviikko;0;0;0
94;06.07.2016;2016;07;05;Keskiviikko;7;2;9
94;06.07.2016;2016;07;06;Keskiviikko;9;1;10
94;06.07.2016;2016;07;07;Keskiviikko;3;1;4
94;06.07.2016;2016;07;08;Keskiviikko;2;0;2
94;06.07.2016;2016;07;09;Keskiviikko;0;0;0
94;06.07.2016;2016;07;10;Keskiviikko;3;1;4
94;06.07.2016;2016;07;11;Keskiviikko;4;5;9
94;06.07.2016;2016;07;12;Keskiviikko;10;3;13
94;06.07.2016;2016;07;13;Keskiviikko;5;5;10
94;06.07.2016;2016;07;14;Keskiviikko;4;8;12
94;06.07.2016;2016;07;15;Keskiviikko;6;5;11
94;06.07.2016;2016;07;16;Keskiviikko;7;10;17
94;06.07.2016;2016;07;17;Keskiviikko;4;7;11
94;06.07.2016;2016;07;18;Keskiviikko;0;5;5
94;06.07.2016;2016;07;19;Keskiviikko;7;1;8
94;06.07.2016;2016;07;20;Keskiviikko;4;4;8
94;06.07.2016;2016;07;21;Keskiviikko;0;4;4
94;06.07.2016;2016;07;22;Keskiviikko;2;1;3
94;06.07.2016;2016;07;23;Keskiviikko;1;2;3
94;07.07.2016;2016;07;00;Torstai;0;0;0
94;07.07.2016;2016;07;01;Torstai;1;0;1
94;07.07.2016;2016;07;02;Torstai;0;0;0
94;07.07.2016;2016;07;03;Torstai;0;0;0
94;07.07.2016;2016;07;04;Torstai;0;2;2
94;07.07.2016;2016;07;05;Torstai;7;3;10
94;07.07.2016;2016;07;06;Torstai;10;1;11
94;07.07.2016;2016;07;07;Torstai;13;6;19
94;07.07.2016;2016;07;08;Torstai;6;2;8
94;07.07.2016;2016;07;09;Torstai;2;0;2
94;07.07.2016;2016;07;10;Torstai;1;3;4
94;07.07.2016;2016;07;11;Torstai;1;1;2
94;07.07.2016;2016;07;12;Torstai;3;3;6
94;07.07.2016;2016;07;13;Torstai;4;1;5
94;07.07.2016;2016;07;14;Torstai;3;3;6
94;07.07.2016;2016;07;15;Torstai;5;13;18
94;07.07.2016;2016;07;16;Torstai;2;13;15
94;07.07.2016;2016;07;17;Torstai;1;2;3
94;07.07.2016;2016;07;18;Torstai;6;7;13
94;07.07.2016;2016;07;19;Torstai;6;10;16
94;07.07.2016;2016;07;20;Torstai;6;4;10
94;07.07.2016;2016;07;21;Torstai;9;7;16
94;07.07.2016;2016;07;22;Torstai;0;2;2
94;07.07.2016;2016;07;23;Torstai;1;0;1
94;08.07.2016;2016;07;00;Perjantai;2;0;2
94;08.07.2016;2016;07;01;Perjantai;1;0;1
94;08.07.2016;2016;07;02;Perjantai;0;1;1
94;08.07.2016;2016;07;03;Perjantai;0;0;0
94;08.07.2016;2016;07;04;Perjantai;0;0;0
94;08.07.2016;2016;07;05;Perjantai;4;2;6
94;08.07.2016;2016;07;06;Perjantai;11;5;16
94;08.07.2016;2016;07;07;Perjantai;10;2;12
94;08.07.2016;2016;07;08;Perjantai;2;1;3
94;08.07.2016;2016;07;09;Perjantai;1;3;4
94;08.07.2016;2016;07;10;Perjantai;7;7;14
94;08.07.2016;2016;07;11;Perjantai;11;13;24
94;08.07.2016;2016;07;12;Perjantai;11;7;18
94;08.07.2016;2016;07;13;Perjantai;6;9;15
94;08.07.2016;2016;07;14;Perjantai;8;8;16
94;08.07.2016;2016;07;15;Perjantai;7;24;31
94;08.07.2016;2016;07;16;Perjantai;6;15;21
94;08.07.2016;2016;07;17;Perjantai;17;6;23
94;08.07.2016;2016;07;18;Perjantai;4;5;9
94;08.07.2016;2016;07;19;Perjantai;7;7;14
94;08.07.2016;2016;07;20;Perjantai;4;7;11
94;08.07.2016;2016;07;21;Perjantai;3;5;8
94;08.07.2016;2016;07;22;Perjantai;5;4;9
94;08.07.2016;2016;07;23;Perjantai;1;8;9
94;09.07.2016;2016;07;00;Lauantai;2;1;3
94;09.07.2016;2016;07;01;Lauantai;0;1;1
94;09.07.2016;2016;07;02;Lauantai;0;1;1
94;09.07.2016;2016;07;03;Lauantai;0;0;0
94;09.07.2016;2016;07;04;Lauantai;3;1;4
94;09.07.2016;2016;07;05;Lauantai;1;1;2
94;09.07.2016;2016;07;06;Lauantai;1;0;1
94;09.07.2016;2016;07;07;Lauantai;2;1;3
94;09.07.2016;2016;07;08;Lauantai;1;2;3
94;09.07.2016;2016;07;09;Lauantai;5;3;8
94;09.07.2016;2016;07;10;Lauantai;7;4;11
94;09.07.2016;2016;07;11;Lauantai;6;3;9
94;09.07.2016;2016;07;12;Lauantai;8;7;15
94;09.07.2016;2016;07;13;Lauantai;10;7;17
94;09.07.2016;2016;07;14;Lauantai;9;13;22
94;09.07.2016;2016;07;15;Lauantai;9;9;18
94;09.07.2016;2016;07;16;Lauantai;7;9;16
94;09.07.2016;2016;07;17;Lauantai;5;3;8
94;09.07.2016;2016;07;18;Lauantai;9;11;20
94;09.07.2016;2016;07;19;Lauantai;2;6;8
94;09.07.2016;2016;07;20;Lauantai;4;6;10
94;09.07.2016;2016;07;21;Lauantai;3;4;7
94;09.07.2016;2016;07;22;Lauantai;5;3;8
94;09.07.2016;2016;07;23;Lauantai;0;0;0
94;10.07.2016;2016;07;00;Sunnuntai;0;0;0
94;10.07.2016;2016;07;01;Sunnuntai;0;4;4
94;10.07.2016;2016;07;02;Sunnuntai;0;2;2
94;10.07.2016;2016;07;03;Sunnuntai;0;1;1
94;10.07.2016;2016;07;04;Sunnuntai;0;1;1
94;10.07.2016;2016;07;05;Sunnuntai;3;0;3
94;10.07.2016;2016;07;06;Sunnuntai;1;0;1
94;10.07.2016;2016;07;07;Sunnuntai;1;3;4
94;10.07.2016;2016;07;08;Sunnuntai;0;0;0
94;10.07.2016;2016;07;09;Sunnuntai;1;9;10
94;10.07.2016;2016;07;10;Sunnuntai;10;12;22
94;10.07.2016;2016;07;11;Sunnuntai;8;11;19
94;10.07.2016;2016;07;12;Sunnuntai;15;9;24
94;10.07.2016;2016;07;13;Sunnuntai;12;14;26
94;10.07.2016;2016;07;14;Sunnuntai;14;11;25
94;10.07.2016;2016;07;15;Sunnuntai;19;11;30
94;10.07.2016;2016;07;16;Sunnuntai;14;13;27
94;10.07.2016;2016;07;17;Sunnuntai;15;14;29
94;10.07.2016;2016;07;18;Sunnuntai;10;6;16
94;10.07.2016;2016;07;19;Sunnuntai;12;10;22
94;10.07.2016;2016;07;20;Sunnuntai;7;9;16
94;10.07.2016;2016;07;21;Sunnuntai;2;12;14
94;10.07.2016;2016;07;22;Sunnuntai;8;5;13
94;10.07.2016;2016;07;23;Sunnuntai;0;2;2
94;11.07.2016;2016;07;00;Maanantai;0;2;2
94;11.07.2016;2016;07;01;Maanantai;0;2;2
94;11.07.2016;2016;07;02;Maanantai;0;1;1
94;11.07.2016;2016;07;03;Maanantai;0;0;0
94;11.07.2016;2016;07;04;Maanantai;0;0;0
94;11.07.2016;2016;07;05;Maanantai;2;4;6
94;11.07.2016;2016;07;06;Maanantai;12;4;16
94;11.07.2016;2016;07;07;Maanantai;17;3;20
94;11.07.2016;2016;07;08;Maanantai;10;1;11
94;11.07.2016;2016;07;09;Maanantai;6;11;17
94;11.07.2016;2016;07;10;Maanantai;11;9;20
94;11.07.2016;2016;07;11;Maanantai;11;11;22
94;11.07.2016;2016;07;12;Maanantai;8;15;23
94;11.07.2016;2016;07;13;Maanantai;19;10;29
94;11.07.2016;2016;07;14;Maanantai;14;13;27
94;11.07.2016;2016;07;15;Maanantai;19;22;41
94;11.07.2016;2016;07;16;Maanantai;13;29;42
94;11.07.2016;2016;07;17;Maanantai;16;23;39
94;11.07.2016;2016;07;18;Maanantai;7;8;15
94;11.07.2016;2016;07;19;Maanantai;15;7;22
94;11.07.2016;2016;07;20;Maanantai;12;19;31
94;11.07.2016;2016;07;21;Maanantai;7;8;15
94;11.07.2016;2016;07;22;Maanantai;6;5;11
94;11.07.2016;2016;07;23;Maanantai;1;4;5
94;12.07.2016;2016;07;00;Tiistai;1;0;1
94;12.07.2016;2016;07;01;Tiistai;1;0;1
94;12.07.2016;2016;07;02;Tiistai;0;0;0
94;12.07.2016;2016;07;03;Tiistai;0;1;1
94;12.07.2016;2016;07;04;Tiistai;0;1;1
94;12.07.2016;2016;07;05;Tiistai;5;2;7
94;12.07.2016;2016;07;06;Tiistai;14;6;20
94;12.07.2016;2016;07;07;Tiistai;24;1;25
94;12.07.2016;2016;07;08;Tiistai;13;3;16
94;12.07.2016;2016;07;09;Tiistai;7;9;16
94;12.07.2016;2016;07;10;Tiistai;6;7;13
94;12.07.2016;2016;07;11;Tiistai;7;10;17
94;12.07.2016;2016;07;12;Tiistai;7;7;14
94;12.07.2016;2016;07;13;Tiistai;19;8;27
94;12.07.2016;2016;07;14;Tiistai;12;24;36
94;12.07.2016;2016;07;15;Tiistai;9;31;40
94;12.07.2016;2016;07;16;Tiistai;8;26;34
94;12.07.2016;2016;07;17;Tiistai;9;15;24
94;12.07.2016;2016;07;18;Tiistai;11;18;29
94;12.07.2016;2016;07;19;Tiistai;6;13;19
94;12.07.2016;2016;07;20;Tiistai;16;13;29
94;12.07.2016;2016;07;21;Tiistai;10;12;22
94;12.07.2016;2016;07;22;Tiistai;5;3;8
94;12.07.2016;2016;07;23;Tiistai;2;1;3
94;13.07.2016;2016;07;00;Keskiviikko;1;1;2
94;13.07.2016;2016;07;01;Keskiviikko;1;1;2
94;13.07.2016;2016;07;02;Keskiviikko;1;0;1
94;13.07.2016;2016;07;03;Keskiviikko;1;0;1
94;13.07.2016;2016;07;04;Keskiviikko;0;0;0
94;13.07.2016;2016;07;05;Keskiviikko;3;1;4
94;13.07.2016;2016;07;06;Keskiviikko;15;4;19
94;13.07.2016;2016;07;07;Keskiviikko;20;3;23
94;13.07.2016;2016;07;08;Keskiviikko;5;0;5
94;13.07.2016;2016;07;09;Keskiviikko;7;3;10
94;13.07.2016;2016;07;10;Keskiviikko;4;1;5
94;13.07.2016;2016;07;11;Keskiviikko;3;5;8
94;13.07.2016;2016;07;12;Keskiviikko;23;6;29
94;13.07.2016;2016;07;13;Keskiviikko;12;10;22
94;13.07.2016;2016;07;14;Keskiviikko;10;13;23
94;13.07.2016;2016;07;15;Keskiviikko;13;24;37
94;13.07.2016;2016;07;16;Keskiviikko;14;28;42
94;13.07.2016;2016;07;17;Keskiviikko;14;9;23
94;13.07.2016;2016;07;18;Keskiviikko;10;25;35
94;13.07.2016;2016;07;19;Keskiviikko;18;15;33
94;13.07.2016;2016;07;20;Keskiviikko;10;15;25
94;13.07.2016;2016;07;21;Keskiviikko;3;11;14
94;13.07.2016;2016;07;22;Keskiviikko;1;4;5
94;13.07.2016;2016;07;23;Keskiviikko;0;2;2
94;14.07.2016;2016;07;00;Torstai;0;3;3
94;14.07.2016;2016;07;01;Torstai;3;5;8
94;14.07.2016;2016;07;02;Torstai;1;2;3
94;14.07.2016;2016;07;03;Torstai;0;2;2
94;14.07.2016;2016;07;04;Torstai;0;0;0
94;14.07.2016;2016;07;05;Torstai;5;5;10
94;14.07.2016;2016;07;06;Torstai;12;6;18
94;14.07.2016;2016;07;07;Torstai;23;3;26
94;14.07.2016;2016;07;08;Torstai;7;5;12
94;14.07.2016;2016;07;09;Torstai;9;8;17
94;14.07.2016;2016;07;10;Torstai;8;8;16
94;14.07.2016;2016;07;11;Torstai;13;4;17
94;14.07.2016;2016;07;12;Torstai;18;11;29
94;14.07.2016;2016;07;13;Torstai;11;9;20
94;14.07.2016;2016;07;14;Torstai;7;11;18
94;14.07.2016;2016;07;15;Torstai;20;29;49
94;14.07.2016;2016;07;16;Torstai;13;30;43
94;14.07.2016;2016;07;17;Torstai;15;21;36
94;14.07.2016;2016;07;18;Torstai;14;23;37
94;14.07.2016;2016;07;19;Torstai;11;11;22
94;14.07.2016;2016;07;20;Torstai;10;12;22
94;14.07.2016;2016;07;21;Torstai;1;11;12
94;14.07.2016;2016;07;22;Torstai;6;6;12
94;14.07.2016;2016;07;23;Torstai;0;4;4
94;15.07.2016;2016;07;00;Perjantai;0;0;0
94;15.07.2016;2016;07;01;Perjantai;0;0;0
94;15.07.2016;2016;07;02;Perjantai;0;4;4
94;15.07.2016;2016;07;03;Perjantai;0;0;0
94;15.07.2016;2016;07;04;Perjantai;0;0;0
94;15.07.2016;2016;07;05;Perjantai;3;2;5
94;15.07.2016;2016;07;06;Perjantai;10;2;12
94;15.07.2016;2016;07;07;Perjantai;13;1;14
94;15.07.2016;2016;07;08;Perjantai;2;1;3
94;15.07.2016;2016;07;09;Perjantai;6;2;8
94;15.07.2016;2016;07;10;Perjantai;5;5;10
94;15.07.2016;2016;07;11;Perjantai;5;9;14
94;15.07.2016;2016;07;12;Perjantai;4;9;13
94;15.07.2016;2016;07;13;Perjantai;11;16;27
94;15.07.2016;2016;07;14;Perjantai;16;22;38
94;15.07.2016;2016;07;15;Perjantai;8;11;19
94;15.07.2016;2016;07;16;Perjantai;7;10;17
94;15.07.2016;2016;07;17;Perjantai;4;10;14
94;15.07.2016;2016;07;18;Perjantai;4;2;6
94;15.07.2016;2016;07;19;Perjantai;8;6;14
94;15.07.2016;2016;07;20;Perjantai;5;11;16
94;15.07.2016;2016;07;21;Perjantai;5;5;10
94;15.07.2016;2016;07;22;Perjantai;5;8;13
94;15.07.2016;2016;07;23;Perjantai;4;2;6
94;16.07.2016;2016;07;00;Lauantai;0;0;0
94;16.07.2016;2016;07;01;Lauantai;1;0;1
94;16.07.2016;2016;07;02;Lauantai;2;3;5
94;16.07.2016;2016;07;03;Lauantai;0;4;4
94;16.07.2016;2016;07;04;Lauantai;0;1;1
94;16.07.2016;2016;07;05;Lauantai;2;0;2
94;16.07.2016;2016;07;06;Lauantai;1;0;1
94;16.07.2016;2016;07;07;Lauantai;1;2;3
94;16.07.2016;2016;07;08;Lauantai;2;0;2
94;16.07.2016;2016;07;09;Lauantai;1;1;2
94;16.07.2016;2016;07;10;Lauantai;1;1;2
94;16.07.2016;2016;07;11;Lauantai;2;1;3
94;16.07.2016;2016;07;12;Lauantai;3;4;7
94;16.07.2016;2016;07;13;Lauantai;1;2;3
94;16.07.2016;2016;07;14;Lauantai;2;5;7
94;16.07.2016;2016;07;15;Lauantai;0;3;3
94;16.07.2016;2016;07;16;Lauantai;5;1;6
94;16.07.2016;2016;07;17;Lauantai;3;3;6
94;16.07.2016;2016;07;18;Lauantai;5;7;12
94;16.07.2016;2016;07;19;Lauantai;9;6;15
94;16.07.2016;2016;07;20;Lauantai;9;12;21
94;16.07.2016;2016;07;21;Lauantai;2;0;2
94;16.07.2016;2016;07;22;Lauantai;8;2;10
94;16.07.2016;2016;07;23;Lauantai;3;0;3
94;17.07.2016;2016;07;00;Sunnuntai;3;3;6
94;17.07.2016;2016;07;01;Sunnuntai;0;2;2
94;17.07.2016;2016;07;02;Sunnuntai;2;0;2
94;17.07.2016;2016;07;03;Sunnuntai;0;3;3
94;17.07.2016;2016;07;04;Sunnuntai;0;0;0
94;17.07.2016;2016;07;05;Sunnuntai;1;0;1
94;17.07.2016;2016;07;06;Sunnuntai;2;1;3
94;17.07.2016;2016;07;07;Sunnuntai;3;4;7
94;17.07.2016;2016;07;08;Sunnuntai;2;0;2
94;17.07.2016;2016;07;09;Sunnuntai;2;5;7
94;17.07.2016;2016;07;10;Sunnuntai;2;7;9
94;17.07.2016;2016;07;11;Sunnuntai;8;5;13
94;17.07.2016;2016;07;12;Sunnuntai;13;5;18
94;17.07.2016;2016;07;13;Sunnuntai;7;2;9
94;17.07.2016;2016;07;14;Sunnuntai;3;4;7
94;17.07.2016;2016;07;15;Sunnuntai;5;7;12
94;17.07.2016;2016;07;16;Sunnuntai;4;0;4
94;17.07.2016;2016;07;17;Sunnuntai;3;1;4
94;17.07.2016;2016;07;18;Sunnuntai;5;8;13
94;17.07.2016;2016;07;19;Sunnuntai;4;2;6
94;17.07.2016;2016;07;20;Sunnuntai;5;6;11
94;17.07.2016;2016;07;21;Sunnuntai;4;7;11
94;17.07.2016;2016;07;22;Sunnuntai;2;3;5
94;17.07.2016;2016;07;23;Sunnuntai;0;3;3
94;18.07.2016;2016;07;00;Maanantai;1;4;5
94;18.07.2016;2016;07;01;Maanantai;0;0;0
94;18.07.2016;2016;07;02;Maanantai;0;0;0
94;18.07.2016;2016;07;03;Maanantai;0;0;0
94;18.07.2016;2016;07;04;Maanantai;2;0;2
94;18.07.2016;2016;07;05;Maanantai;4;1;5
94;18.07.2016;2016;07;06;Maanantai;13;2;15
94;18.07.2016;2016;07;07;Maanantai;16;3;19
94;18.07.2016;2016;07;08;Maanantai;8;1;9
94;18.07.2016;2016;07;09;Maanantai;9;8;17
94;18.07.2016;2016;07;10;Maanantai;6;6;12
94;18.07.2016;2016;07;11;Maanantai;9;8;17
94;18.07.2016;2016;07;12;Maanantai;17;1;18
94;18.07.2016;2016;07;13;Maanantai;16;12;28
94;18.07.2016;2016;07;14;Maanantai;10;13;23
94;18.07.2016;2016;07;15;Maanantai;13;23;36
94;18.07.2016;2016;07;16;Maanantai;4;29;33
94;18.07.2016;2016;07;17;Maanantai;8;27;35
94;18.07.2016;2016;07;18;Maanantai;6;10;16
94;18.07.2016;2016;07;19;Maanantai;15;13;28
94;18.07.2016;2016;07;20;Maanantai;5;5;10
94;18.07.2016;2016;07;21;Maanantai;7;8;15
94;18.07.2016;2016;07;22;Maanantai;4;7;11
94;18.07.2016;2016;07;23;Maanantai;1;4;5
94;19.07.2016;2016;07;00;Tiistai;2;2;4
94;19.07.2016;2016;07;01;Tiistai;0;0;0
94;19.07.2016;2016;07;02;Tiistai;1;6;7
94;19.07.2016;2016;07;03;Tiistai;0;1;1
94;19.07.2016;2016;07;04;Tiistai;0;3;3
94;19.07.2016;2016;07;05;Tiistai;4;2;6
94;19.07.2016;2016;07;06;Tiistai;19;3;22
94;19.07.2016;2016;07;07;Tiistai;22;1;23
94;19.07.2016;2016;07;08;Tiistai;9;5;14
94;19.07.2016;2016;07;09;Tiistai;12;1;13
94;19.07.2016;2016;07;10;Tiistai;13;4;17
94;19.07.2016;2016;07;11;Tiistai;10;7;17
94;19.07.2016;2016;07;12;Tiistai;11;11;22
94;19.07.2016;2016;07;13;Tiistai;17;12;29
94;19.07.2016;2016;07;14;Tiistai;8;18;26
94;19.07.2016;2016;07;15;Tiistai;11;31;42
94;19.07.2016;2016;07;16;Tiistai;9;31;40
94;19.07.2016;2016;07;17;Tiistai;7;16;23
94;19.07.2016;2016;07;18;Tiistai;7;12;19
94;19.07.2016;2016;07;19;Tiistai;12;11;23
94;19.07.2016;2016;07;20;Tiistai;10;15;25
94;19.07.2016;2016;07;21;Tiistai;6;9;15
94;19.07.2016;2016;07;22;Tiistai;2;9;11
94;19.07.2016;2016;07;23;Tiistai;3;2;5
94;20.07.2016;2016;07;00;Keskiviikko;1;0;1
94;20.07.2016;2016;07;01;Keskiviikko;2;0;2
94;20.07.2016;2016;07;02;Keskiviikko;0;4;4
94;20.07.2016;2016;07;03;Keskiviikko;0;1;1
94;20.07.2016;2016;07;04;Keskiviikko;1;2;3
94;20.07.2016;2016;07;05;Keskiviikko;4;2;6
94;20.07.2016;2016;07;06;Keskiviikko;15;3;18
94;20.07.2016;2016;07;07;Keskiviikko;19;3;22
94;20.07.2016;2016;07;08;Keskiviikko;6;1;7
94;20.07.2016;2016;07;09;Keskiviikko;6;6;12
94;20.07.2016;2016;07;10;Keskiviikko;13;7;20
94;20.07.2016;2016;07;11;Keskiviikko;16;8;24
94;20.07.2016;2016;07;12;Keskiviikko;13;14;27
94;20.07.2016;2016;07;13;Keskiviikko;11;18;29
94;20.07.2016;2016;07;14;Keskiviikko;7;17;24
94;20.07.2016;2016;07;15;Keskiviikko;17;31;48
94;20.07.2016;2016;07;16;Keskiviikko;28;21;49
94;20.07.2016;2016;07;17;Keskiviikko;30;23;53
94;20.07.2016;2016;07;18;Keskiviikko;13;17;30
94;20.07.2016;2016;07;19;Keskiviikko;15;22;37
94;20.07.2016;2016;07;20;Keskiviikko;15;20;35
94;20.07.2016;2016;07;21;Keskiviikko;6;13;19
94;20.07.2016;2016;07;22;Keskiviikko;10;5;15
94;20.07.2016;2016;07;23;Keskiviikko;1;7;8
94;21.07.2016;2016;07;00;Torstai;7;10;17
94;21.07.2016;2016;07;01;Torstai;0;3;3
94;21.07.2016;2016;07;02;Torstai;0;2;2
94;21.07.2016;2016;07;03;Torstai;0;1;1
94;21.07.2016;2016;07;04;Torstai;0;1;1
94;21.07.2016;2016;07;05;Torstai;2;1;3
94;21.07.2016;2016;07;06;Torstai;14;3;17
94;21.07.2016;2016;07;07;Torstai;20;2;22
94;21.07.2016;2016;07;08;Torstai;10;3;13
94;21.07.2016;2016;07;09;Torstai;7;6;13
94;21.07.2016;2016;07;10;Torstai;19;7;26
94;21.07.2016;2016;07;11;Torstai;12;10;22
94;21.07.2016;2016;07;12;Torstai;13;12;25
94;21.07.2016;2016;07;13;Torstai;12;6;18
94;21.07.2016;2016;07;14;Torstai;10;12;22
94;21.07.2016;2016;07;15;Torstai;14;23;37
94;21.07.2016;2016;07;16;Torstai;12;29;41
94;21.07.2016;2016;07;17;Torstai;21;19;40
94;21.07.2016;2016;07;18;Torstai;14;13;27
94;21.07.2016;2016;07;19;Torstai;11;15;26
94;21.07.2016;2016;07;20;Torstai;10;6;16
94;21.07.2016;2016;07;21;Torstai;8;10;18
94;21.07.2016;2016;07;22;Torstai;3;7;10
94;21.07.2016;2016;07;23;Torstai;6;2;8
94;22.07.2016;2016;07;00;Perjantai;0;2;2
94;22.07.2016;2016;07;01;Perjantai;0;2;2
94;22.07.2016;2016;07;02;Perjantai;0;0;0
94;22.07.2016;2016;07;03;Perjantai;0;3;3
94;22.07.2016;2016;07;04;Perjantai;1;0;1
94;22.07.2016;2016;07;05;Perjantai;2;2;4
94;22.07.2016;2016;07;06;Perjantai;14;5;19
94;22.07.2016;2016;07;07;Perjantai;17;1;18
94;22.07.2016;2016;07;08;Perjantai;5;4;9
94;22.07.2016;2016;07;09;Perjantai;8;7;15
94;22.07.2016;2016;07;10;Perjantai;8;10;18
94;22.07.2016;2016;07;11;Perjantai;22;21;43
94;22.07.2016;2016;07;12;Perjantai;15;8;23
94;22.07.2016;2016;07;13;Perjantai;19;12;31
94;22.07.2016;2016;07;14;Perjantai;9;19;28
94;22.07.2016;2016;07;15;Perjantai;10;24;34
94;22.07.2016;2016;07;16;Perjantai;22;19;41
94;22.07.2016;2016;07;17;Perjantai;12;16;28
94;22.07.2016;2016;07;18;Perjantai;14;19;33
94;22.07.2016;2016;07;19;Perjantai;9;15;24
94;22.07.2016;2016;07;20;Perjantai;10;13;23
94;22.07.2016;2016;07;21;Perjantai;17;9;26
94;22.07.2016;2016;07;22;Perjantai;11;14;25
94;22.07.2016;2016;07;23;Perjantai;6;4;10
94;23.07.2016;2016;07;00;Lauantai;2;4;6
94;23.07.2016;2016;07;01;Lauantai;1;6;7
94;23.07.2016;2016;07;02;Lauantai;0;2;2
94;23.07.2016;2016;07;03;Lauantai;0;0;0
94;23.07.2016;2016;07;04;Lauantai;0;1;1
94;23.07.2016;2016;07;05;Lauantai;0;0;0
94;23.07.2016;2016;07;06;Lauantai;2;3;5
94;23.07.2016;2016;07;07;Lauantai;0;4;4
94;23.07.2016;2016;07;08;Lauantai;3;11;14
94;23.07.2016;2016;07;09;Lauantai;6;2;8
94;23.07.2016;2016;07;10;Lauantai;8;7;15
94;23.07.2016;2016;07;11;Lauantai;24;8;32
94;23.07.2016;2016;07;12;Lauantai;16;13;29
94;23.07.2016;2016;07;13;Lauantai;11;9;20
94;23.07.2016;2016;07;14;Lauantai;14;17;31
94;23.07.2016;2016;07;15;Lauantai;22;20;42
94;23.07.2016;2016;07;16;Lauantai;16;9;25
94;23.07.2016;2016;07;17;Lauantai;12;26;38
94;23.07.2016;2016;07;18;Lauantai;23;10;33
94;23.07.2016;2016;07;19;Lauantai;15;7;22
94;23.07.2016;2016;07;20;Lauantai;18;6;24
94;23.07.2016;2016;07;21;Lauantai;5;16;21
94;23.07.2016;2016;07;22;Lauantai;0;12;12
94;23.07.2016;2016;07;23;Lauantai;0;7;7
94;24.07.2016;2016;07;00;Sunnuntai;1;3;4
94;24.07.2016;2016;07;01;Sunnuntai;0;2;2
94;24.07.2016;2016;07;02;Sunnuntai;0;1;1
94;24.07.2016;2016;07;03;Sunnuntai;0;2;2
94;24.07.2016;2016;07;04;Sunnuntai;0;0;0
94;24.07.2016;2016;07;05;Sunnuntai;0;0;0
94;24.07.2016;2016;07;06;Sunnuntai;1;2;3
94;24.07.2016;2016;07;07;Sunnuntai;3;2;5
94;24.07.2016;2016;07;08;Sunnuntai;6;2;8
94;24.07.2016;2016;07;09;Sunnuntai;8;8;16
94;24.07.2016;2016;07;10;Sunnuntai;2;9;11
94;24.07.2016;2016;07;11;Sunnuntai;25;12;37
94;24.07.2016;2016;07;12;Sunnuntai;33;17;50
94;24.07.2016;2016;07;13;Sunnuntai;10;14;24
94;24.07.2016;2016;07;14;Sunnuntai;13;15;28
94;24.07.2016;2016;07;15;Sunnuntai;12;18;30
94;24.07.2016;2016;07;16;Sunnuntai;11;14;25
94;24.07.2016;2016;07;17;Sunnuntai;13;11;24
94;24.07.2016;2016;07;18;Sunnuntai;14;22;36
94;24.07.2016;2016;07;19;Sunnuntai;14;15;29
94;24.07.2016;2016;07;20;Sunnuntai;8;8;16
94;24.07.2016;2016;07;21;Sunnuntai;11;7;18
94;24.07.2016;2016;07;22;Sunnuntai;2;2;4
94;24.07.2016;2016;07;23;Sunnuntai;0;2;2
94;25.07.2016;2016;07;00;Maanantai;0;0;0
94;25.07.2016;2016;07;01;Maanantai;0;4;4
94;25.07.2016;2016;07;02;Maanantai;0;0;0
94;25.07.2016;2016;07;03;Maanantai;0;2;2
94;25.07.2016;2016;07;04;Maanantai;1;0;1
94;25.07.2016;2016;07;05;Maanantai;4;2;6
94;25.07.2016;2016;07;06;Maanantai;15;6;21
94;25.07.2016;2016;07;07;Maanantai;20;4;24
94;25.07.2016;2016;07;08;Maanantai;7;4;11
94;25.07.2016;2016;07;09;Maanantai;5;2;7
94;25.07.2016;2016;07;10;Maanantai;6;12;18
94;25.07.2016;2016;07;11;Maanantai;16;14;30
94;25.07.2016;2016;07;12;Maanantai;22;5;27
94;25.07.2016;2016;07;13;Maanantai;14;12;26
94;25.07.2016;2016;07;14;Maanantai;11;19;30
94;25.07.2016;2016;07;15;Maanantai;21;34;55
94;25.07.2016;2016;07;16;Maanantai;12;32;44
94;25.07.2016;2016;07;17;Maanantai;20;16;36
94;25.07.2016;2016;07;18;Maanantai;8;19;27
94;25.07.2016;2016;07;19;Maanantai;16;8;24
94;25.07.2016;2016;07;20;Maanantai;16;21;37
94;25.07.2016;2016;07;21;Maanantai;6;14;20
94;25.07.2016;2016;07;22;Maanantai;0;7;7
94;25.07.2016;2016;07;23;Maanantai;1;6;7
94;26.07.2016;2016;07;00;Tiistai;0;0;0
94;26.07.2016;2016;07;01;Tiistai;0;0;0
94;26.07.2016;2016;07;02;Tiistai;1;1;2
94;26.07.2016;2016;07;03;Tiistai;0;0;0
94;26.07.2016;2016;07;04;Tiistai;0;0;0
94;26.07.2016;2016;07;05;Tiistai;5;1;6
94;26.07.2016;2016;07;06;Tiistai;20;4;24
94;26.07.2016;2016;07;07;Tiistai;22;3;25
94;26.07.2016;2016;07;08;Tiistai;11;5;16
94;26.07.2016;2016;07;09;Tiistai;14;10;24
94;26.07.2016;2016;07;10;Tiistai;19;2;21
94;26.07.2016;2016;07;11;Tiistai;13;9;22
94;26.07.2016;2016;07;12;Tiistai;18;7;25
94;26.07.2016;2016;07;13;Tiistai;14;14;28
94;26.07.2016;2016;07;14;Tiistai;10;19;29
94;26.07.2016;2016;07;15;Tiistai;24;38;62
94;26.07.2016;2016;07;16;Tiistai;12;50;62
94;26.07.2016;2016;07;17;Tiistai;20;24;44
94;26.07.2016;2016;07;18;Tiistai;20;25;45
94;26.07.2016;2016;07;19;Tiistai;22;10;32
94;26.07.2016;2016;07;20;Tiistai;25;16;41
94;26.07.2016;2016;07;21;Tiistai;3;13;16
94;26.07.2016;2016;07;22;Tiistai;5;11;16
94;26.07.2016;2016;07;23;Tiistai;2;4;6
94;27.07.2016;2016;07;00;Keskiviikko;0;0;0
94;27.07.2016;2016;07;01;Keskiviikko;0;1;1
94;27.07.2016;2016;07;02;Keskiviikko;0;3;3
94;27.07.2016;2016;07;03;Keskiviikko;0;1;1
94;27.07.2016;2016;07;04;Keskiviikko;2;0;2
94;27.07.2016;2016;07;05;Keskiviikko;4;2;6
94;27.07.2016;2016;07;06;Keskiviikko;13;5;18
94;27.07.2016;2016;07;07;Keskiviikko;18;2;20
94;27.07.2016;2016;07;08;Keskiviikko;5;2;7
94;27.07.2016;2016;07;09;Keskiviikko;2;0;2
94;27.07.2016;2016;07;10;Keskiviikko;1;2;3
94;27.07.2016;2016;07;11;Keskiviikko;6;2;8
94;27.07.2016;2016;07;12;Keskiviikko;8;5;13
94;27.07.2016;2016;07;13;Keskiviikko;6;8;14
94;27.07.2016;2016;07;14;Keskiviikko;7;11;18
94;27.07.2016;2016;07;15;Keskiviikko;17;18;35
94;27.07.2016;2016;07;16;Keskiviikko;16;24;40
94;27.07.2016;2016;07;17;Keskiviikko;18;19;37
94;27.07.2016;2016;07;18;Keskiviikko;7;10;17
94;27.07.2016;2016;07;19;Keskiviikko;13;17;30
94;27.07.2016;2016;07;20;Keskiviikko;11;6;17
94;27.07.2016;2016;07;21;Keskiviikko;7;14;21
94;27.07.2016;2016;07;22;Keskiviikko;3;4;7
94;27.07.2016;2016;07;23;Keskiviikko;0;3;3
94;28.07.2016;2016;07;00;Torstai;0;1;1
94;28.07.2016;2016;07;01;Torstai;1;0;1
94;28.07.2016;2016;07;02;Torstai;0;3;3
94;28.07.2016;2016;07;03;Torstai;0;1;1
94;28.07.2016;2016;07;04;Torstai;0;1;1
94;28.07.2016;2016;07;05;Torstai;4;0;4
94;28.07.2016;2016;07;06;Torstai;17;4;21
94;28.07.2016;2016;07;07;Torstai;19;2;21
94;28.07.2016;2016;07;08;Torstai;9;5;14
94;28.07.2016;2016;07;09;Torstai;12;4;16
94;28.07.2016;2016;07;10;Torstai;9;8;17
94;28.07.2016;2016;07;11;Torstai;9;12;21
94;28.07.2016;2016;07;12;Torstai;7;13;20
94;28.07.2016;2016;07;13;Torstai;9;16;25
94;28.07.2016;2016;07;14;Torstai;15;24;39
94;28.07.2016;2016;07;15;Torstai;18;23;41
94;28.07.2016;2016;07;16;Torstai;17;28;45
94;28.07.2016;2016;07;17;Torstai;5;17;22
94;28.07.2016;2016;07;18;Torstai;7;15;22
94;28.07.2016;2016;07;19;Torstai;21;9;30
94;28.07.2016;2016;07;20;Torstai;17;12;29
94;28.07.2016;2016;07;21;Torstai;7;4;11
94;28.07.2016;2016;07;22;Torstai;6;3;9
94;28.07.2016;2016;07;23;Torstai;1;3;4
94;29.07.2016;2016;07;00;Perjantai;0;3;3
94;29.07.2016;2016;07;01;Perjantai;0;0;0
94;29.07.2016;2016;07;02;Perjantai;0;0;0
94;29.07.2016;2016;07;03;Perjantai;0;1;1
94;29.07.2016;2016;07;04;Perjantai;0;0;0
94;29.07.2016;2016;07;05;Perjantai;0;1;1
94;29.07.2016;2016;07;06;Perjantai;8;7;15
94;29.07.2016;2016;07;07;Perjantai;25;3;28
94;29.07.2016;2016;07;08;Perjantai;12;5;17
94;29.07.2016;2016;07;09;Perjantai;5;6;11
94;29.07.2016;2016;07;10;Perjantai;10;7;17
94;29.07.2016;2016;07;11;Perjantai;10;7;17
94;29.07.2016;2016;07;12;Perjantai;10;8;18
94;29.07.2016;2016;07;13;Perjantai;19;11;30
94;29.07.2016;2016;07;14;Perjantai;9;16;25
94;29.07.2016;2016;07;15;Perjantai;6;22;28
94;29.07.2016;2016;07;16;Perjantai;9;15;24
94;29.07.2016;2016;07;17;Perjantai;14;3;17
94;29.07.2016;2016;07;18;Perjantai;16;7;23
94;29.07.2016;2016;07;19;Perjantai;14;9;23
94;29.07.2016;2016;07;20;Perjantai;4;5;9
94;29.07.2016;2016;07;21;Perjantai;3;10;13
94;29.07.2016;2016;07;22;Perjantai;4;8;12
94;29.07.2016;2016;07;23;Perjantai;2;2;4
94;30.07.2016;2016;07;00;Lauantai;0;6;6
94;30.07.2016;2016;07;01;Lauantai;0;5;5
94;30.07.2016;2016;07;02;Lauantai;1;3;4
94;30.07.2016;2016;07;03;Lauantai;0;0;0
94;30.07.2016;2016;07;04;Lauantai;1;0;1
94;30.07.2016;2016;07;05;Lauantai;2;2;4
94;30.07.2016;2016;07;06;Lauantai;1;1;2
94;30.07.2016;2016;07;07;Lauantai;2;3;5
94;30.07.2016;2016;07;08;Lauantai;6;7;13
94;30.07.2016;2016;07;09;Lauantai;2;11;13
94;30.07.2016;2016;07;10;Lauantai;8;8;16
94;30.07.2016;2016;07;11;Lauantai;11;13;24
94;30.07.2016;2016;07;12;Lauantai;26;8;34
94;30.07.2016;2016;07;13;Lauantai;24;19;43
94;30.07.2016;2016;07;14;Lauantai;15;16;31
94;30.07.2016;2016;07;15;Lauantai;8;9;17
94;30.07.2016;2016;07;16;Lauantai;8;4;12
94;30.07.2016;2016;07;17;Lauantai;10;11;21
94;30.07.2016;2016;07;18;Lauantai;12;11;23
94;30.07.2016;2016;07;19;Lauantai;13;4;17
94;30.07.2016;2016;07;20;Lauantai;7;7;14
94;30.07.2016;2016;07;21;Lauantai;6;16;22
94;30.07.2016;2016;07;22;Lauantai;4;5;9
94;30.07.2016;2016;07;23;Lauantai;0;7;7
94;31.07.2016;2016;07;00;Sunnuntai;0;5;5
94;31.07.2016;2016;07;01;Sunnuntai;2;4;6
94;31.07.2016;2016;07;02;Sunnuntai;0;3;3
94;31.07.2016;2016;07;03;Sunnuntai;1;4;5
94;31.07.2016;2016;07;04;Sunnuntai;1;1;2
94;31.07.2016;2016;07;05;Sunnuntai;2;2;4
94;31.07.2016;2016;07;06;Sunnuntai;0;0;0
94;31.07.2016;2016;07;07;Sunnuntai;4;1;5
94;31.07.2016;2016;07;08;Sunnuntai;0;2;2
94;31.07.2016;2016;07;09;Sunnuntai;1;7;8
94;31.07.2016;2016;07;10;Sunnuntai;4;3;7
94;31.07.2016;2016;07;11;Sunnuntai;5;2;7
94;31.07.2016;2016;07;12;Sunnuntai;8;4;12
94;31.07.2016;2016;07;13;Sunnuntai;0;7;7
94;31.07.2016;2016;07;14;Sunnuntai;10;6;16
94;31.07.2016;2016;07;15;Sunnuntai;6;9;15
94;31.07.2016;2016;07;16;Sunnuntai;5;6;11
94;31.07.2016;2016;07;17;Sunnuntai;4;3;7
94;31.07.2016;2016;07;18;Sunnuntai;2;3;5
94;31.07.2016;2016;07;19;Sunnuntai;0;0;0
94;31.07.2016;2016;07;20;Sunnuntai;2;4;6
94;31.07.2016;2016;07;21;Sunnuntai;1;1;2
94;31.07.2016;2016;07;22;Sunnuntai;2;0;2
94;31.07.2016;2016;07;23;Sunnuntai;0;0;0
94;01.08.2016;2016;08;00;Maanantai;0;0;0
94;01.08.2016;2016;08;01;Maanantai;0;0;0
94;01.08.2016;2016;08;02;Maanantai;0;0;0
94;01.08.2016;2016;08;03;Maanantai;0;0;0
94;01.08.2016;2016;08;04;Maanantai;2;0;2
94;01.08.2016;2016;08;05;Maanantai;4;1;5
94;01.08.2016;2016;08;06;Maanantai;14;4;18
94;01.08.2016;2016;08;07;Maanantai;18;3;21
94;01.08.2016;2016;08;08;Maanantai;12;2;14
94;01.08.2016;2016;08;09;Maanantai;9;1;10
94;01.08.2016;2016;08;10;Maanantai;12;12;24
94;01.08.2016;2016;08;11;Maanantai;9;10;19
94;01.08.2016;2016;08;12;Maanantai;12;8;20
94;01.08.2016;2016;08;13;Maanantai;4;3;7
94;01.08.2016;2016;08;14;Maanantai;6;12;18
94;01.08.2016;2016;08;15;Maanantai;10;18;28
94;01.08.2016;2016;08;16;Maanantai;7;37;44
94;01.08.2016;2016;08;17;Maanantai;10;22;32
94;01.08.2016;2016;08;18;Maanantai;12;13;25
94;01.08.2016;2016;08;19;Maanantai;15;13;28
94;01.08.2016;2016;08;20;Maanantai;8;14;22
94;01.08.2016;2016;08;21;Maanantai;7;5;12
94;01.08.2016;2016;08;22;Maanantai;3;10;13
94;01.08.2016;2016;08;23;Maanantai;2;2;4
94;02.08.2016;2016;08;00;Tiistai;0;0;0
94;02.08.2016;2016;08;01;Tiistai;1;0;1
94;02.08.2016;2016;08;02;Tiistai;0;0;0
94;02.08.2016;2016;08;03;Tiistai;0;0;0
94;02.08.2016;2016;08;04;Tiistai;0;1;1
94;02.08.2016;2016;08;05;Tiistai;7;0;7
94;02.08.2016;2016;08;06;Tiistai;13;6;19
94;02.08.2016;2016;08;07;Tiistai;23;3;26
94;02.08.2016;2016;08;08;Tiistai;6;1;7
94;02.08.2016;2016;08;09;Tiistai;2;1;3
94;02.08.2016;2016;08;10;Tiistai;4;2;6
94;02.08.2016;2016;08;11;Tiistai;2;4;6
94;02.08.2016;2016;08;12;Tiistai;9;5;14
94;02.08.2016;2016;08;13;Tiistai;4;7;11
94;02.08.2016;2016;08;14;Tiistai;4;7;11
94;02.08.2016;2016;08;15;Tiistai;2;6;8
94;02.08.2016;2016;08;16;Tiistai;0;19;19
94;02.08.2016;2016;08;17;Tiistai;2;10;12
94;02.08.2016;2016;08;18;Tiistai;4;7;11
94;02.08.2016;2016;08;19;Tiistai;7;4;11
94;02.08.2016;2016;08;20;Tiistai;6;2;8
94;02.08.2016;2016;08;21;Tiistai;3;3;6
94;02.08.2016;2016;08;22;Tiistai;1;5;6
94;02.08.2016;2016;08;23;Tiistai;1;1;2
94;03.08.2016;2016;08;00;Keskiviikko;0;0;0
94;03.08.2016;2016;08;01;Keskiviikko;0;0;0
94;03.08.2016;2016;08;02;Keskiviikko;0;0;0
94;03.08.2016;2016;08;03;Keskiviikko;0;0;0
94;03.08.2016;2016;08;04;Keskiviikko;1;0;1
94;03.08.2016;2016;08;05;Keskiviikko;3;0;3
94;03.08.2016;2016;08;06;Keskiviikko;8;1;9
94;03.08.2016;2016;08;07;Keskiviikko;19;2;21
94;03.08.2016;2016;08;08;Keskiviikko;7;4;11
94;03.08.2016;2016;08;09;Keskiviikko;11;11;22
94;03.08.2016;2016;08;10;Keskiviikko;10;5;15
94;03.08.2016;2016;08;11;Keskiviikko;5;8;13
94;03.08.2016;2016;08;12;Keskiviikko;6;7;13
94;03.08.2016;2016;08;13;Keskiviikko;5;7;12
94;03.08.2016;2016;08;14;Keskiviikko;5;8;13
94;03.08.2016;2016;08;15;Keskiviikko;5;10;15
94;03.08.2016;2016;08;16;Keskiviikko;4;9;13
94;03.08.2016;2016;08;17;Keskiviikko;4;8;12
94;03.08.2016;2016;08;18;Keskiviikko;5;5;10
94;03.08.2016;2016;08;19;Keskiviikko;13;9;22
94;03.08.2016;2016;08;20;Keskiviikko;5;5;10
94;03.08.2016;2016;08;21;Keskiviikko;3;6;9
94;03.08.2016;2016;08;22;Keskiviikko;0;5;5
94;03.08.2016;2016;08;23;Keskiviikko;3;1;4
94;04.08.2016;2016;08;00;Torstai;0;0;0
94;04.08.2016;2016;08;01;Torstai;0;0;0
94;04.08.2016;2016;08;02;Torstai;0;0;0
94;04.08.2016;2016;08;03;Torstai;0;0;0
94;04.08.2016;2016;08;04;Torstai;1;1;2
94;04.08.2016;2016;08;05;Torstai;2;0;2
94;04.08.2016;2016;08;06;Torstai;12;3;15
94;04.08.2016;2016;08;07;Torstai;20;4;24
94;04.08.2016;2016;08;08;Torstai;10;2;12
94;04.08.2016;2016;08;09;Torstai;11;5;16
94;04.08.2016;2016;08;10;Torstai;12;3;15
94;04.08.2016;2016;08;11;Torstai;9;13;22
94;04.08.2016;2016;08;12;Torstai;9;9;18
94;04.08.2016;2016;08;13;Torstai;19;15;34
94;04.08.2016;2016;08;14;Torstai;5;12;17
94;04.08.2016;2016;08;15;Torstai;13;19;32
94;04.08.2016;2016;08;16;Torstai;7;18;25
94;04.08.2016;2016;08;17;Torstai;6;15;21
94;04.08.2016;2016;08;18;Torstai;4;11;15
94;04.08.2016;2016;08;19;Torstai;6;8;14
94;04.08.2016;2016;08;20;Torstai;5;10;15
94;04.08.2016;2016;08;21;Torstai;3;4;7
94;04.08.2016;2016;08;22;Torstai;0;1;1
94;04.08.2016;2016;08;23;Torstai;1;1;2
94;05.08.2016;2016;08;00;Perjantai;0;1;1
94;05.08.2016;2016;08;01;Perjantai;0;0;0
94;05.08.2016;2016;08;02;Perjantai;0;1;1
94;05.08.2016;2016;08;03;Perjantai;0;0;0
94;05.08.2016;2016;08;04;Perjantai;1;0;1
94;05.08.2016;2016;08;05;Perjantai;3;0;3
94;05.08.2016;2016;08;06;Perjantai;10;2;12
94;05.08.2016;2016;08;07;Perjantai;14;0;14
94;05.08.2016;2016;08;08;Perjantai;10;3;13
94;05.08.2016;2016;08;09;Perjantai;3;2;5
94;05.08.2016;2016;08;10;Perjantai;4;5;9
94;05.08.2016;2016;08;11;Perjantai;6;0;6
94;05.08.2016;2016;08;12;Perjantai;6;7;13
94;05.08.2016;2016;08;13;Perjantai;4;5;9
94;05.08.2016;2016;08;14;Perjantai;7;7;14
94;05.08.2016;2016;08;15;Perjantai;11;16;27
94;05.08.2016;2016;08;16;Perjantai;11;13;24
94;05.08.2016;2016;08;17;Perjantai;8;10;18
94;05.08.2016;2016;08;18;Perjantai;6;9;15
94;05.08.2016;2016;08;19;Perjantai;7;10;17
94;05.08.2016;2016;08;20;Perjantai;9;4;13
94;05.08.2016;2016;08;21;Perjantai;1;7;8
94;05.08.2016;2016;08;22;Perjantai;0;4;4
94;05.08.2016;2016;08;23;Perjantai;2;4;6
94;06.08.2016;2016;08;00;Lauantai;0;1;1
94;06.08.2016;2016;08;01;Lauantai;0;1;1
94;06.08.2016;2016;08;02;Lauantai;0;0;0
94;06.08.2016;2016;08;03;Lauantai;0;0;0
94;06.08.2016;2016;08;04;Lauantai;0;1;1
94;06.08.2016;2016;08;05;Lauantai;2;0;2
94;06.08.2016;2016;08;06;Lauantai;2;3;5
94;06.08.2016;2016;08;07;Lauantai;3;1;4
94;06.08.2016;2016;08;08;Lauantai;4;1;5
94;06.08.2016;2016;08;09;Lauantai;7;10;17
94;06.08.2016;2016;08;10;Lauantai;11;10;21
94;06.08.2016;2016;08;11;Lauantai;7;15;22
94;06.08.2016;2016;08;12;Lauantai;12;19;31
94;06.08.2016;2016;08;13;Lauantai;10;13;23
94;06.08.2016;2016;08;14;Lauantai;10;13;23
94;06.08.2016;2016;08;15;Lauantai;9;8;17
94;06.08.2016;2016;08;16;Lauantai;17;9;26
94;06.08.2016;2016;08;17;Lauantai;7;9;16
94;06.08.2016;2016;08;18;Lauantai;8;7;15
94;06.08.2016;2016;08;19;Lauantai;6;9;15
94;06.08.2016;2016;08;20;Lauantai;6;10;16
94;06.08.2016;2016;08;21;Lauantai;4;3;7
94;06.08.2016;2016;08;22;Lauantai;1;0;1
94;06.08.2016;2016;08;23;Lauantai;0;0;0
94;07.08.2016;2016;08;00;Sunnuntai;1;0;1
94;07.08.2016;2016;08;01;Sunnuntai;0;0;0
94;07.08.2016;2016;08;02;Sunnuntai;0;0;0
94;07.08.2016;2016;08;03;Sunnuntai;1;0;1
94;07.08.2016;2016;08;04;Sunnuntai;0;0;0
94;07.08.2016;2016;08;05;Sunnuntai;2;0;2
94;07.08.2016;2016;08;06;Sunnuntai;1;0;1
94;07.08.2016;2016;08;07;Sunnuntai;2;1;3
94;07.08.2016;2016;08;08;Sunnuntai;1;2;3
94;07.08.2016;2016;08;09;Sunnuntai;4;4;8
94;07.08.2016;2016;08;10;Sunnuntai;10;7;17
94;07.08.2016;2016;08;11;Sunnuntai;8;10;18
94;07.08.2016;2016;08;12;Sunnuntai;5;4;9
94;07.08.2016;2016;08;13;Sunnuntai;6;2;8
94;07.08.2016;2016;08;14;Sunnuntai;13;5;18
94;07.08.2016;2016;08;15;Sunnuntai;13;4;17
94;07.08.2016;2016;08;16;Sunnuntai;9;17;26
94;07.08.2016;2016;08;17;Sunnuntai;11;6;17
94;07.08.2016;2016;08;18;Sunnuntai;12;8;20
94;07.08.2016;2016;08;19;Sunnuntai;17;11;28
94;07.08.2016;2016;08;20;Sunnuntai;7;6;13
94;07.08.2016;2016;08;21;Sunnuntai;3;5;8
94;07.08.2016;2016;08;22;Sunnuntai;2;7;9
94;07.08.2016;2016;08;23;Sunnuntai;0;1;1
94;08.08.2016;2016;08;00;Maanantai;0;2;2
94;08.08.2016;2016;08;01;Maanantai;0;0;0
94;08.08.2016;2016;08;02;Maanantai;0;0;0
94;08.08.2016;2016;08;03;Maanantai;0;0;0
94;08.08.2016;2016;08;04;Maanantai;2;0;2
94;08.08.2016;2016;08;05;Maanantai;6;2;8
94;08.08.2016;2016;08;06;Maanantai;15;1;16
94;08.08.2016;2016;08;07;Maanantai;26;5;31
94;08.08.2016;2016;08;08;Maanantai;13;4;17
94;08.08.2016;2016;08;09;Maanantai;6;3;9
94;08.08.2016;2016;08;10;Maanantai;6;5;11
94;08.08.2016;2016;08;11;Maanantai;9;6;15
94;08.08.2016;2016;08;12;Maanantai;14;7;21
94;08.08.2016;2016;08;13;Maanantai;8;7;15
94;08.08.2016;2016;08;14;Maanantai;5;15;20
94;08.08.2016;2016;08;15;Maanantai;12;17;29
94;08.08.2016;2016;08;16;Maanantai;13;39;52
94;08.08.2016;2016;08;17;Maanantai;14;22;36
94;08.08.2016;2016;08;18;Maanantai;12;9;21
94;08.08.2016;2016;08;19;Maanantai;12;5;17
94;08.08.2016;2016;08;20;Maanantai;8;4;12
94;08.08.2016;2016;08;21;Maanantai;6;6;12
94;08.08.2016;2016;08;22;Maanantai;0;2;2
94;08.08.2016;2016;08;23;Maanantai;1;1;2
94;09.08.2016;2016;08;00;Tiistai;0;0;0
94;09.08.2016;2016;08;01;Tiistai;0;0;0
94;09.08.2016;2016;08;02;Tiistai;0;0;0
94;09.08.2016;2016;08;03;Tiistai;0;0;0
94;09.08.2016;2016;08;04;Tiistai;1;0;1
94;09.08.2016;2016;08;05;Tiistai;3;2;5
94;09.08.2016;2016;08;06;Tiistai;18;4;22
94;09.08.2016;2016;08;07;Tiistai;14;6;20
94;09.08.2016;2016;08;08;Tiistai;8;2;10
94;09.08.2016;2016;08;09;Tiistai;8;7;15
94;09.08.2016;2016;08;10;Tiistai;3;3;6
94;09.08.2016;2016;08;11;Tiistai;9;7;16
94;09.08.2016;2016;08;12;Tiistai;4;4;8
94;09.08.2016;2016;08;13;Tiistai;3;5;8
94;09.08.2016;2016;08;14;Tiistai;0;7;7
94;09.08.2016;2016;08;15;Tiistai;6;13;19
94;09.08.2016;2016;08;16;Tiistai;10;31;41
94;09.08.2016;2016;08;17;Tiistai;10;7;17
94;09.08.2016;2016;08;18;Tiistai;3;8;11
94;09.08.2016;2016;08;19;Tiistai;7;3;10
94;09.08.2016;2016;08;20;Tiistai;6;3;9
94;09.08.2016;2016;08;21;Tiistai;1;4;5
94;09.08.2016;2016;08;22;Tiistai;0;5;5
94;09.08.2016;2016;08;23;Tiistai;0;2;2
94;10.08.2016;2016;08;00;Keskiviikko;0;0;0
94;10.08.2016;2016;08;01;Keskiviikko;0;1;1
94;10.08.2016;2016;08;02;Keskiviikko;0;0;0
94;10.08.2016;2016;08;03;Keskiviikko;0;0;0
94;10.08.2016;2016;08;04;Keskiviikko;0;0;0
94;10.08.2016;2016;08;05;Keskiviikko;5;1;6
94;10.08.2016;2016;08;06;Keskiviikko;8;1;9
94;10.08.2016;2016;08;07;Keskiviikko;13;1;14
94;10.08.2016;2016;08;08;Keskiviikko;11;3;14
94;10.08.2016;2016;08;09;Keskiviikko;3;1;4
94;10.08.2016;2016;08;10;Keskiviikko;8;3;11
94;10.08.2016;2016;08;11;Keskiviikko;7;3;10
94;10.08.2016;2016;08;12;Keskiviikko;4;3;7
94;10.08.2016;2016;08;13;Keskiviikko;8;7;15
94;10.08.2016;2016;08;14;Keskiviikko;12;8;20
94;10.08.2016;2016;08;15;Keskiviikko;8;11;19
94;10.08.2016;2016;08;16;Keskiviikko;2;21;23
94;10.08.2016;2016;08;17;Keskiviikko;2;12;14
94;10.08.2016;2016;08;18;Keskiviikko;9;7;16
94;10.08.2016;2016;08;19;Keskiviikko;5;8;13
94;10.08.2016;2016;08;20;Keskiviikko;2;5;7
94;10.08.2016;2016;08;21;Keskiviikko;6;6;12
94;10.08.2016;2016;08;22;Keskiviikko;2;7;9
94;10.08.2016;2016;08;23;Keskiviikko;0;1;1
94;11.08.2016;2016;08;00;Torstai;0;0;0
94;11.08.2016;2016;08;01;Torstai;0;0;0
94;11.08.2016;2016;08;02;Torstai;0;0;0
94;11.08.2016;2016;08;03;Torstai;0;1;1
94;11.08.2016;2016;08;04;Torstai;1;0;1
94;11.08.2016;2016;08;05;Torstai;6;0;6
94;11.08.2016;2016;08;06;Torstai;15;4;19
94;11.08.2016;2016;08;07;Torstai;23;3;26
94;11.08.2016;2016;08;08;Torstai;11;2;13
94;11.08.2016;2016;08;09;Torstai;10;1;11
94;11.08.2016;2016;08;10;Torstai;6;2;8
94;11.08.2016;2016;08;11;Torstai;3;6;9
94;11.08.2016;2016;08;12;Torstai;6;7;13
94;11.08.2016;2016;08;13;Torstai;5;5;10
94;11.08.2016;2016;08;14;Torstai;3;9;12
94;11.08.2016;2016;08;15;Torstai;9;22;31
94;11.08.2016;2016;08;16;Torstai;8;19;27
94;11.08.2016;2016;08;17;Torstai;3;15;18
94;11.08.2016;2016;08;18;Torstai;7;10;17
94;11.08.2016;2016;08;19;Torstai;6;9;15
94;11.08.2016;2016;08;20;Torstai;8;6;14
94;11.08.2016;2016;08;21;Torstai;1;3;4
94;11.08.2016;2016;08;22;Torstai;2;1;3
94;11.08.2016;2016;08;23;Torstai;0;0;0
94;12.08.2016;2016;08;00;Perjantai;0;1;1
94;12.08.2016;2016;08;01;Perjantai;0;0;0
94;12.08.2016;2016;08;02;Perjantai;0;0;0
94;12.08.2016;2016;08;03;Perjantai;1;1;2
94;12.08.2016;2016;08;04;Perjantai;0;0;0
94;12.08.2016;2016;08;05;Perjantai;3;0;3
94;12.08.2016;2016;08;06;Perjantai;6;2;8
94;12.08.2016;2016;08;07;Perjantai;16;0;16
94;12.08.2016;2016;08;08;Perjantai;5;0;5
94;12.08.2016;2016;08;09;Perjantai;4;1;5
94;12.08.2016;2016;08;10;Perjantai;1;0;1
94;12.08.2016;2016;08;11;Perjantai;2;0;2
94;12.08.2016;2016;08;12;Perjantai;1;2;3
94;12.08.2016;2016;08;13;Perjantai;1;2;3
94;12.08.2016;2016;08;14;Perjantai;1;3;4
94;12.08.2016;2016;08;15;Perjantai;0;12;12
94;12.08.2016;2016;08;16;Perjantai;3;15;18
94;12.08.2016;2016;08;17;Perjantai;5;4;9
94;12.08.2016;2016;08;18;Perjantai;5;8;13
94;12.08.2016;2016;08;19;Perjantai;7;7;14
94;12.08.2016;2016;08;20;Perjantai;6;7;13
94;12.08.2016;2016;08;21;Perjantai;3;1;4
94;12.08.2016;2016;08;22;Perjantai;0;3;3
94;12.08.2016;2016;08;23;Perjantai;2;3;5
94;13.08.2016;2016;08;00;Lauantai;0;1;1
94;13.08.2016;2016;08;01;Lauantai;1;1;2
94;13.08.2016;2016;08;02;Lauantai;0;1;1
94;13.08.2016;2016;08;03;Lauantai;0;0;0
94;13.08.2016;2016;08;04;Lauantai;1;1;2
94;13.08.2016;2016;08;05;Lauantai;1;0;1
94;13.08.2016;2016;08;06;Lauantai;3;0;3
94;13.08.2016;2016;08;07;Lauantai;1;0;1
94;13.08.2016;2016;08;08;Lauantai;0;2;2
94;13.08.2016;2016;08;09;Lauantai;4;2;6
94;13.08.2016;2016;08;10;Lauantai;1;5;6
94;13.08.2016;2016;08;11;Lauantai;5;5;10
94;13.08.2016;2016;08;12;Lauantai;1;2;3
94;13.08.2016;2016;08;13;Lauantai;1;1;2
94;13.08.2016;2016;08;14;Lauantai;1;0;1
94;13.08.2016;2016;08;15;Lauantai;1;1;2
94;13.08.2016;2016;08;16;Lauantai;2;1;3
94;13.08.2016;2016;08;17;Lauantai;3;2;5
94;13.08.2016;2016;08;18;Lauantai;1;2;3
94;13.08.2016;2016;08;19;Lauantai;2;1;3
94;13.08.2016;2016;08;20;Lauantai;2;1;3
94;13.08.2016;2016;08;21;Lauantai;1;5;6
94;13.08.2016;2016;08;22;Lauantai;0;1;1
94;13.08.2016;2016;08;23;Lauantai;1;0;1
94;14.08.2016;2016;08;00;Sunnuntai;0;1;1
94;14.08.2016;2016;08;01;Sunnuntai;0;0;0
94;14.08.2016;2016;08;02;Sunnuntai;0;0;0
94;14.08.2016;2016;08;03;Sunnuntai;0;0;0
94;14.08.2016;2016;08;04;Sunnuntai;1;0;1
94;14.08.2016;2016;08;05;Sunnuntai;3;1;4
94;14.08.2016;2016;08;06;Sunnuntai;1;0;1
94;14.08.2016;2016;08;07;Sunnuntai;0;0;0
94;14.08.2016;2016;08;08;Sunnuntai;1;0;1
94;14.08.2016;2016;08;09;Sunnuntai;3;2;5
94;14.08.2016;2016;08;10;Sunnuntai;5;8;13
94;14.08.2016;2016;08;11;Sunnuntai;6;9;15
94;14.08.2016;2016;08;12;Sunnuntai;12;4;16
94;14.08.2016;2016;08;13;Sunnuntai;16;15;31
94;14.08.2016;2016;08;14;Sunnuntai;14;12;26
94;14.08.2016;2016;08;15;Sunnuntai;19;14;33
94;14.08.2016;2016;08;16;Sunnuntai;9;9;18
94;14.08.2016;2016;08;17;Sunnuntai;6;12;18
94;14.08.2016;2016;08;18;Sunnuntai;8;13;21
94;14.08.2016;2016;08;19;Sunnuntai;12;8;20
94;14.08.2016;2016;08;20;Sunnuntai;13;2;15
94;14.08.2016;2016;08;21;Sunnuntai;2;4;6
94;14.08.2016;2016;08;22;Sunnuntai;1;3;4
94;14.08.2016;2016;08;23;Sunnuntai;0;1;1
94;15.08.2016;2016;08;00;Maanantai;0;0;0
94;15.08.2016;2016;08;01;Maanantai;0;0;0
94;15.08.2016;2016;08;02;Maanantai;0;0;0
94;15.08.2016;2016;08;03;Maanantai;0;0;0
94;15.08.2016;2016;08;04;Maanantai;2;1;3
94;15.08.2016;2016;08;05;Maanantai;11;1;12
94;15.08.2016;2016;08;06;Maanantai;19;4;23
94;15.08.2016;2016;08;07;Maanantai;31;2;33
94;15.08.2016;2016;08;08;Maanantai;9;1;10
94;15.08.2016;2016;08;09;Maanantai;4;2;6
94;15.08.2016;2016;08;10;Maanantai;5;1;6
94;15.08.2016;2016;08;11;Maanantai;5;7;12
94;15.08.2016;2016;08;12;Maanantai;10;4;14
94;15.08.2016;2016;08;13;Maanantai;2;9;11
94;15.08.2016;2016;08;14;Maanantai;7;14;21
94;15.08.2016;2016;08;15;Maanantai;10;26;36
94;15.08.2016;2016;08;16;Maanantai;8;30;38
94;15.08.2016;2016;08;17;Maanantai;11;18;29
94;15.08.2016;2016;08;18;Maanantai;13;18;31
94;15.08.2016;2016;08;19;Maanantai;16;9;25
94;15.08.2016;2016;08;20;Maanantai;7;6;13
94;15.08.2016;2016;08;21;Maanantai;1;7;8
94;15.08.2016;2016;08;22;Maanantai;1;2;3
94;15.08.2016;2016;08;23;Maanantai;0;1;1
94;16.08.2016;2016;08;00;Tiistai;0;0;0
94;16.08.2016;2016;08;01;Tiistai;0;0;0
94;16.08.2016;2016;08;02;Tiistai;0;0;0
94;16.08.2016;2016;08;03;Tiistai;0;0;0
94;16.08.2016;2016;08;04;Tiistai;2;0;2
94;16.08.2016;2016;08;05;Tiistai;8;0;8
94;16.08.2016;2016;08;06;Tiistai;15;3;18
94;16.08.2016;2016;08;07;Tiistai;23;3;26
94;16.08.2016;2016;08;08;Tiistai;12;3;15
94;16.08.2016;2016;08;09;Tiistai;7;4;11
94;16.08.2016;2016;08;10;Tiistai;3;5;8
94;16.08.2016;2016;08;11;Tiistai;3;1;4
94;16.08.2016;2016;08;12;Tiistai;7;1;8
94;16.08.2016;2016;08;13;Tiistai;2;2;4
94;16.08.2016;2016;08;14;Tiistai;1;8;9
94;16.08.2016;2016;08;15;Tiistai;8;13;21
94;16.08.2016;2016;08;16;Tiistai;9;24;33
94;16.08.2016;2016;08;17;Tiistai;4;13;17
94;16.08.2016;2016;08;18;Tiistai;3;7;10
94;16.08.2016;2016;08;19;Tiistai;2;0;2
94;16.08.2016;2016;08;20;Tiistai;2;2;4
94;16.08.2016;2016;08;21;Tiistai;3;1;4
94;16.08.2016;2016;08;22;Tiistai;0;6;6
94;16.08.2016;2016;08;23;Tiistai;1;0;1
94;17.08.2016;2016;08;00;Keskiviikko;0;0;0
94;17.08.2016;2016;08;01;Keskiviikko;0;0;0
94;17.08.2016;2016;08;02;Keskiviikko;0;0;0
94;17.08.2016;2016;08;03;Keskiviikko;0;0;0
94;17.08.2016;2016;08;04;Keskiviikko;1;0;1
94;17.08.2016;2016;08;05;Keskiviikko;5;0;5
94;17.08.2016;2016;08;06;Keskiviikko;21;3;24
94;17.08.2016;2016;08;07;Keskiviikko;20;3;23
94;17.08.2016;2016;08;08;Keskiviikko;9;2;11
94;17.08.2016;2016;08;09;Keskiviikko;7;3;10
94;17.08.2016;2016;08;10;Keskiviikko;4;3;7
94;17.08.2016;2016;08;11;Keskiviikko;1;3;4
94;17.08.2016;2016;08;12;Keskiviikko;5;5;10
94;17.08.2016;2016;08;13;Keskiviikko;4;7;11
94;17.08.2016;2016;08;14;Keskiviikko;2;14;16
94;17.08.2016;2016;08;15;Keskiviikko;6;14;20
94;17.08.2016;2016;08;16;Keskiviikko;7;24;31
94;17.08.2016;2016;08;17;Keskiviikko;5;12;17
94;17.08.2016;2016;08;18;Keskiviikko;8;10;18
94;17.08.2016;2016;08;19;Keskiviikko;6;14;20
94;17.08.2016;2016;08;20;Keskiviikko;10;7;17
94;17.08.2016;2016;08;21;Keskiviikko;6;4;10
94;17.08.2016;2016;08;22;Keskiviikko;0;2;2
94;17.08.2016;2016;08;23;Keskiviikko;0;1;1
94;18.08.2016;2016;08;00;Torstai;0;1;1
94;18.08.2016;2016;08;01;Torstai;0;0;0
94;18.08.2016;2016;08;02;Torstai;0;0;0
94;18.08.2016;2016;08;03;Torstai;0;1;1
94;18.08.2016;2016;08;04;Torstai;2;0;2
94;18.08.2016;2016;08;05;Torstai;4;0;4
94;18.08.2016;2016;08;06;Torstai;29;3;32
94;18.08.2016;2016;08;07;Torstai;22;9;31
94;18.08.2016;2016;08;08;Torstai;15;3;18
94;18.08.2016;2016;08;09;Torstai;6;8;14
94;18.08.2016;2016;08;10;Torstai;7;6;13
94;18.08.2016;2016;08;11;Torstai;6;10;16
94;18.08.2016;2016;08;12;Torstai;3;5;8
94;18.08.2016;2016;08;13;Torstai;12;7;19
94;18.08.2016;2016;08;14;Torstai;9;11;20
94;18.08.2016;2016;08;15;Torstai;15;27;42
94;18.08.2016;2016;08;16;Torstai;9;29;38
94;18.08.2016;2016;08;17;Torstai;9;13;22
94;18.08.2016;2016;08;18;Torstai;9;13;22
94;18.08.2016;2016;08;19;Torstai;5;7;12
94;18.08.2016;2016;08;20;Torstai;3;5;8
94;18.08.2016;2016;08;21;Torstai;3;10;13
94;18.08.2016;2016;08;22;Torstai;1;3;4
94;18.08.2016;2016;08;23;Torstai;0;0;0
94;19.08.2016;2016;08;00;Perjantai;0;4;4
94;19.08.2016;2016;08;01;Perjantai;0;0;0
94;19.08.2016;2016;08;02;Perjantai;0;0;0
94;19.08.2016;2016;08;03;Perjantai;0;2;2
94;19.08.2016;2016;08;04;Perjantai;1;1;2
94;19.08.2016;2016;08;05;Perjantai;5;1;6
94;19.08.2016;2016;08;06;Perjantai;17;4;21
94;19.08.2016;2016;08;07;Perjantai;12;1;13
94;19.08.2016;2016;08;08;Perjantai;8;0;8
94;19.08.2016;2016;08;09;Perjantai;3;0;3
94;19.08.2016;2016;08;10;Perjantai;7;0;7
94;19.08.2016;2016;08;11;Perjantai;6;3;9
94;19.08.2016;2016;08;12;Perjantai;3;1;4
94;19.08.2016;2016;08;13;Perjantai;3;6;9
94;19.08.2016;2016;08;14;Perjantai;5;9;14
94;19.08.2016;2016;08;15;Perjantai;7;11;18
94;19.08.2016;2016;08;16;Perjantai;4;19;23
94;19.08.2016;2016;08;17;Perjantai;1;7;8
94;19.08.2016;2016;08;18;Perjantai;4;10;14
94;19.08.2016;2016;08;19;Perjantai;4;4;8
94;19.08.2016;2016;08;20;Perjantai;8;3;11
94;19.08.2016;2016;08;21;Perjantai;7;4;11
94;19.08.2016;2016;08;22;Perjantai;1;1;2
94;19.08.2016;2016;08;23;Perjantai;0;2;2
94;20.08.2016;2016;08;00;Lauantai;2;2;4
94;20.08.2016;2016;08;01;Lauantai;0;1;1
94;20.08.2016;2016;08;02;Lauantai;0;0;0
94;20.08.2016;2016;08;03;Lauantai;0;1;1
94;20.08.2016;2016;08;04;Lauantai;1;2;3
94;20.08.2016;2016;08;05;Lauantai;3;2;5
94;20.08.2016;2016;08;06;Lauantai;0;3;3
94;20.08.2016;2016;08;07;Lauantai;1;0;1
94;20.08.2016;2016;08;08;Lauantai;3;2;5
94;20.08.2016;2016;08;09;Lauantai;7;3;10
94;20.08.2016;2016;08;10;Lauantai;6;6;12
94;20.08.2016;2016;08;11;Lauantai;10;6;16
94;20.08.2016;2016;08;12;Lauantai;9;22;31
94;20.08.2016;2016;08;13;Lauantai;10;8;18
94;20.08.2016;2016;08;14;Lauantai;4;14;18
94;20.08.2016;2016;08;15;Lauantai;6;7;13
94;20.08.2016;2016;08;16;Lauantai;9;11;20
94;20.08.2016;2016;08;17;Lauantai;7;5;12
94;20.08.2016;2016;08;18;Lauantai;6;4;10
94;20.08.2016;2016;08;19;Lauantai;3;1;4
94;20.08.2016;2016;08;20;Lauantai;2;1;3
94;20.08.2016;2016;08;21;Lauantai;2;2;4
94;20.08.2016;2016;08;22;Lauantai;0;1;1
94;20.08.2016;2016;08;23;Lauantai;0;1;1
94;21.08.2016;2016;08;00;Sunnuntai;1;2;3
94;21.08.2016;2016;08;01;Sunnuntai;0;0;0
94;21.08.2016;2016;08;02;Sunnuntai;2;1;3
94;21.08.2016;2016;08;03;Sunnuntai;0;0;0
94;21.08.2016;2016;08;04;Sunnuntai;0;0;0
94;21.08.2016;2016;08;05;Sunnuntai;2;1;3
94;21.08.2016;2016;08;06;Sunnuntai;2;0;2
94;21.08.2016;2016;08;07;Sunnuntai;0;1;1
94;21.08.2016;2016;08;08;Sunnuntai;2;2;4
94;21.08.2016;2016;08;09;Sunnuntai;5;1;6
94;21.08.2016;2016;08;10;Sunnuntai;7;8;15
94;21.08.2016;2016;08;11;Sunnuntai;6;4;10
94;21.08.2016;2016;08;12;Sunnuntai;12;2;14
94;21.08.2016;2016;08;13;Sunnuntai;3;5;8
94;21.08.2016;2016;08;14;Sunnuntai;3;8;11
94;21.08.2016;2016;08;15;Sunnuntai;14;10;24
94;21.08.2016;2016;08;16;Sunnuntai;10;8;18
94;21.08.2016;2016;08;17;Sunnuntai;4;7;11
94;21.08.2016;2016;08;18;Sunnuntai;8;10;18
94;21.08.2016;2016;08;19;Sunnuntai;14;15;29
94;21.08.2016;2016;08;20;Sunnuntai;4;5;9
94;21.08.2016;2016;08;21;Sunnuntai;7;4;11
94;21.08.2016;2016;08;22;Sunnuntai;0;2;2
94;21.08.2016;2016;08;23;Sunnuntai;0;0;0
94;22.08.2016;2016;08;00;Maanantai;0;0;0
94;22.08.2016;2016;08;01;Maanantai;0;0;0
94;22.08.2016;2016;08;02;Maanantai;0;0;0
94;22.08.2016;2016;08;03;Maanantai;1;0;1
94;22.08.2016;2016;08;04;Maanantai;1;0;1
94;22.08.2016;2016;08;05;Maanantai;3;1;4
94;22.08.2016;2016;08;06;Maanantai;15;3;18
94;22.08.2016;2016;08;07;Maanantai;10;3;13
94;22.08.2016;2016;08;08;Maanantai;2;0;2
94;22.08.2016;2016;08;09;Maanantai;0;0;0
94;22.08.2016;2016;08;10;Maanantai;2;1;3
94;22.08.2016;2016;08;11;Maanantai;3;2;5
94;22.08.2016;2016;08;12;Maanantai;2;0;2
94;22.08.2016;2016;08;13;Maanantai;3;4;7
94;22.08.2016;2016;08;14;Maanantai;3;5;8
94;22.08.2016;2016;08;15;Maanantai;4;11;15
94;22.08.2016;2016;08;16;Maanantai;2;13;15
94;22.08.2016;2016;08;17;Maanantai;0;6;6
94;22.08.2016;2016;08;18;Maanantai;1;2;3
94;22.08.2016;2016;08;19;Maanantai;1;2;3
94;22.08.2016;2016;08;20;Maanantai;1;5;6
94;22.08.2016;2016;08;21;Maanantai;2;3;5
94;22.08.2016;2016;08;22;Maanantai;0;0;0
94;22.08.2016;2016;08;23;Maanantai;0;1;1
94;23.08.2016;2016;08;00;Tiistai;1;0;1
94;23.08.2016;2016;08;01;Tiistai;0;0;0
94;23.08.2016;2016;08;02;Tiistai;0;0;0
94;23.08.2016;2016;08;03;Tiistai;0;0;0
94;23.08.2016;2016;08;04;Tiistai;2;0;2
94;23.08.2016;2016;08;05;Tiistai;4;1;5
94;23.08.2016;2016;08;06;Tiistai;17;4;21
94;23.08.2016;2016;08;07;Tiistai;20;2;22
94;23.08.2016;2016;08;08;Tiistai;17;4;21
94;23.08.2016;2016;08;09;Tiistai;5;3;8
94;23.08.2016;2016;08;10;Tiistai;6;6;12
94;23.08.2016;2016;08;11;Tiistai;4;2;6
94;23.08.2016;2016;08;12;Tiistai;9;4;13
94;23.08.2016;2016;08;13;Tiistai;6;8;14
94;23.08.2016;2016;08;14;Tiistai;4;8;12
94;23.08.2016;2016;08;15;Tiistai;10;15;25
94;23.08.2016;2016;08;16;Tiistai;19;23;42
94;23.08.2016;2016;08;17;Tiistai;9;21;30
94;23.08.2016;2016;08;18;Tiistai;5;16;21
94;23.08.2016;2016;08;19;Tiistai;11;8;19
94;23.08.2016;2016;08;20;Tiistai;10;7;17
94;23.08.2016;2016;08;21;Tiistai;3;3;6
94;23.08.2016;2016;08;22;Tiistai;0;3;3
94;23.08.2016;2016;08;23;Tiistai;1;0;1
94;24.08.2016;2016;08;00;Keskiviikko;1;0;1
94;24.08.2016;2016;08;01;Keskiviikko;0;0;0
94;24.08.2016;2016;08;02;Keskiviikko;0;0;0
94;24.08.2016;2016;08;03;Keskiviikko;0;0;0
94;24.08.2016;2016;08;04;Keskiviikko;3;0;3
94;24.08.2016;2016;08;05;Keskiviikko;5;1;6
94;24.08.2016;2016;08;06;Keskiviikko;22;3;25
94;24.08.2016;2016;08;07;Keskiviikko;28;5;33
94;24.08.2016;2016;08;08;Keskiviikko;16;1;17
94;24.08.2016;2016;08;09;Keskiviikko;6;4;10
94;24.08.2016;2016;08;10;Keskiviikko;10;4;14
94;24.08.2016;2016;08;11;Keskiviikko;3;10;13
94;24.08.2016;2016;08;12;Keskiviikko;11;10;21
94;24.08.2016;2016;08;13;Keskiviikko;8;10;18
94;24.08.2016;2016;08;14;Keskiviikko;9;13;22
94;24.08.2016;2016;08;15;Keskiviikko;11;28;39
94;24.08.2016;2016;08;16;Keskiviikko;9;32;41
94;24.08.2016;2016;08;17;Keskiviikko;8;18;26
94;24.08.2016;2016;08;18;Keskiviikko;8;16;24
94;24.08.2016;2016;08;19;Keskiviikko;9;11;20
94;24.08.2016;2016;08;20;Keskiviikko;8;7;15
94;24.08.2016;2016;08;21;Keskiviikko;1;1;2
94;24.08.2016;2016;08;22;Keskiviikko;0;0;0
94;24.08.2016;2016;08;23;Keskiviikko;1;0;1
94;25.08.2016;2016;08;00;Torstai;0;0;0
94;25.08.2016;2016;08;01;Torstai;0;0;0
94;25.08.2016;2016;08;02;Torstai;0;0;0
94;25.08.2016;2016;08;03;Torstai;0;1;1
94;25.08.2016;2016;08;04;Torstai;1;0;1
94;25.08.2016;2016;08;05;Torstai;7;0;7
94;25.08.2016;2016;08;06;Torstai;9;3;12
94;25.08.2016;2016;08;07;Torstai;20;5;25
94;25.08.2016;2016;08;08;Torstai;9;4;13
94;25.08.2016;2016;08;09;Torstai;4;0;4
94;25.08.2016;2016;08;10;Torstai;0;0;0
94;25.08.2016;2016;08;11;Torstai;3;0;3
94;25.08.2016;2016;08;12;Torstai;3;1;4
94;25.08.2016;2016;08;13;Torstai;2;1;3
94;25.08.2016;2016;08;14;Torstai;3;7;10
94;25.08.2016;2016;08;15;Torstai;5;13;18
94;25.08.2016;2016;08;16;Torstai;5;28;33
94;25.08.2016;2016;08;17;Torstai;4;11;15
94;25.08.2016;2016;08;18;Torstai;2;1;3
94;25.08.2016;2016;08;19;Torstai;3;8;11
94;25.08.2016;2016;08;20;Torstai;4;2;6
94;25.08.2016;2016;08;21;Torstai;2;2;4
94;25.08.2016;2016;08;22;Torstai;0;3;3
94;25.08.2016;2016;08;23;Torstai;0;0;0
94;26.08.2016;2016;08;00;Perjantai;0;0;0
94;26.08.2016;2016;08;01;Perjantai;0;0;0
94;26.08.2016;2016;08;02;Perjantai;0;0;0
94;26.08.2016;2016;08;03;Perjantai;0;1;1
94;26.08.2016;2016;08;04;Perjantai;1;0;1
94;26.08.2016;2016;08;05;Perjantai;5;1;6
94;26.08.2016;2016;08;06;Perjantai;12;2;14
94;26.08.2016;2016;08;07;Perjantai;18;5;23
94;26.08.2016;2016;08;08;Perjantai;6;1;7
94;26.08.2016;2016;08;09;Perjantai;10;3;13
94;26.08.2016;2016;08;10;Perjantai;6;3;9
94;26.08.2016;2016;08;11;Perjantai;12;4;16
94;26.08.2016;2016;08;12;Perjantai;5;10;15
94;26.08.2016;2016;08;13;Perjantai;1;8;9
94;26.08.2016;2016;08;14;Perjantai;11;15;26
94;26.08.2016;2016;08;15;Perjantai;6;19;25
94;26.08.2016;2016;08;16;Perjantai;17;27;44
94;26.08.2016;2016;08;17;Perjantai;12;12;24
94;26.08.2016;2016;08;18;Perjantai;9;12;21
94;26.08.2016;2016;08;19;Perjantai;7;9;16
94;26.08.2016;2016;08;20;Perjantai;9;8;17
94;26.08.2016;2016;08;21;Perjantai;2;8;10
94;26.08.2016;2016;08;22;Perjantai;1;3;4
94;26.08.2016;2016;08;23;Perjantai;2;1;3
94;27.08.2016;2016;08;00;Lauantai;0;2;2
94;27.08.2016;2016;08;01;Lauantai;0;0;0
94;27.08.2016;2016;08;02;Lauantai;0;1;1
94;27.08.2016;2016;08;03;Lauantai;0;0;0
94;27.08.2016;2016;08;04;Lauantai;0;0;0
94;27.08.2016;2016;08;05;Lauantai;0;0;0
94;27.08.2016;2016;08;06;Lauantai;1;0;1
94;27.08.2016;2016;08;07;Lauantai;1;0;1
94;27.08.2016;2016;08;08;Lauantai;0;1;1
94;27.08.2016;2016;08;09;Lauantai;0;2;2
94;27.08.2016;2016;08;10;Lauantai;1;4;5
94;27.08.2016;2016;08;11;Lauantai;3;1;4
94;27.08.2016;2016;08;12;Lauantai;2;2;4
94;27.08.2016;2016;08;13;Lauantai;2;1;3
94;27.08.2016;2016;08;14;Lauantai;3;1;4
94;27.08.2016;2016;08;15;Lauantai;2;1;3
94;27.08.2016;2016;08;16;Lauantai;3;2;5
94;27.08.2016;2016;08;17;Lauantai;4;4;8
94;27.08.2016;2016;08;18;Lauantai;5;3;8
94;27.08.2016;2016;08;19;Lauantai;3;1;4
94;27.08.2016;2016;08;20;Lauantai;1;5;6
94;27.08.2016;2016;08;21;Lauantai;2;1;3
94;27.08.2016;2016;08;22;Lauantai;1;2;3
94;27.08.2016;2016;08;23;Lauantai;0;1;1
94;28.08.2016;2016;08;00;Sunnuntai;1;0;1
94;28.08.2016;2016;08;01;Sunnuntai;0;0;0
94;28.08.2016;2016;08;02;Sunnuntai;0;0;0
94;28.08.2016;2016;08;03;Sunnuntai;0;1;1
94;28.08.2016;2016;08;04;Sunnuntai;0;0;0
94;28.08.2016;2016;08;05;Sunnuntai;1;0;1
94;28.08.2016;2016;08;06;Sunnuntai;2;0;2
94;28.08.2016;2016;08;07;Sunnuntai;1;1;2
94;28.08.2016;2016;08;08;Sunnuntai;0;0;0
94;28.08.2016;2016;08;09;Sunnuntai;6;6;12
94;28.08.2016;2016;08;10;Sunnuntai;3;5;8
94;28.08.2016;2016;08;11;Sunnuntai;13;4;17
94;28.08.2016;2016;08;12;Sunnuntai;11;9;20
94;28.08.2016;2016;08;13;Sunnuntai;15;14;29
94;28.08.2016;2016;08;14;Sunnuntai;13;7;20
94;28.08.2016;2016;08;15;Sunnuntai;10;11;21
94;28.08.2016;2016;08;16;Sunnuntai;11;9;20
94;28.08.2016;2016;08;17;Sunnuntai;10;10;20
94;28.08.2016;2016;08;18;Sunnuntai;3;3;6
94;28.08.2016;2016;08;19;Sunnuntai;5;5;10
94;28.08.2016;2016;08;20;Sunnuntai;5;1;6
94;28.08.2016;2016;08;21;Sunnuntai;1;1;2
94;28.08.2016;2016;08;22;Sunnuntai;0;2;2
94;28.08.2016;2016;08;23;Sunnuntai;0;0;0
94;29.08.2016;2016;08;00;Maanantai;0;0;0
94;29.08.2016;2016;08;01;Maanantai;0;0;0
94;29.08.2016;2016;08;02;Maanantai;0;0;0
94;29.08.2016;2016;08;03;Maanantai;0;0;0
94;29.08.2016;2016;08;04;Maanantai;1;1;2
94;29.08.2016;2016;08;05;Maanantai;6;1;7
94;29.08.2016;2016;08;06;Maanantai;21;3;24
94;29.08.2016;2016;08;07;Maanantai;20;3;23
94;29.08.2016;2016;08;08;Maanantai;7;3;10
94;29.08.2016;2016;08;09;Maanantai;9;4;13
94;29.08.2016;2016;08;10;Maanantai;2;0;2
94;29.08.2016;2016;08;11;Maanantai;6;8;14
94;29.08.2016;2016;08;12;Maanantai;1;1;2
94;29.08.2016;2016;08;13;Maanantai;6;4;10
94;29.08.2016;2016;08;14;Maanantai;3;8;11
94;29.08.2016;2016;08;15;Maanantai;3;24;27
94;29.08.2016;2016;08;16;Maanantai;13;29;42
94;29.08.2016;2016;08;17;Maanantai;5;20;25
94;29.08.2016;2016;08;18;Maanantai;11;10;21
94;29.08.2016;2016;08;19;Maanantai;13;9;22
94;29.08.2016;2016;08;20;Maanantai;5;6;11
94;29.08.2016;2016;08;21;Maanantai;5;4;9
94;29.08.2016;2016;08;22;Maanantai;0;1;1
94;29.08.2016;2016;08;23;Maanantai;0;1;1
94;30.08.2016;2016;08;00;Tiistai;0;0;0
94;30.08.2016;2016;08;01;Tiistai;0;0;0
94;30.08.2016;2016;08;02;Tiistai;0;1;1
94;30.08.2016;2016;08;03;Tiistai;0;2;2
94;30.08.2016;2016;08;04;Tiistai;1;0;1
94;30.08.2016;2016;08;05;Tiistai;9;0;9
94;30.08.2016;2016;08;06;Tiistai;19;5;24
94;30.08.2016;2016;08;07;Tiistai;15;5;20
94;30.08.2016;2016;08;08;Tiistai;12;4;16
94;30.08.2016;2016;08;09;Tiistai;4;3;7
94;30.08.2016;2016;08;10;Tiistai;6;3;9
94;30.08.2016;2016;08;11;Tiistai;3;4;7
94;30.08.2016;2016;08;12;Tiistai;5;7;12
94;30.08.2016;2016;08;13;Tiistai;3;5;8
94;30.08.2016;2016;08;14;Tiistai;5;8;13
94;30.08.2016;2016;08;15;Tiistai;8;25;33
94;30.08.2016;2016;08;16;Tiistai;9;26;35
94;30.08.2016;2016;08;17;Tiistai;6;16;22
94;30.08.2016;2016;08;18;Tiistai;3;11;14
94;30.08.2016;2016;08;19;Tiistai;7;8;15
94;30.08.2016;2016;08;20;Tiistai;7;2;9
94;30.08.2016;2016;08;21;Tiistai;1;4;5
94;30.08.2016;2016;08;22;Tiistai;1;1;2
94;30.08.2016;2016;08;23;Tiistai;0;1;1
94;31.08.2016;2016;08;00;Keskiviikko;0;0;0
94;31.08.2016;2016;08;01;Keskiviikko;0;2;2
94;31.08.2016;2016;08;02;Keskiviikko;0;0;0
94;31.08.2016;2016;08;03;Keskiviikko;0;0;0
94;31.08.2016;2016;08;04;Keskiviikko;1;0;1
94;31.08.2016;2016;08;05;Keskiviikko;6;1;7
94;31.08.2016;2016;08;06;Keskiviikko;19;2;21
94;31.08.2016;2016;08;07;Keskiviikko;22;5;27
94;31.08.2016;2016;08;08;Keskiviikko;10;2;12
94;31.08.2016;2016;08;09;Keskiviikko;5;2;7
94;31.08.2016;2016;08;10;Keskiviikko;8;4;12
94;31.08.2016;2016;08;11;Keskiviikko;6;9;15
94;31.08.2016;2016;08;12;Keskiviikko;4;3;7
94;31.08.2016;2016;08;13;Keskiviikko;8;5;13
94;31.08.2016;2016;08;14;Keskiviikko;7;6;13
94;31.08.2016;2016;08;15;Keskiviikko;8;18;26
94;31.08.2016;2016;08;16;Keskiviikko;5;34;39
94;31.08.2016;2016;08;17;Keskiviikko;8;22;30
94;31.08.2016;2016;08;18;Keskiviikko;8;13;21
94;31.08.2016;2016;08;19;Keskiviikko;11;6;17
94;31.08.2016;2016;08;20;Keskiviikko;7;5;12
94;31.08.2016;2016;08;21;Keskiviikko;6;8;14
94;31.08.2016;2016;08;22;Keskiviikko;0;2;2
94;31.08.2016;2016;08;23;Keskiviikko;2;0;2
94;01.09.2016;2016;09;00;Torstai;0;1;1
94;01.09.2016;2016;09;01;Torstai;0;0;0
94;01.09.2016;2016;09;02;Torstai;0;0;0
94;01.09.2016;2016;09;03;Torstai;0;0;0
94;01.09.2016;2016;09;04;Torstai;2;1;3
94;01.09.2016;2016;09;05;Torstai;5;1;6
94;01.09.2016;2016;09;06;Torstai;9;3;12
94;01.09.2016;2016;09;07;Torstai;19;1;20
94;01.09.2016;2016;09;08;Torstai;7;1;8
94;01.09.2016;2016;09;09;Torstai;4;0;4
94;01.09.2016;2016;09;10;Torstai;2;0;2
94;01.09.2016;2016;09;11;Torstai;2;3;5
94;01.09.2016;2016;09;12;Torstai;6;3;9
94;01.09.2016;2016;09;13;Torstai;5;6;11
94;01.09.2016;2016;09;14;Torstai;2;6;8
94;01.09.2016;2016;09;15;Torstai;6;10;16
94;01.09.2016;2016;09;16;Torstai;6;17;23
94;01.09.2016;2016;09;17;Torstai;6;12;18
94;01.09.2016;2016;09;18;Torstai;5;11;16
94;01.09.2016;2016;09;19;Torstai;1;8;9
94;01.09.2016;2016;09;20;Torstai;4;2;6
94;01.09.2016;2016;09;21;Torstai;3;5;8
94;01.09.2016;2016;09;22;Torstai;1;1;2
94;01.09.2016;2016;09;23;Torstai;0;1;1
94;02.09.2016;2016;09;00;Perjantai;0;0;0
94;02.09.2016;2016;09;01;Perjantai;0;0;0
94;02.09.2016;2016;09;02;Perjantai;0;1;1
94;02.09.2016;2016;09;03;Perjantai;0;0;0
94;02.09.2016;2016;09;04;Perjantai;1;0;1
94;02.09.2016;2016;09;05;Perjantai;4;3;7
94;02.09.2016;2016;09;06;Perjantai;8;3;11
94;02.09.2016;2016;09;07;Perjantai;19;5;24
94;02.09.2016;2016;09;08;Perjantai;6;2;8
94;02.09.2016;2016;09;09;Perjantai;8;1;9
94;02.09.2016;2016;09;10;Perjantai;2;4;6
94;02.09.2016;2016;09;11;Perjantai;2;1;3
94;02.09.2016;2016;09;12;Perjantai;3;2;5
94;02.09.2016;2016;09;13;Perjantai;4;5;9
94;02.09.2016;2016;09;14;Perjantai;4;7;11
94;02.09.2016;2016;09;15;Perjantai;8;10;18
94;02.09.2016;2016;09;16;Perjantai;4;16;20
94;02.09.2016;2016;09;17;Perjantai;7;13;20
94;02.09.2016;2016;09;18;Perjantai;8;10;18
94;02.09.2016;2016;09;19;Perjantai;4;8;12
94;02.09.2016;2016;09;20;Perjantai;3;6;9
94;02.09.2016;2016;09;21;Perjantai;1;5;6
94;02.09.2016;2016;09;22;Perjantai;0;4;4
94;02.09.2016;2016;09;23;Perjantai;0;1;1
94;03.09.2016;2016;09;00;Lauantai;0;0;0
94;03.09.2016;2016;09;01;Lauantai;0;2;2
94;03.09.2016;2016;09;02;Lauantai;0;0;0
94;03.09.2016;2016;09;03;Lauantai;0;0;0
94;03.09.2016;2016;09;04;Lauantai;1;0;1
94;03.09.2016;2016;09;05;Lauantai;2;0;2
94;03.09.2016;2016;09;06;Lauantai;0;0;0
94;03.09.2016;2016;09;07;Lauantai;0;0;0
94;03.09.2016;2016;09;08;Lauantai;0;1;1
94;03.09.2016;2016;09;09;Lauantai;5;8;13
94;03.09.2016;2016;09;10;Lauantai;11;6;17
94;03.09.2016;2016;09;11;Lauantai;11;6;17
94;03.09.2016;2016;09;12;Lauantai;15;11;26
94;03.09.2016;2016;09;13;Lauantai;12;9;21
94;03.09.2016;2016;09;14;Lauantai;7;16;23
94;03.09.2016;2016;09;15;Lauantai;8;12;20
94;03.09.2016;2016;09;16;Lauantai;13;4;17
94;03.09.2016;2016;09;17;Lauantai;6;7;13
94;03.09.2016;2016;09;18;Lauantai;7;8;15
94;03.09.2016;2016;09;19;Lauantai;9;9;18
94;03.09.2016;2016;09;20;Lauantai;6;2;8
94;03.09.2016;2016;09;21;Lauantai;0;3;3
94;03.09.2016;2016;09;22;Lauantai;4;2;6
94;03.09.2016;2016;09;23;Lauantai;0;1;1
94;04.09.2016;2016;09;00;Sunnuntai;0;0;0
94;04.09.2016;2016;09;01;Sunnuntai;0;0;0
94;04.09.2016;2016;09;02;Sunnuntai;1;1;2
94;04.09.2016;2016;09;03;Sunnuntai;0;0;0
94;04.09.2016;2016;09;04;Sunnuntai;1;0;1
94;04.09.2016;2016;09;05;Sunnuntai;1;0;1
94;04.09.2016;2016;09;06;Sunnuntai;4;1;5
94;04.09.2016;2016;09;07;Sunnuntai;2;0;2
94;04.09.2016;2016;09;08;Sunnuntai;0;0;0
94;04.09.2016;2016;09;09;Sunnuntai;4;7;11
94;04.09.2016;2016;09;10;Sunnuntai;4;3;7
94;04.09.2016;2016;09;11;Sunnuntai;3;11;14
94;04.09.2016;2016;09;12;Sunnuntai;11;45;56
94;04.09.2016;2016;09;13;Sunnuntai;11;15;26
94;04.09.2016;2016;09;14;Sunnuntai;20;10;30
94;04.09.2016;2016;09;15;Sunnuntai;15;19;34
94;04.09.2016;2016;09;16;Sunnuntai;11;9;20
94;04.09.2016;2016;09;17;Sunnuntai;12;8;20
94;04.09.2016;2016;09;18;Sunnuntai;39;11;50
94;04.09.2016;2016;09;19;Sunnuntai;4;8;12
94;04.09.2016;2016;09;20;Sunnuntai;1;1;2
94;04.09.2016;2016;09;21;Sunnuntai;2;0;2
94;04.09.2016;2016;09;22;Sunnuntai;0;0;0
94;04.09.2016;2016;09;23;Sunnuntai;0;1;1
94;05.09.2016;2016;09;00;Maanantai;0;0;0
94;05.09.2016;2016;09;01;Maanantai;0;0;0
94;05.09.2016;2016;09;02;Maanantai;0;1;1
94;05.09.2016;2016;09;03;Maanantai;1;0;1
94;05.09.2016;2016;09;04;Maanantai;2;0;2
94;05.09.2016;2016;09;05;Maanantai;3;1;4
94;05.09.2016;2016;09;06;Maanantai;14;0;14
94;05.09.2016;2016;09;07;Maanantai;19;4;23
94;05.09.2016;2016;09;08;Maanantai;14;1;15
94;05.09.2016;2016;09;09;Maanantai;4;3;7
94;05.09.2016;2016;09;10;Maanantai;5;4;9
94;05.09.2016;2016;09;11;Maanantai;2;4;6
94;05.09.2016;2016;09;12;Maanantai;5;5;10
94;05.09.2016;2016;09;13;Maanantai;5;12;17
94;05.09.2016;2016;09;14;Maanantai;4;4;8
94;05.09.2016;2016;09;15;Maanantai;11;18;29
94;05.09.2016;2016;09;16;Maanantai;9;30;39
94;05.09.2016;2016;09;17;Maanantai;5;14;19
94;05.09.2016;2016;09;18;Maanantai;10;13;23
94;05.09.2016;2016;09;19;Maanantai;2;3;5
94;05.09.2016;2016;09;20;Maanantai;7;4;11
94;05.09.2016;2016;09;21;Maanantai;6;8;14
94;05.09.2016;2016;09;22;Maanantai;0;3;3
94;05.09.2016;2016;09;23;Maanantai;0;0;0
94;06.09.2016;2016;09;00;Tiistai;0;0;0
94;06.09.2016;2016;09;01;Tiistai;0;0;0
94;06.09.2016;2016;09;02;Tiistai;0;0;0
94;06.09.2016;2016;09;03;Tiistai;0;0;0
94;06.09.2016;2016;09;04;Tiistai;2;0;2
94;06.09.2016;2016;09;05;Tiistai;9;1;10
94;06.09.2016;2016;09;06;Tiistai;21;2;23
94;06.09.2016;2016;09;07;Tiistai;17;3;20
94;06.09.2016;2016;09;08;Tiistai;13;3;16
94;06.09.2016;2016;09;09;Tiistai;6;1;7
94;06.09.2016;2016;09;10;Tiistai;8;5;13
94;06.09.2016;2016;09;11;Tiistai;2;3;5
94;06.09.2016;2016;09;12;Tiistai;3;3;6
94;06.09.2016;2016;09;13;Tiistai;5;5;10
94;06.09.2016;2016;09;14;Tiistai;5;8;13
94;06.09.2016;2016;09;15;Tiistai;6;22;28
94;06.09.2016;2016;09;16;Tiistai;1;24;25
94;06.09.2016;2016;09;17;Tiistai;7;19;26
94;06.09.2016;2016;09;18;Tiistai;5;3;8
94;06.09.2016;2016;09;19;Tiistai;10;7;17
94;06.09.2016;2016;09;20;Tiistai;2;3;5
94;06.09.2016;2016;09;21;Tiistai;1;7;8
94;06.09.2016;2016;09;22;Tiistai;0;3;3
94;06.09.2016;2016;09;23;Tiistai;0;2;2
94;07.09.2016;2016;09;00;Keskiviikko;0;0;0
94;07.09.2016;2016;09;01;Keskiviikko;0;0;0
94;07.09.2016;2016;09;02;Keskiviikko;0;0;0
94;07.09.2016;2016;09;03;Keskiviikko;0;0;0
94;07.09.2016;2016;09;04;Keskiviikko;1;0;1
94;07.09.2016;2016;09;05;Keskiviikko;5;1;6
94;07.09.2016;2016;09;06;Keskiviikko;11;0;11
94;07.09.2016;2016;09;07;Keskiviikko;18;3;21
94;07.09.2016;2016;09;08;Keskiviikko;5;0;5
94;07.09.2016;2016;09;09;Keskiviikko;5;2;7
94;07.09.2016;2016;09;10;Keskiviikko;7;1;8
94;07.09.2016;2016;09;11;Keskiviikko;5;11;16
94;07.09.2016;2016;09;12;Keskiviikko;4;1;5
94;07.09.2016;2016;09;13;Keskiviikko;4;4;8
94;07.09.2016;2016;09;14;Keskiviikko;7;8;15
94;07.09.2016;2016;09;15;Keskiviikko;8;16;24
94;07.09.2016;2016;09;16;Keskiviikko;8;23;31
94;07.09.2016;2016;09;17;Keskiviikko;10;20;30
94;07.09.2016;2016;09;18;Keskiviikko;3;5;8
94;07.09.2016;2016;09;19;Keskiviikko;6;6;12
94;07.09.2016;2016;09;20;Keskiviikko;5;3;8
94;07.09.2016;2016;09;21;Keskiviikko;5;10;15
94;07.09.2016;2016;09;22;Keskiviikko;0;2;2
94;07.09.2016;2016;09;23;Keskiviikko;0;1;1
94;08.09.2016;2016;09;00;Torstai;0;0;0
94;08.09.2016;2016;09;01;Torstai;0;0;0
94;08.09.2016;2016;09;02;Torstai;0;0;0
94;08.09.2016;2016;09;03;Torstai;0;0;0
94;08.09.2016;2016;09;04;Torstai;0;0;0
94;08.09.2016;2016;09;05;Torstai;3;1;4
94;08.09.2016;2016;09;06;Torstai;18;3;21
94;08.09.2016;2016;09;07;Torstai;21;4;25
94;08.09.2016;2016;09;08;Torstai;7;1;8
94;08.09.2016;2016;09;09;Torstai;6;4;10
94;08.09.2016;2016;09;10;Torstai;5;2;7
94;08.09.2016;2016;09;11;Torstai;4;1;5
94;08.09.2016;2016;09;12;Torstai;6;5;11
94;08.09.2016;2016;09;13;Torstai;1;4;5
94;08.09.2016;2016;09;14;Torstai;5;8;13
94;08.09.2016;2016;09;15;Torstai;6;17;23
94;08.09.2016;2016;09;16;Torstai;5;27;32
94;08.09.2016;2016;09;17;Torstai;6;10;16
94;08.09.2016;2016;09;18;Torstai;7;8;15
94;08.09.2016;2016;09;19;Torstai;4;7;11
94;08.09.2016;2016;09;20;Torstai;4;3;7
94;08.09.2016;2016;09;21;Torstai;0;2;2
94;08.09.2016;2016;09;22;Torstai;0;2;2
94;08.09.2016;2016;09;23;Torstai;0;0;0
94;09.09.2016;2016;09;00;Perjantai;0;0;0
94;09.09.2016;2016;09;01;Perjantai;0;0;0
94;09.09.2016;2016;09;02;Perjantai;0;0;0
94;09.09.2016;2016;09;03;Perjantai;0;0;0
94;09.09.2016;2016;09;04;Perjantai;2;0;2
94;09.09.2016;2016;09;05;Perjantai;3;2;5
94;09.09.2016;2016;09;06;Perjantai;11;3;14
94;09.09.2016;2016;09;07;Perjantai;15;3;18
94;09.09.2016;2016;09;08;Perjantai;9;1;10
94;09.09.2016;2016;09;09;Perjantai;6;1;7
94;09.09.2016;2016;09;10;Perjantai;6;1;7
94;09.09.2016;2016;09;11;Perjantai;3;2;5
94;09.09.2016;2016;09;12;Perjantai;7;3;10
94;09.09.2016;2016;09;13;Perjantai;5;9;14
94;09.09.2016;2016;09;14;Perjantai;4;16;20
94;09.09.2016;2016;09;15;Perjantai;9;19;28
94;09.09.2016;2016;09;16;Perjantai;2;15;17
94;09.09.2016;2016;09;17;Perjantai;6;7;13
94;09.09.2016;2016;09;18;Perjantai;3;12;15
94;09.09.2016;2016;09;19;Perjantai;4;8;12
94;09.09.2016;2016;09;20;Perjantai;2;2;4
94;09.09.2016;2016;09;21;Perjantai;2;9;11
94;09.09.2016;2016;09;22;Perjantai;0;1;1
94;09.09.2016;2016;09;23;Perjantai;0;1;1
94;10.09.2016;2016;09;00;Lauantai;0;0;0
94;10.09.2016;2016;09;01;Lauantai;0;0;0
94;10.09.2016;2016;09;02;Lauantai;1;1;2
94;10.09.2016;2016;09;03;Lauantai;0;0;0
94;10.09.2016;2016;09;04;Lauantai;0;1;1
94;10.09.2016;2016;09;05;Lauantai;2;1;3
94;10.09.2016;2016;09;06;Lauantai;1;0;1
94;10.09.2016;2016;09;07;Lauantai;0;1;1
94;10.09.2016;2016;09;08;Lauantai;2;3;5
94;10.09.2016;2016;09;09;Lauantai;3;1;4
94;10.09.2016;2016;09;10;Lauantai;5;2;7
94;10.09.2016;2016;09;11;Lauantai;7;6;13
94;10.09.2016;2016;09;12;Lauantai;11;5;16
94;10.09.2016;2016;09;13;Lauantai;6;9;15
94;10.09.2016;2016;09;14;Lauantai;8;5;13
94;10.09.2016;2016;09;15;Lauantai;6;8;14
94;10.09.2016;2016;09;16;Lauantai;7;2;9
94;10.09.2016;2016;09;17;Lauantai;5;4;9
94;10.09.2016;2016;09;18;Lauantai;8;3;11
94;10.09.2016;2016;09;19;Lauantai;4;11;15
94;10.09.2016;2016;09;20;Lauantai;8;3;11
94;10.09.2016;2016;09;21;Lauantai;0;0;0
94;10.09.2016;2016;09;22;Lauantai;0;5;5
94;10.09.2016;2016;09;23;Lauantai;0;4;4
94;11.09.2016;2016;09;00;Sunnuntai;0;2;2
94;11.09.2016;2016;09;01;Sunnuntai;0;2;2
94;11.09.2016;2016;09;02;Sunnuntai;0;0;0
94;11.09.2016;2016;09;03;Sunnuntai;0;1;1
94;11.09.2016;2016;09;04;Sunnuntai;0;0;0
94;11.09.2016;2016;09;05;Sunnuntai;2;0;2
94;11.09.2016;2016;09;06;Sunnuntai;2;0;2
94;11.09.2016;2016;09;07;Sunnuntai;0;1;1
94;11.09.2016;2016;09;08;Sunnuntai;2;0;2
94;11.09.2016;2016;09;09;Sunnuntai;2;3;5
94;11.09.2016;2016;09;10;Sunnuntai;6;4;10
94;11.09.2016;2016;09;11;Sunnuntai;5;8;13
94;11.09.2016;2016;09;12;Sunnuntai;6;9;15
94;11.09.2016;2016;09;13;Sunnuntai;8;10;18
94;11.09.2016;2016;09;14;Sunnuntai;8;8;16
94;11.09.2016;2016;09;15;Sunnuntai;7;4;11
94;11.09.2016;2016;09;16;Sunnuntai;12;13;25
94;11.09.2016;2016;09;17;Sunnuntai;15;4;19
94;11.09.2016;2016;09;18;Sunnuntai;7;6;13
94;11.09.2016;2016;09;19;Sunnuntai;4;4;8
94;11.09.2016;2016;09;20;Sunnuntai;1;8;9
94;11.09.2016;2016;09;21;Sunnuntai;1;3;4
94;11.09.2016;2016;09;22;Sunnuntai;0;1;1
94;11.09.2016;2016;09;23;Sunnuntai;0;0;0
94;12.09.2016;2016;09;00;Maanantai;0;0;0
94;12.09.2016;2016;09;01;Maanantai;0;0;0
94;12.09.2016;2016;09;02;Maanantai;0;0;0
94;12.09.2016;2016;09;03;Maanantai;0;0;0
94;12.09.2016;2016;09;04;Maanantai;1;0;1
94;12.09.2016;2016;09;05;Maanantai;6;1;7
94;12.09.2016;2016;09;06;Maanantai;10;1;11
94;12.09.2016;2016;09;07;Maanantai;14;2;16
94;12.09.2016;2016;09;08;Maanantai;11;0;11
94;12.09.2016;2016;09;09;Maanantai;4;0;4
94;12.09.2016;2016;09;10;Maanantai;0;0;0
94;12.09.2016;2016;09;11;Maanantai;2;3;5
94;12.09.2016;2016;09;12;Maanantai;3;3;6
94;12.09.2016;2016;09;13;Maanantai;3;1;4
94;12.09.2016;2016;09;14;Maanantai;3;10;13
94;12.09.2016;2016;09;15;Maanantai;4;14;18
94;12.09.2016;2016;09;16;Maanantai;5;14;19
94;12.09.2016;2016;09;17;Maanantai;1;10;11
94;12.09.2016;2016;09;18;Maanantai;2;8;10
94;12.09.2016;2016;09;19;Maanantai;9;5;14
94;12.09.2016;2016;09;20;Maanantai;0;5;5
94;12.09.2016;2016;09;21;Maanantai;0;4;4
94;12.09.2016;2016;09;22;Maanantai;1;3;4
94;12.09.2016;2016;09;23;Maanantai;0;1;1
94;13.09.2016;2016;09;00;Tiistai;0;0;0
94;13.09.2016;2016;09;01;Tiistai;0;0;0
94;13.09.2016;2016;09;02;Tiistai;0;0;0
94;13.09.2016;2016;09;03;Tiistai;0;0;0
94;13.09.2016;2016;09;04;Tiistai;1;0;1
94;13.09.2016;2016;09;05;Tiistai;6;2;8
94;13.09.2016;2016;09;06;Tiistai;15;1;16
94;13.09.2016;2016;09;07;Tiistai;18;3;21
94;13.09.2016;2016;09;08;Tiistai;15;5;20
94;13.09.2016;2016;09;09;Tiistai;1;5;6
94;13.09.2016;2016;09;10;Tiistai;8;1;9
94;13.09.2016;2016;09;11;Tiistai;6;3;9
94;13.09.2016;2016;09;12;Tiistai;4;4;8
94;13.09.2016;2016;09;13;Tiistai;3;5;8
94;13.09.2016;2016;09;14;Tiistai;6;15;21
94;13.09.2016;2016;09;15;Tiistai;6;18;24
94;13.09.2016;2016;09;16;Tiistai;10;23;33
94;13.09.2016;2016;09;17;Tiistai;7;15;22
94;13.09.2016;2016;09;18;Tiistai;9;14;23
94;13.09.2016;2016;09;19;Tiistai;12;5;17
94;13.09.2016;2016;09;20;Tiistai;6;13;19
94;13.09.2016;2016;09;21;Tiistai;1;1;2
94;13.09.2016;2016;09;22;Tiistai;0;0;0
94;13.09.2016;2016;09;23;Tiistai;0;0;0
94;14.09.2016;2016;09;00;Keskiviikko;0;0;0
94;14.09.2016;2016;09;01;Keskiviikko;0;0;0
94;14.09.2016;2016;09;02;Keskiviikko;0;0;0
94;14.09.2016;2016;09;03;Keskiviikko;0;0;0
94;14.09.2016;2016;09;04;Keskiviikko;2;0;2
94;14.09.2016;2016;09;05;Keskiviikko;5;3;8
94;14.09.2016;2016;09;06;Keskiviikko;20;1;21
94;14.09.2016;2016;09;07;Keskiviikko;13;5;18
94;14.09.2016;2016;09;08;Keskiviikko;10;1;11
94;14.09.2016;2016;09;09;Keskiviikko;3;6;9
94;14.09.2016;2016;09;10;Keskiviikko;12;2;14
94;14.09.2016;2016;09;11;Keskiviikko;1;4;5
94;14.09.2016;2016;09;12;Keskiviikko;8;5;13
94;14.09.2016;2016;09;13;Keskiviikko;9;5;14
94;14.09.2016;2016;09;14;Keskiviikko;7;13;20
94;14.09.2016;2016;09;15;Keskiviikko;9;20;29
94;14.09.2016;2016;09;16;Keskiviikko;9;28;37
94;14.09.2016;2016;09;17;Keskiviikko;5;13;18
94;14.09.2016;2016;09;18;Keskiviikko;5;10;15
94;14.09.2016;2016;09;19;Keskiviikko;7;3;10
94;14.09.2016;2016;09;20;Keskiviikko;1;1;2
94;14.09.2016;2016;09;21;Keskiviikko;2;5;7
94;14.09.2016;2016;09;22;Keskiviikko;1;3;4
94;14.09.2016;2016;09;23;Keskiviikko;0;0;0
94;15.09.2016;2016;09;00;Torstai;0;0;0
94;15.09.2016;2016;09;01;Torstai;0;0;0
94;15.09.2016;2016;09;02;Torstai;0;0;0
94;15.09.2016;2016;09;03;Torstai;0;0;0
94;15.09.2016;2016;09;04;Torstai;2;0;2
94;15.09.2016;2016;09;05;Torstai;5;1;6
94;15.09.2016;2016;09;06;Torstai;20;2;22
94;15.09.2016;2016;09;07;Torstai;25;4;29
94;15.09.2016;2016;09;08;Torstai;11;1;12
94;15.09.2016;2016;09;09;Torstai;8;3;11
94;15.09.2016;2016;09;10;Torstai;1;2;3
94;15.09.2016;2016;09;11;Torstai;7;3;10
94;15.09.2016;2016;09;12;Torstai;6;2;8
94;15.09.2016;2016;09;13;Torstai;4;6;10
94;15.09.2016;2016;09;14;Torstai;3;4;7
94;15.09.2016;2016;09;15;Torstai;4;19;23
94;15.09.2016;2016;09;16;Torstai;8;32;40
94;15.09.2016;2016;09;17;Torstai;3;17;20
94;15.09.2016;2016;09;18;Torstai;7;6;13
94;15.09.2016;2016;09;19;Torstai;3;2;5
94;15.09.2016;2016;09;20;Torstai;5;4;9
94;15.09.2016;2016;09;21;Torstai;3;8;11
94;15.09.2016;2016;09;22;Torstai;0;4;4
94;15.09.2016;2016;09;23;Torstai;0;2;2
94;16.09.2016;2016;09;00;Perjantai;1;1;2
94;16.09.2016;2016;09;01;Perjantai;0;0;0
94;16.09.2016;2016;09;02;Perjantai;0;0;0
94;16.09.2016;2016;09;03;Perjantai;0;0;0
94;16.09.2016;2016;09;04;Perjantai;1;0;1
94;16.09.2016;2016;09;05;Perjantai;3;0;3
94;16.09.2016;2016;09;06;Perjantai;7;2;9
94;16.09.2016;2016;09;07;Perjantai;25;4;29
94;16.09.2016;2016;09;08;Perjantai;10;1;11
94;16.09.2016;2016;09;09;Perjantai;7;2;9
94;16.09.2016;2016;09;10;Perjantai;2;2;4
94;16.09.2016;2016;09;11;Perjantai;3;3;6
94;16.09.2016;2016;09;12;Perjantai;8;2;10
94;16.09.2016;2016;09;13;Perjantai;5;7;12
94;16.09.2016;2016;09;14;Perjantai;5;13;18
94;16.09.2016;2016;09;15;Perjantai;7;21;28
94;16.09.2016;2016;09;16;Perjantai;7;24;31
94;16.09.2016;2016;09;17;Perjantai;1;14;15
94;16.09.2016;2016;09;18;Perjantai;5;4;9
94;16.09.2016;2016;09;19;Perjantai;8;1;9
94;16.09.2016;2016;09;20;Perjantai;8;5;13
94;16.09.2016;2016;09;21;Perjantai;4;6;10
94;16.09.2016;2016;09;22;Perjantai;1;4;5
94;16.09.2016;2016;09;23;Perjantai;0;4;4
94;17.09.2016;2016;09;00;Lauantai;1;3;4
94;17.09.2016;2016;09;01;Lauantai;0;0;0
94;17.09.2016;2016;09;02;Lauantai;0;0;0
94;17.09.2016;2016;09;03;Lauantai;0;0;0
94;17.09.2016;2016;09;04;Lauantai;0;0;0
94;17.09.2016;2016;09;05;Lauantai;2;0;2
94;17.09.2016;2016;09;06;Lauantai;0;2;2
94;17.09.2016;2016;09;07;Lauantai;3;0;3
94;17.09.2016;2016;09;08;Lauantai;1;5;6
94;17.09.2016;2016;09;09;Lauantai;4;8;12
94;17.09.2016;2016;09;10;Lauantai;7;12;19
94;17.09.2016;2016;09;11;Lauantai;4;7;11
94;17.09.2016;2016;09;12;Lauantai;2;16;18
94;17.09.2016;2016;09;13;Lauantai;11;7;18
94;17.09.2016;2016;09;14;Lauantai;8;8;16
94;17.09.2016;2016;09;15;Lauantai;8;7;15
94;17.09.2016;2016;09;16;Lauantai;13;4;17
94;17.09.2016;2016;09;17;Lauantai;9;10;19
94;17.09.2016;2016;09;18;Lauantai;9;5;14
94;17.09.2016;2016;09;19;Lauantai;3;1;4
94;17.09.2016;2016;09;20;Lauantai;2;1;3
94;17.09.2016;2016;09;21;Lauantai;2;1;3
94;17.09.2016;2016;09;22;Lauantai;0;2;2
94;17.09.2016;2016;09;23;Lauantai;1;0;1
94;18.09.2016;2016;09;00;Sunnuntai;1;1;2
94;18.09.2016;2016;09;01;Sunnuntai;0;0;0
94;18.09.2016;2016;09;02;Sunnuntai;2;1;3
94;18.09.2016;2016;09;03;Sunnuntai;0;0;0
94;18.09.2016;2016;09;04;Sunnuntai;0;0;0
94;18.09.2016;2016;09;05;Sunnuntai;1;0;1
94;18.09.2016;2016;09;06;Sunnuntai;0;1;1
94;18.09.2016;2016;09;07;Sunnuntai;0;0;0
94;18.09.2016;2016;09;08;Sunnuntai;2;2;4
94;18.09.2016;2016;09;09;Sunnuntai;2;1;3
94;18.09.2016;2016;09;10;Sunnuntai;2;4;6
94;18.09.2016;2016;09;11;Sunnuntai;2;19;21
94;18.09.2016;2016;09;12;Sunnuntai;14;13;27
94;18.09.2016;2016;09;13;Sunnuntai;10;16;26
94;18.09.2016;2016;09;14;Sunnuntai;10;16;26
94;18.09.2016;2016;09;15;Sunnuntai;10;8;18
94;18.09.2016;2016;09;16;Sunnuntai;9;5;14
94;18.09.2016;2016;09;17;Sunnuntai;22;4;26
94;18.09.2016;2016;09;18;Sunnuntai;8;3;11
94;18.09.2016;2016;09;19;Sunnuntai;6;1;7
94;18.09.2016;2016;09;20;Sunnuntai;5;2;7
94;18.09.2016;2016;09;21;Sunnuntai;0;2;2
94;18.09.2016;2016;09;22;Sunnuntai;0;3;3
94;18.09.2016;2016;09;23;Sunnuntai;0;0;0
94;19.09.2016;2016;09;00;Maanantai;0;0;0
94;19.09.2016;2016;09;01;Maanantai;0;0;0
94;19.09.2016;2016;09;02;Maanantai;0;0;0
94;19.09.2016;2016;09;03;Maanantai;0;0;0
94;19.09.2016;2016;09;04;Maanantai;2;1;3
94;19.09.2016;2016;09;05;Maanantai;5;2;7
94;19.09.2016;2016;09;06;Maanantai;14;3;17
94;19.09.2016;2016;09;07;Maanantai;22;5;27
94;19.09.2016;2016;09;08;Maanantai;8;2;10
94;19.09.2016;2016;09;09;Maanantai;8;2;10
94;19.09.2016;2016;09;10;Maanantai;1;5;6
94;19.09.2016;2016;09;11;Maanantai;3;3;6
94;19.09.2016;2016;09;12;Maanantai;5;3;8
94;19.09.2016;2016;09;13;Maanantai;5;2;7
94;19.09.2016;2016;09;14;Maanantai;6;10;16
94;19.09.2016;2016;09;15;Maanantai;5;18;23
94;19.09.2016;2016;09;16;Maanantai;8;27;35
94;19.09.2016;2016;09;17;Maanantai;3;12;15
94;19.09.2016;2016;09;18;Maanantai;1;8;9
94;19.09.2016;2016;09;19;Maanantai;6;7;13
94;19.09.2016;2016;09;20;Maanantai;7;2;9
94;19.09.2016;2016;09;21;Maanantai;1;5;6
94;19.09.2016;2016;09;22;Maanantai;1;2;3
94;19.09.2016;2016;09;23;Maanantai;0;0;0
94;20.09.2016;2016;09;00;Tiistai;0;0;0
94;20.09.2016;2016;09;01;Tiistai;0;1;1
94;20.09.2016;2016;09;02;Tiistai;0;0;0
94;20.09.2016;2016;09;03;Tiistai;0;0;0
94;20.09.2016;2016;09;04;Tiistai;1;0;1
94;20.09.2016;2016;09;05;Tiistai;4;2;6
94;20.09.2016;2016;09;06;Tiistai;16;3;19
94;20.09.2016;2016;09;07;Tiistai;21;1;22
94;20.09.2016;2016;09;08;Tiistai;7;1;8
94;20.09.2016;2016;09;09;Tiistai;7;1;8
94;20.09.2016;2016;09;10;Tiistai;4;0;4
94;20.09.2016;2016;09;11;Tiistai;6;3;9
94;20.09.2016;2016;09;12;Tiistai;6;5;11
94;20.09.2016;2016;09;13;Tiistai;3;5;8
94;20.09.2016;2016;09;14;Tiistai;3;10;13
94;20.09.2016;2016;09;15;Tiistai;7;14;21
94;20.09.2016;2016;09;16;Tiistai;5;30;35
94;20.09.2016;2016;09;17;Tiistai;2;8;10
94;20.09.2016;2016;09;18;Tiistai;2;5;7
94;20.09.2016;2016;09;19;Tiistai;9;7;16
94;20.09.2016;2016;09;20;Tiistai;2;2;4
94;20.09.2016;2016;09;21;Tiistai;3;8;11
94;20.09.2016;2016;09;22;Tiistai;0;3;3
94;20.09.2016;2016;09;23;Tiistai;0;0;0
94;21.09.2016;2016;09;00;Keskiviikko;0;0;0
94;21.09.2016;2016;09;01;Keskiviikko;0;0;0
94;21.09.2016;2016;09;02;Keskiviikko;0;1;1
94;21.09.2016;2016;09;03;Keskiviikko;0;0;0
94;21.09.2016;2016;09;04;Keskiviikko;1;1;2
94;21.09.2016;2016;09;05;Keskiviikko;5;1;6
94;21.09.2016;2016;09;06;Keskiviikko;19;1;20
94;21.09.2016;2016;09;07;Keskiviikko;15;3;18
94;21.09.2016;2016;09;08;Keskiviikko;13;0;13
94;21.09.2016;2016;09;09;Keskiviikko;2;3;5
94;21.09.2016;2016;09;10;Keskiviikko;5;2;7
94;21.09.2016;2016;09;11;Keskiviikko;3;3;6
94;21.09.2016;2016;09;12;Keskiviikko;5;2;7
94;21.09.2016;2016;09;13;Keskiviikko;1;3;4
94;21.09.2016;2016;09;14;Keskiviikko;6;10;16
94;21.09.2016;2016;09;15;Keskiviikko;7;14;21
94;21.09.2016;2016;09;16;Keskiviikko;11;21;32
94;21.09.2016;2016;09;17;Keskiviikko;5;18;23
94;21.09.2016;2016;09;18;Keskiviikko;5;9;14
94;21.09.2016;2016;09;19;Keskiviikko;7;4;11
94;21.09.2016;2016;09;20;Keskiviikko;5;6;11
94;21.09.2016;2016;09;21;Keskiviikko;4;5;9
94;21.09.2016;2016;09;22;Keskiviikko;0;1;1
94;21.09.2016;2016;09;23;Keskiviikko;0;0;0
94;22.09.2016;2016;09;00;Torstai;0;0;0
94;22.09.2016;2016;09;01;Torstai;0;1;1
94;22.09.2016;2016;09;02;Torstai;0;0;0
94;22.09.2016;2016;09;03;Torstai;0;0;0
94;22.09.2016;2016;09;04;Torstai;1;0;1
94;22.09.2016;2016;09;05;Torstai;4;3;7
94;22.09.2016;2016;09;06;Torstai;11;2;13
94;22.09.2016;2016;09;07;Torstai;16;4;20
94;22.09.2016;2016;09;08;Torstai;8;1;9
94;22.09.2016;2016;09;09;Torstai;2;1;3
94;22.09.2016;2016;09;10;Torstai;5;5;10
94;22.09.2016;2016;09;11;Torstai;5;1;6
94;22.09.2016;2016;09;12;Torstai;2;2;4
94;22.09.2016;2016;09;13;Torstai;3;5;8
94;22.09.2016;2016;09;14;Torstai;6;12;18
94;22.09.2016;2016;09;15;Torstai;5;10;15
94;22.09.2016;2016;09;16;Torstai;9;14;23
94;22.09.2016;2016;09;17;Torstai;6;11;17
94;22.09.2016;2016;09;18;Torstai;6;6;12
94;22.09.2016;2016;09;19;Torstai;4;6;10
94;22.09.2016;2016;09;20;Torstai;5;9;14
94;22.09.2016;2016;09;21;Torstai;2;5;7
94;22.09.2016;2016;09;22;Torstai;0;1;1
94;22.09.2016;2016;09;23;Torstai;0;1;1
94;23.09.2016;2016;09;00;Perjantai;0;0;0
94;23.09.2016;2016;09;01;Perjantai;1;1;2
94;23.09.2016;2016;09;02;Perjantai;0;0;0
94;23.09.2016;2016;09;03;Perjantai;0;0;0
94;23.09.2016;2016;09;04;Perjantai;2;0;2
94;23.09.2016;2016;09;05;Perjantai;4;1;5
94;23.09.2016;2016;09;06;Perjantai;7;1;8
94;23.09.2016;2016;09;07;Perjantai;17;2;19
94;23.09.2016;2016;09;08;Perjantai;5;2;7
94;23.09.2016;2016;09;09;Perjantai;1;2;3
94;23.09.2016;2016;09;10;Perjantai;2;2;4
94;23.09.2016;2016;09;11;Perjantai;1;3;4
94;23.09.2016;2016;09;12;Perjantai;6;5;11
94;23.09.2016;2016;09;13;Perjantai;2;3;5
94;23.09.2016;2016;09;14;Perjantai;3;10;13
94;23.09.2016;2016;09;15;Perjantai;7;14;21
94;23.09.2016;2016;09;16;Perjantai;4;13;17
94;23.09.2016;2016;09;17;Perjantai;2;9;11
94;23.09.2016;2016;09;18;Perjantai;6;4;10
94;23.09.2016;2016;09;19;Perjantai;1;5;6
94;23.09.2016;2016;09;20;Perjantai;2;3;5
94;23.09.2016;2016;09;21;Perjantai;4;2;6
94;23.09.2016;2016;09;22;Perjantai;2;1;3
94;23.09.2016;2016;09;23;Perjantai;0;0;0
94;24.09.2016;2016;09;00;Lauantai;0;0;0
94;24.09.2016;2016;09;01;Lauantai;0;1;1
94;24.09.2016;2016;09;02;Lauantai;1;0;1
94;24.09.2016;2016;09;03;Lauantai;0;0;0
94;24.09.2016;2016;09;04;Lauantai;1;1;2
94;24.09.2016;2016;09;05;Lauantai;2;0;2
94;24.09.2016;2016;09;06;Lauantai;1;2;3
94;24.09.2016;2016;09;07;Lauantai;0;1;1
94;24.09.2016;2016;09;08;Lauantai;0;0;0
94;24.09.2016;2016;09;09;Lauantai;2;4;6
94;24.09.2016;2016;09;10;Lauantai;2;0;2
94;24.09.2016;2016;09;11;Lauantai;1;3;4
94;24.09.2016;2016;09;12;Lauantai;6;4;10
94;24.09.2016;2016;09;13;Lauantai;4;9;13
94;24.09.2016;2016;09;14;Lauantai;9;6;15
94;24.09.2016;2016;09;15;Lauantai;3;6;9
94;24.09.2016;2016;09;16;Lauantai;2;5;7
94;24.09.2016;2016;09;17;Lauantai;3;2;5
94;24.09.2016;2016;09;18;Lauantai;6;3;9
94;24.09.2016;2016;09;19;Lauantai;1;0;1
94;24.09.2016;2016;09;20;Lauantai;1;0;1
94;24.09.2016;2016;09;21;Lauantai;0;1;1
94;24.09.2016;2016;09;22;Lauantai;0;0;0
94;24.09.2016;2016;09;23;Lauantai;0;2;2
94;25.09.2016;2016;09;00;Sunnuntai;3;3;6
94;25.09.2016;2016;09;01;Sunnuntai;0;0;0
94;25.09.2016;2016;09;02;Sunnuntai;0;0;0
94;25.09.2016;2016;09;03;Sunnuntai;0;0;0
94;25.09.2016;2016;09;04;Sunnuntai;2;0;2
94;25.09.2016;2016;09;05;Sunnuntai;0;0;0
94;25.09.2016;2016;09;06;Sunnuntai;1;0;1
94;25.09.2016;2016;09;07;Sunnuntai;0;1;1
94;25.09.2016;2016;09;08;Sunnuntai;0;1;1
94;25.09.2016;2016;09;09;Sunnuntai;2;1;3
94;25.09.2016;2016;09;10;Sunnuntai;6;4;10
94;25.09.2016;2016;09;11;Sunnuntai;3;2;5
94;25.09.2016;2016;09;12;Sunnuntai;8;7;15
94;25.09.2016;2016;09;13;Sunnuntai;4;11;15
94;25.09.2016;2016;09;14;Sunnuntai;4;5;9
94;25.09.2016;2016;09;15;Sunnuntai;5;4;9
94;25.09.2016;2016;09;16;Sunnuntai;4;3;7
94;25.09.2016;2016;09;17;Sunnuntai;8;4;12
94;25.09.2016;2016;09;18;Sunnuntai;8;5;13
94;25.09.2016;2016;09;19;Sunnuntai;2;5;7
94;25.09.2016;2016;09;20;Sunnuntai;6;2;8
94;25.09.2016;2016;09;21;Sunnuntai;0;2;2
94;25.09.2016;2016;09;22;Sunnuntai;0;1;1
94;25.09.2016;2016;09;23;Sunnuntai;0;0;0
94;26.09.2016;2016;09;00;Maanantai;0;0;0
94;26.09.2016;2016;09;01;Maanantai;0;0;0
94;26.09.2016;2016;09;02;Maanantai;0;0;0
94;26.09.2016;2016;09;03;Maanantai;0;0;0
94;26.09.2016;2016;09;04;Maanantai;1;0;1
94;26.09.2016;2016;09;05;Maanantai;4;2;6
94;26.09.2016;2016;09;06;Maanantai;15;3;18
94;26.09.2016;2016;09;07;Maanantai;18;2;20
94;26.09.2016;2016;09;08;Maanantai;8;1;9
94;26.09.2016;2016;09;09;Maanantai;4;3;7
94;26.09.2016;2016;09;10;Maanantai;2;3;5
94;26.09.2016;2016;09;11;Maanantai;7;2;9
94;26.09.2016;2016;09;12;Maanantai;7;3;10
94;26.09.2016;2016;09;13;Maanantai;2;3;5
94;26.09.2016;2016;09;14;Maanantai;3;14;17
94;26.09.2016;2016;09;15;Maanantai;12;12;24
94;26.09.2016;2016;09;16;Maanantai;4;19;23
94;26.09.2016;2016;09;17;Maanantai;2;17;19
94;26.09.2016;2016;09;18;Maanantai;5;12;17
94;26.09.2016;2016;09;19;Maanantai;6;5;11
94;26.09.2016;2016;09;20;Maanantai;4;4;8
94;26.09.2016;2016;09;21;Maanantai;4;2;6
94;26.09.2016;2016;09;22;Maanantai;0;2;2
94;26.09.2016;2016;09;23;Maanantai;1;1;2
94;27.09.2016;2016;09;00;Tiistai;0;0;0
94;27.09.2016;2016;09;01;Tiistai;0;0;0
94;27.09.2016;2016;09;02;Tiistai;0;0;0
94;27.09.2016;2016;09;03;Tiistai;0;0;0
94;27.09.2016;2016;09;04;Tiistai;1;0;1
94;27.09.2016;2016;09;05;Tiistai;5;2;7
94;27.09.2016;2016;09;06;Tiistai;19;3;22
94;27.09.2016;2016;09;07;Tiistai;15;4;19
94;27.09.2016;2016;09;08;Tiistai;7;3;10
94;27.09.2016;2016;09;09;Tiistai;4;0;4
94;27.09.2016;2016;09;10;Tiistai;5;1;6
94;27.09.2016;2016;09;11;Tiistai;4;5;9
94;27.09.2016;2016;09;12;Tiistai;5;8;13
94;27.09.2016;2016;09;13;Tiistai;9;10;19
94;27.09.2016;2016;09;14;Tiistai;9;5;14
94;27.09.2016;2016;09;15;Tiistai;8;15;23
94;27.09.2016;2016;09;16;Tiistai;10;18;28
94;27.09.2016;2016;09;17;Tiistai;3;17;20
94;27.09.2016;2016;09;18;Tiistai;7;15;22
94;27.09.2016;2016;09;19;Tiistai;12;3;15
94;27.09.2016;2016;09;20;Tiistai;4;3;7
94;27.09.2016;2016;09;21;Tiistai;3;3;6
94;27.09.2016;2016;09;22;Tiistai;0;1;1
94;27.09.2016;2016;09;23;Tiistai;0;0;0
94;28.09.2016;2016;09;00;Keskiviikko;0;0;0
94;28.09.2016;2016;09;01;Keskiviikko;0;1;1
94;28.09.2016;2016;09;02;Keskiviikko;0;0;0
94;28.09.2016;2016;09;03;Keskiviikko;0;0;0
94;28.09.2016;2016;09;04;Keskiviikko;1;0;1
94;28.09.2016;2016;09;05;Keskiviikko;6;3;9
94;28.09.2016;2016;09;06;Keskiviikko;14;2;16
94;28.09.2016;2016;09;07;Keskiviikko;10;5;15
94;28.09.2016;2016;09;08;Keskiviikko;8;1;9
94;28.09.2016;2016;09;09;Keskiviikko;3;3;6
94;28.09.2016;2016;09;10;Keskiviikko;2;0;2
94;28.09.2016;2016;09;11;Keskiviikko;4;2;6
94;28.09.2016;2016;09;12;Keskiviikko;2;2;4
94;28.09.2016;2016;09;13;Keskiviikko;3;1;4
94;28.09.2016;2016;09;14;Keskiviikko;6;9;15
94;28.09.2016;2016;09;15;Keskiviikko;4;9;13
94;28.09.2016;2016;09;16;Keskiviikko;4;11;15
94;28.09.2016;2016;09;17;Keskiviikko;1;6;7
94;28.09.2016;2016;09;18;Keskiviikko;0;2;2
94;28.09.2016;2016;09;19;Keskiviikko;1;1;2
94;28.09.2016;2016;09;20;Keskiviikko;2;1;3
94;28.09.2016;2016;09;21;Keskiviikko;2;5;7
94;28.09.2016;2016;09;22;Keskiviikko;0;0;0
94;28.09.2016;2016;09;23;Keskiviikko;0;0;0
94;29.09.2016;2016;09;00;Torstai;0;0;0
94;29.09.2016;2016;09;01;Torstai;0;0;0
94;29.09.2016;2016;09;02;Torstai;0;0;0
94;29.09.2016;2016;09;03;Torstai;0;0;0
94;29.09.2016;2016;09;04;Torstai;2;0;2
94;29.09.2016;2016;09;05;Torstai;3;0;3
94;29.09.2016;2016;09;06;Torstai;5;3;8
94;29.09.2016;2016;09;07;Torstai;16;4;20
94;29.09.2016;2016;09;08;Torstai;3;0;3
94;29.09.2016;2016;09;09;Torstai;4;1;5
94;29.09.2016;2016;09;10;Torstai;2;1;3
94;29.09.2016;2016;09;11;Torstai;3;2;5
94;29.09.2016;2016;09;12;Torstai;6;1;7
94;29.09.2016;2016;09;13;Torstai;4;8;12
94;29.09.2016;2016;09;14;Torstai;2;8;10
94;29.09.2016;2016;09;15;Torstai;6;7;13
94;29.09.2016;2016;09;16;Torstai;5;11;16
94;29.09.2016;2016;09;17;Torstai;7;8;15
94;29.09.2016;2016;09;18;Torstai;5;4;9
94;29.09.2016;2016;09;19;Torstai;2;5;7
94;29.09.2016;2016;09;20;Torstai;2;1;3
94;29.09.2016;2016;09;21;Torstai;0;2;2
94;29.09.2016;2016;09;22;Torstai;0;1;1
94;29.09.2016;2016;09;23;Torstai;0;0;0
94;30.09.2016;2016;09;00;Perjantai;0;1;1
94;30.09.2016;2016;09;01;Perjantai;0;0;0
94;30.09.2016;2016;09;02;Perjantai;0;0;0
94;30.09.2016;2016;09;03;Perjantai;0;0;0
94;30.09.2016;2016;09;04;Perjantai;0;2;2
94;30.09.2016;2016;09;05;Perjantai;3;0;3
94;30.09.2016;2016;09;06;Perjantai;1;3;4
94;30.09.2016;2016;09;07;Perjantai;7;2;9
94;30.09.2016;2016;09;08;Perjantai;8;1;9
94;30.09.2016;2016;09;09;Perjantai;3;1;4
94;30.09.2016;2016;09;10;Perjantai;1;3;4
94;30.09.2016;2016;09;11;Perjantai;3;1;4
94;30.09.2016;2016;09;12;Perjantai;3;1;4
94;30.09.2016;2016;09;13;Perjantai;3;0;3
94;30.09.2016;2016;09;14;Perjantai;1;7;8
94;30.09.2016;2016;09;15;Perjantai;8;11;19
94;30.09.2016;2016;09;16;Perjantai;4;7;11
94;30.09.2016;2016;09;17;Perjantai;6;9;15
94;30.09.2016;2016;09;18;Perjantai;0;7;7
94;30.09.2016;2016;09;19;Perjantai;5;2;7
94;30.09.2016;2016;09;20;Perjantai;4;2;6
94;30.09.2016;2016;09;21;Perjantai;2;4;6
94;30.09.2016;2016;09;22;Perjantai;2;3;5
94;30.09.2016;2016;09;23;Perjantai;0;0;0
94;01.10.2016;2016;10;00;Lauantai;2;2;4
94;01.10.2016;2016;10;01;Lauantai;0;0;0
94;01.10.2016;2016;10;02;Lauantai;1;0;1
94;01.10.2016;2016;10;03;Lauantai;0;0;0
94;01.10.2016;2016;10;04;Lauantai;0;0;0
94;01.10.2016;2016;10;05;Lauantai;1;1;2
94;01.10.2016;2016;10;06;Lauantai;3;0;3
94;01.10.2016;2016;10;07;Lauantai;1;1;2
94;01.10.2016;2016;10;08;Lauantai;1;0;1
94;01.10.2016;2016;10;09;Lauantai;6;2;8
94;01.10.2016;2016;10;10;Lauantai;3;2;5
94;01.10.2016;2016;10;11;Lauantai;5;4;9
94;01.10.2016;2016;10;12;Lauantai;2;5;7
94;01.10.2016;2016;10;13;Lauantai;3;3;6
94;01.10.2016;2016;10;14;Lauantai;2;6;8
94;01.10.2016;2016;10;15;Lauantai;2;4;6
94;01.10.2016;2016;10;16;Lauantai;5;3;8
94;01.10.2016;2016;10;17;Lauantai;4;10;14
94;01.10.2016;2016;10;18;Lauantai;2;2;4
94;01.10.2016;2016;10;19;Lauantai;6;2;8
94;01.10.2016;2016;10;20;Lauantai;1;1;2
94;01.10.2016;2016;10;21;Lauantai;3;2;5
94;01.10.2016;2016;10;22;Lauantai;0;4;4
94;01.10.2016;2016;10;23;Lauantai;1;0;1
94;02.10.2016;2016;10;00;Sunnuntai;0;2;2
94;02.10.2016;2016;10;01;Sunnuntai;1;0;1
94;02.10.2016;2016;10;02;Sunnuntai;0;1;1
94;02.10.2016;2016;10;03;Sunnuntai;0;0;0
94;02.10.2016;2016;10;04;Sunnuntai;0;0;0
94;02.10.2016;2016;10;05;Sunnuntai;1;0;1
94;02.10.2016;2016;10;06;Sunnuntai;1;1;2
94;02.10.2016;2016;10;07;Sunnuntai;2;2;4
94;02.10.2016;2016;10;08;Sunnuntai;0;3;3
94;02.10.2016;2016;10;09;Sunnuntai;2;0;2
94;02.10.2016;2016;10;10;Sunnuntai;8;10;18
94;02.10.2016;2016;10;11;Sunnuntai;8;9;17
94;02.10.2016;2016;10;12;Sunnuntai;6;8;14
94;02.10.2016;2016;10;13;Sunnuntai;11;4;15
94;02.10.2016;2016;10;14;Sunnuntai;2;4;6
94;02.10.2016;2016;10;15;Sunnuntai;9;5;14
94;02.10.2016;2016;10;16;Sunnuntai;6;6;12
94;02.10.2016;2016;10;17;Sunnuntai;10;3;13
94;02.10.2016;2016;10;18;Sunnuntai;4;4;8
94;02.10.2016;2016;10;19;Sunnuntai;2;0;2
94;02.10.2016;2016;10;20;Sunnuntai;2;3;5
94;02.10.2016;2016;10;21;Sunnuntai;0;2;2
94;02.10.2016;2016;10;22;Sunnuntai;1;0;1
94;02.10.2016;2016;10;23;Sunnuntai;0;0;0
94;03.10.2016;2016;10;00;Maanantai;0;0;0
94;03.10.2016;2016;10;01;Maanantai;0;0;0
94;03.10.2016;2016;10;02;Maanantai;0;0;0
94;03.10.2016;2016;10;03;Maanantai;0;1;1
94;03.10.2016;2016;10;04;Maanantai;1;0;1
94;03.10.2016;2016;10;05;Maanantai;7;2;9
94;03.10.2016;2016;10;06;Maanantai;11;1;12
94;03.10.2016;2016;10;07;Maanantai;16;2;18
94;03.10.2016;2016;10;08;Maanantai;7;0;7
94;03.10.2016;2016;10;09;Maanantai;1;3;4
94;03.10.2016;2016;10;10;Maanantai;1;4;5
94;03.10.2016;2016;10;11;Maanantai;1;2;3
94;03.10.2016;2016;10;12;Maanantai;7;2;9
94;03.10.2016;2016;10;13;Maanantai;2;5;7
94;03.10.2016;2016;10;14;Maanantai;5;11;16
94;03.10.2016;2016;10;15;Maanantai;7;9;16
94;03.10.2016;2016;10;16;Maanantai;6;17;23
94;03.10.2016;2016;10;17;Maanantai;2;11;13
94;03.10.2016;2016;10;18;Maanantai;2;3;5
94;03.10.2016;2016;10;19;Maanantai;6;2;8
94;03.10.2016;2016;10;20;Maanantai;2;3;5
94;03.10.2016;2016;10;21;Maanantai;1;5;6
94;03.10.2016;2016;10;22;Maanantai;0;1;1
94;03.10.2016;2016;10;23;Maanantai;0;0;0
94;04.10.2016;2016;10;00;Tiistai;0;1;1
94;04.10.2016;2016;10;01;Tiistai;0;0;0
94;04.10.2016;2016;10;02;Tiistai;0;0;0
94;04.10.2016;2016;10;03;Tiistai;0;0;0
94;04.10.2016;2016;10;04;Tiistai;2;0;2
94;04.10.2016;2016;10;05;Tiistai;6;0;6
94;04.10.2016;2016;10;06;Tiistai;13;2;15
94;04.10.2016;2016;10;07;Tiistai;16;0;16
94;04.10.2016;2016;10;08;Tiistai;12;1;13
94;04.10.2016;2016;10;09;Tiistai;7;4;11
94;04.10.2016;2016;10;10;Tiistai;6;1;7
94;04.10.2016;2016;10;11;Tiistai;4;5;9
94;04.10.2016;2016;10;12;Tiistai;3;3;6
94;04.10.2016;2016;10;13;Tiistai;4;4;8
94;04.10.2016;2016;10;14;Tiistai;2;4;6
94;04.10.2016;2016;10;15;Tiistai;5;14;19
94;04.10.2016;2016;10;16;Tiistai;7;16;23
94;04.10.2016;2016;10;17;Tiistai;5;6;11
94;04.10.2016;2016;10;18;Tiistai;7;7;14
94;04.10.2016;2016;10;19;Tiistai;1;6;7
94;04.10.2016;2016;10;20;Tiistai;3;9;12
94;04.10.2016;2016;10;21;Tiistai;1;3;4
94;04.10.2016;2016;10;22;Tiistai;0;2;2
94;04.10.2016;2016;10;23;Tiistai;0;0;0
94;05.10.2016;2016;10;00;Keskiviikko;1;0;1
94;05.10.2016;2016;10;01;Keskiviikko;0;0;0
94;05.10.2016;2016;10;02;Keskiviikko;0;1;1
94;05.10.2016;2016;10;03;Keskiviikko;0;0;0
94;05.10.2016;2016;10;04;Keskiviikko;2;0;2
94;05.10.2016;2016;10;05;Keskiviikko;5;0;5
94;05.10.2016;2016;10;06;Keskiviikko;12;1;13
94;05.10.2016;2016;10;07;Keskiviikko;7;5;12
94;05.10.2016;2016;10;08;Keskiviikko;7;0;7
94;05.10.2016;2016;10;09;Keskiviikko;4;2;6
94;05.10.2016;2016;10;10;Keskiviikko;8;1;9
94;05.10.2016;2016;10;11;Keskiviikko;3;3;6
94;05.10.2016;2016;10;12;Keskiviikko;1;2;3
94;05.10.2016;2016;10;13;Keskiviikko;2;4;6
94;05.10.2016;2016;10;14;Keskiviikko;6;4;10
94;05.10.2016;2016;10;15;Keskiviikko;9;12;21
94;05.10.2016;2016;10;16;Keskiviikko;6;12;18
94;05.10.2016;2016;10;17;Keskiviikko;3;13;16
94;05.10.2016;2016;10;18;Keskiviikko;5;10;15
94;05.10.2016;2016;10;19;Keskiviikko;3;4;7
94;05.10.2016;2016;10;20;Keskiviikko;2;5;7
94;05.10.2016;2016;10;21;Keskiviikko;2;3;5
94;05.10.2016;2016;10;22;Keskiviikko;0;0;0
94;05.10.2016;2016;10;23;Keskiviikko;1;0;1
94;06.10.2016;2016;10;00;Torstai;0;0;0
94;06.10.2016;2016;10;01;Torstai;0;0;0
94;06.10.2016;2016;10;02;Torstai;0;0;0
94;06.10.2016;2016;10;03;Torstai;0;0;0
94;06.10.2016;2016;10;04;Torstai;1;0;1
94;06.10.2016;2016;10;05;Torstai;4;2;6
94;06.10.2016;2016;10;06;Torstai;9;3;12
94;06.10.2016;2016;10;07;Torstai;17;2;19
94;06.10.2016;2016;10;08;Torstai;3;1;4
94;06.10.2016;2016;10;09;Torstai;6;2;8
94;06.10.2016;2016;10;10;Torstai;2;1;3
94;06.10.2016;2016;10;11;Torstai;6;0;6
94;06.10.2016;2016;10;12;Torstai;4;1;5
94;06.10.2016;2016;10;13;Torstai;3;5;8
94;06.10.2016;2016;10;14;Torstai;5;7;12
94;06.10.2016;2016;10;15;Torstai;5;9;14
94;06.10.2016;2016;10;16;Torstai;1;13;14
94;06.10.2016;2016;10;17;Torstai;1;11;12
94;06.10.2016;2016;10;18;Torstai;1;10;11
94;06.10.2016;2016;10;19;Torstai;1;2;3
94;06.10.2016;2016;10;20;Torstai;1;0;1
94;06.10.2016;2016;10;21;Torstai;3;2;5
94;06.10.2016;2016;10;22;Torstai;0;2;2
94;06.10.2016;2016;10;23;Torstai;0;0;0
94;07.10.2016;2016;10;00;Perjantai;0;0;0
94;07.10.2016;2016;10;01;Perjantai;0;0;0
94;07.10.2016;2016;10;02;Perjantai;0;0;0
94;07.10.2016;2016;10;03;Perjantai;0;0;0
94;07.10.2016;2016;10;04;Perjantai;1;0;1
94;07.10.2016;2016;10;05;Perjantai;4;2;6
94;07.10.2016;2016;10;06;Perjantai;7;2;9
94;07.10.2016;2016;10;07;Perjantai;12;3;15
94;07.10.2016;2016;10;08;Perjantai;6;0;6
94;07.10.2016;2016;10;09;Perjantai;5;1;6
94;07.10.2016;2016;10;10;Perjantai;2;0;2
94;07.10.2016;2016;10;11;Perjantai;6;0;6
94;07.10.2016;2016;10;12;Perjantai;6;4;10
94;07.10.2016;2016;10;13;Perjantai;4;2;6
94;07.10.2016;2016;10;14;Perjantai;3;15;18
94;07.10.2016;2016;10;15;Perjantai;6;10;16
94;07.10.2016;2016;10;16;Perjantai;5;13;18
94;07.10.2016;2016;10;17;Perjantai;0;6;6
94;07.10.2016;2016;10;18;Perjantai;3;10;13
94;07.10.2016;2016;10;19;Perjantai;7;3;10
94;07.10.2016;2016;10;20;Perjantai;0;3;3
94;07.10.2016;2016;10;21;Perjantai;2;2;4
94;07.10.2016;2016;10;22;Perjantai;0;1;1
94;07.10.2016;2016;10;23;Perjantai;2;0;2
94;08.10.2016;2016;10;00;Lauantai;1;1;2
94;08.10.2016;2016;10;01;Lauantai;0;0;0
94;08.10.2016;2016;10;02;Lauantai;0;0;0
94;08.10.2016;2016;10;03;Lauantai;0;0;0
94;08.10.2016;2016;10;04;Lauantai;0;0;0
94;08.10.2016;2016;10;05;Lauantai;1;0;1
94;08.10.2016;2016;10;06;Lauantai;1;2;3
94;08.10.2016;2016;10;07;Lauantai;1;0;1
94;08.10.2016;2016;10;08;Lauantai;2;0;2
94;08.10.2016;2016;10;09;Lauantai;2;1;3
94;08.10.2016;2016;10;10;Lauantai;4;3;7
94;08.10.2016;2016;10;11;Lauantai;4;2;6
94;08.10.2016;2016;10;12;Lauantai;6;8;14
94;08.10.2016;2016;10;13;Lauantai;4;14;18
94;08.10.2016;2016;10;14;Lauantai;4;3;7
94;08.10.2016;2016;10;15;Lauantai;2;6;8
94;08.10.2016;2016;10;16;Lauantai;1;5;6
94;08.10.2016;2016;10;17;Lauantai;5;5;10
94;08.10.2016;2016;10;18;Lauantai;6;0;6
94;08.10.2016;2016;10;19;Lauantai;2;1;3
94;08.10.2016;2016;10;20;Lauantai;0;0;0
94;08.10.2016;2016;10;21;Lauantai;2;1;3
94;08.10.2016;2016;10;22;Lauantai;0;1;1
94;08.10.2016;2016;10;23;Lauantai;0;0;0
94;09.10.2016;2016;10;00;Sunnuntai;1;0;1
94;09.10.2016;2016;10;01;Sunnuntai;0;0;0
94;09.10.2016;2016;10;02;Sunnuntai;0;0;0
94;09.10.2016;2016;10;03;Sunnuntai;0;1;1
94;09.10.2016;2016;10;04;Sunnuntai;0;0;0
94;09.10.2016;2016;10;05;Sunnuntai;0;0;0
94;09.10.2016;2016;10;06;Sunnuntai;0;1;1
94;09.10.2016;2016;10;07;Sunnuntai;1;0;1
94;09.10.2016;2016;10;08;Sunnuntai;1;1;2
94;09.10.2016;2016;10;09;Sunnuntai;3;2;5
94;09.10.2016;2016;10;10;Sunnuntai;3;9;12
94;09.10.2016;2016;10;11;Sunnuntai;4;3;7
94;09.10.2016;2016;10;12;Sunnuntai;6;0;6
94;09.10.2016;2016;10;13;Sunnuntai;9;8;17
94;09.10.2016;2016;10;14;Sunnuntai;2;10;12
94;09.10.2016;2016;10;15;Sunnuntai;8;9;17
94;09.10.2016;2016;10;16;Sunnuntai;6;4;10
94;09.10.2016;2016;10;17;Sunnuntai;14;3;17
94;09.10.2016;2016;10;18;Sunnuntai;4;2;6
94;09.10.2016;2016;10;19;Sunnuntai;2;3;5
94;09.10.2016;2016;10;20;Sunnuntai;4;0;4
94;09.10.2016;2016;10;21;Sunnuntai;0;1;1
94;09.10.2016;2016;10;22;Sunnuntai;0;2;2
94;09.10.2016;2016;10;23;Sunnuntai;1;0;1
94;10.10.2016;2016;10;00;Maanantai;0;0;0
94;10.10.2016;2016;10;01;Maanantai;0;0;0
94;10.10.2016;2016;10;02;Maanantai;0;0;0
94;10.10.2016;2016;10;03;Maanantai;0;0;0
94;10.10.2016;2016;10;04;Maanantai;0;0;0
94;10.10.2016;2016;10;05;Maanantai;3;3;6
94;10.10.2016;2016;10;06;Maanantai;8;3;11
94;10.10.2016;2016;10;07;Maanantai;17;3;20
94;10.10.2016;2016;10;08;Maanantai;10;1;11
94;10.10.2016;2016;10;09;Maanantai;4;2;6
94;10.10.2016;2016;10;10;Maanantai;5;1;6
94;10.10.2016;2016;10;11;Maanantai;2;3;5
94;10.10.2016;2016;10;12;Maanantai;5;0;5
94;10.10.2016;2016;10;13;Maanantai;4;4;8
94;10.10.2016;2016;10;14;Maanantai;4;6;10
94;10.10.2016;2016;10;15;Maanantai;6;5;11
94;10.10.2016;2016;10;16;Maanantai;3;11;14
94;10.10.2016;2016;10;17;Maanantai;2;11;13
94;10.10.2016;2016;10;18;Maanantai;1;10;11
94;10.10.2016;2016;10;19;Maanantai;7;7;14
94;10.10.2016;2016;10;20;Maanantai;3;8;11
94;10.10.2016;2016;10;21;Maanantai;1;3;4
94;10.10.2016;2016;10;22;Maanantai;0;3;3
94;10.10.2016;2016;10;23;Maanantai;0;0;0
94;11.10.2016;2016;10;00;Tiistai;0;0;0
94;11.10.2016;2016;10;01;Tiistai;0;0;0
94;11.10.2016;2016;10;02;Tiistai;0;0;0
94;11.10.2016;2016;10;03;Tiistai;0;0;0
94;11.10.2016;2016;10;04;Tiistai;1;0;1
94;11.10.2016;2016;10;05;Tiistai;2;1;3
94;11.10.2016;2016;10;06;Tiistai;13;3;16
94;11.10.2016;2016;10;07;Tiistai;10;1;11
94;11.10.2016;2016;10;08;Tiistai;8;3;11
94;11.10.2016;2016;10;09;Tiistai;1;0;1
94;11.10.2016;2016;10;10;Tiistai;6;2;8
94;11.10.2016;2016;10;11;Tiistai;4;0;4
94;11.10.2016;2016;10;12;Tiistai;1;2;3
94;11.10.2016;2016;10;13;Tiistai;0;4;4
94;11.10.2016;2016;10;14;Tiistai;2;5;7
94;11.10.2016;2016;10;15;Tiistai;6;9;15
94;11.10.2016;2016;10;16;Tiistai;5;18;23
94;11.10.2016;2016;10;17;Tiistai;2;8;10
94;11.10.2016;2016;10;18;Tiistai;4;7;11
94;11.10.2016;2016;10;19;Tiistai;3;6;9
94;11.10.2016;2016;10;20;Tiistai;1;3;4
94;11.10.2016;2016;10;21;Tiistai;0;4;4
94;11.10.2016;2016;10;22;Tiistai;0;2;2
94;11.10.2016;2016;10;23;Tiistai;2;2;4
94;12.10.2016;2016;10;00;Keskiviikko;0;0;0
94;12.10.2016;2016;10;01;Keskiviikko;0;0;0
94;12.10.2016;2016;10;02;Keskiviikko;0;0;0
94;12.10.2016;2016;10;03;Keskiviikko;0;1;1
94;12.10.2016;2016;10;04;Keskiviikko;0;0;0
94;12.10.2016;2016;10;05;Keskiviikko;3;2;5
94;12.10.2016;2016;10;06;Keskiviikko;13;3;16
94;12.10.2016;2016;10;07;Keskiviikko;15;2;17
94;12.10.2016;2016;10;08;Keskiviikko;7;3;10
94;12.10.2016;2016;10;09;Keskiviikko;5;2;7
94;12.10.2016;2016;10;10;Keskiviikko;1;3;4
94;12.10.2016;2016;10;11;Keskiviikko;3;1;4
94;12.10.2016;2016;10;12;Keskiviikko;3;5;8
94;12.10.2016;2016;10;13;Keskiviikko;4;2;6
94;12.10.2016;2016;10;14;Keskiviikko;5;8;13
94;12.10.2016;2016;10;15;Keskiviikko;11;9;20
94;12.10.2016;2016;10;16;Keskiviikko;5;19;24
94;12.10.2016;2016;10;17;Keskiviikko;4;10;14
94;12.10.2016;2016;10;18;Keskiviikko;1;10;11
94;12.10.2016;2016;10;19;Keskiviikko;5;4;9
94;12.10.2016;2016;10;20;Keskiviikko;1;3;4
94;12.10.2016;2016;10;21;Keskiviikko;1;2;3
94;12.10.2016;2016;10;22;Keskiviikko;0;1;1
94;12.10.2016;2016;10;23;Keskiviikko;0;0;0
94;13.10.2016;2016;10;00;Torstai;1;0;1
94;13.10.2016;2016;10;01;Torstai;0;0;0
94;13.10.2016;2016;10;02;Torstai;0;1;1
94;13.10.2016;2016;10;03;Torstai;0;0;0
94;13.10.2016;2016;10;04;Torstai;0;0;0
94;13.10.2016;2016;10;05;Torstai;5;0;5
94;13.10.2016;2016;10;06;Torstai;12;5;17
94;13.10.2016;2016;10;07;Torstai;17;2;19
94;13.10.2016;2016;10;08;Torstai;10;0;10
94;13.10.2016;2016;10;09;Torstai;7;2;9
94;13.10.2016;2016;10;10;Torstai;4;5;9
94;13.10.2016;2016;10;11;Torstai;4;3;7
94;13.10.2016;2016;10;12;Torstai;3;1;4
94;13.10.2016;2016;10;13;Torstai;2;5;7
94;13.10.2016;2016;10;14;Torstai;0;7;7
94;13.10.2016;2016;10;15;Torstai;6;15;21
94;13.10.2016;2016;10;16;Torstai;4;12;16
94;13.10.2016;2016;10;17;Torstai;2;7;9
94;13.10.2016;2016;10;18;Torstai;1;7;8
94;13.10.2016;2016;10;19;Torstai;1;6;7
94;13.10.2016;2016;10;20;Torstai;2;2;4
94;13.10.2016;2016;10;21;Torstai;1;2;3
94;13.10.2016;2016;10;22;Torstai;0;0;0
94;13.10.2016;2016;10;23;Torstai;0;0;0
94;14.10.2016;2016;10;00;Perjantai;0;0;0
94;14.10.2016;2016;10;01;Perjantai;0;0;0
94;14.10.2016;2016;10;02;Perjantai;0;0;0
94;14.10.2016;2016;10;03;Perjantai;0;0;0
94;14.10.2016;2016;10;04;Perjantai;1;0;1
94;14.10.2016;2016;10;05;Perjantai;4;0;4
94;14.10.2016;2016;10;06;Perjantai;6;3;9
94;14.10.2016;2016;10;07;Perjantai;21;1;22
94;14.10.2016;2016;10;08;Perjantai;8;0;8
94;14.10.2016;2016;10;09;Perjantai;4;2;6
94;14.10.2016;2016;10;10;Perjantai;1;1;2
94;14.10.2016;2016;10;11;Perjantai;2;2;4
94;14.10.2016;2016;10;12;Perjantai;3;5;8
94;14.10.2016;2016;10;13;Perjantai;0;1;1
94;14.10.2016;2016;10;14;Perjantai;4;9;13
94;14.10.2016;2016;10;15;Perjantai;7;6;13
94;14.10.2016;2016;10;16;Perjantai;3;18;21
94;14.10.2016;2016;10;17;Perjantai;2;6;8
94;14.10.2016;2016;10;18;Perjantai;4;4;8
94;14.10.2016;2016;10;19;Perjantai;4;3;7
94;14.10.2016;2016;10;20;Perjantai;1;0;1
94;14.10.2016;2016;10;21;Perjantai;1;1;2
94;14.10.2016;2016;10;22;Perjantai;0;1;1
94;14.10.2016;2016;10;23;Perjantai;1;1;2
94;15.10.2016;2016;10;00;Lauantai;0;0;0
94;15.10.2016;2016;10;01;Lauantai;1;1;2
94;15.10.2016;2016;10;02;Lauantai;0;0;0
94;15.10.2016;2016;10;03;Lauantai;0;0;0
94;15.10.2016;2016;10;04;Lauantai;1;0;1
94;15.10.2016;2016;10;05;Lauantai;0;0;0
94;15.10.2016;2016;10;06;Lauantai;1;0;1
94;15.10.2016;2016;10;07;Lauantai;1;1;2
94;15.10.2016;2016;10;08;Lauantai;2;1;3
94;15.10.2016;2016;10;09;Lauantai;1;1;2
94;15.10.2016;2016;10;10;Lauantai;1;4;5
94;15.10.2016;2016;10;11;Lauantai;3;1;4
94;15.10.2016;2016;10;12;Lauantai;2;5;7
94;15.10.2016;2016;10;13;Lauantai;6;9;15
94;15.10.2016;2016;10;14;Lauantai;0;6;6
94;15.10.2016;2016;10;15;Lauantai;5;1;6
94;15.10.2016;2016;10;16;Lauantai;5;5;10
94;15.10.2016;2016;10;17;Lauantai;7;3;10
94;15.10.2016;2016;10;18;Lauantai;7;1;8
94;15.10.2016;2016;10;19;Lauantai;2;3;5
94;15.10.2016;2016;10;20;Lauantai;0;2;2
94;15.10.2016;2016;10;21;Lauantai;0;1;1
94;15.10.2016;2016;10;22;Lauantai;1;1;2
94;15.10.2016;2016;10;23;Lauantai;1;6;7
94;16.10.2016;2016;10;00;Sunnuntai;1;0;1
94;16.10.2016;2016;10;01;Sunnuntai;0;0;0
94;16.10.2016;2016;10;02;Sunnuntai;0;0;0
94;16.10.2016;2016;10;03;Sunnuntai;0;0;0
94;16.10.2016;2016;10;04;Sunnuntai;1;0;1
94;16.10.2016;2016;10;05;Sunnuntai;0;0;0
94;16.10.2016;2016;10;06;Sunnuntai;0;0;0
94;16.10.2016;2016;10;07;Sunnuntai;0;0;0
94;16.10.2016;2016;10;08;Sunnuntai;1;0;1
94;16.10.2016;2016;10;09;Sunnuntai;2;0;2
94;16.10.2016;2016;10;10;Sunnuntai;1;2;3
94;16.10.2016;2016;10;11;Sunnuntai;0;2;2
94;16.10.2016;2016;10;12;Sunnuntai;3;3;6
94;16.10.2016;2016;10;13;Sunnuntai;0;2;2
94;16.10.2016;2016;10;14;Sunnuntai;0;0;0
94;16.10.2016;2016;10;15;Sunnuntai;1;0;1
94;16.10.2016;2016;10;16;Sunnuntai;4;3;7
94;16.10.2016;2016;10;17;Sunnuntai;6;1;7
94;16.10.2016;2016;10;18;Sunnuntai;1;3;4
94;16.10.2016;2016;10;19;Sunnuntai;1;0;1
94;16.10.2016;2016;10;20;Sunnuntai;0;3;3
94;16.10.2016;2016;10;21;Sunnuntai;0;0;0
94;16.10.2016;2016;10;22;Sunnuntai;0;0;0
94;16.10.2016;2016;10;23;Sunnuntai;0;0;0
94;17.10.2016;2016;10;00;Maanantai;0;0;0
94;17.10.2016;2016;10;01;Maanantai;0;0;0
94;17.10.2016;2016;10;02;Maanantai;0;0;0
94;17.10.2016;2016;10;03;Maanantai;0;0;0
94;17.10.2016;2016;10;04;Maanantai;0;0;0
94;17.10.2016;2016;10;05;Maanantai;6;1;7
94;17.10.2016;2016;10;06;Maanantai;10;1;11
94;17.10.2016;2016;10;07;Maanantai;17;2;19
94;17.10.2016;2016;10;08;Maanantai;12;0;12
94;17.10.2016;2016;10;09;Maanantai;4;1;5
94;17.10.2016;2016;10;10;Maanantai;1;1;2
94;17.10.2016;2016;10;11;Maanantai;1;4;5
94;17.10.2016;2016;10;12;Maanantai;6;3;9
94;17.10.2016;2016;10;13;Maanantai;5;5;10
94;17.10.2016;2016;10;14;Maanantai;3;10;13
94;17.10.2016;2016;10;15;Maanantai;4;9;13
94;17.10.2016;2016;10;16;Maanantai;1;22;23
94;17.10.2016;2016;10;17;Maanantai;4;10;14
94;17.10.2016;2016;10;18;Maanantai;2;5;7
94;17.10.2016;2016;10;19;Maanantai;1;3;4
94;17.10.2016;2016;10;20;Maanantai;5;4;9
94;17.10.2016;2016;10;21;Maanantai;5;1;6
94;17.10.2016;2016;10;22;Maanantai;0;0;0
94;17.10.2016;2016;10;23;Maanantai;0;0;0
94;18.10.2016;2016;10;00;Tiistai;0;0;0
94;18.10.2016;2016;10;01;Tiistai;0;0;0
94;18.10.2016;2016;10;02;Tiistai;0;0;0
94;18.10.2016;2016;10;03;Tiistai;0;0;0
94;18.10.2016;2016;10;04;Tiistai;0;1;1
94;18.10.2016;2016;10;05;Tiistai;4;2;6
94;18.10.2016;2016;10;06;Tiistai;12;2;14
94;18.10.2016;2016;10;07;Tiistai;13;4;17
94;18.10.2016;2016;10;08;Tiistai;10;0;10
94;18.10.2016;2016;10;09;Tiistai;6;2;8
94;18.10.2016;2016;10;10;Tiistai;4;1;5
94;18.10.2016;2016;10;11;Tiistai;1;0;1
94;18.10.2016;2016;10;12;Tiistai;3;3;6
94;18.10.2016;2016;10;13;Tiistai;3;4;7
94;18.10.2016;2016;10;14;Tiistai;4;4;8
94;18.10.2016;2016;10;15;Tiistai;6;9;15
94;18.10.2016;2016;10;16;Tiistai;1;18;19
94;18.10.2016;2016;10;17;Tiistai;1;10;11
94;18.10.2016;2016;10;18;Tiistai;3;8;11
94;18.10.2016;2016;10;19;Tiistai;3;4;7
94;18.10.2016;2016;10;20;Tiistai;2;4;6
94;18.10.2016;2016;10;21;Tiistai;1;1;2
94;18.10.2016;2016;10;22;Tiistai;0;2;2
94;18.10.2016;2016;10;23;Tiistai;0;1;1
94;19.10.2016;2016;10;00;Keskiviikko;0;0;0
94;19.10.2016;2016;10;01;Keskiviikko;0;0;0
94;19.10.2016;2016;10;02;Keskiviikko;0;0;0
94;19.10.2016;2016;10;03;Keskiviikko;0;0;0
94;19.10.2016;2016;10;04;Keskiviikko;0;0;0
94;19.10.2016;2016;10;05;Keskiviikko;3;1;4
94;19.10.2016;2016;10;06;Keskiviikko;15;3;18
94;19.10.2016;2016;10;07;Keskiviikko;12;3;15
94;19.10.2016;2016;10;08;Keskiviikko;10;0;10
94;19.10.2016;2016;10;09;Keskiviikko;5;0;5
94;19.10.2016;2016;10;10;Keskiviikko;3;1;4
94;19.10.2016;2016;10;11;Keskiviikko;1;2;3
94;19.10.2016;2016;10;12;Keskiviikko;1;1;2
94;19.10.2016;2016;10;13;Keskiviikko;2;3;5
94;19.10.2016;2016;10;14;Keskiviikko;3;9;12
94;19.10.2016;2016;10;15;Keskiviikko;4;10;14
94;19.10.2016;2016;10;16;Keskiviikko;7;21;28
94;19.10.2016;2016;10;17;Keskiviikko;2;9;11
94;19.10.2016;2016;10;18;Keskiviikko;1;7;8
94;19.10.2016;2016;10;19;Keskiviikko;4;5;9
94;19.10.2016;2016;10;20;Keskiviikko;1;2;3
94;19.10.2016;2016;10;21;Keskiviikko;2;1;3
94;19.10.2016;2016;10;22;Keskiviikko;0;1;1
94;19.10.2016;2016;10;23;Keskiviikko;0;0;0
94;20.10.2016;2016;10;00;Torstai;0;0;0
94;20.10.2016;2016;10;01;Torstai;0;0;0
94;20.10.2016;2016;10;02;Torstai;0;0;0
94;20.10.2016;2016;10;03;Torstai;0;0;0
94;20.10.2016;2016;10;04;Torstai;0;1;1
94;20.10.2016;2016;10;05;Torstai;4;1;5
94;20.10.2016;2016;10;06;Torstai;8;2;10
94;20.10.2016;2016;10;07;Torstai;13;5;18
94;20.10.2016;2016;10;08;Torstai;9;0;9
94;20.10.2016;2016;10;09;Torstai;4;1;5
94;20.10.2016;2016;10;10;Torstai;2;0;2
94;20.10.2016;2016;10;11;Torstai;4;3;7
94;20.10.2016;2016;10;12;Torstai;4;3;7
94;20.10.2016;2016;10;13;Torstai;0;8;8
94;20.10.2016;2016;10;14;Torstai;1;8;9
94;20.10.2016;2016;10;15;Torstai;3;6;9
94;20.10.2016;2016;10;16;Torstai;6;13;19
94;20.10.2016;2016;10;17;Torstai;0;7;7
94;20.10.2016;2016;10;18;Torstai;5;7;12
94;20.10.2016;2016;10;19;Torstai;3;2;5
94;20.10.2016;2016;10;20;Torstai;7;2;9
94;20.10.2016;2016;10;21;Torstai;0;3;3
94;20.10.2016;2016;10;22;Torstai;0;2;2
94;20.10.2016;2016;10;23;Torstai;0;1;1
94;21.10.2016;2016;10;00;Perjantai;0;1;1
94;21.10.2016;2016;10;01;Perjantai;0;0;0
94;21.10.2016;2016;10;02;Perjantai;0;0;0
94;21.10.2016;2016;10;03;Perjantai;0;0;0
94;21.10.2016;2016;10;04;Perjantai;0;0;0
94;21.10.2016;2016;10;05;Perjantai;4;0;4
94;21.10.2016;2016;10;06;Perjantai;8;1;9
94;21.10.2016;2016;10;07;Perjantai;14;2;16
94;21.10.2016;2016;10;08;Perjantai;6;1;7
94;21.10.2016;2016;10;09;Perjantai;5;1;6
94;21.10.2016;2016;10;10;Perjantai;1;1;2
94;21.10.2016;2016;10;11;Perjantai;4;1;5
94;21.10.2016;2016;10;12;Perjantai;1;5;6
94;21.10.2016;2016;10;13;Perjantai;2;2;4
94;21.10.2016;2016;10;14;Perjantai;1;8;9
94;21.10.2016;2016;10;15;Perjantai;6;11;17
94;21.10.2016;2016;10;16;Perjantai;2;7;9
94;21.10.2016;2016;10;17;Perjantai;2;5;7
94;21.10.2016;2016;10;18;Perjantai;3;3;6
94;21.10.2016;2016;10;19;Perjantai;1;3;4
94;21.10.2016;2016;10;20;Perjantai;1;1;2
94;21.10.2016;2016;10;21;Perjantai;1;0;1
94;21.10.2016;2016;10;22;Perjantai;1;2;3
94;21.10.2016;2016;10;23;Perjantai;0;0;0
94;22.10.2016;2016;10;00;Lauantai;0;1;1
94;22.10.2016;2016;10;01;Lauantai;1;1;2
94;22.10.2016;2016;10;02;Lauantai;0;1;1
94;22.10.2016;2016;10;03;Lauantai;0;0;0
94;22.10.2016;2016;10;04;Lauantai;1;0;1
94;22.10.2016;2016;10;05;Lauantai;0;0;0
94;22.10.2016;2016;10;06;Lauantai;0;1;1
94;22.10.2016;2016;10;07;Lauantai;0;0;0
94;22.10.2016;2016;10;08;Lauantai;0;0;0
94;22.10.2016;2016;10;09;Lauantai;3;3;6
94;22.10.2016;2016;10;10;Lauantai;3;3;6
94;22.10.2016;2016;10;11;Lauantai;1;5;6
94;22.10.2016;2016;10;12;Lauantai;6;4;10
94;22.10.2016;2016;10;13;Lauantai;1;8;9
94;22.10.2016;2016;10;14;Lauantai;3;8;11
94;22.10.2016;2016;10;15;Lauantai;4;5;9
94;22.10.2016;2016;10;16;Lauantai;4;0;4
94;22.10.2016;2016;10;17;Lauantai;3;3;6
94;22.10.2016;2016;10;18;Lauantai;1;3;4
94;22.10.2016;2016;10;19;Lauantai;0;3;3
94;22.10.2016;2016;10;20;Lauantai;4;1;5
94;22.10.2016;2016;10;21;Lauantai;2;1;3
94;22.10.2016;2016;10;22;Lauantai;0;4;4
94;22.10.2016;2016;10;23;Lauantai;0;0;0
94;23.10.2016;2016;10;00;Sunnuntai;0;0;0
94;23.10.2016;2016;10;01;Sunnuntai;0;0;0
94;23.10.2016;2016;10;02;Sunnuntai;0;0;0
94;23.10.2016;2016;10;03;Sunnuntai;0;0;0
94;23.10.2016;2016;10;04;Sunnuntai;0;0;0
94;23.10.2016;2016;10;05;Sunnuntai;0;0;0
94;23.10.2016;2016;10;06;Sunnuntai;2;0;2
94;23.10.2016;2016;10;07;Sunnuntai;0;1;1
94;23.10.2016;2016;10;08;Sunnuntai;1;0;1
94;23.10.2016;2016;10;09;Sunnuntai;4;0;4
94;23.10.2016;2016;10;10;Sunnuntai;1;3;4
94;23.10.2016;2016;10;11;Sunnuntai;1;0;1
94;23.10.2016;2016;10;12;Sunnuntai;4;4;8
94;23.10.2016;2016;10;13;Sunnuntai;0;1;1
94;23.10.2016;2016;10;14;Sunnuntai;4;2;6
94;23.10.2016;2016;10;15;Sunnuntai;5;3;8
94;23.10.2016;2016;10;16;Sunnuntai;4;3;7
94;23.10.2016;2016;10;17;Sunnuntai;3;2;5
94;23.10.2016;2016;10;18;Sunnuntai;1;1;2
94;23.10.2016;2016;10;19;Sunnuntai;2;5;7
94;23.10.2016;2016;10;20;Sunnuntai;0;0;0
94;23.10.2016;2016;10;21;Sunnuntai;0;1;1
94;23.10.2016;2016;10;22;Sunnuntai;0;1;1
94;23.10.2016;2016;10;23;Sunnuntai;1;0;1
94;24.10.2016;2016;10;00;Maanantai;0;0;0
94;24.10.2016;2016;10;01;Maanantai;0;1;1
94;24.10.2016;2016;10;02;Maanantai;1;0;1
94;24.10.2016;2016;10;03;Maanantai;0;0;0
94;24.10.2016;2016;10;04;Maanantai;0;0;0
94;24.10.2016;2016;10;05;Maanantai;5;0;5
94;24.10.2016;2016;10;06;Maanantai;8;1;9
94;24.10.2016;2016;10;07;Maanantai;11;1;12
94;24.10.2016;2016;10;08;Maanantai;3;0;3
94;24.10.2016;2016;10;09;Maanantai;2;0;2
94;24.10.2016;2016;10;10;Maanantai;2;1;3
94;24.10.2016;2016;10;11;Maanantai;0;0;0
94;24.10.2016;2016;10;12;Maanantai;4;1;5
94;24.10.2016;2016;10;13;Maanantai;0;0;0
94;24.10.2016;2016;10;14;Maanantai;4;6;10
94;24.10.2016;2016;10;15;Maanantai;3;11;14
94;24.10.2016;2016;10;16;Maanantai;3;12;15
94;24.10.2016;2016;10;17;Maanantai;3;4;7
94;24.10.2016;2016;10;18;Maanantai;1;4;5
94;24.10.2016;2016;10;19;Maanantai;3;3;6
94;24.10.2016;2016;10;20;Maanantai;1;5;6
94;24.10.2016;2016;10;21;Maanantai;1;0;1
94;24.10.2016;2016;10;22;Maanantai;0;1;1
94;24.10.2016;2016;10;23;Maanantai;1;0;1
94;25.10.2016;2016;10;00;Tiistai;0;0;0
94;25.10.2016;2016;10;01;Tiistai;0;0;0
94;25.10.2016;2016;10;02;Tiistai;0;0;0
94;25.10.2016;2016;10;03;Tiistai;0;0;0
94;25.10.2016;2016;10;04;Tiistai;1;0;1
94;25.10.2016;2016;10;05;Tiistai;3;0;3
94;25.10.2016;2016;10;06;Tiistai;12;1;13
94;25.10.2016;2016;10;07;Tiistai;6;1;7
94;25.10.2016;2016;10;08;Tiistai;4;2;6
94;25.10.2016;2016;10;09;Tiistai;3;1;4
94;25.10.2016;2016;10;10;Tiistai;6;2;8
94;25.10.2016;2016;10;11;Tiistai;6;2;8
94;25.10.2016;2016;10;12;Tiistai;1;3;4
94;25.10.2016;2016;10;13;Tiistai;3;0;3
94;25.10.2016;2016;10;14;Tiistai;1;2;3
94;25.10.2016;2016;10;15;Tiistai;3;8;11
94;25.10.2016;2016;10;16;Tiistai;2;7;9
94;25.10.2016;2016;10;17;Tiistai;0;11;11
94;25.10.2016;2016;10;18;Tiistai;0;2;2
94;25.10.2016;2016;10;19;Tiistai;1;1;2
94;25.10.2016;2016;10;20;Tiistai;1;3;4
94;25.10.2016;2016;10;21;Tiistai;1;6;7
94;25.10.2016;2016;10;22;Tiistai;1;1;2
94;25.10.2016;2016;10;23;Tiistai;0;0;0
94;26.10.2016;2016;10;00;Keskiviikko;0;0;0
94;26.10.2016;2016;10;01;Keskiviikko;0;0;0
94;26.10.2016;2016;10;02;Keskiviikko;0;0;0
94;26.10.2016;2016;10;03;Keskiviikko;0;0;0
94;26.10.2016;2016;10;04;Keskiviikko;0;0;0
94;26.10.2016;2016;10;05;Keskiviikko;3;0;3
94;26.10.2016;2016;10;06;Keskiviikko;6;1;7
94;26.10.2016;2016;10;07;Keskiviikko;7;1;8
94;26.10.2016;2016;10;08;Keskiviikko;4;1;5
94;26.10.2016;2016;10;09;Keskiviikko;1;1;2
94;26.10.2016;2016;10;10;Keskiviikko;4;0;4
94;26.10.2016;2016;10;11;Keskiviikko;4;4;8
94;26.10.2016;2016;10;12;Keskiviikko;6;2;8
94;26.10.2016;2016;10;13;Keskiviikko;1;1;2
94;26.10.2016;2016;10;14;Keskiviikko;4;11;15
94;26.10.2016;2016;10;15;Keskiviikko;3;8;11
94;26.10.2016;2016;10;16;Keskiviikko;0;6;6
94;26.10.2016;2016;10;17;Keskiviikko;0;6;6
94;26.10.2016;2016;10;18;Keskiviikko;1;1;2
94;26.10.2016;2016;10;19;Keskiviikko;1;2;3
94;26.10.2016;2016;10;20;Keskiviikko;0;2;2
94;26.10.2016;2016;10;21;Keskiviikko;0;3;3
94;26.10.2016;2016;10;22;Keskiviikko;0;1;1
94;26.10.2016;2016;10;23;Keskiviikko;0;1;1
94;27.10.2016;2016;10;00;Torstai;1;0;1
94;27.10.2016;2016;10;01;Torstai;1;1;2
94;27.10.2016;2016;10;02;Torstai;0;0;0
94;27.10.2016;2016;10;03;Torstai;0;0;0
94;27.10.2016;2016;10;04;Torstai;0;0;0
94;27.10.2016;2016;10;05;Torstai;3;0;3
94;27.10.2016;2016;10;06;Torstai;5;1;6
94;27.10.2016;2016;10;07;Torstai;6;1;7
94;27.10.2016;2016;10;08;Torstai;4;2;6
94;27.10.2016;2016;10;09;Torstai;4;2;6
94;27.10.2016;2016;10;10;Torstai;1;0;1
94;27.10.2016;2016;10;11;Torstai;2;0;2
94;27.10.2016;2016;10;12;Torstai;3;4;7
94;27.10.2016;2016;10;13;Torstai;4;0;4
94;27.10.2016;2016;10;14;Torstai;2;5;7
94;27.10.2016;2016;10;15;Torstai;2;5;7
94;27.10.2016;2016;10;16;Torstai;4;5;9
94;27.10.2016;2016;10;17;Torstai;0;1;1
94;27.10.2016;2016;10;18;Torstai;1;3;4
94;27.10.2016;2016;10;19;Torstai;1;2;3
94;27.10.2016;2016;10;20;Torstai;0;2;2
94;27.10.2016;2016;10;21;Torstai;0;2;2
94;27.10.2016;2016;10;22;Torstai;0;1;1
94;27.10.2016;2016;10;23;Torstai;0;0;0
94;28.10.2016;2016;10;00;Perjantai;0;0;0
94;28.10.2016;2016;10;01;Perjantai;0;0;0
94;28.10.2016;2016;10;02;Perjantai;0;0;0
94;28.10.2016;2016;10;03;Perjantai;0;0;0
94;28.10.2016;2016;10;04;Perjantai;0;0;0
94;28.10.2016;2016;10;05;Perjantai;1;0;1
94;28.10.2016;2016;10;06;Perjantai;3;1;4
94;28.10.2016;2016;10;07;Perjantai;4;1;5
94;28.10.2016;2016;10;08;Perjantai;1;0;1
94;28.10.2016;2016;10;09;Perjantai;1;0;1
94;28.10.2016;2016;10;10;Perjantai;0;0;0
94;28.10.2016;2016;10;11;Perjantai;3;1;4
94;28.10.2016;2016;10;12;Perjantai;1;2;3
94;28.10.2016;2016;10;13;Perjantai;2;2;4
94;28.10.2016;2016;10;14;Perjantai;6;4;10
94;28.10.2016;2016;10;15;Perjantai;3;5;8
94;28.10.2016;2016;10;16;Perjantai;2;3;5
94;28.10.2016;2016;10;17;Perjantai;3;8;11
94;28.10.2016;2016;10;18;Perjantai;2;0;2
94;28.10.2016;2016;10;19;Perjantai;1;2;3
94;28.10.2016;2016;10;20;Perjantai;0;2;2
94;28.10.2016;2016;10;21;Perjantai;0;3;3
94;28.10.2016;2016;10;22;Perjantai;1;1;2
94;28.10.2016;2016;10;23;Perjantai;1;0;1
94;29.10.2016;2016;10;00;Lauantai;0;1;1
94;29.10.2016;2016;10;01;Lauantai;0;0;0
94;29.10.2016;2016;10;02;Lauantai;0;0;0
94;29.10.2016;2016;10;03;Lauantai;0;0;0
94;29.10.2016;2016;10;04;Lauantai;0;0;0
94;29.10.2016;2016;10;05;Lauantai;1;0;1
94;29.10.2016;2016;10;06;Lauantai;1;0;1
94;29.10.2016;2016;10;07;Lauantai;1;0;1
94;29.10.2016;2016;10;08;Lauantai;1;0;1
94;29.10.2016;2016;10;09;Lauantai;0;1;1
94;29.10.2016;2016;10;10;Lauantai;2;2;4
94;29.10.2016;2016;10;11;Lauantai;2;2;4
94;29.10.2016;2016;10;12;Lauantai;2;2;4
94;29.10.2016;2016;10;13;Lauantai;3;2;5
94;29.10.2016;2016;10;14;Lauantai;2;7;9
94;29.10.2016;2016;10;15;Lauantai;2;6;8
94;29.10.2016;2016;10;16;Lauantai;3;1;4
94;29.10.2016;2016;10;17;Lauantai;2;0;2
94;29.10.2016;2016;10;18;Lauantai;4;2;6
94;29.10.2016;2016;10;19;Lauantai;0;3;3
94;29.10.2016;2016;10;20;Lauantai;0;0;0
94;29.10.2016;2016;10;21;Lauantai;0;1;1
94;29.10.2016;2016;10;22;Lauantai;0;1;1
94;29.10.2016;2016;10;23;Lauantai;0;0;0
94;30.10.2016;2016;10;00;Sunnuntai;1;0;1
94;30.10.2016;2016;10;01;Sunnuntai;0;0;0
94;30.10.2016;2016;10;02;Sunnuntai;0;0;0
94;30.10.2016;2016;10;03;Sunnuntai;1;0;1
94;30.10.2016;2016;10;04;Sunnuntai;1;0;1
94;30.10.2016;2016;10;05;Sunnuntai;0;0;0
94;30.10.2016;2016;10;06;Sunnuntai;1;0;1
94;30.10.2016;2016;10;07;Sunnuntai;0;0;0
94;30.10.2016;2016;10;08;Sunnuntai;0;1;1
94;30.10.2016;2016;10;09;Sunnuntai;4;2;6
94;30.10.2016;2016;10;10;Sunnuntai;5;3;8
94;30.10.2016;2016;10;11;Sunnuntai;4;1;5
94;30.10.2016;2016;10;12;Sunnuntai;1;2;3
94;30.10.2016;2016;10;13;Sunnuntai;2;3;5
94;30.10.2016;2016;10;14;Sunnuntai;2;3;5
94;30.10.2016;2016;10;15;Sunnuntai;4;5;9
94;30.10.2016;2016;10;16;Sunnuntai;2;2;4
94;30.10.2016;2016;10;17;Sunnuntai;2;1;3
94;30.10.2016;2016;10;18;Sunnuntai;1;1;2
94;30.10.2016;2016;10;19;Sunnuntai;2;1;3
94;30.10.2016;2016;10;20;Sunnuntai;0;1;1
94;30.10.2016;2016;10;21;Sunnuntai;0;1;1
94;30.10.2016;2016;10;22;Sunnuntai;0;1;1
94;30.10.2016;2016;10;23;Sunnuntai;0;0;0
94;31.10.2016;2016;10;00;Maanantai;0;0;0
94;31.10.2016;2016;10;01;Maanantai;0;0;0
94;31.10.2016;2016;10;02;Maanantai;0;0;0
94;31.10.2016;2016;10;03;Maanantai;0;0;0
94;31.10.2016;2016;10;04;Maanantai;0;0;0
94;31.10.2016;2016;10;05;Maanantai;2;0;2
94;31.10.2016;2016;10;06;Maanantai;10;1;11
94;31.10.2016;2016;10;07;Maanantai;15;1;16
94;31.10.2016;2016;10;08;Maanantai;6;2;8
94;31.10.2016;2016;10;09;Maanantai;3;2;5
94;31.10.2016;2016;10;10;Maanantai;2;2;4
94;31.10.2016;2016;10;11;Maanantai;4;1;5
94;31.10.2016;2016;10;12;Maanantai;4;2;6
94;31.10.2016;2016;10;13;Maanantai;5;2;7
94;31.10.2016;2016;10;14;Maanantai;3;8;11
94;31.10.2016;2016;10;15;Maanantai;8;9;17
94;31.10.2016;2016;10;16;Maanantai;2;9;11
94;31.10.2016;2016;10;17;Maanantai;2;8;10
94;31.10.2016;2016;10;18;Maanantai;2;2;4
94;31.10.2016;2016;10;19;Maanantai;0;4;4
94;31.10.2016;2016;10;20;Maanantai;0;2;2
94;31.10.2016;2016;10;21;Maanantai;1;3;4
94;31.10.2016;2016;10;22;Maanantai;0;1;1
94;31.10.2016;2016;10;23;Maanantai;0;0;0
94;01.11.2016;2016;11;00;Tiistai;0;0;0
94;01.11.2016;2016;11;01;Tiistai;0;0;0
94;01.11.2016;2016;11;02;Tiistai;0;0;0
94;01.11.2016;2016;11;03;Tiistai;0;0;0
94;01.11.2016;2016;11;04;Tiistai;0;0;0
94;01.11.2016;2016;11;05;Tiistai;0;0;0
94;01.11.2016;2016;11;06;Tiistai;8;2;10
94;01.11.2016;2016;11;07;Tiistai;12;2;14
94;01.11.2016;2016;11;08;Tiistai;9;1;10
94;01.11.2016;2016;11;09;Tiistai;4;0;4
94;01.11.2016;2016;11;10;Tiistai;8;2;10
94;01.11.2016;2016;11;11;Tiistai;1;0;1
94;01.11.2016;2016;11;12;Tiistai;3;4;7
94;01.11.2016;2016;11;13;Tiistai;0;2;2
94;01.11.2016;2016;11;14;Tiistai;2;5;7
94;01.11.2016;2016;11;15;Tiistai;3;12;15
94;01.11.2016;2016;11;16;Tiistai;3;13;16
94;01.11.2016;2016;11;17;Tiistai;3;5;8
94;01.11.2016;2016;11;18;Tiistai;0;3;3
94;01.11.2016;2016;11;19;Tiistai;1;2;3
94;01.11.2016;2016;11;20;Tiistai;0;1;1
94;01.11.2016;2016;11;21;Tiistai;3;1;4
94;01.11.2016;2016;11;22;Tiistai;0;1;1
94;01.11.2016;2016;11;23;Tiistai;0;1;1
94;02.11.2016;2016;11;00;Keskiviikko;0;0;0
94;02.11.2016;2016;11;01;Keskiviikko;0;0;0
94;02.11.2016;2016;11;02;Keskiviikko;0;0;0
94;02.11.2016;2016;11;03;Keskiviikko;2;0;2
94;02.11.2016;2016;11;04;Keskiviikko;0;0;0
94;02.11.2016;2016;11;05;Keskiviikko;1;2;3
94;02.11.2016;2016;11;06;Keskiviikko;7;1;8
94;02.11.2016;2016;11;07;Keskiviikko;11;3;14
94;02.11.2016;2016;11;08;Keskiviikko;7;0;7
94;02.11.2016;2016;11;09;Keskiviikko;3;0;3
94;02.11.2016;2016;11;10;Keskiviikko;2;1;3
94;02.11.2016;2016;11;11;Keskiviikko;4;1;5
94;02.11.2016;2016;11;12;Keskiviikko;1;2;3
94;02.11.2016;2016;11;13;Keskiviikko;1;1;2
94;02.11.2016;2016;11;14;Keskiviikko;1;5;6
94;02.11.2016;2016;11;15;Keskiviikko;2;8;10
94;02.11.2016;2016;11;16;Keskiviikko;3;9;12
94;02.11.2016;2016;11;17;Keskiviikko;2;6;8
94;02.11.2016;2016;11;18;Keskiviikko;0;1;1
94;02.11.2016;2016;11;19;Keskiviikko;2;4;6
94;02.11.2016;2016;11;20;Keskiviikko;1;0;1
94;02.11.2016;2016;11;21;Keskiviikko;1;1;2
94;02.11.2016;2016;11;22;Keskiviikko;0;1;1
94;02.11.2016;2016;11;23;Keskiviikko;0;0;0
94;03.11.2016;2016;11;00;Torstai;0;0;0
94;03.11.2016;2016;11;01;Torstai;0;0;0
94;03.11.2016;2016;11;02;Torstai;0;0;0
94;03.11.2016;2016;11;03;Torstai;0;1;1
94;03.11.2016;2016;11;04;Torstai;1;0;1
94;03.11.2016;2016;11;05;Torstai;0;0;0
94;03.11.2016;2016;11;06;Torstai;6;2;8
94;03.11.2016;2016;11;07;Torstai;13;7;20
94;03.11.2016;2016;11;08;Torstai;5;1;6
94;03.11.2016;2016;11;09;Torstai;2;3;5
94;03.11.2016;2016;11;10;Torstai;0;0;0
94;03.11.2016;2016;11;11;Torstai;1;2;3
94;03.11.2016;2016;11;12;Torstai;2;0;2
94;03.11.2016;2016;11;13;Torstai;1;1;2
94;03.11.2016;2016;11;14;Torstai;1;2;3
94;03.11.2016;2016;11;15;Torstai;4;10;14
94;03.11.2016;2016;11;16;Torstai;2;8;10
94;03.11.2016;2016;11;17;Torstai;2;4;6
94;03.11.2016;2016;11;18;Torstai;0;3;3
94;03.11.2016;2016;11;19;Torstai;1;7;8
94;03.11.2016;2016;11;20;Torstai;3;1;4
94;03.11.2016;2016;11;21;Torstai;0;1;1
94;03.11.2016;2016;11;22;Torstai;0;1;1
94;03.11.2016;2016;11;23;Torstai;0;0;0
94;04.11.2016;2016;11;00;Perjantai;0;0;0
94;04.11.2016;2016;11;01;Perjantai;0;0;0
94;04.11.2016;2016;11;02;Perjantai;0;0;0
94;04.11.2016;2016;11;03;Perjantai;0;0;0
94;04.11.2016;2016;11;04;Perjantai;0;1;1
94;04.11.2016;2016;11;05;Perjantai;0;0;0
94;04.11.2016;2016;11;06;Perjantai;4;1;5
94;04.11.2016;2016;11;07;Perjantai;12;1;13
94;04.11.2016;2016;11;08;Perjantai;4;1;5
94;04.11.2016;2016;11;09;Perjantai;1;0;1
94;04.11.2016;2016;11;10;Perjantai;1;0;1
94;04.11.2016;2016;11;11;Perjantai;3;0;3
94;04.11.2016;2016;11;12;Perjantai;1;0;1
94;04.11.2016;2016;11;13;Perjantai;1;1;2
94;04.11.2016;2016;11;14;Perjantai;3;2;5
94;04.11.2016;2016;11;15;Perjantai;2;5;7
94;04.11.2016;2016;11;16;Perjantai;0;8;8
94;04.11.2016;2016;11;17;Perjantai;1;2;3
94;04.11.2016;2016;11;18;Perjantai;1;2;3
94;04.11.2016;2016;11;19;Perjantai;1;1;2
94;04.11.2016;2016;11;20;Perjantai;0;0;0
94;04.11.2016;2016;11;21;Perjantai;0;0;0
94;04.11.2016;2016;11;22;Perjantai;0;0;0
94;04.11.2016;2016;11;23;Perjantai;0;0;0
94;05.11.2016;2016;11;00;Lauantai;0;0;0
94;05.11.2016;2016;11;01;Lauantai;0;0;0
94;05.11.2016;2016;11;02;Lauantai;0;1;1
94;05.11.2016;2016;11;03;Lauantai;0;0;0
94;05.11.2016;2016;11;04;Lauantai;0;0;0
94;05.11.2016;2016;11;05;Lauantai;0;0;0
94;05.11.2016;2016;11;06;Lauantai;1;0;1
94;05.11.2016;2016;11;07;Lauantai;1;0;1
94;05.11.2016;2016;11;08;Lauantai;0;0;0
94;05.11.2016;2016;11;09;Lauantai;1;0;1
94;05.11.2016;2016;11;10;Lauantai;0;0;0
94;05.11.2016;2016;11;11;Lauantai;1;1;2
94;05.11.2016;2016;11;12;Lauantai;2;3;5
94;05.11.2016;2016;11;13;Lauantai;2;1;3
94;05.11.2016;2016;11;14;Lauantai;2;1;3
94;05.11.2016;2016;11;15;Lauantai;2;2;4
94;05.11.2016;2016;11;16;Lauantai;1;4;5
94;05.11.2016;2016;11;17;Lauantai;5;2;7
94;05.11.2016;2016;11;18;Lauantai;5;1;6
94;05.11.2016;2016;11;19;Lauantai;1;1;2
94;05.11.2016;2016;11;20;Lauantai;1;1;2
94;05.11.2016;2016;11;21;Lauantai;0;0;0
94;05.11.2016;2016;11;22;Lauantai;0;0;0
94;05.11.2016;2016;11;23;Lauantai;0;0;0
94;06.11.2016;2016;11;00;Sunnuntai;0;0;0
94;06.11.2016;2016;11;01;Sunnuntai;0;0;0
94;06.11.2016;2016;11;02;Sunnuntai;0;0;0
94;06.11.2016;2016;11;03;Sunnuntai;0;0;0
94;06.11.2016;2016;11;04;Sunnuntai;0;0;0
94;06.11.2016;2016;11;05;Sunnuntai;0;0;0
94;06.11.2016;2016;11;06;Sunnuntai;0;0;0
94;06.11.2016;2016;11;07;Sunnuntai;1;1;2
94;06.11.2016;2016;11;08;Sunnuntai;0;0;0
94;06.11.2016;2016;11;09;Sunnuntai;0;1;1
94;06.11.2016;2016;11;10;Sunnuntai;0;1;1
94;06.11.2016;2016;11;11;Sunnuntai;2;3;5
94;06.11.2016;2016;11;12;Sunnuntai;1;0;1
94;06.11.2016;2016;11;13;Sunnuntai;2;0;2
94;06.11.2016;2016;11;14;Sunnuntai;1;2;3
94;06.11.2016;2016;11;15;Sunnuntai;3;0;3
94;06.11.2016;2016;11;16;Sunnuntai;2;4;6
94;06.11.2016;2016;11;17;Sunnuntai;0;1;1
94;06.11.2016;2016;11;18;Sunnuntai;1;0;1
94;06.11.2016;2016;11;19;Sunnuntai;0;0;0
94;06.11.2016;2016;11;20;Sunnuntai;0;1;1
94;06.11.2016;2016;11;21;Sunnuntai;0;0;0
94;06.11.2016;2016;11;22;Sunnuntai;0;0;0
94;06.11.2016;2016;11;23;Sunnuntai;0;0;0
94;07.11.2016;2016;11;00;Maanantai;0;0;0
94;07.11.2016;2016;11;01;Maanantai;0;0;0
94;07.11.2016;2016;11;02;Maanantai;0;0;0
94;07.11.2016;2016;11;03;Maanantai;0;0;0
94;07.11.2016;2016;11;04;Maanantai;0;0;0
94;07.11.2016;2016;11;05;Maanantai;1;1;2
94;07.11.2016;2016;11;06;Maanantai;6;1;7
94;07.11.2016;2016;11;07;Maanantai;9;3;12
94;07.11.2016;2016;11;08;Maanantai;7;1;8
94;07.11.2016;2016;11;09;Maanantai;3;1;4
94;07.11.2016;2016;11;10;Maanantai;0;0;0
94;07.11.2016;2016;11;11;Maanantai;2;3;5
94;07.11.2016;2016;11;12;Maanantai;1;0;1
94;07.11.2016;2016;11;13;Maanantai;1;1;2
94;07.11.2016;2016;11;14;Maanantai;3;2;5
94;07.11.2016;2016;11;15;Maanantai;3;7;10
94;07.11.2016;2016;11;16;Maanantai;3;12;15
94;07.11.2016;2016;11;17;Maanantai;1;6;7
94;07.11.2016;2016;11;18;Maanantai;0;1;1
94;07.11.2016;2016;11;19;Maanantai;0;2;2
94;07.11.2016;2016;11;20;Maanantai;0;2;2
94;07.11.2016;2016;11;21;Maanantai;1;2;3
94;07.11.2016;2016;11;22;Maanantai;0;0;0
94;07.11.2016;2016;11;23;Maanantai;0;0;0
94;08.11.2016;2016;11;00;Tiistai;0;0;0
94;08.11.2016;2016;11;01;Tiistai;0;0;0
94;08.11.2016;2016;11;02;Tiistai;0;0;0
94;08.11.2016;2016;11;03;Tiistai;0;0;0
94;08.11.2016;2016;11;04;Tiistai;1;1;2
94;08.11.2016;2016;11;05;Tiistai;4;0;4
94;08.11.2016;2016;11;06;Tiistai;4;1;5
94;08.11.2016;2016;11;07;Tiistai;12;3;15
94;08.11.2016;2016;11;08;Tiistai;2;1;3
94;08.11.2016;2016;11;09;Tiistai;1;1;2
94;08.11.2016;2016;11;10;Tiistai;0;0;0
94;08.11.2016;2016;11;11;Tiistai;2;1;3
94;08.11.2016;2016;11;12;Tiistai;1;1;2
94;08.11.2016;2016;11;13;Tiistai;0;0;0
94;08.11.2016;2016;11;14;Tiistai;0;3;3
94;08.11.2016;2016;11;15;Tiistai;3;6;9
94;08.11.2016;2016;11;16;Tiistai;2;8;10
94;08.11.2016;2016;11;17;Tiistai;0;7;7
94;08.11.2016;2016;11;18;Tiistai;1;1;2
94;08.11.2016;2016;11;19;Tiistai;0;2;2
94;08.11.2016;2016;11;20;Tiistai;0;0;0
94;08.11.2016;2016;11;21;Tiistai;1;4;5
94;08.11.2016;2016;11;22;Tiistai;0;0;0
94;08.11.2016;2016;11;23;Tiistai;1;0;1
94;09.11.2016;2016;11;00;Keskiviikko;0;0;0
94;09.11.2016;2016;11;01;Keskiviikko;0;0;0
94;09.11.2016;2016;11;02;Keskiviikko;0;0;0
94;09.11.2016;2016;11;03;Keskiviikko;0;0;0
94;09.11.2016;2016;11;04;Keskiviikko;0;0;0
94;09.11.2016;2016;11;05;Keskiviikko;2;1;3
94;09.11.2016;2016;11;06;Keskiviikko;5;2;7
94;09.11.2016;2016;11;07;Keskiviikko;14;2;16
94;09.11.2016;2016;11;08;Keskiviikko;5;0;5
94;09.11.2016;2016;11;09;Keskiviikko;3;0;3
94;09.11.2016;2016;11;10;Keskiviikko;3;0;3
94;09.11.2016;2016;11;11;Keskiviikko;2;3;5
94;09.11.2016;2016;11;12;Keskiviikko;2;1;3
94;09.11.2016;2016;11;13;Keskiviikko;2;2;4
94;09.11.2016;2016;11;14;Keskiviikko;3;4;7
94;09.11.2016;2016;11;15;Keskiviikko;3;9;12
94;09.11.2016;2016;11;16;Keskiviikko;3;5;8
94;09.11.2016;2016;11;17;Keskiviikko;2;7;9
94;09.11.2016;2016;11;18;Keskiviikko;0;5;5
94;09.11.2016;2016;11;19;Keskiviikko;0;0;0
94;09.11.2016;2016;11;20;Keskiviikko;0;1;1
94;09.11.2016;2016;11;21;Keskiviikko;0;1;1
94;09.11.2016;2016;11;22;Keskiviikko;1;0;1
94;09.11.2016;2016;11;23;Keskiviikko;0;0;0
94;10.11.2016;2016;11;00;Torstai;0;0;0
94;10.11.2016;2016;11;01;Torstai;0;0;0
94;10.11.2016;2016;11;02;Torstai;0;0;0
94;10.11.2016;2016;11;03;Torstai;0;0;0
94;10.11.2016;2016;11;04;Torstai;0;0;0
94;10.11.2016;2016;11;05;Torstai;3;0;3
94;10.11.2016;2016;11;06;Torstai;3;1;4
94;10.11.2016;2016;11;07;Torstai;9;2;11
94;10.11.2016;2016;11;08;Torstai;3;1;4
94;10.11.2016;2016;11;09;Torstai;4;0;4
94;10.11.2016;2016;11;10;Torstai;0;0;0
94;10.11.2016;2016;11;11;Torstai;1;1;2
94;10.11.2016;2016;11;12;Torstai;2;2;4
94;10.11.2016;2016;11;13;Torstai;1;0;1
94;10.11.2016;2016;11;14;Torstai;0;2;2
94;10.11.2016;2016;11;15;Torstai;2;7;9
94;10.11.2016;2016;11;16;Torstai;3;5;8
94;10.11.2016;2016;11;17;Torstai;0;3;3
94;10.11.2016;2016;11;18;Torstai;1;4;5
94;10.11.2016;2016;11;19;Torstai;0;1;1
94;10.11.2016;2016;11;20;Torstai;2;2;4
94;10.11.2016;2016;11;21;Torstai;0;0;0
94;10.11.2016;2016;11;22;Torstai;0;2;2
94;10.11.2016;2016;11;23;Torstai;0;0;0
94;11.11.2016;2016;11;00;Perjantai;0;1;1
94;11.11.2016;2016;11;01;Perjantai;0;0;0
94;11.11.2016;2016;11;02;Perjantai;0;0;0
94;11.11.2016;2016;11;03;Perjantai;0;1;1
94;11.11.2016;2016;11;04;Perjantai;0;0;0
94;11.11.2016;2016;11;05;Perjantai;2;0;2
94;11.11.2016;2016;11;06;Perjantai;2;2;4
94;11.11.2016;2016;11;07;Perjantai;10;1;11
94;11.11.2016;2016;11;08;Perjantai;6;1;7
94;11.11.2016;2016;11;09;Perjantai;2;0;2
94;11.11.2016;2016;11;10;Perjantai;0;0;0
94;11.11.2016;2016;11;11;Perjantai;1;1;2
94;11.11.2016;2016;11;12;Perjantai;2;1;3
94;11.11.2016;2016;11;13;Perjantai;0;0;0
94;11.11.2016;2016;11;14;Perjantai;3;9;12
94;11.11.2016;2016;11;15;Perjantai;0;13;13
94;11.11.2016;2016;11;16;Perjantai;7;11;18
94;11.11.2016;2016;11;17;Perjantai;2;2;4
94;11.11.2016;2016;11;18;Perjantai;0;0;0
94;11.11.2016;2016;11;19;Perjantai;0;1;1
94;11.11.2016;2016;11;20;Perjantai;1;2;3
94;11.11.2016;2016;11;21;Perjantai;0;1;1
94;11.11.2016;2016;11;22;Perjantai;0;0;0
94;11.11.2016;2016;11;23;Perjantai;0;0;0
94;12.11.2016;2016;11;00;Lauantai;0;0;0
94;12.11.2016;2016;11;01;Lauantai;0;1;1
94;12.11.2016;2016;11;02;Lauantai;0;0;0
94;12.11.2016;2016;11;03;Lauantai;0;0;0
94;12.11.2016;2016;11;04;Lauantai;0;1;1
94;12.11.2016;2016;11;05;Lauantai;0;0;0
94;12.11.2016;2016;11;06;Lauantai;0;0;0
94;12.11.2016;2016;11;07;Lauantai;1;0;1
94;12.11.2016;2016;11;08;Lauantai;0;1;1
94;12.11.2016;2016;11;09;Lauantai;0;0;0
94;12.11.2016;2016;11;10;Lauantai;1;0;1
94;12.11.2016;2016;11;11;Lauantai;3;1;4
94;12.11.2016;2016;11;12;Lauantai;0;0;0
94;12.11.2016;2016;11;13;Lauantai;0;1;1
94;12.11.2016;2016;11;14;Lauantai;0;0;0
94;12.11.2016;2016;11;15;Lauantai;1;2;3
94;12.11.2016;2016;11;16;Lauantai;2;0;2
94;12.11.2016;2016;11;17;Lauantai;0;1;1
94;12.11.2016;2016;11;18;Lauantai;1;0;1
94;12.11.2016;2016;11;19;Lauantai;1;0;1
94;12.11.2016;2016;11;20;Lauantai;0;0;0
94;12.11.2016;2016;11;21;Lauantai;0;1;1
94;12.11.2016;2016;11;22;Lauantai;0;1;1
94;12.11.2016;2016;11;23;Lauantai;0;0;0
94;13.11.2016;2016;11;00;Sunnuntai;0;0;0
94;13.11.2016;2016;11;01;Sunnuntai;0;0;0
94;13.11.2016;2016;11;02;Sunnuntai;0;0;0
94;13.11.2016;2016;11;03;Sunnuntai;0;0;0
94;13.11.2016;2016;11;04;Sunnuntai;0;0;0
94;13.11.2016;2016;11;05;Sunnuntai;0;0;0
94;13.11.2016;2016;11;06;Sunnuntai;1;0;1
94;13.11.2016;2016;11;07;Sunnuntai;1;1;2
94;13.11.2016;2016;11;08;Sunnuntai;0;0;0
94;13.11.2016;2016;11;09;Sunnuntai;3;0;3
94;13.11.2016;2016;11;10;Sunnuntai;0;0;0
94;13.11.2016;2016;11;11;Sunnuntai;1;0;1
94;13.11.2016;2016;11;12;Sunnuntai;1;2;3
94;13.11.2016;2016;11;13;Sunnuntai;0;3;3
94;13.11.2016;2016;11;14;Sunnuntai;1;1;2
94;13.11.2016;2016;11;15;Sunnuntai;3;1;4
94;13.11.2016;2016;11;16;Sunnuntai;1;2;3
94;13.11.2016;2016;11;17;Sunnuntai;3;2;5
94;13.11.2016;2016;11;18;Sunnuntai;1;1;2
94;13.11.2016;2016;11;19;Sunnuntai;2;1;3
94;13.11.2016;2016;11;20;Sunnuntai;0;0;0
94;13.11.2016;2016;11;21;Sunnuntai;0;0;0
94;13.11.2016;2016;11;22;Sunnuntai;0;1;1
94;13.11.2016;2016;11;23;Sunnuntai;0;0;0
94;14.11.2016;2016;11;00;Maanantai;0;0;0
94;14.11.2016;2016;11;01;Maanantai;0;0;0
94;14.11.2016;2016;11;02;Maanantai;0;0;0
94;14.11.2016;2016;11;03;Maanantai;0;0;0
94;14.11.2016;2016;11;04;Maanantai;0;0;0
94;14.11.2016;2016;11;05;Maanantai;4;1;5
94;14.11.2016;2016;11;06;Maanantai;7;1;8
94;14.11.2016;2016;11;07;Maanantai;8;3;11
94;14.11.2016;2016;11;08;Maanantai;8;1;9
94;14.11.2016;2016;11;09;Maanantai;3;1;4
94;14.11.2016;2016;11;10;Maanantai;2;0;2
94;14.11.2016;2016;11;11;Maanantai;2;0;2
94;14.11.2016;2016;11;12;Maanantai;0;0;0
94;14.11.2016;2016;11;13;Maanantai;0;1;1
94;14.11.2016;2016;11;14;Maanantai;3;1;4
94;14.11.2016;2016;11;15;Maanantai;1;9;10
94;14.11.2016;2016;11;16;Maanantai;0;9;9
94;14.11.2016;2016;11;17;Maanantai;0;8;8
94;14.11.2016;2016;11;18;Maanantai;3;2;5
94;14.11.2016;2016;11;19;Maanantai;1;2;3
94;14.11.2016;2016;11;20;Maanantai;0;1;1
94;14.11.2016;2016;11;21;Maanantai;1;1;2
94;14.11.2016;2016;11;22;Maanantai;0;1;1
94;14.11.2016;2016;11;23;Maanantai;0;0;0
94;15.11.2016;2016;11;00;Tiistai;0;0;0
94;15.11.2016;2016;11;01;Tiistai;0;0;0
94;15.11.2016;2016;11;02;Tiistai;0;0;0
94;15.11.2016;2016;11;03;Tiistai;0;0;0
94;15.11.2016;2016;11;04;Tiistai;0;0;0
94;15.11.2016;2016;11;05;Tiistai;4;1;5
94;15.11.2016;2016;11;06;Tiistai;6;1;7
94;15.11.2016;2016;11;07;Tiistai;11;2;13
94;15.11.2016;2016;11;08;Tiistai;4;0;4
94;15.11.2016;2016;11;09;Tiistai;2;3;5
94;15.11.2016;2016;11;10;Tiistai;0;0;0
94;15.11.2016;2016;11;11;Tiistai;0;0;0
94;15.11.2016;2016;11;12;Tiistai;0;0;0
94;15.11.2016;2016;11;13;Tiistai;1;2;3
94;15.11.2016;2016;11;14;Tiistai;2;6;8
94;15.11.2016;2016;11;15;Tiistai;3;8;11
94;15.11.2016;2016;11;16;Tiistai;0;8;8
94;15.11.2016;2016;11;17;Tiistai;2;4;6
94;15.11.2016;2016;11;18;Tiistai;0;5;5
94;15.11.2016;2016;11;19;Tiistai;1;2;3
94;15.11.2016;2016;11;20;Tiistai;1;1;2
94;15.11.2016;2016;11;21;Tiistai;0;1;1
94;15.11.2016;2016;11;22;Tiistai;0;0;0
94;15.11.2016;2016;11;23;Tiistai;0;0;0
94;16.11.2016;2016;11;00;Keskiviikko;0;0;0
94;16.11.2016;2016;11;01;Keskiviikko;0;0;0
94;16.11.2016;2016;11;02;Keskiviikko;0;0;0
94;16.11.2016;2016;11;03;Keskiviikko;0;0;0
94;16.11.2016;2016;11;04;Keskiviikko;0;0;0
94;16.11.2016;2016;11;05;Keskiviikko;2;0;2
94;16.11.2016;2016;11;06;Keskiviikko;4;1;5
94;16.11.2016;2016;11;07;Keskiviikko;7;2;9
94;16.11.2016;2016;11;08;Keskiviikko;6;0;6
94;16.11.2016;2016;11;09;Keskiviikko;3;0;3
94;16.11.2016;2016;11;10;Keskiviikko;1;1;2
94;16.11.2016;2016;11;11;Keskiviikko;2;1;3
94;16.11.2016;2016;11;12;Keskiviikko;2;1;3
94;16.11.2016;2016;11;13;Keskiviikko;1;2;3
94;16.11.2016;2016;11;14;Keskiviikko;3;2;5
94;16.11.2016;2016;11;15;Keskiviikko;1;6;7
94;16.11.2016;2016;11;16;Keskiviikko;1;6;7
94;16.11.2016;2016;11;17;Keskiviikko;0;8;8
94;16.11.2016;2016;11;18;Keskiviikko;0;1;1
94;16.11.2016;2016;11;19;Keskiviikko;3;2;5
94;16.11.2016;2016;11;20;Keskiviikko;1;2;3
94;16.11.2016;2016;11;21;Keskiviikko;1;2;3
94;16.11.2016;2016;11;22;Keskiviikko;0;0;0
94;16.11.2016;2016;11;23;Keskiviikko;0;0;0
94;17.11.2016;2016;11;00;Torstai;0;0;0
94;17.11.2016;2016;11;01;Torstai;0;0;0
94;17.11.2016;2016;11;02;Torstai;0;0;0
94;17.11.2016;2016;11;03;Torstai;0;0;0
94;17.11.2016;2016;11;04;Torstai;0;0;0
94;17.11.2016;2016;11;05;Torstai;3;1;4
94;17.11.2016;2016;11;06;Torstai;4;1;5
94;17.11.2016;2016;11;07;Torstai;11;0;11
94;17.11.2016;2016;11;08;Torstai;6;3;9
94;17.11.2016;2016;11;09;Torstai;1;0;1
94;17.11.2016;2016;11;10;Torstai;1;1;2
94;17.11.2016;2016;11;11;Torstai;1;1;2
94;17.11.2016;2016;11;12;Torstai;2;0;2
94;17.11.2016;2016;11;13;Torstai;0;2;2
94;17.11.2016;2016;11;14;Torstai;0;3;3
94;17.11.2016;2016;11;15;Torstai;5;6;11
94;17.11.2016;2016;11;16;Torstai;2;10;12
94;17.11.2016;2016;11;17;Torstai;1;5;6
94;17.11.2016;2016;11;18;Torstai;1;1;2
94;17.11.2016;2016;11;19;Torstai;5;0;5
94;17.11.2016;2016;11;20;Torstai;2;1;3
94;17.11.2016;2016;11;21;Torstai;0;1;1
94;17.11.2016;2016;11;22;Torstai;0;1;1
94;17.11.2016;2016;11;23;Torstai;0;0;0
94;18.11.2016;2016;11;00;Perjantai;0;0;0
94;18.11.2016;2016;11;01;Perjantai;0;0;0
94;18.11.2016;2016;11;02;Perjantai;0;0;0
94;18.11.2016;2016;11;03;Perjantai;0;0;0
94;18.11.2016;2016;11;04;Perjantai;0;0;0
94;18.11.2016;2016;11;05;Perjantai;3;0;3
94;18.11.2016;2016;11;06;Perjantai;3;2;5
94;18.11.2016;2016;11;07;Perjantai;12;1;13
94;18.11.2016;2016;11;08;Perjantai;4;1;5
94;18.11.2016;2016;11;09;Perjantai;1;0;1
94;18.11.2016;2016;11;10;Perjantai;1;1;2
94;18.11.2016;2016;11;11;Perjantai;2;0;2
94;18.11.2016;2016;11;12;Perjantai;0;2;2
94;18.11.2016;2016;11;13;Perjantai;2;1;3
94;18.11.2016;2016;11;14;Perjantai;0;6;6
94;18.11.2016;2016;11;15;Perjantai;1;6;7
94;18.11.2016;2016;11;16;Perjantai;2;6;8
94;18.11.2016;2016;11;17;Perjantai;0;6;6
94;18.11.2016;2016;11;18;Perjantai;0;2;2
94;18.11.2016;2016;11;19;Perjantai;1;0;1
94;18.11.2016;2016;11;20;Perjantai;1;0;1
94;18.11.2016;2016;11;21;Perjantai;1;1;2
94;18.11.2016;2016;11;22;Perjantai;0;0;0
94;18.11.2016;2016;11;23;Perjantai;0;0;0
94;19.11.2016;2016;11;00;Lauantai;0;0;0
94;19.11.2016;2016;11;01;Lauantai;0;0;0
94;19.11.2016;2016;11;02;Lauantai;0;0;0
94;19.11.2016;2016;11;03;Lauantai;0;0;0
94;19.11.2016;2016;11;04;Lauantai;0;0;0
94;19.11.2016;2016;11;05;Lauantai;2;0;2
94;19.11.2016;2016;11;06;Lauantai;0;0;0
94;19.11.2016;2016;11;07;Lauantai;0;0;0
94;19.11.2016;2016;11;08;Lauantai;0;0;0
94;19.11.2016;2016;11;09;Lauantai;0;0;0
94;19.11.2016;2016;11;10;Lauantai;1;1;2
94;19.11.2016;2016;11;11;Lauantai;0;1;1
94;19.11.2016;2016;11;12;Lauantai;0;0;0
94;19.11.2016;2016;11;13;Lauantai;2;1;3
94;19.11.2016;2016;11;14;Lauantai;0;1;1
94;19.11.2016;2016;11;15;Lauantai;0;1;1
94;19.11.2016;2016;11;16;Lauantai;2;3;5
94;19.11.2016;2016;11;17;Lauantai;0;0;0
94;19.11.2016;2016;11;18;Lauantai;1;0;1
94;19.11.2016;2016;11;19;Lauantai;0;1;1
94;19.11.2016;2016;11;20;Lauantai;0;0;0
94;19.11.2016;2016;11;21;Lauantai;1;0;1
94;19.11.2016;2016;11;22;Lauantai;0;0;0
94;19.11.2016;2016;11;23;Lauantai;0;0;0
94;20.11.2016;2016;11;00;Sunnuntai;0;0;0
94;20.11.2016;2016;11;01;Sunnuntai;0;0;0
94;20.11.2016;2016;11;02;Sunnuntai;0;0;0
94;20.11.2016;2016;11;03;Sunnuntai;0;0;0
94;20.11.2016;2016;11;04;Sunnuntai;0;0;0
94;20.11.2016;2016;11;05;Sunnuntai;0;0;0
94;20.11.2016;2016;11;06;Sunnuntai;0;0;0
94;20.11.2016;2016;11;07;Sunnuntai;1;0;1
94;20.11.2016;2016;11;08;Sunnuntai;0;0;0
94;20.11.2016;2016;11;09;Sunnuntai;0;1;1
94;20.11.2016;2016;11;10;Sunnuntai;2;1;3
94;20.11.2016;2016;11;11;Sunnuntai;1;3;4
94;20.11.2016;2016;11;12;Sunnuntai;2;1;3
94;20.11.2016;2016;11;13;Sunnuntai;2;4;6
94;20.11.2016;2016;11;14;Sunnuntai;2;3;5
94;20.11.2016;2016;11;15;Sunnuntai;3;2;5
94;20.11.2016;2016;11;16;Sunnuntai;1;2;3
94;20.11.2016;2016;11;17;Sunnuntai;1;1;2
94;20.11.2016;2016;11;18;Sunnuntai;0;0;0
94;20.11.2016;2016;11;19;Sunnuntai;1;1;2
94;20.11.2016;2016;11;20;Sunnuntai;0;1;1
94;20.11.2016;2016;11;21;Sunnuntai;0;1;1
94;20.11.2016;2016;11;22;Sunnuntai;0;0;0
94;20.11.2016;2016;11;23;Sunnuntai;0;0;0
94;21.11.2016;2016;11;00;Maanantai;1;0;1
94;21.11.2016;2016;11;01;Maanantai;0;0;0
94;21.11.2016;2016;11;02;Maanantai;0;0;0
94;21.11.2016;2016;11;03;Maanantai;0;0;0
94;21.11.2016;2016;11;04;Maanantai;0;0;0
94;21.11.2016;2016;11;05;Maanantai;3;2;5
94;21.11.2016;2016;11;06;Maanantai;3;0;3
94;21.11.2016;2016;11;07;Maanantai;11;4;15
94;21.11.2016;2016;11;08;Maanantai;10;0;10
94;21.11.2016;2016;11;09;Maanantai;5;0;5
94;21.11.2016;2016;11;10;Maanantai;1;1;2
94;21.11.2016;2016;11;11;Maanantai;2;1;3
94;21.11.2016;2016;11;12;Maanantai;3;2;5
94;21.11.2016;2016;11;13;Maanantai;3;0;3
94;21.11.2016;2016;11;14;Maanantai;1;4;5
94;21.11.2016;2016;11;15;Maanantai;0;8;8
94;21.11.2016;2016;11;16;Maanantai;4;14;18
94;21.11.2016;2016;11;17;Maanantai;1;9;10
94;21.11.2016;2016;11;18;Maanantai;0;1;1
94;21.11.2016;2016;11;19;Maanantai;0;1;1
94;21.11.2016;2016;11;20;Maanantai;0;1;1
94;21.11.2016;2016;11;21;Maanantai;1;2;3
94;21.11.2016;2016;11;22;Maanantai;0;0;0
94;21.11.2016;2016;11;23;Maanantai;0;0;0
94;22.11.2016;2016;11;00;Tiistai;0;0;0
94;22.11.2016;2016;11;01;Tiistai;0;0;0
94;22.11.2016;2016;11;02;Tiistai;0;0;0
94;22.11.2016;2016;11;03;Tiistai;0;0;0
94;22.11.2016;2016;11;04;Tiistai;0;0;0
94;22.11.2016;2016;11;05;Tiistai;3;1;4
94;22.11.2016;2016;11;06;Tiistai;6;1;7
94;22.11.2016;2016;11;07;Tiistai;11;4;15
94;22.11.2016;2016;11;08;Tiistai;8;1;9
94;22.11.2016;2016;11;09;Tiistai;1;3;4
94;22.11.2016;2016;11;10;Tiistai;2;0;2
94;22.11.2016;2016;11;11;Tiistai;3;2;5
94;22.11.2016;2016;11;12;Tiistai;3;1;4
94;22.11.2016;2016;11;13;Tiistai;1;0;1
94;22.11.2016;2016;11;14;Tiistai;0;4;4
94;22.11.2016;2016;11;15;Tiistai;3;9;12
94;22.11.2016;2016;11;16;Tiistai;4;9;13
94;22.11.2016;2016;11;17;Tiistai;2;10;12
94;22.11.2016;2016;11;18;Tiistai;2;5;7
94;22.11.2016;2016;11;19;Tiistai;2;1;3
94;22.11.2016;2016;11;20;Tiistai;0;0;0
94;22.11.2016;2016;11;21;Tiistai;0;1;1
94;22.11.2016;2016;11;22;Tiistai;0;0;0
94;22.11.2016;2016;11;23;Tiistai;0;0;0
94;23.11.2016;2016;11;00;Keskiviikko;0;0;0
94;23.11.2016;2016;11;01;Keskiviikko;0;0;0
94;23.11.2016;2016;11;02;Keskiviikko;0;0;0
94;23.11.2016;2016;11;03;Keskiviikko;0;0;0
94;23.11.2016;2016;11;04;Keskiviikko;1;0;1
94;23.11.2016;2016;11;05;Keskiviikko;3;2;5
94;23.11.2016;2016;11;06;Keskiviikko;8;1;9
94;23.11.2016;2016;11;07;Keskiviikko;6;1;7
94;23.11.2016;2016;11;08;Keskiviikko;8;2;10
94;23.11.2016;2016;11;09;Keskiviikko;1;0;1
94;23.11.2016;2016;11;10;Keskiviikko;1;0;1
94;23.11.2016;2016;11;11;Keskiviikko;1;0;1
94;23.11.2016;2016;11;12;Keskiviikko;1;1;2
94;23.11.2016;2016;11;13;Keskiviikko;1;1;2
94;23.11.2016;2016;11;14;Keskiviikko;3;1;4
94;23.11.2016;2016;11;15;Keskiviikko;2;7;9
94;23.11.2016;2016;11;16;Keskiviikko;2;18;20
94;23.11.2016;2016;11;17;Keskiviikko;1;8;9
94;23.11.2016;2016;11;18;Keskiviikko;1;6;7
94;23.11.2016;2016;11;19;Keskiviikko;1;2;3
94;23.11.2016;2016;11;20;Keskiviikko;1;0;1
94;23.11.2016;2016;11;21;Keskiviikko;0;1;1
94;23.11.2016;2016;11;22;Keskiviikko;0;0;0
94;23.11.2016;2016;11;23;Keskiviikko;0;0;0
94;24.11.2016;2016;11;00;Torstai;1;0;1
94;24.11.2016;2016;11;01;Torstai;0;0;0
94;24.11.2016;2016;11;02;Torstai;0;0;0
94;24.11.2016;2016;11;03;Torstai;0;0;0
94;24.11.2016;2016;11;04;Torstai;0;0;0
94;24.11.2016;2016;11;05;Torstai;2;1;3
94;24.11.2016;2016;11;06;Torstai;6;0;6
94;24.11.2016;2016;11;07;Torstai;10;4;14
94;24.11.2016;2016;11;08;Torstai;8;0;8
94;24.11.2016;2016;11;09;Torstai;0;1;1
94;24.11.2016;2016;11;10;Torstai;0;1;1
94;24.11.2016;2016;11;11;Torstai;5;0;5
94;24.11.2016;2016;11;12;Torstai;2;1;3
94;24.11.2016;2016;11;13;Torstai;1;1;2
94;24.11.2016;2016;11;14;Torstai;2;4;6
94;24.11.2016;2016;11;15;Torstai;3;7;10
94;24.11.2016;2016;11;16;Torstai;3;16;19
94;24.11.2016;2016;11;17;Torstai;1;4;5
94;24.11.2016;2016;11;18;Torstai;0;6;6
94;24.11.2016;2016;11;19;Torstai;3;2;5
94;24.11.2016;2016;11;20;Torstai;1;0;1
94;24.11.2016;2016;11;21;Torstai;0;2;2
94;24.11.2016;2016;11;22;Torstai;0;0;0
94;24.11.2016;2016;11;23;Torstai;0;1;1
94;25.11.2016;2016;11;00;Perjantai;0;0;0
94;25.11.2016;2016;11;01;Perjantai;0;0;0
94;25.11.2016;2016;11;02;Perjantai;0;0;0
94;25.11.2016;2016;11;03;Perjantai;0;0;0
94;25.11.2016;2016;11;04;Perjantai;0;0;0
94;25.11.2016;2016;11;05;Perjantai;3;1;4
94;25.11.2016;2016;11;06;Perjantai;3;1;4
94;25.11.2016;2016;11;07;Perjantai;11;2;13
94;25.11.2016;2016;11;08;Perjantai;8;1;9
94;25.11.2016;2016;11;09;Perjantai;0;0;0
94;25.11.2016;2016;11;10;Perjantai;0;0;0
94;25.11.2016;2016;11;11;Perjantai;3;0;3
94;25.11.2016;2016;11;12;Perjantai;2;2;4
94;25.11.2016;2016;11;13;Perjantai;2;4;6
94;25.11.2016;2016;11;14;Perjantai;1;3;4
94;25.11.2016;2016;11;15;Perjantai;2;5;7
94;25.11.2016;2016;11;16;Perjantai;2;10;12
94;25.11.2016;2016;11;17;Perjantai;1;5;6
94;25.11.2016;2016;11;18;Perjantai;2;3;5
94;25.11.2016;2016;11;19;Perjantai;2;1;3
94;25.11.2016;2016;11;20;Perjantai;1;0;1
94;25.11.2016;2016;11;21;Perjantai;1;2;3
94;25.11.2016;2016;11;22;Perjantai;0;0;0
94;25.11.2016;2016;11;23;Perjantai;0;0;0
94;26.11.2016;2016;11;00;Lauantai;0;0;0
94;26.11.2016;2016;11;01;Lauantai;0;0;0
94;26.11.2016;2016;11;02;Lauantai;0;0;0
94;26.11.2016;2016;11;03;Lauantai;0;0;0
94;26.11.2016;2016;11;04;Lauantai;0;0;0
94;26.11.2016;2016;11;05;Lauantai;1;0;1
94;26.11.2016;2016;11;06;Lauantai;0;0;0
94;26.11.2016;2016;11;07;Lauantai;1;2;3
94;26.11.2016;2016;11;08;Lauantai;0;1;1
94;26.11.2016;2016;11;09;Lauantai;0;0;0
94;26.11.2016;2016;11;10;Lauantai;0;1;1
94;26.11.2016;2016;11;11;Lauantai;1;0;1
94;26.11.2016;2016;11;12;Lauantai;0;1;1
94;26.11.2016;2016;11;13;Lauantai;0;0;0
94;26.11.2016;2016;11;14;Lauantai;0;1;1
94;26.11.2016;2016;11;15;Lauantai;0;1;1
94;26.11.2016;2016;11;16;Lauantai;0;0;0
94;26.11.2016;2016;11;17;Lauantai;2;0;2
94;26.11.2016;2016;11;18;Lauantai;1;0;1
94;26.11.2016;2016;11;19;Lauantai;0;0;0
94;26.11.2016;2016;11;20;Lauantai;1;0;1
94;26.11.2016;2016;11;21;Lauantai;0;0;0
94;26.11.2016;2016;11;22;Lauantai;0;3;3
94;26.11.2016;2016;11;23;Lauantai;0;0;0
94;27.11.2016;2016;11;00;Sunnuntai;1;0;1
94;27.11.2016;2016;11;01;Sunnuntai;0;0;0
94;27.11.2016;2016;11;02;Sunnuntai;1;0;1
94;27.11.2016;2016;11;03;Sunnuntai;0;0;0
94;27.11.2016;2016;11;04;Sunnuntai;0;0;0
94;27.11.2016;2016;11;05;Sunnuntai;0;0;0
94;27.11.2016;2016;11;06;Sunnuntai;0;0;0
94;27.11.2016;2016;11;07;Sunnuntai;0;2;2
94;27.11.2016;2016;11;08;Sunnuntai;0;0;0
94;27.11.2016;2016;11;09;Sunnuntai;0;3;3
94;27.11.2016;2016;11;10;Sunnuntai;1;0;1
94;27.11.2016;2016;11;11;Sunnuntai;1;0;1
94;27.11.2016;2016;11;12;Sunnuntai;4;0;4
94;27.11.2016;2016;11;13;Sunnuntai;0;0;0
94;27.11.2016;2016;11;14;Sunnuntai;0;1;1
94;27.11.2016;2016;11;15;Sunnuntai;1;1;2
94;27.11.2016;2016;11;16;Sunnuntai;0;1;1
94;27.11.2016;2016;11;17;Sunnuntai;1;0;1
94;27.11.2016;2016;11;18;Sunnuntai;0;0;0
94;27.11.2016;2016;11;19;Sunnuntai;1;0;1
94;27.11.2016;2016;11;20;Sunnuntai;0;1;1
94;27.11.2016;2016;11;21;Sunnuntai;0;1;1
94;27.11.2016;2016;11;22;Sunnuntai;0;0;0
94;27.11.2016;2016;11;23;Sunnuntai;0;0;0
94;28.11.2016;2016;11;00;Maanantai;0;0;0
94;28.11.2016;2016;11;01;Maanantai;0;0;0
94;28.11.2016;2016;11;02;Maanantai;0;0;0
94;28.11.2016;2016;11;03;Maanantai;0;0;0
94;28.11.2016;2016;11;04;Maanantai;0;0;0
94;28.11.2016;2016;11;05;Maanantai;3;1;4
94;28.11.2016;2016;11;06;Maanantai;6;0;6
94;28.11.2016;2016;11;07;Maanantai;8;1;9
94;28.11.2016;2016;11;08;Maanantai;6;0;6
94;28.11.2016;2016;11;09;Maanantai;2;0;2
94;28.11.2016;2016;11;10;Maanantai;0;0;0
94;28.11.2016;2016;11;11;Maanantai;3;0;3
94;28.11.2016;2016;11;12;Maanantai;1;0;1
94;28.11.2016;2016;11;13;Maanantai;0;1;1
94;28.11.2016;2016;11;14;Maanantai;1;5;6
94;28.11.2016;2016;11;15;Maanantai;2;2;4
94;28.11.2016;2016;11;16;Maanantai;1;9;10
94;28.11.2016;2016;11;17;Maanantai;1;11;12
94;28.11.2016;2016;11;18;Maanantai;0;2;2
94;28.11.2016;2016;11;19;Maanantai;0;2;2
94;28.11.2016;2016;11;20;Maanantai;0;0;0
94;28.11.2016;2016;11;21;Maanantai;1;2;3
94;28.11.2016;2016;11;22;Maanantai;1;1;2
94;28.11.2016;2016;11;23;Maanantai;0;0;0
94;29.11.2016;2016;11;00;Tiistai;0;0;0
94;29.11.2016;2016;11;01;Tiistai;0;0;0
94;29.11.2016;2016;11;02;Tiistai;0;0;0
94;29.11.2016;2016;11;03;Tiistai;0;0;0
94;29.11.2016;2016;11;04;Tiistai;0;0;0
94;29.11.2016;2016;11;05;Tiistai;3;1;4
94;29.11.2016;2016;11;06;Tiistai;6;0;6
94;29.11.2016;2016;11;07;Tiistai;9;1;10
94;29.11.2016;2016;11;08;Tiistai;3;0;3
94;29.11.2016;2016;11;09;Tiistai;1;1;2
94;29.11.2016;2016;11;10;Tiistai;0;0;0
94;29.11.2016;2016;11;11;Tiistai;2;0;2
94;29.11.2016;2016;11;12;Tiistai;1;0;1
94;29.11.2016;2016;11;13;Tiistai;0;0;0
94;29.11.2016;2016;11;14;Tiistai;0;2;2
94;29.11.2016;2016;11;15;Tiistai;1;5;6
94;29.11.2016;2016;11;16;Tiistai;2;10;12
94;29.11.2016;2016;11;17;Tiistai;0;7;7
94;29.11.2016;2016;11;18;Tiistai;1;2;3
94;29.11.2016;2016;11;19;Tiistai;0;2;2
94;29.11.2016;2016;11;20;Tiistai;1;1;2
94;29.11.2016;2016;11;21;Tiistai;1;1;2
94;29.11.2016;2016;11;22;Tiistai;0;0;0
94;29.11.2016;2016;11;23;Tiistai;0;0;0
94;30.11.2016;2016;11;00;Keskiviikko;0;0;0
94;30.11.2016;2016;11;01;Keskiviikko;0;0;0
94;30.11.2016;2016;11;02;Keskiviikko;0;0;0
94;30.11.2016;2016;11;03;Keskiviikko;0;0;0
94;30.11.2016;2016;11;04;Keskiviikko;0;0;0
94;30.11.2016;2016;11;05;Keskiviikko;3;1;4
94;30.11.2016;2016;11;06;Keskiviikko;5;0;5
94;30.11.2016;2016;11;07;Keskiviikko;13;1;14
94;30.11.2016;2016;11;08;Keskiviikko;4;0;4
94;30.11.2016;2016;11;09;Keskiviikko;3;1;4
94;30.11.2016;2016;11;10;Keskiviikko;0;3;3
94;30.11.2016;2016;11;11;Keskiviikko;0;0;0
94;30.11.2016;2016;11;12;Keskiviikko;2;3;5
94;30.11.2016;2016;11;13;Keskiviikko;1;2;3
94;30.11.2016;2016;11;14;Keskiviikko;0;2;2
94;30.11.2016;2016;11;15;Keskiviikko;2;10;12
94;30.11.2016;2016;11;16;Keskiviikko;2;11;13
94;30.11.2016;2016;11;17;Keskiviikko;0;4;4
94;30.11.2016;2016;11;18;Keskiviikko;0;6;6
94;30.11.2016;2016;11;19;Keskiviikko;6;1;7
94;30.11.2016;2016;11;20;Keskiviikko;1;4;5
94;30.11.2016;2016;11;21;Keskiviikko;0;0;0
94;30.11.2016;2016;11;22;Keskiviikko;0;0;0
94;30.11.2016;2016;11;23;Keskiviikko;0;0;0
94;01.12.2016;2016;12;00;Torstai;0;0;0
94;01.12.2016;2016;12;01;Torstai;0;0;0
94;01.12.2016;2016;12;02;Torstai;0;0;0
94;01.12.2016;2016;12;03;Torstai;0;0;0
94;01.12.2016;2016;12;04;Torstai;0;0;0
94;01.12.2016;2016;12;05;Torstai;3;2;5
94;01.12.2016;2016;12;06;Torstai;4;0;4
94;01.12.2016;2016;12;07;Torstai;14;5;19
94;01.12.2016;2016;12;08;Torstai;7;1;8
94;01.12.2016;2016;12;09;Torstai;3;1;4
94;01.12.2016;2016;12;10;Torstai;1;2;3
94;01.12.2016;2016;12;11;Torstai;1;0;1
94;01.12.2016;2016;12;12;Torstai;3;0;3
94;01.12.2016;2016;12;13;Torstai;1;2;3
94;01.12.2016;2016;12;14;Torstai;1;4;5
94;01.12.2016;2016;12;15;Torstai;1;8;9
94;01.12.2016;2016;12;16;Torstai;3;11;14
94;01.12.2016;2016;12;17;Torstai;3;6;9
94;01.12.2016;2016;12;18;Torstai;3;3;6
94;01.12.2016;2016;12;19;Torstai;0;0;0
94;01.12.2016;2016;12;20;Torstai;1;1;2
94;01.12.2016;2016;12;21;Torstai;0;2;2
94;01.12.2016;2016;12;22;Torstai;0;2;2
94;01.12.2016;2016;12;23;Torstai;0;0;0
94;02.12.2016;2016;12;00;Perjantai;0;0;0
94;02.12.2016;2016;12;01;Perjantai;0;0;0
94;02.12.2016;2016;12;02;Perjantai;0;0;0
94;02.12.2016;2016;12;03;Perjantai;0;0;0
94;02.12.2016;2016;12;04;Perjantai;0;0;0
94;02.12.2016;2016;12;05;Perjantai;3;1;4
94;02.12.2016;2016;12;06;Perjantai;5;1;6
94;02.12.2016;2016;12;07;Perjantai;12;1;13
94;02.12.2016;2016;12;08;Perjantai;1;0;1
94;02.12.2016;2016;12;09;Perjantai;1;0;1
94;02.12.2016;2016;12;10;Perjantai;1;0;1
94;02.12.2016;2016;12;11;Perjantai;0;0;0
94;02.12.2016;2016;12;12;Perjantai;0;1;1
94;02.12.2016;2016;12;13;Perjantai;0;2;2
94;02.12.2016;2016;12;14;Perjantai;1;2;3
94;02.12.2016;2016;12;15;Perjantai;7;10;17
94;02.12.2016;2016;12;16;Perjantai;1;6;7
94;02.12.2016;2016;12;17;Perjantai;0;4;4
94;02.12.2016;2016;12;18;Perjantai;0;2;2
94;02.12.2016;2016;12;19;Perjantai;1;0;1
94;02.12.2016;2016;12;20;Perjantai;3;0;3
94;02.12.2016;2016;12;21;Perjantai;0;2;2
94;02.12.2016;2016;12;22;Perjantai;0;0;0
94;02.12.2016;2016;12;23;Perjantai;0;0;0
94;03.12.2016;2016;12;00;Lauantai;0;0;0
94;03.12.2016;2016;12;01;Lauantai;0;1;1
94;03.12.2016;2016;12;02;Lauantai;0;0;0
94;03.12.2016;2016;12;03;Lauantai;0;0;0
94;03.12.2016;2016;12;04;Lauantai;1;0;1
94;03.12.2016;2016;12;05;Lauantai;0;0;0
94;03.12.2016;2016;12;06;Lauantai;0;0;0
94;03.12.2016;2016;12;07;Lauantai;0;0;0
94;03.12.2016;2016;12;08;Lauantai;0;0;0
94;03.12.2016;2016;12;09;Lauantai;0;0;0
94;03.12.2016;2016;12;10;Lauantai;0;0;0
94;03.12.2016;2016;12;11;Lauantai;1;0;1
94;03.12.2016;2016;12;12;Lauantai;0;1;1
94;03.12.2016;2016;12;13;Lauantai;0;1;1
94;03.12.2016;2016;12;14;Lauantai;0;0;0
94;03.12.2016;2016;12;15;Lauantai;0;0;0
94;03.12.2016;2016;12;16;Lauantai;0;0;0
94;03.12.2016;2016;12;17;Lauantai;3;1;4
94;03.12.2016;2016;12;18;Lauantai;1;4;5
94;03.12.2016;2016;12;19;Lauantai;0;1;1
94;03.12.2016;2016;12;20;Lauantai;0;1;1
94;03.12.2016;2016;12;21;Lauantai;0;0;0
94;03.12.2016;2016;12;22;Lauantai;1;0;1
94;03.12.2016;2016;12;23;Lauantai;0;0;0
94;04.12.2016;2016;12;00;Sunnuntai;0;0;0
94;04.12.2016;2016;12;01;Sunnuntai;0;0;0
94;04.12.2016;2016;12;02;Sunnuntai;0;0;0
94;04.12.2016;2016;12;03;Sunnuntai;0;0;0
94;04.12.2016;2016;12;04;Sunnuntai;0;0;0
94;04.12.2016;2016;12;05;Sunnuntai;0;0;0
94;04.12.2016;2016;12;06;Sunnuntai;0;0;0
94;04.12.2016;2016;12;07;Sunnuntai;0;0;0
94;04.12.2016;2016;12;08;Sunnuntai;1;0;1
94;04.12.2016;2016;12;09;Sunnuntai;1;0;1
94;04.12.2016;2016;12;10;Sunnuntai;0;0;0
94;04.12.2016;2016;12;11;Sunnuntai;0;0;0
94;04.12.2016;2016;12;12;Sunnuntai;1;1;2
94;04.12.2016;2016;12;13;Sunnuntai;0;2;2
94;04.12.2016;2016;12;14;Sunnuntai;3;1;4
94;04.12.2016;2016;12;15;Sunnuntai;0;1;1
94;04.12.2016;2016;12;16;Sunnuntai;0;0;0
94;04.12.2016;2016;12;17;Sunnuntai;1;1;2
94;04.12.2016;2016;12;18;Sunnuntai;0;1;1
94;04.12.2016;2016;12;19;Sunnuntai;0;0;0
94;04.12.2016;2016;12;20;Sunnuntai;0;1;1
94;04.12.2016;2016;12;21;Sunnuntai;0;0;0
94;04.12.2016;2016;12;22;Sunnuntai;0;1;1
94;04.12.2016;2016;12;23;Sunnuntai;0;0;0
94;05.12.2016;2016;12;00;Maanantai;0;0;0
94;05.12.2016;2016;12;01;Maanantai;0;0;0
94;05.12.2016;2016;12;02;Maanantai;0;0;0
94;05.12.2016;2016;12;03;Maanantai;0;0;0
94;05.12.2016;2016;12;04;Maanantai;0;0;0
94;05.12.2016;2016;12;05;Maanantai;2;3;5
94;05.12.2016;2016;12;06;Maanantai;1;0;1
94;05.12.2016;2016;12;07;Maanantai;4;1;5
94;05.12.2016;2016;12;08;Maanantai;4;0;4
94;05.12.2016;2016;12;09;Maanantai;0;0;0
94;05.12.2016;2016;12;10;Maanantai;0;0;0
94;05.12.2016;2016;12;11;Maanantai;1;2;3
94;05.12.2016;2016;12;12;Maanantai;3;0;3
94;05.12.2016;2016;12;13;Maanantai;0;1;1
94;05.12.2016;2016;12;14;Maanantai;1;2;3
94;05.12.2016;2016;12;15;Maanantai;1;5;6
94;05.12.2016;2016;12;16;Maanantai;0;9;9
94;05.12.2016;2016;12;17;Maanantai;1;0;1
94;05.12.2016;2016;12;18;Maanantai;0;1;1
94;05.12.2016;2016;12;19;Maanantai;0;0;0
94;05.12.2016;2016;12;20;Maanantai;1;3;4
94;05.12.2016;2016;12;21;Maanantai;0;0;0
94;05.12.2016;2016;12;22;Maanantai;0;0;0
94;05.12.2016;2016;12;23;Maanantai;0;0;0
94;06.12.2016;2016;12;00;Tiistai;1;0;1
94;06.12.2016;2016;12;01;Tiistai;1;0;1
94;06.12.2016;2016;12;02;Tiistai;0;0;0
94;06.12.2016;2016;12;03;Tiistai;0;0;0
94;06.12.2016;2016;12;04;Tiistai;0;0;0
94;06.12.2016;2016;12;05;Tiistai;0;0;0
94;06.12.2016;2016;12;06;Tiistai;0;0;0
94;06.12.2016;2016;12;07;Tiistai;0;2;2
94;06.12.2016;2016;12;08;Tiistai;0;0;0
94;06.12.2016;2016;12;09;Tiistai;0;2;2
94;06.12.2016;2016;12;10;Tiistai;0;0;0
94;06.12.2016;2016;12;11;Tiistai;0;0;0
94;06.12.2016;2016;12;12;Tiistai;1;1;2
94;06.12.2016;2016;12;13;Tiistai;0;0;0
94;06.12.2016;2016;12;14;Tiistai;1;1;2
94;06.12.2016;2016;12;15;Tiistai;1;0;1
94;06.12.2016;2016;12;16;Tiistai;0;0;0
94;06.12.2016;2016;12;17;Tiistai;1;0;1
94;06.12.2016;2016;12;18;Tiistai;1;0;1
94;06.12.2016;2016;12;19;Tiistai;0;0;0
94;06.12.2016;2016;12;20;Tiistai;0;0;0
94;06.12.2016;2016;12;21;Tiistai;0;1;1
94;06.12.2016;2016;12;22;Tiistai;0;0;0
94;06.12.2016;2016;12;23;Tiistai;0;0;0
94;07.12.2016;2016;12;00;Keskiviikko;0;0;0
94;07.12.2016;2016;12;01;Keskiviikko;0;0;0
94;07.12.2016;2016;12;02;Keskiviikko;0;0;0
94;07.12.2016;2016;12;03;Keskiviikko;0;0;0
94;07.12.2016;2016;12;04;Keskiviikko;0;0;0
94;07.12.2016;2016;12;05;Keskiviikko;3;0;3
94;07.12.2016;2016;12;06;Keskiviikko;5;0;5
94;07.12.2016;2016;12;07;Keskiviikko;12;4;16
94;07.12.2016;2016;12;08;Keskiviikko;5;1;6
94;07.12.2016;2016;12;09;Keskiviikko;3;0;3
94;07.12.2016;2016;12;10;Keskiviikko;0;0;0
94;07.12.2016;2016;12;11;Keskiviikko;0;0;0
94;07.12.2016;2016;12;12;Keskiviikko;2;1;3
94;07.12.2016;2016;12;13;Keskiviikko;2;4;6
94;07.12.2016;2016;12;14;Keskiviikko;1;4;5
94;07.12.2016;2016;12;15;Keskiviikko;1;10;11
94;07.12.2016;2016;12;16;Keskiviikko;2;7;9
94;07.12.2016;2016;12;17;Keskiviikko;2;11;13
94;07.12.2016;2016;12;18;Keskiviikko;0;1;1
94;07.12.2016;2016;12;19;Keskiviikko;2;4;6
94;07.12.2016;2016;12;20;Keskiviikko;1;1;2
94;07.12.2016;2016;12;21;Keskiviikko;0;1;1
94;07.12.2016;2016;12;22;Keskiviikko;0;0;0
94;07.12.2016;2016;12;23;Keskiviikko;0;0;0
94;08.12.2016;2016;12;00;Torstai;0;0;0
94;08.12.2016;2016;12;01;Torstai;0;0;0
94;08.12.2016;2016;12;02;Torstai;0;0;0
94;08.12.2016;2016;12;03;Torstai;0;0;0
94;08.12.2016;2016;12;04;Torstai;0;0;0
94;08.12.2016;2016;12;05;Torstai;6;2;8
94;08.12.2016;2016;12;06;Torstai;3;0;3
94;08.12.2016;2016;12;07;Torstai;8;2;10
94;08.12.2016;2016;12;08;Torstai;6;1;7
94;08.12.2016;2016;12;09;Torstai;3;1;4
94;08.12.2016;2016;12;10;Torstai;2;1;3
94;08.12.2016;2016;12;11;Torstai;2;0;2
94;08.12.2016;2016;12;12;Torstai;3;1;4
94;08.12.2016;2016;12;13;Torstai;1;1;2
94;08.12.2016;2016;12;14;Torstai;4;7;11
94;08.12.2016;2016;12;15;Torstai;0;4;4
94;08.12.2016;2016;12;16;Torstai;3;7;10
94;08.12.2016;2016;12;17;Torstai;0;4;4
94;08.12.2016;2016;12;18;Torstai;0;3;3
94;08.12.2016;2016;12;19;Torstai;2;2;4
94;08.12.2016;2016;12;20;Torstai;1;1;2
94;08.12.2016;2016;12;21;Torstai;1;2;3
94;08.12.2016;2016;12;22;Torstai;0;0;0
94;08.12.2016;2016;12;23;Torstai;0;1;1
94;09.12.2016;2016;12;00;Perjantai;0;0;0
94;09.12.2016;2016;12;01;Perjantai;0;0;0
94;09.12.2016;2016;12;02;Perjantai;0;0;0
94;09.12.2016;2016;12;03;Perjantai;0;0;0
94;09.12.2016;2016;12;04;Perjantai;0;0;0
94;09.12.2016;2016;12;05;Perjantai;6;1;7
94;09.12.2016;2016;12;06;Perjantai;1;0;1
94;09.12.2016;2016;12;07;Perjantai;14;1;15
94;09.12.2016;2016;12;08;Perjantai;7;1;8
94;09.12.2016;2016;12;09;Perjantai;1;1;2
94;09.12.2016;2016;12;10;Perjantai;1;0;1
94;09.12.2016;2016;12;11;Perjantai;1;0;1
94;09.12.2016;2016;12;12;Perjantai;0;1;1
94;09.12.2016;2016;12;13;Perjantai;0;3;3
94;09.12.2016;2016;12;14;Perjantai;5;5;10
94;09.12.2016;2016;12;15;Perjantai;1;8;9
94;09.12.2016;2016;12;16;Perjantai;1;9;10
94;09.12.2016;2016;12;17;Perjantai;0;5;5
94;09.12.2016;2016;12;18;Perjantai;0;2;2
94;09.12.2016;2016;12;19;Perjantai;0;2;2
94;09.12.2016;2016;12;20;Perjantai;0;0;0
94;09.12.2016;2016;12;21;Perjantai;1;0;1
94;09.12.2016;2016;12;22;Perjantai;0;0;0
94;09.12.2016;2016;12;23;Perjantai;0;0;0
94;10.12.2016;2016;12;00;Lauantai;0;0;0
94;10.12.2016;2016;12;01;Lauantai;0;0;0
94;10.12.2016;2016;12;02;Lauantai;0;0;0
94;10.12.2016;2016;12;03;Lauantai;0;0;0
94;10.12.2016;2016;12;04;Lauantai;1;0;1
94;10.12.2016;2016;12;05;Lauantai;0;0;0
94;10.12.2016;2016;12;06;Lauantai;0;0;0
94;10.12.2016;2016;12;07;Lauantai;0;0;0
94;10.12.2016;2016;12;08;Lauantai;0;0;0
94;10.12.2016;2016;12;09;Lauantai;0;0;0
94;10.12.2016;2016;12;10;Lauantai;0;1;1
94;10.12.2016;2016;12;11;Lauantai;0;2;2
94;10.12.2016;2016;12;12;Lauantai;3;0;3
94;10.12.2016;2016;12;13;Lauantai;3;0;3
94;10.12.2016;2016;12;14;Lauantai;0;1;1
94;10.12.2016;2016;12;15;Lauantai;1;2;3
94;10.12.2016;2016;12;16;Lauantai;0;1;1
94;10.12.2016;2016;12;17;Lauantai;0;0;0
94;10.12.2016;2016;12;18;Lauantai;0;0;0
94;10.12.2016;2016;12;19;Lauantai;0;1;1
94;10.12.2016;2016;12;20;Lauantai;1;0;1
94;10.12.2016;2016;12;21;Lauantai;0;1;1
94;10.12.2016;2016;12;22;Lauantai;0;1;1
94;10.12.2016;2016;12;23;Lauantai;0;0;0
94;11.12.2016;2016;12;00;Sunnuntai;0;0;0
94;11.12.2016;2016;12;01;Sunnuntai;0;0;0
94;11.12.2016;2016;12;02;Sunnuntai;0;0;0
94;11.12.2016;2016;12;03;Sunnuntai;0;0;0
94;11.12.2016;2016;12;04;Sunnuntai;0;0;0
94;11.12.2016;2016;12;05;Sunnuntai;0;0;0
94;11.12.2016;2016;12;06;Sunnuntai;0;0;0
94;11.12.2016;2016;12;07;Sunnuntai;0;0;0
94;11.12.2016;2016;12;08;Sunnuntai;0;0;0
94;11.12.2016;2016;12;09;Sunnuntai;1;1;2
94;11.12.2016;2016;12;10;Sunnuntai;0;0;0
94;11.12.2016;2016;12;11;Sunnuntai;1;1;2
94;11.12.2016;2016;12;12;Sunnuntai;1;1;2
94;11.12.2016;2016;12;13;Sunnuntai;0;0;0
94;11.12.2016;2016;12;14;Sunnuntai;0;0;0
94;11.12.2016;2016;12;15;Sunnuntai;0;1;1
94;11.12.2016;2016;12;16;Sunnuntai;1;1;2
94;11.12.2016;2016;12;17;Sunnuntai;0;0;0
94;11.12.2016;2016;12;18;Sunnuntai;0;0;0
94;11.12.2016;2016;12;19;Sunnuntai;1;0;1
94;11.12.2016;2016;12;20;Sunnuntai;0;0;0
94;11.12.2016;2016;12;21;Sunnuntai;0;0;0
94;11.12.2016;2016;12;22;Sunnuntai;0;1;1
94;11.12.2016;2016;12;23;Sunnuntai;0;0;0
94;12.12.2016;2016;12;00;Maanantai;0;0;0
94;12.12.2016;2016;12;01;Maanantai;0;0;0
94;12.12.2016;2016;12;02;Maanantai;0;0;0
94;12.12.2016;2016;12;03;Maanantai;0;0;0
94;12.12.2016;2016;12;04;Maanantai;0;0;0
94;12.12.2016;2016;12;05;Maanantai;2;1;3
94;12.12.2016;2016;12;06;Maanantai;4;0;4
94;12.12.2016;2016;12;07;Maanantai;11;2;13
94;12.12.2016;2016;12;08;Maanantai;2;0;2
94;12.12.2016;2016;12;09;Maanantai;2;0;2
94;12.12.2016;2016;12;10;Maanantai;0;0;0
94;12.12.2016;2016;12;11;Maanantai;0;1;1
94;12.12.2016;2016;12;12;Maanantai;1;0;1
94;12.12.2016;2016;12;13;Maanantai;0;1;1
94;12.12.2016;2016;12;14;Maanantai;1;2;3
94;12.12.2016;2016;12;15;Maanantai;1;4;5
94;12.12.2016;2016;12;16;Maanantai;2;8;10
94;12.12.2016;2016;12;17;Maanantai;2;6;8
94;12.12.2016;2016;12;18;Maanantai;0;2;2
94;12.12.2016;2016;12;19;Maanantai;0;2;2
94;12.12.2016;2016;12;20;Maanantai;0;1;1
94;12.12.2016;2016;12;21;Maanantai;0;1;1
94;12.12.2016;2016;12;22;Maanantai;0;1;1
94;12.12.2016;2016;12;23;Maanantai;0;0;0
94;13.12.2016;2016;12;00;Tiistai;0;0;0
94;13.12.2016;2016;12;01;Tiistai;0;0;0
94;13.12.2016;2016;12;02;Tiistai;0;0;0
94;13.12.2016;2016;12;03;Tiistai;1;0;1
94;13.12.2016;2016;12;04;Tiistai;0;0;0
94;13.12.2016;2016;12;05;Tiistai;1;2;3
94;13.12.2016;2016;12;06;Tiistai;4;0;4
94;13.12.2016;2016;12;07;Tiistai;7;2;9
94;13.12.2016;2016;12;08;Tiistai;5;1;6
94;13.12.2016;2016;12;09;Tiistai;1;2;3
94;13.12.2016;2016;12;10;Tiistai;3;0;3
94;13.12.2016;2016;12;11;Tiistai;0;0;0
94;13.12.2016;2016;12;12;Tiistai;3;2;5
94;13.12.2016;2016;12;13;Tiistai;2;1;3
94;13.12.2016;2016;12;14;Tiistai;1;3;4
94;13.12.2016;2016;12;15;Tiistai;1;4;5
94;13.12.2016;2016;12;16;Tiistai;2;3;5
94;13.12.2016;2016;12;17;Tiistai;1;8;9
94;13.12.2016;2016;12;18;Tiistai;2;0;2
94;13.12.2016;2016;12;19;Tiistai;0;2;2
94;13.12.2016;2016;12;20;Tiistai;0;1;1
94;13.12.2016;2016;12;21;Tiistai;0;0;0
94;13.12.2016;2016;12;22;Tiistai;0;0;0
94;13.12.2016;2016;12;23;Tiistai;0;0;0
94;14.12.2016;2016;12;00;Keskiviikko;0;0;0
94;14.12.2016;2016;12;01;Keskiviikko;1;1;2
94;14.12.2016;2016;12;02;Keskiviikko;0;0;0
94;14.12.2016;2016;12;03;Keskiviikko;0;0;0
94;14.12.2016;2016;12;04;Keskiviikko;1;0;1
94;14.12.2016;2016;12;05;Keskiviikko;4;1;5
94;14.12.2016;2016;12;06;Keskiviikko;6;0;6
94;14.12.2016;2016;12;07;Keskiviikko;13;1;14
94;14.12.2016;2016;12;08;Keskiviikko;3;1;4
94;14.12.2016;2016;12;09;Keskiviikko;4;0;4
94;14.12.2016;2016;12;10;Keskiviikko;1;0;1
94;14.12.2016;2016;12;11;Keskiviikko;1;0;1
94;14.12.2016;2016;12;12;Keskiviikko;0;1;1
94;14.12.2016;2016;12;13;Keskiviikko;0;1;1
94;14.12.2016;2016;12;14;Keskiviikko;1;6;7
94;14.12.2016;2016;12;15;Keskiviikko;2;6;8
94;14.12.2016;2016;12;16;Keskiviikko;0;9;9
94;14.12.2016;2016;12;17;Keskiviikko;1;6;7
94;14.12.2016;2016;12;18;Keskiviikko;0;3;3
94;14.12.2016;2016;12;19;Keskiviikko;1;2;3
94;14.12.2016;2016;12;20;Keskiviikko;0;1;1
94;14.12.2016;2016;12;21;Keskiviikko;1;2;3
94;14.12.2016;2016;12;22;Keskiviikko;0;0;0
94;14.12.2016;2016;12;23;Keskiviikko;0;0;0
94;15.12.2016;2016;12;00;Torstai;0;0;0
94;15.12.2016;2016;12;01;Torstai;0;0;0
94;15.12.2016;2016;12;02;Torstai;0;0;0
94;15.12.2016;2016;12;03;Torstai;0;0;0
94;15.12.2016;2016;12;04;Torstai;1;0;1
94;15.12.2016;2016;12;05;Torstai;1;2;3
94;15.12.2016;2016;12;06;Torstai;2;0;2
94;15.12.2016;2016;12;07;Torstai;14;2;16
94;15.12.2016;2016;12;08;Torstai;6;0;6
94;15.12.2016;2016;12;09;Torstai;2;1;3
94;15.12.2016;2016;12;10;Torstai;1;0;1
94;15.12.2016;2016;12;11;Torstai;1;1;2
94;15.12.2016;2016;12;12;Torstai;0;1;1
94;15.12.2016;2016;12;13;Torstai;1;1;2
94;15.12.2016;2016;12;14;Torstai;2;1;3
94;15.12.2016;2016;12;15;Torstai;2;2;4
94;15.12.2016;2016;12;16;Torstai;0;9;9
94;15.12.2016;2016;12;17;Torstai;0;10;10
94;15.12.2016;2016;12;18;Torstai;0;2;2
94;15.12.2016;2016;12;19;Torstai;3;1;4
94;15.12.2016;2016;12;20;Torstai;0;4;4
94;15.12.2016;2016;12;21;Torstai;0;1;1
94;15.12.2016;2016;12;22;Torstai;0;0;0
94;15.12.2016;2016;12;23;Torstai;0;0;0
94;16.12.2016;2016;12;00;Perjantai;0;0;0
94;16.12.2016;2016;12;01;Perjantai;0;0;0
94;16.12.2016;2016;12;02;Perjantai;0;1;1
94;16.12.2016;2016;12;03;Perjantai;0;0;0
94;16.12.2016;2016;12;04;Perjantai;0;0;0
94;16.12.2016;2016;12;05;Perjantai;1;1;2
94;16.12.2016;2016;12;06;Perjantai;2;1;3
94;16.12.2016;2016;12;07;Perjantai;12;3;15
94;16.12.2016;2016;12;08;Perjantai;4;0;4
94;16.12.2016;2016;12;09;Perjantai;2;0;2
94;16.12.2016;2016;12;10;Perjantai;2;2;4
94;16.12.2016;2016;12;11;Perjantai;1;1;2
94;16.12.2016;2016;12;12;Perjantai;1;1;2
94;16.12.2016;2016;12;13;Perjantai;1;2;3
94;16.12.2016;2016;12;14;Perjantai;2;3;5
94;16.12.2016;2016;12;15;Perjantai;2;9;11
94;16.12.2016;2016;12;16;Perjantai;0;4;4
94;16.12.2016;2016;12;17;Perjantai;2;4;6
94;16.12.2016;2016;12;18;Perjantai;0;5;5
94;16.12.2016;2016;12;19;Perjantai;1;5;6
94;16.12.2016;2016;12;20;Perjantai;0;0;0
94;16.12.2016;2016;12;21;Perjantai;2;1;3
94;16.12.2016;2016;12;22;Perjantai;0;2;2
94;16.12.2016;2016;12;23;Perjantai;0;0;0
94;17.12.2016;2016;12;00;Lauantai;0;0;0
94;17.12.2016;2016;12;01;Lauantai;0;0;0
94;17.12.2016;2016;12;02;Lauantai;0;0;0
94;17.12.2016;2016;12;03;Lauantai;0;0;0
94;17.12.2016;2016;12;04;Lauantai;0;0;0
94;17.12.2016;2016;12;05;Lauantai;1;0;1
94;17.12.2016;2016;12;06;Lauantai;0;0;0
94;17.12.2016;2016;12;07;Lauantai;0;1;1
94;17.12.2016;2016;12;08;Lauantai;0;0;0
94;17.12.2016;2016;12;09;Lauantai;0;0;0
94;17.12.2016;2016;12;10;Lauantai;2;1;3
94;17.12.2016;2016;12;11;Lauantai;3;2;5
94;17.12.2016;2016;12;12;Lauantai;1;2;3
94;17.12.2016;2016;12;13;Lauantai;1;0;1
94;17.12.2016;2016;12;14;Lauantai;1;6;7
94;17.12.2016;2016;12;15;Lauantai;0;1;1
94;17.12.2016;2016;12;16;Lauantai;1;4;5
94;17.12.2016;2016;12;17;Lauantai;0;1;1
94;17.12.2016;2016;12;18;Lauantai;0;0;0
94;17.12.2016;2016;12;19;Lauantai;0;0;0
94;17.12.2016;2016;12;20;Lauantai;0;0;0
94;17.12.2016;2016;12;21;Lauantai;0;0;0
94;17.12.2016;2016;12;22;Lauantai;0;0;0
94;17.12.2016;2016;12;23;Lauantai;1;0;1
94;18.12.2016;2016;12;00;Sunnuntai;0;0;0
94;18.12.2016;2016;12;01;Sunnuntai;0;0;0
94;18.12.2016;2016;12;02;Sunnuntai;0;0;0
94;18.12.2016;2016;12;03;Sunnuntai;0;0;0
94;18.12.2016;2016;12;04;Sunnuntai;0;0;0
94;18.12.2016;2016;12;05;Sunnuntai;0;0;0
94;18.12.2016;2016;12;06;Sunnuntai;0;0;0
94;18.12.2016;2016;12;07;Sunnuntai;0;0;0
94;18.12.2016;2016;12;08;Sunnuntai;0;0;0
94;18.12.2016;2016;12;09;Sunnuntai;1;1;2
94;18.12.2016;2016;12;10;Sunnuntai;0;0;0
94;18.12.2016;2016;12;11;Sunnuntai;2;0;2
94;18.12.2016;2016;12;12;Sunnuntai;2;0;2
94;18.12.2016;2016;12;13;Sunnuntai;0;1;1
94;18.12.2016;2016;12;14;Sunnuntai;2;1;3
94;18.12.2016;2016;12;15;Sunnuntai;1;0;1
94;18.12.2016;2016;12;16;Sunnuntai;1;0;1
94;18.12.2016;2016;12;17;Sunnuntai;0;0;0
94;18.12.2016;2016;12;18;Sunnuntai;0;1;1
94;18.12.2016;2016;12;19;Sunnuntai;0;1;1
94;18.12.2016;2016;12;20;Sunnuntai;0;0;0
94;18.12.2016;2016;12;21;Sunnuntai;0;2;2
94;18.12.2016;2016;12;22;Sunnuntai;0;0;0
94;18.12.2016;2016;12;23;Sunnuntai;0;0;0
94;19.12.2016;2016;12;00;Maanantai;0;0;0
94;19.12.2016;2016;12;01;Maanantai;0;0;0
94;19.12.2016;2016;12;02;Maanantai;0;0;0
94;19.12.2016;2016;12;03;Maanantai;0;0;0
94;19.12.2016;2016;12;04;Maanantai;0;0;0
94;19.12.2016;2016;12;05;Maanantai;4;1;5
94;19.12.2016;2016;12;06;Maanantai;3;0;3
94;19.12.2016;2016;12;07;Maanantai;8;2;10
94;19.12.2016;2016;12;08;Maanantai;9;0;9
94;19.12.2016;2016;12;09;Maanantai;0;0;0
94;19.12.2016;2016;12;10;Maanantai;3;0;3
94;19.12.2016;2016;12;11;Maanantai;0;0;0
94;19.12.2016;2016;12;12;Maanantai;0;2;2
94;19.12.2016;2016;12;13;Maanantai;3;3;6
94;19.12.2016;2016;12;14;Maanantai;1;2;3
94;19.12.2016;2016;12;15;Maanantai;2;9;11
94;19.12.2016;2016;12;16;Maanantai;2;3;5
94;19.12.2016;2016;12;17;Maanantai;2;5;7
94;19.12.2016;2016;12;18;Maanantai;0;4;4
94;19.12.2016;2016;12;19;Maanantai;0;1;1
94;19.12.2016;2016;12;20;Maanantai;0;2;2
94;19.12.2016;2016;12;21;Maanantai;1;1;2
94;19.12.2016;2016;12;22;Maanantai;0;1;1
94;19.12.2016;2016;12;23;Maanantai;0;5;5
94;20.12.2016;2016;12;00;Tiistai;0;0;0
94;20.12.2016;2016;12;01;Tiistai;0;0;0
94;20.12.2016;2016;12;02;Tiistai;0;0;0
94;20.12.2016;2016;12;03;Tiistai;0;0;0
94;20.12.2016;2016;12;04;Tiistai;0;0;0
94;20.12.2016;2016;12;05;Tiistai;2;2;4
94;20.12.2016;2016;12;06;Tiistai;5;0;5
94;20.12.2016;2016;12;07;Tiistai;3;3;6
94;20.12.2016;2016;12;08;Tiistai;7;0;7
94;20.12.2016;2016;12;09;Tiistai;2;1;3
94;20.12.2016;2016;12;10;Tiistai;2;0;2
94;20.12.2016;2016;12;11;Tiistai;0;1;1
94;20.12.2016;2016;12;12;Tiistai;0;1;1
94;20.12.2016;2016;12;13;Tiistai;1;0;1
94;20.12.2016;2016;12;14;Tiistai;0;7;7
94;20.12.2016;2016;12;15;Tiistai;1;3;4
94;20.12.2016;2016;12;16;Tiistai;1;5;6
94;20.12.2016;2016;12;17;Tiistai;1;6;7
94;20.12.2016;2016;12;18;Tiistai;1;0;1
94;20.12.2016;2016;12;19;Tiistai;0;0;0
94;20.12.2016;2016;12;20;Tiistai;1;1;2
94;20.12.2016;2016;12;21;Tiistai;0;1;1
94;20.12.2016;2016;12;22;Tiistai;0;0;0
94;20.12.2016;2016;12;23;Tiistai;0;0;0
94;21.12.2016;2016;12;00;Keskiviikko;0;0;0
94;21.12.2016;2016;12;01;Keskiviikko;0;0;0
94;21.12.2016;2016;12;02;Keskiviikko;0;0;0
94;21.12.2016;2016;12;03;Keskiviikko;0;0;0
94;21.12.2016;2016;12;04;Keskiviikko;0;0;0
94;21.12.2016;2016;12;05;Keskiviikko;2;1;3
94;21.12.2016;2016;12;06;Keskiviikko;5;0;5
94;21.12.2016;2016;12;07;Keskiviikko;4;0;4
94;21.12.2016;2016;12;08;Keskiviikko;7;1;8
94;21.12.2016;2016;12;09;Keskiviikko;0;0;0
94;21.12.2016;2016;12;10;Keskiviikko;2;0;2
94;21.12.2016;2016;12;11;Keskiviikko;1;3;4
94;21.12.2016;2016;12;12;Keskiviikko;1;0;1
94;21.12.2016;2016;12;13;Keskiviikko;0;1;1
94;21.12.2016;2016;12;14;Keskiviikko;5;2;7
94;21.12.2016;2016;12;15;Keskiviikko;1;5;6
94;21.12.2016;2016;12;16;Keskiviikko;0;4;4
94;21.12.2016;2016;12;17;Keskiviikko;0;6;6
94;21.12.2016;2016;12;18;Keskiviikko;1;1;2
94;21.12.2016;2016;12;19;Keskiviikko;1;0;1
94;21.12.2016;2016;12;20;Keskiviikko;1;1;2
94;21.12.2016;2016;12;21;Keskiviikko;0;1;1
94;21.12.2016;2016;12;22;Keskiviikko;0;1;1
94;21.12.2016;2016;12;23;Keskiviikko;0;0;0
94;22.12.2016;2016;12;00;Torstai;0;0;0
94;22.12.2016;2016;12;01;Torstai;0;0;0
94;22.12.2016;2016;12;02;Torstai;0;0;0
94;22.12.2016;2016;12;03;Torstai;0;0;0
94;22.12.2016;2016;12;04;Torstai;1;0;1
94;22.12.2016;2016;12;05;Torstai;0;2;2
94;22.12.2016;2016;12;06;Torstai;4;0;4
94;22.12.2016;2016;12;07;Torstai;4;0;4
94;22.12.2016;2016;12;08;Torstai;2;1;3
94;22.12.2016;2016;12;09;Torstai;0;2;2
94;22.12.2016;2016;12;10;Torstai;1;0;1
94;22.12.2016;2016;12;11;Torstai;1;0;1
94;22.12.2016;2016;12;12;Torstai;1;2;3
94;22.12.2016;2016;12;13;Torstai;0;0;0
94;22.12.2016;2016;12;14;Torstai;2;2;4
94;22.12.2016;2016;12;15;Torstai;0;5;5
94;22.12.2016;2016;12;16;Torstai;1;1;2
94;22.12.2016;2016;12;17;Torstai;1;3;4
94;22.12.2016;2016;12;18;Torstai;0;2;2
94;22.12.2016;2016;12;19;Torstai;0;0;0
94;22.12.2016;2016;12;20;Torstai;1;0;1
94;22.12.2016;2016;12;21;Torstai;0;0;0
94;22.12.2016;2016;12;22;Torstai;1;1;2
94;22.12.2016;2016;12;23;Torstai;0;0;0
94;23.12.2016;2016;12;00;Perjantai;0;0;0
94;23.12.2016;2016;12;01;Perjantai;0;0;0
94;23.12.2016;2016;12;02;Perjantai;0;0;0
94;23.12.2016;2016;12;03;Perjantai;0;0;0
94;23.12.2016;2016;12;04;Perjantai;0;0;0
94;23.12.2016;2016;12;05;Perjantai;1;1;2
94;23.12.2016;2016;12;06;Perjantai;2;0;2
94;23.12.2016;2016;12;07;Perjantai;2;2;4
94;23.12.2016;2016;12;08;Perjantai;4;0;4
94;23.12.2016;2016;12;09;Perjantai;0;1;1
94;23.12.2016;2016;12;10;Perjantai;0;0;0
94;23.12.2016;2016;12;11;Perjantai;1;1;2
94;23.12.2016;2016;12;12;Perjantai;1;1;2
94;23.12.2016;2016;12;13;Perjantai;1;1;2
94;23.12.2016;2016;12;14;Perjantai;3;1;4
94;23.12.2016;2016;12;15;Perjantai;1;6;7
94;23.12.2016;2016;12;16;Perjantai;1;0;1
94;23.12.2016;2016;12;17;Perjantai;1;2;3
94;23.12.2016;2016;12;18;Perjantai;0;2;2
94;23.12.2016;2016;12;19;Perjantai;0;2;2
94;23.12.2016;2016;12;20;Perjantai;0;1;1
94;23.12.2016;2016;12;21;Perjantai;1;0;1
94;23.12.2016;2016;12;22;Perjantai;0;0;0
94;23.12.2016;2016;12;23;Perjantai;0;0;0
94;24.12.2016;2016;12;00;Lauantai;0;0;0
94;24.12.2016;2016;12;01;Lauantai;0;0;0
94;24.12.2016;2016;12;02;Lauantai;0;0;0
94;24.12.2016;2016;12;03;Lauantai;0;0;0
94;24.12.2016;2016;12;04;Lauantai;1;0;1
94;24.12.2016;2016;12;05;Lauantai;0;0;0
94;24.12.2016;2016;12;06;Lauantai;0;0;0
94;24.12.2016;2016;12;07;Lauantai;0;0;0
94;24.12.2016;2016;12;08;Lauantai;0;0;0
94;24.12.2016;2016;12;09;Lauantai;0;0;0
94;24.12.2016;2016;12;10;Lauantai;0;1;1
94;24.12.2016;2016;12;11;Lauantai;1;2;3
94;24.12.2016;2016;12;12;Lauantai;2;1;3
94;24.12.2016;2016;12;13;Lauantai;0;1;1
94;24.12.2016;2016;12;14;Lauantai;0;0;0
94;24.12.2016;2016;12;15;Lauantai;0;0;0
94;24.12.2016;2016;12;16;Lauantai;1;0;1
94;24.12.2016;2016;12;17;Lauantai;1;1;2
94;24.12.2016;2016;12;18;Lauantai;0;0;0
94;24.12.2016;2016;12;19;Lauantai;0;0;0
94;24.12.2016;2016;12;20;Lauantai;0;0;0
94;24.12.2016;2016;12;21;Lauantai;1;0;1
94;24.12.2016;2016;12;22;Lauantai;0;1;1
94;24.12.2016;2016;12;23;Lauantai;0;0;0
94;25.12.2016;2016;12;00;Sunnuntai;0;0;0
94;25.12.2016;2016;12;01;Sunnuntai;0;0;0
94;25.12.2016;2016;12;02;Sunnuntai;0;0;0
94;25.12.2016;2016;12;03;Sunnuntai;0;2;2
94;25.12.2016;2016;12;04;Sunnuntai;0;0;0
94;25.12.2016;2016;12;05;Sunnuntai;0;0;0
94;25.12.2016;2016;12;06;Sunnuntai;0;0;0
94;25.12.2016;2016;12;07;Sunnuntai;0;0;0
94;25.12.2016;2016;12;08;Sunnuntai;0;0;0
94;25.12.2016;2016;12;09;Sunnuntai;0;0;0
94;25.12.2016;2016;12;10;Sunnuntai;1;1;2
94;25.12.2016;2016;12;11;Sunnuntai;1;0;1
94;25.12.2016;2016;12;12;Sunnuntai;2;1;3
94;25.12.2016;2016;12;13;Sunnuntai;2;1;3
94;25.12.2016;2016;12;14;Sunnuntai;0;1;1
94;25.12.2016;2016;12;15;Sunnuntai;0;0;0
94;25.12.2016;2016;12;16;Sunnuntai;2;2;4
94;25.12.2016;2016;12;17;Sunnuntai;0;0;0
94;25.12.2016;2016;12;18;Sunnuntai;1;2;3
94;25.12.2016;2016;12;19;Sunnuntai;0;4;4
94;25.12.2016;2016;12;20;Sunnuntai;2;0;2
94;25.12.2016;2016;12;21;Sunnuntai;0;2;2
94;25.12.2016;2016;12;22;Sunnuntai;0;0;0
94;25.12.2016;2016;12;23;Sunnuntai;0;0;0
94;26.12.2016;2016;12;00;Maanantai;0;0;0
94;26.12.2016;2016;12;01;Maanantai;0;0;0
94;26.12.2016;2016;12;02;Maanantai;0;0;0
94;26.12.2016;2016;12;03;Maanantai;0;0;0
94;26.12.2016;2016;12;04;Maanantai;0;0;0
94;26.12.2016;2016;12;05;Maanantai;0;0;0
94;26.12.2016;2016;12;06;Maanantai;1;0;1
94;26.12.2016;2016;12;07;Maanantai;0;1;1
94;26.12.2016;2016;12;08;Maanantai;0;0;0
94;26.12.2016;2016;12;09;Maanantai;1;1;2
94;26.12.2016;2016;12;10;Maanantai;2;1;3
94;26.12.2016;2016;12;11;Maanantai;0;1;1
94;26.12.2016;2016;12;12;Maanantai;3;0;3
94;26.12.2016;2016;12;13;Maanantai;0;5;5
94;26.12.2016;2016;12;14;Maanantai;1;0;1
94;26.12.2016;2016;12;15;Maanantai;1;1;2
94;26.12.2016;2016;12;16;Maanantai;0;0;0
94;26.12.2016;2016;12;17;Maanantai;0;0;0
94;26.12.2016;2016;12;18;Maanantai;1;2;3
94;26.12.2016;2016;12;19;Maanantai;1;1;2
94;26.12.2016;2016;12;20;Maanantai;1;0;1
94;26.12.2016;2016;12;21;Maanantai;0;0;0
94;26.12.2016;2016;12;22;Maanantai;0;0;0
94;26.12.2016;2016;12;23;Maanantai;0;0;0
94;27.12.2016;2016;12;00;Tiistai;0;0;0
94;27.12.2016;2016;12;01;Tiistai;0;0;0
94;27.12.2016;2016;12;02;Tiistai;0;0;0
94;27.12.2016;2016;12;03;Tiistai;0;0;0
94;27.12.2016;2016;12;04;Tiistai;0;0;0
94;27.12.2016;2016;12;05;Tiistai;1;0;1
94;27.12.2016;2016;12;06;Tiistai;9;0;9
94;27.12.2016;2016;12;07;Tiistai;3;3;6
94;27.12.2016;2016;12;08;Tiistai;3;1;4
94;27.12.2016;2016;12;09;Tiistai;2;0;2
94;27.12.2016;2016;12;10;Tiistai;0;0;0
94;27.12.2016;2016;12;11;Tiistai;1;0;1
94;27.12.2016;2016;12;12;Tiistai;0;0;0
94;27.12.2016;2016;12;13;Tiistai;0;1;1
94;27.12.2016;2016;12;14;Tiistai;4;3;7
94;27.12.2016;2016;12;15;Tiistai;0;3;3
94;27.12.2016;2016;12;16;Tiistai;0;6;6
94;27.12.2016;2016;12;17;Tiistai;1;3;4
94;27.12.2016;2016;12;18;Tiistai;0;3;3
94;27.12.2016;2016;12;19;Tiistai;0;0;0
94;27.12.2016;2016;12;20;Tiistai;1;2;3
94;27.12.2016;2016;12;21;Tiistai;0;0;0
94;27.12.2016;2016;12;22;Tiistai;2;0;2
94;27.12.2016;2016;12;23;Tiistai;0;0;0
94;28.12.2016;2016;12;00;Keskiviikko;0;0;0
94;28.12.2016;2016;12;01;Keskiviikko;0;0;0
94;28.12.2016;2016;12;02;Keskiviikko;0;0;0
94;28.12.2016;2016;12;03;Keskiviikko;0;0;0
94;28.12.2016;2016;12;04;Keskiviikko;0;0;0
94;28.12.2016;2016;12;05;Keskiviikko;2;0;2
94;28.12.2016;2016;12;06;Keskiviikko;6;0;6
94;28.12.2016;2016;12;07;Keskiviikko;4;1;5
94;28.12.2016;2016;12;08;Keskiviikko;3;0;3
94;28.12.2016;2016;12;09;Keskiviikko;1;0;1
94;28.12.2016;2016;12;10;Keskiviikko;3;0;3
94;28.12.2016;2016;12;11;Keskiviikko;2;1;3
94;28.12.2016;2016;12;12;Keskiviikko;0;0;0
94;28.12.2016;2016;12;13;Keskiviikko;2;1;3
94;28.12.2016;2016;12;14;Keskiviikko;1;3;4
94;28.12.2016;2016;12;15;Keskiviikko;2;6;8
94;28.12.2016;2016;12;16;Keskiviikko;0;5;5
94;28.12.2016;2016;12;17;Keskiviikko;0;7;7
94;28.12.2016;2016;12;18;Keskiviikko;2;4;6
94;28.12.2016;2016;12;19;Keskiviikko;0;2;2
94;28.12.2016;2016;12;20;Keskiviikko;1;3;4
94;28.12.2016;2016;12;21;Keskiviikko;1;1;2
94;28.12.2016;2016;12;22;Keskiviikko;0;0;0
94;28.12.2016;2016;12;23;Keskiviikko;0;1;1
94;29.12.2016;2016;12;00;Torstai;0;0;0
94;29.12.2016;2016;12;01;Torstai;0;0;0
94;29.12.2016;2016;12;02;Torstai;0;0;0
94;29.12.2016;2016;12;03;Torstai;0;0;0
94;29.12.2016;2016;12;04;Torstai;0;0;0
94;29.12.2016;2016;12;05;Torstai;2;1;3
94;29.12.2016;2016;12;06;Torstai;5;0;5
94;29.12.2016;2016;12;07;Torstai;2;3;5
94;29.12.2016;2016;12;08;Torstai;5;0;5
94;29.12.2016;2016;12;09;Torstai;2;1;3
94;29.12.2016;2016;12;10;Torstai;0;1;1
94;29.12.2016;2016;12;11;Torstai;3;2;5
94;29.12.2016;2016;12;12;Torstai;0;0;0
94;29.12.2016;2016;12;13;Torstai;2;1;3
94;29.12.2016;2016;12;14;Torstai;4;2;6
94;29.12.2016;2016;12;15;Torstai;2;11;13
94;29.12.2016;2016;12;16;Torstai;0;5;5
94;29.12.2016;2016;12;17;Torstai;0;7;7
94;29.12.2016;2016;12;18;Torstai;0;3;3
94;29.12.2016;2016;12;19;Torstai;0;0;0
94;29.12.2016;2016;12;20;Torstai;1;0;1
94;29.12.2016;2016;12;21;Torstai;2;2;4
94;29.12.2016;2016;12;22;Torstai;0;0;0
94;29.12.2016;2016;12;23;Torstai;0;0;0
94;30.12.2016;2016;12;00;Perjantai;0;0;0
94;30.12.2016;2016;12;01;Perjantai;0;0;0
94;30.12.2016;2016;12;02;Perjantai;0;0;0
94;30.12.2016;2016;12;03;Perjantai;0;0;0
94;30.12.2016;2016;12;04;Perjantai;0;0;0
94;30.12.2016;2016;12;05;Perjantai;0;0;0
94;30.12.2016;2016;12;06;Perjantai;0;0;0
94;30.12.2016;2016;12;07;Perjantai;2;1;3
94;30.12.2016;2016;12;08;Perjantai;1;0;1
94;30.12.2016;2016;12;09;Perjantai;1;0;1
94;30.12.2016;2016;12;10;Perjantai;0;0;0
94;30.12.2016;2016;12;11;Perjantai;0;0;0
94;30.12.2016;2016;12;12;Perjantai;0;0;0
94;30.12.2016;2016;12;13;Perjantai;0;0;0
94;30.12.2016;2016;12;14;Perjantai;0;2;2
94;30.12.2016;2016;12;15;Perjantai;1;2;3
94;30.12.2016;2016;12;16;Perjantai;0;3;3
94;30.12.2016;2016;12;17;Perjantai;0;1;1
94;30.12.2016;2016;12;18;Perjantai;0;1;1
94;30.12.2016;2016;12;19;Perjantai;1;2;3
94;30.12.2016;2016;12;20;Perjantai;1;0;1
94;30.12.2016;2016;12;21;Perjantai;5;2;7
94;30.12.2016;2016;12;22;Perjantai;0;0;0
94;30.12.2016;2016;12;23;Perjantai;0;0;0
94;31.12.2016;2016;12;00;Lauantai;0;0;0
94;31.12.2016;2016;12;01;Lauantai;0;4;4
94;31.12.2016;2016;12;02;Lauantai;0;0;0
94;31.12.2016;2016;12;03;Lauantai;0;0;0
94;31.12.2016;2016;12;04;Lauantai;0;0;0
94;31.12.2016;2016;12;05;Lauantai;0;0;0
94;31.12.2016;2016;12;06;Lauantai;0;0;0
94;31.12.2016;2016;12;07;Lauantai;0;0;0
94;31.12.2016;2016;12;08;Lauantai;0;0;0
94;31.12.2016;2016;12;09;Lauantai;0;0;0
94;31.12.2016;2016;12;10;Lauantai;0;0;0
94;31.12.2016;2016;12;11;Lauantai;2;1;3
94;31.12.2016;2016;12;12;Lauantai;0;0;0
94;31.12.2016;2016;12;13;Lauantai;0;0;0
94;31.12.2016;2016;12;14;Lauantai;1;4;5
94;31.12.2016;2016;12;15;Lauantai;2;1;3
94;31.12.2016;2016;12;16;Lauantai;0;0;0
94;31.12.2016;2016;12;17;Lauantai;0;0;0
94;31.12.2016;2016;12;18;Lauantai;0;0;0
94;31.12.2016;2016;12;19;Lauantai;4;1;5
94;31.12.2016;2016;12;20;Lauantai;0;0;0
94;31.12.2016;2016;12;21;Lauantai;0;2;2
94;31.12.2016;2016;12;22;Lauantai;0;0;0
94;31.12.2016;2016;12;23;Lauantai;0;0;0
94;01.01.2017;2017;01;00;Sunnuntai;0;0;0
94;01.01.2017;2017;01;01;Sunnuntai;0;0;0
94;01.01.2017;2017;01;02;Sunnuntai;0;0;0
94;01.01.2017;2017;01;03;Sunnuntai;0;0;0
94;01.01.2017;2017;01;04;Sunnuntai;0;0;0
94;01.01.2017;2017;01;05;Sunnuntai;0;0;0
94;01.01.2017;2017;01;06;Sunnuntai;1;0;1
94;01.01.2017;2017;01;07;Sunnuntai;0;0;0
94;01.01.2017;2017;01;08;Sunnuntai;0;0;0
94;01.01.2017;2017;01;09;Sunnuntai;0;0;0
94;01.01.2017;2017;01;10;Sunnuntai;1;0;1
94;01.01.2017;2017;01;11;Sunnuntai;0;0;0
94;01.01.2017;2017;01;12;Sunnuntai;0;1;1
94;01.01.2017;2017;01;13;Sunnuntai;0;0;0
94;01.01.2017;2017;01;14;Sunnuntai;0;1;1
94;01.01.2017;2017;01;15;Sunnuntai;2;2;4
94;01.01.2017;2017;01;16;Sunnuntai;0;1;1
94;01.01.2017;2017;01;17;Sunnuntai;1;0;1
94;01.01.2017;2017;01;18;Sunnuntai;2;1;3
94;01.01.2017;2017;01;19;Sunnuntai;0;0;0
94;01.01.2017;2017;01;20;Sunnuntai;1;0;1
94;01.01.2017;2017;01;21;Sunnuntai;0;0;0
94;01.01.2017;2017;01;22;Sunnuntai;0;0;0
94;01.01.2017;2017;01;23;Sunnuntai;0;0;0
94;02.01.2017;2017;01;00;Maanantai;0;0;0
94;02.01.2017;2017;01;01;Maanantai;0;0;0
94;02.01.2017;2017;01;02;Maanantai;0;0;0
94;02.01.2017;2017;01;03;Maanantai;0;0;0
94;02.01.2017;2017;01;04;Maanantai;0;0;0
94;02.01.2017;2017;01;05;Maanantai;3;1;4
94;02.01.2017;2017;01;06;Maanantai;3;0;3
94;02.01.2017;2017;01;07;Maanantai;8;1;9
94;02.01.2017;2017;01;08;Maanantai;2;1;3
94;02.01.2017;2017;01;09;Maanantai;3;0;3
94;02.01.2017;2017;01;10;Maanantai;0;2;2
94;02.01.2017;2017;01;11;Maanantai;3;0;3
94;02.01.2017;2017;01;12;Maanantai;2;0;2
94;02.01.2017;2017;01;13;Maanantai;0;1;1
94;02.01.2017;2017;01;14;Maanantai;1;3;4
94;02.01.2017;2017;01;15;Maanantai;1;1;2
94;02.01.2017;2017;01;16;Maanantai;1;7;8
94;02.01.2017;2017;01;17;Maanantai;0;4;4
94;02.01.2017;2017;01;18;Maanantai;2;6;8
94;02.01.2017;2017;01;19;Maanantai;0;4;4
94;02.01.2017;2017;01;20;Maanantai;0;3;3
94;02.01.2017;2017;01;21;Maanantai;1;0;1
94;02.01.2017;2017;01;22;Maanantai;0;1;1
94;02.01.2017;2017;01;23;Maanantai;0;0;0
94;03.01.2017;2017;01;00;Tiistai;0;0;0
94;03.01.2017;2017;01;01;Tiistai;0;0;0
94;03.01.2017;2017;01;02;Tiistai;0;0;0
94;03.01.2017;2017;01;03;Tiistai;0;0;0
94;03.01.2017;2017;01;04;Tiistai;1;0;1
94;03.01.2017;2017;01;05;Tiistai;2;1;3
94;03.01.2017;2017;01;06;Tiistai;4;0;4
94;03.01.2017;2017;01;07;Tiistai;5;0;5
94;03.01.2017;2017;01;08;Tiistai;4;0;4
94;03.01.2017;2017;01;09;Tiistai;1;0;1
94;03.01.2017;2017;01;10;Tiistai;1;0;1
94;03.01.2017;2017;01;11;Tiistai;0;0;0
94;03.01.2017;2017;01;12;Tiistai;1;0;1
94;03.01.2017;2017;01;13;Tiistai;1;0;1
94;03.01.2017;2017;01;14;Tiistai;1;1;2
94;03.01.2017;2017;01;15;Tiistai;1;3;4
94;03.01.2017;2017;01;16;Tiistai;0;4;4
94;03.01.2017;2017;01;17;Tiistai;1;4;5
94;03.01.2017;2017;01;18;Tiistai;0;4;4
94;03.01.2017;2017;01;19;Tiistai;0;3;3
94;03.01.2017;2017;01;20;Tiistai;0;0;0
94;03.01.2017;2017;01;21;Tiistai;1;3;4
94;03.01.2017;2017;01;22;Tiistai;0;0;0
94;03.01.2017;2017;01;23;Tiistai;0;0;0
94;04.01.2017;2017;01;00;Keskiviikko;0;0;0
94;04.01.2017;2017;01;01;Keskiviikko;0;0;0
94;04.01.2017;2017;01;02;Keskiviikko;0;0;0
94;04.01.2017;2017;01;03;Keskiviikko;0;1;1
94;04.01.2017;2017;01;04;Keskiviikko;0;0;0
94;04.01.2017;2017;01;05;Keskiviikko;0;1;1
94;04.01.2017;2017;01;06;Keskiviikko;3;0;3
94;04.01.2017;2017;01;07;Keskiviikko;0;0;0
94;04.01.2017;2017;01;08;Keskiviikko;2;0;2
94;04.01.2017;2017;01;09;Keskiviikko;0;0;0
94;04.01.2017;2017;01;10;Keskiviikko;0;1;1
94;04.01.2017;2017;01;11;Keskiviikko;1;0;1
94;04.01.2017;2017;01;12;Keskiviikko;1;0;1
94;04.01.2017;2017;01;13;Keskiviikko;1;1;2
94;04.01.2017;2017;01;14;Keskiviikko;1;0;1
94;04.01.2017;2017;01;15;Keskiviikko;0;2;2
94;04.01.2017;2017;01;16;Keskiviikko;1;0;1
94;04.01.2017;2017;01;17;Keskiviikko;0;2;2
94;04.01.2017;2017;01;18;Keskiviikko;1;1;2
94;04.01.2017;2017;01;19;Keskiviikko;0;1;1
94;04.01.2017;2017;01;20;Keskiviikko;0;1;1
94;04.01.2017;2017;01;21;Keskiviikko;0;1;1
94;04.01.2017;2017;01;22;Keskiviikko;0;1;1
94;04.01.2017;2017;01;23;Keskiviikko;0;0;0
94;05.01.2017;2017;01;00;Torstai;0;0;0
94;05.01.2017;2017;01;01;Torstai;0;0;0
94;05.01.2017;2017;01;02;Torstai;0;0;0
94;05.01.2017;2017;01;03;Torstai;0;0;0
94;05.01.2017;2017;01;04;Torstai;0;0;0
94;05.01.2017;2017;01;05;Torstai;2;1;3
94;05.01.2017;2017;01;06;Torstai;3;0;3
94;05.01.2017;2017;01;07;Torstai;1;1;2
94;05.01.2017;2017;01;08;Torstai;1;0;1
94;05.01.2017;2017;01;09;Torstai;1;0;1
94;05.01.2017;2017;01;10;Torstai;0;0;0
94;05.01.2017;2017;01;11;Torstai;0;0;0
94;05.01.2017;2017;01;12;Torstai;0;0;0
94;05.01.2017;2017;01;13;Torstai;0;0;0
94;05.01.2017;2017;01;14;Torstai;1;2;3
94;05.01.2017;2017;01;15;Torstai;0;3;3
94;05.01.2017;2017;01;16;Torstai;0;2;2
94;05.01.2017;2017;01;17;Torstai;0;0;0
94;05.01.2017;2017;01;18;Torstai;0;1;1
94;05.01.2017;2017;01;19;Torstai;0;0;0
94;05.01.2017;2017;01;20;Torstai;0;0;0
94;05.01.2017;2017;01;21;Torstai;0;1;1
94;05.01.2017;2017;01;22;Torstai;0;0;0
94;05.01.2017;2017;01;23;Torstai;0;0;0
94;06.01.2017;2017;01;00;Perjantai;0;0;0
94;06.01.2017;2017;01;01;Perjantai;0;0;0
94;06.01.2017;2017;01;02;Perjantai;0;0;0
94;06.01.2017;2017;01;03;Perjantai;0;0;0
94;06.01.2017;2017;01;04;Perjantai;0;0;0
94;06.01.2017;2017;01;05;Perjantai;1;0;1
94;06.01.2017;2017;01;06;Perjantai;0;0;0
94;06.01.2017;2017;01;07;Perjantai;0;0;0
94;06.01.2017;2017;01;08;Perjantai;0;0;0
94;06.01.2017;2017;01;09;Perjantai;1;1;2
94;06.01.2017;2017;01;10;Perjantai;0;1;1
94;06.01.2017;2017;01;11;Perjantai;0;0;0
94;06.01.2017;2017;01;12;Perjantai;1;0;1
94;06.01.2017;2017;01;13;Perjantai;0;0;0
94;06.01.2017;2017;01;14;Perjantai;2;2;4
94;06.01.2017;2017;01;15;Perjantai;0;1;1
94;06.01.2017;2017;01;16;Perjantai;0;2;2
94;06.01.2017;2017;01;17;Perjantai;1;1;2
94;06.01.2017;2017;01;18;Perjantai;0;1;1
94;06.01.2017;2017;01;19;Perjantai;1;0;1
94;06.01.2017;2017;01;20;Perjantai;2;0;2
94;06.01.2017;2017;01;21;Perjantai;0;0;0
94;06.01.2017;2017;01;22;Perjantai;0;1;1
94;06.01.2017;2017;01;23;Perjantai;0;0;0
94;07.01.2017;2017;01;00;Lauantai;0;0;0
94;07.01.2017;2017;01;01;Lauantai;0;1;1
94;07.01.2017;2017;01;02;Lauantai;0;0;0
94;07.01.2017;2017;01;03;Lauantai;0;0;0
94;07.01.2017;2017;01;04;Lauantai;0;0;0
94;07.01.2017;2017;01;05;Lauantai;0;0;0
94;07.01.2017;2017;01;06;Lauantai;0;0;0
94;07.01.2017;2017;01;07;Lauantai;0;0;0
94;07.01.2017;2017;01;08;Lauantai;0;0;0
94;07.01.2017;2017;01;09;Lauantai;0;2;2
94;07.01.2017;2017;01;10;Lauantai;1;0;1
94;07.01.2017;2017;01;11;Lauantai;4;0;4
94;07.01.2017;2017;01;12;Lauantai;0;1;1
94;07.01.2017;2017;01;13;Lauantai;1;1;2
94;07.01.2017;2017;01;14;Lauantai;0;0;0
94;07.01.2017;2017;01;15;Lauantai;1;0;1
94;07.01.2017;2017;01;16;Lauantai;0;2;2
94;07.01.2017;2017;01;17;Lauantai;0;0;0
94;07.01.2017;2017;01;18;Lauantai;4;1;5
94;07.01.2017;2017;01;19;Lauantai;0;1;1
94;07.01.2017;2017;01;20;Lauantai;1;1;2
94;07.01.2017;2017;01;21;Lauantai;0;0;0
94;07.01.2017;2017;01;22;Lauantai;0;2;2
94;07.01.2017;2017;01;23;Lauantai;0;0;0
94;08.01.2017;2017;01;00;Sunnuntai;0;0;0
94;08.01.2017;2017;01;01;Sunnuntai;0;0;0
94;08.01.2017;2017;01;02;Sunnuntai;0;0;0
94;08.01.2017;2017;01;03;Sunnuntai;0;0;0
94;08.01.2017;2017;01;04;Sunnuntai;1;0;1
94;08.01.2017;2017;01;05;Sunnuntai;0;0;0
94;08.01.2017;2017;01;06;Sunnuntai;1;1;2
94;08.01.2017;2017;01;07;Sunnuntai;0;1;1
94;08.01.2017;2017;01;08;Sunnuntai;1;0;1
94;08.01.2017;2017;01;09;Sunnuntai;1;0;1
94;08.01.2017;2017;01;10;Sunnuntai;0;1;1
94;08.01.2017;2017;01;11;Sunnuntai;0;1;1
94;08.01.2017;2017;01;12;Sunnuntai;4;1;5
94;08.01.2017;2017;01;13;Sunnuntai;1;1;2
94;08.01.2017;2017;01;14;Sunnuntai;1;3;4
94;08.01.2017;2017;01;15;Sunnuntai;1;2;3
94;08.01.2017;2017;01;16;Sunnuntai;0;1;1
94;08.01.2017;2017;01;17;Sunnuntai;0;1;1
94;08.01.2017;2017;01;18;Sunnuntai;2;0;2
94;08.01.2017;2017;01;19;Sunnuntai;0;0;0
94;08.01.2017;2017;01;20;Sunnuntai;0;0;0
94;08.01.2017;2017;01;21;Sunnuntai;0;2;2
94;08.01.2017;2017;01;22;Sunnuntai;0;1;1
94;08.01.2017;2017;01;23;Sunnuntai;0;0;0
94;09.01.2017;2017;01;00;Maanantai;0;0;0
94;09.01.2017;2017;01;01;Maanantai;0;0;0
94;09.01.2017;2017;01;02;Maanantai;0;0;0
94;09.01.2017;2017;01;03;Maanantai;0;0;0
94;09.01.2017;2017;01;04;Maanantai;0;0;0
94;09.01.2017;2017;01;05;Maanantai;5;2;7
94;09.01.2017;2017;01;06;Maanantai;6;1;7
94;09.01.2017;2017;01;07;Maanantai;12;2;14
94;09.01.2017;2017;01;08;Maanantai;5;1;6
94;09.01.2017;2017;01;09;Maanantai;1;1;2
94;09.01.2017;2017;01;10;Maanantai;1;1;2
94;09.01.2017;2017;01;11;Maanantai;1;0;1
94;09.01.2017;2017;01;12;Maanantai;2;1;3
94;09.01.2017;2017;01;13;Maanantai;1;2;3
94;09.01.2017;2017;01;14;Maanantai;3;5;8
94;09.01.2017;2017;01;15;Maanantai;1;6;7
94;09.01.2017;2017;01;16;Maanantai;2;7;9
94;09.01.2017;2017;01;17;Maanantai;1;11;12
94;09.01.2017;2017;01;18;Maanantai;2;2;4
94;09.01.2017;2017;01;19;Maanantai;0;3;3
94;09.01.2017;2017;01;20;Maanantai;1;2;3
94;09.01.2017;2017;01;21;Maanantai;0;1;1
94;09.01.2017;2017;01;22;Maanantai;0;3;3
94;09.01.2017;2017;01;23;Maanantai;0;0;0
94;10.01.2017;2017;01;00;Tiistai;0;1;1
94;10.01.2017;2017;01;01;Tiistai;0;0;0
94;10.01.2017;2017;01;02;Tiistai;0;0;0
94;10.01.2017;2017;01;03;Tiistai;0;0;0
94;10.01.2017;2017;01;04;Tiistai;0;0;0
94;10.01.2017;2017;01;05;Tiistai;5;1;6
94;10.01.2017;2017;01;06;Tiistai;2;0;2
94;10.01.2017;2017;01;07;Tiistai;9;5;14
94;10.01.2017;2017;01;08;Tiistai;5;0;5
94;10.01.2017;2017;01;09;Tiistai;2;0;2
94;10.01.2017;2017;01;10;Tiistai;2;1;3
94;10.01.2017;2017;01;11;Tiistai;1;0;1
94;10.01.2017;2017;01;12;Tiistai;1;1;2
94;10.01.2017;2017;01;13;Tiistai;0;1;1
94;10.01.2017;2017;01;14;Tiistai;1;2;3
94;10.01.2017;2017;01;15;Tiistai;1;5;6
94;10.01.2017;2017;01;16;Tiistai;2;4;6
94;10.01.2017;2017;01;17;Tiistai;0;7;7
94;10.01.2017;2017;01;18;Tiistai;1;7;8
94;10.01.2017;2017;01;19;Tiistai;1;3;4
94;10.01.2017;2017;01;20;Tiistai;0;0;0
94;10.01.2017;2017;01;21;Tiistai;0;1;1
94;10.01.2017;2017;01;22;Tiistai;0;3;3
94;10.01.2017;2017;01;23;Tiistai;0;0;0
94;11.01.2017;2017;01;00;Keskiviikko;0;0;0
94;11.01.2017;2017;01;01;Keskiviikko;0;0;0
94;11.01.2017;2017;01;02;Keskiviikko;0;0;0
94;11.01.2017;2017;01;03;Keskiviikko;0;0;0
94;11.01.2017;2017;01;04;Keskiviikko;0;0;0
94;11.01.2017;2017;01;05;Keskiviikko;2;3;5
94;11.01.2017;2017;01;06;Keskiviikko;2;0;2
94;11.01.2017;2017;01;07;Keskiviikko;8;2;10
94;11.01.2017;2017;01;08;Keskiviikko;5;0;5
94;11.01.2017;2017;01;09;Keskiviikko;2;3;5
94;11.01.2017;2017;01;10;Keskiviikko;1;0;1
94;11.01.2017;2017;01;11;Keskiviikko;1;0;1
94;11.01.2017;2017;01;12;Keskiviikko;1;0;1
94;11.01.2017;2017;01;13;Keskiviikko;1;1;2
94;11.01.2017;2017;01;14;Keskiviikko;2;2;4
94;11.01.2017;2017;01;15;Keskiviikko;3;3;6
94;11.01.2017;2017;01;16;Keskiviikko;0;7;7
94;11.01.2017;2017;01;17;Keskiviikko;1;4;5
94;11.01.2017;2017;01;18;Keskiviikko;1;5;6
94;11.01.2017;2017;01;19;Keskiviikko;1;0;1
94;11.01.2017;2017;01;20;Keskiviikko;0;3;3
94;11.01.2017;2017;01;21;Keskiviikko;0;3;3
94;11.01.2017;2017;01;22;Keskiviikko;0;0;0
94;11.01.2017;2017;01;23;Keskiviikko;0;0;0
94;12.01.2017;2017;01;00;Torstai;0;0;0
94;12.01.2017;2017;01;01;Torstai;0;0;0
94;12.01.2017;2017;01;02;Torstai;0;0;0
94;12.01.2017;2017;01;03;Torstai;0;0;0
94;12.01.2017;2017;01;04;Torstai;0;0;0
94;12.01.2017;2017;01;05;Torstai;5;1;6
94;12.01.2017;2017;01;06;Torstai;3;1;4
94;12.01.2017;2017;01;07;Torstai;7;2;9
94;12.01.2017;2017;01;08;Torstai;3;1;4
94;12.01.2017;2017;01;09;Torstai;4;1;5
94;12.01.2017;2017;01;10;Torstai;1;1;2
94;12.01.2017;2017;01;11;Torstai;3;0;3
94;12.01.2017;2017;01;12;Torstai;0;0;0
94;12.01.2017;2017;01;13;Torstai;0;0;0
94;12.01.2017;2017;01;14;Torstai;1;1;2
94;12.01.2017;2017;01;15;Torstai;2;5;7
94;12.01.2017;2017;01;16;Torstai;0;8;8
94;12.01.2017;2017;01;17;Torstai;3;9;12
94;12.01.2017;2017;01;18;Torstai;0;4;4
94;12.01.2017;2017;01;19;Torstai;1;2;3
94;12.01.2017;2017;01;20;Torstai;2;1;3
94;12.01.2017;2017;01;21;Torstai;0;1;1
94;12.01.2017;2017;01;22;Torstai;0;0;0
94;12.01.2017;2017;01;23;Torstai;0;0;0
94;13.01.2017;2017;01;00;Perjantai;0;0;0
94;13.01.2017;2017;01;01;Perjantai;0;0;0
94;13.01.2017;2017;01;02;Perjantai;0;0;0
94;13.01.2017;2017;01;03;Perjantai;0;0;0
94;13.01.2017;2017;01;04;Perjantai;0;0;0
94;13.01.2017;2017;01;05;Perjantai;2;1;3
94;13.01.2017;2017;01;06;Perjantai;6;0;6
94;13.01.2017;2017;01;07;Perjantai;11;5;16
94;13.01.2017;2017;01;08;Perjantai;3;0;3
94;13.01.2017;2017;01;09;Perjantai;2;0;2
94;13.01.2017;2017;01;10;Perjantai;2;2;4
94;13.01.2017;2017;01;11;Perjantai;2;0;2
94;13.01.2017;2017;01;12;Perjantai;0;2;2
94;13.01.2017;2017;01;13;Perjantai;1;5;6
94;13.01.2017;2017;01;14;Perjantai;3;4;7
94;13.01.2017;2017;01;15;Perjantai;0;6;6
94;13.01.2017;2017;01;16;Perjantai;4;6;10
94;13.01.2017;2017;01;17;Perjantai;0;5;5
94;13.01.2017;2017;01;18;Perjantai;2;4;6
94;13.01.2017;2017;01;19;Perjantai;1;3;4
94;13.01.2017;2017;01;20;Perjantai;0;2;2
94;13.01.2017;2017;01;21;Perjantai;1;1;2
94;13.01.2017;2017;01;22;Perjantai;2;0;2
94;13.01.2017;2017;01;23;Perjantai;0;0;0
94;14.01.2017;2017;01;00;Lauantai;0;1;1
94;14.01.2017;2017;01;01;Lauantai;0;0;0
94;14.01.2017;2017;01;02;Lauantai;1;0;1
94;14.01.2017;2017;01;03;Lauantai;0;0;0
94;14.01.2017;2017;01;04;Lauantai;0;0;0
94;14.01.2017;2017;01;05;Lauantai;0;2;2
94;14.01.2017;2017;01;06;Lauantai;0;1;1
94;14.01.2017;2017;01;07;Lauantai;0;0;0
94;14.01.2017;2017;01;08;Lauantai;0;0;0
94;14.01.2017;2017;01;09;Lauantai;1;1;2
94;14.01.2017;2017;01;10;Lauantai;1;1;2
94;14.01.2017;2017;01;11;Lauantai;1;0;1
94;14.01.2017;2017;01;12;Lauantai;0;0;0
94;14.01.2017;2017;01;13;Lauantai;1;0;1
94;14.01.2017;2017;01;14;Lauantai;1;0;1
94;14.01.2017;2017;01;15;Lauantai;2;0;2
94;14.01.2017;2017;01;16;Lauantai;0;4;4
94;14.01.2017;2017;01;17;Lauantai;1;2;3
94;14.01.2017;2017;01;18;Lauantai;2;1;3
94;14.01.2017;2017;01;19;Lauantai;0;0;0
94;14.01.2017;2017;01;20;Lauantai;0;3;3
94;14.01.2017;2017;01;21;Lauantai;1;1;2
94;14.01.2017;2017;01;22;Lauantai;0;0;0
94;14.01.2017;2017;01;23;Lauantai;1;0;1
94;15.01.2017;2017;01;00;Sunnuntai;0;0;0
94;15.01.2017;2017;01;01;Sunnuntai;0;0;0
94;15.01.2017;2017;01;02;Sunnuntai;0;0;0
94;15.01.2017;2017;01;03;Sunnuntai;0;0;0
94;15.01.2017;2017;01;04;Sunnuntai;0;0;0
94;15.01.2017;2017;01;05;Sunnuntai;1;0;1
94;15.01.2017;2017;01;06;Sunnuntai;0;0;0
94;15.01.2017;2017;01;07;Sunnuntai;0;1;1
94;15.01.2017;2017;01;08;Sunnuntai;0;0;0
94;15.01.2017;2017;01;09;Sunnuntai;2;1;3
94;15.01.2017;2017;01;10;Sunnuntai;1;1;2
94;15.01.2017;2017;01;11;Sunnuntai;2;0;2
94;15.01.2017;2017;01;12;Sunnuntai;1;1;2
94;15.01.2017;2017;01;13;Sunnuntai;0;0;0
94;15.01.2017;2017;01;14;Sunnuntai;0;1;1
94;15.01.2017;2017;01;15;Sunnuntai;0;1;1
94;15.01.2017;2017;01;16;Sunnuntai;1;1;2
94;15.01.2017;2017;01;17;Sunnuntai;1;0;1
94;15.01.2017;2017;01;18;Sunnuntai;0;1;1
94;15.01.2017;2017;01;19;Sunnuntai;0;0;0
94;15.01.2017;2017;01;20;Sunnuntai;0;1;1
94;15.01.2017;2017;01;21;Sunnuntai;0;0;0
94;15.01.2017;2017;01;22;Sunnuntai;0;1;1
94;15.01.2017;2017;01;23;Sunnuntai;0;0;0
94;16.01.2017;2017;01;00;Maanantai;0;0;0
94;16.01.2017;2017;01;01;Maanantai;0;0;0
94;16.01.2017;2017;01;02;Maanantai;0;0;0
94;16.01.2017;2017;01;03;Maanantai;0;0;0
94;16.01.2017;2017;01;04;Maanantai;0;0;0
94;16.01.2017;2017;01;05;Maanantai;4;2;6
94;16.01.2017;2017;01;06;Maanantai;6;0;6
94;16.01.2017;2017;01;07;Maanantai;16;5;21
94;16.01.2017;2017;01;08;Maanantai;6;0;6
94;16.01.2017;2017;01;09;Maanantai;2;0;2
94;16.01.2017;2017;01;10;Maanantai;3;0;3
94;16.01.2017;2017;01;11;Maanantai;0;3;3
94;16.01.2017;2017;01;12;Maanantai;3;1;4
94;16.01.2017;2017;01;13;Maanantai;1;0;1
94;16.01.2017;2017;01;14;Maanantai;2;5;7
94;16.01.2017;2017;01;15;Maanantai;1;6;7
94;16.01.2017;2017;01;16;Maanantai;2;16;18
94;16.01.2017;2017;01;17;Maanantai;2;4;6
94;16.01.2017;2017;01;18;Maanantai;1;6;7
94;16.01.2017;2017;01;19;Maanantai;1;2;3
94;16.01.2017;2017;01;20;Maanantai;0;2;2
94;16.01.2017;2017;01;21;Maanantai;0;1;1
94;16.01.2017;2017;01;22;Maanantai;0;1;1
94;16.01.2017;2017;01;23;Maanantai;0;0;0
94;17.01.2017;2017;01;00;Tiistai;0;0;0
94;17.01.2017;2017;01;01;Tiistai;0;0;0
94;17.01.2017;2017;01;02;Tiistai;0;0;0
94;17.01.2017;2017;01;03;Tiistai;0;0;0
94;17.01.2017;2017;01;04;Tiistai;0;0;0
94;17.01.2017;2017;01;05;Tiistai;4;1;5
94;17.01.2017;2017;01;06;Tiistai;5;2;7
94;17.01.2017;2017;01;07;Tiistai;9;1;10
94;17.01.2017;2017;01;08;Tiistai;5;0;5
94;17.01.2017;2017;01;09;Tiistai;1;1;2
94;17.01.2017;2017;01;10;Tiistai;1;0;1
94;17.01.2017;2017;01;11;Tiistai;3;1;4
94;17.01.2017;2017;01;12;Tiistai;1;0;1
94;17.01.2017;2017;01;13;Tiistai;0;1;1
94;17.01.2017;2017;01;14;Tiistai;1;3;4
94;17.01.2017;2017;01;15;Tiistai;3;5;8
94;17.01.2017;2017;01;16;Tiistai;2;6;8
94;17.01.2017;2017;01;17;Tiistai;4;7;11
94;17.01.2017;2017;01;18;Tiistai;1;2;3
94;17.01.2017;2017;01;19;Tiistai;0;2;2
94;17.01.2017;2017;01;20;Tiistai;1;3;4
94;17.01.2017;2017;01;21;Tiistai;0;0;0
94;17.01.2017;2017;01;22;Tiistai;0;2;2
94;17.01.2017;2017;01;23;Tiistai;0;0;0
94;18.01.2017;2017;01;00;Keskiviikko;0;0;0
94;18.01.2017;2017;01;01;Keskiviikko;0;0;0
94;18.01.2017;2017;01;02;Keskiviikko;0;0;0
94;18.01.2017;2017;01;03;Keskiviikko;1;0;1
94;18.01.2017;2017;01;04;Keskiviikko;1;0;1
94;18.01.2017;2017;01;05;Keskiviikko;5;2;7
94;18.01.2017;2017;01;06;Keskiviikko;5;1;6
94;18.01.2017;2017;01;07;Keskiviikko;10;2;12
94;18.01.2017;2017;01;08;Keskiviikko;8;1;9
94;18.01.2017;2017;01;09;Keskiviikko;2;1;3
94;18.01.2017;2017;01;10;Keskiviikko;2;0;2
94;18.01.2017;2017;01;11;Keskiviikko;0;1;1
94;18.01.2017;2017;01;12;Keskiviikko;2;1;3
94;18.01.2017;2017;01;13;Keskiviikko;3;0;3
94;18.01.2017;2017;01;14;Keskiviikko;2;3;5
94;18.01.2017;2017;01;15;Keskiviikko;2;11;13
94;18.01.2017;2017;01;16;Keskiviikko;0;12;12
94;18.01.2017;2017;01;17;Keskiviikko;1;12;13
94;18.01.2017;2017;01;18;Keskiviikko;0;6;6
94;18.01.2017;2017;01;19;Keskiviikko;1;4;5
94;18.01.2017;2017;01;20;Keskiviikko;2;1;3
94;18.01.2017;2017;01;21;Keskiviikko;0;2;2
94;18.01.2017;2017;01;22;Keskiviikko;0;2;2
94;18.01.2017;2017;01;23;Keskiviikko;0;0;0
94;19.01.2017;2017;01;00;Torstai;0;0;0
94;19.01.2017;2017;01;01;Torstai;0;0;0
94;19.01.2017;2017;01;02;Torstai;0;0;0
94;19.01.2017;2017;01;03;Torstai;0;0;0
94;19.01.2017;2017;01;04;Torstai;0;0;0
94;19.01.2017;2017;01;05;Torstai;2;1;3
94;19.01.2017;2017;01;06;Torstai;5;0;5
94;19.01.2017;2017;01;07;Torstai;7;1;8
94;19.01.2017;2017;01;08;Torstai;6;1;7
94;19.01.2017;2017;01;09;Torstai;0;1;1
94;19.01.2017;2017;01;10;Torstai;2;1;3
94;19.01.2017;2017;01;11;Torstai;3;1;4
94;19.01.2017;2017;01;12;Torstai;1;3;4
94;19.01.2017;2017;01;13;Torstai;0;0;0
94;19.01.2017;2017;01;14;Torstai;1;8;9
94;19.01.2017;2017;01;15;Torstai;1;5;6
94;19.01.2017;2017;01;16;Torstai;0;4;4
94;19.01.2017;2017;01;17;Torstai;0;1;1
94;19.01.2017;2017;01;18;Torstai;0;7;7
94;19.01.2017;2017;01;19;Torstai;1;1;2
94;19.01.2017;2017;01;20;Torstai;2;1;3
94;19.01.2017;2017;01;21;Torstai;0;1;1
94;19.01.2017;2017;01;22;Torstai;0;0;0
94;19.01.2017;2017;01;23;Torstai;0;0;0
94;20.01.2017;2017;01;00;Perjantai;0;0;0
94;20.01.2017;2017;01;01;Perjantai;3;1;4
94;20.01.2017;2017;01;02;Perjantai;0;0;0
94;20.01.2017;2017;01;03;Perjantai;0;0;0
94;20.01.2017;2017;01;04;Perjantai;0;0;0
94;20.01.2017;2017;01;05;Perjantai;4;1;5
94;20.01.2017;2017;01;06;Perjantai;2;0;2
94;20.01.2017;2017;01;07;Perjantai;14;1;15
94;20.01.2017;2017;01;08;Perjantai;1;0;1
94;20.01.2017;2017;01;09;Perjantai;1;2;3
94;20.01.2017;2017;01;10;Perjantai;1;0;1
94;20.01.2017;2017;01;11;Perjantai;1;3;4
94;20.01.2017;2017;01;12;Perjantai;1;1;2
94;20.01.2017;2017;01;13;Perjantai;0;1;1
94;20.01.2017;2017;01;14;Perjantai;2;4;6
94;20.01.2017;2017;01;15;Perjantai;0;8;8
94;20.01.2017;2017;01;16;Perjantai;0;9;9
94;20.01.2017;2017;01;17;Perjantai;1;4;5
94;20.01.2017;2017;01;18;Perjantai;1;0;1
94;20.01.2017;2017;01;19;Perjantai;0;3;3
94;20.01.2017;2017;01;20;Perjantai;2;0;2
94;20.01.2017;2017;01;21;Perjantai;1;2;3
94;20.01.2017;2017;01;22;Perjantai;0;0;0
94;20.01.2017;2017;01;23;Perjantai;0;0;0
94;21.01.2017;2017;01;00;Lauantai;0;0;0
94;21.01.2017;2017;01;01;Lauantai;0;0;0
94;21.01.2017;2017;01;02;Lauantai;0;0;0
94;21.01.2017;2017;01;03;Lauantai;0;0;0
94;21.01.2017;2017;01;04;Lauantai;0;0;0
94;21.01.2017;2017;01;05;Lauantai;1;0;1
94;21.01.2017;2017;01;06;Lauantai;0;0;0
94;21.01.2017;2017;01;07;Lauantai;1;0;1
94;21.01.2017;2017;01;08;Lauantai;0;0;0
94;21.01.2017;2017;01;09;Lauantai;0;0;0
94;21.01.2017;2017;01;10;Lauantai;1;1;2
94;21.01.2017;2017;01;11;Lauantai;0;0;0
94;21.01.2017;2017;01;12;Lauantai;2;2;4
94;21.01.2017;2017;01;13;Lauantai;2;1;3
94;21.01.2017;2017;01;14;Lauantai;2;2;4
94;21.01.2017;2017;01;15;Lauantai;3;1;4
94;21.01.2017;2017;01;16;Lauantai;0;1;1
94;21.01.2017;2017;01;17;Lauantai;1;2;3
94;21.01.2017;2017;01;18;Lauantai;0;1;1
94;21.01.2017;2017;01;19;Lauantai;1;1;2
94;21.01.2017;2017;01;20;Lauantai;0;0;0
94;21.01.2017;2017;01;21;Lauantai;1;0;1
94;21.01.2017;2017;01;22;Lauantai;0;0;0
94;21.01.2017;2017;01;23;Lauantai;0;0;0
94;22.01.2017;2017;01;00;Sunnuntai;0;0;0
94;22.01.2017;2017;01;01;Sunnuntai;0;0;0
94;22.01.2017;2017;01;02;Sunnuntai;0;0;0
94;22.01.2017;2017;01;03;Sunnuntai;0;0;0
94;22.01.2017;2017;01;04;Sunnuntai;0;0;0
94;22.01.2017;2017;01;05;Sunnuntai;1;0;1
94;22.01.2017;2017;01;06;Sunnuntai;2;0;2
94;22.01.2017;2017;01;07;Sunnuntai;1;1;2
94;22.01.2017;2017;01;08;Sunnuntai;0;2;2
94;22.01.2017;2017;01;09;Sunnuntai;0;1;1
94;22.01.2017;2017;01;10;Sunnuntai;0;0;0
94;22.01.2017;2017;01;11;Sunnuntai;0;2;2
94;22.01.2017;2017;01;12;Sunnuntai;4;1;5
94;22.01.2017;2017;01;13;Sunnuntai;0;0;0
94;22.01.2017;2017;01;14;Sunnuntai;2;1;3
94;22.01.2017;2017;01;15;Sunnuntai;3;1;4
94;22.01.2017;2017;01;16;Sunnuntai;2;3;5
94;22.01.2017;2017;01;17;Sunnuntai;0;1;1
94;22.01.2017;2017;01;18;Sunnuntai;0;0;0
94;22.01.2017;2017;01;19;Sunnuntai;0;2;2
94;22.01.2017;2017;01;20;Sunnuntai;0;1;1
94;22.01.2017;2017;01;21;Sunnuntai;1;0;1
94;22.01.2017;2017;01;22;Sunnuntai;0;1;1
94;22.01.2017;2017;01;23;Sunnuntai;0;0;0
94;23.01.2017;2017;01;00;Maanantai;0;0;0
94;23.01.2017;2017;01;01;Maanantai;0;0;0
94;23.01.2017;2017;01;02;Maanantai;0;0;0
94;23.01.2017;2017;01;03;Maanantai;0;0;0
94;23.01.2017;2017;01;04;Maanantai;0;0;0
94;23.01.2017;2017;01;05;Maanantai;2;1;3
94;23.01.2017;2017;01;06;Maanantai;5;0;5
94;23.01.2017;2017;01;07;Maanantai;5;1;6
94;23.01.2017;2017;01;08;Maanantai;6;0;6
94;23.01.2017;2017;01;09;Maanantai;0;0;0
94;23.01.2017;2017;01;10;Maanantai;1;0;1
94;23.01.2017;2017;01;11;Maanantai;1;0;1
94;23.01.2017;2017;01;12;Maanantai;1;0;1
94;23.01.2017;2017;01;13;Maanantai;0;3;3
94;23.01.2017;2017;01;14;Maanantai;1;4;5
94;23.01.2017;2017;01;15;Maanantai;1;5;6
94;23.01.2017;2017;01;16;Maanantai;1;6;7
94;23.01.2017;2017;01;17;Maanantai;0;10;10
94;23.01.2017;2017;01;18;Maanantai;1;3;4
94;23.01.2017;2017;01;19;Maanantai;0;5;5
94;23.01.2017;2017;01;20;Maanantai;1;0;1
94;23.01.2017;2017;01;21;Maanantai;0;3;3
94;23.01.2017;2017;01;22;Maanantai;0;1;1
94;23.01.2017;2017;01;23;Maanantai;0;0;0
94;24.01.2017;2017;01;00;Tiistai;0;0;0
94;24.01.2017;2017;01;01;Tiistai;0;0;0
94;24.01.2017;2017;01;02;Tiistai;0;0;0
94;24.01.2017;2017;01;03;Tiistai;0;0;0
94;24.01.2017;2017;01;04;Tiistai;0;0;0
94;24.01.2017;2017;01;05;Tiistai;2;2;4
94;24.01.2017;2017;01;06;Tiistai;5;0;5
94;24.01.2017;2017;01;07;Tiistai;5;2;7
94;24.01.2017;2017;01;08;Tiistai;4;0;4
94;24.01.2017;2017;01;09;Tiistai;1;0;1
94;24.01.2017;2017;01;10;Tiistai;0;2;2
94;24.01.2017;2017;01;11;Tiistai;2;0;2
94;24.01.2017;2017;01;12;Tiistai;3;0;3
94;24.01.2017;2017;01;13;Tiistai;1;2;3
94;24.01.2017;2017;01;14;Tiistai;1;3;4
94;24.01.2017;2017;01;15;Tiistai;1;3;4
94;24.01.2017;2017;01;16;Tiistai;0;12;12
94;24.01.2017;2017;01;17;Tiistai;1;5;6
94;24.01.2017;2017;01;18;Tiistai;2;5;7
94;24.01.2017;2017;01;19;Tiistai;1;2;3
94;24.01.2017;2017;01;20;Tiistai;0;4;4
94;24.01.2017;2017;01;21;Tiistai;0;3;3
94;24.01.2017;2017;01;22;Tiistai;0;1;1
94;24.01.2017;2017;01;23;Tiistai;0;0;0
94;25.01.2017;2017;01;00;Keskiviikko;0;0;0
94;25.01.2017;2017;01;01;Keskiviikko;0;0;0
94;25.01.2017;2017;01;02;Keskiviikko;0;0;0
94;25.01.2017;2017;01;03;Keskiviikko;0;0;0
94;25.01.2017;2017;01;04;Keskiviikko;0;0;0
94;25.01.2017;2017;01;05;Keskiviikko;2;1;3
94;25.01.2017;2017;01;06;Keskiviikko;3;0;3
94;25.01.2017;2017;01;07;Keskiviikko;8;2;10
94;25.01.2017;2017;01;08;Keskiviikko;5;0;5
94;25.01.2017;2017;01;09;Keskiviikko;2;0;2
94;25.01.2017;2017;01;10;Keskiviikko;1;0;1
94;25.01.2017;2017;01;11;Keskiviikko;1;0;1
94;25.01.2017;2017;01;12;Keskiviikko;0;1;1
94;25.01.2017;2017;01;13;Keskiviikko;1;0;1
94;25.01.2017;2017;01;14;Keskiviikko;1;4;5
94;25.01.2017;2017;01;15;Keskiviikko;2;6;8
94;25.01.2017;2017;01;16;Keskiviikko;0;8;8
94;25.01.2017;2017;01;17;Keskiviikko;0;2;2
94;25.01.2017;2017;01;18;Keskiviikko;0;3;3
94;25.01.2017;2017;01;19;Keskiviikko;1;1;2
94;25.01.2017;2017;01;20;Keskiviikko;0;2;2
94;25.01.2017;2017;01;21;Keskiviikko;0;3;3
94;25.01.2017;2017;01;22;Keskiviikko;0;0;0
94;25.01.2017;2017;01;23;Keskiviikko;0;0;0
94;26.01.2017;2017;01;00;Torstai;0;0;0
94;26.01.2017;2017;01;01;Torstai;0;1;1
94;26.01.2017;2017;01;02;Torstai;0;0;0
94;26.01.2017;2017;01;03;Torstai;0;0;0
94;26.01.2017;2017;01;04;Torstai;0;0;0
94;26.01.2017;2017;01;05;Torstai;2;1;3
94;26.01.2017;2017;01;06;Torstai;5;0;5
94;26.01.2017;2017;01;07;Torstai;8;1;9
94;26.01.2017;2017;01;08;Torstai;3;1;4
94;26.01.2017;2017;01;09;Torstai;2;1;3
94;26.01.2017;2017;01;10;Torstai;2;1;3
94;26.01.2017;2017;01;11;Torstai;2;1;3
94;26.01.2017;2017;01;12;Torstai;1;1;2
94;26.01.2017;2017;01;13;Torstai;0;0;0
94;26.01.2017;2017;01;14;Torstai;6;6;12
94;26.01.2017;2017;01;15;Torstai;3;6;9
94;26.01.2017;2017;01;16;Torstai;1;8;9
94;26.01.2017;2017;01;17;Torstai;2;4;6
94;26.01.2017;2017;01;18;Torstai;0;4;4
94;26.01.2017;2017;01;19;Torstai;0;4;4
94;26.01.2017;2017;01;20;Torstai;0;1;1
94;26.01.2017;2017;01;21;Torstai;0;2;2
94;26.01.2017;2017;01;22;Torstai;0;1;1
94;26.01.2017;2017;01;23;Torstai;0;0;0
94;27.01.2017;2017;01;00;Perjantai;0;0;0
94;27.01.2017;2017;01;01;Perjantai;0;0;0
94;27.01.2017;2017;01;02;Perjantai;0;0;0
94;27.01.2017;2017;01;03;Perjantai;0;0;0
94;27.01.2017;2017;01;04;Perjantai;1;0;1
94;27.01.2017;2017;01;05;Perjantai;2;1;3
94;27.01.2017;2017;01;06;Perjantai;7;0;7
94;27.01.2017;2017;01;07;Perjantai;7;2;9
94;27.01.2017;2017;01;08;Perjantai;3;0;3
94;27.01.2017;2017;01;09;Perjantai;3;0;3
94;27.01.2017;2017;01;10;Perjantai;1;1;2
94;27.01.2017;2017;01;11;Perjantai;1;1;2
94;27.01.2017;2017;01;12;Perjantai;0;0;0
94;27.01.2017;2017;01;13;Perjantai;0;1;1
94;27.01.2017;2017;01;14;Perjantai;3;3;6
94;27.01.2017;2017;01;15;Perjantai;1;10;11
94;27.01.2017;2017;01;16;Perjantai;1;12;13
94;27.01.2017;2017;01;17;Perjantai;1;4;5
94;27.01.2017;2017;01;18;Perjantai;0;3;3
94;27.01.2017;2017;01;19;Perjantai;1;0;1
94;27.01.2017;2017;01;20;Perjantai;0;3;3
94;27.01.2017;2017;01;21;Perjantai;1;3;4
94;27.01.2017;2017;01;22;Perjantai;0;0;0
94;27.01.2017;2017;01;23;Perjantai;0;0;0
94;28.01.2017;2017;01;00;Lauantai;0;0;0
94;28.01.2017;2017;01;01;Lauantai;0;0;0
94;28.01.2017;2017;01;02;Lauantai;0;0;0
94;28.01.2017;2017;01;03;Lauantai;0;0;0
94;28.01.2017;2017;01;04;Lauantai;0;0;0
94;28.01.2017;2017;01;05;Lauantai;2;0;2
94;28.01.2017;2017;01;06;Lauantai;1;0;1
94;28.01.2017;2017;01;07;Lauantai;0;0;0
94;28.01.2017;2017;01;08;Lauantai;0;0;0
94;28.01.2017;2017;01;09;Lauantai;0;0;0
94;28.01.2017;2017;01;10;Lauantai;1;2;3
94;28.01.2017;2017;01;11;Lauantai;0;0;0
94;28.01.2017;2017;01;12;Lauantai;0;3;3
94;28.01.2017;2017;01;13;Lauantai;4;3;7
94;28.01.2017;2017;01;14;Lauantai;1;1;2
94;28.01.2017;2017;01;15;Lauantai;0;2;2
94;28.01.2017;2017;01;16;Lauantai;0;0;0
94;28.01.2017;2017;01;17;Lauantai;0;1;1
94;28.01.2017;2017;01;18;Lauantai;0;1;1
94;28.01.2017;2017;01;19;Lauantai;0;0;0
94;28.01.2017;2017;01;20;Lauantai;0;3;3
94;28.01.2017;2017;01;21;Lauantai;1;0;1
94;28.01.2017;2017;01;22;Lauantai;0;0;0
94;28.01.2017;2017;01;23;Lauantai;0;0;0
94;29.01.2017;2017;01;00;Sunnuntai;0;0;0
94;29.01.2017;2017;01;01;Sunnuntai;0;0;0
94;29.01.2017;2017;01;02;Sunnuntai;0;0;0
94;29.01.2017;2017;01;03;Sunnuntai;0;0;0
94;29.01.2017;2017;01;04;Sunnuntai;0;0;0
94;29.01.2017;2017;01;05;Sunnuntai;0;0;0
94;29.01.2017;2017;01;06;Sunnuntai;0;0;0
94;29.01.2017;2017;01;07;Sunnuntai;1;1;2
94;29.01.2017;2017;01;08;Sunnuntai;0;0;0
94;29.01.2017;2017;01;09;Sunnuntai;1;1;2
94;29.01.2017;2017;01;10;Sunnuntai;4;2;6
94;29.01.2017;2017;01;11;Sunnuntai;3;2;5
94;29.01.2017;2017;01;12;Sunnuntai;2;2;4
94;29.01.2017;2017;01;13;Sunnuntai;1;4;5
94;29.01.2017;2017;01;14;Sunnuntai;3;1;4
94;29.01.2017;2017;01;15;Sunnuntai;0;5;5
94;29.01.2017;2017;01;16;Sunnuntai;1;3;4
94;29.01.2017;2017;01;17;Sunnuntai;2;0;2
94;29.01.2017;2017;01;18;Sunnuntai;0;4;4
94;29.01.2017;2017;01;19;Sunnuntai;0;0;0
94;29.01.2017;2017;01;20;Sunnuntai;1;1;2
94;29.01.2017;2017;01;21;Sunnuntai;0;1;1
94;29.01.2017;2017;01;22;Sunnuntai;0;1;1
94;29.01.2017;2017;01;23;Sunnuntai;0;0;0
94;30.01.2017;2017;01;00;Maanantai;0;0;0
94;30.01.2017;2017;01;01;Maanantai;0;0;0
94;30.01.2017;2017;01;02;Maanantai;0;0;0
94;30.01.2017;2017;01;03;Maanantai;0;0;0
94;30.01.2017;2017;01;04;Maanantai;0;0;0
94;30.01.2017;2017;01;05;Maanantai;2;2;4
94;30.01.2017;2017;01;06;Maanantai;7;0;7
94;30.01.2017;2017;01;07;Maanantai;11;1;12
94;30.01.2017;2017;01;08;Maanantai;2;1;3
94;30.01.2017;2017;01;09;Maanantai;1;0;1
94;30.01.2017;2017;01;10;Maanantai;1;1;2
94;30.01.2017;2017;01;11;Maanantai;1;1;2
94;30.01.2017;2017;01;12;Maanantai;0;0;0
94;30.01.2017;2017;01;13;Maanantai;0;2;2
94;30.01.2017;2017;01;14;Maanantai;2;3;5
94;30.01.2017;2017;01;15;Maanantai;1;5;6
94;30.01.2017;2017;01;16;Maanantai;0;6;6
94;30.01.2017;2017;01;17;Maanantai;0;7;7
94;30.01.2017;2017;01;18;Maanantai;1;2;3
94;30.01.2017;2017;01;19;Maanantai;0;2;2
94;30.01.2017;2017;01;20;Maanantai;0;0;0
94;30.01.2017;2017;01;21;Maanantai;0;1;1
94;30.01.2017;2017;01;22;Maanantai;0;1;1
94;30.01.2017;2017;01;23;Maanantai;0;0;0
94;31.01.2017;2017;01;00;Tiistai;0;0;0
94;31.01.2017;2017;01;01;Tiistai;0;0;0
94;31.01.2017;2017;01;02;Tiistai;0;0;0
94;31.01.2017;2017;01;03;Tiistai;0;0;0
94;31.01.2017;2017;01;04;Tiistai;0;0;0
94;31.01.2017;2017;01;05;Tiistai;2;1;3
94;31.01.2017;2017;01;06;Tiistai;9;0;9
94;31.01.2017;2017;01;07;Tiistai;8;3;11
94;31.01.2017;2017;01;08;Tiistai;4;0;4
94;31.01.2017;2017;01;09;Tiistai;1;1;2
94;31.01.2017;2017;01;10;Tiistai;2;0;2
94;31.01.2017;2017;01;11;Tiistai;0;0;0
94;31.01.2017;2017;01;12;Tiistai;2;1;3
94;31.01.2017;2017;01;13;Tiistai;0;0;0
94;31.01.2017;2017;01;14;Tiistai;2;2;4
94;31.01.2017;2017;01;15;Tiistai;0;5;5
94;31.01.2017;2017;01;16;Tiistai;2;9;11
94;31.01.2017;2017;01;17;Tiistai;1;5;6
94;31.01.2017;2017;01;18;Tiistai;2;4;6
94;31.01.2017;2017;01;19;Tiistai;0;5;5
94;31.01.2017;2017;01;20;Tiistai;0;3;3
94;31.01.2017;2017;01;21;Tiistai;0;2;2
94;31.01.2017;2017;01;22;Tiistai;0;0;0
94;31.01.2017;2017;01;23;Tiistai;0;0;0
94;01.02.2017;2017;02;00;Keskiviikko;1;0;1
94;01.02.2017;2017;02;01;Keskiviikko;0;0;0
94;01.02.2017;2017;02;02;Keskiviikko;0;0;0
94;01.02.2017;2017;02;03;Keskiviikko;0;0;0
94;01.02.2017;2017;02;04;Keskiviikko;1;0;1
94;01.02.2017;2017;02;05;Keskiviikko;2;1;3
94;01.02.2017;2017;02;06;Keskiviikko;9;0;9
94;01.02.2017;2017;02;07;Keskiviikko;9;2;11
94;01.02.2017;2017;02;08;Keskiviikko;4;0;4
94;01.02.2017;2017;02;09;Keskiviikko;7;0;7
94;01.02.2017;2017;02;10;Keskiviikko;0;2;2
94;01.02.2017;2017;02;11;Keskiviikko;1;1;2
94;01.02.2017;2017;02;12;Keskiviikko;2;1;3
94;01.02.2017;2017;02;13;Keskiviikko;1;0;1
94;01.02.2017;2017;02;14;Keskiviikko;1;2;3
94;01.02.2017;2017;02;15;Keskiviikko;2;5;7
94;01.02.2017;2017;02;16;Keskiviikko;0;8;8
94;01.02.2017;2017;02;17;Keskiviikko;0;7;7
94;01.02.2017;2017;02;18;Keskiviikko;0;5;5
94;01.02.2017;2017;02;19;Keskiviikko;0;4;4
94;01.02.2017;2017;02;20;Keskiviikko;1;0;1
94;01.02.2017;2017;02;21;Keskiviikko;0;2;2
94;01.02.2017;2017;02;22;Keskiviikko;0;2;2
94;01.02.2017;2017;02;23;Keskiviikko;0;0;0
94;02.02.2017;2017;02;00;Torstai;0;0;0
94;02.02.2017;2017;02;01;Torstai;0;0;0
94;02.02.2017;2017;02;02;Torstai;0;0;0
94;02.02.2017;2017;02;03;Torstai;0;0;0
94;02.02.2017;2017;02;04;Torstai;0;0;0
94;02.02.2017;2017;02;05;Torstai;0;2;2
94;02.02.2017;2017;02;06;Torstai;8;0;8
94;02.02.2017;2017;02;07;Torstai;9;1;10
94;02.02.2017;2017;02;08;Torstai;5;0;5
94;02.02.2017;2017;02;09;Torstai;1;0;1
94;02.02.2017;2017;02;10;Torstai;1;0;1
94;02.02.2017;2017;02;11;Torstai;1;1;2
94;02.02.2017;2017;02;12;Torstai;1;1;2
94;02.02.2017;2017;02;13;Torstai;0;2;2
94;02.02.2017;2017;02;14;Torstai;1;1;2
94;02.02.2017;2017;02;15;Torstai;1;7;8
94;02.02.2017;2017;02;16;Torstai;1;6;7
94;02.02.2017;2017;02;17;Torstai;0;6;6
94;02.02.2017;2017;02;18;Torstai;0;2;2
94;02.02.2017;2017;02;19;Torstai;1;1;2
94;02.02.2017;2017;02;20;Torstai;1;0;1
94;02.02.2017;2017;02;21;Torstai;0;2;2
94;02.02.2017;2017;02;22;Torstai;0;0;0
94;02.02.2017;2017;02;23;Torstai;0;0;0
94;03.02.2017;2017;02;00;Perjantai;0;0;0
94;03.02.2017;2017;02;01;Perjantai;0;0;0
94;03.02.2017;2017;02;02;Perjantai;0;0;0
94;03.02.2017;2017;02;03;Perjantai;0;0;0
94;03.02.2017;2017;02;04;Perjantai;0;0;0
94;03.02.2017;2017;02;05;Perjantai;0;1;1
94;03.02.2017;2017;02;06;Perjantai;2;0;2
94;03.02.2017;2017;02;07;Perjantai;14;1;15
94;03.02.2017;2017;02;08;Perjantai;5;0;5
94;03.02.2017;2017;02;09;Perjantai;1;0;1
94;03.02.2017;2017;02;10;Perjantai;1;0;1
94;03.02.2017;2017;02;11;Perjantai;0;1;1
94;03.02.2017;2017;02;12;Perjantai;1;0;1
94;03.02.2017;2017;02;13;Perjantai;1;2;3
94;03.02.2017;2017;02;14;Perjantai;1;2;3
94;03.02.2017;2017;02;15;Perjantai;0;4;4
94;03.02.2017;2017;02;16;Perjantai;1;9;10
94;03.02.2017;2017;02;17;Perjantai;0;6;6
94;03.02.2017;2017;02;18;Perjantai;1;0;1
94;03.02.2017;2017;02;19;Perjantai;0;2;2
94;03.02.2017;2017;02;20;Perjantai;0;1;1
94;03.02.2017;2017;02;21;Perjantai;1;0;1
94;03.02.2017;2017;02;22;Perjantai;0;1;1
94;03.02.2017;2017;02;23;Perjantai;0;0;0
94;04.02.2017;2017;02;00;Lauantai;0;0;0
94;04.02.2017;2017;02;01;Lauantai;0;0;0
94;04.02.2017;2017;02;02;Lauantai;0;0;0
94;04.02.2017;2017;02;03;Lauantai;0;0;0
94;04.02.2017;2017;02;04;Lauantai;0;0;0
94;04.02.2017;2017;02;05;Lauantai;1;0;1
94;04.02.2017;2017;02;06;Lauantai;0;0;0
94;04.02.2017;2017;02;07;Lauantai;1;0;1
94;04.02.2017;2017;02;08;Lauantai;1;1;2
94;04.02.2017;2017;02;09;Lauantai;0;0;0
94;04.02.2017;2017;02;10;Lauantai;1;1;2
94;04.02.2017;2017;02;11;Lauantai;4;0;4
94;04.02.2017;2017;02;12;Lauantai;1;0;1
94;04.02.2017;2017;02;13;Lauantai;1;0;1
94;04.02.2017;2017;02;14;Lauantai;0;1;1
94;04.02.2017;2017;02;15;Lauantai;1;4;5
94;04.02.2017;2017;02;16;Lauantai;3;2;5
94;04.02.2017;2017;02;17;Lauantai;1;2;3
94;04.02.2017;2017;02;18;Lauantai;1;3;4
94;04.02.2017;2017;02;19;Lauantai;0;1;1
94;04.02.2017;2017;02;20;Lauantai;0;1;1
94;04.02.2017;2017;02;21;Lauantai;1;1;2
94;04.02.2017;2017;02;22;Lauantai;0;0;0
94;04.02.2017;2017;02;23;Lauantai;0;0;0
94;05.02.2017;2017;02;00;Sunnuntai;0;0;0
94;05.02.2017;2017;02;01;Sunnuntai;0;0;0
94;05.02.2017;2017;02;02;Sunnuntai;0;0;0
94;05.02.2017;2017;02;03;Sunnuntai;0;0;0
94;05.02.2017;2017;02;04;Sunnuntai;0;0;0
94;05.02.2017;2017;02;05;Sunnuntai;0;0;0
94;05.02.2017;2017;02;06;Sunnuntai;0;0;0
94;05.02.2017;2017;02;07;Sunnuntai;1;1;2
94;05.02.2017;2017;02;08;Sunnuntai;1;2;3
94;05.02.2017;2017;02;09;Sunnuntai;1;0;1
94;05.02.2017;2017;02;10;Sunnuntai;2;1;3
94;05.02.2017;2017;02;11;Sunnuntai;2;0;2
94;05.02.2017;2017;02;12;Sunnuntai;1;0;1
94;05.02.2017;2017;02;13;Sunnuntai;4;1;5
94;05.02.2017;2017;02;14;Sunnuntai;1;1;2
94;05.02.2017;2017;02;15;Sunnuntai;1;0;1
94;05.02.2017;2017;02;16;Sunnuntai;0;2;2
94;05.02.2017;2017;02;17;Sunnuntai;3;1;4
94;05.02.2017;2017;02;18;Sunnuntai;0;0;0
94;05.02.2017;2017;02;19;Sunnuntai;0;1;1
94;05.02.2017;2017;02;20;Sunnuntai;1;1;2
94;05.02.2017;2017;02;21;Sunnuntai;0;0;0
94;05.02.2017;2017;02;22;Sunnuntai;0;1;1
94;05.02.2017;2017;02;23;Sunnuntai;0;0;0
94;06.02.2017;2017;02;00;Maanantai;0;0;0
94;06.02.2017;2017;02;01;Maanantai;0;0;0
94;06.02.2017;2017;02;02;Maanantai;0;0;0
94;06.02.2017;2017;02;03;Maanantai;0;0;0
94;06.02.2017;2017;02;04;Maanantai;2;0;2
94;06.02.2017;2017;02;05;Maanantai;3;2;5
94;06.02.2017;2017;02;06;Maanantai;5;0;5
94;06.02.2017;2017;02;07;Maanantai;12;1;13
94;06.02.2017;2017;02;08;Maanantai;4;0;4
94;06.02.2017;2017;02;09;Maanantai;0;0;0
94;06.02.2017;2017;02;10;Maanantai;1;0;1
94;06.02.2017;2017;02;11;Maanantai;1;0;1
94;06.02.2017;2017;02;12;Maanantai;1;1;2
94;06.02.2017;2017;02;13;Maanantai;1;1;2
94;06.02.2017;2017;02;14;Maanantai;3;3;6
94;06.02.2017;2017;02;15;Maanantai;1;6;7
94;06.02.2017;2017;02;16;Maanantai;0;12;12
94;06.02.2017;2017;02;17;Maanantai;2;4;6
94;06.02.2017;2017;02;18;Maanantai;1;2;3
94;06.02.2017;2017;02;19;Maanantai;1;3;4
94;06.02.2017;2017;02;20;Maanantai;1;0;1
94;06.02.2017;2017;02;21;Maanantai;0;2;2
94;06.02.2017;2017;02;22;Maanantai;0;2;2
94;06.02.2017;2017;02;23;Maanantai;0;0;0
94;07.02.2017;2017;02;00;Tiistai;0;0;0
94;07.02.2017;2017;02;01;Tiistai;0;0;0
94;07.02.2017;2017;02;02;Tiistai;0;0;0
94;07.02.2017;2017;02;03;Tiistai;0;0;0
94;07.02.2017;2017;02;04;Tiistai;1;0;1
94;07.02.2017;2017;02;05;Tiistai;3;1;4
94;07.02.2017;2017;02;06;Tiistai;4;0;4
94;07.02.2017;2017;02;07;Tiistai;14;1;15
94;07.02.2017;2017;02;08;Tiistai;3;4;7
94;07.02.2017;2017;02;09;Tiistai;0;1;1
94;07.02.2017;2017;02;10;Tiistai;2;0;2
94;07.02.2017;2017;02;11;Tiistai;0;0;0
94;07.02.2017;2017;02;12;Tiistai;1;1;2
94;07.02.2017;2017;02;13;Tiistai;1;0;1
94;07.02.2017;2017;02;14;Tiistai;1;2;3
94;07.02.2017;2017;02;15;Tiistai;1;8;9
94;07.02.2017;2017;02;16;Tiistai;1;8;9
94;07.02.2017;2017;02;17;Tiistai;3;3;6
94;07.02.2017;2017;02;18;Tiistai;1;6;7
94;07.02.2017;2017;02;19;Tiistai;1;1;2
94;07.02.2017;2017;02;20;Tiistai;0;1;1
94;07.02.2017;2017;02;21;Tiistai;0;2;2
94;07.02.2017;2017;02;22;Tiistai;0;0;0
94;07.02.2017;2017;02;23;Tiistai;0;0;0
94;08.02.2017;2017;02;00;Keskiviikko;0;1;1
94;08.02.2017;2017;02;01;Keskiviikko;0;1;1
94;08.02.2017;2017;02;02;Keskiviikko;0;0;0
94;08.02.2017;2017;02;03;Keskiviikko;0;0;0
94;08.02.2017;2017;02;04;Keskiviikko;1;0;1
94;08.02.2017;2017;02;05;Keskiviikko;1;1;2
94;08.02.2017;2017;02;06;Keskiviikko;5;0;5
94;08.02.2017;2017;02;07;Keskiviikko;9;1;10
94;08.02.2017;2017;02;08;Keskiviikko;2;1;3
94;08.02.2017;2017;02;09;Keskiviikko;1;0;1
94;08.02.2017;2017;02;10;Keskiviikko;0;0;0
94;08.02.2017;2017;02;11;Keskiviikko;1;0;1
94;08.02.2017;2017;02;12;Keskiviikko;0;0;0
94;08.02.2017;2017;02;13;Keskiviikko;1;0;1
94;08.02.2017;2017;02;14;Keskiviikko;1;3;4
94;08.02.2017;2017;02;15;Keskiviikko;1;4;5
94;08.02.2017;2017;02;16;Keskiviikko;0;5;5
94;08.02.2017;2017;02;17;Keskiviikko;0;3;3
94;08.02.2017;2017;02;18;Keskiviikko;1;3;4
94;08.02.2017;2017;02;19;Keskiviikko;0;1;1
94;08.02.2017;2017;02;20;Keskiviikko;0;1;1
94;08.02.2017;2017;02;21;Keskiviikko;0;1;1
94;08.02.2017;2017;02;22;Keskiviikko;0;1;1
94;08.02.2017;2017;02;23;Keskiviikko;0;0;0
94;09.02.2017;2017;02;00;Torstai;0;0;0
94;09.02.2017;2017;02;01;Torstai;0;0;0
94;09.02.2017;2017;02;02;Torstai;0;0;0
94;09.02.2017;2017;02;03;Torstai;0;0;0
94;09.02.2017;2017;02;04;Torstai;0;0;0
94;09.02.2017;2017;02;05;Torstai;1;1;2
94;09.02.2017;2017;02;06;Torstai;3;0;3
94;09.02.2017;2017;02;07;Torstai;6;0;6
94;09.02.2017;2017;02;08;Torstai;3;3;6
94;09.02.2017;2017;02;09;Torstai;0;0;0
94;09.02.2017;2017;02;10;Torstai;0;0;0
94;09.02.2017;2017;02;11;Torstai;2;0;2
94;09.02.2017;2017;02;12;Torstai;0;1;1
94;09.02.2017;2017;02;13;Torstai;1;0;1
94;09.02.2017;2017;02;14;Torstai;1;3;4
94;09.02.2017;2017;02;15;Torstai;1;3;4
94;09.02.2017;2017;02;16;Torstai;0;8;8
94;09.02.2017;2017;02;17;Torstai;1;1;2
94;09.02.2017;2017;02;18;Torstai;0;3;3
94;09.02.2017;2017;02;19;Torstai;0;1;1
94;09.02.2017;2017;02;20;Torstai;1;1;2
94;09.02.2017;2017;02;21;Torstai;0;1;1
94;09.02.2017;2017;02;22;Torstai;0;1;1
94;09.02.2017;2017;02;23;Torstai;0;0;0
94;10.02.2017;2017;02;00;Perjantai;0;0;0
94;10.02.2017;2017;02;01;Perjantai;0;0;0
94;10.02.2017;2017;02;02;Perjantai;0;0;0
94;10.02.2017;2017;02;03;Perjantai;0;0;0
94;10.02.2017;2017;02;04;Perjantai;0;0;0
94;10.02.2017;2017;02;05;Perjantai;4;2;6
94;10.02.2017;2017;02;06;Perjantai;2;0;2
94;10.02.2017;2017;02;07;Perjantai;9;1;10
94;10.02.2017;2017;02;08;Perjantai;3;0;3
94;10.02.2017;2017;02;09;Perjantai;3;0;3
94;10.02.2017;2017;02;10;Perjantai;0;0;0
94;10.02.2017;2017;02;11;Perjantai;1;1;2
94;10.02.2017;2017;02;12;Perjantai;0;2;2
94;10.02.2017;2017;02;13;Perjantai;0;0;0
94;10.02.2017;2017;02;14;Perjantai;3;4;7
94;10.02.2017;2017;02;15;Perjantai;0;4;4
94;10.02.2017;2017;02;16;Perjantai;1;7;8
94;10.02.2017;2017;02;17;Perjantai;2;7;9
94;10.02.2017;2017;02;18;Perjantai;0;1;1
94;10.02.2017;2017;02;19;Perjantai;0;2;2
94;10.02.2017;2017;02;20;Perjantai;0;1;1
94;10.02.2017;2017;02;21;Perjantai;1;1;2
94;10.02.2017;2017;02;22;Perjantai;1;0;1
94;10.02.2017;2017;02;23;Perjantai;0;0;0
94;11.02.2017;2017;02;00;Lauantai;1;0;1
94;11.02.2017;2017;02;01;Lauantai;0;0;0
94;11.02.2017;2017;02;02;Lauantai;0;0;0
94;11.02.2017;2017;02;03;Lauantai;0;0;0
94;11.02.2017;2017;02;04;Lauantai;1;0;1
94;11.02.2017;2017;02;05;Lauantai;0;0;0
94;11.02.2017;2017;02;06;Lauantai;0;0;0
94;11.02.2017;2017;02;07;Lauantai;1;0;1
94;11.02.2017;2017;02;08;Lauantai;0;0;0
94;11.02.2017;2017;02;09;Lauantai;1;2;3
94;11.02.2017;2017;02;10;Lauantai;0;2;2
94;11.02.2017;2017;02;11;Lauantai;3;0;3
94;11.02.2017;2017;02;12;Lauantai;0;0;0
94;11.02.2017;2017;02;13;Lauantai;3;1;4
94;11.02.2017;2017;02;14;Lauantai;0;0;0
94;11.02.2017;2017;02;15;Lauantai;0;5;5
94;11.02.2017;2017;02;16;Lauantai;0;3;3
94;11.02.2017;2017;02;17;Lauantai;1;1;2
94;11.02.2017;2017;02;18;Lauantai;0;0;0
94;11.02.2017;2017;02;19;Lauantai;0;2;2
94;11.02.2017;2017;02;20;Lauantai;0;1;1
94;11.02.2017;2017;02;21;Lauantai;0;1;1
94;11.02.2017;2017;02;22;Lauantai;1;0;1
94;11.02.2017;2017;02;23;Lauantai;0;0;0
94;12.02.2017;2017;02;00;Sunnuntai;0;0;0
94;12.02.2017;2017;02;01;Sunnuntai;0;0;0
94;12.02.2017;2017;02;02;Sunnuntai;0;0;0
94;12.02.2017;2017;02;03;Sunnuntai;0;0;0
94;12.02.2017;2017;02;04;Sunnuntai;0;0;0
94;12.02.2017;2017;02;05;Sunnuntai;0;0;0
94;12.02.2017;2017;02;06;Sunnuntai;0;0;0
94;12.02.2017;2017;02;07;Sunnuntai;0;0;0
94;12.02.2017;2017;02;08;Sunnuntai;0;0;0
94;12.02.2017;2017;02;09;Sunnuntai;1;0;1
94;12.02.2017;2017;02;10;Sunnuntai;2;1;3
94;12.02.2017;2017;02;11;Sunnuntai;4;0;4
94;12.02.2017;2017;02;12;Sunnuntai;0;0;0
94;12.02.2017;2017;02;13;Sunnuntai;1;1;2
94;12.02.2017;2017;02;14;Sunnuntai;3;2;5
94;12.02.2017;2017;02;15;Sunnuntai;0;2;2
94;12.02.2017;2017;02;16;Sunnuntai;2;0;2
94;12.02.2017;2017;02;17;Sunnuntai;0;0;0
94;12.02.2017;2017;02;18;Sunnuntai;1;0;1
94;12.02.2017;2017;02;19;Sunnuntai;0;2;2
94;12.02.2017;2017;02;20;Sunnuntai;1;0;1
94;12.02.2017;2017;02;21;Sunnuntai;0;1;1
94;12.02.2017;2017;02;22;Sunnuntai;0;0;0
94;12.02.2017;2017;02;23;Sunnuntai;0;0;0
94;13.02.2017;2017;02;00;Maanantai;0;0;0
94;13.02.2017;2017;02;01;Maanantai;0;0;0
94;13.02.2017;2017;02;02;Maanantai;0;0;0
94;13.02.2017;2017;02;03;Maanantai;0;0;0
94;13.02.2017;2017;02;04;Maanantai;1;0;1
94;13.02.2017;2017;02;05;Maanantai;3;1;4
94;13.02.2017;2017;02;06;Maanantai;6;0;6
94;13.02.2017;2017;02;07;Maanantai;10;2;12
94;13.02.2017;2017;02;08;Maanantai;10;1;11
94;13.02.2017;2017;02;09;Maanantai;0;3;3
94;13.02.2017;2017;02;10;Maanantai;1;0;1
94;13.02.2017;2017;02;11;Maanantai;2;0;2
94;13.02.2017;2017;02;12;Maanantai;5;0;5
94;13.02.2017;2017;02;13;Maanantai;1;3;4
94;13.02.2017;2017;02;14;Maanantai;2;5;7
94;13.02.2017;2017;02;15;Maanantai;0;8;8
94;13.02.2017;2017;02;16;Maanantai;1;12;13
94;13.02.2017;2017;02;17;Maanantai;1;4;5
94;13.02.2017;2017;02;18;Maanantai;2;0;2
94;13.02.2017;2017;02;19;Maanantai;0;3;3
94;13.02.2017;2017;02;20;Maanantai;0;1;1
94;13.02.2017;2017;02;21;Maanantai;0;2;2
94;13.02.2017;2017;02;22;Maanantai;0;0;0
94;13.02.2017;2017;02;23;Maanantai;0;0;0
94;14.02.2017;2017;02;00;Tiistai;0;0;0
94;14.02.2017;2017;02;01;Tiistai;0;0;0
94;14.02.2017;2017;02;02;Tiistai;0;0;0
94;14.02.2017;2017;02;03;Tiistai;0;0;0
94;14.02.2017;2017;02;04;Tiistai;0;0;0
94;14.02.2017;2017;02;05;Tiistai;3;1;4
94;14.02.2017;2017;02;06;Tiistai;5;0;5
94;14.02.2017;2017;02;07;Tiistai;11;1;12
94;14.02.2017;2017;02;08;Tiistai;8;2;10
94;14.02.2017;2017;02;09;Tiistai;4;1;5
94;14.02.2017;2017;02;10;Tiistai;0;0;0
94;14.02.2017;2017;02;11;Tiistai;0;2;2
94;14.02.2017;2017;02;12;Tiistai;1;1;2
94;14.02.2017;2017;02;13;Tiistai;0;1;1
94;14.02.2017;2017;02;14;Tiistai;6;0;6
94;14.02.2017;2017;02;15;Tiistai;0;9;9
94;14.02.2017;2017;02;16;Tiistai;0;9;9
94;14.02.2017;2017;02;17;Tiistai;1;9;10
94;14.02.2017;2017;02;18;Tiistai;2;3;5
94;14.02.2017;2017;02;19;Tiistai;1;5;6
94;14.02.2017;2017;02;20;Tiistai;1;0;1
94;14.02.2017;2017;02;21;Tiistai;0;0;0
94;14.02.2017;2017;02;22;Tiistai;1;1;2
94;14.02.2017;2017;02;23;Tiistai;0;0;0
94;15.02.2017;2017;02;00;Keskiviikko;0;0;0
94;15.02.2017;2017;02;01;Keskiviikko;0;0;0
94;15.02.2017;2017;02;02;Keskiviikko;0;0;0
94;15.02.2017;2017;02;03;Keskiviikko;0;1;1
94;15.02.2017;2017;02;04;Keskiviikko;0;0;0
94;15.02.2017;2017;02;05;Keskiviikko;3;1;4
94;15.02.2017;2017;02;06;Keskiviikko;6;0;6
94;15.02.2017;2017;02;07;Keskiviikko;10;3;13
94;15.02.2017;2017;02;08;Keskiviikko;2;1;3
94;15.02.2017;2017;02;09;Keskiviikko;1;1;2
94;15.02.2017;2017;02;10;Keskiviikko;1;0;1
94;15.02.2017;2017;02;11;Keskiviikko;2;1;3
94;15.02.2017;2017;02;12;Keskiviikko;1;3;4
94;15.02.2017;2017;02;13;Keskiviikko;1;0;1
94;15.02.2017;2017;02;14;Keskiviikko;2;4;6
94;15.02.2017;2017;02;15;Keskiviikko;2;7;9
94;15.02.2017;2017;02;16;Keskiviikko;2;6;8
94;15.02.2017;2017;02;17;Keskiviikko;1;4;5
94;15.02.2017;2017;02;18;Keskiviikko;1;2;3
94;15.02.2017;2017;02;19;Keskiviikko;1;3;4
94;15.02.2017;2017;02;20;Keskiviikko;0;0;0
94;15.02.2017;2017;02;21;Keskiviikko;0;1;1
94;15.02.2017;2017;02;22;Keskiviikko;1;2;3
94;15.02.2017;2017;02;23;Keskiviikko;0;0;0
94;16.02.2017;2017;02;00;Torstai;0;1;1
94;16.02.2017;2017;02;01;Torstai;0;0;0
94;16.02.2017;2017;02;02;Torstai;0;0;0
94;16.02.2017;2017;02;03;Torstai;0;0;0
94;16.02.2017;2017;02;04;Torstai;1;0;1
94;16.02.2017;2017;02;05;Torstai;1;1;2
94;16.02.2017;2017;02;06;Torstai;4;0;4
94;16.02.2017;2017;02;07;Torstai;8;3;11
94;16.02.2017;2017;02;08;Torstai;7;0;7
94;16.02.2017;2017;02;09;Torstai;1;1;2
94;16.02.2017;2017;02;10;Torstai;1;0;1
94;16.02.2017;2017;02;11;Torstai;1;1;2
94;16.02.2017;2017;02;12;Torstai;1;1;2
94;16.02.2017;2017;02;13;Torstai;0;0;0
94;16.02.2017;2017;02;14;Torstai;1;3;4
94;16.02.2017;2017;02;15;Torstai;1;8;9
94;16.02.2017;2017;02;16;Torstai;3;4;7
94;16.02.2017;2017;02;17;Torstai;2;5;7
94;16.02.2017;2017;02;18;Torstai;0;6;6
94;16.02.2017;2017;02;19;Torstai;2;2;4
94;16.02.2017;2017;02;20;Torstai;2;0;2
94;16.02.2017;2017;02;21;Torstai;0;2;2
94;16.02.2017;2017;02;22;Torstai;0;0;0
94;16.02.2017;2017;02;23;Torstai;0;0;0
94;17.02.2017;2017;02;00;Perjantai;0;0;0
94;17.02.2017;2017;02;01;Perjantai;0;0;0
94;17.02.2017;2017;02;02;Perjantai;0;0;0
94;17.02.2017;2017;02;03;Perjantai;0;1;1
94;17.02.2017;2017;02;04;Perjantai;0;0;0
94;17.02.2017;2017;02;05;Perjantai;2;1;3
94;17.02.2017;2017;02;06;Perjantai;5;0;5
94;17.02.2017;2017;02;07;Perjantai;12;2;14
94;17.02.2017;2017;02;08;Perjantai;5;0;5
94;17.02.2017;2017;02;09;Perjantai;3;0;3
94;17.02.2017;2017;02;10;Perjantai;3;0;3
94;17.02.2017;2017;02;11;Perjantai;2;1;3
94;17.02.2017;2017;02;12;Perjantai;1;5;6
94;17.02.2017;2017;02;13;Perjantai;0;0;0
94;17.02.2017;2017;02;14;Perjantai;3;7;10
94;17.02.2017;2017;02;15;Perjantai;1;7;8
94;17.02.2017;2017;02;16;Perjantai;2;4;6
94;17.02.2017;2017;02;17;Perjantai;0;8;8
94;17.02.2017;2017;02;18;Perjantai;1;3;4
94;17.02.2017;2017;02;19;Perjantai;2;0;2
94;17.02.2017;2017;02;20;Perjantai;1;2;3
94;17.02.2017;2017;02;21;Perjantai;0;0;0
94;17.02.2017;2017;02;22;Perjantai;0;2;2
94;17.02.2017;2017;02;23;Perjantai;0;0;0
94;18.02.2017;2017;02;00;Lauantai;0;1;1
94;18.02.2017;2017;02;01;Lauantai;2;0;2
94;18.02.2017;2017;02;02;Lauantai;0;0;0
94;18.02.2017;2017;02;03;Lauantai;0;2;2
94;18.02.2017;2017;02;04;Lauantai;0;0;0
94;18.02.2017;2017;02;05;Lauantai;0;0;0
94;18.02.2017;2017;02;06;Lauantai;0;0;0
94;18.02.2017;2017;02;07;Lauantai;1;0;1
94;18.02.2017;2017;02;08;Lauantai;0;1;1
94;18.02.2017;2017;02;09;Lauantai;1;0;1
94;18.02.2017;2017;02;10;Lauantai;3;2;5
94;18.02.2017;2017;02;11;Lauantai;3;2;5
94;18.02.2017;2017;02;12;Lauantai;1;1;2
94;18.02.2017;2017;02;13;Lauantai;2;6;8
94;18.02.2017;2017;02;14;Lauantai;1;4;5
94;18.02.2017;2017;02;15;Lauantai;3;2;5
94;18.02.2017;2017;02;16;Lauantai;3;2;5
94;18.02.2017;2017;02;17;Lauantai;1;6;7
94;18.02.2017;2017;02;18;Lauantai;0;0;0
94;18.02.2017;2017;02;19;Lauantai;1;0;1
94;18.02.2017;2017;02;20;Lauantai;0;2;2
94;18.02.2017;2017;02;21;Lauantai;1;2;3
94;18.02.2017;2017;02;22;Lauantai;0;2;2
94;18.02.2017;2017;02;23;Lauantai;0;0;0
94;19.02.2017;2017;02;00;Sunnuntai;0;0;0
94;19.02.2017;2017;02;01;Sunnuntai;0;0;0
94;19.02.2017;2017;02;02;Sunnuntai;0;0;0
94;19.02.2017;2017;02;03;Sunnuntai;0;0;0
94;19.02.2017;2017;02;04;Sunnuntai;0;0;0
94;19.02.2017;2017;02;05;Sunnuntai;0;0;0
94;19.02.2017;2017;02;06;Sunnuntai;0;0;0
94;19.02.2017;2017;02;07;Sunnuntai;0;1;1
94;19.02.2017;2017;02;08;Sunnuntai;0;2;2
94;19.02.2017;2017;02;09;Sunnuntai;1;0;1
94;19.02.2017;2017;02;10;Sunnuntai;0;1;1
94;19.02.2017;2017;02;11;Sunnuntai;5;0;5
94;19.02.2017;2017;02;12;Sunnuntai;1;1;2
94;19.02.2017;2017;02;13;Sunnuntai;2;2;4
94;19.02.2017;2017;02;14;Sunnuntai;1;4;5
94;19.02.2017;2017;02;15;Sunnuntai;4;1;5
94;19.02.2017;2017;02;16;Sunnuntai;0;0;0
94;19.02.2017;2017;02;17;Sunnuntai;1;1;2
94;19.02.2017;2017;02;18;Sunnuntai;1;0;1
94;19.02.2017;2017;02;19;Sunnuntai;0;1;1
94;19.02.2017;2017;02;20;Sunnuntai;0;0;0
94;19.02.2017;2017;02;21;Sunnuntai;0;0;0
94;19.02.2017;2017;02;22;Sunnuntai;0;2;2
94;19.02.2017;2017;02;23;Sunnuntai;0;0;0
94;20.02.2017;2017;02;00;Maanantai;0;0;0
94;20.02.2017;2017;02;01;Maanantai;0;0;0
94;20.02.2017;2017;02;02;Maanantai;0;0;0
94;20.02.2017;2017;02;03;Maanantai;0;0;0
94;20.02.2017;2017;02;04;Maanantai;0;0;0
94;20.02.2017;2017;02;05;Maanantai;2;2;4
94;20.02.2017;2017;02;06;Maanantai;2;0;2
94;20.02.2017;2017;02;07;Maanantai;8;1;9
94;20.02.2017;2017;02;08;Maanantai;12;0;12
94;20.02.2017;2017;02;09;Maanantai;2;2;4
94;20.02.2017;2017;02;10;Maanantai;1;4;5
94;20.02.2017;2017;02;11;Maanantai;1;0;1
94;20.02.2017;2017;02;12;Maanantai;2;0;2
94;20.02.2017;2017;02;13;Maanantai;1;3;4
94;20.02.2017;2017;02;14;Maanantai;1;6;7
94;20.02.2017;2017;02;15;Maanantai;1;4;5
94;20.02.2017;2017;02;16;Maanantai;1;12;13
94;20.02.2017;2017;02;17;Maanantai;1;5;6
94;20.02.2017;2017;02;18;Maanantai;0;3;3
94;20.02.2017;2017;02;19;Maanantai;1;2;3
94;20.02.2017;2017;02;20;Maanantai;0;2;2
94;20.02.2017;2017;02;21;Maanantai;1;2;3
94;20.02.2017;2017;02;22;Maanantai;0;0;0
94;20.02.2017;2017;02;23;Maanantai;0;1;1
94;21.02.2017;2017;02;00;Tiistai;0;0;0
94;21.02.2017;2017;02;01;Tiistai;0;0;0
94;21.02.2017;2017;02;02;Tiistai;0;0;0
94;21.02.2017;2017;02;03;Tiistai;0;0;0
94;21.02.2017;2017;02;04;Tiistai;1;0;1
94;21.02.2017;2017;02;05;Tiistai;3;1;4
94;21.02.2017;2017;02;06;Tiistai;4;0;4
94;21.02.2017;2017;02;07;Tiistai;11;1;12
94;21.02.2017;2017;02;08;Tiistai;7;0;7
94;21.02.2017;2017;02;09;Tiistai;1;1;2
94;21.02.2017;2017;02;10;Tiistai;1;0;1
94;21.02.2017;2017;02;11;Tiistai;0;0;0
94;21.02.2017;2017;02;12;Tiistai;0;1;1
94;21.02.2017;2017;02;13;Tiistai;0;1;1
94;21.02.2017;2017;02;14;Tiistai;1;1;2
94;21.02.2017;2017;02;15;Tiistai;1;3;4
94;21.02.2017;2017;02;16;Tiistai;1;10;11
94;21.02.2017;2017;02;17;Tiistai;1;6;7
94;21.02.2017;2017;02;18;Tiistai;1;2;3
94;21.02.2017;2017;02;19;Tiistai;0;4;4
94;21.02.2017;2017;02;20;Tiistai;0;0;0
94;21.02.2017;2017;02;21;Tiistai;0;2;2
94;21.02.2017;2017;02;22;Tiistai;0;0;0
94;21.02.2017;2017;02;23;Tiistai;0;0;0
94;22.02.2017;2017;02;00;Keskiviikko;0;0;0
94;22.02.2017;2017;02;01;Keskiviikko;0;0;0
94;22.02.2017;2017;02;02;Keskiviikko;0;0;0
94;22.02.2017;2017;02;03;Keskiviikko;0;0;0
94;22.02.2017;2017;02;04;Keskiviikko;0;0;0
94;22.02.2017;2017;02;05;Keskiviikko;1;1;2
94;22.02.2017;2017;02;06;Keskiviikko;4;0;4
94;22.02.2017;2017;02;07;Keskiviikko;9;1;10
94;22.02.2017;2017;02;08;Keskiviikko;2;0;2
94;22.02.2017;2017;02;09;Keskiviikko;1;1;2
94;22.02.2017;2017;02;10;Keskiviikko;1;0;1
94;22.02.2017;2017;02;11;Keskiviikko;2;0;2
94;22.02.2017;2017;02;12;Keskiviikko;1;1;2
94;22.02.2017;2017;02;13;Keskiviikko;2;2;4
94;22.02.2017;2017;02;14;Keskiviikko;1;0;1
94;22.02.2017;2017;02;15;Keskiviikko;1;8;9
94;22.02.2017;2017;02;16;Keskiviikko;0;10;10
94;22.02.2017;2017;02;17;Keskiviikko;1;1;2
94;22.02.2017;2017;02;18;Keskiviikko;0;3;3
94;22.02.2017;2017;02;19;Keskiviikko;1;1;2
94;22.02.2017;2017;02;20;Keskiviikko;0;1;1
94;22.02.2017;2017;02;21;Keskiviikko;0;2;2
94;22.02.2017;2017;02;22;Keskiviikko;0;2;2
94;22.02.2017;2017;02;23;Keskiviikko;0;1;1
94;23.02.2017;2017;02;00;Torstai;0;0;0
94;23.02.2017;2017;02;01;Torstai;0;0;0
94;23.02.2017;2017;02;02;Torstai;0;0;0
94;23.02.2017;2017;02;03;Torstai;0;0;0
94;23.02.2017;2017;02;04;Torstai;0;0;0
94;23.02.2017;2017;02;05;Torstai;1;1;2
94;23.02.2017;2017;02;06;Torstai;3;0;3
94;23.02.2017;2017;02;07;Torstai;7;2;9
94;23.02.2017;2017;02;08;Torstai;8;0;8
94;23.02.2017;2017;02;09;Torstai;2;0;2
94;23.02.2017;2017;02;10;Torstai;0;0;0
94;23.02.2017;2017;02;11;Torstai;0;1;1
94;23.02.2017;2017;02;12;Torstai;1;0;1
94;23.02.2017;2017;02;13;Torstai;0;0;0
94;23.02.2017;2017;02;14;Torstai;2;2;4
94;23.02.2017;2017;02;15;Torstai;1;5;6
94;23.02.2017;2017;02;16;Torstai;0;3;3
94;23.02.2017;2017;02;17;Torstai;0;7;7
94;23.02.2017;2017;02;18;Torstai;0;5;5
94;23.02.2017;2017;02;19;Torstai;5;2;7
94;23.02.2017;2017;02;20;Torstai;1;1;2
94;23.02.2017;2017;02;21;Torstai;0;1;1
94;23.02.2017;2017;02;22;Torstai;0;1;1
94;23.02.2017;2017;02;23;Torstai;0;0;0
94;24.02.2017;2017;02;00;Perjantai;0;0;0
94;24.02.2017;2017;02;01;Perjantai;0;0;0
94;24.02.2017;2017;02;02;Perjantai;0;0;0
94;24.02.2017;2017;02;03;Perjantai;0;0;0
94;24.02.2017;2017;02;04;Perjantai;0;0;0
94;24.02.2017;2017;02;05;Perjantai;2;2;4
94;24.02.2017;2017;02;06;Perjantai;3;0;3
94;24.02.2017;2017;02;07;Perjantai;12;2;14
94;24.02.2017;2017;02;08;Perjantai;3;0;3
94;24.02.2017;2017;02;09;Perjantai;2;0;2
94;24.02.2017;2017;02;10;Perjantai;0;0;0
94;24.02.2017;2017;02;11;Perjantai;0;0;0
94;24.02.2017;2017;02;12;Perjantai;1;2;3
94;24.02.2017;2017;02;13;Perjantai;0;3;3
94;24.02.2017;2017;02;14;Perjantai;1;3;4
94;24.02.2017;2017;02;15;Perjantai;2;4;6
94;24.02.2017;2017;02;16;Perjantai;1;4;5
94;24.02.2017;2017;02;17;Perjantai;0;11;11
94;24.02.2017;2017;02;18;Perjantai;0;0;0
94;24.02.2017;2017;02;19;Perjantai;0;2;2
94;24.02.2017;2017;02;20;Perjantai;0;0;0
94;24.02.2017;2017;02;21;Perjantai;1;1;2
94;24.02.2017;2017;02;22;Perjantai;0;0;0
94;24.02.2017;2017;02;23;Perjantai;0;0;0
94;25.02.2017;2017;02;00;Lauantai;0;0;0
94;25.02.2017;2017;02;01;Lauantai;0;0;0
94;25.02.2017;2017;02;02;Lauantai;0;0;0
94;25.02.2017;2017;02;03;Lauantai;1;0;1
94;25.02.2017;2017;02;04;Lauantai;0;0;0
94;25.02.2017;2017;02;05;Lauantai;1;0;1
94;25.02.2017;2017;02;06;Lauantai;1;0;1
94;25.02.2017;2017;02;07;Lauantai;0;0;0
94;25.02.2017;2017;02;08;Lauantai;0;0;0
94;25.02.2017;2017;02;09;Lauantai;1;1;2
94;25.02.2017;2017;02;10;Lauantai;0;0;0
94;25.02.2017;2017;02;11;Lauantai;2;0;2
94;25.02.2017;2017;02;12;Lauantai;1;0;1
94;25.02.2017;2017;02;13;Lauantai;4;1;5
94;25.02.2017;2017;02;14;Lauantai;0;2;2
94;25.02.2017;2017;02;15;Lauantai;0;3;3
94;25.02.2017;2017;02;16;Lauantai;0;3;3
94;25.02.2017;2017;02;17;Lauantai;0;0;0
94;25.02.2017;2017;02;18;Lauantai;2;1;3
94;25.02.2017;2017;02;19;Lauantai;1;0;1
94;25.02.2017;2017;02;20;Lauantai;0;1;1
94;25.02.2017;2017;02;21;Lauantai;1;2;3
94;25.02.2017;2017;02;22;Lauantai;0;1;1
94;25.02.2017;2017;02;23;Lauantai;0;0;0
94;26.02.2017;2017;02;00;Sunnuntai;0;0;0
94;26.02.2017;2017;02;01;Sunnuntai;0;0;0
94;26.02.2017;2017;02;02;Sunnuntai;0;0;0
94;26.02.2017;2017;02;03;Sunnuntai;0;0;0
94;26.02.2017;2017;02;04;Sunnuntai;0;0;0
94;26.02.2017;2017;02;05;Sunnuntai;0;0;0
94;26.02.2017;2017;02;06;Sunnuntai;0;0;0
94;26.02.2017;2017;02;07;Sunnuntai;1;1;2
94;26.02.2017;2017;02;08;Sunnuntai;1;0;1
94;26.02.2017;2017;02;09;Sunnuntai;0;0;0
94;26.02.2017;2017;02;10;Sunnuntai;0;0;0
94;26.02.2017;2017;02;11;Sunnuntai;1;0;1
94;26.02.2017;2017;02;12;Sunnuntai;1;1;2
94;26.02.2017;2017;02;13;Sunnuntai;1;2;3
94;26.02.2017;2017;02;14;Sunnuntai;3;3;6
94;26.02.2017;2017;02;15;Sunnuntai;3;1;4
94;26.02.2017;2017;02;16;Sunnuntai;1;0;1
94;26.02.2017;2017;02;17;Sunnuntai;0;1;1
94;26.02.2017;2017;02;18;Sunnuntai;2;0;2
94;26.02.2017;2017;02;19;Sunnuntai;0;2;2
94;26.02.2017;2017;02;20;Sunnuntai;0;0;0
94;26.02.2017;2017;02;21;Sunnuntai;0;0;0
94;26.02.2017;2017;02;22;Sunnuntai;0;1;1
94;26.02.2017;2017;02;23;Sunnuntai;0;0;0
94;27.02.2017;2017;02;00;Maanantai;0;1;1
94;27.02.2017;2017;02;01;Maanantai;0;0;0
94;27.02.2017;2017;02;02;Maanantai;0;0;0
94;27.02.2017;2017;02;03;Maanantai;0;0;0
94;27.02.2017;2017;02;04;Maanantai;0;0;0
94;27.02.2017;2017;02;05;Maanantai;0;1;1
94;27.02.2017;2017;02;06;Maanantai;5;0;5
94;27.02.2017;2017;02;07;Maanantai;2;1;3
94;27.02.2017;2017;02;08;Maanantai;3;0;3
94;27.02.2017;2017;02;09;Maanantai;0;0;0
94;27.02.2017;2017;02;10;Maanantai;1;0;1
94;27.02.2017;2017;02;11;Maanantai;1;0;1
94;27.02.2017;2017;02;12;Maanantai;2;0;2
94;27.02.2017;2017;02;13;Maanantai;2;1;3
94;27.02.2017;2017;02;14;Maanantai;1;1;2
94;27.02.2017;2017;02;15;Maanantai;0;4;4
94;27.02.2017;2017;02;16;Maanantai;0;5;5
94;27.02.2017;2017;02;17;Maanantai;1;3;4
94;27.02.2017;2017;02;18;Maanantai;0;5;5
94;27.02.2017;2017;02;19;Maanantai;0;4;4
94;27.02.2017;2017;02;20;Maanantai;0;2;2
94;27.02.2017;2017;02;21;Maanantai;0;0;0
94;27.02.2017;2017;02;22;Maanantai;0;2;2
94;27.02.2017;2017;02;23;Maanantai;0;0;0
94;28.02.2017;2017;02;00;Tiistai;0;0;0
94;28.02.2017;2017;02;01;Tiistai;0;0;0
94;28.02.2017;2017;02;02;Tiistai;0;0;0
94;28.02.2017;2017;02;03;Tiistai;0;0;0
94;28.02.2017;2017;02;04;Tiistai;0;0;0
94;28.02.2017;2017;02;05;Tiistai;1;1;2
94;28.02.2017;2017;02;06;Tiistai;4;0;4
94;28.02.2017;2017;02;07;Tiistai;12;0;12
94;28.02.2017;2017;02;08;Tiistai;7;0;7
94;28.02.2017;2017;02;09;Tiistai;2;0;2
94;28.02.2017;2017;02;10;Tiistai;1;0;1
94;28.02.2017;2017;02;11;Tiistai;2;0;2
94;28.02.2017;2017;02;12;Tiistai;1;1;2
94;28.02.2017;2017;02;13;Tiistai;0;1;1
94;28.02.2017;2017;02;14;Tiistai;1;3;4
94;28.02.2017;2017;02;15;Tiistai;0;4;4
94;28.02.2017;2017;02;16;Tiistai;0;11;11
94;28.02.2017;2017;02;17;Tiistai;1;8;9
94;28.02.2017;2017;02;18;Tiistai;0;3;3
94;28.02.2017;2017;02;19;Tiistai;2;2;4
94;28.02.2017;2017;02;20;Tiistai;0;1;1
94;28.02.2017;2017;02;21;Tiistai;0;1;1
94;28.02.2017;2017;02;22;Tiistai;0;1;1
94;28.02.2017;2017;02;23;Tiistai;0;0;0
94;01.03.2017;2017;03;00;Keskiviikko;0;0;0
94;01.03.2017;2017;03;01;Keskiviikko;0;0;0
94;01.03.2017;2017;03;02;Keskiviikko;0;0;0
94;01.03.2017;2017;03;03;Keskiviikko;1;0;1
94;01.03.2017;2017;03;04;Keskiviikko;0;0;0
94;01.03.2017;2017;03;05;Keskiviikko;2;1;3
94;01.03.2017;2017;03;06;Keskiviikko;2;0;2
94;01.03.2017;2017;03;07;Keskiviikko;11;0;11
94;01.03.2017;2017;03;08;Keskiviikko;5;0;5
94;01.03.2017;2017;03;09;Keskiviikko;0;0;0
94;01.03.2017;2017;03;10;Keskiviikko;0;0;0
94;01.03.2017;2017;03;11;Keskiviikko;0;0;0
94;01.03.2017;2017;03;12;Keskiviikko;0;0;0
94;01.03.2017;2017;03;13;Keskiviikko;1;0;1
94;01.03.2017;2017;03;14;Keskiviikko;1;3;4
94;01.03.2017;2017;03;15;Keskiviikko;0;1;1
94;01.03.2017;2017;03;16;Keskiviikko;0;6;6
94;01.03.2017;2017;03;17;Keskiviikko;0;8;8
94;01.03.2017;2017;03;18;Keskiviikko;0;2;2
94;01.03.2017;2017;03;19;Keskiviikko;0;2;2
94;01.03.2017;2017;03;20;Keskiviikko;0;0;0
94;01.03.2017;2017;03;21;Keskiviikko;0;4;4
94;01.03.2017;2017;03;22;Keskiviikko;0;0;0
94;01.03.2017;2017;03;23;Keskiviikko;0;0;0
94;02.03.2017;2017;03;00;Torstai;0;0;0
94;02.03.2017;2017;03;01;Torstai;0;0;0
94;02.03.2017;2017;03;02;Torstai;0;0;0
94;02.03.2017;2017;03;03;Torstai;0;0;0
94;02.03.2017;2017;03;04;Torstai;0;0;0
94;02.03.2017;2017;03;05;Torstai;0;1;1
94;02.03.2017;2017;03;06;Torstai;5;0;5
94;02.03.2017;2017;03;07;Torstai;7;1;8
94;02.03.2017;2017;03;08;Torstai;5;1;6
94;02.03.2017;2017;03;09;Torstai;1;1;2
94;02.03.2017;2017;03;10;Torstai;0;0;0
94;02.03.2017;2017;03;11;Torstai;0;0;0
94;02.03.2017;2017;03;12;Torstai;0;0;0
94;02.03.2017;2017;03;13;Torstai;0;0;0
94;02.03.2017;2017;03;14;Torstai;3;3;6
94;02.03.2017;2017;03;15;Torstai;2;8;10
94;02.03.2017;2017;03;16;Torstai;0;6;6
94;02.03.2017;2017;03;17;Torstai;1;7;8
94;02.03.2017;2017;03;18;Torstai;1;4;5
94;02.03.2017;2017;03;19;Torstai;0;0;0
94;02.03.2017;2017;03;20;Torstai;2;2;4
94;02.03.2017;2017;03;21;Torstai;0;0;0
94;02.03.2017;2017;03;22;Torstai;0;0;0
94;02.03.2017;2017;03;23;Torstai;0;0;0
94;03.03.2017;2017;03;00;Perjantai;0;0;0
94;03.03.2017;2017;03;01;Perjantai;0;0;0
94;03.03.2017;2017;03;02;Perjantai;0;0;0
94;03.03.2017;2017;03;03;Perjantai;0;0;0
94;03.03.2017;2017;03;04;Perjantai;0;0;0
94;03.03.2017;2017;03;05;Perjantai;2;1;3
94;03.03.2017;2017;03;06;Perjantai;1;0;1
94;03.03.2017;2017;03;07;Perjantai;15;1;16
94;03.03.2017;2017;03;08;Perjantai;5;0;5
94;03.03.2017;2017;03;09;Perjantai;1;1;2
94;03.03.2017;2017;03;10;Perjantai;0;0;0
94;03.03.2017;2017;03;11;Perjantai;0;2;2
94;03.03.2017;2017;03;12;Perjantai;0;0;0
94;03.03.2017;2017;03;13;Perjantai;2;3;5
94;03.03.2017;2017;03;14;Perjantai;1;6;7
94;03.03.2017;2017;03;15;Perjantai;1;4;5
94;03.03.2017;2017;03;16;Perjantai;0;9;9
94;03.03.2017;2017;03;17;Perjantai;1;5;6
94;03.03.2017;2017;03;18;Perjantai;0;2;2
94;03.03.2017;2017;03;19;Perjantai;0;0;0
94;03.03.2017;2017;03;20;Perjantai;0;0;0
94;03.03.2017;2017;03;21;Perjantai;0;1;1
94;03.03.2017;2017;03;22;Perjantai;0;1;1
94;03.03.2017;2017;03;23;Perjantai;0;0;0
94;04.03.2017;2017;03;00;Lauantai;0;0;0
94;04.03.2017;2017;03;01;Lauantai;0;0;0
94;04.03.2017;2017;03;02;Lauantai;0;0;0
94;04.03.2017;2017;03;03;Lauantai;0;0;0
94;04.03.2017;2017;03;04;Lauantai;0;0;0
94;04.03.2017;2017;03;05;Lauantai;0;0;0
94;04.03.2017;2017;03;06;Lauantai;0;0;0
94;04.03.2017;2017;03;07;Lauantai;0;1;1
94;04.03.2017;2017;03;08;Lauantai;0;0;0
94;04.03.2017;2017;03;09;Lauantai;0;1;1
94;04.03.2017;2017;03;10;Lauantai;3;0;3
94;04.03.2017;2017;03;11;Lauantai;4;0;4
94;04.03.2017;2017;03;12;Lauantai;1;3;4
94;04.03.2017;2017;03;13;Lauantai;0;6;6
94;04.03.2017;2017;03;14;Lauantai;1;1;2
94;04.03.2017;2017;03;15;Lauantai;0;0;0
94;04.03.2017;2017;03;16;Lauantai;1;0;1
94;04.03.2017;2017;03;17;Lauantai;0;0;0
94;04.03.2017;2017;03;18;Lauantai;0;0;0
94;04.03.2017;2017;03;19;Lauantai;1;0;1
94;04.03.2017;2017;03;20;Lauantai;0;0;0
94;04.03.2017;2017;03;21;Lauantai;0;0;0
94;04.03.2017;2017;03;22;Lauantai;0;0;0
94;04.03.2017;2017;03;23;Lauantai;0;1;1
94;05.03.2017;2017;03;00;Sunnuntai;0;0;0
94;05.03.2017;2017;03;01;Sunnuntai;0;0;0
94;05.03.2017;2017;03;02;Sunnuntai;0;0;0
94;05.03.2017;2017;03;03;Sunnuntai;0;0;0
94;05.03.2017;2017;03;04;Sunnuntai;0;0;0
94;05.03.2017;2017;03;05;Sunnuntai;0;0;0
94;05.03.2017;2017;03;06;Sunnuntai;0;0;0
94;05.03.2017;2017;03;07;Sunnuntai;0;0;0
94;05.03.2017;2017;03;08;Sunnuntai;1;0;1
94;05.03.2017;2017;03;09;Sunnuntai;0;0;0
94;05.03.2017;2017;03;10;Sunnuntai;0;0;0
94;05.03.2017;2017;03;11;Sunnuntai;2;1;3
94;05.03.2017;2017;03;12;Sunnuntai;0;0;0
94;05.03.2017;2017;03;13;Sunnuntai;0;3;3
94;05.03.2017;2017;03;14;Sunnuntai;0;2;2
94;05.03.2017;2017;03;15;Sunnuntai;1;0;1
94;05.03.2017;2017;03;16;Sunnuntai;0;1;1
94;05.03.2017;2017;03;17;Sunnuntai;0;2;2
94;05.03.2017;2017;03;18;Sunnuntai;1;0;1
94;05.03.2017;2017;03;19;Sunnuntai;0;0;0
94;05.03.2017;2017;03;20;Sunnuntai;0;0;0
94;05.03.2017;2017;03;21;Sunnuntai;0;0;0
94;05.03.2017;2017;03;22;Sunnuntai;0;0;0
94;05.03.2017;2017;03;23;Sunnuntai;0;0;0
94;06.03.2017;2017;03;00;Maanantai;0;0;0
94;06.03.2017;2017;03;01;Maanantai;0;0;0
94;06.03.2017;2017;03;02;Maanantai;0;0;0
94;06.03.2017;2017;03;03;Maanantai;0;0;0
94;06.03.2017;2017;03;04;Maanantai;0;0;0
94;06.03.2017;2017;03;05;Maanantai;0;2;2
94;06.03.2017;2017;03;06;Maanantai;3;0;3
94;06.03.2017;2017;03;07;Maanantai;2;1;3
94;06.03.2017;2017;03;08;Maanantai;1;0;1
94;06.03.2017;2017;03;09;Maanantai;1;1;2
94;06.03.2017;2017;03;10;Maanantai;2;0;2
94;06.03.2017;2017;03;11;Maanantai;0;0;0
94;06.03.2017;2017;03;12;Maanantai;0;0;0
94;06.03.2017;2017;03;13;Maanantai;2;0;2
94;06.03.2017;2017;03;14;Maanantai;1;2;3
94;06.03.2017;2017;03;15;Maanantai;0;9;9
94;06.03.2017;2017;03;16;Maanantai;4;5;9
94;06.03.2017;2017;03;17;Maanantai;1;2;3
94;06.03.2017;2017;03;18;Maanantai;0;1;1
94;06.03.2017;2017;03;19;Maanantai;0;3;3
94;06.03.2017;2017;03;20;Maanantai;0;1;1
94;06.03.2017;2017;03;21;Maanantai;0;0;0
94;06.03.2017;2017;03;22;Maanantai;0;0;0
94;06.03.2017;2017;03;23;Maanantai;0;0;0
94;07.03.2017;2017;03;00;Tiistai;0;1;1
94;07.03.2017;2017;03;01;Tiistai;0;0;0
94;07.03.2017;2017;03;02;Tiistai;0;0;0
94;07.03.2017;2017;03;03;Tiistai;0;0;0
94;07.03.2017;2017;03;04;Tiistai;0;0;0
94;07.03.2017;2017;03;05;Tiistai;1;2;3
94;07.03.2017;2017;03;06;Tiistai;1;1;2
94;07.03.2017;2017;03;07;Tiistai;6;0;6
94;07.03.2017;2017;03;08;Tiistai;2;0;2
94;07.03.2017;2017;03;09;Tiistai;3;2;5
94;07.03.2017;2017;03;10;Tiistai;3;0;3
94;07.03.2017;2017;03;11;Tiistai;0;0;0
94;07.03.2017;2017;03;12;Tiistai;0;0;0
94;07.03.2017;2017;03;13;Tiistai;1;0;1
94;07.03.2017;2017;03;14;Tiistai;2;1;3
94;07.03.2017;2017;03;15;Tiistai;3;6;9
94;07.03.2017;2017;03;16;Tiistai;1;4;5
94;07.03.2017;2017;03;17;Tiistai;1;4;5
94;07.03.2017;2017;03;18;Tiistai;0;5;5
94;07.03.2017;2017;03;19;Tiistai;1;0;1
94;07.03.2017;2017;03;20;Tiistai;1;3;4
94;07.03.2017;2017;03;21;Tiistai;0;1;1
94;07.03.2017;2017;03;22;Tiistai;0;0;0
94;07.03.2017;2017;03;23;Tiistai;0;0;0
94;08.03.2017;2017;03;00;Keskiviikko;0;0;0
94;08.03.2017;2017;03;01;Keskiviikko;0;0;0
94;08.03.2017;2017;03;02;Keskiviikko;0;0;0
94;08.03.2017;2017;03;03;Keskiviikko;0;0;0
94;08.03.2017;2017;03;04;Keskiviikko;0;0;0
94;08.03.2017;2017;03;05;Keskiviikko;1;1;2
94;08.03.2017;2017;03;06;Keskiviikko;3;2;5
94;08.03.2017;2017;03;07;Keskiviikko;5;0;5
94;08.03.2017;2017;03;08;Keskiviikko;2;0;2
94;08.03.2017;2017;03;09;Keskiviikko;2;0;2
94;08.03.2017;2017;03;10;Keskiviikko;3;0;3
94;08.03.2017;2017;03;11;Keskiviikko;1;0;1
94;08.03.2017;2017;03;12;Keskiviikko;0;0;0
94;08.03.2017;2017;03;13;Keskiviikko;2;1;3
94;08.03.2017;2017;03;14;Keskiviikko;1;1;2
94;08.03.2017;2017;03;15;Keskiviikko;0;3;3
94;08.03.2017;2017;03;16;Keskiviikko;2;4;6
94;08.03.2017;2017;03;17;Keskiviikko;0;0;0
94;08.03.2017;2017;03;18;Keskiviikko;1;1;2
94;08.03.2017;2017;03;19;Keskiviikko;0;6;6
94;08.03.2017;2017;03;20;Keskiviikko;1;0;1
94;08.03.2017;2017;03;21;Keskiviikko;0;1;1
94;08.03.2017;2017;03;22;Keskiviikko;0;1;1
94;08.03.2017;2017;03;23;Keskiviikko;0;0;0
94;09.03.2017;2017;03;00;Torstai;0;0;0
94;09.03.2017;2017;03;01;Torstai;0;0;0
94;09.03.2017;2017;03;02;Torstai;0;0;0
94;09.03.2017;2017;03;03;Torstai;0;0;0
94;09.03.2017;2017;03;04;Torstai;0;0;0
94;09.03.2017;2017;03;05;Torstai;0;1;1
94;09.03.2017;2017;03;06;Torstai;1;0;1
94;09.03.2017;2017;03;07;Torstai;4;2;6
94;09.03.2017;2017;03;08;Torstai;2;0;2
94;09.03.2017;2017;03;09;Torstai;2;2;4
94;09.03.2017;2017;03;10;Torstai;2;0;2
94;09.03.2017;2017;03;11;Torstai;0;0;0
94;09.03.2017;2017;03;12;Torstai;0;1;1
94;09.03.2017;2017;03;13;Torstai;0;0;0
94;09.03.2017;2017;03;14;Torstai;1;0;1
94;09.03.2017;2017;03;15;Torstai;0;1;1
94;09.03.2017;2017;03;16;Torstai;0;7;7
94;09.03.2017;2017;03;17;Torstai;1;1;2
94;09.03.2017;2017;03;18;Torstai;0;2;2
94;09.03.2017;2017;03;19;Torstai;0;2;2
94;09.03.2017;2017;03;20;Torstai;0;0;0
94;09.03.2017;2017;03;21;Torstai;0;0;0
94;09.03.2017;2017;03;22;Torstai;0;0;0
94;09.03.2017;2017;03;23;Torstai;0;0;0
94;10.03.2017;2017;03;00;Perjantai;0;0;0
94;10.03.2017;2017;03;01;Perjantai;0;0;0
94;10.03.2017;2017;03;02;Perjantai;0;0;0
94;10.03.2017;2017;03;03;Perjantai;0;0;0
94;10.03.2017;2017;03;04;Perjantai;0;0;0
94;10.03.2017;2017;03;05;Perjantai;0;2;2
94;10.03.2017;2017;03;06;Perjantai;2;0;2
94;10.03.2017;2017;03;07;Perjantai;5;0;5
94;10.03.2017;2017;03;08;Perjantai;2;0;2
94;10.03.2017;2017;03;09;Perjantai;3;0;3
94;10.03.2017;2017;03;10;Perjantai;1;0;1
94;10.03.2017;2017;03;11;Perjantai;0;2;2
94;10.03.2017;2017;03;12;Perjantai;0;1;1
94;10.03.2017;2017;03;13;Perjantai;0;0;0
94;10.03.2017;2017;03;14;Perjantai;1;2;3
94;10.03.2017;2017;03;15;Perjantai;2;4;6
94;10.03.2017;2017;03;16;Perjantai;2;6;8
94;10.03.2017;2017;03;17;Perjantai;0;1;1
94;10.03.2017;2017;03;18;Perjantai;0;4;4
94;10.03.2017;2017;03;19;Perjantai;0;0;0
94;10.03.2017;2017;03;20;Perjantai;0;0;0
94;10.03.2017;2017;03;21;Perjantai;2;0;2
94;10.03.2017;2017;03;22;Perjantai;0;0;0
94;10.03.2017;2017;03;23;Perjantai;0;0;0
94;11.03.2017;2017;03;00;Lauantai;0;1;1
94;11.03.2017;2017;03;01;Lauantai;0;0;0
94;11.03.2017;2017;03;02;Lauantai;0;0;0
94;11.03.2017;2017;03;03;Lauantai;0;0;0
94;11.03.2017;2017;03;04;Lauantai;0;0;0
94;11.03.2017;2017;03;05;Lauantai;0;0;0
94;11.03.2017;2017;03;06;Lauantai;0;0;0
94;11.03.2017;2017;03;07;Lauantai;0;0;0
94;11.03.2017;2017;03;08;Lauantai;0;4;4
94;11.03.2017;2017;03;09;Lauantai;0;0;0
94;11.03.2017;2017;03;10;Lauantai;2;1;3
94;11.03.2017;2017;03;11;Lauantai;0;2;2
94;11.03.2017;2017;03;12;Lauantai;2;2;4
94;11.03.2017;2017;03;13;Lauantai;1;6;7
94;11.03.2017;2017;03;14;Lauantai;2;1;3
94;11.03.2017;2017;03;15;Lauantai;1;3;4
94;11.03.2017;2017;03;16;Lauantai;3;1;4
94;11.03.2017;2017;03;17;Lauantai;0;1;1
94;11.03.2017;2017;03;18;Lauantai;0;0;0
94;11.03.2017;2017;03;19;Lauantai;0;0;0
94;11.03.2017;2017;03;20;Lauantai;0;0;0
94;11.03.2017;2017;03;21;Lauantai;1;0;1
94;11.03.2017;2017;03;22;Lauantai;0;1;1
94;11.03.2017;2017;03;23;Lauantai;0;0;0
94;12.03.2017;2017;03;00;Sunnuntai;0;0;0
94;12.03.2017;2017;03;01;Sunnuntai;0;0;0
94;12.03.2017;2017;03;02;Sunnuntai;0;0;0
94;12.03.2017;2017;03;03;Sunnuntai;0;0;0
94;12.03.2017;2017;03;04;Sunnuntai;0;0;0
94;12.03.2017;2017;03;05;Sunnuntai;0;0;0
94;12.03.2017;2017;03;06;Sunnuntai;0;0;0
94;12.03.2017;2017;03;07;Sunnuntai;1;1;2
94;12.03.2017;2017;03;08;Sunnuntai;1;0;1
94;12.03.2017;2017;03;09;Sunnuntai;0;1;1
94;12.03.2017;2017;03;10;Sunnuntai;4;0;4
94;12.03.2017;2017;03;11;Sunnuntai;1;2;3
94;12.03.2017;2017;03;12;Sunnuntai;0;3;3
94;12.03.2017;2017;03;13;Sunnuntai;2;0;2
94;12.03.2017;2017;03;14;Sunnuntai;0;5;5
94;12.03.2017;2017;03;15;Sunnuntai;0;3;3
94;12.03.2017;2017;03;16;Sunnuntai;1;0;1
94;12.03.2017;2017;03;17;Sunnuntai;0;0;0
94;12.03.2017;2017;03;18;Sunnuntai;0;0;0
94;12.03.2017;2017;03;19;Sunnuntai;0;2;2
94;12.03.2017;2017;03;20;Sunnuntai;0;0;0
94;12.03.2017;2017;03;21;Sunnuntai;0;0;0
94;12.03.2017;2017;03;22;Sunnuntai;0;1;1
94;12.03.2017;2017;03;23;Sunnuntai;0;0;0
94;13.03.2017;2017;03;00;Maanantai;0;0;0
94;13.03.2017;2017;03;01;Maanantai;0;0;0
94;13.03.2017;2017;03;02;Maanantai;0;0;0
94;13.03.2017;2017;03;03;Maanantai;0;0;0
94;13.03.2017;2017;03;04;Maanantai;1;0;1
94;13.03.2017;2017;03;05;Maanantai;4;1;5
94;13.03.2017;2017;03;06;Maanantai;3;1;4
94;13.03.2017;2017;03;07;Maanantai;11;2;13
94;13.03.2017;2017;03;08;Maanantai;7;2;9
94;13.03.2017;2017;03;09;Maanantai;3;0;3
94;13.03.2017;2017;03;10;Maanantai;0;0;0
94;13.03.2017;2017;03;11;Maanantai;0;1;1
94;13.03.2017;2017;03;12;Maanantai;1;1;2
94;13.03.2017;2017;03;13;Maanantai;2;2;4
94;13.03.2017;2017;03;14;Maanantai;1;6;7
94;13.03.2017;2017;03;15;Maanantai;4;3;7
94;13.03.2017;2017;03;16;Maanantai;2;15;17
94;13.03.2017;2017;03;17;Maanantai;0;9;9
94;13.03.2017;2017;03;18;Maanantai;0;3;3
94;13.03.2017;2017;03;19;Maanantai;0;5;5
94;13.03.2017;2017;03;20;Maanantai;0;4;4
94;13.03.2017;2017;03;21;Maanantai;0;0;0
94;13.03.2017;2017;03;22;Maanantai;0;0;0
94;13.03.2017;2017;03;23;Maanantai;0;0;0
94;14.03.2017;2017;03;00;Tiistai;0;2;2
94;14.03.2017;2017;03;01;Tiistai;0;0;0
94;14.03.2017;2017;03;02;Tiistai;0;0;0
94;14.03.2017;2017;03;03;Tiistai;0;0;0
94;14.03.2017;2017;03;04;Tiistai;0;0;0
94;14.03.2017;2017;03;05;Tiistai;2;1;3
94;14.03.2017;2017;03;06;Tiistai;4;0;4
94;14.03.2017;2017;03;07;Tiistai;9;2;11
94;14.03.2017;2017;03;08;Tiistai;6;0;6
94;14.03.2017;2017;03;09;Tiistai;1;0;1
94;14.03.2017;2017;03;10;Tiistai;0;0;0
94;14.03.2017;2017;03;11;Tiistai;2;0;2
94;14.03.2017;2017;03;12;Tiistai;0;0;0
94;14.03.2017;2017;03;13;Tiistai;0;0;0
94;14.03.2017;2017;03;14;Tiistai;1;3;4
94;14.03.2017;2017;03;15;Tiistai;0;4;4
94;14.03.2017;2017;03;16;Tiistai;1;5;6
94;14.03.2017;2017;03;17;Tiistai;2;9;11
94;14.03.2017;2017;03;18;Tiistai;0;3;3
94;14.03.2017;2017;03;19;Tiistai;1;5;6
94;14.03.2017;2017;03;20;Tiistai;1;1;2
94;14.03.2017;2017;03;21;Tiistai;0;3;3
94;14.03.2017;2017;03;22;Tiistai;0;0;0
94;14.03.2017;2017;03;23;Tiistai;0;0;0
94;15.03.2017;2017;03;00;Keskiviikko;0;0;0
94;15.03.2017;2017;03;01;Keskiviikko;0;0;0
94;15.03.2017;2017;03;02;Keskiviikko;0;0;0
94;15.03.2017;2017;03;03;Keskiviikko;0;0;0
94;15.03.2017;2017;03;04;Keskiviikko;1;0;1
94;15.03.2017;2017;03;05;Keskiviikko;1;1;2
94;15.03.2017;2017;03;06;Keskiviikko;2;0;2
94;15.03.2017;2017;03;07;Keskiviikko;10;0;10
94;15.03.2017;2017;03;08;Keskiviikko;6;0;6
94;15.03.2017;2017;03;09;Keskiviikko;3;1;4
94;15.03.2017;2017;03;10;Keskiviikko;0;0;0
94;15.03.2017;2017;03;11;Keskiviikko;0;0;0
94;15.03.2017;2017;03;12;Keskiviikko;1;2;3
94;15.03.2017;2017;03;13;Keskiviikko;0;0;0
94;15.03.2017;2017;03;14;Keskiviikko;1;7;8
94;15.03.2017;2017;03;15;Keskiviikko;0;6;6
94;15.03.2017;2017;03;16;Keskiviikko;0;5;5
94;15.03.2017;2017;03;17;Keskiviikko;0;3;3
94;15.03.2017;2017;03;18;Keskiviikko;1;4;5
94;15.03.2017;2017;03;19;Keskiviikko;0;4;4
94;15.03.2017;2017;03;20;Keskiviikko;0;0;0
94;15.03.2017;2017;03;21;Keskiviikko;0;0;0
94;15.03.2017;2017;03;22;Keskiviikko;0;0;0
94;15.03.2017;2017;03;23;Keskiviikko;0;0;0
94;16.03.2017;2017;03;00;Torstai;0;0;0
94;16.03.2017;2017;03;01;Torstai;0;0;0
94;16.03.2017;2017;03;02;Torstai;0;0;0
94;16.03.2017;2017;03;03;Torstai;0;0;0
94;16.03.2017;2017;03;04;Torstai;1;0;1
94;16.03.2017;2017;03;05;Torstai;2;2;4
94;16.03.2017;2017;03;06;Torstai;2;0;2
94;16.03.2017;2017;03;07;Torstai;2;0;2
94;16.03.2017;2017;03;08;Torstai;2;0;2
94;16.03.2017;2017;03;09;Torstai;1;0;1
94;16.03.2017;2017;03;10;Torstai;0;0;0
94;16.03.2017;2017;03;11;Torstai;0;0;0
94;16.03.2017;2017;03;12;Torstai;0;2;2
94;16.03.2017;2017;03;13;Torstai;0;3;3
94;16.03.2017;2017;03;14;Torstai;1;4;5
94;16.03.2017;2017;03;15;Torstai;0;1;1
94;16.03.2017;2017;03;16;Torstai;2;5;7
94;16.03.2017;2017;03;17;Torstai;1;2;3
94;16.03.2017;2017;03;18;Torstai;1;3;4
94;16.03.2017;2017;03;19;Torstai;1;6;7
94;16.03.2017;2017;03;20;Torstai;1;0;1
94;16.03.2017;2017;03;21;Torstai;0;1;1
94;16.03.2017;2017;03;22;Torstai;0;2;2
94;16.03.2017;2017;03;23;Torstai;0;0;0
94;17.03.2017;2017;03;00;Perjantai;1;0;1
94;17.03.2017;2017;03;01;Perjantai;0;0;0
94;17.03.2017;2017;03;02;Perjantai;0;0;0
94;17.03.2017;2017;03;03;Perjantai;0;0;0
94;17.03.2017;2017;03;04;Perjantai;0;0;0
94;17.03.2017;2017;03;05;Perjantai;1;0;1
94;17.03.2017;2017;03;06;Perjantai;0;0;0
94;17.03.2017;2017;03;07;Perjantai;3;0;3
94;17.03.2017;2017;03;08;Perjantai;2;0;2
94;17.03.2017;2017;03;09;Perjantai;0;0;0
94;17.03.2017;2017;03;10;Perjantai;0;0;0
94;17.03.2017;2017;03;11;Perjantai;0;1;1
94;17.03.2017;2017;03;12;Perjantai;0;0;0
94;17.03.2017;2017;03;13;Perjantai;0;1;1
94;17.03.2017;2017;03;14;Perjantai;1;1;2
94;17.03.2017;2017;03;15;Perjantai;1;0;1
94;17.03.2017;2017;03;16;Perjantai;0;3;3
94;17.03.2017;2017;03;17;Perjantai;1;1;2
94;17.03.2017;2017;03;18;Perjantai;0;2;2
94;17.03.2017;2017;03;19;Perjantai;0;0;0
94;17.03.2017;2017;03;20;Perjantai;0;1;1
94;17.03.2017;2017;03;21;Perjantai;0;0;0
94;17.03.2017;2017;03;22;Perjantai;0;0;0
94;17.03.2017;2017;03;23;Perjantai;0;0;0
94;18.03.2017;2017;03;00;Lauantai;0;1;1
94;18.03.2017;2017;03;01;Lauantai;0;0;0
94;18.03.2017;2017;03;02;Lauantai;0;0;0
94;18.03.2017;2017;03;03;Lauantai;0;0;0
94;18.03.2017;2017;03;04;Lauantai;0;0;0
94;18.03.2017;2017;03;05;Lauantai;0;0;0
94;18.03.2017;2017;03;06;Lauantai;0;0;0
94;18.03.2017;2017;03;07;Lauantai;0;0;0
94;18.03.2017;2017;03;08;Lauantai;0;1;1
94;18.03.2017;2017;03;09;Lauantai;0;0;0
94;18.03.2017;2017;03;10;Lauantai;0;1;1
94;18.03.2017;2017;03;11;Lauantai;0;0;0
94;18.03.2017;2017;03;12;Lauantai;0;0;0
94;18.03.2017;2017;03;13;Lauantai;0;0;0
94;18.03.2017;2017;03;14;Lauantai;0;0;0
94;18.03.2017;2017;03;15;Lauantai;0;0;0
94;18.03.2017;2017;03;16;Lauantai;0;0;0
94;18.03.2017;2017;03;17;Lauantai;0;0;0
94;18.03.2017;2017;03;18;Lauantai;0;0;0
94;18.03.2017;2017;03;19;Lauantai;1;1;2
94;18.03.2017;2017;03;20;Lauantai;0;0;0
94;18.03.2017;2017;03;21;Lauantai;0;1;1
94;18.03.2017;2017;03;22;Lauantai;0;0;0
94;18.03.2017;2017;03;23;Lauantai;0;0;0
94;19.03.2017;2017;03;00;Sunnuntai;0;0;0
94;19.03.2017;2017;03;01;Sunnuntai;0;0;0
94;19.03.2017;2017;03;02;Sunnuntai;0;0;0
94;19.03.2017;2017;03;03;Sunnuntai;0;0;0
94;19.03.2017;2017;03;04;Sunnuntai;0;0;0
94;19.03.2017;2017;03;05;Sunnuntai;0;0;0
94;19.03.2017;2017;03;06;Sunnuntai;0;0;0
94;19.03.2017;2017;03;07;Sunnuntai;0;0;0
94;19.03.2017;2017;03;08;Sunnuntai;0;0;0
94;19.03.2017;2017;03;09;Sunnuntai;1;1;2
94;19.03.2017;2017;03;10;Sunnuntai;2;1;3
94;19.03.2017;2017;03;11;Sunnuntai;0;1;1
94;19.03.2017;2017;03;12;Sunnuntai;2;0;2
94;19.03.2017;2017;03;13;Sunnuntai;2;0;2
94;19.03.2017;2017;03;14;Sunnuntai;0;4;4
94;19.03.2017;2017;03;15;Sunnuntai;0;1;1
94;19.03.2017;2017;03;16;Sunnuntai;0;0;0
94;19.03.2017;2017;03;17;Sunnuntai;0;1;1
94;19.03.2017;2017;03;18;Sunnuntai;0;0;0
94;19.03.2017;2017;03;19;Sunnuntai;0;0;0
94;19.03.2017;2017;03;20;Sunnuntai;0;0;0
94;19.03.2017;2017;03;21;Sunnuntai;0;1;1
94;19.03.2017;2017;03;22;Sunnuntai;0;0;0
94;19.03.2017;2017;03;23;Sunnuntai;0;0;0
94;20.03.2017;2017;03;00;Maanantai;0;0;0
94;20.03.2017;2017;03;01;Maanantai;0;0;0
94;20.03.2017;2017;03;02;Maanantai;0;0;0
94;20.03.2017;2017;03;03;Maanantai;0;0;0
94;20.03.2017;2017;03;04;Maanantai;0;0;0
94;20.03.2017;2017;03;05;Maanantai;0;1;1
94;20.03.2017;2017;03;06;Maanantai;1;0;1
94;20.03.2017;2017;03;07;Maanantai;4;0;4
94;20.03.2017;2017;03;08;Maanantai;4;2;6
94;20.03.2017;2017;03;09;Maanantai;1;0;1
94;20.03.2017;2017;03;10;Maanantai;1;0;1
94;20.03.2017;2017;03;11;Maanantai;0;4;4
94;20.03.2017;2017;03;12;Maanantai;0;0;0
94;20.03.2017;2017;03;13;Maanantai;2;2;4
94;20.03.2017;2017;03;14;Maanantai;1;2;3
94;20.03.2017;2017;03;15;Maanantai;0;9;9
94;20.03.2017;2017;03;16;Maanantai;1;7;8
94;20.03.2017;2017;03;17;Maanantai;0;3;3
94;20.03.2017;2017;03;18;Maanantai;0;1;1
94;20.03.2017;2017;03;19;Maanantai;1;4;5
94;20.03.2017;2017;03;20;Maanantai;0;0;0
94;20.03.2017;2017;03;21;Maanantai;0;0;0
94;20.03.2017;2017;03;22;Maanantai;0;1;1
94;20.03.2017;2017;03;23;Maanantai;0;2;2
94;21.03.2017;2017;03;00;Tiistai;0;0;0
94;21.03.2017;2017;03;01;Tiistai;0;0;0
94;21.03.2017;2017;03;02;Tiistai;0;0;0
94;21.03.2017;2017;03;03;Tiistai;0;0;0
94;21.03.2017;2017;03;04;Tiistai;0;0;0
94;21.03.2017;2017;03;05;Tiistai;3;1;4
94;21.03.2017;2017;03;06;Tiistai;2;0;2
94;21.03.2017;2017;03;07;Tiistai;4;0;4
94;21.03.2017;2017;03;08;Tiistai;4;2;6
94;21.03.2017;2017;03;09;Tiistai;1;2;3
94;21.03.2017;2017;03;10;Tiistai;1;0;1
94;21.03.2017;2017;03;11;Tiistai;2;1;3
94;21.03.2017;2017;03;12;Tiistai;1;0;1
94;21.03.2017;2017;03;13;Tiistai;0;1;1
94;21.03.2017;2017;03;14;Tiistai;1;3;4
94;21.03.2017;2017;03;15;Tiistai;0;5;5
94;21.03.2017;2017;03;16;Tiistai;0;11;11
94;21.03.2017;2017;03;17;Tiistai;2;9;11
94;21.03.2017;2017;03;18;Tiistai;0;3;3
94;21.03.2017;2017;03;19;Tiistai;1;4;5
94;21.03.2017;2017;03;20;Tiistai;0;1;1
94;21.03.2017;2017;03;21;Tiistai;0;0;0
94;21.03.2017;2017;03;22;Tiistai;0;1;1
94;21.03.2017;2017;03;23;Tiistai;0;0;0
94;22.03.2017;2017;03;00;Keskiviikko;0;0;0
94;22.03.2017;2017;03;01;Keskiviikko;0;0;0
94;22.03.2017;2017;03;02;Keskiviikko;0;0;0
94;22.03.2017;2017;03;03;Keskiviikko;0;0;0
94;22.03.2017;2017;03;04;Keskiviikko;0;0;0
94;22.03.2017;2017;03;05;Keskiviikko;2;1;3
94;22.03.2017;2017;03;06;Keskiviikko;0;0;0
94;22.03.2017;2017;03;07;Keskiviikko;2;0;2
94;22.03.2017;2017;03;08;Keskiviikko;4;0;4
94;22.03.2017;2017;03;09;Keskiviikko;1;1;2
94;22.03.2017;2017;03;10;Keskiviikko;0;0;0
94;22.03.2017;2017;03;11;Keskiviikko;0;0;0
94;22.03.2017;2017;03;12;Keskiviikko;1;1;2
94;22.03.2017;2017;03;13;Keskiviikko;1;1;2
94;22.03.2017;2017;03;14;Keskiviikko;1;4;5
94;22.03.2017;2017;03;15;Keskiviikko;0;2;2
94;22.03.2017;2017;03;16;Keskiviikko;0;8;8
94;22.03.2017;2017;03;17;Keskiviikko;0;1;1
94;22.03.2017;2017;03;18;Keskiviikko;0;4;4
94;22.03.2017;2017;03;19;Keskiviikko;0;2;2
94;22.03.2017;2017;03;20;Keskiviikko;0;0;0
94;22.03.2017;2017;03;21;Keskiviikko;0;0;0
94;22.03.2017;2017;03;22;Keskiviikko;0;1;1
94;22.03.2017;2017;03;23;Keskiviikko;0;0;0
94;23.03.2017;2017;03;00;Torstai;0;0;0
94;23.03.2017;2017;03;01;Torstai;0;0;0
94;23.03.2017;2017;03;02;Torstai;0;0;0
94;23.03.2017;2017;03;03;Torstai;0;0;0
94;23.03.2017;2017;03;04;Torstai;0;0;0
94;23.03.2017;2017;03;05;Torstai;0;1;1
94;23.03.2017;2017;03;06;Torstai;1;0;1
94;23.03.2017;2017;03;07;Torstai;9;0;9
94;23.03.2017;2017;03;08;Torstai;1;0;1
94;23.03.2017;2017;03;09;Torstai;0;0;0
94;23.03.2017;2017;03;10;Torstai;1;0;1
94;23.03.2017;2017;03;11;Torstai;0;1;1
94;23.03.2017;2017;03;12;Torstai;0;0;0
94;23.03.2017;2017;03;13;Torstai;0;0;0
94;23.03.2017;2017;03;14;Torstai;0;5;5
94;23.03.2017;2017;03;15;Torstai;1;3;4
94;23.03.2017;2017;03;16;Torstai;0;11;11
94;23.03.2017;2017;03;17;Torstai;0;5;5
94;23.03.2017;2017;03;18;Torstai;0;4;4
94;23.03.2017;2017;03;19;Torstai;0;0;0
94;23.03.2017;2017;03;20;Torstai;0;2;2
94;23.03.2017;2017;03;21;Torstai;0;0;0
94;23.03.2017;2017;03;22;Torstai;0;0;0
94;23.03.2017;2017;03;23;Torstai;0;0;0
94;24.03.2017;2017;03;00;Perjantai;0;0;0
94;24.03.2017;2017;03;01;Perjantai;0;1;1
94;24.03.2017;2017;03;02;Perjantai;0;0;0
94;24.03.2017;2017;03;03;Perjantai;0;0;0
94;24.03.2017;2017;03;04;Perjantai;0;0;0
94;24.03.2017;2017;03;05;Perjantai;1;1;2
94;24.03.2017;2017;03;06;Perjantai;3;1;4
94;24.03.2017;2017;03;07;Perjantai;2;0;2
94;24.03.2017;2017;03;08;Perjantai;2;0;2
94;24.03.2017;2017;03;09;Perjantai;0;0;0
94;24.03.2017;2017;03;10;Perjantai;0;0;0
94;24.03.2017;2017;03;11;Perjantai;0;1;1
94;24.03.2017;2017;03;12;Perjantai;0;1;1
94;24.03.2017;2017;03;13;Perjantai;0;1;1
94;24.03.2017;2017;03;14;Perjantai;0;5;5
94;24.03.2017;2017;03;15;Perjantai;1;2;3
94;24.03.2017;2017;03;16;Perjantai;0;8;8
94;24.03.2017;2017;03;17;Perjantai;0;1;1
94;24.03.2017;2017;03;18;Perjantai;1;1;2
94;24.03.2017;2017;03;19;Perjantai;2;2;4
94;24.03.2017;2017;03;20;Perjantai;0;2;2
94;24.03.2017;2017;03;21;Perjantai;0;2;2
94;24.03.2017;2017;03;22;Perjantai;0;0;0
94;24.03.2017;2017;03;23;Perjantai;0;0;0
94;25.03.2017;2017;03;00;Lauantai;0;0;0
94;25.03.2017;2017;03;01;Lauantai;0;0;0
94;25.03.2017;2017;03;02;Lauantai;0;0;0
94;25.03.2017;2017;03;03;Lauantai;0;0;0
94;25.03.2017;2017;03;04;Lauantai;0;0;0
94;25.03.2017;2017;03;05;Lauantai;1;1;2
94;25.03.2017;2017;03;06;Lauantai;0;0;0
94;25.03.2017;2017;03;07;Lauantai;0;0;0
94;25.03.2017;2017;03;08;Lauantai;0;0;0
94;25.03.2017;2017;03;09;Lauantai;0;0;0
94;25.03.2017;2017;03;10;Lauantai;2;0;2
94;25.03.2017;2017;03;11;Lauantai;1;2;3
94;25.03.2017;2017;03;12;Lauantai;1;0;1
94;25.03.2017;2017;03;13;Lauantai;1;2;3
94;25.03.2017;2017;03;14;Lauantai;0;1;1
94;25.03.2017;2017;03;15;Lauantai;2;0;2
94;25.03.2017;2017;03;16;Lauantai;0;1;1
94;25.03.2017;2017;03;17;Lauantai;0;0;0
94;25.03.2017;2017;03;18;Lauantai;0;1;1
94;25.03.2017;2017;03;19;Lauantai;0;0;0
94;25.03.2017;2017;03;20;Lauantai;0;0;0
94;25.03.2017;2017;03;21;Lauantai;1;1;2
94;25.03.2017;2017;03;22;Lauantai;0;0;0
94;25.03.2017;2017;03;23;Lauantai;0;0;0
94;26.03.2017;2017;03;00;Sunnuntai;0;0;0
94;26.03.2017;2017;03;01;Sunnuntai;0;0;0
94;26.03.2017;2017;03;02;Sunnuntai;0;0;0
94;26.03.2017;2017;03;03;Sunnuntai;0;0;0
94;26.03.2017;2017;03;04;Sunnuntai;1;0;1
94;26.03.2017;2017;03;05;Sunnuntai;0;0;0
94;26.03.2017;2017;03;06;Sunnuntai;0;0;0
94;26.03.2017;2017;03;07;Sunnuntai;0;0;0
94;26.03.2017;2017;03;08;Sunnuntai;0;0;0
94;26.03.2017;2017;03;09;Sunnuntai;1;0;1
94;26.03.2017;2017;03;10;Sunnuntai;0;0;0
94;26.03.2017;2017;03;11;Sunnuntai;2;0;2
94;26.03.2017;2017;03;12;Sunnuntai;1;0;1
94;26.03.2017;2017;03;13;Sunnuntai;0;0;0
94;26.03.2017;2017;03;14;Sunnuntai;1;1;2
94;26.03.2017;2017;03;15;Sunnuntai;0;0;0
94;26.03.2017;2017;03;16;Sunnuntai;0;1;1
94;26.03.2017;2017;03;17;Sunnuntai;1;0;1
94;26.03.2017;2017;03;18;Sunnuntai;0;0;0
94;26.03.2017;2017;03;19;Sunnuntai;0;0;0
94;26.03.2017;2017;03;20;Sunnuntai;0;1;1
94;26.03.2017;2017;03;21;Sunnuntai;0;0;0
94;26.03.2017;2017;03;22;Sunnuntai;0;2;2
94;26.03.2017;2017;03;23;Sunnuntai;0;0;0
94;27.03.2017;2017;03;00;Maanantai;0;0;0
94;27.03.2017;2017;03;01;Maanantai;0;0;0
94;27.03.2017;2017;03;02;Maanantai;0;0;0
94;27.03.2017;2017;03;03;Maanantai;0;0;0
94;27.03.2017;2017;03;04;Maanantai;1;0;1
94;27.03.2017;2017;03;05;Maanantai;2;1;3
94;27.03.2017;2017;03;06;Maanantai;2;0;2
94;27.03.2017;2017;03;07;Maanantai;2;1;3
94;27.03.2017;2017;03;08;Maanantai;6;0;6
94;27.03.2017;2017;03;09;Maanantai;1;0;1
94;27.03.2017;2017;03;10;Maanantai;0;1;1
94;27.03.2017;2017;03;11;Maanantai;0;2;2
94;27.03.2017;2017;03;12;Maanantai;1;0;1
94;27.03.2017;2017;03;13;Maanantai;1;0;1
94;27.03.2017;2017;03;14;Maanantai;2;5;7
94;27.03.2017;2017;03;15;Maanantai;2;5;7
94;27.03.2017;2017;03;16;Maanantai;0;2;2
94;27.03.2017;2017;03;17;Maanantai;0;7;7
94;27.03.2017;2017;03;18;Maanantai;1;1;2
94;27.03.2017;2017;03;19;Maanantai;0;0;0
94;27.03.2017;2017;03;20;Maanantai;0;0;0
94;27.03.2017;2017;03;21;Maanantai;0;1;1
94;27.03.2017;2017;03;22;Maanantai;0;0;0
94;27.03.2017;2017;03;23;Maanantai;0;0;0
94;28.03.2017;2017;03;00;Tiistai;0;0;0
94;28.03.2017;2017;03;01;Tiistai;0;0;0
94;28.03.2017;2017;03;02;Tiistai;0;0;0
94;28.03.2017;2017;03;03;Tiistai;0;0;0
94;28.03.2017;2017;03;04;Tiistai;0;0;0
94;28.03.2017;2017;03;05;Tiistai;1;2;3
94;28.03.2017;2017;03;06;Tiistai;2;0;2
94;28.03.2017;2017;03;07;Tiistai;2;0;2
94;28.03.2017;2017;03;08;Tiistai;1;0;1
94;28.03.2017;2017;03;09;Tiistai;0;6;6
94;28.03.2017;2017;03;10;Tiistai;1;0;1
94;28.03.2017;2017;03;11;Tiistai;1;0;1
94;28.03.2017;2017;03;12;Tiistai;4;1;5
94;28.03.2017;2017;03;13;Tiistai;0;0;0
94;28.03.2017;2017;03;14;Tiistai;0;5;5
94;28.03.2017;2017;03;15;Tiistai;2;6;8
94;28.03.2017;2017;03;16;Tiistai;0;13;13
94;28.03.2017;2017;03;17;Tiistai;1;5;6
94;28.03.2017;2017;03;18;Tiistai;0;4;4
94;28.03.2017;2017;03;19;Tiistai;2;0;2
94;28.03.2017;2017;03;20;Tiistai;2;2;4
94;28.03.2017;2017;03;21;Tiistai;0;1;1
94;28.03.2017;2017;03;22;Tiistai;0;2;2
94;28.03.2017;2017;03;23;Tiistai;0;0;0
94;29.03.2017;2017;03;00;Keskiviikko;0;0;0
94;29.03.2017;2017;03;01;Keskiviikko;0;1;1
94;29.03.2017;2017;03;02;Keskiviikko;0;0;0
94;29.03.2017;2017;03;03;Keskiviikko;0;0;0
94;29.03.2017;2017;03;04;Keskiviikko;0;0;0
94;29.03.2017;2017;03;05;Keskiviikko;4;2;6
94;29.03.2017;2017;03;06;Keskiviikko;1;2;3
94;29.03.2017;2017;03;07;Keskiviikko;9;0;9
94;29.03.2017;2017;03;08;Keskiviikko;3;0;3
94;29.03.2017;2017;03;09;Keskiviikko;1;0;1
94;29.03.2017;2017;03;10;Keskiviikko;2;0;2
94;29.03.2017;2017;03;11;Keskiviikko;0;0;0
94;29.03.2017;2017;03;12;Keskiviikko;0;0;0
94;29.03.2017;2017;03;13;Keskiviikko;1;0;1
94;29.03.2017;2017;03;14;Keskiviikko;1;3;4
94;29.03.2017;2017;03;15;Keskiviikko;2;4;6
94;29.03.2017;2017;03;16;Keskiviikko;1;4;5
94;29.03.2017;2017;03;17;Keskiviikko;0;5;5
94;29.03.2017;2017;03;18;Keskiviikko;0;1;1
94;29.03.2017;2017;03;19;Keskiviikko;1;3;4
94;29.03.2017;2017;03;20;Keskiviikko;0;1;1
94;29.03.2017;2017;03;21;Keskiviikko;0;1;1
94;29.03.2017;2017;03;22;Keskiviikko;0;0;0
94;29.03.2017;2017;03;23;Keskiviikko;0;0;0
94;30.03.2017;2017;03;00;Torstai;0;1;1
94;30.03.2017;2017;03;01;Torstai;0;0;0
94;30.03.2017;2017;03;02;Torstai;0;0;0
94;30.03.2017;2017;03;03;Torstai;0;0;0
94;30.03.2017;2017;03;04;Torstai;0;0;0
94;30.03.2017;2017;03;05;Torstai;2;1;3
94;30.03.2017;2017;03;06;Torstai;4;0;4
94;30.03.2017;2017;03;07;Torstai;7;0;7
94;30.03.2017;2017;03;08;Torstai;3;0;3
94;30.03.2017;2017;03;09;Torstai;1;0;1
94;30.03.2017;2017;03;10;Torstai;1;1;2
94;30.03.2017;2017;03;11;Torstai;1;0;1
94;30.03.2017;2017;03;12;Torstai;3;3;6
94;30.03.2017;2017;03;13;Torstai;0;0;0
94;30.03.2017;2017;03;14;Torstai;0;2;2
94;30.03.2017;2017;03;15;Torstai;1;8;9
94;30.03.2017;2017;03;16;Torstai;0;3;3
94;30.03.2017;2017;03;17;Torstai;1;3;4
94;30.03.2017;2017;03;18;Torstai;0;2;2
94;30.03.2017;2017;03;19;Torstai;0;2;2
94;30.03.2017;2017;03;20;Torstai;1;1;2
94;30.03.2017;2017;03;21;Torstai;0;0;0
94;30.03.2017;2017;03;22;Torstai;1;0;1
94;30.03.2017;2017;03;23;Torstai;0;0;0
94;31.03.2017;2017;03;00;Perjantai;0;1;1
94;31.03.2017;2017;03;01;Perjantai;0;0;0
94;31.03.2017;2017;03;02;Perjantai;0;0;0
94;31.03.2017;2017;03;03;Perjantai;0;0;0
94;31.03.2017;2017;03;04;Perjantai;1;0;1
94;31.03.2017;2017;03;05;Perjantai;1;1;2
94;31.03.2017;2017;03;06;Perjantai;2;0;2
94;31.03.2017;2017;03;07;Perjantai;10;0;10
94;31.03.2017;2017;03;08;Perjantai;2;0;2
94;31.03.2017;2017;03;09;Perjantai;0;2;2
94;31.03.2017;2017;03;10;Perjantai;1;0;1
94;31.03.2017;2017;03;11;Perjantai;1;1;2
94;31.03.2017;2017;03;12;Perjantai;2;3;5
94;31.03.2017;2017;03;13;Perjantai;2;1;3
94;31.03.2017;2017;03;14;Perjantai;1;5;6
94;31.03.2017;2017;03;15;Perjantai;0;3;3
94;31.03.2017;2017;03;16;Perjantai;2;5;7
94;31.03.2017;2017;03;17;Perjantai;3;3;6
94;31.03.2017;2017;03;18;Perjantai;1;4;5
94;31.03.2017;2017;03;19;Perjantai;0;0;0
94;31.03.2017;2017;03;20;Perjantai;0;0;0
94;31.03.2017;2017;03;21;Perjantai;0;3;3
94;31.03.2017;2017;03;22;Perjantai;0;1;1
94;31.03.2017;2017;03;23;Perjantai;0;0;0
94;01.04.2017;2017;04;00;Lauantai;0;0;0
94;01.04.2017;2017;04;01;Lauantai;0;0;0
94;01.04.2017;2017;04;02;Lauantai;0;0;0
94;01.04.2017;2017;04;03;Lauantai;0;0;0
94;01.04.2017;2017;04;04;Lauantai;1;1;2
94;01.04.2017;2017;04;05;Lauantai;0;1;1
94;01.04.2017;2017;04;06;Lauantai;0;0;0
94;01.04.2017;2017;04;07;Lauantai;0;0;0
94;01.04.2017;2017;04;08;Lauantai;0;0;0
94;01.04.2017;2017;04;09;Lauantai;0;1;1
94;01.04.2017;2017;04;10;Lauantai;1;0;1
94;01.04.2017;2017;04;11;Lauantai;0;0;0
94;01.04.2017;2017;04;12;Lauantai;1;0;1
94;01.04.2017;2017;04;13;Lauantai;2;0;2
94;01.04.2017;2017;04;14;Lauantai;1;2;3
94;01.04.2017;2017;04;15;Lauantai;0;2;2
94;01.04.2017;2017;04;16;Lauantai;0;1;1
94;01.04.2017;2017;04;17;Lauantai;0;0;0
94;01.04.2017;2017;04;18;Lauantai;0;0;0
94;01.04.2017;2017;04;19;Lauantai;0;0;0
94;01.04.2017;2017;04;20;Lauantai;0;1;1
94;01.04.2017;2017;04;21;Lauantai;0;0;0
94;01.04.2017;2017;04;22;Lauantai;0;0;0
94;01.04.2017;2017;04;23;Lauantai;0;1;1
94;02.04.2017;2017;04;00;Sunnuntai;0;0;0
94;02.04.2017;2017;04;01;Sunnuntai;0;0;0
94;02.04.2017;2017;04;02;Sunnuntai;0;0;0
94;02.04.2017;2017;04;03;Sunnuntai;0;0;0
94;02.04.2017;2017;04;04;Sunnuntai;0;0;0
94;02.04.2017;2017;04;05;Sunnuntai;0;0;0
94;02.04.2017;2017;04;06;Sunnuntai;0;0;0
94;02.04.2017;2017;04;07;Sunnuntai;1;1;2
94;02.04.2017;2017;04;08;Sunnuntai;0;0;0
94;02.04.2017;2017;04;09;Sunnuntai;0;1;1
94;02.04.2017;2017;04;10;Sunnuntai;0;0;0
94;02.04.2017;2017;04;11;Sunnuntai;2;1;3
94;02.04.2017;2017;04;12;Sunnuntai;2;0;2
94;02.04.2017;2017;04;13;Sunnuntai;2;0;2
94;02.04.2017;2017;04;14;Sunnuntai;1;0;1
94;02.04.2017;2017;04;15;Sunnuntai;1;2;3
94;02.04.2017;2017;04;16;Sunnuntai;1;1;2
94;02.04.2017;2017;04;17;Sunnuntai;0;2;2
94;02.04.2017;2017;04;18;Sunnuntai;1;2;3
94;02.04.2017;2017;04;19;Sunnuntai;1;2;3
94;02.04.2017;2017;04;20;Sunnuntai;2;0;2
94;02.04.2017;2017;04;21;Sunnuntai;0;0;0
94;02.04.2017;2017;04;22;Sunnuntai;0;1;1
94;02.04.2017;2017;04;23;Sunnuntai;0;0;0
94;03.04.2017;2017;04;00;Maanantai;0;0;0
94;03.04.2017;2017;04;01;Maanantai;0;0;0
94;03.04.2017;2017;04;02;Maanantai;0;0;0
94;03.04.2017;2017;04;03;Maanantai;0;0;0
94;03.04.2017;2017;04;04;Maanantai;0;0;0
94;03.04.2017;2017;04;05;Maanantai;3;1;4
94;03.04.2017;2017;04;06;Maanantai;7;0;7
94;03.04.2017;2017;04;07;Maanantai;10;0;10
94;03.04.2017;2017;04;08;Maanantai;8;0;8
94;03.04.2017;2017;04;09;Maanantai;3;1;4
94;03.04.2017;2017;04;10;Maanantai;0;1;1
94;03.04.2017;2017;04;11;Maanantai;2;0;2
94;03.04.2017;2017;04;12;Maanantai;0;0;0
94;03.04.2017;2017;04;13;Maanantai;1;4;5
94;03.04.2017;2017;04;14;Maanantai;3;2;5
94;03.04.2017;2017;04;15;Maanantai;0;8;8
94;03.04.2017;2017;04;16;Maanantai;1;6;7
94;03.04.2017;2017;04;17;Maanantai;2;6;8
94;03.04.2017;2017;04;18;Maanantai;0;5;5
94;03.04.2017;2017;04;19;Maanantai;2;2;4
94;03.04.2017;2017;04;20;Maanantai;0;1;1
94;03.04.2017;2017;04;21;Maanantai;0;0;0
94;03.04.2017;2017;04;22;Maanantai;0;0;0
94;03.04.2017;2017;04;23;Maanantai;0;0;0
94;04.04.2017;2017;04;00;Tiistai;0;0;0
94;04.04.2017;2017;04;01;Tiistai;0;0;0
94;04.04.2017;2017;04;02;Tiistai;0;0;0
94;04.04.2017;2017;04;03;Tiistai;0;0;0
94;04.04.2017;2017;04;04;Tiistai;0;0;0
94;04.04.2017;2017;04;05;Tiistai;2;1;3
94;04.04.2017;2017;04;06;Tiistai;4;0;4
94;04.04.2017;2017;04;07;Tiistai;10;0;10
94;04.04.2017;2017;04;08;Tiistai;9;0;9
94;04.04.2017;2017;04;09;Tiistai;1;1;2
94;04.04.2017;2017;04;10;Tiistai;2;1;3
94;04.04.2017;2017;04;11;Tiistai;1;0;1
94;04.04.2017;2017;04;12;Tiistai;0;0;0
94;04.04.2017;2017;04;13;Tiistai;0;2;2
94;04.04.2017;2017;04;14;Tiistai;1;4;5
94;04.04.2017;2017;04;15;Tiistai;2;8;10
94;04.04.2017;2017;04;16;Tiistai;3;15;18
94;04.04.2017;2017;04;17;Tiistai;1;6;7
94;04.04.2017;2017;04;18;Tiistai;4;6;10
94;04.04.2017;2017;04;19;Tiistai;2;2;4
94;04.04.2017;2017;04;20;Tiistai;0;1;1
94;04.04.2017;2017;04;21;Tiistai;0;0;0
94;04.04.2017;2017;04;22;Tiistai;0;1;1
94;04.04.2017;2017;04;23;Tiistai;0;0;0
94;05.04.2017;2017;04;00;Keskiviikko;0;0;0
94;05.04.2017;2017;04;01;Keskiviikko;0;0;0
94;05.04.2017;2017;04;02;Keskiviikko;0;0;0
94;05.04.2017;2017;04;03;Keskiviikko;0;0;0
94;05.04.2017;2017;04;04;Keskiviikko;0;0;0
94;05.04.2017;2017;04;05;Keskiviikko;2;1;3
94;05.04.2017;2017;04;06;Keskiviikko;6;0;6
94;05.04.2017;2017;04;07;Keskiviikko;11;0;11
94;05.04.2017;2017;04;08;Keskiviikko;8;1;9
94;05.04.2017;2017;04;09;Keskiviikko;1;0;1
94;05.04.2017;2017;04;10;Keskiviikko;4;1;5
94;05.04.2017;2017;04;11;Keskiviikko;1;0;1
94;05.04.2017;2017;04;12;Keskiviikko;2;2;4
94;05.04.2017;2017;04;13;Keskiviikko;2;4;6
94;05.04.2017;2017;04;14;Keskiviikko;4;8;12
94;05.04.2017;2017;04;15;Keskiviikko;1;9;10
94;05.04.2017;2017;04;16;Keskiviikko;2;5;7
94;05.04.2017;2017;04;17;Keskiviikko;3;10;13
94;05.04.2017;2017;04;18;Keskiviikko;3;6;9
94;05.04.2017;2017;04;19;Keskiviikko;0;3;3
94;05.04.2017;2017;04;20;Keskiviikko;0;5;5
94;05.04.2017;2017;04;21;Keskiviikko;0;2;2
94;05.04.2017;2017;04;22;Keskiviikko;0;0;0
94;05.04.2017;2017;04;23;Keskiviikko;0;0;0
94;06.04.2017;2017;04;00;Torstai;0;0;0
94;06.04.2017;2017;04;01;Torstai;0;1;1
94;06.04.2017;2017;04;02;Torstai;0;0;0
94;06.04.2017;2017;04;03;Torstai;0;0;0
94;06.04.2017;2017;04;04;Torstai;0;0;0
94;06.04.2017;2017;04;05;Torstai;3;1;4
94;06.04.2017;2017;04;06;Torstai;3;0;3
94;06.04.2017;2017;04;07;Torstai;16;5;21
94;06.04.2017;2017;04;08;Torstai;4;0;4
94;06.04.2017;2017;04;09;Torstai;2;4;6
94;06.04.2017;2017;04;10;Torstai;2;0;2
94;06.04.2017;2017;04;11;Torstai;3;0;3
94;06.04.2017;2017;04;12;Torstai;0;0;0
94;06.04.2017;2017;04;13;Torstai;3;2;5
94;06.04.2017;2017;04;14;Torstai;2;9;11
94;06.04.2017;2017;04;15;Torstai;2;7;9
94;06.04.2017;2017;04;16;Torstai;0;8;8
94;06.04.2017;2017;04;17;Torstai;4;7;11
94;06.04.2017;2017;04;18;Torstai;4;6;10
94;06.04.2017;2017;04;19;Torstai;4;5;9
94;06.04.2017;2017;04;20;Torstai;2;1;3
94;06.04.2017;2017;04;21;Torstai;0;1;1
94;06.04.2017;2017;04;22;Torstai;1;2;3
94;06.04.2017;2017;04;23;Torstai;0;0;0
94;07.04.2017;2017;04;00;Perjantai;0;0;0
94;07.04.2017;2017;04;01;Perjantai;0;0;0
94;07.04.2017;2017;04;02;Perjantai;0;2;2
94;07.04.2017;2017;04;03;Perjantai;0;0;0
94;07.04.2017;2017;04;04;Perjantai;1;0;1
94;07.04.2017;2017;04;05;Perjantai;3;1;4
94;07.04.2017;2017;04;06;Perjantai;2;0;2
94;07.04.2017;2017;04;07;Perjantai;12;1;13
94;07.04.2017;2017;04;08;Perjantai;4;0;4
94;07.04.2017;2017;04;09;Perjantai;2;1;3
94;07.04.2017;2017;04;10;Perjantai;2;0;2
94;07.04.2017;2017;04;11;Perjantai;0;1;1
94;07.04.2017;2017;04;12;Perjantai;0;4;4
94;07.04.2017;2017;04;13;Perjantai;3;4;7
94;07.04.2017;2017;04;14;Perjantai;4;3;7
94;07.04.2017;2017;04;15;Perjantai;1;5;6
94;07.04.2017;2017;04;16;Perjantai;1;8;9
94;07.04.2017;2017;04;17;Perjantai;1;5;6
94;07.04.2017;2017;04;18;Perjantai;0;0;0
94;07.04.2017;2017;04;19;Perjantai;1;3;4
94;07.04.2017;2017;04;20;Perjantai;1;3;4
94;07.04.2017;2017;04;21;Perjantai;0;3;3
94;07.04.2017;2017;04;22;Perjantai;0;0;0
94;07.04.2017;2017;04;23;Perjantai;0;0;0
94;08.04.2017;2017;04;00;Lauantai;0;0;0
94;08.04.2017;2017;04;01;Lauantai;0;0;0
94;08.04.2017;2017;04;02;Lauantai;0;0;0
94;08.04.2017;2017;04;03;Lauantai;0;0;0
94;08.04.2017;2017;04;04;Lauantai;0;0;0
94;08.04.2017;2017;04;05;Lauantai;0;0;0
94;08.04.2017;2017;04;06;Lauantai;0;0;0
94;08.04.2017;2017;04;07;Lauantai;0;0;0
94;08.04.2017;2017;04;08;Lauantai;0;0;0
94;08.04.2017;2017;04;09;Lauantai;1;0;1
94;08.04.2017;2017;04;10;Lauantai;1;0;1
94;08.04.2017;2017;04;11;Lauantai;1;1;2
94;08.04.2017;2017;04;12;Lauantai;1;0;1
94;08.04.2017;2017;04;13;Lauantai;1;3;4
94;08.04.2017;2017;04;14;Lauantai;2;0;2
94;08.04.2017;2017;04;15;Lauantai;2;7;9
94;08.04.2017;2017;04;16;Lauantai;3;0;3
94;08.04.2017;2017;04;17;Lauantai;5;3;8
94;08.04.2017;2017;04;18;Lauantai;3;3;6
94;08.04.2017;2017;04;19;Lauantai;0;1;1
94;08.04.2017;2017;04;20;Lauantai;0;1;1
94;08.04.2017;2017;04;21;Lauantai;1;0;1
94;08.04.2017;2017;04;22;Lauantai;0;1;1
94;08.04.2017;2017;04;23;Lauantai;0;0;0
94;09.04.2017;2017;04;00;Sunnuntai;0;0;0
94;09.04.2017;2017;04;01;Sunnuntai;0;0;0
94;09.04.2017;2017;04;02;Sunnuntai;0;0;0
94;09.04.2017;2017;04;03;Sunnuntai;0;0;0
94;09.04.2017;2017;04;04;Sunnuntai;0;0;0
94;09.04.2017;2017;04;05;Sunnuntai;0;0;0
94;09.04.2017;2017;04;06;Sunnuntai;0;0;0
94;09.04.2017;2017;04;07;Sunnuntai;0;0;0
94;09.04.2017;2017;04;08;Sunnuntai;0;1;1
94;09.04.2017;2017;04;09;Sunnuntai;2;2;4
94;09.04.2017;2017;04;10;Sunnuntai;2;0;2
94;09.04.2017;2017;04;11;Sunnuntai;0;1;1
94;09.04.2017;2017;04;12;Sunnuntai;1;5;6
94;09.04.2017;2017;04;13;Sunnuntai;1;0;1
94;09.04.2017;2017;04;14;Sunnuntai;0;0;0
94;09.04.2017;2017;04;15;Sunnuntai;1;1;2
94;09.04.2017;2017;04;16;Sunnuntai;0;1;1
94;09.04.2017;2017;04;17;Sunnuntai;3;4;7
94;09.04.2017;2017;04;18;Sunnuntai;1;1;2
94;09.04.2017;2017;04;19;Sunnuntai;4;1;5
94;09.04.2017;2017;04;20;Sunnuntai;0;1;1
94;09.04.2017;2017;04;21;Sunnuntai;0;0;0
94;09.04.2017;2017;04;22;Sunnuntai;0;0;0
94;09.04.2017;2017;04;23;Sunnuntai;0;0;0
94;10.04.2017;2017;04;00;Maanantai;0;0;0
94;10.04.2017;2017;04;01;Maanantai;0;0;0
94;10.04.2017;2017;04;02;Maanantai;0;0;0
94;10.04.2017;2017;04;03;Maanantai;0;0;0
94;10.04.2017;2017;04;04;Maanantai;0;0;0
94;10.04.2017;2017;04;05;Maanantai;2;1;3
94;10.04.2017;2017;04;06;Maanantai;4;0;4
94;10.04.2017;2017;04;07;Maanantai;10;3;13
94;10.04.2017;2017;04;08;Maanantai;8;1;9
94;10.04.2017;2017;04;09;Maanantai;4;2;6
94;10.04.2017;2017;04;10;Maanantai;2;0;2
94;10.04.2017;2017;04;11;Maanantai;0;0;0
94;10.04.2017;2017;04;12;Maanantai;1;0;1
94;10.04.2017;2017;04;13;Maanantai;2;2;4
94;10.04.2017;2017;04;14;Maanantai;1;2;3
94;10.04.2017;2017;04;15;Maanantai;1;6;7
94;10.04.2017;2017;04;16;Maanantai;2;9;11
94;10.04.2017;2017;04;17;Maanantai;3;5;8
94;10.04.2017;2017;04;18;Maanantai;2;2;4
94;10.04.2017;2017;04;19;Maanantai;0;1;1
94;10.04.2017;2017;04;20;Maanantai;0;4;4
94;10.04.2017;2017;04;21;Maanantai;0;0;0
94;10.04.2017;2017;04;22;Maanantai;0;0;0
94;10.04.2017;2017;04;23;Maanantai;0;0;0
94;11.04.2017;2017;04;00;Tiistai;0;0;0
94;11.04.2017;2017;04;01;Tiistai;0;0;0
94;11.04.2017;2017;04;02;Tiistai;0;0;0
94;11.04.2017;2017;04;03;Tiistai;1;0;1
94;11.04.2017;2017;04;04;Tiistai;0;0;0
94;11.04.2017;2017;04;05;Tiistai;1;2;3
94;11.04.2017;2017;04;06;Tiistai;1;0;1
94;11.04.2017;2017;04;07;Tiistai;8;0;8
94;11.04.2017;2017;04;08;Tiistai;5;1;6
94;11.04.2017;2017;04;09;Tiistai;2;0;2
94;11.04.2017;2017;04;10;Tiistai;0;1;1
94;11.04.2017;2017;04;11;Tiistai;1;0;1
94;11.04.2017;2017;04;12;Tiistai;0;0;0
94;11.04.2017;2017;04;13;Tiistai;0;0;0
94;11.04.2017;2017;04;14;Tiistai;1;2;3
94;11.04.2017;2017;04;15;Tiistai;0;0;0
94;11.04.2017;2017;04;16;Tiistai;0;6;6
94;11.04.2017;2017;04;17;Tiistai;0;8;8
94;11.04.2017;2017;04;18;Tiistai;0;2;2
94;11.04.2017;2017;04;19;Tiistai;2;3;5
94;11.04.2017;2017;04;20;Tiistai;2;1;3
94;11.04.2017;2017;04;21;Tiistai;0;2;2
94;11.04.2017;2017;04;22;Tiistai;0;0;0
94;11.04.2017;2017;04;23;Tiistai;0;0;0
94;12.04.2017;2017;04;00;Keskiviikko;0;1;1
94;12.04.2017;2017;04;01;Keskiviikko;0;0;0
94;12.04.2017;2017;04;02;Keskiviikko;0;0;0
94;12.04.2017;2017;04;03;Keskiviikko;0;0;0
94;12.04.2017;2017;04;04;Keskiviikko;1;0;1
94;12.04.2017;2017;04;05;Keskiviikko;3;3;6
94;12.04.2017;2017;04;06;Keskiviikko;1;0;1
94;12.04.2017;2017;04;07;Keskiviikko;11;0;11
94;12.04.2017;2017;04;08;Keskiviikko;5;3;8
94;12.04.2017;2017;04;09;Keskiviikko;5;2;7
94;12.04.2017;2017;04;10;Keskiviikko;1;0;1
94;12.04.2017;2017;04;11;Keskiviikko;2;0;2
94;12.04.2017;2017;04;12;Keskiviikko;2;3;5
94;12.04.2017;2017;04;13;Keskiviikko;3;2;5
94;12.04.2017;2017;04;14;Keskiviikko;6;5;11
94;12.04.2017;2017;04;15;Keskiviikko;0;7;7
94;12.04.2017;2017;04;16;Keskiviikko;1;4;5
94;12.04.2017;2017;04;17;Keskiviikko;3;5;8
94;12.04.2017;2017;04;18;Keskiviikko;0;7;7
94;12.04.2017;2017;04;19;Keskiviikko;3;3;6
94;12.04.2017;2017;04;20;Keskiviikko;4;2;6
94;12.04.2017;2017;04;21;Keskiviikko;3;2;5
94;12.04.2017;2017;04;22;Keskiviikko;0;0;0
94;12.04.2017;2017;04;23;Keskiviikko;0;0;0
94;13.04.2017;2017;04;00;Torstai;0;0;0
94;13.04.2017;2017;04;01;Torstai;0;0;0
94;13.04.2017;2017;04;02;Torstai;0;0;0
94;13.04.2017;2017;04;03;Torstai;0;0;0
94;13.04.2017;2017;04;04;Torstai;0;0;0
94;13.04.2017;2017;04;05;Torstai;3;2;5
94;13.04.2017;2017;04;06;Torstai;5;0;5
94;13.04.2017;2017;04;07;Torstai;9;1;10
94;13.04.2017;2017;04;08;Torstai;1;1;2
94;13.04.2017;2017;04;09;Torstai;4;2;6
94;13.04.2017;2017;04;10;Torstai;2;4;6
94;13.04.2017;2017;04;11;Torstai;5;0;5
94;13.04.2017;2017;04;12;Torstai;1;2;3
94;13.04.2017;2017;04;13;Torstai;1;2;3
94;13.04.2017;2017;04;14;Torstai;2;4;6
94;13.04.2017;2017;04;15;Torstai;2;5;7
94;13.04.2017;2017;04;16;Torstai;0;10;10
94;13.04.2017;2017;04;17;Torstai;1;2;3
94;13.04.2017;2017;04;18;Torstai;0;2;2
94;13.04.2017;2017;04;19;Torstai;1;2;3
94;13.04.2017;2017;04;20;Torstai;2;2;4
94;13.04.2017;2017;04;21;Torstai;2;2;4
94;13.04.2017;2017;04;22;Torstai;0;1;1
94;13.04.2017;2017;04;23;Torstai;0;0;0
94;14.04.2017;2017;04;00;Perjantai;0;0;0
94;14.04.2017;2017;04;01;Perjantai;0;0;0
94;14.04.2017;2017;04;02;Perjantai;0;0;0
94;14.04.2017;2017;04;03;Perjantai;0;0;0
94;14.04.2017;2017;04;04;Perjantai;0;0;0
94;14.04.2017;2017;04;05;Perjantai;1;0;1
94;14.04.2017;2017;04;06;Perjantai;1;0;1
94;14.04.2017;2017;04;07;Perjantai;0;0;0
94;14.04.2017;2017;04;08;Perjantai;0;0;0
94;14.04.2017;2017;04;09;Perjantai;3;0;3
94;14.04.2017;2017;04;10;Perjantai;2;0;2
94;14.04.2017;2017;04;11;Perjantai;1;2;3
94;14.04.2017;2017;04;12;Perjantai;2;1;3
94;14.04.2017;2017;04;13;Perjantai;1;1;2
94;14.04.2017;2017;04;14;Perjantai;0;3;3
94;14.04.2017;2017;04;15;Perjantai;0;1;1
94;14.04.2017;2017;04;16;Perjantai;4;1;5
94;14.04.2017;2017;04;17;Perjantai;0;1;1
94;14.04.2017;2017;04;18;Perjantai;5;5;10
94;14.04.2017;2017;04;19;Perjantai;0;3;3
94;14.04.2017;2017;04;20;Perjantai;0;0;0
94;14.04.2017;2017;04;21;Perjantai;1;1;2
94;14.04.2017;2017;04;22;Perjantai;0;0;0
94;14.04.2017;2017;04;23;Perjantai;0;0;0
94;15.04.2017;2017;04;00;Lauantai;0;0;0
94;15.04.2017;2017;04;01;Lauantai;0;0;0
94;15.04.2017;2017;04;02;Lauantai;0;0;0
94;15.04.2017;2017;04;03;Lauantai;0;0;0
94;15.04.2017;2017;04;04;Lauantai;0;0;0
94;15.04.2017;2017;04;05;Lauantai;1;0;1
94;15.04.2017;2017;04;06;Lauantai;0;0;0
94;15.04.2017;2017;04;07;Lauantai;0;0;0
94;15.04.2017;2017;04;08;Lauantai;0;0;0
94;15.04.2017;2017;04;09;Lauantai;0;0;0
94;15.04.2017;2017;04;10;Lauantai;0;0;0
94;15.04.2017;2017;04;11;Lauantai;1;2;3
94;15.04.2017;2017;04;12;Lauantai;3;0;3
94;15.04.2017;2017;04;13;Lauantai;3;0;3
94;15.04.2017;2017;04;14;Lauantai;2;2;4
94;15.04.2017;2017;04;15;Lauantai;0;0;0
94;15.04.2017;2017;04;16;Lauantai;2;4;6
94;15.04.2017;2017;04;17;Lauantai;2;0;2
94;15.04.2017;2017;04;18;Lauantai;1;4;5
94;15.04.2017;2017;04;19;Lauantai;1;1;2
94;15.04.2017;2017;04;20;Lauantai;0;0;0
94;15.04.2017;2017;04;21;Lauantai;0;0;0
94;15.04.2017;2017;04;22;Lauantai;0;0;0
94;15.04.2017;2017;04;23;Lauantai;0;0;0
94;16.04.2017;2017;04;00;Sunnuntai;0;0;0
94;16.04.2017;2017;04;01;Sunnuntai;0;0;0
94;16.04.2017;2017;04;02;Sunnuntai;0;0;0
94;16.04.2017;2017;04;03;Sunnuntai;0;0;0
94;16.04.2017;2017;04;04;Sunnuntai;0;0;0
94;16.04.2017;2017;04;05;Sunnuntai;1;0;1
94;16.04.2017;2017;04;06;Sunnuntai;0;0;0
94;16.04.2017;2017;04;07;Sunnuntai;0;1;1
94;16.04.2017;2017;04;08;Sunnuntai;0;0;0
94;16.04.2017;2017;04;09;Sunnuntai;0;0;0
94;16.04.2017;2017;04;10;Sunnuntai;0;0;0
94;16.04.2017;2017;04;11;Sunnuntai;2;1;3
94;16.04.2017;2017;04;12;Sunnuntai;5;3;8
94;16.04.2017;2017;04;13;Sunnuntai;3;0;3
94;16.04.2017;2017;04;14;Sunnuntai;2;7;9
94;16.04.2017;2017;04;15;Sunnuntai;2;4;6
94;16.04.2017;2017;04;16;Sunnuntai;8;4;12
94;16.04.2017;2017;04;17;Sunnuntai;0;1;1
94;16.04.2017;2017;04;18;Sunnuntai;1;5;6
94;16.04.2017;2017;04;19;Sunnuntai;3;1;4
94;16.04.2017;2017;04;20;Sunnuntai;0;2;2
94;16.04.2017;2017;04;21;Sunnuntai;0;2;2
94;16.04.2017;2017;04;22;Sunnuntai;3;4;7
94;16.04.2017;2017;04;23;Sunnuntai;0;0;0
94;17.04.2017;2017;04;00;Maanantai;3;0;3
94;17.04.2017;2017;04;01;Maanantai;0;0;0
94;17.04.2017;2017;04;02;Maanantai;0;1;1
94;17.04.2017;2017;04;03;Maanantai;0;0;0
94;17.04.2017;2017;04;04;Maanantai;0;0;0
94;17.04.2017;2017;04;05;Maanantai;0;0;0
94;17.04.2017;2017;04;06;Maanantai;0;0;0
94;17.04.2017;2017;04;07;Maanantai;1;2;3
94;17.04.2017;2017;04;08;Maanantai;0;0;0
94;17.04.2017;2017;04;09;Maanantai;0;0;0
94;17.04.2017;2017;04;10;Maanantai;3;3;6
94;17.04.2017;2017;04;11;Maanantai;5;5;10
94;17.04.2017;2017;04;12;Maanantai;6;3;9
94;17.04.2017;2017;04;13;Maanantai;4;4;8
94;17.04.2017;2017;04;14;Maanantai;3;9;12
94;17.04.2017;2017;04;15;Maanantai;7;2;9
94;17.04.2017;2017;04;16;Maanantai;1;3;4
94;17.04.2017;2017;04;17;Maanantai;5;3;8
94;17.04.2017;2017;04;18;Maanantai;2;0;2
94;17.04.2017;2017;04;19;Maanantai;3;5;8
94;17.04.2017;2017;04;20;Maanantai;0;4;4
94;17.04.2017;2017;04;21;Maanantai;0;2;2
94;17.04.2017;2017;04;22;Maanantai;0;0;0
94;17.04.2017;2017;04;23;Maanantai;0;0;0
94;18.04.2017;2017;04;00;Tiistai;0;0;0
94;18.04.2017;2017;04;01;Tiistai;0;0;0
94;18.04.2017;2017;04;02;Tiistai;0;0;0
94;18.04.2017;2017;04;03;Tiistai;0;0;0
94;18.04.2017;2017;04;04;Tiistai;0;0;0
94;18.04.2017;2017;04;05;Tiistai;2;0;2
94;18.04.2017;2017;04;06;Tiistai;4;0;4
94;18.04.2017;2017;04;07;Tiistai;10;1;11
94;18.04.2017;2017;04;08;Tiistai;9;1;10
94;18.04.2017;2017;04;09;Tiistai;4;1;5
94;18.04.2017;2017;04;10;Tiistai;4;0;4
94;18.04.2017;2017;04;11;Tiistai;2;2;4
94;18.04.2017;2017;04;12;Tiistai;3;0;3
94;18.04.2017;2017;04;13;Tiistai;0;3;3
94;18.04.2017;2017;04;14;Tiistai;2;6;8
94;18.04.2017;2017;04;15;Tiistai;1;3;4
94;18.04.2017;2017;04;16;Tiistai;9;19;28
94;18.04.2017;2017;04;17;Tiistai;1;11;12
94;18.04.2017;2017;04;18;Tiistai;0;5;5
94;18.04.2017;2017;04;19;Tiistai;2;5;7
94;18.04.2017;2017;04;20;Tiistai;0;2;2
94;18.04.2017;2017;04;21;Tiistai;0;2;2
94;18.04.2017;2017;04;22;Tiistai;0;0;0
94;18.04.2017;2017;04;23;Tiistai;0;0;0
94;19.04.2017;2017;04;00;Keskiviikko;0;0;0
94;19.04.2017;2017;04;01;Keskiviikko;0;0;0
94;19.04.2017;2017;04;02;Keskiviikko;0;0;0
94;19.04.2017;2017;04;03;Keskiviikko;0;0;0
94;19.04.2017;2017;04;04;Keskiviikko;0;0;0
94;19.04.2017;2017;04;05;Keskiviikko;1;1;2
94;19.04.2017;2017;04;06;Keskiviikko;4;0;4
94;19.04.2017;2017;04;07;Keskiviikko;10;3;13
94;19.04.2017;2017;04;08;Keskiviikko;6;1;7
94;19.04.2017;2017;04;09;Keskiviikko;2;2;4
94;19.04.2017;2017;04;10;Keskiviikko;4;2;6
94;19.04.2017;2017;04;11;Keskiviikko;2;2;4
94;19.04.2017;2017;04;12;Keskiviikko;1;0;1
94;19.04.2017;2017;04;13;Keskiviikko;4;5;9
94;19.04.2017;2017;04;14;Keskiviikko;5;5;10
94;19.04.2017;2017;04;15;Keskiviikko;2;7;9
94;19.04.2017;2017;04;16;Keskiviikko;4;8;12
94;19.04.2017;2017;04;17;Keskiviikko;3;4;7
94;19.04.2017;2017;04;18;Keskiviikko;0;2;2
94;19.04.2017;2017;04;19;Keskiviikko;2;4;6
94;19.04.2017;2017;04;20;Keskiviikko;0;1;1
94;19.04.2017;2017;04;21;Keskiviikko;2;1;3
94;19.04.2017;2017;04;22;Keskiviikko;1;0;1
94;19.04.2017;2017;04;23;Keskiviikko;0;0;0
94;20.04.2017;2017;04;00;Torstai;0;0;0
94;20.04.2017;2017;04;01;Torstai;0;1;1
94;20.04.2017;2017;04;02;Torstai;0;0;0
94;20.04.2017;2017;04;03;Torstai;0;0;0
94;20.04.2017;2017;04;04;Torstai;0;0;0
94;20.04.2017;2017;04;05;Torstai;2;2;4
94;20.04.2017;2017;04;06;Torstai;4;1;5
94;20.04.2017;2017;04;07;Torstai;10;1;11
94;20.04.2017;2017;04;08;Torstai;5;1;6
94;20.04.2017;2017;04;09;Torstai;3;0;3
94;20.04.2017;2017;04;10;Torstai;4;1;5
94;20.04.2017;2017;04;11;Torstai;1;2;3
94;20.04.2017;2017;04;12;Torstai;1;4;5
94;20.04.2017;2017;04;13;Torstai;3;2;5
94;20.04.2017;2017;04;14;Torstai;2;2;4
94;20.04.2017;2017;04;15;Torstai;4;6;10
94;20.04.2017;2017;04;16;Torstai;2;5;7
94;20.04.2017;2017;04;17;Torstai;0;6;6
94;20.04.2017;2017;04;18;Torstai;0;4;4
94;20.04.2017;2017;04;19;Torstai;1;2;3
94;20.04.2017;2017;04;20;Torstai;1;3;4
94;20.04.2017;2017;04;21;Torstai;0;2;2
94;20.04.2017;2017;04;22;Torstai;0;0;0
94;20.04.2017;2017;04;23;Torstai;0;0;0
94;21.04.2017;2017;04;00;Perjantai;0;0;0
94;21.04.2017;2017;04;01;Perjantai;0;1;1
94;21.04.2017;2017;04;02;Perjantai;0;0;0
94;21.04.2017;2017;04;03;Perjantai;0;0;0
94;21.04.2017;2017;04;04;Perjantai;0;0;0
94;21.04.2017;2017;04;05;Perjantai;2;1;3
94;21.04.2017;2017;04;06;Perjantai;3;1;4
94;21.04.2017;2017;04;07;Perjantai;14;1;15
94;21.04.2017;2017;04;08;Perjantai;4;1;5
94;21.04.2017;2017;04;09;Perjantai;5;2;7
94;21.04.2017;2017;04;10;Perjantai;3;2;5
94;21.04.2017;2017;04;11;Perjantai;4;3;7
94;21.04.2017;2017;04;12;Perjantai;2;3;5
94;21.04.2017;2017;04;13;Perjantai;4;5;9
94;21.04.2017;2017;04;14;Perjantai;6;8;14
94;21.04.2017;2017;04;15;Perjantai;5;10;15
94;21.04.2017;2017;04;16;Perjantai;7;13;20
94;21.04.2017;2017;04;17;Perjantai;0;12;12
94;21.04.2017;2017;04;18;Perjantai;3;2;5
94;21.04.2017;2017;04;19;Perjantai;1;1;2
94;21.04.2017;2017;04;20;Perjantai;0;4;4
94;21.04.2017;2017;04;21;Perjantai;1;2;3
94;21.04.2017;2017;04;22;Perjantai;3;3;6
94;21.04.2017;2017;04;23;Perjantai;0;0;0
94;22.04.2017;2017;04;00;Lauantai;0;0;0
94;22.04.2017;2017;04;01;Lauantai;0;0;0
94;22.04.2017;2017;04;02;Lauantai;0;0;0
94;22.04.2017;2017;04;03;Lauantai;0;0;0
94;22.04.2017;2017;04;04;Lauantai;0;0;0
94;22.04.2017;2017;04;05;Lauantai;1;0;1
94;22.04.2017;2017;04;06;Lauantai;1;0;1
94;22.04.2017;2017;04;07;Lauantai;0;0;0
94;22.04.2017;2017;04;08;Lauantai;0;0;0
94;22.04.2017;2017;04;09;Lauantai;1;1;2
94;22.04.2017;2017;04;10;Lauantai;6;3;9
94;22.04.2017;2017;04;11;Lauantai;6;1;7
94;22.04.2017;2017;04;12;Lauantai;4;2;6
94;22.04.2017;2017;04;13;Lauantai;2;7;9
94;22.04.2017;2017;04;14;Lauantai;4;3;7
94;22.04.2017;2017;04;15;Lauantai;5;2;7
94;22.04.2017;2017;04;16;Lauantai;7;12;19
94;22.04.2017;2017;04;17;Lauantai;14;2;16
94;22.04.2017;2017;04;18;Lauantai;2;3;5
94;22.04.2017;2017;04;19;Lauantai;2;6;8
94;22.04.2017;2017;04;20;Lauantai;1;4;5
94;22.04.2017;2017;04;21;Lauantai;1;3;4
94;22.04.2017;2017;04;22;Lauantai;1;0;1
94;22.04.2017;2017;04;23;Lauantai;0;2;2
94;23.04.2017;2017;04;00;Sunnuntai;0;4;4
94;23.04.2017;2017;04;01;Sunnuntai;0;1;1
94;23.04.2017;2017;04;02;Sunnuntai;0;0;0
94;23.04.2017;2017;04;03;Sunnuntai;0;0;0
94;23.04.2017;2017;04;04;Sunnuntai;0;0;0
94;23.04.2017;2017;04;05;Sunnuntai;0;1;1
94;23.04.2017;2017;04;06;Sunnuntai;1;0;1
94;23.04.2017;2017;04;07;Sunnuntai;0;0;0
94;23.04.2017;2017;04;08;Sunnuntai;2;1;3
94;23.04.2017;2017;04;09;Sunnuntai;1;0;1
94;23.04.2017;2017;04;10;Sunnuntai;6;1;7
94;23.04.2017;2017;04;11;Sunnuntai;6;2;8
94;23.04.2017;2017;04;12;Sunnuntai;3;8;11
94;23.04.2017;2017;04;13;Sunnuntai;1;9;10
94;23.04.2017;2017;04;14;Sunnuntai;5;5;10
94;23.04.2017;2017;04;15;Sunnuntai;5;7;12
94;23.04.2017;2017;04;16;Sunnuntai;3;4;7
94;23.04.2017;2017;04;17;Sunnuntai;4;4;8
94;23.04.2017;2017;04;18;Sunnuntai;0;3;3
94;23.04.2017;2017;04;19;Sunnuntai;2;1;3
94;23.04.2017;2017;04;20;Sunnuntai;0;0;0
94;23.04.2017;2017;04;21;Sunnuntai;0;1;1
94;23.04.2017;2017;04;22;Sunnuntai;0;2;2
94;23.04.2017;2017;04;23;Sunnuntai;0;0;0
94;24.04.2017;2017;04;00;Maanantai;0;0;0
94;24.04.2017;2017;04;01;Maanantai;0;0;0
94;24.04.2017;2017;04;02;Maanantai;0;0;0
94;24.04.2017;2017;04;03;Maanantai;0;0;0
94;24.04.2017;2017;04;04;Maanantai;0;0;0
94;24.04.2017;2017;04;05;Maanantai;5;3;8
94;24.04.2017;2017;04;06;Maanantai;8;1;9
94;24.04.2017;2017;04;07;Maanantai;15;1;16
94;24.04.2017;2017;04;08;Maanantai;6;1;7
94;24.04.2017;2017;04;09;Maanantai;7;2;9
94;24.04.2017;2017;04;10;Maanantai;4;1;5
94;24.04.2017;2017;04;11;Maanantai;5;1;6
94;24.04.2017;2017;04;12;Maanantai;1;3;4
94;24.04.2017;2017;04;13;Maanantai;2;4;6
94;24.04.2017;2017;04;14;Maanantai;3;7;10
94;24.04.2017;2017;04;15;Maanantai;4;13;17
94;24.04.2017;2017;04;16;Maanantai;4;18;22
94;24.04.2017;2017;04;17;Maanantai;2;11;13
94;24.04.2017;2017;04;18;Maanantai;5;6;11
94;24.04.2017;2017;04;19;Maanantai;0;2;2
94;24.04.2017;2017;04;20;Maanantai;1;1;2
94;24.04.2017;2017;04;21;Maanantai;2;3;5
94;24.04.2017;2017;04;22;Maanantai;0;4;4
94;24.04.2017;2017;04;23;Maanantai;0;0;0
94;25.04.2017;2017;04;00;Tiistai;0;0;0
94;25.04.2017;2017;04;01;Tiistai;0;1;1
94;25.04.2017;2017;04;02;Tiistai;0;0;0
94;25.04.2017;2017;04;03;Tiistai;0;0;0
94;25.04.2017;2017;04;04;Tiistai;1;0;1
94;25.04.2017;2017;04;05;Tiistai;5;1;6
94;25.04.2017;2017;04;06;Tiistai;7;1;8
94;25.04.2017;2017;04;07;Tiistai;15;3;18
94;25.04.2017;2017;04;08;Tiistai;8;1;9
94;25.04.2017;2017;04;09;Tiistai;6;3;9
94;25.04.2017;2017;04;10;Tiistai;4;2;6
94;25.04.2017;2017;04;11;Tiistai;5;3;8
94;25.04.2017;2017;04;12;Tiistai;0;7;7
94;25.04.2017;2017;04;13;Tiistai;2;5;7
94;25.04.2017;2017;04;14;Tiistai;5;6;11
94;25.04.2017;2017;04;15;Tiistai;7;6;13
94;25.04.2017;2017;04;16;Tiistai;4;21;25
94;25.04.2017;2017;04;17;Tiistai;1;6;7
94;25.04.2017;2017;04;18;Tiistai;1;8;9
94;25.04.2017;2017;04;19;Tiistai;2;6;8
94;25.04.2017;2017;04;20;Tiistai;2;2;4
94;25.04.2017;2017;04;21;Tiistai;4;1;5
94;25.04.2017;2017;04;22;Tiistai;0;0;0
94;25.04.2017;2017;04;23;Tiistai;0;0;0
94;26.04.2017;2017;04;00;Keskiviikko;0;0;0
94;26.04.2017;2017;04;01;Keskiviikko;0;0;0
94;26.04.2017;2017;04;02;Keskiviikko;0;0;0
94;26.04.2017;2017;04;03;Keskiviikko;0;0;0
94;26.04.2017;2017;04;04;Keskiviikko;0;0;0
94;26.04.2017;2017;04;05;Keskiviikko;3;1;4
94;26.04.2017;2017;04;06;Keskiviikko;7;1;8
94;26.04.2017;2017;04;07;Keskiviikko;10;5;15
94;26.04.2017;2017;04;08;Keskiviikko;4;3;7
94;26.04.2017;2017;04;09;Keskiviikko;4;0;4
94;26.04.2017;2017;04;10;Keskiviikko;0;0;0
94;26.04.2017;2017;04;11;Keskiviikko;0;0;0
94;26.04.2017;2017;04;12;Keskiviikko;0;0;0
94;26.04.2017;2017;04;13;Keskiviikko;0;2;2
94;26.04.2017;2017;04;14;Keskiviikko;3;2;5
94;26.04.2017;2017;04;15;Keskiviikko;4;8;12
94;26.04.2017;2017;04;16;Keskiviikko;0;5;5
94;26.04.2017;2017;04;17;Keskiviikko;0;6;6
94;26.04.2017;2017;04;18;Keskiviikko;0;3;3
94;26.04.2017;2017;04;19;Keskiviikko;0;3;3
94;26.04.2017;2017;04;20;Keskiviikko;0;0;0
94;26.04.2017;2017;04;21;Keskiviikko;0;0;0
94;26.04.2017;2017;04;22;Keskiviikko;0;0;0
94;26.04.2017;2017;04;23;Keskiviikko;0;0;0
94;27.04.2017;2017;04;00;Torstai;0;0;0
94;27.04.2017;2017;04;01;Torstai;0;1;1
94;27.04.2017;2017;04;02;Torstai;0;0;0
94;27.04.2017;2017;04;03;Torstai;0;0;0
94;27.04.2017;2017;04;04;Torstai;0;0;0
94;27.04.2017;2017;04;05;Torstai;2;1;3
94;27.04.2017;2017;04;06;Torstai;2;2;4
94;27.04.2017;2017;04;07;Torstai;4;4;8
94;27.04.2017;2017;04;08;Torstai;4;0;4
94;27.04.2017;2017;04;09;Torstai;4;0;4
94;27.04.2017;2017;04;10;Torstai;1;3;4
94;27.04.2017;2017;04;11;Torstai;5;1;6
94;27.04.2017;2017;04;12;Torstai;2;2;4
94;27.04.2017;2017;04;13;Torstai;1;0;1
94;27.04.2017;2017;04;14;Torstai;2;4;6
94;27.04.2017;2017;04;15;Torstai;4;4;8
94;27.04.2017;2017;04;16;Torstai;2;8;10
94;27.04.2017;2017;04;17;Torstai;2;0;2
94;27.04.2017;2017;04;18;Torstai;3;2;5
94;27.04.2017;2017;04;19;Torstai;1;4;5
94;27.04.2017;2017;04;20;Torstai;6;1;7
94;27.04.2017;2017;04;21;Torstai;1;1;2
94;27.04.2017;2017;04;22;Torstai;0;0;0
94;27.04.2017;2017;04;23;Torstai;0;0;0
94;28.04.2017;2017;04;00;Perjantai;0;0;0
94;28.04.2017;2017;04;01;Perjantai;0;1;1
94;28.04.2017;2017;04;02;Perjantai;0;0;0
94;28.04.2017;2017;04;03;Perjantai;0;0;0
94;28.04.2017;2017;04;04;Perjantai;0;0;0
94;28.04.2017;2017;04;05;Perjantai;3;2;5
94;28.04.2017;2017;04;06;Perjantai;7;1;8
94;28.04.2017;2017;04;07;Perjantai;4;1;5
94;28.04.2017;2017;04;08;Perjantai;4;1;5
94;28.04.2017;2017;04;09;Perjantai;4;0;4
94;28.04.2017;2017;04;10;Perjantai;3;0;3
94;28.04.2017;2017;04;11;Perjantai;3;3;6
94;28.04.2017;2017;04;12;Perjantai;5;4;9
94;28.04.2017;2017;04;13;Perjantai;8;4;12
94;28.04.2017;2017;04;14;Perjantai;3;9;12
94;28.04.2017;2017;04;15;Perjantai;4;9;13
94;28.04.2017;2017;04;16;Perjantai;3;6;9
94;28.04.2017;2017;04;17;Perjantai;2;6;8
94;28.04.2017;2017;04;18;Perjantai;3;8;11
94;28.04.2017;2017;04;19;Perjantai;2;1;3
94;28.04.2017;2017;04;20;Perjantai;0;1;1
94;28.04.2017;2017;04;21;Perjantai;0;0;0
94;28.04.2017;2017;04;22;Perjantai;1;1;2
94;28.04.2017;2017;04;23;Perjantai;0;0;0
94;29.04.2017;2017;04;00;Lauantai;0;2;2
94;29.04.2017;2017;04;01;Lauantai;0;0;0
94;29.04.2017;2017;04;02;Lauantai;0;1;1
94;29.04.2017;2017;04;03;Lauantai;0;0;0
94;29.04.2017;2017;04;04;Lauantai;0;0;0
94;29.04.2017;2017;04;05;Lauantai;0;0;0
94;29.04.2017;2017;04;06;Lauantai;0;0;0
94;29.04.2017;2017;04;07;Lauantai;0;0;0
94;29.04.2017;2017;04;08;Lauantai;1;0;1
94;29.04.2017;2017;04;09;Lauantai;3;1;4
94;29.04.2017;2017;04;10;Lauantai;4;6;10
94;29.04.2017;2017;04;11;Lauantai;8;11;19
94;29.04.2017;2017;04;12;Lauantai;7;3;10
94;29.04.2017;2017;04;13;Lauantai;8;9;17
94;29.04.2017;2017;04;14;Lauantai;6;4;10
94;29.04.2017;2017;04;15;Lauantai;4;4;8
94;29.04.2017;2017;04;16;Lauantai;5;7;12
94;29.04.2017;2017;04;17;Lauantai;6;13;19
94;29.04.2017;2017;04;18;Lauantai;7;10;17
94;29.04.2017;2017;04;19;Lauantai;0;1;1
94;29.04.2017;2017;04;20;Lauantai;7;2;9
94;29.04.2017;2017;04;21;Lauantai;0;5;5
94;29.04.2017;2017;04;22;Lauantai;1;3;4
94;29.04.2017;2017;04;23;Lauantai;0;3;3
94;30.04.2017;2017;04;00;Sunnuntai;0;2;2
94;30.04.2017;2017;04;01;Sunnuntai;0;0;0
94;30.04.2017;2017;04;02;Sunnuntai;0;0;0
94;30.04.2017;2017;04;03;Sunnuntai;0;0;0
94;30.04.2017;2017;04;04;Sunnuntai;1;0;1
94;30.04.2017;2017;04;05;Sunnuntai;1;0;1
94;30.04.2017;2017;04;06;Sunnuntai;0;0;0
94;30.04.2017;2017;04;07;Sunnuntai;1;1;2
94;30.04.2017;2017;04;08;Sunnuntai;0;0;0
94;30.04.2017;2017;04;09;Sunnuntai;1;1;2
94;30.04.2017;2017;04;10;Sunnuntai;1;2;3
94;30.04.2017;2017;04;11;Sunnuntai;2;1;3
94;30.04.2017;2017;04;12;Sunnuntai;7;0;7
94;30.04.2017;2017;04;13;Sunnuntai;0;2;2
94;30.04.2017;2017;04;14;Sunnuntai;0;0;0
94;30.04.2017;2017;04;15;Sunnuntai;3;6;9
94;30.04.2017;2017;04;16;Sunnuntai;0;4;4
94;30.04.2017;2017;04;17;Sunnuntai;2;1;3
94;30.04.2017;2017;04;18;Sunnuntai;5;2;7
94;30.04.2017;2017;04;19;Sunnuntai;2;4;6
94;30.04.2017;2017;04;20;Sunnuntai;2;2;4
94;30.04.2017;2017;04;21;Sunnuntai;0;1;1
94;30.04.2017;2017;04;22;Sunnuntai;0;0;0
94;30.04.2017;2017;04;23;Sunnuntai;1;0;1
94;01.05.2017;2017;05;00;Maanantai;0;0;0
94;01.05.2017;2017;05;01;Maanantai;0;1;1
94;01.05.2017;2017;05;02;Maanantai;0;0;0
94;01.05.2017;2017;05;03;Maanantai;1;0;1
94;01.05.2017;2017;05;04;Maanantai;0;0;0
94;01.05.2017;2017;05;05;Maanantai;0;0;0
94;01.05.2017;2017;05;06;Maanantai;1;1;2
94;01.05.2017;2017;05;07;Maanantai;0;1;1
94;01.05.2017;2017;05;08;Maanantai;3;2;5
94;01.05.2017;2017;05;09;Maanantai;2;3;5
94;01.05.2017;2017;05;10;Maanantai;7;0;7
94;01.05.2017;2017;05;11;Maanantai;3;5;8
94;01.05.2017;2017;05;12;Maanantai;8;4;12
94;01.05.2017;2017;05;13;Maanantai;6;6;12
94;01.05.2017;2017;05;14;Maanantai;5;7;12
94;01.05.2017;2017;05;15;Maanantai;6;6;12
94;01.05.2017;2017;05;16;Maanantai;5;6;11
94;01.05.2017;2017;05;17;Maanantai;4;5;9
94;01.05.2017;2017;05;18;Maanantai;5;4;9
94;01.05.2017;2017;05;19;Maanantai;2;5;7
94;01.05.2017;2017;05;20;Maanantai;1;1;2
94;01.05.2017;2017;05;21;Maanantai;1;2;3
94;01.05.2017;2017;05;22;Maanantai;0;1;1
94;01.05.2017;2017;05;23;Maanantai;0;0;0
94;02.05.2017;2017;05;00;Tiistai;0;0;0
94;02.05.2017;2017;05;01;Tiistai;0;0;0
94;02.05.2017;2017;05;02;Tiistai;0;0;0
94;02.05.2017;2017;05;03;Tiistai;0;0;0
94;02.05.2017;2017;05;04;Tiistai;0;0;0
94;02.05.2017;2017;05;05;Tiistai;6;1;7
94;02.05.2017;2017;05;06;Tiistai;15;1;16
94;02.05.2017;2017;05;07;Tiistai;20;3;23
94;02.05.2017;2017;05;08;Tiistai;9;0;9
94;02.05.2017;2017;05;09;Tiistai;4;1;5
94;02.05.2017;2017;05;10;Tiistai;5;3;8
94;02.05.2017;2017;05;11;Tiistai;4;4;8
94;02.05.2017;2017;05;12;Tiistai;5;7;12
94;02.05.2017;2017;05;13;Tiistai;0;4;4
94;02.05.2017;2017;05;14;Tiistai;5;6;11
94;02.05.2017;2017;05;15;Tiistai;9;9;18
94;02.05.2017;2017;05;16;Tiistai;11;19;30
94;02.05.2017;2017;05;17;Tiistai;2;17;19
94;02.05.2017;2017;05;18;Tiistai;5;16;21
94;02.05.2017;2017;05;19;Tiistai;3;5;8
94;02.05.2017;2017;05;20;Tiistai;3;6;9
94;02.05.2017;2017;05;21;Tiistai;1;3;4
94;02.05.2017;2017;05;22;Tiistai;0;1;1
94;02.05.2017;2017;05;23;Tiistai;0;0;0
94;03.05.2017;2017;05;00;Keskiviikko;0;1;1
94;03.05.2017;2017;05;01;Keskiviikko;0;1;1
94;03.05.2017;2017;05;02;Keskiviikko;0;0;0
94;03.05.2017;2017;05;03;Keskiviikko;0;0;0
94;03.05.2017;2017;05;04;Keskiviikko;1;0;1
94;03.05.2017;2017;05;05;Keskiviikko;4;1;5
94;03.05.2017;2017;05;06;Keskiviikko;15;1;16
94;03.05.2017;2017;05;07;Keskiviikko;20;1;21
94;03.05.2017;2017;05;08;Keskiviikko;14;4;18
94;03.05.2017;2017;05;09;Keskiviikko;6;2;8
94;03.05.2017;2017;05;10;Keskiviikko;6;5;11
94;03.05.2017;2017;05;11;Keskiviikko;2;4;6
94;03.05.2017;2017;05;12;Keskiviikko;0;2;2
94;03.05.2017;2017;05;13;Keskiviikko;5;6;11
94;03.05.2017;2017;05;14;Keskiviikko;6;6;12
94;03.05.2017;2017;05;15;Keskiviikko;4;14;18
94;03.05.2017;2017;05;16;Keskiviikko;0;26;26
94;03.05.2017;2017;05;17;Keskiviikko;4;10;14
94;03.05.2017;2017;05;18;Keskiviikko;3;9;12
94;03.05.2017;2017;05;19;Keskiviikko;3;3;6
94;03.05.2017;2017;05;20;Keskiviikko;1;7;8
94;03.05.2017;2017;05;21;Keskiviikko;3;4;7
94;03.05.2017;2017;05;22;Keskiviikko;0;0;0
94;03.05.2017;2017;05;23;Keskiviikko;0;0;0
94;04.05.2017;2017;05;00;Torstai;0;0;0
94;04.05.2017;2017;05;01;Torstai;0;0;0
94;04.05.2017;2017;05;02;Torstai;0;0;0
94;04.05.2017;2017;05;03;Torstai;0;1;1
94;04.05.2017;2017;05;04;Torstai;0;0;0
94;04.05.2017;2017;05;05;Torstai;4;1;5
94;04.05.2017;2017;05;06;Torstai;20;1;21
94;04.05.2017;2017;05;07;Torstai;21;1;22
94;04.05.2017;2017;05;08;Torstai;14;2;16
94;04.05.2017;2017;05;09;Torstai;4;0;4
94;04.05.2017;2017;05;10;Torstai;4;4;8
94;04.05.2017;2017;05;11;Torstai;9;7;16
94;04.05.2017;2017;05;12;Torstai;3;5;8
94;04.05.2017;2017;05;13;Torstai;0;2;2
94;04.05.2017;2017;05;14;Torstai;3;11;14
94;04.05.2017;2017;05;15;Torstai;6;10;16
94;04.05.2017;2017;05;16;Torstai;5;35;40
94;04.05.2017;2017;05;17;Torstai;5;15;20
94;04.05.2017;2017;05;18;Torstai;8;8;16
94;04.05.2017;2017;05;19;Torstai;3;3;6
94;04.05.2017;2017;05;20;Torstai;2;7;9
94;04.05.2017;2017;05;21;Torstai;2;3;5
94;04.05.2017;2017;05;22;Torstai;0;2;2
94;04.05.2017;2017;05;23;Torstai;0;0;0
94;05.05.2017;2017;05;00;Perjantai;0;0;0
94;05.05.2017;2017;05;01;Perjantai;0;0;0
94;05.05.2017;2017;05;02;Perjantai;0;0;0
94;05.05.2017;2017;05;03;Perjantai;0;0;0
94;05.05.2017;2017;05;04;Perjantai;1;0;1
94;05.05.2017;2017;05;05;Perjantai;5;1;6
94;05.05.2017;2017;05;06;Perjantai;15;3;18
94;05.05.2017;2017;05;07;Perjantai;21;2;23
94;05.05.2017;2017;05;08;Perjantai;7;4;11
94;05.05.2017;2017;05;09;Perjantai;9;3;12
94;05.05.2017;2017;05;10;Perjantai;5;5;10
94;05.05.2017;2017;05;11;Perjantai;3;6;9
94;05.05.2017;2017;05;12;Perjantai;2;3;5
94;05.05.2017;2017;05;13;Perjantai;8;11;19
94;05.05.2017;2017;05;14;Perjantai;13;19;32
94;05.05.2017;2017;05;15;Perjantai;9;23;32
94;05.05.2017;2017;05;16;Perjantai;13;19;32
94;05.05.2017;2017;05;17;Perjantai;10;16;26
94;05.05.2017;2017;05;18;Perjantai;5;13;18
94;05.05.2017;2017;05;19;Perjantai;9;10;19
94;05.05.2017;2017;05;20;Perjantai;5;5;10
94;05.05.2017;2017;05;21;Perjantai;3;7;10
94;05.05.2017;2017;05;22;Perjantai;1;1;2
94;05.05.2017;2017;05;23;Perjantai;0;0;0
94;06.05.2017;2017;05;00;Lauantai;0;0;0
94;06.05.2017;2017;05;01;Lauantai;0;0;0
94;06.05.2017;2017;05;02;Lauantai;0;0;0
94;06.05.2017;2017;05;03;Lauantai;0;0;0
94;06.05.2017;2017;05;04;Lauantai;0;0;0
94;06.05.2017;2017;05;05;Lauantai;0;0;0
94;06.05.2017;2017;05;06;Lauantai;1;1;2
94;06.05.2017;2017;05;07;Lauantai;1;1;2
94;06.05.2017;2017;05;08;Lauantai;0;1;1
94;06.05.2017;2017;05;09;Lauantai;1;0;1
94;06.05.2017;2017;05;10;Lauantai;3;2;5
94;06.05.2017;2017;05;11;Lauantai;6;2;8
94;06.05.2017;2017;05;12;Lauantai;5;0;5
94;06.05.2017;2017;05;13;Lauantai;3;2;5
94;06.05.2017;2017;05;14;Lauantai;5;10;15
94;06.05.2017;2017;05;15;Lauantai;5;6;11
94;06.05.2017;2017;05;16;Lauantai;7;3;10
94;06.05.2017;2017;05;17;Lauantai;5;3;8
94;06.05.2017;2017;05;18;Lauantai;2;2;4
94;06.05.2017;2017;05;19;Lauantai;8;3;11
94;06.05.2017;2017;05;20;Lauantai;7;11;18
94;06.05.2017;2017;05;21;Lauantai;1;6;7
94;06.05.2017;2017;05;22;Lauantai;2;0;2
94;06.05.2017;2017;05;23;Lauantai;1;3;4
94;07.05.2017;2017;05;00;Sunnuntai;0;0;0
94;07.05.2017;2017;05;01;Sunnuntai;1;1;2
94;07.05.2017;2017;05;02;Sunnuntai;0;0;0
94;07.05.2017;2017;05;03;Sunnuntai;0;1;1
94;07.05.2017;2017;05;04;Sunnuntai;0;0;0
94;07.05.2017;2017;05;05;Sunnuntai;0;1;1
94;07.05.2017;2017;05;06;Sunnuntai;1;0;1
94;07.05.2017;2017;05;07;Sunnuntai;0;1;1
94;07.05.2017;2017;05;08;Sunnuntai;2;2;4
94;07.05.2017;2017;05;09;Sunnuntai;4;1;5
94;07.05.2017;2017;05;10;Sunnuntai;6;8;14
94;07.05.2017;2017;05;11;Sunnuntai;3;4;7
94;07.05.2017;2017;05;12;Sunnuntai;9;3;12
94;07.05.2017;2017;05;13;Sunnuntai;7;7;14
94;07.05.2017;2017;05;14;Sunnuntai;7;7;14
94;07.05.2017;2017;05;15;Sunnuntai;3;3;6
94;07.05.2017;2017;05;16;Sunnuntai;6;11;17
94;07.05.2017;2017;05;17;Sunnuntai;1;0;1
94;07.05.2017;2017;05;18;Sunnuntai;5;3;8
94;07.05.2017;2017;05;19;Sunnuntai;6;5;11
94;07.05.2017;2017;05;20;Sunnuntai;4;3;7
94;07.05.2017;2017;05;21;Sunnuntai;2;2;4
94;07.05.2017;2017;05;22;Sunnuntai;0;1;1
94;07.05.2017;2017;05;23;Sunnuntai;0;0;0
94;08.05.2017;2017;05;00;Maanantai;0;0;0
94;08.05.2017;2017;05;01;Maanantai;0;0;0
94;08.05.2017;2017;05;02;Maanantai;0;0;0
94;08.05.2017;2017;05;03;Maanantai;0;0;0
94;08.05.2017;2017;05;04;Maanantai;0;0;0
94;08.05.2017;2017;05;05;Maanantai;4;0;4
94;08.05.2017;2017;05;06;Maanantai;12;1;13
94;08.05.2017;2017;05;07;Maanantai;14;3;17
94;08.05.2017;2017;05;08;Maanantai;13;0;13
94;08.05.2017;2017;05;09;Maanantai;4;2;6
94;08.05.2017;2017;05;10;Maanantai;1;0;1
94;08.05.2017;2017;05;11;Maanantai;4;2;6
94;08.05.2017;2017;05;12;Maanantai;2;6;8
94;08.05.2017;2017;05;13;Maanantai;5;2;7
94;08.05.2017;2017;05;14;Maanantai;1;11;12
94;08.05.2017;2017;05;15;Maanantai;5;16;21
94;08.05.2017;2017;05;16;Maanantai;7;16;23
94;08.05.2017;2017;05;17;Maanantai;3;12;15
94;08.05.2017;2017;05;18;Maanantai;3;6;9
94;08.05.2017;2017;05;19;Maanantai;2;4;6
94;08.05.2017;2017;05;20;Maanantai;0;7;7
94;08.05.2017;2017;05;21;Maanantai;3;0;3
94;08.05.2017;2017;05;22;Maanantai;0;1;1
94;08.05.2017;2017;05;23;Maanantai;0;0;0
94;09.05.2017;2017;05;00;Tiistai;0;0;0
94;09.05.2017;2017;05;01;Tiistai;0;0;0
94;09.05.2017;2017;05;02;Tiistai;0;0;0
94;09.05.2017;2017;05;03;Tiistai;0;0;0
94;09.05.2017;2017;05;04;Tiistai;0;0;0
94;09.05.2017;2017;05;05;Tiistai;3;2;5
94;09.05.2017;2017;05;06;Tiistai;12;3;15
94;09.05.2017;2017;05;07;Tiistai;12;2;14
94;09.05.2017;2017;05;08;Tiistai;14;0;14
94;09.05.2017;2017;05;09;Tiistai;4;5;9
94;09.05.2017;2017;05;10;Tiistai;6;2;8
94;09.05.2017;2017;05;11;Tiistai;6;2;8
94;09.05.2017;2017;05;12;Tiistai;4;5;9
94;09.05.2017;2017;05;13;Tiistai;1;4;5
94;09.05.2017;2017;05;14;Tiistai;5;6;11
94;09.05.2017;2017;05;15;Tiistai;7;9;16
94;09.05.2017;2017;05;16;Tiistai;3;19;22
94;09.05.2017;2017;05;17;Tiistai;4;11;15
94;09.05.2017;2017;05;18;Tiistai;5;3;8
94;09.05.2017;2017;05;19;Tiistai;4;4;8
94;09.05.2017;2017;05;20;Tiistai;2;4;6
94;09.05.2017;2017;05;21;Tiistai;1;2;3
94;09.05.2017;2017;05;22;Tiistai;0;2;2
94;09.05.2017;2017;05;23;Tiistai;0;1;1
94;10.05.2017;2017;05;00;Keskiviikko;0;0;0
94;10.05.2017;2017;05;01;Keskiviikko;0;0;0
94;10.05.2017;2017;05;02;Keskiviikko;0;0;0
94;10.05.2017;2017;05;03;Keskiviikko;1;0;1
94;10.05.2017;2017;05;04;Keskiviikko;2;0;2
94;10.05.2017;2017;05;05;Keskiviikko;4;2;6
94;10.05.2017;2017;05;06;Keskiviikko;15;2;17
94;10.05.2017;2017;05;07;Keskiviikko;18;1;19
94;10.05.2017;2017;05;08;Keskiviikko;9;1;10
94;10.05.2017;2017;05;09;Keskiviikko;5;2;7
94;10.05.2017;2017;05;10;Keskiviikko;3;1;4
94;10.05.2017;2017;05;11;Keskiviikko;4;1;5
94;10.05.2017;2017;05;12;Keskiviikko;5;7;12
94;10.05.2017;2017;05;13;Keskiviikko;1;5;6
94;10.05.2017;2017;05;14;Keskiviikko;5;7;12
94;10.05.2017;2017;05;15;Keskiviikko;3;11;14
94;10.05.2017;2017;05;16;Keskiviikko;3;21;24
94;10.05.2017;2017;05;17;Keskiviikko;2;9;11
94;10.05.2017;2017;05;18;Keskiviikko;5;6;11
94;10.05.2017;2017;05;19;Keskiviikko;1;0;1
94;10.05.2017;2017;05;20;Keskiviikko;1;9;10
94;10.05.2017;2017;05;21;Keskiviikko;4;4;8
94;10.05.2017;2017;05;22;Keskiviikko;0;1;1
94;10.05.2017;2017;05;23;Keskiviikko;0;0;0
94;11.05.2017;2017;05;00;Torstai;0;0;0
94;11.05.2017;2017;05;01;Torstai;0;0;0
94;11.05.2017;2017;05;02;Torstai;0;0;0
94;11.05.2017;2017;05;03;Torstai;1;0;1
94;11.05.2017;2017;05;04;Torstai;2;0;2
94;11.05.2017;2017;05;05;Torstai;4;2;6
94;11.05.2017;2017;05;06;Torstai;13;2;15
94;11.05.2017;2017;05;07;Torstai;17;1;18
94;11.05.2017;2017;05;08;Torstai;12;3;15
94;11.05.2017;2017;05;09;Torstai;3;0;3
94;11.05.2017;2017;05;10;Torstai;3;4;7
94;11.05.2017;2017;05;11;Torstai;5;3;8
94;11.05.2017;2017;05;12;Torstai;3;1;4
94;11.05.2017;2017;05;13;Torstai;0;2;2
94;11.05.2017;2017;05;14;Torstai;1;9;10
94;11.05.2017;2017;05;15;Torstai;5;16;21
94;11.05.2017;2017;05;16;Torstai;2;20;22
94;11.05.2017;2017;05;17;Torstai;2;9;11
94;11.05.2017;2017;05;18;Torstai;2;6;8
94;11.05.2017;2017;05;19;Torstai;4;2;6
94;11.05.2017;2017;05;20;Torstai;2;4;6
94;11.05.2017;2017;05;21;Torstai;0;4;4
94;11.05.2017;2017;05;22;Torstai;0;2;2
94;11.05.2017;2017;05;23;Torstai;0;0;0
94;12.05.2017;2017;05;00;Perjantai;0;0;0
94;12.05.2017;2017;05;01;Perjantai;0;1;1
94;12.05.2017;2017;05;02;Perjantai;0;0;0
94;12.05.2017;2017;05;03;Perjantai;0;0;0
94;12.05.2017;2017;05;04;Perjantai;1;0;1
94;12.05.2017;2017;05;05;Perjantai;4;1;5
94;12.05.2017;2017;05;06;Perjantai;5;3;8
94;12.05.2017;2017;05;07;Perjantai;17;2;19
94;12.05.2017;2017;05;08;Perjantai;11;2;13
94;12.05.2017;2017;05;09;Perjantai;8;1;9
94;12.05.2017;2017;05;10;Perjantai;6;1;7
94;12.05.2017;2017;05;11;Perjantai;0;3;3
94;12.05.2017;2017;05;12;Perjantai;3;1;4
94;12.05.2017;2017;05;13;Perjantai;5;7;12
94;12.05.2017;2017;05;14;Perjantai;3;7;10
94;12.05.2017;2017;05;15;Perjantai;7;16;23
94;12.05.2017;2017;05;16;Perjantai;5;19;24
94;12.05.2017;2017;05;17;Perjantai;7;12;19
94;12.05.2017;2017;05;18;Perjantai;3;7;10
94;12.05.2017;2017;05;19;Perjantai;4;3;7
94;12.05.2017;2017;05;20;Perjantai;6;7;13
94;12.05.2017;2017;05;21;Perjantai;3;3;6
94;12.05.2017;2017;05;22;Perjantai;0;2;2
94;12.05.2017;2017;05;23;Perjantai;0;1;1
94;13.05.2017;2017;05;00;Lauantai;0;0;0
94;13.05.2017;2017;05;01;Lauantai;0;0;0
94;13.05.2017;2017;05;02;Lauantai;0;0;0
94;13.05.2017;2017;05;03;Lauantai;0;0;0
94;13.05.2017;2017;05;04;Lauantai;0;0;0
94;13.05.2017;2017;05;05;Lauantai;1;0;1
94;13.05.2017;2017;05;06;Lauantai;0;0;0
94;13.05.2017;2017;05;07;Lauantai;2;1;3
94;13.05.2017;2017;05;08;Lauantai;1;0;1
94;13.05.2017;2017;05;09;Lauantai;2;2;4
94;13.05.2017;2017;05;10;Lauantai;5;4;9
94;13.05.2017;2017;05;11;Lauantai;3;4;7
94;13.05.2017;2017;05;12;Lauantai;4;4;8
94;13.05.2017;2017;05;13;Lauantai;7;6;13
94;13.05.2017;2017;05;14;Lauantai;10;2;12
94;13.05.2017;2017;05;15;Lauantai;9;6;15
94;13.05.2017;2017;05;16;Lauantai;9;14;23
94;13.05.2017;2017;05;17;Lauantai;8;8;16
94;13.05.2017;2017;05;18;Lauantai;6;8;14
94;13.05.2017;2017;05;19;Lauantai;11;4;15
94;13.05.2017;2017;05;20;Lauantai;0;3;3
94;13.05.2017;2017;05;21;Lauantai;0;1;1
94;13.05.2017;2017;05;22;Lauantai;4;0;4
94;13.05.2017;2017;05;23;Lauantai;0;0;0
94;14.05.2017;2017;05;00;Sunnuntai;0;1;1
94;14.05.2017;2017;05;01;Sunnuntai;0;0;0
94;14.05.2017;2017;05;02;Sunnuntai;0;0;0
94;14.05.2017;2017;05;03;Sunnuntai;0;0;0
94;14.05.2017;2017;05;04;Sunnuntai;0;0;0
94;14.05.2017;2017;05;05;Sunnuntai;2;0;2
94;14.05.2017;2017;05;06;Sunnuntai;2;0;2
94;14.05.2017;2017;05;07;Sunnuntai;2;0;2
94;14.05.2017;2017;05;08;Sunnuntai;2;2;4
94;14.05.2017;2017;05;09;Sunnuntai;4;3;7
94;14.05.2017;2017;05;10;Sunnuntai;4;4;8
94;14.05.2017;2017;05;11;Sunnuntai;1;0;1
94;14.05.2017;2017;05;12;Sunnuntai;1;0;1
94;14.05.2017;2017;05;13;Sunnuntai;2;0;2
94;14.05.2017;2017;05;14;Sunnuntai;2;1;3
94;14.05.2017;2017;05;15;Sunnuntai;0;3;3
94;14.05.2017;2017;05;16;Sunnuntai;2;0;2
94;14.05.2017;2017;05;17;Sunnuntai;1;0;1
94;14.05.2017;2017;05;18;Sunnuntai;0;2;2
94;14.05.2017;2017;05;19;Sunnuntai;2;2;4
94;14.05.2017;2017;05;20;Sunnuntai;0;0;0
94;14.05.2017;2017;05;21;Sunnuntai;1;0;1
94;14.05.2017;2017;05;22;Sunnuntai;0;0;0
94;14.05.2017;2017;05;23;Sunnuntai;0;0;0
94;15.05.2017;2017;05;00;Maanantai;0;0;0
94;15.05.2017;2017;05;01;Maanantai;0;0;0
94;15.05.2017;2017;05;02;Maanantai;0;0;0
94;15.05.2017;2017;05;03;Maanantai;0;1;1
94;15.05.2017;2017;05;04;Maanantai;1;0;1
94;15.05.2017;2017;05;05;Maanantai;4;2;6
94;15.05.2017;2017;05;06;Maanantai;8;2;10
94;15.05.2017;2017;05;07;Maanantai;27;1;28
94;15.05.2017;2017;05;08;Maanantai;7;3;10
94;15.05.2017;2017;05;09;Maanantai;7;3;10
94;15.05.2017;2017;05;10;Maanantai;6;2;8
94;15.05.2017;2017;05;11;Maanantai;5;5;10
94;15.05.2017;2017;05;12;Maanantai;0;6;6
94;15.05.2017;2017;05;13;Maanantai;5;3;8
94;15.05.2017;2017;05;14;Maanantai;9;13;22
94;15.05.2017;2017;05;15;Maanantai;6;15;21
94;15.05.2017;2017;05;16;Maanantai;10;18;28
94;15.05.2017;2017;05;17;Maanantai;5;13;18
94;15.05.2017;2017;05;18;Maanantai;10;18;28
94;15.05.2017;2017;05;19;Maanantai;9;13;22
94;15.05.2017;2017;05;20;Maanantai;2;11;13
94;15.05.2017;2017;05;21;Maanantai;4;4;8
94;15.05.2017;2017;05;22;Maanantai;0;3;3
94;15.05.2017;2017;05;23;Maanantai;0;0;0
94;16.05.2017;2017;05;00;Tiistai;0;0;0
94;16.05.2017;2017;05;01;Tiistai;0;0;0
94;16.05.2017;2017;05;02;Tiistai;0;0;0
94;16.05.2017;2017;05;03;Tiistai;0;0;0
94;16.05.2017;2017;05;04;Tiistai;1;0;1
94;16.05.2017;2017;05;05;Tiistai;6;2;8
94;16.05.2017;2017;05;06;Tiistai;17;3;20
94;16.05.2017;2017;05;07;Tiistai;18;5;23
94;16.05.2017;2017;05;08;Tiistai;11;1;12
94;16.05.2017;2017;05;09;Tiistai;12;2;14
94;16.05.2017;2017;05;10;Tiistai;6;6;12
94;16.05.2017;2017;05;11;Tiistai;10;8;18
94;16.05.2017;2017;05;12;Tiistai;5;10;15
94;16.05.2017;2017;05;13;Tiistai;5;5;10
94;16.05.2017;2017;05;14;Tiistai;6;11;17
94;16.05.2017;2017;05;15;Tiistai;11;12;23
94;16.05.2017;2017;05;16;Tiistai;11;28;39
94;16.05.2017;2017;05;17;Tiistai;4;11;15
94;16.05.2017;2017;05;18;Tiistai;9;12;21
94;16.05.2017;2017;05;19;Tiistai;14;11;25
94;16.05.2017;2017;05;20;Tiistai;2;9;11
94;16.05.2017;2017;05;21;Tiistai;3;4;7
94;16.05.2017;2017;05;22;Tiistai;0;3;3
94;16.05.2017;2017;05;23;Tiistai;1;2;3
94;17.05.2017;2017;05;00;Keskiviikko;0;0;0
94;17.05.2017;2017;05;01;Keskiviikko;0;0;0
94;17.05.2017;2017;05;02;Keskiviikko;0;1;1
94;17.05.2017;2017;05;03;Keskiviikko;0;0;0
94;17.05.2017;2017;05;04;Keskiviikko;2;0;2
94;17.05.2017;2017;05;05;Keskiviikko;3;2;5
94;17.05.2017;2017;05;06;Keskiviikko;13;1;14
94;17.05.2017;2017;05;07;Keskiviikko;13;0;13
94;17.05.2017;2017;05;08;Keskiviikko;7;2;9
94;17.05.2017;2017;05;09;Keskiviikko;4;0;4
94;17.05.2017;2017;05;10;Keskiviikko;0;0;0
94;17.05.2017;2017;05;11;Keskiviikko;0;2;2
94;17.05.2017;2017;05;12;Keskiviikko;0;1;1
94;17.05.2017;2017;05;13;Keskiviikko;4;0;4
94;17.05.2017;2017;05;14;Keskiviikko;4;6;10
94;17.05.2017;2017;05;15;Keskiviikko;1;11;12
94;17.05.2017;2017;05;16;Keskiviikko;1;9;10
94;17.05.2017;2017;05;17;Keskiviikko;1;7;8
94;17.05.2017;2017;05;18;Keskiviikko;0;3;3
94;17.05.2017;2017;05;19;Keskiviikko;0;0;0
94;17.05.2017;2017;05;20;Keskiviikko;0;2;2
94;17.05.2017;2017;05;21;Keskiviikko;0;1;1
94;17.05.2017;2017;05;22;Keskiviikko;0;2;2
94;17.05.2017;2017;05;23;Keskiviikko;0;0;0
94;18.05.2017;2017;05;00;Torstai;1;0;1
94;18.05.2017;2017;05;01;Torstai;0;0;0
94;18.05.2017;2017;05;02;Torstai;0;0;0
94;18.05.2017;2017;05;03;Torstai;0;0;0
94;18.05.2017;2017;05;04;Torstai;2;0;2
94;18.05.2017;2017;05;05;Torstai;7;1;8
94;18.05.2017;2017;05;06;Torstai;10;2;12
94;18.05.2017;2017;05;07;Torstai;24;2;26
94;18.05.2017;2017;05;08;Torstai;9;2;11
94;18.05.2017;2017;05;09;Torstai;2;2;4
94;18.05.2017;2017;05;10;Torstai;2;1;3
94;18.05.2017;2017;05;11;Torstai;6;2;8
94;18.05.2017;2017;05;12;Torstai;2;9;11
94;18.05.2017;2017;05;13;Torstai;3;4;7
94;18.05.2017;2017;05;14;Torstai;4;11;15
94;18.05.2017;2017;05;15;Torstai;9;11;20
94;18.05.2017;2017;05;16;Torstai;8;29;37
94;18.05.2017;2017;05;17;Torstai;2;13;15
94;18.05.2017;2017;05;18;Torstai;3;15;18
94;18.05.2017;2017;05;19;Torstai;8;3;11
94;18.05.2017;2017;05;20;Torstai;6;8;14
94;18.05.2017;2017;05;21;Torstai;1;3;4
94;18.05.2017;2017;05;22;Torstai;1;4;5
94;18.05.2017;2017;05;23;Torstai;1;0;1
94;19.05.2017;2017;05;00;Perjantai;1;0;1
94;19.05.2017;2017;05;01;Perjantai;0;0;0
94;19.05.2017;2017;05;02;Perjantai;0;0;0
94;19.05.2017;2017;05;03;Perjantai;0;0;0
94;19.05.2017;2017;05;04;Perjantai;2;0;2
94;19.05.2017;2017;05;05;Perjantai;2;2;4
94;19.05.2017;2017;05;06;Perjantai;1;0;1
94;19.05.2017;2017;05;07;Perjantai;8;0;8
94;19.05.2017;2017;05;08;Perjantai;4;0;4
94;19.05.2017;2017;05;09;Perjantai;1;1;2
94;19.05.2017;2017;05;10;Perjantai;2;0;2
94;19.05.2017;2017;05;11;Perjantai;2;0;2
94;19.05.2017;2017;05;12;Perjantai;4;1;5
94;19.05.2017;2017;05;13;Perjantai;0;1;1
94;19.05.2017;2017;05;14;Perjantai;1;5;6
94;19.05.2017;2017;05;15;Perjantai;4;14;18
94;19.05.2017;2017;05;16;Perjantai;2;3;5
94;19.05.2017;2017;05;17;Perjantai;0;9;9
94;19.05.2017;2017;05;18;Perjantai;3;3;6
94;19.05.2017;2017;05;19;Perjantai;3;4;7
94;19.05.2017;2017;05;20;Perjantai;4;3;7
94;19.05.2017;2017;05;21;Perjantai;1;2;3
94;19.05.2017;2017;05;22;Perjantai;4;1;5
94;19.05.2017;2017;05;23;Perjantai;0;0;0
94;20.05.2017;2017;05;00;Lauantai;0;0;0
94;20.05.2017;2017;05;01;Lauantai;0;0;0
94;20.05.2017;2017;05;02;Lauantai;0;0;0
94;20.05.2017;2017;05;03;Lauantai;0;0;0
94;20.05.2017;2017;05;04;Lauantai;1;0;1
94;20.05.2017;2017;05;05;Lauantai;0;0;0
94;20.05.2017;2017;05;06;Lauantai;0;0;0
94;20.05.2017;2017;05;07;Lauantai;0;0;0
94;20.05.2017;2017;05;08;Lauantai;3;1;4
94;20.05.2017;2017;05;09;Lauantai;2;5;7
94;20.05.2017;2017;05;10;Lauantai;11;11;22
94;20.05.2017;2017;05;11;Lauantai;8;15;23
94;20.05.2017;2017;05;12;Lauantai;20;15;35
94;20.05.2017;2017;05;13;Lauantai;11;9;20
94;20.05.2017;2017;05;14;Lauantai;16;15;31
94;20.05.2017;2017;05;15;Lauantai;13;6;19
94;20.05.2017;2017;05;16;Lauantai;13;13;26
94;20.05.2017;2017;05;17;Lauantai;17;8;25
94;20.05.2017;2017;05;18;Lauantai;9;7;16
94;20.05.2017;2017;05;19;Lauantai;6;14;20
94;20.05.2017;2017;05;20;Lauantai;4;4;8
94;20.05.2017;2017;05;21;Lauantai;1;1;2
94;20.05.2017;2017;05;22;Lauantai;2;4;6
94;20.05.2017;2017;05;23;Lauantai;1;4;5
94;21.05.2017;2017;05;00;Sunnuntai;0;1;1
94;21.05.2017;2017;05;01;Sunnuntai;1;0;1
94;21.05.2017;2017;05;02;Sunnuntai;0;0;0
94;21.05.2017;2017;05;03;Sunnuntai;0;0;0
94;21.05.2017;2017;05;04;Sunnuntai;0;0;0
94;21.05.2017;2017;05;05;Sunnuntai;1;0;1
94;21.05.2017;2017;05;06;Sunnuntai;0;0;0
94;21.05.2017;2017;05;07;Sunnuntai;2;0;2
94;21.05.2017;2017;05;08;Sunnuntai;0;1;1
94;21.05.2017;2017;05;09;Sunnuntai;6;6;12
94;21.05.2017;2017;05;10;Sunnuntai;6;6;12
94;21.05.2017;2017;05;11;Sunnuntai;14;8;22
94;21.05.2017;2017;05;12;Sunnuntai;11;10;21
94;21.05.2017;2017;05;13;Sunnuntai;6;12;18
94;21.05.2017;2017;05;14;Sunnuntai;11;16;27
94;21.05.2017;2017;05;15;Sunnuntai;17;15;32
94;21.05.2017;2017;05;16;Sunnuntai;12;18;30
94;21.05.2017;2017;05;17;Sunnuntai;9;8;17
94;21.05.2017;2017;05;18;Sunnuntai;9;3;12
94;21.05.2017;2017;05;19;Sunnuntai;17;15;32
94;21.05.2017;2017;05;20;Sunnuntai;4;8;12
94;21.05.2017;2017;05;21;Sunnuntai;4;5;9
94;21.05.2017;2017;05;22;Sunnuntai;2;1;3
94;21.05.2017;2017;05;23;Sunnuntai;0;0;0
94;22.05.2017;2017;05;00;Maanantai;1;0;1
94;22.05.2017;2017;05;01;Maanantai;1;0;1
94;22.05.2017;2017;05;02;Maanantai;0;0;0
94;22.05.2017;2017;05;03;Maanantai;0;0;0
94;22.05.2017;2017;05;04;Maanantai;2;0;2
94;22.05.2017;2017;05;05;Maanantai;5;2;7
94;22.05.2017;2017;05;06;Maanantai;25;2;27
94;22.05.2017;2017;05;07;Maanantai;28;2;30
94;22.05.2017;2017;05;08;Maanantai;16;6;22
94;22.05.2017;2017;05;09;Maanantai;6;2;8
94;22.05.2017;2017;05;10;Maanantai;16;3;19
94;22.05.2017;2017;05;11;Maanantai;12;4;16
94;22.05.2017;2017;05;12;Maanantai;12;7;19
94;22.05.2017;2017;05;13;Maanantai;5;9;14
94;22.05.2017;2017;05;14;Maanantai;8;11;19
94;22.05.2017;2017;05;15;Maanantai;4;34;38
94;22.05.2017;2017;05;16;Maanantai;9;37;46
94;22.05.2017;2017;05;17;Maanantai;6;19;25
94;22.05.2017;2017;05;18;Maanantai;10;12;22
94;22.05.2017;2017;05;19;Maanantai;10;13;23
94;22.05.2017;2017;05;20;Maanantai;11;11;22
94;22.05.2017;2017;05;21;Maanantai;6;10;16
94;22.05.2017;2017;05;22;Maanantai;3;6;9
94;22.05.2017;2017;05;23;Maanantai;1;2;3
94;23.05.2017;2017;05;00;Tiistai;1;0;1
94;23.05.2017;2017;05;01;Tiistai;0;0;0
94;23.05.2017;2017;05;02;Tiistai;0;0;0
94;23.05.2017;2017;05;03;Tiistai;1;0;1
94;23.05.2017;2017;05;04;Tiistai;2;0;2
94;23.05.2017;2017;05;05;Tiistai;5;5;10
94;23.05.2017;2017;05;06;Tiistai;30;3;33
94;23.05.2017;2017;05;07;Tiistai;26;8;34
94;23.05.2017;2017;05;08;Tiistai;17;1;18
94;23.05.2017;2017;05;09;Tiistai;6;4;10
94;23.05.2017;2017;05;10;Tiistai;3;2;5
94;23.05.2017;2017;05;11;Tiistai;6;12;18
94;23.05.2017;2017;05;12;Tiistai;6;1;7
94;23.05.2017;2017;05;13;Tiistai;9;8;17
94;23.05.2017;2017;05;14;Tiistai;13;16;29
94;23.05.2017;2017;05;15;Tiistai;14;21;35
94;23.05.2017;2017;05;16;Tiistai;13;30;43
94;23.05.2017;2017;05;17;Tiistai;12;19;31
94;23.05.2017;2017;05;18;Tiistai;7;20;27
94;23.05.2017;2017;05;19;Tiistai;13;16;29
94;23.05.2017;2017;05;20;Tiistai;11;12;23
94;23.05.2017;2017;05;21;Tiistai;0;7;7
94;23.05.2017;2017;05;22;Tiistai;1;3;4
94;23.05.2017;2017;05;23;Tiistai;0;1;1
94;24.05.2017;2017;05;00;Keskiviikko;0;0;0
94;24.05.2017;2017;05;01;Keskiviikko;0;0;0
94;24.05.2017;2017;05;02;Keskiviikko;0;0;0
94;24.05.2017;2017;05;03;Keskiviikko;0;0;0
94;24.05.2017;2017;05;04;Keskiviikko;1;0;1
94;24.05.2017;2017;05;05;Keskiviikko;7;3;10
94;24.05.2017;2017;05;06;Keskiviikko;15;5;20
94;24.05.2017;2017;05;07;Keskiviikko;28;7;35
94;24.05.2017;2017;05;08;Keskiviikko;17;1;18
94;24.05.2017;2017;05;09;Keskiviikko;6;9;15
94;24.05.2017;2017;05;10;Keskiviikko;7;3;10
94;24.05.2017;2017;05;11;Keskiviikko;10;2;12
94;24.05.2017;2017;05;12;Keskiviikko;6;2;8
94;24.05.2017;2017;05;13;Keskiviikko;5;14;19
94;24.05.2017;2017;05;14;Keskiviikko;9;17;26
94;24.05.2017;2017;05;15;Keskiviikko;12;22;34
94;24.05.2017;2017;05;16;Keskiviikko;5;35;40
94;24.05.2017;2017;05;17;Keskiviikko;14;17;31
94;24.05.2017;2017;05;18;Keskiviikko;17;16;33
94;24.05.2017;2017;05;19;Keskiviikko;6;7;13
94;24.05.2017;2017;05;20;Keskiviikko;5;24;29
94;24.05.2017;2017;05;21;Keskiviikko;3;5;8
94;24.05.2017;2017;05;22;Keskiviikko;5;6;11
94;24.05.2017;2017;05;23;Keskiviikko;2;3;5
94;25.05.2017;2017;05;00;Torstai;0;1;1
94;25.05.2017;2017;05;01;Torstai;0;1;1
94;25.05.2017;2017;05;02;Torstai;1;0;1
94;25.05.2017;2017;05;03;Torstai;0;0;0
94;25.05.2017;2017;05;04;Torstai;0;0;0
94;25.05.2017;2017;05;05;Torstai;4;2;6
94;25.05.2017;2017;05;06;Torstai;7;3;10
94;25.05.2017;2017;05;07;Torstai;8;2;10
94;25.05.2017;2017;05;08;Torstai;1;3;4
94;25.05.2017;2017;05;09;Torstai;6;5;11
94;25.05.2017;2017;05;10;Torstai;7;7;14
94;25.05.2017;2017;05;11;Torstai;10;16;26
94;25.05.2017;2017;05;12;Torstai;14;8;22
94;25.05.2017;2017;05;13;Torstai;10;14;24
94;25.05.2017;2017;05;14;Torstai;11;15;26
94;25.05.2017;2017;05;15;Torstai;20;10;30
94;25.05.2017;2017;05;16;Torstai;10;10;20
94;25.05.2017;2017;05;17;Torstai;10;13;23
94;25.05.2017;2017;05;18;Torstai;17;17;34
94;25.05.2017;2017;05;19;Torstai;13;8;21
94;25.05.2017;2017;05;20;Torstai;4;3;7
94;25.05.2017;2017;05;21;Torstai;4;4;8
94;25.05.2017;2017;05;22;Torstai;2;1;3
94;25.05.2017;2017;05;23;Torstai;1;6;7
94;26.05.2017;2017;05;00;Perjantai;0;1;1
94;26.05.2017;2017;05;01;Perjantai;0;0;0
94;26.05.2017;2017;05;02;Perjantai;0;0;0
94;26.05.2017;2017;05;03;Perjantai;0;0;0
94;26.05.2017;2017;05;04;Perjantai;1;0;1
94;26.05.2017;2017;05;05;Perjantai;4;0;4
94;26.05.2017;2017;05;06;Perjantai;11;1;12
94;26.05.2017;2017;05;07;Perjantai;12;2;14
94;26.05.2017;2017;05;08;Perjantai;10;7;17
94;26.05.2017;2017;05;09;Perjantai;3;4;7
94;26.05.2017;2017;05;10;Perjantai;3;4;7
94;26.05.2017;2017;05;11;Perjantai;1;4;5
94;26.05.2017;2017;05;12;Perjantai;8;7;15
94;26.05.2017;2017;05;13;Perjantai;11;5;16
94;26.05.2017;2017;05;14;Perjantai;6;9;15
94;26.05.2017;2017;05;15;Perjantai;6;20;26
94;26.05.2017;2017;05;16;Perjantai;9;21;30
94;26.05.2017;2017;05;17;Perjantai;1;12;13
94;26.05.2017;2017;05;18;Perjantai;8;10;18
94;26.05.2017;2017;05;19;Perjantai;3;6;9
94;26.05.2017;2017;05;20;Perjantai;3;1;4
94;26.05.2017;2017;05;21;Perjantai;1;1;2
94;26.05.2017;2017;05;22;Perjantai;1;3;4
94;26.05.2017;2017;05;23;Perjantai;1;1;2
94;27.05.2017;2017;05;00;Lauantai;2;0;2
94;27.05.2017;2017;05;01;Lauantai;1;2;3
94;27.05.2017;2017;05;02;Lauantai;0;0;0
94;27.05.2017;2017;05;03;Lauantai;0;0;0
94;27.05.2017;2017;05;04;Lauantai;1;0;1
94;27.05.2017;2017;05;05;Lauantai;0;1;1
94;27.05.2017;2017;05;06;Lauantai;2;0;2
94;27.05.2017;2017;05;07;Lauantai;0;0;0
94;27.05.2017;2017;05;08;Lauantai;4;2;6
94;27.05.2017;2017;05;09;Lauantai;1;5;6
94;27.05.2017;2017;05;10;Lauantai;4;8;12
94;27.05.2017;2017;05;11;Lauantai;8;5;13
94;27.05.2017;2017;05;12;Lauantai;9;10;19
94;27.05.2017;2017;05;13;Lauantai;11;9;20
94;27.05.2017;2017;05;14;Lauantai;11;5;16
94;27.05.2017;2017;05;15;Lauantai;9;8;17
94;27.05.2017;2017;05;16;Lauantai;8;5;13
94;27.05.2017;2017;05;17;Lauantai;2;6;8
94;27.05.2017;2017;05;18;Lauantai;5;1;6
94;27.05.2017;2017;05;19;Lauantai;2;8;10
94;27.05.2017;2017;05;20;Lauantai;4;8;12
94;27.05.2017;2017;05;21;Lauantai;4;6;10
94;27.05.2017;2017;05;22;Lauantai;6;2;8
94;27.05.2017;2017;05;23;Lauantai;1;0;1
94;28.05.2017;2017;05;00;Sunnuntai;0;2;2
94;28.05.2017;2017;05;01;Sunnuntai;0;0;0
94;28.05.2017;2017;05;02;Sunnuntai;1;0;1
94;28.05.2017;2017;05;03;Sunnuntai;0;0;0
94;28.05.2017;2017;05;04;Sunnuntai;1;1;2
94;28.05.2017;2017;05;05;Sunnuntai;2;0;2
94;28.05.2017;2017;05;06;Sunnuntai;1;0;1
94;28.05.2017;2017;05;07;Sunnuntai;1;0;1
94;28.05.2017;2017;05;08;Sunnuntai;1;0;1
94;28.05.2017;2017;05;09;Sunnuntai;2;4;6
94;28.05.2017;2017;05;10;Sunnuntai;3;4;7
94;28.05.2017;2017;05;11;Sunnuntai;2;1;3
94;28.05.2017;2017;05;12;Sunnuntai;1;2;3
94;28.05.2017;2017;05;13;Sunnuntai;3;3;6
94;28.05.2017;2017;05;14;Sunnuntai;3;1;4
94;28.05.2017;2017;05;15;Sunnuntai;5;2;7
94;28.05.2017;2017;05;16;Sunnuntai;4;3;7
94;28.05.2017;2017;05;17;Sunnuntai;6;1;7
94;28.05.2017;2017;05;18;Sunnuntai;5;4;9
94;28.05.2017;2017;05;19;Sunnuntai;0;4;4
94;28.05.2017;2017;05;20;Sunnuntai;2;4;6
94;28.05.2017;2017;05;21;Sunnuntai;0;1;1
94;28.05.2017;2017;05;22;Sunnuntai;0;2;2
94;28.05.2017;2017;05;23;Sunnuntai;0;0;0
94;29.05.2017;2017;05;00;Maanantai;1;0;1
94;29.05.2017;2017;05;01;Maanantai;0;0;0
94;29.05.2017;2017;05;02;Maanantai;0;0;0
94;29.05.2017;2017;05;03;Maanantai;0;0;0
94;29.05.2017;2017;05;04;Maanantai;1;0;1
94;29.05.2017;2017;05;05;Maanantai;3;2;5
94;29.05.2017;2017;05;06;Maanantai;19;3;22
94;29.05.2017;2017;05;07;Maanantai;25;3;28
94;29.05.2017;2017;05;08;Maanantai;20;1;21
94;29.05.2017;2017;05;09;Maanantai;2;3;5
94;29.05.2017;2017;05;10;Maanantai;0;4;4
94;29.05.2017;2017;05;11;Maanantai;4;4;8
94;29.05.2017;2017;05;12;Maanantai;5;5;10
94;29.05.2017;2017;05;13;Maanantai;3;7;10
94;29.05.2017;2017;05;14;Maanantai;10;9;19
94;29.05.2017;2017;05;15;Maanantai;11;14;25
94;29.05.2017;2017;05;16;Maanantai;6;27;33
94;29.05.2017;2017;05;17;Maanantai;5;15;20
94;29.05.2017;2017;05;18;Maanantai;10;7;17
94;29.05.2017;2017;05;19;Maanantai;4;9;13
94;29.05.2017;2017;05;20;Maanantai;5;8;13
94;29.05.2017;2017;05;21;Maanantai;2;4;6
94;29.05.2017;2017;05;22;Maanantai;0;4;4
94;29.05.2017;2017;05;23;Maanantai;0;1;1
94;30.05.2017;2017;05;00;Tiistai;1;0;1
94;30.05.2017;2017;05;01;Tiistai;0;0;0
94;30.05.2017;2017;05;02;Tiistai;0;0;0
94;30.05.2017;2017;05;03;Tiistai;0;0;0
94;30.05.2017;2017;05;04;Tiistai;2;0;2
94;30.05.2017;2017;05;05;Tiistai;11;5;16
94;30.05.2017;2017;05;06;Tiistai;18;2;20
94;30.05.2017;2017;05;07;Tiistai;30;6;36
94;30.05.2017;2017;05;08;Tiistai;18;2;20
94;30.05.2017;2017;05;09;Tiistai;4;2;6
94;30.05.2017;2017;05;10;Tiistai;3;6;9
94;30.05.2017;2017;05;11;Tiistai;4;7;11
94;30.05.2017;2017;05;12;Tiistai;7;8;15
94;30.05.2017;2017;05;13;Tiistai;3;9;12
94;30.05.2017;2017;05;14;Tiistai;11;13;24
94;30.05.2017;2017;05;15;Tiistai;6;22;28
94;30.05.2017;2017;05;16;Tiistai;14;33;47
94;30.05.2017;2017;05;17;Tiistai;8;20;28
94;30.05.2017;2017;05;18;Tiistai;5;14;19
94;30.05.2017;2017;05;19;Tiistai;7;6;13
94;30.05.2017;2017;05;20;Tiistai;4;8;12
94;30.05.2017;2017;05;21;Tiistai;4;5;9
94;30.05.2017;2017;05;22;Tiistai;0;3;3
94;30.05.2017;2017;05;23;Tiistai;4;1;5
94;31.05.2017;2017;05;00;Keskiviikko;1;0;1
94;31.05.2017;2017;05;01;Keskiviikko;0;0;0
94;31.05.2017;2017;05;02;Keskiviikko;0;0;0
94;31.05.2017;2017;05;03;Keskiviikko;0;0;0
94;31.05.2017;2017;05;04;Keskiviikko;2;0;2
94;31.05.2017;2017;05;05;Keskiviikko;3;3;6
94;31.05.2017;2017;05;06;Keskiviikko;21;5;26
94;31.05.2017;2017;05;07;Keskiviikko;19;1;20
94;31.05.2017;2017;05;08;Keskiviikko;15;2;17
94;31.05.2017;2017;05;09;Keskiviikko;1;0;1
94;31.05.2017;2017;05;10;Keskiviikko;1;3;4
94;31.05.2017;2017;05;11;Keskiviikko;0;3;3
94;31.05.2017;2017;05;12;Keskiviikko;0;3;3
94;31.05.2017;2017;05;13;Keskiviikko;4;4;8
94;31.05.2017;2017;05;14;Keskiviikko;3;5;8
94;31.05.2017;2017;05;15;Keskiviikko;4;19;23
94;31.05.2017;2017;05;16;Keskiviikko;6;14;20
94;31.05.2017;2017;05;17;Keskiviikko;3;16;19
94;31.05.2017;2017;05;18;Keskiviikko;1;9;10
94;31.05.2017;2017;05;19;Keskiviikko;7;3;10
94;31.05.2017;2017;05;20;Keskiviikko;1;7;8
94;31.05.2017;2017;05;21;Keskiviikko;2;5;7
94;31.05.2017;2017;05;22;Keskiviikko;1;1;2
94;31.05.2017;2017;05;23;Keskiviikko;0;3;3
94;01.06.2017;2017;06;00;Torstai;0;0;0
94;01.06.2017;2017;06;01;Torstai;0;0;0
94;01.06.2017;2017;06;02;Torstai;0;0;0
94;01.06.2017;2017;06;03;Torstai;0;0;0
94;01.06.2017;2017;06;04;Torstai;1;0;1
94;01.06.2017;2017;06;05;Torstai;4;3;7
94;01.06.2017;2017;06;06;Torstai;22;3;25
94;01.06.2017;2017;06;07;Torstai;15;3;18
94;01.06.2017;2017;06;08;Torstai;13;2;15
94;01.06.2017;2017;06;09;Torstai;6;2;8
94;01.06.2017;2017;06;10;Torstai;2;5;7
94;01.06.2017;2017;06;11;Torstai;1;2;3
94;01.06.2017;2017;06;12;Torstai;3;2;5
94;01.06.2017;2017;06;13;Torstai;2;3;5
94;01.06.2017;2017;06;14;Torstai;4;3;7
94;01.06.2017;2017;06;15;Torstai;3;12;15
94;01.06.2017;2017;06;16;Torstai;3;20;23
94;01.06.2017;2017;06;17;Torstai;4;12;16
94;01.06.2017;2017;06;18;Torstai;1;5;6
94;01.06.2017;2017;06;19;Torstai;3;4;7
94;01.06.2017;2017;06;20;Torstai;1;1;2
94;01.06.2017;2017;06;21;Torstai;4;3;7
94;01.06.2017;2017;06;22;Torstai;4;7;11
94;01.06.2017;2017;06;23;Torstai;0;0;0
94;02.06.2017;2017;06;00;Perjantai;0;0;0
94;02.06.2017;2017;06;01;Perjantai;0;0;0
94;02.06.2017;2017;06;02;Perjantai;0;0;0
94;02.06.2017;2017;06;03;Perjantai;0;0;0
94;02.06.2017;2017;06;04;Perjantai;1;0;1
94;02.06.2017;2017;06;05;Perjantai;3;1;4
94;02.06.2017;2017;06;06;Perjantai;5;1;6
94;02.06.2017;2017;06;07;Perjantai;10;4;14
94;02.06.2017;2017;06;08;Perjantai;6;1;7
94;02.06.2017;2017;06;09;Perjantai;4;1;5
94;02.06.2017;2017;06;10;Perjantai;1;1;2
94;02.06.2017;2017;06;11;Perjantai;1;1;2
94;02.06.2017;2017;06;12;Perjantai;3;3;6
94;02.06.2017;2017;06;13;Perjantai;2;6;8
94;02.06.2017;2017;06;14;Perjantai;2;4;6
94;02.06.2017;2017;06;15;Perjantai;3;9;12
94;02.06.2017;2017;06;16;Perjantai;6;6;12
94;02.06.2017;2017;06;17;Perjantai;1;7;8
94;02.06.2017;2017;06;18;Perjantai;3;4;7
94;02.06.2017;2017;06;19;Perjantai;3;3;6
94;02.06.2017;2017;06;20;Perjantai;0;1;1
94;02.06.2017;2017;06;21;Perjantai;5;6;11
94;02.06.2017;2017;06;22;Perjantai;0;2;2
94;02.06.2017;2017;06;23;Perjantai;0;1;1
94;03.06.2017;2017;06;00;Lauantai;1;0;1
94;03.06.2017;2017;06;01;Lauantai;0;0;0
94;03.06.2017;2017;06;02;Lauantai;1;1;2
94;03.06.2017;2017;06;03;Lauantai;0;0;0
94;03.06.2017;2017;06;04;Lauantai;0;0;0
94;03.06.2017;2017;06;05;Lauantai;0;0;0
94;03.06.2017;2017;06;06;Lauantai;0;0;0
94;03.06.2017;2017;06;07;Lauantai;1;2;3
94;03.06.2017;2017;06;08;Lauantai;1;5;6
94;03.06.2017;2017;06;09;Lauantai;0;2;2
94;03.06.2017;2017;06;10;Lauantai;1;1;2
94;03.06.2017;2017;06;11;Lauantai;3;1;4
94;03.06.2017;2017;06;12;Lauantai;6;3;9
94;03.06.2017;2017;06;13;Lauantai;2;8;10
94;03.06.2017;2017;06;14;Lauantai;6;11;17
94;03.06.2017;2017;06;15;Lauantai;7;3;10
94;03.06.2017;2017;06;16;Lauantai;4;6;10
94;03.06.2017;2017;06;17;Lauantai;9;5;14
94;03.06.2017;2017;06;18;Lauantai;5;4;9
94;03.06.2017;2017;06;19;Lauantai;6;6;12
94;03.06.2017;2017;06;20;Lauantai;5;2;7
94;03.06.2017;2017;06;21;Lauantai;2;3;5
94;03.06.2017;2017;06;22;Lauantai;3;2;5
94;03.06.2017;2017;06;23;Lauantai;1;0;1
94;04.06.2017;2017;06;00;Sunnuntai;0;0;0
94;04.06.2017;2017;06;01;Sunnuntai;0;2;2
94;04.06.2017;2017;06;02;Sunnuntai;0;0;0
94;04.06.2017;2017;06;03;Sunnuntai;0;0;0
94;04.06.2017;2017;06;04;Sunnuntai;0;0;0
94;04.06.2017;2017;06;05;Sunnuntai;0;0;0
94;04.06.2017;2017;06;06;Sunnuntai;0;0;0
94;04.06.2017;2017;06;07;Sunnuntai;0;2;2
94;04.06.2017;2017;06;08;Sunnuntai;3;5;8
94;04.06.2017;2017;06;09;Sunnuntai;4;0;4
94;04.06.2017;2017;06;10;Sunnuntai;5;4;9
94;04.06.2017;2017;06;11;Sunnuntai;9;5;14
94;04.06.2017;2017;06;12;Sunnuntai;7;12;19
94;04.06.2017;2017;06;13;Sunnuntai;9;8;17
94;04.06.2017;2017;06;14;Sunnuntai;6;10;16
94;04.06.2017;2017;06;15;Sunnuntai;11;9;20
94;04.06.2017;2017;06;16;Sunnuntai;15;7;22
94;04.06.2017;2017;06;17;Sunnuntai;14;5;19
94;04.06.2017;2017;06;18;Sunnuntai;5;7;12
94;04.06.2017;2017;06;19;Sunnuntai;7;6;13
94;04.06.2017;2017;06;20;Sunnuntai;4;1;5
94;04.06.2017;2017;06;21;Sunnuntai;2;1;3
94;04.06.2017;2017;06;22;Sunnuntai;2;0;2
94;04.06.2017;2017;06;23;Sunnuntai;1;0;1
94;05.06.2017;2017;06;00;Maanantai;0;0;0
94;05.06.2017;2017;06;01;Maanantai;0;1;1
94;05.06.2017;2017;06;02;Maanantai;0;0;0
94;05.06.2017;2017;06;03;Maanantai;0;0;0
94;05.06.2017;2017;06;04;Maanantai;1;0;1
94;05.06.2017;2017;06;05;Maanantai;6;1;7
94;05.06.2017;2017;06;06;Maanantai;23;5;28
94;05.06.2017;2017;06;07;Maanantai;25;4;29
94;05.06.2017;2017;06;08;Maanantai;16;5;21
94;05.06.2017;2017;06;09;Maanantai;5;2;7
94;05.06.2017;2017;06;10;Maanantai;3;3;6
94;05.06.2017;2017;06;11;Maanantai;7;7;14
94;05.06.2017;2017;06;12;Maanantai;11;8;19
94;05.06.2017;2017;06;13;Maanantai;6;14;20
94;05.06.2017;2017;06;14;Maanantai;13;17;30
94;05.06.2017;2017;06;15;Maanantai;12;26;38
94;05.06.2017;2017;06;16;Maanantai;3;39;42
94;05.06.2017;2017;06;17;Maanantai;5;16;21
94;05.06.2017;2017;06;18;Maanantai;9;23;32
94;05.06.2017;2017;06;19;Maanantai;8;12;20
94;05.06.2017;2017;06;20;Maanantai;5;5;10
94;05.06.2017;2017;06;21;Maanantai;1;7;8
94;05.06.2017;2017;06;22;Maanantai;1;1;2
94;05.06.2017;2017;06;23;Maanantai;1;2;3
94;06.06.2017;2017;06;00;Tiistai;0;0;0
94;06.06.2017;2017;06;01;Tiistai;0;0;0
94;06.06.2017;2017;06;02;Tiistai;0;1;1
94;06.06.2017;2017;06;03;Tiistai;0;0;0
94;06.06.2017;2017;06;04;Tiistai;1;0;1
94;06.06.2017;2017;06;05;Tiistai;4;4;8
94;06.06.2017;2017;06;06;Tiistai;16;0;16
94;06.06.2017;2017;06;07;Tiistai;14;3;17
94;06.06.2017;2017;06;08;Tiistai;7;8;15
94;06.06.2017;2017;06;09;Tiistai;2;2;4
94;06.06.2017;2017;06;10;Tiistai;4;3;7
94;06.06.2017;2017;06;11;Tiistai;4;0;4
94;06.06.2017;2017;06;12;Tiistai;5;5;10
94;06.06.2017;2017;06;13;Tiistai;1;5;6
94;06.06.2017;2017;06;14;Tiistai;8;6;14
94;06.06.2017;2017;06;15;Tiistai;8;12;20
94;06.06.2017;2017;06;16;Tiistai;5;12;17
94;06.06.2017;2017;06;17;Tiistai;4;22;26
94;06.06.2017;2017;06;18;Tiistai;9;21;30
94;06.06.2017;2017;06;19;Tiistai;9;11;20
94;06.06.2017;2017;06;20;Tiistai;9;9;18
94;06.06.2017;2017;06;21;Tiistai;6;5;11
94;06.06.2017;2017;06;22;Tiistai;1;4;5
94;06.06.2017;2017;06;23;Tiistai;1;0;1
94;07.06.2017;2017;06;00;Keskiviikko;0;0;0
94;07.06.2017;2017;06;01;Keskiviikko;0;0;0
94;07.06.2017;2017;06;02;Keskiviikko;0;1;1
94;07.06.2017;2017;06;03;Keskiviikko;0;0;0
94;07.06.2017;2017;06;04;Keskiviikko;2;0;2
94;07.06.2017;2017;06;05;Keskiviikko;6;4;10
94;07.06.2017;2017;06;06;Keskiviikko;37;3;40
94;07.06.2017;2017;06;07;Keskiviikko;29;9;38
94;07.06.2017;2017;06;08;Keskiviikko;16;8;24
94;07.06.2017;2017;06;09;Keskiviikko;9;2;11
94;07.06.2017;2017;06;10;Keskiviikko;19;6;25
94;07.06.2017;2017;06;11;Keskiviikko;9;8;17
94;07.06.2017;2017;06;12;Keskiviikko;16;16;32
94;07.06.2017;2017;06;13;Keskiviikko;17;5;22
94;07.06.2017;2017;06;14;Keskiviikko;11;14;25
94;07.06.2017;2017;06;15;Keskiviikko;17;48;65
94;07.06.2017;2017;06;16;Keskiviikko;10;38;48
94;07.06.2017;2017;06;17;Keskiviikko;10;33;43
94;07.06.2017;2017;06;18;Keskiviikko;21;17;38
94;07.06.2017;2017;06;19;Keskiviikko;19;17;36
94;07.06.2017;2017;06;20;Keskiviikko;14;16;30
94;07.06.2017;2017;06;21;Keskiviikko;8;14;22
94;07.06.2017;2017;06;22;Keskiviikko;1;10;11
94;07.06.2017;2017;06;23;Keskiviikko;3;3;6
94;08.06.2017;2017;06;00;Torstai;0;0;0
94;08.06.2017;2017;06;01;Torstai;0;0;0
94;08.06.2017;2017;06;02;Torstai;0;0;0
94;08.06.2017;2017;06;03;Torstai;0;1;1
94;08.06.2017;2017;06;04;Torstai;1;0;1
94;08.06.2017;2017;06;05;Torstai;6;7;13
94;08.06.2017;2017;06;06;Torstai;29;2;31
94;08.06.2017;2017;06;07;Torstai;35;11;46
94;08.06.2017;2017;06;08;Torstai;19;2;21
94;08.06.2017;2017;06;09;Torstai;4;9;13
94;08.06.2017;2017;06;10;Torstai;7;5;12
94;08.06.2017;2017;06;11;Torstai;12;10;22
94;08.06.2017;2017;06;12;Torstai;13;10;23
94;08.06.2017;2017;06;13;Torstai;10;10;20
94;08.06.2017;2017;06;14;Torstai;10;8;18
94;08.06.2017;2017;06;15;Torstai;17;33;50
94;08.06.2017;2017;06;16;Torstai;12;50;62
94;08.06.2017;2017;06;17;Torstai;11;23;34
94;08.06.2017;2017;06;18;Torstai;15;22;37
94;08.06.2017;2017;06;19;Torstai;20;11;31
94;08.06.2017;2017;06;20;Torstai;5;14;19
94;08.06.2017;2017;06;21;Torstai;7;11;18
94;08.06.2017;2017;06;22;Torstai;1;12;13
94;08.06.2017;2017;06;23;Torstai;2;3;5
94;09.06.2017;2017;06;00;Perjantai;0;0;0
94;09.06.2017;2017;06;01;Perjantai;0;0;0
94;09.06.2017;2017;06;02;Perjantai;0;0;0
94;09.06.2017;2017;06;03;Perjantai;0;2;2
94;09.06.2017;2017;06;04;Perjantai;1;0;1
94;09.06.2017;2017;06;05;Perjantai;10;1;11
94;09.06.2017;2017;06;06;Perjantai;25;3;28
94;09.06.2017;2017;06;07;Perjantai;23;6;29
94;09.06.2017;2017;06;08;Perjantai;11;8;19
94;09.06.2017;2017;06;09;Perjantai;8;8;16
94;09.06.2017;2017;06;10;Perjantai;5;4;9
94;09.06.2017;2017;06;11;Perjantai;10;8;18
94;09.06.2017;2017;06;12;Perjantai;15;15;30
94;09.06.2017;2017;06;13;Perjantai;6;7;13
94;09.06.2017;2017;06;14;Perjantai;14;17;31
94;09.06.2017;2017;06;15;Perjantai;10;31;41
94;09.06.2017;2017;06;16;Perjantai;19;23;42
94;09.06.2017;2017;06;17;Perjantai;10;16;26
94;09.06.2017;2017;06;18;Perjantai;13;22;35
94;09.06.2017;2017;06;19;Perjantai;7;16;23
94;09.06.2017;2017;06;20;Perjantai;6;8;14
94;09.06.2017;2017;06;21;Perjantai;3;6;9
94;09.06.2017;2017;06;22;Perjantai;1;10;11
94;09.06.2017;2017;06;23;Perjantai;3;2;5
94;10.06.2017;2017;06;00;Lauantai;3;1;4
94;10.06.2017;2017;06;01;Lauantai;0;3;3
94;10.06.2017;2017;06;02;Lauantai;1;5;6
94;10.06.2017;2017;06;03;Lauantai;0;0;0
94;10.06.2017;2017;06;04;Lauantai;3;0;3
94;10.06.2017;2017;06;05;Lauantai;0;0;0
94;10.06.2017;2017;06;06;Lauantai;3;2;5
94;10.06.2017;2017;06;07;Lauantai;1;3;4
94;10.06.2017;2017;06;08;Lauantai;1;3;4
94;10.06.2017;2017;06;09;Lauantai;6;13;19
94;10.06.2017;2017;06;10;Lauantai;10;4;14
94;10.06.2017;2017;06;11;Lauantai;7;5;12
94;10.06.2017;2017;06;12;Lauantai;23;13;36
94;10.06.2017;2017;06;13;Lauantai;16;19;35
94;10.06.2017;2017;06;14;Lauantai;11;14;25
94;10.06.2017;2017;06;15;Lauantai;17;8;25
94;10.06.2017;2017;06;16;Lauantai;16;18;34
94;10.06.2017;2017;06;17;Lauantai;19;17;36
94;10.06.2017;2017;06;18;Lauantai;23;12;35
94;10.06.2017;2017;06;19;Lauantai;9;10;19
94;10.06.2017;2017;06;20;Lauantai;11;4;15
94;10.06.2017;2017;06;21;Lauantai;2;7;9
94;10.06.2017;2017;06;22;Lauantai;1;2;3
94;10.06.2017;2017;06;23;Lauantai;0;3;3
94;11.06.2017;2017;06;00;Sunnuntai;5;5;10
94;11.06.2017;2017;06;01;Sunnuntai;2;0;2
94;11.06.2017;2017;06;02;Sunnuntai;1;0;1
94;11.06.2017;2017;06;03;Sunnuntai;0;1;1
94;11.06.2017;2017;06;04;Sunnuntai;1;0;1
94;11.06.2017;2017;06;05;Sunnuntai;2;0;2
94;11.06.2017;2017;06;06;Sunnuntai;3;0;3
94;11.06.2017;2017;06;07;Sunnuntai;0;6;6
94;11.06.2017;2017;06;08;Sunnuntai;4;7;11
94;11.06.2017;2017;06;09;Sunnuntai;11;11;22
94;11.06.2017;2017;06;10;Sunnuntai;16;5;21
94;11.06.2017;2017;06;11;Sunnuntai;14;15;29
94;11.06.2017;2017;06;12;Sunnuntai;17;18;35
94;11.06.2017;2017;06;13;Sunnuntai;14;10;24
94;11.06.2017;2017;06;14;Sunnuntai;18;22;40
94;11.06.2017;2017;06;15;Sunnuntai;14;11;25
94;11.06.2017;2017;06;16;Sunnuntai;18;12;30
94;11.06.2017;2017;06;17;Sunnuntai;14;7;21
94;11.06.2017;2017;06;18;Sunnuntai;11;7;18
94;11.06.2017;2017;06;19;Sunnuntai;18;16;34
94;11.06.2017;2017;06;20;Sunnuntai;6;4;10
94;11.06.2017;2017;06;21;Sunnuntai;4;9;13
94;11.06.2017;2017;06;22;Sunnuntai;1;4;5
94;11.06.2017;2017;06;23;Sunnuntai;0;0;0
94;12.06.2017;2017;06;00;Maanantai;0;0;0
94;12.06.2017;2017;06;01;Maanantai;0;1;1
94;12.06.2017;2017;06;02;Maanantai;0;0;0
94;12.06.2017;2017;06;03;Maanantai;0;0;0
94;12.06.2017;2017;06;04;Maanantai;1;0;1
94;12.06.2017;2017;06;05;Maanantai;4;3;7
94;12.06.2017;2017;06;06;Maanantai;35;5;40
94;12.06.2017;2017;06;07;Maanantai;29;5;34
94;12.06.2017;2017;06;08;Maanantai;12;7;19
94;12.06.2017;2017;06;09;Maanantai;1;1;2
94;12.06.2017;2017;06;10;Maanantai;3;0;3
94;12.06.2017;2017;06;11;Maanantai;1;2;3
94;12.06.2017;2017;06;12;Maanantai;5;2;7
94;12.06.2017;2017;06;13;Maanantai;4;6;10
94;12.06.2017;2017;06;14;Maanantai;11;8;19
94;12.06.2017;2017;06;15;Maanantai;12;21;33
94;12.06.2017;2017;06;16;Maanantai;10;44;54
94;12.06.2017;2017;06;17;Maanantai;0;22;22
94;12.06.2017;2017;06;18;Maanantai;2;7;9
94;12.06.2017;2017;06;19;Maanantai;10;14;24
94;12.06.2017;2017;06;20;Maanantai;3;6;9
94;12.06.2017;2017;06;21;Maanantai;3;4;7
94;12.06.2017;2017;06;22;Maanantai;1;2;3
94;12.06.2017;2017;06;23;Maanantai;3;3;6
94;13.06.2017;2017;06;00;Tiistai;0;1;1
94;13.06.2017;2017;06;01;Tiistai;0;0;0
94;13.06.2017;2017;06;02;Tiistai;0;0;0
94;13.06.2017;2017;06;03;Tiistai;0;0;0
94;13.06.2017;2017;06;04;Tiistai;1;0;1
94;13.06.2017;2017;06;05;Tiistai;9;3;12
94;13.06.2017;2017;06;06;Tiistai;23;4;27
94;13.06.2017;2017;06;07;Tiistai;33;4;37
94;13.06.2017;2017;06;08;Tiistai;18;8;26
94;13.06.2017;2017;06;09;Tiistai;2;4;6
94;13.06.2017;2017;06;10;Tiistai;8;8;16
94;13.06.2017;2017;06;11;Tiistai;5;3;8
94;13.06.2017;2017;06;12;Tiistai;9;6;15
94;13.06.2017;2017;06;13;Tiistai;11;11;22
94;13.06.2017;2017;06;14;Tiistai;18;14;32
94;13.06.2017;2017;06;15;Tiistai;17;27;44
94;13.06.2017;2017;06;16;Tiistai;11;47;58
94;13.06.2017;2017;06;17;Tiistai;15;24;39
94;13.06.2017;2017;06;18;Tiistai;19;30;49
94;13.06.2017;2017;06;19;Tiistai;14;14;28
94;13.06.2017;2017;06;20;Tiistai;12;7;19
94;13.06.2017;2017;06;21;Tiistai;1;4;5
94;13.06.2017;2017;06;22;Tiistai;1;3;4
94;13.06.2017;2017;06;23;Tiistai;0;2;2
94;14.06.2017;2017;06;00;Keskiviikko;0;2;2
94;14.06.2017;2017;06;01;Keskiviikko;0;1;1
94;14.06.2017;2017;06;02;Keskiviikko;0;0;0
94;14.06.2017;2017;06;03;Keskiviikko;1;0;1
94;14.06.2017;2017;06;04;Keskiviikko;0;0;0
94;14.06.2017;2017;06;05;Keskiviikko;8;4;12
94;14.06.2017;2017;06;06;Keskiviikko;30;6;36
94;14.06.2017;2017;06;07;Keskiviikko;34;3;37
94;14.06.2017;2017;06;08;Keskiviikko;19;4;23
94;14.06.2017;2017;06;09;Keskiviikko;5;4;9
94;14.06.2017;2017;06;10;Keskiviikko;7;5;12
94;14.06.2017;2017;06;11;Keskiviikko;14;5;19
94;14.06.2017;2017;06;12;Keskiviikko;10;11;21
94;14.06.2017;2017;06;13;Keskiviikko;12;12;24
94;14.06.2017;2017;06;14;Keskiviikko;12;11;23
94;14.06.2017;2017;06;15;Keskiviikko;14;35;49
94;14.06.2017;2017;06;16;Keskiviikko;14;38;52
94;14.06.2017;2017;06;17;Keskiviikko;18;20;38
94;14.06.2017;2017;06;18;Keskiviikko;19;23;42
94;14.06.2017;2017;06;19;Keskiviikko;21;13;34
94;14.06.2017;2017;06;20;Keskiviikko;12;17;29
94;14.06.2017;2017;06;21;Keskiviikko;10;13;23
94;14.06.2017;2017;06;22;Keskiviikko;6;7;13
94;14.06.2017;2017;06;23;Keskiviikko;0;1;1
94;15.06.2017;2017;06;00;Torstai;0;0;0
94;15.06.2017;2017;06;01;Torstai;0;0;0
94;15.06.2017;2017;06;02;Torstai;2;1;3
94;15.06.2017;2017;06;03;Torstai;0;0;0
94;15.06.2017;2017;06;04;Torstai;0;0;0
94;15.06.2017;2017;06;05;Torstai;6;4;10
94;15.06.2017;2017;06;06;Torstai;24;2;26
94;15.06.2017;2017;06;07;Torstai;26;4;30
94;15.06.2017;2017;06;08;Torstai;17;6;23
94;15.06.2017;2017;06;09;Torstai;8;3;11
94;15.06.2017;2017;06;10;Torstai;15;11;26
94;15.06.2017;2017;06;11;Torstai;6;14;20
94;15.06.2017;2017;06;12;Torstai;9;12;21
94;15.06.2017;2017;06;13;Torstai;10;22;32
94;15.06.2017;2017;06;14;Torstai;10;19;29
94;15.06.2017;2017;06;15;Torstai;12;23;35
94;15.06.2017;2017;06;16;Torstai;18;47;65
94;15.06.2017;2017;06;17;Torstai;12;25;37
94;15.06.2017;2017;06;18;Torstai;23;13;36
94;15.06.2017;2017;06;19;Torstai;12;14;26
94;15.06.2017;2017;06;20;Torstai;9;9;18
94;15.06.2017;2017;06;21;Torstai;7;13;20
94;15.06.2017;2017;06;22;Torstai;0;5;5
94;15.06.2017;2017;06;23;Torstai;2;3;5
94;16.06.2017;2017;06;00;Perjantai;0;4;4
94;16.06.2017;2017;06;01;Perjantai;0;0;0
94;16.06.2017;2017;06;02;Perjantai;0;0;0
94;16.06.2017;2017;06;03;Perjantai;0;0;0
94;16.06.2017;2017;06;04;Perjantai;0;0;0
94;16.06.2017;2017;06;05;Perjantai;9;4;13
94;16.06.2017;2017;06;06;Perjantai;21;1;22
94;16.06.2017;2017;06;07;Perjantai;20;3;23
94;16.06.2017;2017;06;08;Perjantai;16;2;18
94;16.06.2017;2017;06;09;Perjantai;9;2;11
94;16.06.2017;2017;06;10;Perjantai;4;4;8
94;16.06.2017;2017;06;11;Perjantai;7;6;13
94;16.06.2017;2017;06;12;Perjantai;10;17;27
94;16.06.2017;2017;06;13;Perjantai;6;18;24
94;16.06.2017;2017;06;14;Perjantai;16;19;35
94;16.06.2017;2017;06;15;Perjantai;10;35;45
94;16.06.2017;2017;06;16;Perjantai;9;29;38
94;16.06.2017;2017;06;17;Perjantai;15;18;33
94;16.06.2017;2017;06;18;Perjantai;16;18;34
94;16.06.2017;2017;06;19;Perjantai;10;13;23
94;16.06.2017;2017;06;20;Perjantai;6;10;16
94;16.06.2017;2017;06;21;Perjantai;2;14;16
94;16.06.2017;2017;06;22;Perjantai;1;2;3
94;16.06.2017;2017;06;23;Perjantai;2;4;6
94;17.06.2017;2017;06;00;Lauantai;4;4;8
94;17.06.2017;2017;06;01;Lauantai;3;2;5
94;17.06.2017;2017;06;02;Lauantai;0;0;0
94;17.06.2017;2017;06;03;Lauantai;3;0;3
94;17.06.2017;2017;06;04;Lauantai;1;0;1
94;17.06.2017;2017;06;05;Lauantai;4;0;4
94;17.06.2017;2017;06;06;Lauantai;1;0;1
94;17.06.2017;2017;06;07;Lauantai;0;1;1
94;17.06.2017;2017;06;08;Lauantai;4;7;11
94;17.06.2017;2017;06;09;Lauantai;12;3;15
94;17.06.2017;2017;06;10;Lauantai;11;23;34
94;17.06.2017;2017;06;11;Lauantai;9;7;16
94;17.06.2017;2017;06;12;Lauantai;14;21;35
94;17.06.2017;2017;06;13;Lauantai;14;14;28
94;17.06.2017;2017;06;14;Lauantai;11;9;20
94;17.06.2017;2017;06;15;Lauantai;12;14;26
94;17.06.2017;2017;06;16;Lauantai;17;18;35
94;17.06.2017;2017;06;17;Lauantai;22;7;29
94;17.06.2017;2017;06;18;Lauantai;6;17;23
94;17.06.2017;2017;06;19;Lauantai;11;12;23
94;17.06.2017;2017;06;20;Lauantai;4;3;7
94;17.06.2017;2017;06;21;Lauantai;2;8;10
94;17.06.2017;2017;06;22;Lauantai;5;0;5
94;17.06.2017;2017;06;23;Lauantai;0;4;4
94;18.06.2017;2017;06;00;Sunnuntai;2;1;3
94;18.06.2017;2017;06;01;Sunnuntai;11;0;11
94;18.06.2017;2017;06;02;Sunnuntai;2;1;3
94;18.06.2017;2017;06;03;Sunnuntai;1;0;1
94;18.06.2017;2017;06;04;Sunnuntai;0;0;0
94;18.06.2017;2017;06;05;Sunnuntai;1;1;2
94;18.06.2017;2017;06;06;Sunnuntai;2;1;3
94;18.06.2017;2017;06;07;Sunnuntai;1;2;3
94;18.06.2017;2017;06;08;Sunnuntai;0;0;0
94;18.06.2017;2017;06;09;Sunnuntai;2;1;3
94;18.06.2017;2017;06;10;Sunnuntai;0;1;1
94;18.06.2017;2017;06;11;Sunnuntai;0;1;1
94;18.06.2017;2017;06;12;Sunnuntai;2;3;5
94;18.06.2017;2017;06;13;Sunnuntai;3;6;9
94;18.06.2017;2017;06;14;Sunnuntai;7;12;19
94;18.06.2017;2017;06;15;Sunnuntai;5;4;9
94;18.06.2017;2017;06;16;Sunnuntai;9;6;15
94;18.06.2017;2017;06;17;Sunnuntai;9;6;15
94;18.06.2017;2017;06;18;Sunnuntai;5;3;8
94;18.06.2017;2017;06;19;Sunnuntai;9;8;17
94;18.06.2017;2017;06;20;Sunnuntai;5;2;7
94;18.06.2017;2017;06;21;Sunnuntai;4;4;8
94;18.06.2017;2017;06;22;Sunnuntai;3;2;5
94;18.06.2017;2017;06;23;Sunnuntai;0;2;2
94;19.06.2017;2017;06;00;Maanantai;1;0;1
94;19.06.2017;2017;06;01;Maanantai;0;1;1
94;19.06.2017;2017;06;02;Maanantai;0;0;0
94;19.06.2017;2017;06;03;Maanantai;0;1;1
94;19.06.2017;2017;06;04;Maanantai;1;1;2
94;19.06.2017;2017;06;05;Maanantai;6;4;10
94;19.06.2017;2017;06;06;Maanantai;28;0;28
94;19.06.2017;2017;06;07;Maanantai;27;6;33
94;19.06.2017;2017;06;08;Maanantai;13;4;17
94;19.06.2017;2017;06;09;Maanantai;10;5;15
94;19.06.2017;2017;06;10;Maanantai;5;8;13
94;19.06.2017;2017;06;11;Maanantai;13;8;21
94;19.06.2017;2017;06;12;Maanantai;13;7;20
94;19.06.2017;2017;06;13;Maanantai;9;12;21
94;19.06.2017;2017;06;14;Maanantai;8;12;20
94;19.06.2017;2017;06;15;Maanantai;5;25;30
94;19.06.2017;2017;06;16;Maanantai;19;40;59
94;19.06.2017;2017;06;17;Maanantai;13;23;36
94;19.06.2017;2017;06;18;Maanantai;9;13;22
94;19.06.2017;2017;06;19;Maanantai;4;8;12
94;19.06.2017;2017;06;20;Maanantai;12;4;16
94;19.06.2017;2017;06;21;Maanantai;6;7;13
94;19.06.2017;2017;06;22;Maanantai;4;3;7
94;19.06.2017;2017;06;23;Maanantai;0;1;1
94;20.06.2017;2017;06;00;Tiistai;2;3;5
94;20.06.2017;2017;06;01;Tiistai;2;0;2
94;20.06.2017;2017;06;02;Tiistai;0;0;0
94;20.06.2017;2017;06;03;Tiistai;0;1;1
94;20.06.2017;2017;06;04;Tiistai;1;0;1
94;20.06.2017;2017;06;05;Tiistai;5;4;9
94;20.06.2017;2017;06;06;Tiistai;21;3;24
94;20.06.2017;2017;06;07;Tiistai;25;5;30
94;20.06.2017;2017;06;08;Tiistai;12;6;18
94;20.06.2017;2017;06;09;Tiistai;9;0;9
94;20.06.2017;2017;06;10;Tiistai;6;5;11
94;20.06.2017;2017;06;11;Tiistai;7;9;16
94;20.06.2017;2017;06;12;Tiistai;9;7;16
94;20.06.2017;2017;06;13;Tiistai;3;3;6
94;20.06.2017;2017;06;14;Tiistai;15;11;26
94;20.06.2017;2017;06;15;Tiistai;11;32;43
94;20.06.2017;2017;06;16;Tiistai;4;19;23
94;20.06.2017;2017;06;17;Tiistai;10;25;35
94;20.06.2017;2017;06;18;Tiistai;20;8;28
94;20.06.2017;2017;06;19;Tiistai;9;11;20
94;20.06.2017;2017;06;20;Tiistai;7;15;22
94;20.06.2017;2017;06;21;Tiistai;3;10;13
94;20.06.2017;2017;06;22;Tiistai;5;6;11
94;20.06.2017;2017;06;23;Tiistai;0;1;1
94;21.06.2017;2017;06;00;Keskiviikko;0;0;0
94;21.06.2017;2017;06;01;Keskiviikko;0;0;0
94;21.06.2017;2017;06;02;Keskiviikko;0;0;0
94;21.06.2017;2017;06;03;Keskiviikko;0;2;2
94;21.06.2017;2017;06;04;Keskiviikko;0;0;0
94;21.06.2017;2017;06;05;Keskiviikko;5;5;10
94;21.06.2017;2017;06;06;Keskiviikko;32;2;34
94;21.06.2017;2017;06;07;Keskiviikko;22;4;26
94;21.06.2017;2017;06;08;Keskiviikko;14;3;17
94;21.06.2017;2017;06;09;Keskiviikko;4;1;5
94;21.06.2017;2017;06;10;Keskiviikko;6;2;8
94;21.06.2017;2017;06;11;Keskiviikko;12;7;19
94;21.06.2017;2017;06;12;Keskiviikko;4;5;9
94;21.06.2017;2017;06;13;Keskiviikko;2;9;11
94;21.06.2017;2017;06;14;Keskiviikko;6;6;12
94;21.06.2017;2017;06;15;Keskiviikko;9;24;33
94;21.06.2017;2017;06;16;Keskiviikko;8;33;41
94;21.06.2017;2017;06;17;Keskiviikko;1;10;11
94;21.06.2017;2017;06;18;Keskiviikko;1;8;9
94;21.06.2017;2017;06;19;Keskiviikko;2;3;5
94;21.06.2017;2017;06;20;Keskiviikko;6;7;13
94;21.06.2017;2017;06;21;Keskiviikko;2;3;5
94;21.06.2017;2017;06;22;Keskiviikko;3;1;4
94;21.06.2017;2017;06;23;Keskiviikko;1;1;2
94;22.06.2017;2017;06;00;Torstai;0;0;0
94;22.06.2017;2017;06;01;Torstai;0;0;0
94;22.06.2017;2017;06;02;Torstai;0;0;0
94;22.06.2017;2017;06;03;Torstai;0;1;1
94;22.06.2017;2017;06;04;Torstai;0;0;0
94;22.06.2017;2017;06;05;Torstai;6;2;8
94;22.06.2017;2017;06;06;Torstai;13;0;13
94;22.06.2017;2017;06;07;Torstai;13;2;15
94;22.06.2017;2017;06;08;Torstai;8;1;9
94;22.06.2017;2017;06;09;Torstai;2;1;3
94;22.06.2017;2017;06;10;Torstai;3;3;6
94;22.06.2017;2017;06;11;Torstai;4;3;7
94;22.06.2017;2017;06;12;Torstai;2;5;7
94;22.06.2017;2017;06;13;Torstai;4;2;6
94;22.06.2017;2017;06;14;Torstai;3;9;12
94;22.06.2017;2017;06;15;Torstai;2;15;17
94;22.06.2017;2017;06;16;Torstai;5;20;25
94;22.06.2017;2017;06;17;Torstai;4;4;8
94;22.06.2017;2017;06;18;Torstai;5;6;11
94;22.06.2017;2017;06;19;Torstai;3;5;8
94;22.06.2017;2017;06;20;Torstai;2;1;3
94;22.06.2017;2017;06;21;Torstai;3;2;5
94;22.06.2017;2017;06;22;Torstai;1;2;3
94;22.06.2017;2017;06;23;Torstai;0;1;1
94;23.06.2017;2017;06;00;Perjantai;0;0;0
94;23.06.2017;2017;06;01;Perjantai;0;0;0
94;23.06.2017;2017;06;02;Perjantai;0;0;0
94;23.06.2017;2017;06;03;Perjantai;0;0;0
94;23.06.2017;2017;06;04;Perjantai;0;0;0
94;23.06.2017;2017;06;05;Perjantai;0;0;0
94;23.06.2017;2017;06;06;Perjantai;0;0;0
94;23.06.2017;2017;06;07;Perjantai;0;0;0
94;23.06.2017;2017;06;08;Perjantai;3;0;3
94;23.06.2017;2017;06;09;Perjantai;2;7;9
94;23.06.2017;2017;06;10;Perjantai;5;7;12
94;23.06.2017;2017;06;11;Perjantai;6;8;14
94;23.06.2017;2017;06;12;Perjantai;1;14;15
94;23.06.2017;2017;06;13;Perjantai;2;14;16
94;23.06.2017;2017;06;14;Perjantai;11;12;23
94;23.06.2017;2017;06;15;Perjantai;11;9;20
94;23.06.2017;2017;06;16;Perjantai;11;7;18
94;23.06.2017;2017;06;17;Perjantai;8;9;17
94;23.06.2017;2017;06;18;Perjantai;6;5;11
94;23.06.2017;2017;06;19;Perjantai;5;3;8
94;23.06.2017;2017;06;20;Perjantai;9;3;12
94;23.06.2017;2017;06;21;Perjantai;1;1;2
94;23.06.2017;2017;06;22;Perjantai;1;2;3
94;23.06.2017;2017;06;23;Perjantai;2;1;3
94;24.06.2017;2017;06;00;Lauantai;0;0;0
94;24.06.2017;2017;06;01;Lauantai;1;1;2
94;24.06.2017;2017;06;02;Lauantai;0;3;3
94;24.06.2017;2017;06;03;Lauantai;0;0;0
94;24.06.2017;2017;06;04;Lauantai;0;0;0
94;24.06.2017;2017;06;05;Lauantai;0;0;0
94;24.06.2017;2017;06;06;Lauantai;0;0;0
94;24.06.2017;2017;06;07;Lauantai;1;3;4
94;24.06.2017;2017;06;08;Lauantai;1;2;3
94;24.06.2017;2017;06;09;Lauantai;2;1;3
94;24.06.2017;2017;06;10;Lauantai;4;5;9
94;24.06.2017;2017;06;11;Lauantai;11;6;17
94;24.06.2017;2017;06;12;Lauantai;12;12;24
94;24.06.2017;2017;06;13;Lauantai;15;18;33
94;24.06.2017;2017;06;14;Lauantai;10;13;23
94;24.06.2017;2017;06;15;Lauantai;8;11;19
94;24.06.2017;2017;06;16;Lauantai;11;9;20
94;24.06.2017;2017;06;17;Lauantai;12;5;17
94;24.06.2017;2017;06;18;Lauantai;3;13;16
94;24.06.2017;2017;06;19;Lauantai;6;4;10
94;24.06.2017;2017;06;20;Lauantai;7;4;11
94;24.06.2017;2017;06;21;Lauantai;4;3;7
94;24.06.2017;2017;06;22;Lauantai;0;1;1
94;24.06.2017;2017;06;23;Lauantai;0;3;3
94;25.06.2017;2017;06;00;Sunnuntai;0;1;1
94;25.06.2017;2017;06;01;Sunnuntai;1;0;1
94;25.06.2017;2017;06;02;Sunnuntai;1;0;1
94;25.06.2017;2017;06;03;Sunnuntai;0;0;0
94;25.06.2017;2017;06;04;Sunnuntai;1;0;1
94;25.06.2017;2017;06;05;Sunnuntai;0;0;0
94;25.06.2017;2017;06;06;Sunnuntai;2;0;2
94;25.06.2017;2017;06;07;Sunnuntai;2;4;6
94;25.06.2017;2017;06;08;Sunnuntai;0;4;4
94;25.06.2017;2017;06;09;Sunnuntai;4;2;6
94;25.06.2017;2017;06;10;Sunnuntai;7;3;10
94;25.06.2017;2017;06;11;Sunnuntai;5;2;7
94;25.06.2017;2017;06;12;Sunnuntai;1;5;6
94;25.06.2017;2017;06;13;Sunnuntai;2;0;2
94;25.06.2017;2017;06;14;Sunnuntai;1;0;1
94;25.06.2017;2017;06;15;Sunnuntai;6;10;16
94;25.06.2017;2017;06;16;Sunnuntai;1;3;4
94;25.06.2017;2017;06;17;Sunnuntai;1;0;1
94;25.06.2017;2017;06;18;Sunnuntai;4;7;11
94;25.06.2017;2017;06;19;Sunnuntai;6;4;10
94;25.06.2017;2017;06;20;Sunnuntai;6;1;7
94;25.06.2017;2017;06;21;Sunnuntai;3;0;3
94;25.06.2017;2017;06;22;Sunnuntai;2;1;3
94;25.06.2017;2017;06;23;Sunnuntai;0;0;0
94;26.06.2017;2017;06;00;Maanantai;0;0;0
94;26.06.2017;2017;06;01;Maanantai;0;1;1
94;26.06.2017;2017;06;02;Maanantai;0;0;0
94;26.06.2017;2017;06;03;Maanantai;0;0;0
94;26.06.2017;2017;06;04;Maanantai;1;0;1
94;26.06.2017;2017;06;05;Maanantai;2;1;3
94;26.06.2017;2017;06;06;Maanantai;8;0;8
94;26.06.2017;2017;06;07;Maanantai;6;2;8
94;26.06.2017;2017;06;08;Maanantai;4;0;4
94;26.06.2017;2017;06;09;Maanantai;2;1;3
94;26.06.2017;2017;06;10;Maanantai;1;1;2
94;26.06.2017;2017;06;11;Maanantai;1;3;4
94;26.06.2017;2017;06;12;Maanantai;2;0;2
94;26.06.2017;2017;06;13;Maanantai;5;1;6
94;26.06.2017;2017;06;14;Maanantai;2;4;6
94;26.06.2017;2017;06;15;Maanantai;8;9;17
94;26.06.2017;2017;06;16;Maanantai;14;12;26
94;26.06.2017;2017;06;17;Maanantai;4;10;14
94;26.06.2017;2017;06;18;Maanantai;11;23;34
94;26.06.2017;2017;06;19;Maanantai;16;10;26
94;26.06.2017;2017;06;20;Maanantai;4;11;15
94;26.06.2017;2017;06;21;Maanantai;6;3;9
94;26.06.2017;2017;06;22;Maanantai;2;6;8
94;26.06.2017;2017;06;23;Maanantai;3;2;5
94;27.06.2017;2017;06;00;Tiistai;1;0;1
94;27.06.2017;2017;06;01;Tiistai;0;0;0
94;27.06.2017;2017;06;02;Tiistai;0;0;0
94;27.06.2017;2017;06;03;Tiistai;0;0;0
94;27.06.2017;2017;06;04;Tiistai;3;0;3
94;27.06.2017;2017;06;05;Tiistai;5;2;7
94;27.06.2017;2017;06;06;Tiistai;14;2;16
94;27.06.2017;2017;06;07;Tiistai;18;6;24
94;27.06.2017;2017;06;08;Tiistai;7;0;7
94;27.06.2017;2017;06;09;Tiistai;5;4;9
94;27.06.2017;2017;06;10;Tiistai;5;5;10
94;27.06.2017;2017;06;11;Tiistai;3;4;7
94;27.06.2017;2017;06;12;Tiistai;5;3;8
94;27.06.2017;2017;06;13;Tiistai;2;2;4
94;27.06.2017;2017;06;14;Tiistai;13;5;18
94;27.06.2017;2017;06;15;Tiistai;7;21;28
94;27.06.2017;2017;06;16;Tiistai;9;18;27
94;27.06.2017;2017;06;17;Tiistai;4;15;19
94;27.06.2017;2017;06;18;Tiistai;5;7;12
94;27.06.2017;2017;06;19;Tiistai;4;13;17
94;27.06.2017;2017;06;20;Tiistai;3;10;13
94;27.06.2017;2017;06;21;Tiistai;3;3;6
94;27.06.2017;2017;06;22;Tiistai;1;6;7
94;27.06.2017;2017;06;23;Tiistai;1;0;1
94;28.06.2017;2017;06;00;Keskiviikko;1;2;3
94;28.06.2017;2017;06;01;Keskiviikko;0;0;0
94;28.06.2017;2017;06;02;Keskiviikko;0;0;0
94;28.06.2017;2017;06;03;Keskiviikko;0;0;0
94;28.06.2017;2017;06;04;Keskiviikko;0;0;0
94;28.06.2017;2017;06;05;Keskiviikko;7;1;8
94;28.06.2017;2017;06;06;Keskiviikko;19;1;20
94;28.06.2017;2017;06;07;Keskiviikko;22;4;26
94;28.06.2017;2017;06;08;Keskiviikko;6;3;9
94;28.06.2017;2017;06;09;Keskiviikko;1;5;6
94;28.06.2017;2017;06;10;Keskiviikko;3;3;6
94;28.06.2017;2017;06;11;Keskiviikko;4;3;7
94;28.06.2017;2017;06;12;Keskiviikko;4;1;5
94;28.06.2017;2017;06;13;Keskiviikko;6;2;8
94;28.06.2017;2017;06;14;Keskiviikko;4;5;9
94;28.06.2017;2017;06;15;Keskiviikko;10;17;27
94;28.06.2017;2017;06;16;Keskiviikko;7;26;33
94;28.06.2017;2017;06;17;Keskiviikko;2;11;13
94;28.06.2017;2017;06;18;Keskiviikko;11;14;25
94;28.06.2017;2017;06;19;Keskiviikko;15;10;25
94;28.06.2017;2017;06;20;Keskiviikko;3;3;6
94;28.06.2017;2017;06;21;Keskiviikko;1;3;4
94;28.06.2017;2017;06;22;Keskiviikko;3;9;12
94;28.06.2017;2017;06;23;Keskiviikko;3;1;4
94;29.06.2017;2017;06;00;Torstai;0;0;0
94;29.06.2017;2017;06;01;Torstai;0;4;4
94;29.06.2017;2017;06;02;Torstai;0;0;0
94;29.06.2017;2017;06;03;Torstai;0;0;0
94;29.06.2017;2017;06;04;Torstai;0;0;0
94;29.06.2017;2017;06;05;Torstai;6;2;8
94;29.06.2017;2017;06;06;Torstai;14;5;19
94;29.06.2017;2017;06;07;Torstai;23;7;30
94;29.06.2017;2017;06;08;Torstai;12;3;15
94;29.06.2017;2017;06;09;Torstai;8;6;14
94;29.06.2017;2017;06;10;Torstai;9;5;14
94;29.06.2017;2017;06;11;Torstai;9;7;16
94;29.06.2017;2017;06;12;Torstai;10;6;16
94;29.06.2017;2017;06;13;Torstai;5;7;12
94;29.06.2017;2017;06;14;Torstai;11;5;16
94;29.06.2017;2017;06;15;Torstai;11;18;29
94;29.06.2017;2017;06;16;Torstai;16;28;44
94;29.06.2017;2017;06;17;Torstai;7;16;23
94;29.06.2017;2017;06;18;Torstai;11;21;32
94;29.06.2017;2017;06;19;Torstai;9;15;24
94;29.06.2017;2017;06;20;Torstai;8;9;17
94;29.06.2017;2017;06;21;Torstai;3;6;9
94;29.06.2017;2017;06;22;Torstai;1;6;7
94;29.06.2017;2017;06;23;Torstai;1;0;1
94;30.06.2017;2017;06;00;Perjantai;0;1;1
94;30.06.2017;2017;06;01;Perjantai;1;0;1
94;30.06.2017;2017;06;02;Perjantai;0;0;0
94;30.06.2017;2017;06;03;Perjantai;0;0;0
94;30.06.2017;2017;06;04;Perjantai;0;0;0
94;30.06.2017;2017;06;05;Perjantai;4;1;5
94;30.06.2017;2017;06;06;Perjantai;15;3;18
94;30.06.2017;2017;06;07;Perjantai;18;4;22
94;30.06.2017;2017;06;08;Perjantai;12;4;16
94;30.06.2017;2017;06;09;Perjantai;6;6;12
94;30.06.2017;2017;06;10;Perjantai;10;6;16
94;30.06.2017;2017;06;11;Perjantai;8;12;20
94;30.06.2017;2017;06;12;Perjantai;4;10;14
94;30.06.2017;2017;06;13;Perjantai;13;12;25
94;30.06.2017;2017;06;14;Perjantai;6;17;23
94;30.06.2017;2017;06;15;Perjantai;17;21;38
94;30.06.2017;2017;06;16;Perjantai;12;19;31
94;30.06.2017;2017;06;17;Perjantai;12;23;35
94;30.06.2017;2017;06;18;Perjantai;17;12;29
94;30.06.2017;2017;06;19;Perjantai;17;11;28
94;30.06.2017;2017;06;20;Perjantai;4;11;15
94;30.06.2017;2017;06;21;Perjantai;4;7;11
94;30.06.2017;2017;06;22;Perjantai;0;10;10
94;30.06.2017;2017;06;23;Perjantai;1;0;1
94;01.07.2017;2017;07;00;Lauantai;4;4;8
94;01.07.2017;2017;07;01;Lauantai;0;1;1
94;01.07.2017;2017;07;02;Lauantai;0;0;0
94;01.07.2017;2017;07;03;Lauantai;0;1;1
94;01.07.2017;2017;07;04;Lauantai;0;0;0
94;01.07.2017;2017;07;05;Lauantai;2;0;2
94;01.07.2017;2017;07;06;Lauantai;2;3;5
94;01.07.2017;2017;07;07;Lauantai;4;3;7
94;01.07.2017;2017;07;08;Lauantai;5;5;10
94;01.07.2017;2017;07;09;Lauantai;6;8;14
94;01.07.2017;2017;07;10;Lauantai;9;15;24
94;01.07.2017;2017;07;11;Lauantai;13;19;32
94;01.07.2017;2017;07;12;Lauantai;15;10;25
94;01.07.2017;2017;07;13;Lauantai;18;22;40
94;01.07.2017;2017;07;14;Lauantai;16;14;30
94;01.07.2017;2017;07;15;Lauantai;12;16;28
94;01.07.2017;2017;07;16;Lauantai;18;5;23
94;01.07.2017;2017;07;17;Lauantai;16;18;34
94;01.07.2017;2017;07;18;Lauantai;25;14;39
94;01.07.2017;2017;07;19;Lauantai;17;17;34
94;01.07.2017;2017;07;20;Lauantai;8;5;13
94;01.07.2017;2017;07;21;Lauantai;8;7;15
94;01.07.2017;2017;07;22;Lauantai;4;2;6
94;01.07.2017;2017;07;23;Lauantai;1;1;2
94;02.07.2017;2017;07;00;Sunnuntai;2;3;5
94;02.07.2017;2017;07;01;Sunnuntai;1;1;2
94;02.07.2017;2017;07;02;Sunnuntai;0;1;1
94;02.07.2017;2017;07;03;Sunnuntai;0;0;0
94;02.07.2017;2017;07;04;Sunnuntai;0;3;3
94;02.07.2017;2017;07;05;Sunnuntai;1;1;2
94;02.07.2017;2017;07;06;Sunnuntai;3;0;3
94;02.07.2017;2017;07;07;Sunnuntai;1;0;1
94;02.07.2017;2017;07;08;Sunnuntai;1;4;5
94;02.07.2017;2017;07;09;Sunnuntai;5;8;13
94;02.07.2017;2017;07;10;Sunnuntai;5;9;14
94;02.07.2017;2017;07;11;Sunnuntai;11;11;22
94;02.07.2017;2017;07;12;Sunnuntai;15;13;28
94;02.07.2017;2017;07;13;Sunnuntai;9;9;18
94;02.07.2017;2017;07;14;Sunnuntai;21;26;47
94;02.07.2017;2017;07;15;Sunnuntai;13;11;24
94;02.07.2017;2017;07;16;Sunnuntai;21;9;30
94;02.07.2017;2017;07;17;Sunnuntai;14;17;31
94;02.07.2017;2017;07;18;Sunnuntai;24;17;41
94;02.07.2017;2017;07;19;Sunnuntai;16;14;30
94;02.07.2017;2017;07;20;Sunnuntai;8;10;18
94;02.07.2017;2017;07;21;Sunnuntai;7;10;17
94;02.07.2017;2017;07;22;Sunnuntai;3;1;4
94;02.07.2017;2017;07;23;Sunnuntai;4;4;8
94;03.07.2017;2017;07;00;Maanantai;0;5;5
94;03.07.2017;2017;07;01;Maanantai;3;1;4
94;03.07.2017;2017;07;02;Maanantai;0;0;0
94;03.07.2017;2017;07;03;Maanantai;0;0;0
94;03.07.2017;2017;07;04;Maanantai;0;0;0
94;03.07.2017;2017;07;05;Maanantai;11;1;12
94;03.07.2017;2017;07;06;Maanantai;18;4;22
94;03.07.2017;2017;07;07;Maanantai;23;4;27
94;03.07.2017;2017;07;08;Maanantai;10;5;15
94;03.07.2017;2017;07;09;Maanantai;9;6;15
94;03.07.2017;2017;07;10;Maanantai;15;11;26
94;03.07.2017;2017;07;11;Maanantai;19;10;29
94;03.07.2017;2017;07;12;Maanantai;6;15;21
94;03.07.2017;2017;07;13;Maanantai;13;9;22
94;03.07.2017;2017;07;14;Maanantai;20;18;38
94;03.07.2017;2017;07;15;Maanantai;15;29;44
94;03.07.2017;2017;07;16;Maanantai;9;36;45
94;03.07.2017;2017;07;17;Maanantai;14;22;36
94;03.07.2017;2017;07;18;Maanantai;11;20;31
94;03.07.2017;2017;07;19;Maanantai;13;10;23
94;03.07.2017;2017;07;20;Maanantai;12;7;19
94;03.07.2017;2017;07;21;Maanantai;5;6;11
94;03.07.2017;2017;07;22;Maanantai;0;5;5
94;03.07.2017;2017;07;23;Maanantai;3;3;6
94;04.07.2017;2017;07;00;Tiistai;1;1;2
94;04.07.2017;2017;07;01;Tiistai;1;1;2
94;04.07.2017;2017;07;02;Tiistai;0;0;0
94;04.07.2017;2017;07;03;Tiistai;1;0;1
94;04.07.2017;2017;07;04;Tiistai;1;1;2
94;04.07.2017;2017;07;05;Tiistai;8;2;10
94;04.07.2017;2017;07;06;Tiistai;13;4;17
94;04.07.2017;2017;07;07;Tiistai;19;2;21
94;04.07.2017;2017;07;08;Tiistai;10;3;13
94;04.07.2017;2017;07;09;Tiistai;7;9;16
94;04.07.2017;2017;07;10;Tiistai;10;10;20
94;04.07.2017;2017;07;11;Tiistai;6;9;15
94;04.07.2017;2017;07;12;Tiistai;9;5;14
94;04.07.2017;2017;07;13;Tiistai;0;3;3
94;04.07.2017;2017;07;14;Tiistai;3;7;10
94;04.07.2017;2017;07;15;Tiistai;8;12;20
94;04.07.2017;2017;07;16;Tiistai;11;26;37
94;04.07.2017;2017;07;17;Tiistai;4;5;9
94;04.07.2017;2017;07;18;Tiistai;5;10;15
94;04.07.2017;2017;07;19;Tiistai;17;11;28
94;04.07.2017;2017;07;20;Tiistai;6;2;8
94;04.07.2017;2017;07;21;Tiistai;4;6;10
94;04.07.2017;2017;07;22;Tiistai;0;5;5
94;04.07.2017;2017;07;23;Tiistai;0;2;2
94;05.07.2017;2017;07;00;Keskiviikko;2;0;2
94;05.07.2017;2017;07;01;Keskiviikko;0;2;2
94;05.07.2017;2017;07;02;Keskiviikko;2;0;2
94;05.07.2017;2017;07;03;Keskiviikko;1;1;2
94;05.07.2017;2017;07;04;Keskiviikko;0;0;0
94;05.07.2017;2017;07;05;Keskiviikko;5;2;7
94;05.07.2017;2017;07;06;Keskiviikko;13;0;13
94;05.07.2017;2017;07;07;Keskiviikko;11;7;18
94;05.07.2017;2017;07;08;Keskiviikko;11;3;14
94;05.07.2017;2017;07;09;Keskiviikko;3;1;4
94;05.07.2017;2017;07;10;Keskiviikko;3;5;8
94;05.07.2017;2017;07;11;Keskiviikko;11;8;19
94;05.07.2017;2017;07;12;Keskiviikko;11;4;15
94;05.07.2017;2017;07;13;Keskiviikko;10;6;16
94;05.07.2017;2017;07;14;Keskiviikko;7;10;17
94;05.07.2017;2017;07;15;Keskiviikko;4;24;28
94;05.07.2017;2017;07;16;Keskiviikko;15;25;40
94;05.07.2017;2017;07;17;Keskiviikko;10;13;23
94;05.07.2017;2017;07;18;Keskiviikko;7;5;12
94;05.07.2017;2017;07;19;Keskiviikko;8;8;16
94;05.07.2017;2017;07;20;Keskiviikko;4;4;8
94;05.07.2017;2017;07;21;Keskiviikko;3;8;11
94;05.07.2017;2017;07;22;Keskiviikko;4;3;7
94;05.07.2017;2017;07;23;Keskiviikko;0;4;4
94;06.07.2017;2017;07;00;Torstai;1;2;3
94;06.07.2017;2017;07;01;Torstai;0;0;0
94;06.07.2017;2017;07;02;Torstai;0;0;0
94;06.07.2017;2017;07;03;Torstai;0;0;0
94;06.07.2017;2017;07;04;Torstai;0;0;0
94;06.07.2017;2017;07;05;Torstai;6;3;9
94;06.07.2017;2017;07;06;Torstai;6;0;6
94;06.07.2017;2017;07;07;Torstai;12;3;15
94;06.07.2017;2017;07;08;Torstai;2;3;5
94;06.07.2017;2017;07;09;Torstai;3;1;4
94;06.07.2017;2017;07;10;Torstai;1;0;1
94;06.07.2017;2017;07;11;Torstai;2;3;5
94;06.07.2017;2017;07;12;Torstai;5;2;7
94;06.07.2017;2017;07;13;Torstai;3;3;6
94;06.07.2017;2017;07;14;Torstai;6;2;8
94;06.07.2017;2017;07;15;Torstai;7;15;22
94;06.07.2017;2017;07;16;Torstai;3;9;12
94;06.07.2017;2017;07;17;Torstai;4;15;19
94;06.07.2017;2017;07;18;Torstai;5;6;11
94;06.07.2017;2017;07;19;Torstai;6;6;12
94;06.07.2017;2017;07;20;Torstai;9;2;11
94;06.07.2017;2017;07;21;Torstai;2;5;7
94;06.07.2017;2017;07;22;Torstai;3;3;6
94;06.07.2017;2017;07;23;Torstai;1;3;4
94;07.07.2017;2017;07;00;Perjantai;1;2;3
94;07.07.2017;2017;07;01;Perjantai;0;0;0
94;07.07.2017;2017;07;02;Perjantai;1;0;1
94;07.07.2017;2017;07;03;Perjantai;0;1;1
94;07.07.2017;2017;07;04;Perjantai;0;0;0
94;07.07.2017;2017;07;05;Perjantai;5;3;8
94;07.07.2017;2017;07;06;Perjantai;9;0;9
94;07.07.2017;2017;07;07;Perjantai;17;2;19
94;07.07.2017;2017;07;08;Perjantai;7;3;10
94;07.07.2017;2017;07;09;Perjantai;13;9;22
94;07.07.2017;2017;07;10;Perjantai;9;9;18
94;07.07.2017;2017;07;11;Perjantai;6;8;14
94;07.07.2017;2017;07;12;Perjantai;13;8;21
94;07.07.2017;2017;07;13;Perjantai;11;17;28
94;07.07.2017;2017;07;14;Perjantai;10;17;27
94;07.07.2017;2017;07;15;Perjantai;10;22;32
94;07.07.2017;2017;07;16;Perjantai;9;19;28
94;07.07.2017;2017;07;17;Perjantai;19;18;37
94;07.07.2017;2017;07;18;Perjantai;12;16;28
94;07.07.2017;2017;07;19;Perjantai;13;11;24
94;07.07.2017;2017;07;20;Perjantai;5;8;13
94;07.07.2017;2017;07;21;Perjantai;4;8;12
94;07.07.2017;2017;07;22;Perjantai;4;5;9
94;07.07.2017;2017;07;23;Perjantai;4;0;4
94;08.07.2017;2017;07;00;Lauantai;0;0;0
94;08.07.2017;2017;07;01;Lauantai;0;0;0
94;08.07.2017;2017;07;02;Lauantai;0;1;1
94;08.07.2017;2017;07;03;Lauantai;0;1;1
94;08.07.2017;2017;07;04;Lauantai;0;0;0
94;08.07.2017;2017;07;05;Lauantai;1;0;1
94;08.07.2017;2017;07;06;Lauantai;3;0;3
94;08.07.2017;2017;07;07;Lauantai;3;0;3
94;08.07.2017;2017;07;08;Lauantai;1;2;3
94;08.07.2017;2017;07;09;Lauantai;0;8;8
94;08.07.2017;2017;07;10;Lauantai;16;10;26
94;08.07.2017;2017;07;11;Lauantai;16;4;20
94;08.07.2017;2017;07;12;Lauantai;18;14;32
94;08.07.2017;2017;07;13;Lauantai;18;15;33
94;08.07.2017;2017;07;14;Lauantai;16;14;30
94;08.07.2017;2017;07;15;Lauantai;12;18;30
94;08.07.2017;2017;07;16;Lauantai;14;17;31
94;08.07.2017;2017;07;17;Lauantai;9;22;31
94;08.07.2017;2017;07;18;Lauantai;13;13;26
94;08.07.2017;2017;07;19;Lauantai;10;14;24
94;08.07.2017;2017;07;20;Lauantai;9;14;23
94;08.07.2017;2017;07;21;Lauantai;10;3;13
94;08.07.2017;2017;07;22;Lauantai;1;1;2
94;08.07.2017;2017;07;23;Lauantai;0;3;3
94;09.07.2017;2017;07;00;Sunnuntai;0;5;5
94;09.07.2017;2017;07;01;Sunnuntai;2;1;3
94;09.07.2017;2017;07;02;Sunnuntai;0;2;2
94;09.07.2017;2017;07;03;Sunnuntai;0;3;3
94;09.07.2017;2017;07;04;Sunnuntai;0;1;1
94;09.07.2017;2017;07;05;Sunnuntai;0;0;0
94;09.07.2017;2017;07;06;Sunnuntai;5;0;5
94;09.07.2017;2017;07;07;Sunnuntai;2;6;8
94;09.07.2017;2017;07;08;Sunnuntai;2;2;4
94;09.07.2017;2017;07;09;Sunnuntai;6;6;12
94;09.07.2017;2017;07;10;Sunnuntai;11;10;21
94;09.07.2017;2017;07;11;Sunnuntai;15;12;27
94;09.07.2017;2017;07;12;Sunnuntai;12;10;22
94;09.07.2017;2017;07;13;Sunnuntai;17;13;30
94;09.07.2017;2017;07;14;Sunnuntai;23;10;33
94;09.07.2017;2017;07;15;Sunnuntai;18;12;30
94;09.07.2017;2017;07;16;Sunnuntai;11;22;33
94;09.07.2017;2017;07;17;Sunnuntai;5;16;21
94;09.07.2017;2017;07;18;Sunnuntai;14;16;30
94;09.07.2017;2017;07;19;Sunnuntai;16;13;29
94;09.07.2017;2017;07;20;Sunnuntai;10;8;18
94;09.07.2017;2017;07;21;Sunnuntai;9;12;21
94;09.07.2017;2017;07;22;Sunnuntai;2;2;4
94;09.07.2017;2017;07;23;Sunnuntai;2;1;3
94;10.07.2017;2017;07;00;Maanantai;3;0;3
94;10.07.2017;2017;07;01;Maanantai;0;0;0
94;10.07.2017;2017;07;02;Maanantai;0;0;0
94;10.07.2017;2017;07;03;Maanantai;1;2;3
94;10.07.2017;2017;07;04;Maanantai;2;1;3
94;10.07.2017;2017;07;05;Maanantai;10;1;11
94;10.07.2017;2017;07;06;Maanantai;17;0;17
94;10.07.2017;2017;07;07;Maanantai;21;3;24
94;10.07.2017;2017;07;08;Maanantai;8;2;10
94;10.07.2017;2017;07;09;Maanantai;6;7;13
94;10.07.2017;2017;07;10;Maanantai;12;8;20
94;10.07.2017;2017;07;11;Maanantai;20;4;24
94;10.07.2017;2017;07;12;Maanantai;10;18;28
94;10.07.2017;2017;07;13;Maanantai;12;11;23
94;10.07.2017;2017;07;14;Maanantai;9;19;28
94;10.07.2017;2017;07;15;Maanantai;10;33;43
94;10.07.2017;2017;07;16;Maanantai;10;27;37
94;10.07.2017;2017;07;17;Maanantai;16;29;45
94;10.07.2017;2017;07;18;Maanantai;8;10;18
94;10.07.2017;2017;07;19;Maanantai;8;17;25
94;10.07.2017;2017;07;20;Maanantai;1;6;7
94;10.07.2017;2017;07;21;Maanantai;13;10;23
94;10.07.2017;2017;07;22;Maanantai;3;4;7
94;10.07.2017;2017;07;23;Maanantai;1;2;3
94;11.07.2017;2017;07;00;Tiistai;5;2;7
94;11.07.2017;2017;07;01;Tiistai;0;2;2
94;11.07.2017;2017;07;02;Tiistai;2;3;5
94;11.07.2017;2017;07;03;Tiistai;0;1;1
94;11.07.2017;2017;07;04;Tiistai;2;0;2
94;11.07.2017;2017;07;05;Tiistai;10;2;12
94;11.07.2017;2017;07;06;Tiistai;16;0;16
94;11.07.2017;2017;07;07;Tiistai;21;4;25
94;11.07.2017;2017;07;08;Tiistai;9;4;13
94;11.07.2017;2017;07;09;Tiistai;6;9;15
94;11.07.2017;2017;07;10;Tiistai;9;8;17
94;11.07.2017;2017;07;11;Tiistai;12;12;24
94;11.07.2017;2017;07;12;Tiistai;14;8;22
94;11.07.2017;2017;07;13;Tiistai;12;9;21
94;11.07.2017;2017;07;14;Tiistai;17;27;44
94;11.07.2017;2017;07;15;Tiistai;11;24;35
94;11.07.2017;2017;07;16;Tiistai;15;30;45
94;11.07.2017;2017;07;17;Tiistai;13;23;36
94;11.07.2017;2017;07;18;Tiistai;16;18;34
94;11.07.2017;2017;07;19;Tiistai;8;11;19
94;11.07.2017;2017;07;20;Tiistai;7;9;16
94;11.07.2017;2017;07;21;Tiistai;1;7;8
94;11.07.2017;2017;07;22;Tiistai;1;3;4
94;11.07.2017;2017;07;23;Tiistai;1;1;2
94;12.07.2017;2017;07;00;Keskiviikko;1;0;1
94;12.07.2017;2017;07;01;Keskiviikko;0;0;0
94;12.07.2017;2017;07;02;Keskiviikko;0;0;0
94;12.07.2017;2017;07;03;Keskiviikko;0;1;1
94;12.07.2017;2017;07;04;Keskiviikko;1;0;1
94;12.07.2017;2017;07;05;Keskiviikko;4;1;5
94;12.07.2017;2017;07;06;Keskiviikko;8;0;8
94;12.07.2017;2017;07;07;Keskiviikko;9;3;12
94;12.07.2017;2017;07;08;Keskiviikko;7;1;8
94;12.07.2017;2017;07;09;Keskiviikko;2;2;4
94;12.07.2017;2017;07;10;Keskiviikko;3;1;4
94;12.07.2017;2017;07;11;Keskiviikko;2;3;5
94;12.07.2017;2017;07;12;Keskiviikko;7;0;7
94;12.07.2017;2017;07;13;Keskiviikko;5;7;12
94;12.07.2017;2017;07;14;Keskiviikko;5;2;7
94;12.07.2017;2017;07;15;Keskiviikko;1;7;8
94;12.07.2017;2017;07;16;Keskiviikko;0;9;9
94;12.07.2017;2017;07;17;Keskiviikko;4;8;12
94;12.07.2017;2017;07;18;Keskiviikko;1;6;7
94;12.07.2017;2017;07;19;Keskiviikko;0;2;2
94;12.07.2017;2017;07;20;Keskiviikko;0;2;2
94;12.07.2017;2017;07;21;Keskiviikko;1;1;2
94;12.07.2017;2017;07;22;Keskiviikko;2;1;3
94;12.07.2017;2017;07;23;Keskiviikko;0;1;1
94;13.07.2017;2017;07;00;Torstai;4;0;4
94;13.07.2017;2017;07;01;Torstai;0;1;1
94;13.07.2017;2017;07;02;Torstai;0;0;0
94;13.07.2017;2017;07;03;Torstai;0;0;0
94;13.07.2017;2017;07;04;Torstai;2;0;2
94;13.07.2017;2017;07;05;Torstai;3;1;4
94;13.07.2017;2017;07;06;Torstai;6;0;6
94;13.07.2017;2017;07;07;Torstai;26;1;27
94;13.07.2017;2017;07;08;Torstai;6;3;9
94;13.07.2017;2017;07;09;Torstai;2;1;3
94;13.07.2017;2017;07;10;Torstai;1;5;6
94;13.07.2017;2017;07;11;Torstai;5;5;10
94;13.07.2017;2017;07;12;Torstai;7;9;16
94;13.07.2017;2017;07;13;Torstai;11;8;19
94;13.07.2017;2017;07;14;Torstai;8;9;17
94;13.07.2017;2017;07;15;Torstai;14;20;34
94;13.07.2017;2017;07;16;Torstai;7;20;27
94;13.07.2017;2017;07;17;Torstai;4;9;13
94;13.07.2017;2017;07;18;Torstai;5;10;15
94;13.07.2017;2017;07;19;Torstai;3;6;9
94;13.07.2017;2017;07;20;Torstai;0;5;5
94;13.07.2017;2017;07;21;Torstai;3;2;5
94;13.07.2017;2017;07;22;Torstai;2;0;2
94;13.07.2017;2017;07;23;Torstai;2;2;4
94;14.07.2017;2017;07;00;Perjantai;1;0;1
94;14.07.2017;2017;07;01;Perjantai;0;0;0
94;14.07.2017;2017;07;02;Perjantai;2;0;2
94;14.07.2017;2017;07;03;Perjantai;1;1;2
94;14.07.2017;2017;07;04;Perjantai;1;0;1
94;14.07.2017;2017;07;05;Perjantai;2;1;3
94;14.07.2017;2017;07;06;Perjantai;4;3;7
94;14.07.2017;2017;07;07;Perjantai;9;1;10
94;14.07.2017;2017;07;08;Perjantai;4;0;4
94;14.07.2017;2017;07;09;Perjantai;2;0;2
94;14.07.2017;2017;07;10;Perjantai;2;0;2
94;14.07.2017;2017;07;11;Perjantai;2;0;2
94;14.07.2017;2017;07;12;Perjantai;0;1;1
94;14.07.2017;2017;07;13;Perjantai;0;3;3
94;14.07.2017;2017;07;14;Perjantai;8;3;11
94;14.07.2017;2017;07;15;Perjantai;3;8;11
94;14.07.2017;2017;07;16;Perjantai;3;13;16
94;14.07.2017;2017;07;17;Perjantai;5;6;11
94;14.07.2017;2017;07;18;Perjantai;8;9;17
94;14.07.2017;2017;07;19;Perjantai;5;12;17
94;14.07.2017;2017;07;20;Perjantai;5;5;10
94;14.07.2017;2017;07;21;Perjantai;4;1;5
94;14.07.2017;2017;07;22;Perjantai;5;4;9
94;14.07.2017;2017;07;23;Perjantai;1;4;5
94;15.07.2017;2017;07;00;Lauantai;1;3;4
94;15.07.2017;2017;07;01;Lauantai;0;2;2
94;15.07.2017;2017;07;02;Lauantai;2;1;3
94;15.07.2017;2017;07;03;Lauantai;0;0;0
94;15.07.2017;2017;07;04;Lauantai;0;0;0
94;15.07.2017;2017;07;05;Lauantai;1;2;3
94;15.07.2017;2017;07;06;Lauantai;2;1;3
94;15.07.2017;2017;07;07;Lauantai;2;2;4
94;15.07.2017;2017;07;08;Lauantai;2;3;5
94;15.07.2017;2017;07;09;Lauantai;6;6;12
94;15.07.2017;2017;07;10;Lauantai;5;8;13
94;15.07.2017;2017;07;11;Lauantai;18;8;26
94;15.07.2017;2017;07;12;Lauantai;7;6;13
94;15.07.2017;2017;07;13;Lauantai;15;12;27
94;15.07.2017;2017;07;14;Lauantai;16;10;26
94;15.07.2017;2017;07;15;Lauantai;11;9;20
94;15.07.2017;2017;07;16;Lauantai;5;11;16
94;15.07.2017;2017;07;17;Lauantai;13;16;29
94;15.07.2017;2017;07;18;Lauantai;5;9;14
94;15.07.2017;2017;07;19;Lauantai;7;9;16
94;15.07.2017;2017;07;20;Lauantai;8;10;18
94;15.07.2017;2017;07;21;Lauantai;5;7;12
94;15.07.2017;2017;07;22;Lauantai;1;5;6
94;15.07.2017;2017;07;23;Lauantai;1;2;3
94;16.07.2017;2017;07;00;Sunnuntai;2;5;7
94;16.07.2017;2017;07;01;Sunnuntai;2;0;2
94;16.07.2017;2017;07;02;Sunnuntai;4;2;6
94;16.07.2017;2017;07;03;Sunnuntai;0;1;1
94;16.07.2017;2017;07;04;Sunnuntai;0;2;2
94;16.07.2017;2017;07;05;Sunnuntai;1;0;1
94;16.07.2017;2017;07;06;Sunnuntai;3;0;3
94;16.07.2017;2017;07;07;Sunnuntai;2;1;3
94;16.07.2017;2017;07;08;Sunnuntai;2;6;8
94;16.07.2017;2017;07;09;Sunnuntai;4;2;6
94;16.07.2017;2017;07;10;Sunnuntai;14;9;23
94;16.07.2017;2017;07;11;Sunnuntai;21;26;47
94;16.07.2017;2017;07;12;Sunnuntai;17;26;43
94;16.07.2017;2017;07;13;Sunnuntai;17;26;43
94;16.07.2017;2017;07;14;Sunnuntai;19;19;38
94;16.07.2017;2017;07;15;Sunnuntai;31;13;44
94;16.07.2017;2017;07;16;Sunnuntai;16;30;46
94;16.07.2017;2017;07;17;Sunnuntai;15;16;31
94;16.07.2017;2017;07;18;Sunnuntai;23;17;40
94;16.07.2017;2017;07;19;Sunnuntai;13;18;31
94;16.07.2017;2017;07;20;Sunnuntai;12;16;28
94;16.07.2017;2017;07;21;Sunnuntai;2;13;15
94;16.07.2017;2017;07;22;Sunnuntai;4;2;6
94;16.07.2017;2017;07;23;Sunnuntai;0;0;0
94;17.07.2017;2017;07;00;Maanantai;0;2;2
94;17.07.2017;2017;07;01;Maanantai;0;0;0
94;17.07.2017;2017;07;02;Maanantai;2;0;2
94;17.07.2017;2017;07;03;Maanantai;0;0;0
94;17.07.2017;2017;07;04;Maanantai;2;1;3
94;17.07.2017;2017;07;05;Maanantai;4;2;6
94;17.07.2017;2017;07;06;Maanantai;19;2;21
94;17.07.2017;2017;07;07;Maanantai;16;4;20
94;17.07.2017;2017;07;08;Maanantai;8;5;13
94;17.07.2017;2017;07;09;Maanantai;12;2;14
94;17.07.2017;2017;07;10;Maanantai;9;17;26
94;17.07.2017;2017;07;11;Maanantai;14;13;27
94;17.07.2017;2017;07;12;Maanantai;7;6;13
94;17.07.2017;2017;07;13;Maanantai;16;3;19
94;17.07.2017;2017;07;14;Maanantai;14;8;22
94;17.07.2017;2017;07;15;Maanantai;9;27;36
94;17.07.2017;2017;07;16;Maanantai;8;34;42
94;17.07.2017;2017;07;17;Maanantai;4;11;15
94;17.07.2017;2017;07;18;Maanantai;1;11;12
94;17.07.2017;2017;07;19;Maanantai;12;15;27
94;17.07.2017;2017;07;20;Maanantai;10;17;27
94;17.07.2017;2017;07;21;Maanantai;17;8;25
94;17.07.2017;2017;07;22;Maanantai;0;3;3
94;17.07.2017;2017;07;23;Maanantai;0;0;0
94;18.07.2017;2017;07;00;Tiistai;1;2;3
94;18.07.2017;2017;07;01;Tiistai;0;1;1
94;18.07.2017;2017;07;02;Tiistai;0;0;0
94;18.07.2017;2017;07;03;Tiistai;0;0;0
94;18.07.2017;2017;07;04;Tiistai;1;0;1
94;18.07.2017;2017;07;05;Tiistai;3;2;5
94;18.07.2017;2017;07;06;Tiistai;3;2;5
94;18.07.2017;2017;07;07;Tiistai;5;0;5
94;18.07.2017;2017;07;08;Tiistai;3;1;4
94;18.07.2017;2017;07;09;Tiistai;1;0;1
94;18.07.2017;2017;07;10;Tiistai;0;0;0
94;18.07.2017;2017;07;11;Tiistai;0;1;1
94;18.07.2017;2017;07;12;Tiistai;5;2;7
94;18.07.2017;2017;07;13;Tiistai;3;4;7
94;18.07.2017;2017;07;14;Tiistai;3;4;7
94;18.07.2017;2017;07;15;Tiistai;3;7;10
94;18.07.2017;2017;07;16;Tiistai;7;6;13
94;18.07.2017;2017;07;17;Tiistai;2;8;10
94;18.07.2017;2017;07;18;Tiistai;5;11;16
94;18.07.2017;2017;07;19;Tiistai;4;9;13
94;18.07.2017;2017;07;20;Tiistai;3;6;9
94;18.07.2017;2017;07;21;Tiistai;3;2;5
94;18.07.2017;2017;07;22;Tiistai;1;1;2
94;18.07.2017;2017;07;23;Tiistai;1;2;3
94;19.07.2017;2017;07;00;Keskiviikko;0;0;0
94;19.07.2017;2017;07;01;Keskiviikko;0;0;0
94;19.07.2017;2017;07;02;Keskiviikko;0;0;0
94;19.07.2017;2017;07;03;Keskiviikko;1;0;1
94;19.07.2017;2017;07;04;Keskiviikko;1;0;1
94;19.07.2017;2017;07;05;Keskiviikko;1;1;2
94;19.07.2017;2017;07;06;Keskiviikko;6;3;9
94;19.07.2017;2017;07;07;Keskiviikko;13;2;15
94;19.07.2017;2017;07;08;Keskiviikko;6;1;7
94;19.07.2017;2017;07;09;Keskiviikko;7;1;8
94;19.07.2017;2017;07;10;Keskiviikko;5;6;11
94;19.07.2017;2017;07;11;Keskiviikko;3;4;7
94;19.07.2017;2017;07;12;Keskiviikko;5;5;10
94;19.07.2017;2017;07;13;Keskiviikko;3;5;8
94;19.07.2017;2017;07;14;Keskiviikko;5;9;14
94;19.07.2017;2017;07;15;Keskiviikko;10;6;16
94;19.07.2017;2017;07;16;Keskiviikko;7;15;22
94;19.07.2017;2017;07;17;Keskiviikko;5;11;16
94;19.07.2017;2017;07;18;Keskiviikko;13;8;21
94;19.07.2017;2017;07;19;Keskiviikko;9;17;26
94;19.07.2017;2017;07;20;Keskiviikko;5;4;9
94;19.07.2017;2017;07;21;Keskiviikko;7;8;15
94;19.07.2017;2017;07;22;Keskiviikko;2;1;3
94;19.07.2017;2017;07;23;Keskiviikko;1;0;1
94;20.07.2017;2017;07;00;Torstai;2;0;2
94;20.07.2017;2017;07;01;Torstai;0;0;0
94;20.07.2017;2017;07;02;Torstai;0;0;0
94;20.07.2017;2017;07;03;Torstai;0;0;0
94;20.07.2017;2017;07;04;Torstai;2;0;2
94;20.07.2017;2017;07;05;Torstai;1;2;3
94;20.07.2017;2017;07;06;Torstai;11;1;12
94;20.07.2017;2017;07;07;Torstai;14;2;16
94;20.07.2017;2017;07;08;Torstai;8;1;9
94;20.07.2017;2017;07;09;Torstai;4;3;7
94;20.07.2017;2017;07;10;Torstai;5;4;9
94;20.07.2017;2017;07;11;Torstai;5;2;7
94;20.07.2017;2017;07;12;Torstai;3;7;10
94;20.07.2017;2017;07;13;Torstai;9;10;19
94;20.07.2017;2017;07;14;Torstai;12;11;23
94;20.07.2017;2017;07;15;Torstai;10;11;21
94;20.07.2017;2017;07;16;Torstai;11;20;31
94;20.07.2017;2017;07;17;Torstai;12;21;33
94;20.07.2017;2017;07;18;Torstai;7;17;24
94;20.07.2017;2017;07;19;Torstai;15;17;32
94;20.07.2017;2017;07;20;Torstai;3;5;8
94;20.07.2017;2017;07;21;Torstai;5;6;11
94;20.07.2017;2017;07;22;Torstai;5;3;8
94;20.07.2017;2017;07;23;Torstai;1;1;2
94;21.07.2017;2017;07;00;Perjantai;0;0;0
94;21.07.2017;2017;07;01;Perjantai;1;0;1
94;21.07.2017;2017;07;02;Perjantai;0;0;0
94;21.07.2017;2017;07;03;Perjantai;0;0;0
94;21.07.2017;2017;07;04;Perjantai;2;0;2
94;21.07.2017;2017;07;05;Perjantai;0;2;2
94;21.07.2017;2017;07;06;Perjantai;11;1;12
94;21.07.2017;2017;07;07;Perjantai;9;0;9
94;21.07.2017;2017;07;08;Perjantai;8;2;10
94;21.07.2017;2017;07;09;Perjantai;1;0;1
94;21.07.2017;2017;07;10;Perjantai;11;6;17
94;21.07.2017;2017;07;11;Perjantai;15;7;22
94;21.07.2017;2017;07;12;Perjantai;8;8;16
94;21.07.2017;2017;07;13;Perjantai;3;9;12
94;21.07.2017;2017;07;14;Perjantai;10;12;22
94;21.07.2017;2017;07;15;Perjantai;14;17;31
94;21.07.2017;2017;07;16;Perjantai;7;11;18
94;21.07.2017;2017;07;17;Perjantai;6;8;14
94;21.07.2017;2017;07;18;Perjantai;11;11;22
94;21.07.2017;2017;07;19;Perjantai;4;11;15
94;21.07.2017;2017;07;20;Perjantai;4;6;10
94;21.07.2017;2017;07;21;Perjantai;1;7;8
94;21.07.2017;2017;07;22;Perjantai;5;3;8
94;21.07.2017;2017;07;23;Perjantai;2;5;7
94;22.07.2017;2017;07;00;Lauantai;0;3;3
94;22.07.2017;2017;07;01;Lauantai;3;1;4
94;22.07.2017;2017;07;02;Lauantai;0;0;0
94;22.07.2017;2017;07;03;Lauantai;0;0;0
94;22.07.2017;2017;07;04;Lauantai;0;0;0
94;22.07.2017;2017;07;05;Lauantai;0;0;0
94;22.07.2017;2017;07;06;Lauantai;1;0;1
94;22.07.2017;2017;07;07;Lauantai;0;0;0
94;22.07.2017;2017;07;08;Lauantai;4;1;5
94;22.07.2017;2017;07;09;Lauantai;2;6;8
94;22.07.2017;2017;07;10;Lauantai;8;3;11
94;22.07.2017;2017;07;11;Lauantai;9;11;20
94;22.07.2017;2017;07;12;Lauantai;8;18;26
94;22.07.2017;2017;07;13;Lauantai;10;10;20
94;22.07.2017;2017;07;14;Lauantai;3;5;8
94;22.07.2017;2017;07;15;Lauantai;10;12;22
94;22.07.2017;2017;07;16;Lauantai;13;8;21
94;22.07.2017;2017;07;17;Lauantai;16;2;18
94;22.07.2017;2017;07;18;Lauantai;6;7;13
94;22.07.2017;2017;07;19;Lauantai;12;7;19
94;22.07.2017;2017;07;20;Lauantai;5;8;13
94;22.07.2017;2017;07;21;Lauantai;5;1;6
94;22.07.2017;2017;07;22;Lauantai;1;3;4
94;22.07.2017;2017;07;23;Lauantai;0;4;4
94;23.07.2017;2017;07;00;Sunnuntai;2;2;4
94;23.07.2017;2017;07;01;Sunnuntai;2;0;2
94;23.07.2017;2017;07;02;Sunnuntai;0;9;9
94;23.07.2017;2017;07;03;Sunnuntai;0;0;0
94;23.07.2017;2017;07;04;Sunnuntai;0;0;0
94;23.07.2017;2017;07;05;Sunnuntai;1;0;1
94;23.07.2017;2017;07;06;Sunnuntai;1;0;1
94;23.07.2017;2017;07;07;Sunnuntai;1;1;2
94;23.07.2017;2017;07;08;Sunnuntai;2;0;2
94;23.07.2017;2017;07;09;Sunnuntai;7;8;15
94;23.07.2017;2017;07;10;Sunnuntai;3;7;10
94;23.07.2017;2017;07;11;Sunnuntai;11;9;20
94;23.07.2017;2017;07;12;Sunnuntai;14;13;27
94;23.07.2017;2017;07;13;Sunnuntai;11;4;15
94;23.07.2017;2017;07;14;Sunnuntai;4;13;17
94;23.07.2017;2017;07;15;Sunnuntai;15;8;23
94;23.07.2017;2017;07;16;Sunnuntai;10;2;12
94;23.07.2017;2017;07;17;Sunnuntai;0;4;4
94;23.07.2017;2017;07;18;Sunnuntai;1;4;5
94;23.07.2017;2017;07;19;Sunnuntai;4;4;8
94;23.07.2017;2017;07;20;Sunnuntai;4;4;8
94;23.07.2017;2017;07;21;Sunnuntai;1;2;3
94;23.07.2017;2017;07;22;Sunnuntai;1;0;1
94;23.07.2017;2017;07;23;Sunnuntai;1;3;4
94;24.07.2017;2017;07;00;Maanantai;3;0;3
94;24.07.2017;2017;07;01;Maanantai;1;0;1
94;24.07.2017;2017;07;02;Maanantai;0;2;2
94;24.07.2017;2017;07;03;Maanantai;0;0;0
94;24.07.2017;2017;07;04;Maanantai;2;1;3
94;24.07.2017;2017;07;05;Maanantai;2;4;6
94;24.07.2017;2017;07;06;Maanantai;17;2;19
94;24.07.2017;2017;07;07;Maanantai;12;2;14
94;24.07.2017;2017;07;08;Maanantai;11;4;15
94;24.07.2017;2017;07;09;Maanantai;10;3;13
94;24.07.2017;2017;07;10;Maanantai;9;10;19
94;24.07.2017;2017;07;11;Maanantai;10;6;16
94;24.07.2017;2017;07;12;Maanantai;19;8;27
94;24.07.2017;2017;07;13;Maanantai;8;6;14
94;24.07.2017;2017;07;14;Maanantai;8;12;20
94;24.07.2017;2017;07;15;Maanantai;9;16;25
94;24.07.2017;2017;07;16;Maanantai;6;30;36
94;24.07.2017;2017;07;17;Maanantai;10;35;45
94;24.07.2017;2017;07;18;Maanantai;8;6;14
94;24.07.2017;2017;07;19;Maanantai;14;12;26
94;24.07.2017;2017;07;20;Maanantai;10;5;15
94;24.07.2017;2017;07;21;Maanantai;3;9;12
94;24.07.2017;2017;07;22;Maanantai;6;0;6
94;24.07.2017;2017;07;23;Maanantai;2;1;3
94;25.07.2017;2017;07;00;Tiistai;0;0;0
94;25.07.2017;2017;07;01;Tiistai;2;0;2
94;25.07.2017;2017;07;02;Tiistai;1;0;1
94;25.07.2017;2017;07;03;Tiistai;0;0;0
94;25.07.2017;2017;07;04;Tiistai;2;1;3
94;25.07.2017;2017;07;05;Tiistai;5;3;8
94;25.07.2017;2017;07;06;Tiistai;20;1;21
94;25.07.2017;2017;07;07;Tiistai;21;3;24
94;25.07.2017;2017;07;08;Tiistai;8;4;12
94;25.07.2017;2017;07;09;Tiistai;6;7;13
94;25.07.2017;2017;07;10;Tiistai;3;9;12
94;25.07.2017;2017;07;11;Tiistai;8;7;15
94;25.07.2017;2017;07;12;Tiistai;16;14;30
94;25.07.2017;2017;07;13;Tiistai;19;9;28
94;25.07.2017;2017;07;14;Tiistai;18;16;34
94;25.07.2017;2017;07;15;Tiistai;9;21;30
94;25.07.2017;2017;07;16;Tiistai;16;36;52
94;25.07.2017;2017;07;17;Tiistai;21;21;42
94;25.07.2017;2017;07;18;Tiistai;13;14;27
94;25.07.2017;2017;07;19;Tiistai;16;12;28
94;25.07.2017;2017;07;20;Tiistai;11;14;25
94;25.07.2017;2017;07;21;Tiistai;6;4;10
94;25.07.2017;2017;07;22;Tiistai;3;9;12
94;25.07.2017;2017;07;23;Tiistai;1;1;2
94;26.07.2017;2017;07;00;Keskiviikko;0;1;1
94;26.07.2017;2017;07;01;Keskiviikko;1;0;1
94;26.07.2017;2017;07;02;Keskiviikko;0;0;0
94;26.07.2017;2017;07;03;Keskiviikko;0;0;0
94;26.07.2017;2017;07;04;Keskiviikko;3;0;3
94;26.07.2017;2017;07;05;Keskiviikko;5;5;10
94;26.07.2017;2017;07;06;Keskiviikko;19;1;20
94;26.07.2017;2017;07;07;Keskiviikko;31;4;35
94;26.07.2017;2017;07;08;Keskiviikko;9;4;13
94;26.07.2017;2017;07;09;Keskiviikko;9;3;12
94;26.07.2017;2017;07;10;Keskiviikko;9;7;16
94;26.07.2017;2017;07;11;Keskiviikko;19;10;29
94;26.07.2017;2017;07;12;Keskiviikko;20;11;31
94;26.07.2017;2017;07;13;Keskiviikko;11;8;19
94;26.07.2017;2017;07;14;Keskiviikko;19;20;39
94;26.07.2017;2017;07;15;Keskiviikko;9;39;48
94;26.07.2017;2017;07;16;Keskiviikko;17;33;50
94;26.07.2017;2017;07;17;Keskiviikko;18;30;48
94;26.07.2017;2017;07;18;Keskiviikko;25;17;42
94;26.07.2017;2017;07;19;Keskiviikko;21;15;36
94;26.07.2017;2017;07;20;Keskiviikko;25;13;38
94;26.07.2017;2017;07;21;Keskiviikko;3;10;13
94;26.07.2017;2017;07;22;Keskiviikko;3;5;8
94;26.07.2017;2017;07;23;Keskiviikko;2;5;7
94;27.07.2017;2017;07;00;Torstai;3;0;3
94;27.07.2017;2017;07;01;Torstai;0;2;2
94;27.07.2017;2017;07;02;Torstai;0;0;0
94;27.07.2017;2017;07;03;Torstai;0;1;1
94;27.07.2017;2017;07;04;Torstai;3;2;5
94;27.07.2017;2017;07;05;Torstai;2;3;5
94;27.07.2017;2017;07;06;Torstai;18;3;21
94;27.07.2017;2017;07;07;Torstai;19;1;20
94;27.07.2017;2017;07;08;Torstai;6;5;11
94;27.07.2017;2017;07;09;Torstai;6;3;9
94;27.07.2017;2017;07;10;Torstai;7;8;15
94;27.07.2017;2017;07;11;Torstai;17;15;32
94;27.07.2017;2017;07;12;Torstai;10;18;28
94;27.07.2017;2017;07;13;Torstai;9;14;23
94;27.07.2017;2017;07;14;Torstai;19;12;31
94;27.07.2017;2017;07;15;Torstai;24;33;57
94;27.07.2017;2017;07;16;Torstai;12;29;41
94;27.07.2017;2017;07;17;Torstai;16;15;31
94;27.07.2017;2017;07;18;Torstai;17;17;34
94;27.07.2017;2017;07;19;Torstai;13;6;19
94;27.07.2017;2017;07;20;Torstai;11;7;18
94;27.07.2017;2017;07;21;Torstai;8;8;16
94;27.07.2017;2017;07;22;Torstai;2;4;6
94;27.07.2017;2017;07;23;Torstai;3;9;12
94;28.07.2017;2017;07;00;Perjantai;2;2;4
94;28.07.2017;2017;07;01;Perjantai;0;0;0
94;28.07.2017;2017;07;02;Perjantai;0;1;1
94;28.07.2017;2017;07;03;Perjantai;0;0;0
94;28.07.2017;2017;07;04;Perjantai;3;0;3
94;28.07.2017;2017;07;05;Perjantai;3;2;5
94;28.07.2017;2017;07;06;Perjantai;13;3;16
94;28.07.2017;2017;07;07;Perjantai;17;1;18
94;28.07.2017;2017;07;08;Perjantai;9;4;13
94;28.07.2017;2017;07;09;Perjantai;8;4;12
94;28.07.2017;2017;07;10;Perjantai;18;5;23
94;28.07.2017;2017;07;11;Perjantai;11;8;19
94;28.07.2017;2017;07;12;Perjantai;11;21;32
94;28.07.2017;2017;07;13;Perjantai;11;8;19
94;28.07.2017;2017;07;14;Perjantai;8;23;31
94;28.07.2017;2017;07;15;Perjantai;13;21;34
94;28.07.2017;2017;07;16;Perjantai;19;12;31
94;28.07.2017;2017;07;17;Perjantai;6;29;35
94;28.07.2017;2017;07;18;Perjantai;9;7;16
94;28.07.2017;2017;07;19;Perjantai;9;13;22
94;28.07.2017;2017;07;20;Perjantai;7;9;16
94;28.07.2017;2017;07;21;Perjantai;6;8;14
94;28.07.2017;2017;07;22;Perjantai;2;1;3
94;28.07.2017;2017;07;23;Perjantai;4;5;9
94;29.07.2017;2017;07;00;Lauantai;3;2;5
94;29.07.2017;2017;07;01;Lauantai;1;7;8
94;29.07.2017;2017;07;02;Lauantai;0;3;3
94;29.07.2017;2017;07;03;Lauantai;0;3;3
94;29.07.2017;2017;07;04;Lauantai;0;3;3
94;29.07.2017;2017;07;05;Lauantai;1;2;3
94;29.07.2017;2017;07;06;Lauantai;2;1;3
94;29.07.2017;2017;07;07;Lauantai;0;1;1
94;29.07.2017;2017;07;08;Lauantai;4;1;5
94;29.07.2017;2017;07;09;Lauantai;2;5;7
94;29.07.2017;2017;07;10;Lauantai;1;4;5
94;29.07.2017;2017;07;11;Lauantai;10;2;12
94;29.07.2017;2017;07;12;Lauantai;0;7;7
94;29.07.2017;2017;07;13;Lauantai;3;7;10
94;29.07.2017;2017;07;14;Lauantai;4;3;7
94;29.07.2017;2017;07;15;Lauantai;7;2;9
94;29.07.2017;2017;07;16;Lauantai;5;5;10
94;29.07.2017;2017;07;17;Lauantai;6;6;12
94;29.07.2017;2017;07;18;Lauantai;13;6;19
94;29.07.2017;2017;07;19;Lauantai;10;5;15
94;29.07.2017;2017;07;20;Lauantai;5;10;15
94;29.07.2017;2017;07;21;Lauantai;4;16;20
94;29.07.2017;2017;07;22;Lauantai;2;0;2
94;29.07.2017;2017;07;23;Lauantai;5;2;7
94;30.07.2017;2017;07;00;Sunnuntai;1;0;1
94;30.07.2017;2017;07;01;Sunnuntai;0;2;2
94;30.07.2017;2017;07;02;Sunnuntai;0;6;6
94;30.07.2017;2017;07;03;Sunnuntai;0;4;4
94;30.07.2017;2017;07;04;Sunnuntai;0;0;0
94;30.07.2017;2017;07;05;Sunnuntai;0;0;0
94;30.07.2017;2017;07;06;Sunnuntai;1;0;1
94;30.07.2017;2017;07;07;Sunnuntai;1;0;1
94;30.07.2017;2017;07;08;Sunnuntai;0;5;5
94;30.07.2017;2017;07;09;Sunnuntai;13;4;17
94;30.07.2017;2017;07;10;Sunnuntai;3;10;13
94;30.07.2017;2017;07;11;Sunnuntai;19;11;30
94;30.07.2017;2017;07;12;Sunnuntai;20;18;38
94;30.07.2017;2017;07;13;Sunnuntai;13;14;27
94;30.07.2017;2017;07;14;Sunnuntai;14;19;33
94;30.07.2017;2017;07;15;Sunnuntai;13;7;20
94;30.07.2017;2017;07;16;Sunnuntai;14;11;25
94;30.07.2017;2017;07;17;Sunnuntai;1;13;14
94;30.07.2017;2017;07;18;Sunnuntai;8;8;16
94;30.07.2017;2017;07;19;Sunnuntai;24;4;28
94;30.07.2017;2017;07;20;Sunnuntai;13;8;21
94;30.07.2017;2017;07;21;Sunnuntai;9;8;17
94;30.07.2017;2017;07;22;Sunnuntai;2;6;8
94;30.07.2017;2017;07;23;Sunnuntai;3;11;14
94;31.07.2017;2017;07;00;Maanantai;1;1;2
94;31.07.2017;2017;07;01;Maanantai;0;1;1
94;31.07.2017;2017;07;02;Maanantai;2;0;2
94;31.07.2017;2017;07;03;Maanantai;0;0;0
94;31.07.2017;2017;07;04;Maanantai;4;2;6
94;31.07.2017;2017;07;05;Maanantai;2;2;4
94;31.07.2017;2017;07;06;Maanantai;21;0;21
94;31.07.2017;2017;07;07;Maanantai;14;2;16
94;31.07.2017;2017;07;08;Maanantai;11;1;12
94;31.07.2017;2017;07;09;Maanantai;5;3;8
94;31.07.2017;2017;07;10;Maanantai;4;2;6
94;31.07.2017;2017;07;11;Maanantai;7;6;13
94;31.07.2017;2017;07;12;Maanantai;5;5;10
94;31.07.2017;2017;07;13;Maanantai;13;5;18
94;31.07.2017;2017;07;14;Maanantai;9;13;22
94;31.07.2017;2017;07;15;Maanantai;14;15;29
94;31.07.2017;2017;07;16;Maanantai;10;32;42
94;31.07.2017;2017;07;17;Maanantai;11;30;41
94;31.07.2017;2017;07;18;Maanantai;14;11;25
94;31.07.2017;2017;07;19;Maanantai;10;14;24
94;31.07.2017;2017;07;20;Maanantai;11;8;19
94;31.07.2017;2017;07;21;Maanantai;4;2;6
94;31.07.2017;2017;07;22;Maanantai;1;1;2
94;31.07.2017;2017;07;23;Maanantai;1;1;2
94;01.08.2017;2017;08;00;Tiistai;0;2;2
94;01.08.2017;2017;08;01;Tiistai;0;0;0
94;01.08.2017;2017;08;02;Tiistai;0;0;0
94;01.08.2017;2017;08;03;Tiistai;0;0;0
94;01.08.2017;2017;08;04;Tiistai;1;0;1
94;01.08.2017;2017;08;05;Tiistai;4;3;7
94;01.08.2017;2017;08;06;Tiistai;18;1;19
94;01.08.2017;2017;08;07;Tiistai;22;7;29
94;01.08.2017;2017;08;08;Tiistai;10;10;20
94;01.08.2017;2017;08;09;Tiistai;4;4;8
94;01.08.2017;2017;08;10;Tiistai;3;5;8
94;01.08.2017;2017;08;11;Tiistai;10;7;17
94;01.08.2017;2017;08;12;Tiistai;8;7;15
94;01.08.2017;2017;08;13;Tiistai;12;11;23
94;01.08.2017;2017;08;14;Tiistai;11;14;25
94;01.08.2017;2017;08;15;Tiistai;16;15;31
94;01.08.2017;2017;08;16;Tiistai;11;28;39
94;01.08.2017;2017;08;17;Tiistai;11;16;27
94;01.08.2017;2017;08;18;Tiistai;13;13;26
94;01.08.2017;2017;08;19;Tiistai;9;17;26
94;01.08.2017;2017;08;20;Tiistai;12;14;26
94;01.08.2017;2017;08;21;Tiistai;6;8;14
94;01.08.2017;2017;08;22;Tiistai;4;9;13
94;01.08.2017;2017;08;23;Tiistai;2;3;5
94;02.08.2017;2017;08;00;Keskiviikko;2;0;2
94;02.08.2017;2017;08;01;Keskiviikko;1;1;2
94;02.08.2017;2017;08;02;Keskiviikko;0;0;0
94;02.08.2017;2017;08;03;Keskiviikko;0;2;2
94;02.08.2017;2017;08;04;Keskiviikko;1;0;1
94;02.08.2017;2017;08;05;Keskiviikko;6;3;9
94;02.08.2017;2017;08;06;Keskiviikko;21;2;23
94;02.08.2017;2017;08;07;Keskiviikko;25;3;28
94;02.08.2017;2017;08;08;Keskiviikko;7;1;8
94;02.08.2017;2017;08;09;Keskiviikko;8;4;12
94;02.08.2017;2017;08;10;Keskiviikko;2;5;7
94;02.08.2017;2017;08;11;Keskiviikko;13;6;19
94;02.08.2017;2017;08;12;Keskiviikko;13;17;30
94;02.08.2017;2017;08;13;Keskiviikko;15;11;26
94;02.08.2017;2017;08;14;Keskiviikko;19;17;36
94;02.08.2017;2017;08;15;Keskiviikko;16;26;42
94;02.08.2017;2017;08;16;Keskiviikko;9;46;55
94;02.08.2017;2017;08;17;Keskiviikko;14;21;35
94;02.08.2017;2017;08;18;Keskiviikko;19;26;45
94;02.08.2017;2017;08;19;Keskiviikko;7;16;23
94;02.08.2017;2017;08;20;Keskiviikko;11;8;19
94;02.08.2017;2017;08;21;Keskiviikko;3;10;13
94;02.08.2017;2017;08;22;Keskiviikko;6;5;11
94;02.08.2017;2017;08;23;Keskiviikko;0;1;1
94;03.08.2017;2017;08;00;Torstai;0;0;0
94;03.08.2017;2017;08;01;Torstai;0;0;0
94;03.08.2017;2017;08;02;Torstai;0;2;2
94;03.08.2017;2017;08;03;Torstai;1;0;1
94;03.08.2017;2017;08;04;Torstai;2;2;4
94;03.08.2017;2017;08;05;Torstai;4;2;6
94;03.08.2017;2017;08;06;Torstai;16;3;19
94;03.08.2017;2017;08;07;Torstai;19;4;23
94;03.08.2017;2017;08;08;Torstai;9;4;13
94;03.08.2017;2017;08;09;Torstai;5;2;7
94;03.08.2017;2017;08;10;Torstai;8;3;11
94;03.08.2017;2017;08;11;Torstai;8;3;11
94;03.08.2017;2017;08;12;Torstai;10;5;15
94;03.08.2017;2017;08;13;Torstai;11;14;25
94;03.08.2017;2017;08;14;Torstai;13;16;29
94;03.08.2017;2017;08;15;Torstai;8;31;39
94;03.08.2017;2017;08;16;Torstai;14;21;35
94;03.08.2017;2017;08;17;Torstai;4;18;22
94;03.08.2017;2017;08;18;Torstai;11;8;19
94;03.08.2017;2017;08;19;Torstai;11;6;17
94;03.08.2017;2017;08;20;Torstai;8;9;17
94;03.08.2017;2017;08;21;Torstai;3;2;5
94;03.08.2017;2017;08;22;Torstai;3;4;7
94;03.08.2017;2017;08;23;Torstai;1;2;3
94;04.08.2017;2017;08;00;Perjantai;3;0;3
94;04.08.2017;2017;08;01;Perjantai;0;0;0
94;04.08.2017;2017;08;02;Perjantai;0;0;0
94;04.08.2017;2017;08;03;Perjantai;0;0;0
94;04.08.2017;2017;08;04;Perjantai;1;0;1
94;04.08.2017;2017;08;05;Perjantai;3;3;6
94;04.08.2017;2017;08;06;Perjantai;19;4;23
94;04.08.2017;2017;08;07;Perjantai;23;4;27
94;04.08.2017;2017;08;08;Perjantai;5;2;7
94;04.08.2017;2017;08;09;Perjantai;4;7;11
94;04.08.2017;2017;08;10;Perjantai;6;5;11
94;04.08.2017;2017;08;11;Perjantai;5;7;12
94;04.08.2017;2017;08;12;Perjantai;9;7;16
94;04.08.2017;2017;08;13;Perjantai;12;13;25
94;04.08.2017;2017;08;14;Perjantai;8;21;29
94;04.08.2017;2017;08;15;Perjantai;9;35;44
94;04.08.2017;2017;08;16;Perjantai;16;22;38
94;04.08.2017;2017;08;17;Perjantai;6;8;14
94;04.08.2017;2017;08;18;Perjantai;10;8;18
94;04.08.2017;2017;08;19;Perjantai;5;4;9
94;04.08.2017;2017;08;20;Perjantai;6;1;7
94;04.08.2017;2017;08;21;Perjantai;10;4;14
94;04.08.2017;2017;08;22;Perjantai;2;3;5
94;04.08.2017;2017;08;23;Perjantai;1;1;2
94;05.08.2017;2017;08;00;Lauantai;0;0;0
94;05.08.2017;2017;08;01;Lauantai;0;0;0
94;05.08.2017;2017;08;02;Lauantai;1;0;1
94;05.08.2017;2017;08;03;Lauantai;0;0;0
94;05.08.2017;2017;08;04;Lauantai;0;0;0
94;05.08.2017;2017;08;05;Lauantai;1;1;2
94;05.08.2017;2017;08;06;Lauantai;1;3;4
94;05.08.2017;2017;08;07;Lauantai;2;2;4
94;05.08.2017;2017;08;08;Lauantai;3;2;5
94;05.08.2017;2017;08;09;Lauantai;5;3;8
94;05.08.2017;2017;08;10;Lauantai;2;6;8
94;05.08.2017;2017;08;11;Lauantai;4;1;5
94;05.08.2017;2017;08;12;Lauantai;2;4;6
94;05.08.2017;2017;08;13;Lauantai;13;6;19
94;05.08.2017;2017;08;14;Lauantai;7;8;15
94;05.08.2017;2017;08;15;Lauantai;8;2;10
94;05.08.2017;2017;08;16;Lauantai;15;5;20
94;05.08.2017;2017;08;17;Lauantai;5;8;13
94;05.08.2017;2017;08;18;Lauantai;2;2;4
94;05.08.2017;2017;08;19;Lauantai;3;5;8
94;05.08.2017;2017;08;20;Lauantai;0;1;1
94;05.08.2017;2017;08;21;Lauantai;3;3;6
94;05.08.2017;2017;08;22;Lauantai;0;1;1
94;05.08.2017;2017;08;23;Lauantai;0;3;3
94;06.08.2017;2017;08;00;Sunnuntai;0;1;1
94;06.08.2017;2017;08;01;Sunnuntai;0;2;2
94;06.08.2017;2017;08;02;Sunnuntai;0;0;0
94;06.08.2017;2017;08;03;Sunnuntai;0;0;0
94;06.08.2017;2017;08;04;Sunnuntai;0;0;0
94;06.08.2017;2017;08;05;Sunnuntai;1;0;1
94;06.08.2017;2017;08;06;Sunnuntai;2;0;2
94;06.08.2017;2017;08;07;Sunnuntai;0;1;1
94;06.08.2017;2017;08;08;Sunnuntai;0;1;1
94;06.08.2017;2017;08;09;Sunnuntai;3;0;3
94;06.08.2017;2017;08;10;Sunnuntai;7;3;10
94;06.08.2017;2017;08;11;Sunnuntai;7;8;15
94;06.08.2017;2017;08;12;Sunnuntai;4;4;8
94;06.08.2017;2017;08;13;Sunnuntai;7;2;9
94;06.08.2017;2017;08;14;Sunnuntai;3;8;11
94;06.08.2017;2017;08;15;Sunnuntai;12;6;18
94;06.08.2017;2017;08;16;Sunnuntai;7;3;10
94;06.08.2017;2017;08;17;Sunnuntai;4;8;12
94;06.08.2017;2017;08;18;Sunnuntai;4;2;6
94;06.08.2017;2017;08;19;Sunnuntai;3;5;8
94;06.08.2017;2017;08;20;Sunnuntai;9;9;18
94;06.08.2017;2017;08;21;Sunnuntai;6;2;8
94;06.08.2017;2017;08;22;Sunnuntai;1;3;4
94;06.08.2017;2017;08;23;Sunnuntai;2;1;3
94;07.08.2017;2017;08;00;Maanantai;3;0;3
94;07.08.2017;2017;08;01;Maanantai;0;0;0
94;07.08.2017;2017;08;02;Maanantai;0;4;4
94;07.08.2017;2017;08;03;Maanantai;0;0;0
94;07.08.2017;2017;08;04;Maanantai;2;2;4
94;07.08.2017;2017;08;05;Maanantai;7;2;9
94;07.08.2017;2017;08;06;Maanantai;10;2;12
94;07.08.2017;2017;08;07;Maanantai;32;2;34
94;07.08.2017;2017;08;08;Maanantai;15;4;19
94;07.08.2017;2017;08;09;Maanantai;3;2;5
94;07.08.2017;2017;08;10;Maanantai;3;6;9
94;07.08.2017;2017;08;11;Maanantai;7;6;13
94;07.08.2017;2017;08;12;Maanantai;8;7;15
94;07.08.2017;2017;08;13;Maanantai;10;10;20
94;07.08.2017;2017;08;14;Maanantai;9;11;20
94;07.08.2017;2017;08;15;Maanantai;10;23;33
94;07.08.2017;2017;08;16;Maanantai;10;25;35
94;07.08.2017;2017;08;17;Maanantai;2;21;23
94;07.08.2017;2017;08;18;Maanantai;6;10;16
94;07.08.2017;2017;08;19;Maanantai;8;15;23
94;07.08.2017;2017;08;20;Maanantai;4;13;17
94;07.08.2017;2017;08;21;Maanantai;7;3;10
94;07.08.2017;2017;08;22;Maanantai;3;2;5
94;07.08.2017;2017;08;23;Maanantai;2;3;5
94;08.08.2017;2017;08;00;Tiistai;0;5;5
94;08.08.2017;2017;08;01;Tiistai;0;0;0
94;08.08.2017;2017;08;02;Tiistai;0;0;0
94;08.08.2017;2017;08;03;Tiistai;1;2;3
94;08.08.2017;2017;08;04;Tiistai;0;1;1
94;08.08.2017;2017;08;05;Tiistai;8;2;10
94;08.08.2017;2017;08;06;Tiistai;17;3;20
94;08.08.2017;2017;08;07;Tiistai;34;1;35
94;08.08.2017;2017;08;08;Tiistai;7;7;14
94;08.08.2017;2017;08;09;Tiistai;6;0;6
94;08.08.2017;2017;08;10;Tiistai;5;5;10
94;08.08.2017;2017;08;11;Tiistai;7;5;12
94;08.08.2017;2017;08;12;Tiistai;7;9;16
94;08.08.2017;2017;08;13;Tiistai;9;12;21
94;08.08.2017;2017;08;14;Tiistai;13;12;25
94;08.08.2017;2017;08;15;Tiistai;12;35;47
94;08.08.2017;2017;08;16;Tiistai;14;34;48
94;08.08.2017;2017;08;17;Tiistai;9;27;36
94;08.08.2017;2017;08;18;Tiistai;10;12;22
94;08.08.2017;2017;08;19;Tiistai;6;9;15
94;08.08.2017;2017;08;20;Tiistai;4;8;12
94;08.08.2017;2017;08;21;Tiistai;3;4;7
94;08.08.2017;2017;08;22;Tiistai;2;6;8
94;08.08.2017;2017;08;23;Tiistai;2;1;3
94;09.08.2017;2017;08;00;Keskiviikko;1;4;5
94;09.08.2017;2017;08;01;Keskiviikko;0;0;0
94;09.08.2017;2017;08;02;Keskiviikko;0;0;0
94;09.08.2017;2017;08;03;Keskiviikko;0;0;0
94;09.08.2017;2017;08;04;Keskiviikko;0;1;1
94;09.08.2017;2017;08;05;Keskiviikko;8;3;11
94;09.08.2017;2017;08;06;Keskiviikko;19;1;20
94;09.08.2017;2017;08;07;Keskiviikko;31;3;34
94;09.08.2017;2017;08;08;Keskiviikko;19;7;26
94;09.08.2017;2017;08;09;Keskiviikko;4;3;7
94;09.08.2017;2017;08;10;Keskiviikko;9;4;13
94;09.08.2017;2017;08;11;Keskiviikko;6;3;9
94;09.08.2017;2017;08;12;Keskiviikko;10;13;23
94;09.08.2017;2017;08;13;Keskiviikko;12;13;25
94;09.08.2017;2017;08;14;Keskiviikko;10;18;28
94;09.08.2017;2017;08;15;Keskiviikko;14;22;36
94;09.08.2017;2017;08;16;Keskiviikko;11;46;57
94;09.08.2017;2017;08;17;Keskiviikko;16;35;51
94;09.08.2017;2017;08;18;Keskiviikko;10;27;37
94;09.08.2017;2017;08;19;Keskiviikko;13;15;28
94;09.08.2017;2017;08;20;Keskiviikko;9;8;17
94;09.08.2017;2017;08;21;Keskiviikko;10;7;17
94;09.08.2017;2017;08;22;Keskiviikko;1;5;6
94;09.08.2017;2017;08;23;Keskiviikko;0;0;0
94;10.08.2017;2017;08;00;Torstai;0;0;0
94;10.08.2017;2017;08;01;Torstai;0;0;0
94;10.08.2017;2017;08;02;Torstai;0;0;0
94;10.08.2017;2017;08;03;Torstai;0;0;0
94;10.08.2017;2017;08;04;Torstai;1;1;2
94;10.08.2017;2017;08;05;Torstai;6;2;8
94;10.08.2017;2017;08;06;Torstai;10;1;11
94;10.08.2017;2017;08;07;Torstai;18;3;21
94;10.08.2017;2017;08;08;Torstai;19;7;26
94;10.08.2017;2017;08;09;Torstai;5;1;6
94;10.08.2017;2017;08;10;Torstai;4;4;8
94;10.08.2017;2017;08;11;Torstai;3;5;8
94;10.08.2017;2017;08;12;Torstai;2;0;2
94;10.08.2017;2017;08;13;Torstai;1;7;8
94;10.08.2017;2017;08;14;Torstai;2;9;11
94;10.08.2017;2017;08;15;Torstai;6;11;17
94;10.08.2017;2017;08;16;Torstai;4;18;22
94;10.08.2017;2017;08;17;Torstai;3;12;15
94;10.08.2017;2017;08;18;Torstai;2;7;9
94;10.08.2017;2017;08;19;Torstai;2;5;7
94;10.08.2017;2017;08;20;Torstai;4;4;8
94;10.08.2017;2017;08;21;Torstai;4;3;7
94;10.08.2017;2017;08;22;Torstai;1;1;2
94;10.08.2017;2017;08;23;Torstai;0;0;0
94;11.08.2017;2017;08;00;Perjantai;0;0;0
94;11.08.2017;2017;08;01;Perjantai;0;0;0
94;11.08.2017;2017;08;02;Perjantai;0;0;0
94;11.08.2017;2017;08;03;Perjantai;0;0;0
94;11.08.2017;2017;08;04;Perjantai;2;0;2
94;11.08.2017;2017;08;05;Perjantai;4;4;8
94;11.08.2017;2017;08;06;Perjantai;12;2;14
94;11.08.2017;2017;08;07;Perjantai;24;5;29
94;11.08.2017;2017;08;08;Perjantai;16;8;24
94;11.08.2017;2017;08;09;Perjantai;9;3;12
94;11.08.2017;2017;08;10;Perjantai;2;3;5
94;11.08.2017;2017;08;11;Perjantai;4;5;9
94;11.08.2017;2017;08;12;Perjantai;8;8;16
94;11.08.2017;2017;08;13;Perjantai;9;15;24
94;11.08.2017;2017;08;14;Perjantai;15;18;33
94;11.08.2017;2017;08;15;Perjantai;14;30;44
94;11.08.2017;2017;08;16;Perjantai;4;17;21
94;11.08.2017;2017;08;17;Perjantai;6;17;23
94;11.08.2017;2017;08;18;Perjantai;10;6;16
94;11.08.2017;2017;08;19;Perjantai;5;7;12
94;11.08.2017;2017;08;20;Perjantai;8;3;11
94;11.08.2017;2017;08;21;Perjantai;1;5;6
94;11.08.2017;2017;08;22;Perjantai;2;2;4
94;11.08.2017;2017;08;23;Perjantai;3;2;5
94;12.08.2017;2017;08;00;Lauantai;0;1;1
94;12.08.2017;2017;08;01;Lauantai;0;1;1
94;12.08.2017;2017;08;02;Lauantai;0;0;0
94;12.08.2017;2017;08;03;Lauantai;0;0;0
94;12.08.2017;2017;08;04;Lauantai;0;0;0
94;12.08.2017;2017;08;05;Lauantai;2;2;4
94;12.08.2017;2017;08;06;Lauantai;2;0;2
94;12.08.2017;2017;08;07;Lauantai;1;0;1
94;12.08.2017;2017;08;08;Lauantai;3;4;7
94;12.08.2017;2017;08;09;Lauantai;4;3;7
94;12.08.2017;2017;08;10;Lauantai;4;13;17
94;12.08.2017;2017;08;11;Lauantai;13;17;30
94;12.08.2017;2017;08;12;Lauantai;20;21;41
94;12.08.2017;2017;08;13;Lauantai;17;13;30
94;12.08.2017;2017;08;14;Lauantai;18;15;33
94;12.08.2017;2017;08;15;Lauantai;9;21;30
94;12.08.2017;2017;08;16;Lauantai;12;7;19
94;12.08.2017;2017;08;17;Lauantai;12;15;27
94;12.08.2017;2017;08;18;Lauantai;5;11;16
94;12.08.2017;2017;08;19;Lauantai;9;7;16
94;12.08.2017;2017;08;20;Lauantai;4;6;10
94;12.08.2017;2017;08;21;Lauantai;6;1;7
94;12.08.2017;2017;08;22;Lauantai;2;3;5
94;12.08.2017;2017;08;23;Lauantai;1;3;4
94;13.08.2017;2017;08;00;Sunnuntai;3;5;8
94;13.08.2017;2017;08;01;Sunnuntai;3;1;4
94;13.08.2017;2017;08;02;Sunnuntai;0;2;2
94;13.08.2017;2017;08;03;Sunnuntai;0;0;0
94;13.08.2017;2017;08;04;Sunnuntai;1;1;2
94;13.08.2017;2017;08;05;Sunnuntai;2;0;2
94;13.08.2017;2017;08;06;Sunnuntai;0;0;0
94;13.08.2017;2017;08;07;Sunnuntai;0;1;1
94;13.08.2017;2017;08;08;Sunnuntai;2;0;2
94;13.08.2017;2017;08;09;Sunnuntai;0;2;2
94;13.08.2017;2017;08;10;Sunnuntai;0;2;2
94;13.08.2017;2017;08;11;Sunnuntai;4;1;5
94;13.08.2017;2017;08;12;Sunnuntai;5;1;6
94;13.08.2017;2017;08;13;Sunnuntai;2;4;6
94;13.08.2017;2017;08;14;Sunnuntai;3;2;5
94;13.08.2017;2017;08;15;Sunnuntai;2;7;9
94;13.08.2017;2017;08;16;Sunnuntai;4;3;7
94;13.08.2017;2017;08;17;Sunnuntai;6;4;10
94;13.08.2017;2017;08;18;Sunnuntai;12;8;20
94;13.08.2017;2017;08;19;Sunnuntai;4;5;9
94;13.08.2017;2017;08;20;Sunnuntai;3;6;9
94;13.08.2017;2017;08;21;Sunnuntai;1;3;4
94;13.08.2017;2017;08;22;Sunnuntai;4;2;6
94;13.08.2017;2017;08;23;Sunnuntai;1;0;1
94;14.08.2017;2017;08;00;Maanantai;0;0;0
94;14.08.2017;2017;08;01;Maanantai;0;0;0
94;14.08.2017;2017;08;02;Maanantai;0;0;0
94;14.08.2017;2017;08;03;Maanantai;0;1;1
94;14.08.2017;2017;08;04;Maanantai;2;0;2
94;14.08.2017;2017;08;05;Maanantai;4;1;5
94;14.08.2017;2017;08;06;Maanantai;13;2;15
94;14.08.2017;2017;08;07;Maanantai;42;6;48
94;14.08.2017;2017;08;08;Maanantai;9;3;12
94;14.08.2017;2017;08;09;Maanantai;3;3;6
94;14.08.2017;2017;08;10;Maanantai;4;2;6
94;14.08.2017;2017;08;11;Maanantai;4;7;11
94;14.08.2017;2017;08;12;Maanantai;1;8;9
94;14.08.2017;2017;08;13;Maanantai;3;6;9
94;14.08.2017;2017;08;14;Maanantai;5;14;19
94;14.08.2017;2017;08;15;Maanantai;6;22;28
94;14.08.2017;2017;08;16;Maanantai;8;35;43
94;14.08.2017;2017;08;17;Maanantai;8;19;27
94;14.08.2017;2017;08;18;Maanantai;6;4;10
94;14.08.2017;2017;08;19;Maanantai;5;6;11
94;14.08.2017;2017;08;20;Maanantai;3;5;8
94;14.08.2017;2017;08;21;Maanantai;4;3;7
94;14.08.2017;2017;08;22;Maanantai;1;1;2
94;14.08.2017;2017;08;23;Maanantai;0;0;0
94;15.08.2017;2017;08;00;Tiistai;0;0;0
94;15.08.2017;2017;08;01;Tiistai;0;0;0
94;15.08.2017;2017;08;02;Tiistai;0;0;0
94;15.08.2017;2017;08;03;Tiistai;0;0;0
94;15.08.2017;2017;08;04;Tiistai;1;0;1
94;15.08.2017;2017;08;05;Tiistai;9;2;11
94;15.08.2017;2017;08;06;Tiistai;17;0;17
94;15.08.2017;2017;08;07;Tiistai;35;3;38
94;15.08.2017;2017;08;08;Tiistai;18;5;23
94;15.08.2017;2017;08;09;Tiistai;6;4;10
94;15.08.2017;2017;08;10;Tiistai;6;2;8
94;15.08.2017;2017;08;11;Tiistai;5;7;12
94;15.08.2017;2017;08;12;Tiistai;13;16;29
94;15.08.2017;2017;08;13;Tiistai;1;5;6
94;15.08.2017;2017;08;14;Tiistai;6;13;19
94;15.08.2017;2017;08;15;Tiistai;4;22;26
94;15.08.2017;2017;08;16;Tiistai;16;36;52
94;15.08.2017;2017;08;17;Tiistai;6;24;30
94;15.08.2017;2017;08;18;Tiistai;17;9;26
94;15.08.2017;2017;08;19;Tiistai;9;12;21
94;15.08.2017;2017;08;20;Tiistai;3;7;10
94;15.08.2017;2017;08;21;Tiistai;7;9;16
94;15.08.2017;2017;08;22;Tiistai;3;2;5
94;15.08.2017;2017;08;23;Tiistai;1;0;1
94;16.08.2017;2017;08;00;Keskiviikko;0;0;0
94;16.08.2017;2017;08;01;Keskiviikko;0;0;0
94;16.08.2017;2017;08;02;Keskiviikko;1;0;1
94;16.08.2017;2017;08;03;Keskiviikko;0;0;0
94;16.08.2017;2017;08;04;Keskiviikko;1;0;1
94;16.08.2017;2017;08;05;Keskiviikko;2;3;5
94;16.08.2017;2017;08;06;Keskiviikko;19;0;19
94;16.08.2017;2017;08;07;Keskiviikko;30;2;32
94;16.08.2017;2017;08;08;Keskiviikko;20;4;24
94;16.08.2017;2017;08;09;Keskiviikko;1;3;4
94;16.08.2017;2017;08;10;Keskiviikko;6;6;12
94;16.08.2017;2017;08;11;Keskiviikko;3;7;10
94;16.08.2017;2017;08;12;Keskiviikko;7;7;14
94;16.08.2017;2017;08;13;Keskiviikko;10;13;23
94;16.08.2017;2017;08;14;Keskiviikko;12;11;23
94;16.08.2017;2017;08;15;Keskiviikko;6;29;35
94;16.08.2017;2017;08;16;Keskiviikko;14;38;52
94;16.08.2017;2017;08;17;Keskiviikko;8;22;30
94;16.08.2017;2017;08;18;Keskiviikko;6;8;14
94;16.08.2017;2017;08;19;Keskiviikko;13;13;26
94;16.08.2017;2017;08;20;Keskiviikko;5;8;13
94;16.08.2017;2017;08;21;Keskiviikko;4;11;15
94;16.08.2017;2017;08;22;Keskiviikko;2;1;3
94;16.08.2017;2017;08;23;Keskiviikko;1;1;2
94;17.08.2017;2017;08;00;Torstai;0;0;0
94;17.08.2017;2017;08;01;Torstai;0;0;0
94;17.08.2017;2017;08;02;Torstai;0;0;0
94;17.08.2017;2017;08;03;Torstai;1;0;1
94;17.08.2017;2017;08;04;Torstai;1;2;3
94;17.08.2017;2017;08;05;Torstai;4;2;6
94;17.08.2017;2017;08;06;Torstai;13;4;17
94;17.08.2017;2017;08;07;Torstai;27;5;32
94;17.08.2017;2017;08;08;Torstai;14;2;16
94;17.08.2017;2017;08;09;Torstai;7;7;14
94;17.08.2017;2017;08;10;Torstai;2;2;4
94;17.08.2017;2017;08;11;Torstai;9;5;14
94;17.08.2017;2017;08;12;Torstai;7;4;11
94;17.08.2017;2017;08;13;Torstai;9;9;18
94;17.08.2017;2017;08;14;Torstai;14;19;33
94;17.08.2017;2017;08;15;Torstai;8;22;30
94;17.08.2017;2017;08;16;Torstai;11;20;31
94;17.08.2017;2017;08;17;Torstai;8;19;27
94;17.08.2017;2017;08;18;Torstai;18;12;30
94;17.08.2017;2017;08;19;Torstai;6;7;13
94;17.08.2017;2017;08;20;Torstai;5;7;12
94;17.08.2017;2017;08;21;Torstai;2;11;13
94;17.08.2017;2017;08;22;Torstai;2;4;6
94;17.08.2017;2017;08;23;Torstai;0;0;0
94;18.08.2017;2017;08;00;Perjantai;0;0;0
94;18.08.2017;2017;08;01;Perjantai;0;0;0
94;18.08.2017;2017;08;02;Perjantai;0;0;0
94;18.08.2017;2017;08;03;Perjantai;1;0;1
94;18.08.2017;2017;08;04;Perjantai;1;0;1
94;18.08.2017;2017;08;05;Perjantai;2;2;4
94;18.08.2017;2017;08;06;Perjantai;16;1;17
94;18.08.2017;2017;08;07;Perjantai;25;1;26
94;18.08.2017;2017;08;08;Perjantai;9;2;11
94;18.08.2017;2017;08;09;Perjantai;7;3;10
94;18.08.2017;2017;08;10;Perjantai;4;3;7
94;18.08.2017;2017;08;11;Perjantai;5;5;10
94;18.08.2017;2017;08;12;Perjantai;3;3;6
94;18.08.2017;2017;08;13;Perjantai;3;8;11
94;18.08.2017;2017;08;14;Perjantai;8;21;29
94;18.08.2017;2017;08;15;Perjantai;4;17;21
94;18.08.2017;2017;08;16;Perjantai;10;15;25
94;18.08.2017;2017;08;17;Perjantai;9;11;20
94;18.08.2017;2017;08;18;Perjantai;12;8;20
94;18.08.2017;2017;08;19;Perjantai;5;8;13
94;18.08.2017;2017;08;20;Perjantai;5;7;12
94;18.08.2017;2017;08;21;Perjantai;1;8;9
94;18.08.2017;2017;08;22;Perjantai;6;8;14
94;18.08.2017;2017;08;23;Perjantai;0;1;1
94;19.08.2017;2017;08;00;Lauantai;0;0;0
94;19.08.2017;2017;08;01;Lauantai;0;0;0
94;19.08.2017;2017;08;02;Lauantai;0;0;0
94;19.08.2017;2017;08;03;Lauantai;1;0;1
94;19.08.2017;2017;08;04;Lauantai;0;0;0
94;19.08.2017;2017;08;05;Lauantai;0;0;0
94;19.08.2017;2017;08;06;Lauantai;1;0;1
94;19.08.2017;2017;08;07;Lauantai;2;1;3
94;19.08.2017;2017;08;08;Lauantai;2;1;3
94;19.08.2017;2017;08;09;Lauantai;1;6;7
94;19.08.2017;2017;08;10;Lauantai;6;2;8
94;19.08.2017;2017;08;11;Lauantai;1;6;7
94;19.08.2017;2017;08;12;Lauantai;4;18;22
94;19.08.2017;2017;08;13;Lauantai;7;7;14
94;19.08.2017;2017;08;14;Lauantai;11;9;20
94;19.08.2017;2017;08;15;Lauantai;15;9;24
94;19.08.2017;2017;08;16;Lauantai;5;4;9
94;19.08.2017;2017;08;17;Lauantai;10;2;12
94;19.08.2017;2017;08;18;Lauantai;7;11;18
94;19.08.2017;2017;08;19;Lauantai;3;10;13
94;19.08.2017;2017;08;20;Lauantai;3;4;7
94;19.08.2017;2017;08;21;Lauantai;3;1;4
94;19.08.2017;2017;08;22;Lauantai;2;0;2
94;19.08.2017;2017;08;23;Lauantai;3;1;4
94;20.08.2017;2017;08;00;Sunnuntai;0;0;0
94;20.08.2017;2017;08;01;Sunnuntai;2;1;3
94;20.08.2017;2017;08;02;Sunnuntai;0;0;0
94;20.08.2017;2017;08;03;Sunnuntai;0;1;1
94;20.08.2017;2017;08;04;Sunnuntai;0;1;1
94;20.08.2017;2017;08;05;Sunnuntai;0;0;0
94;20.08.2017;2017;08;06;Sunnuntai;2;1;3
94;20.08.2017;2017;08;07;Sunnuntai;1;1;2
94;20.08.2017;2017;08;08;Sunnuntai;1;2;3
94;20.08.2017;2017;08;09;Sunnuntai;1;2;3
94;20.08.2017;2017;08;10;Sunnuntai;7;9;16
94;20.08.2017;2017;08;11;Sunnuntai;4;6;10
94;20.08.2017;2017;08;12;Sunnuntai;7;5;12
94;20.08.2017;2017;08;13;Sunnuntai;5;5;10
94;20.08.2017;2017;08;14;Sunnuntai;16;1;17
94;20.08.2017;2017;08;15;Sunnuntai;6;7;13
94;20.08.2017;2017;08;16;Sunnuntai;10;4;14
94;20.08.2017;2017;08;17;Sunnuntai;3;5;8
94;20.08.2017;2017;08;18;Sunnuntai;4;5;9
94;20.08.2017;2017;08;19;Sunnuntai;5;9;14
94;20.08.2017;2017;08;20;Sunnuntai;7;4;11
94;20.08.2017;2017;08;21;Sunnuntai;6;8;14
94;20.08.2017;2017;08;22;Sunnuntai;0;3;3
94;20.08.2017;2017;08;23;Sunnuntai;0;0;0
94;21.08.2017;2017;08;00;Maanantai;0;0;0
94;21.08.2017;2017;08;01;Maanantai;1;1;2
94;21.08.2017;2017;08;02;Maanantai;0;0;0
94;21.08.2017;2017;08;03;Maanantai;0;0;0
94;21.08.2017;2017;08;04;Maanantai;3;2;5
94;21.08.2017;2017;08;05;Maanantai;3;2;5
94;21.08.2017;2017;08;06;Maanantai;23;1;24
94;21.08.2017;2017;08;07;Maanantai;22;3;25
94;21.08.2017;2017;08;08;Maanantai;13;4;17
94;21.08.2017;2017;08;09;Maanantai;8;0;8
94;21.08.2017;2017;08;10;Maanantai;2;4;6
94;21.08.2017;2017;08;11;Maanantai;3;2;5
94;21.08.2017;2017;08;12;Maanantai;0;2;2
94;21.08.2017;2017;08;13;Maanantai;3;7;10
94;21.08.2017;2017;08;14;Maanantai;4;4;8
94;21.08.2017;2017;08;15;Maanantai;5;27;32
94;21.08.2017;2017;08;16;Maanantai;7;31;38
94;21.08.2017;2017;08;17;Maanantai;5;19;24
94;21.08.2017;2017;08;18;Maanantai;8;8;16
94;21.08.2017;2017;08;19;Maanantai;3;6;9
94;21.08.2017;2017;08;20;Maanantai;3;5;8
94;21.08.2017;2017;08;21;Maanantai;4;4;8
94;21.08.2017;2017;08;22;Maanantai;0;0;0
94;21.08.2017;2017;08;23;Maanantai;0;2;2
94;22.08.2017;2017;08;00;Tiistai;0;0;0
94;22.08.2017;2017;08;01;Tiistai;0;0;0
94;22.08.2017;2017;08;02;Tiistai;0;0;0
94;22.08.2017;2017;08;03;Tiistai;0;0;0
94;22.08.2017;2017;08;04;Tiistai;1;0;1
94;22.08.2017;2017;08;05;Tiistai;5;2;7
94;22.08.2017;2017;08;06;Tiistai;15;1;16
94;22.08.2017;2017;08;07;Tiistai;23;6;29
94;22.08.2017;2017;08;08;Tiistai;13;6;19
94;22.08.2017;2017;08;09;Tiistai;7;2;9
94;22.08.2017;2017;08;10;Tiistai;4;4;8
94;22.08.2017;2017;08;11;Tiistai;1;3;4
94;22.08.2017;2017;08;12;Tiistai;1;2;3
94;22.08.2017;2017;08;13;Tiistai;5;2;7
94;22.08.2017;2017;08;14;Tiistai;7;4;11
94;22.08.2017;2017;08;15;Tiistai;4;14;18
94;22.08.2017;2017;08;16;Tiistai;4;25;29
94;22.08.2017;2017;08;17;Tiistai;2;10;12
94;22.08.2017;2017;08;18;Tiistai;3;9;12
94;22.08.2017;2017;08;19;Tiistai;2;11;13
94;22.08.2017;2017;08;20;Tiistai;4;3;7
94;22.08.2017;2017;08;21;Tiistai;3;1;4
94;22.08.2017;2017;08;22;Tiistai;0;2;2
94;22.08.2017;2017;08;23;Tiistai;1;1;2
94;23.08.2017;2017;08;00;Keskiviikko;0;0;0
94;23.08.2017;2017;08;01;Keskiviikko;0;0;0
94;23.08.2017;2017;08;02;Keskiviikko;0;0;0
94;23.08.2017;2017;08;03;Keskiviikko;0;0;0
94;23.08.2017;2017;08;04;Keskiviikko;1;0;1
94;23.08.2017;2017;08;05;Keskiviikko;4;2;6
94;23.08.2017;2017;08;06;Keskiviikko;16;1;17
94;23.08.2017;2017;08;07;Keskiviikko;27;3;30
94;23.08.2017;2017;08;08;Keskiviikko;20;6;26
94;23.08.2017;2017;08;09;Keskiviikko;5;3;8
94;23.08.2017;2017;08;10;Keskiviikko;4;3;7
94;23.08.2017;2017;08;11;Keskiviikko;6;5;11
94;23.08.2017;2017;08;12;Keskiviikko;0;6;6
94;23.08.2017;2017;08;13;Keskiviikko;7;6;13
94;23.08.2017;2017;08;14;Keskiviikko;5;16;21
94;23.08.2017;2017;08;15;Keskiviikko;3;21;24
94;23.08.2017;2017;08;16;Keskiviikko;8;32;40
94;23.08.2017;2017;08;17;Keskiviikko;12;14;26
94;23.08.2017;2017;08;18;Keskiviikko;1;13;14
94;23.08.2017;2017;08;19;Keskiviikko;6;6;12
94;23.08.2017;2017;08;20;Keskiviikko;1;3;4
94;23.08.2017;2017;08;21;Keskiviikko;2;4;6
94;23.08.2017;2017;08;22;Keskiviikko;2;1;3
94;23.08.2017;2017;08;23;Keskiviikko;4;2;6
94;24.08.2017;2017;08;00;Torstai;0;0;0
94;24.08.2017;2017;08;01;Torstai;0;0;0
94;24.08.2017;2017;08;02;Torstai;0;0;0
94;24.08.2017;2017;08;03;Torstai;0;0;0
94;24.08.2017;2017;08;04;Torstai;1;0;1
94;24.08.2017;2017;08;05;Torstai;3;2;5
94;24.08.2017;2017;08;06;Torstai;13;1;14
94;24.08.2017;2017;08;07;Torstai;20;1;21
94;24.08.2017;2017;08;08;Torstai;14;4;18
94;24.08.2017;2017;08;09;Torstai;9;7;16
94;24.08.2017;2017;08;10;Torstai;4;4;8
94;24.08.2017;2017;08;11;Torstai;3;2;5
94;24.08.2017;2017;08;12;Torstai;3;3;6
94;24.08.2017;2017;08;13;Torstai;4;6;10
94;24.08.2017;2017;08;14;Torstai;6;13;19
94;24.08.2017;2017;08;15;Torstai;6;18;24
94;24.08.2017;2017;08;16;Torstai;3;20;23
94;24.08.2017;2017;08;17;Torstai;5;16;21
94;24.08.2017;2017;08;18;Torstai;3;13;16
94;24.08.2017;2017;08;19;Torstai;5;6;11
94;24.08.2017;2017;08;20;Torstai;3;7;10
94;24.08.2017;2017;08;21;Torstai;3;1;4
94;24.08.2017;2017;08;22;Torstai;2;1;3
94;24.08.2017;2017;08;23;Torstai;0;0;0
94;25.08.2017;2017;08;00;Perjantai;0;0;0
94;25.08.2017;2017;08;01;Perjantai;0;0;0
94;25.08.2017;2017;08;02;Perjantai;0;0;0
94;25.08.2017;2017;08;03;Perjantai;0;0;0
94;25.08.2017;2017;08;04;Perjantai;1;1;2
94;25.08.2017;2017;08;05;Perjantai;3;3;6
94;25.08.2017;2017;08;06;Perjantai;8;1;9
94;25.08.2017;2017;08;07;Perjantai;22;1;23
94;25.08.2017;2017;08;08;Perjantai;11;7;18
94;25.08.2017;2017;08;09;Perjantai;5;1;6
94;25.08.2017;2017;08;10;Perjantai;1;0;1
94;25.08.2017;2017;08;11;Perjantai;3;4;7
94;25.08.2017;2017;08;12;Perjantai;1;3;4
94;25.08.2017;2017;08;13;Perjantai;2;5;7
94;25.08.2017;2017;08;14;Perjantai;3;8;11
94;25.08.2017;2017;08;15;Perjantai;1;11;12
94;25.08.2017;2017;08;16;Perjantai;1;15;16
94;25.08.2017;2017;08;17;Perjantai;0;9;9
94;25.08.2017;2017;08;18;Perjantai;4;2;6
94;25.08.2017;2017;08;19;Perjantai;2;3;5
94;25.08.2017;2017;08;20;Perjantai;1;7;8
94;25.08.2017;2017;08;21;Perjantai;1;3;4
94;25.08.2017;2017;08;22;Perjantai;4;2;6
94;25.08.2017;2017;08;23;Perjantai;0;0;0
94;26.08.2017;2017;08;00;Lauantai;0;0;0
94;26.08.2017;2017;08;01;Lauantai;0;0;0
94;26.08.2017;2017;08;02;Lauantai;0;0;0
94;26.08.2017;2017;08;03;Lauantai;1;0;1
94;26.08.2017;2017;08;04;Lauantai;0;0;0
94;26.08.2017;2017;08;05;Lauantai;0;0;0
94;26.08.2017;2017;08;06;Lauantai;0;0;0
94;26.08.2017;2017;08;07;Lauantai;1;1;2
94;26.08.2017;2017;08;08;Lauantai;3;3;6
94;26.08.2017;2017;08;09;Lauantai;2;4;6
94;26.08.2017;2017;08;10;Lauantai;2;3;5
94;26.08.2017;2017;08;11;Lauantai;2;4;6
94;26.08.2017;2017;08;12;Lauantai;6;2;8
94;26.08.2017;2017;08;13;Lauantai;4;3;7
94;26.08.2017;2017;08;14;Lauantai;5;5;10
94;26.08.2017;2017;08;15;Lauantai;5;9;14
94;26.08.2017;2017;08;16;Lauantai;2;8;10
94;26.08.2017;2017;08;17;Lauantai;6;6;12
94;26.08.2017;2017;08;18;Lauantai;3;7;10
94;26.08.2017;2017;08;19;Lauantai;4;5;9
94;26.08.2017;2017;08;20;Lauantai;2;2;4
94;26.08.2017;2017;08;21;Lauantai;0;3;3
94;26.08.2017;2017;08;22;Lauantai;2;0;2
94;26.08.2017;2017;08;23;Lauantai;0;2;2
94;27.08.2017;2017;08;00;Sunnuntai;0;0;0
94;27.08.2017;2017;08;01;Sunnuntai;0;1;1
94;27.08.2017;2017;08;02;Sunnuntai;1;1;2
94;27.08.2017;2017;08;03;Sunnuntai;0;0;0
94;27.08.2017;2017;08;04;Sunnuntai;1;0;1
94;27.08.2017;2017;08;05;Sunnuntai;1;1;2
94;27.08.2017;2017;08;06;Sunnuntai;0;1;1
94;27.08.2017;2017;08;07;Sunnuntai;2;0;2
94;27.08.2017;2017;08;08;Sunnuntai;5;3;8
94;27.08.2017;2017;08;09;Sunnuntai;1;2;3
94;27.08.2017;2017;08;10;Sunnuntai;4;8;12
94;27.08.2017;2017;08;11;Sunnuntai;4;9;13
94;27.08.2017;2017;08;12;Sunnuntai;11;13;24
94;27.08.2017;2017;08;13;Sunnuntai;6;9;15
94;27.08.2017;2017;08;14;Sunnuntai;16;6;22
94;27.08.2017;2017;08;15;Sunnuntai;10;7;17
94;27.08.2017;2017;08;16;Sunnuntai;7;2;9
94;27.08.2017;2017;08;17;Sunnuntai;13;5;18
94;27.08.2017;2017;08;18;Sunnuntai;2;2;4
94;27.08.2017;2017;08;19;Sunnuntai;5;2;7
94;27.08.2017;2017;08;20;Sunnuntai;1;6;7
94;27.08.2017;2017;08;21;Sunnuntai;0;1;1
94;27.08.2017;2017;08;22;Sunnuntai;1;0;1
94;27.08.2017;2017;08;23;Sunnuntai;0;2;2
94;28.08.2017;2017;08;00;Maanantai;0;0;0
94;28.08.2017;2017;08;01;Maanantai;0;0;0
94;28.08.2017;2017;08;02;Maanantai;0;0;0
94;28.08.2017;2017;08;03;Maanantai;0;0;0
94;28.08.2017;2017;08;04;Maanantai;1;0;1
94;28.08.2017;2017;08;05;Maanantai;4;1;5
94;28.08.2017;2017;08;06;Maanantai;16;0;16
94;28.08.2017;2017;08;07;Maanantai;25;4;29
94;28.08.2017;2017;08;08;Maanantai;14;2;16
94;28.08.2017;2017;08;09;Maanantai;7;2;9
94;28.08.2017;2017;08;10;Maanantai;4;6;10
94;28.08.2017;2017;08;11;Maanantai;4;2;6
94;28.08.2017;2017;08;12;Maanantai;0;3;3
94;28.08.2017;2017;08;13;Maanantai;4;7;11
94;28.08.2017;2017;08;14;Maanantai;5;19;24
94;28.08.2017;2017;08;15;Maanantai;10;20;30
94;28.08.2017;2017;08;16;Maanantai;8;21;29
94;28.08.2017;2017;08;17;Maanantai;6;14;20
94;28.08.2017;2017;08;18;Maanantai;8;19;27
94;28.08.2017;2017;08;19;Maanantai;4;6;10
94;28.08.2017;2017;08;20;Maanantai;3;6;9
94;28.08.2017;2017;08;21;Maanantai;3;3;6
94;28.08.2017;2017;08;22;Maanantai;3;2;5
94;28.08.2017;2017;08;23;Maanantai;1;0;1
94;29.08.2017;2017;08;00;Tiistai;0;0;0
94;29.08.2017;2017;08;01;Tiistai;0;0;0
94;29.08.2017;2017;08;02;Tiistai;0;0;0
94;29.08.2017;2017;08;03;Tiistai;0;0;0
94;29.08.2017;2017;08;04;Tiistai;1;0;1
94;29.08.2017;2017;08;05;Tiistai;5;2;7
94;29.08.2017;2017;08;06;Tiistai;11;1;12
94;29.08.2017;2017;08;07;Tiistai;24;2;26
94;29.08.2017;2017;08;08;Tiistai;17;6;23
94;29.08.2017;2017;08;09;Tiistai;4;2;6
94;29.08.2017;2017;08;10;Tiistai;4;7;11
94;29.08.2017;2017;08;11;Tiistai;1;5;6
94;29.08.2017;2017;08;12;Tiistai;1;2;3
94;29.08.2017;2017;08;13;Tiistai;3;4;7
94;29.08.2017;2017;08;14;Tiistai;6;11;17
94;29.08.2017;2017;08;15;Tiistai;6;18;24
94;29.08.2017;2017;08;16;Tiistai;1;17;18
94;29.08.2017;2017;08;17;Tiistai;1;11;12
94;29.08.2017;2017;08;18;Tiistai;3;3;6
94;29.08.2017;2017;08;19;Tiistai;0;4;4
94;29.08.2017;2017;08;20;Tiistai;1;5;6
94;29.08.2017;2017;08;21;Tiistai;0;3;3
94;29.08.2017;2017;08;22;Tiistai;1;1;2
94;29.08.2017;2017;08;23;Tiistai;0;2;2
94;30.08.2017;2017;08;00;Keskiviikko;0;0;0
94;30.08.2017;2017;08;01;Keskiviikko;0;0;0
94;30.08.2017;2017;08;02;Keskiviikko;0;0;0
94;30.08.2017;2017;08;03;Keskiviikko;0;0;0
94;30.08.2017;2017;08;04;Keskiviikko;1;0;1
94;30.08.2017;2017;08;05;Keskiviikko;2;2;4
94;30.08.2017;2017;08;06;Keskiviikko;5;1;6
94;30.08.2017;2017;08;07;Keskiviikko;10;1;11
94;30.08.2017;2017;08;08;Keskiviikko;8;2;10
94;30.08.2017;2017;08;09;Keskiviikko;4;0;4
94;30.08.2017;2017;08;10;Keskiviikko;0;0;0
94;30.08.2017;2017;08;11;Keskiviikko;1;1;2
94;30.08.2017;2017;08;12;Keskiviikko;1;0;1
94;30.08.2017;2017;08;13;Keskiviikko;4;4;8
94;30.08.2017;2017;08;14;Keskiviikko;2;7;9
94;30.08.2017;2017;08;15;Keskiviikko;5;16;21
94;30.08.2017;2017;08;16;Keskiviikko;4;22;26
94;30.08.2017;2017;08;17;Keskiviikko;7;3;10
94;30.08.2017;2017;08;18;Keskiviikko;3;11;14
94;30.08.2017;2017;08;19;Keskiviikko;9;7;16
94;30.08.2017;2017;08;20;Keskiviikko;3;4;7
94;30.08.2017;2017;08;21;Keskiviikko;5;7;12
94;30.08.2017;2017;08;22;Keskiviikko;1;3;4
94;30.08.2017;2017;08;23;Keskiviikko;0;1;1
94;31.08.2017;2017;08;00;Torstai;0;0;0
94;31.08.2017;2017;08;01;Torstai;0;0;0
94;31.08.2017;2017;08;02;Torstai;0;0;0
94;31.08.2017;2017;08;03;Torstai;0;0;0
94;31.08.2017;2017;08;04;Torstai;1;0;1
94;31.08.2017;2017;08;05;Torstai;5;2;7
94;31.08.2017;2017;08;06;Torstai;11;2;13
94;31.08.2017;2017;08;07;Torstai;34;5;39
94;31.08.2017;2017;08;08;Torstai;19;5;24
94;31.08.2017;2017;08;09;Torstai;4;2;6
94;31.08.2017;2017;08;10;Torstai;6;2;8
94;31.08.2017;2017;08;11;Torstai;4;4;8
94;31.08.2017;2017;08;12;Torstai;4;2;6
94;31.08.2017;2017;08;13;Torstai;7;9;16
94;31.08.2017;2017;08;14;Torstai;4;16;20
94;31.08.2017;2017;08;15;Torstai;7;22;29
94;31.08.2017;2017;08;16;Torstai;12;40;52
94;31.08.2017;2017;08;17;Torstai;12;21;33
94;31.08.2017;2017;08;18;Torstai;6;13;19
94;31.08.2017;2017;08;19;Torstai;9;12;21
94;31.08.2017;2017;08;20;Torstai;6;10;16
94;31.08.2017;2017;08;21;Torstai;1;3;4
94;31.08.2017;2017;08;22;Torstai;3;1;4
94;31.08.2017;2017;08;23;Torstai;0;1;1
94;01.09.2017;2017;09;00;Perjantai;1;0;1
94;01.09.2017;2017;09;01;Perjantai;0;0;0
94;01.09.2017;2017;09;02;Perjantai;0;1;1
94;01.09.2017;2017;09;03;Perjantai;0;0;0
94;01.09.2017;2017;09;04;Perjantai;1;0;1
94;01.09.2017;2017;09;05;Perjantai;2;2;4
94;01.09.2017;2017;09;06;Perjantai;3;0;3
94;01.09.2017;2017;09;07;Perjantai;10;1;11
94;01.09.2017;2017;09;08;Perjantai;1;2;3
94;01.09.2017;2017;09;09;Perjantai;0;1;1
94;01.09.2017;2017;09;10;Perjantai;1;0;1
94;01.09.2017;2017;09;11;Perjantai;0;0;0
94;01.09.2017;2017;09;12;Perjantai;1;1;2
94;01.09.2017;2017;09;13;Perjantai;1;3;4
94;01.09.2017;2017;09;14;Perjantai;1;3;4
94;01.09.2017;2017;09;15;Perjantai;0;8;8
94;01.09.2017;2017;09;16;Perjantai;0;2;2
94;01.09.2017;2017;09;17;Perjantai;2;10;12
94;01.09.2017;2017;09;18;Perjantai;5;1;6
94;01.09.2017;2017;09;19;Perjantai;1;5;6
94;01.09.2017;2017;09;20;Perjantai;1;4;5
94;01.09.2017;2017;09;21;Perjantai;0;2;2
94;01.09.2017;2017;09;22;Perjantai;2;1;3
94;01.09.2017;2017;09;23;Perjantai;1;1;2
94;02.09.2017;2017;09;00;Lauantai;0;1;1
94;02.09.2017;2017;09;01;Lauantai;0;1;1
94;02.09.2017;2017;09;02;Lauantai;0;0;0
94;02.09.2017;2017;09;03;Lauantai;0;0;0
94;02.09.2017;2017;09;04;Lauantai;0;0;0
94;02.09.2017;2017;09;05;Lauantai;1;0;1
94;02.09.2017;2017;09;06;Lauantai;3;0;3
94;02.09.2017;2017;09;07;Lauantai;2;1;3
94;02.09.2017;2017;09;08;Lauantai;3;3;6
94;02.09.2017;2017;09;09;Lauantai;6;7;13
94;02.09.2017;2017;09;10;Lauantai;5;3;8
94;02.09.2017;2017;09;11;Lauantai;4;8;12
94;02.09.2017;2017;09;12;Lauantai;5;3;8
94;02.09.2017;2017;09;13;Lauantai;7;11;18
94;02.09.2017;2017;09;14;Lauantai;11;10;21
94;02.09.2017;2017;09;15;Lauantai;6;10;16
94;02.09.2017;2017;09;16;Lauantai;11;3;14
94;02.09.2017;2017;09;17;Lauantai;8;3;11
94;02.09.2017;2017;09;18;Lauantai;4;5;9
94;02.09.2017;2017;09;19;Lauantai;5;3;8
94;02.09.2017;2017;09;20;Lauantai;3;4;7
94;02.09.2017;2017;09;21;Lauantai;1;2;3
94;02.09.2017;2017;09;22;Lauantai;3;3;6
94;02.09.2017;2017;09;23;Lauantai;0;0;0
94;03.09.2017;2017;09;00;Sunnuntai;0;0;0
94;03.09.2017;2017;09;01;Sunnuntai;0;0;0
94;03.09.2017;2017;09;02;Sunnuntai;0;0;0
94;03.09.2017;2017;09;03;Sunnuntai;0;0;0
94;03.09.2017;2017;09;04;Sunnuntai;0;0;0
94;03.09.2017;2017;09;05;Sunnuntai;0;0;0
94;03.09.2017;2017;09;06;Sunnuntai;0;0;0
94;03.09.2017;2017;09;07;Sunnuntai;0;2;2
94;03.09.2017;2017;09;08;Sunnuntai;1;0;1
94;03.09.2017;2017;09;09;Sunnuntai;4;2;6
94;03.09.2017;2017;09;10;Sunnuntai;2;4;6
94;03.09.2017;2017;09;11;Sunnuntai;7;6;13
94;03.09.2017;2017;09;12;Sunnuntai;6;18;24
94;03.09.2017;2017;09;13;Sunnuntai;7;15;22
94;03.09.2017;2017;09;14;Sunnuntai;13;7;20
94;03.09.2017;2017;09;15;Sunnuntai;7;17;24
94;03.09.2017;2017;09;16;Sunnuntai;14;7;21
94;03.09.2017;2017;09;17;Sunnuntai;15;5;20
94;03.09.2017;2017;09;18;Sunnuntai;18;14;32
94;03.09.2017;2017;09;19;Sunnuntai;8;7;15
94;03.09.2017;2017;09;20;Sunnuntai;3;6;9
94;03.09.2017;2017;09;21;Sunnuntai;3;2;5
94;03.09.2017;2017;09;22;Sunnuntai;2;0;2
94;03.09.2017;2017;09;23;Sunnuntai;0;1;1
94;04.09.2017;2017;09;00;Maanantai;0;0;0
94;04.09.2017;2017;09;01;Maanantai;0;0;0
94;04.09.2017;2017;09;02;Maanantai;0;0;0
94;04.09.2017;2017;09;03;Maanantai;0;0;0
94;04.09.2017;2017;09;04;Maanantai;1;0;1
94;04.09.2017;2017;09;05;Maanantai;2;1;3
94;04.09.2017;2017;09;06;Maanantai;22;0;22
94;04.09.2017;2017;09;07;Maanantai;35;4;39
94;04.09.2017;2017;09;08;Maanantai;13;3;16
94;04.09.2017;2017;09;09;Maanantai;3;0;3
94;04.09.2017;2017;09;10;Maanantai;7;4;11
94;04.09.2017;2017;09;11;Maanantai;5;5;10
94;04.09.2017;2017;09;12;Maanantai;0;2;2
94;04.09.2017;2017;09;13;Maanantai;6;6;12
94;04.09.2017;2017;09;14;Maanantai;6;7;13
94;04.09.2017;2017;09;15;Maanantai;6;26;32
94;04.09.2017;2017;09;16;Maanantai;4;31;35
94;04.09.2017;2017;09;17;Maanantai;7;20;27
94;04.09.2017;2017;09;18;Maanantai;8;14;22
94;04.09.2017;2017;09;19;Maanantai;5;4;9
94;04.09.2017;2017;09;20;Maanantai;3;8;11
94;04.09.2017;2017;09;21;Maanantai;5;5;10
94;04.09.2017;2017;09;22;Maanantai;0;3;3
94;04.09.2017;2017;09;23;Maanantai;2;3;5
94;05.09.2017;2017;09;00;Tiistai;0;1;1
94;05.09.2017;2017;09;01;Tiistai;0;2;2
94;05.09.2017;2017;09;02;Tiistai;0;0;0
94;05.09.2017;2017;09;03;Tiistai;0;0;0
94;05.09.2017;2017;09;04;Tiistai;1;0;1
94;05.09.2017;2017;09;05;Tiistai;5;3;8
94;05.09.2017;2017;09;06;Tiistai;15;1;16
94;05.09.2017;2017;09;07;Tiistai;31;2;33
94;05.09.2017;2017;09;08;Tiistai;14;6;20
94;05.09.2017;2017;09;09;Tiistai;8;3;11
94;05.09.2017;2017;09;10;Tiistai;6;5;11
94;05.09.2017;2017;09;11;Tiistai;8;6;14
94;05.09.2017;2017;09;12;Tiistai;6;0;6
94;05.09.2017;2017;09;13;Tiistai;5;12;17
94;05.09.2017;2017;09;14;Tiistai;4;10;14
94;05.09.2017;2017;09;15;Tiistai;6;19;25
94;05.09.2017;2017;09;16;Tiistai;8;34;42
94;05.09.2017;2017;09;17;Tiistai;5;18;23
94;05.09.2017;2017;09;18;Tiistai;5;8;13
94;05.09.2017;2017;09;19;Tiistai;12;10;22
94;05.09.2017;2017;09;20;Tiistai;5;3;8
94;05.09.2017;2017;09;21;Tiistai;2;2;4
94;05.09.2017;2017;09;22;Tiistai;1;2;3
94;05.09.2017;2017;09;23;Tiistai;0;3;3
94;06.09.2017;2017;09;00;Keskiviikko;0;0;0
94;06.09.2017;2017;09;01;Keskiviikko;0;0;0
94;06.09.2017;2017;09;02;Keskiviikko;0;1;1
94;06.09.2017;2017;09;03;Keskiviikko;0;0;0
94;06.09.2017;2017;09;04;Keskiviikko;1;0;1
94;06.09.2017;2017;09;05;Keskiviikko;5;3;8
94;06.09.2017;2017;09;06;Keskiviikko;15;1;16
94;06.09.2017;2017;09;07;Keskiviikko;22;2;24
94;06.09.2017;2017;09;08;Keskiviikko;16;5;21
94;06.09.2017;2017;09;09;Keskiviikko;5;1;6
94;06.09.2017;2017;09;10;Keskiviikko;8;0;8
94;06.09.2017;2017;09;11;Keskiviikko;3;8;11
94;06.09.2017;2017;09;12;Keskiviikko;6;2;8
94;06.09.2017;2017;09;13;Keskiviikko;7;3;10
94;06.09.2017;2017;09;14;Keskiviikko;4;14;18
94;06.09.2017;2017;09;15;Keskiviikko;5;23;28
94;06.09.2017;2017;09;16;Keskiviikko;7;25;32
94;06.09.2017;2017;09;17;Keskiviikko;1;20;21
94;06.09.2017;2017;09;18;Keskiviikko;9;13;22
94;06.09.2017;2017;09;19;Keskiviikko;7;9;16
94;06.09.2017;2017;09;20;Keskiviikko;6;4;10
94;06.09.2017;2017;09;21;Keskiviikko;1;3;4
94;06.09.2017;2017;09;22;Keskiviikko;0;4;4
94;06.09.2017;2017;09;23;Keskiviikko;0;0;0
94;07.09.2017;2017;09;00;Torstai;0;0;0
94;07.09.2017;2017;09;01;Torstai;0;0;0
94;07.09.2017;2017;09;02;Torstai;0;1;1
94;07.09.2017;2017;09;03;Torstai;0;0;0
94;07.09.2017;2017;09;04;Torstai;1;0;1
94;07.09.2017;2017;09;05;Torstai;4;2;6
94;07.09.2017;2017;09;06;Torstai;13;3;16
94;07.09.2017;2017;09;07;Torstai;25;2;27
94;07.09.2017;2017;09;08;Torstai;12;3;15
94;07.09.2017;2017;09;09;Torstai;4;1;5
94;07.09.2017;2017;09;10;Torstai;10;5;15
94;07.09.2017;2017;09;11;Torstai;4;5;9
94;07.09.2017;2017;09;12;Torstai;1;2;3
94;07.09.2017;2017;09;13;Torstai;3;5;8
94;07.09.2017;2017;09;14;Torstai;3;8;11
94;07.09.2017;2017;09;15;Torstai;4;14;18
94;07.09.2017;2017;09;16;Torstai;6;23;29
94;07.09.2017;2017;09;17;Torstai;12;12;24
94;07.09.2017;2017;09;18;Torstai;4;6;10
94;07.09.2017;2017;09;19;Torstai;1;10;11
94;07.09.2017;2017;09;20;Torstai;0;2;2
94;07.09.2017;2017;09;21;Torstai;0;5;5
94;07.09.2017;2017;09;22;Torstai;2;2;4
94;07.09.2017;2017;09;23;Torstai;3;3;6
94;08.09.2017;2017;09;00;Perjantai;0;0;0
94;08.09.2017;2017;09;01;Perjantai;0;0;0
94;08.09.2017;2017;09;02;Perjantai;0;1;1
94;08.09.2017;2017;09;03;Perjantai;0;0;0
94;08.09.2017;2017;09;04;Perjantai;1;0;1
94;08.09.2017;2017;09;05;Perjantai;5;1;6
94;08.09.2017;2017;09;06;Perjantai;6;0;6
94;08.09.2017;2017;09;07;Perjantai;14;0;14
94;08.09.2017;2017;09;08;Perjantai;2;1;3
94;08.09.2017;2017;09;09;Perjantai;4;1;5
94;08.09.2017;2017;09;10;Perjantai;0;0;0
94;08.09.2017;2017;09;11;Perjantai;2;0;2
94;08.09.2017;2017;09;12;Perjantai;0;4;4
94;08.09.2017;2017;09;13;Perjantai;2;7;9
94;08.09.2017;2017;09;14;Perjantai;4;8;12
94;08.09.2017;2017;09;15;Perjantai;2;7;9
94;08.09.2017;2017;09;16;Perjantai;4;8;12
94;08.09.2017;2017;09;17;Perjantai;4;7;11
94;08.09.2017;2017;09;18;Perjantai;0;1;1
94;08.09.2017;2017;09;19;Perjantai;5;2;7
94;08.09.2017;2017;09;20;Perjantai;1;6;7
94;08.09.2017;2017;09;21;Perjantai;1;1;2
94;08.09.2017;2017;09;22;Perjantai;2;1;3
94;08.09.2017;2017;09;23;Perjantai;0;0;0
94;09.09.2017;2017;09;00;Lauantai;0;0;0
94;09.09.2017;2017;09;01;Lauantai;0;0;0
94;09.09.2017;2017;09;02;Lauantai;0;0;0
94;09.09.2017;2017;09;03;Lauantai;0;0;0
94;09.09.2017;2017;09;04;Lauantai;0;0;0
94;09.09.2017;2017;09;05;Lauantai;1;0;1
94;09.09.2017;2017;09;06;Lauantai;1;1;2
94;09.09.2017;2017;09;07;Lauantai;1;0;1
94;09.09.2017;2017;09;08;Lauantai;0;0;0
94;09.09.2017;2017;09;09;Lauantai;0;0;0
94;09.09.2017;2017;09;10;Lauantai;1;1;2
94;09.09.2017;2017;09;11;Lauantai;0;3;3
94;09.09.2017;2017;09;12;Lauantai;3;4;7
94;09.09.2017;2017;09;13;Lauantai;7;7;14
94;09.09.2017;2017;09;14;Lauantai;12;4;16
94;09.09.2017;2017;09;15;Lauantai;3;7;10
94;09.09.2017;2017;09;16;Lauantai;11;7;18
94;09.09.2017;2017;09;17;Lauantai;6;8;14
94;09.09.2017;2017;09;18;Lauantai;5;5;10
94;09.09.2017;2017;09;19;Lauantai;4;2;6
94;09.09.2017;2017;09;20;Lauantai;1;7;8
94;09.09.2017;2017;09;21;Lauantai;1;2;3
94;09.09.2017;2017;09;22;Lauantai;0;0;0
94;09.09.2017;2017;09;23;Lauantai;1;0;1
94;10.09.2017;2017;09;00;Sunnuntai;0;0;0
94;10.09.2017;2017;09;01;Sunnuntai;1;1;2
94;10.09.2017;2017;09;02;Sunnuntai;0;0;0
94;10.09.2017;2017;09;03;Sunnuntai;0;0;0
94;10.09.2017;2017;09;04;Sunnuntai;0;0;0
94;10.09.2017;2017;09;05;Sunnuntai;1;0;1
94;10.09.2017;2017;09;06;Sunnuntai;2;0;2
94;10.09.2017;2017;09;07;Sunnuntai;1;1;2
94;10.09.2017;2017;09;08;Sunnuntai;0;1;1
94;10.09.2017;2017;09;09;Sunnuntai;1;0;1
94;10.09.2017;2017;09;10;Sunnuntai;0;0;0
94;10.09.2017;2017;09;11;Sunnuntai;2;1;3
94;10.09.2017;2017;09;12;Sunnuntai;1;4;5
94;10.09.2017;2017;09;13;Sunnuntai;3;1;4
94;10.09.2017;2017;09;14;Sunnuntai;0;1;1
94;10.09.2017;2017;09;15;Sunnuntai;2;0;2
94;10.09.2017;2017;09;16;Sunnuntai;0;5;5
94;10.09.2017;2017;09;17;Sunnuntai;1;0;1
94;10.09.2017;2017;09;18;Sunnuntai;1;3;4
94;10.09.2017;2017;09;19;Sunnuntai;5;2;7
94;10.09.2017;2017;09;20;Sunnuntai;1;1;2
94;10.09.2017;2017;09;21;Sunnuntai;2;3;5
94;10.09.2017;2017;09;22;Sunnuntai;0;0;0
94;10.09.2017;2017;09;23;Sunnuntai;0;0;0
94;11.09.2017;2017;09;00;Maanantai;0;0;0
94;11.09.2017;2017;09;01;Maanantai;0;0;0
94;11.09.2017;2017;09;02;Maanantai;0;0;0
94;11.09.2017;2017;09;03;Maanantai;0;0;0
94;11.09.2017;2017;09;04;Maanantai;1;0;1
94;11.09.2017;2017;09;05;Maanantai;3;1;4
94;11.09.2017;2017;09;06;Maanantai;13;1;14
94;11.09.2017;2017;09;07;Maanantai;27;1;28
94;11.09.2017;2017;09;08;Maanantai;9;4;13
94;11.09.2017;2017;09;09;Maanantai;2;2;4
94;11.09.2017;2017;09;10;Maanantai;6;1;7
94;11.09.2017;2017;09;11;Maanantai;2;3;5
94;11.09.2017;2017;09;12;Maanantai;5;3;8
94;11.09.2017;2017;09;13;Maanantai;7;6;13
94;11.09.2017;2017;09;14;Maanantai;3;13;16
94;11.09.2017;2017;09;15;Maanantai;7;19;26
94;11.09.2017;2017;09;16;Maanantai;6;16;22
94;11.09.2017;2017;09;17;Maanantai;8;16;24
94;11.09.2017;2017;09;18;Maanantai;4;11;15
94;11.09.2017;2017;09;19;Maanantai;10;10;20
94;11.09.2017;2017;09;20;Maanantai;7;3;10
94;11.09.2017;2017;09;21;Maanantai;3;5;8
94;11.09.2017;2017;09;22;Maanantai;0;7;7
94;11.09.2017;2017;09;23;Maanantai;0;0;0
94;12.09.2017;2017;09;00;Tiistai;0;0;0
94;12.09.2017;2017;09;01;Tiistai;0;0;0
94;12.09.2017;2017;09;02;Tiistai;0;0;0
94;12.09.2017;2017;09;03;Tiistai;0;0;0
94;12.09.2017;2017;09;04;Tiistai;1;0;1
94;12.09.2017;2017;09;05;Tiistai;2;2;4
94;12.09.2017;2017;09;06;Tiistai;15;1;16
94;12.09.2017;2017;09;07;Tiistai;28;1;29
94;12.09.2017;2017;09;08;Tiistai;9;2;11
94;12.09.2017;2017;09;09;Tiistai;6;1;7
94;12.09.2017;2017;09;10;Tiistai;8;1;9
94;12.09.2017;2017;09;11;Tiistai;1;6;7
94;12.09.2017;2017;09;12;Tiistai;2;2;4
94;12.09.2017;2017;09;13;Tiistai;1;5;6
94;12.09.2017;2017;09;14;Tiistai;6;8;14
94;12.09.2017;2017;09;15;Tiistai;2;21;23
94;12.09.2017;2017;09;16;Tiistai;0;15;15
94;12.09.2017;2017;09;17;Tiistai;0;6;6
94;12.09.2017;2017;09;18;Tiistai;0;6;6
94;12.09.2017;2017;09;19;Tiistai;2;5;7
94;12.09.2017;2017;09;20;Tiistai;2;1;3
94;12.09.2017;2017;09;21;Tiistai;0;2;2
94;12.09.2017;2017;09;22;Tiistai;0;0;0
94;12.09.2017;2017;09;23;Tiistai;0;0;0
94;13.09.2017;2017;09;00;Keskiviikko;0;0;0
94;13.09.2017;2017;09;01;Keskiviikko;0;0;0
94;13.09.2017;2017;09;02;Keskiviikko;0;0;0
94;13.09.2017;2017;09;03;Keskiviikko;1;0;1
94;13.09.2017;2017;09;04;Keskiviikko;1;0;1
94;13.09.2017;2017;09;05;Keskiviikko;4;2;6
94;13.09.2017;2017;09;06;Keskiviikko;8;1;9
94;13.09.2017;2017;09;07;Keskiviikko;19;0;19
94;13.09.2017;2017;09;08;Keskiviikko;13;0;13
94;13.09.2017;2017;09;09;Keskiviikko;3;2;5
94;13.09.2017;2017;09;10;Keskiviikko;5;2;7
94;13.09.2017;2017;09;11;Keskiviikko;5;3;8
94;13.09.2017;2017;09;12;Keskiviikko;1;4;5
94;13.09.2017;2017;09;13;Keskiviikko;4;6;10
94;13.09.2017;2017;09;14;Keskiviikko;4;4;8
94;13.09.2017;2017;09;15;Keskiviikko;2;13;15
94;13.09.2017;2017;09;16;Keskiviikko;3;19;22
94;13.09.2017;2017;09;17;Keskiviikko;2;6;8
94;13.09.2017;2017;09;18;Keskiviikko;1;9;10
94;13.09.2017;2017;09;19;Keskiviikko;4;6;10
94;13.09.2017;2017;09;20;Keskiviikko;1;6;7
94;13.09.2017;2017;09;21;Keskiviikko;2;3;5
94;13.09.2017;2017;09;22;Keskiviikko;0;1;1
94;13.09.2017;2017;09;23;Keskiviikko;0;0;0
94;14.09.2017;2017;09;00;Torstai;0;0;0
94;14.09.2017;2017;09;01;Torstai;0;1;1
94;14.09.2017;2017;09;02;Torstai;0;0;0
94;14.09.2017;2017;09;03;Torstai;0;0;0
94;14.09.2017;2017;09;04;Torstai;1;0;1
94;14.09.2017;2017;09;05;Torstai;2;1;3
94;14.09.2017;2017;09;06;Torstai;15;0;15
94;14.09.2017;2017;09;07;Torstai;22;1;23
94;14.09.2017;2017;09;08;Torstai;9;5;14
94;14.09.2017;2017;09;09;Torstai;4;0;4
94;14.09.2017;2017;09;10;Torstai;1;3;4
94;14.09.2017;2017;09;11;Torstai;4;3;7
94;14.09.2017;2017;09;12;Torstai;3;5;8
94;14.09.2017;2017;09;13;Torstai;5;2;7
94;14.09.2017;2017;09;14;Torstai;7;12;19
94;14.09.2017;2017;09;15;Torstai;5;14;19
94;14.09.2017;2017;09;16;Torstai;3;23;26
94;14.09.2017;2017;09;17;Torstai;2;15;17
94;14.09.2017;2017;09;18;Torstai;11;3;14
94;14.09.2017;2017;09;19;Torstai;3;11;14
94;14.09.2017;2017;09;20;Torstai;4;7;11
94;14.09.2017;2017;09;21;Torstai;1;2;3
94;14.09.2017;2017;09;22;Torstai;2;0;2
94;14.09.2017;2017;09;23;Torstai;0;0;0
94;15.09.2017;2017;09;00;Perjantai;0;0;0
94;15.09.2017;2017;09;01;Perjantai;0;0;0
94;15.09.2017;2017;09;02;Perjantai;0;0;0
94;15.09.2017;2017;09;03;Perjantai;0;0;0
94;15.09.2017;2017;09;04;Perjantai;1;0;1
94;15.09.2017;2017;09;05;Perjantai;5;2;7
94;15.09.2017;2017;09;06;Perjantai;5;0;5
94;15.09.2017;2017;09;07;Perjantai;13;1;14
94;15.09.2017;2017;09;08;Perjantai;9;2;11
94;15.09.2017;2017;09;09;Perjantai;6;2;8
94;15.09.2017;2017;09;10;Perjantai;1;4;5
94;15.09.2017;2017;09;11;Perjantai;2;1;3
94;15.09.2017;2017;09;12;Perjantai;2;4;6
94;15.09.2017;2017;09;13;Perjantai;2;2;4
94;15.09.2017;2017;09;14;Perjantai;7;4;11
94;15.09.2017;2017;09;15;Perjantai;2;12;14
94;15.09.2017;2017;09;16;Perjantai;1;12;13
94;15.09.2017;2017;09;17;Perjantai;2;6;8
94;15.09.2017;2017;09;18;Perjantai;1;2;3
94;15.09.2017;2017;09;19;Perjantai;0;5;5
94;15.09.2017;2017;09;20;Perjantai;0;4;4
94;15.09.2017;2017;09;21;Perjantai;1;5;6
94;15.09.2017;2017;09;22;Perjantai;1;1;2
94;15.09.2017;2017;09;23;Perjantai;0;0;0
94;16.09.2017;2017;09;00;Lauantai;1;0;1
94;16.09.2017;2017;09;01;Lauantai;0;0;0
94;16.09.2017;2017;09;02;Lauantai;0;0;0
94;16.09.2017;2017;09;03;Lauantai;0;0;0
94;16.09.2017;2017;09;04;Lauantai;0;0;0
94;16.09.2017;2017;09;05;Lauantai;1;0;1
94;16.09.2017;2017;09;06;Lauantai;1;0;1
94;16.09.2017;2017;09;07;Lauantai;0;0;0
94;16.09.2017;2017;09;08;Lauantai;1;2;3
94;16.09.2017;2017;09;09;Lauantai;2;2;4
94;16.09.2017;2017;09;10;Lauantai;3;9;12
94;16.09.2017;2017;09;11;Lauantai;0;18;18
94;16.09.2017;2017;09;12;Lauantai;4;1;5
94;16.09.2017;2017;09;13;Lauantai;4;4;8
94;16.09.2017;2017;09;14;Lauantai;5;1;6
94;16.09.2017;2017;09;15;Lauantai;3;7;10
94;16.09.2017;2017;09;16;Lauantai;11;6;17
94;16.09.2017;2017;09;17;Lauantai;18;8;26
94;16.09.2017;2017;09;18;Lauantai;1;2;3
94;16.09.2017;2017;09;19;Lauantai;4;1;5
94;16.09.2017;2017;09;20;Lauantai;3;2;5
94;16.09.2017;2017;09;21;Lauantai;1;2;3
94;16.09.2017;2017;09;22;Lauantai;2;3;5
94;16.09.2017;2017;09;23;Lauantai;3;2;5
94;17.09.2017;2017;09;00;Sunnuntai;0;7;7
94;17.09.2017;2017;09;01;Sunnuntai;0;0;0
94;17.09.2017;2017;09;02;Sunnuntai;0;0;0
94;17.09.2017;2017;09;03;Sunnuntai;1;0;1
94;17.09.2017;2017;09;04;Sunnuntai;0;0;0
94;17.09.2017;2017;09;05;Sunnuntai;0;0;0
94;17.09.2017;2017;09;06;Sunnuntai;2;0;2
94;17.09.2017;2017;09;07;Sunnuntai;1;0;1
94;17.09.2017;2017;09;08;Sunnuntai;1;0;1
94;17.09.2017;2017;09;09;Sunnuntai;1;0;1
94;17.09.2017;2017;09;10;Sunnuntai;2;2;4
94;17.09.2017;2017;09;11;Sunnuntai;3;4;7
94;17.09.2017;2017;09;12;Sunnuntai;8;11;19
94;17.09.2017;2017;09;13;Sunnuntai;2;2;4
94;17.09.2017;2017;09;14;Sunnuntai;10;4;14
94;17.09.2017;2017;09;15;Sunnuntai;12;5;17
94;17.09.2017;2017;09;16;Sunnuntai;6;6;12
94;17.09.2017;2017;09;17;Sunnuntai;10;4;14
94;17.09.2017;2017;09;18;Sunnuntai;2;6;8
94;17.09.2017;2017;09;19;Sunnuntai;5;1;6
94;17.09.2017;2017;09;20;Sunnuntai;1;4;5
94;17.09.2017;2017;09;21;Sunnuntai;2;2;4
94;17.09.2017;2017;09;22;Sunnuntai;0;0;0
94;17.09.2017;2017;09;23;Sunnuntai;0;0;0
94;18.09.2017;2017;09;00;Maanantai;0;0;0
94;18.09.2017;2017;09;01;Maanantai;0;0;0
94;18.09.2017;2017;09;02;Maanantai;0;0;0
94;18.09.2017;2017;09;03;Maanantai;0;0;0
94;18.09.2017;2017;09;04;Maanantai;0;0;0
94;18.09.2017;2017;09;05;Maanantai;5;1;6
94;18.09.2017;2017;09;06;Maanantai;10;1;11
94;18.09.2017;2017;09;07;Maanantai;14;1;15
94;18.09.2017;2017;09;08;Maanantai;10;5;15
94;18.09.2017;2017;09;09;Maanantai;5;3;8
94;18.09.2017;2017;09;10;Maanantai;5;1;6
94;18.09.2017;2017;09;11;Maanantai;5;2;7
94;18.09.2017;2017;09;12;Maanantai;2;8;10
94;18.09.2017;2017;09;13;Maanantai;4;5;9
94;18.09.2017;2017;09;14;Maanantai;8;14;22
94;18.09.2017;2017;09;15;Maanantai;4;15;19
94;18.09.2017;2017;09;16;Maanantai;7;11;18
94;18.09.2017;2017;09;17;Maanantai;6;15;21
94;18.09.2017;2017;09;18;Maanantai;4;5;9
94;18.09.2017;2017;09;19;Maanantai;6;3;9
94;18.09.2017;2017;09;20;Maanantai;2;5;7
94;18.09.2017;2017;09;21;Maanantai;2;4;6
94;18.09.2017;2017;09;22;Maanantai;0;1;1
94;18.09.2017;2017;09;23;Maanantai;0;0;0
94;19.09.2017;2017;09;00;Tiistai;0;1;1
94;19.09.2017;2017;09;01;Tiistai;0;0;0
94;19.09.2017;2017;09;02;Tiistai;0;0;0
94;19.09.2017;2017;09;03;Tiistai;0;0;0
94;19.09.2017;2017;09;04;Tiistai;1;0;1
94;19.09.2017;2017;09;05;Tiistai;4;3;7
94;19.09.2017;2017;09;06;Tiistai;10;2;12
94;19.09.2017;2017;09;07;Tiistai;19;3;22
94;19.09.2017;2017;09;08;Tiistai;14;1;15
94;19.09.2017;2017;09;09;Tiistai;2;0;2
94;19.09.2017;2017;09;10;Tiistai;1;1;2
94;19.09.2017;2017;09;11;Tiistai;0;1;1
94;19.09.2017;2017;09;12;Tiistai;4;1;5
94;19.09.2017;2017;09;13;Tiistai;1;1;2
94;19.09.2017;2017;09;14;Tiistai;4;6;10
94;19.09.2017;2017;09;15;Tiistai;2;11;13
94;19.09.2017;2017;09;16;Tiistai;0;16;16
94;19.09.2017;2017;09;17;Tiistai;3;15;18
94;19.09.2017;2017;09;18;Tiistai;5;7;12
94;19.09.2017;2017;09;19;Tiistai;2;2;4
94;19.09.2017;2017;09;20;Tiistai;6;1;7
94;19.09.2017;2017;09;21;Tiistai;1;0;1
94;19.09.2017;2017;09;22;Tiistai;0;1;1
94;19.09.2017;2017;09;23;Tiistai;0;2;2
94;20.09.2017;2017;09;00;Keskiviikko;0;0;0
94;20.09.2017;2017;09;01;Keskiviikko;0;0;0
94;20.09.2017;2017;09;02;Keskiviikko;0;0;0
94;20.09.2017;2017;09;03;Keskiviikko;0;0;0
94;20.09.2017;2017;09;04;Keskiviikko;1;0;1
94;20.09.2017;2017;09;05;Keskiviikko;3;3;6
94;20.09.2017;2017;09;06;Keskiviikko;15;2;17
94;20.09.2017;2017;09;07;Keskiviikko;18;3;21
94;20.09.2017;2017;09;08;Keskiviikko;12;1;13
94;20.09.2017;2017;09;09;Keskiviikko;6;1;7
94;20.09.2017;2017;09;10;Keskiviikko;3;2;5
94;20.09.2017;2017;09;11;Keskiviikko;6;2;8
94;20.09.2017;2017;09;12;Keskiviikko;2;2;4
94;20.09.2017;2017;09;13;Keskiviikko;4;5;9
94;20.09.2017;2017;09;14;Keskiviikko;4;7;11
94;20.09.2017;2017;09;15;Keskiviikko;6;12;18
94;20.09.2017;2017;09;16;Keskiviikko;2;11;13
94;20.09.2017;2017;09;17;Keskiviikko;2;10;12
94;20.09.2017;2017;09;18;Keskiviikko;4;4;8
94;20.09.2017;2017;09;19;Keskiviikko;0;7;7
94;20.09.2017;2017;09;20;Keskiviikko;6;7;13
94;20.09.2017;2017;09;21;Keskiviikko;0;2;2
94;20.09.2017;2017;09;22;Keskiviikko;0;1;1
94;20.09.2017;2017;09;23;Keskiviikko;0;0;0
94;21.09.2017;2017;09;00;Torstai;0;0;0
94;21.09.2017;2017;09;01;Torstai;2;0;2
94;21.09.2017;2017;09;02;Torstai;0;0;0
94;21.09.2017;2017;09;03;Torstai;0;0;0
94;21.09.2017;2017;09;04;Torstai;1;0;1
94;21.09.2017;2017;09;05;Torstai;2;3;5
94;21.09.2017;2017;09;06;Torstai;15;0;15
94;21.09.2017;2017;09;07;Torstai;15;1;16
94;21.09.2017;2017;09;08;Torstai;11;0;11
94;21.09.2017;2017;09;09;Torstai;2;3;5
94;21.09.2017;2017;09;10;Torstai;5;3;8
94;21.09.2017;2017;09;11;Torstai;1;1;2
94;21.09.2017;2017;09;12;Torstai;3;5;8
94;21.09.2017;2017;09;13;Torstai;3;2;5
94;21.09.2017;2017;09;14;Torstai;9;7;16
94;21.09.2017;2017;09;15;Torstai;3;13;16
94;21.09.2017;2017;09;16;Torstai;2;21;23
94;21.09.2017;2017;09;17;Torstai;5;21;26
94;21.09.2017;2017;09;18;Torstai;9;2;11
94;21.09.2017;2017;09;19;Torstai;4;7;11
94;21.09.2017;2017;09;20;Torstai;3;5;8
94;21.09.2017;2017;09;21;Torstai;3;3;6
94;21.09.2017;2017;09;22;Torstai;1;2;3
94;21.09.2017;2017;09;23;Torstai;0;3;3
94;22.09.2017;2017;09;00;Perjantai;0;0;0
94;22.09.2017;2017;09;01;Perjantai;0;0;0
94;22.09.2017;2017;09;02;Perjantai;0;0;0
94;22.09.2017;2017;09;03;Perjantai;0;0;0
94;22.09.2017;2017;09;04;Perjantai;0;0;0
94;22.09.2017;2017;09;05;Perjantai;3;1;4
94;22.09.2017;2017;09;06;Perjantai;12;3;15
94;22.09.2017;2017;09;07;Perjantai;14;4;18
94;22.09.2017;2017;09;08;Perjantai;11;1;12
94;22.09.2017;2017;09;09;Perjantai;4;2;6
94;22.09.2017;2017;09;10;Perjantai;2;1;3
94;22.09.2017;2017;09;11;Perjantai;6;1;7
94;22.09.2017;2017;09;12;Perjantai;0;3;3
94;22.09.2017;2017;09;13;Perjantai;1;8;9
94;22.09.2017;2017;09;14;Perjantai;10;11;21
94;22.09.2017;2017;09;15;Perjantai;4;11;15
94;22.09.2017;2017;09;16;Perjantai;5;18;23
94;22.09.2017;2017;09;17;Perjantai;9;10;19
94;22.09.2017;2017;09;18;Perjantai;4;9;13
94;22.09.2017;2017;09;19;Perjantai;5;3;8
94;22.09.2017;2017;09;20;Perjantai;7;4;11
94;22.09.2017;2017;09;21;Perjantai;0;4;4
94;22.09.2017;2017;09;22;Perjantai;0;2;2
94;22.09.2017;2017;09;23;Perjantai;1;1;2
94;23.09.2017;2017;09;00;Lauantai;0;0;0
94;23.09.2017;2017;09;01;Lauantai;1;0;1
94;23.09.2017;2017;09;02;Lauantai;0;0;0
94;23.09.2017;2017;09;03;Lauantai;0;0;0
94;23.09.2017;2017;09;04;Lauantai;1;0;1
94;23.09.2017;2017;09;05;Lauantai;3;0;3
94;23.09.2017;2017;09;06;Lauantai;2;0;2
94;23.09.2017;2017;09;07;Lauantai;4;1;5
94;23.09.2017;2017;09;08;Lauantai;0;0;0
94;23.09.2017;2017;09;09;Lauantai;2;2;4
94;23.09.2017;2017;09;10;Lauantai;3;8;11
94;23.09.2017;2017;09;11;Lauantai;5;4;9
94;23.09.2017;2017;09;12;Lauantai;5;2;7
94;23.09.2017;2017;09;13;Lauantai;5;6;11
94;23.09.2017;2017;09;14;Lauantai;3;7;10
94;23.09.2017;2017;09;15;Lauantai;10;4;14
94;23.09.2017;2017;09;16;Lauantai;7;8;15
94;23.09.2017;2017;09;17;Lauantai;5;2;7
94;23.09.2017;2017;09;18;Lauantai;6;3;9
94;23.09.2017;2017;09;19;Lauantai;3;8;11
94;23.09.2017;2017;09;20;Lauantai;7;1;8
94;23.09.2017;2017;09;21;Lauantai;0;0;0
94;23.09.2017;2017;09;22;Lauantai;2;1;3
94;23.09.2017;2017;09;23;Lauantai;2;1;3
94;24.09.2017;2017;09;00;Sunnuntai;0;1;1
94;24.09.2017;2017;09;01;Sunnuntai;0;0;0
94;24.09.2017;2017;09;02;Sunnuntai;0;1;1
94;24.09.2017;2017;09;03;Sunnuntai;0;0;0
94;24.09.2017;2017;09;04;Sunnuntai;0;0;0
94;24.09.2017;2017;09;05;Sunnuntai;1;0;1
94;24.09.2017;2017;09;06;Sunnuntai;0;0;0
94;24.09.2017;2017;09;07;Sunnuntai;0;0;0
94;24.09.2017;2017;09;08;Sunnuntai;1;2;3
94;24.09.2017;2017;09;09;Sunnuntai;3;3;6
94;24.09.2017;2017;09;10;Sunnuntai;2;7;9
94;24.09.2017;2017;09;11;Sunnuntai;6;5;11
94;24.09.2017;2017;09;12;Sunnuntai;7;8;15
94;24.09.2017;2017;09;13;Sunnuntai;11;0;11
94;24.09.2017;2017;09;14;Sunnuntai;8;2;10
94;24.09.2017;2017;09;15;Sunnuntai;10;9;19
94;24.09.2017;2017;09;16;Sunnuntai;7;4;11
94;24.09.2017;2017;09;17;Sunnuntai;7;8;15
94;24.09.2017;2017;09;18;Sunnuntai;3;10;13
94;24.09.2017;2017;09;19;Sunnuntai;2;5;7
94;24.09.2017;2017;09;20;Sunnuntai;9;0;9
94;24.09.2017;2017;09;21;Sunnuntai;0;3;3
94;24.09.2017;2017;09;22;Sunnuntai;1;0;1
94;24.09.2017;2017;09;23;Sunnuntai;0;0;0
94;25.09.2017;2017;09;00;Maanantai;0;0;0
94;25.09.2017;2017;09;01;Maanantai;0;0;0
94;25.09.2017;2017;09;02;Maanantai;0;0;0
94;25.09.2017;2017;09;03;Maanantai;0;0;0
94;25.09.2017;2017;09;04;Maanantai;1;1;2
94;25.09.2017;2017;09;05;Maanantai;4;4;8
94;25.09.2017;2017;09;06;Maanantai;13;0;13
94;25.09.2017;2017;09;07;Maanantai;25;1;26
94;25.09.2017;2017;09;08;Maanantai;11;2;13
94;25.09.2017;2017;09;09;Maanantai;4;4;8
94;25.09.2017;2017;09;10;Maanantai;4;4;8
94;25.09.2017;2017;09;11;Maanantai;8;2;10
94;25.09.2017;2017;09;12;Maanantai;3;2;5
94;25.09.2017;2017;09;13;Maanantai;3;3;6
94;25.09.2017;2017;09;14;Maanantai;6;6;12
94;25.09.2017;2017;09;15;Maanantai;5;24;29
94;25.09.2017;2017;09;16;Maanantai;11;18;29
94;25.09.2017;2017;09;17;Maanantai;6;20;26
94;25.09.2017;2017;09;18;Maanantai;10;19;29
94;25.09.2017;2017;09;19;Maanantai;11;7;18
94;25.09.2017;2017;09;20;Maanantai;4;3;7
94;25.09.2017;2017;09;21;Maanantai;2;1;3
94;25.09.2017;2017;09;22;Maanantai;0;0;0
94;25.09.2017;2017;09;23;Maanantai;0;1;1
94;26.09.2017;2017;09;00;Tiistai;0;0;0
94;26.09.2017;2017;09;01;Tiistai;0;2;2
94;26.09.2017;2017;09;02;Tiistai;0;0;0
94;26.09.2017;2017;09;03;Tiistai;0;0;0
94;26.09.2017;2017;09;04;Tiistai;1;0;1
94;26.09.2017;2017;09;05;Tiistai;4;2;6
94;26.09.2017;2017;09;06;Tiistai;13;0;13
94;26.09.2017;2017;09;07;Tiistai;25;1;26
94;26.09.2017;2017;09;08;Tiistai;12;3;15
94;26.09.2017;2017;09;09;Tiistai;4;2;6
94;26.09.2017;2017;09;10;Tiistai;3;3;6
94;26.09.2017;2017;09;11;Tiistai;4;3;7
94;26.09.2017;2017;09;12;Tiistai;3;2;5
94;26.09.2017;2017;09;13;Tiistai;3;3;6
94;26.09.2017;2017;09;14;Tiistai;6;4;10
94;26.09.2017;2017;09;15;Tiistai;1;13;14
94;26.09.2017;2017;09;16;Tiistai;5;16;21
94;26.09.2017;2017;09;17;Tiistai;2;18;20
94;26.09.2017;2017;09;18;Tiistai;3;7;10
94;26.09.2017;2017;09;19;Tiistai;1;13;14
94;26.09.2017;2017;09;20;Tiistai;2;4;6
94;26.09.2017;2017;09;21;Tiistai;0;3;3
94;26.09.2017;2017;09;22;Tiistai;2;2;4
94;26.09.2017;2017;09;23;Tiistai;0;0;0
94;27.09.2017;2017;09;00;Keskiviikko;0;1;1
94;27.09.2017;2017;09;01;Keskiviikko;0;0;0
94;27.09.2017;2017;09;02;Keskiviikko;0;0;0
94;27.09.2017;2017;09;03;Keskiviikko;0;0;0
94;27.09.2017;2017;09;04;Keskiviikko;1;0;1
94;27.09.2017;2017;09;05;Keskiviikko;3;2;5
94;27.09.2017;2017;09;06;Keskiviikko;15;0;15
94;27.09.2017;2017;09;07;Keskiviikko;19;2;21
94;27.09.2017;2017;09;08;Keskiviikko;9;2;11
94;27.09.2017;2017;09;09;Keskiviikko;1;1;2
94;27.09.2017;2017;09;10;Keskiviikko;3;3;6
94;27.09.2017;2017;09;11;Keskiviikko;1;2;3
94;27.09.2017;2017;09;12;Keskiviikko;6;3;9
94;27.09.2017;2017;09;13;Keskiviikko;3;2;5
94;27.09.2017;2017;09;14;Keskiviikko;4;6;10
94;27.09.2017;2017;09;15;Keskiviikko;4;14;18
94;27.09.2017;2017;09;16;Keskiviikko;2;16;18
94;27.09.2017;2017;09;17;Keskiviikko;9;10;19
94;27.09.2017;2017;09;18;Keskiviikko;2;10;12
94;27.09.2017;2017;09;19;Keskiviikko;9;5;14
94;27.09.2017;2017;09;20;Keskiviikko;4;8;12
94;27.09.2017;2017;09;21;Keskiviikko;2;3;5
94;27.09.2017;2017;09;22;Keskiviikko;0;1;1
94;27.09.2017;2017;09;23;Keskiviikko;0;0;0
94;28.09.2017;2017;09;00;Torstai;0;0;0
94;28.09.2017;2017;09;01;Torstai;0;0;0
94;28.09.2017;2017;09;02;Torstai;0;0;0
94;28.09.2017;2017;09;03;Torstai;0;0;0
94;28.09.2017;2017;09;04;Torstai;0;0;0
94;28.09.2017;2017;09;05;Torstai;4;1;5
94;28.09.2017;2017;09;06;Torstai;12;1;13
94;28.09.2017;2017;09;07;Torstai;18;1;19
94;28.09.2017;2017;09;08;Torstai;11;1;12
94;28.09.2017;2017;09;09;Torstai;5;3;8
94;28.09.2017;2017;09;10;Torstai;6;0;6
94;28.09.2017;2017;09;11;Torstai;3;5;8
94;28.09.2017;2017;09;12;Torstai;0;4;4
94;28.09.2017;2017;09;13;Torstai;4;3;7
94;28.09.2017;2017;09;14;Torstai;5;7;12
94;28.09.2017;2017;09;15;Torstai;3;16;19
94;28.09.2017;2017;09;16;Torstai;8;18;26
94;28.09.2017;2017;09;17;Torstai;4;14;18
94;28.09.2017;2017;09;18;Torstai;2;10;12
94;28.09.2017;2017;09;19;Torstai;1;8;9
94;28.09.2017;2017;09;20;Torstai;6;3;9
94;28.09.2017;2017;09;21;Torstai;1;4;5
94;28.09.2017;2017;09;22;Torstai;3;1;4
94;28.09.2017;2017;09;23;Torstai;1;1;2
94;29.09.2017;2017;09;00;Perjantai;0;0;0
94;29.09.2017;2017;09;01;Perjantai;0;0;0
94;29.09.2017;2017;09;02;Perjantai;1;0;1
94;29.09.2017;2017;09;03;Perjantai;0;0;0
94;29.09.2017;2017;09;04;Perjantai;0;0;0
94;29.09.2017;2017;09;05;Perjantai;5;3;8
94;29.09.2017;2017;09;06;Perjantai;8;0;8
94;29.09.2017;2017;09;07;Perjantai;20;3;23
94;29.09.2017;2017;09;08;Perjantai;5;0;5
94;29.09.2017;2017;09;09;Perjantai;5;1;6
94;29.09.2017;2017;09;10;Perjantai;2;1;3
94;29.09.2017;2017;09;11;Perjantai;4;5;9
94;29.09.2017;2017;09;12;Perjantai;1;1;2
94;29.09.2017;2017;09;13;Perjantai;3;6;9
94;29.09.2017;2017;09;14;Perjantai;6;3;9
94;29.09.2017;2017;09;15;Perjantai;7;14;21
94;29.09.2017;2017;09;16;Perjantai;3;15;18
94;29.09.2017;2017;09;17;Perjantai;2;11;13
94;29.09.2017;2017;09;18;Perjantai;4;6;10
94;29.09.2017;2017;09;19;Perjantai;2;10;12
94;29.09.2017;2017;09;20;Perjantai;3;4;7
94;29.09.2017;2017;09;21;Perjantai;3;4;7
94;29.09.2017;2017;09;22;Perjantai;2;3;5
94;29.09.2017;2017;09;23;Perjantai;0;1;1
94;30.09.2017;2017;09;00;Lauantai;0;0;0
94;30.09.2017;2017;09;01;Lauantai;2;3;5
94;30.09.2017;2017;09;02;Lauantai;0;2;2
94;30.09.2017;2017;09;03;Lauantai;0;0;0
94;30.09.2017;2017;09;04;Lauantai;0;1;1
94;30.09.2017;2017;09;05;Lauantai;3;0;3
94;30.09.2017;2017;09;06;Lauantai;1;0;1
94;30.09.2017;2017;09;07;Lauantai;0;0;0
94;30.09.2017;2017;09;08;Lauantai;1;2;3
94;30.09.2017;2017;09;09;Lauantai;0;2;2
94;30.09.2017;2017;09;10;Lauantai;1;2;3
94;30.09.2017;2017;09;11;Lauantai;2;1;3
94;30.09.2017;2017;09;12;Lauantai;1;4;5
94;30.09.2017;2017;09;13;Lauantai;1;0;1
94;30.09.2017;2017;09;14;Lauantai;5;5;10
94;30.09.2017;2017;09;15;Lauantai;4;4;8
94;30.09.2017;2017;09;16;Lauantai;26;24;50
94;30.09.2017;2017;09;17;Lauantai;4;5;9
94;30.09.2017;2017;09;18;Lauantai;1;4;5
94;30.09.2017;2017;09;19;Lauantai;2;3;5
94;30.09.2017;2017;09;20;Lauantai;3;4;7
94;30.09.2017;2017;09;21;Lauantai;1;7;8
94;30.09.2017;2017;09;22;Lauantai;1;2;3
94;30.09.2017;2017;09;23;Lauantai;1;2;3
94;01.10.2017;2017;10;00;Sunnuntai;1;0;1
94;01.10.2017;2017;10;01;Sunnuntai;0;2;2
94;01.10.2017;2017;10;02;Sunnuntai;1;2;3
94;01.10.2017;2017;10;03;Sunnuntai;0;0;0
94;01.10.2017;2017;10;04;Sunnuntai;2;0;2
94;01.10.2017;2017;10;05;Sunnuntai;1;0;1
94;01.10.2017;2017;10;06;Sunnuntai;1;0;1
94;01.10.2017;2017;10;07;Sunnuntai;1;0;1
94;01.10.2017;2017;10;08;Sunnuntai;0;0;0
94;01.10.2017;2017;10;09;Sunnuntai;1;5;6
94;01.10.2017;2017;10;10;Sunnuntai;3;1;4
94;01.10.2017;2017;10;11;Sunnuntai;7;6;13
94;01.10.2017;2017;10;12;Sunnuntai;6;3;9
94;01.10.2017;2017;10;13;Sunnuntai;6;10;16
94;01.10.2017;2017;10;14;Sunnuntai;4;7;11
94;01.10.2017;2017;10;15;Sunnuntai;9;2;11
94;01.10.2017;2017;10;16;Sunnuntai;5;3;8
94;01.10.2017;2017;10;17;Sunnuntai;3;3;6
94;01.10.2017;2017;10;18;Sunnuntai;7;5;12
94;01.10.2017;2017;10;19;Sunnuntai;0;1;1
94;01.10.2017;2017;10;20;Sunnuntai;3;2;5
94;01.10.2017;2017;10;21;Sunnuntai;0;2;2
94;01.10.2017;2017;10;22;Sunnuntai;2;0;2
94;01.10.2017;2017;10;23;Sunnuntai;0;0;0
94;02.10.2017;2017;10;00;Maanantai;0;0;0
94;02.10.2017;2017;10;01;Maanantai;0;1;1
94;02.10.2017;2017;10;02;Maanantai;0;0;0
94;02.10.2017;2017;10;03;Maanantai;0;0;0
94;02.10.2017;2017;10;04;Maanantai;0;0;0
94;02.10.2017;2017;10;05;Maanantai;1;1;2
94;02.10.2017;2017;10;06;Maanantai;14;1;15
94;02.10.2017;2017;10;07;Maanantai;24;2;26
94;02.10.2017;2017;10;08;Maanantai;10;1;11
94;02.10.2017;2017;10;09;Maanantai;5;0;5
94;02.10.2017;2017;10;10;Maanantai;3;1;4
94;02.10.2017;2017;10;11;Maanantai;2;4;6
94;02.10.2017;2017;10;12;Maanantai;3;6;9
94;02.10.2017;2017;10;13;Maanantai;7;1;8
94;02.10.2017;2017;10;14;Maanantai;3;9;12
94;02.10.2017;2017;10;15;Maanantai;5;9;14
94;02.10.2017;2017;10;16;Maanantai;1;19;20
94;02.10.2017;2017;10;17;Maanantai;2;13;15
94;02.10.2017;2017;10;18;Maanantai;3;10;13
94;02.10.2017;2017;10;19;Maanantai;4;9;13
94;02.10.2017;2017;10;20;Maanantai;7;4;11
94;02.10.2017;2017;10;21;Maanantai;0;1;1
94;02.10.2017;2017;10;22;Maanantai;2;4;6
94;02.10.2017;2017;10;23;Maanantai;0;0;0
94;03.10.2017;2017;10;00;Tiistai;0;0;0
94;03.10.2017;2017;10;01;Tiistai;0;0;0
94;03.10.2017;2017;10;02;Tiistai;0;0;0
94;03.10.2017;2017;10;03;Tiistai;0;0;0
94;03.10.2017;2017;10;04;Tiistai;0;0;0
94;03.10.2017;2017;10;05;Tiistai;2;2;4
94;03.10.2017;2017;10;06;Tiistai;12;1;13
94;03.10.2017;2017;10;07;Tiistai;21;4;25
94;03.10.2017;2017;10;08;Tiistai;7;1;8
94;03.10.2017;2017;10;09;Tiistai;4;1;5
94;03.10.2017;2017;10;10;Tiistai;0;0;0
94;03.10.2017;2017;10;11;Tiistai;2;1;3
94;03.10.2017;2017;10;12;Tiistai;1;2;3
94;03.10.2017;2017;10;13;Tiistai;1;0;1
94;03.10.2017;2017;10;14;Tiistai;2;1;3
94;03.10.2017;2017;10;15;Tiistai;4;12;16
94;03.10.2017;2017;10;16;Tiistai;5;19;24
94;03.10.2017;2017;10;17;Tiistai;0;12;12
94;03.10.2017;2017;10;18;Tiistai;7;7;14
94;03.10.2017;2017;10;19;Tiistai;6;5;11
94;03.10.2017;2017;10;20;Tiistai;2;5;7
94;03.10.2017;2017;10;21;Tiistai;0;1;1
94;03.10.2017;2017;10;22;Tiistai;0;2;2
94;03.10.2017;2017;10;23;Tiistai;0;0;0
94;04.10.2017;2017;10;00;Keskiviikko;1;0;1
94;04.10.2017;2017;10;01;Keskiviikko;0;1;1
94;04.10.2017;2017;10;02;Keskiviikko;0;0;0
94;04.10.2017;2017;10;03;Keskiviikko;0;0;0
94;04.10.2017;2017;10;04;Keskiviikko;0;0;0
94;04.10.2017;2017;10;05;Keskiviikko;3;2;5
94;04.10.2017;2017;10;06;Keskiviikko;5;1;6
94;04.10.2017;2017;10;07;Keskiviikko;15;1;16
94;04.10.2017;2017;10;08;Keskiviikko;8;2;10
94;04.10.2017;2017;10;09;Keskiviikko;3;1;4
94;04.10.2017;2017;10;10;Keskiviikko;1;1;2
94;04.10.2017;2017;10;11;Keskiviikko;2;0;2
94;04.10.2017;2017;10;12;Keskiviikko;1;2;3
94;04.10.2017;2017;10;13;Keskiviikko;1;1;2
94;04.10.2017;2017;10;14;Keskiviikko;2;3;5
94;04.10.2017;2017;10;15;Keskiviikko;3;6;9
94;04.10.2017;2017;10;16;Keskiviikko;4;8;12
94;04.10.2017;2017;10;17;Keskiviikko;3;8;11
94;04.10.2017;2017;10;18;Keskiviikko;5;5;10
94;04.10.2017;2017;10;19;Keskiviikko;1;3;4
94;04.10.2017;2017;10;20;Keskiviikko;2;6;8
94;04.10.2017;2017;10;21;Keskiviikko;0;2;2
94;04.10.2017;2017;10;22;Keskiviikko;0;2;2
94;04.10.2017;2017;10;23;Keskiviikko;0;0;0
94;05.10.2017;2017;10;00;Torstai;0;0;0
94;05.10.2017;2017;10;01;Torstai;0;0;0
94;05.10.2017;2017;10;02;Torstai;0;0;0
94;05.10.2017;2017;10;03;Torstai;0;0;0
94;05.10.2017;2017;10;04;Torstai;1;0;1
94;05.10.2017;2017;10;05;Torstai;4;3;7
94;05.10.2017;2017;10;06;Torstai;6;1;7
94;05.10.2017;2017;10;07;Torstai;13;2;15
94;05.10.2017;2017;10;08;Torstai;10;1;11
94;05.10.2017;2017;10;09;Torstai;1;2;3
94;05.10.2017;2017;10;10;Torstai;1;1;2
94;05.10.2017;2017;10;11;Torstai;3;3;6
94;05.10.2017;2017;10;12;Torstai;1;5;6
94;05.10.2017;2017;10;13;Torstai;0;4;4
94;05.10.2017;2017;10;14;Torstai;3;3;6
94;05.10.2017;2017;10;15;Torstai;2;9;11
94;05.10.2017;2017;10;16;Torstai;2;14;16
94;05.10.2017;2017;10;17;Torstai;2;8;10
94;05.10.2017;2017;10;18;Torstai;0;7;7
94;05.10.2017;2017;10;19;Torstai;1;6;7
94;05.10.2017;2017;10;20;Torstai;1;1;2
94;05.10.2017;2017;10;21;Torstai;0;2;2
94;05.10.2017;2017;10;22;Torstai;0;0;0
94;05.10.2017;2017;10;23;Torstai;1;0;1
94;06.10.2017;2017;10;00;Perjantai;0;0;0
94;06.10.2017;2017;10;01;Perjantai;0;0;0
94;06.10.2017;2017;10;02;Perjantai;0;1;1
94;06.10.2017;2017;10;03;Perjantai;0;0;0
94;06.10.2017;2017;10;04;Perjantai;0;0;0
94;06.10.2017;2017;10;05;Perjantai;4;1;5
94;06.10.2017;2017;10;06;Perjantai;6;1;7
94;06.10.2017;2017;10;07;Perjantai;15;2;17
94;06.10.2017;2017;10;08;Perjantai;12;3;15
94;06.10.2017;2017;10;09;Perjantai;6;0;6
94;06.10.2017;2017;10;10;Perjantai;3;2;5
94;06.10.2017;2017;10;11;Perjantai;3;6;9
94;06.10.2017;2017;10;12;Perjantai;5;3;8
94;06.10.2017;2017;10;13;Perjantai;1;1;2
94;06.10.2017;2017;10;14;Perjantai;1;10;11
94;06.10.2017;2017;10;15;Perjantai;2;8;10
94;06.10.2017;2017;10;16;Perjantai;2;11;13
94;06.10.2017;2017;10;17;Perjantai;2;9;11
94;06.10.2017;2017;10;18;Perjantai;2;4;6
94;06.10.2017;2017;10;19;Perjantai;2;2;4
94;06.10.2017;2017;10;20;Perjantai;2;2;4
94;06.10.2017;2017;10;21;Perjantai;3;2;5
94;06.10.2017;2017;10;22;Perjantai;1;1;2
94;06.10.2017;2017;10;23;Perjantai;0;0;0
94;07.10.2017;2017;10;00;Lauantai;0;1;1
94;07.10.2017;2017;10;01;Lauantai;0;0;0
94;07.10.2017;2017;10;02;Lauantai;0;0;0
94;07.10.2017;2017;10;03;Lauantai;0;1;1
94;07.10.2017;2017;10;04;Lauantai;0;0;0
94;07.10.2017;2017;10;05;Lauantai;1;0;1
94;07.10.2017;2017;10;06;Lauantai;2;0;2
94;07.10.2017;2017;10;07;Lauantai;0;2;2
94;07.10.2017;2017;10;08;Lauantai;3;7;10
94;07.10.2017;2017;10;09;Lauantai;12;2;14
94;07.10.2017;2017;10;10;Lauantai;5;6;11
94;07.10.2017;2017;10;11;Lauantai;5;11;16
94;07.10.2017;2017;10;12;Lauantai;6;4;10
94;07.10.2017;2017;10;13;Lauantai;5;8;13
94;07.10.2017;2017;10;14;Lauantai;4;5;9
94;07.10.2017;2017;10;15;Lauantai;3;5;8
94;07.10.2017;2017;10;16;Lauantai;9;3;12
94;07.10.2017;2017;10;17;Lauantai;8;0;8
94;07.10.2017;2017;10;18;Lauantai;13;4;17
94;07.10.2017;2017;10;19;Lauantai;0;1;1
94;07.10.2017;2017;10;20;Lauantai;2;1;3
94;07.10.2017;2017;10;21;Lauantai;2;1;3
94;07.10.2017;2017;10;22;Lauantai;1;1;2
94;07.10.2017;2017;10;23;Lauantai;0;6;6
94;08.10.2017;2017;10;00;Sunnuntai;0;0;0
94;08.10.2017;2017;10;01;Sunnuntai;0;0;0
94;08.10.2017;2017;10;02;Sunnuntai;0;0;0
94;08.10.2017;2017;10;03;Sunnuntai;0;0;0
94;08.10.2017;2017;10;04;Sunnuntai;0;0;0
94;08.10.2017;2017;10;05;Sunnuntai;0;0;0
94;08.10.2017;2017;10;06;Sunnuntai;3;0;3
94;08.10.2017;2017;10;07;Sunnuntai;2;0;2
94;08.10.2017;2017;10;08;Sunnuntai;0;0;0
94;08.10.2017;2017;10;09;Sunnuntai;2;3;5
94;08.10.2017;2017;10;10;Sunnuntai;3;4;7
94;08.10.2017;2017;10;11;Sunnuntai;8;2;10
94;08.10.2017;2017;10;12;Sunnuntai;1;10;11
94;08.10.2017;2017;10;13;Sunnuntai;9;9;18
94;08.10.2017;2017;10;14;Sunnuntai;4;7;11
94;08.10.2017;2017;10;15;Sunnuntai;9;9;18
94;08.10.2017;2017;10;16;Sunnuntai;6;7;13
94;08.10.2017;2017;10;17;Sunnuntai;5;4;9
94;08.10.2017;2017;10;18;Sunnuntai;1;1;2
94;08.10.2017;2017;10;19;Sunnuntai;3;1;4
94;08.10.2017;2017;10;20;Sunnuntai;5;0;5
94;08.10.2017;2017;10;21;Sunnuntai;1;4;5
94;08.10.2017;2017;10;22;Sunnuntai;3;1;4
94;08.10.2017;2017;10;23;Sunnuntai;2;0;2
94;09.10.2017;2017;10;00;Maanantai;0;0;0
94;09.10.2017;2017;10;01;Maanantai;0;0;0
94;09.10.2017;2017;10;02;Maanantai;0;0;0
94;09.10.2017;2017;10;03;Maanantai;0;0;0
94;09.10.2017;2017;10;04;Maanantai;0;0;0
94;09.10.2017;2017;10;05;Maanantai;4;3;7
94;09.10.2017;2017;10;06;Maanantai;13;0;13
94;09.10.2017;2017;10;07;Maanantai;21;3;24
94;09.10.2017;2017;10;08;Maanantai;8;0;8
94;09.10.2017;2017;10;09;Maanantai;4;0;4
94;09.10.2017;2017;10;10;Maanantai;4;0;4
94;09.10.2017;2017;10;11;Maanantai;3;1;4
94;09.10.2017;2017;10;12;Maanantai;4;0;4
94;09.10.2017;2017;10;13;Maanantai;1;6;7
94;09.10.2017;2017;10;14;Maanantai;2;5;7
94;09.10.2017;2017;10;15;Maanantai;3;10;13
94;09.10.2017;2017;10;16;Maanantai;0;11;11
94;09.10.2017;2017;10;17;Maanantai;6;18;24
94;09.10.2017;2017;10;18;Maanantai;2;5;7
94;09.10.2017;2017;10;19;Maanantai;3;7;10
94;09.10.2017;2017;10;20;Maanantai;3;0;3
94;09.10.2017;2017;10;21;Maanantai;1;3;4
94;09.10.2017;2017;10;22;Maanantai;1;2;3
94;09.10.2017;2017;10;23;Maanantai;0;0;0
94;10.10.2017;2017;10;00;Tiistai;0;0;0
94;10.10.2017;2017;10;01;Tiistai;0;0;0
94;10.10.2017;2017;10;02;Tiistai;0;0;0
94;10.10.2017;2017;10;03;Tiistai;0;0;0
94;10.10.2017;2017;10;04;Tiistai;0;0;0
94;10.10.2017;2017;10;05;Tiistai;3;3;6
94;10.10.2017;2017;10;06;Tiistai;7;2;9
94;10.10.2017;2017;10;07;Tiistai;10;0;10
94;10.10.2017;2017;10;08;Tiistai;3;1;4
94;10.10.2017;2017;10;09;Tiistai;4;0;4
94;10.10.2017;2017;10;10;Tiistai;0;0;0
94;10.10.2017;2017;10;11;Tiistai;2;1;3
94;10.10.2017;2017;10;12;Tiistai;0;2;2
94;10.10.2017;2017;10;13;Tiistai;0;1;1
94;10.10.2017;2017;10;14;Tiistai;2;4;6
94;10.10.2017;2017;10;15;Tiistai;1;3;4
94;10.10.2017;2017;10;16;Tiistai;2;10;12
94;10.10.2017;2017;10;17;Tiistai;2;8;10
94;10.10.2017;2017;10;18;Tiistai;0;2;2
94;10.10.2017;2017;10;19;Tiistai;0;3;3
94;10.10.2017;2017;10;20;Tiistai;2;3;5
94;10.10.2017;2017;10;21;Tiistai;2;1;3
94;10.10.2017;2017;10;22;Tiistai;0;0;0
94;10.10.2017;2017;10;23;Tiistai;0;0;0
94;11.10.2017;2017;10;00;Keskiviikko;0;0;0
94;11.10.2017;2017;10;01;Keskiviikko;0;0;0
94;11.10.2017;2017;10;02;Keskiviikko;0;0;0
94;11.10.2017;2017;10;03;Keskiviikko;0;0;0
94;11.10.2017;2017;10;04;Keskiviikko;0;0;0
94;11.10.2017;2017;10;05;Keskiviikko;3;2;5
94;11.10.2017;2017;10;06;Keskiviikko;16;2;18
94;11.10.2017;2017;10;07;Keskiviikko;17;1;18
94;11.10.2017;2017;10;08;Keskiviikko;14;2;16
94;11.10.2017;2017;10;09;Keskiviikko;2;0;2
94;11.10.2017;2017;10;10;Keskiviikko;3;1;4
94;11.10.2017;2017;10;11;Keskiviikko;2;4;6
94;11.10.2017;2017;10;12;Keskiviikko;0;1;1
94;11.10.2017;2017;10;13;Keskiviikko;4;3;7
94;11.10.2017;2017;10;14;Keskiviikko;3;7;10
94;11.10.2017;2017;10;15;Keskiviikko;3;14;17
94;11.10.2017;2017;10;16;Keskiviikko;4;19;23
94;11.10.2017;2017;10;17;Keskiviikko;4;11;15
94;11.10.2017;2017;10;18;Keskiviikko;2;3;5
94;11.10.2017;2017;10;19;Keskiviikko;3;4;7
94;11.10.2017;2017;10;20;Keskiviikko;0;2;2
94;11.10.2017;2017;10;21;Keskiviikko;1;1;2
94;11.10.2017;2017;10;22;Keskiviikko;0;0;0
94;11.10.2017;2017;10;23;Keskiviikko;0;0;0
94;12.10.2017;2017;10;00;Torstai;0;0;0
94;12.10.2017;2017;10;01;Torstai;0;0;0
94;12.10.2017;2017;10;02;Torstai;0;0;0
94;12.10.2017;2017;10;03;Torstai;0;0;0
94;12.10.2017;2017;10;04;Torstai;0;0;0
94;12.10.2017;2017;10;05;Torstai;6;2;8
94;12.10.2017;2017;10;06;Torstai;10;3;13
94;12.10.2017;2017;10;07;Torstai;16;1;17
94;12.10.2017;2017;10;08;Torstai;8;3;11
94;12.10.2017;2017;10;09;Torstai;5;1;6
94;12.10.2017;2017;10;10;Torstai;1;2;3
94;12.10.2017;2017;10;11;Torstai;5;4;9
94;12.10.2017;2017;10;12;Torstai;2;3;5
94;12.10.2017;2017;10;13;Torstai;0;1;1
94;12.10.2017;2017;10;14;Torstai;2;11;13
94;12.10.2017;2017;10;15;Torstai;3;10;13
94;12.10.2017;2017;10;16;Torstai;3;13;16
94;12.10.2017;2017;10;17;Torstai;3;12;15
94;12.10.2017;2017;10;18;Torstai;2;6;8
94;12.10.2017;2017;10;19;Torstai;0;0;0
94;12.10.2017;2017;10;20;Torstai;2;1;3
94;12.10.2017;2017;10;21;Torstai;1;3;4
94;12.10.2017;2017;10;22;Torstai;1;0;1
94;12.10.2017;2017;10;23;Torstai;0;1;1
94;13.10.2017;2017;10;00;Perjantai;0;0;0
94;13.10.2017;2017;10;01;Perjantai;0;0;0
94;13.10.2017;2017;10;02;Perjantai;0;0;0
94;13.10.2017;2017;10;03;Perjantai;0;0;0
94;13.10.2017;2017;10;04;Perjantai;0;0;0
94;13.10.2017;2017;10;05;Perjantai;4;3;7
94;13.10.2017;2017;10;06;Perjantai;7;1;8
94;13.10.2017;2017;10;07;Perjantai;12;1;13
94;13.10.2017;2017;10;08;Perjantai;6;1;7
94;13.10.2017;2017;10;09;Perjantai;4;0;4
94;13.10.2017;2017;10;10;Perjantai;1;2;3
94;13.10.2017;2017;10;11;Perjantai;2;1;3
94;13.10.2017;2017;10;12;Perjantai;1;4;5
94;13.10.2017;2017;10;13;Perjantai;4;7;11
94;13.10.2017;2017;10;14;Perjantai;5;8;13
94;13.10.2017;2017;10;15;Perjantai;5;7;12
94;13.10.2017;2017;10;16;Perjantai;6;10;16
94;13.10.2017;2017;10;17;Perjantai;2;6;8
94;13.10.2017;2017;10;18;Perjantai;3;7;10
94;13.10.2017;2017;10;19;Perjantai;1;2;3
94;13.10.2017;2017;10;20;Perjantai;0;1;1
94;13.10.2017;2017;10;21;Perjantai;1;0;1
94;13.10.2017;2017;10;22;Perjantai;2;0;2
94;13.10.2017;2017;10;23;Perjantai;2;0;2
94;14.10.2017;2017;10;00;Lauantai;0;0;0
94;14.10.2017;2017;10;01;Lauantai;0;0;0
94;14.10.2017;2017;10;02;Lauantai;0;0;0
94;14.10.2017;2017;10;03;Lauantai;0;0;0
94;14.10.2017;2017;10;04;Lauantai;0;0;0
94;14.10.2017;2017;10;05;Lauantai;1;0;1
94;14.10.2017;2017;10;06;Lauantai;2;1;3
94;14.10.2017;2017;10;07;Lauantai;0;0;0
94;14.10.2017;2017;10;08;Lauantai;0;1;1
94;14.10.2017;2017;10;09;Lauantai;1;3;4
94;14.10.2017;2017;10;10;Lauantai;1;4;5
94;14.10.2017;2017;10;11;Lauantai;5;0;5
94;14.10.2017;2017;10;12;Lauantai;8;4;12
94;14.10.2017;2017;10;13;Lauantai;0;4;4
94;14.10.2017;2017;10;14;Lauantai;6;3;9
94;14.10.2017;2017;10;15;Lauantai;3;4;7
94;14.10.2017;2017;10;16;Lauantai;7;4;11
94;14.10.2017;2017;10;17;Lauantai;2;2;4
94;14.10.2017;2017;10;18;Lauantai;1;0;1
94;14.10.2017;2017;10;19;Lauantai;0;1;1
94;14.10.2017;2017;10;20;Lauantai;0;3;3
94;14.10.2017;2017;10;21;Lauantai;0;2;2
94;14.10.2017;2017;10;22;Lauantai;2;0;2
94;14.10.2017;2017;10;23;Lauantai;1;1;2
94;15.10.2017;2017;10;00;Sunnuntai;0;0;0
94;15.10.2017;2017;10;01;Sunnuntai;0;0;0
94;15.10.2017;2017;10;02;Sunnuntai;0;1;1
94;15.10.2017;2017;10;03;Sunnuntai;0;0;0
94;15.10.2017;2017;10;04;Sunnuntai;0;0;0
94;15.10.2017;2017;10;05;Sunnuntai;0;0;0
94;15.10.2017;2017;10;06;Sunnuntai;0;0;0
94;15.10.2017;2017;10;07;Sunnuntai;2;0;2
94;15.10.2017;2017;10;08;Sunnuntai;0;0;0
94;15.10.2017;2017;10;09;Sunnuntai;2;5;7
94;15.10.2017;2017;10;10;Sunnuntai;2;1;3
94;15.10.2017;2017;10;11;Sunnuntai;5;5;10
94;15.10.2017;2017;10;12;Sunnuntai;6;5;11
94;15.10.2017;2017;10;13;Sunnuntai;7;9;16
94;15.10.2017;2017;10;14;Sunnuntai;4;5;9
94;15.10.2017;2017;10;15;Sunnuntai;5;9;14
94;15.10.2017;2017;10;16;Sunnuntai;7;5;12
94;15.10.2017;2017;10;17;Sunnuntai;8;2;10
94;15.10.2017;2017;10;18;Sunnuntai;6;4;10
94;15.10.2017;2017;10;19;Sunnuntai;0;7;7
94;15.10.2017;2017;10;20;Sunnuntai;4;2;6
94;15.10.2017;2017;10;21;Sunnuntai;2;0;2
94;15.10.2017;2017;10;22;Sunnuntai;2;2;4
94;15.10.2017;2017;10;23;Sunnuntai;0;0;0
94;16.10.2017;2017;10;00;Maanantai;0;1;1
94;16.10.2017;2017;10;01;Maanantai;0;0;0
94;16.10.2017;2017;10;02;Maanantai;0;0;0
94;16.10.2017;2017;10;03;Maanantai;0;0;0
94;16.10.2017;2017;10;04;Maanantai;0;0;0
94;16.10.2017;2017;10;05;Maanantai;3;1;4
94;16.10.2017;2017;10;06;Maanantai;5;1;6
94;16.10.2017;2017;10;07;Maanantai;19;0;19
94;16.10.2017;2017;10;08;Maanantai;8;1;9
94;16.10.2017;2017;10;09;Maanantai;2;0;2
94;16.10.2017;2017;10;10;Maanantai;0;0;0
94;16.10.2017;2017;10;11;Maanantai;0;2;2
94;16.10.2017;2017;10;12;Maanantai;2;0;2
94;16.10.2017;2017;10;13;Maanantai;0;3;3
94;16.10.2017;2017;10;14;Maanantai;1;1;2
94;16.10.2017;2017;10;15;Maanantai;1;15;16
94;16.10.2017;2017;10;16;Maanantai;4;10;14
94;16.10.2017;2017;10;17;Maanantai;4;13;17
94;16.10.2017;2017;10;18;Maanantai;3;2;5
94;16.10.2017;2017;10;19;Maanantai;1;5;6
94;16.10.2017;2017;10;20;Maanantai;2;2;4
94;16.10.2017;2017;10;21;Maanantai;2;0;2
94;16.10.2017;2017;10;22;Maanantai;0;0;0
94;16.10.2017;2017;10;23;Maanantai;0;0;0
94;17.10.2017;2017;10;00;Tiistai;0;0;0
94;17.10.2017;2017;10;01;Tiistai;0;0;0
94;17.10.2017;2017;10;02;Tiistai;0;0;0
94;17.10.2017;2017;10;03;Tiistai;0;0;0
94;17.10.2017;2017;10;04;Tiistai;0;0;0
94;17.10.2017;2017;10;05;Tiistai;5;1;6
94;17.10.2017;2017;10;06;Tiistai;17;2;19
94;17.10.2017;2017;10;07;Tiistai;17;1;18
94;17.10.2017;2017;10;08;Tiistai;11;1;12
94;17.10.2017;2017;10;09;Tiistai;2;2;4
94;17.10.2017;2017;10;10;Tiistai;7;2;9
94;17.10.2017;2017;10;11;Tiistai;4;3;7
94;17.10.2017;2017;10;12;Tiistai;4;6;10
94;17.10.2017;2017;10;13;Tiistai;3;6;9
94;17.10.2017;2017;10;14;Tiistai;3;6;9
94;17.10.2017;2017;10;15;Tiistai;4;18;22
94;17.10.2017;2017;10;16;Tiistai;2;11;13
94;17.10.2017;2017;10;17;Tiistai;4;11;15
94;17.10.2017;2017;10;18;Tiistai;1;2;3
94;17.10.2017;2017;10;19;Tiistai;1;4;5
94;17.10.2017;2017;10;20;Tiistai;1;4;5
94;17.10.2017;2017;10;21;Tiistai;0;2;2
94;17.10.2017;2017;10;22;Tiistai;0;3;3
94;17.10.2017;2017;10;23;Tiistai;0;0;0
94;18.10.2017;2017;10;00;Keskiviikko;0;0;0
94;18.10.2017;2017;10;01;Keskiviikko;0;0;0
94;18.10.2017;2017;10;02;Keskiviikko;0;0;0
94;18.10.2017;2017;10;03;Keskiviikko;0;0;0
94;18.10.2017;2017;10;04;Keskiviikko;0;0;0
94;18.10.2017;2017;10;05;Keskiviikko;4;2;6
94;18.10.2017;2017;10;06;Keskiviikko;12;2;14
94;18.10.2017;2017;10;07;Keskiviikko;19;1;20
94;18.10.2017;2017;10;08;Keskiviikko;7;1;8
94;18.10.2017;2017;10;09;Keskiviikko;3;2;5
94;18.10.2017;2017;10;10;Keskiviikko;1;2;3
94;18.10.2017;2017;10;11;Keskiviikko;4;1;5
94;18.10.2017;2017;10;12;Keskiviikko;5;1;6
94;18.10.2017;2017;10;13;Keskiviikko;3;3;6
94;18.10.2017;2017;10;14;Keskiviikko;3;10;13
94;18.10.2017;2017;10;15;Keskiviikko;3;14;17
94;18.10.2017;2017;10;16;Keskiviikko;2;14;16
94;18.10.2017;2017;10;17;Keskiviikko;2;12;14
94;18.10.2017;2017;10;18;Keskiviikko;1;3;4
94;18.10.2017;2017;10;19;Keskiviikko;1;4;5
94;18.10.2017;2017;10;20;Keskiviikko;2;0;2
94;18.10.2017;2017;10;21;Keskiviikko;0;4;4
94;18.10.2017;2017;10;22;Keskiviikko;1;0;1
94;18.10.2017;2017;10;23;Keskiviikko;0;0;0
94;19.10.2017;2017;10;00;Torstai;0;0;0
94;19.10.2017;2017;10;01;Torstai;0;0;0
94;19.10.2017;2017;10;02;Torstai;0;0;0
94;19.10.2017;2017;10;03;Torstai;0;0;0
94;19.10.2017;2017;10;04;Torstai;0;0;0
94;19.10.2017;2017;10;05;Torstai;2;1;3
94;19.10.2017;2017;10;06;Torstai;10;3;13
94;19.10.2017;2017;10;07;Torstai;15;1;16
94;19.10.2017;2017;10;08;Torstai;8;1;9
94;19.10.2017;2017;10;09;Torstai;4;1;5
94;19.10.2017;2017;10;10;Torstai;1;2;3
94;19.10.2017;2017;10;11;Torstai;3;1;4
94;19.10.2017;2017;10;12;Torstai;1;1;2
94;19.10.2017;2017;10;13;Torstai;2;5;7
94;19.10.2017;2017;10;14;Torstai;3;5;8
94;19.10.2017;2017;10;15;Torstai;4;8;12
94;19.10.2017;2017;10;16;Torstai;2;20;22
94;19.10.2017;2017;10;17;Torstai;1;11;12
94;19.10.2017;2017;10;18;Torstai;4;3;7
94;19.10.2017;2017;10;19;Torstai;2;7;9
94;19.10.2017;2017;10;20;Torstai;2;4;6
94;19.10.2017;2017;10;21;Torstai;1;4;5
94;19.10.2017;2017;10;22;Torstai;0;1;1
94;19.10.2017;2017;10;23;Torstai;1;0;1
94;20.10.2017;2017;10;00;Perjantai;0;0;0
94;20.10.2017;2017;10;01;Perjantai;0;0;0
94;20.10.2017;2017;10;02;Perjantai;0;4;4
94;20.10.2017;2017;10;03;Perjantai;0;0;0
94;20.10.2017;2017;10;04;Perjantai;0;0;0
94;20.10.2017;2017;10;05;Perjantai;2;1;3
94;20.10.2017;2017;10;06;Perjantai;5;3;8
94;20.10.2017;2017;10;07;Perjantai;11;0;11
94;20.10.2017;2017;10;08;Perjantai;8;0;8
94;20.10.2017;2017;10;09;Perjantai;5;0;5
94;20.10.2017;2017;10;10;Perjantai;3;0;3
94;20.10.2017;2017;10;11;Perjantai;1;1;2
94;20.10.2017;2017;10;12;Perjantai;3;5;8
94;20.10.2017;2017;10;13;Perjantai;0;3;3
94;20.10.2017;2017;10;14;Perjantai;1;10;11
94;20.10.2017;2017;10;15;Perjantai;3;7;10
94;20.10.2017;2017;10;16;Perjantai;0;7;7
94;20.10.2017;2017;10;17;Perjantai;1;9;10
94;20.10.2017;2017;10;18;Perjantai;1;3;4
94;20.10.2017;2017;10;19;Perjantai;0;2;2
94;20.10.2017;2017;10;20;Perjantai;0;3;3
94;20.10.2017;2017;10;21;Perjantai;0;0;0
94;20.10.2017;2017;10;22;Perjantai;1;1;2
94;20.10.2017;2017;10;23;Perjantai;1;0;1
94;21.10.2017;2017;10;00;Lauantai;0;0;0
94;21.10.2017;2017;10;01;Lauantai;0;0;0
94;21.10.2017;2017;10;02;Lauantai;0;0;0
94;21.10.2017;2017;10;03;Lauantai;0;0;0
94;21.10.2017;2017;10;04;Lauantai;0;0;0
94;21.10.2017;2017;10;05;Lauantai;1;0;1
94;21.10.2017;2017;10;06;Lauantai;1;0;1
94;21.10.2017;2017;10;07;Lauantai;1;0;1
94;21.10.2017;2017;10;08;Lauantai;0;1;1
94;21.10.2017;2017;10;09;Lauantai;0;2;2
94;21.10.2017;2017;10;10;Lauantai;2;0;2
94;21.10.2017;2017;10;11;Lauantai;2;0;2
94;21.10.2017;2017;10;12;Lauantai;1;2;3
94;21.10.2017;2017;10;13;Lauantai;2;4;6
94;21.10.2017;2017;10;14;Lauantai;2;1;3
94;21.10.2017;2017;10;15;Lauantai;0;3;3
94;21.10.2017;2017;10;16;Lauantai;2;1;3
94;21.10.2017;2017;10;17;Lauantai;11;5;16
94;21.10.2017;2017;10;18;Lauantai;1;0;1
94;21.10.2017;2017;10;19;Lauantai;0;1;1
94;21.10.2017;2017;10;20;Lauantai;1;1;2
94;21.10.2017;2017;10;21;Lauantai;0;1;1
94;21.10.2017;2017;10;22;Lauantai;1;0;1
94;21.10.2017;2017;10;23;Lauantai;0;1;1
94;22.10.2017;2017;10;00;Sunnuntai;1;9;10
94;22.10.2017;2017;10;01;Sunnuntai;0;0;0
94;22.10.2017;2017;10;02;Sunnuntai;0;0;0
94;22.10.2017;2017;10;03;Sunnuntai;1;0;1
94;22.10.2017;2017;10;04;Sunnuntai;0;0;0
94;22.10.2017;2017;10;05;Sunnuntai;0;0;0
94;22.10.2017;2017;10;06;Sunnuntai;0;0;0
94;22.10.2017;2017;10;07;Sunnuntai;1;2;3
94;22.10.2017;2017;10;08;Sunnuntai;0;0;0
94;22.10.2017;2017;10;09;Sunnuntai;1;1;2
94;22.10.2017;2017;10;10;Sunnuntai;2;2;4
94;22.10.2017;2017;10;11;Sunnuntai;2;0;2
94;22.10.2017;2017;10;12;Sunnuntai;2;1;3
94;22.10.2017;2017;10;13;Sunnuntai;0;3;3
94;22.10.2017;2017;10;14;Sunnuntai;0;1;1
94;22.10.2017;2017;10;15;Sunnuntai;0;1;1
94;22.10.2017;2017;10;16;Sunnuntai;3;1;4
94;22.10.2017;2017;10;17;Sunnuntai;2;0;2
94;22.10.2017;2017;10;18;Sunnuntai;2;1;3
94;22.10.2017;2017;10;19;Sunnuntai;2;2;4
94;22.10.2017;2017;10;20;Sunnuntai;0;1;1
94;22.10.2017;2017;10;21;Sunnuntai;0;0;0
94;22.10.2017;2017;10;22;Sunnuntai;1;0;1
94;22.10.2017;2017;10;23;Sunnuntai;0;0;0
94;23.10.2017;2017;10;00;Maanantai;0;0;0
94;23.10.2017;2017;10;01;Maanantai;0;1;1
94;23.10.2017;2017;10;02;Maanantai;0;0;0
94;23.10.2017;2017;10;03;Maanantai;1;0;1
94;23.10.2017;2017;10;04;Maanantai;0;0;0
94;23.10.2017;2017;10;05;Maanantai;2;1;3
94;23.10.2017;2017;10;06;Maanantai;6;1;7
94;23.10.2017;2017;10;07;Maanantai;4;1;5
94;23.10.2017;2017;10;08;Maanantai;5;0;5
94;23.10.2017;2017;10;09;Maanantai;3;0;3
94;23.10.2017;2017;10;10;Maanantai;3;0;3
94;23.10.2017;2017;10;11;Maanantai;1;1;2
94;23.10.2017;2017;10;12;Maanantai;1;0;1
94;23.10.2017;2017;10;13;Maanantai;2;2;4
94;23.10.2017;2017;10;14;Maanantai;2;3;5
94;23.10.2017;2017;10;15;Maanantai;4;3;7
94;23.10.2017;2017;10;16;Maanantai;0;8;8
94;23.10.2017;2017;10;17;Maanantai;2;6;8
94;23.10.2017;2017;10;18;Maanantai;1;1;2
94;23.10.2017;2017;10;19;Maanantai;0;5;5
94;23.10.2017;2017;10;20;Maanantai;0;0;0
94;23.10.2017;2017;10;21;Maanantai;1;0;1
94;23.10.2017;2017;10;22;Maanantai;1;2;3
94;23.10.2017;2017;10;23;Maanantai;0;1;1
94;24.10.2017;2017;10;00;Tiistai;0;0;0
94;24.10.2017;2017;10;01;Tiistai;0;0;0
94;24.10.2017;2017;10;02;Tiistai;0;0;0
94;24.10.2017;2017;10;03;Tiistai;0;0;0
94;24.10.2017;2017;10;04;Tiistai;0;0;0
94;24.10.2017;2017;10;05;Tiistai;2;1;3
94;24.10.2017;2017;10;06;Tiistai;2;3;5
94;24.10.2017;2017;10;07;Tiistai;11;0;11
94;24.10.2017;2017;10;08;Tiistai;4;1;5
94;24.10.2017;2017;10;09;Tiistai;1;1;2
94;24.10.2017;2017;10;10;Tiistai;3;2;5
94;24.10.2017;2017;10;11;Tiistai;3;2;5
94;24.10.2017;2017;10;12;Tiistai;1;0;1
94;24.10.2017;2017;10;13;Tiistai;0;1;1
94;24.10.2017;2017;10;14;Tiistai;1;3;4
94;24.10.2017;2017;10;15;Tiistai;5;4;9
94;24.10.2017;2017;10;16;Tiistai;4;9;13
94;24.10.2017;2017;10;17;Tiistai;0;5;5
94;24.10.2017;2017;10;18;Tiistai;0;4;4
94;24.10.2017;2017;10;19;Tiistai;0;4;4
94;24.10.2017;2017;10;20;Tiistai;0;1;1
94;24.10.2017;2017;10;21;Tiistai;0;1;1
94;24.10.2017;2017;10;22;Tiistai;2;0;2
94;24.10.2017;2017;10;23;Tiistai;0;0;0
94;25.10.2017;2017;10;00;Keskiviikko;0;0;0
94;25.10.2017;2017;10;01;Keskiviikko;0;0;0
94;25.10.2017;2017;10;02;Keskiviikko;0;0;0
94;25.10.2017;2017;10;03;Keskiviikko;0;0;0
94;25.10.2017;2017;10;04;Keskiviikko;0;0;0
94;25.10.2017;2017;10;05;Keskiviikko;3;1;4
94;25.10.2017;2017;10;06;Keskiviikko;5;2;7
94;25.10.2017;2017;10;07;Keskiviikko;7;0;7
94;25.10.2017;2017;10;08;Keskiviikko;3;1;4
94;25.10.2017;2017;10;09;Keskiviikko;3;2;5
94;25.10.2017;2017;10;10;Keskiviikko;3;1;4
94;25.10.2017;2017;10;11;Keskiviikko;0;2;2
94;25.10.2017;2017;10;12;Keskiviikko;3;2;5
94;25.10.2017;2017;10;13;Keskiviikko;1;1;2
94;25.10.2017;2017;10;14;Keskiviikko;3;2;5
94;25.10.2017;2017;10;15;Keskiviikko;4;5;9
94;25.10.2017;2017;10;16;Keskiviikko;1;6;7
94;25.10.2017;2017;10;17;Keskiviikko;2;7;9
94;25.10.2017;2017;10;18;Keskiviikko;0;5;5
94;25.10.2017;2017;10;19;Keskiviikko;0;4;4
94;25.10.2017;2017;10;20;Keskiviikko;0;1;1
94;25.10.2017;2017;10;21;Keskiviikko;3;1;4
94;25.10.2017;2017;10;22;Keskiviikko;0;0;0
94;25.10.2017;2017;10;23;Keskiviikko;0;0;0
94;26.10.2017;2017;10;00;Torstai;0;0;0
94;26.10.2017;2017;10;01;Torstai;0;0;0
94;26.10.2017;2017;10;02;Torstai;0;0;0
94;26.10.2017;2017;10;03;Torstai;0;0;0
94;26.10.2017;2017;10;04;Torstai;0;0;0
94;26.10.2017;2017;10;05;Torstai;2;2;4
94;26.10.2017;2017;10;06;Torstai;5;2;7
94;26.10.2017;2017;10;07;Torstai;9;0;9
94;26.10.2017;2017;10;08;Torstai;2;1;3
94;26.10.2017;2017;10;09;Torstai;1;0;1
94;26.10.2017;2017;10;10;Torstai;2;0;2
94;26.10.2017;2017;10;11;Torstai;1;1;2
94;26.10.2017;2017;10;12;Torstai;2;1;3
94;26.10.2017;2017;10;13;Torstai;2;1;3
94;26.10.2017;2017;10;14;Torstai;2;1;3
94;26.10.2017;2017;10;15;Torstai;4;5;9
94;26.10.2017;2017;10;16;Torstai;1;7;8
94;26.10.2017;2017;10;17;Torstai;2;4;6
94;26.10.2017;2017;10;18;Torstai;0;5;5
94;26.10.2017;2017;10;19;Torstai;2;5;7
94;26.10.2017;2017;10;20;Torstai;0;0;0
94;26.10.2017;2017;10;21;Torstai;0;1;1
94;26.10.2017;2017;10;22;Torstai;1;0;1
94;26.10.2017;2017;10;23;Torstai;0;0;0
94;27.10.2017;2017;10;00;Perjantai;0;0;0
94;27.10.2017;2017;10;01;Perjantai;1;0;1
94;27.10.2017;2017;10;02;Perjantai;0;0;0
94;27.10.2017;2017;10;03;Perjantai;0;0;0
94;27.10.2017;2017;10;04;Perjantai;0;0;0
94;27.10.2017;2017;10;05;Perjantai;3;2;5
94;27.10.2017;2017;10;06;Perjantai;0;2;2
94;27.10.2017;2017;10;07;Perjantai;5;1;6
94;27.10.2017;2017;10;08;Perjantai;0;0;0
94;27.10.2017;2017;10;09;Perjantai;0;0;0
94;27.10.2017;2017;10;10;Perjantai;3;1;4
94;27.10.2017;2017;10;11;Perjantai;1;3;4
94;27.10.2017;2017;10;12;Perjantai;1;2;3
94;27.10.2017;2017;10;13;Perjantai;1;0;1
94;27.10.2017;2017;10;14;Perjantai;3;2;5
94;27.10.2017;2017;10;15;Perjantai;2;4;6
94;27.10.2017;2017;10;16;Perjantai;4;1;5
94;27.10.2017;2017;10;17;Perjantai;1;4;5
94;27.10.2017;2017;10;18;Perjantai;1;2;3
94;27.10.2017;2017;10;19;Perjantai;1;3;4
94;27.10.2017;2017;10;20;Perjantai;1;0;1
94;27.10.2017;2017;10;21;Perjantai;1;1;2
94;27.10.2017;2017;10;22;Perjantai;1;3;4
94;27.10.2017;2017;10;23;Perjantai;0;0;0
94;28.10.2017;2017;10;00;Lauantai;0;0;0
94;28.10.2017;2017;10;01;Lauantai;1;0;1
94;28.10.2017;2017;10;02;Lauantai;0;0;0
94;28.10.2017;2017;10;03;Lauantai;0;0;0
94;28.10.2017;2017;10;04;Lauantai;0;0;0
94;28.10.2017;2017;10;05;Lauantai;0;0;0
94;28.10.2017;2017;10;06;Lauantai;0;0;0
94;28.10.2017;2017;10;07;Lauantai;0;1;1
94;28.10.2017;2017;10;08;Lauantai;1;1;2
94;28.10.2017;2017;10;09;Lauantai;1;0;1
94;28.10.2017;2017;10;10;Lauantai;1;2;3
94;28.10.2017;2017;10;11;Lauantai;0;0;0
94;28.10.2017;2017;10;12;Lauantai;2;3;5
94;28.10.2017;2017;10;13;Lauantai;2;2;4
94;28.10.2017;2017;10;14;Lauantai;0;0;0
94;28.10.2017;2017;10;15;Lauantai;2;0;2
94;28.10.2017;2017;10;16;Lauantai;0;2;2
94;28.10.2017;2017;10;17;Lauantai;2;0;2
94;28.10.2017;2017;10;18;Lauantai;0;1;1
94;28.10.2017;2017;10;19;Lauantai;2;6;8
94;28.10.2017;2017;10;20;Lauantai;0;1;1
94;28.10.2017;2017;10;21;Lauantai;1;1;2
94;28.10.2017;2017;10;22;Lauantai;2;0;2
94;28.10.2017;2017;10;23;Lauantai;0;0;0
94;29.10.2017;2017;10;00;Sunnuntai;0;0;0
94;29.10.2017;2017;10;01;Sunnuntai;1;0;1
94;29.10.2017;2017;10;02;Sunnuntai;2;0;2
94;29.10.2017;2017;10;03;Sunnuntai;1;0;1
94;29.10.2017;2017;10;04;Sunnuntai;0;0;0
94;29.10.2017;2017;10;05;Sunnuntai;0;0;0
94;29.10.2017;2017;10;06;Sunnuntai;1;0;1
94;29.10.2017;2017;10;07;Sunnuntai;0;0;0
94;29.10.2017;2017;10;08;Sunnuntai;0;2;2
94;29.10.2017;2017;10;09;Sunnuntai;4;1;5
94;29.10.2017;2017;10;10;Sunnuntai;0;0;0
94;29.10.2017;2017;10;11;Sunnuntai;2;1;3
94;29.10.2017;2017;10;12;Sunnuntai;2;3;5
94;29.10.2017;2017;10;13;Sunnuntai;0;1;1
94;29.10.2017;2017;10;14;Sunnuntai;3;1;4
94;29.10.2017;2017;10;15;Sunnuntai;1;0;1
94;29.10.2017;2017;10;16;Sunnuntai;1;1;2
94;29.10.2017;2017;10;17;Sunnuntai;1;1;2
94;29.10.2017;2017;10;18;Sunnuntai;1;1;2
94;29.10.2017;2017;10;19;Sunnuntai;0;2;2
94;29.10.2017;2017;10;20;Sunnuntai;1;0;1
94;29.10.2017;2017;10;21;Sunnuntai;0;0;0
94;29.10.2017;2017;10;22;Sunnuntai;0;0;0
94;29.10.2017;2017;10;23;Sunnuntai;0;0;0
94;30.10.2017;2017;10;00;Maanantai;0;0;0
94;30.10.2017;2017;10;01;Maanantai;0;0;0
94;30.10.2017;2017;10;02;Maanantai;0;0;0
94;30.10.2017;2017;10;03;Maanantai;0;0;0
94;30.10.2017;2017;10;04;Maanantai;0;0;0
94;30.10.2017;2017;10;05;Maanantai;3;1;4
94;30.10.2017;2017;10;06;Maanantai;8;3;11
94;30.10.2017;2017;10;07;Maanantai;9;0;9
94;30.10.2017;2017;10;08;Maanantai;10;1;11
94;30.10.2017;2017;10;09;Maanantai;1;0;1
94;30.10.2017;2017;10;10;Maanantai;0;3;3
94;30.10.2017;2017;10;11;Maanantai;2;3;5
94;30.10.2017;2017;10;12;Maanantai;4;1;5
94;30.10.2017;2017;10;13;Maanantai;2;3;5
94;30.10.2017;2017;10;14;Maanantai;2;6;8
94;30.10.2017;2017;10;15;Maanantai;6;9;15
94;30.10.2017;2017;10;16;Maanantai;2;10;12
94;30.10.2017;2017;10;17;Maanantai;0;7;7
94;30.10.2017;2017;10;18;Maanantai;1;1;2
94;30.10.2017;2017;10;19;Maanantai;0;2;2
94;30.10.2017;2017;10;20;Maanantai;1;0;1
94;30.10.2017;2017;10;21;Maanantai;1;2;3
94;30.10.2017;2017;10;22;Maanantai;1;2;3
94;30.10.2017;2017;10;23;Maanantai;0;2;2
94;31.10.2017;2017;10;00;Tiistai;0;0;0
94;31.10.2017;2017;10;01;Tiistai;0;0;0
94;31.10.2017;2017;10;02;Tiistai;0;0;0
94;31.10.2017;2017;10;03;Tiistai;0;0;0
94;31.10.2017;2017;10;04;Tiistai;0;0;0
94;31.10.2017;2017;10;05;Tiistai;0;0;0
94;31.10.2017;2017;10;06;Tiistai;7;4;11
94;31.10.2017;2017;10;07;Tiistai;6;1;7
94;31.10.2017;2017;10;08;Tiistai;6;1;7
94;31.10.2017;2017;10;09;Tiistai;1;1;2
94;31.10.2017;2017;10;10;Tiistai;0;0;0
94;31.10.2017;2017;10;11;Tiistai;1;0;1
94;31.10.2017;2017;10;12;Tiistai;0;0;0
94;31.10.2017;2017;10;13;Tiistai;1;0;1
94;31.10.2017;2017;10;14;Tiistai;2;3;5
94;31.10.2017;2017;10;15;Tiistai;2;3;5
94;31.10.2017;2017;10;16;Tiistai;3;8;11
94;31.10.2017;2017;10;17;Tiistai;1;5;6
94;31.10.2017;2017;10;18;Tiistai;3;3;6
94;31.10.2017;2017;10;19;Tiistai;1;2;3
94;31.10.2017;2017;10;20;Tiistai;1;1;2
94;31.10.2017;2017;10;21;Tiistai;0;0;0
94;31.10.2017;2017;10;22;Tiistai;0;0;0
94;31.10.2017;2017;10;23;Tiistai;1;1;2
94;01.11.2017;2017;11;00;Keskiviikko;0;0;0
94;01.11.2017;2017;11;01;Keskiviikko;0;0;0
94;01.11.2017;2017;11;02;Keskiviikko;0;0;0
94;01.11.2017;2017;11;03;Keskiviikko;0;0;0
94;01.11.2017;2017;11;04;Keskiviikko;0;0;0
94;01.11.2017;2017;11;05;Keskiviikko;4;2;6
94;01.11.2017;2017;11;06;Keskiviikko;4;2;6
94;01.11.2017;2017;11;07;Keskiviikko;10;2;12
94;01.11.2017;2017;11;08;Keskiviikko;5;1;6
94;01.11.2017;2017;11;09;Keskiviikko;2;0;2
94;01.11.2017;2017;11;10;Keskiviikko;1;0;1
94;01.11.2017;2017;11;11;Keskiviikko;0;0;0
94;01.11.2017;2017;11;12;Keskiviikko;1;0;1
94;01.11.2017;2017;11;13;Keskiviikko;1;1;2
94;01.11.2017;2017;11;14;Keskiviikko;2;2;4
94;01.11.2017;2017;11;15;Keskiviikko;4;9;13
94;01.11.2017;2017;11;16;Keskiviikko;0;8;8
94;01.11.2017;2017;11;17;Keskiviikko;1;3;4
94;01.11.2017;2017;11;18;Keskiviikko;1;1;2
94;01.11.2017;2017;11;19;Keskiviikko;0;5;5
94;01.11.2017;2017;11;20;Keskiviikko;1;0;1
94;01.11.2017;2017;11;21;Keskiviikko;0;1;1
94;01.11.2017;2017;11;22;Keskiviikko;0;0;0
94;01.11.2017;2017;11;23;Keskiviikko;1;0;1
94;02.11.2017;2017;11;00;Torstai;0;0;0
94;02.11.2017;2017;11;01;Torstai;0;0;0
94;02.11.2017;2017;11;02;Torstai;0;0;0
94;02.11.2017;2017;11;03;Torstai;0;0;0
94;02.11.2017;2017;11;04;Torstai;0;0;0
94;02.11.2017;2017;11;05;Torstai;2;2;4
94;02.11.2017;2017;11;06;Torstai;5;2;7
94;02.11.2017;2017;11;07;Torstai;9;0;9
94;02.11.2017;2017;11;08;Torstai;2;1;3
94;02.11.2017;2017;11;09;Torstai;1;0;1
94;02.11.2017;2017;11;10;Torstai;2;0;2
94;02.11.2017;2017;11;11;Torstai;1;1;2
94;02.11.2017;2017;11;12;Torstai;2;1;3
94;02.11.2017;2017;11;13;Torstai;2;1;3
94;02.11.2017;2017;11;14;Torstai;2;1;3
94;02.11.2017;2017;11;15;Torstai;4;5;9
94;02.11.2017;2017;11;16;Torstai;1;7;8
94;02.11.2017;2017;11;17;Torstai;2;4;6
94;02.11.2017;2017;11;18;Torstai;0;5;5
94;02.11.2017;2017;11;19;Torstai;2;5;7
94;02.11.2017;2017;11;20;Torstai;0;0;0
94;02.11.2017;2017;11;21;Torstai;0;1;1
94;02.11.2017;2017;11;22;Torstai;1;0;1
94;02.11.2017;2017;11;23;Torstai;0;0;0
94;03.11.2017;2017;11;00;Perjantai;0;0;0
94;03.11.2017;2017;11;01;Perjantai;0;3;3
94;03.11.2017;2017;11;02;Perjantai;0;0;0
94;03.11.2017;2017;11;03;Perjantai;0;0;0
94;03.11.2017;2017;11;04;Perjantai;0;0;0
94;03.11.2017;2017;11;05;Perjantai;2;2;4
94;03.11.2017;2017;11;06;Perjantai;4;3;7
94;03.11.2017;2017;11;07;Perjantai;10;1;11
94;03.11.2017;2017;11;08;Perjantai;9;0;9
94;03.11.2017;2017;11;09;Perjantai;3;0;3
94;03.11.2017;2017;11;10;Perjantai;3;1;4
94;03.11.2017;2017;11;11;Perjantai;0;2;2
94;03.11.2017;2017;11;12;Perjantai;1;0;1
94;03.11.2017;2017;11;13;Perjantai;4;4;8
94;03.11.2017;2017;11;14;Perjantai;1;4;5
94;03.11.2017;2017;11;15;Perjantai;1;2;3
94;03.11.2017;2017;11;16;Perjantai;0;10;10
94;03.11.2017;2017;11;17;Perjantai;0;2;2
94;03.11.2017;2017;11;18;Perjantai;1;2;3
94;03.11.2017;2017;11;19;Perjantai;0;2;2
94;03.11.2017;2017;11;20;Perjantai;0;2;2
94;03.11.2017;2017;11;21;Perjantai;0;0;0
94;03.11.2017;2017;11;22;Perjantai;1;0;1
94;03.11.2017;2017;11;23;Perjantai;0;1;1
94;04.11.2017;2017;11;00;Lauantai;0;1;1
94;04.11.2017;2017;11;01;Lauantai;0;0;0
94;04.11.2017;2017;11;02;Lauantai;1;0;1
94;04.11.2017;2017;11;03;Lauantai;0;0;0
94;04.11.2017;2017;11;04;Lauantai;0;0;0
94;04.11.2017;2017;11;05;Lauantai;0;0;0
94;04.11.2017;2017;11;06;Lauantai;0;0;0
94;04.11.2017;2017;11;07;Lauantai;0;0;0
94;04.11.2017;2017;11;08;Lauantai;0;0;0
94;04.11.2017;2017;11;09;Lauantai;1;1;2
94;04.11.2017;2017;11;10;Lauantai;0;0;0
94;04.11.2017;2017;11;11;Lauantai;3;0;3
94;04.11.2017;2017;11;12;Lauantai;1;1;2
94;04.11.2017;2017;11;13;Lauantai;1;3;4
94;04.11.2017;2017;11;14;Lauantai;0;3;3
94;04.11.2017;2017;11;15;Lauantai;1;1;2
94;04.11.2017;2017;11;16;Lauantai;1;5;6
94;04.11.2017;2017;11;17;Lauantai;3;0;3
94;04.11.2017;2017;11;18;Lauantai;1;0;1
94;04.11.2017;2017;11;19;Lauantai;0;1;1
94;04.11.2017;2017;11;20;Lauantai;4;1;5
94;04.11.2017;2017;11;21;Lauantai;0;0;0
94;04.11.2017;2017;11;22;Lauantai;1;0;1
94;04.11.2017;2017;11;23;Lauantai;1;1;2
94;05.11.2017;2017;11;00;Sunnuntai;0;0;0
94;05.11.2017;2017;11;01;Sunnuntai;0;0;0
94;05.11.2017;2017;11;02;Sunnuntai;0;0;0
94;05.11.2017;2017;11;03;Sunnuntai;0;0;0
94;05.11.2017;2017;11;04;Sunnuntai;0;0;0
94;05.11.2017;2017;11;05;Sunnuntai;0;0;0
94;05.11.2017;2017;11;06;Sunnuntai;0;0;0
94;05.11.2017;2017;11;07;Sunnuntai;0;0;0
94;05.11.2017;2017;11;08;Sunnuntai;1;0;1
94;05.11.2017;2017;11;09;Sunnuntai;4;1;5
94;05.11.2017;2017;11;10;Sunnuntai;1;0;1
94;05.11.2017;2017;11;11;Sunnuntai;0;4;4
94;05.11.2017;2017;11;12;Sunnuntai;3;2;5
94;05.11.2017;2017;11;13;Sunnuntai;4;3;7
94;05.11.2017;2017;11;14;Sunnuntai;2;0;2
94;05.11.2017;2017;11;15;Sunnuntai;1;2;3
94;05.11.2017;2017;11;16;Sunnuntai;0;1;1
94;05.11.2017;2017;11;17;Sunnuntai;2;1;3
94;05.11.2017;2017;11;18;Sunnuntai;0;0;0
94;05.11.2017;2017;11;19;Sunnuntai;1;1;2
94;05.11.2017;2017;11;20;Sunnuntai;0;2;2
94;05.11.2017;2017;11;21;Sunnuntai;0;1;1
94;05.11.2017;2017;11;22;Sunnuntai;0;0;0
94;05.11.2017;2017;11;23;Sunnuntai;0;0;0
94;06.11.2017;2017;11;00;Maanantai;0;0;0
94;06.11.2017;2017;11;01;Maanantai;0;0;0
94;06.11.2017;2017;11;02;Maanantai;0;0;0
94;06.11.2017;2017;11;03;Maanantai;0;0;0
94;06.11.2017;2017;11;04;Maanantai;0;0;0
94;06.11.2017;2017;11;05;Maanantai;1;1;2
94;06.11.2017;2017;11;06;Maanantai;6;3;9
94;06.11.2017;2017;11;07;Maanantai;9;1;10
94;06.11.2017;2017;11;08;Maanantai;9;2;11
94;06.11.2017;2017;11;09;Maanantai;2;1;3
94;06.11.2017;2017;11;10;Maanantai;2;0;2
94;06.11.2017;2017;11;11;Maanantai;2;1;3
94;06.11.2017;2017;11;12;Maanantai;0;2;2
94;06.11.2017;2017;11;13;Maanantai;2;0;2
94;06.11.2017;2017;11;14;Maanantai;3;4;7
94;06.11.2017;2017;11;15;Maanantai;3;5;8
94;06.11.2017;2017;11;16;Maanantai;0;5;5
94;06.11.2017;2017;11;17;Maanantai;1;8;9
94;06.11.2017;2017;11;18;Maanantai;0;2;2
94;06.11.2017;2017;11;19;Maanantai;1;3;4
94;06.11.2017;2017;11;20;Maanantai;1;2;3
94;06.11.2017;2017;11;21;Maanantai;1;0;1
94;06.11.2017;2017;11;22;Maanantai;0;1;1
94;06.11.2017;2017;11;23;Maanantai;0;0;0
94;07.11.2017;2017;11;00;Tiistai;0;0;0
94;07.11.2017;2017;11;01;Tiistai;0;0;0
94;07.11.2017;2017;11;02;Tiistai;0;0;0
94;07.11.2017;2017;11;03;Tiistai;0;0;0
94;07.11.2017;2017;11;04;Tiistai;0;0;0
94;07.11.2017;2017;11;05;Tiistai;4;3;7
94;07.11.2017;2017;11;06;Tiistai;3;1;4
94;07.11.2017;2017;11;07;Tiistai;16;1;17
94;07.11.2017;2017;11;08;Tiistai;5;2;7
94;07.11.2017;2017;11;09;Tiistai;4;0;4
94;07.11.2017;2017;11;10;Tiistai;2;2;4
94;07.11.2017;2017;11;11;Tiistai;2;3;5
94;07.11.2017;2017;11;12;Tiistai;1;2;3
94;07.11.2017;2017;11;13;Tiistai;1;3;4
94;07.11.2017;2017;11;14;Tiistai;4;4;8
94;07.11.2017;2017;11;15;Tiistai;5;7;12
94;07.11.2017;2017;11;16;Tiistai;2;11;13
94;07.11.2017;2017;11;17;Tiistai;1;7;8
94;07.11.2017;2017;11;18;Tiistai;0;4;4
94;07.11.2017;2017;11;19;Tiistai;0;2;2
94;07.11.2017;2017;11;20;Tiistai;1;1;2
94;07.11.2017;2017;11;21;Tiistai;0;0;0
94;07.11.2017;2017;11;22;Tiistai;0;1;1
94;07.11.2017;2017;11;23;Tiistai;0;0;0
94;08.11.2017;2017;11;00;Keskiviikko;0;0;0
94;08.11.2017;2017;11;01;Keskiviikko;0;0;0
94;08.11.2017;2017;11;02;Keskiviikko;0;0;0
94;08.11.2017;2017;11;03;Keskiviikko;0;0;0
94;08.11.2017;2017;11;04;Keskiviikko;0;0;0
94;08.11.2017;2017;11;05;Keskiviikko;2;2;4
94;08.11.2017;2017;11;06;Keskiviikko;4;3;7
94;08.11.2017;2017;11;07;Keskiviikko;12;1;13
94;08.11.2017;2017;11;08;Keskiviikko;9;0;9
94;08.11.2017;2017;11;09;Keskiviikko;4;1;5
94;08.11.2017;2017;11;10;Keskiviikko;0;0;0
94;08.11.2017;2017;11;11;Keskiviikko;4;0;4
94;08.11.2017;2017;11;12;Keskiviikko;1;0;1
94;08.11.2017;2017;11;13;Keskiviikko;4;4;8
94;08.11.2017;2017;11;14;Keskiviikko;1;2;3
94;08.11.2017;2017;11;15;Keskiviikko;6;8;14
94;08.11.2017;2017;11;16;Keskiviikko;2;6;8
94;08.11.2017;2017;11;17;Keskiviikko;1;7;8
94;08.11.2017;2017;11;18;Keskiviikko;0;4;4
94;08.11.2017;2017;11;19;Keskiviikko;0;2;2
94;08.11.2017;2017;11;20;Keskiviikko;1;1;2
94;08.11.2017;2017;11;21;Keskiviikko;0;2;2
94;08.11.2017;2017;11;22;Keskiviikko;0;0;0
94;08.11.2017;2017;11;23;Keskiviikko;0;2;2
94;09.11.2017;2017;11;00;Torstai;0;0;0
94;09.11.2017;2017;11;01;Torstai;1;0;1
94;09.11.2017;2017;11;02;Torstai;0;0;0
94;09.11.2017;2017;11;03;Torstai;0;0;0
94;09.11.2017;2017;11;04;Torstai;0;0;0
94;09.11.2017;2017;11;05;Torstai;2;2;4
94;09.11.2017;2017;11;06;Torstai;7;2;9
94;09.11.2017;2017;11;07;Torstai;12;2;14
94;09.11.2017;2017;11;08;Torstai;6;0;6
94;09.11.2017;2017;11;09;Torstai;1;3;4
94;09.11.2017;2017;11;10;Torstai;1;3;4
94;09.11.2017;2017;11;11;Torstai;2;0;2
94;09.11.2017;2017;11;12;Torstai;4;0;4
94;09.11.2017;2017;11;13;Torstai;1;1;2
94;09.11.2017;2017;11;14;Torstai;2;2;4
94;09.11.2017;2017;11;15;Torstai;5;7;12
94;09.11.2017;2017;11;16;Torstai;1;12;13
94;09.11.2017;2017;11;17;Torstai;3;7;10
94;09.11.2017;2017;11;18;Torstai;1;4;5
94;09.11.2017;2017;11;19;Torstai;0;2;2
94;09.11.2017;2017;11;20;Torstai;1;0;1
94;09.11.2017;2017;11;21;Torstai;0;0;0
94;09.11.2017;2017;11;22;Torstai;0;0;0
94;09.11.2017;2017;11;23;Torstai;0;0;0
94;10.11.2017;2017;11;00;Perjantai;0;0;0
94;10.11.2017;2017;11;01;Perjantai;0;0;0
94;10.11.2017;2017;11;02;Perjantai;0;0;0
94;10.11.2017;2017;11;03;Perjantai;0;0;0
94;10.11.2017;2017;11;04;Perjantai;0;1;1
94;10.11.2017;2017;11;05;Perjantai;2;2;4
94;10.11.2017;2017;11;06;Perjantai;3;2;5
94;10.11.2017;2017;11;07;Perjantai;7;1;8
94;10.11.2017;2017;11;08;Perjantai;5;0;5
94;10.11.2017;2017;11;09;Perjantai;2;1;3
94;10.11.2017;2017;11;10;Perjantai;5;2;7
94;10.11.2017;2017;11;11;Perjantai;4;1;5
94;10.11.2017;2017;11;12;Perjantai;2;3;5
94;10.11.2017;2017;11;13;Perjantai;0;4;4
94;10.11.2017;2017;11;14;Perjantai;4;2;6
94;10.11.2017;2017;11;15;Perjantai;3;5;8
94;10.11.2017;2017;11;16;Perjantai;2;7;9
94;10.11.2017;2017;11;17;Perjantai;0;3;3
94;10.11.2017;2017;11;18;Perjantai;1;5;6
94;10.11.2017;2017;11;19;Perjantai;0;3;3
94;10.11.2017;2017;11;20;Perjantai;3;1;4
94;10.11.2017;2017;11;21;Perjantai;0;1;1
94;10.11.2017;2017;11;22;Perjantai;1;0;1
94;10.11.2017;2017;11;23;Perjantai;0;0;0
94;11.11.2017;2017;11;00;Lauantai;0;0;0
94;11.11.2017;2017;11;01;Lauantai;0;0;0
94;11.11.2017;2017;11;02;Lauantai;0;0;0
94;11.11.2017;2017;11;03;Lauantai;0;0;0
94;11.11.2017;2017;11;04;Lauantai;0;0;0
94;11.11.2017;2017;11;05;Lauantai;0;0;0
94;11.11.2017;2017;11;06;Lauantai;0;1;1
94;11.11.2017;2017;11;07;Lauantai;1;0;1
94;11.11.2017;2017;11;08;Lauantai;0;0;0
94;11.11.2017;2017;11;09;Lauantai;3;4;7
94;11.11.2017;2017;11;10;Lauantai;0;2;2
94;11.11.2017;2017;11;11;Lauantai;4;0;4
94;11.11.2017;2017;11;12;Lauantai;1;2;3
94;11.11.2017;2017;11;13;Lauantai;2;2;4
94;11.11.2017;2017;11;14;Lauantai;1;3;4
94;11.11.2017;2017;11;15;Lauantai;3;6;9
94;11.11.2017;2017;11;16;Lauantai;4;0;4
94;11.11.2017;2017;11;17;Lauantai;2;3;5
94;11.11.2017;2017;11;18;Lauantai;0;1;1
94;11.11.2017;2017;11;19;Lauantai;3;2;5
94;11.11.2017;2017;11;20;Lauantai;0;1;1
94;11.11.2017;2017;11;21;Lauantai;0;1;1
94;11.11.2017;2017;11;22;Lauantai;1;0;1
94;11.11.2017;2017;11;23;Lauantai;0;0;0
94;12.11.2017;2017;11;00;Sunnuntai;0;0;0
94;12.11.2017;2017;11;01;Sunnuntai;0;0;0
94;12.11.2017;2017;11;02;Sunnuntai;0;0;0
94;12.11.2017;2017;11;03;Sunnuntai;0;0;0
94;12.11.2017;2017;11;04;Sunnuntai;0;0;0
94;12.11.2017;2017;11;05;Sunnuntai;0;0;0
94;12.11.2017;2017;11;06;Sunnuntai;0;0;0
94;12.11.2017;2017;11;07;Sunnuntai;0;0;0
94;12.11.2017;2017;11;08;Sunnuntai;0;0;0
94;12.11.2017;2017;11;09;Sunnuntai;1;0;1
94;12.11.2017;2017;11;10;Sunnuntai;2;2;4
94;12.11.2017;2017;11;11;Sunnuntai;3;4;7
94;12.11.2017;2017;11;12;Sunnuntai;1;1;2
94;12.11.2017;2017;11;13;Sunnuntai;2;2;4
94;12.11.2017;2017;11;14;Sunnuntai;0;2;2
94;12.11.2017;2017;11;15;Sunnuntai;0;1;1
94;12.11.2017;2017;11;16;Sunnuntai;0;2;2
94;12.11.2017;2017;11;17;Sunnuntai;5;1;6
94;12.11.2017;2017;11;18;Sunnuntai;0;2;2
94;12.11.2017;2017;11;19;Sunnuntai;3;0;3
94;12.11.2017;2017;11;20;Sunnuntai;0;1;1
94;12.11.2017;2017;11;21;Sunnuntai;0;2;2
94;12.11.2017;2017;11;22;Sunnuntai;0;0;0
94;12.11.2017;2017;11;23;Sunnuntai;0;0;0
94;13.11.2017;2017;11;00;Maanantai;0;0;0
94;13.11.2017;2017;11;01;Maanantai;0;0;0
94;13.11.2017;2017;11;02;Maanantai;0;0;0
94;13.11.2017;2017;11;03;Maanantai;0;0;0
94;13.11.2017;2017;11;04;Maanantai;0;2;2
94;13.11.2017;2017;11;05;Maanantai;3;0;3
94;13.11.2017;2017;11;06;Maanantai;7;3;10
94;13.11.2017;2017;11;07;Maanantai;11;1;12
94;13.11.2017;2017;11;08;Maanantai;11;2;13
94;13.11.2017;2017;11;09;Maanantai;0;1;1
94;13.11.2017;2017;11;10;Maanantai;1;0;1
94;13.11.2017;2017;11;11;Maanantai;1;2;3
94;13.11.2017;2017;11;12;Maanantai;2;0;2
94;13.11.2017;2017;11;13;Maanantai;2;0;2
94;13.11.2017;2017;11;14;Maanantai;1;4;5
94;13.11.2017;2017;11;15;Maanantai;4;7;11
94;13.11.2017;2017;11;16;Maanantai;4;14;18
94;13.11.2017;2017;11;17;Maanantai;1;5;6
94;13.11.2017;2017;11;18;Maanantai;1;7;8
94;13.11.2017;2017;11;19;Maanantai;4;3;7
94;13.11.2017;2017;11;20;Maanantai;1;2;3
94;13.11.2017;2017;11;21;Maanantai;1;1;2
94;13.11.2017;2017;11;22;Maanantai;1;2;3
94;13.11.2017;2017;11;23;Maanantai;0;0;0
94;14.11.2017;2017;11;00;Tiistai;0;0;0
94;14.11.2017;2017;11;01;Tiistai;0;0;0
94;14.11.2017;2017;11;02;Tiistai;0;0;0
94;14.11.2017;2017;11;03;Tiistai;0;0;0
94;14.11.2017;2017;11;04;Tiistai;0;0;0
94;14.11.2017;2017;11;05;Tiistai;2;2;4
94;14.11.2017;2017;11;06;Tiistai;11;3;14
94;14.11.2017;2017;11;07;Tiistai;14;1;15
94;14.11.2017;2017;11;08;Tiistai;5;1;6
94;14.11.2017;2017;11;09;Tiistai;2;1;3
94;14.11.2017;2017;11;10;Tiistai;2;0;2
94;14.11.2017;2017;11;11;Tiistai;2;2;4
94;14.11.2017;2017;11;12;Tiistai;1;0;1
94;14.11.2017;2017;11;13;Tiistai;1;0;1
94;14.11.2017;2017;11;14;Tiistai;4;1;5
94;14.11.2017;2017;11;15;Tiistai;5;13;18
94;14.11.2017;2017;11;16;Tiistai;1;13;14
94;14.11.2017;2017;11;17;Tiistai;2;6;8
94;14.11.2017;2017;11;18;Tiistai;1;6;7
94;14.11.2017;2017;11;19;Tiistai;0;2;2
94;14.11.2017;2017;11;20;Tiistai;1;1;2
94;14.11.2017;2017;11;21;Tiistai;1;0;1
94;14.11.2017;2017;11;22;Tiistai;0;0;0
94;14.11.2017;2017;11;23;Tiistai;0;0;0
94;15.11.2017;2017;11;00;Keskiviikko;0;0;0
94;15.11.2017;2017;11;01;Keskiviikko;0;0;0
94;15.11.2017;2017;11;02;Keskiviikko;0;0;0
94;15.11.2017;2017;11;03;Keskiviikko;0;0;0
94;15.11.2017;2017;11;04;Keskiviikko;0;0;0
94;15.11.2017;2017;11;05;Keskiviikko;2;2;4
94;15.11.2017;2017;11;06;Keskiviikko;4;3;7
94;15.11.2017;2017;11;07;Keskiviikko;12;1;13
94;15.11.2017;2017;11;08;Keskiviikko;9;0;9
94;15.11.2017;2017;11;09;Keskiviikko;4;1;5
94;15.11.2017;2017;11;10;Keskiviikko;0;0;0
94;15.11.2017;2017;11;11;Keskiviikko;4;0;4
94;15.11.2017;2017;11;12;Keskiviikko;1;0;1
94;15.11.2017;2017;11;13;Keskiviikko;4;4;8
94;15.11.2017;2017;11;14;Keskiviikko;1;2;3
94;15.11.2017;2017;11;15;Keskiviikko;6;8;14
94;15.11.2017;2017;11;16;Keskiviikko;2;6;8
94;15.11.2017;2017;11;17;Keskiviikko;1;7;8
94;15.11.2017;2017;11;18;Keskiviikko;0;4;4
94;15.11.2017;2017;11;19;Keskiviikko;0;2;2
94;15.11.2017;2017;11;20;Keskiviikko;1;1;2
94;15.11.2017;2017;11;21;Keskiviikko;0;2;2
94;15.11.2017;2017;11;22;Keskiviikko;0;0;0
94;15.11.2017;2017;11;23;Keskiviikko;0;2;2
94;16.11.2017;2017;11;00;Torstai;0;0;0
94;16.11.2017;2017;11;01;Torstai;1;0;1
94;16.11.2017;2017;11;02;Torstai;0;0;0
94;16.11.2017;2017;11;03;Torstai;0;0;0
94;16.11.2017;2017;11;04;Torstai;0;0;0
94;16.11.2017;2017;11;05;Torstai;2;2;4
94;16.11.2017;2017;11;06;Torstai;7;2;9
94;16.11.2017;2017;11;07;Torstai;12;2;14
94;16.11.2017;2017;11;08;Torstai;6;0;6
94;16.11.2017;2017;11;09;Torstai;1;3;4
94;16.11.2017;2017;11;10;Torstai;1;3;4
94;16.11.2017;2017;11;11;Torstai;2;0;2
94;16.11.2017;2017;11;12;Torstai;4;0;4
94;16.11.2017;2017;11;13;Torstai;1;1;2
94;16.11.2017;2017;11;14;Torstai;2;2;4
94;16.11.2017;2017;11;15;Torstai;5;7;12
94;16.11.2017;2017;11;16;Torstai;1;12;13
94;16.11.2017;2017;11;17;Torstai;3;7;10
94;16.11.2017;2017;11;18;Torstai;1;4;5
94;16.11.2017;2017;11;19;Torstai;0;2;2
94;16.11.2017;2017;11;20;Torstai;1;0;1
94;16.11.2017;2017;11;21;Torstai;0;0;0
94;16.11.2017;2017;11;22;Torstai;0;0;0
94;16.11.2017;2017;11;23;Torstai;0;0;0
94;17.11.2017;2017;11;00;Perjantai;0;0;0
94;17.11.2017;2017;11;01;Perjantai;0;0;0
94;17.11.2017;2017;11;02;Perjantai;0;0;0
94;17.11.2017;2017;11;03;Perjantai;0;0;0
94;17.11.2017;2017;11;04;Perjantai;0;0;0
94;17.11.2017;2017;11;05;Perjantai;3;2;5
94;17.11.2017;2017;11;06;Perjantai;5;1;6
94;17.11.2017;2017;11;07;Perjantai;12;1;13
94;17.11.2017;2017;11;08;Perjantai;3;1;4
94;17.11.2017;2017;11;09;Perjantai;2;1;3
94;17.11.2017;2017;11;10;Perjantai;0;0;0
94;17.11.2017;2017;11;11;Perjantai;0;2;2
94;17.11.2017;2017;11;12;Perjantai;3;0;3
94;17.11.2017;2017;11;13;Perjantai;3;3;6
94;17.11.2017;2017;11;14;Perjantai;3;3;6
94;17.11.2017;2017;11;15;Perjantai;0;6;6
94;17.11.2017;2017;11;16;Perjantai;0;11;11
94;17.11.2017;2017;11;17;Perjantai;1;5;6
94;17.11.2017;2017;11;18;Perjantai;0;2;2
94;17.11.2017;2017;11;19;Perjantai;0;2;2
94;17.11.2017;2017;11;20;Perjantai;0;2;2
94;17.11.2017;2017;11;21;Perjantai;0;0;0
94;17.11.2017;2017;11;22;Perjantai;1;0;1
94;17.11.2017;2017;11;23;Perjantai;0;0;0
94;18.11.2017;2017;11;00;Lauantai;1;0;1
94;18.11.2017;2017;11;01;Lauantai;0;0;0
94;18.11.2017;2017;11;02;Lauantai;0;0;0
94;18.11.2017;2017;11;03;Lauantai;0;0;0
94;18.11.2017;2017;11;04;Lauantai;0;0;0
94;18.11.2017;2017;11;05;Lauantai;0;0;0
94;18.11.2017;2017;11;06;Lauantai;2;0;2
94;18.11.2017;2017;11;07;Lauantai;0;2;2
94;18.11.2017;2017;11;08;Lauantai;0;0;0
94;18.11.2017;2017;11;09;Lauantai;1;2;3
94;18.11.2017;2017;11;10;Lauantai;2;3;5
94;18.11.2017;2017;11;11;Lauantai;1;5;6
94;18.11.2017;2017;11;12;Lauantai;3;0;3
94;18.11.2017;2017;11;13;Lauantai;1;3;4
94;18.11.2017;2017;11;14;Lauantai;2;0;2
94;18.11.2017;2017;11;15;Lauantai;0;3;3
94;18.11.2017;2017;11;16;Lauantai;0;2;2
94;18.11.2017;2017;11;17;Lauantai;2;1;3
94;18.11.2017;2017;11;18;Lauantai;1;1;2
94;18.11.2017;2017;11;19;Lauantai;1;2;3
94;18.11.2017;2017;11;20;Lauantai;0;2;2
94;18.11.2017;2017;11;21;Lauantai;0;1;1
94;18.11.2017;2017;11;22;Lauantai;1;0;1
94;18.11.2017;2017;11;23;Lauantai;0;2;2
94;19.11.2017;2017;11;00;Sunnuntai;0;0;0
94;19.11.2017;2017;11;01;Sunnuntai;0;0;0
94;19.11.2017;2017;11;02;Sunnuntai;0;0;0
94;19.11.2017;2017;11;03;Sunnuntai;0;0;0
94;19.11.2017;2017;11;04;Sunnuntai;0;0;0
94;19.11.2017;2017;11;05;Sunnuntai;0;0;0
94;19.11.2017;2017;11;06;Sunnuntai;1;0;1
94;19.11.2017;2017;11;07;Sunnuntai;0;0;0
94;19.11.2017;2017;11;08;Sunnuntai;1;1;2
94;19.11.2017;2017;11;09;Sunnuntai;2;1;3
94;19.11.2017;2017;11;10;Sunnuntai;2;3;5
94;19.11.2017;2017;11;11;Sunnuntai;1;1;2
94;19.11.2017;2017;11;12;Sunnuntai;1;2;3
94;19.11.2017;2017;11;13;Sunnuntai;1;0;1
94;19.11.2017;2017;11;14;Sunnuntai;0;3;3
94;19.11.2017;2017;11;15;Sunnuntai;0;2;2
94;19.11.2017;2017;11;16;Sunnuntai;2;1;3
94;19.11.2017;2017;11;17;Sunnuntai;3;3;6
94;19.11.2017;2017;11;18;Sunnuntai;0;1;1
94;19.11.2017;2017;11;19;Sunnuntai;1;3;4
94;19.11.2017;2017;11;20;Sunnuntai;3;1;4
94;19.11.2017;2017;11;21;Sunnuntai;1;0;1
94;19.11.2017;2017;11;22;Sunnuntai;1;0;1
94;19.11.2017;2017;11;23;Sunnuntai;0;0;0
94;20.11.2017;2017;11;00;Maanantai;0;0;0
94;20.11.2017;2017;11;01;Maanantai;0;0;0
94;20.11.2017;2017;11;02;Maanantai;0;0;0
94;20.11.2017;2017;11;03;Maanantai;0;0;0
94;20.11.2017;2017;11;04;Maanantai;0;0;0
94;20.11.2017;2017;11;05;Maanantai;4;2;6
94;20.11.2017;2017;11;06;Maanantai;9;2;11
94;20.11.2017;2017;11;07;Maanantai;7;0;7
94;20.11.2017;2017;11;08;Maanantai;9;0;9
94;20.11.2017;2017;11;09;Maanantai;1;1;2
94;20.11.2017;2017;11;10;Maanantai;2;1;3
94;20.11.2017;2017;11;11;Maanantai;0;1;1
94;20.11.2017;2017;11;12;Maanantai;1;1;2
94;20.11.2017;2017;11;13;Maanantai;1;3;4
94;20.11.2017;2017;11;14;Maanantai;1;12;13
94;20.11.2017;2017;11;15;Maanantai;2;6;8
94;20.11.2017;2017;11;16;Maanantai;0;9;9
94;20.11.2017;2017;11;17;Maanantai;0;3;3
94;20.11.2017;2017;11;18;Maanantai;3;4;7
94;20.11.2017;2017;11;19;Maanantai;1;3;4
94;20.11.2017;2017;11;20;Maanantai;1;0;1
94;20.11.2017;2017;11;21;Maanantai;0;0;0
94;20.11.2017;2017;11;22;Maanantai;0;1;1
94;20.11.2017;2017;11;23;Maanantai;0;1;1
94;21.11.2017;2017;11;00;Tiistai;0;0;0
94;21.11.2017;2017;11;01;Tiistai;0;0;0
94;21.11.2017;2017;11;02;Tiistai;0;0;0
94;21.11.2017;2017;11;03;Tiistai;0;0;0
94;21.11.2017;2017;11;04;Tiistai;0;0;0
94;21.11.2017;2017;11;05;Tiistai;3;2;5
94;21.11.2017;2017;11;06;Tiistai;5;1;6
94;21.11.2017;2017;11;07;Tiistai;14;1;15
94;21.11.2017;2017;11;08;Tiistai;6;1;7
94;21.11.2017;2017;11;09;Tiistai;0;1;1
94;21.11.2017;2017;11;10;Tiistai;3;1;4
94;21.11.2017;2017;11;11;Tiistai;3;0;3
94;21.11.2017;2017;11;12;Tiistai;1;1;2
94;21.11.2017;2017;11;13;Tiistai;2;3;5
94;21.11.2017;2017;11;14;Tiistai;1;3;4
94;21.11.2017;2017;11;15;Tiistai;2;7;9
94;21.11.2017;2017;11;16;Tiistai;2;7;9
94;21.11.2017;2017;11;17;Tiistai;0;7;7
94;21.11.2017;2017;11;18;Tiistai;1;3;4
94;21.11.2017;2017;11;19;Tiistai;1;3;4
94;21.11.2017;2017;11;20;Tiistai;2;1;3
94;21.11.2017;2017;11;21;Tiistai;0;0;0
94;21.11.2017;2017;11;22;Tiistai;0;0;0
94;21.11.2017;2017;11;23;Tiistai;0;1;1
94;22.11.2017;2017;11;00;Keskiviikko;0;0;0
94;22.11.2017;2017;11;01;Keskiviikko;0;0;0
94;22.11.2017;2017;11;02;Keskiviikko;0;0;0
94;22.11.2017;2017;11;03;Keskiviikko;1;0;1
94;22.11.2017;2017;11;04;Keskiviikko;0;0;0
94;22.11.2017;2017;11;05;Keskiviikko;3;2;5
94;22.11.2017;2017;11;06;Keskiviikko;2;2;4
94;22.11.2017;2017;11;07;Keskiviikko;14;1;15
94;22.11.2017;2017;11;08;Keskiviikko;10;0;10
94;22.11.2017;2017;11;09;Keskiviikko;0;2;2
94;22.11.2017;2017;11;10;Keskiviikko;2;0;2
94;22.11.2017;2017;11;11;Keskiviikko;3;0;3
94;22.11.2017;2017;11;12;Keskiviikko;1;1;2
94;22.11.2017;2017;11;13;Keskiviikko;1;1;2
94;22.11.2017;2017;11;14;Keskiviikko;2;0;2
94;22.11.2017;2017;11;15;Keskiviikko;2;4;6
94;22.11.2017;2017;11;16;Keskiviikko;1;10;11
94;22.11.2017;2017;11;17;Keskiviikko;0;4;4
94;22.11.2017;2017;11;18;Keskiviikko;0;3;3
94;22.11.2017;2017;11;19;Keskiviikko;0;3;3
94;22.11.2017;2017;11;20;Keskiviikko;1;1;2
94;22.11.2017;2017;11;21;Keskiviikko;0;1;1
94;22.11.2017;2017;11;22;Keskiviikko;0;0;0
94;22.11.2017;2017;11;23;Keskiviikko;0;0;0
94;23.11.2017;2017;11;00;Torstai;0;2;2
94;23.11.2017;2017;11;01;Torstai;0;0;0
94;23.11.2017;2017;11;02;Torstai;0;0;0
94;23.11.2017;2017;11;03;Torstai;0;0;0
94;23.11.2017;2017;11;04;Torstai;0;0;0
94;23.11.2017;2017;11;05;Torstai;5;2;7
94;23.11.2017;2017;11;06;Torstai;3;1;4
94;23.11.2017;2017;11;07;Torstai;9;0;9
94;23.11.2017;2017;11;08;Torstai;7;0;7
94;23.11.2017;2017;11;09;Torstai;0;1;1
94;23.11.2017;2017;11;10;Torstai;0;0;0
94;23.11.2017;2017;11;11;Torstai;2;0;2
94;23.11.2017;2017;11;12;Torstai;1;1;2
94;23.11.2017;2017;11;13;Torstai;0;2;2
94;23.11.2017;2017;11;14;Torstai;1;4;5
94;23.11.2017;2017;11;15;Torstai;2;5;7
94;23.11.2017;2017;11;16;Torstai;0;9;9
94;23.11.2017;2017;11;17;Torstai;1;4;5
94;23.11.2017;2017;11;18;Torstai;0;1;1
94;23.11.2017;2017;11;19;Torstai;0;2;2
94;23.11.2017;2017;11;20;Torstai;0;0;0
94;23.11.2017;2017;11;21;Torstai;1;0;1
94;23.11.2017;2017;11;22;Torstai;0;0;0
94;23.11.2017;2017;11;23;Torstai;0;1;1
94;24.11.2017;2017;11;00;Perjantai;0;0;0
94;24.11.2017;2017;11;01;Perjantai;0;0;0
94;24.11.2017;2017;11;02;Perjantai;0;0;0
94;24.11.2017;2017;11;03;Perjantai;0;0;0
94;24.11.2017;2017;11;04;Perjantai;1;0;1
94;24.11.2017;2017;11;05;Perjantai;9;0;9
94;24.11.2017;2017;11;06;Perjantai;1;0;1
94;24.11.2017;2017;11;07;Perjantai;7;0;7
94;24.11.2017;2017;11;08;Perjantai;2;0;2
94;24.11.2017;2017;11;09;Perjantai;1;0;1
94;24.11.2017;2017;11;10;Perjantai;0;0;0
94;24.11.2017;2017;11;11;Perjantai;1;0;1
94;24.11.2017;2017;11;12;Perjantai;2;0;2
94;24.11.2017;2017;11;13;Perjantai;0;2;2
94;24.11.2017;2017;11;14;Perjantai;1;3;4
94;24.11.2017;2017;11;15;Perjantai;0;6;6
94;24.11.2017;2017;11;16;Perjantai;0;5;5
94;24.11.2017;2017;11;17;Perjantai;1;1;2
94;24.11.2017;2017;11;18;Perjantai;0;0;0
94;24.11.2017;2017;11;19;Perjantai;0;1;1
94;24.11.2017;2017;11;20;Perjantai;1;1;2
94;24.11.2017;2017;11;21;Perjantai;0;0;0
94;24.11.2017;2017;11;22;Perjantai;0;0;0
94;24.11.2017;2017;11;23;Perjantai;0;5;5
94;25.11.2017;2017;11;00;Lauantai;0;1;1
94;25.11.2017;2017;11;01;Lauantai;1;0;1
94;25.11.2017;2017;11;02;Lauantai;0;0;0
94;25.11.2017;2017;11;03;Lauantai;0;0;0
94;25.11.2017;2017;11;04;Lauantai;0;0;0
94;25.11.2017;2017;11;05;Lauantai;0;0;0
94;25.11.2017;2017;11;06;Lauantai;0;0;0
94;25.11.2017;2017;11;07;Lauantai;0;0;0
94;25.11.2017;2017;11;08;Lauantai;0;0;0
94;25.11.2017;2017;11;09;Lauantai;1;0;1
94;25.11.2017;2017;11;10;Lauantai;1;1;2
94;25.11.2017;2017;11;11;Lauantai;3;4;7
94;25.11.2017;2017;11;12;Lauantai;0;1;1
94;25.11.2017;2017;11;13;Lauantai;2;0;2
94;25.11.2017;2017;11;14;Lauantai;0;0;0
94;25.11.2017;2017;11;15;Lauantai;0;0;0
94;25.11.2017;2017;11;16;Lauantai;0;2;2
94;25.11.2017;2017;11;17;Lauantai;1;1;2
94;25.11.2017;2017;11;18;Lauantai;0;2;2
94;25.11.2017;2017;11;19;Lauantai;0;1;1
94;25.11.2017;2017;11;20;Lauantai;0;0;0
94;25.11.2017;2017;11;21;Lauantai;0;0;0
94;25.11.2017;2017;11;22;Lauantai;0;0;0
94;25.11.2017;2017;11;23;Lauantai;0;1;1
94;26.11.2017;2017;11;00;Sunnuntai;0;0;0
94;26.11.2017;2017;11;01;Sunnuntai;1;0;1
94;26.11.2017;2017;11;02;Sunnuntai;0;0;0
94;26.11.2017;2017;11;03;Sunnuntai;0;0;0
94;26.11.2017;2017;11;04;Sunnuntai;0;0;0
94;26.11.2017;2017;11;05;Sunnuntai;0;0;0
94;26.11.2017;2017;11;06;Sunnuntai;0;0;0
94;26.11.2017;2017;11;07;Sunnuntai;0;0;0
94;26.11.2017;2017;11;08;Sunnuntai;1;0;1
94;26.11.2017;2017;11;09;Sunnuntai;0;1;1
94;26.11.2017;2017;11;10;Sunnuntai;0;0;0
94;26.11.2017;2017;11;11;Sunnuntai;0;0;0
94;26.11.2017;2017;11;12;Sunnuntai;2;2;4
94;26.11.2017;2017;11;13;Sunnuntai;2;2;4
94;26.11.2017;2017;11;14;Sunnuntai;1;2;3
94;26.11.2017;2017;11;15;Sunnuntai;0;2;2
94;26.11.2017;2017;11;16;Sunnuntai;2;1;3
94;26.11.2017;2017;11;17;Sunnuntai;3;1;4
94;26.11.2017;2017;11;18;Sunnuntai;0;2;2
94;26.11.2017;2017;11;19;Sunnuntai;0;1;1
94;26.11.2017;2017;11;20;Sunnuntai;2;0;2
94;26.11.2017;2017;11;21;Sunnuntai;1;1;2
94;26.11.2017;2017;11;22;Sunnuntai;0;1;1
94;26.11.2017;2017;11;23;Sunnuntai;0;0;0
94;27.11.2017;2017;11;00;Maanantai;0;0;0
94;27.11.2017;2017;11;01;Maanantai;0;2;2
94;27.11.2017;2017;11;02;Maanantai;0;0;0
94;27.11.2017;2017;11;03;Maanantai;0;0;0
94;27.11.2017;2017;11;04;Maanantai;0;0;0
94;27.11.2017;2017;11;05;Maanantai;5;2;7
94;27.11.2017;2017;11;06;Maanantai;6;4;10
94;27.11.2017;2017;11;07;Maanantai;10;1;11
94;27.11.2017;2017;11;08;Maanantai;10;0;10
94;27.11.2017;2017;11;09;Maanantai;2;0;2
94;27.11.2017;2017;11;10;Maanantai;0;0;0
94;27.11.2017;2017;11;11;Maanantai;0;1;1
94;27.11.2017;2017;11;12;Maanantai;1;0;1
94;27.11.2017;2017;11;13;Maanantai;3;2;5
94;27.11.2017;2017;11;14;Maanantai;1;7;8
94;27.11.2017;2017;11;15;Maanantai;3;9;12
94;27.11.2017;2017;11;16;Maanantai;1;10;11
94;27.11.2017;2017;11;17;Maanantai;1;8;9
94;27.11.2017;2017;11;18;Maanantai;0;2;2
94;27.11.2017;2017;11;19;Maanantai;1;1;2
94;27.11.2017;2017;11;20;Maanantai;1;1;2
94;27.11.2017;2017;11;21;Maanantai;0;0;0
94;27.11.2017;2017;11;22;Maanantai;0;1;1
94;27.11.2017;2017;11;23;Maanantai;0;0;0
94;28.11.2017;2017;11;00;Tiistai;0;0;0
94;28.11.2017;2017;11;01;Tiistai;0;0;0
94;28.11.2017;2017;11;02;Tiistai;1;0;1
94;28.11.2017;2017;11;03;Tiistai;0;0;0
94;28.11.2017;2017;11;04;Tiistai;0;0;0
94;28.11.2017;2017;11;05;Tiistai;4;1;5
94;28.11.2017;2017;11;06;Tiistai;8;1;9
94;28.11.2017;2017;11;07;Tiistai;12;0;12
94;28.11.2017;2017;11;08;Tiistai;5;2;7
94;28.11.2017;2017;11;09;Tiistai;4;0;4
94;28.11.2017;2017;11;10;Tiistai;1;1;2
94;28.11.2017;2017;11;11;Tiistai;0;0;0
94;28.11.2017;2017;11;12;Tiistai;2;1;3
94;28.11.2017;2017;11;13;Tiistai;0;1;1
94;28.11.2017;2017;11;14;Tiistai;1;5;6
94;28.11.2017;2017;11;15;Tiistai;0;11;11
94;28.11.2017;2017;11;16;Tiistai;1;7;8
94;28.11.2017;2017;11;17;Tiistai;0;7;7
94;28.11.2017;2017;11;18;Tiistai;0;2;2
94;28.11.2017;2017;11;19;Tiistai;0;3;3
94;28.11.2017;2017;11;20;Tiistai;1;1;2
94;28.11.2017;2017;11;21;Tiistai;0;0;0
94;28.11.2017;2017;11;22;Tiistai;0;1;1
94;28.11.2017;2017;11;23;Tiistai;0;0;0
94;29.11.2017;2017;11;00;Keskiviikko;0;0;0
94;29.11.2017;2017;11;01;Keskiviikko;0;0;0
94;29.11.2017;2017;11;02;Keskiviikko;0;0;0
94;29.11.2017;2017;11;03;Keskiviikko;0;0;0
94;29.11.2017;2017;11;04;Keskiviikko;0;0;0
94;29.11.2017;2017;11;05;Keskiviikko;5;2;7
94;29.11.2017;2017;11;06;Keskiviikko;8;1;9
94;29.11.2017;2017;11;07;Keskiviikko;10;1;11
94;29.11.2017;2017;11;08;Keskiviikko;6;0;6
94;29.11.2017;2017;11;09;Keskiviikko;1;1;2
94;29.11.2017;2017;11;10;Keskiviikko;3;1;4
94;29.11.2017;2017;11;11;Keskiviikko;0;2;2
94;29.11.2017;2017;11;12;Keskiviikko;3;2;5
94;29.11.2017;2017;11;13;Keskiviikko;3;1;4
94;29.11.2017;2017;11;14;Keskiviikko;3;3;6
94;29.11.2017;2017;11;15;Keskiviikko;1;9;10
94;29.11.2017;2017;11;16;Keskiviikko;1;11;12
94;29.11.2017;2017;11;17;Keskiviikko;2;3;5
94;29.11.2017;2017;11;18;Keskiviikko;1;1;2
94;29.11.2017;2017;11;19;Keskiviikko;0;2;2
94;29.11.2017;2017;11;20;Keskiviikko;1;3;4
94;29.11.2017;2017;11;21;Keskiviikko;0;5;5
94;29.11.2017;2017;11;22;Keskiviikko;0;0;0
94;29.11.2017;2017;11;23;Keskiviikko;0;0;0
94;30.11.2017;2017;11;00;Torstai;0;0;0
94;30.11.2017;2017;11;01;Torstai;0;0;0
94;30.11.2017;2017;11;02;Torstai;0;0;0
94;30.11.2017;2017;11;03;Torstai;0;0;0
94;30.11.2017;2017;11;04;Torstai;0;0;0
94;30.11.2017;2017;11;05;Torstai;4;3;7
94;30.11.2017;2017;11;06;Torstai;4;0;4
94;30.11.2017;2017;11;07;Torstai;13;0;13
94;30.11.2017;2017;11;08;Torstai;8;0;8
94;30.11.2017;2017;11;09;Torstai;0;0;0
94;30.11.2017;2017;11;10;Torstai;0;0;0
94;30.11.2017;2017;11;11;Torstai;1;1;2
94;30.11.2017;2017;11;12;Torstai;1;0;1
94;30.11.2017;2017;11;13;Torstai;1;7;8
94;30.11.2017;2017;11;14;Torstai;1;4;5
94;30.11.2017;2017;11;15;Torstai;3;6;9
94;30.11.2017;2017;11;16;Torstai;1;12;13
94;30.11.2017;2017;11;17;Torstai;1;10;11
94;30.11.2017;2017;11;18;Torstai;2;6;8
94;30.11.2017;2017;11;19;Torstai;2;0;2
94;30.11.2017;2017;11;20;Torstai;0;0;0
94;30.11.2017;2017;11;21;Torstai;1;0;1
94;30.11.2017;2017;11;22;Torstai;0;1;1
94;30.11.2017;2017;11;23;Torstai;0;0;0
94;01.12.2017;2017;12;00;Perjantai;0;0;0
94;01.12.2017;2017;12;01;Perjantai;0;0;0
94;01.12.2017;2017;12;02;Perjantai;0;0;0
94;01.12.2017;2017;12;03;Perjantai;0;0;0
94;01.12.2017;2017;12;04;Perjantai;0;0;0
94;01.12.2017;2017;12;05;Perjantai;2;4;6
94;01.12.2017;2017;12;06;Perjantai;12;2;14
94;01.12.2017;2017;12;07;Perjantai;6;1;7
94;01.12.2017;2017;12;08;Perjantai;8;1;9
94;01.12.2017;2017;12;09;Perjantai;2;0;2
94;01.12.2017;2017;12;10;Perjantai;3;1;4
94;01.12.2017;2017;12;11;Perjantai;0;0;0
94;01.12.2017;2017;12;12;Perjantai;0;1;1
94;01.12.2017;2017;12;13;Perjantai;2;2;4
94;01.12.2017;2017;12;14;Perjantai;3;10;13
94;01.12.2017;2017;12;15;Perjantai;1;7;8
94;01.12.2017;2017;12;16;Perjantai;0;5;5
94;01.12.2017;2017;12;17;Perjantai;0;3;3
94;01.12.2017;2017;12;18;Perjantai;2;1;3
94;01.12.2017;2017;12;19;Perjantai;1;0;1
94;01.12.2017;2017;12;20;Perjantai;0;1;1
94;01.12.2017;2017;12;21;Perjantai;1;0;1
94;01.12.2017;2017;12;22;Perjantai;0;1;1
94;01.12.2017;2017;12;23;Perjantai;0;1;1
94;02.12.2017;2017;12;00;Lauantai;0;0;0
94;02.12.2017;2017;12;01;Lauantai;0;0;0
94;02.12.2017;2017;12;02;Lauantai;0;0;0
94;02.12.2017;2017;12;03;Lauantai;0;0;0
94;02.12.2017;2017;12;04;Lauantai;0;0;0
94;02.12.2017;2017;12;05;Lauantai;0;0;0
94;02.12.2017;2017;12;06;Lauantai;0;0;0
94;02.12.2017;2017;12;07;Lauantai;0;1;1
94;02.12.2017;2017;12;08;Lauantai;1;1;2
94;02.12.2017;2017;12;09;Lauantai;1;0;1
94;02.12.2017;2017;12;10;Lauantai;0;0;0
94;02.12.2017;2017;12;11;Lauantai;2;2;4
94;02.12.2017;2017;12;12;Lauantai;1;0;1
94;02.12.2017;2017;12;13;Lauantai;2;2;4
94;02.12.2017;2017;12;14;Lauantai;3;3;6
94;02.12.2017;2017;12;15;Lauantai;0;2;2
94;02.12.2017;2017;12;16;Lauantai;1;0;1
94;02.12.2017;2017;12;17;Lauantai;0;2;2
94;02.12.2017;2017;12;18;Lauantai;0;0;0
94;02.12.2017;2017;12;19;Lauantai;0;0;0
94;02.12.2017;2017;12;20;Lauantai;0;0;0
94;02.12.2017;2017;12;21;Lauantai;0;1;1
94;02.12.2017;2017;12;22;Lauantai;0;0;0
94;02.12.2017;2017;12;23;Lauantai;0;0;0
94;03.12.2017;2017;12;00;Sunnuntai;0;0;0
94;03.12.2017;2017;12;01;Sunnuntai;0;0;0
94;03.12.2017;2017;12;02;Sunnuntai;0;0;0
94;03.12.2017;2017;12;03;Sunnuntai;0;0;0
94;03.12.2017;2017;12;04;Sunnuntai;0;0;0
94;03.12.2017;2017;12;05;Sunnuntai;0;0;0
94;03.12.2017;2017;12;06;Sunnuntai;0;0;0
94;03.12.2017;2017;12;07;Sunnuntai;2;0;2
94;03.12.2017;2017;12;08;Sunnuntai;0;0;0
94;03.12.2017;2017;12;09;Sunnuntai;1;1;2
94;03.12.2017;2017;12;10;Sunnuntai;2;0;2
94;03.12.2017;2017;12;11;Sunnuntai;2;0;2
94;03.12.2017;2017;12;12;Sunnuntai;4;4;8
94;03.12.2017;2017;12;13;Sunnuntai;0;3;3
94;03.12.2017;2017;12;14;Sunnuntai;3;3;6
94;03.12.2017;2017;12;15;Sunnuntai;1;0;1
94;03.12.2017;2017;12;16;Sunnuntai;1;0;1
94;03.12.2017;2017;12;17;Sunnuntai;1;0;1
94;03.12.2017;2017;12;18;Sunnuntai;0;1;1
94;03.12.2017;2017;12;19;Sunnuntai;0;0;0
94;03.12.2017;2017;12;20;Sunnuntai;0;0;0
94;03.12.2017;2017;12;21;Sunnuntai;0;1;1
94;03.12.2017;2017;12;22;Sunnuntai;1;2;3
94;03.12.2017;2017;12;23;Sunnuntai;0;0;0
94;04.12.2017;2017;12;00;Maanantai;0;0;0
94;04.12.2017;2017;12;01;Maanantai;0;0;0
94;04.12.2017;2017;12;02;Maanantai;0;0;0
94;04.12.2017;2017;12;03;Maanantai;0;0;0
94;04.12.2017;2017;12;04;Maanantai;0;0;0
94;04.12.2017;2017;12;05;Maanantai;4;1;5
94;04.12.2017;2017;12;06;Maanantai;3;1;4
94;04.12.2017;2017;12;07;Maanantai;11;0;11
94;04.12.2017;2017;12;08;Maanantai;5;1;6
94;04.12.2017;2017;12;09;Maanantai;0;1;1
94;04.12.2017;2017;12;10;Maanantai;2;1;3
94;04.12.2017;2017;12;11;Maanantai;1;1;2
94;04.12.2017;2017;12;12;Maanantai;1;0;1
94;04.12.2017;2017;12;13;Maanantai;1;1;2
94;04.12.2017;2017;12;14;Maanantai;1;3;4
94;04.12.2017;2017;12;15;Maanantai;2;6;8
94;04.12.2017;2017;12;16;Maanantai;0;10;10
94;04.12.2017;2017;12;17;Maanantai;0;5;5
94;04.12.2017;2017;12;18;Maanantai;0;0;0
94;04.12.2017;2017;12;19;Maanantai;0;3;3
94;04.12.2017;2017;12;20;Maanantai;1;0;1
94;04.12.2017;2017;12;21;Maanantai;0;0;0
94;04.12.2017;2017;12;22;Maanantai;0;0;0
94;04.12.2017;2017;12;23;Maanantai;0;0;0
94;05.12.2017;2017;12;00;Tiistai;0;0;0
94;05.12.2017;2017;12;01;Tiistai;0;0;0
94;05.12.2017;2017;12;02;Tiistai;0;0;0
94;05.12.2017;2017;12;03;Tiistai;0;0;0
94;05.12.2017;2017;12;04;Tiistai;0;0;0
94;05.12.2017;2017;12;05;Tiistai;2;1;3
94;05.12.2017;2017;12;06;Tiistai;5;1;6
94;05.12.2017;2017;12;07;Tiistai;5;0;5
94;05.12.2017;2017;12;08;Tiistai;1;0;1
94;05.12.2017;2017;12;09;Tiistai;2;0;2
94;05.12.2017;2017;12;10;Tiistai;1;2;3
94;05.12.2017;2017;12;11;Tiistai;1;0;1
94;05.12.2017;2017;12;12;Tiistai;1;2;3
94;05.12.2017;2017;12;13;Tiistai;2;0;2
94;05.12.2017;2017;12;14;Tiistai;2;5;7
94;05.12.2017;2017;12;15;Tiistai;1;3;4
94;05.12.2017;2017;12;16;Tiistai;1;7;8
94;05.12.2017;2017;12;17;Tiistai;0;0;0
94;05.12.2017;2017;12;18;Tiistai;0;1;1
94;05.12.2017;2017;12;19;Tiistai;1;1;2
94;05.12.2017;2017;12;20;Tiistai;0;5;5
94;05.12.2017;2017;12;21;Tiistai;1;0;1
94;05.12.2017;2017;12;22;Tiistai;1;0;1
94;05.12.2017;2017;12;23;Tiistai;0;0;0
94;06.12.2017;2017;12;00;Keskiviikko;0;0;0
94;06.12.2017;2017;12;01;Keskiviikko;0;0;0
94;06.12.2017;2017;12;02;Keskiviikko;0;0;0
94;06.12.2017;2017;12;03;Keskiviikko;0;0;0
94;06.12.2017;2017;12;04;Keskiviikko;0;0;0
94;06.12.2017;2017;12;05;Keskiviikko;0;1;1
94;06.12.2017;2017;12;06;Keskiviikko;0;0;0
94;06.12.2017;2017;12;07;Keskiviikko;0;0;0
94;06.12.2017;2017;12;08;Keskiviikko;0;0;0
94;06.12.2017;2017;12;09;Keskiviikko;1;1;2
94;06.12.2017;2017;12;10;Keskiviikko;0;0;0
94;06.12.2017;2017;12;11;Keskiviikko;0;1;1
94;06.12.2017;2017;12;12;Keskiviikko;1;1;2
94;06.12.2017;2017;12;13;Keskiviikko;1;0;1
94;06.12.2017;2017;12;14;Keskiviikko;2;1;3
94;06.12.2017;2017;12;15;Keskiviikko;1;0;1
94;06.12.2017;2017;12;16;Keskiviikko;0;2;2
94;06.12.2017;2017;12;17;Keskiviikko;0;0;0
94;06.12.2017;2017;12;18;Keskiviikko;0;0;0
94;06.12.2017;2017;12;19;Keskiviikko;1;0;1
94;06.12.2017;2017;12;20;Keskiviikko;2;2;4
94;06.12.2017;2017;12;21;Keskiviikko;0;0;0
94;06.12.2017;2017;12;22;Keskiviikko;0;0;0
94;06.12.2017;2017;12;23;Keskiviikko;0;0;0
94;07.12.2017;2017;12;00;Torstai;0;0;0
94;07.12.2017;2017;12;01;Torstai;0;0;0
94;07.12.2017;2017;12;02;Torstai;0;0;0
94;07.12.2017;2017;12;03;Torstai;0;0;0
94;07.12.2017;2017;12;04;Torstai;0;0;0
94;07.12.2017;2017;12;05;Torstai;1;2;3
94;07.12.2017;2017;12;06;Torstai;6;1;7
94;07.12.2017;2017;12;07;Torstai;8;0;8
94;07.12.2017;2017;12;08;Torstai;7;0;7
94;07.12.2017;2017;12;09;Torstai;2;0;2
94;07.12.2017;2017;12;10;Torstai;2;1;3
94;07.12.2017;2017;12;11;Torstai;2;0;2
94;07.12.2017;2017;12;12;Torstai;1;0;1
94;07.12.2017;2017;12;13;Torstai;0;2;2
94;07.12.2017;2017;12;14;Torstai;1;3;4
94;07.12.2017;2017;12;15;Torstai;1;7;8
94;07.12.2017;2017;12;16;Torstai;0;9;9
94;07.12.2017;2017;12;17;Torstai;0;5;5
94;07.12.2017;2017;12;18;Torstai;0;6;6
94;07.12.2017;2017;12;19;Torstai;0;1;1
94;07.12.2017;2017;12;20;Torstai;1;0;1
94;07.12.2017;2017;12;21;Torstai;1;0;1
94;07.12.2017;2017;12;22;Torstai;0;1;1
94;07.12.2017;2017;12;23;Torstai;0;0;0
94;08.12.2017;2017;12;00;Perjantai;0;0;0
94;08.12.2017;2017;12;01;Perjantai;0;0;0
94;08.12.2017;2017;12;02;Perjantai;0;0;0
94;08.12.2017;2017;12;03;Perjantai;0;0;0
94;08.12.2017;2017;12;04;Perjantai;0;0;0
94;08.12.2017;2017;12;05;Perjantai;1;0;1
94;08.12.2017;2017;12;06;Perjantai;4;0;4
94;08.12.2017;2017;12;07;Perjantai;7;0;7
94;08.12.2017;2017;12;08;Perjantai;2;0;2
94;08.12.2017;2017;12;09;Perjantai;3;0;3
94;08.12.2017;2017;12;10;Perjantai;0;0;0
94;08.12.2017;2017;12;11;Perjantai;0;0;0
94;08.12.2017;2017;12;12;Perjantai;0;0;0
94;08.12.2017;2017;12;13;Perjantai;1;3;4
94;08.12.2017;2017;12;14;Perjantai;1;5;6
94;08.12.2017;2017;12;15;Perjantai;0;4;4
94;08.12.2017;2017;12;16;Perjantai;0;3;3
94;08.12.2017;2017;12;17;Perjantai;0;1;1
94;08.12.2017;2017;12;18;Perjantai;0;2;2
94;08.12.2017;2017;12;19;Perjantai;0;2;2
94;08.12.2017;2017;12;20;Perjantai;5;0;5
94;08.12.2017;2017;12;21;Perjantai;0;0;0
94;08.12.2017;2017;12;22;Perjantai;0;0;0
94;08.12.2017;2017;12;23;Perjantai;1;0;1
94;09.12.2017;2017;12;00;Lauantai;0;3;3
94;09.12.2017;2017;12;01;Lauantai;0;2;2
94;09.12.2017;2017;12;02;Lauantai;0;0;0
94;09.12.2017;2017;12;03;Lauantai;0;0;0
94;09.12.2017;2017;12;04;Lauantai;0;0;0
94;09.12.2017;2017;12;05;Lauantai;0;0;0
94;09.12.2017;2017;12;06;Lauantai;1;1;2
94;09.12.2017;2017;12;07;Lauantai;0;0;0
94;09.12.2017;2017;12;08;Lauantai;2;0;2
94;09.12.2017;2017;12;09;Lauantai;0;0;0
94;09.12.2017;2017;12;10;Lauantai;0;1;1
94;09.12.2017;2017;12;11;Lauantai;2;0;2
94;09.12.2017;2017;12;12;Lauantai;4;2;6
94;09.12.2017;2017;12;13;Lauantai;3;0;3
94;09.12.2017;2017;12;14;Lauantai;0;0;0
94;09.12.2017;2017;12;15;Lauantai;0;5;5
94;09.12.2017;2017;12;16;Lauantai;0;3;3
94;09.12.2017;2017;12;17;Lauantai;3;0;3
94;09.12.2017;2017;12;18;Lauantai;0;0;0
94;09.12.2017;2017;12;19;Lauantai;0;1;1
94;09.12.2017;2017;12;20;Lauantai;0;0;0
94;09.12.2017;2017;12;21;Lauantai;0;0;0
94;09.12.2017;2017;12;22;Lauantai;0;1;1
94;09.12.2017;2017;12;23;Lauantai;1;0;1
94;10.12.2017;2017;12;00;Sunnuntai;0;0;0
94;10.12.2017;2017;12;01;Sunnuntai;0;0;0
94;10.12.2017;2017;12;02;Sunnuntai;0;0;0
94;10.12.2017;2017;12;03;Sunnuntai;0;0;0
94;10.12.2017;2017;12;04;Sunnuntai;0;0;0
94;10.12.2017;2017;12;05;Sunnuntai;0;0;0
94;10.12.2017;2017;12;06;Sunnuntai;0;0;0
94;10.12.2017;2017;12;07;Sunnuntai;0;0;0
94;10.12.2017;2017;12;08;Sunnuntai;0;0;0
94;10.12.2017;2017;12;09;Sunnuntai;0;0;0
94;10.12.2017;2017;12;10;Sunnuntai;1;1;2
94;10.12.2017;2017;12;11;Sunnuntai;1;0;1
94;10.12.2017;2017;12;12;Sunnuntai;0;1;1
94;10.12.2017;2017;12;13;Sunnuntai;1;0;1
94;10.12.2017;2017;12;14;Sunnuntai;1;0;1
94;10.12.2017;2017;12;15;Sunnuntai;3;2;5
94;10.12.2017;2017;12;16;Sunnuntai;0;1;1
94;10.12.2017;2017;12;17;Sunnuntai;1;0;1
94;10.12.2017;2017;12;18;Sunnuntai;2;4;6
94;10.12.2017;2017;12;19;Sunnuntai;0;0;0
94;10.12.2017;2017;12;20;Sunnuntai;1;0;1
94;10.12.2017;2017;12;21;Sunnuntai;1;1;2
94;10.12.2017;2017;12;22;Sunnuntai;0;0;0
94;10.12.2017;2017;12;23;Sunnuntai;0;0;0
94;11.12.2017;2017;12;00;Maanantai;0;2;2
94;11.12.2017;2017;12;01;Maanantai;0;0;0
94;11.12.2017;2017;12;02;Maanantai;0;0;0
94;11.12.2017;2017;12;03;Maanantai;0;0;0
94;11.12.2017;2017;12;04;Maanantai;0;0;0
94;11.12.2017;2017;12;05;Maanantai;3;1;4
94;11.12.2017;2017;12;06;Maanantai;6;0;6
94;11.12.2017;2017;12;07;Maanantai;12;0;12
94;11.12.2017;2017;12;08;Maanantai;3;1;4
94;11.12.2017;2017;12;09;Maanantai;1;1;2
94;11.12.2017;2017;12;10;Maanantai;1;0;1
94;11.12.2017;2017;12;11;Maanantai;4;0;4
94;11.12.2017;2017;12;12;Maanantai;1;0;1
94;11.12.2017;2017;12;13;Maanantai;2;5;7
94;11.12.2017;2017;12;14;Maanantai;1;4;5
94;11.12.2017;2017;12;15;Maanantai;0;6;6
94;11.12.2017;2017;12;16;Maanantai;0;7;7
94;11.12.2017;2017;12;17;Maanantai;2;6;8
94;11.12.2017;2017;12;18;Maanantai;2;3;5
94;11.12.2017;2017;12;19;Maanantai;1;3;4
94;11.12.2017;2017;12;20;Maanantai;0;2;2
94;11.12.2017;2017;12;21;Maanantai;0;0;0
94;11.12.2017;2017;12;22;Maanantai;0;0;0
94;11.12.2017;2017;12;23;Maanantai;0;0;0
94;12.12.2017;2017;12;00;Tiistai;0;0;0
94;12.12.2017;2017;12;01;Tiistai;0;0;0
94;12.12.2017;2017;12;02;Tiistai;0;0;0
94;12.12.2017;2017;12;03;Tiistai;0;0;0
94;12.12.2017;2017;12;04;Tiistai;0;0;0
94;12.12.2017;2017;12;05;Tiistai;3;1;4
94;12.12.2017;2017;12;06;Tiistai;5;0;5
94;12.12.2017;2017;12;07;Tiistai;9;0;9
94;12.12.2017;2017;12;08;Tiistai;7;0;7
94;12.12.2017;2017;12;09;Tiistai;0;0;0
94;12.12.2017;2017;12;10;Tiistai;0;0;0
94;12.12.2017;2017;12;11;Tiistai;2;0;2
94;12.12.2017;2017;12;12;Tiistai;0;0;0
94;12.12.2017;2017;12;13;Tiistai;1;2;3
94;12.12.2017;2017;12;14;Tiistai;1;6;7
94;12.12.2017;2017;12;15;Tiistai;0;6;6
94;12.12.2017;2017;12;16;Tiistai;0;2;2
94;12.12.2017;2017;12;17;Tiistai;3;7;10
94;12.12.2017;2017;12;18;Tiistai;0;3;3
94;12.12.2017;2017;12;19;Tiistai;1;2;3
94;12.12.2017;2017;12;20;Tiistai;1;0;1
94;12.12.2017;2017;12;21;Tiistai;0;1;1
94;12.12.2017;2017;12;22;Tiistai;0;0;0
94;12.12.2017;2017;12;23;Tiistai;0;0;0
94;13.12.2017;2017;12;00;Keskiviikko;0;0;0
94;13.12.2017;2017;12;01;Keskiviikko;0;0;0
94;13.12.2017;2017;12;02;Keskiviikko;0;1;1
94;13.12.2017;2017;12;03;Keskiviikko;0;0;0
94;13.12.2017;2017;12;04;Keskiviikko;0;0;0
94;13.12.2017;2017;12;05;Keskiviikko;2;0;2
94;13.12.2017;2017;12;06;Keskiviikko;4;1;5
94;13.12.2017;2017;12;07;Keskiviikko;8;1;9
94;13.12.2017;2017;12;08;Keskiviikko;5;0;5
94;13.12.2017;2017;12;09;Keskiviikko;2;0;2
94;13.12.2017;2017;12;10;Keskiviikko;0;0;0
94;13.12.2017;2017;12;11;Keskiviikko;0;0;0
94;13.12.2017;2017;12;12;Keskiviikko;0;1;1
94;13.12.2017;2017;12;13;Keskiviikko;2;0;2
94;13.12.2017;2017;12;14;Keskiviikko;0;2;2
94;13.12.2017;2017;12;15;Keskiviikko;0;6;6
94;13.12.2017;2017;12;16;Keskiviikko;2;6;8
94;13.12.2017;2017;12;17;Keskiviikko;0;2;2
94;13.12.2017;2017;12;18;Keskiviikko;0;1;1
94;13.12.2017;2017;12;19;Keskiviikko;0;2;2
94;13.12.2017;2017;12;20;Keskiviikko;1;0;1
94;13.12.2017;2017;12;21;Keskiviikko;0;0;0
94;13.12.2017;2017;12;22;Keskiviikko;0;0;0
94;13.12.2017;2017;12;23;Keskiviikko;0;0;0
94;14.12.2017;2017;12;00;Torstai;0;1;1
94;14.12.2017;2017;12;01;Torstai;0;0;0
94;14.12.2017;2017;12;02;Torstai;0;0;0
94;14.12.2017;2017;12;03;Torstai;0;0;0
94;14.12.2017;2017;12;04;Torstai;0;0;0
94;14.12.2017;2017;12;05;Torstai;4;2;6
94;14.12.2017;2017;12;06;Torstai;5;1;6
94;14.12.2017;2017;12;07;Torstai;15;0;15
94;14.12.2017;2017;12;08;Torstai;4;1;5
94;14.12.2017;2017;12;09;Torstai;0;0;0
94;14.12.2017;2017;12;10;Torstai;0;0;0
94;14.12.2017;2017;12;11;Torstai;1;0;1
94;14.12.2017;2017;12;12;Torstai;1;2;3
94;14.12.2017;2017;12;13;Torstai;2;4;6
94;14.12.2017;2017;12;14;Torstai;1;2;3
94;14.12.2017;2017;12;15;Torstai;0;6;6
94;14.12.2017;2017;12;16;Torstai;1;8;9
94;14.12.2017;2017;12;17;Torstai;2;3;5
94;14.12.2017;2017;12;18;Torstai;0;1;1
94;14.12.2017;2017;12;19;Torstai;0;1;1
94;14.12.2017;2017;12;20;Torstai;0;1;1
94;14.12.2017;2017;12;21;Torstai;1;0;1
94;14.12.2017;2017;12;22;Torstai;0;0;0
94;14.12.2017;2017;12;23;Torstai;0;0;0
94;15.12.2017;2017;12;00;Perjantai;0;0;0
94;15.12.2017;2017;12;01;Perjantai;0;1;1
94;15.12.2017;2017;12;02;Perjantai;0;0;0
94;15.12.2017;2017;12;03;Perjantai;0;0;0
94;15.12.2017;2017;12;04;Perjantai;0;0;0
94;15.12.2017;2017;12;05;Perjantai;1;1;2
94;15.12.2017;2017;12;06;Perjantai;6;1;7
94;15.12.2017;2017;12;07;Perjantai;7;0;7
94;15.12.2017;2017;12;08;Perjantai;8;2;10
94;15.12.2017;2017;12;09;Perjantai;2;0;2
94;15.12.2017;2017;12;10;Perjantai;3;0;3
94;15.12.2017;2017;12;11;Perjantai;1;1;2
94;15.12.2017;2017;12;12;Perjantai;0;2;2
94;15.12.2017;2017;12;13;Perjantai;2;4;6
94;15.12.2017;2017;12;14;Perjantai;2;5;7
94;15.12.2017;2017;12;15;Perjantai;0;4;4
94;15.12.2017;2017;12;16;Perjantai;2;7;9
94;15.12.2017;2017;12;17;Perjantai;0;8;8
94;15.12.2017;2017;12;18;Perjantai;0;1;1
94;15.12.2017;2017;12;19;Perjantai;0;0;0
94;15.12.2017;2017;12;20;Perjantai;0;0;0
94;15.12.2017;2017;12;21;Perjantai;0;0;0
94;15.12.2017;2017;12;22;Perjantai;1;3;4
94;15.12.2017;2017;12;23;Perjantai;0;0;0
94;16.12.2017;2017;12;00;Lauantai;0;0;0
94;16.12.2017;2017;12;01;Lauantai;0;0;0
94;16.12.2017;2017;12;02;Lauantai;0;1;1
94;16.12.2017;2017;12;03;Lauantai;0;0;0
94;16.12.2017;2017;12;04;Lauantai;0;0;0
94;16.12.2017;2017;12;05;Lauantai;1;0;1
94;16.12.2017;2017;12;06;Lauantai;0;0;0
94;16.12.2017;2017;12;07;Lauantai;0;0;0
94;16.12.2017;2017;12;08;Lauantai;0;1;1
94;16.12.2017;2017;12;09;Lauantai;1;0;1
94;16.12.2017;2017;12;10;Lauantai;0;1;1
94;16.12.2017;2017;12;11;Lauantai;0;2;2
94;16.12.2017;2017;12;12;Lauantai;1;2;3
94;16.12.2017;2017;12;13;Lauantai;0;0;0
94;16.12.2017;2017;12;14;Lauantai;2;3;5
94;16.12.2017;2017;12;15;Lauantai;0;0;0
94;16.12.2017;2017;12;16;Lauantai;0;2;2
94;16.12.2017;2017;12;17;Lauantai;0;0;0
94;16.12.2017;2017;12;18;Lauantai;0;0;0
94;16.12.2017;2017;12;19;Lauantai;0;1;1
94;16.12.2017;2017;12;20;Lauantai;0;1;1
94;16.12.2017;2017;12;21;Lauantai;0;0;0
94;16.12.2017;2017;12;22;Lauantai;0;0;0
94;16.12.2017;2017;12;23;Lauantai;1;0;1
94;17.12.2017;2017;12;00;Sunnuntai;1;0;1
94;17.12.2017;2017;12;01;Sunnuntai;0;2;2
94;17.12.2017;2017;12;02;Sunnuntai;0;0;0
94;17.12.2017;2017;12;03;Sunnuntai;0;0;0
94;17.12.2017;2017;12;04;Sunnuntai;0;0;0
94;17.12.2017;2017;12;05;Sunnuntai;0;0;0
94;17.12.2017;2017;12;06;Sunnuntai;0;0;0
94;17.12.2017;2017;12;07;Sunnuntai;0;0;0
94;17.12.2017;2017;12;08;Sunnuntai;2;0;2
94;17.12.2017;2017;12;09;Sunnuntai;1;1;2
94;17.12.2017;2017;12;10;Sunnuntai;0;1;1
94;17.12.2017;2017;12;11;Sunnuntai;2;0;2
94;17.12.2017;2017;12;12;Sunnuntai;1;2;3
94;17.12.2017;2017;12;13;Sunnuntai;1;0;1
94;17.12.2017;2017;12;14;Sunnuntai;3;1;4
94;17.12.2017;2017;12;15;Sunnuntai;1;3;4
94;17.12.2017;2017;12;16;Sunnuntai;0;0;0
94;17.12.2017;2017;12;17;Sunnuntai;1;0;1
94;17.12.2017;2017;12;18;Sunnuntai;0;1;1
94;17.12.2017;2017;12;19;Sunnuntai;0;2;2
94;17.12.2017;2017;12;20;Sunnuntai;1;0;1
94;17.12.2017;2017;12;21;Sunnuntai;0;1;1
94;17.12.2017;2017;12;22;Sunnuntai;0;1;1
94;17.12.2017;2017;12;23;Sunnuntai;0;0;0
94;18.12.2017;2017;12;00;Maanantai;0;0;0
94;18.12.2017;2017;12;01;Maanantai;0;0;0
94;18.12.2017;2017;12;02;Maanantai;0;0;0
94;18.12.2017;2017;12;03;Maanantai;0;0;0
94;18.12.2017;2017;12;04;Maanantai;0;0;0
94;18.12.2017;2017;12;05;Maanantai;5;2;7
94;18.12.2017;2017;12;06;Maanantai;6;2;8
94;18.12.2017;2017;12;07;Maanantai;11;0;11
94;18.12.2017;2017;12;08;Maanantai;4;0;4
94;18.12.2017;2017;12;09;Maanantai;1;1;2
94;18.12.2017;2017;12;10;Maanantai;2;1;3
94;18.12.2017;2017;12;11;Maanantai;1;1;2
94;18.12.2017;2017;12;12;Maanantai;1;1;2
94;18.12.2017;2017;12;13;Maanantai;1;0;1
94;18.12.2017;2017;12;14;Maanantai;2;7;9
94;18.12.2017;2017;12;15;Maanantai;4;6;10
94;18.12.2017;2017;12;16;Maanantai;0;11;11
94;18.12.2017;2017;12;17;Maanantai;1;4;5
94;18.12.2017;2017;12;18;Maanantai;0;2;2
94;18.12.2017;2017;12;19;Maanantai;0;2;2
94;18.12.2017;2017;12;20;Maanantai;1;1;2
94;18.12.2017;2017;12;21;Maanantai;0;0;0
94;18.12.2017;2017;12;22;Maanantai;0;0;0
94;18.12.2017;2017;12;23;Maanantai;0;0;0
94;19.12.2017;2017;12;00;Tiistai;0;0;0
94;19.12.2017;2017;12;01;Tiistai;0;0;0
94;19.12.2017;2017;12;02;Tiistai;0;0;0
94;19.12.2017;2017;12;03;Tiistai;0;0;0
94;19.12.2017;2017;12;04;Tiistai;0;0;0
94;19.12.2017;2017;12;05;Tiistai;3;4;7
94;19.12.2017;2017;12;06;Tiistai;5;1;6
94;19.12.2017;2017;12;07;Tiistai;10;0;10
94;19.12.2017;2017;12;08;Tiistai;3;1;4
94;19.12.2017;2017;12;09;Tiistai;1;0;1
94;19.12.2017;2017;12;10;Tiistai;3;0;3
94;19.12.2017;2017;12;11;Tiistai;1;2;3
94;19.12.2017;2017;12;12;Tiistai;1;0;1
94;19.12.2017;2017;12;13;Tiistai;0;0;0
94;19.12.2017;2017;12;14;Tiistai;2;4;6
94;19.12.2017;2017;12;15;Tiistai;1;11;12
94;19.12.2017;2017;12;16;Tiistai;1;11;12
94;19.12.2017;2017;12;17;Tiistai;0;4;4
94;19.12.2017;2017;12;18;Tiistai;0;2;2
94;19.12.2017;2017;12;19;Tiistai;1;2;3
94;19.12.2017;2017;12;20;Tiistai;0;0;0
94;19.12.2017;2017;12;21;Tiistai;0;0;0
94;19.12.2017;2017;12;22;Tiistai;0;0;0
94;19.12.2017;2017;12;23;Tiistai;0;0;0
94;20.12.2017;2017;12;00;Keskiviikko;0;0;0
94;20.12.2017;2017;12;01;Keskiviikko;0;0;0
94;20.12.2017;2017;12;02;Keskiviikko;0;0;0
94;20.12.2017;2017;12;03;Keskiviikko;0;0;0
94;20.12.2017;2017;12;04;Keskiviikko;0;0;0
94;20.12.2017;2017;12;05;Keskiviikko;4;4;8
94;20.12.2017;2017;12;06;Keskiviikko;6;0;6
94;20.12.2017;2017;12;07;Keskiviikko;7;0;7
94;20.12.2017;2017;12;08;Keskiviikko;6;0;6
94;20.12.2017;2017;12;09;Keskiviikko;1;2;3
94;20.12.2017;2017;12;10;Keskiviikko;2;0;2
94;20.12.2017;2017;12;11;Keskiviikko;0;0;0
94;20.12.2017;2017;12;12;Keskiviikko;0;0;0
94;20.12.2017;2017;12;13;Keskiviikko;0;0;0
94;20.12.2017;2017;12;14;Keskiviikko;1;4;5
94;20.12.2017;2017;12;15;Keskiviikko;2;5;7
94;20.12.2017;2017;12;16;Keskiviikko;0;5;5
94;20.12.2017;2017;12;17;Keskiviikko;0;0;0
94;20.12.2017;2017;12;18;Keskiviikko;0;5;5
94;20.12.2017;2017;12;19;Keskiviikko;0;2;2
94;20.12.2017;2017;12;20;Keskiviikko;0;0;0
94;20.12.2017;2017;12;21;Keskiviikko;1;0;1
94;20.12.2017;2017;12;22;Keskiviikko;0;2;2
94;20.12.2017;2017;12;23;Keskiviikko;0;0;0
94;21.12.2017;2017;12;00;Torstai;0;0;0
94;21.12.2017;2017;12;01;Torstai;0;0;0
94;21.12.2017;2017;12;02;Torstai;0;0;0
94;21.12.2017;2017;12;03;Torstai;0;0;0
94;21.12.2017;2017;12;04;Torstai;0;0;0
94;21.12.2017;2017;12;05;Torstai;2;1;3
94;21.12.2017;2017;12;06;Torstai;2;0;2
94;21.12.2017;2017;12;07;Torstai;6;0;6
94;21.12.2017;2017;12;08;Torstai;7;0;7
94;21.12.2017;2017;12;09;Torstai;1;0;1
94;21.12.2017;2017;12;10;Torstai;0;0;0
94;21.12.2017;2017;12;11;Torstai;1;0;1
94;21.12.2017;2017;12;12;Torstai;1;2;3
94;21.12.2017;2017;12;13;Torstai;0;1;1
94;21.12.2017;2017;12;14;Torstai;2;4;6
94;21.12.2017;2017;12;15;Torstai;0;5;5
94;21.12.2017;2017;12;16;Torstai;0;4;4
94;21.12.2017;2017;12;17;Torstai;1;1;2
94;21.12.2017;2017;12;18;Torstai;0;1;1
94;21.12.2017;2017;12;19;Torstai;0;2;2
94;21.12.2017;2017;12;20;Torstai;0;0;0
94;21.12.2017;2017;12;21;Torstai;0;0;0
94;21.12.2017;2017;12;22;Torstai;0;0;0
94;21.12.2017;2017;12;23;Torstai;2;0;2
94;22.12.2017;2017;12;00;Perjantai;0;0;0
94;22.12.2017;2017;12;01;Perjantai;0;0;0
94;22.12.2017;2017;12;02;Perjantai;0;0;0
94;22.12.2017;2017;12;03;Perjantai;0;0;0
94;22.12.2017;2017;12;04;Perjantai;0;0;0
94;22.12.2017;2017;12;05;Perjantai;1;1;2
94;22.12.2017;2017;12;06;Perjantai;5;1;6
94;22.12.2017;2017;12;07;Perjantai;5;0;5
94;22.12.2017;2017;12;08;Perjantai;4;1;5
94;22.12.2017;2017;12;09;Perjantai;0;0;0
94;22.12.2017;2017;12;10;Perjantai;2;2;4
94;22.12.2017;2017;12;11;Perjantai;1;2;3
94;22.12.2017;2017;12;12;Perjantai;1;1;2
94;22.12.2017;2017;12;13;Perjantai;3;3;6
94;22.12.2017;2017;12;14;Perjantai;0;3;3
94;22.12.2017;2017;12;15;Perjantai;0;5;5
94;22.12.2017;2017;12;16;Perjantai;0;5;5
94;22.12.2017;2017;12;17;Perjantai;1;1;2
94;22.12.2017;2017;12;18;Perjantai;0;1;1
94;22.12.2017;2017;12;19;Perjantai;1;3;4
94;22.12.2017;2017;12;20;Perjantai;0;0;0
94;22.12.2017;2017;12;21;Perjantai;1;0;1
94;22.12.2017;2017;12;22;Perjantai;0;1;1
94;22.12.2017;2017;12;23;Perjantai;0;0;0
94;23.12.2017;2017;12;00;Lauantai;0;0;0
94;23.12.2017;2017;12;01;Lauantai;0;0;0
94;23.12.2017;2017;12;02;Lauantai;0;0;0
94;23.12.2017;2017;12;03;Lauantai;0;0;0
94;23.12.2017;2017;12;04;Lauantai;0;0;0
94;23.12.2017;2017;12;05;Lauantai;0;0;0
94;23.12.2017;2017;12;06;Lauantai;0;0;0
94;23.12.2017;2017;12;07;Lauantai;0;0;0
94;23.12.2017;2017;12;08;Lauantai;0;0;0
94;23.12.2017;2017;12;09;Lauantai;1;0;1
94;23.12.2017;2017;12;10;Lauantai;0;0;0
94;23.12.2017;2017;12;11;Lauantai;0;0;0
94;23.12.2017;2017;12;12;Lauantai;0;0;0
94;23.12.2017;2017;12;13;Lauantai;1;0;1
94;23.12.2017;2017;12;14;Lauantai;0;0;0
94;23.12.2017;2017;12;15;Lauantai;0;1;1
94;23.12.2017;2017;12;16;Lauantai;1;1;2
94;23.12.2017;2017;12;17;Lauantai;1;0;1
94;23.12.2017;2017;12;18;Lauantai;0;0;0
94;23.12.2017;2017;12;19;Lauantai;0;1;1
94;23.12.2017;2017;12;20;Lauantai;1;0;1
94;23.12.2017;2017;12;21;Lauantai;1;0;1
94;23.12.2017;2017;12;22;Lauantai;0;1;1
94;23.12.2017;2017;12;23;Lauantai;0;0;0
94;24.12.2017;2017;12;00;Sunnuntai;0;0;0
94;24.12.2017;2017;12;01;Sunnuntai;0;0;0
94;24.12.2017;2017;12;02;Sunnuntai;1;0;1
94;24.12.2017;2017;12;03;Sunnuntai;0;0;0
94;24.12.2017;2017;12;04;Sunnuntai;0;0;0
94;24.12.2017;2017;12;05;Sunnuntai;0;0;0
94;24.12.2017;2017;12;06;Sunnuntai;0;0;0
94;24.12.2017;2017;12;07;Sunnuntai;0;0;0
94;24.12.2017;2017;12;08;Sunnuntai;0;0;0
94;24.12.2017;2017;12;09;Sunnuntai;0;0;0
94;24.12.2017;2017;12;10;Sunnuntai;0;1;1
94;24.12.2017;2017;12;11;Sunnuntai;0;1;1
94;24.12.2017;2017;12;12;Sunnuntai;0;1;1
94;24.12.2017;2017;12;13;Sunnuntai;1;0;1
94;24.12.2017;2017;12;14;Sunnuntai;1;0;1
94;24.12.2017;2017;12;15;Sunnuntai;0;0;0
94;24.12.2017;2017;12;16;Sunnuntai;0;0;0
94;24.12.2017;2017;12;17;Sunnuntai;0;0;0
94;24.12.2017;2017;12;18;Sunnuntai;0;0;0
94;24.12.2017;2017;12;19;Sunnuntai;0;0;0
94;24.12.2017;2017;12;20;Sunnuntai;0;0;0
94;24.12.2017;2017;12;21;Sunnuntai;1;1;2
94;24.12.2017;2017;12;22;Sunnuntai;0;0;0
94;24.12.2017;2017;12;23;Sunnuntai;0;0;0
94;25.12.2017;2017;12;00;Maanantai;0;0;0
94;25.12.2017;2017;12;01;Maanantai;0;0;0
94;25.12.2017;2017;12;02;Maanantai;0;0;0
94;25.12.2017;2017;12;03;Maanantai;0;0;0
94;25.12.2017;2017;12;04;Maanantai;0;0;0
94;25.12.2017;2017;12;05;Maanantai;0;0;0
94;25.12.2017;2017;12;06;Maanantai;0;0;0
94;25.12.2017;2017;12;07;Maanantai;0;0;0
94;25.12.2017;2017;12;08;Maanantai;0;0;0
94;25.12.2017;2017;12;09;Maanantai;0;0;0
94;25.12.2017;2017;12;10;Maanantai;0;0;0
94;25.12.2017;2017;12;11;Maanantai;1;3;4
94;25.12.2017;2017;12;12;Maanantai;2;0;2
94;25.12.2017;2017;12;13;Maanantai;0;0;0
94;25.12.2017;2017;12;14;Maanantai;0;0;0
94;25.12.2017;2017;12;15;Maanantai;0;1;1
94;25.12.2017;2017;12;16;Maanantai;0;2;2
94;25.12.2017;2017;12;17;Maanantai;0;0;0
94;25.12.2017;2017;12;18;Maanantai;0;0;0
94;25.12.2017;2017;12;19;Maanantai;0;0;0
94;25.12.2017;2017;12;20;Maanantai;0;0;0
94;25.12.2017;2017;12;21;Maanantai;0;0;0
94;25.12.2017;2017;12;22;Maanantai;2;0;2
94;25.12.2017;2017;12;23;Maanantai;0;1;1
94;26.12.2017;2017;12;00;Tiistai;0;0;0
94;26.12.2017;2017;12;01;Tiistai;0;0;0
94;26.12.2017;2017;12;02;Tiistai;0;0;0
94;26.12.2017;2017;12;03;Tiistai;0;0;0
94;26.12.2017;2017;12;04;Tiistai;0;0;0
94;26.12.2017;2017;12;05;Tiistai;0;0;0
94;26.12.2017;2017;12;06;Tiistai;0;0;0
94;26.12.2017;2017;12;07;Tiistai;0;0;0
94;26.12.2017;2017;12;08;Tiistai;0;0;0
94;26.12.2017;2017;12;09;Tiistai;0;0;0
94;26.12.2017;2017;12;10;Tiistai;0;0;0
94;26.12.2017;2017;12;11;Tiistai;0;0;0
94;26.12.2017;2017;12;12;Tiistai;1;0;1
94;26.12.2017;2017;12;13;Tiistai;0;1;1
94;26.12.2017;2017;12;14;Tiistai;0;0;0
94;26.12.2017;2017;12;15;Tiistai;1;1;2
94;26.12.2017;2017;12;16;Tiistai;1;0;1
94;26.12.2017;2017;12;17;Tiistai;0;0;0
94;26.12.2017;2017;12;18;Tiistai;0;1;1
94;26.12.2017;2017;12;19;Tiistai;0;0;0
94;26.12.2017;2017;12;20;Tiistai;0;0;0
94;26.12.2017;2017;12;21;Tiistai;0;0;0
94;26.12.2017;2017;12;22;Tiistai;0;0;0
94;26.12.2017;2017;12;23;Tiistai;0;0;0
94;27.12.2017;2017;12;00;Keskiviikko;0;0;0
94;27.12.2017;2017;12;01;Keskiviikko;0;0;0
94;27.12.2017;2017;12;02;Keskiviikko;0;0;0
94;27.12.2017;2017;12;03;Keskiviikko;0;0;0
94;27.12.2017;2017;12;04;Keskiviikko;0;0;0
94;27.12.2017;2017;12;05;Keskiviikko;0;0;0
94;27.12.2017;2017;12;06;Keskiviikko;1;1;2
94;27.12.2017;2017;12;07;Keskiviikko;2;0;2
94;27.12.2017;2017;12;08;Keskiviikko;1;0;1
94;27.12.2017;2017;12;09;Keskiviikko;2;0;2
94;27.12.2017;2017;12;10;Keskiviikko;0;0;0
94;27.12.2017;2017;12;11;Keskiviikko;1;0;1
94;27.12.2017;2017;12;12;Keskiviikko;0;1;1
94;27.12.2017;2017;12;13;Keskiviikko;1;2;3
94;27.12.2017;2017;12;14;Keskiviikko;0;0;0
94;27.12.2017;2017;12;15;Keskiviikko;0;1;1
94;27.12.2017;2017;12;16;Keskiviikko;2;2;4
94;27.12.2017;2017;12;17;Keskiviikko;1;2;3
94;27.12.2017;2017;12;18;Keskiviikko;0;3;3
94;27.12.2017;2017;12;19;Keskiviikko;0;2;2
94;27.12.2017;2017;12;20;Keskiviikko;1;0;1
94;27.12.2017;2017;12;21;Keskiviikko;0;2;2
94;27.12.2017;2017;12;22;Keskiviikko;2;0;2
94;27.12.2017;2017;12;23;Keskiviikko;0;0;0
94;28.12.2017;2017;12;00;Torstai;0;0;0
94;28.12.2017;2017;12;01;Torstai;0;0;0
94;28.12.2017;2017;12;02;Torstai;0;0;0
94;28.12.2017;2017;12;03;Torstai;0;0;0
94;28.12.2017;2017;12;04;Torstai;1;0;1
94;28.12.2017;2017;12;05;Torstai;2;0;2
94;28.12.2017;2017;12;06;Torstai;1;1;2
94;28.12.2017;2017;12;07;Torstai;1;0;1
94;28.12.2017;2017;12;08;Torstai;1;0;1
94;28.12.2017;2017;12;09;Torstai;1;0;1
94;28.12.2017;2017;12;10;Torstai;0;0;0
94;28.12.2017;2017;12;11;Torstai;0;0;0
94;28.12.2017;2017;12;12;Torstai;1;0;1
94;28.12.2017;2017;12;13;Torstai;0;0;0
94;28.12.2017;2017;12;14;Torstai;1;5;6
94;28.12.2017;2017;12;15;Torstai;1;4;5
94;28.12.2017;2017;12;16;Torstai;0;2;2
94;28.12.2017;2017;12;17;Torstai;2;1;3
94;28.12.2017;2017;12;18;Torstai;1;2;3
94;28.12.2017;2017;12;19;Torstai;0;1;1
94;28.12.2017;2017;12;20;Torstai;4;1;5
94;28.12.2017;2017;12;21;Torstai;0;1;1
94;28.12.2017;2017;12;22;Torstai;1;0;1
94;28.12.2017;2017;12;23;Torstai;0;0;0
94;29.12.2017;2017;12;00;Perjantai;0;0;0
94;29.12.2017;2017;12;01;Perjantai;0;0;0
94;29.12.2017;2017;12;02;Perjantai;0;0;0
94;29.12.2017;2017;12;03;Perjantai;0;0;0
94;29.12.2017;2017;12;04;Perjantai;0;0;0
94;29.12.2017;2017;12;05;Perjantai;0;0;0
94;29.12.2017;2017;12;06;Perjantai;2;0;2
94;29.12.2017;2017;12;07;Perjantai;3;0;3
94;29.12.2017;2017;12;08;Perjantai;0;0;0
94;29.12.2017;2017;12;09;Perjantai;1;0;1
94;29.12.2017;2017;12;10;Perjantai;1;0;1
94;29.12.2017;2017;12;11;Perjantai;0;0;0
94;29.12.2017;2017;12;12;Perjantai;0;0;0
94;29.12.2017;2017;12;13;Perjantai;0;1;1
94;29.12.2017;2017;12;14;Perjantai;0;2;2
94;29.12.2017;2017;12;15;Perjantai;0;1;1
94;29.12.2017;2017;12;16;Perjantai;0;1;1
94;29.12.2017;2017;12;17;Perjantai;0;1;1
94;29.12.2017;2017;12;18;Perjantai;1;3;4
94;29.12.2017;2017;12;19;Perjantai;0;0;0
94;29.12.2017;2017;12;20;Perjantai;0;0;0
94;29.12.2017;2017;12;21;Perjantai;0;0;0
94;29.12.2017;2017;12;22;Perjantai;1;0;1
94;29.12.2017;2017;12;23;Perjantai;0;2;2
94;30.12.2017;2017;12;00;Lauantai;0;0;0
94;30.12.2017;2017;12;01;Lauantai;0;0;0
94;30.12.2017;2017;12;02;Lauantai;3;0;3
94;30.12.2017;2017;12;03;Lauantai;0;0;0
94;30.12.2017;2017;12;04;Lauantai;0;0;0
94;30.12.2017;2017;12;05;Lauantai;0;0;0
94;30.12.2017;2017;12;06;Lauantai;0;0;0
94;30.12.2017;2017;12;07;Lauantai;0;0;0
94;30.12.2017;2017;12;08;Lauantai;0;0;0
94;30.12.2017;2017;12;09;Lauantai;0;1;1
94;30.12.2017;2017;12;10;Lauantai;0;0;0
94;30.12.2017;2017;12;11;Lauantai;0;0;0
94;30.12.2017;2017;12;12;Lauantai;1;2;3
94;30.12.2017;2017;12;13;Lauantai;1;1;2
94;30.12.2017;2017;12;14;Lauantai;1;0;1
94;30.12.2017;2017;12;15;Lauantai;1;0;1
94;30.12.2017;2017;12;16;Lauantai;0;0;0
94;30.12.2017;2017;12;17;Lauantai;1;0;1
94;30.12.2017;2017;12;18;Lauantai;0;1;1
94;30.12.2017;2017;12;19;Lauantai;1;0;1
94;30.12.2017;2017;12;20;Lauantai;0;1;1
94;30.12.2017;2017;12;21;Lauantai;0;2;2
94;30.12.2017;2017;12;22;Lauantai;0;0;0
94;30.12.2017;2017;12;23;Lauantai;1;0;1
94;31.12.2017;2017;12;00;Sunnuntai;0;0;0
94;31.12.2017;2017;12;01;Sunnuntai;1;0;1
94;31.12.2017;2017;12;02;Sunnuntai;0;0;0
94;31.12.2017;2017;12;03;Sunnuntai;0;0;0
94;31.12.2017;2017;12;04;Sunnuntai;0;0;0
94;31.12.2017;2017;12;05;Sunnuntai;0;0;0
94;31.12.2017;2017;12;06;Sunnuntai;0;0;0
94;31.12.2017;2017;12;07;Sunnuntai;1;1;2
94;31.12.2017;2017;12;08;Sunnuntai;0;0;0
94;31.12.2017;2017;12;09;Sunnuntai;1;0;1
94;31.12.2017;2017;12;10;Sunnuntai;0;1;1
94;31.12.2017;2017;12;11;Sunnuntai;1;1;2
94;31.12.2017;2017;12;12;Sunnuntai;3;0;3
94;31.12.2017;2017;12;13;Sunnuntai;1;1;2
94;31.12.2017;2017;12;14;Sunnuntai;0;0;0
94;31.12.2017;2017;12;15;Sunnuntai;0;1;1
94;31.12.2017;2017;12;16;Sunnuntai;1;0;1
94;31.12.2017;2017;12;17;Sunnuntai;0;1;1
94;31.12.2017;2017;12;18;Sunnuntai;0;0;0
94;31.12.2017;2017;12;19;Sunnuntai;1;0;1
94;31.12.2017;2017;12;20;Sunnuntai;0;1;1
94;31.12.2017;2017;12;21;Sunnuntai;0;0;0
94;31.12.2017;2017;12;22;Sunnuntai;0;1;1
94;31.12.2017;2017;12;23;Sunnuntai;0;1;1
94;01.01.2018;2018;01;00;Maanantai;1;0;1
94;01.01.2018;2018;01;01;Maanantai;0;0;0
94;01.01.2018;2018;01;02;Maanantai;0;0;0
94;01.01.2018;2018;01;03;Maanantai;0;0;0
94;01.01.2018;2018;01;04;Maanantai;0;0;0
94;01.01.2018;2018;01;05;Maanantai;1;0;1
94;01.01.2018;2018;01;06;Maanantai;0;0;0
94;01.01.2018;2018;01;07;Maanantai;0;0;0
94;01.01.2018;2018;01;08;Maanantai;0;0;0
94;01.01.2018;2018;01;09;Maanantai;0;0;0
94;01.01.2018;2018;01;10;Maanantai;0;0;0
94;01.01.2018;2018;01;11;Maanantai;1;0;1
94;01.01.2018;2018;01;12;Maanantai;1;0;1
94;01.01.2018;2018;01;13;Maanantai;0;2;2
94;01.01.2018;2018;01;14;Maanantai;0;0;0
94;01.01.2018;2018;01;15;Maanantai;3;0;3
94;01.01.2018;2018;01;16;Maanantai;2;4;6
94;01.01.2018;2018;01;17;Maanantai;0;1;1
94;01.01.2018;2018;01;18;Maanantai;3;1;4
94;01.01.2018;2018;01;19;Maanantai;0;4;4
94;01.01.2018;2018;01;20;Maanantai;1;1;2
94;01.01.2018;2018;01;21;Maanantai;2;0;2
94;01.01.2018;2018;01;22;Maanantai;0;0;0
94;01.01.2018;2018;01;23;Maanantai;1;0;1
94;02.01.2018;2018;01;00;Tiistai;0;0;0
94;02.01.2018;2018;01;01;Tiistai;0;0;0
94;02.01.2018;2018;01;02;Tiistai;0;0;0
94;02.01.2018;2018;01;03;Tiistai;0;0;0
94;02.01.2018;2018;01;04;Tiistai;0;0;0
94;02.01.2018;2018;01;05;Tiistai;2;3;5
94;02.01.2018;2018;01;06;Tiistai;4;1;5
94;02.01.2018;2018;01;07;Tiistai;5;0;5
94;02.01.2018;2018;01;08;Tiistai;7;0;7
94;02.01.2018;2018;01;09;Tiistai;1;1;2
94;02.01.2018;2018;01;10;Tiistai;0;0;0
94;02.01.2018;2018;01;11;Tiistai;0;0;0
94;02.01.2018;2018;01;12;Tiistai;2;0;2
94;02.01.2018;2018;01;13;Tiistai;2;1;3
94;02.01.2018;2018;01;14;Tiistai;2;2;4
94;02.01.2018;2018;01;15;Tiistai;0;6;6
94;02.01.2018;2018;01;16;Tiistai;1;11;12
94;02.01.2018;2018;01;17;Tiistai;0;4;4
94;02.01.2018;2018;01;18;Tiistai;2;4;6
94;02.01.2018;2018;01;19;Tiistai;0;2;2
94;02.01.2018;2018;01;20;Tiistai;0;0;0
94;02.01.2018;2018;01;21;Tiistai;0;0;0
94;02.01.2018;2018;01;22;Tiistai;0;1;1
94;02.01.2018;2018;01;23;Tiistai;0;0;0
94;03.01.2018;2018;01;00;Keskiviikko;0;0;0
94;03.01.2018;2018;01;01;Keskiviikko;0;0;0
94;03.01.2018;2018;01;02;Keskiviikko;0;0;0
94;03.01.2018;2018;01;03;Keskiviikko;0;0;0
94;03.01.2018;2018;01;04;Keskiviikko;0;0;0
94;03.01.2018;2018;01;05;Keskiviikko;3;3;6
94;03.01.2018;2018;01;06;Keskiviikko;5;1;6
94;03.01.2018;2018;01;07;Keskiviikko;9;0;9
94;03.01.2018;2018;01;08;Keskiviikko;4;0;4
94;03.01.2018;2018;01;09;Keskiviikko;1;1;2
94;03.01.2018;2018;01;10;Keskiviikko;0;0;0
94;03.01.2018;2018;01;11;Keskiviikko;1;0;1
94;03.01.2018;2018;01;12;Keskiviikko;1;0;1
94;03.01.2018;2018;01;13;Keskiviikko;1;1;2
94;03.01.2018;2018;01;14;Keskiviikko;1;4;5
94;03.01.2018;2018;01;15;Keskiviikko;2;3;5
94;03.01.2018;2018;01;16;Keskiviikko;0;9;9
94;03.01.2018;2018;01;17;Keskiviikko;0;3;3
94;03.01.2018;2018;01;18;Keskiviikko;1;0;1
94;03.01.2018;2018;01;19;Keskiviikko;0;2;2
94;03.01.2018;2018;01;20;Keskiviikko;1;3;4
94;03.01.2018;2018;01;21;Keskiviikko;0;0;0
94;03.01.2018;2018;01;22;Keskiviikko;0;3;3
94;03.01.2018;2018;01;23;Keskiviikko;0;0;0
94;04.01.2018;2018;01;00;Torstai;0;0;0
94;04.01.2018;2018;01;01;Torstai;0;0;0
94;04.01.2018;2018;01;02;Torstai;0;0;0
94;04.01.2018;2018;01;03;Torstai;0;0;0
94;04.01.2018;2018;01;04;Torstai;1;0;1
94;04.01.2018;2018;01;05;Torstai;2;0;2
94;04.01.2018;2018;01;06;Torstai;2;0;2
94;04.01.2018;2018;01;07;Torstai;1;0;1
94;04.01.2018;2018;01;08;Torstai;1;0;1
94;04.01.2018;2018;01;09;Torstai;1;0;1
94;04.01.2018;2018;01;10;Torstai;0;0;0
94;04.01.2018;2018;01;11;Torstai;0;0;0
94;04.01.2018;2018;01;12;Torstai;1;0;1
94;04.01.2018;2018;01;13;Torstai;0;0;0
94;04.01.2018;2018;01;14;Torstai;6;0;6
94;04.01.2018;2018;01;15;Torstai;5;0;5
94;04.01.2018;2018;01;16;Torstai;2;0;2
94;04.01.2018;2018;01;17;Torstai;3;0;3
94;04.01.2018;2018;01;18;Torstai;3;0;3
94;04.01.2018;2018;01;19;Torstai;1;0;1
94;04.01.2018;2018;01;20;Torstai;5;0;5
94;04.01.2018;2018;01;21;Torstai;1;0;1
94;04.01.2018;2018;01;22;Torstai;1;0;1
94;04.01.2018;2018;01;23;Torstai;0;0;0
94;05.01.2018;2018;01;00;Perjantai;0;0;0
94;05.01.2018;2018;01;01;Perjantai;0;0;0
94;05.01.2018;2018;01;02;Perjantai;0;0;0
94;05.01.2018;2018;01;03;Perjantai;0;0;0
94;05.01.2018;2018;01;04;Perjantai;0;0;0
94;05.01.2018;2018;01;05;Perjantai;3;3;6
94;05.01.2018;2018;01;06;Perjantai;2;0;2
94;05.01.2018;2018;01;07;Perjantai;6;0;6
94;05.01.2018;2018;01;08;Perjantai;1;1;2
94;05.01.2018;2018;01;09;Perjantai;0;0;0
94;05.01.2018;2018;01;10;Perjantai;0;0;0
94;05.01.2018;2018;01;11;Perjantai;0;0;0
94;05.01.2018;2018;01;12;Perjantai;0;0;0
94;05.01.2018;2018;01;13;Perjantai;0;0;0
94;05.01.2018;2018;01;14;Perjantai;2;1;3
94;05.01.2018;2018;01;15;Perjantai;0;8;8
94;05.01.2018;2018;01;16;Perjantai;0;4;4
94;05.01.2018;2018;01;17;Perjantai;0;3;3
94;05.01.2018;2018;01;18;Perjantai;0;0;0
94;05.01.2018;2018;01;19;Perjantai;0;0;0
94;05.01.2018;2018;01;20;Perjantai;0;3;3
94;05.01.2018;2018;01;21;Perjantai;0;1;1
94;05.01.2018;2018;01;22;Perjantai;1;0;1
94;05.01.2018;2018;01;23;Perjantai;1;0;1
94;06.01.2018;2018;01;00;Lauantai;0;0;0
94;06.01.2018;2018;01;01;Lauantai;0;0;0
94;06.01.2018;2018;01;02;Lauantai;0;0;0
94;06.01.2018;2018;01;03;Lauantai;0;0;0
94;06.01.2018;2018;01;04;Lauantai;0;0;0
94;06.01.2018;2018;01;05;Lauantai;0;0;0
94;06.01.2018;2018;01;06;Lauantai;0;0;0
94;06.01.2018;2018;01;07;Lauantai;0;0;0
94;06.01.2018;2018;01;08;Lauantai;0;0;0
94;06.01.2018;2018;01;09;Lauantai;1;1;2
94;06.01.2018;2018;01;10;Lauantai;0;2;2
94;06.01.2018;2018;01;11;Lauantai;0;0;0
94;06.01.2018;2018;01;12;Lauantai;1;3;4
94;06.01.2018;2018;01;13;Lauantai;0;1;1
94;06.01.2018;2018;01;14;Lauantai;3;2;5
94;06.01.2018;2018;01;15;Lauantai;1;1;2
94;06.01.2018;2018;01;16;Lauantai;0;1;1
94;06.01.2018;2018;01;17;Lauantai;0;0;0
94;06.01.2018;2018;01;18;Lauantai;0;2;2
94;06.01.2018;2018;01;19;Lauantai;0;1;1
94;06.01.2018;2018;01;20;Lauantai;0;0;0
94;06.01.2018;2018;01;21;Lauantai;0;0;0
94;06.01.2018;2018;01;22;Lauantai;0;0;0
94;06.01.2018;2018;01;23;Lauantai;1;0;1
94;07.01.2018;2018;01;00;Sunnuntai;0;0;0
94;07.01.2018;2018;01;01;Sunnuntai;0;0;0
94;07.01.2018;2018;01;02;Sunnuntai;0;0;0
94;07.01.2018;2018;01;03;Sunnuntai;0;0;0
94;07.01.2018;2018;01;04;Sunnuntai;0;0;0
94;07.01.2018;2018;01;05;Sunnuntai;0;0;0
94;07.01.2018;2018;01;06;Sunnuntai;0;0;0
94;07.01.2018;2018;01;07;Sunnuntai;0;0;0
94;07.01.2018;2018;01;08;Sunnuntai;0;0;0
94;07.01.2018;2018;01;09;Sunnuntai;0;0;0
94;07.01.2018;2018;01;10;Sunnuntai;1;0;1
94;07.01.2018;2018;01;11;Sunnuntai;1;2;3
94;07.01.2018;2018;01;12;Sunnuntai;2;1;3
94;07.01.2018;2018;01;13;Sunnuntai;0;1;1
94;07.01.2018;2018;01;14;Sunnuntai;3;0;3
94;07.01.2018;2018;01;15;Sunnuntai;0;2;2
94;07.01.2018;2018;01;16;Sunnuntai;0;0;0
94;07.01.2018;2018;01;17;Sunnuntai;0;0;0
94;07.01.2018;2018;01;18;Sunnuntai;0;1;1
94;07.01.2018;2018;01;19;Sunnuntai;2;0;2
94;07.01.2018;2018;01;20;Sunnuntai;0;0;0
94;07.01.2018;2018;01;21;Sunnuntai;0;0;0
94;07.01.2018;2018;01;22;Sunnuntai;0;0;0
94;07.01.2018;2018;01;23;Sunnuntai;0;0;0
94;08.01.2018;2018;01;00;Maanantai;0;0;0
94;08.01.2018;2018;01;01;Maanantai;0;0;0
94;08.01.2018;2018;01;02;Maanantai;0;0;0
94;08.01.2018;2018;01;03;Maanantai;0;0;0
94;08.01.2018;2018;01;04;Maanantai;1;0;1
94;08.01.2018;2018;01;05;Maanantai;2;1;3
94;08.01.2018;2018;01;06;Maanantai;3;0;3
94;08.01.2018;2018;01;07;Maanantai;6;0;6
94;08.01.2018;2018;01;08;Maanantai;5;2;7
94;08.01.2018;2018;01;09;Maanantai;1;0;1
94;08.01.2018;2018;01;10;Maanantai;0;0;0
94;08.01.2018;2018;01;11;Maanantai;0;0;0
94;08.01.2018;2018;01;12;Maanantai;0;2;2
94;08.01.2018;2018;01;13;Maanantai;1;0;1
94;08.01.2018;2018;01;14;Maanantai;1;2;3
94;08.01.2018;2018;01;15;Maanantai;0;3;3
94;08.01.2018;2018;01;16;Maanantai;0;7;7
94;08.01.2018;2018;01;17;Maanantai;1;1;2
94;08.01.2018;2018;01;18;Maanantai;0;2;2
94;08.01.2018;2018;01;19;Maanantai;2;4;6
94;08.01.2018;2018;01;20;Maanantai;0;1;1
94;08.01.2018;2018;01;21;Maanantai;0;2;2
94;08.01.2018;2018;01;22;Maanantai;0;0;0
94;08.01.2018;2018;01;23;Maanantai;1;0;1
94;09.01.2018;2018;01;00;Tiistai;0;0;0
94;09.01.2018;2018;01;01;Tiistai;0;0;0
94;09.01.2018;2018;01;02;Tiistai;0;0;0
94;09.01.2018;2018;01;03;Tiistai;0;0;0
94;09.01.2018;2018;01;04;Tiistai;0;0;0
94;09.01.2018;2018;01;05;Tiistai;3;1;4
94;09.01.2018;2018;01;06;Tiistai;5;2;7
94;09.01.2018;2018;01;07;Tiistai;7;0;7
94;09.01.2018;2018;01;08;Tiistai;4;1;5
94;09.01.2018;2018;01;09;Tiistai;1;0;1
94;09.01.2018;2018;01;10;Tiistai;0;1;1
94;09.01.2018;2018;01;11;Tiistai;2;0;2
94;09.01.2018;2018;01;12;Tiistai;0;0;0
94;09.01.2018;2018;01;13;Tiistai;0;1;1
94;09.01.2018;2018;01;14;Tiistai;1;3;4
94;09.01.2018;2018;01;15;Tiistai;0;8;8
94;09.01.2018;2018;01;16;Tiistai;0;5;5
94;09.01.2018;2018;01;17;Tiistai;0;3;3
94;09.01.2018;2018;01;18;Tiistai;1;3;4
94;09.01.2018;2018;01;19;Tiistai;0;3;3
94;09.01.2018;2018;01;20;Tiistai;1;3;4
94;09.01.2018;2018;01;21;Tiistai;1;0;1
94;09.01.2018;2018;01;22;Tiistai;0;0;0
94;09.01.2018;2018;01;23;Tiistai;0;0;0
94;10.01.2018;2018;01;00;Keskiviikko;0;0;0
94;10.01.2018;2018;01;01;Keskiviikko;0;0;0
94;10.01.2018;2018;01;02;Keskiviikko;0;0;0
94;10.01.2018;2018;01;03;Keskiviikko;0;0;0
94;10.01.2018;2018;01;04;Keskiviikko;0;0;0
94;10.01.2018;2018;01;05;Keskiviikko;3;2;5
94;10.01.2018;2018;01;06;Keskiviikko;2;0;2
94;10.01.2018;2018;01;07;Keskiviikko;11;0;11
94;10.01.2018;2018;01;08;Keskiviikko;8;0;8
94;10.01.2018;2018;01;09;Keskiviikko;1;0;1
94;10.01.2018;2018;01;10;Keskiviikko;1;0;1
94;10.01.2018;2018;01;11;Keskiviikko;2;0;2
94;10.01.2018;2018;01;12;Keskiviikko;0;2;2
94;10.01.2018;2018;01;13;Keskiviikko;1;3;4
94;10.01.2018;2018;01;14;Keskiviikko;1;4;5
94;10.01.2018;2018;01;15;Keskiviikko;0;7;7
94;10.01.2018;2018;01;16;Keskiviikko;0;12;12
94;10.01.2018;2018;01;17;Keskiviikko;1;0;1
94;10.01.2018;2018;01;18;Keskiviikko;1;2;3
94;10.01.2018;2018;01;19;Keskiviikko;1;2;3
94;10.01.2018;2018;01;20;Keskiviikko;0;3;3
94;10.01.2018;2018;01;21;Keskiviikko;0;4;4
94;10.01.2018;2018;01;22;Keskiviikko;0;1;1
94;10.01.2018;2018;01;23;Keskiviikko;0;0;0
94;11.01.2018;2018;01;00;Torstai;0;0;0
94;11.01.2018;2018;01;01;Torstai;0;0;0
94;11.01.2018;2018;01;02;Torstai;0;0;0
94;11.01.2018;2018;01;03;Torstai;0;0;0
94;11.01.2018;2018;01;04;Torstai;0;0;0
94;11.01.2018;2018;01;05;Torstai;3;1;4
94;11.01.2018;2018;01;06;Torstai;6;0;6
94;11.01.2018;2018;01;07;Torstai;5;2;7
94;11.01.2018;2018;01;08;Torstai;1;0;1
94;11.01.2018;2018;01;09;Torstai;0;0;0
94;11.01.2018;2018;01;10;Torstai;0;0;0
94;11.01.2018;2018;01;11;Torstai;1;0;1
94;11.01.2018;2018;01;12;Torstai;0;3;3
94;11.01.2018;2018;01;13;Torstai;1;1;2
94;11.01.2018;2018;01;14;Torstai;2;2;4
94;11.01.2018;2018;01;15;Torstai;0;5;5
94;11.01.2018;2018;01;16;Torstai;1;10;11
94;11.01.2018;2018;01;17;Torstai;0;5;5
94;11.01.2018;2018;01;18;Torstai;0;2;2
94;11.01.2018;2018;01;19;Torstai;1;1;2
94;11.01.2018;2018;01;20;Torstai;0;0;0
94;11.01.2018;2018;01;21;Torstai;0;1;1
94;11.01.2018;2018;01;22;Torstai;0;0;0
94;11.01.2018;2018;01;23;Torstai;0;0;0
94;12.01.2018;2018;01;00;Perjantai;0;0;0
94;12.01.2018;2018;01;01;Perjantai;0;0;0
94;12.01.2018;2018;01;02;Perjantai;0;0;0
94;12.01.2018;2018;01;03;Perjantai;0;0;0
94;12.01.2018;2018;01;04;Perjantai;0;0;0
94;12.01.2018;2018;01;05;Perjantai;4;2;6
94;12.01.2018;2018;01;06;Perjantai;3;0;3
94;12.01.2018;2018;01;07;Perjantai;5;1;6
94;12.01.2018;2018;01;08;Perjantai;2;0;2
94;12.01.2018;2018;01;09;Perjantai;2;1;3
94;12.01.2018;2018;01;10;Perjantai;1;1;2
94;12.01.2018;2018;01;11;Perjantai;2;0;2
94;12.01.2018;2018;01;12;Perjantai;2;0;2
94;12.01.2018;2018;01;13;Perjantai;0;3;3
94;12.01.2018;2018;01;14;Perjantai;1;5;6
94;12.01.2018;2018;01;15;Perjantai;0;5;5
94;12.01.2018;2018;01;16;Perjantai;0;11;11
94;12.01.2018;2018;01;17;Perjantai;2;1;3
94;12.01.2018;2018;01;18;Perjantai;0;1;1
94;12.01.2018;2018;01;19;Perjantai;0;3;3
94;12.01.2018;2018;01;20;Perjantai;0;1;1
94;12.01.2018;2018;01;21;Perjantai;0;0;0
94;12.01.2018;2018;01;22;Perjantai;0;2;2
94;12.01.2018;2018;01;23;Perjantai;2;0;2
94;13.01.2018;2018;01;00;Lauantai;0;0;0
94;13.01.2018;2018;01;01;Lauantai;0;0;0
94;13.01.2018;2018;01;02;Lauantai;0;0;0
94;13.01.2018;2018;01;03;Lauantai;0;0;0
94;13.01.2018;2018;01;04;Lauantai;0;0;0
94;13.01.2018;2018;01;05;Lauantai;0;0;0
94;13.01.2018;2018;01;06;Lauantai;0;1;1
94;13.01.2018;2018;01;07;Lauantai;0;0;0
94;13.01.2018;2018;01;08;Lauantai;0;0;0
94;13.01.2018;2018;01;09;Lauantai;0;0;0
94;13.01.2018;2018;01;10;Lauantai;0;1;1
94;13.01.2018;2018;01;11;Lauantai;2;1;3
94;13.01.2018;2018;01;12;Lauantai;0;0;0
94;13.01.2018;2018;01;13;Lauantai;1;0;1
94;13.01.2018;2018;01;14;Lauantai;1;0;1
94;13.01.2018;2018;01;15;Lauantai;1;2;3
94;13.01.2018;2018;01;16;Lauantai;0;0;0
94;13.01.2018;2018;01;17;Lauantai;0;0;0
94;13.01.2018;2018;01;18;Lauantai;1;1;2
94;13.01.2018;2018;01;19;Lauantai;0;1;1
94;13.01.2018;2018;01;20;Lauantai;0;2;2
94;13.01.2018;2018;01;21;Lauantai;0;0;0
94;13.01.2018;2018;01;22;Lauantai;0;0;0
94;13.01.2018;2018;01;23;Lauantai;2;0;2
94;14.01.2018;2018;01;00;Sunnuntai;0;0;0
94;14.01.2018;2018;01;01;Sunnuntai;0;0;0
94;14.01.2018;2018;01;02;Sunnuntai;0;1;1
94;14.01.2018;2018;01;03;Sunnuntai;0;0;0
94;14.01.2018;2018;01;04;Sunnuntai;0;0;0
94;14.01.2018;2018;01;05;Sunnuntai;0;0;0
94;14.01.2018;2018;01;06;Sunnuntai;1;0;1
94;14.01.2018;2018;01;07;Sunnuntai;0;0;0
94;14.01.2018;2018;01;08;Sunnuntai;1;0;1
94;14.01.2018;2018;01;09;Sunnuntai;1;1;2
94;14.01.2018;2018;01;10;Sunnuntai;0;3;3
94;14.01.2018;2018;01;11;Sunnuntai;0;1;1
94;14.01.2018;2018;01;12;Sunnuntai;1;1;2
94;14.01.2018;2018;01;13;Sunnuntai;0;1;1
94;14.01.2018;2018;01;14;Sunnuntai;1;0;1
94;14.01.2018;2018;01;15;Sunnuntai;3;1;4
94;14.01.2018;2018;01;16;Sunnuntai;0;2;2
94;14.01.2018;2018;01;17;Sunnuntai;2;0;2
94;14.01.2018;2018;01;18;Sunnuntai;0;0;0
94;14.01.2018;2018;01;19;Sunnuntai;1;1;2
94;14.01.2018;2018;01;20;Sunnuntai;0;1;1
94;14.01.2018;2018;01;21;Sunnuntai;0;0;0
94;14.01.2018;2018;01;22;Sunnuntai;0;0;0
94;14.01.2018;2018;01;23;Sunnuntai;0;0;0
94;15.01.2018;2018;01;00;Maanantai;0;0;0
94;15.01.2018;2018;01;01;Maanantai;0;0;0
94;15.01.2018;2018;01;02;Maanantai;0;0;0
94;15.01.2018;2018;01;03;Maanantai;0;0;0
94;15.01.2018;2018;01;04;Maanantai;0;0;0
94;15.01.2018;2018;01;05;Maanantai;1;1;2
94;15.01.2018;2018;01;06;Maanantai;5;0;5
94;15.01.2018;2018;01;07;Maanantai;7;0;7
94;15.01.2018;2018;01;08;Maanantai;7;0;7
94;15.01.2018;2018;01;09;Maanantai;1;0;1
94;15.01.2018;2018;01;10;Maanantai;1;1;2
94;15.01.2018;2018;01;11;Maanantai;0;0;0
94;15.01.2018;2018;01;12;Maanantai;0;0;0
94;15.01.2018;2018;01;13;Maanantai;1;0;1
94;15.01.2018;2018;01;14;Maanantai;1;3;4
94;15.01.2018;2018;01;15;Maanantai;0;5;5
94;15.01.2018;2018;01;16;Maanantai;2;8;10
94;15.01.2018;2018;01;17;Maanantai;0;5;5
94;15.01.2018;2018;01;18;Maanantai;0;1;1
94;15.01.2018;2018;01;19;Maanantai;1;2;3
94;15.01.2018;2018;01;20;Maanantai;0;1;1
94;15.01.2018;2018;01;21;Maanantai;0;0;0
94;15.01.2018;2018;01;22;Maanantai;0;1;1
94;15.01.2018;2018;01;23;Maanantai;0;0;0
94;16.01.2018;2018;01;00;Tiistai;0;0;0
94;16.01.2018;2018;01;01;Tiistai;0;0;0
94;16.01.2018;2018;01;02;Tiistai;0;0;0
94;16.01.2018;2018;01;03;Tiistai;0;0;0
94;16.01.2018;2018;01;04;Tiistai;0;0;0
94;16.01.2018;2018;01;05;Tiistai;3;1;4
94;16.01.2018;2018;01;06;Tiistai;4;1;5
94;16.01.2018;2018;01;07;Tiistai;6;0;6
94;16.01.2018;2018;01;08;Tiistai;3;0;3
94;16.01.2018;2018;01;09;Tiistai;0;0;0
94;16.01.2018;2018;01;10;Tiistai;0;0;0
94;16.01.2018;2018;01;11;Tiistai;0;1;1
94;16.01.2018;2018;01;12;Tiistai;0;0;0
94;16.01.2018;2018;01;13;Tiistai;0;0;0
94;16.01.2018;2018;01;14;Tiistai;1;3;4
94;16.01.2018;2018;01;15;Tiistai;0;3;3
94;16.01.2018;2018;01;16;Tiistai;1;10;11
94;16.01.2018;2018;01;17;Tiistai;0;2;2
94;16.01.2018;2018;01;18;Tiistai;0;2;2
94;16.01.2018;2018;01;19;Tiistai;1;3;4
94;16.01.2018;2018;01;20;Tiistai;0;0;0
94;16.01.2018;2018;01;21;Tiistai;0;0;0
94;16.01.2018;2018;01;22;Tiistai;0;0;0
94;16.01.2018;2018;01;23;Tiistai;0;0;0
94;17.01.2018;2018;01;00;Keskiviikko;0;0;0
94;17.01.2018;2018;01;01;Keskiviikko;0;1;1
94;17.01.2018;2018;01;02;Keskiviikko;0;0;0
94;17.01.2018;2018;01;03;Keskiviikko;0;0;0
94;17.01.2018;2018;01;04;Keskiviikko;0;0;0
94;17.01.2018;2018;01;05;Keskiviikko;3;1;4
94;17.01.2018;2018;01;06;Keskiviikko;4;0;4
94;17.01.2018;2018;01;07;Keskiviikko;6;0;6
94;17.01.2018;2018;01;08;Keskiviikko;5;1;6
94;17.01.2018;2018;01;09;Keskiviikko;0;0;0
94;17.01.2018;2018;01;10;Keskiviikko;0;0;0
94;17.01.2018;2018;01;11;Keskiviikko;0;0;0
94;17.01.2018;2018;01;12;Keskiviikko;0;0;0
94;17.01.2018;2018;01;13;Keskiviikko;2;0;2
94;17.01.2018;2018;01;14;Keskiviikko;2;3;5
94;17.01.2018;2018;01;15;Keskiviikko;0;6;6
94;17.01.2018;2018;01;16;Keskiviikko;0;13;13
94;17.01.2018;2018;01;17;Keskiviikko;1;7;8
94;17.01.2018;2018;01;18;Keskiviikko;0;3;3
94;17.01.2018;2018;01;19;Keskiviikko;1;3;4
94;17.01.2018;2018;01;20;Keskiviikko;0;0;0
94;17.01.2018;2018;01;21;Keskiviikko;0;1;1
94;17.01.2018;2018;01;22;Keskiviikko;1;1;2
94;17.01.2018;2018;01;23;Keskiviikko;0;0;0
94;18.01.2018;2018;01;00;Torstai;0;0;0
94;18.01.2018;2018;01;01;Torstai;0;0;0
94;18.01.2018;2018;01;02;Torstai;0;0;0
94;18.01.2018;2018;01;03;Torstai;0;0;0
94;18.01.2018;2018;01;04;Torstai;0;0;0
94;18.01.2018;2018;01;05;Torstai;0;4;4
94;18.01.2018;2018;01;06;Torstai;3;0;3
94;18.01.2018;2018;01;07;Torstai;8;0;8
94;18.01.2018;2018;01;08;Torstai;4;3;7
94;18.01.2018;2018;01;09;Torstai;1;0;1
94;18.01.2018;2018;01;10;Torstai;0;0;0
94;18.01.2018;2018;01;11;Torstai;1;0;1
94;18.01.2018;2018;01;12;Torstai;0;3;3
94;18.01.2018;2018;01;13;Torstai;0;2;2
94;18.01.2018;2018;01;14;Torstai;1;2;3
94;18.01.2018;2018;01;15;Torstai;0;3;3
94;18.01.2018;2018;01;16;Torstai;2;7;9
94;18.01.2018;2018;01;17;Torstai;2;2;4
94;18.01.2018;2018;01;18;Torstai;0;1;1
94;18.01.2018;2018;01;19;Torstai;0;7;7
94;18.01.2018;2018;01;20;Torstai;1;0;1
94;18.01.2018;2018;01;21;Torstai;0;0;0
94;18.01.2018;2018;01;22;Torstai;0;0;0
94;18.01.2018;2018;01;23;Torstai;0;0;0
94;19.01.2018;2018;01;00;Perjantai;0;0;0
94;19.01.2018;2018;01;01;Perjantai;0;0;0
94;19.01.2018;2018;01;02;Perjantai;0;0;0
94;19.01.2018;2018;01;03;Perjantai;0;0;0
94;19.01.2018;2018;01;04;Perjantai;0;0;0
94;19.01.2018;2018;01;05;Perjantai;4;1;5
94;19.01.2018;2018;01;06;Perjantai;2;0;2
94;19.01.2018;2018;01;07;Perjantai;4;0;4
94;19.01.2018;2018;01;08;Perjantai;1;0;1
94;19.01.2018;2018;01;09;Perjantai;4;0;4
94;19.01.2018;2018;01;10;Perjantai;0;0;0
94;19.01.2018;2018;01;11;Perjantai;0;2;2
94;19.01.2018;2018;01;12;Perjantai;0;0;0
94;19.01.2018;2018;01;13;Perjantai;1;2;3
94;19.01.2018;2018;01;14;Perjantai;2;3;5
94;19.01.2018;2018;01;15;Perjantai;0;4;4
94;19.01.2018;2018;01;16;Perjantai;0;3;3
94;19.01.2018;2018;01;17;Perjantai;0;1;1
94;19.01.2018;2018;01;18;Perjantai;1;1;2
94;19.01.2018;2018;01;19;Perjantai;0;2;2
94;19.01.2018;2018;01;20;Perjantai;0;2;2
94;19.01.2018;2018;01;21;Perjantai;0;0;0
94;19.01.2018;2018;01;22;Perjantai;0;0;0
94;19.01.2018;2018;01;23;Perjantai;0;0;0
94;20.01.2018;2018;01;00;Lauantai;0;0;0
94;20.01.2018;2018;01;01;Lauantai;2;0;2
94;20.01.2018;2018;01;02;Lauantai;0;0;0
94;20.01.2018;2018;01;03;Lauantai;0;0;0
94;20.01.2018;2018;01;04;Lauantai;0;0;0
94;20.01.2018;2018;01;05;Lauantai;0;1;1
94;20.01.2018;2018;01;06;Lauantai;0;0;0
94;20.01.2018;2018;01;07;Lauantai;1;1;2
94;20.01.2018;2018;01;08;Lauantai;0;0;0
94;20.01.2018;2018;01;09;Lauantai;0;0;0
94;20.01.2018;2018;01;10;Lauantai;0;0;0
94;20.01.2018;2018;01;11;Lauantai;1;0;1
94;20.01.2018;2018;01;12;Lauantai;0;0;0
94;20.01.2018;2018;01;13;Lauantai;2;0;2
94;20.01.2018;2018;01;14;Lauantai;1;0;1
94;20.01.2018;2018;01;15;Lauantai;0;1;1
94;20.01.2018;2018;01;16;Lauantai;0;1;1
94;20.01.2018;2018;01;17;Lauantai;1;0;1
94;20.01.2018;2018;01;18;Lauantai;4;1;5
94;20.01.2018;2018;01;19;Lauantai;0;0;0
94;20.01.2018;2018;01;20;Lauantai;0;1;1
94;20.01.2018;2018;01;21;Lauantai;0;1;1
94;20.01.2018;2018;01;22;Lauantai;0;0;0
94;20.01.2018;2018;01;23;Lauantai;0;2;2
94;21.01.2018;2018;01;00;Sunnuntai;0;0;0
94;21.01.2018;2018;01;01;Sunnuntai;1;0;1
94;21.01.2018;2018;01;02;Sunnuntai;0;0;0
94;21.01.2018;2018;01;03;Sunnuntai;0;1;1
94;21.01.2018;2018;01;04;Sunnuntai;0;0;0
94;21.01.2018;2018;01;05;Sunnuntai;1;0;1
94;21.01.2018;2018;01;06;Sunnuntai;0;0;0
94;21.01.2018;2018;01;07;Sunnuntai;0;1;1
94;21.01.2018;2018;01;08;Sunnuntai;0;0;0
94;21.01.2018;2018;01;09;Sunnuntai;1;1;2
94;21.01.2018;2018;01;10;Sunnuntai;0;3;3
94;21.01.2018;2018;01;11;Sunnuntai;2;0;2
94;21.01.2018;2018;01;12;Sunnuntai;1;0;1
94;21.01.2018;2018;01;13;Sunnuntai;2;0;2
94;21.01.2018;2018;01;14;Sunnuntai;0;0;0
94;21.01.2018;2018;01;15;Sunnuntai;3;1;4
94;21.01.2018;2018;01;16;Sunnuntai;0;1;1
94;21.01.2018;2018;01;17;Sunnuntai;0;0;0
94;21.01.2018;2018;01;18;Sunnuntai;1;0;1
94;21.01.2018;2018;01;19;Sunnuntai;0;1;1
94;21.01.2018;2018;01;20;Sunnuntai;1;0;1
94;21.01.2018;2018;01;21;Sunnuntai;0;1;1
94;21.01.2018;2018;01;22;Sunnuntai;0;0;0
94;21.01.2018;2018;01;23;Sunnuntai;0;0;0
94;22.01.2018;2018;01;00;Maanantai;0;0;0
94;22.01.2018;2018;01;01;Maanantai;0;0;0
94;22.01.2018;2018;01;02;Maanantai;0;0;0
94;22.01.2018;2018;01;03;Maanantai;0;0;0
94;22.01.2018;2018;01;04;Maanantai;0;1;1
94;22.01.2018;2018;01;05;Maanantai;3;1;4
94;22.01.2018;2018;01;06;Maanantai;5;0;5
94;22.01.2018;2018;01;07;Maanantai;5;0;5
94;22.01.2018;2018;01;08;Maanantai;2;0;2
94;22.01.2018;2018;01;09;Maanantai;0;0;0
94;22.01.2018;2018;01;10;Maanantai;0;2;2
94;22.01.2018;2018;01;11;Maanantai;1;0;1
94;22.01.2018;2018;01;12;Maanantai;0;0;0
94;22.01.2018;2018;01;13;Maanantai;1;0;1
94;22.01.2018;2018;01;14;Maanantai;1;3;4
94;22.01.2018;2018;01;15;Maanantai;0;5;5
94;22.01.2018;2018;01;16;Maanantai;0;4;4
94;22.01.2018;2018;01;17;Maanantai;0;1;1
94;22.01.2018;2018;01;18;Maanantai;0;1;1
94;22.01.2018;2018;01;19;Maanantai;0;1;1
94;22.01.2018;2018;01;20;Maanantai;0;0;0
94;22.01.2018;2018;01;21;Maanantai;0;0;0
94;22.01.2018;2018;01;22;Maanantai;0;2;2
94;22.01.2018;2018;01;23;Maanantai;0;0;0
94;23.01.2018;2018;01;00;Tiistai;0;0;0
94;23.01.2018;2018;01;01;Tiistai;0;0;0
94;23.01.2018;2018;01;02;Tiistai;0;0;0
94;23.01.2018;2018;01;03;Tiistai;0;0;0
94;23.01.2018;2018;01;04;Tiistai;0;0;0
94;23.01.2018;2018;01;05;Tiistai;2;1;3
94;23.01.2018;2018;01;06;Tiistai;2;0;2
94;23.01.2018;2018;01;07;Tiistai;6;0;6
94;23.01.2018;2018;01;08;Tiistai;2;0;2
94;23.01.2018;2018;01;09;Tiistai;0;0;0
94;23.01.2018;2018;01;10;Tiistai;0;0;0
94;23.01.2018;2018;01;11;Tiistai;0;0;0
94;23.01.2018;2018;01;12;Tiistai;0;0;0
94;23.01.2018;2018;01;13;Tiistai;0;0;0
94;23.01.2018;2018;01;14;Tiistai;1;0;1
94;23.01.2018;2018;01;15;Tiistai;0;7;7
94;23.01.2018;2018;01;16;Tiistai;0;4;4
94;23.01.2018;2018;01;17;Tiistai;0;3;3
94;23.01.2018;2018;01;18;Tiistai;0;1;1
94;23.01.2018;2018;01;19;Tiistai;0;3;3
94;23.01.2018;2018;01;20;Tiistai;1;0;1
94;23.01.2018;2018;01;21;Tiistai;0;0;0
94;23.01.2018;2018;01;22;Tiistai;0;0;0
94;23.01.2018;2018;01;23;Tiistai;0;0;0
94;24.01.2018;2018;01;00;Keskiviikko;0;0;0
94;24.01.2018;2018;01;01;Keskiviikko;0;0;0
94;24.01.2018;2018;01;02;Keskiviikko;0;0;0
94;24.01.2018;2018;01;03;Keskiviikko;0;0;0
94;24.01.2018;2018;01;04;Keskiviikko;0;0;0
94;24.01.2018;2018;01;05;Keskiviikko;3;1;4
94;24.01.2018;2018;01;06;Keskiviikko;3;0;3
94;24.01.2018;2018;01;07;Keskiviikko;6;1;7
94;24.01.2018;2018;01;08;Keskiviikko;3;0;3
94;24.01.2018;2018;01;09;Keskiviikko;2;0;2
94;24.01.2018;2018;01;10;Keskiviikko;0;0;0
94;24.01.2018;2018;01;11;Keskiviikko;0;0;0
94;24.01.2018;2018;01;12;Keskiviikko;0;0;0
94;24.01.2018;2018;01;13;Keskiviikko;0;2;2
94;24.01.2018;2018;01;14;Keskiviikko;1;6;7
94;24.01.2018;2018;01;15;Keskiviikko;1;2;3
94;24.01.2018;2018;01;16;Keskiviikko;1;7;8
94;24.01.2018;2018;01;17;Keskiviikko;1;4;5
94;24.01.2018;2018;01;18;Keskiviikko;0;2;2
94;24.01.2018;2018;01;19;Keskiviikko;0;2;2
94;24.01.2018;2018;01;20;Keskiviikko;1;0;1
94;24.01.2018;2018;01;21;Keskiviikko;0;1;1
94;24.01.2018;2018;01;22;Keskiviikko;0;2;2
94;24.01.2018;2018;01;23;Keskiviikko;0;0;0
94;25.01.2018;2018;01;00;Torstai;0;0;0
94;25.01.2018;2018;01;01;Torstai;0;0;0
94;25.01.2018;2018;01;02;Torstai;0;0;0
94;25.01.2018;2018;01;03;Torstai;0;0;0
94;25.01.2018;2018;01;04;Torstai;0;0;0
94;25.01.2018;2018;01;05;Torstai;2;0;2
94;25.01.2018;2018;01;06;Torstai;0;0;0
94;25.01.2018;2018;01;07;Torstai;3;0;3
94;25.01.2018;2018;01;08;Torstai;6;1;7
94;25.01.2018;2018;01;09;Torstai;1;0;1
94;25.01.2018;2018;01;10;Torstai;0;1;1
94;25.01.2018;2018;01;11;Torstai;0;0;0
94;25.01.2018;2018;01;12;Torstai;1;0;1
94;25.01.2018;2018;01;13;Torstai;0;0;0
94;25.01.2018;2018;01;14;Torstai;0;2;2
94;25.01.2018;2018;01;15;Torstai;0;1;1
94;25.01.2018;2018;01;16;Torstai;1;5;6
94;25.01.2018;2018;01;17;Torstai;0;4;4
94;25.01.2018;2018;01;18;Torstai;0;1;1
94;25.01.2018;2018;01;19;Torstai;0;0;0
94;25.01.2018;2018;01;20;Torstai;0;0;0
94;25.01.2018;2018;01;21;Torstai;0;0;0
94;25.01.2018;2018;01;22;Torstai;0;0;0
94;25.01.2018;2018;01;23;Torstai;0;0;0
94;26.01.2018;2018;01;00;Perjantai;0;0;0
94;26.01.2018;2018;01;01;Perjantai;0;0;0
94;26.01.2018;2018;01;02;Perjantai;0;0;0
94;26.01.2018;2018;01;03;Perjantai;0;0;0
94;26.01.2018;2018;01;04;Perjantai;0;0;0
94;26.01.2018;2018;01;05;Perjantai;3;1;4
94;26.01.2018;2018;01;06;Perjantai;4;0;4
94;26.01.2018;2018;01;07;Perjantai;6;0;6
94;26.01.2018;2018;01;08;Perjantai;3;0;3
94;26.01.2018;2018;01;09;Perjantai;2;0;2
94;26.01.2018;2018;01;10;Perjantai;0;0;0
94;26.01.2018;2018;01;11;Perjantai;1;1;2
94;26.01.2018;2018;01;12;Perjantai;0;1;1
94;26.01.2018;2018;01;13;Perjantai;2;1;3
94;26.01.2018;2018;01;14;Perjantai;3;4;7
94;26.01.2018;2018;01;15;Perjantai;0;4;4
94;26.01.2018;2018;01;16;Perjantai;0;4;4
94;26.01.2018;2018;01;17;Perjantai;1;7;8
94;26.01.2018;2018;01;18;Perjantai;2;3;5
94;26.01.2018;2018;01;19;Perjantai;0;3;3
94;26.01.2018;2018;01;20;Perjantai;0;1;1
94;26.01.2018;2018;01;21;Perjantai;0;0;0
94;26.01.2018;2018;01;22;Perjantai;0;0;0
94;26.01.2018;2018;01;23;Perjantai;0;0;0
94;27.01.2018;2018;01;00;Lauantai;0;0;0
94;27.01.2018;2018;01;01;Lauantai;0;0;0
94;27.01.2018;2018;01;02;Lauantai;0;0;0
94;27.01.2018;2018;01;03;Lauantai;2;0;2
94;27.01.2018;2018;01;04;Lauantai;1;0;1
94;27.01.2018;2018;01;05;Lauantai;1;0;1
94;27.01.2018;2018;01;06;Lauantai;0;0;0
94;27.01.2018;2018;01;07;Lauantai;0;0;0
94;27.01.2018;2018;01;08;Lauantai;0;0;0
94;27.01.2018;2018;01;09;Lauantai;0;0;0
94;27.01.2018;2018;01;10;Lauantai;2;0;2
94;27.01.2018;2018;01;11;Lauantai;0;3;3
94;27.01.2018;2018;01;12;Lauantai;0;0;0
94;27.01.2018;2018;01;13;Lauantai;2;1;3
94;27.01.2018;2018;01;14;Lauantai;0;1;1
94;27.01.2018;2018;01;15;Lauantai;2;2;4
94;27.01.2018;2018;01;16;Lauantai;2;1;3
94;27.01.2018;2018;01;17;Lauantai;0;2;2
94;27.01.2018;2018;01;18;Lauantai;1;1;2
94;27.01.2018;2018;01;19;Lauantai;0;0;0
94;27.01.2018;2018;01;20;Lauantai;0;1;1
94;27.01.2018;2018;01;21;Lauantai;0;1;1
94;27.01.2018;2018;01;22;Lauantai;0;1;1
94;27.01.2018;2018;01;23;Lauantai;0;0;0
94;28.01.2018;2018;01;00;Sunnuntai;0;0;0
94;28.01.2018;2018;01;01;Sunnuntai;0;0;0
94;28.01.2018;2018;01;02;Sunnuntai;2;0;2
94;28.01.2018;2018;01;03;Sunnuntai;0;0;0
94;28.01.2018;2018;01;04;Sunnuntai;0;0;0
94;28.01.2018;2018;01;05;Sunnuntai;1;0;1
94;28.01.2018;2018;01;06;Sunnuntai;1;0;1
94;28.01.2018;2018;01;07;Sunnuntai;0;0;0
94;28.01.2018;2018;01;08;Sunnuntai;0;0;0
94;28.01.2018;2018;01;09;Sunnuntai;0;0;0
94;28.01.2018;2018;01;10;Sunnuntai;2;0;2
94;28.01.2018;2018;01;11;Sunnuntai;2;3;5
94;28.01.2018;2018;01;12;Sunnuntai;4;1;5
94;28.01.2018;2018;01;13;Sunnuntai;0;0;0
94;28.01.2018;2018;01;14;Sunnuntai;1;2;3
94;28.01.2018;2018;01;15;Sunnuntai;0;2;2
94;28.01.2018;2018;01;16;Sunnuntai;0;1;1
94;28.01.2018;2018;01;17;Sunnuntai;0;3;3
94;28.01.2018;2018;01;18;Sunnuntai;0;0;0
94;28.01.2018;2018;01;19;Sunnuntai;0;0;0
94;28.01.2018;2018;01;20;Sunnuntai;2;0;2
94;28.01.2018;2018;01;21;Sunnuntai;1;0;1
94;28.01.2018;2018;01;22;Sunnuntai;1;0;1
94;28.01.2018;2018;01;23;Sunnuntai;0;0;0
94;29.01.2018;2018;01;00;Maanantai;0;0;0
94;29.01.2018;2018;01;01;Maanantai;0;0;0
94;29.01.2018;2018;01;02;Maanantai;0;0;0
94;29.01.2018;2018;01;03;Maanantai;0;0;0
94;29.01.2018;2018;01;04;Maanantai;0;0;0
94;29.01.2018;2018;01;05;Maanantai;1;2;3
94;29.01.2018;2018;01;06;Maanantai;2;0;2
94;29.01.2018;2018;01;07;Maanantai;10;0;10
94;29.01.2018;2018;01;08;Maanantai;7;1;8
94;29.01.2018;2018;01;09;Maanantai;3;0;3
94;29.01.2018;2018;01;10;Maanantai;0;0;0
94;29.01.2018;2018;01;11;Maanantai;1;2;3
94;29.01.2018;2018;01;12;Maanantai;0;0;0
94;29.01.2018;2018;01;13;Maanantai;2;1;3
94;29.01.2018;2018;01;14;Maanantai;2;1;3
94;29.01.2018;2018;01;15;Maanantai;1;7;8
94;29.01.2018;2018;01;16;Maanantai;0;10;10
94;29.01.2018;2018;01;17;Maanantai;0;4;4
94;29.01.2018;2018;01;18;Maanantai;1;3;4
94;29.01.2018;2018;01;19;Maanantai;0;4;4
94;29.01.2018;2018;01;20;Maanantai;0;3;3
94;29.01.2018;2018;01;21;Maanantai;1;1;2
94;29.01.2018;2018;01;22;Maanantai;0;2;2
94;29.01.2018;2018;01;23;Maanantai;0;1;1
94;30.01.2018;2018;01;00;Tiistai;0;0;0
94;30.01.2018;2018;01;01;Tiistai;0;0;0
94;30.01.2018;2018;01;02;Tiistai;0;0;0
94;30.01.2018;2018;01;03;Tiistai;0;0;0
94;30.01.2018;2018;01;04;Tiistai;0;0;0
94;30.01.2018;2018;01;05;Tiistai;5;3;8
94;30.01.2018;2018;01;06;Tiistai;2;0;2
94;30.01.2018;2018;01;07;Tiistai;10;0;10
94;30.01.2018;2018;01;08;Tiistai;4;1;5
94;30.01.2018;2018;01;09;Tiistai;1;0;1
94;30.01.2018;2018;01;10;Tiistai;1;0;1
94;30.01.2018;2018;01;11;Tiistai;1;1;2
94;30.01.2018;2018;01;12;Tiistai;0;0;0
94;30.01.2018;2018;01;13;Tiistai;1;2;3
94;30.01.2018;2018;01;14;Tiistai;1;1;2
94;30.01.2018;2018;01;15;Tiistai;0;7;7
94;30.01.2018;2018;01;16;Tiistai;1;10;11
94;30.01.2018;2018;01;17;Tiistai;0;2;2
94;30.01.2018;2018;01;18;Tiistai;0;6;6
94;30.01.2018;2018;01;19;Tiistai;1;2;3
94;30.01.2018;2018;01;20;Tiistai;0;1;1
94;30.01.2018;2018;01;21;Tiistai;1;0;1
94;30.01.2018;2018;01;22;Tiistai;0;1;1
94;30.01.2018;2018;01;23;Tiistai;0;1;1
94;31.01.2018;2018;01;00;Keskiviikko;0;0;0
94;31.01.2018;2018;01;01;Keskiviikko;0;0;0
94;31.01.2018;2018;01;02;Keskiviikko;0;0;0
94;31.01.2018;2018;01;03;Keskiviikko;0;0;0
94;31.01.2018;2018;01;04;Keskiviikko;0;0;0
94;31.01.2018;2018;01;05;Keskiviikko;2;2;4
94;31.01.2018;2018;01;06;Keskiviikko;2;2;4
94;31.01.2018;2018;01;07;Keskiviikko;5;0;5
94;31.01.2018;2018;01;08;Keskiviikko;2;0;2
94;31.01.2018;2018;01;09;Keskiviikko;1;0;1
94;31.01.2018;2018;01;10;Keskiviikko;0;0;0
94;31.01.2018;2018;01;11;Keskiviikko;1;1;2
94;31.01.2018;2018;01;12;Keskiviikko;0;0;0
94;31.01.2018;2018;01;13;Keskiviikko;1;1;2
94;31.01.2018;2018;01;14;Keskiviikko;3;2;5
94;31.01.2018;2018;01;15;Keskiviikko;0;9;9
94;31.01.2018;2018;01;16;Keskiviikko;1;8;9
94;31.01.2018;2018;01;17;Keskiviikko;0;4;4
94;31.01.2018;2018;01;18;Keskiviikko;0;1;1
94;31.01.2018;2018;01;19;Keskiviikko;0;0;0
94;31.01.2018;2018;01;20;Keskiviikko;0;2;2
94;31.01.2018;2018;01;21;Keskiviikko;0;3;3
94;31.01.2018;2018;01;22;Keskiviikko;0;0;0
94;31.01.2018;2018;01;23;Keskiviikko;0;2;2
94;01.02.2018;2018;02;00;Torstai;0;0;0
94;01.02.2018;2018;02;01;Torstai;0;0;0
94;01.02.2018;2018;02;02;Torstai;0;0;0
94;01.02.2018;2018;02;03;Torstai;0;2;2
94;01.02.2018;2018;02;04;Torstai;0;0;0
94;01.02.2018;2018;02;05;Torstai;2;1;3
94;01.02.2018;2018;02;06;Torstai;2;0;2
94;01.02.2018;2018;02;07;Torstai;4;0;4
94;01.02.2018;2018;02;08;Torstai;4;2;6
94;01.02.2018;2018;02;09;Torstai;1;2;3
94;01.02.2018;2018;02;10;Torstai;0;0;0
94;01.02.2018;2018;02;11;Torstai;0;1;1
94;01.02.2018;2018;02;12;Torstai;1;2;3
94;01.02.2018;2018;02;13;Torstai;1;0;1
94;01.02.2018;2018;02;14;Torstai;1;1;2
94;01.02.2018;2018;02;15;Torstai;0;3;3
94;01.02.2018;2018;02;16;Torstai;0;2;2
94;01.02.2018;2018;02;17;Torstai;3;5;8
94;01.02.2018;2018;02;18;Torstai;0;0;0
94;01.02.2018;2018;02;19;Torstai;0;1;1
94;01.02.2018;2018;02;20;Torstai;0;0;0
94;01.02.2018;2018;02;21;Torstai;0;0;0
94;01.02.2018;2018;02;22;Torstai;0;0;0
94;01.02.2018;2018;02;23;Torstai;1;0;1
94;02.02.2018;2018;02;00;Perjantai;0;0;0
94;02.02.2018;2018;02;01;Perjantai;0;0;0
94;02.02.2018;2018;02;02;Perjantai;0;0;0
94;02.02.2018;2018;02;03;Perjantai;0;0;0
94;02.02.2018;2018;02;04;Perjantai;0;0;0
94;02.02.2018;2018;02;05;Perjantai;2;0;2
94;02.02.2018;2018;02;06;Perjantai;2;0;2
94;02.02.2018;2018;02;07;Perjantai;4;0;4
94;02.02.2018;2018;02;08;Perjantai;3;0;3
94;02.02.2018;2018;02;09;Perjantai;1;0;1
94;02.02.2018;2018;02;10;Perjantai;0;0;0
94;02.02.2018;2018;02;11;Perjantai;0;1;1
94;02.02.2018;2018;02;12;Perjantai;0;0;0
94;02.02.2018;2018;02;13;Perjantai;1;2;3
94;02.02.2018;2018;02;14;Perjantai;1;0;1
94;02.02.2018;2018;02;15;Perjantai;1;3;4
94;02.02.2018;2018;02;16;Perjantai;1;4;5
94;02.02.2018;2018;02;17;Perjantai;0;3;3
94;02.02.2018;2018;02;18;Perjantai;0;1;1
94;02.02.2018;2018;02;19;Perjantai;0;2;2
94;02.02.2018;2018;02;20;Perjantai;0;0;0
94;02.02.2018;2018;02;21;Perjantai;0;0;0
94;02.02.2018;2018;02;22;Perjantai;0;1;1
94;02.02.2018;2018;02;23;Perjantai;1;0;1
94;03.02.2018;2018;02;00;Lauantai;0;0;0
94;03.02.2018;2018;02;01;Lauantai;0;0;0
94;03.02.2018;2018;02;02;Lauantai;0;0;0
94;03.02.2018;2018;02;03;Lauantai;0;0;0
94;03.02.2018;2018;02;04;Lauantai;0;0;0
94;03.02.2018;2018;02;05;Lauantai;0;0;0
94;03.02.2018;2018;02;06;Lauantai;0;0;0
94;03.02.2018;2018;02;07;Lauantai;0;0;0
94;03.02.2018;2018;02;08;Lauantai;0;0;0
94;03.02.2018;2018;02;09;Lauantai;1;0;1
94;03.02.2018;2018;02;10;Lauantai;0;0;0
94;03.02.2018;2018;02;11;Lauantai;1;0;1
94;03.02.2018;2018;02;12;Lauantai;0;0;0
94;03.02.2018;2018;02;13;Lauantai;1;3;4
94;03.02.2018;2018;02;14;Lauantai;1;0;1
94;03.02.2018;2018;02;15;Lauantai;0;1;1
94;03.02.2018;2018;02;16;Lauantai;0;0;0
94;03.02.2018;2018;02;17;Lauantai;0;0;0
94;03.02.2018;2018;02;18;Lauantai;0;0;0
94;03.02.2018;2018;02;19;Lauantai;0;0;0
94;03.02.2018;2018;02;20;Lauantai;0;1;1
94;03.02.2018;2018;02;21;Lauantai;0;0;0
94;03.02.2018;2018;02;22;Lauantai;0;1;1
94;03.02.2018;2018;02;23;Lauantai;0;0;0
94;04.02.2018;2018;02;00;Sunnuntai;1;0;1
94;04.02.2018;2018;02;01;Sunnuntai;0;0;0
94;04.02.2018;2018;02;02;Sunnuntai;0;0;0
94;04.02.2018;2018;02;03;Sunnuntai;0;0;0
94;04.02.2018;2018;02;04;Sunnuntai;0;0;0
94;04.02.2018;2018;02;05;Sunnuntai;0;0;0
94;04.02.2018;2018;02;06;Sunnuntai;0;0;0
94;04.02.2018;2018;02;07;Sunnuntai;0;0;0
94;04.02.2018;2018;02;08;Sunnuntai;0;0;0
94;04.02.2018;2018;02;09;Sunnuntai;0;0;0
94;04.02.2018;2018;02;10;Sunnuntai;0;1;1
94;04.02.2018;2018;02;11;Sunnuntai;0;0;0
94;04.02.2018;2018;02;12;Sunnuntai;0;0;0
94;04.02.2018;2018;02;13;Sunnuntai;1;1;2
94;04.02.2018;2018;02;14;Sunnuntai;1;0;1
94;04.02.2018;2018;02;15;Sunnuntai;0;0;0
94;04.02.2018;2018;02;16;Sunnuntai;0;0;0
94;04.02.2018;2018;02;17;Sunnuntai;0;0;0
94;04.02.2018;2018;02;18;Sunnuntai;0;1;1
94;04.02.2018;2018;02;19;Sunnuntai;0;0;0
94;04.02.2018;2018;02;20;Sunnuntai;0;0;0
94;04.02.2018;2018;02;21;Sunnuntai;0;0;0
94;04.02.2018;2018;02;22;Sunnuntai;0;0;0
94;04.02.2018;2018;02;23;Sunnuntai;0;0;0
94;05.02.2018;2018;02;00;Maanantai;0;0;0
94;05.02.2018;2018;02;01;Maanantai;0;0;0
94;05.02.2018;2018;02;02;Maanantai;0;0;0
94;05.02.2018;2018;02;03;Maanantai;0;0;0
94;05.02.2018;2018;02;04;Maanantai;0;0;0
94;05.02.2018;2018;02;05;Maanantai;3;1;4
94;05.02.2018;2018;02;06;Maanantai;0;0;0
94;05.02.2018;2018;02;07;Maanantai;3;0;3
94;05.02.2018;2018;02;08;Maanantai;2;0;2
94;05.02.2018;2018;02;09;Maanantai;1;0;1
94;05.02.2018;2018;02;10;Maanantai;0;0;0
94;05.02.2018;2018;02;11;Maanantai;0;0;0
94;05.02.2018;2018;02;12;Maanantai;0;1;1
94;05.02.2018;2018;02;13;Maanantai;2;1;3
94;05.02.2018;2018;02;14;Maanantai;1;1;2
94;05.02.2018;2018;02;15;Maanantai;0;2;2
94;05.02.2018;2018;02;16;Maanantai;0;7;7
94;05.02.2018;2018;02;17;Maanantai;0;1;1
94;05.02.2018;2018;02;18;Maanantai;0;1;1
94;05.02.2018;2018;02;19;Maanantai;1;1;2
94;05.02.2018;2018;02;20;Maanantai;0;1;1
94;05.02.2018;2018;02;21;Maanantai;1;0;1
94;05.02.2018;2018;02;22;Maanantai;0;1;1
94;05.02.2018;2018;02;23;Maanantai;0;0;0
94;06.02.2018;2018;02;00;Tiistai;0;0;0
94;06.02.2018;2018;02;01;Tiistai;0;0;0
94;06.02.2018;2018;02;02;Tiistai;0;0;0
94;06.02.2018;2018;02;03;Tiistai;0;0;0
94;06.02.2018;2018;02;04;Tiistai;0;0;0
94;06.02.2018;2018;02;05;Tiistai;3;1;4
94;06.02.2018;2018;02;06;Tiistai;1;0;1
94;06.02.2018;2018;02;07;Tiistai;8;0;8
94;06.02.2018;2018;02;08;Tiistai;2;0;2
94;06.02.2018;2018;02;09;Tiistai;0;0;0
94;06.02.2018;2018;02;10;Tiistai;0;0;0
94;06.02.2018;2018;02;11;Tiistai;0;0;0
94;06.02.2018;2018;02;12;Tiistai;0;0;0
94;06.02.2018;2018;02;13;Tiistai;1;0;1
94;06.02.2018;2018;02;14;Tiistai;1;2;3
94;06.02.2018;2018;02;15;Tiistai;0;2;2
94;06.02.2018;2018;02;16;Tiistai;0;5;5
94;06.02.2018;2018;02;17;Tiistai;0;4;4
94;06.02.2018;2018;02;18;Tiistai;0;2;2
94;06.02.2018;2018;02;19;Tiistai;0;1;1
94;06.02.2018;2018;02;20;Tiistai;1;0;1
94;06.02.2018;2018;02;21;Tiistai;1;0;1
94;06.02.2018;2018;02;22;Tiistai;0;0;0
94;06.02.2018;2018;02;23;Tiistai;0;1;1
94;07.02.2018;2018;02;00;Keskiviikko;0;0;0
94;07.02.2018;2018;02;01;Keskiviikko;0;0;0
94;07.02.2018;2018;02;02;Keskiviikko;0;1;1
94;07.02.2018;2018;02;03;Keskiviikko;0;0;0
94;07.02.2018;2018;02;04;Keskiviikko;0;0;0
94;07.02.2018;2018;02;05;Keskiviikko;3;1;4
94;07.02.2018;2018;02;06;Keskiviikko;5;0;5
94;07.02.2018;2018;02;07;Keskiviikko;3;0;3
94;07.02.2018;2018;02;08;Keskiviikko;4;0;4
94;07.02.2018;2018;02;09;Keskiviikko;1;0;1
94;07.02.2018;2018;02;10;Keskiviikko;0;0;0
94;07.02.2018;2018;02;11;Keskiviikko;0;0;0
94;07.02.2018;2018;02;12;Keskiviikko;0;0;0
94;07.02.2018;2018;02;13;Keskiviikko;1;0;1
94;07.02.2018;2018;02;14;Keskiviikko;1;4;5
94;07.02.2018;2018;02;15;Keskiviikko;0;5;5
94;07.02.2018;2018;02;16;Keskiviikko;0;6;6
94;07.02.2018;2018;02;17;Keskiviikko;0;5;5
94;07.02.2018;2018;02;18;Keskiviikko;0;1;1
94;07.02.2018;2018;02;19;Keskiviikko;3;4;7
94;07.02.2018;2018;02;20;Keskiviikko;1;0;1
94;07.02.2018;2018;02;21;Keskiviikko;0;2;2
94;07.02.2018;2018;02;22;Keskiviikko;2;0;2
94;07.02.2018;2018;02;23;Keskiviikko;0;0;0
94;08.02.2018;2018;02;00;Torstai;0;0;0
94;08.02.2018;2018;02;01;Torstai;0;0;0
94;08.02.2018;2018;02;02;Torstai;0;0;0
94;08.02.2018;2018;02;03;Torstai;0;0;0
94;08.02.2018;2018;02;04;Torstai;0;0;0
94;08.02.2018;2018;02;05;Torstai;4;1;5
94;08.02.2018;2018;02;06;Torstai;4;0;4
94;08.02.2018;2018;02;07;Torstai;5;0;5
94;08.02.2018;2018;02;08;Torstai;4;2;6
94;08.02.2018;2018;02;09;Torstai;0;0;0
94;08.02.2018;2018;02;10;Torstai;0;0;0
94;08.02.2018;2018;02;11;Torstai;1;2;3
94;08.02.2018;2018;02;12;Torstai;1;0;1
94;08.02.2018;2018;02;13;Torstai;1;0;1
94;08.02.2018;2018;02;14;Torstai;1;6;7
94;08.02.2018;2018;02;15;Torstai;0;3;3
94;08.02.2018;2018;02;16;Torstai;0;6;6
94;08.02.2018;2018;02;17;Torstai;1;5;6
94;08.02.2018;2018;02;18;Torstai;0;2;2
94;08.02.2018;2018;02;19;Torstai;0;1;1
94;08.02.2018;2018;02;20;Torstai;0;0;0
94;08.02.2018;2018;02;21;Torstai;1;1;2
94;08.02.2018;2018;02;22;Torstai;0;0;0
94;08.02.2018;2018;02;23;Torstai;0;0;0
94;09.02.2018;2018;02;00;Perjantai;0;0;0
94;09.02.2018;2018;02;01;Perjantai;0;0;0
94;09.02.2018;2018;02;02;Perjantai;0;0;0
94;09.02.2018;2018;02;03;Perjantai;0;0;0
94;09.02.2018;2018;02;04;Perjantai;0;0;0
94;09.02.2018;2018;02;05;Perjantai;4;1;5
94;09.02.2018;2018;02;06;Perjantai;3;2;5
94;09.02.2018;2018;02;07;Perjantai;8;0;8
94;09.02.2018;2018;02;08;Perjantai;4;0;4
94;09.02.2018;2018;02;09;Perjantai;2;1;3
94;09.02.2018;2018;02;10;Perjantai;0;0;0
94;09.02.2018;2018;02;11;Perjantai;2;1;3
94;09.02.2018;2018;02;12;Perjantai;2;0;2
94;09.02.2018;2018;02;13;Perjantai;0;4;4
94;09.02.2018;2018;02;14;Perjantai;0;4;4
94;09.02.2018;2018;02;15;Perjantai;2;7;9
94;09.02.2018;2018;02;16;Perjantai;0;7;7
94;09.02.2018;2018;02;17;Perjantai;0;7;7
94;09.02.2018;2018;02;18;Perjantai;1;1;2
94;09.02.2018;2018;02;19;Perjantai;0;0;0
94;09.02.2018;2018;02;20;Perjantai;0;5;5
94;09.02.2018;2018;02;21;Perjantai;0;2;2
94;09.02.2018;2018;02;22;Perjantai;0;2;2
94;09.02.2018;2018;02;23;Perjantai;1;0;1
94;10.02.2018;2018;02;00;Lauantai;0;0;0
94;10.02.2018;2018;02;01;Lauantai;0;0;0
94;10.02.2018;2018;02;02;Lauantai;2;0;2
94;10.02.2018;2018;02;03;Lauantai;0;0;0
94;10.02.2018;2018;02;04;Lauantai;0;0;0
94;10.02.2018;2018;02;05;Lauantai;0;0;0
94;10.02.2018;2018;02;06;Lauantai;1;0;1
94;10.02.2018;2018;02;07;Lauantai;0;1;1
94;10.02.2018;2018;02;08;Lauantai;0;0;0
94;10.02.2018;2018;02;09;Lauantai;0;0;0
94;10.02.2018;2018;02;10;Lauantai;1;0;1
94;10.02.2018;2018;02;11;Lauantai;1;2;3
94;10.02.2018;2018;02;12;Lauantai;2;1;3
94;10.02.2018;2018;02;13;Lauantai;0;2;2
94;10.02.2018;2018;02;14;Lauantai;2;0;2
94;10.02.2018;2018;02;15;Lauantai;0;2;2
94;10.02.2018;2018;02;16;Lauantai;0;1;1
94;10.02.2018;2018;02;17;Lauantai;0;3;3
94;10.02.2018;2018;02;18;Lauantai;0;0;0
94;10.02.2018;2018;02;19;Lauantai;1;2;3
94;10.02.2018;2018;02;20;Lauantai;0;1;1
94;10.02.2018;2018;02;21;Lauantai;0;0;0
94;10.02.2018;2018;02;22;Lauantai;0;0;0
94;10.02.2018;2018;02;23;Lauantai;0;0;0
94;11.02.2018;2018;02;00;Sunnuntai;1;0;1
94;11.02.2018;2018;02;01;Sunnuntai;0;0;0
94;11.02.2018;2018;02;02;Sunnuntai;0;0;0
94;11.02.2018;2018;02;03;Sunnuntai;0;0;0
94;11.02.2018;2018;02;04;Sunnuntai;0;0;0
94;11.02.2018;2018;02;05;Sunnuntai;0;0;0
94;11.02.2018;2018;02;06;Sunnuntai;0;1;1
94;11.02.2018;2018;02;07;Sunnuntai;1;0;1
94;11.02.2018;2018;02;08;Sunnuntai;0;1;1
94;11.02.2018;2018;02;09;Sunnuntai;1;0;1
94;11.02.2018;2018;02;10;Sunnuntai;0;0;0
94;11.02.2018;2018;02;11;Sunnuntai;0;2;2
94;11.02.2018;2018;02;12;Sunnuntai;2;2;4
94;11.02.2018;2018;02;13;Sunnuntai;1;2;3
94;11.02.2018;2018;02;14;Sunnuntai;4;1;5
94;11.02.2018;2018;02;15;Sunnuntai;0;1;1
94;11.02.2018;2018;02;16;Sunnuntai;0;0;0
94;11.02.2018;2018;02;17;Sunnuntai;2;0;2
94;11.02.2018;2018;02;18;Sunnuntai;0;4;4
94;11.02.2018;2018;02;19;Sunnuntai;4;1;5
94;11.02.2018;2018;02;20;Sunnuntai;1;0;1
94;11.02.2018;2018;02;21;Sunnuntai;0;0;0
94;11.02.2018;2018;02;22;Sunnuntai;0;0;0
94;11.02.2018;2018;02;23;Sunnuntai;0;0;0
94;12.02.2018;2018;02;00;Maanantai;0;0;0
94;12.02.2018;2018;02;01;Maanantai;0;0;0
94;12.02.2018;2018;02;02;Maanantai;0;0;0
94;12.02.2018;2018;02;03;Maanantai;0;0;0
94;12.02.2018;2018;02;04;Maanantai;0;0;0
94;12.02.2018;2018;02;05;Maanantai;5;3;8
94;12.02.2018;2018;02;06;Maanantai;4;0;4
94;12.02.2018;2018;02;07;Maanantai;9;0;9
94;12.02.2018;2018;02;08;Maanantai;3;2;5
94;12.02.2018;2018;02;09;Maanantai;2;0;2
94;12.02.2018;2018;02;10;Maanantai;1;1;2
94;12.02.2018;2018;02;11;Maanantai;0;2;2
94;12.02.2018;2018;02;12;Maanantai;0;1;1
94;12.02.2018;2018;02;13;Maanantai;2;1;3
94;12.02.2018;2018;02;14;Maanantai;2;4;6
94;12.02.2018;2018;02;15;Maanantai;0;7;7
94;12.02.2018;2018;02;16;Maanantai;1;7;8
94;12.02.2018;2018;02;17;Maanantai;0;6;6
94;12.02.2018;2018;02;18;Maanantai;0;3;3
94;12.02.2018;2018;02;19;Maanantai;2;1;3
94;12.02.2018;2018;02;20;Maanantai;2;4;6
94;12.02.2018;2018;02;21;Maanantai;1;1;2
94;12.02.2018;2018;02;22;Maanantai;0;2;2
94;12.02.2018;2018;02;23;Maanantai;0;1;1
94;13.02.2018;2018;02;00;Tiistai;0;0;0
94;13.02.2018;2018;02;01;Tiistai;0;0;0
94;13.02.2018;2018;02;02;Tiistai;0;0;0
94;13.02.2018;2018;02;03;Tiistai;0;0;0
94;13.02.2018;2018;02;04;Tiistai;0;0;0
94;13.02.2018;2018;02;05;Tiistai;4;2;6
94;13.02.2018;2018;02;06;Tiistai;1;1;2
94;13.02.2018;2018;02;07;Tiistai;12;0;12
94;13.02.2018;2018;02;08;Tiistai;4;0;4
94;13.02.2018;2018;02;09;Tiistai;1;0;1
94;13.02.2018;2018;02;10;Tiistai;0;0;0
94;13.02.2018;2018;02;11;Tiistai;1;0;1
94;13.02.2018;2018;02;12;Tiistai;0;0;0
94;13.02.2018;2018;02;13;Tiistai;1;1;2
94;13.02.2018;2018;02;14;Tiistai;2;3;5
94;13.02.2018;2018;02;15;Tiistai;1;7;8
94;13.02.2018;2018;02;16;Tiistai;1;5;6
94;13.02.2018;2018;02;17;Tiistai;1;5;6
94;13.02.2018;2018;02;18;Tiistai;0;0;0
94;13.02.2018;2018;02;19;Tiistai;2;5;7
94;13.02.2018;2018;02;20;Tiistai;0;1;1
94;13.02.2018;2018;02;21;Tiistai;0;0;0
94;13.02.2018;2018;02;22;Tiistai;0;3;3
94;13.02.2018;2018;02;23;Tiistai;0;0;0
94;14.02.2018;2018;02;00;Keskiviikko;0;0;0
94;14.02.2018;2018;02;01;Keskiviikko;0;0;0
94;14.02.2018;2018;02;02;Keskiviikko;1;0;1
94;14.02.2018;2018;02;03;Keskiviikko;0;0;0
94;14.02.2018;2018;02;04;Keskiviikko;0;0;0
94;14.02.2018;2018;02;05;Keskiviikko;4;0;4
94;14.02.2018;2018;02;06;Keskiviikko;5;0;5
94;14.02.2018;2018;02;07;Keskiviikko;3;0;3
94;14.02.2018;2018;02;08;Keskiviikko;4;0;4
94;14.02.2018;2018;02;09;Keskiviikko;1;0;1
94;14.02.2018;2018;02;10;Keskiviikko;0;0;0
94;14.02.2018;2018;02;11;Keskiviikko;0;0;0
94;14.02.2018;2018;02;12;Keskiviikko;0;0;0
94;14.02.2018;2018;02;13;Keskiviikko;1;0;1
94;14.02.2018;2018;02;14;Keskiviikko;5;0;5
94;14.02.2018;2018;02;15;Keskiviikko;5;0;5
94;14.02.2018;2018;02;16;Keskiviikko;6;0;6
94;14.02.2018;2018;02;17;Keskiviikko;5;0;5
94;14.02.2018;2018;02;18;Keskiviikko;1;0;1
94;14.02.2018;2018;02;19;Keskiviikko;7;0;7
94;14.02.2018;2018;02;20;Keskiviikko;1;0;1
94;14.02.2018;2018;02;21;Keskiviikko;2;0;2
94;14.02.2018;2018;02;22;Keskiviikko;2;0;2
94;14.02.2018;2018;02;23;Keskiviikko;0;0;0
94;15.02.2018;2018;02;00;Torstai;0;0;0
94;15.02.2018;2018;02;01;Torstai;0;0;0
94;15.02.2018;2018;02;02;Torstai;0;0;0
94;15.02.2018;2018;02;03;Torstai;0;0;0
94;15.02.2018;2018;02;04;Torstai;0;0;0
94;15.02.2018;2018;02;05;Torstai;5;0;5
94;15.02.2018;2018;02;06;Torstai;4;0;4
94;15.02.2018;2018;02;07;Torstai;5;0;5
94;15.02.2018;2018;02;08;Torstai;6;0;6
94;15.02.2018;2018;02;09;Torstai;0;0;0
94;15.02.2018;2018;02;10;Torstai;0;0;0
94;15.02.2018;2018;02;11;Torstai;3;0;3
94;15.02.2018;2018;02;12;Torstai;1;0;1
94;15.02.2018;2018;02;13;Torstai;1;0;1
94;15.02.2018;2018;02;14;Torstai;7;0;7
94;15.02.2018;2018;02;15;Torstai;3;0;3
94;15.02.2018;2018;02;16;Torstai;6;0;6
94;15.02.2018;2018;02;17;Torstai;6;0;6
94;15.02.2018;2018;02;18;Torstai;2;0;2
94;15.02.2018;2018;02;19;Torstai;1;0;1
94;15.02.2018;2018;02;20;Torstai;0;0;0
94;15.02.2018;2018;02;21;Torstai;2;0;2
94;15.02.2018;2018;02;22;Torstai;0;0;0
94;15.02.2018;2018;02;23;Torstai;0;0;0
94;16.02.2018;2018;02;00;Perjantai;0;0;0
94;16.02.2018;2018;02;01;Perjantai;0;0;0
94;16.02.2018;2018;02;02;Perjantai;0;0;0
94;16.02.2018;2018;02;03;Perjantai;0;0;0
94;16.02.2018;2018;02;04;Perjantai;0;0;0
94;16.02.2018;2018;02;05;Perjantai;4;1;5
94;16.02.2018;2018;02;06;Perjantai;2;0;2
94;16.02.2018;2018;02;07;Perjantai;6;1;7
94;16.02.2018;2018;02;08;Perjantai;1;0;1
94;16.02.2018;2018;02;09;Perjantai;1;0;1
94;16.02.2018;2018;02;10;Perjantai;4;0;4
94;16.02.2018;2018;02;11;Perjantai;2;1;3
94;16.02.2018;2018;02;12;Perjantai;1;1;2
94;16.02.2018;2018;02;13;Perjantai;3;6;9
94;16.02.2018;2018;02;14;Perjantai;1;2;3
94;16.02.2018;2018;02;15;Perjantai;0;4;4
94;16.02.2018;2018;02;16;Perjantai;1;2;3
94;16.02.2018;2018;02;17;Perjantai;0;7;7
94;16.02.2018;2018;02;18;Perjantai;2;2;4
94;16.02.2018;2018;02;19;Perjantai;0;3;3
94;16.02.2018;2018;02;20;Perjantai;0;0;0
94;16.02.2018;2018;02;21;Perjantai;0;1;1
94;16.02.2018;2018;02;22;Perjantai;1;1;2
94;16.02.2018;2018;02;23;Perjantai;0;0;0
94;17.02.2018;2018;02;00;Lauantai;0;0;0
94;17.02.2018;2018;02;01;Lauantai;0;0;0
94;17.02.2018;2018;02;02;Lauantai;0;0;0
94;17.02.2018;2018;02;03;Lauantai;0;0;0
94;17.02.2018;2018;02;04;Lauantai;0;0;0
94;17.02.2018;2018;02;05;Lauantai;0;0;0
94;17.02.2018;2018;02;06;Lauantai;1;0;1
94;17.02.2018;2018;02;07;Lauantai;1;0;1
94;17.02.2018;2018;02;08;Lauantai;0;0;0
94;17.02.2018;2018;02;09;Lauantai;0;0;0
94;17.02.2018;2018;02;10;Lauantai;0;0;0
94;17.02.2018;2018;02;11;Lauantai;0;0;0
94;17.02.2018;2018;02;12;Lauantai;0;1;1
94;17.02.2018;2018;02;13;Lauantai;0;0;0
94;17.02.2018;2018;02;14;Lauantai;2;2;4
94;17.02.2018;2018;02;15;Lauantai;0;1;1
94;17.02.2018;2018;02;16;Lauantai;0;0;0
94;17.02.2018;2018;02;17;Lauantai;0;0;0
94;17.02.2018;2018;02;18;Lauantai;0;1;1
94;17.02.2018;2018;02;19;Lauantai;1;0;1
94;17.02.2018;2018;02;20;Lauantai;1;0;1
94;17.02.2018;2018;02;21;Lauantai;0;0;0
94;17.02.2018;2018;02;22;Lauantai;0;0;0
94;17.02.2018;2018;02;23;Lauantai;0;0;0
94;18.02.2018;2018;02;00;Sunnuntai;0;0;0
94;18.02.2018;2018;02;01;Sunnuntai;0;0;0
94;18.02.2018;2018;02;02;Sunnuntai;0;0;0
94;18.02.2018;2018;02;03;Sunnuntai;0;0;0
94;18.02.2018;2018;02;04;Sunnuntai;0;0;0
94;18.02.2018;2018;02;05;Sunnuntai;0;0;0
94;18.02.2018;2018;02;06;Sunnuntai;1;0;1
94;18.02.2018;2018;02;07;Sunnuntai;0;0;0
94;18.02.2018;2018;02;08;Sunnuntai;0;2;2
94;18.02.2018;2018;02;09;Sunnuntai;1;0;1
94;18.02.2018;2018;02;10;Sunnuntai;0;0;0
94;18.02.2018;2018;02;11;Sunnuntai;0;0;0
94;18.02.2018;2018;02;12;Sunnuntai;0;0;0
94;18.02.2018;2018;02;13;Sunnuntai;0;1;1
94;18.02.2018;2018;02;14;Sunnuntai;1;0;1
94;18.02.2018;2018;02;15;Sunnuntai;0;2;2
94;18.02.2018;2018;02;16;Sunnuntai;0;0;0
94;18.02.2018;2018;02;17;Sunnuntai;1;0;1
94;18.02.2018;2018;02;18;Sunnuntai;0;0;0
94;18.02.2018;2018;02;19;Sunnuntai;2;1;3
94;18.02.2018;2018;02;20;Sunnuntai;1;0;1
94;18.02.2018;2018;02;21;Sunnuntai;0;0;0
94;18.02.2018;2018;02;22;Sunnuntai;0;1;1
94;18.02.2018;2018;02;23;Sunnuntai;0;0;0
94;19.02.2018;2018;02;00;Maanantai;0;0;0
94;19.02.2018;2018;02;01;Maanantai;0;0;0
94;19.02.2018;2018;02;02;Maanantai;0;0;0
94;19.02.2018;2018;02;03;Maanantai;0;0;0
94;19.02.2018;2018;02;04;Maanantai;0;0;0
94;19.02.2018;2018;02;05;Maanantai;0;1;1
94;19.02.2018;2018;02;06;Maanantai;3;0;3
94;19.02.2018;2018;02;07;Maanantai;7;1;8
94;19.02.2018;2018;02;08;Maanantai;3;1;4
94;19.02.2018;2018;02;09;Maanantai;0;0;0
94;19.02.2018;2018;02;10;Maanantai;0;0;0
94;19.02.2018;2018;02;11;Maanantai;0;1;1
94;19.02.2018;2018;02;12;Maanantai;0;0;0
94;19.02.2018;2018;02;13;Maanantai;3;0;3
94;19.02.2018;2018;02;14;Maanantai;1;0;1
94;19.02.2018;2018;02;15;Maanantai;0;3;3
94;19.02.2018;2018;02;16;Maanantai;0;7;7
94;19.02.2018;2018;02;17;Maanantai;1;1;2
94;19.02.2018;2018;02;18;Maanantai;0;1;1
94;19.02.2018;2018;02;19;Maanantai;0;2;2
94;19.02.2018;2018;02;20;Maanantai;1;1;2
94;19.02.2018;2018;02;21;Maanantai;1;1;2
94;19.02.2018;2018;02;22;Maanantai;0;1;1
94;19.02.2018;2018;02;23;Maanantai;0;0;0
94;20.02.2018;2018;02;00;Tiistai;0;0;0
94;20.02.2018;2018;02;01;Tiistai;0;0;0
94;20.02.2018;2018;02;02;Tiistai;0;0;0
94;20.02.2018;2018;02;03;Tiistai;0;0;0
94;20.02.2018;2018;02;04;Tiistai;0;1;1
94;20.02.2018;2018;02;05;Tiistai;0;1;1
94;20.02.2018;2018;02;06;Tiistai;2;0;2
94;20.02.2018;2018;02;07;Tiistai;5;3;8
94;20.02.2018;2018;02;08;Tiistai;1;0;1
94;20.02.2018;2018;02;09;Tiistai;1;0;1
94;20.02.2018;2018;02;10;Tiistai;0;0;0
94;20.02.2018;2018;02;11;Tiistai;0;0;0
94;20.02.2018;2018;02;12;Tiistai;0;0;0
94;20.02.2018;2018;02;13;Tiistai;0;1;1
94;20.02.2018;2018;02;14;Tiistai;1;1;2
94;20.02.2018;2018;02;15;Tiistai;2;3;5
94;20.02.2018;2018;02;16;Tiistai;1;4;5
94;20.02.2018;2018;02;17;Tiistai;0;2;2
94;20.02.2018;2018;02;18;Tiistai;0;1;1
94;20.02.2018;2018;02;19;Tiistai;1;1;2
94;20.02.2018;2018;02;20;Tiistai;0;3;3
94;20.02.2018;2018;02;21;Tiistai;0;0;0
94;20.02.2018;2018;02;22;Tiistai;0;0;0
94;20.02.2018;2018;02;23;Tiistai;0;0;0
94;21.02.2018;2018;02;00;Keskiviikko;0;0;0
94;21.02.2018;2018;02;01;Keskiviikko;0;0;0
94;21.02.2018;2018;02;02;Keskiviikko;0;0;0
94;21.02.2018;2018;02;03;Keskiviikko;0;0;0
94;21.02.2018;2018;02;04;Keskiviikko;0;0;0
94;21.02.2018;2018;02;05;Keskiviikko;2;1;3
94;21.02.2018;2018;02;06;Keskiviikko;5;1;6
94;21.02.2018;2018;02;07;Keskiviikko;7;1;8
94;21.02.2018;2018;02;08;Keskiviikko;3;0;3
94;21.02.2018;2018;02;09;Keskiviikko;0;0;0
94;21.02.2018;2018;02;10;Keskiviikko;0;0;0
94;21.02.2018;2018;02;11;Keskiviikko;0;0;0
94;21.02.2018;2018;02;12;Keskiviikko;1;0;1
94;21.02.2018;2018;02;13;Keskiviikko;2;0;2
94;21.02.2018;2018;02;14;Keskiviikko;1;2;3
94;21.02.2018;2018;02;15;Keskiviikko;2;2;4
94;21.02.2018;2018;02;16;Keskiviikko;0;4;4
94;21.02.2018;2018;02;17;Keskiviikko;0;5;5
94;21.02.2018;2018;02;18;Keskiviikko;0;3;3
94;21.02.2018;2018;02;19;Keskiviikko;0;1;1
94;21.02.2018;2018;02;20;Keskiviikko;1;0;1
94;21.02.2018;2018;02;21;Keskiviikko;0;2;2
94;21.02.2018;2018;02;22;Keskiviikko;0;0;0
94;21.02.2018;2018;02;23;Keskiviikko;0;0;0
94;22.02.2018;2018;02;00;Torstai;0;0;0
94;22.02.2018;2018;02;01;Torstai;0;0;0
94;22.02.2018;2018;02;02;Torstai;0;0;0
94;22.02.2018;2018;02;03;Torstai;0;0;0
94;22.02.2018;2018;02;04;Torstai;0;0;0
94;22.02.2018;2018;02;05;Torstai;3;1;4
94;22.02.2018;2018;02;06;Torstai;3;2;5
94;22.02.2018;2018;02;07;Torstai;3;0;3
94;22.02.2018;2018;02;08;Torstai;2;0;2
94;22.02.2018;2018;02;09;Torstai;0;0;0
94;22.02.2018;2018;02;10;Torstai;0;0;0
94;22.02.2018;2018;02;11;Torstai;2;0;2
94;22.02.2018;2018;02;12;Torstai;0;0;0
94;22.02.2018;2018;02;13;Torstai;2;1;3
94;22.02.2018;2018;02;14;Torstai;0;0;0
94;22.02.2018;2018;02;15;Torstai;1;5;6
94;22.02.2018;2018;02;16;Torstai;0;4;4
94;22.02.2018;2018;02;17;Torstai;0;2;2
94;22.02.2018;2018;02;18;Torstai;0;1;1
94;22.02.2018;2018;02;19;Torstai;0;2;2
94;22.02.2018;2018;02;20;Torstai;0;1;1
94;22.02.2018;2018;02;21;Torstai;0;1;1
94;22.02.2018;2018;02;22;Torstai;1;0;1
94;22.02.2018;2018;02;23;Torstai;0;0;0
94;23.02.2018;2018;02;00;Perjantai;0;0;0
94;23.02.2018;2018;02;01;Perjantai;0;0;0
94;23.02.2018;2018;02;02;Perjantai;0;0;0
94;23.02.2018;2018;02;03;Perjantai;0;0;0
94;23.02.2018;2018;02;04;Perjantai;0;0;0
94;23.02.2018;2018;02;05;Perjantai;4;0;4
94;23.02.2018;2018;02;06;Perjantai;2;0;2
94;23.02.2018;2018;02;07;Perjantai;3;1;4
94;23.02.2018;2018;02;08;Perjantai;5;1;6
94;23.02.2018;2018;02;09;Perjantai;0;0;0
94;23.02.2018;2018;02;10;Perjantai;1;0;1
94;23.02.2018;2018;02;11;Perjantai;0;0;0
94;23.02.2018;2018;02;12;Perjantai;0;1;1
94;23.02.2018;2018;02;13;Perjantai;1;2;3
94;23.02.2018;2018;02;14;Perjantai;0;0;0
94;23.02.2018;2018;02;15;Perjantai;0;5;5
94;23.02.2018;2018;02;16;Perjantai;1;2;3
94;23.02.2018;2018;02;17;Perjantai;1;2;3
94;23.02.2018;2018;02;18;Perjantai;0;3;3
94;23.02.2018;2018;02;19;Perjantai;0;0;0
94;23.02.2018;2018;02;20;Perjantai;0;1;1
94;23.02.2018;2018;02;21;Perjantai;0;0;0
94;23.02.2018;2018;02;22;Perjantai;1;0;1
94;23.02.2018;2018;02;23;Perjantai;1;0;1
94;24.02.2018;2018;02;00;Lauantai;0;0;0
94;24.02.2018;2018;02;01;Lauantai;0;0;0
94;24.02.2018;2018;02;02;Lauantai;0;0;0
94;24.02.2018;2018;02;03;Lauantai;0;0;0
94;24.02.2018;2018;02;04;Lauantai;0;0;0
94;24.02.2018;2018;02;05;Lauantai;0;0;0
94;24.02.2018;2018;02;06;Lauantai;1;0;1
94;24.02.2018;2018;02;07;Lauantai;0;0;0
94;24.02.2018;2018;02;08;Lauantai;0;1;1
94;24.02.2018;2018;02;09;Lauantai;0;1;1
94;24.02.2018;2018;02;10;Lauantai;1;0;1
94;24.02.2018;2018;02;11;Lauantai;0;0;0
94;24.02.2018;2018;02;12;Lauantai;1;0;1
94;24.02.2018;2018;02;13;Lauantai;0;1;1
94;24.02.2018;2018;02;14;Lauantai;1;0;1
94;24.02.2018;2018;02;15;Lauantai;1;2;3
94;24.02.2018;2018;02;16;Lauantai;1;1;2
94;24.02.2018;2018;02;17;Lauantai;1;0;1
94;24.02.2018;2018;02;18;Lauantai;1;1;2
94;24.02.2018;2018;02;19;Lauantai;0;1;1
94;24.02.2018;2018;02;20;Lauantai;0;0;0
94;24.02.2018;2018;02;21;Lauantai;0;0;0
94;24.02.2018;2018;02;22;Lauantai;0;1;1
94;24.02.2018;2018;02;23;Lauantai;0;0;0
94;25.02.2018;2018;02;00;Sunnuntai;0;0;0
94;25.02.2018;2018;02;01;Sunnuntai;1;0;1
94;25.02.2018;2018;02;02;Sunnuntai;0;0;0
94;25.02.2018;2018;02;03;Sunnuntai;0;0;0
94;25.02.2018;2018;02;04;Sunnuntai;0;0;0
94;25.02.2018;2018;02;05;Sunnuntai;0;0;0
94;25.02.2018;2018;02;06;Sunnuntai;0;0;0
94;25.02.2018;2018;02;07;Sunnuntai;1;0;1
94;25.02.2018;2018;02;08;Sunnuntai;0;0;0
94;25.02.2018;2018;02;09;Sunnuntai;0;0;0
94;25.02.2018;2018;02;10;Sunnuntai;1;0;1
94;25.02.2018;2018;02;11;Sunnuntai;2;0;2
94;25.02.2018;2018;02;12;Sunnuntai;0;1;1
94;25.02.2018;2018;02;13;Sunnuntai;1;0;1
94;25.02.2018;2018;02;14;Sunnuntai;1;0;1
94;25.02.2018;2018;02;15;Sunnuntai;0;2;2
94;25.02.2018;2018;02;16;Sunnuntai;0;0;0
94;25.02.2018;2018;02;17;Sunnuntai;2;0;2
94;25.02.2018;2018;02;18;Sunnuntai;0;1;1
94;25.02.2018;2018;02;19;Sunnuntai;1;0;1
94;25.02.2018;2018;02;20;Sunnuntai;0;1;1
94;25.02.2018;2018;02;21;Sunnuntai;0;0;0
94;25.02.2018;2018;02;22;Sunnuntai;0;0;0
94;25.02.2018;2018;02;23;Sunnuntai;0;0;0
94;26.02.2018;2018;02;00;Maanantai;0;0;0
94;26.02.2018;2018;02;01;Maanantai;0;0;0
94;26.02.2018;2018;02;02;Maanantai;0;0;0
94;26.02.2018;2018;02;03;Maanantai;0;0;0
94;26.02.2018;2018;02;04;Maanantai;0;0;0
94;26.02.2018;2018;02;05;Maanantai;0;2;2
94;26.02.2018;2018;02;06;Maanantai;5;1;6
94;26.02.2018;2018;02;07;Maanantai;6;1;7
94;26.02.2018;2018;02;08;Maanantai;6;1;7
94;26.02.2018;2018;02;09;Maanantai;2;0;2
94;26.02.2018;2018;02;10;Maanantai;0;1;1
94;26.02.2018;2018;02;11;Maanantai;2;2;4
94;26.02.2018;2018;02;12;Maanantai;0;0;0
94;26.02.2018;2018;02;13;Maanantai;1;1;2
94;26.02.2018;2018;02;14;Maanantai;2;2;4
94;26.02.2018;2018;02;15;Maanantai;1;4;5
94;26.02.2018;2018;02;16;Maanantai;1;7;8
94;26.02.2018;2018;02;17;Maanantai;0;4;4
94;26.02.2018;2018;02;18;Maanantai;0;5;5
94;26.02.2018;2018;02;19;Maanantai;0;2;2
94;26.02.2018;2018;02;20;Maanantai;0;0;0
94;26.02.2018;2018;02;21;Maanantai;0;0;0
94;26.02.2018;2018;02;22;Maanantai;0;1;1
94;26.02.2018;2018;02;23;Maanantai;0;0;0
94;27.02.2018;2018;02;00;Tiistai;0;0;0
94;27.02.2018;2018;02;01;Tiistai;0;0;0
94;27.02.2018;2018;02;02;Tiistai;0;0;0
94;27.02.2018;2018;02;03;Tiistai;0;0;0
94;27.02.2018;2018;02;04;Tiistai;0;0;0
94;27.02.2018;2018;02;05;Tiistai;3;1;4
94;27.02.2018;2018;02;06;Tiistai;3;0;3
94;27.02.2018;2018;02;07;Tiistai;3;1;4
94;27.02.2018;2018;02;08;Tiistai;1;0;1
94;27.02.2018;2018;02;09;Tiistai;1;0;1
94;27.02.2018;2018;02;10;Tiistai;0;0;0
94;27.02.2018;2018;02;11;Tiistai;0;0;0
94;27.02.2018;2018;02;12;Tiistai;0;0;0
94;27.02.2018;2018;02;13;Tiistai;0;0;0
94;27.02.2018;2018;02;14;Tiistai;1;1;2
94;27.02.2018;2018;02;15;Tiistai;0;4;4
94;27.02.2018;2018;02;16;Tiistai;1;5;6
94;27.02.2018;2018;02;17;Tiistai;0;2;2
94;27.02.2018;2018;02;18;Tiistai;1;2;3
94;27.02.2018;2018;02;19;Tiistai;0;0;0
94;27.02.2018;2018;02;20;Tiistai;0;1;1
94;27.02.2018;2018;02;21;Tiistai;0;0;0
94;27.02.2018;2018;02;22;Tiistai;0;1;1
94;27.02.2018;2018;02;23;Tiistai;0;0;0
94;28.02.2018;2018;02;00;Keskiviikko;0;0;0
94;28.02.2018;2018;02;01;Keskiviikko;0;0;0
94;28.02.2018;2018;02;02;Keskiviikko;0;0;0
94;28.02.2018;2018;02;03;Keskiviikko;0;0;0
94;28.02.2018;2018;02;04;Keskiviikko;0;0;0
94;28.02.2018;2018;02;05;Keskiviikko;0;1;1
94;28.02.2018;2018;02;06;Keskiviikko;2;1;3
94;28.02.2018;2018;02;07;Keskiviikko;2;0;2
94;28.02.2018;2018;02;08;Keskiviikko;1;0;1
94;28.02.2018;2018;02;09;Keskiviikko;1;0;1
94;28.02.2018;2018;02;10;Keskiviikko;0;0;0
94;28.02.2018;2018;02;11;Keskiviikko;0;0;0
94;28.02.2018;2018;02;12;Keskiviikko;0;0;0
94;28.02.2018;2018;02;13;Keskiviikko;2;1;3
94;28.02.2018;2018;02;14;Keskiviikko;2;1;3
94;28.02.2018;2018;02;15;Keskiviikko;0;1;1
94;28.02.2018;2018;02;16;Keskiviikko;0;3;3
94;28.02.2018;2018;02;17;Keskiviikko;0;1;1
94;28.02.2018;2018;02;18;Keskiviikko;0;1;1
94;28.02.2018;2018;02;19;Keskiviikko;1;1;2
94;28.02.2018;2018;02;20;Keskiviikko;0;1;1
94;28.02.2018;2018;02;21;Keskiviikko;0;1;1
94;28.02.2018;2018;02;22;Keskiviikko;0;0;0
94;28.02.2018;2018;02;23;Keskiviikko;0;0;0
94;01.03.2018;2018;03;00;Torstai;0;0;0
94;01.03.2018;2018;03;01;Torstai;0;0;0
94;01.03.2018;2018;03;02;Torstai;0;0;0
94;01.03.2018;2018;03;03;Torstai;0;0;0
94;01.03.2018;2018;03;04;Torstai;0;0;0
94;01.03.2018;2018;03;05;Torstai;2;1;3
94;01.03.2018;2018;03;06;Torstai;3;0;3
94;01.03.2018;2018;03;07;Torstai;2;1;3
94;01.03.2018;2018;03;08;Torstai;3;0;3
94;01.03.2018;2018;03;09;Torstai;0;0;0
94;01.03.2018;2018;03;10;Torstai;1;0;1
94;01.03.2018;2018;03;11;Torstai;0;1;1
94;01.03.2018;2018;03;12;Torstai;2;0;2
94;01.03.2018;2018;03;13;Torstai;0;1;1
94;01.03.2018;2018;03;14;Torstai;1;1;2
94;01.03.2018;2018;03;15;Torstai;0;5;5
94;01.03.2018;2018;03;16;Torstai;2;2;4
94;01.03.2018;2018;03;17;Torstai;0;5;5
94;01.03.2018;2018;03;18;Torstai;0;2;2
94;01.03.2018;2018;03;19;Torstai;0;1;1
94;01.03.2018;2018;03;20;Torstai;0;0;0
94;01.03.2018;2018;03;21;Torstai;0;0;0
94;01.03.2018;2018;03;22;Torstai;0;0;0
94;01.03.2018;2018;03;23;Torstai;0;0;0
94;02.03.2018;2018;03;00;Perjantai;0;0;0
94;02.03.2018;2018;03;01;Perjantai;0;0;0
94;02.03.2018;2018;03;02;Perjantai;0;0;0
94;02.03.2018;2018;03;03;Perjantai;0;0;0
94;02.03.2018;2018;03;04;Perjantai;0;0;0
94;02.03.2018;2018;03;05;Perjantai;2;1;3
94;02.03.2018;2018;03;06;Perjantai;3;1;4
94;02.03.2018;2018;03;07;Perjantai;6;0;6
94;02.03.2018;2018;03;08;Perjantai;3;0;3
94;02.03.2018;2018;03;09;Perjantai;0;1;1
94;02.03.2018;2018;03;10;Perjantai;3;0;3
94;02.03.2018;2018;03;11;Perjantai;2;1;3
94;02.03.2018;2018;03;12;Perjantai;1;0;1
94;02.03.2018;2018;03;13;Perjantai;1;2;3
94;02.03.2018;2018;03;14;Perjantai;1;3;4
94;02.03.2018;2018;03;15;Perjantai;2;3;5
94;02.03.2018;2018;03;16;Perjantai;2;3;5
94;02.03.2018;2018;03;17;Perjantai;4;6;10
94;02.03.2018;2018;03;18;Perjantai;0;4;4
94;02.03.2018;2018;03;19;Perjantai;2;3;5
94;02.03.2018;2018;03;20;Perjantai;6;6;12
94;02.03.2018;2018;03;21;Perjantai;0;0;0
94;02.03.2018;2018;03;22;Perjantai;0;0;0
94;02.03.2018;2018;03;23;Perjantai;0;0;0
94;03.03.2018;2018;03;00;Lauantai;0;0;0
94;03.03.2018;2018;03;01;Lauantai;1;0;1
94;03.03.2018;2018;03;02;Lauantai;0;0;0
94;03.03.2018;2018;03;03;Lauantai;0;0;0
94;03.03.2018;2018;03;04;Lauantai;0;0;0
94;03.03.2018;2018;03;05;Lauantai;0;0;0
94;03.03.2018;2018;03;06;Lauantai;0;0;0
94;03.03.2018;2018;03;07;Lauantai;0;0;0
94;03.03.2018;2018;03;08;Lauantai;0;0;0
94;03.03.2018;2018;03;09;Lauantai;0;0;0
94;03.03.2018;2018;03;10;Lauantai;2;4;6
94;03.03.2018;2018;03;11;Lauantai;1;4;5
94;03.03.2018;2018;03;12;Lauantai;1;1;2
94;03.03.2018;2018;03;13;Lauantai;1;0;1
94;03.03.2018;2018;03;14;Lauantai;1;0;1
94;03.03.2018;2018;03;15;Lauantai;1;0;1
94;03.03.2018;2018;03;16;Lauantai;0;0;0
94;03.03.2018;2018;03;17;Lauantai;1;1;2
94;03.03.2018;2018;03;18;Lauantai;0;2;2
94;03.03.2018;2018;03;19;Lauantai;0;0;0
94;03.03.2018;2018;03;20;Lauantai;0;0;0
94;03.03.2018;2018;03;21;Lauantai;0;0;0
94;03.03.2018;2018;03;22;Lauantai;0;0;0
94;03.03.2018;2018;03;23;Lauantai;0;0;0
94;04.03.2018;2018;03;00;Sunnuntai;0;0;0
94;04.03.2018;2018;03;01;Sunnuntai;0;0;0
94;04.03.2018;2018;03;02;Sunnuntai;0;0;0
94;04.03.2018;2018;03;03;Sunnuntai;0;0;0
94;04.03.2018;2018;03;04;Sunnuntai;0;0;0
94;04.03.2018;2018;03;05;Sunnuntai;0;0;0
94;04.03.2018;2018;03;06;Sunnuntai;0;1;1
94;04.03.2018;2018;03;07;Sunnuntai;0;0;0
94;04.03.2018;2018;03;08;Sunnuntai;0;0;0
94;04.03.2018;2018;03;09;Sunnuntai;0;0;0
94;04.03.2018;2018;03;10;Sunnuntai;0;0;0
94;04.03.2018;2018;03;11;Sunnuntai;1;2;3
94;04.03.2018;2018;03;12;Sunnuntai;2;1;3
94;04.03.2018;2018;03;13;Sunnuntai;0;0;0
94;04.03.2018;2018;03;14;Sunnuntai;1;0;1
94;04.03.2018;2018;03;15;Sunnuntai;1;1;2
94;04.03.2018;2018;03;16;Sunnuntai;1;0;1
94;04.03.2018;2018;03;17;Sunnuntai;0;2;2
94;04.03.2018;2018;03;18;Sunnuntai;1;1;2
94;04.03.2018;2018;03;19;Sunnuntai;0;1;1
94;04.03.2018;2018;03;20;Sunnuntai;0;0;0
94;04.03.2018;2018;03;21;Sunnuntai;0;0;0
94;04.03.2018;2018;03;22;Sunnuntai;0;0;0
94;04.03.2018;2018;03;23;Sunnuntai;0;0;0
94;05.03.2018;2018;03;00;Maanantai;0;0;0
94;05.03.2018;2018;03;01;Maanantai;0;0;0
94;05.03.2018;2018;03;02;Maanantai;0;0;0
94;05.03.2018;2018;03;03;Maanantai;0;0;0
94;05.03.2018;2018;03;04;Maanantai;0;0;0
94;05.03.2018;2018;03;05;Maanantai;3;1;4
94;05.03.2018;2018;03;06;Maanantai;2;0;2
94;05.03.2018;2018;03;07;Maanantai;4;0;4
94;05.03.2018;2018;03;08;Maanantai;0;0;0
94;05.03.2018;2018;03;09;Maanantai;1;0;1
94;05.03.2018;2018;03;10;Maanantai;1;0;1
94;05.03.2018;2018;03;11;Maanantai;0;0;0
94;05.03.2018;2018;03;12;Maanantai;0;0;0
94;05.03.2018;2018;03;13;Maanantai;1;0;1
94;05.03.2018;2018;03;14;Maanantai;1;2;3
94;05.03.2018;2018;03;15;Maanantai;0;6;6
94;05.03.2018;2018;03;16;Maanantai;0;2;2
94;05.03.2018;2018;03;17;Maanantai;0;3;3
94;05.03.2018;2018;03;18;Maanantai;1;1;2
94;05.03.2018;2018;03;19;Maanantai;1;2;3
94;05.03.2018;2018;03;20;Maanantai;0;0;0
94;05.03.2018;2018;03;21;Maanantai;0;2;2
94;05.03.2018;2018;03;22;Maanantai;0;0;0
94;05.03.2018;2018;03;23;Maanantai;0;0;0
94;06.03.2018;2018;03;00;Tiistai;0;0;0
94;06.03.2018;2018;03;01;Tiistai;0;0;0
94;06.03.2018;2018;03;02;Tiistai;0;0;0
94;06.03.2018;2018;03;03;Tiistai;0;0;0
94;06.03.2018;2018;03;04;Tiistai;0;0;0
94;06.03.2018;2018;03;05;Tiistai;2;1;3
94;06.03.2018;2018;03;06;Tiistai;0;0;0
94;06.03.2018;2018;03;07;Tiistai;3;0;3
94;06.03.2018;2018;03;08;Tiistai;2;0;2
94;06.03.2018;2018;03;09;Tiistai;2;0;2
94;06.03.2018;2018;03;10;Tiistai;0;0;0
94;06.03.2018;2018;03;11;Tiistai;0;0;0
94;06.03.2018;2018;03;12;Tiistai;0;0;0
94;06.03.2018;2018;03;13;Tiistai;0;1;1
94;06.03.2018;2018;03;14;Tiistai;2;1;3
94;06.03.2018;2018;03;15;Tiistai;1;1;2
94;06.03.2018;2018;03;16;Tiistai;1;3;4
94;06.03.2018;2018;03;17;Tiistai;0;3;3
94;06.03.2018;2018;03;18;Tiistai;2;1;3
94;06.03.2018;2018;03;19;Tiistai;0;1;1
94;06.03.2018;2018;03;20;Tiistai;0;2;2
94;06.03.2018;2018;03;21;Tiistai;0;0;0
94;06.03.2018;2018;03;22;Tiistai;0;0;0
94;06.03.2018;2018;03;23;Tiistai;0;0;0
94;07.03.2018;2018;03;00;Keskiviikko;1;0;1
94;07.03.2018;2018;03;01;Keskiviikko;0;0;0
94;07.03.2018;2018;03;02;Keskiviikko;0;0;0
94;07.03.2018;2018;03;03;Keskiviikko;0;0;0
94;07.03.2018;2018;03;04;Keskiviikko;0;0;0
94;07.03.2018;2018;03;05;Keskiviikko;3;1;4
94;07.03.2018;2018;03;06;Keskiviikko;2;0;2
94;07.03.2018;2018;03;07;Keskiviikko;3;0;3
94;07.03.2018;2018;03;08;Keskiviikko;2;0;2
94;07.03.2018;2018;03;09;Keskiviikko;0;0;0
94;07.03.2018;2018;03;10;Keskiviikko;0;0;0
94;07.03.2018;2018;03;11;Keskiviikko;0;1;1
94;07.03.2018;2018;03;12;Keskiviikko;0;0;0
94;07.03.2018;2018;03;13;Keskiviikko;2;1;3
94;07.03.2018;2018;03;14;Keskiviikko;3;2;5
94;07.03.2018;2018;03;15;Keskiviikko;0;1;1
94;07.03.2018;2018;03;16;Keskiviikko;1;6;7
94;07.03.2018;2018;03;17;Keskiviikko;0;1;1
94;07.03.2018;2018;03;18;Keskiviikko;0;1;1
94;07.03.2018;2018;03;19;Keskiviikko;0;1;1
94;07.03.2018;2018;03;20;Keskiviikko;0;1;1
94;07.03.2018;2018;03;21;Keskiviikko;0;1;1
94;07.03.2018;2018;03;22;Keskiviikko;0;1;1
94;07.03.2018;2018;03;23;Keskiviikko;0;0;0
94;08.03.2018;2018;03;00;Torstai;0;0;0
94;08.03.2018;2018;03;01;Torstai;0;0;0
94;08.03.2018;2018;03;02;Torstai;0;0;0
94;08.03.2018;2018;03;03;Torstai;0;0;0
94;08.03.2018;2018;03;04;Torstai;0;0;0
94;08.03.2018;2018;03;05;Torstai;3;1;4
94;08.03.2018;2018;03;06;Torstai;0;0;0
94;08.03.2018;2018;03;07;Torstai;4;0;4
94;08.03.2018;2018;03;08;Torstai;3;1;4
94;08.03.2018;2018;03;09;Torstai;0;1;1
94;08.03.2018;2018;03;10;Torstai;1;0;1
94;08.03.2018;2018;03;11;Torstai;0;0;0
94;08.03.2018;2018;03;12;Torstai;1;0;1
94;08.03.2018;2018;03;13;Torstai;0;1;1
94;08.03.2018;2018;03;14;Torstai;1;3;4
94;08.03.2018;2018;03;15;Torstai;1;3;4
94;08.03.2018;2018;03;16;Torstai;0;5;5
94;08.03.2018;2018;03;17;Torstai;0;2;2
94;08.03.2018;2018;03;18;Torstai;0;2;2
94;08.03.2018;2018;03;19;Torstai;0;1;1
94;08.03.2018;2018;03;20;Torstai;0;1;1
94;08.03.2018;2018;03;21;Torstai;0;0;0
94;08.03.2018;2018;03;22;Torstai;0;0;0
94;08.03.2018;2018;03;23;Torstai;0;0;0
94;09.03.2018;2018;03;00;Perjantai;0;0;0
94;09.03.2018;2018;03;01;Perjantai;0;0;0
94;09.03.2018;2018;03;02;Perjantai;0;0;0
94;09.03.2018;2018;03;03;Perjantai;0;0;0
94;09.03.2018;2018;03;04;Perjantai;0;0;0
94;09.03.2018;2018;03;05;Perjantai;3;1;4
94;09.03.2018;2018;03;06;Perjantai;1;0;1
94;09.03.2018;2018;03;07;Perjantai;3;0;3
94;09.03.2018;2018;03;08;Perjantai;1;0;1
94;09.03.2018;2018;03;09;Perjantai;2;0;2
94;09.03.2018;2018;03;10;Perjantai;0;0;0
94;09.03.2018;2018;03;11;Perjantai;1;0;1
94;09.03.2018;2018;03;12;Perjantai;0;0;0
94;09.03.2018;2018;03;13;Perjantai;1;1;2
94;09.03.2018;2018;03;14;Perjantai;0;2;2
94;09.03.2018;2018;03;15;Perjantai;0;5;5
94;09.03.2018;2018;03;16;Perjantai;0;2;2
94;09.03.2018;2018;03;17;Perjantai;0;1;1
94;09.03.2018;2018;03;18;Perjantai;0;0;0
94;09.03.2018;2018;03;19;Perjantai;0;2;2
94;09.03.2018;2018;03;20;Perjantai;0;0;0
94;09.03.2018;2018;03;21;Perjantai;0;0;0
94;09.03.2018;2018;03;22;Perjantai;0;0;0
94;09.03.2018;2018;03;23;Perjantai;0;0;0
94;10.03.2018;2018;03;00;Lauantai;0;0;0
94;10.03.2018;2018;03;01;Lauantai;0;0;0
94;10.03.2018;2018;03;02;Lauantai;0;0;0
94;10.03.2018;2018;03;03;Lauantai;0;0;0
94;10.03.2018;2018;03;04;Lauantai;0;0;0
94;10.03.2018;2018;03;05;Lauantai;0;0;0
94;10.03.2018;2018;03;06;Lauantai;1;0;1
94;10.03.2018;2018;03;07;Lauantai;0;0;0
94;10.03.2018;2018;03;08;Lauantai;0;0;0
94;10.03.2018;2018;03;09;Lauantai;1;1;2
94;10.03.2018;2018;03;10;Lauantai;3;1;4
94;10.03.2018;2018;03;11;Lauantai;1;1;2
94;10.03.2018;2018;03;12;Lauantai;2;0;2
94;10.03.2018;2018;03;13;Lauantai;0;1;1
94;10.03.2018;2018;03;14;Lauantai;1;4;5
94;10.03.2018;2018;03;15;Lauantai;0;1;1
94;10.03.2018;2018;03;16;Lauantai;2;0;2
94;10.03.2018;2018;03;17;Lauantai;0;0;0
94;10.03.2018;2018;03;18;Lauantai;0;1;1
94;10.03.2018;2018;03;19;Lauantai;1;2;3
94;10.03.2018;2018;03;20;Lauantai;1;0;1
94;10.03.2018;2018;03;21;Lauantai;0;1;1
94;10.03.2018;2018;03;22;Lauantai;0;1;1
94;10.03.2018;2018;03;23;Lauantai;0;0;0
94;11.03.2018;2018;03;00;Sunnuntai;1;0;1
94;11.03.2018;2018;03;01;Sunnuntai;0;0;0
94;11.03.2018;2018;03;02;Sunnuntai;0;0;0
94;11.03.2018;2018;03;03;Sunnuntai;0;0;0
94;11.03.2018;2018;03;04;Sunnuntai;0;0;0
94;11.03.2018;2018;03;05;Sunnuntai;0;0;0
94;11.03.2018;2018;03;06;Sunnuntai;0;0;0
94;11.03.2018;2018;03;07;Sunnuntai;0;0;0
94;11.03.2018;2018;03;08;Sunnuntai;1;1;2
94;11.03.2018;2018;03;09;Sunnuntai;0;0;0
94;11.03.2018;2018;03;10;Sunnuntai;0;0;0
94;11.03.2018;2018;03;11;Sunnuntai;0;3;3
94;11.03.2018;2018;03;12;Sunnuntai;2;0;2
94;11.03.2018;2018;03;13;Sunnuntai;1;0;1
94;11.03.2018;2018;03;14;Sunnuntai;1;0;1
94;11.03.2018;2018;03;15;Sunnuntai;1;0;1
94;11.03.2018;2018;03;16;Sunnuntai;0;1;1
94;11.03.2018;2018;03;17;Sunnuntai;0;0;0
94;11.03.2018;2018;03;18;Sunnuntai;0;0;0
94;11.03.2018;2018;03;19;Sunnuntai;0;0;0
94;11.03.2018;2018;03;20;Sunnuntai;0;1;1
94;11.03.2018;2018;03;21;Sunnuntai;0;3;3
94;11.03.2018;2018;03;22;Sunnuntai;0;0;0
94;11.03.2018;2018;03;23;Sunnuntai;0;0;0
94;12.03.2018;2018;03;00;Maanantai;0;0;0
94;12.03.2018;2018;03;01;Maanantai;0;0;0
94;12.03.2018;2018;03;02;Maanantai;0;0;0
94;12.03.2018;2018;03;03;Maanantai;0;0;0
94;12.03.2018;2018;03;04;Maanantai;0;0;0
94;12.03.2018;2018;03;05;Maanantai;2;0;2
94;12.03.2018;2018;03;06;Maanantai;3;1;4
94;12.03.2018;2018;03;07;Maanantai;11;1;12
94;12.03.2018;2018;03;08;Maanantai;4;1;5
94;12.03.2018;2018;03;09;Maanantai;1;1;2
94;12.03.2018;2018;03;10;Maanantai;2;0;2
94;12.03.2018;2018;03;11;Maanantai;0;1;1
94;12.03.2018;2018;03;12;Maanantai;2;1;3
94;12.03.2018;2018;03;13;Maanantai;1;0;1
94;12.03.2018;2018;03;14;Maanantai;1;3;4
94;12.03.2018;2018;03;15;Maanantai;1;7;8
94;12.03.2018;2018;03;16;Maanantai;1;7;8
94;12.03.2018;2018;03;17;Maanantai;0;4;4
94;12.03.2018;2018;03;18;Maanantai;0;3;3
94;12.03.2018;2018;03;19;Maanantai;0;2;2
94;12.03.2018;2018;03;20;Maanantai;0;0;0
94;12.03.2018;2018;03;21;Maanantai;0;0;0
94;12.03.2018;2018;03;22;Maanantai;0;2;2
94;12.03.2018;2018;03;23;Maanantai;0;0;0
94;13.03.2018;2018;03;00;Tiistai;0;0;0
94;13.03.2018;2018;03;01;Tiistai;0;0;0
94;13.03.2018;2018;03;02;Tiistai;0;0;0
94;13.03.2018;2018;03;03;Tiistai;0;0;0
94;13.03.2018;2018;03;04;Tiistai;0;0;0
94;13.03.2018;2018;03;05;Tiistai;4;1;5
94;13.03.2018;2018;03;06;Tiistai;4;1;5
94;13.03.2018;2018;03;07;Tiistai;7;0;7
94;13.03.2018;2018;03;08;Tiistai;4;1;5
94;13.03.2018;2018;03;09;Tiistai;3;0;3
94;13.03.2018;2018;03;10;Tiistai;1;0;1
94;13.03.2018;2018;03;11;Tiistai;0;0;0
94;13.03.2018;2018;03;12;Tiistai;0;0;0
94;13.03.2018;2018;03;13;Tiistai;0;0;0
94;13.03.2018;2018;03;14;Tiistai;1;5;6
94;13.03.2018;2018;03;15;Tiistai;0;8;8
94;13.03.2018;2018;03;16;Tiistai;0;8;8
94;13.03.2018;2018;03;17;Tiistai;3;2;5
94;13.03.2018;2018;03;18;Tiistai;0;1;1
94;13.03.2018;2018;03;19;Tiistai;0;3;3
94;13.03.2018;2018;03;20;Tiistai;0;0;0
94;13.03.2018;2018;03;21;Tiistai;0;0;0
94;13.03.2018;2018;03;22;Tiistai;0;0;0
94;13.03.2018;2018;03;23;Tiistai;0;0;0
94;14.03.2018;2018;03;00;Keskiviikko;0;0;0
94;14.03.2018;2018;03;01;Keskiviikko;0;0;0
94;14.03.2018;2018;03;02;Keskiviikko;0;0;0
94;14.03.2018;2018;03;03;Keskiviikko;0;0;0
94;14.03.2018;2018;03;04;Keskiviikko;1;0;1
94;14.03.2018;2018;03;05;Keskiviikko;3;0;3
94;14.03.2018;2018;03;06;Keskiviikko;5;0;5
94;14.03.2018;2018;03;07;Keskiviikko;7;0;7
94;14.03.2018;2018;03;08;Keskiviikko;4;1;5
94;14.03.2018;2018;03;09;Keskiviikko;1;1;2
94;14.03.2018;2018;03;10;Keskiviikko;0;0;0
94;14.03.2018;2018;03;11;Keskiviikko;0;1;1
94;14.03.2018;2018;03;12;Keskiviikko;0;0;0
94;14.03.2018;2018;03;13;Keskiviikko;2;1;3
94;14.03.2018;2018;03;14;Keskiviikko;0;3;3
94;14.03.2018;2018;03;15;Keskiviikko;0;3;3
94;14.03.2018;2018;03;16;Keskiviikko;0;7;7
94;14.03.2018;2018;03;17;Keskiviikko;0;3;3
94;14.03.2018;2018;03;18;Keskiviikko;1;0;1
94;14.03.2018;2018;03;19;Keskiviikko;0;2;2
94;14.03.2018;2018;03;20;Keskiviikko;0;0;0
94;14.03.2018;2018;03;21;Keskiviikko;0;1;1
94;14.03.2018;2018;03;22;Keskiviikko;0;1;1
94;14.03.2018;2018;03;23;Keskiviikko;0;0;0
94;15.03.2018;2018;03;00;Torstai;0;0;0
94;15.03.2018;2018;03;01;Torstai;0;0;0
94;15.03.2018;2018;03;02;Torstai;0;0;0
94;15.03.2018;2018;03;03;Torstai;0;0;0
94;15.03.2018;2018;03;04;Torstai;0;0;0
94;15.03.2018;2018;03;05;Torstai;3;0;3
94;15.03.2018;2018;03;06;Torstai;1;0;1
94;15.03.2018;2018;03;07;Torstai;9;0;9
94;15.03.2018;2018;03;08;Torstai;3;0;3
94;15.03.2018;2018;03;09;Torstai;2;0;2
94;15.03.2018;2018;03;10;Torstai;2;1;3
94;15.03.2018;2018;03;11;Torstai;0;0;0
94;15.03.2018;2018;03;12;Torstai;1;1;2
94;15.03.2018;2018;03;13;Torstai;0;0;0
94;15.03.2018;2018;03;14;Torstai;0;4;4
94;15.03.2018;2018;03;15;Torstai;1;5;6
94;15.03.2018;2018;03;16;Torstai;2;12;14
94;15.03.2018;2018;03;17;Torstai;0;3;3
94;15.03.2018;2018;03;18;Torstai;0;2;2
94;15.03.2018;2018;03;19;Torstai;0;2;2
94;15.03.2018;2018;03;20;Torstai;0;1;1
94;15.03.2018;2018;03;21;Torstai;0;0;0
94;15.03.2018;2018;03;22;Torstai;0;1;1
94;15.03.2018;2018;03;23;Torstai;0;0;0
94;16.03.2018;2018;03;00;Perjantai;0;0;0
94;16.03.2018;2018;03;01;Perjantai;0;0;0
94;16.03.2018;2018;03;02;Perjantai;0;0;0
94;16.03.2018;2018;03;03;Perjantai;0;0;0
94;16.03.2018;2018;03;04;Perjantai;0;0;0
94;16.03.2018;2018;03;05;Perjantai;4;0;4
94;16.03.2018;2018;03;06;Perjantai;2;0;2
94;16.03.2018;2018;03;07;Perjantai;7;0;7
94;16.03.2018;2018;03;08;Perjantai;4;0;4
94;16.03.2018;2018;03;09;Perjantai;1;0;1
94;16.03.2018;2018;03;10;Perjantai;0;0;0
94;16.03.2018;2018;03;11;Perjantai;2;0;2
94;16.03.2018;2018;03;12;Perjantai;1;1;2
94;16.03.2018;2018;03;13;Perjantai;0;4;4
94;16.03.2018;2018;03;14;Perjantai;1;6;7
94;16.03.2018;2018;03;15;Perjantai;2;1;3
94;16.03.2018;2018;03;16;Perjantai;7;6;13
94;16.03.2018;2018;03;17;Perjantai;1;3;4
94;16.03.2018;2018;03;18;Perjantai;0;2;2
94;16.03.2018;2018;03;19;Perjantai;1;3;4
94;16.03.2018;2018;03;20;Perjantai;0;6;6
94;16.03.2018;2018;03;21;Perjantai;0;0;0
94;16.03.2018;2018;03;22;Perjantai;0;1;1
94;16.03.2018;2018;03;23;Perjantai;0;0;0
94;17.03.2018;2018;03;00;Lauantai;0;0;0
94;17.03.2018;2018;03;01;Lauantai;0;0;0
94;17.03.2018;2018;03;02;Lauantai;0;0;0
94;17.03.2018;2018;03;03;Lauantai;0;0;0
94;17.03.2018;2018;03;04;Lauantai;0;0;0
94;17.03.2018;2018;03;05;Lauantai;1;0;1
94;17.03.2018;2018;03;06;Lauantai;0;1;1
94;17.03.2018;2018;03;07;Lauantai;0;0;0
94;17.03.2018;2018;03;08;Lauantai;2;0;2
94;17.03.2018;2018;03;09;Lauantai;1;1;2
94;17.03.2018;2018;03;10;Lauantai;2;0;2
94;17.03.2018;2018;03;11;Lauantai;0;1;1
94;17.03.2018;2018;03;12;Lauantai;0;1;1
94;17.03.2018;2018;03;13;Lauantai;1;0;1
94;17.03.2018;2018;03;14;Lauantai;1;2;3
94;17.03.2018;2018;03;15;Lauantai;1;4;5
94;17.03.2018;2018;03;16;Lauantai;1;1;2
94;17.03.2018;2018;03;17;Lauantai;1;1;2
94;17.03.2018;2018;03;18;Lauantai;0;2;2
94;17.03.2018;2018;03;19;Lauantai;0;2;2
94;17.03.2018;2018;03;20;Lauantai;0;1;1
94;17.03.2018;2018;03;21;Lauantai;1;0;1
94;17.03.2018;2018;03;22;Lauantai;0;0;0
94;17.03.2018;2018;03;23;Lauantai;0;1;1
94;18.03.2018;2018;03;00;Sunnuntai;1;0;1
94;18.03.2018;2018;03;01;Sunnuntai;0;0;0
94;18.03.2018;2018;03;02;Sunnuntai;0;0;0
94;18.03.2018;2018;03;03;Sunnuntai;0;0;0
94;18.03.2018;2018;03;04;Sunnuntai;0;0;0
94;18.03.2018;2018;03;05;Sunnuntai;0;0;0
94;18.03.2018;2018;03;06;Sunnuntai;0;1;1
94;18.03.2018;2018;03;07;Sunnuntai;0;0;0
94;18.03.2018;2018;03;08;Sunnuntai;1;0;1
94;18.03.2018;2018;03;09;Sunnuntai;1;0;1
94;18.03.2018;2018;03;10;Sunnuntai;1;0;1
94;18.03.2018;2018;03;11;Sunnuntai;1;0;1
94;18.03.2018;2018;03;12;Sunnuntai;0;1;1
94;18.03.2018;2018;03;13;Sunnuntai;1;0;1
94;18.03.2018;2018;03;14;Sunnuntai;4;1;5
94;18.03.2018;2018;03;15;Sunnuntai;0;1;1
94;18.03.2018;2018;03;16;Sunnuntai;1;2;3
94;18.03.2018;2018;03;17;Sunnuntai;0;0;0
94;18.03.2018;2018;03;18;Sunnuntai;0;2;2
94;18.03.2018;2018;03;19;Sunnuntai;0;1;1
94;18.03.2018;2018;03;20;Sunnuntai;1;0;1
94;18.03.2018;2018;03;21;Sunnuntai;0;0;0
94;18.03.2018;2018;03;22;Sunnuntai;0;0;0
94;18.03.2018;2018;03;23;Sunnuntai;0;0;0
94;19.03.2018;2018;03;00;Maanantai;0;0;0
94;19.03.2018;2018;03;01;Maanantai;0;0;0
94;19.03.2018;2018;03;02;Maanantai;0;0;0
94;19.03.2018;2018;03;03;Maanantai;0;0;0
94;19.03.2018;2018;03;04;Maanantai;0;0;0
94;19.03.2018;2018;03;05;Maanantai;3;1;4
94;19.03.2018;2018;03;06;Maanantai;5;0;5
94;19.03.2018;2018;03;07;Maanantai;6;0;6
94;19.03.2018;2018;03;08;Maanantai;6;0;6
94;19.03.2018;2018;03;09;Maanantai;1;0;1
94;19.03.2018;2018;03;10;Maanantai;0;0;0
94;19.03.2018;2018;03;11;Maanantai;0;0;0
94;19.03.2018;2018;03;12;Maanantai;2;0;2
94;19.03.2018;2018;03;13;Maanantai;0;1;1
94;19.03.2018;2018;03;14;Maanantai;1;6;7
94;19.03.2018;2018;03;15;Maanantai;1;6;7
94;19.03.2018;2018;03;16;Maanantai;2;11;13
94;19.03.2018;2018;03;17;Maanantai;0;3;3
94;19.03.2018;2018;03;18;Maanantai;0;4;4
94;19.03.2018;2018;03;19;Maanantai;0;2;2
94;19.03.2018;2018;03;20;Maanantai;1;1;2
94;19.03.2018;2018;03;21;Maanantai;1;0;1
94;19.03.2018;2018;03;22;Maanantai;0;1;1
94;19.03.2018;2018;03;23;Maanantai;0;0;0
94;20.03.2018;2018;03;00;Tiistai;0;0;0
94;20.03.2018;2018;03;01;Tiistai;0;0;0
94;20.03.2018;2018;03;02;Tiistai;0;0;0
94;20.03.2018;2018;03;03;Tiistai;0;0;0
94;20.03.2018;2018;03;04;Tiistai;0;0;0
94;20.03.2018;2018;03;05;Tiistai;3;1;4
94;20.03.2018;2018;03;06;Tiistai;4;1;5
94;20.03.2018;2018;03;07;Tiistai;10;0;10
94;20.03.2018;2018;03;08;Tiistai;4;0;4
94;20.03.2018;2018;03;09;Tiistai;0;0;0
94;20.03.2018;2018;03;10;Tiistai;0;0;0
94;20.03.2018;2018;03;11;Tiistai;2;0;2
94;20.03.2018;2018;03;12;Tiistai;0;0;0
94;20.03.2018;2018;03;13;Tiistai;1;0;1
94;20.03.2018;2018;03;14;Tiistai;2;6;8
94;20.03.2018;2018;03;15;Tiistai;1;7;8
94;20.03.2018;2018;03;16;Tiistai;0;6;6
94;20.03.2018;2018;03;17;Tiistai;0;5;5
94;20.03.2018;2018;03;18;Tiistai;1;2;3
94;20.03.2018;2018;03;19;Tiistai;0;3;3
94;20.03.2018;2018;03;20;Tiistai;0;2;2
94;20.03.2018;2018;03;21;Tiistai;1;1;2
94;20.03.2018;2018;03;22;Tiistai;0;0;0
94;20.03.2018;2018;03;23;Tiistai;0;0;0
94;21.03.2018;2018;03;00;Keskiviikko;0;0;0
94;21.03.2018;2018;03;01;Keskiviikko;0;0;0
94;21.03.2018;2018;03;02;Keskiviikko;0;0;0
94;21.03.2018;2018;03;03;Keskiviikko;0;0;0
94;21.03.2018;2018;03;04;Keskiviikko;0;0;0
94;21.03.2018;2018;03;05;Keskiviikko;2;2;4
94;21.03.2018;2018;03;06;Keskiviikko;3;0;3
94;21.03.2018;2018;03;07;Keskiviikko;6;0;6
94;21.03.2018;2018;03;08;Keskiviikko;1;0;1
94;21.03.2018;2018;03;09;Keskiviikko;2;2;4
94;21.03.2018;2018;03;10;Keskiviikko;0;0;0
94;21.03.2018;2018;03;11;Keskiviikko;1;0;1
94;21.03.2018;2018;03;12;Keskiviikko;1;0;1
94;21.03.2018;2018;03;13;Keskiviikko;0;1;1
94;21.03.2018;2018;03;14;Keskiviikko;1;4;5
94;21.03.2018;2018;03;15;Keskiviikko;0;7;7
94;21.03.2018;2018;03;16;Keskiviikko;2;2;4
94;21.03.2018;2018;03;17;Keskiviikko;1;2;3
94;21.03.2018;2018;03;18;Keskiviikko;0;1;1
94;21.03.2018;2018;03;19;Keskiviikko;0;1;1
94;21.03.2018;2018;03;20;Keskiviikko;0;1;1
94;21.03.2018;2018;03;21;Keskiviikko;0;0;0
94;21.03.2018;2018;03;22;Keskiviikko;0;1;1
94;21.03.2018;2018;03;23;Keskiviikko;0;0;0
94;22.03.2018;2018;03;00;Torstai;0;0;0
94;22.03.2018;2018;03;01;Torstai;0;0;0
94;22.03.2018;2018;03;02;Torstai;0;0;0
94;22.03.2018;2018;03;03;Torstai;0;0;0
94;22.03.2018;2018;03;04;Torstai;0;0;0
94;22.03.2018;2018;03;05;Torstai;5;1;6
94;22.03.2018;2018;03;06;Torstai;4;0;4
94;22.03.2018;2018;03;07;Torstai;12;0;12
94;22.03.2018;2018;03;08;Torstai;1;0;1
94;22.03.2018;2018;03;09;Torstai;2;0;2
94;22.03.2018;2018;03;10;Torstai;0;1;1
94;22.03.2018;2018;03;11;Torstai;1;0;1
94;22.03.2018;2018;03;12;Torstai;0;0;0
94;22.03.2018;2018;03;13;Torstai;0;0;0
94;22.03.2018;2018;03;14;Torstai;2;5;7
94;22.03.2018;2018;03;15;Torstai;1;7;8
94;22.03.2018;2018;03;16;Torstai;0;8;8
94;22.03.2018;2018;03;17;Torstai;0;5;5
94;22.03.2018;2018;03;18;Torstai;0;0;0
94;22.03.2018;2018;03;19;Torstai;1;0;1
94;22.03.2018;2018;03;20;Torstai;0;0;0
94;22.03.2018;2018;03;21;Torstai;0;1;1
94;22.03.2018;2018;03;22;Torstai;0;0;0
94;22.03.2018;2018;03;23;Torstai;0;0;0
94;23.03.2018;2018;03;00;Perjantai;0;0;0
94;23.03.2018;2018;03;01;Perjantai;0;0;0
94;23.03.2018;2018;03;02;Perjantai;0;0;0
94;23.03.2018;2018;03;03;Perjantai;0;0;0
94;23.03.2018;2018;03;04;Perjantai;1;0;1
94;23.03.2018;2018;03;05;Perjantai;1;1;2
94;23.03.2018;2018;03;06;Perjantai;1;1;2
94;23.03.2018;2018;03;07;Perjantai;7;0;7
94;23.03.2018;2018;03;08;Perjantai;3;0;3
94;23.03.2018;2018;03;09;Perjantai;1;1;2
94;23.03.2018;2018;03;10;Perjantai;1;1;2
94;23.03.2018;2018;03;11;Perjantai;2;0;2
94;23.03.2018;2018;03;12;Perjantai;2;2;4
94;23.03.2018;2018;03;13;Perjantai;0;2;2
94;23.03.2018;2018;03;14;Perjantai;2;3;5
94;23.03.2018;2018;03;15;Perjantai;1;4;5
94;23.03.2018;2018;03;16;Perjantai;0;5;5
94;23.03.2018;2018;03;17;Perjantai;0;3;3
94;23.03.2018;2018;03;18;Perjantai;1;0;1
94;23.03.2018;2018;03;19;Perjantai;0;0;0
94;23.03.2018;2018;03;20;Perjantai;0;2;2
94;23.03.2018;2018;03;21;Perjantai;0;0;0
94;23.03.2018;2018;03;22;Perjantai;0;2;2
94;23.03.2018;2018;03;23;Perjantai;0;0;0
94;24.03.2018;2018;03;00;Lauantai;0;0;0
94;24.03.2018;2018;03;01;Lauantai;0;0;0
94;24.03.2018;2018;03;02;Lauantai;0;0;0
94;24.03.2018;2018;03;03;Lauantai;0;0;0
94;24.03.2018;2018;03;04;Lauantai;0;0;0
94;24.03.2018;2018;03;05;Lauantai;0;1;1
94;24.03.2018;2018;03;06;Lauantai;0;0;0
94;24.03.2018;2018;03;07;Lauantai;0;0;0
94;24.03.2018;2018;03;08;Lauantai;2;0;2
94;24.03.2018;2018;03;09;Lauantai;0;0;0
94;24.03.2018;2018;03;10;Lauantai;0;1;1
94;24.03.2018;2018;03;11;Lauantai;1;0;1
94;24.03.2018;2018;03;12;Lauantai;1;0;1
94;24.03.2018;2018;03;13;Lauantai;1;1;2
94;24.03.2018;2018;03;14;Lauantai;1;1;2
94;24.03.2018;2018;03;15;Lauantai;1;0;1
94;24.03.2018;2018;03;16;Lauantai;0;0;0
94;24.03.2018;2018;03;17;Lauantai;0;0;0
94;24.03.2018;2018;03;18;Lauantai;5;7;12
94;24.03.2018;2018;03;19;Lauantai;0;1;1
94;24.03.2018;2018;03;20;Lauantai;0;0;0
94;24.03.2018;2018;03;21;Lauantai;0;1;1
94;24.03.2018;2018;03;22;Lauantai;0;0;0
94;24.03.2018;2018;03;23;Lauantai;0;0;0
94;25.03.2018;2018;03;00;Sunnuntai;0;0;0
94;25.03.2018;2018;03;01;Sunnuntai;0;0;0
94;25.03.2018;2018;03;02;Sunnuntai;0;0;0
94;25.03.2018;2018;03;03;Sunnuntai;0;0;0
94;25.03.2018;2018;03;04;Sunnuntai;0;0;0
94;25.03.2018;2018;03;05;Sunnuntai;1;0;1
94;25.03.2018;2018;03;06;Sunnuntai;0;0;0
94;25.03.2018;2018;03;07;Sunnuntai;0;0;0
94;25.03.2018;2018;03;08;Sunnuntai;1;0;1
94;25.03.2018;2018;03;09;Sunnuntai;0;0;0
94;25.03.2018;2018;03;10;Sunnuntai;0;0;0
94;25.03.2018;2018;03;11;Sunnuntai;1;0;1
94;25.03.2018;2018;03;12;Sunnuntai;1;1;2
94;25.03.2018;2018;03;13;Sunnuntai;0;0;0
94;25.03.2018;2018;03;14;Sunnuntai;2;5;7
94;25.03.2018;2018;03;15;Sunnuntai;5;6;11
94;25.03.2018;2018;03;16;Sunnuntai;1;4;5
94;25.03.2018;2018;03;17;Sunnuntai;3;0;3
94;25.03.2018;2018;03;18;Sunnuntai;2;1;3
94;25.03.2018;2018;03;19;Sunnuntai;1;1;2
94;25.03.2018;2018;03;20;Sunnuntai;0;0;0
94;25.03.2018;2018;03;21;Sunnuntai;0;1;1
94;25.03.2018;2018;03;22;Sunnuntai;0;0;0
94;25.03.2018;2018;03;23;Sunnuntai;0;0;0
94;26.03.2018;2018;03;00;Maanantai;0;0;0
94;26.03.2018;2018;03;01;Maanantai;0;0;0
94;26.03.2018;2018;03;02;Maanantai;0;0;0
94;26.03.2018;2018;03;03;Maanantai;0;0;0
94;26.03.2018;2018;03;04;Maanantai;0;0;0
94;26.03.2018;2018;03;05;Maanantai;0;1;1
94;26.03.2018;2018;03;06;Maanantai;2;0;2
94;26.03.2018;2018;03;07;Maanantai;4;0;4
94;26.03.2018;2018;03;08;Maanantai;6;2;8
94;26.03.2018;2018;03;09;Maanantai;2;0;2
94;26.03.2018;2018;03;10;Maanantai;0;0;0
94;26.03.2018;2018;03;11;Maanantai;0;0;0
94;26.03.2018;2018;03;12;Maanantai;3;0;3
94;26.03.2018;2018;03;13;Maanantai;3;1;4
94;26.03.2018;2018;03;14;Maanantai;2;0;2
94;26.03.2018;2018;03;15;Maanantai;0;5;5
94;26.03.2018;2018;03;16;Maanantai;1;6;7
94;26.03.2018;2018;03;17;Maanantai;0;6;6
94;26.03.2018;2018;03;18;Maanantai;0;2;2
94;26.03.2018;2018;03;19;Maanantai;0;4;4
94;26.03.2018;2018;03;20;Maanantai;0;0;0
94;26.03.2018;2018;03;21;Maanantai;0;2;2
94;26.03.2018;2018;03;22;Maanantai;0;3;3
94;26.03.2018;2018;03;23;Maanantai;0;2;2
94;27.03.2018;2018;03;00;Tiistai;0;0;0
94;27.03.2018;2018;03;01;Tiistai;0;0;0
94;27.03.2018;2018;03;02;Tiistai;0;0;0
94;27.03.2018;2018;03;03;Tiistai;0;0;0
94;27.03.2018;2018;03;04;Tiistai;0;0;0
94;27.03.2018;2018;03;05;Tiistai;0;1;1
94;27.03.2018;2018;03;06;Tiistai;3;2;5
94;27.03.2018;2018;03;07;Tiistai;6;0;6
94;27.03.2018;2018;03;08;Tiistai;3;1;4
94;27.03.2018;2018;03;09;Tiistai;2;0;2
94;27.03.2018;2018;03;10;Tiistai;1;0;1
94;27.03.2018;2018;03;11;Tiistai;2;1;3
94;27.03.2018;2018;03;12;Tiistai;1;0;1
94;27.03.2018;2018;03;13;Tiistai;3;0;3
94;27.03.2018;2018;03;14;Tiistai;1;0;1
94;27.03.2018;2018;03;15;Tiistai;0;8;8
94;27.03.2018;2018;03;16;Tiistai;0;5;5
94;27.03.2018;2018;03;17;Tiistai;0;5;5
94;27.03.2018;2018;03;18;Tiistai;1;4;5
94;27.03.2018;2018;03;19;Tiistai;0;1;1
94;27.03.2018;2018;03;20;Tiistai;0;2;2
94;27.03.2018;2018;03;21;Tiistai;0;0;0
94;27.03.2018;2018;03;22;Tiistai;0;1;1
94;27.03.2018;2018;03;23;Tiistai;0;1;1
94;28.03.2018;2018;03;00;Keskiviikko;0;0;0
94;28.03.2018;2018;03;01;Keskiviikko;0;0;0
94;28.03.2018;2018;03;02;Keskiviikko;0;0;0
94;28.03.2018;2018;03;03;Keskiviikko;0;0;0
94;28.03.2018;2018;03;04;Keskiviikko;1;0;1
94;28.03.2018;2018;03;05;Keskiviikko;1;1;2
94;28.03.2018;2018;03;06;Keskiviikko;3;1;4
94;28.03.2018;2018;03;07;Keskiviikko;7;0;7
94;28.03.2018;2018;03;08;Keskiviikko;2;0;2
94;28.03.2018;2018;03;09;Keskiviikko;2;0;2
94;28.03.2018;2018;03;10;Keskiviikko;0;0;0
94;28.03.2018;2018;03;11;Keskiviikko;3;0;3
94;28.03.2018;2018;03;12;Keskiviikko;1;0;1
94;28.03.2018;2018;03;13;Keskiviikko;1;1;2
94;28.03.2018;2018;03;14;Keskiviikko;4;5;9
94;28.03.2018;2018;03;15;Keskiviikko;0;6;6
94;28.03.2018;2018;03;16;Keskiviikko;5;8;13
94;28.03.2018;2018;03;17;Keskiviikko;1;7;8
94;28.03.2018;2018;03;18;Keskiviikko;0;1;1
94;28.03.2018;2018;03;19;Keskiviikko;0;2;2
94;28.03.2018;2018;03;20;Keskiviikko;1;3;4
94;28.03.2018;2018;03;21;Keskiviikko;0;3;3
94;28.03.2018;2018;03;22;Keskiviikko;0;0;0
94;28.03.2018;2018;03;23;Keskiviikko;0;0;0
94;29.03.2018;2018;03;00;Torstai;0;0;0
94;29.03.2018;2018;03;01;Torstai;0;0;0
94;29.03.2018;2018;03;02;Torstai;0;0;0
94;29.03.2018;2018;03;03;Torstai;0;0;0
94;29.03.2018;2018;03;04;Torstai;0;0;0
94;29.03.2018;2018;03;05;Torstai;1;1;2
94;29.03.2018;2018;03;06;Torstai;1;0;1
94;29.03.2018;2018;03;07;Torstai;6;1;7
94;29.03.2018;2018;03;08;Torstai;1;0;1
94;29.03.2018;2018;03;09;Torstai;0;0;0
94;29.03.2018;2018;03;10;Torstai;1;0;1
94;29.03.2018;2018;03;11;Torstai;0;1;1
94;29.03.2018;2018;03;12;Torstai;1;3;4
94;29.03.2018;2018;03;13;Torstai;1;0;1
94;29.03.2018;2018;03;14;Torstai;0;2;2
94;29.03.2018;2018;03;15;Torstai;1;4;5
94;29.03.2018;2018;03;16;Torstai;3;2;5
94;29.03.2018;2018;03;17;Torstai;0;1;1
94;29.03.2018;2018;03;18;Torstai;0;1;1
94;29.03.2018;2018;03;19;Torstai;0;2;2
94;29.03.2018;2018;03;20;Torstai;1;2;3
94;29.03.2018;2018;03;21;Torstai;1;1;2
94;29.03.2018;2018;03;22;Torstai;0;1;1
94;29.03.2018;2018;03;23;Torstai;0;0;0
94;30.03.2018;2018;03;00;Perjantai;0;0;0
94;30.03.2018;2018;03;01;Perjantai;0;0;0
94;30.03.2018;2018;03;02;Perjantai;0;0;0
94;30.03.2018;2018;03;03;Perjantai;0;0;0
94;30.03.2018;2018;03;04;Perjantai;0;0;0
94;30.03.2018;2018;03;05;Perjantai;0;0;0
94;30.03.2018;2018;03;06;Perjantai;0;0;0
94;30.03.2018;2018;03;07;Perjantai;0;0;0
94;30.03.2018;2018;03;08;Perjantai;0;0;0
94;30.03.2018;2018;03;09;Perjantai;0;0;0
94;30.03.2018;2018;03;10;Perjantai;1;0;1
94;30.03.2018;2018;03;11;Perjantai;0;3;3
94;30.03.2018;2018;03;12;Perjantai;1;1;2
94;30.03.2018;2018;03;13;Perjantai;3;3;6
94;30.03.2018;2018;03;14;Perjantai;4;2;6
94;30.03.2018;2018;03;15;Perjantai;4;2;6
94;30.03.2018;2018;03;16;Perjantai;0;7;7
94;30.03.2018;2018;03;17;Perjantai;3;1;4
94;30.03.2018;2018;03;18;Perjantai;0;1;1
94;30.03.2018;2018;03;19;Perjantai;0;2;2
94;30.03.2018;2018;03;20;Perjantai;1;1;2
94;30.03.2018;2018;03;21;Perjantai;0;1;1
94;30.03.2018;2018;03;22;Perjantai;0;0;0
94;30.03.2018;2018;03;23;Perjantai;0;0;0
94;31.03.2018;2018;03;00;Lauantai;0;0;0
94;31.03.2018;2018;03;01;Lauantai;0;0;0
94;31.03.2018;2018;03;02;Lauantai;0;0;0
94;31.03.2018;2018;03;03;Lauantai;0;0;0
94;31.03.2018;2018;03;04;Lauantai;0;0;0
94;31.03.2018;2018;03;05;Lauantai;0;0;0
94;31.03.2018;2018;03;06;Lauantai;0;0;0
94;31.03.2018;2018;03;07;Lauantai;0;0;0
94;31.03.2018;2018;03;08;Lauantai;1;0;1
94;31.03.2018;2018;03;09;Lauantai;0;1;1
94;31.03.2018;2018;03;10;Lauantai;1;0;1
94;31.03.2018;2018;03;11;Lauantai;1;0;1
94;31.03.2018;2018;03;12;Lauantai;4;0;4
94;31.03.2018;2018;03;13;Lauantai;1;2;3
94;31.03.2018;2018;03;14;Lauantai;0;1;1
94;31.03.2018;2018;03;15;Lauantai;0;1;1
94;31.03.2018;2018;03;16;Lauantai;0;2;2
94;31.03.2018;2018;03;17;Lauantai;0;1;1
94;31.03.2018;2018;03;18;Lauantai;0;0;0
94;31.03.2018;2018;03;19;Lauantai;1;0;1
94;31.03.2018;2018;03;20;Lauantai;5;1;6
94;31.03.2018;2018;03;21;Lauantai;0;2;2
94;31.03.2018;2018;03;22;Lauantai;0;0;0
94;31.03.2018;2018;03;23;Lauantai;0;3;3
94;01.04.2018;2018;04;00;Sunnuntai;0;0;0
94;01.04.2018;2018;04;01;Sunnuntai;0;0;0
94;01.04.2018;2018;04;02;Sunnuntai;0;0;0
94;01.04.2018;2018;04;03;Sunnuntai;0;0;0
94;01.04.2018;2018;04;04;Sunnuntai;0;0;0
94;01.04.2018;2018;04;05;Sunnuntai;0;0;0
94;01.04.2018;2018;04;06;Sunnuntai;0;0;0
94;01.04.2018;2018;04;07;Sunnuntai;0;0;0
94;01.04.2018;2018;04;08;Sunnuntai;1;1;2
94;01.04.2018;2018;04;09;Sunnuntai;1;0;1
94;01.04.2018;2018;04;10;Sunnuntai;0;0;0
94;01.04.2018;2018;04;11;Sunnuntai;3;3;6
94;01.04.2018;2018;04;12;Sunnuntai;0;0;0
94;01.04.2018;2018;04;13;Sunnuntai;1;1;2
94;01.04.2018;2018;04;14;Sunnuntai;2;2;4
94;01.04.2018;2018;04;15;Sunnuntai;4;2;6
94;01.04.2018;2018;04;16;Sunnuntai;1;2;3
94;01.04.2018;2018;04;17;Sunnuntai;2;0;2
94;01.04.2018;2018;04;18;Sunnuntai;0;0;0
94;01.04.2018;2018;04;19;Sunnuntai;1;0;1
94;01.04.2018;2018;04;20;Sunnuntai;0;0;0
94;01.04.2018;2018;04;21;Sunnuntai;0;0;0
94;01.04.2018;2018;04;22;Sunnuntai;0;1;1
94;01.04.2018;2018;04;23;Sunnuntai;0;0;0
94;02.04.2018;2018;04;00;Maanantai;0;0;0
94;02.04.2018;2018;04;01;Maanantai;0;0;0
94;02.04.2018;2018;04;02;Maanantai;0;0;0
94;02.04.2018;2018;04;03;Maanantai;0;0;0
94;02.04.2018;2018;04;04;Maanantai;0;0;0
94;02.04.2018;2018;04;05;Maanantai;0;0;0
94;02.04.2018;2018;04;06;Maanantai;0;0;0
94;02.04.2018;2018;04;07;Maanantai;0;0;0
94;02.04.2018;2018;04;08;Maanantai;0;1;1
94;02.04.2018;2018;04;09;Maanantai;0;0;0
94;02.04.2018;2018;04;10;Maanantai;2;0;2
94;02.04.2018;2018;04;11;Maanantai;2;2;4
94;02.04.2018;2018;04;12;Maanantai;4;1;5
94;02.04.2018;2018;04;13;Maanantai;0;0;0
94;02.04.2018;2018;04;14;Maanantai;0;1;1
94;02.04.2018;2018;04;15;Maanantai;1;1;2
94;02.04.2018;2018;04;16;Maanantai;1;0;1
94;02.04.2018;2018;04;17;Maanantai;1;0;1
94;02.04.2018;2018;04;18;Maanantai;0;0;0
94;02.04.2018;2018;04;19;Maanantai;1;0;1
94;02.04.2018;2018;04;20;Maanantai;0;3;3
94;02.04.2018;2018;04;21;Maanantai;0;0;0
94;02.04.2018;2018;04;22;Maanantai;0;0;0
94;02.04.2018;2018;04;23;Maanantai;0;0;0
94;03.04.2018;2018;04;00;Tiistai;0;0;0
94;03.04.2018;2018;04;01;Tiistai;0;0;0
94;03.04.2018;2018;04;02;Tiistai;0;0;0
94;03.04.2018;2018;04;03;Tiistai;0;0;0
94;03.04.2018;2018;04;04;Tiistai;0;0;0
94;03.04.2018;2018;04;05;Tiistai;2;1;3
94;03.04.2018;2018;04;06;Tiistai;5;0;5
94;03.04.2018;2018;04;07;Tiistai;6;0;6
94;03.04.2018;2018;04;08;Tiistai;4;1;5
94;03.04.2018;2018;04;09;Tiistai;4;0;4
94;03.04.2018;2018;04;10;Tiistai;0;1;1
94;03.04.2018;2018;04;11;Tiistai;0;1;1
94;03.04.2018;2018;04;12;Tiistai;1;1;2
94;03.04.2018;2018;04;13;Tiistai;0;0;0
94;03.04.2018;2018;04;14;Tiistai;3;4;7
94;03.04.2018;2018;04;15;Tiistai;1;6;7
94;03.04.2018;2018;04;16;Tiistai;0;5;5
94;03.04.2018;2018;04;17;Tiistai;0;4;4
94;03.04.2018;2018;04;18;Tiistai;1;2;3
94;03.04.2018;2018;04;19;Tiistai;0;2;2
94;03.04.2018;2018;04;20;Tiistai;1;0;1
94;03.04.2018;2018;04;21;Tiistai;1;2;3
94;03.04.2018;2018;04;22;Tiistai;0;0;0
94;03.04.2018;2018;04;23;Tiistai;0;0;0
94;04.04.2018;2018;04;00;Keskiviikko;0;0;0
94;04.04.2018;2018;04;01;Keskiviikko;0;0;0
94;04.04.2018;2018;04;02;Keskiviikko;0;0;0
94;04.04.2018;2018;04;03;Keskiviikko;0;0;0
94;04.04.2018;2018;04;04;Keskiviikko;0;0;0
94;04.04.2018;2018;04;05;Keskiviikko;3;1;4
94;04.04.2018;2018;04;06;Keskiviikko;10;0;10
94;04.04.2018;2018;04;07;Keskiviikko;8;1;9
94;04.04.2018;2018;04;08;Keskiviikko;6;2;8
94;04.04.2018;2018;04;09;Keskiviikko;5;0;5
94;04.04.2018;2018;04;10;Keskiviikko;0;2;2
94;04.04.2018;2018;04;11;Keskiviikko;1;1;2
94;04.04.2018;2018;04;12;Keskiviikko;1;0;1
94;04.04.2018;2018;04;13;Keskiviikko;1;1;2
94;04.04.2018;2018;04;14;Keskiviikko;1;5;6
94;04.04.2018;2018;04;15;Keskiviikko;0;7;7
94;04.04.2018;2018;04;16;Keskiviikko;0;7;7
94;04.04.2018;2018;04;17;Keskiviikko;0;4;4
94;04.04.2018;2018;04;18;Keskiviikko;1;3;4
94;04.04.2018;2018;04;19;Keskiviikko;0;3;3
94;04.04.2018;2018;04;20;Keskiviikko;1;1;2
94;04.04.2018;2018;04;21;Keskiviikko;0;1;1
94;04.04.2018;2018;04;22;Keskiviikko;0;0;0
94;04.04.2018;2018;04;23;Keskiviikko;0;1;1
94;05.04.2018;2018;04;00;Torstai;0;0;0
94;05.04.2018;2018;04;01;Torstai;0;0;0
94;05.04.2018;2018;04;02;Torstai;0;0;0
94;05.04.2018;2018;04;03;Torstai;0;0;0
94;05.04.2018;2018;04;04;Torstai;0;0;0
94;05.04.2018;2018;04;05;Torstai;4;1;5
94;05.04.2018;2018;04;06;Torstai;4;0;4
94;05.04.2018;2018;04;07;Torstai;6;1;7
94;05.04.2018;2018;04;08;Torstai;5;0;5
94;05.04.2018;2018;04;09;Torstai;1;0;1
94;05.04.2018;2018;04;10;Torstai;0;0;0
94;05.04.2018;2018;04;11;Torstai;2;2;4
94;05.04.2018;2018;04;12;Torstai;0;3;3
94;05.04.2018;2018;04;13;Torstai;0;1;1
94;05.04.2018;2018;04;14;Torstai;1;5;6
94;05.04.2018;2018;04;15;Torstai;0;5;5
94;05.04.2018;2018;04;16;Torstai;1;5;6
94;05.04.2018;2018;04;17;Torstai;0;6;6
94;05.04.2018;2018;04;18;Torstai;1;2;3
94;05.04.2018;2018;04;19;Torstai;1;5;6
94;05.04.2018;2018;04;20;Torstai;0;0;0
94;05.04.2018;2018;04;21;Torstai;1;1;2
94;05.04.2018;2018;04;22;Torstai;0;0;0
94;05.04.2018;2018;04;23;Torstai;0;0;0
94;06.04.2018;2018;04;00;Perjantai;0;0;0
94;06.04.2018;2018;04;01;Perjantai;0;0;0
94;06.04.2018;2018;04;02;Perjantai;0;0;0
94;06.04.2018;2018;04;03;Perjantai;0;0;0
94;06.04.2018;2018;04;04;Perjantai;1;0;1
94;06.04.2018;2018;04;05;Perjantai;2;1;3
94;06.04.2018;2018;04;06;Perjantai;2;0;2
94;06.04.2018;2018;04;07;Perjantai;5;1;6
94;06.04.2018;2018;04;08;Perjantai;0;0;0
94;06.04.2018;2018;04;09;Perjantai;1;2;3
94;06.04.2018;2018;04;10;Perjantai;0;0;0
94;06.04.2018;2018;04;11;Perjantai;0;6;6
94;06.04.2018;2018;04;12;Perjantai;0;0;0
94;06.04.2018;2018;04;13;Perjantai;0;2;2
94;06.04.2018;2018;04;14;Perjantai;1;5;6
94;06.04.2018;2018;04;15;Perjantai;1;2;3
94;06.04.2018;2018;04;16;Perjantai;0;3;3
94;06.04.2018;2018;04;17;Perjantai;0;2;2
94;06.04.2018;2018;04;18;Perjantai;2;4;6
94;06.04.2018;2018;04;19;Perjantai;1;0;1
94;06.04.2018;2018;04;20;Perjantai;0;0;0
94;06.04.2018;2018;04;21;Perjantai;0;4;4
94;06.04.2018;2018;04;22;Perjantai;0;0;0
94;06.04.2018;2018;04;23;Perjantai;0;0;0
94;07.04.2018;2018;04;00;Lauantai;0;0;0
94;07.04.2018;2018;04;01;Lauantai;0;0;0
94;07.04.2018;2018;04;02;Lauantai;0;0;0
94;07.04.2018;2018;04;03;Lauantai;0;0;0
94;07.04.2018;2018;04;04;Lauantai;0;0;0
94;07.04.2018;2018;04;05;Lauantai;1;0;1
94;07.04.2018;2018;04;06;Lauantai;0;0;0
94;07.04.2018;2018;04;07;Lauantai;0;0;0
94;07.04.2018;2018;04;08;Lauantai;1;1;2
94;07.04.2018;2018;04;09;Lauantai;0;0;0
94;07.04.2018;2018;04;10;Lauantai;0;0;0
94;07.04.2018;2018;04;11;Lauantai;1;3;4
94;07.04.2018;2018;04;12;Lauantai;0;0;0
94;07.04.2018;2018;04;13;Lauantai;0;2;2
94;07.04.2018;2018;04;14;Lauantai;2;0;2
94;07.04.2018;2018;04;15;Lauantai;0;0;0
94;07.04.2018;2018;04;16;Lauantai;1;0;1
94;07.04.2018;2018;04;17;Lauantai;0;1;1
94;07.04.2018;2018;04;18;Lauantai;0;0;0
94;07.04.2018;2018;04;19;Lauantai;0;1;1
94;07.04.2018;2018;04;20;Lauantai;0;4;4
94;07.04.2018;2018;04;21;Lauantai;4;0;4
94;07.04.2018;2018;04;22;Lauantai;0;0;0
94;07.04.2018;2018;04;23;Lauantai;3;0;3
94;08.04.2018;2018;04;00;Sunnuntai;0;0;0
94;08.04.2018;2018;04;01;Sunnuntai;0;0;0
94;08.04.2018;2018;04;02;Sunnuntai;0;0;0
94;08.04.2018;2018;04;03;Sunnuntai;0;0;0
94;08.04.2018;2018;04;04;Sunnuntai;0;0;0
94;08.04.2018;2018;04;05;Sunnuntai;2;0;2
94;08.04.2018;2018;04;06;Sunnuntai;0;0;0
94;08.04.2018;2018;04;07;Sunnuntai;0;0;0
94;08.04.2018;2018;04;08;Sunnuntai;2;0;2
94;08.04.2018;2018;04;09;Sunnuntai;0;1;1
94;08.04.2018;2018;04;10;Sunnuntai;0;0;0
94;08.04.2018;2018;04;11;Sunnuntai;1;0;1
94;08.04.2018;2018;04;12;Sunnuntai;0;3;3
94;08.04.2018;2018;04;13;Sunnuntai;2;0;2
94;08.04.2018;2018;04;14;Sunnuntai;0;1;1
94;08.04.2018;2018;04;15;Sunnuntai;1;1;2
94;08.04.2018;2018;04;16;Sunnuntai;5;2;7
94;08.04.2018;2018;04;17;Sunnuntai;3;0;3
94;08.04.2018;2018;04;18;Sunnuntai;0;0;0
94;08.04.2018;2018;04;19;Sunnuntai;1;1;2
94;08.04.2018;2018;04;20;Sunnuntai;1;0;1
94;08.04.2018;2018;04;21;Sunnuntai;2;1;3
94;08.04.2018;2018;04;22;Sunnuntai;1;0;1
94;08.04.2018;2018;04;23;Sunnuntai;0;0;0
94;09.04.2018;2018;04;00;Maanantai;0;0;0
94;09.04.2018;2018;04;01;Maanantai;0;0;0
94;09.04.2018;2018;04;02;Maanantai;0;0;0
94;09.04.2018;2018;04;03;Maanantai;0;0;0
94;09.04.2018;2018;04;04;Maanantai;0;0;0
94;09.04.2018;2018;04;05;Maanantai;3;1;4
94;09.04.2018;2018;04;06;Maanantai;7;0;7
94;09.04.2018;2018;04;07;Maanantai;8;0;8
94;09.04.2018;2018;04;08;Maanantai;3;0;3
94;09.04.2018;2018;04;09;Maanantai;1;0;1
94;09.04.2018;2018;04;10;Maanantai;0;0;0
94;09.04.2018;2018;04;11;Maanantai;0;1;1
94;09.04.2018;2018;04;12;Maanantai;1;0;1
94;09.04.2018;2018;04;13;Maanantai;1;1;2
94;09.04.2018;2018;04;14;Maanantai;1;6;7
94;09.04.2018;2018;04;15;Maanantai;1;10;11
94;09.04.2018;2018;04;16;Maanantai;4;6;10
94;09.04.2018;2018;04;17;Maanantai;0;6;6
94;09.04.2018;2018;04;18;Maanantai;0;3;3
94;09.04.2018;2018;04;19;Maanantai;2;3;5
94;09.04.2018;2018;04;20;Maanantai;1;5;6
94;09.04.2018;2018;04;21;Maanantai;0;0;0
94;09.04.2018;2018;04;22;Maanantai;1;1;2
94;09.04.2018;2018;04;23;Maanantai;0;0;0
94;10.04.2018;2018;04;00;Tiistai;0;0;0
94;10.04.2018;2018;04;01;Tiistai;0;0;0
94;10.04.2018;2018;04;02;Tiistai;0;0;0
94;10.04.2018;2018;04;03;Tiistai;0;0;0
94;10.04.2018;2018;04;04;Tiistai;0;0;0
94;10.04.2018;2018;04;05;Tiistai;2;1;3
94;10.04.2018;2018;04;06;Tiistai;4;0;4
94;10.04.2018;2018;04;07;Tiistai;5;0;5
94;10.04.2018;2018;04;08;Tiistai;2;0;2
94;10.04.2018;2018;04;09;Tiistai;1;0;1
94;10.04.2018;2018;04;10;Tiistai;1;0;1
94;10.04.2018;2018;04;11;Tiistai;1;0;1
94;10.04.2018;2018;04;12;Tiistai;1;4;5
94;10.04.2018;2018;04;13;Tiistai;1;0;1
94;10.04.2018;2018;04;14;Tiistai;1;6;7
94;10.04.2018;2018;04;15;Tiistai;0;5;5
94;10.04.2018;2018;04;16;Tiistai;0;5;5
94;10.04.2018;2018;04;17;Tiistai;2;2;4
94;10.04.2018;2018;04;18;Tiistai;1;4;5
94;10.04.2018;2018;04;19;Tiistai;1;1;2
94;10.04.2018;2018;04;20;Tiistai;0;1;1
94;10.04.2018;2018;04;21;Tiistai;0;0;0
94;10.04.2018;2018;04;22;Tiistai;0;1;1
94;10.04.2018;2018;04;23;Tiistai;0;0;0
94;11.04.2018;2018;04;00;Keskiviikko;0;0;0
94;11.04.2018;2018;04;01;Keskiviikko;0;0;0
94;11.04.2018;2018;04;02;Keskiviikko;0;0;0
94;11.04.2018;2018;04;03;Keskiviikko;1;0;1
94;11.04.2018;2018;04;04;Keskiviikko;1;0;1
94;11.04.2018;2018;04;05;Keskiviikko;4;1;5
94;11.04.2018;2018;04;06;Keskiviikko;3;0;3
94;11.04.2018;2018;04;07;Keskiviikko;5;0;5
94;11.04.2018;2018;04;08;Keskiviikko;7;0;7
94;11.04.2018;2018;04;09;Keskiviikko;0;0;0
94;11.04.2018;2018;04;10;Keskiviikko;3;2;5
94;11.04.2018;2018;04;11;Keskiviikko;1;0;1
94;11.04.2018;2018;04;12;Keskiviikko;0;1;1
94;11.04.2018;2018;04;13;Keskiviikko;2;1;3
94;11.04.2018;2018;04;14;Keskiviikko;3;5;8
94;11.04.2018;2018;04;15;Keskiviikko;1;10;11
94;11.04.2018;2018;04;16;Keskiviikko;3;7;10
94;11.04.2018;2018;04;17;Keskiviikko;0;6;6
94;11.04.2018;2018;04;18;Keskiviikko;3;3;6
94;11.04.2018;2018;04;19;Keskiviikko;0;2;2
94;11.04.2018;2018;04;20;Keskiviikko;0;1;1
94;11.04.2018;2018;04;21;Keskiviikko;0;1;1
94;11.04.2018;2018;04;22;Keskiviikko;1;1;2
94;11.04.2018;2018;04;23;Keskiviikko;0;0;0
94;12.04.2018;2018;04;00;Torstai;0;0;0
94;12.04.2018;2018;04;01;Torstai;0;0;0
94;12.04.2018;2018;04;02;Torstai;0;0;0
94;12.04.2018;2018;04;03;Torstai;0;0;0
94;12.04.2018;2018;04;04;Torstai;0;0;0
94;12.04.2018;2018;04;05;Torstai;1;2;3
94;12.04.2018;2018;04;06;Torstai;5;0;5
94;12.04.2018;2018;04;07;Torstai;10;0;10
94;12.04.2018;2018;04;08;Torstai;8;1;9
94;12.04.2018;2018;04;09;Torstai;1;0;1
94;12.04.2018;2018;04;10;Torstai;0;2;2
94;12.04.2018;2018;04;11;Torstai;2;0;2
94;12.04.2018;2018;04;12;Torstai;2;2;4
94;12.04.2018;2018;04;13;Torstai;0;1;1
94;12.04.2018;2018;04;14;Torstai;3;6;9
94;12.04.2018;2018;04;15;Torstai;1;7;8
94;12.04.2018;2018;04;16;Torstai;4;6;10
94;12.04.2018;2018;04;17;Torstai;0;4;4
94;12.04.2018;2018;04;18;Torstai;3;1;4
94;12.04.2018;2018;04;19;Torstai;0;6;6
94;12.04.2018;2018;04;20;Torstai;0;1;1
94;12.04.2018;2018;04;21;Torstai;0;3;3
94;12.04.2018;2018;04;22;Torstai;1;2;3
94;12.04.2018;2018;04;23;Torstai;0;0;0
94;13.04.2018;2018;04;00;Perjantai;0;0;0
94;13.04.2018;2018;04;01;Perjantai;0;0;0
94;13.04.2018;2018;04;02;Perjantai;0;0;0
94;13.04.2018;2018;04;03;Perjantai;2;0;2
94;13.04.2018;2018;04;04;Perjantai;0;0;0
94;13.04.2018;2018;04;05;Perjantai;3;3;6
94;13.04.2018;2018;04;06;Perjantai;1;0;1
94;13.04.2018;2018;04;07;Perjantai;10;0;10
94;13.04.2018;2018;04;08;Perjantai;2;0;2
94;13.04.2018;2018;04;09;Perjantai;1;0;1
94;13.04.2018;2018;04;10;Perjantai;2;0;2
94;13.04.2018;2018;04;11;Perjantai;1;0;1
94;13.04.2018;2018;04;12;Perjantai;1;0;1
94;13.04.2018;2018;04;13;Perjantai;3;7;10
94;13.04.2018;2018;04;14;Perjantai;2;6;8
94;13.04.2018;2018;04;15;Perjantai;3;4;7
94;13.04.2018;2018;04;16;Perjantai;3;7;10
94;13.04.2018;2018;04;17;Perjantai;1;6;7
94;13.04.2018;2018;04;18;Perjantai;6;4;10
94;13.04.2018;2018;04;19;Perjantai;4;0;4
94;13.04.2018;2018;04;20;Perjantai;0;3;3
94;13.04.2018;2018;04;21;Perjantai;0;5;5
94;13.04.2018;2018;04;22;Perjantai;0;0;0
94;13.04.2018;2018;04;23;Perjantai;0;0;0
94;14.04.2018;2018;04;00;Lauantai;0;0;0
94;14.04.2018;2018;04;01;Lauantai;0;0;0
94;14.04.2018;2018;04;02;Lauantai;0;0;0
94;14.04.2018;2018;04;03;Lauantai;0;0;0
94;14.04.2018;2018;04;04;Lauantai;0;0;0
94;14.04.2018;2018;04;05;Lauantai;0;0;0
94;14.04.2018;2018;04;06;Lauantai;1;0;1
94;14.04.2018;2018;04;07;Lauantai;1;0;1
94;14.04.2018;2018;04;08;Lauantai;0;1;1
94;14.04.2018;2018;04;09;Lauantai;1;1;2
94;14.04.2018;2018;04;10;Lauantai;1;0;1
94;14.04.2018;2018;04;11;Lauantai;2;2;4
94;14.04.2018;2018;04;12;Lauantai;1;3;4
94;14.04.2018;2018;04;13;Lauantai;5;1;6
94;14.04.2018;2018;04;14;Lauantai;2;2;4
94;14.04.2018;2018;04;15;Lauantai;2;4;6
94;14.04.2018;2018;04;16;Lauantai;1;0;1
94;14.04.2018;2018;04;17;Lauantai;3;5;8
94;14.04.2018;2018;04;18;Lauantai;1;2;3
94;14.04.2018;2018;04;19;Lauantai;3;3;6
94;14.04.2018;2018;04;20;Lauantai;0;0;0
94;14.04.2018;2018;04;21;Lauantai;0;2;2
94;14.04.2018;2018;04;22;Lauantai;0;0;0
94;14.04.2018;2018;04;23;Lauantai;0;0;0
94;15.04.2018;2018;04;00;Sunnuntai;0;0;0
94;15.04.2018;2018;04;01;Sunnuntai;0;0;0
94;15.04.2018;2018;04;02;Sunnuntai;0;0;0
94;15.04.2018;2018;04;03;Sunnuntai;0;0;0
94;15.04.2018;2018;04;04;Sunnuntai;0;0;0
94;15.04.2018;2018;04;05;Sunnuntai;0;0;0
94;15.04.2018;2018;04;06;Sunnuntai;1;0;1
94;15.04.2018;2018;04;07;Sunnuntai;1;0;1
94;15.04.2018;2018;04;08;Sunnuntai;1;2;3
94;15.04.2018;2018;04;09;Sunnuntai;1;1;2
94;15.04.2018;2018;04;10;Sunnuntai;2;0;2
94;15.04.2018;2018;04;11;Sunnuntai;3;2;5
94;15.04.2018;2018;04;12;Sunnuntai;8;2;10
94;15.04.2018;2018;04;13;Sunnuntai;4;5;9
94;15.04.2018;2018;04;14;Sunnuntai;4;2;6
94;15.04.2018;2018;04;15;Sunnuntai;5;13;18
94;15.04.2018;2018;04;16;Sunnuntai;0;1;1
94;15.04.2018;2018;04;17;Sunnuntai;2;1;3
94;15.04.2018;2018;04;18;Sunnuntai;2;2;4
94;15.04.2018;2018;04;19;Sunnuntai;4;7;11
94;15.04.2018;2018;04;20;Sunnuntai;1;0;1
94;15.04.2018;2018;04;21;Sunnuntai;2;2;4
94;15.04.2018;2018;04;22;Sunnuntai;0;0;0
94;15.04.2018;2018;04;23;Sunnuntai;0;0;0
94;16.04.2018;2018;04;00;Maanantai;0;0;0
94;16.04.2018;2018;04;01;Maanantai;0;0;0
94;16.04.2018;2018;04;02;Maanantai;0;0;0
94;16.04.2018;2018;04;03;Maanantai;0;0;0
94;16.04.2018;2018;04;04;Maanantai;0;0;0
94;16.04.2018;2018;04;05;Maanantai;7;2;9
94;16.04.2018;2018;04;06;Maanantai;5;1;6
94;16.04.2018;2018;04;07;Maanantai;8;2;10
94;16.04.2018;2018;04;08;Maanantai;8;0;8
94;16.04.2018;2018;04;09;Maanantai;2;0;2
94;16.04.2018;2018;04;10;Maanantai;8;3;11
94;16.04.2018;2018;04;11;Maanantai;3;2;5
94;16.04.2018;2018;04;12;Maanantai;2;4;6
94;16.04.2018;2018;04;13;Maanantai;3;2;5
94;16.04.2018;2018;04;14;Maanantai;2;7;9
94;16.04.2018;2018;04;15;Maanantai;6;11;17
94;16.04.2018;2018;04;16;Maanantai;2;8;10
94;16.04.2018;2018;04;17;Maanantai;5;8;13
94;16.04.2018;2018;04;18;Maanantai;0;7;7
94;16.04.2018;2018;04;19;Maanantai;4;3;7
94;16.04.2018;2018;04;20;Maanantai;2;4;6
94;16.04.2018;2018;04;21;Maanantai;2;1;3
94;16.04.2018;2018;04;22;Maanantai;1;2;3
94;16.04.2018;2018;04;23;Maanantai;0;0;0
94;17.04.2018;2018;04;00;Tiistai;0;0;0
94;17.04.2018;2018;04;01;Tiistai;0;0;0
94;17.04.2018;2018;04;02;Tiistai;0;0;0
94;17.04.2018;2018;04;03;Tiistai;0;0;0
94;17.04.2018;2018;04;04;Tiistai;0;0;0
94;17.04.2018;2018;04;05;Tiistai;4;2;6
94;17.04.2018;2018;04;06;Tiistai;10;0;10
94;17.04.2018;2018;04;07;Tiistai;14;3;17
94;17.04.2018;2018;04;08;Tiistai;8;3;11
94;17.04.2018;2018;04;09;Tiistai;4;1;5
94;17.04.2018;2018;04;10;Tiistai;2;1;3
94;17.04.2018;2018;04;11;Tiistai;4;2;6
94;17.04.2018;2018;04;12;Tiistai;1;2;3
94;17.04.2018;2018;04;13;Tiistai;4;6;10
94;17.04.2018;2018;04;14;Tiistai;1;7;8
94;17.04.2018;2018;04;15;Tiistai;7;11;18
94;17.04.2018;2018;04;16;Tiistai;2;15;17
94;17.04.2018;2018;04;17;Tiistai;8;11;19
94;17.04.2018;2018;04;18;Tiistai;4;6;10
94;17.04.2018;2018;04;19;Tiistai;4;5;9
94;17.04.2018;2018;04;20;Tiistai;2;4;6
94;17.04.2018;2018;04;21;Tiistai;3;4;7
94;17.04.2018;2018;04;22;Tiistai;1;2;3
94;17.04.2018;2018;04;23;Tiistai;0;0;0
94;18.04.2018;2018;04;00;Keskiviikko;0;0;0
94;18.04.2018;2018;04;01;Keskiviikko;0;0;0
94;18.04.2018;2018;04;02;Keskiviikko;0;0;0
94;18.04.2018;2018;04;03;Keskiviikko;0;0;0
94;18.04.2018;2018;04;04;Keskiviikko;0;1;1
94;18.04.2018;2018;04;05;Keskiviikko;5;4;9
94;18.04.2018;2018;04;06;Keskiviikko;9;0;9
94;18.04.2018;2018;04;07;Keskiviikko;11;1;12
94;18.04.2018;2018;04;08;Keskiviikko;12;1;13
94;18.04.2018;2018;04;09;Keskiviikko;3;2;5
94;18.04.2018;2018;04;10;Keskiviikko;7;2;9
94;18.04.2018;2018;04;11;Keskiviikko;2;4;6
94;18.04.2018;2018;04;12;Keskiviikko;1;4;5
94;18.04.2018;2018;04;13;Keskiviikko;6;6;12
94;18.04.2018;2018;04;14;Keskiviikko;7;4;11
94;18.04.2018;2018;04;15;Keskiviikko;7;12;19
94;18.04.2018;2018;04;16;Keskiviikko;2;18;20
94;18.04.2018;2018;04;17;Keskiviikko;5;17;22
94;18.04.2018;2018;04;18;Keskiviikko;3;12;15
94;18.04.2018;2018;04;19;Keskiviikko;8;5;13
94;18.04.2018;2018;04;20;Keskiviikko;4;5;9
94;18.04.2018;2018;04;21;Keskiviikko;1;0;1
94;18.04.2018;2018;04;22;Keskiviikko;1;3;4
94;18.04.2018;2018;04;23;Keskiviikko;0;0;0
94;19.04.2018;2018;04;00;Torstai;0;0;0
94;19.04.2018;2018;04;01;Torstai;0;0;0
94;19.04.2018;2018;04;02;Torstai;0;0;0
94;19.04.2018;2018;04;03;Torstai;0;0;0
94;19.04.2018;2018;04;04;Torstai;0;0;0
94;19.04.2018;2018;04;05;Torstai;3;2;5
94;19.04.2018;2018;04;06;Torstai;8;0;8
94;19.04.2018;2018;04;07;Torstai;15;0;15
94;19.04.2018;2018;04;08;Torstai;10;1;11
94;19.04.2018;2018;04;09;Torstai;1;2;3
94;19.04.2018;2018;04;10;Torstai;2;2;4
94;19.04.2018;2018;04;11;Torstai;3;2;5
94;19.04.2018;2018;04;12;Torstai;3;2;5
94;19.04.2018;2018;04;13;Torstai;2;3;5
94;19.04.2018;2018;04;14;Torstai;4;9;13
94;19.04.2018;2018;04;15;Torstai;3;12;15
94;19.04.2018;2018;04;16;Torstai;8;17;25
94;19.04.2018;2018;04;17;Torstai;2;11;13
94;19.04.2018;2018;04;18;Torstai;4;3;7
94;19.04.2018;2018;04;19;Torstai;2;8;10
94;19.04.2018;2018;04;20;Torstai;2;3;5
94;19.04.2018;2018;04;21;Torstai;1;1;2
94;19.04.2018;2018;04;22;Torstai;1;4;5
94;19.04.2018;2018;04;23;Torstai;0;0;0
94;20.04.2018;2018;04;00;Perjantai;0;0;0
94;20.04.2018;2018;04;01;Perjantai;0;0;0
94;20.04.2018;2018;04;02;Perjantai;0;0;0
94;20.04.2018;2018;04;03;Perjantai;0;0;0
94;20.04.2018;2018;04;04;Perjantai;0;0;0
94;20.04.2018;2018;04;05;Perjantai;2;1;3
94;20.04.2018;2018;04;06;Perjantai;5;0;5
94;20.04.2018;2018;04;07;Perjantai;9;0;9
94;20.04.2018;2018;04;08;Perjantai;3;0;3
94;20.04.2018;2018;04;09;Perjantai;2;0;2
94;20.04.2018;2018;04;10;Perjantai;0;0;0
94;20.04.2018;2018;04;11;Perjantai;1;1;2
94;20.04.2018;2018;04;12;Perjantai;0;3;3
94;20.04.2018;2018;04;13;Perjantai;1;6;7
94;20.04.2018;2018;04;14;Perjantai;4;2;6
94;20.04.2018;2018;04;15;Perjantai;2;7;9
94;20.04.2018;2018;04;16;Perjantai;1;8;9
94;20.04.2018;2018;04;17;Perjantai;1;7;8
94;20.04.2018;2018;04;18;Perjantai;2;3;5
94;20.04.2018;2018;04;19;Perjantai;1;3;4
94;20.04.2018;2018;04;20;Perjantai;0;3;3
94;20.04.2018;2018;04;21;Perjantai;0;3;3
94;20.04.2018;2018;04;22;Perjantai;0;1;1
94;20.04.2018;2018;04;23;Perjantai;1;0;1
94;21.04.2018;2018;04;00;Lauantai;0;0;0
94;21.04.2018;2018;04;01;Lauantai;0;0;0
94;21.04.2018;2018;04;02;Lauantai;0;0;0
94;21.04.2018;2018;04;03;Lauantai;1;0;1
94;21.04.2018;2018;04;04;Lauantai;0;0;0
94;21.04.2018;2018;04;05;Lauantai;0;2;2
94;21.04.2018;2018;04;06;Lauantai;1;0;1
94;21.04.2018;2018;04;07;Lauantai;0;1;1
94;21.04.2018;2018;04;08;Lauantai;2;1;3
94;21.04.2018;2018;04;09;Lauantai;3;2;5
94;21.04.2018;2018;04;10;Lauantai;2;4;6
94;21.04.2018;2018;04;11;Lauantai;4;5;9
94;21.04.2018;2018;04;12;Lauantai;9;4;13
94;21.04.2018;2018;04;13;Lauantai;7;3;10
94;21.04.2018;2018;04;14;Lauantai;5;8;13
94;21.04.2018;2018;04;15;Lauantai;1;7;8
94;21.04.2018;2018;04;16;Lauantai;11;5;16
94;21.04.2018;2018;04;17;Lauantai;8;10;18
94;21.04.2018;2018;04;18;Lauantai;2;1;3
94;21.04.2018;2018;04;19;Lauantai;1;4;5
94;21.04.2018;2018;04;20;Lauantai;5;1;6
94;21.04.2018;2018;04;21;Lauantai;1;1;2
94;21.04.2018;2018;04;22;Lauantai;0;1;1
94;21.04.2018;2018;04;23;Lauantai;1;1;2
94;22.04.2018;2018;04;00;Sunnuntai;0;1;1
94;22.04.2018;2018;04;01;Sunnuntai;0;0;0
94;22.04.2018;2018;04;02;Sunnuntai;0;0;0
94;22.04.2018;2018;04;03;Sunnuntai;0;0;0
94;22.04.2018;2018;04;04;Sunnuntai;0;1;1
94;22.04.2018;2018;04;05;Sunnuntai;0;1;1
94;22.04.2018;2018;04;06;Sunnuntai;0;0;0
94;22.04.2018;2018;04;07;Sunnuntai;0;0;0
94;22.04.2018;2018;04;08;Sunnuntai;1;2;3
94;22.04.2018;2018;04;09;Sunnuntai;4;2;6
94;22.04.2018;2018;04;10;Sunnuntai;6;3;9
94;22.04.2018;2018;04;11;Sunnuntai;10;6;16
94;22.04.2018;2018;04;12;Sunnuntai;12;8;20
94;22.04.2018;2018;04;13;Sunnuntai;7;9;16
94;22.04.2018;2018;04;14;Sunnuntai;14;16;30
94;22.04.2018;2018;04;15;Sunnuntai;4;16;20
94;22.04.2018;2018;04;16;Sunnuntai;13;9;22
94;22.04.2018;2018;04;17;Sunnuntai;5;8;13
94;22.04.2018;2018;04;18;Sunnuntai;7;5;12
94;22.04.2018;2018;04;19;Sunnuntai;2;7;9
94;22.04.2018;2018;04;20;Sunnuntai;2;0;2
94;22.04.2018;2018;04;21;Sunnuntai;3;2;5
94;22.04.2018;2018;04;22;Sunnuntai;0;0;0
94;22.04.2018;2018;04;23;Sunnuntai;0;0;0
94;23.04.2018;2018;04;00;Maanantai;0;0;0
94;23.04.2018;2018;04;01;Maanantai;0;0;0
94;23.04.2018;2018;04;02;Maanantai;0;0;0
94;23.04.2018;2018;04;03;Maanantai;0;0;0
94;23.04.2018;2018;04;04;Maanantai;0;0;0
94;23.04.2018;2018;04;05;Maanantai;4;2;6
94;23.04.2018;2018;04;06;Maanantai;8;1;9
94;23.04.2018;2018;04;07;Maanantai;22;1;23
94;23.04.2018;2018;04;08;Maanantai;16;1;17
94;23.04.2018;2018;04;09;Maanantai;4;0;4
94;23.04.2018;2018;04;10;Maanantai;1;2;3
94;23.04.2018;2018;04;11;Maanantai;1;4;5
94;23.04.2018;2018;04;12;Maanantai;4;25;29
94;23.04.2018;2018;04;13;Maanantai;41;30;71
94;23.04.2018;2018;04;14;Maanantai;3;12;15
94;23.04.2018;2018;04;15;Maanantai;5;16;21
94;23.04.2018;2018;04;16;Maanantai;4;16;20
94;23.04.2018;2018;04;17;Maanantai;11;11;22
94;23.04.2018;2018;04;18;Maanantai;5;10;15
94;23.04.2018;2018;04;19;Maanantai;8;5;13
94;23.04.2018;2018;04;20;Maanantai;3;1;4
94;23.04.2018;2018;04;21;Maanantai;3;3;6
94;23.04.2018;2018;04;22;Maanantai;0;0;0
94;23.04.2018;2018;04;23;Maanantai;0;0;0
94;24.04.2018;2018;04;00;Tiistai;0;0;0
94;24.04.2018;2018;04;01;Tiistai;0;0;0
94;24.04.2018;2018;04;02;Tiistai;0;0;0
94;24.04.2018;2018;04;03;Tiistai;0;0;0
94;24.04.2018;2018;04;04;Tiistai;0;0;0
94;24.04.2018;2018;04;05;Tiistai;5;2;7
94;24.04.2018;2018;04;06;Tiistai;12;1;13
94;24.04.2018;2018;04;07;Tiistai;21;2;23
94;24.04.2018;2018;04;08;Tiistai;7;2;9
94;24.04.2018;2018;04;09;Tiistai;3;0;3
94;24.04.2018;2018;04;10;Tiistai;3;1;4
94;24.04.2018;2018;04;11;Tiistai;2;1;3
94;24.04.2018;2018;04;12;Tiistai;2;0;2
94;24.04.2018;2018;04;13;Tiistai;0;3;3
94;24.04.2018;2018;04;14;Tiistai;2;8;10
94;24.04.2018;2018;04;15;Tiistai;0;17;17
94;24.04.2018;2018;04;16;Tiistai;2;11;13
94;24.04.2018;2018;04;17;Tiistai;1;13;14
94;24.04.2018;2018;04;18;Tiistai;1;1;2
94;24.04.2018;2018;04;19;Tiistai;0;4;4
94;24.04.2018;2018;04;20;Tiistai;3;2;5
94;24.04.2018;2018;04;21;Tiistai;1;2;3
94;24.04.2018;2018;04;22;Tiistai;0;0;0
94;24.04.2018;2018;04;23;Tiistai;0;0;0
94;25.04.2018;2018;04;00;Keskiviikko;0;0;0
94;25.04.2018;2018;04;01;Keskiviikko;0;0;0
94;25.04.2018;2018;04;02;Keskiviikko;0;0;0
94;25.04.2018;2018;04;03;Keskiviikko;0;0;0
94;25.04.2018;2018;04;04;Keskiviikko;0;0;0
94;25.04.2018;2018;04;05;Keskiviikko;5;2;7
94;25.04.2018;2018;04;06;Keskiviikko;7;1;8
94;25.04.2018;2018;04;07;Keskiviikko;14;2;16
94;25.04.2018;2018;04;08;Keskiviikko;6;0;6
94;25.04.2018;2018;04;09;Keskiviikko;5;2;7
94;25.04.2018;2018;04;10;Keskiviikko;3;2;5
94;25.04.2018;2018;04;11;Keskiviikko;1;6;7
94;25.04.2018;2018;04;12;Keskiviikko;2;1;3
94;25.04.2018;2018;04;13;Keskiviikko;4;1;5
94;25.04.2018;2018;04;14;Keskiviikko;3;9;12
94;25.04.2018;2018;04;15;Keskiviikko;5;11;16
94;25.04.2018;2018;04;16;Keskiviikko;6;22;28
94;25.04.2018;2018;04;17;Keskiviikko;5;7;12
94;25.04.2018;2018;04;18;Keskiviikko;6;10;16
94;25.04.2018;2018;04;19;Keskiviikko;9;10;19
94;25.04.2018;2018;04;20;Keskiviikko;4;2;6
94;25.04.2018;2018;04;21;Keskiviikko;2;4;6
94;25.04.2018;2018;04;22;Keskiviikko;0;1;1
94;25.04.2018;2018;04;23;Keskiviikko;0;0;0
94;26.04.2018;2018;04;00;Torstai;0;0;0
94;26.04.2018;2018;04;01;Torstai;0;0;0
94;26.04.2018;2018;04;02;Torstai;0;0;0
94;26.04.2018;2018;04;03;Torstai;0;0;0
94;26.04.2018;2018;04;04;Torstai;0;0;0
94;26.04.2018;2018;04;05;Torstai;6;2;8
94;26.04.2018;2018;04;06;Torstai;8;4;12
94;26.04.2018;2018;04;07;Torstai;16;5;21
94;26.04.2018;2018;04;08;Torstai;10;1;11
94;26.04.2018;2018;04;09;Torstai;2;0;2
94;26.04.2018;2018;04;10;Torstai;2;0;2
94;26.04.2018;2018;04;11;Torstai;2;4;6
94;26.04.2018;2018;04;12;Torstai;2;4;6
94;26.04.2018;2018;04;13;Torstai;4;3;7
94;26.04.2018;2018;04;14;Torstai;11;14;25
94;26.04.2018;2018;04;15;Torstai;9;14;23
94;26.04.2018;2018;04;16;Torstai;4;11;15
94;26.04.2018;2018;04;17;Torstai;3;19;22
94;26.04.2018;2018;04;18;Torstai;4;7;11
94;26.04.2018;2018;04;19;Torstai;5;2;7
94;26.04.2018;2018;04;20;Torstai;6;7;13
94;26.04.2018;2018;04;21;Torstai;1;4;5
94;26.04.2018;2018;04;22;Torstai;1;0;1
94;26.04.2018;2018;04;23;Torstai;0;0;0
94;27.04.2018;2018;04;00;Perjantai;0;0;0
94;27.04.2018;2018;04;01;Perjantai;0;0;0
94;27.04.2018;2018;04;02;Perjantai;0;0;0
94;27.04.2018;2018;04;03;Perjantai;0;0;0
94;27.04.2018;2018;04;04;Perjantai;1;0;1
94;27.04.2018;2018;04;05;Perjantai;7;2;9
94;27.04.2018;2018;04;06;Perjantai;6;1;7
94;27.04.2018;2018;04;07;Perjantai;14;4;18
94;27.04.2018;2018;04;08;Perjantai;5;0;5
94;27.04.2018;2018;04;09;Perjantai;4;1;5
94;27.04.2018;2018;04;10;Perjantai;4;1;5
94;27.04.2018;2018;04;11;Perjantai;7;1;8
94;27.04.2018;2018;04;12;Perjantai;3;4;7
94;27.04.2018;2018;04;13;Perjantai;4;10;14
94;27.04.2018;2018;04;14;Perjantai;5;16;21
94;27.04.2018;2018;04;15;Perjantai;9;14;23
94;27.04.2018;2018;04;16;Perjantai;4;11;15
94;27.04.2018;2018;04;17;Perjantai;6;8;14
94;27.04.2018;2018;04;18;Perjantai;8;3;11
94;27.04.2018;2018;04;19;Perjantai;1;8;9
94;27.04.2018;2018;04;20;Perjantai;4;8;12
94;27.04.2018;2018;04;21;Perjantai;0;4;4
94;27.04.2018;2018;04;22;Perjantai;1;1;2
94;27.04.2018;2018;04;23;Perjantai;2;1;3
94;28.04.2018;2018;04;00;Lauantai;0;1;1
94;28.04.2018;2018;04;01;Lauantai;0;0;0
94;28.04.2018;2018;04;02;Lauantai;0;0;0
94;28.04.2018;2018;04;03;Lauantai;0;0;0
94;28.04.2018;2018;04;04;Lauantai;0;0;0
94;28.04.2018;2018;04;05;Lauantai;1;1;2
94;28.04.2018;2018;04;06;Lauantai;1;0;1
94;28.04.2018;2018;04;07;Lauantai;2;2;4
94;28.04.2018;2018;04;08;Lauantai;4;1;5
94;28.04.2018;2018;04;09;Lauantai;6;6;12
94;28.04.2018;2018;04;10;Lauantai;3;8;11
94;28.04.2018;2018;04;11;Lauantai;6;6;12
94;28.04.2018;2018;04;12;Lauantai;10;6;16
94;28.04.2018;2018;04;13;Lauantai;8;7;15
94;28.04.2018;2018;04;14;Lauantai;7;10;17
94;28.04.2018;2018;04;15;Lauantai;7;7;14
94;28.04.2018;2018;04;16;Lauantai;5;8;13
94;28.04.2018;2018;04;17;Lauantai;18;5;23
94;28.04.2018;2018;04;18;Lauantai;11;4;15
94;28.04.2018;2018;04;19;Lauantai;3;5;8
94;28.04.2018;2018;04;20;Lauantai;4;4;8
94;28.04.2018;2018;04;21;Lauantai;2;1;3
94;28.04.2018;2018;04;22;Lauantai;0;1;1
94;28.04.2018;2018;04;23;Lauantai;0;3;3
94;29.04.2018;2018;04;00;Sunnuntai;2;6;8
94;29.04.2018;2018;04;01;Sunnuntai;0;1;1
94;29.04.2018;2018;04;02;Sunnuntai;0;0;0
94;29.04.2018;2018;04;03;Sunnuntai;0;0;0
94;29.04.2018;2018;04;04;Sunnuntai;0;0;0
94;29.04.2018;2018;04;05;Sunnuntai;0;0;0
94;29.04.2018;2018;04;06;Sunnuntai;1;0;1
94;29.04.2018;2018;04;07;Sunnuntai;0;0;0
94;29.04.2018;2018;04;08;Sunnuntai;3;1;4
94;29.04.2018;2018;04;09;Sunnuntai;1;1;2
94;29.04.2018;2018;04;10;Sunnuntai;4;6;10
94;29.04.2018;2018;04;11;Sunnuntai;3;6;9
94;29.04.2018;2018;04;12;Sunnuntai;11;8;19
94;29.04.2018;2018;04;13;Sunnuntai;14;19;33
94;29.04.2018;2018;04;14;Sunnuntai;13;6;19
94;29.04.2018;2018;04;15;Sunnuntai;9;9;18
94;29.04.2018;2018;04;16;Sunnuntai;8;8;16
94;29.04.2018;2018;04;17;Sunnuntai;13;6;19
94;29.04.2018;2018;04;18;Sunnuntai;5;9;14
94;29.04.2018;2018;04;19;Sunnuntai;13;3;16
94;29.04.2018;2018;04;20;Sunnuntai;4;3;7
94;29.04.2018;2018;04;21;Sunnuntai;1;3;4
94;29.04.2018;2018;04;22;Sunnuntai;0;2;2
94;29.04.2018;2018;04;23;Sunnuntai;2;1;3
94;30.04.2018;2018;04;00;Maanantai;0;0;0
94;30.04.2018;2018;04;01;Maanantai;0;0;0
94;30.04.2018;2018;04;02;Maanantai;0;0;0
94;30.04.2018;2018;04;03;Maanantai;0;0;0
94;30.04.2018;2018;04;04;Maanantai;0;0;0
94;30.04.2018;2018;04;05;Maanantai;2;0;2
94;30.04.2018;2018;04;06;Maanantai;6;2;8
94;30.04.2018;2018;04;07;Maanantai;6;4;10
94;30.04.2018;2018;04;08;Maanantai;10;0;10
94;30.04.2018;2018;04;09;Maanantai;2;4;6
94;30.04.2018;2018;04;10;Maanantai;3;1;4
94;30.04.2018;2018;04;11;Maanantai;4;5;9
94;30.04.2018;2018;04;12;Maanantai;9;5;14
94;30.04.2018;2018;04;13;Maanantai;7;5;12
94;30.04.2018;2018;04;14;Maanantai;7;12;19
94;30.04.2018;2018;04;15;Maanantai;4;13;17
94;30.04.2018;2018;04;16;Maanantai;5;13;18
94;30.04.2018;2018;04;17;Maanantai;4;8;12
94;30.04.2018;2018;04;18;Maanantai;3;12;15
94;30.04.2018;2018;04;19;Maanantai;2;2;4
94;30.04.2018;2018;04;20;Maanantai;0;0;0
94;30.04.2018;2018;04;21;Maanantai;2;7;9
94;30.04.2018;2018;04;22;Maanantai;0;1;1
94;30.04.2018;2018;04;23;Maanantai;1;0;1
94;01.05.2018;2018;05;00;Tiistai;0;0;0
94;01.05.2018;2018;05;01;Tiistai;0;0;0
94;01.05.2018;2018;05;02;Tiistai;0;0;0
94;01.05.2018;2018;05;03;Tiistai;0;0;0
94;01.05.2018;2018;05;04;Tiistai;0;0;0
94;01.05.2018;2018;05;05;Tiistai;0;0;0
94;01.05.2018;2018;05;06;Tiistai;3;2;5
94;01.05.2018;2018;05;07;Tiistai;0;0;0
94;01.05.2018;2018;05;08;Tiistai;1;3;4
94;01.05.2018;2018;05;09;Tiistai;8;5;13
94;01.05.2018;2018;05;10;Tiistai;4;3;7
94;01.05.2018;2018;05;11;Tiistai;20;19;39
94;01.05.2018;2018;05;12;Tiistai;15;29;44
94;01.05.2018;2018;05;13;Tiistai;15;15;30
94;01.05.2018;2018;05;14;Tiistai;15;18;33
94;01.05.2018;2018;05;15;Tiistai;12;2;14
94;01.05.2018;2018;05;16;Tiistai;8;9;17
94;01.05.2018;2018;05;17;Tiistai;2;5;7
94;01.05.2018;2018;05;18;Tiistai;6;3;9
94;01.05.2018;2018;05;19;Tiistai;7;9;16
94;01.05.2018;2018;05;20;Tiistai;5;4;9
94;01.05.2018;2018;05;21;Tiistai;4;4;8
94;01.05.2018;2018;05;22;Tiistai;0;1;1
94;01.05.2018;2018;05;23;Tiistai;0;0;0
94;02.05.2018;2018;05;00;Keskiviikko;0;1;1
94;02.05.2018;2018;05;01;Keskiviikko;0;0;0
94;02.05.2018;2018;05;02;Keskiviikko;0;0;0
94;02.05.2018;2018;05;03;Keskiviikko;0;0;0
94;02.05.2018;2018;05;04;Keskiviikko;1;0;1
94;02.05.2018;2018;05;05;Keskiviikko;6;5;11
94;02.05.2018;2018;05;06;Keskiviikko;10;3;13
94;02.05.2018;2018;05;07;Keskiviikko;12;0;12
94;02.05.2018;2018;05;08;Keskiviikko;9;2;11
94;02.05.2018;2018;05;09;Keskiviikko;4;5;9
94;02.05.2018;2018;05;10;Keskiviikko;0;1;1
94;02.05.2018;2018;05;11;Keskiviikko;0;0;0
94;02.05.2018;2018;05;12;Keskiviikko;5;0;5
94;02.05.2018;2018;05;13;Keskiviikko;1;7;8
94;02.05.2018;2018;05;14;Keskiviikko;4;4;8
94;02.05.2018;2018;05;15;Keskiviikko;7;7;14
94;02.05.2018;2018;05;16;Keskiviikko;0;13;13
94;02.05.2018;2018;05;17;Keskiviikko;2;7;9
94;02.05.2018;2018;05;18;Keskiviikko;1;24;25
94;02.05.2018;2018;05;19;Keskiviikko;2;1;3
94;02.05.2018;2018;05;20;Keskiviikko;1;5;6
94;02.05.2018;2018;05;21;Keskiviikko;3;2;5
94;02.05.2018;2018;05;22;Keskiviikko;0;1;1
94;02.05.2018;2018;05;23;Keskiviikko;1;0;1
94;03.05.2018;2018;05;00;Torstai;0;0;0
94;03.05.2018;2018;05;01;Torstai;0;0;0
94;03.05.2018;2018;05;02;Torstai;0;0;0
94;03.05.2018;2018;05;03;Torstai;0;0;0
94;03.05.2018;2018;05;04;Torstai;1;0;1
94;03.05.2018;2018;05;05;Torstai;8;3;11
94;03.05.2018;2018;05;06;Torstai;13;1;14
94;03.05.2018;2018;05;07;Torstai;22;2;24
94;03.05.2018;2018;05;08;Torstai;10;2;12
94;03.05.2018;2018;05;09;Torstai;8;3;11
94;03.05.2018;2018;05;10;Torstai;2;2;4
94;03.05.2018;2018;05;11;Torstai;3;1;4
94;03.05.2018;2018;05;12;Torstai;2;3;5
94;03.05.2018;2018;05;13;Torstai;2;4;6
94;03.05.2018;2018;05;14;Torstai;3;12;15
94;03.05.2018;2018;05;15;Torstai;7;11;18
94;03.05.2018;2018;05;16;Torstai;4;19;23
94;03.05.2018;2018;05;17;Torstai;3;15;18
94;03.05.2018;2018;05;18;Torstai;6;11;17
94;03.05.2018;2018;05;19;Torstai;6;8;14
94;03.05.2018;2018;05;20;Torstai;6;9;15
94;03.05.2018;2018;05;21;Torstai;1;4;5
94;03.05.2018;2018;05;22;Torstai;1;0;1
94;03.05.2018;2018;05;23;Torstai;0;0;0
94;04.05.2018;2018;05;00;Perjantai;0;1;1
94;04.05.2018;2018;05;01;Perjantai;0;0;0
94;04.05.2018;2018;05;02;Perjantai;0;0;0
94;04.05.2018;2018;05;03;Perjantai;0;0;0
94;04.05.2018;2018;05;04;Perjantai;1;0;1
94;04.05.2018;2018;05;05;Perjantai;5;2;7
94;04.05.2018;2018;05;06;Perjantai;12;1;13
94;04.05.2018;2018;05;07;Perjantai;6;0;6
94;04.05.2018;2018;05;08;Perjantai;9;1;10
94;04.05.2018;2018;05;09;Perjantai;2;1;3
94;04.05.2018;2018;05;10;Perjantai;1;0;1
94;04.05.2018;2018;05;11;Perjantai;0;1;1
94;04.05.2018;2018;05;12;Perjantai;1;1;2
94;04.05.2018;2018;05;13;Perjantai;1;1;2
94;04.05.2018;2018;05;14;Perjantai;2;11;13
94;04.05.2018;2018;05;15;Perjantai;1;6;7
94;04.05.2018;2018;05;16;Perjantai;2;10;12
94;04.05.2018;2018;05;17;Perjantai;2;1;3
94;04.05.2018;2018;05;18;Perjantai;4;5;9
94;04.05.2018;2018;05;19;Perjantai;1;1;2
94;04.05.2018;2018;05;20;Perjantai;0;3;3
94;04.05.2018;2018;05;21;Perjantai;0;1;1
94;04.05.2018;2018;05;22;Perjantai;1;0;1
94;04.05.2018;2018;05;23;Perjantai;0;2;2
94;05.05.2018;2018;05;00;Lauantai;0;0;0
94;05.05.2018;2018;05;01;Lauantai;0;0;0
94;05.05.2018;2018;05;02;Lauantai;0;0;0
94;05.05.2018;2018;05;03;Lauantai;0;0;0
94;05.05.2018;2018;05;04;Lauantai;0;0;0
94;05.05.2018;2018;05;05;Lauantai;1;0;1
94;05.05.2018;2018;05;06;Lauantai;1;1;2
94;05.05.2018;2018;05;07;Lauantai;4;1;5
94;05.05.2018;2018;05;08;Lauantai;1;1;2
94;05.05.2018;2018;05;09;Lauantai;4;1;5
94;05.05.2018;2018;05;10;Lauantai;8;13;21
94;05.05.2018;2018;05;11;Lauantai;8;16;24
94;05.05.2018;2018;05;12;Lauantai;13;9;22
94;05.05.2018;2018;05;13;Lauantai;10;12;22
94;05.05.2018;2018;05;14;Lauantai;9;9;18
94;05.05.2018;2018;05;15;Lauantai;15;9;24
94;05.05.2018;2018;05;16;Lauantai;13;6;19
94;05.05.2018;2018;05;17;Lauantai;2;3;5
94;05.05.2018;2018;05;18;Lauantai;8;7;15
94;05.05.2018;2018;05;19;Lauantai;8;6;14
94;05.05.2018;2018;05;20;Lauantai;8;11;19
94;05.05.2018;2018;05;21;Lauantai;1;6;7
94;05.05.2018;2018;05;22;Lauantai;0;2;2
94;05.05.2018;2018;05;23;Lauantai;0;1;1
94;06.05.2018;2018;05;00;Sunnuntai;0;2;2
94;06.05.2018;2018;05;01;Sunnuntai;0;0;0
94;06.05.2018;2018;05;02;Sunnuntai;0;0;0
94;06.05.2018;2018;05;03;Sunnuntai;0;0;0
94;06.05.2018;2018;05;04;Sunnuntai;0;0;0
94;06.05.2018;2018;05;05;Sunnuntai;2;1;3
94;06.05.2018;2018;05;06;Sunnuntai;0;1;1
94;06.05.2018;2018;05;07;Sunnuntai;1;0;1
94;06.05.2018;2018;05;08;Sunnuntai;1;10;11
94;06.05.2018;2018;05;09;Sunnuntai;10;11;21
94;06.05.2018;2018;05;10;Sunnuntai;17;9;26
94;06.05.2018;2018;05;11;Sunnuntai;15;10;25
94;06.05.2018;2018;05;12;Sunnuntai;15;26;41
94;06.05.2018;2018;05;13;Sunnuntai;13;18;31
94;06.05.2018;2018;05;14;Sunnuntai;9;10;19
94;06.05.2018;2018;05;15;Sunnuntai;7;8;15
94;06.05.2018;2018;05;16;Sunnuntai;14;11;25
94;06.05.2018;2018;05;17;Sunnuntai;9;10;19
94;06.05.2018;2018;05;18;Sunnuntai;8;14;22
94;06.05.2018;2018;05;19;Sunnuntai;4;3;7
94;06.05.2018;2018;05;20;Sunnuntai;7;6;13
94;06.05.2018;2018;05;21;Sunnuntai;3;2;5
94;06.05.2018;2018;05;22;Sunnuntai;0;1;1
94;06.05.2018;2018;05;23;Sunnuntai;0;0;0
94;07.05.2018;2018;05;00;Maanantai;0;0;0
94;07.05.2018;2018;05;01;Maanantai;0;0;0
94;07.05.2018;2018;05;02;Maanantai;0;0;0
94;07.05.2018;2018;05;03;Maanantai;0;0;0
94;07.05.2018;2018;05;04;Maanantai;2;0;2
94;07.05.2018;2018;05;05;Maanantai;8;3;11
94;07.05.2018;2018;05;06;Maanantai;12;1;13
94;07.05.2018;2018;05;07;Maanantai;22;3;25
94;07.05.2018;2018;05;08;Maanantai;19;1;20
94;07.05.2018;2018;05;09;Maanantai;3;0;3
94;07.05.2018;2018;05;10;Maanantai;4;0;4
94;07.05.2018;2018;05;11;Maanantai;5;7;12
94;07.05.2018;2018;05;12;Maanantai;5;4;9
94;07.05.2018;2018;05;13;Maanantai;5;3;8
94;07.05.2018;2018;05;14;Maanantai;3;3;6
94;07.05.2018;2018;05;15;Maanantai;1;27;28
94;07.05.2018;2018;05;16;Maanantai;1;22;23
94;07.05.2018;2018;05;17;Maanantai;0;10;10
94;07.05.2018;2018;05;18;Maanantai;1;4;5
94;07.05.2018;2018;05;19;Maanantai;4;7;11
94;07.05.2018;2018;05;20;Maanantai;4;5;9
94;07.05.2018;2018;05;21;Maanantai;0;5;5
94;07.05.2018;2018;05;22;Maanantai;1;3;4
94;07.05.2018;2018;05;23;Maanantai;0;0;0
94;08.05.2018;2018;05;00;Tiistai;0;0;0
94;08.05.2018;2018;05;01;Tiistai;0;0;0
94;08.05.2018;2018;05;02;Tiistai;0;0;0
94;08.05.2018;2018;05;03;Tiistai;0;0;0
94;08.05.2018;2018;05;04;Tiistai;1;0;1
94;08.05.2018;2018;05;05;Tiistai;10;3;13
94;08.05.2018;2018;05;06;Tiistai;17;2;19
94;08.05.2018;2018;05;07;Tiistai;30;7;37
94;08.05.2018;2018;05;08;Tiistai;18;2;20
94;08.05.2018;2018;05;09;Tiistai;8;5;13
94;08.05.2018;2018;05;10;Tiistai;5;2;7
94;08.05.2018;2018;05;11;Tiistai;3;5;8
94;08.05.2018;2018;05;12;Tiistai;7;5;12
94;08.05.2018;2018;05;13;Tiistai;8;8;16
94;08.05.2018;2018;05;14;Tiistai;9;15;24
94;08.05.2018;2018;05;15;Tiistai;10;23;33
94;08.05.2018;2018;05;16;Tiistai;8;35;43
94;08.05.2018;2018;05;17;Tiistai;3;17;20
94;08.05.2018;2018;05;18;Tiistai;7;15;22
94;08.05.2018;2018;05;19;Tiistai;12;11;23
94;08.05.2018;2018;05;20;Tiistai;7;10;17
94;08.05.2018;2018;05;21;Tiistai;1;5;6
94;08.05.2018;2018;05;22;Tiistai;0;4;4
94;08.05.2018;2018;05;23;Tiistai;0;0;0
94;09.05.2018;2018;05;00;Keskiviikko;0;0;0
94;09.05.2018;2018;05;01;Keskiviikko;1;0;1
94;09.05.2018;2018;05;02;Keskiviikko;0;0;0
94;09.05.2018;2018;05;03;Keskiviikko;1;0;1
94;09.05.2018;2018;05;04;Keskiviikko;1;0;1
94;09.05.2018;2018;05;05;Keskiviikko;6;1;7
94;09.05.2018;2018;05;06;Keskiviikko;24;4;28
94;09.05.2018;2018;05;07;Keskiviikko;33;2;35
94;09.05.2018;2018;05;08;Keskiviikko;17;2;19
94;09.05.2018;2018;05;09;Keskiviikko;6;6;12
94;09.05.2018;2018;05;10;Keskiviikko;5;3;8
94;09.05.2018;2018;05;11;Keskiviikko;8;16;24
94;09.05.2018;2018;05;12;Keskiviikko;9;3;12
94;09.05.2018;2018;05;13;Keskiviikko;7;5;12
94;09.05.2018;2018;05;14;Keskiviikko;7;9;16
94;09.05.2018;2018;05;15;Keskiviikko;12;19;31
94;09.05.2018;2018;05;16;Keskiviikko;12;41;53
94;09.05.2018;2018;05;17;Keskiviikko;4;37;41
94;09.05.2018;2018;05;18;Keskiviikko;6;23;29
94;09.05.2018;2018;05;19;Keskiviikko;18;11;29
94;09.05.2018;2018;05;20;Keskiviikko;6;9;15
94;09.05.2018;2018;05;21;Keskiviikko;3;5;8
94;09.05.2018;2018;05;22;Keskiviikko;1;3;4
94;09.05.2018;2018;05;23;Keskiviikko;3;1;4
94;10.05.2018;2018;05;00;Torstai;1;1;2
94;10.05.2018;2018;05;01;Torstai;0;0;0
94;10.05.2018;2018;05;02;Torstai;0;0;0
94;10.05.2018;2018;05;03;Torstai;1;0;1
94;10.05.2018;2018;05;04;Torstai;0;0;0
94;10.05.2018;2018;05;05;Torstai;0;0;0
94;10.05.2018;2018;05;06;Torstai;6;0;6
94;10.05.2018;2018;05;07;Torstai;6;0;6
94;10.05.2018;2018;05;08;Torstai;4;9;13
94;10.05.2018;2018;05;09;Torstai;7;3;10
94;10.05.2018;2018;05;10;Torstai;14;8;22
94;10.05.2018;2018;05;11;Torstai;14;12;26
94;10.05.2018;2018;05;12;Torstai;19;26;45
94;10.05.2018;2018;05;13;Torstai;26;23;49
94;10.05.2018;2018;05;14;Torstai;15;24;39
94;10.05.2018;2018;05;15;Torstai;17;16;33
94;10.05.2018;2018;05;16;Torstai;24;23;47
94;10.05.2018;2018;05;17;Torstai;18;31;49
94;10.05.2018;2018;05;18;Torstai;19;10;29
94;10.05.2018;2018;05;19;Torstai;10;14;24
94;10.05.2018;2018;05;20;Torstai;12;6;18
94;10.05.2018;2018;05;21;Torstai;7;7;14
94;10.05.2018;2018;05;22;Torstai;5;3;8
94;10.05.2018;2018;05;23;Torstai;1;4;5
94;11.05.2018;2018;05;00;Perjantai;1;0;1
94;11.05.2018;2018;05;01;Perjantai;0;1;1
94;11.05.2018;2018;05;02;Perjantai;2;1;3
94;11.05.2018;2018;05;03;Perjantai;0;0;0
94;11.05.2018;2018;05;04;Perjantai;2;2;4
94;11.05.2018;2018;05;05;Perjantai;5;0;5
94;11.05.2018;2018;05;06;Perjantai;12;4;16
94;11.05.2018;2018;05;07;Perjantai;22;3;25
94;11.05.2018;2018;05;08;Perjantai;12;1;13
94;11.05.2018;2018;05;09;Perjantai;5;1;6
94;11.05.2018;2018;05;10;Perjantai;6;7;13
94;11.05.2018;2018;05;11;Perjantai;7;8;15
94;11.05.2018;2018;05;12;Perjantai;12;11;23
94;11.05.2018;2018;05;13;Perjantai;11;17;28
94;11.05.2018;2018;05;14;Perjantai;7;15;22
94;11.05.2018;2018;05;15;Perjantai;12;16;28
94;11.05.2018;2018;05;16;Perjantai;16;9;25
94;11.05.2018;2018;05;17;Perjantai;12;21;33
94;11.05.2018;2018;05;18;Perjantai;20;20;40
94;11.05.2018;2018;05;19;Perjantai;10;9;19
94;11.05.2018;2018;05;20;Perjantai;10;17;27
94;11.05.2018;2018;05;21;Perjantai;5;10;15
94;11.05.2018;2018;05;22;Perjantai;6;9;15
94;11.05.2018;2018;05;23;Perjantai;4;3;7
94;12.05.2018;2018;05;00;Lauantai;2;3;5
94;12.05.2018;2018;05;01;Lauantai;6;0;6
94;12.05.2018;2018;05;02;Lauantai;0;0;0
94;12.05.2018;2018;05;03;Lauantai;0;0;0
94;12.05.2018;2018;05;04;Lauantai;0;1;1
94;12.05.2018;2018;05;05;Lauantai;0;2;2
94;12.05.2018;2018;05;06;Lauantai;2;0;2
94;12.05.2018;2018;05;07;Lauantai;2;2;4
94;12.05.2018;2018;05;08;Lauantai;4;3;7
94;12.05.2018;2018;05;09;Lauantai;3;5;8
94;12.05.2018;2018;05;10;Lauantai;13;11;24
94;12.05.2018;2018;05;11;Lauantai;10;19;29
94;12.05.2018;2018;05;12;Lauantai;14;16;30
94;12.05.2018;2018;05;13;Lauantai;22;19;41
94;12.05.2018;2018;05;14;Lauantai;12;24;36
94;12.05.2018;2018;05;15;Lauantai;22;21;43
94;12.05.2018;2018;05;16;Lauantai;21;22;43
94;12.05.2018;2018;05;17;Lauantai;18;9;27
94;12.05.2018;2018;05;18;Lauantai;23;19;42
94;12.05.2018;2018;05;19;Lauantai;6;8;14
94;12.05.2018;2018;05;20;Lauantai;5;4;9
94;12.05.2018;2018;05;21;Lauantai;5;3;8
94;12.05.2018;2018;05;22;Lauantai;2;2;4
94;12.05.2018;2018;05;23;Lauantai;1;3;4
94;13.05.2018;2018;05;00;Sunnuntai;0;9;9
94;13.05.2018;2018;05;01;Sunnuntai;0;0;0
94;13.05.2018;2018;05;02;Sunnuntai;0;0;0
94;13.05.2018;2018;05;03;Sunnuntai;0;2;2
94;13.05.2018;2018;05;04;Sunnuntai;0;0;0
94;13.05.2018;2018;05;05;Sunnuntai;0;1;1
94;13.05.2018;2018;05;06;Sunnuntai;2;0;2
94;13.05.2018;2018;05;07;Sunnuntai;1;1;2
94;13.05.2018;2018;05;08;Sunnuntai;2;0;2
94;13.05.2018;2018;05;09;Sunnuntai;4;4;8
94;13.05.2018;2018;05;10;Sunnuntai;7;9;16
94;13.05.2018;2018;05;11;Sunnuntai;22;16;38
94;13.05.2018;2018;05;12;Sunnuntai;17;11;28
94;13.05.2018;2018;05;13;Sunnuntai;13;25;38
94;13.05.2018;2018;05;14;Sunnuntai;13;19;32
94;13.05.2018;2018;05;15;Sunnuntai;21;15;36
94;13.05.2018;2018;05;16;Sunnuntai;9;15;24
94;13.05.2018;2018;05;17;Sunnuntai;9;12;21
94;13.05.2018;2018;05;18;Sunnuntai;24;11;35
94;13.05.2018;2018;05;19;Sunnuntai;15;16;31
94;13.05.2018;2018;05;20;Sunnuntai;5;7;12
94;13.05.2018;2018;05;21;Sunnuntai;7;4;11
94;13.05.2018;2018;05;22;Sunnuntai;2;0;2
94;13.05.2018;2018;05;23;Sunnuntai;0;1;1
94;14.05.2018;2018;05;00;Maanantai;1;1;2
94;14.05.2018;2018;05;01;Maanantai;0;0;0
94;14.05.2018;2018;05;02;Maanantai;0;0;0
94;14.05.2018;2018;05;03;Maanantai;0;0;0
94;14.05.2018;2018;05;04;Maanantai;3;0;3
94;14.05.2018;2018;05;05;Maanantai;12;2;14
94;14.05.2018;2018;05;06;Maanantai;23;4;27
94;14.05.2018;2018;05;07;Maanantai;37;5;42
94;14.05.2018;2018;05;08;Maanantai;25;6;31
94;14.05.2018;2018;05;09;Maanantai;9;5;14
94;14.05.2018;2018;05;10;Maanantai;8;3;11
94;14.05.2018;2018;05;11;Maanantai;3;6;9
94;14.05.2018;2018;05;12;Maanantai;10;10;20
94;14.05.2018;2018;05;13;Maanantai;10;7;17
94;14.05.2018;2018;05;14;Maanantai;6;20;26
94;14.05.2018;2018;05;15;Maanantai;18;31;49
94;14.05.2018;2018;05;16;Maanantai;12;38;50
94;14.05.2018;2018;05;17;Maanantai;14;33;47
94;14.05.2018;2018;05;18;Maanantai;14;31;45
94;14.05.2018;2018;05;19;Maanantai;18;11;29
94;14.05.2018;2018;05;20;Maanantai;7;13;20
94;14.05.2018;2018;05;21;Maanantai;0;8;8
94;14.05.2018;2018;05;22;Maanantai;2;4;6
94;14.05.2018;2018;05;23;Maanantai;1;2;3
94;15.05.2018;2018;05;00;Tiistai;0;3;3
94;15.05.2018;2018;05;01;Tiistai;0;0;0
94;15.05.2018;2018;05;02;Tiistai;0;0;0
94;15.05.2018;2018;05;03;Tiistai;0;0;0
94;15.05.2018;2018;05;04;Tiistai;1;0;1
94;15.05.2018;2018;05;05;Tiistai;14;2;16
94;15.05.2018;2018;05;06;Tiistai;32;4;36
94;15.05.2018;2018;05;07;Tiistai;42;5;47
94;15.05.2018;2018;05;08;Tiistai;23;3;26
94;15.05.2018;2018;05;09;Tiistai;7;0;7
94;15.05.2018;2018;05;10;Tiistai;8;5;13
94;15.05.2018;2018;05;11;Tiistai;13;7;20
94;15.05.2018;2018;05;12;Tiistai;8;7;15
94;15.05.2018;2018;05;13;Tiistai;6;10;16
94;15.05.2018;2018;05;14;Tiistai;9;19;28
94;15.05.2018;2018;05;15;Tiistai;10;31;41
94;15.05.2018;2018;05;16;Tiistai;19;38;57
94;15.05.2018;2018;05;17;Tiistai;13;25;38
94;15.05.2018;2018;05;18;Tiistai;10;36;46
94;15.05.2018;2018;05;19;Tiistai;13;9;22
94;15.05.2018;2018;05;20;Tiistai;16;10;26
94;15.05.2018;2018;05;21;Tiistai;8;15;23
94;15.05.2018;2018;05;22;Tiistai;2;4;6
94;15.05.2018;2018;05;23;Tiistai;0;0;0
94;16.05.2018;2018;05;00;Keskiviikko;0;0;0
94;16.05.2018;2018;05;01;Keskiviikko;0;0;0
94;16.05.2018;2018;05;02;Keskiviikko;2;6;8
94;16.05.2018;2018;05;03;Keskiviikko;8;1;9
94;16.05.2018;2018;05;04;Keskiviikko;1;0;1
94;16.05.2018;2018;05;05;Keskiviikko;10;3;13
94;16.05.2018;2018;05;06;Keskiviikko;33;5;38
94;16.05.2018;2018;05;07;Keskiviikko;45;3;48
94;16.05.2018;2018;05;08;Keskiviikko;65;5;70
94;16.05.2018;2018;05;09;Keskiviikko;11;9;20
94;16.05.2018;2018;05;10;Keskiviikko;6;7;13
94;16.05.2018;2018;05;11;Keskiviikko;8;14;22
94;16.05.2018;2018;05;12;Keskiviikko;13;5;18
94;16.05.2018;2018;05;13;Keskiviikko;13;51;64
94;16.05.2018;2018;05;14;Keskiviikko;10;23;33
94;16.05.2018;2018;05;15;Keskiviikko;17;57;74
94;16.05.2018;2018;05;16;Keskiviikko;10;40;50
94;16.05.2018;2018;05;17;Keskiviikko;14;29;43
94;16.05.2018;2018;05;18;Keskiviikko;17;20;37
94;16.05.2018;2018;05;19;Keskiviikko;15;19;34
94;16.05.2018;2018;05;20;Keskiviikko;16;12;28
94;16.05.2018;2018;05;21;Keskiviikko;5;12;17
94;16.05.2018;2018;05;22;Keskiviikko;1;7;8
94;16.05.2018;2018;05;23;Keskiviikko;0;1;1
94;17.05.2018;2018;05;00;Torstai;0;0;0
94;17.05.2018;2018;05;01;Torstai;0;0;0
94;17.05.2018;2018;05;02;Torstai;0;0;0
94;17.05.2018;2018;05;03;Torstai;1;0;1
94;17.05.2018;2018;05;04;Torstai;2;0;2
94;17.05.2018;2018;05;05;Torstai;9;2;11
94;17.05.2018;2018;05;06;Torstai;25;6;31
94;17.05.2018;2018;05;07;Torstai;37;6;43
94;17.05.2018;2018;05;08;Torstai;43;2;45
94;17.05.2018;2018;05;09;Torstai;5;8;13
94;17.05.2018;2018;05;10;Torstai;7;20;27
94;17.05.2018;2018;05;11;Torstai;6;3;9
94;17.05.2018;2018;05;12;Torstai;10;10;20
94;17.05.2018;2018;05;13;Torstai;4;8;12
94;17.05.2018;2018;05;14;Torstai;6;13;19
94;17.05.2018;2018;05;15;Torstai;9;29;38
94;17.05.2018;2018;05;16;Torstai;8;43;51
94;17.05.2018;2018;05;17;Torstai;6;18;24
94;17.05.2018;2018;05;18;Torstai;9;16;25
94;17.05.2018;2018;05;19;Torstai;3;10;13
94;17.05.2018;2018;05;20;Torstai;4;6;10
94;17.05.2018;2018;05;21;Torstai;1;8;9
94;17.05.2018;2018;05;22;Torstai;1;3;4
94;17.05.2018;2018;05;23;Torstai;0;1;1
94;18.05.2018;2018;05;00;Perjantai;0;1;1
94;18.05.2018;2018;05;01;Perjantai;0;0;0
94;18.05.2018;2018;05;02;Perjantai;0;0;0
94;18.05.2018;2018;05;03;Perjantai;0;2;2
94;18.05.2018;2018;05;04;Perjantai;1;0;1
94;18.05.2018;2018;05;05;Perjantai;5;1;6
94;18.05.2018;2018;05;06;Perjantai;18;3;21
94;18.05.2018;2018;05;07;Perjantai;21;3;24
94;18.05.2018;2018;05;08;Perjantai;17;0;17
94;18.05.2018;2018;05;09;Perjantai;3;4;7
94;18.05.2018;2018;05;10;Perjantai;3;2;5
94;18.05.2018;2018;05;11;Perjantai;4;4;8
94;18.05.2018;2018;05;12;Perjantai;6;2;8
94;18.05.2018;2018;05;13;Perjantai;8;13;21
94;18.05.2018;2018;05;14;Perjantai;5;19;24
94;18.05.2018;2018;05;15;Perjantai;10;30;40
94;18.05.2018;2018;05;16;Perjantai;3;23;26
94;18.05.2018;2018;05;17;Perjantai;4;13;17
94;18.05.2018;2018;05;18;Perjantai;9;10;19
94;18.05.2018;2018;05;19;Perjantai;1;2;3
94;18.05.2018;2018;05;20;Perjantai;4;4;8
94;18.05.2018;2018;05;21;Perjantai;3;5;8
94;18.05.2018;2018;05;22;Perjantai;1;5;6
94;18.05.2018;2018;05;23;Perjantai;2;2;4
94;19.05.2018;2018;05;00;Lauantai;0;1;1
94;19.05.2018;2018;05;01;Lauantai;0;0;0
94;19.05.2018;2018;05;02;Lauantai;0;0;0
94;19.05.2018;2018;05;03;Lauantai;0;0;0
94;19.05.2018;2018;05;04;Lauantai;0;0;0
94;19.05.2018;2018;05;05;Lauantai;2;1;3
94;19.05.2018;2018;05;06;Lauantai;3;0;3
94;19.05.2018;2018;05;07;Lauantai;3;2;5
94;19.05.2018;2018;05;08;Lauantai;4;2;6
94;19.05.2018;2018;05;09;Lauantai;12;6;18
94;19.05.2018;2018;05;10;Lauantai;7;2;9
94;19.05.2018;2018;05;11;Lauantai;7;10;17
94;19.05.2018;2018;05;12;Lauantai;19;10;29
94;19.05.2018;2018;05;13;Lauantai;10;6;16
94;19.05.2018;2018;05;14;Lauantai;12;6;18
94;19.05.2018;2018;05;15;Lauantai;12;16;28
94;19.05.2018;2018;05;16;Lauantai;19;25;44
94;19.05.2018;2018;05;17;Lauantai;11;21;32
94;19.05.2018;2018;05;18;Lauantai;19;15;34
94;19.05.2018;2018;05;19;Lauantai;6;8;14
94;19.05.2018;2018;05;20;Lauantai;1;14;15
94;19.05.2018;2018;05;21;Lauantai;9;4;13
94;19.05.2018;2018;05;22;Lauantai;4;2;6
94;19.05.2018;2018;05;23;Lauantai;1;3;4
94;20.05.2018;2018;05;00;Sunnuntai;0;2;2
94;20.05.2018;2018;05;01;Sunnuntai;0;1;1
94;20.05.2018;2018;05;02;Sunnuntai;0;1;1
94;20.05.2018;2018;05;03;Sunnuntai;0;1;1
94;20.05.2018;2018;05;04;Sunnuntai;0;0;0
94;20.05.2018;2018;05;05;Sunnuntai;2;0;2
94;20.05.2018;2018;05;06;Sunnuntai;1;0;1
94;20.05.2018;2018;05;07;Sunnuntai;3;4;7
94;20.05.2018;2018;05;08;Sunnuntai;5;5;10
94;20.05.2018;2018;05;09;Sunnuntai;3;4;7
94;20.05.2018;2018;05;10;Sunnuntai;12;12;24
94;20.05.2018;2018;05;11;Sunnuntai;11;11;22
94;20.05.2018;2018;05;12;Sunnuntai;17;9;26
94;20.05.2018;2018;05;13;Sunnuntai;15;12;27
94;20.05.2018;2018;05;14;Sunnuntai;12;10;22
94;20.05.2018;2018;05;15;Sunnuntai;11;9;20
94;20.05.2018;2018;05;16;Sunnuntai;12;19;31
94;20.05.2018;2018;05;17;Sunnuntai;15;4;19
94;20.05.2018;2018;05;18;Sunnuntai;7;7;14
94;20.05.2018;2018;05;19;Sunnuntai;6;9;15
94;20.05.2018;2018;05;20;Sunnuntai;6;2;8
94;20.05.2018;2018;05;21;Sunnuntai;3;5;8
94;20.05.2018;2018;05;22;Sunnuntai;0;2;2
94;20.05.2018;2018;05;23;Sunnuntai;0;0;0
94;21.05.2018;2018;05;00;Maanantai;0;0;0
94;21.05.2018;2018;05;01;Maanantai;0;0;0
94;21.05.2018;2018;05;02;Maanantai;0;0;0
94;21.05.2018;2018;05;03;Maanantai;0;0;0
94;21.05.2018;2018;05;04;Maanantai;1;0;1
94;21.05.2018;2018;05;05;Maanantai;7;3;10
94;21.05.2018;2018;05;06;Maanantai;28;5;33
94;21.05.2018;2018;05;07;Maanantai;33;5;38
94;21.05.2018;2018;05;08;Maanantai;18;7;25
94;21.05.2018;2018;05;09;Maanantai;7;2;9
94;21.05.2018;2018;05;10;Maanantai;7;7;14
94;21.05.2018;2018;05;11;Maanantai;6;8;14
94;21.05.2018;2018;05;12;Maanantai;9;6;15
94;21.05.2018;2018;05;13;Maanantai;8;8;16
94;21.05.2018;2018;05;14;Maanantai;11;14;25
94;21.05.2018;2018;05;15;Maanantai;11;29;40
94;21.05.2018;2018;05;16;Maanantai;8;37;45
94;21.05.2018;2018;05;17;Maanantai;12;23;35
94;21.05.2018;2018;05;18;Maanantai;9;14;23
94;21.05.2018;2018;05;19;Maanantai;12;12;24
94;21.05.2018;2018;05;20;Maanantai;11;11;22
94;21.05.2018;2018;05;21;Maanantai;3;8;11
94;21.05.2018;2018;05;22;Maanantai;0;4;4
94;21.05.2018;2018;05;23;Maanantai;0;3;3
94;22.05.2018;2018;05;00;Tiistai;0;0;0
94;22.05.2018;2018;05;01;Tiistai;0;0;0
94;22.05.2018;2018;05;02;Tiistai;0;1;1
94;22.05.2018;2018;05;03;Tiistai;0;0;0
94;22.05.2018;2018;05;04;Tiistai;1;0;1
94;22.05.2018;2018;05;05;Tiistai;10;4;14
94;22.05.2018;2018;05;06;Tiistai;32;3;35
94;22.05.2018;2018;05;07;Tiistai;35;5;40
94;22.05.2018;2018;05;08;Tiistai;20;7;27
94;22.05.2018;2018;05;09;Tiistai;11;3;14
94;22.05.2018;2018;05;10;Tiistai;6;10;16
94;22.05.2018;2018;05;11;Tiistai;8;7;15
94;22.05.2018;2018;05;12;Tiistai;12;5;17
94;22.05.2018;2018;05;13;Tiistai;7;12;19
94;22.05.2018;2018;05;14;Tiistai;7;17;24
94;22.05.2018;2018;05;15;Tiistai;12;43;55
94;22.05.2018;2018;05;16;Tiistai;16;41;57
94;22.05.2018;2018;05;17;Tiistai;11;23;34
94;22.05.2018;2018;05;18;Tiistai;7;21;28
94;22.05.2018;2018;05;19;Tiistai;17;11;28
94;22.05.2018;2018;05;20;Tiistai;11;8;19
94;22.05.2018;2018;05;21;Tiistai;5;6;11
94;22.05.2018;2018;05;22;Tiistai;2;7;9
94;22.05.2018;2018;05;23;Tiistai;0;1;1
94;23.05.2018;2018;05;00;Keskiviikko;0;0;0
94;23.05.2018;2018;05;01;Keskiviikko;0;0;0
94;23.05.2018;2018;05;02;Keskiviikko;0;0;0
94;23.05.2018;2018;05;03;Keskiviikko;0;1;1
94;23.05.2018;2018;05;04;Keskiviikko;1;0;1
94;23.05.2018;2018;05;05;Keskiviikko;10;3;13
94;23.05.2018;2018;05;06;Keskiviikko;20;5;25
94;23.05.2018;2018;05;07;Keskiviikko;38;2;40
94;23.05.2018;2018;05;08;Keskiviikko;23;4;27
94;23.05.2018;2018;05;09;Keskiviikko;9;2;11
94;23.05.2018;2018;05;10;Keskiviikko;3;3;6
94;23.05.2018;2018;05;11;Keskiviikko;4;3;7
94;23.05.2018;2018;05;12;Keskiviikko;5;6;11
94;23.05.2018;2018;05;13;Keskiviikko;7;8;15
94;23.05.2018;2018;05;14;Keskiviikko;12;20;32
94;23.05.2018;2018;05;15;Keskiviikko;17;24;41
94;23.05.2018;2018;05;16;Keskiviikko;7;34;41
94;23.05.2018;2018;05;17;Keskiviikko;5;19;24
94;23.05.2018;2018;05;18;Keskiviikko;4;14;18
94;23.05.2018;2018;05;19;Keskiviikko;4;5;9
94;23.05.2018;2018;05;20;Keskiviikko;3;8;11
94;23.05.2018;2018;05;21;Keskiviikko;1;4;5
94;23.05.2018;2018;05;22;Keskiviikko;2;4;6
94;23.05.2018;2018;05;23;Keskiviikko;1;1;2
94;24.05.2018;2018;05;00;Torstai;0;0;0
94;24.05.2018;2018;05;01;Torstai;1;0;1
94;24.05.2018;2018;05;02;Torstai;0;0;0
94;24.05.2018;2018;05;03;Torstai;0;1;1
94;24.05.2018;2018;05;04;Torstai;2;1;3
94;24.05.2018;2018;05;05;Torstai;7;2;9
94;24.05.2018;2018;05;06;Torstai;15;3;18
94;24.05.2018;2018;05;07;Torstai;29;5;34
94;24.05.2018;2018;05;08;Torstai;18;6;24
94;24.05.2018;2018;05;09;Torstai;9;3;12
94;24.05.2018;2018;05;10;Torstai;6;5;11
94;24.05.2018;2018;05;11;Torstai;3;0;3
94;24.05.2018;2018;05;12;Torstai;11;6;17
94;24.05.2018;2018;05;13;Torstai;7;9;16
94;24.05.2018;2018;05;14;Torstai;6;16;22
94;24.05.2018;2018;05;15;Torstai;9;24;33
94;24.05.2018;2018;05;16;Torstai;7;31;38
94;24.05.2018;2018;05;17;Torstai;7;18;25
94;24.05.2018;2018;05;18;Torstai;7;5;12
94;24.05.2018;2018;05;19;Torstai;13;20;33
94;24.05.2018;2018;05;20;Torstai;10;9;19
94;24.05.2018;2018;05;21;Torstai;5;6;11
94;24.05.2018;2018;05;22;Torstai;2;4;6
94;24.05.2018;2018;05;23;Torstai;0;0;0
94;25.05.2018;2018;05;00;Perjantai;0;0;0
94;25.05.2018;2018;05;01;Perjantai;0;0;0
94;25.05.2018;2018;05;02;Perjantai;0;0;0
94;25.05.2018;2018;05;03;Perjantai;0;2;2
94;25.05.2018;2018;05;04;Perjantai;1;0;1
94;25.05.2018;2018;05;05;Perjantai;11;1;12
94;25.05.2018;2018;05;06;Perjantai;23;1;24
94;25.05.2018;2018;05;07;Perjantai;31;6;37
94;25.05.2018;2018;05;08;Perjantai;18;4;22
94;25.05.2018;2018;05;09;Perjantai;8;4;12
94;25.05.2018;2018;05;10;Perjantai;4;2;6
94;25.05.2018;2018;05;11;Perjantai;9;6;15
94;25.05.2018;2018;05;12;Perjantai;9;14;23
94;25.05.2018;2018;05;13;Perjantai;5;6;11
94;25.05.2018;2018;05;14;Perjantai;7;19;26
94;25.05.2018;2018;05;15;Perjantai;3;32;35
94;25.05.2018;2018;05;16;Perjantai;10;27;37
94;25.05.2018;2018;05;17;Perjantai;16;15;31
94;25.05.2018;2018;05;18;Perjantai;10;13;23
94;25.05.2018;2018;05;19;Perjantai;7;12;19
94;25.05.2018;2018;05;20;Perjantai;3;8;11
94;25.05.2018;2018;05;21;Perjantai;4;3;7
94;25.05.2018;2018;05;22;Perjantai;2;5;7
94;25.05.2018;2018;05;23;Perjantai;0;2;2
94;26.05.2018;2018;05;00;Lauantai;2;1;3
94;26.05.2018;2018;05;01;Lauantai;1;0;1
94;26.05.2018;2018;05;02;Lauantai;0;1;1
94;26.05.2018;2018;05;03;Lauantai;0;0;0
94;26.05.2018;2018;05;04;Lauantai;0;2;2
94;26.05.2018;2018;05;05;Lauantai;3;2;5
94;26.05.2018;2018;05;06;Lauantai;3;0;3
94;26.05.2018;2018;05;07;Lauantai;0;2;2
94;26.05.2018;2018;05;08;Lauantai;3;2;5
94;26.05.2018;2018;05;09;Lauantai;5;4;9
94;26.05.2018;2018;05;10;Lauantai;9;3;12
94;26.05.2018;2018;05;11;Lauantai;14;14;28
94;26.05.2018;2018;05;12;Lauantai;10;6;16
94;26.05.2018;2018;05;13;Lauantai;11;9;20
94;26.05.2018;2018;05;14;Lauantai;9;7;16
94;26.05.2018;2018;05;15;Lauantai;6;12;18
94;26.05.2018;2018;05;16;Lauantai;12;11;23
94;26.05.2018;2018;05;17;Lauantai;8;12;20
94;26.05.2018;2018;05;18;Lauantai;5;11;16
94;26.05.2018;2018;05;19;Lauantai;8;6;14
94;26.05.2018;2018;05;20;Lauantai;3;1;4
94;26.05.2018;2018;05;21;Lauantai;3;3;6
94;26.05.2018;2018;05;22;Lauantai;3;6;9
94;26.05.2018;2018;05;23;Lauantai;1;3;4
94;27.05.2018;2018;05;00;Sunnuntai;0;1;1
94;27.05.2018;2018;05;01;Sunnuntai;0;0;0
94;27.05.2018;2018;05;02;Sunnuntai;0;1;1
94;27.05.2018;2018;05;03;Sunnuntai;1;0;1
94;27.05.2018;2018;05;04;Sunnuntai;0;0;0
94;27.05.2018;2018;05;05;Sunnuntai;1;1;2
94;27.05.2018;2018;05;06;Sunnuntai;2;1;3
94;27.05.2018;2018;05;07;Sunnuntai;1;2;3
94;27.05.2018;2018;05;08;Sunnuntai;5;6;11
94;27.05.2018;2018;05;09;Sunnuntai;6;4;10
94;27.05.2018;2018;05;10;Sunnuntai;9;3;12
94;27.05.2018;2018;05;11;Sunnuntai;12;7;19
94;27.05.2018;2018;05;12;Sunnuntai;11;12;23
94;27.05.2018;2018;05;13;Sunnuntai;13;24;37
94;27.05.2018;2018;05;14;Sunnuntai;8;21;29
94;27.05.2018;2018;05;15;Sunnuntai;12;7;19
94;27.05.2018;2018;05;16;Sunnuntai;9;9;18
94;27.05.2018;2018;05;17;Sunnuntai;13;7;20
94;27.05.2018;2018;05;18;Sunnuntai;10;6;16
94;27.05.2018;2018;05;19;Sunnuntai;10;11;21
94;27.05.2018;2018;05;20;Sunnuntai;5;3;8
94;27.05.2018;2018;05;21;Sunnuntai;6;4;10
94;27.05.2018;2018;05;22;Sunnuntai;0;3;3
94;27.05.2018;2018;05;23;Sunnuntai;0;1;1
94;28.05.2018;2018;05;00;Maanantai;0;0;0
94;28.05.2018;2018;05;01;Maanantai;1;0;1
94;28.05.2018;2018;05;02;Maanantai;0;0;0
94;28.05.2018;2018;05;03;Maanantai;0;0;0
94;28.05.2018;2018;05;04;Maanantai;3;0;3
94;28.05.2018;2018;05;05;Maanantai;9;2;11
94;28.05.2018;2018;05;06;Maanantai;21;2;23
94;28.05.2018;2018;05;07;Maanantai;42;4;46
94;28.05.2018;2018;05;08;Maanantai;20;4;24
94;28.05.2018;2018;05;09;Maanantai;11;4;15
94;28.05.2018;2018;05;10;Maanantai;4;3;7
94;28.05.2018;2018;05;11;Maanantai;6;11;17
94;28.05.2018;2018;05;12;Maanantai;6;4;10
94;28.05.2018;2018;05;13;Maanantai;6;16;22
94;28.05.2018;2018;05;14;Maanantai;4;16;20
94;28.05.2018;2018;05;15;Maanantai;3;28;31
94;28.05.2018;2018;05;16;Maanantai;16;33;49
94;28.05.2018;2018;05;17;Maanantai;6;25;31
94;28.05.2018;2018;05;18;Maanantai;11;18;29
94;28.05.2018;2018;05;19;Maanantai;7;8;15
94;28.05.2018;2018;05;20;Maanantai;7;11;18
94;28.05.2018;2018;05;21;Maanantai;1;6;7
94;28.05.2018;2018;05;22;Maanantai;2;4;6
94;28.05.2018;2018;05;23;Maanantai;0;2;2
94;29.05.2018;2018;05;00;Tiistai;0;0;0
94;29.05.2018;2018;05;01;Tiistai;1;0;1
94;29.05.2018;2018;05;02;Tiistai;0;1;1
94;29.05.2018;2018;05;03;Tiistai;0;1;1
94;29.05.2018;2018;05;04;Tiistai;6;0;6
94;29.05.2018;2018;05;05;Tiistai;6;2;8
94;29.05.2018;2018;05;06;Tiistai;33;4;37
94;29.05.2018;2018;05;07;Tiistai;32;6;38
94;29.05.2018;2018;05;08;Tiistai;20;3;23
94;29.05.2018;2018;05;09;Tiistai;9;3;12
94;29.05.2018;2018;05;10;Tiistai;5;3;8
94;29.05.2018;2018;05;11;Tiistai;3;10;13
94;29.05.2018;2018;05;12;Tiistai;6;11;17
94;29.05.2018;2018;05;13;Tiistai;12;9;21
94;29.05.2018;2018;05;14;Tiistai;6;12;18
94;29.05.2018;2018;05;15;Tiistai;7;33;40
94;29.05.2018;2018;05;16;Tiistai;18;42;60
94;29.05.2018;2018;05;17;Tiistai;7;22;29
94;29.05.2018;2018;05;18;Tiistai;16;18;34
94;29.05.2018;2018;05;19;Tiistai;11;11;22
94;29.05.2018;2018;05;20;Tiistai;4;9;13
94;29.05.2018;2018;05;21;Tiistai;2;5;7
94;29.05.2018;2018;05;22;Tiistai;3;6;9
94;29.05.2018;2018;05;23;Tiistai;0;0;0
94;30.05.2018;2018;05;00;Keskiviikko;0;0;0
94;30.05.2018;2018;05;01;Keskiviikko;0;0;0
94;30.05.2018;2018;05;02;Keskiviikko;0;1;1
94;30.05.2018;2018;05;03;Keskiviikko;0;0;0
94;30.05.2018;2018;05;04;Keskiviikko;2;0;2
94;30.05.2018;2018;05;05;Keskiviikko;9;2;11
94;30.05.2018;2018;05;06;Keskiviikko;27;3;30
94;30.05.2018;2018;05;07;Keskiviikko;33;3;36
94;30.05.2018;2018;05;08;Keskiviikko;16;5;21
94;30.05.2018;2018;05;09;Keskiviikko;5;4;9
94;30.05.2018;2018;05;10;Keskiviikko;7;3;10
94;30.05.2018;2018;05;11;Keskiviikko;5;3;8
94;30.05.2018;2018;05;12;Keskiviikko;2;3;5
94;30.05.2018;2018;05;13;Keskiviikko;8;9;17
94;30.05.2018;2018;05;14;Keskiviikko;4;14;18
94;30.05.2018;2018;05;15;Keskiviikko;8;24;32
94;30.05.2018;2018;05;16;Keskiviikko;7;27;34
94;30.05.2018;2018;05;17;Keskiviikko;1;16;17
94;30.05.2018;2018;05;18;Keskiviikko;4;11;15
94;30.05.2018;2018;05;19;Keskiviikko;3;9;12
94;30.05.2018;2018;05;20;Keskiviikko;5;7;12
94;30.05.2018;2018;05;21;Keskiviikko;2;8;10
94;30.05.2018;2018;05;22;Keskiviikko;2;3;5
94;30.05.2018;2018;05;23;Keskiviikko;0;8;8
94;31.05.2018;2018;05;00;Torstai;0;0;0
94;31.05.2018;2018;05;01;Torstai;0;0;0
94;31.05.2018;2018;05;02;Torstai;0;0;0
94;31.05.2018;2018;05;03;Torstai;0;0;0
94;31.05.2018;2018;05;04;Torstai;2;0;2
94;31.05.2018;2018;05;05;Torstai;10;2;12
94;31.05.2018;2018;05;06;Torstai;21;2;23
94;31.05.2018;2018;05;07;Torstai;28;3;31
94;31.05.2018;2018;05;08;Torstai;23;3;26
94;31.05.2018;2018;05;09;Torstai;9;2;11
94;31.05.2018;2018;05;10;Torstai;7;6;13
94;31.05.2018;2018;05;11;Torstai;3;6;9
94;31.05.2018;2018;05;12;Torstai;7;7;14
94;31.05.2018;2018;05;13;Torstai;8;6;14
94;31.05.2018;2018;05;14;Torstai;7;15;22
94;31.05.2018;2018;05;15;Torstai;8;25;33
94;31.05.2018;2018;05;16;Torstai;6;22;28
94;31.05.2018;2018;05;17;Torstai;5;27;32
94;31.05.2018;2018;05;18;Torstai;4;13;17
94;31.05.2018;2018;05;19;Torstai;5;10;15
94;31.05.2018;2018;05;20;Torstai;9;9;18
94;31.05.2018;2018;05;21;Torstai;4;12;16
94;31.05.2018;2018;05;22;Torstai;0;2;2
94;31.05.2018;2018;05;23;Torstai;1;1;2
94;01.06.2018;2018;06;00;Perjantai;0;0;0
94;01.06.2018;2018;06;01;Perjantai;0;0;0
94;01.06.2018;2018;06;02;Perjantai;0;0;0
94;01.06.2018;2018;06;03;Perjantai;2;0;2
94;01.06.2018;2018;06;04;Perjantai;1;0;1
94;01.06.2018;2018;06;05;Perjantai;12;0;12
94;01.06.2018;2018;06;06;Perjantai;24;0;24
94;01.06.2018;2018;06;07;Perjantai;37;0;37
94;01.06.2018;2018;06;08;Perjantai;22;0;22
94;01.06.2018;2018;06;09;Perjantai;12;0;12
94;01.06.2018;2018;06;10;Perjantai;6;0;6
94;01.06.2018;2018;06;11;Perjantai;15;0;15
94;01.06.2018;2018;06;12;Perjantai;23;0;23
94;01.06.2018;2018;06;13;Perjantai;11;0;11
94;01.06.2018;2018;06;14;Perjantai;26;0;26
94;01.06.2018;2018;06;15;Perjantai;35;0;35
94;01.06.2018;2018;06;16;Perjantai;37;0;37
94;01.06.2018;2018;06;17;Perjantai;31;0;31
94;01.06.2018;2018;06;18;Perjantai;23;0;23
94;01.06.2018;2018;06;19;Perjantai;19;0;19
94;01.06.2018;2018;06;20;Perjantai;11;0;11
94;01.06.2018;2018;06;21;Perjantai;7;0;7
94;01.06.2018;2018;06;22;Perjantai;7;0;7
94;01.06.2018;2018;06;23;Perjantai;2;0;2
94;02.06.2018;2018;06;00;Lauantai;0;0;0
94;02.06.2018;2018;06;01;Lauantai;2;0;2
94;02.06.2018;2018;06;02;Lauantai;1;3;4
94;02.06.2018;2018;06;03;Lauantai;0;0;0
94;02.06.2018;2018;06;04;Lauantai;1;2;3
94;02.06.2018;2018;06;05;Lauantai;3;3;6
94;02.06.2018;2018;06;06;Lauantai;3;2;5
94;02.06.2018;2018;06;07;Lauantai;3;1;4
94;02.06.2018;2018;06;08;Lauantai;3;5;8
94;02.06.2018;2018;06;09;Lauantai;12;2;14
94;02.06.2018;2018;06;10;Lauantai;13;11;24
94;02.06.2018;2018;06;11;Lauantai;8;9;17
94;02.06.2018;2018;06;12;Lauantai;10;7;17
94;02.06.2018;2018;06;13;Lauantai;6;15;21
94;02.06.2018;2018;06;14;Lauantai;12;21;33
94;02.06.2018;2018;06;15;Lauantai;13;12;25
94;02.06.2018;2018;06;16;Lauantai;16;11;27
94;02.06.2018;2018;06;17;Lauantai;17;9;26
94;02.06.2018;2018;06;18;Lauantai;5;8;13
94;02.06.2018;2018;06;19;Lauantai;15;9;24
94;02.06.2018;2018;06;20;Lauantai;8;2;10
94;02.06.2018;2018;06;21;Lauantai;1;7;8
94;02.06.2018;2018;06;22;Lauantai;1;2;3
94;02.06.2018;2018;06;23;Lauantai;1;3;4
94;03.06.2018;2018;06;00;Sunnuntai;0;1;1
94;03.06.2018;2018;06;01;Sunnuntai;0;1;1
94;03.06.2018;2018;06;02;Sunnuntai;0;1;1
94;03.06.2018;2018;06;03;Sunnuntai;0;2;2
94;03.06.2018;2018;06;04;Sunnuntai;0;0;0
94;03.06.2018;2018;06;05;Sunnuntai;1;0;1
94;03.06.2018;2018;06;06;Sunnuntai;1;0;1
94;03.06.2018;2018;06;07;Sunnuntai;1;2;3
94;03.06.2018;2018;06;08;Sunnuntai;7;2;9
94;03.06.2018;2018;06;09;Sunnuntai;6;5;11
94;03.06.2018;2018;06;10;Sunnuntai;2;8;10
94;03.06.2018;2018;06;11;Sunnuntai;10;12;22
94;03.06.2018;2018;06;12;Sunnuntai;18;11;29
94;03.06.2018;2018;06;13;Sunnuntai;12;16;28
94;03.06.2018;2018;06;14;Sunnuntai;16;7;23
94;03.06.2018;2018;06;15;Sunnuntai;15;10;25
94;03.06.2018;2018;06;16;Sunnuntai;19;11;30
94;03.06.2018;2018;06;17;Sunnuntai;4;14;18
94;03.06.2018;2018;06;18;Sunnuntai;8;3;11
94;03.06.2018;2018;06;19;Sunnuntai;6;4;10
94;03.06.2018;2018;06;20;Sunnuntai;5;10;15
94;03.06.2018;2018;06;21;Sunnuntai;1;6;7
94;03.06.2018;2018;06;22;Sunnuntai;0;3;3
94;03.06.2018;2018;06;23;Sunnuntai;0;1;1
94;04.06.2018;2018;06;00;Maanantai;0;0;0
94;04.06.2018;2018;06;01;Maanantai;1;1;2
94;04.06.2018;2018;06;02;Maanantai;0;0;0
94;04.06.2018;2018;06;03;Maanantai;0;0;0
94;04.06.2018;2018;06;04;Maanantai;2;0;2
94;04.06.2018;2018;06;05;Maanantai;5;1;6
94;04.06.2018;2018;06;06;Maanantai;25;3;28
94;04.06.2018;2018;06;07;Maanantai;13;4;17
94;04.06.2018;2018;06;08;Maanantai;14;0;14
94;04.06.2018;2018;06;09;Maanantai;1;3;4
94;04.06.2018;2018;06;10;Maanantai;2;2;4
94;04.06.2018;2018;06;11;Maanantai;5;0;5
94;04.06.2018;2018;06;12;Maanantai;4;2;6
94;04.06.2018;2018;06;13;Maanantai;4;2;6
94;04.06.2018;2018;06;14;Maanantai;7;9;16
94;04.06.2018;2018;06;15;Maanantai;4;11;15
94;04.06.2018;2018;06;16;Maanantai;2;25;27
94;04.06.2018;2018;06;17;Maanantai;1;7;8
94;04.06.2018;2018;06;18;Maanantai;2;6;8
94;04.06.2018;2018;06;19;Maanantai;4;8;12
94;04.06.2018;2018;06;20;Maanantai;0;3;3
94;04.06.2018;2018;06;21;Maanantai;5;3;8
94;04.06.2018;2018;06;22;Maanantai;1;5;6
94;04.06.2018;2018;06;23;Maanantai;0;0;0
94;05.06.2018;2018;06;00;Tiistai;1;0;1
94;05.06.2018;2018;06;01;Tiistai;1;1;2
94;05.06.2018;2018;06;02;Tiistai;0;2;2
94;05.06.2018;2018;06;03;Tiistai;0;0;0
94;05.06.2018;2018;06;04;Tiistai;2;0;2
94;05.06.2018;2018;06;05;Tiistai;6;4;10
94;05.06.2018;2018;06;06;Tiistai;18;2;20
94;05.06.2018;2018;06;07;Tiistai;10;2;12
94;05.06.2018;2018;06;08;Tiistai;12;2;14
94;05.06.2018;2018;06;09;Tiistai;1;1;2
94;05.06.2018;2018;06;10;Tiistai;3;0;3
94;05.06.2018;2018;06;11;Tiistai;8;2;10
94;05.06.2018;2018;06;12;Tiistai;6;1;7
94;05.06.2018;2018;06;13;Tiistai;3;5;8
94;05.06.2018;2018;06;14;Tiistai;6;10;16
94;05.06.2018;2018;06;15;Tiistai;5;13;18
94;05.06.2018;2018;06;16;Tiistai;2;20;22
94;05.06.2018;2018;06;17;Tiistai;2;7;9
94;05.06.2018;2018;06;18;Tiistai;2;10;12
94;05.06.2018;2018;06;19;Tiistai;5;9;14
94;05.06.2018;2018;06;20;Tiistai;2;12;14
94;05.06.2018;2018;06;21;Tiistai;2;1;3
94;05.06.2018;2018;06;22;Tiistai;3;1;4
94;05.06.2018;2018;06;23;Tiistai;0;0;0
94;06.06.2018;2018;06;00;Keskiviikko;0;1;1
94;06.06.2018;2018;06;01;Keskiviikko;0;0;0
94;06.06.2018;2018;06;02;Keskiviikko;0;0;0
94;06.06.2018;2018;06;03;Keskiviikko;0;0;0
94;06.06.2018;2018;06;04;Keskiviikko;2;0;2
94;06.06.2018;2018;06;05;Keskiviikko;7;3;10
94;06.06.2018;2018;06;06;Keskiviikko;19;4;23
94;06.06.2018;2018;06;07;Keskiviikko;21;2;23
94;06.06.2018;2018;06;08;Keskiviikko;7;0;7
94;06.06.2018;2018;06;09;Keskiviikko;9;5;14
94;06.06.2018;2018;06;10;Keskiviikko;4;5;9
94;06.06.2018;2018;06;11;Keskiviikko;11;4;15
94;06.06.2018;2018;06;12;Keskiviikko;4;6;10
94;06.06.2018;2018;06;13;Keskiviikko;2;8;10
94;06.06.2018;2018;06;14;Keskiviikko;5;8;13
94;06.06.2018;2018;06;15;Keskiviikko;11;24;35
94;06.06.2018;2018;06;16;Keskiviikko;6;26;32
94;06.06.2018;2018;06;17;Keskiviikko;3;17;20
94;06.06.2018;2018;06;18;Keskiviikko;1;12;13
94;06.06.2018;2018;06;19;Keskiviikko;5;8;13
94;06.06.2018;2018;06;20;Keskiviikko;9;9;18
94;06.06.2018;2018;06;21;Keskiviikko;3;5;8
94;06.06.2018;2018;06;22;Keskiviikko;1;2;3
94;06.06.2018;2018;06;23;Keskiviikko;0;2;2
94;07.06.2018;2018;06;00;Torstai;0;0;0
94;07.06.2018;2018;06;01;Torstai;0;0;0
94;07.06.2018;2018;06;02;Torstai;1;0;1
94;07.06.2018;2018;06;03;Torstai;0;0;0
94;07.06.2018;2018;06;04;Torstai;1;0;1
94;07.06.2018;2018;06;05;Torstai;6;1;7
94;07.06.2018;2018;06;06;Torstai;13;3;16
94;07.06.2018;2018;06;07;Torstai;10;0;10
94;07.06.2018;2018;06;08;Torstai;6;2;8
94;07.06.2018;2018;06;09;Torstai;1;2;3
94;07.06.2018;2018;06;10;Torstai;1;1;2
94;07.06.2018;2018;06;11;Torstai;1;1;2
94;07.06.2018;2018;06;12;Torstai;5;2;7
94;07.06.2018;2018;06;13;Torstai;2;3;5
94;07.06.2018;2018;06;14;Torstai;2;12;14
94;07.06.2018;2018;06;15;Torstai;5;13;18
94;07.06.2018;2018;06;16;Torstai;6;11;17
94;07.06.2018;2018;06;17;Torstai;2;4;6
94;07.06.2018;2018;06;18;Torstai;4;4;8
94;07.06.2018;2018;06;19;Torstai;4;3;7
94;07.06.2018;2018;06;20;Torstai;2;3;5
94;07.06.2018;2018;06;21;Torstai;0;1;1
94;07.06.2018;2018;06;22;Torstai;0;6;6
94;07.06.2018;2018;06;23;Torstai;0;0;0
94;08.06.2018;2018;06;00;Perjantai;1;3;4
94;08.06.2018;2018;06;01;Perjantai;0;0;0
94;08.06.2018;2018;06;02;Perjantai;1;0;1
94;08.06.2018;2018;06;03;Perjantai;0;0;0
94;08.06.2018;2018;06;04;Perjantai;1;0;1
94;08.06.2018;2018;06;05;Perjantai;9;2;11
94;08.06.2018;2018;06;06;Perjantai;17;2;19
94;08.06.2018;2018;06;07;Perjantai;17;0;17
94;08.06.2018;2018;06;08;Perjantai;10;4;14
94;08.06.2018;2018;06;09;Perjantai;10;0;10
94;08.06.2018;2018;06;10;Perjantai;7;1;8
94;08.06.2018;2018;06;11;Perjantai;4;6;10
94;08.06.2018;2018;06;12;Perjantai;13;6;19
94;08.06.2018;2018;06;13;Perjantai;6;10;16
94;08.06.2018;2018;06;14;Perjantai;8;19;27
94;08.06.2018;2018;06;15;Perjantai;10;20;30
94;08.06.2018;2018;06;16;Perjantai;6;28;34
94;08.06.2018;2018;06;17;Perjantai;3;15;18
94;08.06.2018;2018;06;18;Perjantai;4;3;7
94;08.06.2018;2018;06;19;Perjantai;8;4;12
94;08.06.2018;2018;06;20;Perjantai;1;9;10
94;08.06.2018;2018;06;21;Perjantai;6;4;10
94;08.06.2018;2018;06;22;Perjantai;2;5;7
94;08.06.2018;2018;06;23;Perjantai;1;1;2
94;09.06.2018;2018;06;00;Lauantai;1;0;1
94;09.06.2018;2018;06;01;Lauantai;1;1;2
94;09.06.2018;2018;06;02;Lauantai;0;0;0
94;09.06.2018;2018;06;03;Lauantai;1;0;1
94;09.06.2018;2018;06;04;Lauantai;1;0;1
94;09.06.2018;2018;06;05;Lauantai;2;1;3
94;09.06.2018;2018;06;06;Lauantai;1;1;2
94;09.06.2018;2018;06;07;Lauantai;0;2;2
94;09.06.2018;2018;06;08;Lauantai;4;3;7
94;09.06.2018;2018;06;09;Lauantai;4;0;4
94;09.06.2018;2018;06;10;Lauantai;7;8;15
94;09.06.2018;2018;06;11;Lauantai;9;13;22
94;09.06.2018;2018;06;12;Lauantai;4;10;14
94;09.06.2018;2018;06;13;Lauantai;10;7;17
94;09.06.2018;2018;06;14;Lauantai;8;6;14
94;09.06.2018;2018;06;15;Lauantai;5;8;13
94;09.06.2018;2018;06;16;Lauantai;4;6;10
94;09.06.2018;2018;06;17;Lauantai;10;3;13
94;09.06.2018;2018;06;18;Lauantai;6;7;13
94;09.06.2018;2018;06;19;Lauantai;0;3;3
94;09.06.2018;2018;06;20;Lauantai;6;5;11
94;09.06.2018;2018;06;21;Lauantai;1;4;5
94;09.06.2018;2018;06;22;Lauantai;2;7;9
94;09.06.2018;2018;06;23;Lauantai;1;1;2
94;10.06.2018;2018;06;00;Sunnuntai;4;2;6
94;10.06.2018;2018;06;01;Sunnuntai;1;1;2
94;10.06.2018;2018;06;02;Sunnuntai;1;1;2
94;10.06.2018;2018;06;03;Sunnuntai;1;0;1
94;10.06.2018;2018;06;04;Sunnuntai;0;0;0
94;10.06.2018;2018;06;05;Sunnuntai;0;2;2
94;10.06.2018;2018;06;06;Sunnuntai;1;1;2
94;10.06.2018;2018;06;07;Sunnuntai;0;1;1
94;10.06.2018;2018;06;08;Sunnuntai;1;0;1
94;10.06.2018;2018;06;09;Sunnuntai;3;3;6
94;10.06.2018;2018;06;10;Sunnuntai;14;15;29
94;10.06.2018;2018;06;11;Sunnuntai;6;16;22
94;10.06.2018;2018;06;12;Sunnuntai;19;11;30
94;10.06.2018;2018;06;13;Sunnuntai;12;8;20
94;10.06.2018;2018;06;14;Sunnuntai;13;11;24
94;10.06.2018;2018;06;15;Sunnuntai;18;16;34
94;10.06.2018;2018;06;16;Sunnuntai;12;16;28
94;10.06.2018;2018;06;17;Sunnuntai;12;10;22
94;10.06.2018;2018;06;18;Sunnuntai;15;10;25
94;10.06.2018;2018;06;19;Sunnuntai;16;11;27
94;10.06.2018;2018;06;20;Sunnuntai;5;6;11
94;10.06.2018;2018;06;21;Sunnuntai;5;7;12
94;10.06.2018;2018;06;22;Sunnuntai;3;3;6
94;10.06.2018;2018;06;23;Sunnuntai;1;1;2
94;11.06.2018;2018;06;00;Maanantai;1;1;2
94;11.06.2018;2018;06;01;Maanantai;0;0;0
94;11.06.2018;2018;06;02;Maanantai;0;0;0
94;11.06.2018;2018;06;03;Maanantai;0;0;0
94;11.06.2018;2018;06;04;Maanantai;3;1;4
94;11.06.2018;2018;06;05;Maanantai;7;3;10
94;11.06.2018;2018;06;06;Maanantai;22;2;24
94;11.06.2018;2018;06;07;Maanantai;23;3;26
94;11.06.2018;2018;06;08;Maanantai;14;0;14
94;11.06.2018;2018;06;09;Maanantai;11;6;17
94;11.06.2018;2018;06;10;Maanantai;8;2;10
94;11.06.2018;2018;06;11;Maanantai;10;8;18
94;11.06.2018;2018;06;12;Maanantai;12;1;13
94;11.06.2018;2018;06;13;Maanantai;16;15;31
94;11.06.2018;2018;06;14;Maanantai;7;17;24
94;11.06.2018;2018;06;15;Maanantai;12;29;41
94;11.06.2018;2018;06;16;Maanantai;15;24;39
94;11.06.2018;2018;06;17;Maanantai;4;27;31
94;11.06.2018;2018;06;18;Maanantai;10;23;33
94;11.06.2018;2018;06;19;Maanantai;9;17;26
94;11.06.2018;2018;06;20;Maanantai;9;8;17
94;11.06.2018;2018;06;21;Maanantai;4;9;13
94;11.06.2018;2018;06;22;Maanantai;3;7;10
94;11.06.2018;2018;06;23;Maanantai;1;1;2
94;12.06.2018;2018;06;00;Tiistai;0;0;0
94;12.06.2018;2018;06;01;Tiistai;0;0;0
94;12.06.2018;2018;06;02;Tiistai;0;0;0
94;12.06.2018;2018;06;03;Tiistai;2;0;2
94;12.06.2018;2018;06;04;Tiistai;1;0;1
94;12.06.2018;2018;06;05;Tiistai;5;3;8
94;12.06.2018;2018;06;06;Tiistai;27;2;29
94;12.06.2018;2018;06;07;Tiistai;23;1;24
94;12.06.2018;2018;06;08;Tiistai;11;2;13
94;12.06.2018;2018;06;09;Tiistai;2;1;3
94;12.06.2018;2018;06;10;Tiistai;9;5;14
94;12.06.2018;2018;06;11;Tiistai;7;5;12
94;12.06.2018;2018;06;12;Tiistai;9;3;12
94;12.06.2018;2018;06;13;Tiistai;5;8;13
94;12.06.2018;2018;06;14;Tiistai;4;20;24
94;12.06.2018;2018;06;15;Tiistai;7;18;25
94;12.06.2018;2018;06;16;Tiistai;6;33;39
94;12.06.2018;2018;06;17;Tiistai;10;15;25
94;12.06.2018;2018;06;18;Tiistai;7;7;14
94;12.06.2018;2018;06;19;Tiistai;3;8;11
94;12.06.2018;2018;06;20;Tiistai;7;4;11
94;12.06.2018;2018;06;21;Tiistai;7;6;13
94;12.06.2018;2018;06;22;Tiistai;1;8;9
94;12.06.2018;2018;06;23;Tiistai;2;1;3
94;13.06.2018;2018;06;00;Keskiviikko;0;0;0
94;13.06.2018;2018;06;01;Keskiviikko;0;0;0
94;13.06.2018;2018;06;02;Keskiviikko;0;2;2
94;13.06.2018;2018;06;03;Keskiviikko;1;0;1
94;13.06.2018;2018;06;04;Keskiviikko;3;1;4
94;13.06.2018;2018;06;05;Keskiviikko;5;4;9
94;13.06.2018;2018;06;06;Keskiviikko;17;2;19
94;13.06.2018;2018;06;07;Keskiviikko;29;2;31
94;13.06.2018;2018;06;08;Keskiviikko;11;3;14
94;13.06.2018;2018;06;09;Keskiviikko;5;4;9
94;13.06.2018;2018;06;10;Keskiviikko;10;5;15
94;13.06.2018;2018;06;11;Keskiviikko;5;2;7
94;13.06.2018;2018;06;12;Keskiviikko;7;4;11
94;13.06.2018;2018;06;13;Keskiviikko;15;11;26
94;13.06.2018;2018;06;14;Keskiviikko;8;15;23
94;13.06.2018;2018;06;15;Keskiviikko;10;27;37
94;13.06.2018;2018;06;16;Keskiviikko;5;28;33
94;13.06.2018;2018;06;17;Keskiviikko;7;24;31
94;13.06.2018;2018;06;18;Keskiviikko;5;13;18
94;13.06.2018;2018;06;19;Keskiviikko;3;12;15
94;13.06.2018;2018;06;20;Keskiviikko;7;16;23
94;13.06.2018;2018;06;21;Keskiviikko;6;13;19
94;13.06.2018;2018;06;22;Keskiviikko;3;0;3
94;13.06.2018;2018;06;23;Keskiviikko;1;0;1
94;14.06.2018;2018;06;00;Torstai;0;0;0
94;14.06.2018;2018;06;01;Torstai;1;0;1
94;14.06.2018;2018;06;02;Torstai;0;0;0
94;14.06.2018;2018;06;03;Torstai;1;0;1
94;14.06.2018;2018;06;04;Torstai;1;1;2
94;14.06.2018;2018;06;05;Torstai;7;3;10
94;14.06.2018;2018;06;06;Torstai;25;3;28
94;14.06.2018;2018;06;07;Torstai;20;4;24
94;14.06.2018;2018;06;08;Torstai;9;2;11
94;14.06.2018;2018;06;09;Torstai;7;3;10
94;14.06.2018;2018;06;10;Torstai;7;9;16
94;14.06.2018;2018;06;11;Torstai;9;0;9
94;14.06.2018;2018;06;12;Torstai;14;7;21
94;14.06.2018;2018;06;13;Torstai;12;17;29
94;14.06.2018;2018;06;14;Torstai;10;17;27
94;14.06.2018;2018;06;15;Torstai;18;24;42
94;14.06.2018;2018;06;16;Torstai;11;31;42
94;14.06.2018;2018;06;17;Torstai;6;16;22
94;14.06.2018;2018;06;18;Torstai;4;15;19
94;14.06.2018;2018;06;19;Torstai;12;10;22
94;14.06.2018;2018;06;20;Torstai;8;12;20
94;14.06.2018;2018;06;21;Torstai;8;6;14
94;14.06.2018;2018;06;22;Torstai;4;3;7
94;14.06.2018;2018;06;23;Torstai;1;1;2
94;15.06.2018;2018;06;00;Perjantai;0;0;0
94;15.06.2018;2018;06;01;Perjantai;2;0;2
94;15.06.2018;2018;06;02;Perjantai;0;0;0
94;15.06.2018;2018;06;03;Perjantai;0;0;0
94;15.06.2018;2018;06;04;Perjantai;1;1;2
94;15.06.2018;2018;06;05;Perjantai;6;1;7
94;15.06.2018;2018;06;06;Perjantai;17;7;24
94;15.06.2018;2018;06;07;Perjantai;20;3;23
94;15.06.2018;2018;06;08;Perjantai;11;4;15
94;15.06.2018;2018;06;09;Perjantai;7;3;10
94;15.06.2018;2018;06;10;Perjantai;12;3;15
94;15.06.2018;2018;06;11;Perjantai;7;3;10
94;15.06.2018;2018;06;12;Perjantai;4;14;18
94;15.06.2018;2018;06;13;Perjantai;5;11;16
94;15.06.2018;2018;06;14;Perjantai;13;19;32
94;15.06.2018;2018;06;15;Perjantai;5;22;27
94;15.06.2018;2018;06;16;Perjantai;6;20;26
94;15.06.2018;2018;06;17;Perjantai;5;10;15
94;15.06.2018;2018;06;18;Perjantai;5;5;10
94;15.06.2018;2018;06;19;Perjantai;3;7;10
94;15.06.2018;2018;06;20;Perjantai;3;6;9
94;15.06.2018;2018;06;21;Perjantai;6;6;12
94;15.06.2018;2018;06;22;Perjantai;0;6;6
94;15.06.2018;2018;06;23;Perjantai;0;0;0
94;16.06.2018;2018;06;00;Lauantai;1;2;3
94;16.06.2018;2018;06;01;Lauantai;0;1;1
94;16.06.2018;2018;06;02;Lauantai;1;1;2
94;16.06.2018;2018;06;03;Lauantai;0;0;0
94;16.06.2018;2018;06;04;Lauantai;0;0;0
94;16.06.2018;2018;06;05;Lauantai;3;1;4
94;16.06.2018;2018;06;06;Lauantai;2;0;2
94;16.06.2018;2018;06;07;Lauantai;2;1;3
94;16.06.2018;2018;06;08;Lauantai;5;2;7
94;16.06.2018;2018;06;09;Lauantai;2;4;6
94;16.06.2018;2018;06;10;Lauantai;11;13;24
94;16.06.2018;2018;06;11;Lauantai;13;8;21
94;16.06.2018;2018;06;12;Lauantai;9;17;26
94;16.06.2018;2018;06;13;Lauantai;26;12;38
94;16.06.2018;2018;06;14;Lauantai;11;10;21
94;16.06.2018;2018;06;15;Lauantai;7;10;17
94;16.06.2018;2018;06;16;Lauantai;11;12;23
94;16.06.2018;2018;06;17;Lauantai;5;8;13
94;16.06.2018;2018;06;18;Lauantai;3;13;16
94;16.06.2018;2018;06;19;Lauantai;9;7;16
94;16.06.2018;2018;06;20;Lauantai;3;6;9
94;16.06.2018;2018;06;21;Lauantai;4;2;6
94;16.06.2018;2018;06;22;Lauantai;5;1;6
94;16.06.2018;2018;06;23;Lauantai;4;1;5
94;17.06.2018;2018;06;00;Sunnuntai;8;3;11
94;17.06.2018;2018;06;01;Sunnuntai;1;0;1
94;17.06.2018;2018;06;02;Sunnuntai;5;1;6
94;17.06.2018;2018;06;03;Sunnuntai;2;1;3
94;17.06.2018;2018;06;04;Sunnuntai;0;1;1
94;17.06.2018;2018;06;05;Sunnuntai;1;1;2
94;17.06.2018;2018;06;06;Sunnuntai;2;0;2
94;17.06.2018;2018;06;07;Sunnuntai;1;0;1
94;17.06.2018;2018;06;08;Sunnuntai;1;4;5
94;17.06.2018;2018;06;09;Sunnuntai;5;3;8
94;17.06.2018;2018;06;10;Sunnuntai;11;14;25
94;17.06.2018;2018;06;11;Sunnuntai;17;15;32
94;17.06.2018;2018;06;12;Sunnuntai;15;29;44
94;17.06.2018;2018;06;13;Sunnuntai;13;28;41
94;17.06.2018;2018;06;14;Sunnuntai;21;12;33
94;17.06.2018;2018;06;15;Sunnuntai;19;8;27
94;17.06.2018;2018;06;16;Sunnuntai;15;16;31
94;17.06.2018;2018;06;17;Sunnuntai;19;11;30
94;17.06.2018;2018;06;18;Sunnuntai;14;12;26
94;17.06.2018;2018;06;19;Sunnuntai;15;11;26
94;17.06.2018;2018;06;20;Sunnuntai;11;4;15
94;17.06.2018;2018;06;21;Sunnuntai;6;8;14
94;17.06.2018;2018;06;22;Sunnuntai;2;2;4
94;17.06.2018;2018;06;23;Sunnuntai;0;2;2
94;18.06.2018;2018;06;00;Maanantai;1;0;1
94;18.06.2018;2018;06;01;Maanantai;1;0;1
94;18.06.2018;2018;06;02;Maanantai;1;0;1
94;18.06.2018;2018;06;03;Maanantai;0;1;1
94;18.06.2018;2018;06;04;Maanantai;1;0;1
94;18.06.2018;2018;06;05;Maanantai;3;1;4
94;18.06.2018;2018;06;06;Maanantai;18;1;19
94;18.06.2018;2018;06;07;Maanantai;22;4;26
94;18.06.2018;2018;06;08;Maanantai;13;2;15
94;18.06.2018;2018;06;09;Maanantai;4;3;7
94;18.06.2018;2018;06;10;Maanantai;7;6;13
94;18.06.2018;2018;06;11;Maanantai;3;1;4
94;18.06.2018;2018;06;12;Maanantai;3;3;6
94;18.06.2018;2018;06;13;Maanantai;6;5;11
94;18.06.2018;2018;06;14;Maanantai;5;9;14
94;18.06.2018;2018;06;15;Maanantai;6;17;23
94;18.06.2018;2018;06;16;Maanantai;4;18;22
94;18.06.2018;2018;06;17;Maanantai;8;14;22
94;18.06.2018;2018;06;18;Maanantai;5;10;15
94;18.06.2018;2018;06;19;Maanantai;3;6;9
94;18.06.2018;2018;06;20;Maanantai;3;4;7
94;18.06.2018;2018;06;21;Maanantai;0;10;10
94;18.06.2018;2018;06;22;Maanantai;1;6;7
94;18.06.2018;2018;06;23;Maanantai;1;0;1
94;19.06.2018;2018;06;00;Tiistai;0;0;0
94;19.06.2018;2018;06;01;Tiistai;0;0;0
94;19.06.2018;2018;06;02;Tiistai;0;0;0
94;19.06.2018;2018;06;03;Tiistai;0;0;0
94;19.06.2018;2018;06;04;Tiistai;2;0;2
94;19.06.2018;2018;06;05;Tiistai;5;1;6
94;19.06.2018;2018;06;06;Tiistai;18;3;21
94;19.06.2018;2018;06;07;Tiistai;15;3;18
94;19.06.2018;2018;06;08;Tiistai;14;5;19
94;19.06.2018;2018;06;09;Tiistai;4;3;7
94;19.06.2018;2018;06;10;Tiistai;3;5;8
94;19.06.2018;2018;06;11;Tiistai;6;4;10
94;19.06.2018;2018;06;12;Tiistai;4;1;5
94;19.06.2018;2018;06;13;Tiistai;8;2;10
94;19.06.2018;2018;06;14;Tiistai;4;7;11
94;19.06.2018;2018;06;15;Tiistai;2;18;20
94;19.06.2018;2018;06;16;Tiistai;0;10;10
94;19.06.2018;2018;06;17;Tiistai;3;5;8
94;19.06.2018;2018;06;18;Tiistai;1;5;6
94;19.06.2018;2018;06;19;Tiistai;1;2;3
94;19.06.2018;2018;06;20;Tiistai;3;7;10
94;19.06.2018;2018;06;21;Tiistai;1;3;4
94;19.06.2018;2018;06;22;Tiistai;0;6;6
94;19.06.2018;2018;06;23;Tiistai;0;5;5
94;20.06.2018;2018;06;00;Keskiviikko;0;1;1
94;20.06.2018;2018;06;01;Keskiviikko;5;0;5
94;20.06.2018;2018;06;02;Keskiviikko;0;0;0
94;20.06.2018;2018;06;03;Keskiviikko;0;0;0
94;20.06.2018;2018;06;04;Keskiviikko;1;1;2
94;20.06.2018;2018;06;05;Keskiviikko;4;3;7
94;20.06.2018;2018;06;06;Keskiviikko;15;1;16
94;20.06.2018;2018;06;07;Keskiviikko;23;3;26
94;20.06.2018;2018;06;08;Keskiviikko;14;1;15
94;20.06.2018;2018;06;09;Keskiviikko;3;8;11
94;20.06.2018;2018;06;10;Keskiviikko;11;6;17
94;20.06.2018;2018;06;11;Keskiviikko;6;3;9
94;20.06.2018;2018;06;12;Keskiviikko;7;3;10
94;20.06.2018;2018;06;13;Keskiviikko;2;6;8
94;20.06.2018;2018;06;14;Keskiviikko;10;6;16
94;20.06.2018;2018;06;15;Keskiviikko;11;14;25
94;20.06.2018;2018;06;16;Keskiviikko;4;36;40
94;20.06.2018;2018;06;17;Keskiviikko;3;20;23
94;20.06.2018;2018;06;18;Keskiviikko;5;11;16
94;20.06.2018;2018;06;19;Keskiviikko;5;14;19
94;20.06.2018;2018;06;20;Keskiviikko;13;14;27
94;20.06.2018;2018;06;21;Keskiviikko;1;5;6
94;20.06.2018;2018;06;22;Keskiviikko;6;6;12
94;20.06.2018;2018;06;23;Keskiviikko;0;3;3
94;21.06.2018;2018;06;00;Torstai;2;1;3
94;21.06.2018;2018;06;01;Torstai;0;0;0
94;21.06.2018;2018;06;02;Torstai;0;0;0
94;21.06.2018;2018;06;03;Torstai;0;1;1
94;21.06.2018;2018;06;04;Torstai;1;0;1
94;21.06.2018;2018;06;05;Torstai;2;2;4
94;21.06.2018;2018;06;06;Torstai;14;1;15
94;21.06.2018;2018;06;07;Torstai;15;9;24
94;21.06.2018;2018;06;08;Torstai;10;2;12
94;21.06.2018;2018;06;09;Torstai;9;5;14
94;21.06.2018;2018;06;10;Torstai;10;3;13
94;21.06.2018;2018;06;11;Torstai;4;11;15
94;21.06.2018;2018;06;12;Torstai;2;8;10
94;21.06.2018;2018;06;13;Torstai;13;12;25
94;21.06.2018;2018;06;14;Torstai;9;17;26
94;21.06.2018;2018;06;15;Torstai;11;16;27
94;21.06.2018;2018;06;16;Torstai;9;25;34
94;21.06.2018;2018;06;17;Torstai;8;23;31
94;21.06.2018;2018;06;18;Torstai;8;13;21
94;21.06.2018;2018;06;19;Torstai;11;12;23
94;21.06.2018;2018;06;20;Torstai;10;4;14
94;21.06.2018;2018;06;21;Torstai;10;1;11
94;21.06.2018;2018;06;22;Torstai;5;10;15
94;21.06.2018;2018;06;23;Torstai;2;5;7
94;22.06.2018;2018;06;00;Perjantai;3;0;3
94;22.06.2018;2018;06;01;Perjantai;0;0;0
94;22.06.2018;2018;06;02;Perjantai;1;0;1
94;22.06.2018;2018;06;03;Perjantai;0;3;3
94;22.06.2018;2018;06;04;Perjantai;0;0;0
94;22.06.2018;2018;06;05;Perjantai;0;1;1
94;22.06.2018;2018;06;06;Perjantai;1;0;1
94;22.06.2018;2018;06;07;Perjantai;1;2;3
94;22.06.2018;2018;06;08;Perjantai;0;0;0
94;22.06.2018;2018;06;09;Perjantai;0;2;2
94;22.06.2018;2018;06;10;Perjantai;1;1;2
94;22.06.2018;2018;06;11;Perjantai;1;0;1
94;22.06.2018;2018;06;12;Perjantai;0;1;1
94;22.06.2018;2018;06;13;Perjantai;0;0;0
94;22.06.2018;2018;06;14;Perjantai;2;2;4
94;22.06.2018;2018;06;15;Perjantai;0;2;2
94;22.06.2018;2018;06;16;Perjantai;0;2;2
94;22.06.2018;2018;06;17;Perjantai;0;0;0
94;22.06.2018;2018;06;18;Perjantai;0;1;1
94;22.06.2018;2018;06;19;Perjantai;4;1;5
94;22.06.2018;2018;06;20;Perjantai;3;1;4
94;22.06.2018;2018;06;21;Perjantai;1;4;5
94;22.06.2018;2018;06;22;Perjantai;2;0;2
94;22.06.2018;2018;06;23;Perjantai;0;0;0
94;23.06.2018;2018;06;00;Lauantai;0;0;0
94;23.06.2018;2018;06;01;Lauantai;0;1;1
94;23.06.2018;2018;06;02;Lauantai;0;0;0
94;23.06.2018;2018;06;03;Lauantai;0;1;1
94;23.06.2018;2018;06;04;Lauantai;0;0;0
94;23.06.2018;2018;06;05;Lauantai;1;0;1
94;23.06.2018;2018;06;06;Lauantai;0;0;0
94;23.06.2018;2018;06;07;Lauantai;0;0;0
94;23.06.2018;2018;06;08;Lauantai;0;0;0
94;23.06.2018;2018;06;09;Lauantai;0;2;2
94;23.06.2018;2018;06;10;Lauantai;5;0;5
94;23.06.2018;2018;06;11;Lauantai;2;0;2
94;23.06.2018;2018;06;12;Lauantai;5;2;7
94;23.06.2018;2018;06;13;Lauantai;2;1;3
94;23.06.2018;2018;06;14;Lauantai;0;2;2
94;23.06.2018;2018;06;15;Lauantai;0;1;1
94;23.06.2018;2018;06;16;Lauantai;2;3;5
94;23.06.2018;2018;06;17;Lauantai;5;2;7
94;23.06.2018;2018;06;18;Lauantai;4;4;8
94;23.06.2018;2018;06;19;Lauantai;5;1;6
94;23.06.2018;2018;06;20;Lauantai;0;1;1
94;23.06.2018;2018;06;21;Lauantai;0;0;0
94;23.06.2018;2018;06;22;Lauantai;0;2;2
94;23.06.2018;2018;06;23;Lauantai;0;1;1
94;24.06.2018;2018;06;00;Sunnuntai;1;0;1
94;24.06.2018;2018;06;01;Sunnuntai;2;2;4
94;24.06.2018;2018;06;02;Sunnuntai;2;0;2
94;24.06.2018;2018;06;03;Sunnuntai;2;0;2
94;24.06.2018;2018;06;04;Sunnuntai;0;0;0
94;24.06.2018;2018;06;05;Sunnuntai;1;0;1
94;24.06.2018;2018;06;06;Sunnuntai;1;1;2
94;24.06.2018;2018;06;07;Sunnuntai;1;0;1
94;24.06.2018;2018;06;08;Sunnuntai;4;5;9
94;24.06.2018;2018;06;09;Sunnuntai;7;7;14
94;24.06.2018;2018;06;10;Sunnuntai;7;9;16
94;24.06.2018;2018;06;11;Sunnuntai;6;9;15
94;24.06.2018;2018;06;12;Sunnuntai;20;10;30
94;24.06.2018;2018;06;13;Sunnuntai;16;10;26
94;24.06.2018;2018;06;14;Sunnuntai;13;8;21
94;24.06.2018;2018;06;15;Sunnuntai;15;18;33
94;24.06.2018;2018;06;16;Sunnuntai;17;7;24
94;24.06.2018;2018;06;17;Sunnuntai;17;14;31
94;24.06.2018;2018;06;18;Sunnuntai;11;4;15
94;24.06.2018;2018;06;19;Sunnuntai;11;5;16
94;24.06.2018;2018;06;20;Sunnuntai;3;12;15
94;24.06.2018;2018;06;21;Sunnuntai;2;4;6
94;24.06.2018;2018;06;22;Sunnuntai;4;1;5
94;24.06.2018;2018;06;23;Sunnuntai;1;1;2
94;25.06.2018;2018;06;00;Maanantai;2;1;3
94;25.06.2018;2018;06;01;Maanantai;0;1;1
94;25.06.2018;2018;06;02;Maanantai;1;0;1
94;25.06.2018;2018;06;03;Maanantai;0;0;0
94;25.06.2018;2018;06;04;Maanantai;2;0;2
94;25.06.2018;2018;06;05;Maanantai;7;2;9
94;25.06.2018;2018;06;06;Maanantai;23;3;26
94;25.06.2018;2018;06;07;Maanantai;31;5;36
94;25.06.2018;2018;06;08;Maanantai;19;2;21
94;25.06.2018;2018;06;09;Maanantai;9;9;18
94;25.06.2018;2018;06;10;Maanantai;11;7;18
94;25.06.2018;2018;06;11;Maanantai;9;3;12
94;25.06.2018;2018;06;12;Maanantai;12;15;27
94;25.06.2018;2018;06;13;Maanantai;15;16;31
94;25.06.2018;2018;06;14;Maanantai;10;15;25
94;25.06.2018;2018;06;15;Maanantai;12;24;36
94;25.06.2018;2018;06;16;Maanantai;17;56;73
94;25.06.2018;2018;06;17;Maanantai;15;28;43
94;25.06.2018;2018;06;18;Maanantai;16;18;34
94;25.06.2018;2018;06;19;Maanantai;12;14;26
94;25.06.2018;2018;06;20;Maanantai;13;12;25
94;25.06.2018;2018;06;21;Maanantai;6;6;12
94;25.06.2018;2018;06;22;Maanantai;1;6;7
94;25.06.2018;2018;06;23;Maanantai;1;0;1
94;26.06.2018;2018;06;00;Tiistai;0;0;0
94;26.06.2018;2018;06;01;Tiistai;0;0;0
94;26.06.2018;2018;06;02;Tiistai;0;0;0
94;26.06.2018;2018;06;03;Tiistai;0;0;0
94;26.06.2018;2018;06;04;Tiistai;3;1;4
94;26.06.2018;2018;06;05;Tiistai;7;3;10
94;26.06.2018;2018;06;06;Tiistai;20;5;25
94;26.06.2018;2018;06;07;Tiistai;26;6;32
94;26.06.2018;2018;06;08;Tiistai;15;2;17
94;26.06.2018;2018;06;09;Tiistai;8;7;15
94;26.06.2018;2018;06;10;Tiistai;11;6;17
94;26.06.2018;2018;06;11;Tiistai;9;5;14
94;26.06.2018;2018;06;12;Tiistai;3;4;7
94;26.06.2018;2018;06;13;Tiistai;9;7;16
94;26.06.2018;2018;06;14;Tiistai;17;26;43
94;26.06.2018;2018;06;15;Tiistai;17;23;40
94;26.06.2018;2018;06;16;Tiistai;15;38;53
94;26.06.2018;2018;06;17;Tiistai;6;23;29
94;26.06.2018;2018;06;18;Tiistai;10;21;31
94;26.06.2018;2018;06;19;Tiistai;10;6;16
94;26.06.2018;2018;06;20;Tiistai;15;17;32
94;26.06.2018;2018;06;21;Tiistai;13;5;18
94;26.06.2018;2018;06;22;Tiistai;1;7;8
94;26.06.2018;2018;06;23;Tiistai;1;0;1
94;27.06.2018;2018;06;00;Keskiviikko;1;1;2
94;27.06.2018;2018;06;01;Keskiviikko;0;0;0
94;27.06.2018;2018;06;02;Keskiviikko;0;0;0
94;27.06.2018;2018;06;03;Keskiviikko;0;1;1
94;27.06.2018;2018;06;04;Keskiviikko;2;1;3
94;27.06.2018;2018;06;05;Keskiviikko;7;3;10
94;27.06.2018;2018;06;06;Keskiviikko;23;4;27
94;27.06.2018;2018;06;07;Keskiviikko;22;5;27
94;27.06.2018;2018;06;08;Keskiviikko;14;2;16
94;27.06.2018;2018;06;09;Keskiviikko;2;6;8
94;27.06.2018;2018;06;10;Keskiviikko;4;11;15
94;27.06.2018;2018;06;11;Keskiviikko;7;16;23
94;27.06.2018;2018;06;12;Keskiviikko;4;3;7
94;27.06.2018;2018;06;13;Keskiviikko;10;8;18
94;27.06.2018;2018;06;14;Keskiviikko;10;16;26
94;27.06.2018;2018;06;15;Keskiviikko;13;24;37
94;27.06.2018;2018;06;16;Keskiviikko;9;36;45
94;27.06.2018;2018;06;17;Keskiviikko;8;12;20
94;27.06.2018;2018;06;18;Keskiviikko;9;14;23
94;27.06.2018;2018;06;19;Keskiviikko;9;7;16
94;27.06.2018;2018;06;20;Keskiviikko;9;9;18
94;27.06.2018;2018;06;21;Keskiviikko;2;5;7
94;27.06.2018;2018;06;22;Keskiviikko;2;5;7
94;27.06.2018;2018;06;23;Keskiviikko;2;1;3
94;28.06.2018;2018;06;00;Torstai;0;0;0
94;28.06.2018;2018;06;01;Torstai;0;1;1
94;28.06.2018;2018;06;02;Torstai;0;0;0
94;28.06.2018;2018;06;03;Torstai;0;0;0
94;28.06.2018;2018;06;04;Torstai;1;0;1
94;28.06.2018;2018;06;05;Torstai;3;2;5
94;28.06.2018;2018;06;06;Torstai;9;0;9
94;28.06.2018;2018;06;07;Torstai;9;2;11
94;28.06.2018;2018;06;08;Torstai;7;2;9
94;28.06.2018;2018;06;09;Torstai;5;1;6
94;28.06.2018;2018;06;10;Torstai;3;0;3
94;28.06.2018;2018;06;11;Torstai;3;0;3
94;28.06.2018;2018;06;12;Torstai;0;0;0
94;28.06.2018;2018;06;13;Torstai;1;4;5
94;28.06.2018;2018;06;14;Torstai;1;3;4
94;28.06.2018;2018;06;15;Torstai;1;11;12
94;28.06.2018;2018;06;16;Torstai;1;8;9
94;28.06.2018;2018;06;17;Torstai;4;4;8
94;28.06.2018;2018;06;18;Torstai;1;4;5
94;28.06.2018;2018;06;19;Torstai;1;2;3
94;28.06.2018;2018;06;20;Torstai;0;5;5
94;28.06.2018;2018;06;21;Torstai;1;0;1
94;28.06.2018;2018;06;22;Torstai;1;1;2
94;28.06.2018;2018;06;23;Torstai;1;0;1
94;29.06.2018;2018;06;00;Perjantai;0;0;0
94;29.06.2018;2018;06;01;Perjantai;0;0;0
94;29.06.2018;2018;06;02;Perjantai;1;0;1
94;29.06.2018;2018;06;03;Perjantai;0;1;1
94;29.06.2018;2018;06;04;Perjantai;2;0;2
94;29.06.2018;2018;06;05;Perjantai;4;2;6
94;29.06.2018;2018;06;06;Perjantai;12;2;14
94;29.06.2018;2018;06;07;Perjantai;11;4;15
94;29.06.2018;2018;06;08;Perjantai;4;2;6
94;29.06.2018;2018;06;09;Perjantai;1;4;5
94;29.06.2018;2018;06;10;Perjantai;9;3;12
94;29.06.2018;2018;06;11;Perjantai;4;6;10
94;29.06.2018;2018;06;12;Perjantai;4;8;12
94;29.06.2018;2018;06;13;Perjantai;5;5;10
94;29.06.2018;2018;06;14;Perjantai;10;11;21
94;29.06.2018;2018;06;15;Perjantai;7;14;21
94;29.06.2018;2018;06;16;Perjantai;7;20;27
94;29.06.2018;2018;06;17;Perjantai;9;6;15
94;29.06.2018;2018;06;18;Perjantai;7;7;14
94;29.06.2018;2018;06;19;Perjantai;4;8;12
94;29.06.2018;2018;06;20;Perjantai;7;4;11
94;29.06.2018;2018;06;21;Perjantai;2;3;5
94;29.06.2018;2018;06;22;Perjantai;1;2;3
94;29.06.2018;2018;06;23;Perjantai;0;0;0
94;30.06.2018;2018;06;00;Lauantai;0;0;0
94;30.06.2018;2018;06;01;Lauantai;2;1;3
94;30.06.2018;2018;06;02;Lauantai;2;0;2
94;30.06.2018;2018;06;03;Lauantai;0;0;0
94;30.06.2018;2018;06;04;Lauantai;0;0;0
94;30.06.2018;2018;06;05;Lauantai;2;1;3
94;30.06.2018;2018;06;06;Lauantai;0;0;0
94;30.06.2018;2018;06;07;Lauantai;0;1;1
94;30.06.2018;2018;06;08;Lauantai;2;0;2
94;30.06.2018;2018;06;09;Lauantai;5;3;8
94;30.06.2018;2018;06;10;Lauantai;9;8;17
94;30.06.2018;2018;06;11;Lauantai;9;9;18
94;30.06.2018;2018;06;12;Lauantai;11;9;20
94;30.06.2018;2018;06;13;Lauantai;14;9;23
94;30.06.2018;2018;06;14;Lauantai;5;6;11
94;30.06.2018;2018;06;15;Lauantai;5;8;13
94;30.06.2018;2018;06;16;Lauantai;8;5;13
94;30.06.2018;2018;06;17;Lauantai;12;5;17
94;30.06.2018;2018;06;18;Lauantai;2;8;10
94;30.06.2018;2018;06;19;Lauantai;5;5;10
94;30.06.2018;2018;06;20;Lauantai;4;3;7
94;30.06.2018;2018;06;21;Lauantai;3;6;9
94;30.06.2018;2018;06;22;Lauantai;0;2;2
94;30.06.2018;2018;06;23;Lauantai;1;1;2
94;01.07.2018;2018;07;00;Sunnuntai;3;6;9
94;01.07.2018;2018;07;01;Sunnuntai;0;1;1
94;01.07.2018;2018;07;02;Sunnuntai;1;1;2
94;01.07.2018;2018;07;03;Sunnuntai;0;0;0
94;01.07.2018;2018;07;04;Sunnuntai;1;0;1
94;01.07.2018;2018;07;05;Sunnuntai;0;3;3
94;01.07.2018;2018;07;06;Sunnuntai;0;0;0
94;01.07.2018;2018;07;07;Sunnuntai;2;1;3
94;01.07.2018;2018;07;08;Sunnuntai;2;0;2
94;01.07.2018;2018;07;09;Sunnuntai;4;4;8
94;01.07.2018;2018;07;10;Sunnuntai;8;7;15
94;01.07.2018;2018;07;11;Sunnuntai;16;13;29
94;01.07.2018;2018;07;12;Sunnuntai;20;18;38
94;01.07.2018;2018;07;13;Sunnuntai;19;22;41
94;01.07.2018;2018;07;14;Sunnuntai;25;20;45
94;01.07.2018;2018;07;15;Sunnuntai;16;14;30
94;01.07.2018;2018;07;16;Sunnuntai;14;7;21
94;01.07.2018;2018;07;17;Sunnuntai;13;15;28
94;01.07.2018;2018;07;18;Sunnuntai;2;12;14
94;01.07.2018;2018;07;19;Sunnuntai;7;13;20
94;01.07.2018;2018;07;20;Sunnuntai;8;3;11
94;01.07.2018;2018;07;21;Sunnuntai;1;8;9
94;01.07.2018;2018;07;22;Sunnuntai;3;1;4
94;01.07.2018;2018;07;23;Sunnuntai;0;0;0
94;02.07.2018;2018;07;00;Maanantai;1;0;1
94;02.07.2018;2018;07;01;Maanantai;0;0;0
94;02.07.2018;2018;07;02;Maanantai;1;0;1
94;02.07.2018;2018;07;03;Maanantai;0;0;0
94;02.07.2018;2018;07;04;Maanantai;0;2;2
94;02.07.2018;2018;07;05;Maanantai;5;4;9
94;02.07.2018;2018;07;06;Maanantai;22;1;23
94;02.07.2018;2018;07;07;Maanantai;22;3;25
94;02.07.2018;2018;07;08;Maanantai;10;4;14
94;02.07.2018;2018;07;09;Maanantai;7;5;12
94;02.07.2018;2018;07;10;Maanantai;5;8;13
94;02.07.2018;2018;07;11;Maanantai;9;5;14
94;02.07.2018;2018;07;12;Maanantai;7;11;18
94;02.07.2018;2018;07;13;Maanantai;18;3;21
94;02.07.2018;2018;07;14;Maanantai;11;20;31
94;02.07.2018;2018;07;15;Maanantai;13;24;37
94;02.07.2018;2018;07;16;Maanantai;12;41;53
94;02.07.2018;2018;07;17;Maanantai;8;25;33
94;02.07.2018;2018;07;18;Maanantai;16;22;38
94;02.07.2018;2018;07;19;Maanantai;16;7;23
94;02.07.2018;2018;07;20;Maanantai;21;17;38
94;02.07.2018;2018;07;21;Maanantai;11;3;14
94;02.07.2018;2018;07;22;Maanantai;3;7;10
94;02.07.2018;2018;07;23;Maanantai;0;2;2
94;03.07.2018;2018;07;00;Tiistai;2;2;4
94;03.07.2018;2018;07;01;Tiistai;0;1;1
94;03.07.2018;2018;07;02;Tiistai;1;0;1
94;03.07.2018;2018;07;03;Tiistai;0;0;0
94;03.07.2018;2018;07;04;Tiistai;1;1;2
94;03.07.2018;2018;07;05;Tiistai;5;2;7
94;03.07.2018;2018;07;06;Tiistai;23;1;24
94;03.07.2018;2018;07;07;Tiistai;19;6;25
94;03.07.2018;2018;07;08;Tiistai;13;4;17
94;03.07.2018;2018;07;09;Tiistai;3;3;6
94;03.07.2018;2018;07;10;Tiistai;11;7;18
94;03.07.2018;2018;07;11;Tiistai;13;5;18
94;03.07.2018;2018;07;12;Tiistai;4;4;8
94;03.07.2018;2018;07;13;Tiistai;11;9;20
94;03.07.2018;2018;07;14;Tiistai;13;17;30
94;03.07.2018;2018;07;15;Tiistai;18;19;37
94;03.07.2018;2018;07;16;Tiistai;15;29;44
94;03.07.2018;2018;07;17;Tiistai;4;26;30
94;03.07.2018;2018;07;18;Tiistai;6;19;25
94;03.07.2018;2018;07;19;Tiistai;18;12;30
94;03.07.2018;2018;07;20;Tiistai;11;9;20
94;03.07.2018;2018;07;21;Tiistai;0;3;3
94;03.07.2018;2018;07;22;Tiistai;3;5;8
94;03.07.2018;2018;07;23;Tiistai;2;1;3
94;04.07.2018;2018;07;00;Keskiviikko;0;0;0
94;04.07.2018;2018;07;01;Keskiviikko;0;0;0
94;04.07.2018;2018;07;02;Keskiviikko;0;0;0
94;04.07.2018;2018;07;03;Keskiviikko;0;0;0
94;04.07.2018;2018;07;04;Keskiviikko;0;1;1
94;04.07.2018;2018;07;05;Keskiviikko;4;2;6
94;04.07.2018;2018;07;06;Keskiviikko;8;0;8
94;04.07.2018;2018;07;07;Keskiviikko;8;2;10
94;04.07.2018;2018;07;08;Keskiviikko;4;1;5
94;04.07.2018;2018;07;09;Keskiviikko;1;4;5
94;04.07.2018;2018;07;10;Keskiviikko;1;2;3
94;04.07.2018;2018;07;11;Keskiviikko;0;1;1
94;04.07.2018;2018;07;12;Keskiviikko;3;1;4
94;04.07.2018;2018;07;13;Keskiviikko;4;3;7
94;04.07.2018;2018;07;14;Keskiviikko;6;7;13
94;04.07.2018;2018;07;15;Keskiviikko;5;9;14
94;04.07.2018;2018;07;16;Keskiviikko;6;17;23
94;04.07.2018;2018;07;17;Keskiviikko;2;11;13
94;04.07.2018;2018;07;18;Keskiviikko;5;12;17
94;04.07.2018;2018;07;19;Keskiviikko;10;8;18
94;04.07.2018;2018;07;20;Keskiviikko;9;3;12
94;04.07.2018;2018;07;21;Keskiviikko;3;5;8
94;04.07.2018;2018;07;22;Keskiviikko;3;3;6
94;04.07.2018;2018;07;23;Keskiviikko;2;5;7
94;05.07.2018;2018;07;00;Torstai;1;0;1
94;05.07.2018;2018;07;01;Torstai;0;0;0
94;05.07.2018;2018;07;02;Torstai;2;0;2
94;05.07.2018;2018;07;03;Torstai;1;1;2
94;05.07.2018;2018;07;04;Torstai;0;0;0
94;05.07.2018;2018;07;05;Torstai;5;7;12
94;05.07.2018;2018;07;06;Torstai;13;0;13
94;05.07.2018;2018;07;07;Torstai;24;4;28
94;05.07.2018;2018;07;08;Torstai;14;7;21
94;05.07.2018;2018;07;09;Torstai;9;11;20
94;05.07.2018;2018;07;10;Torstai;10;4;14
94;05.07.2018;2018;07;11;Torstai;17;11;28
94;05.07.2018;2018;07;12;Torstai;9;5;14
94;05.07.2018;2018;07;13;Torstai;4;11;15
94;05.07.2018;2018;07;14;Torstai;12;14;26
94;05.07.2018;2018;07;15;Torstai;13;26;39
94;05.07.2018;2018;07;16;Torstai;5;28;33
94;05.07.2018;2018;07;17;Torstai;16;18;34
94;05.07.2018;2018;07;18;Torstai;8;12;20
94;05.07.2018;2018;07;19;Torstai;4;4;8
94;05.07.2018;2018;07;20;Torstai;2;8;10
94;05.07.2018;2018;07;21;Torstai;1;2;3
94;05.07.2018;2018;07;22;Torstai;3;2;5
94;05.07.2018;2018;07;23;Torstai;2;1;3
94;06.07.2018;2018;07;00;Perjantai;0;0;0
94;06.07.2018;2018;07;01;Perjantai;0;0;0
94;06.07.2018;2018;07;02;Perjantai;0;0;0
94;06.07.2018;2018;07;03;Perjantai;2;0;2
94;06.07.2018;2018;07;04;Perjantai;1;2;3
94;06.07.2018;2018;07;05;Perjantai;3;1;4
94;06.07.2018;2018;07;06;Perjantai;16;1;17
94;06.07.2018;2018;07;07;Perjantai;12;5;17
94;06.07.2018;2018;07;08;Perjantai;4;1;5
94;06.07.2018;2018;07;09;Perjantai;4;6;10
94;06.07.2018;2018;07;10;Perjantai;8;5;13
94;06.07.2018;2018;07;11;Perjantai;11;8;19
94;06.07.2018;2018;07;12;Perjantai;8;5;13
94;06.07.2018;2018;07;13;Perjantai;18;8;26
94;06.07.2018;2018;07;14;Perjantai;8;20;28
94;06.07.2018;2018;07;15;Perjantai;9;32;41
94;06.07.2018;2018;07;16;Perjantai;21;12;33
94;06.07.2018;2018;07;17;Perjantai;19;9;28
94;06.07.2018;2018;07;18;Perjantai;8;13;21
94;06.07.2018;2018;07;19;Perjantai;9;10;19
94;06.07.2018;2018;07;20;Perjantai;13;7;20
94;06.07.2018;2018;07;21;Perjantai;5;7;12
94;06.07.2018;2018;07;22;Perjantai;0;4;4
94;06.07.2018;2018;07;23;Perjantai;1;1;2
94;07.07.2018;2018;07;00;Lauantai;2;5;7
94;07.07.2018;2018;07;01;Lauantai;1;2;3
94;07.07.2018;2018;07;02;Lauantai;3;0;3
94;07.07.2018;2018;07;03;Lauantai;0;0;0
94;07.07.2018;2018;07;04;Lauantai;0;0;0
94;07.07.2018;2018;07;05;Lauantai;0;0;0
94;07.07.2018;2018;07;06;Lauantai;2;0;2
94;07.07.2018;2018;07;07;Lauantai;1;5;6
94;07.07.2018;2018;07;08;Lauantai;3;2;5
94;07.07.2018;2018;07;09;Lauantai;2;4;6
94;07.07.2018;2018;07;10;Lauantai;12;5;17
94;07.07.2018;2018;07;11;Lauantai;15;11;26
94;07.07.2018;2018;07;12;Lauantai;14;12;26
94;07.07.2018;2018;07;13;Lauantai;5;11;16
94;07.07.2018;2018;07;14;Lauantai;20;19;39
94;07.07.2018;2018;07;15;Lauantai;13;18;31
94;07.07.2018;2018;07;16;Lauantai;7;9;16
94;07.07.2018;2018;07;17;Lauantai;15;14;29
94;07.07.2018;2018;07;18;Lauantai;11;13;24
94;07.07.2018;2018;07;19;Lauantai;22;9;31
94;07.07.2018;2018;07;20;Lauantai;6;2;8
94;07.07.2018;2018;07;21;Lauantai;6;8;14
94;07.07.2018;2018;07;22;Lauantai;4;4;8
94;07.07.2018;2018;07;23;Lauantai;3;1;4
94;08.07.2018;2018;07;00;Sunnuntai;2;2;4
94;08.07.2018;2018;07;01;Sunnuntai;1;2;3
94;08.07.2018;2018;07;02;Sunnuntai;0;0;0
94;08.07.2018;2018;07;03;Sunnuntai;0;0;0
94;08.07.2018;2018;07;04;Sunnuntai;0;1;1
94;08.07.2018;2018;07;05;Sunnuntai;0;0;0
94;08.07.2018;2018;07;06;Sunnuntai;1;1;2
94;08.07.2018;2018;07;07;Sunnuntai;1;2;3
94;08.07.2018;2018;07;08;Sunnuntai;1;1;2
94;08.07.2018;2018;07;09;Sunnuntai;9;6;15
94;08.07.2018;2018;07;10;Sunnuntai;6;9;15
94;08.07.2018;2018;07;11;Sunnuntai;7;18;25
94;08.07.2018;2018;07;12;Sunnuntai;18;20;38
94;08.07.2018;2018;07;13;Sunnuntai;10;12;22
94;08.07.2018;2018;07;14;Sunnuntai;11;13;24
94;08.07.2018;2018;07;15;Sunnuntai;25;11;36
94;08.07.2018;2018;07;16;Sunnuntai;5;13;18
94;08.07.2018;2018;07;17;Sunnuntai;21;12;33
94;08.07.2018;2018;07;18;Sunnuntai;16;15;31
94;08.07.2018;2018;07;19;Sunnuntai;11;12;23
94;08.07.2018;2018;07;20;Sunnuntai;15;16;31
94;08.07.2018;2018;07;21;Sunnuntai;12;11;23
94;08.07.2018;2018;07;22;Sunnuntai;2;6;8
94;08.07.2018;2018;07;23;Sunnuntai;5;2;7
94;09.07.2018;2018;07;00;Maanantai;0;1;1
94;09.07.2018;2018;07;01;Maanantai;0;1;1
94;09.07.2018;2018;07;02;Maanantai;4;1;5
94;09.07.2018;2018;07;03;Maanantai;0;3;3
94;09.07.2018;2018;07;04;Maanantai;1;0;1
94;09.07.2018;2018;07;05;Maanantai;5;2;7
94;09.07.2018;2018;07;06;Maanantai;22;2;24
94;09.07.2018;2018;07;07;Maanantai;20;7;27
94;09.07.2018;2018;07;08;Maanantai;10;1;11
94;09.07.2018;2018;07;09;Maanantai;3;3;6
94;09.07.2018;2018;07;10;Maanantai;6;11;17
94;09.07.2018;2018;07;11;Maanantai;8;9;17
94;09.07.2018;2018;07;12;Maanantai;12;13;25
94;09.07.2018;2018;07;13;Maanantai;12;8;20
94;09.07.2018;2018;07;14;Maanantai;14;9;23
94;09.07.2018;2018;07;15;Maanantai;20;25;45
94;09.07.2018;2018;07;16;Maanantai;16;43;59
94;09.07.2018;2018;07;17;Maanantai;15;28;43
94;09.07.2018;2018;07;18;Maanantai;22;15;37
94;09.07.2018;2018;07;19;Maanantai;12;24;36
94;09.07.2018;2018;07;20;Maanantai;3;11;14
94;09.07.2018;2018;07;21;Maanantai;6;9;15
94;09.07.2018;2018;07;22;Maanantai;5;9;14
94;09.07.2018;2018;07;23;Maanantai;3;3;6
94;10.07.2018;2018;07;00;Tiistai;0;0;0
94;10.07.2018;2018;07;01;Tiistai;0;1;1
94;10.07.2018;2018;07;02;Tiistai;1;0;1
94;10.07.2018;2018;07;03;Tiistai;0;1;1
94;10.07.2018;2018;07;04;Tiistai;0;0;0
94;10.07.2018;2018;07;05;Tiistai;7;2;9
94;10.07.2018;2018;07;06;Tiistai;21;1;22
94;10.07.2018;2018;07;07;Tiistai;27;3;30
94;10.07.2018;2018;07;08;Tiistai;12;4;16
94;10.07.2018;2018;07;09;Tiistai;12;5;17
94;10.07.2018;2018;07;10;Tiistai;19;9;28
94;10.07.2018;2018;07;11;Tiistai;14;13;27
94;10.07.2018;2018;07;12;Tiistai;18;13;31
94;10.07.2018;2018;07;13;Tiistai;20;12;32
94;10.07.2018;2018;07;14;Tiistai;7;14;21
94;10.07.2018;2018;07;15;Tiistai;14;21;35
94;10.07.2018;2018;07;16;Tiistai;13;43;56
94;10.07.2018;2018;07;17;Tiistai;26;31;57
94;10.07.2018;2018;07;18;Tiistai;11;21;32
94;10.07.2018;2018;07;19;Tiistai;11;28;39
94;10.07.2018;2018;07;20;Tiistai;18;17;35
94;10.07.2018;2018;07;21;Tiistai;10;10;20
94;10.07.2018;2018;07;22;Tiistai;4;8;12
94;10.07.2018;2018;07;23;Tiistai;2;5;7
94;11.07.2018;2018;07;00;Keskiviikko;0;1;1
94;11.07.2018;2018;07;01;Keskiviikko;0;1;1
94;11.07.2018;2018;07;02;Keskiviikko;1;0;1
94;11.07.2018;2018;07;03;Keskiviikko;0;0;0
94;11.07.2018;2018;07;04;Keskiviikko;1;0;1
94;11.07.2018;2018;07;05;Keskiviikko;8;3;11
94;11.07.2018;2018;07;06;Keskiviikko;21;1;22
94;11.07.2018;2018;07;07;Keskiviikko;26;4;30
94;11.07.2018;2018;07;08;Keskiviikko;9;3;12
94;11.07.2018;2018;07;09;Keskiviikko;8;7;15
94;11.07.2018;2018;07;10;Keskiviikko;15;4;19
94;11.07.2018;2018;07;11;Keskiviikko;13;15;28
94;11.07.2018;2018;07;12;Keskiviikko;6;14;20
94;11.07.2018;2018;07;13;Keskiviikko;19;13;32
94;11.07.2018;2018;07;14;Keskiviikko;12;18;30
94;11.07.2018;2018;07;15;Keskiviikko;15;24;39
94;11.07.2018;2018;07;16;Keskiviikko;10;36;46
94;11.07.2018;2018;07;17;Keskiviikko;10;28;38
94;11.07.2018;2018;07;18;Keskiviikko;18;25;43
94;11.07.2018;2018;07;19;Keskiviikko;16;18;34
94;11.07.2018;2018;07;20;Keskiviikko;13;12;25
94;11.07.2018;2018;07;21;Keskiviikko;8;7;15
94;11.07.2018;2018;07;22;Keskiviikko;3;4;7
94;11.07.2018;2018;07;23;Keskiviikko;1;0;1
94;12.07.2018;2018;07;00;Torstai;1;1;2
94;12.07.2018;2018;07;01;Torstai;0;1;1
94;12.07.2018;2018;07;02;Torstai;1;0;1
94;12.07.2018;2018;07;03;Torstai;0;1;1
94;12.07.2018;2018;07;04;Torstai;2;1;3
94;12.07.2018;2018;07;05;Torstai;9;1;10
94;12.07.2018;2018;07;06;Torstai;14;1;15
94;12.07.2018;2018;07;07;Torstai;27;1;28
94;12.07.2018;2018;07;08;Torstai;9;1;10
94;12.07.2018;2018;07;09;Torstai;4;14;18
94;12.07.2018;2018;07;10;Torstai;6;9;15
94;12.07.2018;2018;07;11;Torstai;14;13;27
94;12.07.2018;2018;07;12;Torstai;8;10;18
94;12.07.2018;2018;07;13;Torstai;20;6;26
94;12.07.2018;2018;07;14;Torstai;20;31;51
94;12.07.2018;2018;07;15;Torstai;16;27;43
94;12.07.2018;2018;07;16;Torstai;13;26;39
94;12.07.2018;2018;07;17;Torstai;19;16;35
94;12.07.2018;2018;07;18;Torstai;12;27;39
94;12.07.2018;2018;07;19;Torstai;20;24;44
94;12.07.2018;2018;07;20;Torstai;15;14;29
94;12.07.2018;2018;07;21;Torstai;7;12;19
94;12.07.2018;2018;07;22;Torstai;2;4;6
94;12.07.2018;2018;07;23;Torstai;2;2;4
94;13.07.2018;2018;07;00;Perjantai;1;0;1
94;13.07.2018;2018;07;01;Perjantai;0;0;0
94;13.07.2018;2018;07;02;Perjantai;0;2;2
94;13.07.2018;2018;07;03;Perjantai;0;1;1
94;13.07.2018;2018;07;04;Perjantai;1;1;2
94;13.07.2018;2018;07;05;Perjantai;5;2;7
94;13.07.2018;2018;07;06;Perjantai;19;1;20
94;13.07.2018;2018;07;07;Perjantai;15;2;17
94;13.07.2018;2018;07;08;Perjantai;9;7;16
94;13.07.2018;2018;07;09;Perjantai;6;4;10
94;13.07.2018;2018;07;10;Perjantai;9;11;20
94;13.07.2018;2018;07;11;Perjantai;5;8;13
94;13.07.2018;2018;07;12;Perjantai;18;5;23
94;13.07.2018;2018;07;13;Perjantai;16;15;31
94;13.07.2018;2018;07;14;Perjantai;7;9;16
94;13.07.2018;2018;07;15;Perjantai;10;21;31
94;13.07.2018;2018;07;16;Perjantai;15;15;30
94;13.07.2018;2018;07;17;Perjantai;16;18;34
94;13.07.2018;2018;07;18;Perjantai;11;13;24
94;13.07.2018;2018;07;19;Perjantai;8;13;21
94;13.07.2018;2018;07;20;Perjantai;9;10;19
94;13.07.2018;2018;07;21;Perjantai;10;9;19
94;13.07.2018;2018;07;22;Perjantai;2;13;15
94;13.07.2018;2018;07;23;Perjantai;0;6;6
94;14.07.2018;2018;07;00;Lauantai;1;3;4
94;14.07.2018;2018;07;01;Lauantai;0;4;4
94;14.07.2018;2018;07;02;Lauantai;4;2;6
94;14.07.2018;2018;07;03;Lauantai;0;0;0
94;14.07.2018;2018;07;04;Lauantai;0;1;1
94;14.07.2018;2018;07;05;Lauantai;1;1;2
94;14.07.2018;2018;07;06;Lauantai;2;1;3
94;14.07.2018;2018;07;07;Lauantai;0;2;2
94;14.07.2018;2018;07;08;Lauantai;3;2;5
94;14.07.2018;2018;07;09;Lauantai;4;7;11
94;14.07.2018;2018;07;10;Lauantai;3;3;6
94;14.07.2018;2018;07;11;Lauantai;10;5;15
94;14.07.2018;2018;07;12;Lauantai;19;11;30
94;14.07.2018;2018;07;13;Lauantai;14;10;24
94;14.07.2018;2018;07;14;Lauantai;11;10;21
94;14.07.2018;2018;07;15;Lauantai;5;10;15
94;14.07.2018;2018;07;16;Lauantai;14;16;30
94;14.07.2018;2018;07;17;Lauantai;12;8;20
94;14.07.2018;2018;07;18;Lauantai;8;8;16
94;14.07.2018;2018;07;19;Lauantai;8;10;18
94;14.07.2018;2018;07;20;Lauantai;14;3;17
94;14.07.2018;2018;07;21;Lauantai;7;8;15
94;14.07.2018;2018;07;22;Lauantai;2;6;8
94;14.07.2018;2018;07;23;Lauantai;0;7;7
94;15.07.2018;2018;07;00;Sunnuntai;3;3;6
94;15.07.2018;2018;07;01;Sunnuntai;0;5;5
94;15.07.2018;2018;07;02;Sunnuntai;0;1;1
94;15.07.2018;2018;07;03;Sunnuntai;1;1;2
94;15.07.2018;2018;07;04;Sunnuntai;0;1;1
94;15.07.2018;2018;07;05;Sunnuntai;0;6;6
94;15.07.2018;2018;07;06;Sunnuntai;1;2;3
94;15.07.2018;2018;07;07;Sunnuntai;2;2;4
94;15.07.2018;2018;07;08;Sunnuntai;6;2;8
94;15.07.2018;2018;07;09;Sunnuntai;7;11;18
94;15.07.2018;2018;07;10;Sunnuntai;17;18;35
94;15.07.2018;2018;07;11;Sunnuntai;8;8;16
94;15.07.2018;2018;07;12;Sunnuntai;15;23;38
94;15.07.2018;2018;07;13;Sunnuntai;14;22;36
94;15.07.2018;2018;07;14;Sunnuntai;16;22;38
94;15.07.2018;2018;07;15;Sunnuntai;8;15;23
94;15.07.2018;2018;07;16;Sunnuntai;16;13;29
94;15.07.2018;2018;07;17;Sunnuntai;9;11;20
94;15.07.2018;2018;07;18;Sunnuntai;12;11;23
94;15.07.2018;2018;07;19;Sunnuntai;8;5;13
94;15.07.2018;2018;07;20;Sunnuntai;10;12;22
94;15.07.2018;2018;07;21;Sunnuntai;14;3;17
94;15.07.2018;2018;07;22;Sunnuntai;1;3;4
94;15.07.2018;2018;07;23;Sunnuntai;3;1;4
94;16.07.2018;2018;07;00;Maanantai;2;0;2
94;16.07.2018;2018;07;01;Maanantai;1;0;1
94;16.07.2018;2018;07;02;Maanantai;0;3;3
94;16.07.2018;2018;07;03;Maanantai;0;0;0
94;16.07.2018;2018;07;04;Maanantai;0;0;0
94;16.07.2018;2018;07;05;Maanantai;7;2;9
94;16.07.2018;2018;07;06;Maanantai;17;1;18
94;16.07.2018;2018;07;07;Maanantai;24;2;26
94;16.07.2018;2018;07;08;Maanantai;7;8;15
94;16.07.2018;2018;07;09;Maanantai;4;7;11
94;16.07.2018;2018;07;10;Maanantai;8;5;13
94;16.07.2018;2018;07;11;Maanantai;11;5;16
94;16.07.2018;2018;07;12;Maanantai;10;11;21
94;16.07.2018;2018;07;13;Maanantai;15;12;27
94;16.07.2018;2018;07;14;Maanantai;9;16;25
94;16.07.2018;2018;07;15;Maanantai;4;26;30
94;16.07.2018;2018;07;16;Maanantai;18;30;48
94;16.07.2018;2018;07;17;Maanantai;8;21;29
94;16.07.2018;2018;07;18;Maanantai;14;19;33
94;16.07.2018;2018;07;19;Maanantai;17;11;28
94;16.07.2018;2018;07;20;Maanantai;15;14;29
94;16.07.2018;2018;07;21;Maanantai;10;11;21
94;16.07.2018;2018;07;22;Maanantai;7;3;10
94;16.07.2018;2018;07;23;Maanantai;0;6;6
94;17.07.2018;2018;07;00;Tiistai;1;3;4
94;17.07.2018;2018;07;01;Tiistai;1;0;1
94;17.07.2018;2018;07;02;Tiistai;0;0;0
94;17.07.2018;2018;07;03;Tiistai;0;1;1
94;17.07.2018;2018;07;04;Tiistai;1;0;1
94;17.07.2018;2018;07;05;Tiistai;8;3;11
94;17.07.2018;2018;07;06;Tiistai;22;0;22
94;17.07.2018;2018;07;07;Tiistai;21;1;22
94;17.07.2018;2018;07;08;Tiistai;11;4;15
94;17.07.2018;2018;07;09;Tiistai;3;6;9
94;17.07.2018;2018;07;10;Tiistai;10;12;22
94;17.07.2018;2018;07;11;Tiistai;13;5;18
94;17.07.2018;2018;07;12;Tiistai;17;8;25
94;17.07.2018;2018;07;13;Tiistai;14;15;29
94;17.07.2018;2018;07;14;Tiistai;15;22;37
94;17.07.2018;2018;07;15;Tiistai;11;18;29
94;17.07.2018;2018;07;16;Tiistai;14;21;35
94;17.07.2018;2018;07;17;Tiistai;11;27;38
94;17.07.2018;2018;07;18;Tiistai;13;20;33
94;17.07.2018;2018;07;19;Tiistai;15;7;22
94;17.07.2018;2018;07;20;Tiistai;5;10;15
94;17.07.2018;2018;07;21;Tiistai;10;17;27
94;17.07.2018;2018;07;22;Tiistai;2;8;10
94;17.07.2018;2018;07;23;Tiistai;2;4;6
94;18.07.2018;2018;07;00;Keskiviikko;4;0;4
94;18.07.2018;2018;07;01;Keskiviikko;4;2;6
94;18.07.2018;2018;07;02;Keskiviikko;0;4;4
94;18.07.2018;2018;07;03;Keskiviikko;0;1;1
94;18.07.2018;2018;07;04;Keskiviikko;2;1;3
94;18.07.2018;2018;07;05;Keskiviikko;5;3;8
94;18.07.2018;2018;07;06;Keskiviikko;19;3;22
94;18.07.2018;2018;07;07;Keskiviikko;17;4;21
94;18.07.2018;2018;07;08;Keskiviikko;7;0;7
94;18.07.2018;2018;07;09;Keskiviikko;5;6;11
94;18.07.2018;2018;07;10;Keskiviikko;12;9;21
94;18.07.2018;2018;07;11;Keskiviikko;5;8;13
94;18.07.2018;2018;07;12;Keskiviikko;6;9;15
94;18.07.2018;2018;07;13;Keskiviikko;12;12;24
94;18.07.2018;2018;07;14;Keskiviikko;17;20;37
94;18.07.2018;2018;07;15;Keskiviikko;8;13;21
94;18.07.2018;2018;07;16;Keskiviikko;7;23;30
94;18.07.2018;2018;07;17;Keskiviikko;19;12;31
94;18.07.2018;2018;07;18;Keskiviikko;10;22;32
94;18.07.2018;2018;07;19;Keskiviikko;9;8;17
94;18.07.2018;2018;07;20;Keskiviikko;10;13;23
94;18.07.2018;2018;07;21;Keskiviikko;12;8;20
94;18.07.2018;2018;07;22;Keskiviikko;7;6;13
94;18.07.2018;2018;07;23;Keskiviikko;1;1;2
94;19.07.2018;2018;07;00;Torstai;1;0;1
94;19.07.2018;2018;07;01;Torstai;0;0;0
94;19.07.2018;2018;07;02;Torstai;0;2;2
94;19.07.2018;2018;07;03;Torstai;0;1;1
94;19.07.2018;2018;07;04;Torstai;0;0;0
94;19.07.2018;2018;07;05;Torstai;6;4;10
94;19.07.2018;2018;07;06;Torstai;14;3;17
94;19.07.2018;2018;07;07;Torstai;24;1;25
94;19.07.2018;2018;07;08;Torstai;14;4;18
94;19.07.2018;2018;07;09;Torstai;2;5;7
94;19.07.2018;2018;07;10;Torstai;14;5;19
94;19.07.2018;2018;07;11;Torstai;10;6;16
94;19.07.2018;2018;07;12;Torstai;14;5;19
94;19.07.2018;2018;07;13;Torstai;15;10;25
94;19.07.2018;2018;07;14;Torstai;7;13;20
94;19.07.2018;2018;07;15;Torstai;15;31;46
94;19.07.2018;2018;07;16;Torstai;11;31;42
94;19.07.2018;2018;07;17;Torstai;11;11;22
94;19.07.2018;2018;07;18;Torstai;11;21;32
94;19.07.2018;2018;07;19;Torstai;10;19;29
94;19.07.2018;2018;07;20;Torstai;3;10;13
94;19.07.2018;2018;07;21;Torstai;10;10;20
94;19.07.2018;2018;07;22;Torstai;5;11;16
94;19.07.2018;2018;07;23;Torstai;1;4;5
94;20.07.2018;2018;07;00;Perjantai;3;2;5
94;20.07.2018;2018;07;01;Perjantai;0;2;2
94;20.07.2018;2018;07;02;Perjantai;0;1;1
94;20.07.2018;2018;07;03;Perjantai;0;1;1
94;20.07.2018;2018;07;04;Perjantai;1;1;2
94;20.07.2018;2018;07;05;Perjantai;4;5;9
94;20.07.2018;2018;07;06;Perjantai;13;3;16
94;20.07.2018;2018;07;07;Perjantai;15;2;17
94;20.07.2018;2018;07;08;Perjantai;12;6;18
94;20.07.2018;2018;07;09;Perjantai;9;2;11
94;20.07.2018;2018;07;10;Perjantai;6;5;11
94;20.07.2018;2018;07;11;Perjantai;11;6;17
94;20.07.2018;2018;07;12;Perjantai;4;10;14
94;20.07.2018;2018;07;13;Perjantai;14;11;25
94;20.07.2018;2018;07;14;Perjantai;12;16;28
94;20.07.2018;2018;07;15;Perjantai;9;29;38
94;20.07.2018;2018;07;16;Perjantai;13;20;33
94;20.07.2018;2018;07;17;Perjantai;8;16;24
94;20.07.2018;2018;07;18;Perjantai;4;10;14
94;20.07.2018;2018;07;19;Perjantai;21;13;34
94;20.07.2018;2018;07;20;Perjantai;10;6;16
94;20.07.2018;2018;07;21;Perjantai;6;11;17
94;20.07.2018;2018;07;22;Perjantai;4;4;8
94;20.07.2018;2018;07;23;Perjantai;2;5;7
94;21.07.2018;2018;07;00;Lauantai;4;2;6
94;21.07.2018;2018;07;01;Lauantai;0;5;5
94;21.07.2018;2018;07;02;Lauantai;1;2;3
94;21.07.2018;2018;07;03;Lauantai;0;0;0
94;21.07.2018;2018;07;04;Lauantai;1;1;2
94;21.07.2018;2018;07;05;Lauantai;1;2;3
94;21.07.2018;2018;07;06;Lauantai;2;0;2
94;21.07.2018;2018;07;07;Lauantai;1;6;7
94;21.07.2018;2018;07;08;Lauantai;7;2;9
94;21.07.2018;2018;07;09;Lauantai;8;10;18
94;21.07.2018;2018;07;10;Lauantai;8;11;19
94;21.07.2018;2018;07;11;Lauantai;3;6;9
94;21.07.2018;2018;07;12;Lauantai;6;6;12
94;21.07.2018;2018;07;13;Lauantai;6;4;10
94;21.07.2018;2018;07;14;Lauantai;11;6;17
94;21.07.2018;2018;07;15;Lauantai;9;13;22
94;21.07.2018;2018;07;16;Lauantai;9;7;16
94;21.07.2018;2018;07;17;Lauantai;15;5;20
94;21.07.2018;2018;07;18;Lauantai;7;7;14
94;21.07.2018;2018;07;19;Lauantai;6;7;13
94;21.07.2018;2018;07;20;Lauantai;8;4;12
94;21.07.2018;2018;07;21;Lauantai;4;14;18
94;21.07.2018;2018;07;22;Lauantai;2;6;8
94;21.07.2018;2018;07;23;Lauantai;1;5;6
94;22.07.2018;2018;07;00;Sunnuntai;1;1;2
94;22.07.2018;2018;07;01;Sunnuntai;0;6;6
94;22.07.2018;2018;07;02;Sunnuntai;1;1;2
94;22.07.2018;2018;07;03;Sunnuntai;0;0;0
94;22.07.2018;2018;07;04;Sunnuntai;0;0;0
94;22.07.2018;2018;07;05;Sunnuntai;1;0;1
94;22.07.2018;2018;07;06;Sunnuntai;0;0;0
94;22.07.2018;2018;07;07;Sunnuntai;1;1;2
94;22.07.2018;2018;07;08;Sunnuntai;2;2;4
94;22.07.2018;2018;07;09;Sunnuntai;4;2;6
94;22.07.2018;2018;07;10;Sunnuntai;9;3;12
94;22.07.2018;2018;07;11;Sunnuntai;11;7;18
94;22.07.2018;2018;07;12;Sunnuntai;7;9;16
94;22.07.2018;2018;07;13;Sunnuntai;8;6;14
94;22.07.2018;2018;07;14;Sunnuntai;8;7;15
94;22.07.2018;2018;07;15;Sunnuntai;2;8;10
94;22.07.2018;2018;07;16;Sunnuntai;7;1;8
94;22.07.2018;2018;07;17;Sunnuntai;0;2;2
94;22.07.2018;2018;07;18;Sunnuntai;8;7;15
94;22.07.2018;2018;07;19;Sunnuntai;8;3;11
94;22.07.2018;2018;07;20;Sunnuntai;3;3;6
94;22.07.2018;2018;07;21;Sunnuntai;1;7;8
94;22.07.2018;2018;07;22;Sunnuntai;1;0;1
94;22.07.2018;2018;07;23;Sunnuntai;0;2;2
94;23.07.2018;2018;07;00;Maanantai;2;0;2
94;23.07.2018;2018;07;01;Maanantai;0;0;0
94;23.07.2018;2018;07;02;Maanantai;0;0;0
94;23.07.2018;2018;07;03;Maanantai;0;0;0
94;23.07.2018;2018;07;04;Maanantai;0;0;0
94;23.07.2018;2018;07;05;Maanantai;5;2;7
94;23.07.2018;2018;07;06;Maanantai;10;2;12
94;23.07.2018;2018;07;07;Maanantai;17;3;20
94;23.07.2018;2018;07;08;Maanantai;7;6;13
94;23.07.2018;2018;07;09;Maanantai;5;4;9
94;23.07.2018;2018;07;10;Maanantai;13;5;18
94;23.07.2018;2018;07;11;Maanantai;6;5;11
94;23.07.2018;2018;07;12;Maanantai;8;10;18
94;23.07.2018;2018;07;13;Maanantai;7;7;14
94;23.07.2018;2018;07;14;Maanantai;14;25;39
94;23.07.2018;2018;07;15;Maanantai;10;21;31
94;23.07.2018;2018;07;16;Maanantai;17;21;38
94;23.07.2018;2018;07;17;Maanantai;10;12;22
94;23.07.2018;2018;07;18;Maanantai;18;19;37
94;23.07.2018;2018;07;19;Maanantai;13;25;38
94;23.07.2018;2018;07;20;Maanantai;7;9;16
94;23.07.2018;2018;07;21;Maanantai;12;15;27
94;23.07.2018;2018;07;22;Maanantai;6;5;11
94;23.07.2018;2018;07;23;Maanantai;6;2;8
94;24.07.2018;2018;07;00;Tiistai;1;5;6
94;24.07.2018;2018;07;01;Tiistai;0;1;1
94;24.07.2018;2018;07;02;Tiistai;0;0;0
94;24.07.2018;2018;07;03;Tiistai;0;2;2
94;24.07.2018;2018;07;04;Tiistai;0;0;0
94;24.07.2018;2018;07;05;Tiistai;10;3;13
94;24.07.2018;2018;07;06;Tiistai;17;2;19
94;24.07.2018;2018;07;07;Tiistai;18;5;23
94;24.07.2018;2018;07;08;Tiistai;12;5;17
94;24.07.2018;2018;07;09;Tiistai;8;6;14
94;24.07.2018;2018;07;10;Tiistai;9;16;25
94;24.07.2018;2018;07;11;Tiistai;12;7;19
94;24.07.2018;2018;07;12;Tiistai;20;9;29
94;24.07.2018;2018;07;13;Tiistai;7;16;23
94;24.07.2018;2018;07;14;Tiistai;16;15;31
94;24.07.2018;2018;07;15;Tiistai;13;23;36
94;24.07.2018;2018;07;16;Tiistai;15;30;45
94;24.07.2018;2018;07;17;Tiistai;10;14;24
94;24.07.2018;2018;07;18;Tiistai;8;20;28
94;24.07.2018;2018;07;19;Tiistai;6;18;24
94;24.07.2018;2018;07;20;Tiistai;13;16;29
94;24.07.2018;2018;07;21;Tiistai;16;8;24
94;24.07.2018;2018;07;22;Tiistai;10;7;17
94;24.07.2018;2018;07;23;Tiistai;1;6;7
94;25.07.2018;2018;07;00;Keskiviikko;0;0;0
94;25.07.2018;2018;07;01;Keskiviikko;0;0;0
94;25.07.2018;2018;07;02;Keskiviikko;0;1;1
94;25.07.2018;2018;07;03;Keskiviikko;0;1;1
94;25.07.2018;2018;07;04;Keskiviikko;0;2;2
94;25.07.2018;2018;07;05;Keskiviikko;5;3;8
94;25.07.2018;2018;07;06;Keskiviikko;20;1;21
94;25.07.2018;2018;07;07;Keskiviikko;16;5;21
94;25.07.2018;2018;07;08;Keskiviikko;8;2;10
94;25.07.2018;2018;07;09;Keskiviikko;13;8;21
94;25.07.2018;2018;07;10;Keskiviikko;11;4;15
94;25.07.2018;2018;07;11;Keskiviikko;7;7;14
94;25.07.2018;2018;07;12;Keskiviikko;13;8;21
94;25.07.2018;2018;07;13;Keskiviikko;10;10;20
94;25.07.2018;2018;07;14;Keskiviikko;10;18;28
94;25.07.2018;2018;07;15;Keskiviikko;15;21;36
94;25.07.2018;2018;07;16;Keskiviikko;18;33;51
94;25.07.2018;2018;07;17;Keskiviikko;9;16;25
94;25.07.2018;2018;07;18;Keskiviikko;16;15;31
94;25.07.2018;2018;07;19;Keskiviikko;10;17;27
94;25.07.2018;2018;07;20;Keskiviikko;16;18;34
94;25.07.2018;2018;07;21;Keskiviikko;7;17;24
94;25.07.2018;2018;07;22;Keskiviikko;5;5;10
94;25.07.2018;2018;07;23;Keskiviikko;1;5;6
94;26.07.2018;2018;07;00;Torstai;2;2;4
94;26.07.2018;2018;07;01;Torstai;2;3;5
94;26.07.2018;2018;07;02;Torstai;0;0;0
94;26.07.2018;2018;07;03;Torstai;0;0;0
94;26.07.2018;2018;07;04;Torstai;0;0;0
94;26.07.2018;2018;07;05;Torstai;6;3;9
94;26.07.2018;2018;07;06;Torstai;10;1;11
94;26.07.2018;2018;07;07;Torstai;14;2;16
94;26.07.2018;2018;07;08;Torstai;9;2;11
94;26.07.2018;2018;07;09;Torstai;6;4;10
94;26.07.2018;2018;07;10;Torstai;7;8;15
94;26.07.2018;2018;07;11;Torstai;7;10;17
94;26.07.2018;2018;07;12;Torstai;8;14;22
94;26.07.2018;2018;07;13;Torstai;6;11;17
94;26.07.2018;2018;07;14;Torstai;9;17;26
94;26.07.2018;2018;07;15;Torstai;9;20;29
94;26.07.2018;2018;07;16;Torstai;12;20;32
94;26.07.2018;2018;07;17;Torstai;10;22;32
94;26.07.2018;2018;07;18;Torstai;12;12;24
94;26.07.2018;2018;07;19;Torstai;9;11;20
94;26.07.2018;2018;07;20;Torstai;10;7;17
94;26.07.2018;2018;07;21;Torstai;4;8;12
94;26.07.2018;2018;07;22;Torstai;9;2;11
94;26.07.2018;2018;07;23;Torstai;3;0;3
94;27.07.2018;2018;07;00;Perjantai;1;2;3
94;27.07.2018;2018;07;01;Perjantai;0;0;0
94;27.07.2018;2018;07;02;Perjantai;0;2;2
94;27.07.2018;2018;07;03;Perjantai;0;1;1
94;27.07.2018;2018;07;04;Perjantai;2;0;2
94;27.07.2018;2018;07;05;Perjantai;9;3;12
94;27.07.2018;2018;07;06;Perjantai;15;2;17
94;27.07.2018;2018;07;07;Perjantai;9;4;13
94;27.07.2018;2018;07;08;Perjantai;7;4;11
94;27.07.2018;2018;07;09;Perjantai;5;3;8
94;27.07.2018;2018;07;10;Perjantai;10;14;24
94;27.07.2018;2018;07;11;Perjantai;5;14;19
94;27.07.2018;2018;07;12;Perjantai;10;10;20
94;27.07.2018;2018;07;13;Perjantai;11;15;26
94;27.07.2018;2018;07;14;Perjantai;18;7;25
94;27.07.2018;2018;07;15;Perjantai;6;21;27
94;27.07.2018;2018;07;16;Perjantai;18;18;36
94;27.07.2018;2018;07;17;Perjantai;7;10;17
94;27.07.2018;2018;07;18;Perjantai;20;8;28
94;27.07.2018;2018;07;19;Perjantai;13;12;25
94;27.07.2018;2018;07;20;Perjantai;13;12;25
94;27.07.2018;2018;07;21;Perjantai;3;9;12
94;27.07.2018;2018;07;22;Perjantai;3;5;8
94;27.07.2018;2018;07;23;Perjantai;1;3;4
94;28.07.2018;2018;07;00;Lauantai;1;7;8
94;28.07.2018;2018;07;01;Lauantai;0;1;1
94;28.07.2018;2018;07;02;Lauantai;0;3;3
94;28.07.2018;2018;07;03;Lauantai;1;0;1
94;28.07.2018;2018;07;04;Lauantai;0;1;1
94;28.07.2018;2018;07;05;Lauantai;3;1;4
94;28.07.2018;2018;07;06;Lauantai;2;0;2
94;28.07.2018;2018;07;07;Lauantai;0;1;1
94;28.07.2018;2018;07;08;Lauantai;0;3;3
94;28.07.2018;2018;07;09;Lauantai;2;12;14
94;28.07.2018;2018;07;10;Lauantai;9;12;21
94;28.07.2018;2018;07;11;Lauantai;12;13;25
94;28.07.2018;2018;07;12;Lauantai;13;4;17
94;28.07.2018;2018;07;13;Lauantai;22;16;38
94;28.07.2018;2018;07;14;Lauantai;14;9;23
94;28.07.2018;2018;07;15;Lauantai;11;11;22
94;28.07.2018;2018;07;16;Lauantai;21;13;34
94;28.07.2018;2018;07;17;Lauantai;16;7;23
94;28.07.2018;2018;07;18;Lauantai;16;19;35
94;28.07.2018;2018;07;19;Lauantai;7;9;16
94;28.07.2018;2018;07;20;Lauantai;9;2;11
94;28.07.2018;2018;07;21;Lauantai;15;7;22
94;28.07.2018;2018;07;22;Lauantai;0;8;8
94;28.07.2018;2018;07;23;Lauantai;3;5;8
94;29.07.2018;2018;07;00;Sunnuntai;0;2;2
94;29.07.2018;2018;07;01;Sunnuntai;0;5;5
94;29.07.2018;2018;07;02;Sunnuntai;0;2;2
94;29.07.2018;2018;07;03;Sunnuntai;0;1;1
94;29.07.2018;2018;07;04;Sunnuntai;1;1;2
94;29.07.2018;2018;07;05;Sunnuntai;1;1;2
94;29.07.2018;2018;07;06;Sunnuntai;0;2;2
94;29.07.2018;2018;07;07;Sunnuntai;1;1;2
94;29.07.2018;2018;07;08;Sunnuntai;4;2;6
94;29.07.2018;2018;07;09;Sunnuntai;4;1;5
94;29.07.2018;2018;07;10;Sunnuntai;13;9;22
94;29.07.2018;2018;07;11;Sunnuntai;7;4;11
94;29.07.2018;2018;07;12;Sunnuntai;11;16;27
94;29.07.2018;2018;07;13;Sunnuntai;22;12;34
94;29.07.2018;2018;07;14;Sunnuntai;11;10;21
94;29.07.2018;2018;07;15;Sunnuntai;18;15;33
94;29.07.2018;2018;07;16;Sunnuntai;9;15;24
94;29.07.2018;2018;07;17;Sunnuntai;11;22;33
94;29.07.2018;2018;07;18;Sunnuntai;14;16;30
94;29.07.2018;2018;07;19;Sunnuntai;20;13;33
94;29.07.2018;2018;07;20;Sunnuntai;15;8;23
94;29.07.2018;2018;07;21;Sunnuntai;5;10;15
94;29.07.2018;2018;07;22;Sunnuntai;9;3;12
94;29.07.2018;2018;07;23;Sunnuntai;0;2;2
94;30.07.2018;2018;07;00;Maanantai;1;1;2
94;30.07.2018;2018;07;01;Maanantai;2;0;2
94;30.07.2018;2018;07;02;Maanantai;0;0;0
94;30.07.2018;2018;07;03;Maanantai;0;1;1
94;30.07.2018;2018;07;04;Maanantai;0;1;1
94;30.07.2018;2018;07;05;Maanantai;7;1;8
94;30.07.2018;2018;07;06;Maanantai;20;0;20
94;30.07.2018;2018;07;07;Maanantai;23;2;25
94;30.07.2018;2018;07;08;Maanantai;13;4;17
94;30.07.2018;2018;07;09;Maanantai;3;6;9
94;30.07.2018;2018;07;10;Maanantai;8;7;15
94;30.07.2018;2018;07;11;Maanantai;11;7;18
94;30.07.2018;2018;07;12;Maanantai;9;9;18
94;30.07.2018;2018;07;13;Maanantai;9;9;18
94;30.07.2018;2018;07;14;Maanantai;6;14;20
94;30.07.2018;2018;07;15;Maanantai;7;18;25
94;30.07.2018;2018;07;16;Maanantai;13;44;57
94;30.07.2018;2018;07;17;Maanantai;6;17;23
94;30.07.2018;2018;07;18;Maanantai;9;15;24
94;30.07.2018;2018;07;19;Maanantai;16;11;27
94;30.07.2018;2018;07;20;Maanantai;11;8;19
94;30.07.2018;2018;07;21;Maanantai;5;12;17
94;30.07.2018;2018;07;22;Maanantai;4;8;12
94;30.07.2018;2018;07;23;Maanantai;4;2;6
94;31.07.2018;2018;07;00;Tiistai;0;1;1
94;31.07.2018;2018;07;01;Tiistai;0;0;0
94;31.07.2018;2018;07;02;Tiistai;0;2;2
94;31.07.2018;2018;07;03;Tiistai;0;4;4
94;31.07.2018;2018;07;04;Tiistai;0;0;0
94;31.07.2018;2018;07;05;Tiistai;8;1;9
94;31.07.2018;2018;07;06;Tiistai;17;1;18
94;31.07.2018;2018;07;07;Tiistai;24;1;25
94;31.07.2018;2018;07;08;Tiistai;20;6;26
94;31.07.2018;2018;07;09;Tiistai;2;8;10
94;31.07.2018;2018;07;10;Tiistai;14;4;18
94;31.07.2018;2018;07;11;Tiistai;8;11;19
94;31.07.2018;2018;07;12;Tiistai;6;14;20
94;31.07.2018;2018;07;13;Tiistai;8;7;15
94;31.07.2018;2018;07;14;Tiistai;9;12;21
94;31.07.2018;2018;07;15;Tiistai;13;14;27
94;31.07.2018;2018;07;16;Tiistai;18;31;49
94;31.07.2018;2018;07;17;Tiistai;12;15;27
94;31.07.2018;2018;07;18;Tiistai;10;12;22
94;31.07.2018;2018;07;19;Tiistai;10;16;26
94;31.07.2018;2018;07;20;Tiistai;13;20;33
94;31.07.2018;2018;07;21;Tiistai;10;13;23
94;31.07.2018;2018;07;22;Tiistai;4;4;8
94;31.07.2018;2018;07;23;Tiistai;1;6;7
94;01.08.2018;2018;08;00;Keskiviikko;1;3;4
94;01.08.2018;2018;08;01;Keskiviikko;1;2;3
94;01.08.2018;2018;08;02;Keskiviikko;0;2;2
94;01.08.2018;2018;08;03;Keskiviikko;0;0;0
94;01.08.2018;2018;08;04;Keskiviikko;0;0;0
94;01.08.2018;2018;08;05;Keskiviikko;5;1;6
94;01.08.2018;2018;08;06;Keskiviikko;13;1;14
94;01.08.2018;2018;08;07;Keskiviikko;19;2;21
94;01.08.2018;2018;08;08;Keskiviikko;14;4;18
94;01.08.2018;2018;08;09;Keskiviikko;5;5;10
94;01.08.2018;2018;08;10;Keskiviikko;12;10;22
94;01.08.2018;2018;08;11;Keskiviikko;8;6;14
94;01.08.2018;2018;08;12;Keskiviikko;10;9;19
94;01.08.2018;2018;08;13;Keskiviikko;6;8;14
94;01.08.2018;2018;08;14;Keskiviikko;24;9;33
94;01.08.2018;2018;08;15;Keskiviikko;9;26;35
94;01.08.2018;2018;08;16;Keskiviikko;15;21;36
94;01.08.2018;2018;08;17;Keskiviikko;6;15;21
94;01.08.2018;2018;08;18;Keskiviikko;8;14;22
94;01.08.2018;2018;08;19;Keskiviikko;8;9;17
94;01.08.2018;2018;08;20;Keskiviikko;6;6;12
94;01.08.2018;2018;08;21;Keskiviikko;5;11;16
94;01.08.2018;2018;08;22;Keskiviikko;5;6;11
94;01.08.2018;2018;08;23;Keskiviikko;2;2;4
94;02.08.2018;2018;08;00;Torstai;0;2;2
94;02.08.2018;2018;08;01;Torstai;0;2;2
94;02.08.2018;2018;08;02;Torstai;0;0;0
94;02.08.2018;2018;08;03;Torstai;0;0;0
94;02.08.2018;2018;08;04;Torstai;0;0;0
94;02.08.2018;2018;08;05;Torstai;6;2;8
94;02.08.2018;2018;08;06;Torstai;17;3;20
94;02.08.2018;2018;08;07;Torstai;27;1;28
94;02.08.2018;2018;08;08;Torstai;2;3;5
94;02.08.2018;2018;08;09;Torstai;5;4;9
94;02.08.2018;2018;08;10;Torstai;9;7;16
94;02.08.2018;2018;08;11;Torstai;4;6;10
94;02.08.2018;2018;08;12;Torstai;4;7;11
94;02.08.2018;2018;08;13;Torstai;8;12;20
94;02.08.2018;2018;08;14;Torstai;4;14;18
94;02.08.2018;2018;08;15;Torstai;13;19;32
94;02.08.2018;2018;08;16;Torstai;6;15;21
94;02.08.2018;2018;08;17;Torstai;8;20;28
94;02.08.2018;2018;08;18;Torstai;3;12;15
94;02.08.2018;2018;08;19;Torstai;10;8;18
94;02.08.2018;2018;08;20;Torstai;6;7;13
94;02.08.2018;2018;08;21;Torstai;7;7;14
94;02.08.2018;2018;08;22;Torstai;2;6;8
94;02.08.2018;2018;08;23;Torstai;1;4;5
94;03.08.2018;2018;08;00;Perjantai;0;1;1
94;03.08.2018;2018;08;01;Perjantai;0;1;1
94;03.08.2018;2018;08;02;Perjantai;0;0;0
94;03.08.2018;2018;08;03;Perjantai;0;1;1
94;03.08.2018;2018;08;04;Perjantai;0;0;0
94;03.08.2018;2018;08;05;Perjantai;4;1;5
94;03.08.2018;2018;08;06;Perjantai;9;0;9
94;03.08.2018;2018;08;07;Perjantai;9;1;10
94;03.08.2018;2018;08;08;Perjantai;3;2;5
94;03.08.2018;2018;08;09;Perjantai;4;6;10
94;03.08.2018;2018;08;10;Perjantai;0;0;0
94;03.08.2018;2018;08;11;Perjantai;0;0;0
94;03.08.2018;2018;08;12;Perjantai;1;1;2
94;03.08.2018;2018;08;13;Perjantai;0;5;5
94;03.08.2018;2018;08;14;Perjantai;2;10;12
94;03.08.2018;2018;08;15;Perjantai;3;6;9
94;03.08.2018;2018;08;16;Perjantai;9;17;26
94;03.08.2018;2018;08;17;Perjantai;6;9;15
94;03.08.2018;2018;08;18;Perjantai;4;5;9
94;03.08.2018;2018;08;19;Perjantai;6;7;13
94;03.08.2018;2018;08;20;Perjantai;3;3;6
94;03.08.2018;2018;08;21;Perjantai;4;4;8
94;03.08.2018;2018;08;22;Perjantai;2;1;3
94;03.08.2018;2018;08;23;Perjantai;1;0;1
94;04.08.2018;2018;08;00;Lauantai;0;2;2
94;04.08.2018;2018;08;01;Lauantai;0;0;0
94;04.08.2018;2018;08;02;Lauantai;0;2;2
94;04.08.2018;2018;08;03;Lauantai;1;1;2
94;04.08.2018;2018;08;04;Lauantai;2;0;2
94;04.08.2018;2018;08;05;Lauantai;2;0;2
94;04.08.2018;2018;08;06;Lauantai;0;1;1
94;04.08.2018;2018;08;07;Lauantai;2;1;3
94;04.08.2018;2018;08;08;Lauantai;5;0;5
94;04.08.2018;2018;08;09;Lauantai;4;6;10
94;04.08.2018;2018;08;10;Lauantai;10;8;18
94;04.08.2018;2018;08;11;Lauantai;16;15;31
94;04.08.2018;2018;08;12;Lauantai;9;11;20
94;04.08.2018;2018;08;13;Lauantai;7;8;15
94;04.08.2018;2018;08;14;Lauantai;11;13;24
94;04.08.2018;2018;08;15;Lauantai;18;15;33
94;04.08.2018;2018;08;16;Lauantai;12;0;12
94;04.08.2018;2018;08;17;Lauantai;12;7;19
94;04.08.2018;2018;08;18;Lauantai;11;11;22
94;04.08.2018;2018;08;19;Lauantai;14;8;22
94;04.08.2018;2018;08;20;Lauantai;4;5;9
94;04.08.2018;2018;08;21;Lauantai;3;5;8
94;04.08.2018;2018;08;22;Lauantai;3;3;6
94;04.08.2018;2018;08;23;Lauantai;3;4;7
94;05.08.2018;2018;08;00;Sunnuntai;1;5;6
94;05.08.2018;2018;08;01;Sunnuntai;0;0;0
94;05.08.2018;2018;08;02;Sunnuntai;0;1;1
94;05.08.2018;2018;08;03;Sunnuntai;0;4;4
94;05.08.2018;2018;08;04;Sunnuntai;0;2;2
94;05.08.2018;2018;08;05;Sunnuntai;2;0;2
94;05.08.2018;2018;08;06;Sunnuntai;0;2;2
94;05.08.2018;2018;08;07;Sunnuntai;1;3;4
94;05.08.2018;2018;08;08;Sunnuntai;0;3;3
94;05.08.2018;2018;08;09;Sunnuntai;9;3;12
94;05.08.2018;2018;08;10;Sunnuntai;12;13;25
94;05.08.2018;2018;08;11;Sunnuntai;20;14;34
94;05.08.2018;2018;08;12;Sunnuntai;12;13;25
94;05.08.2018;2018;08;13;Sunnuntai;25;7;32
94;05.08.2018;2018;08;14;Sunnuntai;10;5;15
94;05.08.2018;2018;08;15;Sunnuntai;7;7;14
94;05.08.2018;2018;08;16;Sunnuntai;7;7;14
94;05.08.2018;2018;08;17;Sunnuntai;11;11;22
94;05.08.2018;2018;08;18;Sunnuntai;11;10;21
94;05.08.2018;2018;08;19;Sunnuntai;14;15;29
94;05.08.2018;2018;08;20;Sunnuntai;12;5;17
94;05.08.2018;2018;08;21;Sunnuntai;7;4;11
94;05.08.2018;2018;08;22;Sunnuntai;0;3;3
94;05.08.2018;2018;08;23;Sunnuntai;1;1;2
94;06.08.2018;2018;08;00;Maanantai;0;2;2
94;06.08.2018;2018;08;01;Maanantai;1;1;2
94;06.08.2018;2018;08;02;Maanantai;0;0;0
94;06.08.2018;2018;08;03;Maanantai;0;0;0
94;06.08.2018;2018;08;04;Maanantai;0;3;3
94;06.08.2018;2018;08;05;Maanantai;5;5;10
94;06.08.2018;2018;08;06;Maanantai;7;2;9
94;06.08.2018;2018;08;07;Maanantai;11;1;12
94;06.08.2018;2018;08;08;Maanantai;6;0;6
94;06.08.2018;2018;08;09;Maanantai;2;3;5
94;06.08.2018;2018;08;10;Maanantai;3;2;5
94;06.08.2018;2018;08;11;Maanantai;1;3;4
94;06.08.2018;2018;08;12;Maanantai;2;1;3
94;06.08.2018;2018;08;13;Maanantai;2;3;5
94;06.08.2018;2018;08;14;Maanantai;1;2;3
94;06.08.2018;2018;08;15;Maanantai;6;7;13
94;06.08.2018;2018;08;16;Maanantai;0;11;11
94;06.08.2018;2018;08;17;Maanantai;6;8;14
94;06.08.2018;2018;08;18;Maanantai;3;4;7
94;06.08.2018;2018;08;19;Maanantai;8;10;18
94;06.08.2018;2018;08;20;Maanantai;7;7;14
94;06.08.2018;2018;08;21;Maanantai;4;5;9
94;06.08.2018;2018;08;22;Maanantai;1;5;6
94;06.08.2018;2018;08;23;Maanantai;3;6;9
94;07.08.2018;2018;08;00;Tiistai;1;0;1
94;07.08.2018;2018;08;01;Tiistai;0;0;0
94;07.08.2018;2018;08;02;Tiistai;2;0;2
94;07.08.2018;2018;08;03;Tiistai;4;0;4
94;07.08.2018;2018;08;04;Tiistai;0;0;0
94;07.08.2018;2018;08;05;Tiistai;9;0;9
94;07.08.2018;2018;08;06;Tiistai;18;0;18
94;07.08.2018;2018;08;07;Tiistai;25;0;25
94;07.08.2018;2018;08;08;Tiistai;26;0;26
94;07.08.2018;2018;08;09;Tiistai;10;0;10
94;07.08.2018;2018;08;10;Tiistai;18;0;18
94;07.08.2018;2018;08;11;Tiistai;19;0;19
94;07.08.2018;2018;08;12;Tiistai;20;0;20
94;07.08.2018;2018;08;13;Tiistai;15;0;15
94;07.08.2018;2018;08;14;Tiistai;21;0;21
94;07.08.2018;2018;08;15;Tiistai;27;0;27
94;07.08.2018;2018;08;16;Tiistai;49;0;49
94;07.08.2018;2018;08;17;Tiistai;27;0;27
94;07.08.2018;2018;08;18;Tiistai;22;0;22
94;07.08.2018;2018;08;19;Tiistai;26;0;26
94;07.08.2018;2018;08;20;Tiistai;33;0;33
94;07.08.2018;2018;08;21;Tiistai;23;0;23
94;07.08.2018;2018;08;22;Tiistai;8;0;8
94;07.08.2018;2018;08;23;Tiistai;7;0;7
94;08.08.2018;2018;08;00;Keskiviikko;0;3;3
94;08.08.2018;2018;08;01;Keskiviikko;0;0;0
94;08.08.2018;2018;08;02;Keskiviikko;0;0;0
94;08.08.2018;2018;08;03;Keskiviikko;0;0;0
94;08.08.2018;2018;08;04;Keskiviikko;0;0;0
94;08.08.2018;2018;08;05;Keskiviikko;6;4;10
94;08.08.2018;2018;08;06;Keskiviikko;25;5;30
94;08.08.2018;2018;08;07;Keskiviikko;33;5;38
94;08.08.2018;2018;08;08;Keskiviikko;21;8;29
94;08.08.2018;2018;08;09;Keskiviikko;9;7;16
94;08.08.2018;2018;08;10;Keskiviikko;11;8;19
94;08.08.2018;2018;08;11;Keskiviikko;11;12;23
94;08.08.2018;2018;08;12;Keskiviikko;9;6;15
94;08.08.2018;2018;08;13;Keskiviikko;14;15;29
94;08.08.2018;2018;08;14;Keskiviikko;10;15;25
94;08.08.2018;2018;08;15;Keskiviikko;14;25;39
94;08.08.2018;2018;08;16;Keskiviikko;8;50;58
94;08.08.2018;2018;08;17;Keskiviikko;12;34;46
94;08.08.2018;2018;08;18;Keskiviikko;18;23;41
94;08.08.2018;2018;08;19;Keskiviikko;16;16;32
94;08.08.2018;2018;08;20;Keskiviikko;12;10;22
94;08.08.2018;2018;08;21;Keskiviikko;10;13;23
94;08.08.2018;2018;08;22;Keskiviikko;5;6;11
94;08.08.2018;2018;08;23;Keskiviikko;1;0;1
94;09.08.2018;2018;08;00;Torstai;0;0;0
94;09.08.2018;2018;08;01;Torstai;0;0;0
94;09.08.2018;2018;08;02;Torstai;0;1;1
94;09.08.2018;2018;08;03;Torstai;0;4;4
94;09.08.2018;2018;08;04;Torstai;0;0;0
94;09.08.2018;2018;08;05;Torstai;6;1;7
94;09.08.2018;2018;08;06;Torstai;6;3;9
94;09.08.2018;2018;08;07;Torstai;22;9;31
94;09.08.2018;2018;08;08;Torstai;15;7;22
94;09.08.2018;2018;08;09;Torstai;5;7;12
94;09.08.2018;2018;08;10;Torstai;7;3;10
94;09.08.2018;2018;08;11;Torstai;3;9;12
94;09.08.2018;2018;08;12;Torstai;3;7;10
94;09.08.2018;2018;08;13;Torstai;5;6;11
94;09.08.2018;2018;08;14;Torstai;5;12;17
94;09.08.2018;2018;08;15;Torstai;7;18;25
94;09.08.2018;2018;08;16;Torstai;7;19;26
94;09.08.2018;2018;08;17;Torstai;9;15;24
94;09.08.2018;2018;08;18;Torstai;6;6;12
94;09.08.2018;2018;08;19;Torstai;5;7;12
94;09.08.2018;2018;08;20;Torstai;4;3;7
94;09.08.2018;2018;08;21;Torstai;9;6;15
94;09.08.2018;2018;08;22;Torstai;2;3;5
94;09.08.2018;2018;08;23;Torstai;1;2;3
94;10.08.2018;2018;08;00;Perjantai;0;2;2
94;10.08.2018;2018;08;01;Perjantai;0;0;0
94;10.08.2018;2018;08;02;Perjantai;0;0;0
94;10.08.2018;2018;08;03;Perjantai;0;0;0
94;10.08.2018;2018;08;04;Perjantai;2;0;2
94;10.08.2018;2018;08;05;Perjantai;6;1;7
94;10.08.2018;2018;08;06;Perjantai;11;8;19
94;10.08.2018;2018;08;07;Perjantai;41;5;46
94;10.08.2018;2018;08;08;Perjantai;15;1;16
94;10.08.2018;2018;08;09;Perjantai;13;3;16
94;10.08.2018;2018;08;10;Perjantai;8;4;12
94;10.08.2018;2018;08;11;Perjantai;6;14;20
94;10.08.2018;2018;08;12;Perjantai;9;10;19
94;10.08.2018;2018;08;13;Perjantai;6;12;18
94;10.08.2018;2018;08;14;Perjantai;9;23;32
94;10.08.2018;2018;08;15;Perjantai;8;24;32
94;10.08.2018;2018;08;16;Perjantai;5;28;33
94;10.08.2018;2018;08;17;Perjantai;20;22;42
94;10.08.2018;2018;08;18;Perjantai;6;6;12
94;10.08.2018;2018;08;19;Perjantai;5;8;13
94;10.08.2018;2018;08;20;Perjantai;0;5;5
94;10.08.2018;2018;08;21;Perjantai;1;8;9
94;10.08.2018;2018;08;22;Perjantai;0;1;1
94;10.08.2018;2018;08;23;Perjantai;1;1;2
94;11.08.2018;2018;08;00;Lauantai;1;0;1
94;11.08.2018;2018;08;01;Lauantai;2;0;2
94;11.08.2018;2018;08;02;Lauantai;1;3;4
94;11.08.2018;2018;08;03;Lauantai;1;1;2
94;11.08.2018;2018;08;04;Lauantai;0;0;0
94;11.08.2018;2018;08;05;Lauantai;1;0;1
94;11.08.2018;2018;08;06;Lauantai;1;1;2
94;11.08.2018;2018;08;07;Lauantai;2;3;5
94;11.08.2018;2018;08;08;Lauantai;1;3;4
94;11.08.2018;2018;08;09;Lauantai;4;3;7
94;11.08.2018;2018;08;10;Lauantai;5;11;16
94;11.08.2018;2018;08;11;Lauantai;9;4;13
94;11.08.2018;2018;08;12;Lauantai;5;12;17
94;11.08.2018;2018;08;13;Lauantai;8;10;18
94;11.08.2018;2018;08;14;Lauantai;5;3;8
94;11.08.2018;2018;08;15;Lauantai;2;8;10
94;11.08.2018;2018;08;16;Lauantai;6;4;10
94;11.08.2018;2018;08;17;Lauantai;11;6;17
94;11.08.2018;2018;08;18;Lauantai;2;4;6
94;11.08.2018;2018;08;19;Lauantai;1;5;6
94;11.08.2018;2018;08;20;Lauantai;4;5;9
94;11.08.2018;2018;08;21;Lauantai;1;2;3
94;11.08.2018;2018;08;22;Lauantai;2;5;7
94;11.08.2018;2018;08;23;Lauantai;4;2;6
94;12.08.2018;2018;08;00;Sunnuntai;2;2;4
94;12.08.2018;2018;08;01;Sunnuntai;0;2;2
94;12.08.2018;2018;08;02;Sunnuntai;1;2;3
94;12.08.2018;2018;08;03;Sunnuntai;1;2;3
94;12.08.2018;2018;08;04;Sunnuntai;0;1;1
94;12.08.2018;2018;08;05;Sunnuntai;0;0;0
94;12.08.2018;2018;08;06;Sunnuntai;1;0;1
94;12.08.2018;2018;08;07;Sunnuntai;1;0;1
94;12.08.2018;2018;08;08;Sunnuntai;1;3;4
94;12.08.2018;2018;08;09;Sunnuntai;3;8;11
94;12.08.2018;2018;08;10;Sunnuntai;9;7;16
94;12.08.2018;2018;08;11;Sunnuntai;8;10;18
94;12.08.2018;2018;08;12;Sunnuntai;11;13;24
94;12.08.2018;2018;08;13;Sunnuntai;12;18;30
94;12.08.2018;2018;08;14;Sunnuntai;12;13;25
94;12.08.2018;2018;08;15;Sunnuntai;10;6;16
94;12.08.2018;2018;08;16;Sunnuntai;15;1;16
94;12.08.2018;2018;08;17;Sunnuntai;8;7;15
94;12.08.2018;2018;08;18;Sunnuntai;16;10;26
94;12.08.2018;2018;08;19;Sunnuntai;5;9;14
94;12.08.2018;2018;08;20;Sunnuntai;6;7;13
94;12.08.2018;2018;08;21;Sunnuntai;4;4;8
94;12.08.2018;2018;08;22;Sunnuntai;0;5;5
94;12.08.2018;2018;08;23;Sunnuntai;0;1;1
94;13.08.2018;2018;08;00;Maanantai;0;0;0
94;13.08.2018;2018;08;01;Maanantai;0;0;0
94;13.08.2018;2018;08;02;Maanantai;0;0;0
94;13.08.2018;2018;08;03;Maanantai;0;0;0
94;13.08.2018;2018;08;04;Maanantai;1;0;1
94;13.08.2018;2018;08;05;Maanantai;6;0;6
94;13.08.2018;2018;08;06;Maanantai;15;1;16
94;13.08.2018;2018;08;07;Maanantai;29;2;31
94;13.08.2018;2018;08;08;Maanantai;13;4;17
94;13.08.2018;2018;08;09;Maanantai;5;6;11
94;13.08.2018;2018;08;10;Maanantai;3;2;5
94;13.08.2018;2018;08;11;Maanantai;2;2;4
94;13.08.2018;2018;08;12;Maanantai;0;3;3
94;13.08.2018;2018;08;13;Maanantai;5;4;9
94;13.08.2018;2018;08;14;Maanantai;1;11;12
94;13.08.2018;2018;08;15;Maanantai;4;15;19
94;13.08.2018;2018;08;16;Maanantai;2;30;32
94;13.08.2018;2018;08;17;Maanantai;3;13;16
94;13.08.2018;2018;08;18;Maanantai;3;7;10
94;13.08.2018;2018;08;19;Maanantai;5;9;14
94;13.08.2018;2018;08;20;Maanantai;4;8;12
94;13.08.2018;2018;08;21;Maanantai;5;6;11
94;13.08.2018;2018;08;22;Maanantai;3;2;5
94;13.08.2018;2018;08;23;Maanantai;1;0;1
94;14.08.2018;2018;08;00;Tiistai;0;0;0
94;14.08.2018;2018;08;01;Tiistai;0;0;0
94;14.08.2018;2018;08;02;Tiistai;0;0;0
94;14.08.2018;2018;08;03;Tiistai;0;0;0
94;14.08.2018;2018;08;04;Tiistai;2;0;2
94;14.08.2018;2018;08;05;Tiistai;8;2;10
94;14.08.2018;2018;08;06;Tiistai;19;3;22
94;14.08.2018;2018;08;07;Tiistai;35;4;39
94;14.08.2018;2018;08;08;Tiistai;14;2;16
94;14.08.2018;2018;08;09;Tiistai;9;4;13
94;14.08.2018;2018;08;10;Tiistai;6;5;11
94;14.08.2018;2018;08;11;Tiistai;4;9;13
94;14.08.2018;2018;08;12;Tiistai;6;10;16
94;14.08.2018;2018;08;13;Tiistai;6;6;12
94;14.08.2018;2018;08;14;Tiistai;7;11;18
94;14.08.2018;2018;08;15;Tiistai;10;22;32
94;14.08.2018;2018;08;16;Tiistai;12;33;45
94;14.08.2018;2018;08;17;Tiistai;6;27;33
94;14.08.2018;2018;08;18;Tiistai;3;12;15
94;14.08.2018;2018;08;19;Tiistai;7;14;21
94;14.08.2018;2018;08;20;Tiistai;5;6;11
94;14.08.2018;2018;08;21;Tiistai;4;6;10
94;14.08.2018;2018;08;22;Tiistai;0;3;3
94;14.08.2018;2018;08;23;Tiistai;0;1;1
94;15.08.2018;2018;08;00;Keskiviikko;0;0;0
94;15.08.2018;2018;08;01;Keskiviikko;0;0;0
94;15.08.2018;2018;08;02;Keskiviikko;0;0;0
94;15.08.2018;2018;08;03;Keskiviikko;0;0;0
94;15.08.2018;2018;08;04;Keskiviikko;1;0;1
94;15.08.2018;2018;08;05;Keskiviikko;7;2;9
94;15.08.2018;2018;08;06;Keskiviikko;16;2;18
94;15.08.2018;2018;08;07;Keskiviikko;42;8;50
94;15.08.2018;2018;08;08;Keskiviikko;24;3;27
94;15.08.2018;2018;08;09;Keskiviikko;11;3;14
94;15.08.2018;2018;08;10;Keskiviikko;6;2;8
94;15.08.2018;2018;08;11;Keskiviikko;14;7;21
94;15.08.2018;2018;08;12;Keskiviikko;7;11;18
94;15.08.2018;2018;08;13;Keskiviikko;12;9;21
94;15.08.2018;2018;08;14;Keskiviikko;8;16;24
94;15.08.2018;2018;08;15;Keskiviikko;8;21;29
94;15.08.2018;2018;08;16;Keskiviikko;12;36;48
94;15.08.2018;2018;08;17;Keskiviikko;9;21;30
94;15.08.2018;2018;08;18;Keskiviikko;10;19;29
94;15.08.2018;2018;08;19;Keskiviikko;6;10;16
94;15.08.2018;2018;08;20;Keskiviikko;2;12;14
94;15.08.2018;2018;08;21;Keskiviikko;9;8;17
94;15.08.2018;2018;08;22;Keskiviikko;2;4;6
94;15.08.2018;2018;08;23;Keskiviikko;0;2;2
94;16.08.2018;2018;08;00;Torstai;0;0;0
94;16.08.2018;2018;08;01;Torstai;0;0;0
94;16.08.2018;2018;08;02;Torstai;0;0;0
94;16.08.2018;2018;08;03;Torstai;0;0;0
94;16.08.2018;2018;08;04;Torstai;1;0;1
94;16.08.2018;2018;08;05;Torstai;7;1;8
94;16.08.2018;2018;08;06;Torstai;21;2;23
94;16.08.2018;2018;08;07;Torstai;28;3;31
94;16.08.2018;2018;08;08;Torstai;19;4;23
94;16.08.2018;2018;08;09;Torstai;7;3;10
94;16.08.2018;2018;08;10;Torstai;6;2;8
94;16.08.2018;2018;08;11;Torstai;7;6;13
94;16.08.2018;2018;08;12;Torstai;8;4;12
94;16.08.2018;2018;08;13;Torstai;1;8;9
94;16.08.2018;2018;08;14;Torstai;9;14;23
94;16.08.2018;2018;08;15;Torstai;8;25;33
94;16.08.2018;2018;08;16;Torstai;10;28;38
94;16.08.2018;2018;08;17;Torstai;7;17;24
94;16.08.2018;2018;08;18;Torstai;7;9;16
94;16.08.2018;2018;08;19;Torstai;7;14;21
94;16.08.2018;2018;08;20;Torstai;6;8;14
94;16.08.2018;2018;08;21;Torstai;3;8;11
94;16.08.2018;2018;08;22;Torstai;4;2;6
94;16.08.2018;2018;08;23;Torstai;0;0;0
94;17.08.2018;2018;08;00;Perjantai;0;0;0
94;17.08.2018;2018;08;01;Perjantai;0;0;0
94;17.08.2018;2018;08;02;Perjantai;0;0;0
94;17.08.2018;2018;08;03;Perjantai;0;0;0
94;17.08.2018;2018;08;04;Perjantai;2;0;2
94;17.08.2018;2018;08;05;Perjantai;4;1;5
94;17.08.2018;2018;08;06;Perjantai;18;1;19
94;17.08.2018;2018;08;07;Perjantai;26;4;30
94;17.08.2018;2018;08;08;Perjantai;21;4;25
94;17.08.2018;2018;08;09;Perjantai;7;2;9
94;17.08.2018;2018;08;10;Perjantai;0;3;3
94;17.08.2018;2018;08;11;Perjantai;5;3;8
94;17.08.2018;2018;08;12;Perjantai;3;8;11
94;17.08.2018;2018;08;13;Perjantai;3;8;11
94;17.08.2018;2018;08;14;Perjantai;12;18;30
94;17.08.2018;2018;08;15;Perjantai;11;20;31
94;17.08.2018;2018;08;16;Perjantai;9;24;33
94;17.08.2018;2018;08;17;Perjantai;6;10;16
94;17.08.2018;2018;08;18;Perjantai;6;7;13
94;17.08.2018;2018;08;19;Perjantai;3;11;14
94;17.08.2018;2018;08;20;Perjantai;7;6;13
94;17.08.2018;2018;08;21;Perjantai;2;3;5
94;17.08.2018;2018;08;22;Perjantai;1;2;3
94;17.08.2018;2018;08;23;Perjantai;0;1;1
94;18.08.2018;2018;08;00;Lauantai;0;0;0
94;18.08.2018;2018;08;01;Lauantai;0;0;0
94;18.08.2018;2018;08;02;Lauantai;0;0;0
94;18.08.2018;2018;08;03;Lauantai;1;0;1
94;18.08.2018;2018;08;04;Lauantai;0;0;0
94;18.08.2018;2018;08;05;Lauantai;1;0;1
94;18.08.2018;2018;08;06;Lauantai;0;1;1
94;18.08.2018;2018;08;07;Lauantai;0;2;2
94;18.08.2018;2018;08;08;Lauantai;6;1;7
94;18.08.2018;2018;08;09;Lauantai;5;3;8
94;18.08.2018;2018;08;10;Lauantai;1;3;4
94;18.08.2018;2018;08;11;Lauantai;8;21;29
94;18.08.2018;2018;08;12;Lauantai;9;11;20
94;18.08.2018;2018;08;13;Lauantai;11;13;24
94;18.08.2018;2018;08;14;Lauantai;16;6;22
94;18.08.2018;2018;08;15;Lauantai;9;5;14
94;18.08.2018;2018;08;16;Lauantai;15;3;18
94;18.08.2018;2018;08;17;Lauantai;11;8;19
94;18.08.2018;2018;08;18;Lauantai;15;13;28
94;18.08.2018;2018;08;19;Lauantai;6;3;9
94;18.08.2018;2018;08;20;Lauantai;10;6;16
94;18.08.2018;2018;08;21;Lauantai;3;10;13
94;18.08.2018;2018;08;22;Lauantai;8;5;13
94;18.08.2018;2018;08;23;Lauantai;1;1;2
94;19.08.2018;2018;08;00;Sunnuntai;3;10;13
94;19.08.2018;2018;08;01;Sunnuntai;2;4;6
94;19.08.2018;2018;08;02;Sunnuntai;0;0;0
94;19.08.2018;2018;08;03;Sunnuntai;5;1;6
94;19.08.2018;2018;08;04;Sunnuntai;0;0;0
94;19.08.2018;2018;08;05;Sunnuntai;0;0;0
94;19.08.2018;2018;08;06;Sunnuntai;1;0;1
94;19.08.2018;2018;08;07;Sunnuntai;0;1;1
94;19.08.2018;2018;08;08;Sunnuntai;2;0;2
94;19.08.2018;2018;08;09;Sunnuntai;1;0;1
94;19.08.2018;2018;08;10;Sunnuntai;4;6;10
94;19.08.2018;2018;08;11;Sunnuntai;11;6;17
94;19.08.2018;2018;08;12;Sunnuntai;7;7;14
94;19.08.2018;2018;08;13;Sunnuntai;5;1;6
94;19.08.2018;2018;08;14;Sunnuntai;12;2;14
94;19.08.2018;2018;08;15;Sunnuntai;6;9;15
94;19.08.2018;2018;08;16;Sunnuntai;9;6;15
94;19.08.2018;2018;08;17;Sunnuntai;6;11;17
94;19.08.2018;2018;08;18;Sunnuntai;6;12;18
94;19.08.2018;2018;08;19;Sunnuntai;9;2;11
94;19.08.2018;2018;08;20;Sunnuntai;1;1;2
94;19.08.2018;2018;08;21;Sunnuntai;2;6;8
94;19.08.2018;2018;08;22;Sunnuntai;0;0;0
94;19.08.2018;2018;08;23;Sunnuntai;1;2;3
94;20.08.2018;2018;08;00;Maanantai;0;0;0
94;20.08.2018;2018;08;01;Maanantai;0;0;0
94;20.08.2018;2018;08;02;Maanantai;0;0;0
94;20.08.2018;2018;08;03;Maanantai;0;0;0
94;20.08.2018;2018;08;04;Maanantai;0;0;0
94;20.08.2018;2018;08;05;Maanantai;8;4;12
94;20.08.2018;2018;08;06;Maanantai;14;2;16
94;20.08.2018;2018;08;07;Maanantai;33;4;37
94;20.08.2018;2018;08;08;Maanantai;15;4;19
94;20.08.2018;2018;08;09;Maanantai;3;5;8
94;20.08.2018;2018;08;10;Maanantai;4;4;8
94;20.08.2018;2018;08;11;Maanantai;3;2;5
94;20.08.2018;2018;08;12;Maanantai;2;3;5
94;20.08.2018;2018;08;13;Maanantai;2;2;4
94;20.08.2018;2018;08;14;Maanantai;4;14;18
94;20.08.2018;2018;08;15;Maanantai;11;21;32
94;20.08.2018;2018;08;16;Maanantai;9;35;44
94;20.08.2018;2018;08;17;Maanantai;9;15;24
94;20.08.2018;2018;08;18;Maanantai;7;15;22
94;20.08.2018;2018;08;19;Maanantai;3;10;13
94;20.08.2018;2018;08;20;Maanantai;4;4;8
94;20.08.2018;2018;08;21;Maanantai;2;2;4
94;20.08.2018;2018;08;22;Maanantai;0;3;3
94;20.08.2018;2018;08;23;Maanantai;0;2;2
94;21.08.2018;2018;08;00;Tiistai;0;0;0
94;21.08.2018;2018;08;01;Tiistai;0;0;0
94;21.08.2018;2018;08;02;Tiistai;0;0;0
94;21.08.2018;2018;08;03;Tiistai;0;0;0
94;21.08.2018;2018;08;04;Tiistai;2;0;2
94;21.08.2018;2018;08;05;Tiistai;8;3;11
94;21.08.2018;2018;08;06;Tiistai;19;6;25
94;21.08.2018;2018;08;07;Tiistai;35;2;37
94;21.08.2018;2018;08;08;Tiistai;15;0;15
94;21.08.2018;2018;08;09;Tiistai;6;3;9
94;21.08.2018;2018;08;10;Tiistai;6;2;8
94;21.08.2018;2018;08;11;Tiistai;4;8;12
94;21.08.2018;2018;08;12;Tiistai;4;8;12
94;21.08.2018;2018;08;13;Tiistai;3;6;9
94;21.08.2018;2018;08;14;Tiistai;9;15;24
94;21.08.2018;2018;08;15;Tiistai;7;18;25
94;21.08.2018;2018;08;16;Tiistai;9;27;36
94;21.08.2018;2018;08;17;Tiistai;2;21;23
94;21.08.2018;2018;08;18;Tiistai;13;12;25
94;21.08.2018;2018;08;19;Tiistai;6;4;10
94;21.08.2018;2018;08;20;Tiistai;3;3;6
94;21.08.2018;2018;08;21;Tiistai;0;7;7
94;21.08.2018;2018;08;22;Tiistai;0;0;0
94;21.08.2018;2018;08;23;Tiistai;0;5;5
94;22.08.2018;2018;08;00;Keskiviikko;0;0;0
94;22.08.2018;2018;08;01;Keskiviikko;0;0;0
94;22.08.2018;2018;08;02;Keskiviikko;0;0;0
94;22.08.2018;2018;08;03;Keskiviikko;0;0;0
94;22.08.2018;2018;08;04;Keskiviikko;2;0;2
94;22.08.2018;2018;08;05;Keskiviikko;5;3;8
94;22.08.2018;2018;08;06;Keskiviikko;18;3;21
94;22.08.2018;2018;08;07;Keskiviikko;30;1;31
94;22.08.2018;2018;08;08;Keskiviikko;19;4;23
94;22.08.2018;2018;08;09;Keskiviikko;9;5;14
94;22.08.2018;2018;08;10;Keskiviikko;4;2;6
94;22.08.2018;2018;08;11;Keskiviikko;5;9;14
94;22.08.2018;2018;08;12;Keskiviikko;6;2;8
94;22.08.2018;2018;08;13;Keskiviikko;4;3;7
94;22.08.2018;2018;08;14;Keskiviikko;7;15;22
94;22.08.2018;2018;08;15;Keskiviikko;8;21;29
94;22.08.2018;2018;08;16;Keskiviikko;10;31;41
94;22.08.2018;2018;08;17;Keskiviikko;6;18;24
94;22.08.2018;2018;08;18;Keskiviikko;6;4;10
94;22.08.2018;2018;08;19;Keskiviikko;0;9;9
94;22.08.2018;2018;08;20;Keskiviikko;2;8;10
94;22.08.2018;2018;08;21;Keskiviikko;1;1;2
94;22.08.2018;2018;08;22;Keskiviikko;1;3;4
94;22.08.2018;2018;08;23;Keskiviikko;0;0;0
94;23.08.2018;2018;08;00;Torstai;0;0;0
94;23.08.2018;2018;08;01;Torstai;0;0;0
94;23.08.2018;2018;08;02;Torstai;0;0;0
94;23.08.2018;2018;08;03;Torstai;0;0;0
94;23.08.2018;2018;08;04;Torstai;1;1;2
94;23.08.2018;2018;08;05;Torstai;3;3;6
94;23.08.2018;2018;08;06;Torstai;9;1;10
94;23.08.2018;2018;08;07;Torstai;18;4;22
94;23.08.2018;2018;08;08;Torstai;7;1;8
94;23.08.2018;2018;08;09;Torstai;1;3;4
94;23.08.2018;2018;08;10;Torstai;2;0;2
94;23.08.2018;2018;08;11;Torstai;0;0;0
94;23.08.2018;2018;08;12;Torstai;1;2;3
94;23.08.2018;2018;08;13;Torstai;4;1;5
94;23.08.2018;2018;08;14;Torstai;7;7;14
94;23.08.2018;2018;08;15;Torstai;4;13;17
94;23.08.2018;2018;08;16;Torstai;6;11;17
94;23.08.2018;2018;08;17;Torstai;8;6;14
94;23.08.2018;2018;08;18;Torstai;5;5;10
94;23.08.2018;2018;08;19;Torstai;4;8;12
94;23.08.2018;2018;08;20;Torstai;5;7;12
94;23.08.2018;2018;08;21;Torstai;5;6;11
94;23.08.2018;2018;08;22;Torstai;0;2;2
94;23.08.2018;2018;08;23;Torstai;0;1;1
94;24.08.2018;2018;08;00;Perjantai;0;0;0
94;24.08.2018;2018;08;01;Perjantai;0;0;0
94;24.08.2018;2018;08;02;Perjantai;0;0;0
94;24.08.2018;2018;08;03;Perjantai;0;0;0
94;24.08.2018;2018;08;04;Perjantai;1;0;1
94;24.08.2018;2018;08;05;Perjantai;2;3;5
94;24.08.2018;2018;08;06;Perjantai;6;2;8
94;24.08.2018;2018;08;07;Perjantai;22;4;26
94;24.08.2018;2018;08;08;Perjantai;10;1;11
94;24.08.2018;2018;08;09;Perjantai;5;0;5
94;24.08.2018;2018;08;10;Perjantai;1;0;1
94;24.08.2018;2018;08;11;Perjantai;0;5;5
94;24.08.2018;2018;08;12;Perjantai;9;1;10
94;24.08.2018;2018;08;13;Perjantai;3;1;4
94;24.08.2018;2018;08;14;Perjantai;3;8;11
94;24.08.2018;2018;08;15;Perjantai;3;14;17
94;24.08.2018;2018;08;16;Perjantai;3;9;12
94;24.08.2018;2018;08;17;Perjantai;8;5;13
94;24.08.2018;2018;08;18;Perjantai;5;10;15
94;24.08.2018;2018;08;19;Perjantai;1;2;3
94;24.08.2018;2018;08;20;Perjantai;3;6;9
94;24.08.2018;2018;08;21;Perjantai;1;3;4
94;24.08.2018;2018;08;22;Perjantai;2;2;4
94;24.08.2018;2018;08;23;Perjantai;1;2;3
94;25.08.2018;2018;08;00;Lauantai;0;0;0
94;25.08.2018;2018;08;01;Lauantai;0;0;0
94;25.08.2018;2018;08;02;Lauantai;0;0;0
94;25.08.2018;2018;08;03;Lauantai;1;0;1
94;25.08.2018;2018;08;04;Lauantai;0;0;0
94;25.08.2018;2018;08;05;Lauantai;1;0;1
94;25.08.2018;2018;08;06;Lauantai;2;1;3
94;25.08.2018;2018;08;07;Lauantai;0;0;0
94;25.08.2018;2018;08;08;Lauantai;1;0;1
94;25.08.2018;2018;08;09;Lauantai;1;0;1
94;25.08.2018;2018;08;10;Lauantai;0;0;0
94;25.08.2018;2018;08;11;Lauantai;3;2;5
94;25.08.2018;2018;08;12;Lauantai;6;6;12
94;25.08.2018;2018;08;13;Lauantai;4;7;11
94;25.08.2018;2018;08;14;Lauantai;8;10;18
94;25.08.2018;2018;08;15;Lauantai;11;6;17
94;25.08.2018;2018;08;16;Lauantai;8;7;15
94;25.08.2018;2018;08;17;Lauantai;9;6;15
94;25.08.2018;2018;08;18;Lauantai;4;5;9
94;25.08.2018;2018;08;19;Lauantai;5;8;13
94;25.08.2018;2018;08;20;Lauantai;4;1;5
94;25.08.2018;2018;08;21;Lauantai;2;4;6
94;25.08.2018;2018;08;22;Lauantai;1;4;5
94;25.08.2018;2018;08;23;Lauantai;3;4;7
94;26.08.2018;2018;08;00;Sunnuntai;2;1;3
94;26.08.2018;2018;08;01;Sunnuntai;2;6;8
94;26.08.2018;2018;08;02;Sunnuntai;0;0;0
94;26.08.2018;2018;08;03;Sunnuntai;0;0;0
94;26.08.2018;2018;08;04;Sunnuntai;0;0;0
94;26.08.2018;2018;08;05;Sunnuntai;0;0;0
94;26.08.2018;2018;08;06;Sunnuntai;1;0;1
94;26.08.2018;2018;08;07;Sunnuntai;0;1;1
94;26.08.2018;2018;08;08;Sunnuntai;1;0;1
94;26.08.2018;2018;08;09;Sunnuntai;4;4;8
94;26.08.2018;2018;08;10;Sunnuntai;10;6;16
94;26.08.2018;2018;08;11;Sunnuntai;18;12;30
94;26.08.2018;2018;08;12;Sunnuntai;13;12;25
94;26.08.2018;2018;08;13;Sunnuntai;9;20;29
94;26.08.2018;2018;08;14;Sunnuntai;2;7;9
94;26.08.2018;2018;08;15;Sunnuntai;15;2;17
94;26.08.2018;2018;08;16;Sunnuntai;7;3;10
94;26.08.2018;2018;08;17;Sunnuntai;2;0;2
94;26.08.2018;2018;08;18;Sunnuntai;3;3;6
94;26.08.2018;2018;08;19;Sunnuntai;4;2;6
94;26.08.2018;2018;08;20;Sunnuntai;0;0;0
94;26.08.2018;2018;08;21;Sunnuntai;1;1;2
94;26.08.2018;2018;08;22;Sunnuntai;0;1;1
94;26.08.2018;2018;08;23;Sunnuntai;0;0;0
94;27.08.2018;2018;08;00;Maanantai;0;0;0
94;27.08.2018;2018;08;01;Maanantai;0;0;0
94;27.08.2018;2018;08;02;Maanantai;0;0;0
94;27.08.2018;2018;08;03;Maanantai;0;0;0
94;27.08.2018;2018;08;04;Maanantai;1;0;1
94;27.08.2018;2018;08;05;Maanantai;5;4;9
94;27.08.2018;2018;08;06;Maanantai;17;2;19
94;27.08.2018;2018;08;07;Maanantai;16;3;19
94;27.08.2018;2018;08;08;Maanantai;12;4;16
94;27.08.2018;2018;08;09;Maanantai;6;3;9
94;27.08.2018;2018;08;10;Maanantai;3;2;5
94;27.08.2018;2018;08;11;Maanantai;5;1;6
94;27.08.2018;2018;08;12;Maanantai;3;7;10
94;27.08.2018;2018;08;13;Maanantai;5;2;7
94;27.08.2018;2018;08;14;Maanantai;2;11;13
94;27.08.2018;2018;08;15;Maanantai;6;16;22
94;27.08.2018;2018;08;16;Maanantai;7;22;29
94;27.08.2018;2018;08;17;Maanantai;10;14;24
94;27.08.2018;2018;08;18;Maanantai;9;13;22
94;27.08.2018;2018;08;19;Maanantai;9;15;24
94;27.08.2018;2018;08;20;Maanantai;3;12;15
94;27.08.2018;2018;08;21;Maanantai;2;1;3
94;27.08.2018;2018;08;22;Maanantai;0;2;2
94;27.08.2018;2018;08;23;Maanantai;0;0;0
94;28.08.2018;2018;08;00;Tiistai;1;0;1
94;28.08.2018;2018;08;01;Tiistai;0;0;0
94;28.08.2018;2018;08;02;Tiistai;0;0;0
94;28.08.2018;2018;08;03;Tiistai;0;0;0
94;28.08.2018;2018;08;04;Tiistai;1;0;1
94;28.08.2018;2018;08;05;Tiistai;9;3;12
94;28.08.2018;2018;08;06;Tiistai;19;1;20
94;28.08.2018;2018;08;07;Tiistai;26;3;29
94;28.08.2018;2018;08;08;Tiistai;18;2;20
94;28.08.2018;2018;08;09;Tiistai;4;3;7
94;28.08.2018;2018;08;10;Tiistai;9;10;19
94;28.08.2018;2018;08;11;Tiistai;3;5;8
94;28.08.2018;2018;08;12;Tiistai;6;5;11
94;28.08.2018;2018;08;13;Tiistai;7;6;13
94;28.08.2018;2018;08;14;Tiistai;5;7;12
94;28.08.2018;2018;08;15;Tiistai;3;24;27
94;28.08.2018;2018;08;16;Tiistai;4;29;33
94;28.08.2018;2018;08;17;Tiistai;5;16;21
94;28.08.2018;2018;08;18;Tiistai;9;21;30
94;28.08.2018;2018;08;19;Tiistai;2;4;6
94;28.08.2018;2018;08;20;Tiistai;6;12;18
94;28.08.2018;2018;08;21;Tiistai;2;4;6
94;28.08.2018;2018;08;22;Tiistai;1;4;5
94;28.08.2018;2018;08;23;Tiistai;0;0;0
94;29.08.2018;2018;08;00;Keskiviikko;0;1;1
94;29.08.2018;2018;08;01;Keskiviikko;0;1;1
94;29.08.2018;2018;08;02;Keskiviikko;0;0;0
94;29.08.2018;2018;08;03;Keskiviikko;0;0;0
94;29.08.2018;2018;08;04;Keskiviikko;1;0;1
94;29.08.2018;2018;08;05;Keskiviikko;7;2;9
94;29.08.2018;2018;08;06;Keskiviikko;18;2;20
94;29.08.2018;2018;08;07;Keskiviikko;29;2;31
94;29.08.2018;2018;08;08;Keskiviikko;19;7;26
94;29.08.2018;2018;08;09;Keskiviikko;10;2;12
94;29.08.2018;2018;08;10;Keskiviikko;4;4;8
94;29.08.2018;2018;08;11;Keskiviikko;4;4;8
94;29.08.2018;2018;08;12;Keskiviikko;2;0;2
94;29.08.2018;2018;08;13;Keskiviikko;6;5;11
94;29.08.2018;2018;08;14;Keskiviikko;5;9;14
94;29.08.2018;2018;08;15;Keskiviikko;9;21;30
94;29.08.2018;2018;08;16;Keskiviikko;6;34;40
94;29.08.2018;2018;08;17;Keskiviikko;10;19;29
94;29.08.2018;2018;08;18;Keskiviikko;16;16;32
94;29.08.2018;2018;08;19;Keskiviikko;3;15;18
94;29.08.2018;2018;08;20;Keskiviikko;4;15;19
94;29.08.2018;2018;08;21;Keskiviikko;3;8;11
94;29.08.2018;2018;08;22;Keskiviikko;1;2;3
94;29.08.2018;2018;08;23;Keskiviikko;0;1;1
94;30.08.2018;2018;08;00;Torstai;0;0;0
94;30.08.2018;2018;08;01;Torstai;0;0;0
94;30.08.2018;2018;08;02;Torstai;0;0;0
94;30.08.2018;2018;08;03;Torstai;0;0;0
94;30.08.2018;2018;08;04;Torstai;1;0;1
94;30.08.2018;2018;08;05;Torstai;7;4;11
94;30.08.2018;2018;08;06;Torstai;17;3;20
94;30.08.2018;2018;08;07;Torstai;32;5;37
94;30.08.2018;2018;08;08;Torstai;17;6;23
94;30.08.2018;2018;08;09;Torstai;5;2;7
94;30.08.2018;2018;08;10;Torstai;2;2;4
94;30.08.2018;2018;08;11;Torstai;9;2;11
94;30.08.2018;2018;08;12;Torstai;5;5;10
94;30.08.2018;2018;08;13;Torstai;3;13;16
94;30.08.2018;2018;08;14;Torstai;5;11;16
94;30.08.2018;2018;08;15;Torstai;10;23;33
94;30.08.2018;2018;08;16;Torstai;3;31;34
94;30.08.2018;2018;08;17;Torstai;3;13;16
94;30.08.2018;2018;08;18;Torstai;10;15;25
94;30.08.2018;2018;08;19;Torstai;1;3;4
94;30.08.2018;2018;08;20;Torstai;2;2;4
94;30.08.2018;2018;08;21;Torstai;3;1;4
94;30.08.2018;2018;08;22;Torstai;0;1;1
94;30.08.2018;2018;08;23;Torstai;0;1;1
94;31.08.2018;2018;08;00;Perjantai;0;0;0
94;31.08.2018;2018;08;01;Perjantai;0;0;0
94;31.08.2018;2018;08;02;Perjantai;0;0;0
94;31.08.2018;2018;08;03;Perjantai;0;0;0
94;31.08.2018;2018;08;04;Perjantai;1;0;1
94;31.08.2018;2018;08;05;Perjantai;7;1;8
94;31.08.2018;2018;08;06;Perjantai;8;2;10
94;31.08.2018;2018;08;07;Perjantai;23;5;28
94;31.08.2018;2018;08;08;Perjantai;15;3;18
94;31.08.2018;2018;08;09;Perjantai;7;1;8
94;31.08.2018;2018;08;10;Perjantai;4;3;7
94;31.08.2018;2018;08;11;Perjantai;1;3;4
94;31.08.2018;2018;08;12;Perjantai;3;20;23
94;31.08.2018;2018;08;13;Perjantai;4;7;11
94;31.08.2018;2018;08;14;Perjantai;5;10;15
94;31.08.2018;2018;08;15;Perjantai;7;15;22
94;31.08.2018;2018;08;16;Perjantai;6;16;22
94;31.08.2018;2018;08;17;Perjantai;7;19;26
94;31.08.2018;2018;08;18;Perjantai;4;6;10
94;31.08.2018;2018;08;19;Perjantai;4;9;13
94;31.08.2018;2018;08;20;Perjantai;3;11;14
94;31.08.2018;2018;08;21;Perjantai;4;5;9
94;31.08.2018;2018;08;22;Perjantai;2;2;4
94;31.08.2018;2018;08;23;Perjantai;0;6;6
94;01.09.2018;2018;09;00;Lauantai;1;0;1
94;01.09.2018;2018;09;01;Lauantai;0;0;0
94;01.09.2018;2018;09;02;Lauantai;0;0;0
94;01.09.2018;2018;09;03;Lauantai;1;1;2
94;01.09.2018;2018;09;04;Lauantai;0;0;0
94;01.09.2018;2018;09;05;Lauantai;1;0;1
94;01.09.2018;2018;09;06;Lauantai;3;1;4
94;01.09.2018;2018;09;07;Lauantai;2;0;2
94;01.09.2018;2018;09;08;Lauantai;3;2;5
94;01.09.2018;2018;09;09;Lauantai;7;4;11
94;01.09.2018;2018;09;10;Lauantai;7;8;15
94;01.09.2018;2018;09;11;Lauantai;9;10;19
94;01.09.2018;2018;09;12;Lauantai;10;8;18
94;01.09.2018;2018;09;13;Lauantai;8;8;16
94;01.09.2018;2018;09;14;Lauantai;6;5;11
94;01.09.2018;2018;09;15;Lauantai;9;11;20
94;01.09.2018;2018;09;16;Lauantai;13;8;21
94;01.09.2018;2018;09;17;Lauantai;17;9;26
94;01.09.2018;2018;09;18;Lauantai;9;4;13
94;01.09.2018;2018;09;19;Lauantai;5;5;10
94;01.09.2018;2018;09;20;Lauantai;7;8;15
94;01.09.2018;2018;09;21;Lauantai;0;1;1
94;01.09.2018;2018;09;22;Lauantai;2;3;5
94;01.09.2018;2018;09;23;Lauantai;0;6;6
94;02.09.2018;2018;09;00;Sunnuntai;1;8;9
94;02.09.2018;2018;09;01;Sunnuntai;0;0;0
94;02.09.2018;2018;09;02;Sunnuntai;0;0;0
94;02.09.2018;2018;09;03;Sunnuntai;0;0;0
94;02.09.2018;2018;09;04;Sunnuntai;0;0;0
94;02.09.2018;2018;09;05;Sunnuntai;0;0;0
94;02.09.2018;2018;09;06;Sunnuntai;1;1;2
94;02.09.2018;2018;09;07;Sunnuntai;1;0;1
94;02.09.2018;2018;09;08;Sunnuntai;1;1;2
94;02.09.2018;2018;09;09;Sunnuntai;5;1;6
94;02.09.2018;2018;09;10;Sunnuntai;6;9;15
94;02.09.2018;2018;09;11;Sunnuntai;12;5;17
94;02.09.2018;2018;09;12;Sunnuntai;15;9;24
94;02.09.2018;2018;09;13;Sunnuntai;8;10;18
94;02.09.2018;2018;09;14;Sunnuntai;13;14;27
94;02.09.2018;2018;09;15;Sunnuntai;17;14;31
94;02.09.2018;2018;09;16;Sunnuntai;17;12;29
94;02.09.2018;2018;09;17;Sunnuntai;7;11;18
94;02.09.2018;2018;09;18;Sunnuntai;9;9;18
94;02.09.2018;2018;09;19;Sunnuntai;12;10;22
94;02.09.2018;2018;09;20;Sunnuntai;0;2;2
94;02.09.2018;2018;09;21;Sunnuntai;1;4;5
94;02.09.2018;2018;09;22;Sunnuntai;0;1;1
94;02.09.2018;2018;09;23;Sunnuntai;0;1;1
94;03.09.2018;2018;09;00;Maanantai;0;0;0
94;03.09.2018;2018;09;01;Maanantai;0;0;0
94;03.09.2018;2018;09;02;Maanantai;0;0;0
94;03.09.2018;2018;09;03;Maanantai;0;0;0
94;03.09.2018;2018;09;04;Maanantai;2;0;2
94;03.09.2018;2018;09;05;Maanantai;5;2;7
94;03.09.2018;2018;09;06;Maanantai;23;1;24
94;03.09.2018;2018;09;07;Maanantai;24;3;27
94;03.09.2018;2018;09;08;Maanantai;10;7;17
94;03.09.2018;2018;09;09;Maanantai;5;2;7
94;03.09.2018;2018;09;10;Maanantai;9;3;12
94;03.09.2018;2018;09;11;Maanantai;4;2;6
94;03.09.2018;2018;09;12;Maanantai;6;2;8
94;03.09.2018;2018;09;13;Maanantai;8;12;20
94;03.09.2018;2018;09;14;Maanantai;6;10;16
94;03.09.2018;2018;09;15;Maanantai;13;21;34
94;03.09.2018;2018;09;16;Maanantai;12;27;39
94;03.09.2018;2018;09;17;Maanantai;8;15;23
94;03.09.2018;2018;09;18;Maanantai;8;10;18
94;03.09.2018;2018;09;19;Maanantai;5;14;19
94;03.09.2018;2018;09;20;Maanantai;0;8;8
94;03.09.2018;2018;09;21;Maanantai;4;10;14
94;03.09.2018;2018;09;22;Maanantai;1;6;7
94;03.09.2018;2018;09;23;Maanantai;0;0;0
94;04.09.2018;2018;09;00;Tiistai;0;0;0
94;04.09.2018;2018;09;01;Tiistai;0;0;0
94;04.09.2018;2018;09;02;Tiistai;0;0;0
94;04.09.2018;2018;09;03;Tiistai;0;0;0
94;04.09.2018;2018;09;04;Tiistai;1;0;1
94;04.09.2018;2018;09;05;Tiistai;4;2;6
94;04.09.2018;2018;09;06;Tiistai;25;1;26
94;04.09.2018;2018;09;07;Tiistai;27;3;30
94;04.09.2018;2018;09;08;Tiistai;16;1;17
94;04.09.2018;2018;09;09;Tiistai;7;5;12
94;04.09.2018;2018;09;10;Tiistai;9;2;11
94;04.09.2018;2018;09;11;Tiistai;6;2;8
94;04.09.2018;2018;09;12;Tiistai;6;6;12
94;04.09.2018;2018;09;13;Tiistai;2;7;9
94;04.09.2018;2018;09;14;Tiistai;4;11;15
94;04.09.2018;2018;09;15;Tiistai;9;31;40
94;04.09.2018;2018;09;16;Tiistai;7;33;40
94;04.09.2018;2018;09;17;Tiistai;6;16;22
94;04.09.2018;2018;09;18;Tiistai;3;10;13
94;04.09.2018;2018;09;19;Tiistai;5;4;9
94;04.09.2018;2018;09;20;Tiistai;4;9;13
94;04.09.2018;2018;09;21;Tiistai;0;5;5
94;04.09.2018;2018;09;22;Tiistai;0;2;2
94;04.09.2018;2018;09;23;Tiistai;0;0;0
94;05.09.2018;2018;09;00;Keskiviikko;0;0;0
94;05.09.2018;2018;09;01;Keskiviikko;0;0;0
94;05.09.2018;2018;09;02;Keskiviikko;0;0;0
94;05.09.2018;2018;09;03;Keskiviikko;0;0;0
94;05.09.2018;2018;09;04;Keskiviikko;1;0;1
94;05.09.2018;2018;09;05;Keskiviikko;4;1;5
94;05.09.2018;2018;09;06;Keskiviikko;16;3;19
94;05.09.2018;2018;09;07;Keskiviikko;18;3;21
94;05.09.2018;2018;09;08;Keskiviikko;16;3;19
94;05.09.2018;2018;09;09;Keskiviikko;8;0;8
94;05.09.2018;2018;09;10;Keskiviikko;4;2;6
94;05.09.2018;2018;09;11;Keskiviikko;6;3;9
94;05.09.2018;2018;09;12;Keskiviikko;3;2;5
94;05.09.2018;2018;09;13;Keskiviikko;3;6;9
94;05.09.2018;2018;09;14;Keskiviikko;6;7;13
94;05.09.2018;2018;09;15;Keskiviikko;6;12;18
94;05.09.2018;2018;09;16;Keskiviikko;7;30;37
94;05.09.2018;2018;09;17;Keskiviikko;9;13;22
94;05.09.2018;2018;09;18;Keskiviikko;9;10;19
94;05.09.2018;2018;09;19;Keskiviikko;6;11;17
94;05.09.2018;2018;09;20;Keskiviikko;2;9;11
94;05.09.2018;2018;09;21;Keskiviikko;0;4;4
94;05.09.2018;2018;09;22;Keskiviikko;0;2;2
94;05.09.2018;2018;09;23;Keskiviikko;1;0;1
94;06.09.2018;2018;09;00;Torstai;0;0;0
94;06.09.2018;2018;09;01;Torstai;0;0;0
94;06.09.2018;2018;09;02;Torstai;0;0;0
94;06.09.2018;2018;09;03;Torstai;0;1;1
94;06.09.2018;2018;09;04;Torstai;1;0;1
94;06.09.2018;2018;09;05;Torstai;4;2;6
94;06.09.2018;2018;09;06;Torstai;14;2;16
94;06.09.2018;2018;09;07;Torstai;23;5;28
94;06.09.2018;2018;09;08;Torstai;13;4;17
94;06.09.2018;2018;09;09;Torstai;7;3;10
94;06.09.2018;2018;09;10;Torstai;6;0;6
94;06.09.2018;2018;09;11;Torstai;1;1;2
94;06.09.2018;2018;09;12;Torstai;2;2;4
94;06.09.2018;2018;09;13;Torstai;1;5;6
94;06.09.2018;2018;09;14;Torstai;3;8;11
94;06.09.2018;2018;09;15;Torstai;3;12;15
94;06.09.2018;2018;09;16;Torstai;4;18;22
94;06.09.2018;2018;09;17;Torstai;1;11;12
94;06.09.2018;2018;09;18;Torstai;1;6;7
94;06.09.2018;2018;09;19;Torstai;2;1;3
94;06.09.2018;2018;09;20;Torstai;3;7;10
94;06.09.2018;2018;09;21;Torstai;0;2;2
94;06.09.2018;2018;09;22;Torstai;0;1;1
94;06.09.2018;2018;09;23;Torstai;0;0;0
94;07.09.2018;2018;09;00;Perjantai;0;0;0
94;07.09.2018;2018;09;01;Perjantai;2;0;2
94;07.09.2018;2018;09;02;Perjantai;0;0;0
94;07.09.2018;2018;09;03;Perjantai;0;0;0
94;07.09.2018;2018;09;04;Perjantai;1;0;1
94;07.09.2018;2018;09;05;Perjantai;4;4;8
94;07.09.2018;2018;09;06;Perjantai;15;0;15
94;07.09.2018;2018;09;07;Perjantai;21;3;24
94;07.09.2018;2018;09;08;Perjantai;8;2;10
94;07.09.2018;2018;09;09;Perjantai;6;2;8
94;07.09.2018;2018;09;10;Perjantai;1;4;5
94;07.09.2018;2018;09;11;Perjantai;5;5;10
94;07.09.2018;2018;09;12;Perjantai;1;3;4
94;07.09.2018;2018;09;13;Perjantai;8;5;13
94;07.09.2018;2018;09;14;Perjantai;8;14;22
94;07.09.2018;2018;09;15;Perjantai;3;21;24
94;07.09.2018;2018;09;16;Perjantai;9;19;28
94;07.09.2018;2018;09;17;Perjantai;9;16;25
94;07.09.2018;2018;09;18;Perjantai;7;8;15
94;07.09.2018;2018;09;19;Perjantai;6;7;13
94;07.09.2018;2018;09;20;Perjantai;7;2;9
94;07.09.2018;2018;09;21;Perjantai;0;5;5
94;07.09.2018;2018;09;22;Perjantai;2;5;7
94;07.09.2018;2018;09;23;Perjantai;0;3;3
94;08.09.2018;2018;09;00;Lauantai;1;1;2
94;08.09.2018;2018;09;01;Lauantai;0;0;0
94;08.09.2018;2018;09;02;Lauantai;0;0;0
94;08.09.2018;2018;09;03;Lauantai;1;0;1
94;08.09.2018;2018;09;04;Lauantai;0;0;0
94;08.09.2018;2018;09;05;Lauantai;0;0;0
94;08.09.2018;2018;09;06;Lauantai;1;0;1
94;08.09.2018;2018;09;07;Lauantai;1;0;1
94;08.09.2018;2018;09;08;Lauantai;2;2;4
94;08.09.2018;2018;09;09;Lauantai;6;3;9
94;08.09.2018;2018;09;10;Lauantai;8;5;13
94;08.09.2018;2018;09;11;Lauantai;10;25;35
94;08.09.2018;2018;09;12;Lauantai;4;26;30
94;08.09.2018;2018;09;13;Lauantai;10;12;22
94;08.09.2018;2018;09;14;Lauantai;9;13;22
94;08.09.2018;2018;09;15;Lauantai;6;18;24
94;08.09.2018;2018;09;16;Lauantai;12;15;27
94;08.09.2018;2018;09;17;Lauantai;39;13;52
94;08.09.2018;2018;09;18;Lauantai;11;6;17
94;08.09.2018;2018;09;19;Lauantai;14;3;17
94;08.09.2018;2018;09;20;Lauantai;2;4;6
94;08.09.2018;2018;09;21;Lauantai;3;3;6
94;08.09.2018;2018;09;22;Lauantai;4;1;5
94;08.09.2018;2018;09;23;Lauantai;0;3;3
94;09.09.2018;2018;09;00;Sunnuntai;0;0;0
94;09.09.2018;2018;09;01;Sunnuntai;0;0;0
94;09.09.2018;2018;09;02;Sunnuntai;0;0;0
94;09.09.2018;2018;09;03;Sunnuntai;0;0;0
94;09.09.2018;2018;09;04;Sunnuntai;0;0;0
94;09.09.2018;2018;09;05;Sunnuntai;0;0;0
94;09.09.2018;2018;09;06;Sunnuntai;2;0;2
94;09.09.2018;2018;09;07;Sunnuntai;0;1;1
94;09.09.2018;2018;09;08;Sunnuntai;3;1;4
94;09.09.2018;2018;09;09;Sunnuntai;5;0;5
94;09.09.2018;2018;09;10;Sunnuntai;1;9;10
94;09.09.2018;2018;09;11;Sunnuntai;11;10;21
94;09.09.2018;2018;09;12;Sunnuntai;8;16;24
94;09.09.2018;2018;09;13;Sunnuntai;10;9;19
94;09.09.2018;2018;09;14;Sunnuntai;12;5;17
94;09.09.2018;2018;09;15;Sunnuntai;5;9;14
94;09.09.2018;2018;09;16;Sunnuntai;5;7;12
94;09.09.2018;2018;09;17;Sunnuntai;9;10;19
94;09.09.2018;2018;09;18;Sunnuntai;6;5;11
94;09.09.2018;2018;09;19;Sunnuntai;7;3;10
94;09.09.2018;2018;09;20;Sunnuntai;1;6;7
94;09.09.2018;2018;09;21;Sunnuntai;1;1;2
94;09.09.2018;2018;09;22;Sunnuntai;0;1;1
94;09.09.2018;2018;09;23;Sunnuntai;0;0;0
94;10.09.2018;2018;09;00;Maanantai;0;1;1
94;10.09.2018;2018;09;01;Maanantai;0;0;0
94;10.09.2018;2018;09;02;Maanantai;0;0;0
94;10.09.2018;2018;09;03;Maanantai;0;0;0
94;10.09.2018;2018;09;04;Maanantai;1;0;1
94;10.09.2018;2018;09;05;Maanantai;7;3;10
94;10.09.2018;2018;09;06;Maanantai;17;2;19
94;10.09.2018;2018;09;07;Maanantai;26;3;29
94;10.09.2018;2018;09;08;Maanantai;11;4;15
94;10.09.2018;2018;09;09;Maanantai;5;1;6
94;10.09.2018;2018;09;10;Maanantai;6;3;9
94;10.09.2018;2018;09;11;Maanantai;6;3;9
94;10.09.2018;2018;09;12;Maanantai;2;2;4
94;10.09.2018;2018;09;13;Maanantai;8;7;15
94;10.09.2018;2018;09;14;Maanantai;5;8;13
94;10.09.2018;2018;09;15;Maanantai;9;20;29
94;10.09.2018;2018;09;16;Maanantai;2;24;26
94;10.09.2018;2018;09;17;Maanantai;4;14;18
94;10.09.2018;2018;09;18;Maanantai;8;14;22
94;10.09.2018;2018;09;19;Maanantai;7;5;12
94;10.09.2018;2018;09;20;Maanantai;6;11;17
94;10.09.2018;2018;09;21;Maanantai;2;2;4
94;10.09.2018;2018;09;22;Maanantai;2;1;3
94;10.09.2018;2018;09;23;Maanantai;0;2;2
94;11.09.2018;2018;09;00;Tiistai;0;1;1
94;11.09.2018;2018;09;01;Tiistai;0;0;0
94;11.09.2018;2018;09;02;Tiistai;0;1;1
94;11.09.2018;2018;09;03;Tiistai;0;0;0
94;11.09.2018;2018;09;04;Tiistai;1;0;1
94;11.09.2018;2018;09;05;Tiistai;6;4;10
94;11.09.2018;2018;09;06;Tiistai;12;1;13
94;11.09.2018;2018;09;07;Tiistai;13;1;14
94;11.09.2018;2018;09;08;Tiistai;10;2;12
94;11.09.2018;2018;09;09;Tiistai;6;2;8
94;11.09.2018;2018;09;10;Tiistai;2;1;3
94;11.09.2018;2018;09;11;Tiistai;2;2;4
94;11.09.2018;2018;09;12;Tiistai;1;2;3
94;11.09.2018;2018;09;13;Tiistai;1;2;3
94;11.09.2018;2018;09;14;Tiistai;3;9;12
94;11.09.2018;2018;09;15;Tiistai;5;12;17
94;11.09.2018;2018;09;16;Tiistai;4;12;16
94;11.09.2018;2018;09;17;Tiistai;3;11;14
94;11.09.2018;2018;09;18;Tiistai;1;1;2
94;11.09.2018;2018;09;19;Tiistai;1;7;8
94;11.09.2018;2018;09;20;Tiistai;2;4;6
94;11.09.2018;2018;09;21;Tiistai;0;2;2
94;11.09.2018;2018;09;22;Tiistai;0;2;2
94;11.09.2018;2018;09;23;Tiistai;0;0;0
94;12.09.2018;2018;09;00;Keskiviikko;0;0;0
94;12.09.2018;2018;09;01;Keskiviikko;0;0;0
94;12.09.2018;2018;09;02;Keskiviikko;0;0;0
94;12.09.2018;2018;09;03;Keskiviikko;0;0;0
94;12.09.2018;2018;09;04;Keskiviikko;1;0;1
94;12.09.2018;2018;09;05;Keskiviikko;3;2;5
94;12.09.2018;2018;09;06;Keskiviikko;5;0;5
94;12.09.2018;2018;09;07;Keskiviikko;6;1;7
94;12.09.2018;2018;09;08;Keskiviikko;9;3;12
94;12.09.2018;2018;09;09;Keskiviikko;5;1;6
94;12.09.2018;2018;09;10;Keskiviikko;2;0;2
94;12.09.2018;2018;09;11;Keskiviikko;1;0;1
94;12.09.2018;2018;09;12;Keskiviikko;1;1;2
94;12.09.2018;2018;09;13;Keskiviikko;1;2;3
94;12.09.2018;2018;09;14;Keskiviikko;2;7;9
94;12.09.2018;2018;09;15;Keskiviikko;1;10;11
94;12.09.2018;2018;09;16;Keskiviikko;2;9;11
94;12.09.2018;2018;09;17;Keskiviikko;7;2;9
94;12.09.2018;2018;09;18;Keskiviikko;2;4;6
94;12.09.2018;2018;09;19;Keskiviikko;0;11;11
94;12.09.2018;2018;09;20;Keskiviikko;1;8;9
94;12.09.2018;2018;09;21;Keskiviikko;0;1;1
94;12.09.2018;2018;09;22;Keskiviikko;0;1;1
94;12.09.2018;2018;09;23;Keskiviikko;0;1;1
94;13.09.2018;2018;09;00;Torstai;0;1;1
94;13.09.2018;2018;09;01;Torstai;0;0;0
94;13.09.2018;2018;09;02;Torstai;0;0;0
94;13.09.2018;2018;09;03;Torstai;0;0;0
94;13.09.2018;2018;09;04;Torstai;1;0;1
94;13.09.2018;2018;09;05;Torstai;4;2;6
94;13.09.2018;2018;09;06;Torstai;12;1;13
94;13.09.2018;2018;09;07;Torstai;18;5;23
94;13.09.2018;2018;09;08;Torstai;16;4;20
94;13.09.2018;2018;09;09;Torstai;3;3;6
94;13.09.2018;2018;09;10;Torstai;7;2;9
94;13.09.2018;2018;09;11;Torstai;4;2;6
94;13.09.2018;2018;09;12;Torstai;4;3;7
94;13.09.2018;2018;09;13;Torstai;2;5;7
94;13.09.2018;2018;09;14;Torstai;8;7;15
94;13.09.2018;2018;09;15;Torstai;5;15;20
94;13.09.2018;2018;09;16;Torstai;4;22;26
94;13.09.2018;2018;09;17;Torstai;8;12;20
94;13.09.2018;2018;09;18;Torstai;11;6;17
94;13.09.2018;2018;09;19;Torstai;3;1;4
94;13.09.2018;2018;09;20;Torstai;4;6;10
94;13.09.2018;2018;09;21;Torstai;0;9;9
94;13.09.2018;2018;09;22;Torstai;0;4;4
94;13.09.2018;2018;09;23;Torstai;0;1;1
94;14.09.2018;2018;09;00;Perjantai;0;1;1
94;14.09.2018;2018;09;01;Perjantai;0;0;0
94;14.09.2018;2018;09;02;Perjantai;0;0;0
94;14.09.2018;2018;09;03;Perjantai;0;0;0
94;14.09.2018;2018;09;04;Perjantai;2;0;2
94;14.09.2018;2018;09;05;Perjantai;2;2;4
94;14.09.2018;2018;09;06;Perjantai;19;1;20
94;14.09.2018;2018;09;07;Perjantai;19;5;24
94;14.09.2018;2018;09;08;Perjantai;9;2;11
94;14.09.2018;2018;09;09;Perjantai;6;3;9
94;14.09.2018;2018;09;10;Perjantai;5;2;7
94;14.09.2018;2018;09;11;Perjantai;4;8;12
94;14.09.2018;2018;09;12;Perjantai;6;8;14
94;14.09.2018;2018;09;13;Perjantai;5;2;7
94;14.09.2018;2018;09;14;Perjantai;7;14;21
94;14.09.2018;2018;09;15;Perjantai;2;13;15
94;14.09.2018;2018;09;16;Perjantai;4;16;20
94;14.09.2018;2018;09;17;Perjantai;1;5;6
94;14.09.2018;2018;09;18;Perjantai;2;2;4
94;14.09.2018;2018;09;19;Perjantai;3;6;9
94;14.09.2018;2018;09;20;Perjantai;3;1;4
94;14.09.2018;2018;09;21;Perjantai;1;4;5
94;14.09.2018;2018;09;22;Perjantai;0;1;1
94;14.09.2018;2018;09;23;Perjantai;0;0;0
94;15.09.2018;2018;09;00;Lauantai;2;3;5
94;15.09.2018;2018;09;01;Lauantai;0;0;0
94;15.09.2018;2018;09;02;Lauantai;0;0;0
94;15.09.2018;2018;09;03;Lauantai;1;0;1
94;15.09.2018;2018;09;04;Lauantai;0;0;0
94;15.09.2018;2018;09;05;Lauantai;0;2;2
94;15.09.2018;2018;09;06;Lauantai;0;1;1
94;15.09.2018;2018;09;07;Lauantai;1;0;1
94;15.09.2018;2018;09;08;Lauantai;3;0;3
94;15.09.2018;2018;09;09;Lauantai;2;5;7
94;15.09.2018;2018;09;10;Lauantai;3;8;11
94;15.09.2018;2018;09;11;Lauantai;9;8;17
94;15.09.2018;2018;09;12;Lauantai;5;7;12
94;15.09.2018;2018;09;13;Lauantai;3;1;4
94;15.09.2018;2018;09;14;Lauantai;3;1;4
94;15.09.2018;2018;09;15;Lauantai;0;1;1
94;15.09.2018;2018;09;16;Lauantai;8;1;9
94;15.09.2018;2018;09;17;Lauantai;2;0;2
94;15.09.2018;2018;09;18;Lauantai;6;7;13
94;15.09.2018;2018;09;19;Lauantai;3;4;7
94;15.09.2018;2018;09;20;Lauantai;1;4;5
94;15.09.2018;2018;09;21;Lauantai;2;1;3
94;15.09.2018;2018;09;22;Lauantai;1;6;7
94;15.09.2018;2018;09;23;Lauantai;0;2;2
94;16.09.2018;2018;09;00;Sunnuntai;0;0;0
94;16.09.2018;2018;09;01;Sunnuntai;0;0;0
94;16.09.2018;2018;09;02;Sunnuntai;0;2;2
94;16.09.2018;2018;09;03;Sunnuntai;0;1;1
94;16.09.2018;2018;09;04;Sunnuntai;0;0;0
94;16.09.2018;2018;09;05;Sunnuntai;0;0;0
94;16.09.2018;2018;09;06;Sunnuntai;0;1;1
94;16.09.2018;2018;09;07;Sunnuntai;1;1;2
94;16.09.2018;2018;09;08;Sunnuntai;2;1;3
94;16.09.2018;2018;09;09;Sunnuntai;3;2;5
94;16.09.2018;2018;09;10;Sunnuntai;8;10;18
94;16.09.2018;2018;09;11;Sunnuntai;4;5;9
94;16.09.2018;2018;09;12;Sunnuntai;3;3;6
94;16.09.2018;2018;09;13;Sunnuntai;5;6;11
94;16.09.2018;2018;09;14;Sunnuntai;6;6;12
94;16.09.2018;2018;09;15;Sunnuntai;6;2;8
94;16.09.2018;2018;09;16;Sunnuntai;4;4;8
94;16.09.2018;2018;09;17;Sunnuntai;4;2;6
94;16.09.2018;2018;09;18;Sunnuntai;3;0;3
94;16.09.2018;2018;09;19;Sunnuntai;4;4;8
94;16.09.2018;2018;09;20;Sunnuntai;0;1;1
94;16.09.2018;2018;09;21;Sunnuntai;0;2;2
94;16.09.2018;2018;09;22;Sunnuntai;0;1;1
94;16.09.2018;2018;09;23;Sunnuntai;0;1;1
94;17.09.2018;2018;09;00;Maanantai;0;0;0
94;17.09.2018;2018;09;01;Maanantai;0;0;0
94;17.09.2018;2018;09;02;Maanantai;0;0;0
94;17.09.2018;2018;09;03;Maanantai;0;0;0
94;17.09.2018;2018;09;04;Maanantai;0;0;0
94;17.09.2018;2018;09;05;Maanantai;6;2;8
94;17.09.2018;2018;09;06;Maanantai;13;1;14
94;17.09.2018;2018;09;07;Maanantai;21;2;23
94;17.09.2018;2018;09;08;Maanantai;11;8;19
94;17.09.2018;2018;09;09;Maanantai;5;5;10
94;17.09.2018;2018;09;10;Maanantai;5;3;8
94;17.09.2018;2018;09;11;Maanantai;4;1;5
94;17.09.2018;2018;09;12;Maanantai;3;1;4
94;17.09.2018;2018;09;13;Maanantai;5;2;7
94;17.09.2018;2018;09;14;Maanantai;6;6;12
94;17.09.2018;2018;09;15;Maanantai;9;13;22
94;17.09.2018;2018;09;16;Maanantai;7;25;32
94;17.09.2018;2018;09;17;Maanantai;5;12;17
94;17.09.2018;2018;09;18;Maanantai;5;8;13
94;17.09.2018;2018;09;19;Maanantai;5;8;13
94;17.09.2018;2018;09;20;Maanantai;3;10;13
94;17.09.2018;2018;09;21;Maanantai;2;1;3
94;17.09.2018;2018;09;22;Maanantai;0;3;3
94;17.09.2018;2018;09;23;Maanantai;0;1;1
94;18.09.2018;2018;09;00;Tiistai;0;0;0
94;18.09.2018;2018;09;01;Tiistai;0;0;0
94;18.09.2018;2018;09;02;Tiistai;0;0;0
94;18.09.2018;2018;09;03;Tiistai;0;0;0
94;18.09.2018;2018;09;04;Tiistai;0;0;0
94;18.09.2018;2018;09;05;Tiistai;5;4;9
94;18.09.2018;2018;09;06;Tiistai;16;1;17
94;18.09.2018;2018;09;07;Tiistai;18;2;20
94;18.09.2018;2018;09;08;Tiistai;11;6;17
94;18.09.2018;2018;09;09;Tiistai;9;1;10
94;18.09.2018;2018;09;10;Tiistai;8;4;12
94;18.09.2018;2018;09;11;Tiistai;7;8;15
94;18.09.2018;2018;09;12;Tiistai;4;6;10
94;18.09.2018;2018;09;13;Tiistai;3;7;10
94;18.09.2018;2018;09;14;Tiistai;6;9;15
94;18.09.2018;2018;09;15;Tiistai;12;17;29
94;18.09.2018;2018;09;16;Tiistai;6;20;26
94;18.09.2018;2018;09;17;Tiistai;4;13;17
94;18.09.2018;2018;09;18;Tiistai;10;13;23
94;18.09.2018;2018;09;19;Tiistai;4;3;7
94;18.09.2018;2018;09;20;Tiistai;2;8;10
94;18.09.2018;2018;09;21;Tiistai;1;1;2
94;18.09.2018;2018;09;22;Tiistai;0;4;4
94;18.09.2018;2018;09;23;Tiistai;0;0;0
94;19.09.2018;2018;09;00;Keskiviikko;0;0;0
94;19.09.2018;2018;09;01;Keskiviikko;0;0;0
94;19.09.2018;2018;09;02;Keskiviikko;0;0;0
94;19.09.2018;2018;09;03;Keskiviikko;0;0;0
94;19.09.2018;2018;09;04;Keskiviikko;0;0;0
94;19.09.2018;2018;09;05;Keskiviikko;6;3;9
94;19.09.2018;2018;09;06;Keskiviikko;12;0;12
94;19.09.2018;2018;09;07;Keskiviikko;11;3;14
94;19.09.2018;2018;09;08;Keskiviikko;12;6;18
94;19.09.2018;2018;09;09;Keskiviikko;5;0;5
94;19.09.2018;2018;09;10;Keskiviikko;0;3;3
94;19.09.2018;2018;09;11;Keskiviikko;2;2;4
94;19.09.2018;2018;09;12;Keskiviikko;2;1;3
94;19.09.2018;2018;09;13;Keskiviikko;1;3;4
94;19.09.2018;2018;09;14;Keskiviikko;6;4;10
94;19.09.2018;2018;09;15;Keskiviikko;5;10;15
94;19.09.2018;2018;09;16;Keskiviikko;2;11;13
94;19.09.2018;2018;09;17;Keskiviikko;0;6;6
94;19.09.2018;2018;09;18;Keskiviikko;5;7;12
94;19.09.2018;2018;09;19;Keskiviikko;2;4;6
94;19.09.2018;2018;09;20;Keskiviikko;2;4;6
94;19.09.2018;2018;09;21;Keskiviikko;4;3;7
94;19.09.2018;2018;09;22;Keskiviikko;0;2;2
94;19.09.2018;2018;09;23;Keskiviikko;0;1;1
94;20.09.2018;2018;09;00;Torstai;0;0;0
94;20.09.2018;2018;09;01;Torstai;0;0;0
94;20.09.2018;2018;09;02;Torstai;0;0;0
94;20.09.2018;2018;09;03;Torstai;0;0;0
94;20.09.2018;2018;09;04;Torstai;0;0;0
94;20.09.2018;2018;09;05;Torstai;8;3;11
94;20.09.2018;2018;09;06;Torstai;11;0;11
94;20.09.2018;2018;09;07;Torstai;13;5;18
94;20.09.2018;2018;09;08;Torstai;9;4;13
94;20.09.2018;2018;09;09;Torstai;2;2;4
94;20.09.2018;2018;09;10;Torstai;2;2;4
94;20.09.2018;2018;09;11;Torstai;2;3;5
94;20.09.2018;2018;09;12;Torstai;1;1;2
94;20.09.2018;2018;09;13;Torstai;3;3;6
94;20.09.2018;2018;09;14;Torstai;3;4;7
94;20.09.2018;2018;09;15;Torstai;6;15;21
94;20.09.2018;2018;09;16;Torstai;2;10;12
94;20.09.2018;2018;09;17;Torstai;4;12;16
94;20.09.2018;2018;09;18;Torstai;5;12;17
94;20.09.2018;2018;09;19;Torstai;5;7;12
94;20.09.2018;2018;09;20;Torstai;3;3;6
94;20.09.2018;2018;09;21;Torstai;2;8;10
94;20.09.2018;2018;09;22;Torstai;0;2;2
94;20.09.2018;2018;09;23;Torstai;0;0;0
94;21.09.2018;2018;09;00;Perjantai;0;0;0
94;21.09.2018;2018;09;01;Perjantai;0;0;0
94;21.09.2018;2018;09;02;Perjantai;0;0;0
94;21.09.2018;2018;09;03;Perjantai;0;0;0
94;21.09.2018;2018;09;04;Perjantai;0;0;0
94;21.09.2018;2018;09;05;Perjantai;4;3;7
94;21.09.2018;2018;09;06;Perjantai;10;1;11
94;21.09.2018;2018;09;07;Perjantai;12;3;15
94;21.09.2018;2018;09;08;Perjantai;14;3;17
94;21.09.2018;2018;09;09;Perjantai;4;3;7
94;21.09.2018;2018;09;10;Perjantai;4;3;7
94;21.09.2018;2018;09;11;Perjantai;2;3;5
94;21.09.2018;2018;09;12;Perjantai;4;4;8
94;21.09.2018;2018;09;13;Perjantai;2;8;10
94;21.09.2018;2018;09;14;Perjantai;12;13;25
94;21.09.2018;2018;09;15;Perjantai;7;9;16
94;21.09.2018;2018;09;16;Perjantai;5;21;26
94;21.09.2018;2018;09;17;Perjantai;4;5;9
94;21.09.2018;2018;09;18;Perjantai;1;6;7
94;21.09.2018;2018;09;19;Perjantai;1;1;2
94;21.09.2018;2018;09;20;Perjantai;1;2;3
94;21.09.2018;2018;09;21;Perjantai;1;2;3
94;21.09.2018;2018;09;22;Perjantai;0;0;0
94;21.09.2018;2018;09;23;Perjantai;0;0;0
94;22.09.2018;2018;09;00;Lauantai;0;1;1
94;22.09.2018;2018;09;01;Lauantai;0;0;0
94;22.09.2018;2018;09;02;Lauantai;0;0;0
94;22.09.2018;2018;09;03;Lauantai;1;0;1
94;22.09.2018;2018;09;04;Lauantai;0;0;0
94;22.09.2018;2018;09;05;Lauantai;0;1;1
94;22.09.2018;2018;09;06;Lauantai;0;0;0
94;22.09.2018;2018;09;07;Lauantai;0;0;0
94;22.09.2018;2018;09;08;Lauantai;1;0;1
94;22.09.2018;2018;09;09;Lauantai;0;1;1
94;22.09.2018;2018;09;10;Lauantai;0;0;0
94;22.09.2018;2018;09;11;Lauantai;0;3;3
94;22.09.2018;2018;09;12;Lauantai;2;2;4
94;22.09.2018;2018;09;13;Lauantai;3;2;5
94;22.09.2018;2018;09;14;Lauantai;3;1;4
94;22.09.2018;2018;09;15;Lauantai;1;3;4
94;22.09.2018;2018;09;16;Lauantai;9;5;14
94;22.09.2018;2018;09;17;Lauantai;7;2;9
94;22.09.2018;2018;09;18;Lauantai;6;2;8
94;22.09.2018;2018;09;19;Lauantai;2;3;5
94;22.09.2018;2018;09;20;Lauantai;0;3;3
94;22.09.2018;2018;09;21;Lauantai;1;1;2
94;22.09.2018;2018;09;22;Lauantai;0;3;3
94;22.09.2018;2018;09;23;Lauantai;1;5;6
94;23.09.2018;2018;09;00;Sunnuntai;2;2;4
94;23.09.2018;2018;09;01;Sunnuntai;1;2;3
94;23.09.2018;2018;09;02;Sunnuntai;0;0;0
94;23.09.2018;2018;09;03;Sunnuntai;0;0;0
94;23.09.2018;2018;09;04;Sunnuntai;0;0;0
94;23.09.2018;2018;09;05;Sunnuntai;0;0;0
94;23.09.2018;2018;09;06;Sunnuntai;0;1;1
94;23.09.2018;2018;09;07;Sunnuntai;1;0;1
94;23.09.2018;2018;09;08;Sunnuntai;1;1;2
94;23.09.2018;2018;09;09;Sunnuntai;3;3;6
94;23.09.2018;2018;09;10;Sunnuntai;5;8;13
94;23.09.2018;2018;09;11;Sunnuntai;4;3;7
94;23.09.2018;2018;09;12;Sunnuntai;5;4;9
94;23.09.2018;2018;09;13;Sunnuntai;2;3;5
94;23.09.2018;2018;09;14;Sunnuntai;4;3;7
94;23.09.2018;2018;09;15;Sunnuntai;6;7;13
94;23.09.2018;2018;09;16;Sunnuntai;7;6;13
94;23.09.2018;2018;09;17;Sunnuntai;7;2;9
94;23.09.2018;2018;09;18;Sunnuntai;1;4;5
94;23.09.2018;2018;09;19;Sunnuntai;5;1;6
94;23.09.2018;2018;09;20;Sunnuntai;0;3;3
94;23.09.2018;2018;09;21;Sunnuntai;0;0;0
94;23.09.2018;2018;09;22;Sunnuntai;1;0;1
94;23.09.2018;2018;09;23;Sunnuntai;0;0;0
94;24.09.2018;2018;09;00;Maanantai;0;0;0
94;24.09.2018;2018;09;01;Maanantai;0;0;0
94;24.09.2018;2018;09;02;Maanantai;0;0;0
94;24.09.2018;2018;09;03;Maanantai;0;0;0
94;24.09.2018;2018;09;04;Maanantai;0;0;0
94;24.09.2018;2018;09;05;Maanantai;5;4;9
94;24.09.2018;2018;09;06;Maanantai;7;0;7
94;24.09.2018;2018;09;07;Maanantai;12;1;13
94;24.09.2018;2018;09;08;Maanantai;11;5;16
94;24.09.2018;2018;09;09;Maanantai;4;3;7
94;24.09.2018;2018;09;10;Maanantai;3;1;4
94;24.09.2018;2018;09;11;Maanantai;3;4;7
94;24.09.2018;2018;09;12;Maanantai;2;2;4
94;24.09.2018;2018;09;13;Maanantai;4;6;10
94;24.09.2018;2018;09;14;Maanantai;4;3;7
94;24.09.2018;2018;09;15;Maanantai;5;12;17
94;24.09.2018;2018;09;16;Maanantai;5;11;16
94;24.09.2018;2018;09;17;Maanantai;4;11;15
94;24.09.2018;2018;09;18;Maanantai;2;2;4
94;24.09.2018;2018;09;19;Maanantai;1;2;3
94;24.09.2018;2018;09;20;Maanantai;1;6;7
94;24.09.2018;2018;09;21;Maanantai;2;2;4
94;24.09.2018;2018;09;22;Maanantai;1;2;3
94;24.09.2018;2018;09;23;Maanantai;0;0;0
94;25.09.2018;2018;09;00;Tiistai;0;0;0
94;25.09.2018;2018;09;01;Tiistai;0;0;0
94;25.09.2018;2018;09;02;Tiistai;0;0;0
94;25.09.2018;2018;09;03;Tiistai;0;0;0
94;25.09.2018;2018;09;04;Tiistai;0;0;0
94;25.09.2018;2018;09;05;Tiistai;5;0;5
94;25.09.2018;2018;09;06;Tiistai;10;0;10
94;25.09.2018;2018;09;07;Tiistai;12;0;12
94;25.09.2018;2018;09;08;Tiistai;10;0;10
94;25.09.2018;2018;09;09;Tiistai;6;0;6
94;25.09.2018;2018;09;10;Tiistai;7;0;7
94;25.09.2018;2018;09;11;Tiistai;9;0;9
94;25.09.2018;2018;09;12;Tiistai;6;0;6
94;25.09.2018;2018;09;13;Tiistai;6;0;6
94;25.09.2018;2018;09;14;Tiistai;9;0;9
94;25.09.2018;2018;09;15;Tiistai;17;0;17
94;25.09.2018;2018;09;16;Tiistai;16;0;16
94;25.09.2018;2018;09;17;Tiistai;10;0;10
94;25.09.2018;2018;09;18;Tiistai;14;0;14
94;25.09.2018;2018;09;19;Tiistai;4;0;4
94;25.09.2018;2018;09;20;Tiistai;6;0;6
94;25.09.2018;2018;09;21;Tiistai;1;0;1
94;25.09.2018;2018;09;22;Tiistai;2;0;2
94;25.09.2018;2018;09;23;Tiistai;0;0;0
94;26.09.2018;2018;09;00;Keskiviikko;0;0;0
94;26.09.2018;2018;09;01;Keskiviikko;0;0;0
94;26.09.2018;2018;09;02;Keskiviikko;0;1;1
94;26.09.2018;2018;09;03;Keskiviikko;0;0;0
94;26.09.2018;2018;09;04;Keskiviikko;0;0;0
94;26.09.2018;2018;09;05;Keskiviikko;2;2;4
94;26.09.2018;2018;09;06;Keskiviikko;3;1;4
94;26.09.2018;2018;09;07;Keskiviikko;10;2;12
94;26.09.2018;2018;09;08;Keskiviikko;8;2;10
94;26.09.2018;2018;09;09;Keskiviikko;3;0;3
94;26.09.2018;2018;09;10;Keskiviikko;1;0;1
94;26.09.2018;2018;09;11;Keskiviikko;0;1;1
94;26.09.2018;2018;09;12;Keskiviikko;1;0;1
94;26.09.2018;2018;09;13;Keskiviikko;2;0;2
94;26.09.2018;2018;09;14;Keskiviikko;3;4;7
94;26.09.2018;2018;09;15;Keskiviikko;1;5;6
94;26.09.2018;2018;09;16;Keskiviikko;2;8;10
94;26.09.2018;2018;09;17;Keskiviikko;2;5;7
94;26.09.2018;2018;09;18;Keskiviikko;1;3;4
94;26.09.2018;2018;09;19;Keskiviikko;1;3;4
94;26.09.2018;2018;09;20;Keskiviikko;2;4;6
94;26.09.2018;2018;09;21;Keskiviikko;0;1;1
94;26.09.2018;2018;09;22;Keskiviikko;0;0;0
94;26.09.2018;2018;09;23;Keskiviikko;0;0;0
94;27.09.2018;2018;09;00;Torstai;0;0;0
94;27.09.2018;2018;09;01;Torstai;0;0;0
94;27.09.2018;2018;09;02;Torstai;0;1;1
94;27.09.2018;2018;09;03;Torstai;0;0;0
94;27.09.2018;2018;09;04;Torstai;0;0;0
94;27.09.2018;2018;09;05;Torstai;3;3;6
94;27.09.2018;2018;09;06;Torstai;8;0;8
94;27.09.2018;2018;09;07;Torstai;9;3;12
94;27.09.2018;2018;09;08;Torstai;7;2;9
94;27.09.2018;2018;09;09;Torstai;2;3;5
94;27.09.2018;2018;09;10;Torstai;1;1;2
94;27.09.2018;2018;09;11;Torstai;1;0;1
94;27.09.2018;2018;09;12;Torstai;0;1;1
94;27.09.2018;2018;09;13;Torstai;2;4;6
94;27.09.2018;2018;09;14;Torstai;3;4;7
94;27.09.2018;2018;09;15;Torstai;6;7;13
94;27.09.2018;2018;09;16;Torstai;1;14;15
94;27.09.2018;2018;09;17;Torstai;7;4;11
94;27.09.2018;2018;09;18;Torstai;1;5;6
94;27.09.2018;2018;09;19;Torstai;0;6;6
94;27.09.2018;2018;09;20;Torstai;1;5;6
94;27.09.2018;2018;09;21;Torstai;0;1;1
94;27.09.2018;2018;09;22;Torstai;1;0;1
94;27.09.2018;2018;09;23;Torstai;0;0;0
94;28.09.2018;2018;09;00;Perjantai;0;0;0
94;28.09.2018;2018;09;01;Perjantai;0;0;0
94;28.09.2018;2018;09;02;Perjantai;0;1;1
94;28.09.2018;2018;09;03;Perjantai;0;0;0
94;28.09.2018;2018;09;04;Perjantai;0;0;0
94;28.09.2018;2018;09;05;Perjantai;3;2;5
94;28.09.2018;2018;09;06;Perjantai;11;0;11
94;28.09.2018;2018;09;07;Perjantai;7;3;10
94;28.09.2018;2018;09;08;Perjantai;9;5;14
94;28.09.2018;2018;09;09;Perjantai;5;0;5
94;28.09.2018;2018;09;10;Perjantai;3;1;4
94;28.09.2018;2018;09;11;Perjantai;1;3;4
94;28.09.2018;2018;09;12;Perjantai;3;4;7
94;28.09.2018;2018;09;13;Perjantai;5;7;12
94;28.09.2018;2018;09;14;Perjantai;9;6;15
94;28.09.2018;2018;09;15;Perjantai;4;9;13
94;28.09.2018;2018;09;16;Perjantai;4;9;13
94;28.09.2018;2018;09;17;Perjantai;1;4;5
94;28.09.2018;2018;09;18;Perjantai;4;1;5
94;28.09.2018;2018;09;19;Perjantai;3;6;9
94;28.09.2018;2018;09;20;Perjantai;0;1;1
94;28.09.2018;2018;09;21;Perjantai;0;0;0
94;28.09.2018;2018;09;22;Perjantai;2;6;8
94;28.09.2018;2018;09;23;Perjantai;0;1;1
94;29.09.2018;2018;09;00;Lauantai;0;0;0
94;29.09.2018;2018;09;01;Lauantai;0;0;0
94;29.09.2018;2018;09;02;Lauantai;0;1;1
94;29.09.2018;2018;09;03;Lauantai;1;0;1
94;29.09.2018;2018;09;04;Lauantai;0;1;1
94;29.09.2018;2018;09;05;Lauantai;1;0;1
94;29.09.2018;2018;09;06;Lauantai;0;0;0
94;29.09.2018;2018;09;07;Lauantai;1;0;1
94;29.09.2018;2018;09;08;Lauantai;1;2;3
94;29.09.2018;2018;09;09;Lauantai;3;7;10
94;29.09.2018;2018;09;10;Lauantai;2;1;3
94;29.09.2018;2018;09;11;Lauantai;3;6;9
94;29.09.2018;2018;09;12;Lauantai;7;0;7
94;29.09.2018;2018;09;13;Lauantai;7;4;11
94;29.09.2018;2018;09;14;Lauantai;4;7;11
94;29.09.2018;2018;09;15;Lauantai;7;6;13
94;29.09.2018;2018;09;16;Lauantai;6;5;11
94;29.09.2018;2018;09;17;Lauantai;1;3;4
94;29.09.2018;2018;09;18;Lauantai;8;3;11
94;29.09.2018;2018;09;19;Lauantai;3;3;6
94;29.09.2018;2018;09;20;Lauantai;1;1;2
94;29.09.2018;2018;09;21;Lauantai;0;5;5
94;29.09.2018;2018;09;22;Lauantai;1;2;3
94;29.09.2018;2018;09;23;Lauantai;0;1;1
94;30.09.2018;2018;09;00;Sunnuntai;0;0;0
94;30.09.2018;2018;09;01;Sunnuntai;0;0;0
94;30.09.2018;2018;09;02;Sunnuntai;0;0;0
94;30.09.2018;2018;09;03;Sunnuntai;0;0;0
94;30.09.2018;2018;09;04;Sunnuntai;0;0;0
94;30.09.2018;2018;09;05;Sunnuntai;0;0;0
94;30.09.2018;2018;09;06;Sunnuntai;0;0;0
94;30.09.2018;2018;09;07;Sunnuntai;0;0;0
94;30.09.2018;2018;09;08;Sunnuntai;2;0;2
94;30.09.2018;2018;09;09;Sunnuntai;1;2;3
94;30.09.2018;2018;09;10;Sunnuntai;1;0;1
94;30.09.2018;2018;09;11;Sunnuntai;6;3;9
94;30.09.2018;2018;09;12;Sunnuntai;8;2;10
94;30.09.2018;2018;09;13;Sunnuntai;5;7;12
94;30.09.2018;2018;09;14;Sunnuntai;1;2;3
94;30.09.2018;2018;09;15;Sunnuntai;2;4;6
94;30.09.2018;2018;09;16;Sunnuntai;9;0;9
94;30.09.2018;2018;09;17;Sunnuntai;5;10;15
94;30.09.2018;2018;09;18;Sunnuntai;5;5;10
94;30.09.2018;2018;09;19;Sunnuntai;2;0;2
94;30.09.2018;2018;09;20;Sunnuntai;2;4;6
94;30.09.2018;2018;09;21;Sunnuntai;2;1;3
94;30.09.2018;2018;09;22;Sunnuntai;1;2;3
94;30.09.2018;2018;09;23;Sunnuntai;0;1;1