MittausID;Pvm;Vuosi;Kuukausi;Tunti;Viikonpäivä;PP_1;PP_2;PP_YHT
624;02.01.2017;2017;01;00;Maanantai;0;0;0
624;02.01.2017;2017;01;01;Maanantai;0;1;1
624;02.01.2017;2017;01;02;Maanantai;0;2;2
624;02.01.2017;2017;01;03;Maanantai;0;0;0
624;02.01.2017;2017;01;04;Maanantai;0;0;0
624;02.01.2017;2017;01;05;Maanantai;0;0;0
624;02.01.2017;2017;01;06;Maanantai;2;3;5
624;02.01.2017;2017;01;07;Maanantai;8;5;13
624;02.01.2017;2017;01;08;Maanantai;4;24;28
624;02.01.2017;2017;01;09;Maanantai;6;23;29
624;02.01.2017;2017;01;10;Maanantai;2;10;12
624;02.01.2017;2017;01;11;Maanantai;6;12;18
624;02.01.2017;2017;01;12;Maanantai;6;7;13
624;02.01.2017;2017;01;13;Maanantai;13;13;26
624;02.01.2017;2017;01;14;Maanantai;4;4;8
624;02.01.2017;2017;01;15;Maanantai;11;6;17
624;02.01.2017;2017;01;16;Maanantai;16;6;22
624;02.01.2017;2017;01;17;Maanantai;33;18;51
624;02.01.2017;2017;01;18;Maanantai;23;6;29
624;02.01.2017;2017;01;19;Maanantai;15;7;22
624;02.01.2017;2017;01;20;Maanantai;5;3;8
624;02.01.2017;2017;01;21;Maanantai;6;3;9
624;02.01.2017;2017;01;22;Maanantai;5;2;7
624;02.01.2017;2017;01;23;Maanantai;3;1;4
624;03.01.2017;2017;01;00;Tiistai;1;0;1
624;03.01.2017;2017;01;01;Tiistai;0;0;0
624;03.01.2017;2017;01;02;Tiistai;1;0;1
624;03.01.2017;2017;01;03;Tiistai;1;0;1
624;03.01.2017;2017;01;04;Tiistai;0;0;0
624;03.01.2017;2017;01;05;Tiistai;1;0;1
624;03.01.2017;2017;01;06;Tiistai;3;5;8
624;03.01.2017;2017;01;07;Tiistai;5;8;13
624;03.01.2017;2017;01;08;Tiistai;5;20;25
624;03.01.2017;2017;01;09;Tiistai;2;12;14
624;03.01.2017;2017;01;10;Tiistai;2;5;7
624;03.01.2017;2017;01;11;Tiistai;7;12;19
624;03.01.2017;2017;01;12;Tiistai;6;9;15
624;03.01.2017;2017;01;13;Tiistai;5;9;14
624;03.01.2017;2017;01;14;Tiistai;5;6;11
624;03.01.2017;2017;01;15;Tiistai;6;8;14
624;03.01.2017;2017;01;16;Tiistai;9;10;19
624;03.01.2017;2017;01;17;Tiistai;29;15;44
624;03.01.2017;2017;01;18;Tiistai;11;3;14
624;03.01.2017;2017;01;19;Tiistai;9;5;14
624;03.01.2017;2017;01;20;Tiistai;6;8;14
624;03.01.2017;2017;01;21;Tiistai;9;3;12
624;03.01.2017;2017;01;22;Tiistai;5;2;7
624;03.01.2017;2017;01;23;Tiistai;4;3;7
624;04.01.2017;2017;01;00;Keskiviikko;1;0;1
624;04.01.2017;2017;01;01;Keskiviikko;0;2;2
624;04.01.2017;2017;01;02;Keskiviikko;0;0;0
624;04.01.2017;2017;01;03;Keskiviikko;0;0;0
624;04.01.2017;2017;01;04;Keskiviikko;3;0;3
624;04.01.2017;2017;01;05;Keskiviikko;1;1;2
624;04.01.2017;2017;01;06;Keskiviikko;2;4;6
624;04.01.2017;2017;01;07;Keskiviikko;3;3;6
624;04.01.2017;2017;01;08;Keskiviikko;1;11;12
624;04.01.2017;2017;01;09;Keskiviikko;8;4;12
624;04.01.2017;2017;01;10;Keskiviikko;2;9;11
624;04.01.2017;2017;01;11;Keskiviikko;3;7;10
624;04.01.2017;2017;01;12;Keskiviikko;3;2;5
624;04.01.2017;2017;01;13;Keskiviikko;3;4;7
624;04.01.2017;2017;01;14;Keskiviikko;3;3;6
624;04.01.2017;2017;01;15;Keskiviikko;5;4;9
624;04.01.2017;2017;01;16;Keskiviikko;10;8;18
624;04.01.2017;2017;01;17;Keskiviikko;7;8;15
624;04.01.2017;2017;01;18;Keskiviikko;8;3;11
624;04.01.2017;2017;01;19;Keskiviikko;11;4;15
624;04.01.2017;2017;01;20;Keskiviikko;8;4;12
624;04.01.2017;2017;01;21;Keskiviikko;4;3;7
624;04.01.2017;2017;01;22;Keskiviikko;3;3;6
624;04.01.2017;2017;01;23;Keskiviikko;1;2;3
624;05.01.2017;2017;01;00;Torstai;1;0;1
624;05.01.2017;2017;01;01;Torstai;0;1;1
624;05.01.2017;2017;01;02;Torstai;0;0;0
624;05.01.2017;2017;01;03;Torstai;0;0;0
624;05.01.2017;2017;01;04;Torstai;0;0;0
624;05.01.2017;2017;01;05;Torstai;0;0;0
624;05.01.2017;2017;01;06;Torstai;3;0;3
624;05.01.2017;2017;01;07;Torstai;3;4;7
624;05.01.2017;2017;01;08;Torstai;3;9;12
624;05.01.2017;2017;01;09;Torstai;1;6;7
624;05.01.2017;2017;01;10;Torstai;0;7;7
624;05.01.2017;2017;01;11;Torstai;1;1;2
624;05.01.2017;2017;01;12;Torstai;1;3;4
624;05.01.2017;2017;01;13;Torstai;2;2;4
624;05.01.2017;2017;01;14;Torstai;2;3;5
624;05.01.2017;2017;01;15;Torstai;5;6;11
624;05.01.2017;2017;01;16;Torstai;5;11;16
624;05.01.2017;2017;01;17;Torstai;16;7;23
624;05.01.2017;2017;01;18;Torstai;10;4;14
624;05.01.2017;2017;01;19;Torstai;6;4;10
624;05.01.2017;2017;01;20;Torstai;2;2;4
624;05.01.2017;2017;01;21;Torstai;2;1;3
624;05.01.2017;2017;01;22;Torstai;0;0;0
624;05.01.2017;2017;01;23;Torstai;1;4;5
624;06.01.2017;2017;01;00;Perjantai;1;0;1
624;06.01.2017;2017;01;01;Perjantai;1;1;2
624;06.01.2017;2017;01;02;Perjantai;0;0;0
624;06.01.2017;2017;01;03;Perjantai;1;0;1
624;06.01.2017;2017;01;04;Perjantai;0;0;0
624;06.01.2017;2017;01;05;Perjantai;0;2;2
624;06.01.2017;2017;01;06;Perjantai;4;0;4
624;06.01.2017;2017;01;07;Perjantai;0;1;1
624;06.01.2017;2017;01;08;Perjantai;1;2;3
624;06.01.2017;2017;01;09;Perjantai;1;3;4
624;06.01.2017;2017;01;10;Perjantai;1;1;2
624;06.01.2017;2017;01;11;Perjantai;3;4;7
624;06.01.2017;2017;01;12;Perjantai;2;3;5
624;06.01.2017;2017;01;13;Perjantai;3;2;5
624;06.01.2017;2017;01;14;Perjantai;3;5;8
624;06.01.2017;2017;01;15;Perjantai;9;2;11
624;06.01.2017;2017;01;16;Perjantai;6;5;11
624;06.01.2017;2017;01;17;Perjantai;7;4;11
624;06.01.2017;2017;01;18;Perjantai;5;5;10
624;06.01.2017;2017;01;19;Perjantai;1;2;3
624;06.01.2017;2017;01;20;Perjantai;5;3;8
624;06.01.2017;2017;01;21;Perjantai;2;5;7
624;06.01.2017;2017;01;22;Perjantai;5;4;9
624;06.01.2017;2017;01;23;Perjantai;1;2;3
624;07.01.2017;2017;01;00;Lauantai;1;1;2
624;07.01.2017;2017;01;01;Lauantai;1;0;1
624;07.01.2017;2017;01;02;Lauantai;1;0;1
624;07.01.2017;2017;01;03;Lauantai;0;0;0
624;07.01.2017;2017;01;04;Lauantai;0;1;1
624;07.01.2017;2017;01;05;Lauantai;1;0;1
624;07.01.2017;2017;01;06;Lauantai;1;0;1
624;07.01.2017;2017;01;07;Lauantai;1;4;5
624;07.01.2017;2017;01;08;Lauantai;1;4;5
624;07.01.2017;2017;01;09;Lauantai;0;1;1
624;07.01.2017;2017;01;10;Lauantai;0;4;4
624;07.01.2017;2017;01;11;Lauantai;4;3;7
624;07.01.2017;2017;01;12;Lauantai;5;9;14
624;07.01.2017;2017;01;13;Lauantai;6;10;16
624;07.01.2017;2017;01;14;Lauantai;2;6;8
624;07.01.2017;2017;01;15;Lauantai;10;7;17
624;07.01.2017;2017;01;16;Lauantai;10;10;20
624;07.01.2017;2017;01;17;Lauantai;1;3;4
624;07.01.2017;2017;01;18;Lauantai;7;7;14
624;07.01.2017;2017;01;19;Lauantai;4;4;8
624;07.01.2017;2017;01;20;Lauantai;12;1;13
624;07.01.2017;2017;01;21;Lauantai;2;2;4
624;07.01.2017;2017;01;22;Lauantai;2;3;5
624;07.01.2017;2017;01;23;Lauantai;2;1;3
624;08.01.2017;2017;01;00;Sunnuntai;0;0;0
624;08.01.2017;2017;01;01;Sunnuntai;1;2;3
624;08.01.2017;2017;01;02;Sunnuntai;1;1;2
624;08.01.2017;2017;01;03;Sunnuntai;0;0;0
624;08.01.2017;2017;01;04;Sunnuntai;1;2;3
624;08.01.2017;2017;01;05;Sunnuntai;1;0;1
624;08.01.2017;2017;01;06;Sunnuntai;1;0;1
624;08.01.2017;2017;01;07;Sunnuntai;1;2;3
624;08.01.2017;2017;01;08;Sunnuntai;1;1;2
624;08.01.2017;2017;01;09;Sunnuntai;1;2;3
624;08.01.2017;2017;01;10;Sunnuntai;2;4;6
624;08.01.2017;2017;01;11;Sunnuntai;2;4;6
624;08.01.2017;2017;01;12;Sunnuntai;2;2;4
624;08.01.2017;2017;01;13;Sunnuntai;8;9;17
624;08.01.2017;2017;01;14;Sunnuntai;6;6;12
624;08.01.2017;2017;01;15;Sunnuntai;5;10;15
624;08.01.2017;2017;01;16;Sunnuntai;13;8;21
624;08.01.2017;2017;01;17;Sunnuntai;8;4;12
624;08.01.2017;2017;01;18;Sunnuntai;2;4;6
624;08.01.2017;2017;01;19;Sunnuntai;4;4;8
624;08.01.2017;2017;01;20;Sunnuntai;6;4;10
624;08.01.2017;2017;01;21;Sunnuntai;5;1;6
624;08.01.2017;2017;01;22;Sunnuntai;4;0;4
624;08.01.2017;2017;01;23;Sunnuntai;1;1;2
624;09.01.2017;2017;01;00;Maanantai;0;2;2
624;09.01.2017;2017;01;01;Maanantai;0;0;0
624;09.01.2017;2017;01;02;Maanantai;1;0;1
624;09.01.2017;2017;01;03;Maanantai;1;0;1
624;09.01.2017;2017;01;04;Maanantai;0;0;0
624;09.01.2017;2017;01;05;Maanantai;0;2;2
624;09.01.2017;2017;01;06;Maanantai;2;3;5
624;09.01.2017;2017;01;07;Maanantai;4;12;16
624;09.01.2017;2017;01;08;Maanantai;15;44;59
624;09.01.2017;2017;01;09;Maanantai;12;22;34
624;09.01.2017;2017;01;10;Maanantai;4;21;25
624;09.01.2017;2017;01;11;Maanantai;4;16;20
624;09.01.2017;2017;01;12;Maanantai;7;8;15
624;09.01.2017;2017;01;13;Maanantai;13;16;29
624;09.01.2017;2017;01;14;Maanantai;12;11;23
624;09.01.2017;2017;01;15;Maanantai;25;18;43
624;09.01.2017;2017;01;16;Maanantai;23;15;38
624;09.01.2017;2017;01;17;Maanantai;56;28;84
624;09.01.2017;2017;01;18;Maanantai;37;15;52
624;09.01.2017;2017;01;19;Maanantai;15;11;26
624;09.01.2017;2017;01;20;Maanantai;17;7;24
624;09.01.2017;2017;01;21;Maanantai;17;6;23
624;09.01.2017;2017;01;22;Maanantai;5;4;9
624;09.01.2017;2017;01;23;Maanantai;3;1;4
624;10.01.2017;2017;01;00;Tiistai;0;2;2
624;10.01.2017;2017;01;01;Tiistai;0;0;0
624;10.01.2017;2017;01;02;Tiistai;0;0;0
624;10.01.2017;2017;01;03;Tiistai;1;0;1
624;10.01.2017;2017;01;04;Tiistai;1;0;1
624;10.01.2017;2017;01;05;Tiistai;1;1;2
624;10.01.2017;2017;01;06;Tiistai;4;5;9
624;10.01.2017;2017;01;07;Tiistai;9;12;21
624;10.01.2017;2017;01;08;Tiistai;12;55;67
624;10.01.2017;2017;01;09;Tiistai;22;46;68
624;10.01.2017;2017;01;10;Tiistai;4;18;22
624;10.01.2017;2017;01;11;Tiistai;5;17;22
624;10.01.2017;2017;01;12;Tiistai;6;20;26
624;10.01.2017;2017;01;13;Tiistai;10;11;21
624;10.01.2017;2017;01;14;Tiistai;17;15;32
624;10.01.2017;2017;01;15;Tiistai;18;15;33
624;10.01.2017;2017;01;16;Tiistai;42;19;61
624;10.01.2017;2017;01;17;Tiistai;49;21;70
624;10.01.2017;2017;01;18;Tiistai;34;18;52
624;10.01.2017;2017;01;19;Tiistai;25;7;32
624;10.01.2017;2017;01;20;Tiistai;12;10;22
624;10.01.2017;2017;01;21;Tiistai;19;10;29
624;10.01.2017;2017;01;22;Tiistai;13;3;16
624;10.01.2017;2017;01;23;Tiistai;3;3;6
624;11.01.2017;2017;01;00;Keskiviikko;0;1;1
624;11.01.2017;2017;01;01;Keskiviikko;0;0;0
624;11.01.2017;2017;01;02;Keskiviikko;0;0;0
624;11.01.2017;2017;01;03;Keskiviikko;0;0;0
624;11.01.2017;2017;01;04;Keskiviikko;0;0;0
624;11.01.2017;2017;01;05;Keskiviikko;3;0;3
624;11.01.2017;2017;01;06;Keskiviikko;4;6;10
624;11.01.2017;2017;01;07;Keskiviikko;5;15;20
624;11.01.2017;2017;01;08;Keskiviikko;13;41;54
624;11.01.2017;2017;01;09;Keskiviikko;7;30;37
624;11.01.2017;2017;01;10;Keskiviikko;10;21;31
624;11.01.2017;2017;01;11;Keskiviikko;4;7;11
624;11.01.2017;2017;01;12;Keskiviikko;13;13;26
624;11.01.2017;2017;01;13;Keskiviikko;15;12;27
624;11.01.2017;2017;01;14;Keskiviikko;11;16;27
624;11.01.2017;2017;01;15;Keskiviikko;20;15;35
624;11.01.2017;2017;01;16;Keskiviikko;25;20;45
624;11.01.2017;2017;01;17;Keskiviikko;35;24;59
624;11.01.2017;2017;01;18;Keskiviikko;28;20;48
624;11.01.2017;2017;01;19;Keskiviikko;18;7;25
624;11.01.2017;2017;01;20;Keskiviikko;17;5;22
624;11.01.2017;2017;01;21;Keskiviikko;17;8;25
624;11.01.2017;2017;01;22;Keskiviikko;6;5;11
624;11.01.2017;2017;01;23;Keskiviikko;4;2;6
624;12.01.2017;2017;01;00;Torstai;1;4;5
624;12.01.2017;2017;01;01;Torstai;1;2;3
624;12.01.2017;2017;01;02;Torstai;1;0;1
624;12.01.2017;2017;01;03;Torstai;0;0;0
624;12.01.2017;2017;01;04;Torstai;0;0;0
624;12.01.2017;2017;01;05;Torstai;1;2;3
624;12.01.2017;2017;01;06;Torstai;3;7;10
624;12.01.2017;2017;01;07;Torstai;7;12;19
624;12.01.2017;2017;01;08;Torstai;14;46;60
624;12.01.2017;2017;01;09;Torstai;9;29;38
624;12.01.2017;2017;01;10;Torstai;9;11;20
624;12.01.2017;2017;01;11;Torstai;3;7;10
624;12.01.2017;2017;01;12;Torstai;7;13;20
624;12.01.2017;2017;01;13;Torstai;9;8;17
624;12.01.2017;2017;01;14;Torstai;7;7;14
624;12.01.2017;2017;01;15;Torstai;28;11;39
624;12.01.2017;2017;01;16;Torstai;24;8;32
624;12.01.2017;2017;01;17;Torstai;39;19;58
624;12.01.2017;2017;01;18;Torstai;26;12;38
624;12.01.2017;2017;01;19;Torstai;14;5;19
624;12.01.2017;2017;01;20;Torstai;7;7;14
624;12.01.2017;2017;01;21;Torstai;12;8;20
624;12.01.2017;2017;01;22;Torstai;9;3;12
624;12.01.2017;2017;01;23;Torstai;1;0;1
624;13.01.2017;2017;01;00;Perjantai;0;0;0
624;13.01.2017;2017;01;01;Perjantai;2;0;2
624;13.01.2017;2017;01;02;Perjantai;0;0;0
624;13.01.2017;2017;01;03;Perjantai;0;0;0
624;13.01.2017;2017;01;04;Perjantai;1;1;2
624;13.01.2017;2017;01;05;Perjantai;0;1;1
624;13.01.2017;2017;01;06;Perjantai;1;6;7
624;13.01.2017;2017;01;07;Perjantai;6;12;18
624;13.01.2017;2017;01;08;Perjantai;10;35;45
624;13.01.2017;2017;01;09;Perjantai;7;17;24
624;13.01.2017;2017;01;10;Perjantai;12;14;26
624;13.01.2017;2017;01;11;Perjantai;1;7;8
624;13.01.2017;2017;01;12;Perjantai;7;8;15
624;13.01.2017;2017;01;13;Perjantai;9;9;18
624;13.01.2017;2017;01;14;Perjantai;8;2;10
624;13.01.2017;2017;01;15;Perjantai;23;11;34
624;13.01.2017;2017;01;16;Perjantai;26;14;40
624;13.01.2017;2017;01;17;Perjantai;26;11;37
624;13.01.2017;2017;01;18;Perjantai;20;12;32
624;13.01.2017;2017;01;19;Perjantai;10;3;13
624;13.01.2017;2017;01;20;Perjantai;13;7;20
624;13.01.2017;2017;01;21;Perjantai;7;0;7
624;13.01.2017;2017;01;22;Perjantai;7;2;9
624;13.01.2017;2017;01;23;Perjantai;2;0;2
624;14.01.2017;2017;01;00;Lauantai;1;0;1
624;14.01.2017;2017;01;01;Lauantai;3;1;4
624;14.01.2017;2017;01;02;Lauantai;1;3;4
624;14.01.2017;2017;01;03;Lauantai;2;1;3
624;14.01.2017;2017;01;04;Lauantai;0;0;0
624;14.01.2017;2017;01;05;Lauantai;2;1;3
624;14.01.2017;2017;01;06;Lauantai;0;0;0
624;14.01.2017;2017;01;07;Lauantai;0;1;1
624;14.01.2017;2017;01;08;Lauantai;3;1;4
624;14.01.2017;2017;01;09;Lauantai;1;0;1
624;14.01.2017;2017;01;10;Lauantai;4;8;12
624;14.01.2017;2017;01;11;Lauantai;2;4;6
624;14.01.2017;2017;01;12;Lauantai;2;4;6
624;14.01.2017;2017;01;13;Lauantai;6;6;12
624;14.01.2017;2017;01;14;Lauantai;2;5;7
624;14.01.2017;2017;01;15;Lauantai;8;9;17
624;14.01.2017;2017;01;16;Lauantai;4;6;10
624;14.01.2017;2017;01;17;Lauantai;8;14;22
624;14.01.2017;2017;01;18;Lauantai;5;7;12
624;14.01.2017;2017;01;19;Lauantai;5;5;10
624;14.01.2017;2017;01;20;Lauantai;18;4;22
624;14.01.2017;2017;01;21;Lauantai;6;5;11
624;14.01.2017;2017;01;22;Lauantai;4;3;7
624;14.01.2017;2017;01;23;Lauantai;4;1;5
624;15.01.2017;2017;01;00;Sunnuntai;1;3;4
624;15.01.2017;2017;01;01;Sunnuntai;2;1;3
624;15.01.2017;2017;01;02;Sunnuntai;3;1;4
624;15.01.2017;2017;01;03;Sunnuntai;4;0;4
624;15.01.2017;2017;01;04;Sunnuntai;3;2;5
624;15.01.2017;2017;01;05;Sunnuntai;2;0;2
624;15.01.2017;2017;01;06;Sunnuntai;0;1;1
624;15.01.2017;2017;01;07;Sunnuntai;3;2;5
624;15.01.2017;2017;01;08;Sunnuntai;0;0;0
624;15.01.2017;2017;01;09;Sunnuntai;1;4;5
624;15.01.2017;2017;01;10;Sunnuntai;0;1;1
624;15.01.2017;2017;01;11;Sunnuntai;5;5;10
624;15.01.2017;2017;01;12;Sunnuntai;2;5;7
624;15.01.2017;2017;01;13;Sunnuntai;6;8;14
624;15.01.2017;2017;01;14;Sunnuntai;6;5;11
624;15.01.2017;2017;01;15;Sunnuntai;9;8;17
624;15.01.2017;2017;01;16;Sunnuntai;7;7;14
624;15.01.2017;2017;01;17;Sunnuntai;7;3;10
624;15.01.2017;2017;01;18;Sunnuntai;8;8;16
624;15.01.2017;2017;01;19;Sunnuntai;8;7;15
624;15.01.2017;2017;01;20;Sunnuntai;7;7;14
624;15.01.2017;2017;01;21;Sunnuntai;5;1;6
624;15.01.2017;2017;01;22;Sunnuntai;1;0;1
624;15.01.2017;2017;01;23;Sunnuntai;4;2;6
624;16.01.2017;2017;01;00;Maanantai;1;0;1
624;16.01.2017;2017;01;01;Maanantai;1;0;1
624;16.01.2017;2017;01;02;Maanantai;0;0;0
624;16.01.2017;2017;01;03;Maanantai;1;1;2
624;16.01.2017;2017;01;04;Maanantai;0;1;1
624;16.01.2017;2017;01;05;Maanantai;0;0;0
624;16.01.2017;2017;01;06;Maanantai;3;2;5
624;16.01.2017;2017;01;07;Maanantai;6;14;20
624;16.01.2017;2017;01;08;Maanantai;9;34;43
624;16.01.2017;2017;01;09;Maanantai;16;33;49
624;16.01.2017;2017;01;10;Maanantai;5;18;23
624;16.01.2017;2017;01;11;Maanantai;8;13;21
624;16.01.2017;2017;01;12;Maanantai;5;12;17
624;16.01.2017;2017;01;13;Maanantai;9;14;23
624;16.01.2017;2017;01;14;Maanantai;10;9;19
624;16.01.2017;2017;01;15;Maanantai;16;12;28
624;16.01.2017;2017;01;16;Maanantai;21;7;28
624;16.01.2017;2017;01;17;Maanantai;41;18;59
624;16.01.2017;2017;01;18;Maanantai;17;11;28
624;16.01.2017;2017;01;19;Maanantai;15;8;23
624;16.01.2017;2017;01;20;Maanantai;11;7;18
624;16.01.2017;2017;01;21;Maanantai;6;1;7
624;16.01.2017;2017;01;22;Maanantai;12;1;13
624;16.01.2017;2017;01;23;Maanantai;3;1;4
624;17.01.2017;2017;01;00;Tiistai;0;1;1
624;17.01.2017;2017;01;01;Tiistai;0;0;0
624;17.01.2017;2017;01;02;Tiistai;0;0;0
624;17.01.2017;2017;01;03;Tiistai;2;0;2
624;17.01.2017;2017;01;04;Tiistai;0;0;0
624;17.01.2017;2017;01;05;Tiistai;2;1;3
624;17.01.2017;2017;01;06;Tiistai;2;4;6
624;17.01.2017;2017;01;07;Tiistai;3;9;12
624;17.01.2017;2017;01;08;Tiistai;11;30;41
624;17.01.2017;2017;01;09;Tiistai;20;39;59
624;17.01.2017;2017;01;10;Tiistai;8;11;19
624;17.01.2017;2017;01;11;Tiistai;5;10;15
624;17.01.2017;2017;01;12;Tiistai;7;13;20
624;17.01.2017;2017;01;13;Tiistai;11;9;20
624;17.01.2017;2017;01;14;Tiistai;10;9;19
624;17.01.2017;2017;01;15;Tiistai;16;12;28
624;17.01.2017;2017;01;16;Tiistai;21;7;28
624;17.01.2017;2017;01;17;Tiistai;41;18;59
624;17.01.2017;2017;01;18;Tiistai;17;11;28
624;17.01.2017;2017;01;19;Tiistai;15;8;23
624;17.01.2017;2017;01;20;Tiistai;11;7;18
624;17.01.2017;2017;01;21;Tiistai;9;5;14
624;17.01.2017;2017;01;22;Tiistai;8;4;12
624;17.01.2017;2017;01;23;Tiistai;1;3;4
624;18.01.2017;2017;01;00;Keskiviikko;0;1;1
624;18.01.2017;2017;01;01;Keskiviikko;0;0;0
624;18.01.2017;2017;01;02;Keskiviikko;0;0;0
624;18.01.2017;2017;01;03;Keskiviikko;1;0;1
624;18.01.2017;2017;01;04;Keskiviikko;0;0;0
624;18.01.2017;2017;01;05;Keskiviikko;2;0;2
624;18.01.2017;2017;01;06;Keskiviikko;2;14;16
624;18.01.2017;2017;01;07;Keskiviikko;7;12;19
624;18.01.2017;2017;01;08;Keskiviikko;14;45;59
624;18.01.2017;2017;01;09;Keskiviikko;7;42;49
624;18.01.2017;2017;01;10;Keskiviikko;10;19;29
624;18.01.2017;2017;01;11;Keskiviikko;7;14;21
624;18.01.2017;2017;01;12;Keskiviikko;12;17;29
624;18.01.2017;2017;01;13;Keskiviikko;16;16;32
624;18.01.2017;2017;01;14;Keskiviikko;17;12;29
624;18.01.2017;2017;01;15;Keskiviikko;28;13;41
624;18.01.2017;2017;01;16;Keskiviikko;42;22;64
624;18.01.2017;2017;01;17;Keskiviikko;48;28;76
624;18.01.2017;2017;01;18;Keskiviikko;24;12;36
624;18.01.2017;2017;01;19;Keskiviikko;24;12;36
624;18.01.2017;2017;01;20;Keskiviikko;11;7;18
624;18.01.2017;2017;01;21;Keskiviikko;13;7;20
624;18.01.2017;2017;01;22;Keskiviikko;10;9;19
624;18.01.2017;2017;01;23;Keskiviikko;2;4;6
624;19.01.2017;2017;01;00;Torstai;0;4;4
624;19.01.2017;2017;01;01;Torstai;3;0;3
624;19.01.2017;2017;01;02;Torstai;1;2;3
624;19.01.2017;2017;01;03;Torstai;0;0;0
624;19.01.2017;2017;01;04;Torstai;1;1;2
624;19.01.2017;2017;01;05;Torstai;2;3;5
624;19.01.2017;2017;01;06;Torstai;2;4;6
624;19.01.2017;2017;01;07;Torstai;6;7;13
624;19.01.2017;2017;01;08;Torstai;8;36;44
624;19.01.2017;2017;01;09;Torstai;10;43;53
624;19.01.2017;2017;01;10;Torstai;13;31;44
624;19.01.2017;2017;01;11;Torstai;6;12;18
624;19.01.2017;2017;01;12;Torstai;9;9;18
624;19.01.2017;2017;01;13;Torstai;9;14;23
624;19.01.2017;2017;01;14;Torstai;15;11;26
624;19.01.2017;2017;01;15;Torstai;15;11;26
624;19.01.2017;2017;01;16;Torstai;24;10;34
624;19.01.2017;2017;01;17;Torstai;32;18;50
624;19.01.2017;2017;01;18;Torstai;24;10;34
624;19.01.2017;2017;01;19;Torstai;14;7;21
624;19.01.2017;2017;01;20;Torstai;12;10;22
624;19.01.2017;2017;01;21;Torstai;7;3;10
624;19.01.2017;2017;01;22;Torstai;3;2;5
624;19.01.2017;2017;01;23;Torstai;5;1;6
624;20.01.2017;2017;01;00;Perjantai;1;3;4
624;20.01.2017;2017;01;01;Perjantai;3;1;4
624;20.01.2017;2017;01;02;Perjantai;0;0;0
624;20.01.2017;2017;01;03;Perjantai;0;2;2
624;20.01.2017;2017;01;04;Perjantai;0;0;0
624;20.01.2017;2017;01;05;Perjantai;2;2;4
624;20.01.2017;2017;01;06;Perjantai;1;8;9
624;20.01.2017;2017;01;07;Perjantai;4;10;14
624;20.01.2017;2017;01;08;Perjantai;11;29;40
624;20.01.2017;2017;01;09;Perjantai;9;39;48
624;20.01.2017;2017;01;10;Perjantai;11;21;32
624;20.01.2017;2017;01;11;Perjantai;1;8;9
624;20.01.2017;2017;01;12;Perjantai;8;14;22
624;20.01.2017;2017;01;13;Perjantai;14;15;29
624;20.01.2017;2017;01;14;Perjantai;13;12;25
624;20.01.2017;2017;01;15;Perjantai;18;14;32
624;20.01.2017;2017;01;16;Perjantai;22;12;34
624;20.01.2017;2017;01;17;Perjantai;25;15;40
624;20.01.2017;2017;01;18;Perjantai;12;15;27
624;20.01.2017;2017;01;19;Perjantai;5;8;13
624;20.01.2017;2017;01;20;Perjantai;6;8;14
624;20.01.2017;2017;01;21;Perjantai;12;6;18
624;20.01.2017;2017;01;22;Perjantai;9;3;12
624;20.01.2017;2017;01;23;Perjantai;6;1;7
624;21.01.2017;2017;01;00;Lauantai;2;1;3
624;21.01.2017;2017;01;01;Lauantai;1;4;5
624;21.01.2017;2017;01;02;Lauantai;3;2;5
624;21.01.2017;2017;01;03;Lauantai;2;1;3
624;21.01.2017;2017;01;04;Lauantai;4;0;4
624;21.01.2017;2017;01;05;Lauantai;1;0;1
624;21.01.2017;2017;01;06;Lauantai;2;2;4
624;21.01.2017;2017;01;07;Lauantai;4;1;5
624;21.01.2017;2017;01;08;Lauantai;0;3;3
624;21.01.2017;2017;01;09;Lauantai;3;4;7
624;21.01.2017;2017;01;10;Lauantai;4;8;12
624;21.01.2017;2017;01;11;Lauantai;4;7;11
624;21.01.2017;2017;01;12;Lauantai;5;8;13
624;21.01.2017;2017;01;13;Lauantai;10;8;18
624;21.01.2017;2017;01;14;Lauantai;11;10;21
624;21.01.2017;2017;01;15;Lauantai;10;13;23
624;21.01.2017;2017;01;16;Lauantai;10;13;23
624;21.01.2017;2017;01;17;Lauantai;12;16;28
624;21.01.2017;2017;01;18;Lauantai;3;8;11
624;21.01.2017;2017;01;19;Lauantai;4;6;10
624;21.01.2017;2017;01;20;Lauantai;8;3;11
624;21.01.2017;2017;01;21;Lauantai;4;2;6
624;21.01.2017;2017;01;22;Lauantai;2;4;6
624;21.01.2017;2017;01;23;Lauantai;5;1;6
624;22.01.2017;2017;01;00;Sunnuntai;1;2;3
624;22.01.2017;2017;01;01;Sunnuntai;0;4;4
624;22.01.2017;2017;01;02;Sunnuntai;5;0;5
624;22.01.2017;2017;01;03;Sunnuntai;2;1;3
624;22.01.2017;2017;01;04;Sunnuntai;3;0;3
624;22.01.2017;2017;01;05;Sunnuntai;3;0;3
624;22.01.2017;2017;01;06;Sunnuntai;3;1;4
624;22.01.2017;2017;01;07;Sunnuntai;2;6;8
624;22.01.2017;2017;01;08;Sunnuntai;3;3;6
624;22.01.2017;2017;01;09;Sunnuntai;1;2;3
624;22.01.2017;2017;01;10;Sunnuntai;2;4;6
624;22.01.2017;2017;01;11;Sunnuntai;2;5;7
624;22.01.2017;2017;01;12;Sunnuntai;6;11;17
624;22.01.2017;2017;01;13;Sunnuntai;3;6;9
624;22.01.2017;2017;01;14;Sunnuntai;1;6;7
624;22.01.2017;2017;01;15;Sunnuntai;6;11;17
624;22.01.2017;2017;01;16;Sunnuntai;6;2;8
624;22.01.2017;2017;01;17;Sunnuntai;6;5;11
624;22.01.2017;2017;01;18;Sunnuntai;4;7;11
624;22.01.2017;2017;01;19;Sunnuntai;8;7;15
624;22.01.2017;2017;01;20;Sunnuntai;5;5;10
624;22.01.2017;2017;01;21;Sunnuntai;6;1;7
624;22.01.2017;2017;01;22;Sunnuntai;11;3;14
624;22.01.2017;2017;01;23;Sunnuntai;0;2;2
624;23.01.2017;2017;01;00;Maanantai;0;3;3
624;23.01.2017;2017;01;01;Maanantai;0;0;0
624;23.01.2017;2017;01;02;Maanantai;0;0;0
624;23.01.2017;2017;01;03;Maanantai;0;1;1
624;23.01.2017;2017;01;04;Maanantai;1;0;1
624;23.01.2017;2017;01;05;Maanantai;0;0;0
624;23.01.2017;2017;01;06;Maanantai;2;10;12
624;23.01.2017;2017;01;07;Maanantai;10;9;19
624;23.01.2017;2017;01;08;Maanantai;16;44;60
624;23.01.2017;2017;01;09;Maanantai;13;48;61
624;23.01.2017;2017;01;10;Maanantai;5;26;31
624;23.01.2017;2017;01;11;Maanantai;9;17;26
624;23.01.2017;2017;01;12;Maanantai;10;11;21
624;23.01.2017;2017;01;13;Maanantai;10;16;26
624;23.01.2017;2017;01;14;Maanantai;14;14;28
624;23.01.2017;2017;01;15;Maanantai;9;14;23
624;23.01.2017;2017;01;16;Maanantai;22;13;35
624;23.01.2017;2017;01;17;Maanantai;42;31;73
624;23.01.2017;2017;01;18;Maanantai;23;20;43
624;23.01.2017;2017;01;19;Maanantai;18;12;30
624;23.01.2017;2017;01;20;Maanantai;14;11;25
624;23.01.2017;2017;01;21;Maanantai;13;11;24
624;23.01.2017;2017;01;22;Maanantai;8;1;9
624;23.01.2017;2017;01;23;Maanantai;3;0;3
624;24.01.2017;2017;01;00;Tiistai;2;1;3
624;24.01.2017;2017;01;01;Tiistai;1;0;1
624;24.01.2017;2017;01;02;Tiistai;0;0;0
624;24.01.2017;2017;01;03;Tiistai;1;0;1
624;24.01.2017;2017;01;04;Tiistai;0;1;1
624;24.01.2017;2017;01;05;Tiistai;4;1;5
624;24.01.2017;2017;01;06;Tiistai;1;6;7
624;24.01.2017;2017;01;07;Tiistai;5;14;19
624;24.01.2017;2017;01;08;Tiistai;9;37;46
624;24.01.2017;2017;01;09;Tiistai;13;36;49
624;24.01.2017;2017;01;10;Tiistai;4;18;22
624;24.01.2017;2017;01;11;Tiistai;7;8;15
624;24.01.2017;2017;01;12;Tiistai;7;8;15
624;24.01.2017;2017;01;13;Tiistai;4;18;22
624;24.01.2017;2017;01;14;Tiistai;12;12;24
624;24.01.2017;2017;01;15;Tiistai;18;4;22
624;24.01.2017;2017;01;16;Tiistai;19;12;31
624;24.01.2017;2017;01;17;Tiistai;40;24;64
624;24.01.2017;2017;01;18;Tiistai;26;17;43
624;24.01.2017;2017;01;19;Tiistai;12;11;23
624;24.01.2017;2017;01;20;Tiistai;0;0;0
624;24.01.2017;2017;01;21;Tiistai;22;13;35
624;24.01.2017;2017;01;22;Tiistai;7;4;11
624;24.01.2017;2017;01;23;Tiistai;5;1;6
624;25.01.2017;2017;01;00;Keskiviikko;1;1;2
624;25.01.2017;2017;01;01;Keskiviikko;2;0;2
624;25.01.2017;2017;01;02;Keskiviikko;1;0;1
624;25.01.2017;2017;01;03;Keskiviikko;0;1;1
624;25.01.2017;2017;01;04;Keskiviikko;1;1;2
624;25.01.2017;2017;01;05;Keskiviikko;1;1;2
624;25.01.2017;2017;01;06;Keskiviikko;2;10;12
624;25.01.2017;2017;01;07;Keskiviikko;7;15;22
624;25.01.2017;2017;01;08;Keskiviikko;13;34;47
624;25.01.2017;2017;01;09;Keskiviikko;15;48;63
624;25.01.2017;2017;01;10;Keskiviikko;9;19;28
624;25.01.2017;2017;01;11;Keskiviikko;4;15;19
624;25.01.2017;2017;01;12;Keskiviikko;8;11;19
624;25.01.2017;2017;01;13;Keskiviikko;10;21;31
624;25.01.2017;2017;01;14;Keskiviikko;16;8;24
624;25.01.2017;2017;01;15;Keskiviikko;20;9;29
624;25.01.2017;2017;01;16;Keskiviikko;26;18;44
624;25.01.2017;2017;01;17;Keskiviikko;32;26;58
624;25.01.2017;2017;01;18;Keskiviikko;26;11;37
624;25.01.2017;2017;01;19;Keskiviikko;16;16;32
624;25.01.2017;2017;01;20;Keskiviikko;16;7;23
624;25.01.2017;2017;01;21;Keskiviikko;11;8;19
624;25.01.2017;2017;01;22;Keskiviikko;8;5;13
624;25.01.2017;2017;01;23;Keskiviikko;4;2;6
624;26.01.2017;2017;01;00;Torstai;0;3;3
624;26.01.2017;2017;01;01;Torstai;1;0;1
624;26.01.2017;2017;01;02;Torstai;0;1;1
624;26.01.2017;2017;01;03;Torstai;0;0;0
624;26.01.2017;2017;01;04;Torstai;0;0;0
624;26.01.2017;2017;01;05;Torstai;1;2;3
624;26.01.2017;2017;01;06;Torstai;2;8;10
624;26.01.2017;2017;01;07;Torstai;4;19;23
624;26.01.2017;2017;01;08;Torstai;5;35;40
624;26.01.2017;2017;01;09;Torstai;10;33;43
624;26.01.2017;2017;01;10;Torstai;5;21;26
624;26.01.2017;2017;01;11;Torstai;7;20;27
624;26.01.2017;2017;01;12;Torstai;11;9;20
624;26.01.2017;2017;01;13;Torstai;5;8;13
624;26.01.2017;2017;01;14;Torstai;18;10;28
624;26.01.2017;2017;01;15;Torstai;17;13;30
624;26.01.2017;2017;01;16;Torstai;28;13;41
624;26.01.2017;2017;01;17;Torstai;33;18;51
624;26.01.2017;2017;01;18;Torstai;15;10;25
624;26.01.2017;2017;01;19;Torstai;11;11;22
624;26.01.2017;2017;01;20;Torstai;6;12;18
624;26.01.2017;2017;01;21;Torstai;0;8;8
624;26.01.2017;2017;01;22;Torstai;3;2;5
624;26.01.2017;2017;01;23;Torstai;2;4;6
624;27.01.2017;2017;01;00;Perjantai;1;2;3
624;27.01.2017;2017;01;01;Perjantai;3;2;5
624;27.01.2017;2017;01;02;Perjantai;0;1;1
624;27.01.2017;2017;01;03;Perjantai;1;0;1
624;27.01.2017;2017;01;04;Perjantai;0;0;0
624;27.01.2017;2017;01;05;Perjantai;1;1;2
624;27.01.2017;2017;01;06;Perjantai;0;7;7
624;27.01.2017;2017;01;07;Perjantai;6;14;20
624;27.01.2017;2017;01;08;Perjantai;7;35;42
624;27.01.2017;2017;01;09;Perjantai;7;33;40
624;27.01.2017;2017;01;10;Perjantai;5;19;24
624;27.01.2017;2017;01;11;Perjantai;2;12;14
624;27.01.2017;2017;01;12;Perjantai;6;13;19
624;27.01.2017;2017;01;13;Perjantai;7;13;20
624;27.01.2017;2017;01;14;Perjantai;20;16;36
624;27.01.2017;2017;01;15;Perjantai;20;16;36
624;27.01.2017;2017;01;16;Perjantai;30;23;53
624;27.01.2017;2017;01;17;Perjantai;31;23;54
624;27.01.2017;2017;01;18;Perjantai;24;15;39
624;27.01.2017;2017;01;19;Perjantai;18;17;35
624;27.01.2017;2017;01;20;Perjantai;17;8;25
624;27.01.2017;2017;01;21;Perjantai;5;5;10
624;27.01.2017;2017;01;22;Perjantai;6;3;9
624;27.01.2017;2017;01;23;Perjantai;2;3;5
624;28.01.2017;2017;01;00;Lauantai;2;2;4
624;28.01.2017;2017;01;01;Lauantai;2;1;3
624;28.01.2017;2017;01;02;Lauantai;2;4;6
624;28.01.2017;2017;01;03;Lauantai;2;1;3
624;28.01.2017;2017;01;04;Lauantai;2;1;3
624;28.01.2017;2017;01;05;Lauantai;1;0;1
624;28.01.2017;2017;01;06;Lauantai;2;1;3
624;28.01.2017;2017;01;07;Lauantai;0;1;1
624;28.01.2017;2017;01;08;Lauantai;1;2;3
624;28.01.2017;2017;01;09;Lauantai;3;7;10
624;28.01.2017;2017;01;10;Lauantai;2;6;8
624;28.01.2017;2017;01;11;Lauantai;1;7;8
624;28.01.2017;2017;01;12;Lauantai;3;13;16
624;28.01.2017;2017;01;13;Lauantai;6;14;20
624;28.01.2017;2017;01;14;Lauantai;10;13;23
624;28.01.2017;2017;01;15;Lauantai;7;15;22
624;28.01.2017;2017;01;16;Lauantai;14;13;27
624;28.01.2017;2017;01;17;Lauantai;9;8;17
624;28.01.2017;2017;01;18;Lauantai;10;6;16
624;28.01.2017;2017;01;19;Lauantai;6;6;12
624;28.01.2017;2017;01;20;Lauantai;4;5;9
624;28.01.2017;2017;01;21;Lauantai;5;2;7
624;28.01.2017;2017;01;22;Lauantai;4;5;9
624;28.01.2017;2017;01;23;Lauantai;1;10;11
624;29.01.2017;2017;01;00;Sunnuntai;0;1;1
624;29.01.2017;2017;01;01;Sunnuntai;1;0;1
624;29.01.2017;2017;01;02;Sunnuntai;2;2;4
624;29.01.2017;2017;01;03;Sunnuntai;0;2;2
624;29.01.2017;2017;01;04;Sunnuntai;1;3;4
624;29.01.2017;2017;01;05;Sunnuntai;4;0;4
624;29.01.2017;2017;01;06;Sunnuntai;0;0;0
624;29.01.2017;2017;01;07;Sunnuntai;0;5;5
624;29.01.2017;2017;01;08;Sunnuntai;2;4;6
624;29.01.2017;2017;01;09;Sunnuntai;1;1;2
624;29.01.2017;2017;01;10;Sunnuntai;2;3;5
624;29.01.2017;2017;01;11;Sunnuntai;7;8;15
624;29.01.2017;2017;01;12;Sunnuntai;2;6;8
624;29.01.2017;2017;01;13;Sunnuntai;5;15;20
624;29.01.2017;2017;01;14;Sunnuntai;6;12;18
624;29.01.2017;2017;01;15;Sunnuntai;10;10;20
624;29.01.2017;2017;01;16;Sunnuntai;11;6;17
624;29.01.2017;2017;01;17;Sunnuntai;5;4;9
624;29.01.2017;2017;01;18;Sunnuntai;9;12;21
624;29.01.2017;2017;01;19;Sunnuntai;10;5;15
624;29.01.2017;2017;01;20;Sunnuntai;6;9;15
624;29.01.2017;2017;01;21;Sunnuntai;1;3;4
624;29.01.2017;2017;01;22;Sunnuntai;7;6;13
624;29.01.2017;2017;01;23;Sunnuntai;7;6;13
624;30.01.2017;2017;01;00;Maanantai;0;2;2
624;30.01.2017;2017;01;01;Maanantai;0;0;0
624;30.01.2017;2017;01;02;Maanantai;0;1;1
624;30.01.2017;2017;01;03;Maanantai;1;0;1
624;30.01.2017;2017;01;04;Maanantai;0;0;0
624;30.01.2017;2017;01;05;Maanantai;2;3;5
624;30.01.2017;2017;01;06;Maanantai;1;6;7
624;30.01.2017;2017;01;07;Maanantai;4;6;10
624;30.01.2017;2017;01;08;Maanantai;16;44;60
624;30.01.2017;2017;01;09;Maanantai;13;29;42
624;30.01.2017;2017;01;10;Maanantai;4;23;27
624;30.01.2017;2017;01;11;Maanantai;4;19;23
624;30.01.2017;2017;01;12;Maanantai;5;16;21
624;30.01.2017;2017;01;13;Maanantai;4;11;15
624;30.01.2017;2017;01;14;Maanantai;8;11;19
624;30.01.2017;2017;01;15;Maanantai;15;14;29
624;30.01.2017;2017;01;16;Maanantai;12;9;21
624;30.01.2017;2017;01;17;Maanantai;27;16;43
624;30.01.2017;2017;01;18;Maanantai;15;22;37
624;30.01.2017;2017;01;19;Maanantai;16;14;30
624;30.01.2017;2017;01;20;Maanantai;5;7;12
624;30.01.2017;2017;01;21;Maanantai;7;7;14
624;30.01.2017;2017;01;22;Maanantai;6;3;9
624;30.01.2017;2017;01;23;Maanantai;6;2;8
624;31.01.2017;2017;01;00;Tiistai;1;0;1
624;31.01.2017;2017;01;01;Tiistai;1;0;1
624;31.01.2017;2017;01;02;Tiistai;1;0;1
624;31.01.2017;2017;01;03;Tiistai;1;1;2
624;31.01.2017;2017;01;04;Tiistai;0;0;0
624;31.01.2017;2017;01;05;Tiistai;3;2;5
624;31.01.2017;2017;01;06;Tiistai;2;4;6
624;31.01.2017;2017;01;07;Tiistai;3;15;18
624;31.01.2017;2017;01;08;Tiistai;7;38;45
624;31.01.2017;2017;01;09;Tiistai;10;41;51
624;31.01.2017;2017;01;10;Tiistai;4;20;24
624;31.01.2017;2017;01;11;Tiistai;3;12;15
624;31.01.2017;2017;01;12;Tiistai;4;11;15
624;31.01.2017;2017;01;13;Tiistai;7;9;16
624;31.01.2017;2017;01;14;Tiistai;9;10;19
624;31.01.2017;2017;01;15;Tiistai;15;12;27
624;31.01.2017;2017;01;16;Tiistai;18;20;38
624;31.01.2017;2017;01;17;Tiistai;24;27;51
624;31.01.2017;2017;01;18;Tiistai;13;12;25
624;31.01.2017;2017;01;19;Tiistai;9;10;19
624;31.01.2017;2017;01;20;Tiistai;10;9;19
624;31.01.2017;2017;01;21;Tiistai;4;4;8
624;31.01.2017;2017;01;22;Tiistai;3;2;5
624;31.01.2017;2017;01;23;Tiistai;1;2;3
624;01.02.2017;2017;02;00;Keskiviikko;1;2;3
624;01.02.2017;2017;02;01;Keskiviikko;0;2;2
624;01.02.2017;2017;02;02;Keskiviikko;2;0;2
624;01.02.2017;2017;02;03;Keskiviikko;0;0;0
624;01.02.2017;2017;02;04;Keskiviikko;0;0;0
624;01.02.2017;2017;02;05;Keskiviikko;1;2;3
624;01.02.2017;2017;02;06;Keskiviikko;0;1;1
624;01.02.2017;2017;02;07;Keskiviikko;1;11;12
624;01.02.2017;2017;02;08;Keskiviikko;10;46;56
624;01.02.2017;2017;02;09;Keskiviikko;7;48;55
624;01.02.2017;2017;02;10;Keskiviikko;11;18;29
624;01.02.2017;2017;02;11;Keskiviikko;1;8;9
624;01.02.2017;2017;02;12;Keskiviikko;9;11;20
624;01.02.2017;2017;02;13;Keskiviikko;7;7;14
624;01.02.2017;2017;02;14;Keskiviikko;14;14;28
624;01.02.2017;2017;02;15;Keskiviikko;22;15;37
624;01.02.2017;2017;02;16;Keskiviikko;26;15;41
624;01.02.2017;2017;02;17;Keskiviikko;36;16;52
624;01.02.2017;2017;02;18;Keskiviikko;21;16;37
624;01.02.2017;2017;02;19;Keskiviikko;17;8;25
624;01.02.2017;2017;02;20;Keskiviikko;5;5;10
624;01.02.2017;2017;02;21;Keskiviikko;7;8;15
624;01.02.2017;2017;02;22;Keskiviikko;9;6;15
624;01.02.2017;2017;02;23;Keskiviikko;5;0;5
624;02.02.2017;2017;02;00;Torstai;1;0;1
624;02.02.2017;2017;02;01;Torstai;1;0;1
624;02.02.2017;2017;02;02;Torstai;1;0;1
624;02.02.2017;2017;02;03;Torstai;0;0;0
624;02.02.2017;2017;02;04;Torstai;0;0;0
624;02.02.2017;2017;02;05;Torstai;1;0;1
624;02.02.2017;2017;02;06;Torstai;2;4;6
624;02.02.2017;2017;02;07;Torstai;3;9;12
624;02.02.2017;2017;02;08;Torstai;10;50;60
624;02.02.2017;2017;02;09;Torstai;10;27;37
624;02.02.2017;2017;02;10;Torstai;4;19;23
624;02.02.2017;2017;02;11;Torstai;4;13;17
624;02.02.2017;2017;02;12;Torstai;8;8;16
624;02.02.2017;2017;02;13;Torstai;16;10;26
624;02.02.2017;2017;02;14;Torstai;5;12;17
624;02.02.2017;2017;02;15;Torstai;11;6;17
624;02.02.2017;2017;02;16;Torstai;16;10;26
624;02.02.2017;2017;02;17;Torstai;8;12;20
624;02.02.2017;2017;02;18;Torstai;8;10;18
624;02.02.2017;2017;02;19;Torstai;4;3;7
624;02.02.2017;2017;02;20;Torstai;4;5;9
624;02.02.2017;2017;02;21;Torstai;3;5;8
624;02.02.2017;2017;02;22;Torstai;4;4;8
624;02.02.2017;2017;02;23;Torstai;2;1;3
624;03.02.2017;2017;02;00;Perjantai;1;1;2
624;03.02.2017;2017;02;01;Perjantai;1;0;1
624;03.02.2017;2017;02;02;Perjantai;0;0;0
624;03.02.2017;2017;02;03;Perjantai;0;0;0
624;03.02.2017;2017;02;04;Perjantai;2;0;2
624;03.02.2017;2017;02;05;Perjantai;0;1;1
624;03.02.2017;2017;02;06;Perjantai;2;1;3
624;03.02.2017;2017;02;07;Perjantai;4;12;16
624;03.02.2017;2017;02;08;Perjantai;5;32;37
624;03.02.2017;2017;02;09;Perjantai;7;34;41
624;03.02.2017;2017;02;10;Perjantai;6;4;10
624;03.02.2017;2017;02;11;Perjantai;5;8;13
624;03.02.2017;2017;02;12;Perjantai;10;17;27
624;03.02.2017;2017;02;13;Perjantai;6;10;16
624;03.02.2017;2017;02;14;Perjantai;5;10;15
624;03.02.2017;2017;02;15;Perjantai;11;5;16
624;03.02.2017;2017;02;16;Perjantai;28;16;44
624;03.02.2017;2017;02;17;Perjantai;15;16;31
624;03.02.2017;2017;02;18;Perjantai;19;13;32
624;03.02.2017;2017;02;19;Perjantai;7;8;15
624;03.02.2017;2017;02;20;Perjantai;6;3;9
624;03.02.2017;2017;02;21;Perjantai;3;9;12
624;03.02.2017;2017;02;22;Perjantai;3;3;6
624;03.02.2017;2017;02;23;Perjantai;0;1;1
624;04.02.2017;2017;02;00;Lauantai;2;5;7
624;04.02.2017;2017;02;01;Lauantai;0;0;0
624;04.02.2017;2017;02;02;Lauantai;2;1;3
624;04.02.2017;2017;02;03;Lauantai;1;0;1
624;04.02.2017;2017;02;04;Lauantai;0;1;1
624;04.02.2017;2017;02;05;Lauantai;1;0;1
624;04.02.2017;2017;02;06;Lauantai;0;0;0
624;04.02.2017;2017;02;07;Lauantai;0;2;2
624;04.02.2017;2017;02;08;Lauantai;1;4;5
624;04.02.2017;2017;02;09;Lauantai;2;8;10
624;04.02.2017;2017;02;10;Lauantai;1;7;8
624;04.02.2017;2017;02;11;Lauantai;2;1;3
624;04.02.2017;2017;02;12;Lauantai;3;8;11
624;04.02.2017;2017;02;13;Lauantai;5;6;11
624;04.02.2017;2017;02;14;Lauantai;7;2;9
624;04.02.2017;2017;02;15;Lauantai;3;6;9
624;04.02.2017;2017;02;16;Lauantai;8;9;17
624;04.02.2017;2017;02;17;Lauantai;6;10;16
624;04.02.2017;2017;02;18;Lauantai;6;8;14
624;04.02.2017;2017;02;19;Lauantai;0;2;2
624;04.02.2017;2017;02;20;Lauantai;0;2;2
624;04.02.2017;2017;02;21;Lauantai;3;6;9
624;04.02.2017;2017;02;22;Lauantai;1;7;8
624;04.02.2017;2017;02;23;Lauantai;3;3;6
624;05.02.2017;2017;02;00;Sunnuntai;0;4;4
624;05.02.2017;2017;02;01;Sunnuntai;1;0;1
624;05.02.2017;2017;02;02;Sunnuntai;0;0;0
624;05.02.2017;2017;02;03;Sunnuntai;0;0;0
624;05.02.2017;2017;02;04;Sunnuntai;0;0;0
624;05.02.2017;2017;02;05;Sunnuntai;3;0;3
624;05.02.2017;2017;02;06;Sunnuntai;0;0;0
624;05.02.2017;2017;02;07;Sunnuntai;0;4;4
624;05.02.2017;2017;02;08;Sunnuntai;1;3;4
624;05.02.2017;2017;02;09;Sunnuntai;1;1;2
624;05.02.2017;2017;02;10;Sunnuntai;1;3;4
624;05.02.2017;2017;02;11;Sunnuntai;0;3;3
624;05.02.2017;2017;02;12;Sunnuntai;3;5;8
624;05.02.2017;2017;02;13;Sunnuntai;3;6;9
624;05.02.2017;2017;02;14;Sunnuntai;8;9;17
624;05.02.2017;2017;02;15;Sunnuntai;4;6;10
624;05.02.2017;2017;02;16;Sunnuntai;5;5;10
624;05.02.2017;2017;02;17;Sunnuntai;3;5;8
624;05.02.2017;2017;02;18;Sunnuntai;8;10;18
624;05.02.2017;2017;02;19;Sunnuntai;5;4;9
624;05.02.2017;2017;02;20;Sunnuntai;9;3;12
624;05.02.2017;2017;02;21;Sunnuntai;2;2;4
624;05.02.2017;2017;02;22;Sunnuntai;7;3;10
624;05.02.2017;2017;02;23;Sunnuntai;2;2;4
624;06.02.2017;2017;02;00;Maanantai;2;1;3
624;06.02.2017;2017;02;01;Maanantai;2;1;3
624;06.02.2017;2017;02;02;Maanantai;0;0;0
624;06.02.2017;2017;02;03;Maanantai;0;0;0
624;06.02.2017;2017;02;04;Maanantai;0;1;1
624;06.02.2017;2017;02;05;Maanantai;1;0;1
624;06.02.2017;2017;02;06;Maanantai;1;9;10
624;06.02.2017;2017;02;07;Maanantai;8;8;16
624;06.02.2017;2017;02;08;Maanantai;8;36;44
624;06.02.2017;2017;02;09;Maanantai;14;43;57
624;06.02.2017;2017;02;10;Maanantai;8;23;31
624;06.02.2017;2017;02;11;Maanantai;3;23;26
624;06.02.2017;2017;02;12;Maanantai;7;7;14
624;06.02.2017;2017;02;13;Maanantai;7;7;14
624;06.02.2017;2017;02;14;Maanantai;6;4;10
624;06.02.2017;2017;02;15;Maanantai;9;17;26
624;06.02.2017;2017;02;16;Maanantai;27;14;41
624;06.02.2017;2017;02;17;Maanantai;41;22;63
624;06.02.2017;2017;02;18;Maanantai;17;13;30
624;06.02.2017;2017;02;19;Maanantai;17;8;25
624;06.02.2017;2017;02;20;Maanantai;8;7;15
624;06.02.2017;2017;02;21;Maanantai;7;5;12
624;06.02.2017;2017;02;22;Maanantai;11;4;15
624;06.02.2017;2017;02;23;Maanantai;4;3;7
624;07.02.2017;2017;02;00;Tiistai;1;2;3
624;07.02.2017;2017;02;01;Tiistai;0;0;0
624;07.02.2017;2017;02;02;Tiistai;1;0;1
624;07.02.2017;2017;02;03;Tiistai;0;0;0
624;07.02.2017;2017;02;04;Tiistai;0;1;1
624;07.02.2017;2017;02;05;Tiistai;1;1;2
624;07.02.2017;2017;02;06;Tiistai;1;4;5
624;07.02.2017;2017;02;07;Tiistai;7;13;20
624;07.02.2017;2017;02;08;Tiistai;17;37;54
624;07.02.2017;2017;02;09;Tiistai;12;31;43
624;07.02.2017;2017;02;10;Tiistai;10;12;22
624;07.02.2017;2017;02;11;Tiistai;9;9;18
624;07.02.2017;2017;02;12;Tiistai;5;13;18
624;07.02.2017;2017;02;13;Tiistai;8;14;22
624;07.02.2017;2017;02;14;Tiistai;10;12;22
624;07.02.2017;2017;02;15;Tiistai;19;11;30
624;07.02.2017;2017;02;16;Tiistai;33;20;53
624;07.02.2017;2017;02;17;Tiistai;37;21;58
624;07.02.2017;2017;02;18;Tiistai;13;17;30
624;07.02.2017;2017;02;19;Tiistai;12;12;24
624;07.02.2017;2017;02;20;Tiistai;14;6;20
624;07.02.2017;2017;02;21;Tiistai;4;0;4
624;07.02.2017;2017;02;22;Tiistai;18;6;24
624;07.02.2017;2017;02;23;Tiistai;2;4;6
624;08.02.2017;2017;02;00;Keskiviikko;0;1;1
624;08.02.2017;2017;02;01;Keskiviikko;3;1;4
624;08.02.2017;2017;02;02;Keskiviikko;0;0;0
624;08.02.2017;2017;02;03;Keskiviikko;1;0;1
624;08.02.2017;2017;02;04;Keskiviikko;0;1;1
624;08.02.2017;2017;02;05;Keskiviikko;0;1;1
624;08.02.2017;2017;02;06;Keskiviikko;3;6;9
624;08.02.2017;2017;02;07;Keskiviikko;4;6;10
624;08.02.2017;2017;02;08;Keskiviikko;7;28;35
624;08.02.2017;2017;02;09;Keskiviikko;10;38;48
624;08.02.2017;2017;02;10;Keskiviikko;8;7;15
624;08.02.2017;2017;02;11;Keskiviikko;4;12;16
624;08.02.2017;2017;02;12;Keskiviikko;11;11;22
624;08.02.2017;2017;02;13;Keskiviikko;3;6;9
624;08.02.2017;2017;02;14;Keskiviikko;13;14;27
624;08.02.2017;2017;02;15;Keskiviikko;17;11;28
624;08.02.2017;2017;02;16;Keskiviikko;21;20;41
624;08.02.2017;2017;02;17;Keskiviikko;33;18;51
624;08.02.2017;2017;02;18;Keskiviikko;13;13;26
624;08.02.2017;2017;02;19;Keskiviikko;17;10;27
624;08.02.2017;2017;02;20;Keskiviikko;10;4;14
624;08.02.2017;2017;02;21;Keskiviikko;11;8;19
624;08.02.2017;2017;02;22;Keskiviikko;9;6;15
624;08.02.2017;2017;02;23;Keskiviikko;1;3;4
624;09.02.2017;2017;02;00;Torstai;3;1;4
624;09.02.2017;2017;02;01;Torstai;1;1;2
624;09.02.2017;2017;02;02;Torstai;1;0;1
624;09.02.2017;2017;02;03;Torstai;1;0;1
624;09.02.2017;2017;02;04;Torstai;0;1;1
624;09.02.2017;2017;02;05;Torstai;1;1;2
624;09.02.2017;2017;02;06;Torstai;2;9;11
624;09.02.2017;2017;02;07;Torstai;5;5;10
624;09.02.2017;2017;02;08;Torstai;7;27;34
624;09.02.2017;2017;02;09;Torstai;6;33;39
624;09.02.2017;2017;02;10;Torstai;12;13;25
624;09.02.2017;2017;02;11;Torstai;7;10;17
624;09.02.2017;2017;02;12;Torstai;8;10;18
624;09.02.2017;2017;02;13;Torstai;6;6;12
624;09.02.2017;2017;02;14;Torstai;11;8;19
624;09.02.2017;2017;02;15;Torstai;18;10;28
624;09.02.2017;2017;02;16;Torstai;18;13;31
624;09.02.2017;2017;02;17;Torstai;26;18;44
624;09.02.2017;2017;02;18;Torstai;21;10;31
624;09.02.2017;2017;02;19;Torstai;12;8;20
624;09.02.2017;2017;02;20;Torstai;14;7;21
624;09.02.2017;2017;02;21;Torstai;5;10;15
624;09.02.2017;2017;02;22;Torstai;6;4;10
624;09.02.2017;2017;02;23;Torstai;4;3;7
624;10.02.2017;2017;02;00;Perjantai;1;0;1
624;10.02.2017;2017;02;01;Perjantai;2;0;2
624;10.02.2017;2017;02;02;Perjantai;1;0;1
624;10.02.2017;2017;02;03;Perjantai;0;0;0
624;10.02.2017;2017;02;04;Perjantai;1;2;3
624;10.02.2017;2017;02;05;Perjantai;0;1;1
624;10.02.2017;2017;02;06;Perjantai;5;6;11
624;10.02.2017;2017;02;07;Perjantai;8;13;21
624;10.02.2017;2017;02;08;Perjantai;15;27;42
624;10.02.2017;2017;02;09;Perjantai;5;29;34
624;10.02.2017;2017;02;10;Perjantai;9;19;28
624;10.02.2017;2017;02;11;Perjantai;10;9;19
624;10.02.2017;2017;02;12;Perjantai;10;14;24
624;10.02.2017;2017;02;13;Perjantai;6;9;15
624;10.02.2017;2017;02;14;Perjantai;18;17;35
624;10.02.2017;2017;02;15;Perjantai;18;11;29
624;10.02.2017;2017;02;16;Perjantai;28;14;42
624;10.02.2017;2017;02;17;Perjantai;19;15;34
624;10.02.2017;2017;02;18;Perjantai;19;17;36
624;10.02.2017;2017;02;19;Perjantai;15;7;22
624;10.02.2017;2017;02;20;Perjantai;7;5;12
624;10.02.2017;2017;02;21;Perjantai;8;3;11
624;10.02.2017;2017;02;22;Perjantai;17;3;20
624;10.02.2017;2017;02;23;Perjantai;1;3;4
624;11.02.2017;2017;02;00;Lauantai;2;4;6
624;11.02.2017;2017;02;01;Lauantai;0;1;1
624;11.02.2017;2017;02;02;Lauantai;3;3;6
624;11.02.2017;2017;02;03;Lauantai;8;0;8
624;11.02.2017;2017;02;04;Lauantai;3;2;5
624;11.02.2017;2017;02;05;Lauantai;1;1;2
624;11.02.2017;2017;02;06;Lauantai;0;3;3
624;11.02.2017;2017;02;07;Lauantai;2;2;4
624;11.02.2017;2017;02;08;Lauantai;1;8;9
624;11.02.2017;2017;02;09;Lauantai;4;6;10
624;11.02.2017;2017;02;10;Lauantai;1;13;14
624;11.02.2017;2017;02;11;Lauantai;8;9;17
624;11.02.2017;2017;02;12;Lauantai;8;6;14
624;11.02.2017;2017;02;13;Lauantai;9;16;25
624;11.02.2017;2017;02;14;Lauantai;5;10;15
624;11.02.2017;2017;02;15;Lauantai;9;8;17
624;11.02.2017;2017;02;16;Lauantai;11;4;15
624;11.02.2017;2017;02;17;Lauantai;14;7;21
624;11.02.2017;2017;02;18;Lauantai;5;5;10
624;11.02.2017;2017;02;19;Lauantai;9;8;17
624;11.02.2017;2017;02;20;Lauantai;2;2;4
624;11.02.2017;2017;02;21;Lauantai;4;9;13
624;11.02.2017;2017;02;22;Lauantai;8;6;14
624;11.02.2017;2017;02;23;Lauantai;9;3;12
624;12.02.2017;2017;02;00;Sunnuntai;3;4;7
624;12.02.2017;2017;02;01;Sunnuntai;1;3;4
624;12.02.2017;2017;02;02;Sunnuntai;5;2;7
624;12.02.2017;2017;02;03;Sunnuntai;1;0;1
624;12.02.2017;2017;02;04;Sunnuntai;2;1;3
624;12.02.2017;2017;02;05;Sunnuntai;3;0;3
624;12.02.2017;2017;02;06;Sunnuntai;0;1;1
624;12.02.2017;2017;02;07;Sunnuntai;0;2;2
624;12.02.2017;2017;02;08;Sunnuntai;2;3;5
624;12.02.2017;2017;02;09;Sunnuntai;0;2;2
624;12.02.2017;2017;02;10;Sunnuntai;2;2;4
624;12.02.2017;2017;02;11;Sunnuntai;2;6;8
624;12.02.2017;2017;02;12;Sunnuntai;4;2;6
624;12.02.2017;2017;02;13;Sunnuntai;3;8;11
624;12.02.2017;2017;02;14;Sunnuntai;7;7;14
624;12.02.2017;2017;02;15;Sunnuntai;10;13;23
624;12.02.2017;2017;02;16;Sunnuntai;6;4;10
624;12.02.2017;2017;02;17;Sunnuntai;4;5;9
624;12.02.2017;2017;02;18;Sunnuntai;10;1;11
624;12.02.2017;2017;02;19;Sunnuntai;7;11;18
624;12.02.2017;2017;02;20;Sunnuntai;4;6;10
624;12.02.2017;2017;02;21;Sunnuntai;2;4;6
624;12.02.2017;2017;02;22;Sunnuntai;6;1;7
624;12.02.2017;2017;02;23;Sunnuntai;0;1;1
624;13.02.2017;2017;02;00;Maanantai;2;1;3
624;13.02.2017;2017;02;01;Maanantai;1;0;1
624;13.02.2017;2017;02;02;Maanantai;0;0;0
624;13.02.2017;2017;02;03;Maanantai;1;0;1
624;13.02.2017;2017;02;04;Maanantai;0;0;0
624;13.02.2017;2017;02;05;Maanantai;1;1;2
624;13.02.2017;2017;02;06;Maanantai;2;8;10
624;13.02.2017;2017;02;07;Maanantai;8;13;21
624;13.02.2017;2017;02;08;Maanantai;11;46;57
624;13.02.2017;2017;02;09;Maanantai;13;31;44
624;13.02.2017;2017;02;10;Maanantai;8;22;30
624;13.02.2017;2017;02;11;Maanantai;5;19;24
624;13.02.2017;2017;02;12;Maanantai;9;9;18
624;13.02.2017;2017;02;13;Maanantai;6;8;14
624;13.02.2017;2017;02;14;Maanantai;17;17;34
624;13.02.2017;2017;02;15;Maanantai;24;17;41
624;13.02.2017;2017;02;16;Maanantai;39;17;56
624;13.02.2017;2017;02;17;Maanantai;50;23;73
624;13.02.2017;2017;02;18;Maanantai;19;17;36
624;13.02.2017;2017;02;19;Maanantai;16;10;26
624;13.02.2017;2017;02;20;Maanantai;21;14;35
624;13.02.2017;2017;02;21;Maanantai;8;12;20
624;13.02.2017;2017;02;22;Maanantai;10;0;10
624;13.02.2017;2017;02;23;Maanantai;3;4;7
624;14.02.2017;2017;02;00;Tiistai;0;1;1
624;14.02.2017;2017;02;01;Tiistai;0;1;1
624;14.02.2017;2017;02;02;Tiistai;2;0;2
624;14.02.2017;2017;02;03;Tiistai;0;0;0
624;14.02.2017;2017;02;04;Tiistai;0;1;1
624;14.02.2017;2017;02;05;Tiistai;0;1;1
624;14.02.2017;2017;02;06;Tiistai;3;6;9
624;14.02.2017;2017;02;07;Tiistai;8;21;29
624;14.02.2017;2017;02;08;Tiistai;7;42;49
624;14.02.2017;2017;02;09;Tiistai;13;40;53
624;14.02.2017;2017;02;10;Tiistai;9;20;29
624;14.02.2017;2017;02;11;Tiistai;8;10;18
624;14.02.2017;2017;02;12;Tiistai;14;22;36
624;14.02.2017;2017;02;13;Tiistai;8;16;24
624;14.02.2017;2017;02;14;Tiistai;17;13;30
624;14.02.2017;2017;02;15;Tiistai;16;11;27
624;14.02.2017;2017;02;16;Tiistai;34;25;59
624;14.02.2017;2017;02;17;Tiistai;44;28;72
624;14.02.2017;2017;02;18;Tiistai;19;16;35
624;14.02.2017;2017;02;19;Tiistai;19;19;38
624;14.02.2017;2017;02;20;Tiistai;14;6;20
624;14.02.2017;2017;02;21;Tiistai;16;9;25
624;14.02.2017;2017;02;22;Tiistai;11;3;14
624;14.02.2017;2017;02;23;Tiistai;1;2;3
624;15.02.2017;2017;02;00;Keskiviikko;0;2;2
624;15.02.2017;2017;02;01;Keskiviikko;0;0;0
624;15.02.2017;2017;02;02;Keskiviikko;0;1;1
624;15.02.2017;2017;02;03;Keskiviikko;1;3;4
624;15.02.2017;2017;02;04;Keskiviikko;0;0;0
624;15.02.2017;2017;02;05;Keskiviikko;2;0;2
624;15.02.2017;2017;02;06;Keskiviikko;3;3;6
624;15.02.2017;2017;02;07;Keskiviikko;10;14;24
624;15.02.2017;2017;02;08;Keskiviikko;16;45;61
624;15.02.2017;2017;02;09;Keskiviikko;9;39;48
624;15.02.2017;2017;02;10;Keskiviikko;7;15;22
624;15.02.2017;2017;02;11;Keskiviikko;6;9;15
624;15.02.2017;2017;02;12;Keskiviikko;11;5;16
624;15.02.2017;2017;02;13;Keskiviikko;7;16;23
624;15.02.2017;2017;02;14;Keskiviikko;11;15;26
624;15.02.2017;2017;02;15;Keskiviikko;11;18;29
624;15.02.2017;2017;02;16;Keskiviikko;21;20;41
624;15.02.2017;2017;02;17;Keskiviikko;41;31;72
624;15.02.2017;2017;02;18;Keskiviikko;28;22;50
624;15.02.2017;2017;02;19;Keskiviikko;20;8;28
624;15.02.2017;2017;02;20;Keskiviikko;14;10;24
624;15.02.2017;2017;02;21;Keskiviikko;11;7;18
624;15.02.2017;2017;02;22;Keskiviikko;9;4;13
624;15.02.2017;2017;02;23;Keskiviikko;5;2;7
624;16.02.2017;2017;02;00;Torstai;3;1;4
624;16.02.2017;2017;02;01;Torstai;2;1;3
624;16.02.2017;2017;02;02;Torstai;0;0;0
624;16.02.2017;2017;02;03;Torstai;1;1;2
624;16.02.2017;2017;02;04;Torstai;0;0;0
624;16.02.2017;2017;02;05;Torstai;0;1;1
624;16.02.2017;2017;02;06;Torstai;0;4;4
624;16.02.2017;2017;02;07;Torstai;8;17;25
624;16.02.2017;2017;02;08;Torstai;15;45;60
624;16.02.2017;2017;02;09;Torstai;15;32;47
624;16.02.2017;2017;02;10;Torstai;7;18;25
624;16.02.2017;2017;02;11;Torstai;6;15;21
624;16.02.2017;2017;02;12;Torstai;9;17;26
624;16.02.2017;2017;02;13;Torstai;9;16;25
624;16.02.2017;2017;02;14;Torstai;19;16;35
624;16.02.2017;2017;02;15;Torstai;38;10;48
624;16.02.2017;2017;02;16;Torstai;31;13;44
624;16.02.2017;2017;02;17;Torstai;40;13;53
624;16.02.2017;2017;02;18;Torstai;25;12;37
624;16.02.2017;2017;02;19;Torstai;22;8;30
624;16.02.2017;2017;02;20;Torstai;16;9;25
624;16.02.2017;2017;02;21;Torstai;9;10;19
624;16.02.2017;2017;02;22;Torstai;12;2;14
624;16.02.2017;2017;02;23;Torstai;5;0;5
624;17.02.2017;2017;02;00;Perjantai;2;0;2
624;17.02.2017;2017;02;01;Perjantai;2;2;4
624;17.02.2017;2017;02;02;Perjantai;2;2;4
624;17.02.2017;2017;02;03;Perjantai;0;1;1
624;17.02.2017;2017;02;04;Perjantai;0;1;1
624;17.02.2017;2017;02;05;Perjantai;0;0;0
624;17.02.2017;2017;02;06;Perjantai;3;9;12
624;17.02.2017;2017;02;07;Perjantai;8;16;24
624;17.02.2017;2017;02;08;Perjantai;9;36;45
624;17.02.2017;2017;02;09;Perjantai;12;39;51
624;17.02.2017;2017;02;10;Perjantai;6;23;29
624;17.02.2017;2017;02;11;Perjantai;8;10;18
624;17.02.2017;2017;02;12;Perjantai;10;12;22
624;17.02.2017;2017;02;13;Perjantai;14;15;29
624;17.02.2017;2017;02;14;Perjantai;21;10;31
624;17.02.2017;2017;02;15;Perjantai;22;18;40
624;17.02.2017;2017;02;16;Perjantai;31;14;45
624;17.02.2017;2017;02;17;Perjantai;40;22;62
624;17.02.2017;2017;02;18;Perjantai;16;19;35
624;17.02.2017;2017;02;19;Perjantai;13;7;20
624;17.02.2017;2017;02;20;Perjantai;8;4;12
624;17.02.2017;2017;02;21;Perjantai;10;5;15
624;17.02.2017;2017;02;22;Perjantai;5;8;13
624;17.02.2017;2017;02;23;Perjantai;2;4;6
624;18.02.2017;2017;02;00;Lauantai;2;3;5
624;18.02.2017;2017;02;01;Lauantai;3;3;6
624;18.02.2017;2017;02;02;Lauantai;4;2;6
624;18.02.2017;2017;02;03;Lauantai;4;0;4
624;18.02.2017;2017;02;04;Lauantai;1;2;3
624;18.02.2017;2017;02;05;Lauantai;1;0;1
624;18.02.2017;2017;02;06;Lauantai;1;1;2
624;18.02.2017;2017;02;07;Lauantai;2;3;5
624;18.02.2017;2017;02;08;Lauantai;0;3;3
624;18.02.2017;2017;02;09;Lauantai;2;6;8
624;18.02.2017;2017;02;10;Lauantai;0;8;8
624;18.02.2017;2017;02;11;Lauantai;3;5;8
624;18.02.2017;2017;02;12;Lauantai;5;11;16
624;18.02.2017;2017;02;13;Lauantai;11;13;24
624;18.02.2017;2017;02;14;Lauantai;10;8;18
624;18.02.2017;2017;02;15;Lauantai;10;6;16
624;18.02.2017;2017;02;16;Lauantai;12;11;23
624;18.02.2017;2017;02;17;Lauantai;8;12;20
624;18.02.2017;2017;02;18;Lauantai;8;7;15
624;18.02.2017;2017;02;19;Lauantai;6;6;12
624;18.02.2017;2017;02;20;Lauantai;7;3;10
624;18.02.2017;2017;02;21;Lauantai;5;7;12
624;18.02.2017;2017;02;22;Lauantai;3;2;5
624;18.02.2017;2017;02;23;Lauantai;3;3;6
624;19.02.2017;2017;02;00;Sunnuntai;0;2;2
624;19.02.2017;2017;02;01;Sunnuntai;6;2;8
624;19.02.2017;2017;02;02;Sunnuntai;1;3;4
624;19.02.2017;2017;02;03;Sunnuntai;2;1;3
624;19.02.2017;2017;02;04;Sunnuntai;4;0;4
624;19.02.2017;2017;02;05;Sunnuntai;0;0;0
624;19.02.2017;2017;02;06;Sunnuntai;1;1;2
624;19.02.2017;2017;02;07;Sunnuntai;2;2;4
624;19.02.2017;2017;02;08;Sunnuntai;1;0;1
624;19.02.2017;2017;02;09;Sunnuntai;0;0;0
624;19.02.2017;2017;02;10;Sunnuntai;2;5;7
624;19.02.2017;2017;02;11;Sunnuntai;2;4;6
624;19.02.2017;2017;02;12;Sunnuntai;5;5;10
624;19.02.2017;2017;02;13;Sunnuntai;2;9;11
624;19.02.2017;2017;02;14;Sunnuntai;8;14;22
624;19.02.2017;2017;02;15;Sunnuntai;8;3;11
624;19.02.2017;2017;02;16;Sunnuntai;8;6;14
624;19.02.2017;2017;02;17;Sunnuntai;3;8;11
624;19.02.2017;2017;02;18;Sunnuntai;7;9;16
624;19.02.2017;2017;02;19;Sunnuntai;1;6;7
624;19.02.2017;2017;02;20;Sunnuntai;5;7;12
624;19.02.2017;2017;02;21;Sunnuntai;3;2;5
624;19.02.2017;2017;02;22;Sunnuntai;7;2;9
624;19.02.2017;2017;02;23;Sunnuntai;0;0;0
624;20.02.2017;2017;02;00;Maanantai;3;0;3
624;20.02.2017;2017;02;01;Maanantai;2;1;3
624;20.02.2017;2017;02;02;Maanantai;0;0;0
624;20.02.2017;2017;02;03;Maanantai;1;0;1
624;20.02.2017;2017;02;04;Maanantai;0;0;0
624;20.02.2017;2017;02;05;Maanantai;0;0;0
624;20.02.2017;2017;02;06;Maanantai;3;11;14
624;20.02.2017;2017;02;07;Maanantai;1;13;14
624;20.02.2017;2017;02;08;Maanantai;7;43;50
624;20.02.2017;2017;02;09;Maanantai;8;36;44
624;20.02.2017;2017;02;10;Maanantai;7;19;26
624;20.02.2017;2017;02;11;Maanantai;4;15;19
624;20.02.2017;2017;02;12;Maanantai;6;15;21
624;20.02.2017;2017;02;13;Maanantai;10;12;22
624;20.02.2017;2017;02;14;Maanantai;10;18;28
624;20.02.2017;2017;02;15;Maanantai;11;12;23
624;20.02.2017;2017;02;16;Maanantai;13;11;24
624;20.02.2017;2017;02;17;Maanantai;13;16;29
624;20.02.2017;2017;02;18;Maanantai;13;17;30
624;20.02.2017;2017;02;19;Maanantai;11;11;22
624;20.02.2017;2017;02;20;Maanantai;8;8;16
624;20.02.2017;2017;02;21;Maanantai;6;6;12
624;20.02.2017;2017;02;22;Maanantai;5;5;10
624;20.02.2017;2017;02;23;Maanantai;4;1;5
624;21.02.2017;2017;02;00;Tiistai;0;0;0
624;21.02.2017;2017;02;01;Tiistai;0;1;1
624;21.02.2017;2017;02;02;Tiistai;2;0;2
624;21.02.2017;2017;02;03;Tiistai;0;0;0
624;21.02.2017;2017;02;04;Tiistai;0;2;2
624;21.02.2017;2017;02;05;Tiistai;2;0;2
624;21.02.2017;2017;02;06;Tiistai;3;10;13
624;21.02.2017;2017;02;07;Tiistai;2;13;15
624;21.02.2017;2017;02;08;Tiistai;8;41;49
624;21.02.2017;2017;02;09;Tiistai;5;36;41
624;21.02.2017;2017;02;10;Tiistai;0;12;12
624;21.02.2017;2017;02;11;Tiistai;2;9;11
624;21.02.2017;2017;02;12;Tiistai;7;11;18
624;21.02.2017;2017;02;13;Tiistai;7;16;23
624;21.02.2017;2017;02;14;Tiistai;5;15;20
624;21.02.2017;2017;02;15;Tiistai;13;18;31
624;21.02.2017;2017;02;16;Tiistai;16;21;37
624;21.02.2017;2017;02;17;Tiistai;26;19;45
624;21.02.2017;2017;02;18;Tiistai;6;10;16
624;21.02.2017;2017;02;19;Tiistai;5;7;12
624;21.02.2017;2017;02;20;Tiistai;6;5;11
624;21.02.2017;2017;02;21;Tiistai;7;6;13
624;21.02.2017;2017;02;22;Tiistai;4;1;5
624;21.02.2017;2017;02;23;Tiistai;2;4;6
624;22.02.2017;2017;02;00;Keskiviikko;2;2;4
624;22.02.2017;2017;02;01;Keskiviikko;0;0;0
624;22.02.2017;2017;02;02;Keskiviikko;0;1;1
624;22.02.2017;2017;02;03;Keskiviikko;0;0;0
624;22.02.2017;2017;02;04;Keskiviikko;0;1;1
624;22.02.2017;2017;02;05;Keskiviikko;0;0;0
624;22.02.2017;2017;02;06;Keskiviikko;3;7;10
624;22.02.2017;2017;02;07;Keskiviikko;5;9;14
624;22.02.2017;2017;02;08;Keskiviikko;11;36;47
624;22.02.2017;2017;02;09;Keskiviikko;5;41;46
624;22.02.2017;2017;02;10;Keskiviikko;8;12;20
624;22.02.2017;2017;02;11;Keskiviikko;4;6;10
624;22.02.2017;2017;02;12;Keskiviikko;3;11;14
624;22.02.2017;2017;02;13;Keskiviikko;6;10;16
624;22.02.2017;2017;02;14;Keskiviikko;4;12;16
624;22.02.2017;2017;02;15;Keskiviikko;15;16;31
624;22.02.2017;2017;02;16;Keskiviikko;17;11;28
624;22.02.2017;2017;02;17;Keskiviikko;25;26;51
624;22.02.2017;2017;02;18;Keskiviikko;13;12;25
624;22.02.2017;2017;02;19;Keskiviikko;17;9;26
624;22.02.2017;2017;02;20;Keskiviikko;6;6;12
624;22.02.2017;2017;02;21;Keskiviikko;6;6;12
624;22.02.2017;2017;02;22;Keskiviikko;4;4;8
624;22.02.2017;2017;02;23;Keskiviikko;2;2;4
624;23.02.2017;2017;02;00;Torstai;4;1;5
624;23.02.2017;2017;02;01;Torstai;1;0;1
624;23.02.2017;2017;02;02;Torstai;0;0;0
624;23.02.2017;2017;02;03;Torstai;0;2;2
624;23.02.2017;2017;02;04;Torstai;0;0;0
624;23.02.2017;2017;02;05;Torstai;0;0;0
624;23.02.2017;2017;02;06;Torstai;2;6;8
624;23.02.2017;2017;02;07;Torstai;1;11;12
624;23.02.2017;2017;02;08;Torstai;7;38;45
624;23.02.2017;2017;02;09;Torstai;4;35;39
624;23.02.2017;2017;02;10;Torstai;7;19;26
624;23.02.2017;2017;02;11;Torstai;5;7;12
624;23.02.2017;2017;02;12;Torstai;6;21;27
624;23.02.2017;2017;02;13;Torstai;2;10;12
624;23.02.2017;2017;02;14;Torstai;6;13;19
624;23.02.2017;2017;02;15;Torstai;7;15;22
624;23.02.2017;2017;02;16;Torstai;10;14;24
624;23.02.2017;2017;02;17;Torstai;6;17;23
624;23.02.2017;2017;02;18;Torstai;5;9;14
624;23.02.2017;2017;02;19;Torstai;14;7;21
624;23.02.2017;2017;02;20;Torstai;9;8;17
624;23.02.2017;2017;02;21;Torstai;6;6;12
624;23.02.2017;2017;02;22;Torstai;9;0;9
624;23.02.2017;2017;02;23;Torstai;1;3;4
624;24.02.2017;2017;02;00;Perjantai;2;1;3
624;24.02.2017;2017;02;01;Perjantai;2;1;3
624;24.02.2017;2017;02;02;Perjantai;2;0;2
624;24.02.2017;2017;02;03;Perjantai;1;0;1
624;24.02.2017;2017;02;04;Perjantai;0;2;2
624;24.02.2017;2017;02;05;Perjantai;1;1;2
624;24.02.2017;2017;02;06;Perjantai;7;8;15
624;24.02.2017;2017;02;07;Perjantai;5;17;22
624;24.02.2017;2017;02;08;Perjantai;10;29;39
624;24.02.2017;2017;02;09;Perjantai;6;35;41
624;24.02.2017;2017;02;10;Perjantai;11;17;28
624;24.02.2017;2017;02;11;Perjantai;4;17;21
624;24.02.2017;2017;02;12;Perjantai;7;10;17
624;24.02.2017;2017;02;13;Perjantai;10;11;21
624;24.02.2017;2017;02;14;Perjantai;19;11;30
624;24.02.2017;2017;02;15;Perjantai;15;11;26
624;24.02.2017;2017;02;16;Perjantai;33;11;44
624;24.02.2017;2017;02;17;Perjantai;22;13;35
624;24.02.2017;2017;02;18;Perjantai;7;12;19
624;24.02.2017;2017;02;19;Perjantai;12;8;20
624;24.02.2017;2017;02;20;Perjantai;11;6;17
624;24.02.2017;2017;02;21;Perjantai;14;6;20
624;24.02.2017;2017;02;22;Perjantai;9;5;14
624;24.02.2017;2017;02;23;Perjantai;4;4;8
624;25.02.2017;2017;02;00;Lauantai;4;3;7
624;25.02.2017;2017;02;01;Lauantai;2;0;2
624;25.02.2017;2017;02;02;Lauantai;1;1;2
624;25.02.2017;2017;02;03;Lauantai;1;0;1
624;25.02.2017;2017;02;04;Lauantai;3;0;3
624;25.02.2017;2017;02;05;Lauantai;2;1;3
624;25.02.2017;2017;02;06;Lauantai;1;0;1
624;25.02.2017;2017;02;07;Lauantai;0;5;5
624;25.02.2017;2017;02;08;Lauantai;2;1;3
624;25.02.2017;2017;02;09;Lauantai;2;4;6
624;25.02.2017;2017;02;10;Lauantai;2;8;10
624;25.02.2017;2017;02;11;Lauantai;3;5;8
624;25.02.2017;2017;02;12;Lauantai;4;4;8
624;25.02.2017;2017;02;13;Lauantai;9;6;15
624;25.02.2017;2017;02;14;Lauantai;4;14;18
624;25.02.2017;2017;02;15;Lauantai;9;8;17
624;25.02.2017;2017;02;16;Lauantai;8;8;16
624;25.02.2017;2017;02;17;Lauantai;10;8;18
624;25.02.2017;2017;02;18;Lauantai;9;4;13
624;25.02.2017;2017;02;19;Lauantai;2;2;4
624;25.02.2017;2017;02;20;Lauantai;5;4;9
624;25.02.2017;2017;02;21;Lauantai;2;3;5
624;25.02.2017;2017;02;22;Lauantai;4;3;7
624;25.02.2017;2017;02;23;Lauantai;3;3;6
624;26.02.2017;2017;02;00;Sunnuntai;2;1;3
624;26.02.2017;2017;02;01;Sunnuntai;3;2;5
624;26.02.2017;2017;02;02;Sunnuntai;1;0;1
624;26.02.2017;2017;02;03;Sunnuntai;1;1;2
624;26.02.2017;2017;02;04;Sunnuntai;5;1;6
624;26.02.2017;2017;02;05;Sunnuntai;0;0;0
624;26.02.2017;2017;02;06;Sunnuntai;1;1;2
624;26.02.2017;2017;02;07;Sunnuntai;0;2;2
624;26.02.2017;2017;02;08;Sunnuntai;0;2;2
624;26.02.2017;2017;02;09;Sunnuntai;2;4;6
624;26.02.2017;2017;02;10;Sunnuntai;0;1;1
624;26.02.2017;2017;02;11;Sunnuntai;1;5;6
624;26.02.2017;2017;02;12;Sunnuntai;3;5;8
624;26.02.2017;2017;02;13;Sunnuntai;11;8;19
624;26.02.2017;2017;02;14;Sunnuntai;9;4;13
624;26.02.2017;2017;02;15;Sunnuntai;11;6;17
624;26.02.2017;2017;02;16;Sunnuntai;7;11;18
624;26.02.2017;2017;02;17;Sunnuntai;9;4;13
624;26.02.2017;2017;02;18;Sunnuntai;8;4;12
624;26.02.2017;2017;02;19;Sunnuntai;11;1;12
624;26.02.2017;2017;02;20;Sunnuntai;6;3;9
624;26.02.2017;2017;02;21;Sunnuntai;9;4;13
624;26.02.2017;2017;02;22;Sunnuntai;3;0;3
624;26.02.2017;2017;02;23;Sunnuntai;4;1;5
624;27.02.2017;2017;02;00;Maanantai;1;0;1
624;27.02.2017;2017;02;01;Maanantai;1;0;1
624;27.02.2017;2017;02;02;Maanantai;0;0;0
624;27.02.2017;2017;02;03;Maanantai;1;0;1
624;27.02.2017;2017;02;04;Maanantai;0;0;0
624;27.02.2017;2017;02;05;Maanantai;1;1;2
624;27.02.2017;2017;02;06;Maanantai;2;8;10
624;27.02.2017;2017;02;07;Maanantai;10;9;19
624;27.02.2017;2017;02;08;Maanantai;13;37;50
624;27.02.2017;2017;02;09;Maanantai;11;26;37
624;27.02.2017;2017;02;10;Maanantai;6;17;23
624;27.02.2017;2017;02;11;Maanantai;8;8;16
624;27.02.2017;2017;02;12;Maanantai;5;10;15
624;27.02.2017;2017;02;13;Maanantai;8;12;20
624;27.02.2017;2017;02;14;Maanantai;19;10;29
624;27.02.2017;2017;02;15;Maanantai;8;9;17
624;27.02.2017;2017;02;16;Maanantai;29;12;41
624;27.02.2017;2017;02;17;Maanantai;41;20;61
624;27.02.2017;2017;02;18;Maanantai;32;19;51
624;27.02.2017;2017;02;19;Maanantai;24;11;35
624;27.02.2017;2017;02;20;Maanantai;17;8;25
624;27.02.2017;2017;02;21;Maanantai;7;5;12
624;27.02.2017;2017;02;22;Maanantai;7;6;13
624;27.02.2017;2017;02;23;Maanantai;3;4;7
624;28.02.2017;2017;02;00;Tiistai;2;1;3
624;28.02.2017;2017;02;01;Tiistai;0;1;1
624;28.02.2017;2017;02;02;Tiistai;0;0;0
624;28.02.2017;2017;02;03;Tiistai;0;0;0
624;28.02.2017;2017;02;04;Tiistai;1;0;1
624;28.02.2017;2017;02;05;Tiistai;1;0;1
624;28.02.2017;2017;02;06;Tiistai;2;6;8
624;28.02.2017;2017;02;07;Tiistai;8;12;20
624;28.02.2017;2017;02;08;Tiistai;13;36;49
624;28.02.2017;2017;02;09;Tiistai;11;31;42
624;28.02.2017;2017;02;10;Tiistai;6;10;16
624;28.02.2017;2017;02;11;Tiistai;13;12;25
624;28.02.2017;2017;02;12;Tiistai;8;14;22
624;28.02.2017;2017;02;13;Tiistai;17;19;36
624;28.02.2017;2017;02;14;Tiistai;15;17;32
624;28.02.2017;2017;02;15;Tiistai;16;13;29
624;28.02.2017;2017;02;16;Tiistai;34;22;56
624;28.02.2017;2017;02;17;Tiistai;45;31;76
624;28.02.2017;2017;02;18;Tiistai;30;23;53
624;28.02.2017;2017;02;19;Tiistai;15;14;29
624;28.02.2017;2017;02;20;Tiistai;14;8;22
624;28.02.2017;2017;02;21;Tiistai;13;4;17
624;28.02.2017;2017;02;22;Tiistai;18;8;26
624;28.02.2017;2017;02;23;Tiistai;6;4;10
624;01.03.2017;2017;03;00;Keskiviikko;0;3;3
624;01.03.2017;2017;03;01;Keskiviikko;0;0;0
624;01.03.2017;2017;03;02;Keskiviikko;1;0;1
624;01.03.2017;2017;03;03;Keskiviikko;1;1;2
624;01.03.2017;2017;03;04;Keskiviikko;0;1;1
624;01.03.2017;2017;03;05;Keskiviikko;0;0;0
624;01.03.2017;2017;03;06;Keskiviikko;4;6;10
624;01.03.2017;2017;03;07;Keskiviikko;9;16;25
624;01.03.2017;2017;03;08;Keskiviikko;16;36;52
624;01.03.2017;2017;03;09;Keskiviikko;5;37;42
624;01.03.2017;2017;03;10;Keskiviikko;10;10;20
624;01.03.2017;2017;03;11;Keskiviikko;6;12;18
624;01.03.2017;2017;03;12;Keskiviikko;11;9;20
624;01.03.2017;2017;03;13;Keskiviikko;10;9;19
624;01.03.2017;2017;03;14;Keskiviikko;15;13;28
624;01.03.2017;2017;03;15;Keskiviikko;15;6;21
624;01.03.2017;2017;03;16;Keskiviikko;30;13;43
624;01.03.2017;2017;03;17;Keskiviikko;38;16;54
624;01.03.2017;2017;03;18;Keskiviikko;34;21;55
624;01.03.2017;2017;03;19;Keskiviikko;22;7;29
624;01.03.2017;2017;03;20;Keskiviikko;12;5;17
624;01.03.2017;2017;03;21;Keskiviikko;5;3;8
624;01.03.2017;2017;03;22;Keskiviikko;3;3;6
624;01.03.2017;2017;03;23;Keskiviikko;2;2;4
624;02.03.2017;2017;03;00;Torstai;4;2;6
624;02.03.2017;2017;03;01;Torstai;1;0;1
624;02.03.2017;2017;03;02;Torstai;0;0;0
624;02.03.2017;2017;03;03;Torstai;0;0;0
624;02.03.2017;2017;03;04;Torstai;0;0;0
624;02.03.2017;2017;03;05;Torstai;0;0;0
624;02.03.2017;2017;03;06;Torstai;3;7;10
624;02.03.2017;2017;03;07;Torstai;9;19;28
624;02.03.2017;2017;03;08;Torstai;11;39;50
624;02.03.2017;2017;03;09;Torstai;8;27;35
624;02.03.2017;2017;03;10;Torstai;9;30;39
624;02.03.2017;2017;03;11;Torstai;4;14;18
624;02.03.2017;2017;03;12;Torstai;5;11;16
624;02.03.2017;2017;03;13;Torstai;12;16;28
624;02.03.2017;2017;03;14;Torstai;7;11;18
624;02.03.2017;2017;03;15;Torstai;12;10;22
624;02.03.2017;2017;03;16;Torstai;26;19;45
624;02.03.2017;2017;03;17;Torstai;51;16;67
624;02.03.2017;2017;03;18;Torstai;22;19;41
624;02.03.2017;2017;03;19;Torstai;22;3;25
624;02.03.2017;2017;03;20;Torstai;7;10;17
624;02.03.2017;2017;03;21;Torstai;11;1;12
624;02.03.2017;2017;03;22;Torstai;11;3;14
624;02.03.2017;2017;03;23;Torstai;3;1;4
624;03.03.2017;2017;03;00;Perjantai;3;2;5
624;03.03.2017;2017;03;01;Perjantai;0;0;0
624;03.03.2017;2017;03;02;Perjantai;0;1;1
624;03.03.2017;2017;03;03;Perjantai;0;1;1
624;03.03.2017;2017;03;04;Perjantai;2;1;3
624;03.03.2017;2017;03;05;Perjantai;2;2;4
624;03.03.2017;2017;03;06;Perjantai;1;3;4
624;03.03.2017;2017;03;07;Perjantai;4;18;22
624;03.03.2017;2017;03;08;Perjantai;7;26;33
624;03.03.2017;2017;03;09;Perjantai;12;29;41
624;03.03.2017;2017;03;10;Perjantai;5;7;12
624;03.03.2017;2017;03;11;Perjantai;5;17;22
624;03.03.2017;2017;03;12;Perjantai;10;6;16
624;03.03.2017;2017;03;13;Perjantai;10;10;20
624;03.03.2017;2017;03;14;Perjantai;18;11;29
624;03.03.2017;2017;03;15;Perjantai;20;9;29
624;03.03.2017;2017;03;16;Perjantai;29;16;45
624;03.03.2017;2017;03;17;Perjantai;19;14;33
624;03.03.2017;2017;03;18;Perjantai;17;11;28
624;03.03.2017;2017;03;19;Perjantai;3;4;7
624;03.03.2017;2017;03;20;Perjantai;11;6;17
624;03.03.2017;2017;03;21;Perjantai;6;3;9
624;03.03.2017;2017;03;22;Perjantai;10;1;11
624;03.03.2017;2017;03;23;Perjantai;3;1;4
624;04.03.2017;2017;03;00;Lauantai;2;2;4
624;04.03.2017;2017;03;01;Lauantai;4;1;5
624;04.03.2017;2017;03;02;Lauantai;3;1;4
624;04.03.2017;2017;03;03;Lauantai;0;0;0
624;04.03.2017;2017;03;04;Lauantai;0;1;1
624;04.03.2017;2017;03;05;Lauantai;3;0;3
624;04.03.2017;2017;03;06;Lauantai;2;4;6
624;04.03.2017;2017;03;07;Lauantai;0;3;3
624;04.03.2017;2017;03;08;Lauantai;0;2;2
624;04.03.2017;2017;03;09;Lauantai;3;3;6
624;04.03.2017;2017;03;10;Lauantai;2;9;11
624;04.03.2017;2017;03;11;Lauantai;3;9;12
624;04.03.2017;2017;03;12;Lauantai;8;8;16
624;04.03.2017;2017;03;13;Lauantai;7;6;13
624;04.03.2017;2017;03;14;Lauantai;7;10;17
624;04.03.2017;2017;03;15;Lauantai;5;5;10
624;04.03.2017;2017;03;16;Lauantai;5;11;16
624;04.03.2017;2017;03;17;Lauantai;11;13;24
624;04.03.2017;2017;03;18;Lauantai;7;4;11
624;04.03.2017;2017;03;19;Lauantai;8;2;10
624;04.03.2017;2017;03;20;Lauantai;9;1;10
624;04.03.2017;2017;03;21;Lauantai;6;0;6
624;04.03.2017;2017;03;22;Lauantai;4;5;9
624;04.03.2017;2017;03;23;Lauantai;2;4;6
624;05.03.2017;2017;03;00;Sunnuntai;0;4;4
624;05.03.2017;2017;03;01;Sunnuntai;2;0;2
624;05.03.2017;2017;03;02;Sunnuntai;1;2;3
624;05.03.2017;2017;03;03;Sunnuntai;3;1;4
624;05.03.2017;2017;03;04;Sunnuntai;6;1;7
624;05.03.2017;2017;03;05;Sunnuntai;3;0;3
624;05.03.2017;2017;03;06;Sunnuntai;0;0;0
624;05.03.2017;2017;03;07;Sunnuntai;0;3;3
624;05.03.2017;2017;03;08;Sunnuntai;1;1;2
624;05.03.2017;2017;03;09;Sunnuntai;0;1;1
624;05.03.2017;2017;03;10;Sunnuntai;3;1;4
624;05.03.2017;2017;03;11;Sunnuntai;3;4;7
624;05.03.2017;2017;03;12;Sunnuntai;0;1;1
624;05.03.2017;2017;03;13;Sunnuntai;2;6;8
624;05.03.2017;2017;03;14;Sunnuntai;9;9;18
624;05.03.2017;2017;03;15;Sunnuntai;6;2;8
624;05.03.2017;2017;03;16;Sunnuntai;4;3;7
624;05.03.2017;2017;03;17;Sunnuntai;9;5;14
624;05.03.2017;2017;03;18;Sunnuntai;1;5;6
624;05.03.2017;2017;03;19;Sunnuntai;7;5;12
624;05.03.2017;2017;03;20;Sunnuntai;5;6;11
624;05.03.2017;2017;03;21;Sunnuntai;0;2;2
624;05.03.2017;2017;03;22;Sunnuntai;4;1;5
624;05.03.2017;2017;03;23;Sunnuntai;1;2;3
624;06.03.2017;2017;03;00;Maanantai;2;2;4
624;06.03.2017;2017;03;01;Maanantai;0;0;0
624;06.03.2017;2017;03;02;Maanantai;0;0;0
624;06.03.2017;2017;03;03;Maanantai;0;0;0
624;06.03.2017;2017;03;04;Maanantai;0;0;0
624;06.03.2017;2017;03;05;Maanantai;0;0;0
624;06.03.2017;2017;03;06;Maanantai;2;6;8
624;06.03.2017;2017;03;07;Maanantai;2;11;13
624;06.03.2017;2017;03;08;Maanantai;10;30;40
624;06.03.2017;2017;03;09;Maanantai;5;15;20
624;06.03.2017;2017;03;10;Maanantai;5;17;22
624;06.03.2017;2017;03;11;Maanantai;2;5;7
624;06.03.2017;2017;03;12;Maanantai;4;11;15
624;06.03.2017;2017;03;13;Maanantai;10;7;17
624;06.03.2017;2017;03;14;Maanantai;11;14;25
624;06.03.2017;2017;03;15;Maanantai;11;4;15
624;06.03.2017;2017;03;16;Maanantai;17;9;26
624;06.03.2017;2017;03;17;Maanantai;29;14;43
624;06.03.2017;2017;03;18;Maanantai;13;6;19
624;06.03.2017;2017;03;19;Maanantai;13;5;18
624;06.03.2017;2017;03;20;Maanantai;11;3;14
624;06.03.2017;2017;03;21;Maanantai;4;4;8
624;06.03.2017;2017;03;22;Maanantai;4;1;5
624;06.03.2017;2017;03;23;Maanantai;5;1;6
624;07.03.2017;2017;03;00;Tiistai;4;3;7
624;07.03.2017;2017;03;01;Tiistai;1;1;2
624;07.03.2017;2017;03;02;Tiistai;0;0;0
624;07.03.2017;2017;03;03;Tiistai;1;0;1
624;07.03.2017;2017;03;04;Tiistai;0;0;0
624;07.03.2017;2017;03;05;Tiistai;1;1;2
624;07.03.2017;2017;03;06;Tiistai;0;5;5
624;07.03.2017;2017;03;07;Tiistai;4;8;12
624;07.03.2017;2017;03;08;Tiistai;9;22;31
624;07.03.2017;2017;03;09;Tiistai;5;17;22
624;07.03.2017;2017;03;10;Tiistai;7;7;14
624;07.03.2017;2017;03;11;Tiistai;4;6;10
624;07.03.2017;2017;03;12;Tiistai;6;10;16
624;07.03.2017;2017;03;13;Tiistai;8;9;17
624;07.03.2017;2017;03;14;Tiistai;11;10;21
624;07.03.2017;2017;03;15;Tiistai;13;8;21
624;07.03.2017;2017;03;16;Tiistai;17;15;32
624;07.03.2017;2017;03;17;Tiistai;38;14;52
624;07.03.2017;2017;03;18;Tiistai;17;9;26
624;07.03.2017;2017;03;19;Tiistai;19;6;25
624;07.03.2017;2017;03;20;Tiistai;16;3;19
624;07.03.2017;2017;03;21;Tiistai;9;6;15
624;07.03.2017;2017;03;22;Tiistai;2;5;7
624;07.03.2017;2017;03;23;Tiistai;2;0;2
624;08.03.2017;2017;03;00;Keskiviikko;2;3;5
624;08.03.2017;2017;03;01;Keskiviikko;0;0;0
624;08.03.2017;2017;03;02;Keskiviikko;0;0;0
624;08.03.2017;2017;03;03;Keskiviikko;0;0;0
624;08.03.2017;2017;03;04;Keskiviikko;0;1;1
624;08.03.2017;2017;03;05;Keskiviikko;0;1;1
624;08.03.2017;2017;03;06;Keskiviikko;2;4;6
624;08.03.2017;2017;03;07;Keskiviikko;7;7;14
624;08.03.2017;2017;03;08;Keskiviikko;7;25;32
624;08.03.2017;2017;03;09;Keskiviikko;6;20;26
624;08.03.2017;2017;03;10;Keskiviikko;8;6;14
624;08.03.2017;2017;03;11;Keskiviikko;12;12;24
624;08.03.2017;2017;03;12;Keskiviikko;1;8;9
624;08.03.2017;2017;03;13;Keskiviikko;8;7;15
624;08.03.2017;2017;03;14;Keskiviikko;12;5;17
624;08.03.2017;2017;03;15;Keskiviikko;12;8;20
624;08.03.2017;2017;03;16;Keskiviikko;19;9;28
624;08.03.2017;2017;03;17;Keskiviikko;25;15;40
624;08.03.2017;2017;03;18;Keskiviikko;12;3;15
624;08.03.2017;2017;03;19;Keskiviikko;10;4;14
624;08.03.2017;2017;03;20;Keskiviikko;8;4;12
624;08.03.2017;2017;03;21;Keskiviikko;7;4;11
624;08.03.2017;2017;03;22;Keskiviikko;5;6;11
624;08.03.2017;2017;03;23;Keskiviikko;2;2;4
624;09.03.2017;2017;03;00;Torstai;1;1;2
624;09.03.2017;2017;03;01;Torstai;2;0;2
624;09.03.2017;2017;03;02;Torstai;1;1;2
624;09.03.2017;2017;03;03;Torstai;1;0;1
624;09.03.2017;2017;03;04;Torstai;0;0;0
624;09.03.2017;2017;03;05;Torstai;1;1;2
624;09.03.2017;2017;03;06;Torstai;1;4;5
624;09.03.2017;2017;03;07;Torstai;5;6;11
624;09.03.2017;2017;03;08;Torstai;6;19;25
624;09.03.2017;2017;03;09;Torstai;8;21;29
624;09.03.2017;2017;03;10;Torstai;4;12;16
624;09.03.2017;2017;03;11;Torstai;11;9;20
624;09.03.2017;2017;03;12;Torstai;2;13;15
624;09.03.2017;2017;03;13;Torstai;8;15;23
624;09.03.2017;2017;03;14;Torstai;7;7;14
624;09.03.2017;2017;03;15;Torstai;7;5;12
624;09.03.2017;2017;03;16;Torstai;24;9;33
624;09.03.2017;2017;03;17;Torstai;19;10;29
624;09.03.2017;2017;03;18;Torstai;10;9;19
624;09.03.2017;2017;03;19;Torstai;14;12;26
624;09.03.2017;2017;03;20;Torstai;5;3;8
624;09.03.2017;2017;03;21;Torstai;10;1;11
624;09.03.2017;2017;03;22;Torstai;11;2;13
624;09.03.2017;2017;03;23;Torstai;1;2;3
624;10.03.2017;2017;03;00;Perjantai;1;4;5
624;10.03.2017;2017;03;01;Perjantai;1;1;2
624;10.03.2017;2017;03;02;Perjantai;0;1;1
624;10.03.2017;2017;03;03;Perjantai;0;0;0
624;10.03.2017;2017;03;04;Perjantai;0;1;1
624;10.03.2017;2017;03;05;Perjantai;2;1;3
624;10.03.2017;2017;03;06;Perjantai;4;6;10
624;10.03.2017;2017;03;07;Perjantai;4;6;10
624;10.03.2017;2017;03;08;Perjantai;6;15;21
624;10.03.2017;2017;03;09;Perjantai;5;20;25
624;10.03.2017;2017;03;10;Perjantai;6;7;13
624;10.03.2017;2017;03;11;Perjantai;3;2;5
624;10.03.2017;2017;03;12;Perjantai;3;10;13
624;10.03.2017;2017;03;13;Perjantai;7;10;17
624;10.03.2017;2017;03;14;Perjantai;16;14;30
624;10.03.2017;2017;03;15;Perjantai;19;17;36
624;10.03.2017;2017;03;16;Perjantai;18;18;36
624;10.03.2017;2017;03;17;Perjantai;16;12;28
624;10.03.2017;2017;03;18;Perjantai;13;11;24
624;10.03.2017;2017;03;19;Perjantai;12;5;17
624;10.03.2017;2017;03;20;Perjantai;8;3;11
624;10.03.2017;2017;03;21;Perjantai;8;10;18
624;10.03.2017;2017;03;22;Perjantai;10;1;11
624;10.03.2017;2017;03;23;Perjantai;4;3;7
624;11.03.2017;2017;03;00;Lauantai;1;1;2
624;11.03.2017;2017;03;01;Lauantai;1;0;1
624;11.03.2017;2017;03;02;Lauantai;0;0;0
624;11.03.2017;2017;03;03;Lauantai;2;0;2
624;11.03.2017;2017;03;04;Lauantai;1;0;1
624;11.03.2017;2017;03;05;Lauantai;3;0;3
624;11.03.2017;2017;03;06;Lauantai;3;1;4
624;11.03.2017;2017;03;07;Lauantai;2;1;3
624;11.03.2017;2017;03;08;Lauantai;0;2;2
624;11.03.2017;2017;03;09;Lauantai;0;2;2
624;11.03.2017;2017;03;10;Lauantai;2;7;9
624;11.03.2017;2017;03;11;Lauantai;2;10;12
624;11.03.2017;2017;03;12;Lauantai;7;12;19
624;11.03.2017;2017;03;13;Lauantai;8;6;14
624;11.03.2017;2017;03;14;Lauantai;18;7;25
624;11.03.2017;2017;03;15;Lauantai;7;11;18
624;11.03.2017;2017;03;16;Lauantai;11;5;16
624;11.03.2017;2017;03;17;Lauantai;15;11;26
624;11.03.2017;2017;03;18;Lauantai;8;9;17
624;11.03.2017;2017;03;19;Lauantai;3;7;10
624;11.03.2017;2017;03;20;Lauantai;5;4;9
624;11.03.2017;2017;03;21;Lauantai;3;3;6
624;11.03.2017;2017;03;22;Lauantai;6;4;10
624;11.03.2017;2017;03;23;Lauantai;4;1;5
624;12.03.2017;2017;03;00;Sunnuntai;1;5;6
624;12.03.2017;2017;03;01;Sunnuntai;5;1;6
624;12.03.2017;2017;03;02;Sunnuntai;3;2;5
624;12.03.2017;2017;03;03;Sunnuntai;3;0;3
624;12.03.2017;2017;03;04;Sunnuntai;4;0;4
624;12.03.2017;2017;03;05;Sunnuntai;2;0;2
624;12.03.2017;2017;03;06;Sunnuntai;1;1;2
624;12.03.2017;2017;03;07;Sunnuntai;4;1;5
624;12.03.2017;2017;03;08;Sunnuntai;2;0;2
624;12.03.2017;2017;03;09;Sunnuntai;0;2;2
624;12.03.2017;2017;03;10;Sunnuntai;3;4;7
624;12.03.2017;2017;03;11;Sunnuntai;3;7;10
624;12.03.2017;2017;03;12;Sunnuntai;6;6;12
624;12.03.2017;2017;03;13;Sunnuntai;3;7;10
624;12.03.2017;2017;03;14;Sunnuntai;6;10;16
624;12.03.2017;2017;03;15;Sunnuntai;5;5;10
624;12.03.2017;2017;03;16;Sunnuntai;9;4;13
624;12.03.2017;2017;03;17;Sunnuntai;4;6;10
624;12.03.2017;2017;03;18;Sunnuntai;7;6;13
624;12.03.2017;2017;03;19;Sunnuntai;7;6;13
624;12.03.2017;2017;03;20;Sunnuntai;6;3;9
624;12.03.2017;2017;03;21;Sunnuntai;2;1;3
624;12.03.2017;2017;03;22;Sunnuntai;7;3;10
624;12.03.2017;2017;03;23;Sunnuntai;6;4;10
624;13.03.2017;2017;03;00;Maanantai;1;1;2
624;13.03.2017;2017;03;01;Maanantai;2;2;4
624;13.03.2017;2017;03;02;Maanantai;0;0;0
624;13.03.2017;2017;03;03;Maanantai;0;0;0
624;13.03.2017;2017;03;04;Maanantai;1;1;2
624;13.03.2017;2017;03;05;Maanantai;0;0;0
624;13.03.2017;2017;03;06;Maanantai;4;6;10
624;13.03.2017;2017;03;07;Maanantai;7;15;22
624;13.03.2017;2017;03;08;Maanantai;13;34;47
624;13.03.2017;2017;03;09;Maanantai;13;27;40
624;13.03.2017;2017;03;10;Maanantai;8;12;20
624;13.03.2017;2017;03;11;Maanantai;10;13;23
624;13.03.2017;2017;03;12;Maanantai;10;13;23
624;13.03.2017;2017;03;13;Maanantai;15;21;36
624;13.03.2017;2017;03;14;Maanantai;12;15;27
624;13.03.2017;2017;03;15;Maanantai;16;7;23
624;13.03.2017;2017;03;16;Maanantai;9;13;22
624;13.03.2017;2017;03;17;Maanantai;7;20;27
624;13.03.2017;2017;03;18;Maanantai;1;9;10
624;13.03.2017;2017;03;19;Maanantai;2;9;11
624;13.03.2017;2017;03;20;Maanantai;0;4;4
624;13.03.2017;2017;03;21;Maanantai;3;6;9
624;13.03.2017;2017;03;22;Maanantai;3;5;8
624;13.03.2017;2017;03;23;Maanantai;2;0;2
624;14.03.2017;2017;03;00;Tiistai;0;0;0
624;14.03.2017;2017;03;01;Tiistai;1;1;2
624;14.03.2017;2017;03;02;Tiistai;0;0;0
624;14.03.2017;2017;03;03;Tiistai;0;1;1
624;14.03.2017;2017;03;04;Tiistai;0;0;0
624;14.03.2017;2017;03;05;Tiistai;1;0;1
624;14.03.2017;2017;03;06;Tiistai;1;5;6
624;14.03.2017;2017;03;07;Tiistai;1;12;13
624;14.03.2017;2017;03;08;Tiistai;6;43;49
624;14.03.2017;2017;03;09;Tiistai;7;45;52
624;14.03.2017;2017;03;10;Tiistai;1;18;19
624;14.03.2017;2017;03;11;Tiistai;4;17;21
624;14.03.2017;2017;03;12;Tiistai;2;13;15
624;14.03.2017;2017;03;13;Tiistai;7;11;18
624;14.03.2017;2017;03;14;Tiistai;8;13;21
624;14.03.2017;2017;03;15;Tiistai;17;10;27
624;14.03.2017;2017;03;16;Tiistai;27;15;42
624;14.03.2017;2017;03;17;Tiistai;23;19;42
624;14.03.2017;2017;03;18;Tiistai;10;17;27
624;14.03.2017;2017;03;19;Tiistai;4;8;12
624;14.03.2017;2017;03;20;Tiistai;1;11;12
624;14.03.2017;2017;03;21;Tiistai;4;7;11
624;14.03.2017;2017;03;22;Tiistai;3;2;5
624;14.03.2017;2017;03;23;Tiistai;4;7;11
624;15.03.2017;2017;03;00;Keskiviikko;0;1;1
624;15.03.2017;2017;03;01;Keskiviikko;0;0;0
624;15.03.2017;2017;03;02;Keskiviikko;0;0;0
624;15.03.2017;2017;03;03;Keskiviikko;0;0;0
624;15.03.2017;2017;03;04;Keskiviikko;1;1;2
624;15.03.2017;2017;03;05;Keskiviikko;1;1;2
624;15.03.2017;2017;03;06;Keskiviikko;3;7;10
624;15.03.2017;2017;03;07;Keskiviikko;5;8;13
624;15.03.2017;2017;03;08;Keskiviikko;10;41;51
624;15.03.2017;2017;03;09;Keskiviikko;15;42;57
624;15.03.2017;2017;03;10;Keskiviikko;9;12;21
624;15.03.2017;2017;03;11;Keskiviikko;7;11;18
624;15.03.2017;2017;03;12;Keskiviikko;9;11;20
624;15.03.2017;2017;03;13;Keskiviikko;10;12;22
624;15.03.2017;2017;03;14;Keskiviikko;7;5;12
624;15.03.2017;2017;03;15;Keskiviikko;16;15;31
624;15.03.2017;2017;03;16;Keskiviikko;14;14;28
624;15.03.2017;2017;03;17;Keskiviikko;37;21;58
624;15.03.2017;2017;03;18;Keskiviikko;17;15;32
624;15.03.2017;2017;03;19;Keskiviikko;18;17;35
624;15.03.2017;2017;03;20;Keskiviikko;10;7;17
624;15.03.2017;2017;03;21;Keskiviikko;11;2;13
624;15.03.2017;2017;03;22;Keskiviikko;12;5;17
624;15.03.2017;2017;03;23;Keskiviikko;8;3;11
624;16.03.2017;2017;03;00;Torstai;0;0;0
624;16.03.2017;2017;03;01;Torstai;0;1;1
624;16.03.2017;2017;03;02;Torstai;2;0;2
624;16.03.2017;2017;03;03;Torstai;0;0;0
624;16.03.2017;2017;03;04;Torstai;0;0;0
624;16.03.2017;2017;03;05;Torstai;0;2;2
624;16.03.2017;2017;03;06;Torstai;5;1;6
624;16.03.2017;2017;03;07;Torstai;6;16;22
624;16.03.2017;2017;03;08;Torstai;10;41;51
624;16.03.2017;2017;03;09;Torstai;11;32;43
624;16.03.2017;2017;03;10;Torstai;10;34;44
624;16.03.2017;2017;03;11;Torstai;8;7;15
624;16.03.2017;2017;03;12;Torstai;3;11;14
624;16.03.2017;2017;03;13;Torstai;8;8;16
624;16.03.2017;2017;03;14;Torstai;11;13;24
624;16.03.2017;2017;03;15;Torstai;16;19;35
624;16.03.2017;2017;03;16;Torstai;24;15;39
624;16.03.2017;2017;03;17;Torstai;21;18;39
624;16.03.2017;2017;03;18;Torstai;21;15;36
624;16.03.2017;2017;03;19;Torstai;21;18;39
624;16.03.2017;2017;03;20;Torstai;16;11;27
624;16.03.2017;2017;03;21;Torstai;7;7;14
624;16.03.2017;2017;03;22;Torstai;10;7;17
624;16.03.2017;2017;03;23;Torstai;3;2;5
624;17.03.2017;2017;03;00;Perjantai;1;1;2
624;17.03.2017;2017;03;01;Perjantai;2;6;8
624;17.03.2017;2017;03;02;Perjantai;1;1;2
624;17.03.2017;2017;03;03;Perjantai;3;1;4
624;17.03.2017;2017;03;04;Perjantai;0;0;0
624;17.03.2017;2017;03;05;Perjantai;2;1;3
624;17.03.2017;2017;03;06;Perjantai;2;5;7
624;17.03.2017;2017;03;07;Perjantai;2;10;12
624;17.03.2017;2017;03;08;Perjantai;4;27;31
624;17.03.2017;2017;03;09;Perjantai;7;20;27
624;17.03.2017;2017;03;10;Perjantai;8;13;21
624;17.03.2017;2017;03;11;Perjantai;2;7;9
624;17.03.2017;2017;03;12;Perjantai;9;9;18
624;17.03.2017;2017;03;13;Perjantai;5;13;18
624;17.03.2017;2017;03;14;Perjantai;19;10;29
624;17.03.2017;2017;03;15;Perjantai;18;19;37
624;17.03.2017;2017;03;16;Perjantai;25;11;36
624;17.03.2017;2017;03;17;Perjantai;15;12;27
624;17.03.2017;2017;03;18;Perjantai;7;9;16
624;17.03.2017;2017;03;19;Perjantai;6;7;13
624;17.03.2017;2017;03;20;Perjantai;6;9;15
624;17.03.2017;2017;03;21;Perjantai;6;4;10
624;17.03.2017;2017;03;22;Perjantai;4;5;9
624;17.03.2017;2017;03;23;Perjantai;4;2;6
624;18.03.2017;2017;03;00;Lauantai;2;3;5
624;18.03.2017;2017;03;01;Lauantai;4;0;4
624;18.03.2017;2017;03;02;Lauantai;3;0;3
624;18.03.2017;2017;03;03;Lauantai;0;0;0
624;18.03.2017;2017;03;04;Lauantai;0;0;0
624;18.03.2017;2017;03;05;Lauantai;5;0;5
624;18.03.2017;2017;03;06;Lauantai;0;0;0
624;18.03.2017;2017;03;07;Lauantai;1;3;4
624;18.03.2017;2017;03;08;Lauantai;0;4;4
624;18.03.2017;2017;03;09;Lauantai;0;4;4
624;18.03.2017;2017;03;10;Lauantai;3;6;9
624;18.03.2017;2017;03;11;Lauantai;2;8;10
624;18.03.2017;2017;03;12;Lauantai;4;5;9
624;18.03.2017;2017;03;13;Lauantai;5;9;14
624;18.03.2017;2017;03;14;Lauantai;3;7;10
624;18.03.2017;2017;03;15;Lauantai;3;11;14
624;18.03.2017;2017;03;16;Lauantai;1;5;6
624;18.03.2017;2017;03;17;Lauantai;2;9;11
624;18.03.2017;2017;03;18;Lauantai;4;3;7
624;18.03.2017;2017;03;19;Lauantai;2;7;9
624;18.03.2017;2017;03;20;Lauantai;3;6;9
624;18.03.2017;2017;03;21;Lauantai;3;2;5
624;18.03.2017;2017;03;22;Lauantai;2;2;4
624;18.03.2017;2017;03;23;Lauantai;2;2;4
624;19.03.2017;2017;03;00;Sunnuntai;2;1;3
624;19.03.2017;2017;03;01;Sunnuntai;0;2;2
624;19.03.2017;2017;03;02;Sunnuntai;1;1;2
624;19.03.2017;2017;03;03;Sunnuntai;0;2;2
624;19.03.2017;2017;03;04;Sunnuntai;3;0;3
624;19.03.2017;2017;03;05;Sunnuntai;1;1;2
624;19.03.2017;2017;03;06;Sunnuntai;1;1;2
624;19.03.2017;2017;03;07;Sunnuntai;0;1;1
624;19.03.2017;2017;03;08;Sunnuntai;0;1;1
624;19.03.2017;2017;03;09;Sunnuntai;0;0;0
624;19.03.2017;2017;03;10;Sunnuntai;0;4;4
624;19.03.2017;2017;03;11;Sunnuntai;2;3;5
624;19.03.2017;2017;03;12;Sunnuntai;3;8;11
624;19.03.2017;2017;03;13;Sunnuntai;3;10;13
624;19.03.2017;2017;03;14;Sunnuntai;7;8;15
624;19.03.2017;2017;03;15;Sunnuntai;2;11;13
624;19.03.2017;2017;03;16;Sunnuntai;3;7;10
624;19.03.2017;2017;03;17;Sunnuntai;6;9;15
624;19.03.2017;2017;03;18;Sunnuntai;2;5;7
624;19.03.2017;2017;03;19;Sunnuntai;2;4;6
624;19.03.2017;2017;03;20;Sunnuntai;0;0;0
624;19.03.2017;2017;03;21;Sunnuntai;9;9;18
624;19.03.2017;2017;03;22;Sunnuntai;8;1;9
624;19.03.2017;2017;03;23;Sunnuntai;4;5;9
624;20.03.2017;2017;03;00;Maanantai;1;1;2
624;20.03.2017;2017;03;01;Maanantai;2;0;2
624;20.03.2017;2017;03;02;Maanantai;0;0;0
624;20.03.2017;2017;03;03;Maanantai;1;0;1
624;20.03.2017;2017;03;04;Maanantai;0;0;0
624;20.03.2017;2017;03;05;Maanantai;1;1;2
624;20.03.2017;2017;03;06;Maanantai;1;8;9
624;20.03.2017;2017;03;07;Maanantai;4;16;20
624;20.03.2017;2017;03;08;Maanantai;3;35;38
624;20.03.2017;2017;03;09;Maanantai;6;32;38
624;20.03.2017;2017;03;10;Maanantai;3;22;25
624;20.03.2017;2017;03;11;Maanantai;6;21;27
624;20.03.2017;2017;03;12;Maanantai;4;15;19
624;20.03.2017;2017;03;13;Maanantai;8;18;26
624;20.03.2017;2017;03;14;Maanantai;9;18;27
624;20.03.2017;2017;03;15;Maanantai;10;20;30
624;20.03.2017;2017;03;16;Maanantai;19;22;41
624;20.03.2017;2017;03;17;Maanantai;12;18;30
624;20.03.2017;2017;03;18;Maanantai;10;12;22
624;20.03.2017;2017;03;19;Maanantai;11;13;24
624;20.03.2017;2017;03;20;Maanantai;12;6;18
624;20.03.2017;2017;03;21;Maanantai;9;7;16
624;20.03.2017;2017;03;22;Maanantai;8;1;9
624;20.03.2017;2017;03;23;Maanantai;2;4;6
624;21.03.2017;2017;03;00;Tiistai;0;1;1
624;21.03.2017;2017;03;01;Tiistai;0;1;1
624;21.03.2017;2017;03;02;Tiistai;0;0;0
624;21.03.2017;2017;03;03;Tiistai;0;0;0
624;21.03.2017;2017;03;04;Tiistai;1;1;2
624;21.03.2017;2017;03;05;Tiistai;1;2;3
624;21.03.2017;2017;03;06;Tiistai;1;5;6
624;21.03.2017;2017;03;07;Tiistai;1;15;16
624;21.03.2017;2017;03;08;Tiistai;9;43;52
624;21.03.2017;2017;03;09;Tiistai;7;46;53
624;21.03.2017;2017;03;10;Tiistai;3;17;20
624;21.03.2017;2017;03;11;Tiistai;2;17;19
624;21.03.2017;2017;03;12;Tiistai;4;10;14
624;21.03.2017;2017;03;13;Tiistai;4;12;16
624;21.03.2017;2017;03;14;Tiistai;6;8;14
624;21.03.2017;2017;03;15;Tiistai;6;8;14
624;21.03.2017;2017;03;16;Tiistai;11;15;26
624;21.03.2017;2017;03;17;Tiistai;11;14;25
624;21.03.2017;2017;03;18;Tiistai;6;20;26
624;21.03.2017;2017;03;19;Tiistai;2;9;11
624;21.03.2017;2017;03;20;Tiistai;8;10;18
624;21.03.2017;2017;03;21;Tiistai;7;5;12
624;21.03.2017;2017;03;22;Tiistai;6;5;11
624;21.03.2017;2017;03;23;Tiistai;2;3;5
624;22.03.2017;2017;03;00;Keskiviikko;0;0;0
624;22.03.2017;2017;03;01;Keskiviikko;0;0;0
624;22.03.2017;2017;03;02;Keskiviikko;1;0;1
624;22.03.2017;2017;03;03;Keskiviikko;0;0;0
624;22.03.2017;2017;03;04;Keskiviikko;0;0;0
624;22.03.2017;2017;03;05;Keskiviikko;1;1;2
624;22.03.2017;2017;03;06;Keskiviikko;0;4;4
624;22.03.2017;2017;03;07;Keskiviikko;5;14;19
624;22.03.2017;2017;03;08;Keskiviikko;0;36;36
624;22.03.2017;2017;03;09;Keskiviikko;3;37;40
624;22.03.2017;2017;03;10;Keskiviikko;3;19;22
624;22.03.2017;2017;03;11;Keskiviikko;5;12;17
624;22.03.2017;2017;03;12;Keskiviikko;7;13;20
624;22.03.2017;2017;03;13;Keskiviikko;1;9;10
624;22.03.2017;2017;03;14;Keskiviikko;7;13;20
624;22.03.2017;2017;03;15;Keskiviikko;4;12;16
624;22.03.2017;2017;03;16;Keskiviikko;4;16;20
624;22.03.2017;2017;03;17;Keskiviikko;18;24;42
624;22.03.2017;2017;03;18;Keskiviikko;5;10;15
624;22.03.2017;2017;03;19;Keskiviikko;2;4;6
624;22.03.2017;2017;03;20;Keskiviikko;6;8;14
624;22.03.2017;2017;03;21;Keskiviikko;4;5;9
624;22.03.2017;2017;03;22;Keskiviikko;6;2;8
624;22.03.2017;2017;03;23;Keskiviikko;2;2;4
624;23.03.2017;2017;03;00;Torstai;1;0;1
624;23.03.2017;2017;03;01;Torstai;0;0;0
624;23.03.2017;2017;03;02;Torstai;1;0;1
624;23.03.2017;2017;03;03;Torstai;1;0;1
624;23.03.2017;2017;03;04;Torstai;1;0;1
624;23.03.2017;2017;03;05;Torstai;0;1;1
624;23.03.2017;2017;03;06;Torstai;1;4;5
624;23.03.2017;2017;03;07;Torstai;3;22;25
624;23.03.2017;2017;03;08;Torstai;2;41;43
624;23.03.2017;2017;03;09;Torstai;11;25;36
624;23.03.2017;2017;03;10;Torstai;2;23;25
624;23.03.2017;2017;03;11;Torstai;3;15;18
624;23.03.2017;2017;03;12;Torstai;7;9;16
624;23.03.2017;2017;03;13;Torstai;6;14;20
624;23.03.2017;2017;03;14;Torstai;5;16;21
624;23.03.2017;2017;03;15;Torstai;3;12;15
624;23.03.2017;2017;03;16;Torstai;18;17;35
624;23.03.2017;2017;03;17;Torstai;15;20;35
624;23.03.2017;2017;03;18;Torstai;13;16;29
624;23.03.2017;2017;03;19;Torstai;6;11;17
624;23.03.2017;2017;03;20;Torstai;11;9;20
624;23.03.2017;2017;03;21;Torstai;9;6;15
624;23.03.2017;2017;03;22;Torstai;5;2;7
624;23.03.2017;2017;03;23;Torstai;1;3;4
624;24.03.2017;2017;03;00;Perjantai;1;0;1
624;24.03.2017;2017;03;01;Perjantai;2;2;4
624;24.03.2017;2017;03;02;Perjantai;3;0;3
624;24.03.2017;2017;03;03;Perjantai;2;1;3
624;24.03.2017;2017;03;04;Perjantai;1;1;2
624;24.03.2017;2017;03;05;Perjantai;1;2;3
624;24.03.2017;2017;03;06;Perjantai;2;3;5
624;24.03.2017;2017;03;07;Perjantai;0;16;16
624;24.03.2017;2017;03;08;Perjantai;9;28;37
624;24.03.2017;2017;03;09;Perjantai;4;35;39
624;24.03.2017;2017;03;10;Perjantai;3;24;27
624;24.03.2017;2017;03;11;Perjantai;2;12;14
624;24.03.2017;2017;03;12;Perjantai;3;15;18
624;24.03.2017;2017;03;13;Perjantai;5;15;20
624;24.03.2017;2017;03;14;Perjantai;12;15;27
624;24.03.2017;2017;03;15;Perjantai;16;18;34
624;24.03.2017;2017;03;16;Perjantai;19;25;44
624;24.03.2017;2017;03;17;Perjantai;14;24;38
624;24.03.2017;2017;03;18;Perjantai;6;9;15
624;24.03.2017;2017;03;19;Perjantai;9;8;17
624;24.03.2017;2017;03;20;Perjantai;4;7;11
624;24.03.2017;2017;03;21;Perjantai;5;6;11
624;24.03.2017;2017;03;22;Perjantai;7;7;14
624;24.03.2017;2017;03;23;Perjantai;5;3;8
624;25.03.2017;2017;03;00;Lauantai;3;2;5
624;25.03.2017;2017;03;01;Lauantai;3;1;4
624;25.03.2017;2017;03;02;Lauantai;4;2;6
624;25.03.2017;2017;03;03;Lauantai;2;0;2
624;25.03.2017;2017;03;04;Lauantai;3;0;3
624;25.03.2017;2017;03;05;Lauantai;2;2;4
624;25.03.2017;2017;03;06;Lauantai;0;3;3
624;25.03.2017;2017;03;07;Lauantai;0;5;5
624;25.03.2017;2017;03;08;Lauantai;0;3;3
624;25.03.2017;2017;03;09;Lauantai;2;6;8
624;25.03.2017;2017;03;10;Lauantai;1;12;13
624;25.03.2017;2017;03;11;Lauantai;3;8;11
624;25.03.2017;2017;03;12;Lauantai;0;8;8
624;25.03.2017;2017;03;13;Lauantai;4;10;14
624;25.03.2017;2017;03;14;Lauantai;1;13;14
624;25.03.2017;2017;03;15;Lauantai;9;18;27
624;25.03.2017;2017;03;16;Lauantai;8;9;17
624;25.03.2017;2017;03;17;Lauantai;7;20;27
624;25.03.2017;2017;03;18;Lauantai;4;11;15
624;25.03.2017;2017;03;19;Lauantai;8;14;22
624;25.03.2017;2017;03;20;Lauantai;4;5;9
624;25.03.2017;2017;03;21;Lauantai;2;6;8
624;25.03.2017;2017;03;22;Lauantai;4;4;8
624;25.03.2017;2017;03;23;Lauantai;5;4;9
624;26.03.2017;2017;03;00;Sunnuntai;1;3;4
624;26.03.2017;2017;03;01;Sunnuntai;5;5;10
624;26.03.2017;2017;03;02;Sunnuntai;2;1;3
624;26.03.2017;2017;03;03;Sunnuntai;0;0;0
624;26.03.2017;2017;03;04;Sunnuntai;2;3;5
624;26.03.2017;2017;03;05;Sunnuntai;1;1;2
624;26.03.2017;2017;03;06;Sunnuntai;3;0;3
624;26.03.2017;2017;03;07;Sunnuntai;0;4;4
624;26.03.2017;2017;03;08;Sunnuntai;1;2;3
624;26.03.2017;2017;03;09;Sunnuntai;0;1;1
624;26.03.2017;2017;03;10;Sunnuntai;0;3;3
624;26.03.2017;2017;03;11;Sunnuntai;3;2;5
624;26.03.2017;2017;03;12;Sunnuntai;4;10;14
624;26.03.2017;2017;03;13;Sunnuntai;6;7;13
624;26.03.2017;2017;03;14;Sunnuntai;7;9;16
624;26.03.2017;2017;03;15;Sunnuntai;5;15;20
624;26.03.2017;2017;03;16;Sunnuntai;11;10;21
624;26.03.2017;2017;03;17;Sunnuntai;3;11;14
624;26.03.2017;2017;03;18;Sunnuntai;3;8;11
624;26.03.2017;2017;03;19;Sunnuntai;2;15;17
624;26.03.2017;2017;03;20;Sunnuntai;1;7;8
624;26.03.2017;2017;03;21;Sunnuntai;7;4;11
624;26.03.2017;2017;03;22;Sunnuntai;7;6;13
624;26.03.2017;2017;03;23;Sunnuntai;0;0;0
624;27.03.2017;2017;03;00;Maanantai;1;1;2
624;27.03.2017;2017;03;01;Maanantai;0;0;0
624;27.03.2017;2017;03;02;Maanantai;0;0;0
624;27.03.2017;2017;03;03;Maanantai;0;0;0
624;27.03.2017;2017;03;04;Maanantai;2;0;2
624;27.03.2017;2017;03;05;Maanantai;0;1;1
624;27.03.2017;2017;03;06;Maanantai;1;5;6
624;27.03.2017;2017;03;07;Maanantai;2;15;17
624;27.03.2017;2017;03;08;Maanantai;3;43;46
624;27.03.2017;2017;03;09;Maanantai;10;39;49
624;27.03.2017;2017;03;10;Maanantai;4;23;27
624;27.03.2017;2017;03;11;Maanantai;1;19;20
624;27.03.2017;2017;03;12;Maanantai;4;9;13
624;27.03.2017;2017;03;13;Maanantai;7;26;33
624;27.03.2017;2017;03;14;Maanantai;6;18;24
624;27.03.2017;2017;03;15;Maanantai;8;19;27
624;27.03.2017;2017;03;16;Maanantai;21;18;39
624;27.03.2017;2017;03;17;Maanantai;22;15;37
624;27.03.2017;2017;03;18;Maanantai;1;12;13
624;27.03.2017;2017;03;19;Maanantai;4;15;19
624;27.03.2017;2017;03;20;Maanantai;2;5;7
624;27.03.2017;2017;03;21;Maanantai;8;4;12
624;27.03.2017;2017;03;22;Maanantai;6;3;9
624;27.03.2017;2017;03;23;Maanantai;0;0;0
624;28.03.2017;2017;03;00;Tiistai;1;1;2
624;28.03.2017;2017;03;01;Tiistai;0;0;0
624;28.03.2017;2017;03;02;Tiistai;0;0;0
624;28.03.2017;2017;03;03;Tiistai;0;0;0
624;28.03.2017;2017;03;04;Tiistai;2;0;2
624;28.03.2017;2017;03;05;Tiistai;0;1;1
624;28.03.2017;2017;03;06;Tiistai;1;5;6
624;28.03.2017;2017;03;07;Tiistai;2;15;17
624;28.03.2017;2017;03;08;Tiistai;3;43;46
624;28.03.2017;2017;03;09;Tiistai;12;39;51
624;28.03.2017;2017;03;10;Tiistai;3;22;25
624;28.03.2017;2017;03;11;Tiistai;8;19;27
624;28.03.2017;2017;03;12;Tiistai;4;12;16
624;28.03.2017;2017;03;13;Tiistai;4;20;24
624;28.03.2017;2017;03;14;Tiistai;8;19;27
624;28.03.2017;2017;03;15;Tiistai;13;14;27
624;28.03.2017;2017;03;16;Tiistai;12;20;32
624;28.03.2017;2017;03;17;Tiistai;14;32;46
624;28.03.2017;2017;03;18;Tiistai;3;17;20
624;28.03.2017;2017;03;19;Tiistai;9;16;25
624;28.03.2017;2017;03;20;Tiistai;5;11;16
624;28.03.2017;2017;03;21;Tiistai;5;8;13
624;28.03.2017;2017;03;22;Tiistai;2;0;2
624;28.03.2017;2017;03;23;Tiistai;3;1;4
624;29.03.2017;2017;03;00;Keskiviikko;0;1;1
624;29.03.2017;2017;03;01;Keskiviikko;3;1;4
624;29.03.2017;2017;03;02;Keskiviikko;1;0;1
624;29.03.2017;2017;03;03;Keskiviikko;0;0;0
624;29.03.2017;2017;03;04;Keskiviikko;0;0;0
624;29.03.2017;2017;03;05;Keskiviikko;0;2;2
624;29.03.2017;2017;03;06;Keskiviikko;0;5;5
624;29.03.2017;2017;03;07;Keskiviikko;1;18;19
624;29.03.2017;2017;03;08;Keskiviikko;6;39;45
624;29.03.2017;2017;03;09;Keskiviikko;7;40;47
624;29.03.2017;2017;03;10;Keskiviikko;5;17;22
624;29.03.2017;2017;03;11;Keskiviikko;2;10;12
624;29.03.2017;2017;03;12;Keskiviikko;9;14;23
624;29.03.2017;2017;03;13;Keskiviikko;5;17;22
624;29.03.2017;2017;03;14;Keskiviikko;11;17;28
624;29.03.2017;2017;03;15;Keskiviikko;8;9;17
624;29.03.2017;2017;03;16;Keskiviikko;8;20;28
624;29.03.2017;2017;03;17;Keskiviikko;10;22;32
624;29.03.2017;2017;03;18;Keskiviikko;8;20;28
624;29.03.2017;2017;03;19;Keskiviikko;8;16;24
624;29.03.2017;2017;03;20;Keskiviikko;4;9;13
624;29.03.2017;2017;03;21;Keskiviikko;10;7;17
624;29.03.2017;2017;03;22;Keskiviikko;3;6;9
624;29.03.2017;2017;03;23;Keskiviikko;3;1;4
624;30.03.2017;2017;03;00;Torstai;2;2;4
624;30.03.2017;2017;03;01;Torstai;0;0;0
624;30.03.2017;2017;03;02;Torstai;1;0;1
624;30.03.2017;2017;03;03;Torstai;0;0;0
624;30.03.2017;2017;03;04;Torstai;0;0;0
624;30.03.2017;2017;03;05;Torstai;1;1;2
624;30.03.2017;2017;03;06;Torstai;0;6;6
624;30.03.2017;2017;03;07;Torstai;3;17;20
624;30.03.2017;2017;03;08;Torstai;4;35;39
624;30.03.2017;2017;03;09;Torstai;5;36;41
624;30.03.2017;2017;03;10;Torstai;4;16;20
624;30.03.2017;2017;03;11;Torstai;2;15;17
624;30.03.2017;2017;03;12;Torstai;5;16;21
624;30.03.2017;2017;03;13;Torstai;1;14;15
624;30.03.2017;2017;03;14;Torstai;7;13;20
624;30.03.2017;2017;03;15;Torstai;5;17;22
624;30.03.2017;2017;03;16;Torstai;9;31;40
624;30.03.2017;2017;03;17;Torstai;6;27;33
624;30.03.2017;2017;03;18;Torstai;11;18;29
624;30.03.2017;2017;03;19;Torstai;7;10;17
624;30.03.2017;2017;03;20;Torstai;5;8;13
624;30.03.2017;2017;03;21;Torstai;3;11;14
624;30.03.2017;2017;03;22;Torstai;11;7;18
624;30.03.2017;2017;03;23;Torstai;4;5;9
624;31.03.2017;2017;03;00;Perjantai;2;1;3
624;31.03.2017;2017;03;01;Perjantai;2;1;3
624;31.03.2017;2017;03;02;Perjantai;0;0;0
624;31.03.2017;2017;03;03;Perjantai;0;1;1
624;31.03.2017;2017;03;04;Perjantai;0;2;2
624;31.03.2017;2017;03;05;Perjantai;0;0;0
624;31.03.2017;2017;03;06;Perjantai;2;7;9
624;31.03.2017;2017;03;07;Perjantai;0;22;22
624;31.03.2017;2017;03;08;Perjantai;5;35;40
624;31.03.2017;2017;03;09;Perjantai;5;27;32
624;31.03.2017;2017;03;10;Perjantai;5;17;22
624;31.03.2017;2017;03;11;Perjantai;1;11;12
624;31.03.2017;2017;03;12;Perjantai;4;8;12
624;31.03.2017;2017;03;13;Perjantai;5;10;15
624;31.03.2017;2017;03;14;Perjantai;4;15;19
624;31.03.2017;2017;03;15;Perjantai;9;14;23
624;31.03.2017;2017;03;16;Perjantai;13;14;27
624;31.03.2017;2017;03;17;Perjantai;16;22;38
624;31.03.2017;2017;03;18;Perjantai;14;14;28
624;31.03.2017;2017;03;19;Perjantai;7;15;22
624;31.03.2017;2017;03;20;Perjantai;3;11;14
624;31.03.2017;2017;03;21;Perjantai;5;10;15
624;31.03.2017;2017;03;22;Perjantai;10;10;20
624;31.03.2017;2017;03;23;Perjantai;2;5;7
624;01.04.2017;2017;04;00;Lauantai;0;3;3
624;01.04.2017;2017;04;01;Lauantai;2;2;4
624;01.04.2017;2017;04;02;Lauantai;0;0;0
624;01.04.2017;2017;04;03;Lauantai;2;0;2
624;01.04.2017;2017;04;04;Lauantai;0;1;1
624;01.04.2017;2017;04;05;Lauantai;1;0;1
624;01.04.2017;2017;04;06;Lauantai;1;3;4
624;01.04.2017;2017;04;07;Lauantai;0;5;5
624;01.04.2017;2017;04;08;Lauantai;0;0;0
624;01.04.2017;2017;04;09;Lauantai;0;5;5
624;01.04.2017;2017;04;10;Lauantai;1;9;10
624;01.04.2017;2017;04;11;Lauantai;1;14;15
624;01.04.2017;2017;04;12;Lauantai;3;12;15
624;01.04.2017;2017;04;13;Lauantai;7;8;15
624;01.04.2017;2017;04;14;Lauantai;6;12;18
624;01.04.2017;2017;04;15;Lauantai;9;15;24
624;01.04.2017;2017;04;16;Lauantai;9;8;17
624;01.04.2017;2017;04;17;Lauantai;5;8;13
624;01.04.2017;2017;04;18;Lauantai;2;2;4
624;01.04.2017;2017;04;19;Lauantai;5;3;8
624;01.04.2017;2017;04;20;Lauantai;1;11;12
624;01.04.2017;2017;04;21;Lauantai;3;6;9
624;01.04.2017;2017;04;22;Lauantai;6;5;11
624;01.04.2017;2017;04;23;Lauantai;2;3;5
624;02.04.2017;2017;04;00;Sunnuntai;0;3;3
624;02.04.2017;2017;04;01;Sunnuntai;3;2;5
624;02.04.2017;2017;04;02;Sunnuntai;5;4;9
624;02.04.2017;2017;04;03;Sunnuntai;1;0;1
624;02.04.2017;2017;04;04;Sunnuntai;1;1;2
624;02.04.2017;2017;04;05;Sunnuntai;1;0;1
624;02.04.2017;2017;04;06;Sunnuntai;1;1;2
624;02.04.2017;2017;04;07;Sunnuntai;0;4;4
624;02.04.2017;2017;04;08;Sunnuntai;1;0;1
624;02.04.2017;2017;04;09;Sunnuntai;1;3;4
624;02.04.2017;2017;04;10;Sunnuntai;1;3;4
624;02.04.2017;2017;04;11;Sunnuntai;2;4;6
624;02.04.2017;2017;04;12;Sunnuntai;3;8;11
624;02.04.2017;2017;04;13;Sunnuntai;5;12;17
624;02.04.2017;2017;04;14;Sunnuntai;3;7;10
624;02.04.2017;2017;04;15;Sunnuntai;3;9;12
624;02.04.2017;2017;04;16;Sunnuntai;7;6;13
624;02.04.2017;2017;04;17;Sunnuntai;7;12;19
624;02.04.2017;2017;04;18;Sunnuntai;1;16;17
624;02.04.2017;2017;04;19;Sunnuntai;4;8;12
624;02.04.2017;2017;04;20;Sunnuntai;4;6;10
624;02.04.2017;2017;04;21;Sunnuntai;4;5;9
624;02.04.2017;2017;04;22;Sunnuntai;1;6;7
624;02.04.2017;2017;04;23;Sunnuntai;0;4;4
624;03.04.2017;2017;04;00;Maanantai;0;2;2
624;03.04.2017;2017;04;01;Maanantai;0;1;1
624;03.04.2017;2017;04;02;Maanantai;0;0;0
624;03.04.2017;2017;04;03;Maanantai;0;1;1
624;03.04.2017;2017;04;04;Maanantai;0;2;2
624;03.04.2017;2017;04;05;Maanantai;1;1;2
624;03.04.2017;2017;04;06;Maanantai;0;10;10
624;03.04.2017;2017;04;07;Maanantai;1;17;18
624;03.04.2017;2017;04;08;Maanantai;5;44;49
624;03.04.2017;2017;04;09;Maanantai;10;43;53
624;03.04.2017;2017;04;10;Maanantai;3;20;23
624;03.04.2017;2017;04;11;Maanantai;5;18;23
624;03.04.2017;2017;04;12;Maanantai;3;8;11
624;03.04.2017;2017;04;13;Maanantai;6;17;23
624;03.04.2017;2017;04;14;Maanantai;6;27;33
624;03.04.2017;2017;04;15;Maanantai;11;15;26
624;03.04.2017;2017;04;16;Maanantai;14;13;27
624;03.04.2017;2017;04;17;Maanantai;18;27;45
624;03.04.2017;2017;04;18;Maanantai;7;17;24
624;03.04.2017;2017;04;19;Maanantai;8;13;21
624;03.04.2017;2017;04;20;Maanantai;10;19;29
624;03.04.2017;2017;04;21;Maanantai;4;6;10
624;03.04.2017;2017;04;22;Maanantai;6;1;7
624;03.04.2017;2017;04;23;Maanantai;3;1;4
624;04.04.2017;2017;04;00;Tiistai;2;1;3
624;04.04.2017;2017;04;01;Tiistai;0;0;0
624;04.04.2017;2017;04;02;Tiistai;0;0;0
624;04.04.2017;2017;04;03;Tiistai;0;1;1
624;04.04.2017;2017;04;04;Tiistai;0;1;1
624;04.04.2017;2017;04;05;Tiistai;0;0;0
624;04.04.2017;2017;04;06;Tiistai;0;4;4
624;04.04.2017;2017;04;07;Tiistai;1;20;21
624;04.04.2017;2017;04;08;Tiistai;4;36;40
624;04.04.2017;2017;04;09;Tiistai;6;38;44
624;04.04.2017;2017;04;10;Tiistai;4;31;35
624;04.04.2017;2017;04;11;Tiistai;1;10;11
624;04.04.2017;2017;04;12;Tiistai;2;21;23
624;04.04.2017;2017;04;13;Tiistai;8;13;21
624;04.04.2017;2017;04;14;Tiistai;13;20;33
624;04.04.2017;2017;04;15;Tiistai;17;14;31
624;04.04.2017;2017;04;16;Tiistai;13;19;32
624;04.04.2017;2017;04;17;Tiistai;17;32;49
624;04.04.2017;2017;04;18;Tiistai;9;21;30
624;04.04.2017;2017;04;19;Tiistai;4;15;19
624;04.04.2017;2017;04;20;Tiistai;6;9;15
624;04.04.2017;2017;04;21;Tiistai;9;12;21
624;04.04.2017;2017;04;22;Tiistai;9;4;13
624;04.04.2017;2017;04;23;Tiistai;5;7;12
624;05.04.2017;2017;04;00;Keskiviikko;0;1;1
624;05.04.2017;2017;04;01;Keskiviikko;0;0;0
624;05.04.2017;2017;04;02;Keskiviikko;0;0;0
624;05.04.2017;2017;04;03;Keskiviikko;0;1;1
624;05.04.2017;2017;04;04;Keskiviikko;0;0;0
624;05.04.2017;2017;04;05;Keskiviikko;1;0;1
624;05.04.2017;2017;04;06;Keskiviikko;0;6;6
624;05.04.2017;2017;04;07;Keskiviikko;5;21;26
624;05.04.2017;2017;04;08;Keskiviikko;5;52;57
624;05.04.2017;2017;04;09;Keskiviikko;8;45;53
624;05.04.2017;2017;04;10;Keskiviikko;1;14;15
624;05.04.2017;2017;04;11;Keskiviikko;0;14;14
624;05.04.2017;2017;04;12;Keskiviikko;6;14;20
624;05.04.2017;2017;04;13;Keskiviikko;3;21;24
624;05.04.2017;2017;04;14;Keskiviikko;3;17;20
624;05.04.2017;2017;04;15;Keskiviikko;9;21;30
624;05.04.2017;2017;04;16;Keskiviikko;11;28;39
624;05.04.2017;2017;04;17;Keskiviikko;12;33;45
624;05.04.2017;2017;04;18;Keskiviikko;10;29;39
624;05.04.2017;2017;04;19;Keskiviikko;7;19;26
624;05.04.2017;2017;04;20;Keskiviikko;13;15;28
624;05.04.2017;2017;04;21;Keskiviikko;6;5;11
624;05.04.2017;2017;04;22;Keskiviikko;1;5;6
624;05.04.2017;2017;04;23;Keskiviikko;0;5;5
624;06.04.2017;2017;04;00;Torstai;0;1;1
624;06.04.2017;2017;04;01;Torstai;1;0;1
624;06.04.2017;2017;04;02;Torstai;0;1;1
624;06.04.2017;2017;04;03;Torstai;0;0;0
624;06.04.2017;2017;04;04;Torstai;0;2;2
624;06.04.2017;2017;04;05;Torstai;0;0;0
624;06.04.2017;2017;04;06;Torstai;1;6;7
624;06.04.2017;2017;04;07;Torstai;2;23;25
624;06.04.2017;2017;04;08;Torstai;5;44;49
624;06.04.2017;2017;04;09;Torstai;11;31;42
624;06.04.2017;2017;04;10;Torstai;2;28;30
624;06.04.2017;2017;04;11;Torstai;4;16;20
624;06.04.2017;2017;04;12;Torstai;2;19;21
624;06.04.2017;2017;04;13;Torstai;5;15;20
624;06.04.2017;2017;04;14;Torstai;15;12;27
624;06.04.2017;2017;04;15;Torstai;6;19;25
624;06.04.2017;2017;04;16;Torstai;18;17;35
624;06.04.2017;2017;04;17;Torstai;7;28;35
624;06.04.2017;2017;04;18;Torstai;9;26;35
624;06.04.2017;2017;04;19;Torstai;8;9;17
624;06.04.2017;2017;04;20;Torstai;4;6;10
624;06.04.2017;2017;04;21;Torstai;10;5;15
624;06.04.2017;2017;04;22;Torstai;5;3;8
624;06.04.2017;2017;04;23;Torstai;6;3;9
624;07.04.2017;2017;04;00;Perjantai;0;1;1
624;07.04.2017;2017;04;01;Perjantai;1;2;3
624;07.04.2017;2017;04;02;Perjantai;0;0;0
624;07.04.2017;2017;04;03;Perjantai;0;2;2
624;07.04.2017;2017;04;04;Perjantai;1;1;2
624;07.04.2017;2017;04;05;Perjantai;1;1;2
624;07.04.2017;2017;04;06;Perjantai;1;7;8
624;07.04.2017;2017;04;07;Perjantai;1;23;24
624;07.04.2017;2017;04;08;Perjantai;5;36;41
624;07.04.2017;2017;04;09;Perjantai;9;45;54
624;07.04.2017;2017;04;10;Perjantai;9;31;40
624;07.04.2017;2017;04;11;Perjantai;2;15;17
624;07.04.2017;2017;04;12;Perjantai;15;38;53
624;07.04.2017;2017;04;13;Perjantai;7;15;22
624;07.04.2017;2017;04;14;Perjantai;11;19;30
624;07.04.2017;2017;04;15;Perjantai;8;17;25
624;07.04.2017;2017;04;16;Perjantai;15;18;33
624;07.04.2017;2017;04;17;Perjantai;6;19;25
624;07.04.2017;2017;04;18;Perjantai;8;15;23
624;07.04.2017;2017;04;19;Perjantai;7;17;24
624;07.04.2017;2017;04;20;Perjantai;5;11;16
624;07.04.2017;2017;04;21;Perjantai;2;6;8
624;07.04.2017;2017;04;22;Perjantai;4;8;12
624;07.04.2017;2017;04;23;Perjantai;3;5;8
624;08.04.2017;2017;04;00;Lauantai;0;0;0
624;08.04.2017;2017;04;01;Lauantai;2;1;3
624;08.04.2017;2017;04;02;Lauantai;3;1;4
624;08.04.2017;2017;04;03;Lauantai;4;0;4
624;08.04.2017;2017;04;04;Lauantai;0;0;0
624;08.04.2017;2017;04;05;Lauantai;2;0;2
624;08.04.2017;2017;04;06;Lauantai;0;0;0
624;08.04.2017;2017;04;07;Lauantai;0;2;2
624;08.04.2017;2017;04;08;Lauantai;0;6;6
624;08.04.2017;2017;04;09;Lauantai;3;7;10
624;08.04.2017;2017;04;10;Lauantai;0;0;0
624;08.04.2017;2017;04;11;Lauantai;0;0;0
624;08.04.2017;2017;04;12;Lauantai;9;48;57
624;08.04.2017;2017;04;13;Lauantai;6;14;20
624;08.04.2017;2017;04;14;Lauantai;8;26;34
624;08.04.2017;2017;04;15;Lauantai;5;9;14
624;08.04.2017;2017;04;16;Lauantai;8;16;24
624;08.04.2017;2017;04;17;Lauantai;6;24;30
624;08.04.2017;2017;04;18;Lauantai;6;14;20
624;08.04.2017;2017;04;19;Lauantai;6;8;14
624;08.04.2017;2017;04;20;Lauantai;3;8;11
624;08.04.2017;2017;04;21;Lauantai;2;6;8
624;08.04.2017;2017;04;22;Lauantai;1;2;3
624;08.04.2017;2017;04;23;Lauantai;1;3;4
624;09.04.2017;2017;04;00;Sunnuntai;0;3;3
624;09.04.2017;2017;04;01;Sunnuntai;3;5;8
624;09.04.2017;2017;04;02;Sunnuntai;1;2;3
624;09.04.2017;2017;04;03;Sunnuntai;4;0;4
624;09.04.2017;2017;04;04;Sunnuntai;2;2;4
624;09.04.2017;2017;04;05;Sunnuntai;1;0;1
624;09.04.2017;2017;04;06;Sunnuntai;0;0;0
624;09.04.2017;2017;04;07;Sunnuntai;1;3;4
624;09.04.2017;2017;04;08;Sunnuntai;0;1;1
624;09.04.2017;2017;04;09;Sunnuntai;1;1;2
624;09.04.2017;2017;04;10;Sunnuntai;3;3;6
624;09.04.2017;2017;04;11;Sunnuntai;2;6;8
624;09.04.2017;2017;04;12;Sunnuntai;0;12;12
624;09.04.2017;2017;04;13;Sunnuntai;3;17;20
624;09.04.2017;2017;04;14;Sunnuntai;1;7;8
624;09.04.2017;2017;04;15;Sunnuntai;3;12;15
624;09.04.2017;2017;04;16;Sunnuntai;4;11;15
624;09.04.2017;2017;04;17;Sunnuntai;5;10;15
624;09.04.2017;2017;04;18;Sunnuntai;5;9;14
624;09.04.2017;2017;04;19;Sunnuntai;3;7;10
624;09.04.2017;2017;04;20;Sunnuntai;5;9;14
624;09.04.2017;2017;04;21;Sunnuntai;4;6;10
624;09.04.2017;2017;04;22;Sunnuntai;1;1;2
624;09.04.2017;2017;04;23;Sunnuntai;1;0;1
624;10.04.2017;2017;04;00;Maanantai;0;1;1
624;10.04.2017;2017;04;01;Maanantai;1;1;2
624;10.04.2017;2017;04;02;Maanantai;0;0;0
624;10.04.2017;2017;04;03;Maanantai;1;0;1
624;10.04.2017;2017;04;04;Maanantai;0;0;0
624;10.04.2017;2017;04;05;Maanantai;0;0;0
624;10.04.2017;2017;04;06;Maanantai;0;10;10
624;10.04.2017;2017;04;07;Maanantai;3;17;20
624;10.04.2017;2017;04;08;Maanantai;3;31;34
624;10.04.2017;2017;04;09;Maanantai;9;49;58
624;10.04.2017;2017;04;10;Maanantai;6;29;35
624;10.04.2017;2017;04;11;Maanantai;2;15;17
624;10.04.2017;2017;04;12;Maanantai;2;17;19
624;10.04.2017;2017;04;13;Maanantai;6;20;26
624;10.04.2017;2017;04;14;Maanantai;2;12;14
624;10.04.2017;2017;04;15;Maanantai;8;7;15
624;10.04.2017;2017;04;16;Maanantai;10;25;35
624;10.04.2017;2017;04;17;Maanantai;12;26;38
624;10.04.2017;2017;04;18;Maanantai;4;7;11
624;10.04.2017;2017;04;19;Maanantai;6;13;19
624;10.04.2017;2017;04;20;Maanantai;6;7;13
624;10.04.2017;2017;04;21;Maanantai;2;1;3
624;10.04.2017;2017;04;22;Maanantai;5;0;5
624;10.04.2017;2017;04;23;Maanantai;0;6;6
624;11.04.2017;2017;04;00;Tiistai;3;0;3
624;11.04.2017;2017;04;01;Tiistai;1;0;1
624;11.04.2017;2017;04;02;Tiistai;0;0;0
624;11.04.2017;2017;04;03;Tiistai;0;0;0
624;11.04.2017;2017;04;04;Tiistai;0;1;1
624;11.04.2017;2017;04;05;Tiistai;1;2;3
624;11.04.2017;2017;04;06;Tiistai;0;9;9
624;11.04.2017;2017;04;07;Tiistai;3;12;15
624;11.04.2017;2017;04;08;Tiistai;8;32;40
624;11.04.2017;2017;04;09;Tiistai;12;31;43
624;11.04.2017;2017;04;10;Tiistai;4;9;13
624;11.04.2017;2017;04;11;Tiistai;4;7;11
624;11.04.2017;2017;04;12;Tiistai;1;9;10
624;11.04.2017;2017;04;13;Tiistai;4;14;18
624;11.04.2017;2017;04;14;Tiistai;3;8;11
624;11.04.2017;2017;04;15;Tiistai;9;6;15
624;11.04.2017;2017;04;16;Tiistai;12;20;32
624;11.04.2017;2017;04;17;Tiistai;9;20;29
624;11.04.2017;2017;04;18;Tiistai;12;16;28
624;11.04.2017;2017;04;19;Tiistai;8;14;22
624;11.04.2017;2017;04;20;Tiistai;5;7;12
624;11.04.2017;2017;04;21;Tiistai;5;6;11
624;11.04.2017;2017;04;22;Tiistai;5;4;9
624;11.04.2017;2017;04;23;Tiistai;3;3;6
624;12.04.2017;2017;04;00;Keskiviikko;0;1;1
624;12.04.2017;2017;04;01;Keskiviikko;0;1;1
624;12.04.2017;2017;04;02;Keskiviikko;1;0;1
624;12.04.2017;2017;04;03;Keskiviikko;0;0;0
624;12.04.2017;2017;04;04;Keskiviikko;0;0;0
624;12.04.2017;2017;04;05;Keskiviikko;0;0;0
624;12.04.2017;2017;04;06;Keskiviikko;0;8;8
624;12.04.2017;2017;04;07;Keskiviikko;0;9;9
624;12.04.2017;2017;04;08;Keskiviikko;3;39;42
624;12.04.2017;2017;04;09;Keskiviikko;5;44;49
624;12.04.2017;2017;04;10;Keskiviikko;1;16;17
624;12.04.2017;2017;04;11;Keskiviikko;1;10;11
624;12.04.2017;2017;04;12;Keskiviikko;2;22;24
624;12.04.2017;2017;04;13;Keskiviikko;4;17;21
624;12.04.2017;2017;04;14;Keskiviikko;5;26;31
624;12.04.2017;2017;04;15;Keskiviikko;8;10;18
624;12.04.2017;2017;04;16;Keskiviikko;17;33;50
624;12.04.2017;2017;04;17;Keskiviikko;11;31;42
624;12.04.2017;2017;04;18;Keskiviikko;6;17;23
624;12.04.2017;2017;04;19;Keskiviikko;5;12;17
624;12.04.2017;2017;04;20;Keskiviikko;2;7;9
624;12.04.2017;2017;04;21;Keskiviikko;11;3;14
624;12.04.2017;2017;04;22;Keskiviikko;5;5;10
624;12.04.2017;2017;04;23;Keskiviikko;3;2;5
624;13.04.2017;2017;04;00;Torstai;1;1;2
624;13.04.2017;2017;04;01;Torstai;0;3;3
624;13.04.2017;2017;04;02;Torstai;2;2;4
624;13.04.2017;2017;04;03;Torstai;1;3;4
624;13.04.2017;2017;04;04;Torstai;0;0;0
624;13.04.2017;2017;04;05;Torstai;0;1;1
624;13.04.2017;2017;04;06;Torstai;0;9;9
624;13.04.2017;2017;04;07;Torstai;0;17;17
624;13.04.2017;2017;04;08;Torstai;2;24;26
624;13.04.2017;2017;04;09;Torstai;3;30;33
624;13.04.2017;2017;04;10;Torstai;1;13;14
624;13.04.2017;2017;04;11;Torstai;1;9;10
624;13.04.2017;2017;04;12;Torstai;7;13;20
624;13.04.2017;2017;04;13;Torstai;11;9;20
624;13.04.2017;2017;04;14;Torstai;2;20;22
624;13.04.2017;2017;04;15;Torstai;4;19;23
624;13.04.2017;2017;04;16;Torstai;14;20;34
624;13.04.2017;2017;04;17;Torstai;2;15;17
624;13.04.2017;2017;04;18;Torstai;7;14;21
624;13.04.2017;2017;04;19;Torstai;1;14;15
624;13.04.2017;2017;04;20;Torstai;4;5;9
624;13.04.2017;2017;04;21;Torstai;3;12;15
624;13.04.2017;2017;04;22;Torstai;6;2;8
624;13.04.2017;2017;04;23;Torstai;0;5;5
624;14.04.2017;2017;04;00;Perjantai;2;5;7
624;14.04.2017;2017;04;01;Perjantai;5;2;7
624;14.04.2017;2017;04;02;Perjantai;2;2;4
624;14.04.2017;2017;04;03;Perjantai;0;2;2
624;14.04.2017;2017;04;04;Perjantai;0;0;0
624;14.04.2017;2017;04;05;Perjantai;0;0;0
624;14.04.2017;2017;04;06;Perjantai;0;2;2
624;14.04.2017;2017;04;07;Perjantai;0;2;2
624;14.04.2017;2017;04;08;Perjantai;0;0;0
624;14.04.2017;2017;04;09;Perjantai;0;1;1
624;14.04.2017;2017;04;10;Perjantai;2;4;6
624;14.04.2017;2017;04;11;Perjantai;0;3;3
624;14.04.2017;2017;04;12;Perjantai;3;3;6
624;14.04.2017;2017;04;13;Perjantai;3;5;8
624;14.04.2017;2017;04;14;Perjantai;2;6;8
624;14.04.2017;2017;04;15;Perjantai;4;6;10
624;14.04.2017;2017;04;16;Perjantai;2;8;10
624;14.04.2017;2017;04;17;Perjantai;1;6;7
624;14.04.2017;2017;04;18;Perjantai;2;5;7
624;14.04.2017;2017;04;19;Perjantai;0;7;7
624;14.04.2017;2017;04;20;Perjantai;4;2;6
624;14.04.2017;2017;04;21;Perjantai;3;5;8
624;14.04.2017;2017;04;22;Perjantai;2;5;7
624;14.04.2017;2017;04;23;Perjantai;0;5;5
624;15.04.2017;2017;04;00;Lauantai;2;1;3
624;15.04.2017;2017;04;01;Lauantai;3;3;6
624;15.04.2017;2017;04;02;Lauantai;1;2;3
624;15.04.2017;2017;04;03;Lauantai;0;2;2
624;15.04.2017;2017;04;04;Lauantai;1;0;1
624;15.04.2017;2017;04;05;Lauantai;2;0;2
624;15.04.2017;2017;04;06;Lauantai;0;1;1
624;15.04.2017;2017;04;07;Lauantai;2;3;5
624;15.04.2017;2017;04;08;Lauantai;0;1;1
624;15.04.2017;2017;04;09;Lauantai;3;5;8
624;15.04.2017;2017;04;10;Lauantai;3;13;16
624;15.04.2017;2017;04;11;Lauantai;4;9;13
624;15.04.2017;2017;04;12;Lauantai;4;7;11
624;15.04.2017;2017;04;13;Lauantai;2;7;9
624;15.04.2017;2017;04;14;Lauantai;5;7;12
624;15.04.2017;2017;04;15;Lauantai;2;10;12
624;15.04.2017;2017;04;16;Lauantai;2;7;9
624;15.04.2017;2017;04;17;Lauantai;1;6;7
624;15.04.2017;2017;04;18;Lauantai;1;4;5
624;15.04.2017;2017;04;19;Lauantai;2;4;6
624;15.04.2017;2017;04;20;Lauantai;2;10;12
624;15.04.2017;2017;04;21;Lauantai;2;6;8
624;15.04.2017;2017;04;22;Lauantai;3;1;4
624;15.04.2017;2017;04;23;Lauantai;1;4;5
624;16.04.2017;2017;04;00;Sunnuntai;0;2;2
624;16.04.2017;2017;04;01;Sunnuntai;1;0;1
624;16.04.2017;2017;04;02;Sunnuntai;0;1;1
624;16.04.2017;2017;04;03;Sunnuntai;0;1;1
624;16.04.2017;2017;04;04;Sunnuntai;0;1;1
624;16.04.2017;2017;04;05;Sunnuntai;0;0;0
624;16.04.2017;2017;04;06;Sunnuntai;0;0;0
624;16.04.2017;2017;04;07;Sunnuntai;0;0;0
624;16.04.2017;2017;04;08;Sunnuntai;0;1;1
624;16.04.2017;2017;04;09;Sunnuntai;0;2;2
624;16.04.2017;2017;04;10;Sunnuntai;0;3;3
624;16.04.2017;2017;04;11;Sunnuntai;1;3;4
624;16.04.2017;2017;04;12;Sunnuntai;0;9;9
624;16.04.2017;2017;04;13;Sunnuntai;3;5;8
624;16.04.2017;2017;04;14;Sunnuntai;3;9;12
624;16.04.2017;2017;04;15;Sunnuntai;4;14;18
624;16.04.2017;2017;04;16;Sunnuntai;4;9;13
624;16.04.2017;2017;04;17;Sunnuntai;3;11;14
624;16.04.2017;2017;04;18;Sunnuntai;0;13;13
624;16.04.2017;2017;04;19;Sunnuntai;4;8;12
624;16.04.2017;2017;04;20;Sunnuntai;4;3;7
624;16.04.2017;2017;04;21;Sunnuntai;2;4;6
624;16.04.2017;2017;04;22;Sunnuntai;3;1;4
624;16.04.2017;2017;04;23;Sunnuntai;2;2;4
624;17.04.2017;2017;04;00;Maanantai;4;1;5
624;17.04.2017;2017;04;01;Maanantai;1;0;1
624;17.04.2017;2017;04;02;Maanantai;0;1;1
624;17.04.2017;2017;04;03;Maanantai;0;0;0
624;17.04.2017;2017;04;04;Maanantai;1;0;1
624;17.04.2017;2017;04;05;Maanantai;0;0;0
624;17.04.2017;2017;04;06;Maanantai;0;0;0
624;17.04.2017;2017;04;07;Maanantai;0;5;5
624;17.04.2017;2017;04;08;Maanantai;0;1;1
624;17.04.2017;2017;04;09;Maanantai;0;2;2
624;17.04.2017;2017;04;10;Maanantai;0;1;1
624;17.04.2017;2017;04;11;Maanantai;2;6;8
624;17.04.2017;2017;04;12;Maanantai;0;4;4
624;17.04.2017;2017;04;13;Maanantai;3;11;14
624;17.04.2017;2017;04;14;Maanantai;8;14;22
624;17.04.2017;2017;04;15;Maanantai;4;12;16
624;17.04.2017;2017;04;16;Maanantai;5;14;19
624;17.04.2017;2017;04;17;Maanantai;5;21;26
624;17.04.2017;2017;04;18;Maanantai;2;11;13
624;17.04.2017;2017;04;19;Maanantai;8;6;14
624;17.04.2017;2017;04;20;Maanantai;4;3;7
624;17.04.2017;2017;04;21;Maanantai;5;10;15
624;17.04.2017;2017;04;22;Maanantai;5;3;8
624;17.04.2017;2017;04;23;Maanantai;1;4;5
624;18.04.2017;2017;04;00;Tiistai;1;1;2
624;18.04.2017;2017;04;01;Tiistai;0;2;2
624;18.04.2017;2017;04;02;Tiistai;1;0;1
624;18.04.2017;2017;04;03;Tiistai;0;0;0
624;18.04.2017;2017;04;04;Tiistai;0;0;0
624;18.04.2017;2017;04;05;Tiistai;1;0;1
624;18.04.2017;2017;04;06;Tiistai;0;6;6
624;18.04.2017;2017;04;07;Tiistai;1;18;19
624;18.04.2017;2017;04;08;Tiistai;5;54;59
624;18.04.2017;2017;04;09;Tiistai;3;37;40
624;18.04.2017;2017;04;10;Tiistai;3;18;21
624;18.04.2017;2017;04;11;Tiistai;1;18;19
624;18.04.2017;2017;04;12;Tiistai;2;19;21
624;18.04.2017;2017;04;13;Tiistai;5;23;28
624;18.04.2017;2017;04;14;Tiistai;7;8;15
624;18.04.2017;2017;04;15;Tiistai;19;18;37
624;18.04.2017;2017;04;16;Tiistai;12;27;39
624;18.04.2017;2017;04;17;Tiistai;10;27;37
624;18.04.2017;2017;04;18;Tiistai;11;30;41
624;18.04.2017;2017;04;19;Tiistai;4;17;21
624;18.04.2017;2017;04;20;Tiistai;3;20;23
624;18.04.2017;2017;04;21;Tiistai;6;8;14
624;18.04.2017;2017;04;22;Tiistai;4;5;9
624;18.04.2017;2017;04;23;Tiistai;2;3;5
624;19.04.2017;2017;04;00;Keskiviikko;0;3;3
624;19.04.2017;2017;04;01;Keskiviikko;1;1;2
624;19.04.2017;2017;04;02;Keskiviikko;0;1;1
624;19.04.2017;2017;04;03;Keskiviikko;1;0;1
624;19.04.2017;2017;04;04;Keskiviikko;0;1;1
624;19.04.2017;2017;04;05;Keskiviikko;0;1;1
624;19.04.2017;2017;04;06;Keskiviikko;0;5;5
624;19.04.2017;2017;04;07;Keskiviikko;1;17;18
624;19.04.2017;2017;04;08;Keskiviikko;6;52;58
624;19.04.2017;2017;04;09;Keskiviikko;4;50;54
624;19.04.2017;2017;04;10;Keskiviikko;3;18;21
624;19.04.2017;2017;04;11;Keskiviikko;1;9;10
624;19.04.2017;2017;04;12;Keskiviikko;6;11;17
624;19.04.2017;2017;04;13;Keskiviikko;4;19;23
624;19.04.2017;2017;04;14;Keskiviikko;6;20;26
624;19.04.2017;2017;04;15;Keskiviikko;12;20;32
624;19.04.2017;2017;04;16;Keskiviikko;9;21;30
624;19.04.2017;2017;04;17;Keskiviikko;8;30;38
624;19.04.2017;2017;04;18;Keskiviikko;5;34;39
624;19.04.2017;2017;04;19;Keskiviikko;10;17;27
624;19.04.2017;2017;04;20;Keskiviikko;3;6;9
624;19.04.2017;2017;04;21;Keskiviikko;1;6;7
624;19.04.2017;2017;04;22;Keskiviikko;3;7;10
624;19.04.2017;2017;04;23;Keskiviikko;0;3;3
624;20.04.2017;2017;04;00;Torstai;2;1;3
624;20.04.2017;2017;04;01;Torstai;0;1;1
624;20.04.2017;2017;04;02;Torstai;0;0;0
624;20.04.2017;2017;04;03;Torstai;0;1;1
624;20.04.2017;2017;04;04;Torstai;0;0;0
624;20.04.2017;2017;04;05;Torstai;0;1;1
624;20.04.2017;2017;04;06;Torstai;0;10;10
624;20.04.2017;2017;04;07;Torstai;1;12;13
624;20.04.2017;2017;04;08;Torstai;5;43;48
624;20.04.2017;2017;04;09;Torstai;3;45;48
624;20.04.2017;2017;04;10;Torstai;4;29;33
624;20.04.2017;2017;04;11;Torstai;2;19;21
624;20.04.2017;2017;04;12;Torstai;3;24;27
624;20.04.2017;2017;04;13;Torstai;2;10;12
624;20.04.2017;2017;04;14;Torstai;5;19;24
624;20.04.2017;2017;04;15;Torstai;6;15;21
624;20.04.2017;2017;04;16;Torstai;10;19;29
624;20.04.2017;2017;04;17;Torstai;4;16;20
624;20.04.2017;2017;04;18;Torstai;5;14;19
624;20.04.2017;2017;04;19;Torstai;2;9;11
624;20.04.2017;2017;04;20;Torstai;5;10;15
624;20.04.2017;2017;04;21;Torstai;0;3;3
624;20.04.2017;2017;04;22;Torstai;3;1;4
624;20.04.2017;2017;04;23;Torstai;1;3;4
624;21.04.2017;2017;04;00;Perjantai;1;1;2
624;21.04.2017;2017;04;01;Perjantai;0;0;0
624;21.04.2017;2017;04;02;Perjantai;2;2;4
624;21.04.2017;2017;04;03;Perjantai;1;0;1
624;21.04.2017;2017;04;04;Perjantai;3;2;5
624;21.04.2017;2017;04;05;Perjantai;0;0;0
624;21.04.2017;2017;04;06;Perjantai;0;4;4
624;21.04.2017;2017;04;07;Perjantai;0;22;22
624;21.04.2017;2017;04;08;Perjantai;1;34;35
624;21.04.2017;2017;04;09;Perjantai;1;39;40
624;21.04.2017;2017;04;10;Perjantai;4;23;27
624;21.04.2017;2017;04;11;Perjantai;4;13;17
624;21.04.2017;2017;04;12;Perjantai;3;16;19
624;21.04.2017;2017;04;13;Perjantai;6;19;25
624;21.04.2017;2017;04;14;Perjantai;4;17;21
624;21.04.2017;2017;04;15;Perjantai;13;18;31
624;21.04.2017;2017;04;16;Perjantai;12;28;40
624;21.04.2017;2017;04;17;Perjantai;8;26;34
624;21.04.2017;2017;04;18;Perjantai;5;14;19
624;21.04.2017;2017;04;19;Perjantai;8;14;22
624;21.04.2017;2017;04;20;Perjantai;1;16;17
624;21.04.2017;2017;04;21;Perjantai;3;12;15
624;21.04.2017;2017;04;22;Perjantai;3;6;9
624;21.04.2017;2017;04;23;Perjantai;1;3;4
624;22.04.2017;2017;04;00;Lauantai;3;6;9
624;22.04.2017;2017;04;01;Lauantai;5;1;6
624;22.04.2017;2017;04;02;Lauantai;1;1;2
624;22.04.2017;2017;04;03;Lauantai;1;0;1
624;22.04.2017;2017;04;04;Lauantai;1;1;2
624;22.04.2017;2017;04;05;Lauantai;0;2;2
624;22.04.2017;2017;04;06;Lauantai;0;2;2
624;22.04.2017;2017;04;07;Lauantai;1;4;5
624;22.04.2017;2017;04;08;Lauantai;1;3;4
624;22.04.2017;2017;04;09;Lauantai;3;10;13
624;22.04.2017;2017;04;10;Lauantai;0;12;12
624;22.04.2017;2017;04;11;Lauantai;3;8;11
624;22.04.2017;2017;04;12;Lauantai;5;19;24
624;22.04.2017;2017;04;13;Lauantai;5;25;30
624;22.04.2017;2017;04;14;Lauantai;4;25;29
624;22.04.2017;2017;04;15;Lauantai;10;11;21
624;22.04.2017;2017;04;16;Lauantai;5;13;18
624;22.04.2017;2017;04;17;Lauantai;7;7;14
624;22.04.2017;2017;04;18;Lauantai;4;14;18
624;22.04.2017;2017;04;19;Lauantai;10;6;16
624;22.04.2017;2017;04;20;Lauantai;8;9;17
624;22.04.2017;2017;04;21;Lauantai;3;7;10
624;22.04.2017;2017;04;22;Lauantai;3;2;5
624;22.04.2017;2017;04;23;Lauantai;5;6;11
624;23.04.2017;2017;04;00;Sunnuntai;1;3;4
624;23.04.2017;2017;04;01;Sunnuntai;2;4;6
624;23.04.2017;2017;04;02;Sunnuntai;1;4;5
624;23.04.2017;2017;04;03;Sunnuntai;2;1;3
624;23.04.2017;2017;04;04;Sunnuntai;1;2;3
624;23.04.2017;2017;04;05;Sunnuntai;3;0;3
624;23.04.2017;2017;04;06;Sunnuntai;0;0;0
624;23.04.2017;2017;04;07;Sunnuntai;0;2;2
624;23.04.2017;2017;04;08;Sunnuntai;0;6;6
624;23.04.2017;2017;04;09;Sunnuntai;1;1;2
624;23.04.2017;2017;04;10;Sunnuntai;1;6;7
624;23.04.2017;2017;04;11;Sunnuntai;2;4;6
624;23.04.2017;2017;04;12;Sunnuntai;11;19;30
624;23.04.2017;2017;04;13;Sunnuntai;13;7;20
624;23.04.2017;2017;04;14;Sunnuntai;9;14;23
624;23.04.2017;2017;04;15;Sunnuntai;7;25;32
624;23.04.2017;2017;04;16;Sunnuntai;10;26;36
624;23.04.2017;2017;04;17;Sunnuntai;1;24;25
624;23.04.2017;2017;04;18;Sunnuntai;4;8;12
624;23.04.2017;2017;04;19;Sunnuntai;3;12;15
624;23.04.2017;2017;04;20;Sunnuntai;2;14;16
624;23.04.2017;2017;04;21;Sunnuntai;3;9;12
624;23.04.2017;2017;04;22;Sunnuntai;2;5;7
624;23.04.2017;2017;04;23;Sunnuntai;4;7;11
624;24.04.2017;2017;04;00;Maanantai;1;1;2
624;24.04.2017;2017;04;01;Maanantai;2;1;3
624;24.04.2017;2017;04;02;Maanantai;0;2;2
624;24.04.2017;2017;04;03;Maanantai;1;1;2
624;24.04.2017;2017;04;04;Maanantai;0;1;1
624;24.04.2017;2017;04;05;Maanantai;0;1;1
624;24.04.2017;2017;04;06;Maanantai;0;8;8
624;24.04.2017;2017;04;07;Maanantai;1;23;24
624;24.04.2017;2017;04;08;Maanantai;5;43;48
624;24.04.2017;2017;04;09;Maanantai;11;46;57
624;24.04.2017;2017;04;10;Maanantai;2;24;26
624;24.04.2017;2017;04;11;Maanantai;4;24;28
624;24.04.2017;2017;04;12;Maanantai;3;18;21
624;24.04.2017;2017;04;13;Maanantai;5;25;30
624;24.04.2017;2017;04;14;Maanantai;7;30;37
624;24.04.2017;2017;04;15;Maanantai;6;18;24
624;24.04.2017;2017;04;16;Maanantai;13;32;45
624;24.04.2017;2017;04;17;Maanantai;9;37;46
624;24.04.2017;2017;04;18;Maanantai;7;27;34
624;24.04.2017;2017;04;19;Maanantai;11;20;31
624;24.04.2017;2017;04;20;Maanantai;6;11;17
624;24.04.2017;2017;04;21;Maanantai;4;4;8
624;24.04.2017;2017;04;22;Maanantai;1;10;11
624;24.04.2017;2017;04;23;Maanantai;4;4;8
624;25.04.2017;2017;04;00;Tiistai;2;5;7
624;25.04.2017;2017;04;01;Tiistai;2;1;3
624;25.04.2017;2017;04;02;Tiistai;1;0;1
624;25.04.2017;2017;04;03;Tiistai;2;0;2
624;25.04.2017;2017;04;04;Tiistai;0;0;0
624;25.04.2017;2017;04;05;Tiistai;0;1;1
624;25.04.2017;2017;04;06;Tiistai;0;7;7
624;25.04.2017;2017;04;07;Tiistai;5;21;26
624;25.04.2017;2017;04;08;Tiistai;9;63;72
624;25.04.2017;2017;04;09;Tiistai;8;66;74
624;25.04.2017;2017;04;10;Tiistai;3;28;31
624;25.04.2017;2017;04;11;Tiistai;2;18;20
624;25.04.2017;2017;04;12;Tiistai;9;20;29
624;25.04.2017;2017;04;13;Tiistai;4;18;22
624;25.04.2017;2017;04;14;Tiistai;4;21;25
624;25.04.2017;2017;04;15;Tiistai;10;11;21
624;25.04.2017;2017;04;16;Tiistai;13;27;40
624;25.04.2017;2017;04;17;Tiistai;11;41;52
624;25.04.2017;2017;04;18;Tiistai;7;19;26
624;25.04.2017;2017;04;19;Tiistai;4;26;30
624;25.04.2017;2017;04;20;Tiistai;6;13;19
624;25.04.2017;2017;04;21;Tiistai;2;11;13
624;25.04.2017;2017;04;22;Tiistai;6;6;12
624;25.04.2017;2017;04;23;Tiistai;2;6;8
624;26.04.2017;2017;04;00;Keskiviikko;2;1;3
624;26.04.2017;2017;04;01;Keskiviikko;0;2;2
624;26.04.2017;2017;04;02;Keskiviikko;0;0;0
624;26.04.2017;2017;04;03;Keskiviikko;1;2;3
624;26.04.2017;2017;04;04;Keskiviikko;0;0;0
624;26.04.2017;2017;04;05;Keskiviikko;0;0;0
624;26.04.2017;2017;04;06;Keskiviikko;0;7;7
624;26.04.2017;2017;04;07;Keskiviikko;1;23;24
624;26.04.2017;2017;04;08;Keskiviikko;9;50;59
624;26.04.2017;2017;04;09;Keskiviikko;8;41;49
624;26.04.2017;2017;04;10;Keskiviikko;2;13;15
624;26.04.2017;2017;04;11;Keskiviikko;1;11;12
624;26.04.2017;2017;04;12;Keskiviikko;2;11;13
624;26.04.2017;2017;04;13;Keskiviikko;3;7;10
624;26.04.2017;2017;04;14;Keskiviikko;5;12;17
624;26.04.2017;2017;04;15;Keskiviikko;4;11;15
624;26.04.2017;2017;04;16;Keskiviikko;6;18;24
624;26.04.2017;2017;04;17;Keskiviikko;11;26;37
624;26.04.2017;2017;04;18;Keskiviikko;1;18;19
624;26.04.2017;2017;04;19;Keskiviikko;9;11;20
624;26.04.2017;2017;04;20;Keskiviikko;5;4;9
624;26.04.2017;2017;04;21;Keskiviikko;2;3;5
624;26.04.2017;2017;04;22;Keskiviikko;4;3;7
624;26.04.2017;2017;04;23;Keskiviikko;3;0;3
624;27.04.2017;2017;04;00;Torstai;1;2;3
624;27.04.2017;2017;04;01;Torstai;0;0;0
624;27.04.2017;2017;04;02;Torstai;1;0;1
624;27.04.2017;2017;04;03;Torstai;0;0;0
624;27.04.2017;2017;04;04;Torstai;0;0;0
624;27.04.2017;2017;04;05;Torstai;1;0;1
624;27.04.2017;2017;04;06;Torstai;0;4;4
624;27.04.2017;2017;04;07;Torstai;6;18;24
624;27.04.2017;2017;04;08;Torstai;2;29;31
624;27.04.2017;2017;04;09;Torstai;7;36;43
624;27.04.2017;2017;04;10;Torstai;1;12;13
624;27.04.2017;2017;04;11;Torstai;6;17;23
624;27.04.2017;2017;04;12;Torstai;4;23;27
624;27.04.2017;2017;04;13;Torstai;0;20;20
624;27.04.2017;2017;04;14;Torstai;5;10;15
624;27.04.2017;2017;04;15;Torstai;8;19;27
624;27.04.2017;2017;04;16;Torstai;10;35;45
624;27.04.2017;2017;04;17;Torstai;15;29;44
624;27.04.2017;2017;04;18;Torstai;5;16;21
624;27.04.2017;2017;04;19;Torstai;8;21;29
624;27.04.2017;2017;04;20;Torstai;8;16;24
624;27.04.2017;2017;04;21;Torstai;4;3;7
624;27.04.2017;2017;04;22;Torstai;8;7;15
624;27.04.2017;2017;04;23;Torstai;3;6;9
624;28.04.2017;2017;04;00;Perjantai;0;0;0
624;28.04.2017;2017;04;01;Perjantai;1;0;1
624;28.04.2017;2017;04;02;Perjantai;0;1;1
624;28.04.2017;2017;04;03;Perjantai;0;0;0
624;28.04.2017;2017;04;04;Perjantai;3;0;3
624;28.04.2017;2017;04;05;Perjantai;1;0;1
624;28.04.2017;2017;04;06;Perjantai;0;8;8
624;28.04.2017;2017;04;07;Perjantai;1;16;17
624;28.04.2017;2017;04;08;Perjantai;4;42;46
624;28.04.2017;2017;04;09;Perjantai;3;55;58
624;28.04.2017;2017;04;10;Perjantai;3;29;32
624;28.04.2017;2017;04;11;Perjantai;2;15;17
624;28.04.2017;2017;04;12;Perjantai;7;23;30
624;28.04.2017;2017;04;13;Perjantai;5;25;30
624;28.04.2017;2017;04;14;Perjantai;7;16;23
624;28.04.2017;2017;04;15;Perjantai;7;20;27
624;28.04.2017;2017;04;16;Perjantai;6;26;32
624;28.04.2017;2017;04;17;Perjantai;9;20;29
624;28.04.2017;2017;04;18;Perjantai;4;19;23
624;28.04.2017;2017;04;19;Perjantai;6;14;20
624;28.04.2017;2017;04;20;Perjantai;4;10;14
624;28.04.2017;2017;04;21;Perjantai;4;11;15
624;28.04.2017;2017;04;22;Perjantai;5;7;12
624;28.04.2017;2017;04;23;Perjantai;3;3;6
624;29.04.2017;2017;04;00;Lauantai;3;6;9
624;29.04.2017;2017;04;01;Lauantai;5;1;6
624;29.04.2017;2017;04;02;Lauantai;1;1;2
624;29.04.2017;2017;04;03;Lauantai;1;0;1
624;29.04.2017;2017;04;04;Lauantai;1;1;2
624;29.04.2017;2017;04;05;Lauantai;0;2;2
624;29.04.2017;2017;04;06;Lauantai;0;2;2
624;29.04.2017;2017;04;07;Lauantai;1;4;5
624;29.04.2017;2017;04;08;Lauantai;1;3;4
624;29.04.2017;2017;04;09;Lauantai;3;10;13
624;29.04.2017;2017;04;10;Lauantai;0;12;12
624;29.04.2017;2017;04;11;Lauantai;3;8;11
624;29.04.2017;2017;04;12;Lauantai;5;19;24
624;29.04.2017;2017;04;13;Lauantai;5;25;30
624;29.04.2017;2017;04;14;Lauantai;4;25;29
624;29.04.2017;2017;04;15;Lauantai;10;11;21
624;29.04.2017;2017;04;16;Lauantai;5;13;18
624;29.04.2017;2017;04;17;Lauantai;7;7;14
624;29.04.2017;2017;04;18;Lauantai;4;14;18
624;29.04.2017;2017;04;19;Lauantai;10;6;16
624;29.04.2017;2017;04;20;Lauantai;8;9;17
624;29.04.2017;2017;04;21;Lauantai;3;7;10
624;29.04.2017;2017;04;22;Lauantai;3;2;5
624;29.04.2017;2017;04;23;Lauantai;5;6;11
624;30.04.2017;2017;04;00;Sunnuntai;1;3;4
624;30.04.2017;2017;04;01;Sunnuntai;2;4;6
624;30.04.2017;2017;04;02;Sunnuntai;1;4;5
624;30.04.2017;2017;04;03;Sunnuntai;2;1;3
624;30.04.2017;2017;04;04;Sunnuntai;1;2;3
624;30.04.2017;2017;04;05;Sunnuntai;3;0;3
624;30.04.2017;2017;04;06;Sunnuntai;0;0;0
624;30.04.2017;2017;04;07;Sunnuntai;0;2;2
624;30.04.2017;2017;04;08;Sunnuntai;0;6;6
624;30.04.2017;2017;04;09;Sunnuntai;1;1;2
624;30.04.2017;2017;04;10;Sunnuntai;1;6;7
624;30.04.2017;2017;04;11;Sunnuntai;2;4;6
624;30.04.2017;2017;04;12;Sunnuntai;11;19;30
624;30.04.2017;2017;04;13;Sunnuntai;13;7;20
624;30.04.2017;2017;04;14;Sunnuntai;9;14;23
624;30.04.2017;2017;04;15;Sunnuntai;7;25;32
624;30.04.2017;2017;04;16;Sunnuntai;10;26;36
624;30.04.2017;2017;04;17;Sunnuntai;1;24;25
624;30.04.2017;2017;04;18;Sunnuntai;4;8;12
624;30.04.2017;2017;04;19;Sunnuntai;3;12;15
624;30.04.2017;2017;04;20;Sunnuntai;2;14;16
624;30.04.2017;2017;04;21;Sunnuntai;3;9;12
624;30.04.2017;2017;04;22;Sunnuntai;2;5;7
624;30.04.2017;2017;04;23;Sunnuntai;4;7;11
624;01.05.2017;2017;05;00;Maanantai;1;3;4
624;01.05.2017;2017;05;01;Maanantai;2;4;6
624;01.05.2017;2017;05;02;Maanantai;1;4;5
624;01.05.2017;2017;05;03;Maanantai;2;1;3
624;01.05.2017;2017;05;04;Maanantai;1;2;3
624;01.05.2017;2017;05;05;Maanantai;3;0;3
624;01.05.2017;2017;05;06;Maanantai;0;0;0
624;01.05.2017;2017;05;07;Maanantai;0;2;2
624;01.05.2017;2017;05;08;Maanantai;0;6;6
624;01.05.2017;2017;05;09;Maanantai;1;1;2
624;01.05.2017;2017;05;10;Maanantai;1;6;7
624;01.05.2017;2017;05;11;Maanantai;2;4;6
624;01.05.2017;2017;05;12;Maanantai;11;19;30
624;01.05.2017;2017;05;13;Maanantai;13;7;20
624;01.05.2017;2017;05;14;Maanantai;9;14;23
624;01.05.2017;2017;05;15;Maanantai;7;25;32
624;01.05.2017;2017;05;16;Maanantai;10;26;36
624;01.05.2017;2017;05;17;Maanantai;1;24;25
624;01.05.2017;2017;05;18;Maanantai;4;8;12
624;01.05.2017;2017;05;19;Maanantai;3;12;15
624;01.05.2017;2017;05;20;Maanantai;2;14;16
624;01.05.2017;2017;05;21;Maanantai;3;9;12
624;01.05.2017;2017;05;22;Maanantai;2;5;7
624;01.05.2017;2017;05;23;Maanantai;4;7;11
624;02.05.2017;2017;05;00;Tiistai;2;5;7
624;02.05.2017;2017;05;01;Tiistai;2;1;3
624;02.05.2017;2017;05;02;Tiistai;1;0;1
624;02.05.2017;2017;05;03;Tiistai;2;0;2
624;02.05.2017;2017;05;04;Tiistai;0;0;0
624;02.05.2017;2017;05;05;Tiistai;0;1;1
624;02.05.2017;2017;05;06;Tiistai;0;7;7
624;02.05.2017;2017;05;07;Tiistai;5;21;26
624;02.05.2017;2017;05;08;Tiistai;9;63;72
624;02.05.2017;2017;05;09;Tiistai;8;66;74
624;02.05.2017;2017;05;10;Tiistai;3;28;31
624;02.05.2017;2017;05;11;Tiistai;2;18;20
624;02.05.2017;2017;05;12;Tiistai;9;20;29
624;02.05.2017;2017;05;13;Tiistai;4;18;22
624;02.05.2017;2017;05;14;Tiistai;4;21;25
624;02.05.2017;2017;05;15;Tiistai;10;11;21
624;02.05.2017;2017;05;16;Tiistai;13;27;40
624;02.05.2017;2017;05;17;Tiistai;11;41;52
624;02.05.2017;2017;05;18;Tiistai;7;19;26
624;02.05.2017;2017;05;19;Tiistai;4;26;30
624;02.05.2017;2017;05;20;Tiistai;6;13;19
624;02.05.2017;2017;05;21;Tiistai;2;11;13
624;02.05.2017;2017;05;22;Tiistai;6;6;12
624;02.05.2017;2017;05;23;Tiistai;2;6;8
624;03.05.2017;2017;05;00;Keskiviikko;2;1;3
624;03.05.2017;2017;05;01;Keskiviikko;0;2;2
624;03.05.2017;2017;05;02;Keskiviikko;0;0;0
624;03.05.2017;2017;05;03;Keskiviikko;1;2;3
624;03.05.2017;2017;05;04;Keskiviikko;0;0;0
624;03.05.2017;2017;05;05;Keskiviikko;0;0;0
624;03.05.2017;2017;05;06;Keskiviikko;0;7;7
624;03.05.2017;2017;05;07;Keskiviikko;1;23;24
624;03.05.2017;2017;05;08;Keskiviikko;9;50;59
624;03.05.2017;2017;05;09;Keskiviikko;8;41;49
624;03.05.2017;2017;05;10;Keskiviikko;2;13;15
624;03.05.2017;2017;05;11;Keskiviikko;1;11;12
624;03.05.2017;2017;05;12;Keskiviikko;2;11;13
624;03.05.2017;2017;05;13;Keskiviikko;3;7;10
624;03.05.2017;2017;05;14;Keskiviikko;5;12;17
624;03.05.2017;2017;05;15;Keskiviikko;4;11;15
624;03.05.2017;2017;05;16;Keskiviikko;6;18;24
624;03.05.2017;2017;05;17;Keskiviikko;11;26;37
624;03.05.2017;2017;05;18;Keskiviikko;1;18;19
624;03.05.2017;2017;05;19;Keskiviikko;9;11;20
624;03.05.2017;2017;05;20;Keskiviikko;5;4;9
624;03.05.2017;2017;05;21;Keskiviikko;2;3;5
624;03.05.2017;2017;05;22;Keskiviikko;4;3;7
624;03.05.2017;2017;05;23;Keskiviikko;3;0;3
624;04.05.2017;2017;05;00;Torstai;2;1;3
624;04.05.2017;2017;05;01;Torstai;1;2;3
624;04.05.2017;2017;05;02;Torstai;0;1;1
624;04.05.2017;2017;05;03;Torstai;0;2;2
624;04.05.2017;2017;05;04;Torstai;0;1;1
624;04.05.2017;2017;05;05;Torstai;0;0;0
624;04.05.2017;2017;05;06;Torstai;2;8;10
624;04.05.2017;2017;05;07;Torstai;6;17;23
624;04.05.2017;2017;05;08;Torstai;6;52;58
624;04.05.2017;2017;05;09;Torstai;10;80;90
624;04.05.2017;2017;05;10;Torstai;8;28;36
624;04.05.2017;2017;05;11;Torstai;4;26;30
624;04.05.2017;2017;05;12;Torstai;7;29;36
624;04.05.2017;2017;05;13;Torstai;10;27;37
624;04.05.2017;2017;05;14;Torstai;6;27;33
624;04.05.2017;2017;05;15;Torstai;14;25;39
624;04.05.2017;2017;05;16;Torstai;15;56;71
624;04.05.2017;2017;05;17;Torstai;23;34;57
624;04.05.2017;2017;05;18;Torstai;10;28;38
624;04.05.2017;2017;05;19;Torstai;11;28;39
624;04.05.2017;2017;05;20;Torstai;19;16;35
624;04.05.2017;2017;05;21;Torstai;12;18;30
624;04.05.2017;2017;05;22;Torstai;3;17;20
624;04.05.2017;2017;05;23;Torstai;1;5;6
624;05.05.2017;2017;05;00;Perjantai;2;1;3
624;05.05.2017;2017;05;01;Perjantai;1;2;3
624;05.05.2017;2017;05;02;Perjantai;0;1;1
624;05.05.2017;2017;05;03;Perjantai;0;2;2
624;05.05.2017;2017;05;04;Perjantai;0;1;1
624;05.05.2017;2017;05;05;Perjantai;0;0;0
624;05.05.2017;2017;05;06;Perjantai;2;8;10
624;05.05.2017;2017;05;07;Perjantai;6;17;23
624;05.05.2017;2017;05;08;Perjantai;6;52;58
624;05.05.2017;2017;05;09;Perjantai;10;80;90
624;05.05.2017;2017;05;10;Perjantai;8;28;36
624;05.05.2017;2017;05;11;Perjantai;4;20;24
624;05.05.2017;2017;05;12;Perjantai;6;21;27
624;05.05.2017;2017;05;13;Perjantai;12;29;41
624;05.05.2017;2017;05;14;Perjantai;22;25;47
624;05.05.2017;2017;05;15;Perjantai;18;43;61
624;05.05.2017;2017;05;16;Perjantai;25;33;58
624;05.05.2017;2017;05;17;Perjantai;12;32;44
624;05.05.2017;2017;05;18;Perjantai;14;33;47
624;05.05.2017;2017;05;19;Perjantai;10;26;36
624;05.05.2017;2017;05;20;Perjantai;4;18;22
624;05.05.2017;2017;05;21;Perjantai;4;21;25
624;05.05.2017;2017;05;22;Perjantai;6;13;19
624;05.05.2017;2017;05;23;Perjantai;1;11;12
624;06.05.2017;2017;05;00;Lauantai;1;3;4
624;06.05.2017;2017;05;01;Lauantai;3;1;4
624;06.05.2017;2017;05;02;Lauantai;1;4;5
624;06.05.2017;2017;05;03;Lauantai;2;0;2
624;06.05.2017;2017;05;04;Lauantai;1;0;1
624;06.05.2017;2017;05;05;Lauantai;0;0;0
624;06.05.2017;2017;05;06;Lauantai;1;1;2
624;06.05.2017;2017;05;07;Lauantai;0;5;5
624;06.05.2017;2017;05;08;Lauantai;2;8;10
624;06.05.2017;2017;05;09;Lauantai;3;11;14
624;06.05.2017;2017;05;10;Lauantai;1;14;15
624;06.05.2017;2017;05;11;Lauantai;3;20;23
624;06.05.2017;2017;05;12;Lauantai;6;16;22
624;06.05.2017;2017;05;13;Lauantai;4;15;19
624;06.05.2017;2017;05;14;Lauantai;6;20;26
624;06.05.2017;2017;05;15;Lauantai;9;15;24
624;06.05.2017;2017;05;16;Lauantai;9;14;23
624;06.05.2017;2017;05;17;Lauantai;10;21;31
624;06.05.2017;2017;05;18;Lauantai;6;15;21
624;06.05.2017;2017;05;19;Lauantai;8;15;23
624;06.05.2017;2017;05;20;Lauantai;6;11;17
624;06.05.2017;2017;05;21;Lauantai;4;14;18
624;06.05.2017;2017;05;22;Lauantai;3;9;12
624;06.05.2017;2017;05;23;Lauantai;4;5;9
624;07.05.2017;2017;05;00;Sunnuntai;1;8;9
624;07.05.2017;2017;05;01;Sunnuntai;3;3;6
624;07.05.2017;2017;05;02;Sunnuntai;6;3;9
624;07.05.2017;2017;05;03;Sunnuntai;2;2;4
624;07.05.2017;2017;05;04;Sunnuntai;2;1;3
624;07.05.2017;2017;05;05;Sunnuntai;4;1;5
624;07.05.2017;2017;05;06;Sunnuntai;2;0;2
624;07.05.2017;2017;05;07;Sunnuntai;0;2;2
624;07.05.2017;2017;05;08;Sunnuntai;0;5;5
624;07.05.2017;2017;05;09;Sunnuntai;2;1;3
624;07.05.2017;2017;05;10;Sunnuntai;3;9;12
624;07.05.2017;2017;05;11;Sunnuntai;4;10;14
624;07.05.2017;2017;05;12;Sunnuntai;1;14;15
624;07.05.2017;2017;05;13;Sunnuntai;11;31;42
624;07.05.2017;2017;05;14;Sunnuntai;4;29;33
624;07.05.2017;2017;05;15;Sunnuntai;12;13;25
624;07.05.2017;2017;05;16;Sunnuntai;11;19;30
624;07.05.2017;2017;05;17;Sunnuntai;13;17;30
624;07.05.2017;2017;05;18;Sunnuntai;7;9;16
624;07.05.2017;2017;05;19;Sunnuntai;6;11;17
624;07.05.2017;2017;05;20;Sunnuntai;4;9;13
624;07.05.2017;2017;05;21;Sunnuntai;2;11;13
624;07.05.2017;2017;05;22;Sunnuntai;7;4;11
624;07.05.2017;2017;05;23;Sunnuntai;1;3;4
624;08.05.2017;2017;05;00;Maanantai;1;0;1
624;08.05.2017;2017;05;01;Maanantai;1;4;5
624;08.05.2017;2017;05;02;Maanantai;1;1;2
624;08.05.2017;2017;05;03;Maanantai;0;0;0
624;08.05.2017;2017;05;04;Maanantai;0;0;0
624;08.05.2017;2017;05;05;Maanantai;0;1;1
624;08.05.2017;2017;05;06;Maanantai;2;8;10
624;08.05.2017;2017;05;07;Maanantai;3;31;34
624;08.05.2017;2017;05;08;Maanantai;9;61;70
624;08.05.2017;2017;05;09;Maanantai;15;60;75
624;08.05.2017;2017;05;10;Maanantai;5;22;27
624;08.05.2017;2017;05;11;Maanantai;4;23;27
624;08.05.2017;2017;05;12;Maanantai;9;19;28
624;08.05.2017;2017;05;13;Maanantai;8;26;34
624;08.05.2017;2017;05;14;Maanantai;3;18;21
624;08.05.2017;2017;05;15;Maanantai;19;19;38
624;08.05.2017;2017;05;16;Maanantai;26;33;59
624;08.05.2017;2017;05;17;Maanantai;26;48;74
624;08.05.2017;2017;05;18;Maanantai;11;21;32
624;08.05.2017;2017;05;19;Maanantai;7;18;25
624;08.05.2017;2017;05;20;Maanantai;9;20;29
624;08.05.2017;2017;05;21;Maanantai;8;4;12
624;08.05.2017;2017;05;22;Maanantai;9;10;19
624;08.05.2017;2017;05;23;Maanantai;2;4;6
624;09.05.2017;2017;05;00;Tiistai;3;2;5
624;09.05.2017;2017;05;01;Tiistai;1;2;3
624;09.05.2017;2017;05;02;Tiistai;0;0;0
624;09.05.2017;2017;05;03;Tiistai;0;0;0
624;09.05.2017;2017;05;04;Tiistai;0;1;1
624;09.05.2017;2017;05;05;Tiistai;1;3;4
624;09.05.2017;2017;05;06;Tiistai;0;7;7
624;09.05.2017;2017;05;07;Tiistai;4;26;30
624;09.05.2017;2017;05;08;Tiistai;5;67;72
624;09.05.2017;2017;05;09;Tiistai;9;67;76
624;09.05.2017;2017;05;10;Tiistai;5;27;32
624;09.05.2017;2017;05;11;Tiistai;5;24;29
624;09.05.2017;2017;05;12;Tiistai;6;20;26
624;09.05.2017;2017;05;13;Tiistai;10;22;32
624;09.05.2017;2017;05;14;Tiistai;4;17;21
624;09.05.2017;2017;05;15;Tiistai;12;29;41
624;09.05.2017;2017;05;16;Tiistai;18;32;50
624;09.05.2017;2017;05;17;Tiistai;32;39;71
624;09.05.2017;2017;05;18;Tiistai;11;32;43
624;09.05.2017;2017;05;19;Tiistai;9;13;22
624;09.05.2017;2017;05;20;Tiistai;14;10;24
624;09.05.2017;2017;05;21;Tiistai;11;15;26
624;09.05.2017;2017;05;22;Tiistai;3;12;15
624;09.05.2017;2017;05;23;Tiistai;1;5;6
624;10.05.2017;2017;05;00;Keskiviikko;5;2;7
624;10.05.2017;2017;05;01;Keskiviikko;1;1;2
624;10.05.2017;2017;05;02;Keskiviikko;1;0;1
624;10.05.2017;2017;05;03;Keskiviikko;0;2;2
624;10.05.2017;2017;05;04;Keskiviikko;2;1;3
624;10.05.2017;2017;05;05;Keskiviikko;1;0;1
624;10.05.2017;2017;05;06;Keskiviikko;1;9;10
624;10.05.2017;2017;05;07;Keskiviikko;5;27;32
624;10.05.2017;2017;05;08;Keskiviikko;8;62;70
624;10.05.2017;2017;05;09;Keskiviikko;11;57;68
624;10.05.2017;2017;05;10;Keskiviikko;8;27;35
624;10.05.2017;2017;05;11;Keskiviikko;11;32;43
624;10.05.2017;2017;05;12;Keskiviikko;10;29;39
624;10.05.2017;2017;05;13;Keskiviikko;15;26;41
624;10.05.2017;2017;05;14;Keskiviikko;10;24;34
624;10.05.2017;2017;05;15;Keskiviikko;24;17;41
624;10.05.2017;2017;05;16;Keskiviikko;20;25;45
624;10.05.2017;2017;05;17;Keskiviikko;29;41;70
624;10.05.2017;2017;05;18;Keskiviikko;18;19;37
624;10.05.2017;2017;05;19;Keskiviikko;9;16;25
624;10.05.2017;2017;05;20;Keskiviikko;8;10;18
624;10.05.2017;2017;05;21;Keskiviikko;11;9;20
624;10.05.2017;2017;05;22;Keskiviikko;10;10;20
624;10.05.2017;2017;05;23;Keskiviikko;0;5;5
624;11.05.2017;2017;05;00;Torstai;0;4;4
624;11.05.2017;2017;05;01;Torstai;0;2;2
624;11.05.2017;2017;05;02;Torstai;2;0;2
624;11.05.2017;2017;05;03;Torstai;0;1;1
624;11.05.2017;2017;05;04;Torstai;0;2;2
624;11.05.2017;2017;05;05;Torstai;0;1;1
624;11.05.2017;2017;05;06;Torstai;1;8;9
624;11.05.2017;2017;05;07;Torstai;4;28;32
624;11.05.2017;2017;05;08;Torstai;8;58;66
624;11.05.2017;2017;05;09;Torstai;8;55;63
624;11.05.2017;2017;05;10;Torstai;10;27;37
624;11.05.2017;2017;05;11;Torstai;8;24;32
624;11.05.2017;2017;05;12;Torstai;8;20;28
624;11.05.2017;2017;05;13;Torstai;6;24;30
624;11.05.2017;2017;05;14;Torstai;6;23;29
624;11.05.2017;2017;05;15;Torstai;19;19;38
624;11.05.2017;2017;05;16;Torstai;23;32;55
624;11.05.2017;2017;05;17;Torstai;20;40;60
624;11.05.2017;2017;05;18;Torstai;11;24;35
624;11.05.2017;2017;05;19;Torstai;16;17;33
624;11.05.2017;2017;05;20;Torstai;6;11;17
624;11.05.2017;2017;05;21;Torstai;6;12;18
624;11.05.2017;2017;05;22;Torstai;6;3;9
624;11.05.2017;2017;05;23;Torstai;3;7;10
624;12.05.2017;2017;05;00;Perjantai;2;4;6
624;12.05.2017;2017;05;01;Perjantai;0;0;0
624;12.05.2017;2017;05;02;Perjantai;1;2;3
624;12.05.2017;2017;05;03;Perjantai;0;1;1
624;12.05.2017;2017;05;04;Perjantai;0;1;1
624;12.05.2017;2017;05;05;Perjantai;0;0;0
624;12.05.2017;2017;05;06;Perjantai;3;9;12
624;12.05.2017;2017;05;07;Perjantai;2;25;27
624;12.05.2017;2017;05;08;Perjantai;5;51;56
624;12.05.2017;2017;05;09;Perjantai;7;70;77
624;12.05.2017;2017;05;10;Perjantai;4;30;34
624;12.05.2017;2017;05;11;Perjantai;12;15;27
624;12.05.2017;2017;05;12;Perjantai;7;17;24
624;12.05.2017;2017;05;13;Perjantai;11;26;37
624;12.05.2017;2017;05;14;Perjantai;6;14;20
624;12.05.2017;2017;05;15;Perjantai;17;21;38
624;12.05.2017;2017;05;16;Perjantai;18;24;42
624;12.05.2017;2017;05;17;Perjantai;22;24;46
624;12.05.2017;2017;05;18;Perjantai;5;20;25
624;12.05.2017;2017;05;19;Perjantai;8;30;38
624;12.05.2017;2017;05;20;Perjantai;8;19;27
624;12.05.2017;2017;05;21;Perjantai;4;12;16
624;12.05.2017;2017;05;22;Perjantai;9;10;19
624;12.05.2017;2017;05;23;Perjantai;4;5;9
624;13.05.2017;2017;05;00;Lauantai;3;5;8
624;13.05.2017;2017;05;01;Lauantai;4;0;4
624;13.05.2017;2017;05;02;Lauantai;2;4;6
624;13.05.2017;2017;05;03;Lauantai;3;1;4
624;13.05.2017;2017;05;04;Lauantai;3;0;3
624;13.05.2017;2017;05;05;Lauantai;0;2;2
624;13.05.2017;2017;05;06;Lauantai;0;0;0
624;13.05.2017;2017;05;07;Lauantai;2;4;6
624;13.05.2017;2017;05;08;Lauantai;0;6;6
624;13.05.2017;2017;05;09;Lauantai;2;11;13
624;13.05.2017;2017;05;10;Lauantai;1;14;15
624;13.05.2017;2017;05;11;Lauantai;8;15;23
624;13.05.2017;2017;05;12;Lauantai;3;18;21
624;13.05.2017;2017;05;13;Lauantai;8;25;33
624;13.05.2017;2017;05;14;Lauantai;7;17;24
624;13.05.2017;2017;05;15;Lauantai;5;10;15
624;13.05.2017;2017;05;16;Lauantai;5;17;22
624;13.05.2017;2017;05;17;Lauantai;8;19;27
624;13.05.2017;2017;05;18;Lauantai;15;22;37
624;13.05.2017;2017;05;19;Lauantai;7;12;19
624;13.05.2017;2017;05;20;Lauantai;8;11;19
624;13.05.2017;2017;05;21;Lauantai;2;6;8
624;13.05.2017;2017;05;22;Lauantai;3;9;12
624;13.05.2017;2017;05;23;Lauantai;3;7;10
624;14.05.2017;2017;05;00;Sunnuntai;3;2;5
624;14.05.2017;2017;05;01;Sunnuntai;5;0;5
624;14.05.2017;2017;05;02;Sunnuntai;0;1;1
624;14.05.2017;2017;05;03;Sunnuntai;2;1;3
624;14.05.2017;2017;05;04;Sunnuntai;0;1;1
624;14.05.2017;2017;05;05;Sunnuntai;0;0;0
624;14.05.2017;2017;05;06;Sunnuntai;1;0;1
624;14.05.2017;2017;05;07;Sunnuntai;1;3;4
624;14.05.2017;2017;05;08;Sunnuntai;1;4;5
624;14.05.2017;2017;05;09;Sunnuntai;2;2;4
624;14.05.2017;2017;05;10;Sunnuntai;2;4;6
624;14.05.2017;2017;05;11;Sunnuntai;0;3;3
624;14.05.2017;2017;05;12;Sunnuntai;4;7;11
624;14.05.2017;2017;05;13;Sunnuntai;2;7;9
624;14.05.2017;2017;05;14;Sunnuntai;3;5;8
624;14.05.2017;2017;05;15;Sunnuntai;2;2;4
624;14.05.2017;2017;05;16;Sunnuntai;3;4;7
624;14.05.2017;2017;05;17;Sunnuntai;2;8;10
624;14.05.2017;2017;05;18;Sunnuntai;5;8;13
624;14.05.2017;2017;05;19;Sunnuntai;1;5;6
624;14.05.2017;2017;05;20;Sunnuntai;1;6;7
624;14.05.2017;2017;05;21;Sunnuntai;2;2;4
624;14.05.2017;2017;05;22;Sunnuntai;3;4;7
624;14.05.2017;2017;05;23;Sunnuntai;2;5;7
624;15.05.2017;2017;05;00;Maanantai;1;0;1
624;15.05.2017;2017;05;01;Maanantai;0;2;2
624;15.05.2017;2017;05;02;Maanantai;0;0;0
624;15.05.2017;2017;05;03;Maanantai;1;1;2
624;15.05.2017;2017;05;04;Maanantai;0;0;0
624;15.05.2017;2017;05;05;Maanantai;0;1;1
624;15.05.2017;2017;05;06;Maanantai;1;9;10
624;15.05.2017;2017;05;07;Maanantai;3;30;33
624;15.05.2017;2017;05;08;Maanantai;9;59;68
624;15.05.2017;2017;05;09;Maanantai;12;68;80
624;15.05.2017;2017;05;10;Maanantai;3;27;30
624;15.05.2017;2017;05;11;Maanantai;5;25;30
624;15.05.2017;2017;05;12;Maanantai;7;27;34
624;15.05.2017;2017;05;13;Maanantai;10;17;27
624;15.05.2017;2017;05;14;Maanantai;3;12;15
624;15.05.2017;2017;05;15;Maanantai;17;32;49
624;15.05.2017;2017;05;16;Maanantai;14;20;34
624;15.05.2017;2017;05;17;Maanantai;15;32;47
624;15.05.2017;2017;05;18;Maanantai;11;17;28
624;15.05.2017;2017;05;19;Maanantai;10;23;33
624;15.05.2017;2017;05;20;Maanantai;8;19;27
624;15.05.2017;2017;05;21;Maanantai;7;7;14
624;15.05.2017;2017;05;22;Maanantai;6;9;15
624;15.05.2017;2017;05;23;Maanantai;4;5;9
624;16.05.2017;2017;05;00;Tiistai;3;3;6
624;16.05.2017;2017;05;01;Tiistai;1;3;4
624;16.05.2017;2017;05;02;Tiistai;0;1;1
624;16.05.2017;2017;05;03;Tiistai;0;0;0
624;16.05.2017;2017;05;04;Tiistai;0;0;0
624;16.05.2017;2017;05;05;Tiistai;1;0;1
624;16.05.2017;2017;05;06;Tiistai;0;8;8
624;16.05.2017;2017;05;07;Tiistai;3;33;36
624;16.05.2017;2017;05;08;Tiistai;10;68;78
624;16.05.2017;2017;05;09;Tiistai;6;68;74
624;16.05.2017;2017;05;10;Tiistai;3;23;26
624;16.05.2017;2017;05;11;Tiistai;5;25;30
624;16.05.2017;2017;05;12;Tiistai;10;27;37
624;16.05.2017;2017;05;13;Tiistai;9;22;31
624;16.05.2017;2017;05;14;Tiistai;6;22;28
624;16.05.2017;2017;05;15;Tiistai;16;25;41
624;16.05.2017;2017;05;16;Tiistai;28;36;64
624;16.05.2017;2017;05;17;Tiistai;23;37;60
624;16.05.2017;2017;05;18;Tiistai;23;36;59
624;16.05.2017;2017;05;19;Tiistai;13;11;24
624;16.05.2017;2017;05;20;Tiistai;8;20;28
624;16.05.2017;2017;05;21;Tiistai;3;18;21
624;16.05.2017;2017;05;22;Tiistai;10;4;14
624;16.05.2017;2017;05;23;Tiistai;1;5;6
624;17.05.2017;2017;05;00;Keskiviikko;2;3;5
624;17.05.2017;2017;05;01;Keskiviikko;0;3;3
624;17.05.2017;2017;05;02;Keskiviikko;0;1;1
624;17.05.2017;2017;05;03;Keskiviikko;0;0;0
624;17.05.2017;2017;05;04;Keskiviikko;0;1;1
624;17.05.2017;2017;05;05;Keskiviikko;0;2;2
624;17.05.2017;2017;05;06;Keskiviikko;1;10;11
624;17.05.2017;2017;05;07;Keskiviikko;3;25;28
624;17.05.2017;2017;05;08;Keskiviikko;7;54;61
624;17.05.2017;2017;05;09;Keskiviikko;10;51;61
624;17.05.2017;2017;05;10;Keskiviikko;2;17;19
624;17.05.2017;2017;05;11;Keskiviikko;2;14;16
624;17.05.2017;2017;05;12;Keskiviikko;5;10;15
624;17.05.2017;2017;05;13;Keskiviikko;4;13;17
624;17.05.2017;2017;05;14;Keskiviikko;4;9;13
624;17.05.2017;2017;05;15;Keskiviikko;8;14;22
624;17.05.2017;2017;05;16;Keskiviikko;11;30;41
624;17.05.2017;2017;05;17;Keskiviikko;18;26;44
624;17.05.2017;2017;05;18;Keskiviikko;9;16;25
624;17.05.2017;2017;05;19;Keskiviikko;9;10;19
624;17.05.2017;2017;05;20;Keskiviikko;5;9;14
624;17.05.2017;2017;05;21;Keskiviikko;5;6;11
624;17.05.2017;2017;05;22;Keskiviikko;3;7;10
624;17.05.2017;2017;05;23;Keskiviikko;0;1;1
624;18.05.2017;2017;05;00;Torstai;1;1;2
624;18.05.2017;2017;05;01;Torstai;0;1;1
624;18.05.2017;2017;05;02;Torstai;1;1;2
624;18.05.2017;2017;05;03;Torstai;0;0;0
624;18.05.2017;2017;05;04;Torstai;1;0;1
624;18.05.2017;2017;05;05;Torstai;1;2;3
624;18.05.2017;2017;05;06;Torstai;1;7;8
624;18.05.2017;2017;05;07;Torstai;4;22;26
624;18.05.2017;2017;05;08;Torstai;6;50;56
624;18.05.2017;2017;05;09;Torstai;12;50;62
624;18.05.2017;2017;05;10;Torstai;3;37;40
624;18.05.2017;2017;05;11;Torstai;0;21;21
624;18.05.2017;2017;05;12;Torstai;7;22;29
624;18.05.2017;2017;05;13;Torstai;9;19;28
624;18.05.2017;2017;05;14;Torstai;8;15;23
624;18.05.2017;2017;05;15;Torstai;13;17;30
624;18.05.2017;2017;05;16;Torstai;19;30;49
624;18.05.2017;2017;05;17;Torstai;19;44;63
624;18.05.2017;2017;05;18;Torstai;3;14;17
624;18.05.2017;2017;05;19;Torstai;13;13;26
624;18.05.2017;2017;05;20;Torstai;6;5;11
624;18.05.2017;2017;05;21;Torstai;6;12;18
624;18.05.2017;2017;05;22;Torstai;6;7;13
624;18.05.2017;2017;05;23;Torstai;3;6;9
624;19.05.2017;2017;05;00;Perjantai;1;3;4
624;19.05.2017;2017;05;01;Perjantai;1;3;4
624;19.05.2017;2017;05;02;Perjantai;0;1;1
624;19.05.2017;2017;05;03;Perjantai;0;0;0
624;19.05.2017;2017;05;04;Perjantai;0;0;0
624;19.05.2017;2017;05;05;Perjantai;1;0;1
624;19.05.2017;2017;05;06;Perjantai;2;7;9
624;19.05.2017;2017;05;07;Perjantai;3;12;15
624;19.05.2017;2017;05;08;Perjantai;3;30;33
624;19.05.2017;2017;05;09;Perjantai;9;26;35
624;19.05.2017;2017;05;10;Perjantai;2;16;18
624;19.05.2017;2017;05;11;Perjantai;2;9;11
624;19.05.2017;2017;05;12;Perjantai;7;15;22
624;19.05.2017;2017;05;13;Perjantai;2;14;16
624;19.05.2017;2017;05;14;Perjantai;14;17;31
624;19.05.2017;2017;05;15;Perjantai;10;19;29
624;19.05.2017;2017;05;16;Perjantai;13;13;26
624;19.05.2017;2017;05;17;Perjantai;10;24;34
624;19.05.2017;2017;05;18;Perjantai;8;20;28
624;19.05.2017;2017;05;19;Perjantai;7;20;27
624;19.05.2017;2017;05;20;Perjantai;3;12;15
624;19.05.2017;2017;05;21;Perjantai;5;14;19
624;19.05.2017;2017;05;22;Perjantai;4;8;12
624;19.05.2017;2017;05;23;Perjantai;0;5;5
624;20.05.2017;2017;05;00;Lauantai;2;1;3
624;20.05.2017;2017;05;01;Lauantai;1;0;1
624;20.05.2017;2017;05;02;Lauantai;3;2;5
624;20.05.2017;2017;05;03;Lauantai;2;0;2
624;20.05.2017;2017;05;04;Lauantai;0;3;3
624;20.05.2017;2017;05;05;Lauantai;1;0;1
624;20.05.2017;2017;05;06;Lauantai;0;0;0
624;20.05.2017;2017;05;07;Lauantai;0;2;2
624;20.05.2017;2017;05;08;Lauantai;0;5;5
624;20.05.2017;2017;05;09;Lauantai;1;8;9
624;20.05.2017;2017;05;10;Lauantai;4;12;16
624;20.05.2017;2017;05;11;Lauantai;7;22;29
624;20.05.2017;2017;05;12;Lauantai;7;20;27
624;20.05.2017;2017;05;13;Lauantai;14;30;44
624;20.05.2017;2017;05;14;Lauantai;10;27;37
624;20.05.2017;2017;05;15;Lauantai;13;9;22
624;20.05.2017;2017;05;16;Lauantai;8;22;30
624;20.05.2017;2017;05;17;Lauantai;9;15;24
624;20.05.2017;2017;05;18;Lauantai;7;17;24
624;20.05.2017;2017;05;19;Lauantai;10;11;21
624;20.05.2017;2017;05;20;Lauantai;10;20;30
624;20.05.2017;2017;05;21;Lauantai;8;15;23
624;20.05.2017;2017;05;22;Lauantai;1;2;3
624;20.05.2017;2017;05;23;Lauantai;2;3;5
624;21.05.2017;2017;05;00;Sunnuntai;6;10;16
624;21.05.2017;2017;05;01;Sunnuntai;1;5;6
624;21.05.2017;2017;05;02;Sunnuntai;3;0;3
624;21.05.2017;2017;05;03;Sunnuntai;0;1;1
624;21.05.2017;2017;05;04;Sunnuntai;4;3;7
624;21.05.2017;2017;05;05;Sunnuntai;1;1;2
624;21.05.2017;2017;05;06;Sunnuntai;2;0;2
624;21.05.2017;2017;05;07;Sunnuntai;1;4;5
624;21.05.2017;2017;05;08;Sunnuntai;3;1;4
624;21.05.2017;2017;05;09;Sunnuntai;0;2;2
624;21.05.2017;2017;05;10;Sunnuntai;2;6;8
624;21.05.2017;2017;05;11;Sunnuntai;0;12;12
624;21.05.2017;2017;05;12;Sunnuntai;8;10;18
624;21.05.2017;2017;05;13;Sunnuntai;4;17;21
624;21.05.2017;2017;05;14;Sunnuntai;2;20;22
624;21.05.2017;2017;05;15;Sunnuntai;5;27;32
624;21.05.2017;2017;05;16;Sunnuntai;10;19;29
624;21.05.2017;2017;05;17;Sunnuntai;9;22;31
624;21.05.2017;2017;05;18;Sunnuntai;6;15;21
624;21.05.2017;2017;05;19;Sunnuntai;6;12;18
624;21.05.2017;2017;05;20;Sunnuntai;7;11;18
624;21.05.2017;2017;05;21;Sunnuntai;3;16;19
624;21.05.2017;2017;05;22;Sunnuntai;4;3;7
624;21.05.2017;2017;05;23;Sunnuntai;0;2;2
624;22.05.2017;2017;05;00;Maanantai;0;0;0
624;22.05.2017;2017;05;01;Maanantai;3;6;9
624;22.05.2017;2017;05;02;Maanantai;0;0;0
624;22.05.2017;2017;05;03;Maanantai;1;1;2
624;22.05.2017;2017;05;04;Maanantai;0;0;0
624;22.05.2017;2017;05;05;Maanantai;0;1;1
624;22.05.2017;2017;05;06;Maanantai;1;9;10
624;22.05.2017;2017;05;07;Maanantai;2;22;24
624;22.05.2017;2017;05;08;Maanantai;7;76;83
624;22.05.2017;2017;05;09;Maanantai;8;64;72
624;22.05.2017;2017;05;10;Maanantai;5;42;47
624;22.05.2017;2017;05;11;Maanantai;7;24;31
624;22.05.2017;2017;05;12;Maanantai;9;16;25
624;22.05.2017;2017;05;13;Maanantai;12;44;56
624;22.05.2017;2017;05;14;Maanantai;4;28;32
624;22.05.2017;2017;05;15;Maanantai;16;24;40
624;22.05.2017;2017;05;16;Maanantai;17;42;59
624;22.05.2017;2017;05;17;Maanantai;28;48;76
624;22.05.2017;2017;05;18;Maanantai;20;26;46
624;22.05.2017;2017;05;19;Maanantai;17;28;45
624;22.05.2017;2017;05;20;Maanantai;14;21;35
624;22.05.2017;2017;05;21;Maanantai;7;17;24
624;22.05.2017;2017;05;22;Maanantai;6;15;21
624;22.05.2017;2017;05;23;Maanantai;2;7;9
624;23.05.2017;2017;05;00;Tiistai;1;3;4
624;23.05.2017;2017;05;01;Tiistai;0;0;0
624;23.05.2017;2017;05;02;Tiistai;0;0;0
624;23.05.2017;2017;05;03;Tiistai;1;0;1
624;23.05.2017;2017;05;04;Tiistai;0;2;2
624;23.05.2017;2017;05;05;Tiistai;3;0;3
624;23.05.2017;2017;05;06;Tiistai;2;10;12
624;23.05.2017;2017;05;07;Tiistai;7;34;41
624;23.05.2017;2017;05;08;Tiistai;10;67;77
624;23.05.2017;2017;05;09;Tiistai;9;65;74
624;23.05.2017;2017;05;10;Tiistai;6;36;42
624;23.05.2017;2017;05;11;Tiistai;1;24;25
624;23.05.2017;2017;05;12;Tiistai;10;29;39
624;23.05.2017;2017;05;13;Tiistai;13;25;38
624;23.05.2017;2017;05;14;Tiistai;9;21;30
624;23.05.2017;2017;05;15;Tiistai;14;24;38
624;23.05.2017;2017;05;16;Tiistai;13;34;47
624;23.05.2017;2017;05;17;Tiistai;24;58;82
624;23.05.2017;2017;05;18;Tiistai;9;32;41
624;23.05.2017;2017;05;19;Tiistai;13;13;26
624;23.05.2017;2017;05;20;Tiistai;18;12;30
624;23.05.2017;2017;05;21;Tiistai;6;14;20
624;23.05.2017;2017;05;22;Tiistai;3;9;12
624;23.05.2017;2017;05;23;Tiistai;0;12;12
624;24.05.2017;2017;05;00;Keskiviikko;4;0;4
624;24.05.2017;2017;05;01;Keskiviikko;3;1;4
624;24.05.2017;2017;05;02;Keskiviikko;3;1;4
624;24.05.2017;2017;05;03;Keskiviikko;0;1;1
624;24.05.2017;2017;05;04;Keskiviikko;0;1;1
624;24.05.2017;2017;05;05;Keskiviikko;0;0;0
624;24.05.2017;2017;05;06;Keskiviikko;2;10;12
624;24.05.2017;2017;05;07;Keskiviikko;2;26;28
624;24.05.2017;2017;05;08;Keskiviikko;13;67;80
624;24.05.2017;2017;05;09;Keskiviikko;1;63;64
624;24.05.2017;2017;05;10;Keskiviikko;4;36;40
624;24.05.2017;2017;05;11;Keskiviikko;4;24;28
624;24.05.2017;2017;05;12;Keskiviikko;8;27;35
624;24.05.2017;2017;05;13;Keskiviikko;10;25;35
624;24.05.2017;2017;05;14;Keskiviikko;8;29;37
624;24.05.2017;2017;05;15;Keskiviikko;12;20;32
624;24.05.2017;2017;05;16;Keskiviikko;22;37;59
624;24.05.2017;2017;05;17;Keskiviikko;20;35;55
624;24.05.2017;2017;05;18;Keskiviikko;8;24;32
624;24.05.2017;2017;05;19;Keskiviikko;14;21;35
624;24.05.2017;2017;05;20;Keskiviikko;8;12;20
624;24.05.2017;2017;05;21;Keskiviikko;6;10;16
624;24.05.2017;2017;05;22;Keskiviikko;7;7;14
624;24.05.2017;2017;05;23;Keskiviikko;0;13;13
624;25.05.2017;2017;05;00;Torstai;2;8;10
624;25.05.2017;2017;05;01;Torstai;3;2;5
624;25.05.2017;2017;05;02;Torstai;5;4;9
624;25.05.2017;2017;05;03;Torstai;1;3;4
624;25.05.2017;2017;05;04;Torstai;0;1;1
624;25.05.2017;2017;05;05;Torstai;2;0;2
624;25.05.2017;2017;05;06;Torstai;1;2;3
624;25.05.2017;2017;05;07;Torstai;0;5;5
624;25.05.2017;2017;05;08;Torstai;1;6;7
624;25.05.2017;2017;05;09;Torstai;2;6;8
624;25.05.2017;2017;05;10;Torstai;1;20;21
624;25.05.2017;2017;05;11;Torstai;0;15;15
624;25.05.2017;2017;05;12;Torstai;7;21;28
624;25.05.2017;2017;05;13;Torstai;7;19;26
624;25.05.2017;2017;05;14;Torstai;8;18;26
624;25.05.2017;2017;05;15;Torstai;6;14;20
624;25.05.2017;2017;05;16;Torstai;8;17;25
624;25.05.2017;2017;05;17;Torstai;11;26;37
624;25.05.2017;2017;05;18;Torstai;6;19;25
624;25.05.2017;2017;05;19;Torstai;8;16;24
624;25.05.2017;2017;05;20;Torstai;6;19;25
624;25.05.2017;2017;05;21;Torstai;2;11;13
624;25.05.2017;2017;05;22;Torstai;5;11;16
624;25.05.2017;2017;05;23;Torstai;1;2;3
624;26.05.2017;2017;05;00;Perjantai;1;3;4
624;26.05.2017;2017;05;01;Perjantai;2;1;3
624;26.05.2017;2017;05;02;Perjantai;1;0;1
624;26.05.2017;2017;05;03;Perjantai;0;0;0
624;26.05.2017;2017;05;04;Perjantai;3;1;4
624;26.05.2017;2017;05;05;Perjantai;1;1;2
624;26.05.2017;2017;05;06;Perjantai;1;5;6
624;26.05.2017;2017;05;07;Perjantai;4;15;19
624;26.05.2017;2017;05;08;Perjantai;5;41;46
624;26.05.2017;2017;05;09;Perjantai;2;36;38
624;26.05.2017;2017;05;10;Perjantai;4;24;28
624;26.05.2017;2017;05;11;Perjantai;4;20;24
624;26.05.2017;2017;05;12;Perjantai;9;43;52
624;26.05.2017;2017;05;13;Perjantai;12;20;32
624;26.05.2017;2017;05;14;Perjantai;12;23;35
624;26.05.2017;2017;05;15;Perjantai;19;18;37
624;26.05.2017;2017;05;16;Perjantai;13;31;44
624;26.05.2017;2017;05;17;Perjantai;15;25;40
624;26.05.2017;2017;05;18;Perjantai;8;17;25
624;26.05.2017;2017;05;19;Perjantai;7;18;25
624;26.05.2017;2017;05;20;Perjantai;9;9;18
624;26.05.2017;2017;05;21;Perjantai;3;12;15
624;26.05.2017;2017;05;22;Perjantai;9;7;16
624;26.05.2017;2017;05;23;Perjantai;5;9;14
624;27.05.2017;2017;05;00;Lauantai;0;3;3
624;27.05.2017;2017;05;01;Lauantai;0;4;4
624;27.05.2017;2017;05;02;Lauantai;3;2;5
624;27.05.2017;2017;05;03;Lauantai;1;5;6
624;27.05.2017;2017;05;04;Lauantai;3;0;3
624;27.05.2017;2017;05;05;Lauantai;2;1;3
624;27.05.2017;2017;05;06;Lauantai;1;2;3
624;27.05.2017;2017;05;07;Lauantai;0;4;4
624;27.05.2017;2017;05;08;Lauantai;2;2;4
624;27.05.2017;2017;05;09;Lauantai;2;6;8
624;27.05.2017;2017;05;10;Lauantai;1;13;14
624;27.05.2017;2017;05;11;Lauantai;6;26;32
624;27.05.2017;2017;05;12;Lauantai;4;22;26
624;27.05.2017;2017;05;13;Lauantai;3;21;24
624;27.05.2017;2017;05;14;Lauantai;7;25;32
624;27.05.2017;2017;05;15;Lauantai;9;20;29
624;27.05.2017;2017;05;16;Lauantai;7;19;26
624;27.05.2017;2017;05;17;Lauantai;9;16;25
624;27.05.2017;2017;05;18;Lauantai;6;14;20
624;27.05.2017;2017;05;19;Lauantai;6;6;12
624;27.05.2017;2017;05;20;Lauantai;8;14;22
624;27.05.2017;2017;05;21;Lauantai;4;4;8
624;27.05.2017;2017;05;22;Lauantai;3;9;12
624;27.05.2017;2017;05;23;Lauantai;1;7;8
624;28.05.2017;2017;05;00;Sunnuntai;1;8;9
624;28.05.2017;2017;05;01;Sunnuntai;1;1;2
624;28.05.2017;2017;05;02;Sunnuntai;3;2;5
624;28.05.2017;2017;05;03;Sunnuntai;1;1;2
624;28.05.2017;2017;05;04;Sunnuntai;1;0;1
624;28.05.2017;2017;05;05;Sunnuntai;2;0;2
624;28.05.2017;2017;05;06;Sunnuntai;3;0;3
624;28.05.2017;2017;05;07;Sunnuntai;1;1;2
624;28.05.2017;2017;05;08;Sunnuntai;0;0;0
624;28.05.2017;2017;05;09;Sunnuntai;1;2;3
624;28.05.2017;2017;05;10;Sunnuntai;1;2;3
624;28.05.2017;2017;05;11;Sunnuntai;0;8;8
624;28.05.2017;2017;05;12;Sunnuntai;1;3;4
624;28.05.2017;2017;05;13;Sunnuntai;0;1;1
624;28.05.2017;2017;05;14;Sunnuntai;2;5;7
624;28.05.2017;2017;05;15;Sunnuntai;1;8;9
624;28.05.2017;2017;05;16;Sunnuntai;8;3;11
624;28.05.2017;2017;05;17;Sunnuntai;5;11;16
624;28.05.2017;2017;05;18;Sunnuntai;5;7;12
624;28.05.2017;2017;05;19;Sunnuntai;5;6;11
624;28.05.2017;2017;05;20;Sunnuntai;5;5;10
624;28.05.2017;2017;05;21;Sunnuntai;2;5;7
624;28.05.2017;2017;05;22;Sunnuntai;3;5;8
624;28.05.2017;2017;05;23;Sunnuntai;2;4;6
624;29.05.2017;2017;05;00;Maanantai;1;2;3
624;29.05.2017;2017;05;01;Maanantai;0;0;0
624;29.05.2017;2017;05;02;Maanantai;0;0;0
624;29.05.2017;2017;05;03;Maanantai;0;0;0
624;29.05.2017;2017;05;04;Maanantai;0;0;0
624;29.05.2017;2017;05;05;Maanantai;0;4;4
624;29.05.2017;2017;05;06;Maanantai;1;9;10
624;29.05.2017;2017;05;07;Maanantai;1;32;33
624;29.05.2017;2017;05;08;Maanantai;8;61;69
624;29.05.2017;2017;05;09;Maanantai;8;59;67
624;29.05.2017;2017;05;10;Maanantai;5;32;37
624;29.05.2017;2017;05;11;Maanantai;9;32;41
624;29.05.2017;2017;05;12;Maanantai;4;19;23
624;29.05.2017;2017;05;13;Maanantai;5;28;33
624;29.05.2017;2017;05;14;Maanantai;8;21;29
624;29.05.2017;2017;05;15;Maanantai;15;24;39
624;29.05.2017;2017;05;16;Maanantai;20;33;53
624;29.05.2017;2017;05;17;Maanantai;21;34;55
624;29.05.2017;2017;05;18;Maanantai;13;19;32
624;29.05.2017;2017;05;19;Maanantai;12;14;26
624;29.05.2017;2017;05;20;Maanantai;7;10;17
624;29.05.2017;2017;05;21;Maanantai;9;10;19
624;29.05.2017;2017;05;22;Maanantai;6;9;15
624;29.05.2017;2017;05;23;Maanantai;1;9;10
624;30.05.2017;2017;05;00;Tiistai;1;0;1
624;30.05.2017;2017;05;01;Tiistai;3;1;4
624;30.05.2017;2017;05;02;Tiistai;1;3;4
624;30.05.2017;2017;05;03;Tiistai;0;0;0
624;30.05.2017;2017;05;04;Tiistai;1;0;1
624;30.05.2017;2017;05;05;Tiistai;1;1;2
624;30.05.2017;2017;05;06;Tiistai;1;6;7
624;30.05.2017;2017;05;07;Tiistai;2;33;35
624;30.05.2017;2017;05;08;Tiistai;4;86;90
624;30.05.2017;2017;05;09;Tiistai;9;68;77
624;30.05.2017;2017;05;10;Tiistai;7;26;33
624;30.05.2017;2017;05;11;Tiistai;6;25;31
624;30.05.2017;2017;05;12;Tiistai;8;25;33
624;30.05.2017;2017;05;13;Tiistai;12;25;37
624;30.05.2017;2017;05;14;Tiistai;9;26;35
624;30.05.2017;2017;05;15;Tiistai;13;32;45
624;30.05.2017;2017;05;16;Tiistai;30;37;67
624;30.05.2017;2017;05;17;Tiistai;22;45;67
624;30.05.2017;2017;05;18;Tiistai;17;33;50
624;30.05.2017;2017;05;19;Tiistai;6;20;26
624;30.05.2017;2017;05;20;Tiistai;4;20;24
624;30.05.2017;2017;05;21;Tiistai;8;21;29
624;30.05.2017;2017;05;22;Tiistai;8;10;18
624;30.05.2017;2017;05;23;Tiistai;4;4;8
624;31.05.2017;2017;05;00;Keskiviikko;3;2;5
624;31.05.2017;2017;05;01;Keskiviikko;3;1;4
624;31.05.2017;2017;05;02;Keskiviikko;0;2;2
624;31.05.2017;2017;05;03;Keskiviikko;0;0;0
624;31.05.2017;2017;05;04;Keskiviikko;0;2;2
624;31.05.2017;2017;05;05;Keskiviikko;0;1;1
624;31.05.2017;2017;05;06;Keskiviikko;1;5;6
624;31.05.2017;2017;05;07;Keskiviikko;1;36;37
624;31.05.2017;2017;05;08;Keskiviikko;3;71;74
624;31.05.2017;2017;05;09;Keskiviikko;11;56;67
624;31.05.2017;2017;05;10;Keskiviikko;3;22;25
624;31.05.2017;2017;05;11;Keskiviikko;6;16;22
624;31.05.2017;2017;05;12;Keskiviikko;3;18;21
624;31.05.2017;2017;05;13;Keskiviikko;13;23;36
624;31.05.2017;2017;05;14;Keskiviikko;8;23;31
624;31.05.2017;2017;05;15;Keskiviikko;18;21;39
624;31.05.2017;2017;05;16;Keskiviikko;11;31;42
624;31.05.2017;2017;05;17;Keskiviikko;20;40;60
624;31.05.2017;2017;05;18;Keskiviikko;19;21;40
624;31.05.2017;2017;05;19;Keskiviikko;12;27;39
624;31.05.2017;2017;05;20;Keskiviikko;5;12;17
624;31.05.2017;2017;05;21;Keskiviikko;6;15;21
624;31.05.2017;2017;05;22;Keskiviikko;6;12;18
624;31.05.2017;2017;05;23;Keskiviikko;5;11;16
624;01.06.2017;2017;06;00;Torstai;1;5;6
624;01.06.2017;2017;06;01;Torstai;2;0;2
624;01.06.2017;2017;06;02;Torstai;1;1;2
624;01.06.2017;2017;06;03;Torstai;0;0;0
624;01.06.2017;2017;06;04;Torstai;0;0;0
624;01.06.2017;2017;06;05;Torstai;0;1;1
624;01.06.2017;2017;06;06;Torstai;2;8;10
624;01.06.2017;2017;06;07;Torstai;2;31;33
624;01.06.2017;2017;06;08;Torstai;11;70;81
624;01.06.2017;2017;06;09;Torstai;8;63;71
624;01.06.2017;2017;06;10;Torstai;7;35;42
624;01.06.2017;2017;06;11;Torstai;4;17;21
624;01.06.2017;2017;06;12;Torstai;12;23;35
624;01.06.2017;2017;06;13;Torstai;10;24;34
624;01.06.2017;2017;06;14;Torstai;10;12;22
624;01.06.2017;2017;06;15;Torstai;4;15;19
624;01.06.2017;2017;06;16;Torstai;14;12;26
624;01.06.2017;2017;06;17;Torstai;20;40;60
624;01.06.2017;2017;06;18;Torstai;19;21;40
624;01.06.2017;2017;06;19;Torstai;12;27;39
624;01.06.2017;2017;06;20;Torstai;5;12;17
624;01.06.2017;2017;06;21;Torstai;6;15;21
624;01.06.2017;2017;06;22;Torstai;6;12;18
624;01.06.2017;2017;06;23;Torstai;5;11;16
624;02.06.2017;2017;06;00;Perjantai;1;3;4
624;02.06.2017;2017;06;01;Perjantai;2;1;3
624;02.06.2017;2017;06;02;Perjantai;1;0;1
624;02.06.2017;2017;06;03;Perjantai;0;0;0
624;02.06.2017;2017;06;04;Perjantai;3;1;4
624;02.06.2017;2017;06;05;Perjantai;1;1;2
624;02.06.2017;2017;06;06;Perjantai;1;5;6
624;02.06.2017;2017;06;07;Perjantai;4;15;19
624;02.06.2017;2017;06;08;Perjantai;5;41;46
624;02.06.2017;2017;06;09;Perjantai;2;36;38
624;02.06.2017;2017;06;10;Perjantai;4;24;28
624;02.06.2017;2017;06;11;Perjantai;4;20;24
624;02.06.2017;2017;06;12;Perjantai;9;43;52
624;02.06.2017;2017;06;13;Perjantai;12;20;32
624;02.06.2017;2017;06;14;Perjantai;12;23;35
624;02.06.2017;2017;06;15;Perjantai;19;18;37
624;02.06.2017;2017;06;16;Perjantai;13;31;44
624;02.06.2017;2017;06;17;Perjantai;15;25;40
624;02.06.2017;2017;06;18;Perjantai;10;18;28
624;02.06.2017;2017;06;19;Perjantai;11;18;29
624;02.06.2017;2017;06;20;Perjantai;7;13;20
624;02.06.2017;2017;06;21;Perjantai;10;16;26
624;02.06.2017;2017;06;22;Perjantai;7;5;12
624;02.06.2017;2017;06;23;Perjantai;3;9;12
624;03.06.2017;2017;06;00;Lauantai;3;4;7
624;03.06.2017;2017;06;01;Lauantai;1;4;5
624;03.06.2017;2017;06;02;Lauantai;1;2;3
624;03.06.2017;2017;06;03;Lauantai;2;2;4
624;03.06.2017;2017;06;04;Lauantai;1;2;3
624;03.06.2017;2017;06;05;Lauantai;0;0;0
624;03.06.2017;2017;06;06;Lauantai;0;2;2
624;03.06.2017;2017;06;07;Lauantai;1;4;5
624;03.06.2017;2017;06;08;Lauantai;2;8;10
624;03.06.2017;2017;06;09;Lauantai;1;8;9
624;03.06.2017;2017;06;10;Lauantai;2;18;20
624;03.06.2017;2017;06;11;Lauantai;7;13;20
624;03.06.2017;2017;06;12;Lauantai;4;20;24
624;03.06.2017;2017;06;13;Lauantai;4;25;29
624;03.06.2017;2017;06;14;Lauantai;9;9;18
624;03.06.2017;2017;06;15;Lauantai;13;11;24
624;03.06.2017;2017;06;16;Lauantai;5;11;16
624;03.06.2017;2017;06;17;Lauantai;6;17;23
624;03.06.2017;2017;06;18;Lauantai;7;18;25
624;03.06.2017;2017;06;19;Lauantai;3;9;12
624;03.06.2017;2017;06;20;Lauantai;5;14;19
624;03.06.2017;2017;06;21;Lauantai;5;17;22
624;03.06.2017;2017;06;22;Lauantai;5;4;9
624;03.06.2017;2017;06;23;Lauantai;3;9;12
624;04.06.2017;2017;06;00;Sunnuntai;1;6;7
624;04.06.2017;2017;06;01;Sunnuntai;1;5;6
624;04.06.2017;2017;06;02;Sunnuntai;3;1;4
624;04.06.2017;2017;06;03;Sunnuntai;2;1;3
624;04.06.2017;2017;06;04;Sunnuntai;4;2;6
624;04.06.2017;2017;06;05;Sunnuntai;4;1;5
624;04.06.2017;2017;06;06;Sunnuntai;2;1;3
624;04.06.2017;2017;06;07;Sunnuntai;1;3;4
624;04.06.2017;2017;06;08;Sunnuntai;0;2;2
624;04.06.2017;2017;06;09;Sunnuntai;0;4;4
624;04.06.2017;2017;06;10;Sunnuntai;5;7;12
624;04.06.2017;2017;06;11;Sunnuntai;7;8;15
624;04.06.2017;2017;06;12;Sunnuntai;5;18;23
624;04.06.2017;2017;06;13;Sunnuntai;8;23;31
624;04.06.2017;2017;06;14;Sunnuntai;12;25;37
624;04.06.2017;2017;06;15;Sunnuntai;12;21;33
624;04.06.2017;2017;06;16;Sunnuntai;7;20;27
624;04.06.2017;2017;06;17;Sunnuntai;3;11;14
624;04.06.2017;2017;06;18;Sunnuntai;6;11;17
624;04.06.2017;2017;06;19;Sunnuntai;10;12;22
624;04.06.2017;2017;06;20;Sunnuntai;9;20;29
624;04.06.2017;2017;06;21;Sunnuntai;2;5;7
624;04.06.2017;2017;06;22;Sunnuntai;3;11;14
624;04.06.2017;2017;06;23;Sunnuntai;1;6;7
624;05.06.2017;2017;06;00;Maanantai;1;4;5
624;05.06.2017;2017;06;01;Maanantai;1;3;4
624;05.06.2017;2017;06;02;Maanantai;0;0;0
624;05.06.2017;2017;06;03;Maanantai;0;0;0
624;05.06.2017;2017;06;04;Maanantai;1;0;1
624;05.06.2017;2017;06;05;Maanantai;0;0;0
624;05.06.2017;2017;06;06;Maanantai;3;10;13
624;05.06.2017;2017;06;07;Maanantai;7;37;44
624;05.06.2017;2017;06;08;Maanantai;7;64;71
624;05.06.2017;2017;06;09;Maanantai;13;61;74
624;05.06.2017;2017;06;10;Maanantai;7;42;49
624;05.06.2017;2017;06;11;Maanantai;9;34;43
624;05.06.2017;2017;06;12;Maanantai;7;23;30
624;05.06.2017;2017;06;13;Maanantai;9;38;47
624;05.06.2017;2017;06;14;Maanantai;16;32;48
624;05.06.2017;2017;06;15;Maanantai;12;19;31
624;05.06.2017;2017;06;16;Maanantai;31;41;72
624;05.06.2017;2017;06;17;Maanantai;22;33;55
624;05.06.2017;2017;06;18;Maanantai;15;31;46
624;05.06.2017;2017;06;19;Maanantai;17;25;42
624;05.06.2017;2017;06;20;Maanantai;15;18;33
624;05.06.2017;2017;06;21;Maanantai;10;21;31
624;05.06.2017;2017;06;22;Maanantai;5;15;20
624;05.06.2017;2017;06;23;Maanantai;3;3;6
624;06.06.2017;2017;06;00;Tiistai;0;3;3
624;06.06.2017;2017;06;01;Tiistai;0;2;2
624;06.06.2017;2017;06;02;Tiistai;0;3;3
624;06.06.2017;2017;06;03;Tiistai;1;1;2
624;06.06.2017;2017;06;04;Tiistai;0;1;1
624;06.06.2017;2017;06;05;Tiistai;2;0;2
624;06.06.2017;2017;06;06;Tiistai;4;7;11
624;06.06.2017;2017;06;07;Tiistai;1;35;36
624;06.06.2017;2017;06;08;Tiistai;12;58;70
624;06.06.2017;2017;06;09;Tiistai;13;49;62
624;06.06.2017;2017;06;10;Tiistai;8;23;31
624;06.06.2017;2017;06;11;Tiistai;6;20;26
624;06.06.2017;2017;06;12;Tiistai;5;18;23
624;06.06.2017;2017;06;13;Tiistai;12;23;35
624;06.06.2017;2017;06;14;Tiistai;12;25;37
624;06.06.2017;2017;06;15;Tiistai;9;19;28
624;06.06.2017;2017;06;16;Tiistai;20;38;58
624;06.06.2017;2017;06;17;Tiistai;16;44;60
624;06.06.2017;2017;06;18;Tiistai;15;44;59
624;06.06.2017;2017;06;19;Tiistai;16;28;44
624;06.06.2017;2017;06;20;Tiistai;13;22;35
624;06.06.2017;2017;06;21;Tiistai;11;23;34
624;06.06.2017;2017;06;22;Tiistai;5;8;13
624;06.06.2017;2017;06;23;Tiistai;5;7;12
624;07.06.2017;2017;06;00;Keskiviikko;2;4;6
624;07.06.2017;2017;06;01;Keskiviikko;3;4;7
624;07.06.2017;2017;06;02;Keskiviikko;1;0;1
624;07.06.2017;2017;06;03;Keskiviikko;1;1;2
624;07.06.2017;2017;06;04;Keskiviikko;0;0;0
624;07.06.2017;2017;06;05;Keskiviikko;1;0;1
624;07.06.2017;2017;06;06;Keskiviikko;2;12;14
624;07.06.2017;2017;06;07;Keskiviikko;6;41;47
624;07.06.2017;2017;06;08;Keskiviikko;20;75;95
624;07.06.2017;2017;06;09;Keskiviikko;14;62;76
624;07.06.2017;2017;06;10;Keskiviikko;15;34;49
624;07.06.2017;2017;06;11;Keskiviikko;10;39;49
624;07.06.2017;2017;06;12;Keskiviikko;5;36;41
624;07.06.2017;2017;06;13;Keskiviikko;12;32;44
624;07.06.2017;2017;06;14;Keskiviikko;27;36;63
624;07.06.2017;2017;06;15;Keskiviikko;20;40;60
624;07.06.2017;2017;06;16;Keskiviikko;28;62;90
624;07.06.2017;2017;06;17;Keskiviikko;24;74;98
624;07.06.2017;2017;06;18;Keskiviikko;17;58;75
624;07.06.2017;2017;06;19;Keskiviikko;11;50;61
624;07.06.2017;2017;06;20;Keskiviikko;14;27;41
624;07.06.2017;2017;06;21;Keskiviikko;15;26;41
624;07.06.2017;2017;06;22;Keskiviikko;12;14;26
624;07.06.2017;2017;06;23;Keskiviikko;5;10;15
624;08.06.2017;2017;06;00;Torstai;2;8;10
624;08.06.2017;2017;06;01;Torstai;1;7;8
624;08.06.2017;2017;06;02;Torstai;1;1;2
624;08.06.2017;2017;06;03;Torstai;2;2;4
624;08.06.2017;2017;06;04;Torstai;1;0;1
624;08.06.2017;2017;06;05;Torstai;0;2;2
624;08.06.2017;2017;06;06;Torstai;1;9;10
624;08.06.2017;2017;06;07;Torstai;7;34;41
624;08.06.2017;2017;06;08;Torstai;19;78;97
624;08.06.2017;2017;06;09;Torstai;12;77;89
624;08.06.2017;2017;06;10;Torstai;5;30;35
624;08.06.2017;2017;06;11;Torstai;11;38;49
624;08.06.2017;2017;06;12;Torstai;10;28;38
624;08.06.2017;2017;06;13;Torstai;13;36;49
624;08.06.2017;2017;06;14;Torstai;8;28;36
624;08.06.2017;2017;06;15;Torstai;16;35;51
624;08.06.2017;2017;06;16;Torstai;18;55;73
624;08.06.2017;2017;06;17;Torstai;26;65;91
624;08.06.2017;2017;06;18;Torstai;21;55;76
624;08.06.2017;2017;06;19;Torstai;20;27;47
624;08.06.2017;2017;06;20;Torstai;11;26;37
624;08.06.2017;2017;06;21;Torstai;19;31;50
624;08.06.2017;2017;06;22;Torstai;24;15;39
624;08.06.2017;2017;06;23;Torstai;3;14;17
624;09.06.2017;2017;06;00;Perjantai;7;7;14
624;09.06.2017;2017;06;01;Perjantai;4;2;6
624;09.06.2017;2017;06;02;Perjantai;1;1;2
624;09.06.2017;2017;06;03;Perjantai;3;4;7
624;09.06.2017;2017;06;04;Perjantai;0;0;0
624;09.06.2017;2017;06;05;Perjantai;3;1;4
624;09.06.2017;2017;06;06;Perjantai;3;9;12
624;09.06.2017;2017;06;07;Perjantai;3;39;42
624;09.06.2017;2017;06;08;Perjantai;13;53;66
624;09.06.2017;2017;06;09;Perjantai;7;57;64
624;09.06.2017;2017;06;10;Perjantai;8;39;47
624;09.06.2017;2017;06;11;Perjantai;4;25;29
624;09.06.2017;2017;06;12;Perjantai;13;43;56
624;09.06.2017;2017;06;13;Perjantai;13;37;50
624;09.06.2017;2017;06;14;Perjantai;16;39;55
624;09.06.2017;2017;06;15;Perjantai;23;45;68
624;09.06.2017;2017;06;16;Perjantai;29;50;79
624;09.06.2017;2017;06;17;Perjantai;20;36;56
624;09.06.2017;2017;06;18;Perjantai;16;28;44
624;09.06.2017;2017;06;19;Perjantai;16;36;52
624;09.06.2017;2017;06;20;Perjantai;10;24;34
624;09.06.2017;2017;06;21;Perjantai;13;31;44
624;09.06.2017;2017;06;22;Perjantai;13;20;33
624;09.06.2017;2017;06;23;Perjantai;6;14;20
624;10.06.2017;2017;06;00;Lauantai;10;10;20
624;10.06.2017;2017;06;01;Lauantai;4;3;7
624;10.06.2017;2017;06;02;Lauantai;4;4;8
624;10.06.2017;2017;06;03;Lauantai;2;1;3
624;10.06.2017;2017;06;04;Lauantai;1;2;3
624;10.06.2017;2017;06;05;Lauantai;2;1;3
624;10.06.2017;2017;06;06;Lauantai;1;4;5
624;10.06.2017;2017;06;07;Lauantai;1;5;6
624;10.06.2017;2017;06;08;Lauantai;0;6;6
624;10.06.2017;2017;06;09;Lauantai;4;15;19
624;10.06.2017;2017;06;10;Lauantai;3;17;20
624;10.06.2017;2017;06;11;Lauantai;8;20;28
624;10.06.2017;2017;06;12;Lauantai;8;30;38
624;10.06.2017;2017;06;13;Lauantai;6;47;53
624;10.06.2017;2017;06;14;Lauantai;15;36;51
624;10.06.2017;2017;06;15;Lauantai;8;29;37
624;10.06.2017;2017;06;16;Lauantai;21;25;46
624;10.06.2017;2017;06;17;Lauantai;9;22;31
624;10.06.2017;2017;06;18;Lauantai;14;33;47
624;10.06.2017;2017;06;19;Lauantai;8;19;27
624;10.06.2017;2017;06;20;Lauantai;8;13;21
624;10.06.2017;2017;06;21;Lauantai;5;23;28
624;10.06.2017;2017;06;22;Lauantai;1;10;11
624;10.06.2017;2017;06;23;Lauantai;5;11;16
624;11.06.2017;2017;06;00;Sunnuntai;4;4;8
624;11.06.2017;2017;06;01;Sunnuntai;2;6;8
624;11.06.2017;2017;06;02;Sunnuntai;0;5;5
624;11.06.2017;2017;06;03;Sunnuntai;4;0;4
624;11.06.2017;2017;06;04;Sunnuntai;2;1;3
624;11.06.2017;2017;06;05;Sunnuntai;2;0;2
624;11.06.2017;2017;06;06;Sunnuntai;1;2;3
624;11.06.2017;2017;06;07;Sunnuntai;0;2;2
624;11.06.2017;2017;06;08;Sunnuntai;0;2;2
624;11.06.2017;2017;06;09;Sunnuntai;1;0;1
624;11.06.2017;2017;06;10;Sunnuntai;5;3;8
624;11.06.2017;2017;06;11;Sunnuntai;7;11;18
624;11.06.2017;2017;06;12;Sunnuntai;7;15;22
624;11.06.2017;2017;06;13;Sunnuntai;7;25;32
624;11.06.2017;2017;06;14;Sunnuntai;11;24;35
624;11.06.2017;2017;06;15;Sunnuntai;11;26;37
624;11.06.2017;2017;06;16;Sunnuntai;10;17;27
624;11.06.2017;2017;06;17;Sunnuntai;9;32;41
624;11.06.2017;2017;06;18;Sunnuntai;8;21;29
624;11.06.2017;2017;06;19;Sunnuntai;10;22;32
624;11.06.2017;2017;06;20;Sunnuntai;14;13;27
624;11.06.2017;2017;06;21;Sunnuntai;7;14;21
624;11.06.2017;2017;06;22;Sunnuntai;4;8;12
624;11.06.2017;2017;06;23;Sunnuntai;2;4;6
624;12.06.2017;2017;06;00;Maanantai;3;4;7
624;12.06.2017;2017;06;01;Maanantai;1;2;3
624;12.06.2017;2017;06;02;Maanantai;0;0;0
624;12.06.2017;2017;06;03;Maanantai;1;1;2
624;12.06.2017;2017;06;04;Maanantai;1;0;1
624;12.06.2017;2017;06;05;Maanantai;0;3;3
624;12.06.2017;2017;06;06;Maanantai;0;11;11
624;12.06.2017;2017;06;07;Maanantai;2;33;35
624;12.06.2017;2017;06;08;Maanantai;5;58;63
624;12.06.2017;2017;06;09;Maanantai;5;54;59
624;12.06.2017;2017;06;10;Maanantai;7;22;29
624;12.06.2017;2017;06;11;Maanantai;4;13;17
624;12.06.2017;2017;06;12;Maanantai;1;10;11
624;12.06.2017;2017;06;13;Maanantai;3;16;19
624;12.06.2017;2017;06;14;Maanantai;11;24;35
624;12.06.2017;2017;06;15;Maanantai;9;18;27
624;12.06.2017;2017;06;16;Maanantai;12;35;47
624;12.06.2017;2017;06;17;Maanantai;10;42;52
624;12.06.2017;2017;06;18;Maanantai;23;31;54
624;12.06.2017;2017;06;19;Maanantai;9;20;29
624;12.06.2017;2017;06;20;Maanantai;8;16;24
624;12.06.2017;2017;06;21;Maanantai;6;21;27
624;12.06.2017;2017;06;22;Maanantai;4;9;13
624;12.06.2017;2017;06;23;Maanantai;2;4;6
624;13.06.2017;2017;06;00;Tiistai;3;2;5
624;13.06.2017;2017;06;01;Tiistai;0;0;0
624;13.06.2017;2017;06;02;Tiistai;0;1;1
624;13.06.2017;2017;06;03;Tiistai;0;0;0
624;13.06.2017;2017;06;04;Tiistai;0;1;1
624;13.06.2017;2017;06;05;Tiistai;1;4;5
624;13.06.2017;2017;06;06;Tiistai;2;5;7
624;13.06.2017;2017;06;07;Tiistai;3;44;47
624;13.06.2017;2017;06;08;Tiistai;8;71;79
624;13.06.2017;2017;06;09;Tiistai;6;56;62
624;13.06.2017;2017;06;10;Tiistai;9;22;31
624;13.06.2017;2017;06;11;Tiistai;4;25;29
624;13.06.2017;2017;06;12;Tiistai;1;15;16
624;13.06.2017;2017;06;13;Tiistai;5;26;31
624;13.06.2017;2017;06;14;Tiistai;7;22;29
624;13.06.2017;2017;06;15;Tiistai;12;24;36
624;13.06.2017;2017;06;16;Tiistai;24;37;61
624;13.06.2017;2017;06;17;Tiistai;21;62;83
624;13.06.2017;2017;06;18;Tiistai;19;29;48
624;13.06.2017;2017;06;19;Tiistai;14;25;39
624;13.06.2017;2017;06;20;Tiistai;4;15;19
624;13.06.2017;2017;06;21;Tiistai;5;22;27
624;13.06.2017;2017;06;22;Tiistai;6;6;12
624;13.06.2017;2017;06;23;Tiistai;3;4;7
624;14.06.2017;2017;06;00;Keskiviikko;2;6;8
624;14.06.2017;2017;06;01;Keskiviikko;2;0;2
624;14.06.2017;2017;06;02;Keskiviikko;1;0;1
624;14.06.2017;2017;06;03;Keskiviikko;0;0;0
624;14.06.2017;2017;06;04;Keskiviikko;0;0;0
624;14.06.2017;2017;06;05;Keskiviikko;1;0;1
624;14.06.2017;2017;06;06;Keskiviikko;2;5;7
624;14.06.2017;2017;06;07;Keskiviikko;6;35;41
624;14.06.2017;2017;06;08;Keskiviikko;4;56;60
624;14.06.2017;2017;06;09;Keskiviikko;9;62;71
624;14.06.2017;2017;06;10;Keskiviikko;4;32;36
624;14.06.2017;2017;06;11;Keskiviikko;4;23;27
624;14.06.2017;2017;06;12;Keskiviikko;10;30;40
624;14.06.2017;2017;06;13;Keskiviikko;6;27;33
624;14.06.2017;2017;06;14;Keskiviikko;6;28;34
624;14.06.2017;2017;06;15;Keskiviikko;14;34;48
624;14.06.2017;2017;06;16;Keskiviikko;25;43;68
624;14.06.2017;2017;06;17;Keskiviikko;37;61;98
624;14.06.2017;2017;06;18;Keskiviikko;15;31;46
624;14.06.2017;2017;06;19;Keskiviikko;16;22;38
624;14.06.2017;2017;06;20;Keskiviikko;9;25;34
624;14.06.2017;2017;06;21;Keskiviikko;10;22;32
624;14.06.2017;2017;06;22;Keskiviikko;10;10;20
624;14.06.2017;2017;06;23;Keskiviikko;5;12;17
624;15.06.2017;2017;06;00;Torstai;2;2;4
624;15.06.2017;2017;06;01;Torstai;0;3;3
624;15.06.2017;2017;06;02;Torstai;1;0;1
624;15.06.2017;2017;06;03;Torstai;0;1;1
624;15.06.2017;2017;06;04;Torstai;0;0;0
624;15.06.2017;2017;06;05;Torstai;0;1;1
624;15.06.2017;2017;06;06;Torstai;1;8;9
624;15.06.2017;2017;06;07;Torstai;0;38;38
624;15.06.2017;2017;06;08;Torstai;9;56;65
624;15.06.2017;2017;06;09;Torstai;11;61;72
624;15.06.2017;2017;06;10;Torstai;5;36;41
624;15.06.2017;2017;06;11;Torstai;7;22;29
624;15.06.2017;2017;06;12;Torstai;5;30;35
624;15.06.2017;2017;06;13;Torstai;7;31;38
624;15.06.2017;2017;06;14;Torstai;9;24;33
624;15.06.2017;2017;06;15;Torstai;24;39;63
624;15.06.2017;2017;06;16;Torstai;26;57;83
624;15.06.2017;2017;06;17;Torstai;29;59;88
624;15.06.2017;2017;06;18;Torstai;18;46;64
624;15.06.2017;2017;06;19;Torstai;11;35;46
624;15.06.2017;2017;06;20;Torstai;13;23;36
624;15.06.2017;2017;06;21;Torstai;10;12;22
624;15.06.2017;2017;06;22;Torstai;6;12;18
624;15.06.2017;2017;06;23;Torstai;3;1;4
624;16.06.2017;2017;06;00;Perjantai;0;2;2
624;16.06.2017;2017;06;01;Perjantai;0;0;0
624;16.06.2017;2017;06;02;Perjantai;2;5;7
624;16.06.2017;2017;06;03;Perjantai;0;0;0
624;16.06.2017;2017;06;04;Perjantai;1;0;1
624;16.06.2017;2017;06;05;Perjantai;2;0;2
624;16.06.2017;2017;06;06;Perjantai;2;5;7
624;16.06.2017;2017;06;07;Perjantai;6;36;42
624;16.06.2017;2017;06;08;Perjantai;9;51;60
624;16.06.2017;2017;06;09;Perjantai;8;48;56
624;16.06.2017;2017;06;10;Perjantai;6;28;34
624;16.06.2017;2017;06;11;Perjantai;5;33;38
624;16.06.2017;2017;06;12;Perjantai;5;29;34
624;16.06.2017;2017;06;13;Perjantai;11;33;44
624;16.06.2017;2017;06;14;Perjantai;6;32;38
624;16.06.2017;2017;06;15;Perjantai;11;32;43
624;16.06.2017;2017;06;16;Perjantai;10;59;69
624;16.06.2017;2017;06;17;Perjantai;12;42;54
624;16.06.2017;2017;06;18;Perjantai;19;26;45
624;16.06.2017;2017;06;19;Perjantai;10;31;41
624;16.06.2017;2017;06;20;Perjantai;11;21;32
624;16.06.2017;2017;06;21;Perjantai;7;16;23
624;16.06.2017;2017;06;22;Perjantai;4;11;15
624;16.06.2017;2017;06;23;Perjantai;3;7;10
624;17.06.2017;2017;06;00;Lauantai;0;8;8
624;17.06.2017;2017;06;01;Lauantai;0;1;1
624;17.06.2017;2017;06;02;Lauantai;3;3;6
624;17.06.2017;2017;06;03;Lauantai;4;3;7
624;17.06.2017;2017;06;04;Lauantai;3;1;4
624;17.06.2017;2017;06;05;Lauantai;0;1;1
624;17.06.2017;2017;06;06;Lauantai;1;1;2
624;17.06.2017;2017;06;07;Lauantai;1;4;5
624;17.06.2017;2017;06;08;Lauantai;1;0;1
624;17.06.2017;2017;06;09;Lauantai;0;5;5
624;17.06.2017;2017;06;10;Lauantai;1;23;24
624;17.06.2017;2017;06;11;Lauantai;4;27;31
624;17.06.2017;2017;06;12;Lauantai;5;33;38
624;17.06.2017;2017;06;13;Lauantai;12;32;44
624;17.06.2017;2017;06;14;Lauantai;15;36;51
624;17.06.2017;2017;06;15;Lauantai;21;29;50
624;17.06.2017;2017;06;16;Lauantai;6;22;28
624;17.06.2017;2017;06;17;Lauantai;9;26;35
624;17.06.2017;2017;06;18;Lauantai;10;18;28
624;17.06.2017;2017;06;19;Lauantai;4;8;12
624;17.06.2017;2017;06;20;Lauantai;9;10;19
624;17.06.2017;2017;06;21;Lauantai;9;11;20
624;17.06.2017;2017;06;22;Lauantai;7;14;21
624;17.06.2017;2017;06;23;Lauantai;3;14;17
624;18.06.2017;2017;06;00;Sunnuntai;4;10;14
624;18.06.2017;2017;06;01;Sunnuntai;1;8;9
624;18.06.2017;2017;06;02;Sunnuntai;0;5;5
624;18.06.2017;2017;06;03;Sunnuntai;1;0;1
624;18.06.2017;2017;06;04;Sunnuntai;12;3;15
624;18.06.2017;2017;06;05;Sunnuntai;4;1;5
624;18.06.2017;2017;06;06;Sunnuntai;1;2;3
624;18.06.2017;2017;06;07;Sunnuntai;1;4;5
624;18.06.2017;2017;06;08;Sunnuntai;0;0;0
624;18.06.2017;2017;06;09;Sunnuntai;0;1;1
624;18.06.2017;2017;06;10;Sunnuntai;2;0;2
624;18.06.2017;2017;06;11;Sunnuntai;1;3;4
624;18.06.2017;2017;06;12;Sunnuntai;0;5;5
624;18.06.2017;2017;06;13;Sunnuntai;2;8;10
624;18.06.2017;2017;06;14;Sunnuntai;3;11;14
624;18.06.2017;2017;06;15;Sunnuntai;9;13;22
624;18.06.2017;2017;06;16;Sunnuntai;9;17;26
624;18.06.2017;2017;06;17;Sunnuntai;7;15;22
624;18.06.2017;2017;06;18;Sunnuntai;6;11;17
624;18.06.2017;2017;06;19;Sunnuntai;3;13;16
624;18.06.2017;2017;06;20;Sunnuntai;6;16;22
624;18.06.2017;2017;06;21;Sunnuntai;2;18;20
624;18.06.2017;2017;06;22;Sunnuntai;2;5;7
624;18.06.2017;2017;06;23;Sunnuntai;3;6;9
624;19.06.2017;2017;06;00;Maanantai;3;1;4
624;19.06.2017;2017;06;01;Maanantai;2;4;6
624;19.06.2017;2017;06;02;Maanantai;3;2;5
624;19.06.2017;2017;06;03;Maanantai;0;3;3
624;19.06.2017;2017;06;04;Maanantai;0;0;0
624;19.06.2017;2017;06;05;Maanantai;0;0;0
624;19.06.2017;2017;06;06;Maanantai;3;16;19
624;19.06.2017;2017;06;07;Maanantai;3;36;39
624;19.06.2017;2017;06;08;Maanantai;9;65;74
624;19.06.2017;2017;06;09;Maanantai;5;53;58
624;19.06.2017;2017;06;10;Maanantai;4;27;31
624;19.06.2017;2017;06;11;Maanantai;0;25;25
624;19.06.2017;2017;06;12;Maanantai;3;13;16
624;19.06.2017;2017;06;13;Maanantai;4;18;22
624;19.06.2017;2017;06;14;Maanantai;15;40;55
624;19.06.2017;2017;06;15;Maanantai;10;34;44
624;19.06.2017;2017;06;16;Maanantai;23;42;65
624;19.06.2017;2017;06;17;Maanantai;11;49;60
624;19.06.2017;2017;06;18;Maanantai;13;33;46
624;19.06.2017;2017;06;19;Maanantai;9;18;27
624;19.06.2017;2017;06;20;Maanantai;11;19;30
624;19.06.2017;2017;06;21;Maanantai;9;14;23
624;19.06.2017;2017;06;22;Maanantai;9;9;18
624;19.06.2017;2017;06;23;Maanantai;2;7;9
624;20.06.2017;2017;06;00;Tiistai;3;1;4
624;20.06.2017;2017;06;01;Tiistai;2;4;6
624;20.06.2017;2017;06;02;Tiistai;3;2;5
624;20.06.2017;2017;06;03;Tiistai;0;3;3
624;20.06.2017;2017;06;04;Tiistai;0;0;0
624;20.06.2017;2017;06;05;Tiistai;0;0;0
624;20.06.2017;2017;06;06;Tiistai;3;16;19
624;20.06.2017;2017;06;07;Tiistai;3;36;39
624;20.06.2017;2017;06;08;Tiistai;9;65;74
624;20.06.2017;2017;06;09;Tiistai;5;53;58
624;20.06.2017;2017;06;10;Tiistai;4;27;31
624;20.06.2017;2017;06;11;Tiistai;11;34;45
624;20.06.2017;2017;06;12;Tiistai;7;34;41
624;20.06.2017;2017;06;13;Tiistai;8;28;36
624;20.06.2017;2017;06;14;Tiistai;17;30;47
624;20.06.2017;2017;06;15;Tiistai;13;24;37
624;20.06.2017;2017;06;16;Tiistai;23;53;76
624;20.06.2017;2017;06;17;Tiistai;40;53;93
624;20.06.2017;2017;06;18;Tiistai;21;42;63
624;20.06.2017;2017;06;19;Tiistai;15;31;46
624;20.06.2017;2017;06;20;Tiistai;20;27;47
624;20.06.2017;2017;06;21;Tiistai;13;20;33
624;20.06.2017;2017;06;22;Tiistai;2;8;10
624;20.06.2017;2017;06;23;Tiistai;4;7;11
624;21.06.2017;2017;06;00;Keskiviikko;4;3;7
624;21.06.2017;2017;06;01;Keskiviikko;0;2;2
624;21.06.2017;2017;06;02;Keskiviikko;0;1;1
624;21.06.2017;2017;06;03;Keskiviikko;0;2;2
624;21.06.2017;2017;06;04;Keskiviikko;1;4;5
624;21.06.2017;2017;06;05;Keskiviikko;0;0;0
624;21.06.2017;2017;06;06;Keskiviikko;4;10;14
624;21.06.2017;2017;06;07;Keskiviikko;5;38;43
624;21.06.2017;2017;06;08;Keskiviikko;9;69;78
624;21.06.2017;2017;06;09;Keskiviikko;14;55;69
624;21.06.2017;2017;06;10;Keskiviikko;4;24;28
624;21.06.2017;2017;06;11;Keskiviikko;2;31;33
624;21.06.2017;2017;06;12;Keskiviikko;9;37;46
624;21.06.2017;2017;06;13;Keskiviikko;6;27;33
624;21.06.2017;2017;06;14;Keskiviikko;14;30;44
624;21.06.2017;2017;06;15;Keskiviikko;14;25;39
624;21.06.2017;2017;06;16;Keskiviikko;21;31;52
624;21.06.2017;2017;06;17;Keskiviikko;17;41;58
624;21.06.2017;2017;06;18;Keskiviikko;18;28;46
624;21.06.2017;2017;06;19;Keskiviikko;20;10;30
624;21.06.2017;2017;06;20;Keskiviikko;11;20;31
624;21.06.2017;2017;06;21;Keskiviikko;2;13;15
624;21.06.2017;2017;06;22;Keskiviikko;3;9;12
624;21.06.2017;2017;06;23;Keskiviikko;4;3;7
624;22.06.2017;2017;06;00;Torstai;4;6;10
624;22.06.2017;2017;06;01;Torstai;0;2;2
624;22.06.2017;2017;06;02;Torstai;1;2;3
624;22.06.2017;2017;06;03;Torstai;1;2;3
624;22.06.2017;2017;06;04;Torstai;0;0;0
624;22.06.2017;2017;06;05;Torstai;1;1;2
624;22.06.2017;2017;06;06;Torstai;1;7;8
624;22.06.2017;2017;06;07;Torstai;2;27;29
624;22.06.2017;2017;06;08;Torstai;7;47;54
624;22.06.2017;2017;06;09;Torstai;5;34;39
624;22.06.2017;2017;06;10;Torstai;3;22;25
624;22.06.2017;2017;06;11;Torstai;6;27;33
624;22.06.2017;2017;06;12;Torstai;4;15;19
624;22.06.2017;2017;06;13;Torstai;6;29;35
624;22.06.2017;2017;06;14;Torstai;4;24;28
624;22.06.2017;2017;06;15;Torstai;15;33;48
624;22.06.2017;2017;06;16;Torstai;14;19;33
624;22.06.2017;2017;06;17;Torstai;19;25;44
624;22.06.2017;2017;06;18;Torstai;16;22;38
624;22.06.2017;2017;06;19;Torstai;6;10;16
624;22.06.2017;2017;06;20;Torstai;7;12;19
624;22.06.2017;2017;06;21;Torstai;5;12;17
624;22.06.2017;2017;06;22;Torstai;6;9;15
624;22.06.2017;2017;06;23;Torstai;4;7;11
624;23.06.2017;2017;06;00;Perjantai;5;1;6
624;23.06.2017;2017;06;01;Perjantai;3;3;6
624;23.06.2017;2017;06;02;Perjantai;2;2;4
624;23.06.2017;2017;06;03;Perjantai;0;0;0
624;23.06.2017;2017;06;04;Perjantai;3;2;5
624;23.06.2017;2017;06;05;Perjantai;1;1;2
624;23.06.2017;2017;06;06;Perjantai;2;3;5
624;23.06.2017;2017;06;07;Perjantai;0;1;1
624;23.06.2017;2017;06;08;Perjantai;0;5;5
624;23.06.2017;2017;06;09;Perjantai;0;8;8
624;23.06.2017;2017;06;10;Perjantai;1;11;12
624;23.06.2017;2017;06;11;Perjantai;1;13;14
624;23.06.2017;2017;06;12;Perjantai;5;9;14
624;23.06.2017;2017;06;13;Perjantai;8;20;28
624;23.06.2017;2017;06;14;Perjantai;4;14;18
624;23.06.2017;2017;06;15;Perjantai;4;7;11
624;23.06.2017;2017;06;16;Perjantai;9;8;17
624;23.06.2017;2017;06;17;Perjantai;10;13;23
624;23.06.2017;2017;06;18;Perjantai;4;18;22
624;23.06.2017;2017;06;19;Perjantai;6;19;25
624;23.06.2017;2017;06;20;Perjantai;8;10;18
624;23.06.2017;2017;06;21;Perjantai;5;7;12
624;23.06.2017;2017;06;22;Perjantai;4;5;9
624;23.06.2017;2017;06;23;Perjantai;3;3;6
624;24.06.2017;2017;06;00;Lauantai;2;4;6
624;24.06.2017;2017;06;01;Lauantai;6;5;11
624;24.06.2017;2017;06;02;Lauantai;4;2;6
624;24.06.2017;2017;06;03;Lauantai;1;2;3
624;24.06.2017;2017;06;04;Lauantai;2;2;4
624;24.06.2017;2017;06;05;Lauantai;0;3;3
624;24.06.2017;2017;06;06;Lauantai;1;2;3
624;24.06.2017;2017;06;07;Lauantai;0;5;5
624;24.06.2017;2017;06;08;Lauantai;1;2;3
624;24.06.2017;2017;06;09;Lauantai;2;3;5
624;24.06.2017;2017;06;10;Lauantai;2;5;7
624;24.06.2017;2017;06;11;Lauantai;3;6;9
624;24.06.2017;2017;06;12;Lauantai;3;5;8
624;24.06.2017;2017;06;13;Lauantai;3;10;13
624;24.06.2017;2017;06;14;Lauantai;6;13;19
624;24.06.2017;2017;06;15;Lauantai;10;12;22
624;24.06.2017;2017;06;16;Lauantai;13;13;26
624;24.06.2017;2017;06;17;Lauantai;5;11;16
624;24.06.2017;2017;06;18;Lauantai;5;8;13
624;24.06.2017;2017;06;19;Lauantai;4;20;24
624;24.06.2017;2017;06;20;Lauantai;4;9;13
624;24.06.2017;2017;06;21;Lauantai;4;6;10
624;24.06.2017;2017;06;22;Lauantai;6;7;13
624;24.06.2017;2017;06;23;Lauantai;2;2;4
624;25.06.2017;2017;06;00;Sunnuntai;2;3;5
624;25.06.2017;2017;06;01;Sunnuntai;0;6;6
624;25.06.2017;2017;06;02;Sunnuntai;2;3;5
624;25.06.2017;2017;06;03;Sunnuntai;4;2;6
624;25.06.2017;2017;06;04;Sunnuntai;1;1;2
624;25.06.2017;2017;06;05;Sunnuntai;2;1;3
624;25.06.2017;2017;06;06;Sunnuntai;0;2;2
624;25.06.2017;2017;06;07;Sunnuntai;1;4;5
624;25.06.2017;2017;06;08;Sunnuntai;0;2;2
624;25.06.2017;2017;06;09;Sunnuntai;3;3;6
624;25.06.2017;2017;06;10;Sunnuntai;1;8;9
624;25.06.2017;2017;06;11;Sunnuntai;3;8;11
624;25.06.2017;2017;06;12;Sunnuntai;0;8;8
624;25.06.2017;2017;06;13;Sunnuntai;4;9;13
624;25.06.2017;2017;06;14;Sunnuntai;0;6;6
624;25.06.2017;2017;06;15;Sunnuntai;4;5;9
624;25.06.2017;2017;06;16;Sunnuntai;3;10;13
624;25.06.2017;2017;06;17;Sunnuntai;3;7;10
624;25.06.2017;2017;06;18;Sunnuntai;4;2;6
624;25.06.2017;2017;06;19;Sunnuntai;2;6;8
624;25.06.2017;2017;06;20;Sunnuntai;9;11;20
624;25.06.2017;2017;06;21;Sunnuntai;3;5;8
624;25.06.2017;2017;06;22;Sunnuntai;5;4;9
624;25.06.2017;2017;06;23;Sunnuntai;2;5;7
624;26.06.2017;2017;06;00;Maanantai;1;0;1
624;26.06.2017;2017;06;01;Maanantai;2;5;7
624;26.06.2017;2017;06;02;Maanantai;3;0;3
624;26.06.2017;2017;06;03;Maanantai;0;1;1
624;26.06.2017;2017;06;04;Maanantai;0;0;0
624;26.06.2017;2017;06;05;Maanantai;1;0;1
624;26.06.2017;2017;06;06;Maanantai;4;7;11
624;26.06.2017;2017;06;07;Maanantai;1;24;25
624;26.06.2017;2017;06;08;Maanantai;6;37;43
624;26.06.2017;2017;06;09;Maanantai;5;50;55
624;26.06.2017;2017;06;10;Maanantai;4;27;31
624;26.06.2017;2017;06;11;Maanantai;0;25;25
624;26.06.2017;2017;06;12;Maanantai;3;13;16
624;26.06.2017;2017;06;13;Maanantai;4;18;22
624;26.06.2017;2017;06;14;Maanantai;15;40;55
624;26.06.2017;2017;06;15;Maanantai;10;34;44
624;26.06.2017;2017;06;16;Maanantai;9;22;31
624;26.06.2017;2017;06;17;Maanantai;10;38;48
624;26.06.2017;2017;06;18;Maanantai;8;30;38
624;26.06.2017;2017;06;19;Maanantai;11;29;40
624;26.06.2017;2017;06;20;Maanantai;4;22;26
624;26.06.2017;2017;06;21;Maanantai;11;21;32
624;26.06.2017;2017;06;22;Maanantai;9;14;23
624;26.06.2017;2017;06;23;Maanantai;2;8;10
624;27.06.2017;2017;06;00;Tiistai;0;4;4
624;27.06.2017;2017;06;01;Tiistai;0;1;1
624;27.06.2017;2017;06;02;Tiistai;0;2;2
624;27.06.2017;2017;06;03;Tiistai;1;0;1
624;27.06.2017;2017;06;04;Tiistai;1;2;3
624;27.06.2017;2017;06;05;Tiistai;1;2;3
624;27.06.2017;2017;06;06;Tiistai;3;5;8
624;27.06.2017;2017;06;07;Tiistai;4;30;34
624;27.06.2017;2017;06;08;Tiistai;3;61;64
624;27.06.2017;2017;06;09;Tiistai;9;53;62
624;27.06.2017;2017;06;10;Tiistai;4;27;31
624;27.06.2017;2017;06;11;Tiistai;0;25;25
624;27.06.2017;2017;06;12;Tiistai;3;13;16
624;27.06.2017;2017;06;13;Tiistai;4;18;22
624;27.06.2017;2017;06;14;Tiistai;15;40;55
624;27.06.2017;2017;06;15;Tiistai;10;34;44
624;27.06.2017;2017;06;16;Tiistai;19;37;56
624;27.06.2017;2017;06;17;Tiistai;18;57;75
624;27.06.2017;2017;06;18;Tiistai;16;36;52
624;27.06.2017;2017;06;19;Tiistai;17;30;47
624;27.06.2017;2017;06;20;Tiistai;9;26;35
624;27.06.2017;2017;06;21;Tiistai;12;28;40
624;27.06.2017;2017;06;22;Tiistai;8;11;19
624;27.06.2017;2017;06;23;Tiistai;1;7;8
624;28.06.2017;2017;06;00;Keskiviikko;1;8;9
624;28.06.2017;2017;06;01;Keskiviikko;3;0;3
624;28.06.2017;2017;06;02;Keskiviikko;0;2;2
624;28.06.2017;2017;06;03;Keskiviikko;1;0;1
624;28.06.2017;2017;06;04;Keskiviikko;0;2;2
624;28.06.2017;2017;06;05;Keskiviikko;2;0;2
624;28.06.2017;2017;06;06;Keskiviikko;4;11;15
624;28.06.2017;2017;06;07;Keskiviikko;4;33;37
624;28.06.2017;2017;06;08;Keskiviikko;5;50;55
624;28.06.2017;2017;06;09;Keskiviikko;3;42;45
624;28.06.2017;2017;06;10;Keskiviikko;5;19;24
624;28.06.2017;2017;06;11;Keskiviikko;3;21;24
624;28.06.2017;2017;06;12;Keskiviikko;8;21;29
624;28.06.2017;2017;06;13;Keskiviikko;7;16;23
624;28.06.2017;2017;06;14;Keskiviikko;8;31;39
624;28.06.2017;2017;06;15;Keskiviikko;15;20;35
624;28.06.2017;2017;06;16;Keskiviikko;15;39;54
624;28.06.2017;2017;06;17;Keskiviikko;15;39;54
624;28.06.2017;2017;06;18;Keskiviikko;15;22;37
624;28.06.2017;2017;06;19;Keskiviikko;18;25;43
624;28.06.2017;2017;06;20;Keskiviikko;12;21;33
624;28.06.2017;2017;06;21;Keskiviikko;6;20;26
624;28.06.2017;2017;06;22;Keskiviikko;7;13;20
624;28.06.2017;2017;06;23;Keskiviikko;2;9;11
624;29.06.2017;2017;06;00;Torstai;2;5;7
624;29.06.2017;2017;06;01;Torstai;0;1;1
624;29.06.2017;2017;06;02;Torstai;0;4;4
624;29.06.2017;2017;06;03;Torstai;0;1;1
624;29.06.2017;2017;06;04;Torstai;2;0;2
624;29.06.2017;2017;06;05;Torstai;0;0;0
624;29.06.2017;2017;06;06;Torstai;2;10;12
624;29.06.2017;2017;06;07;Torstai;4;27;31
624;29.06.2017;2017;06;08;Torstai;6;50;56
624;29.06.2017;2017;06;09;Torstai;8;35;43
624;29.06.2017;2017;06;10;Torstai;4;35;39
624;29.06.2017;2017;06;11;Torstai;3;45;48
624;29.06.2017;2017;06;12;Torstai;4;30;34
624;29.06.2017;2017;06;13;Torstai;13;35;48
624;29.06.2017;2017;06;14;Torstai;16;35;51
624;29.06.2017;2017;06;15;Torstai;9;35;44
624;29.06.2017;2017;06;16;Torstai;22;43;65
624;29.06.2017;2017;06;17;Torstai;27;52;79
624;29.06.2017;2017;06;18;Torstai;14;45;59
624;29.06.2017;2017;06;19;Torstai;13;26;39
624;29.06.2017;2017;06;20;Torstai;12;21;33
624;29.06.2017;2017;06;21;Torstai;10;23;33
624;29.06.2017;2017;06;22;Torstai;13;12;25
624;29.06.2017;2017;06;23;Torstai;5;8;13
624;30.06.2017;2017;06;00;Perjantai;5;6;11
624;30.06.2017;2017;06;01;Perjantai;4;3;7
624;30.06.2017;2017;06;02;Perjantai;2;0;2
624;30.06.2017;2017;06;03;Perjantai;1;0;1
624;30.06.2017;2017;06;04;Perjantai;0;1;1
624;30.06.2017;2017;06;05;Perjantai;0;3;3
624;30.06.2017;2017;06;06;Perjantai;2;13;15
624;30.06.2017;2017;06;07;Perjantai;5;33;38
624;30.06.2017;2017;06;08;Perjantai;9;40;49
624;30.06.2017;2017;06;09;Perjantai;6;38;44
624;30.06.2017;2017;06;10;Perjantai;3;25;28
624;30.06.2017;2017;06;11;Perjantai;6;27;33
624;30.06.2017;2017;06;12;Perjantai;8;23;31
624;30.06.2017;2017;06;13;Perjantai;20;22;42
624;30.06.2017;2017;06;14;Perjantai;13;40;53
624;30.06.2017;2017;06;15;Perjantai;13;36;49
624;30.06.2017;2017;06;16;Perjantai;10;39;49
624;30.06.2017;2017;06;17;Perjantai;18;31;49
624;30.06.2017;2017;06;18;Perjantai;8;28;36
624;30.06.2017;2017;06;19;Perjantai;10;27;37
624;30.06.2017;2017;06;20;Perjantai;12;19;31
624;30.06.2017;2017;06;21;Perjantai;4;25;29
624;30.06.2017;2017;06;22;Perjantai;6;14;20
624;30.06.2017;2017;06;23;Perjantai;5;13;18
624;01.07.2017;2017;07;00;Lauantai;6;2;8
624;01.07.2017;2017;07;01;Lauantai;4;3;7
624;01.07.2017;2017;07;02;Lauantai;4;8;12
624;01.07.2017;2017;07;03;Lauantai;1;1;2
624;01.07.2017;2017;07;04;Lauantai;1;3;4
624;01.07.2017;2017;07;05;Lauantai;0;2;2
624;01.07.2017;2017;07;06;Lauantai;2;4;6
624;01.07.2017;2017;07;07;Lauantai;0;5;5
624;01.07.2017;2017;07;08;Lauantai;2;5;7
624;01.07.2017;2017;07;09;Lauantai;3;7;10
624;01.07.2017;2017;07;10;Lauantai;4;20;24
624;01.07.2017;2017;07;11;Lauantai;8;23;31
624;01.07.2017;2017;07;12;Lauantai;11;32;43
624;01.07.2017;2017;07;13;Lauantai;15;29;44
624;01.07.2017;2017;07;14;Lauantai;21;28;49
624;01.07.2017;2017;07;15;Lauantai;16;19;35
624;01.07.2017;2017;07;16;Lauantai;23;28;51
624;01.07.2017;2017;07;17;Lauantai;5;48;53
624;01.07.2017;2017;07;18;Lauantai;10;32;42
624;01.07.2017;2017;07;19;Lauantai;11;27;38
624;01.07.2017;2017;07;20;Lauantai;7;22;29
624;01.07.2017;2017;07;21;Lauantai;7;27;34
624;01.07.2017;2017;07;22;Lauantai;9;11;20
624;01.07.2017;2017;07;23;Lauantai;5;9;14
624;02.07.2017;2017;07;00;Sunnuntai;5;8;13
624;02.07.2017;2017;07;01;Sunnuntai;8;4;12
624;02.07.2017;2017;07;02;Sunnuntai;5;7;12
624;02.07.2017;2017;07;03;Sunnuntai;5;2;7
624;02.07.2017;2017;07;04;Sunnuntai;4;0;4
624;02.07.2017;2017;07;05;Sunnuntai;2;1;3
624;02.07.2017;2017;07;06;Sunnuntai;1;3;4
624;02.07.2017;2017;07;07;Sunnuntai;0;4;4
624;02.07.2017;2017;07;08;Sunnuntai;0;0;0
624;02.07.2017;2017;07;09;Sunnuntai;3;4;7
624;02.07.2017;2017;07;10;Sunnuntai;2;13;15
624;02.07.2017;2017;07;11;Sunnuntai;6;15;21
624;02.07.2017;2017;07;12;Sunnuntai;13;24;37
624;02.07.2017;2017;07;13;Sunnuntai;13;22;35
624;02.07.2017;2017;07;14;Sunnuntai;8;31;39
624;02.07.2017;2017;07;15;Sunnuntai;17;30;47
624;02.07.2017;2017;07;16;Sunnuntai;10;32;42
624;02.07.2017;2017;07;17;Sunnuntai;9;23;32
624;02.07.2017;2017;07;18;Sunnuntai;10;19;29
624;02.07.2017;2017;07;19;Sunnuntai;14;26;40
624;02.07.2017;2017;07;20;Sunnuntai;12;30;42
624;02.07.2017;2017;07;21;Sunnuntai;7;32;39
624;02.07.2017;2017;07;22;Sunnuntai;10;11;21
624;02.07.2017;2017;07;23;Sunnuntai;2;5;7
624;03.07.2017;2017;07;00;Maanantai;5;6;11
624;03.07.2017;2017;07;01;Maanantai;3;4;7
624;03.07.2017;2017;07;02;Maanantai;2;5;7
624;03.07.2017;2017;07;03;Maanantai;2;0;2
624;03.07.2017;2017;07;04;Maanantai;0;0;0
624;03.07.2017;2017;07;05;Maanantai;1;3;4
624;03.07.2017;2017;07;06;Maanantai;3;14;17
624;03.07.2017;2017;07;07;Maanantai;6;33;39
624;03.07.2017;2017;07;08;Maanantai;11;46;57
624;03.07.2017;2017;07;09;Maanantai;11;46;57
624;03.07.2017;2017;07;10;Maanantai;11;38;49
624;03.07.2017;2017;07;11;Maanantai;4;32;36
624;03.07.2017;2017;07;12;Maanantai;18;39;57
624;03.07.2017;2017;07;13;Maanantai;12;30;42
624;03.07.2017;2017;07;14;Maanantai;3;32;35
624;03.07.2017;2017;07;15;Maanantai;7;31;38
624;03.07.2017;2017;07;16;Maanantai;27;44;71
624;03.07.2017;2017;07;17;Maanantai;12;38;50
624;03.07.2017;2017;07;18;Maanantai;19;44;63
624;03.07.2017;2017;07;19;Maanantai;11;37;48
624;03.07.2017;2017;07;20;Maanantai;15;26;41
624;03.07.2017;2017;07;21;Maanantai;14;26;40
624;03.07.2017;2017;07;22;Maanantai;10;20;30
624;03.07.2017;2017;07;23;Maanantai;6;10;16
624;04.07.2017;2017;07;00;Tiistai;2;6;8
624;04.07.2017;2017;07;01;Tiistai;4;2;6
624;04.07.2017;2017;07;02;Tiistai;2;0;2
624;04.07.2017;2017;07;03;Tiistai;2;0;2
624;04.07.2017;2017;07;04;Tiistai;0;1;1
624;04.07.2017;2017;07;05;Tiistai;1;1;2
624;04.07.2017;2017;07;06;Tiistai;1;7;8
624;04.07.2017;2017;07;07;Tiistai;3;33;36
624;04.07.2017;2017;07;08;Tiistai;6;39;45
624;04.07.2017;2017;07;09;Tiistai;8;39;47
624;04.07.2017;2017;07;10;Tiistai;7;20;27
624;04.07.2017;2017;07;11;Tiistai;7;35;42
624;04.07.2017;2017;07;12;Tiistai;11;36;47
624;04.07.2017;2017;07;13;Tiistai;8;36;44
624;04.07.2017;2017;07;14;Tiistai;16;18;34
624;04.07.2017;2017;07;15;Tiistai;10;16;26
624;04.07.2017;2017;07;16;Tiistai;19;44;63
624;04.07.2017;2017;07;17;Tiistai;14;41;55
624;04.07.2017;2017;07;18;Tiistai;16;24;40
624;04.07.2017;2017;07;19;Tiistai;21;26;47
624;04.07.2017;2017;07;20;Tiistai;11;20;31
624;04.07.2017;2017;07;21;Tiistai;12;35;47
624;04.07.2017;2017;07;22;Tiistai;10;18;28
624;04.07.2017;2017;07;23;Tiistai;4;7;11
624;05.07.2017;2017;07;00;Keskiviikko;3;8;11
624;05.07.2017;2017;07;01;Keskiviikko;5;2;7
624;05.07.2017;2017;07;02;Keskiviikko;0;5;5
624;05.07.2017;2017;07;03;Keskiviikko;4;2;6
624;05.07.2017;2017;07;04;Keskiviikko;0;1;1
624;05.07.2017;2017;07;05;Keskiviikko;2;0;2
624;05.07.2017;2017;07;06;Keskiviikko;3;8;11
624;05.07.2017;2017;07;07;Keskiviikko;3;30;33
624;05.07.2017;2017;07;08;Keskiviikko;6;37;43
624;05.07.2017;2017;07;09;Keskiviikko;4;39;43
624;05.07.2017;2017;07;10;Keskiviikko;1;13;14
624;05.07.2017;2017;07;11;Keskiviikko;6;27;33
624;05.07.2017;2017;07;12;Keskiviikko;5;21;26
624;05.07.2017;2017;07;13;Keskiviikko;11;25;36
624;05.07.2017;2017;07;14;Keskiviikko;8;18;26
624;05.07.2017;2017;07;15;Keskiviikko;5;29;34
624;05.07.2017;2017;07;16;Keskiviikko;21;48;69
624;05.07.2017;2017;07;17;Keskiviikko;17;49;66
624;05.07.2017;2017;07;18;Keskiviikko;8;30;38
624;05.07.2017;2017;07;19;Keskiviikko;11;20;31
624;05.07.2017;2017;07;20;Keskiviikko;11;16;27
624;05.07.2017;2017;07;21;Keskiviikko;9;14;23
624;05.07.2017;2017;07;22;Keskiviikko;9;9;18
624;05.07.2017;2017;07;23;Keskiviikko;3;13;16
624;06.07.2017;2017;07;00;Torstai;2;4;6
624;06.07.2017;2017;07;01;Torstai;4;2;6
624;06.07.2017;2017;07;02;Torstai;4;1;5
624;06.07.2017;2017;07;03;Torstai;0;0;0
624;06.07.2017;2017;07;04;Torstai;2;1;3
624;06.07.2017;2017;07;05;Torstai;1;0;1
624;06.07.2017;2017;07;06;Torstai;2;11;13
624;06.07.2017;2017;07;07;Torstai;8;32;40
624;06.07.2017;2017;07;08;Torstai;10;32;42
624;06.07.2017;2017;07;09;Torstai;2;29;31
624;06.07.2017;2017;07;10;Torstai;7;10;17
624;06.07.2017;2017;07;11;Torstai;3;19;22
624;06.07.2017;2017;07;12;Torstai;5;17;22
624;06.07.2017;2017;07;13;Torstai;9;24;33
624;06.07.2017;2017;07;14;Torstai;8;24;32
624;06.07.2017;2017;07;15;Torstai;2;20;22
624;06.07.2017;2017;07;16;Torstai;18;34;52
624;06.07.2017;2017;07;17;Torstai;17;34;51
624;06.07.2017;2017;07;18;Torstai;7;23;30
624;06.07.2017;2017;07;19;Torstai;10;25;35
624;06.07.2017;2017;07;20;Torstai;8;14;22
624;06.07.2017;2017;07;21;Torstai;6;21;27
624;06.07.2017;2017;07;22;Torstai;7;10;17
624;06.07.2017;2017;07;23;Torstai;6;5;11
624;07.07.2017;2017;07;00;Perjantai;1;8;9
624;07.07.2017;2017;07;01;Perjantai;4;4;8
624;07.07.2017;2017;07;02;Perjantai;2;2;4
624;07.07.2017;2017;07;03;Perjantai;0;0;0
624;07.07.2017;2017;07;04;Perjantai;1;1;2
624;07.07.2017;2017;07;05;Perjantai;0;1;1
624;07.07.2017;2017;07;06;Perjantai;2;8;10
624;07.07.2017;2017;07;07;Perjantai;2;33;35
624;07.07.2017;2017;07;08;Perjantai;9;46;55
624;07.07.2017;2017;07;09;Perjantai;4;31;35
624;07.07.2017;2017;07;10;Perjantai;6;25;31
624;07.07.2017;2017;07;11;Perjantai;4;20;24
624;07.07.2017;2017;07;12;Perjantai;6;23;29
624;07.07.2017;2017;07;13;Perjantai;10;22;32
624;07.07.2017;2017;07;14;Perjantai;16;30;46
624;07.07.2017;2017;07;15;Perjantai;10;37;47
624;07.07.2017;2017;07;16;Perjantai;22;45;67
624;07.07.2017;2017;07;17;Perjantai;30;36;66
624;07.07.2017;2017;07;18;Perjantai;8;20;28
624;07.07.2017;2017;07;19;Perjantai;13;27;40
624;07.07.2017;2017;07;20;Perjantai;10;21;31
624;07.07.2017;2017;07;21;Perjantai;10;20;30
624;07.07.2017;2017;07;22;Perjantai;5;19;24
624;07.07.2017;2017;07;23;Perjantai;2;5;7
624;08.07.2017;2017;07;00;Lauantai;5;7;12
624;08.07.2017;2017;07;01;Lauantai;3;3;6
624;08.07.2017;2017;07;02;Lauantai;1;9;10
624;08.07.2017;2017;07;03;Lauantai;8;3;11
624;08.07.2017;2017;07;04;Lauantai;2;3;5
624;08.07.2017;2017;07;05;Lauantai;4;3;7
624;08.07.2017;2017;07;06;Lauantai;1;6;7
624;08.07.2017;2017;07;07;Lauantai;3;9;12
624;08.07.2017;2017;07;08;Lauantai;1;5;6
624;08.07.2017;2017;07;09;Lauantai;5;8;13
624;08.07.2017;2017;07;10;Lauantai;0;23;23
624;08.07.2017;2017;07;11;Lauantai;3;27;30
624;08.07.2017;2017;07;12;Lauantai;7;25;32
624;08.07.2017;2017;07;13;Lauantai;5;27;32
624;08.07.2017;2017;07;14;Lauantai;17;44;61
624;08.07.2017;2017;07;15;Lauantai;21;37;58
624;08.07.2017;2017;07;16;Lauantai;19;25;44
624;08.07.2017;2017;07;17;Lauantai;15;25;40
624;08.07.2017;2017;07;18;Lauantai;12;22;34
624;08.07.2017;2017;07;19;Lauantai;13;17;30
624;08.07.2017;2017;07;20;Lauantai;17;18;35
624;08.07.2017;2017;07;21;Lauantai;9;9;18
624;08.07.2017;2017;07;22;Lauantai;5;12;17
624;08.07.2017;2017;07;23;Lauantai;5;12;17
624;09.07.2017;2017;07;00;Sunnuntai;6;10;16
624;09.07.2017;2017;07;01;Sunnuntai;5;7;12
624;09.07.2017;2017;07;02;Sunnuntai;2;9;11
624;09.07.2017;2017;07;03;Sunnuntai;4;3;7
624;09.07.2017;2017;07;04;Sunnuntai;8;3;11
624;09.07.2017;2017;07;05;Sunnuntai;2;2;4
624;09.07.2017;2017;07;06;Sunnuntai;1;1;2
624;09.07.2017;2017;07;07;Sunnuntai;1;11;12
624;09.07.2017;2017;07;08;Sunnuntai;0;4;4
624;09.07.2017;2017;07;09;Sunnuntai;1;5;6
624;09.07.2017;2017;07;10;Sunnuntai;7;16;23
624;09.07.2017;2017;07;11;Sunnuntai;3;14;17
624;09.07.2017;2017;07;12;Sunnuntai;9;29;38
624;09.07.2017;2017;07;13;Sunnuntai;13;27;40
624;09.07.2017;2017;07;14;Sunnuntai;6;28;34
624;09.07.2017;2017;07;15;Sunnuntai;9;21;30
624;09.07.2017;2017;07;16;Sunnuntai;14;28;42
624;09.07.2017;2017;07;17;Sunnuntai;18;37;55
624;09.07.2017;2017;07;18;Sunnuntai;14;24;38
624;09.07.2017;2017;07;19;Sunnuntai;12;15;27
624;09.07.2017;2017;07;20;Sunnuntai;12;20;32
624;09.07.2017;2017;07;21;Sunnuntai;8;19;27
624;09.07.2017;2017;07;22;Sunnuntai;6;8;14
624;09.07.2017;2017;07;23;Sunnuntai;4;9;13
624;10.07.2017;2017;07;00;Maanantai;5;7;12
624;10.07.2017;2017;07;01;Maanantai;3;4;7
624;10.07.2017;2017;07;02;Maanantai;5;1;6
624;10.07.2017;2017;07;03;Maanantai;0;1;1
624;10.07.2017;2017;07;04;Maanantai;0;0;0
624;10.07.2017;2017;07;05;Maanantai;0;1;1
624;10.07.2017;2017;07;06;Maanantai;2;5;7
624;10.07.2017;2017;07;07;Maanantai;5;39;44
624;10.07.2017;2017;07;08;Maanantai;7;42;49
624;10.07.2017;2017;07;09;Maanantai;8;39;47
624;10.07.2017;2017;07;10;Maanantai;5;27;32
624;10.07.2017;2017;07;11;Maanantai;12;26;38
624;10.07.2017;2017;07;12;Maanantai;8;32;40
624;10.07.2017;2017;07;13;Maanantai;10;28;38
624;10.07.2017;2017;07;14;Maanantai;10;39;49
624;10.07.2017;2017;07;15;Maanantai;14;41;55
624;10.07.2017;2017;07;16;Maanantai;17;56;73
624;10.07.2017;2017;07;17;Maanantai;24;42;66
624;10.07.2017;2017;07;18;Maanantai;10;40;50
624;10.07.2017;2017;07;19;Maanantai;7;30;37
624;10.07.2017;2017;07;20;Maanantai;9;15;24
624;10.07.2017;2017;07;21;Maanantai;4;11;15
624;10.07.2017;2017;07;22;Maanantai;8;12;20
624;10.07.2017;2017;07;23;Maanantai;2;8;10
624;11.07.2017;2017;07;00;Tiistai;1;4;5
624;11.07.2017;2017;07;01;Tiistai;1;6;7
624;11.07.2017;2017;07;02;Tiistai;2;2;4
624;11.07.2017;2017;07;03;Tiistai;0;2;2
624;11.07.2017;2017;07;04;Tiistai;0;1;1
624;11.07.2017;2017;07;05;Tiistai;1;1;2
624;11.07.2017;2017;07;06;Tiistai;2;8;10
624;11.07.2017;2017;07;07;Tiistai;8;33;41
624;11.07.2017;2017;07;08;Tiistai;5;40;45
624;11.07.2017;2017;07;09;Tiistai;13;31;44
624;11.07.2017;2017;07;10;Tiistai;8;29;37
624;11.07.2017;2017;07;11;Tiistai;6;23;29
624;11.07.2017;2017;07;12;Tiistai;5;26;31
624;11.07.2017;2017;07;13;Tiistai;6;36;42
624;11.07.2017;2017;07;14;Tiistai;19;35;54
624;11.07.2017;2017;07;15;Tiistai;14;30;44
624;11.07.2017;2017;07;16;Tiistai;23;42;65
624;11.07.2017;2017;07;17;Tiistai;11;49;60
624;11.07.2017;2017;07;18;Tiistai;13;33;46
624;11.07.2017;2017;07;19;Tiistai;9;18;27
624;11.07.2017;2017;07;20;Tiistai;11;19;30
624;11.07.2017;2017;07;21;Tiistai;9;14;23
624;11.07.2017;2017;07;22;Tiistai;9;9;18
624;11.07.2017;2017;07;23;Tiistai;2;7;9
624;12.07.2017;2017;07;00;Keskiviikko;3;1;4
624;12.07.2017;2017;07;01;Keskiviikko;2;4;6
624;12.07.2017;2017;07;02;Keskiviikko;3;2;5
624;12.07.2017;2017;07;03;Keskiviikko;0;3;3
624;12.07.2017;2017;07;04;Keskiviikko;0;0;0
624;12.07.2017;2017;07;05;Keskiviikko;0;0;0
624;12.07.2017;2017;07;06;Keskiviikko;3;16;19
624;12.07.2017;2017;07;07;Keskiviikko;3;36;39
624;12.07.2017;2017;07;08;Keskiviikko;9;65;74
624;12.07.2017;2017;07;09;Keskiviikko;5;53;58
624;12.07.2017;2017;07;10;Keskiviikko;4;27;31
624;12.07.2017;2017;07;11;Keskiviikko;6;16;22
624;12.07.2017;2017;07;12;Keskiviikko;6;16;22
624;12.07.2017;2017;07;13;Keskiviikko;12;25;37
624;12.07.2017;2017;07;14;Keskiviikko;9;16;25
624;12.07.2017;2017;07;15;Keskiviikko;6;15;21
624;12.07.2017;2017;07;16;Keskiviikko;21;23;44
624;12.07.2017;2017;07;17;Keskiviikko;15;20;35
624;12.07.2017;2017;07;18;Keskiviikko;9;13;22
624;12.07.2017;2017;07;19;Keskiviikko;10;9;19
624;12.07.2017;2017;07;20;Keskiviikko;8;10;18
624;12.07.2017;2017;07;21;Keskiviikko;5;11;16
624;12.07.2017;2017;07;22;Keskiviikko;8;7;15
624;12.07.2017;2017;07;23;Keskiviikko;2;6;8
624;13.07.2017;2017;07;00;Torstai;1;0;1
624;13.07.2017;2017;07;01;Torstai;4;7;11
624;13.07.2017;2017;07;02;Torstai;1;1;2
624;13.07.2017;2017;07;03;Torstai;1;1;2
624;13.07.2017;2017;07;04;Torstai;1;1;2
624;13.07.2017;2017;07;05;Torstai;1;1;2
624;13.07.2017;2017;07;06;Torstai;1;6;7
624;13.07.2017;2017;07;07;Torstai;3;15;18
624;13.07.2017;2017;07;08;Torstai;4;27;31
624;13.07.2017;2017;07;09;Torstai;7;28;35
624;13.07.2017;2017;07;10;Torstai;5;21;26
624;13.07.2017;2017;07;11;Torstai;4;20;24
624;13.07.2017;2017;07;12;Torstai;9;25;34
624;13.07.2017;2017;07;13;Torstai;9;30;39
624;13.07.2017;2017;07;14;Torstai;14;21;35
624;13.07.2017;2017;07;15;Torstai;10;36;46
624;13.07.2017;2017;07;16;Torstai;21;52;73
624;13.07.2017;2017;07;17;Torstai;15;44;59
624;13.07.2017;2017;07;18;Torstai;16;27;43
624;13.07.2017;2017;07;19;Torstai;12;23;35
624;13.07.2017;2017;07;20;Torstai;6;16;22
624;13.07.2017;2017;07;21;Torstai;3;5;8
624;13.07.2017;2017;07;22;Torstai;4;14;18
624;13.07.2017;2017;07;23;Torstai;8;12;20
624;14.07.2017;2017;07;00;Perjantai;7;1;8
624;14.07.2017;2017;07;01;Perjantai;3;6;9
624;14.07.2017;2017;07;02;Perjantai;2;5;7
624;14.07.2017;2017;07;03;Perjantai;1;1;2
624;14.07.2017;2017;07;04;Perjantai;2;1;3
624;14.07.2017;2017;07;05;Perjantai;1;0;1
624;14.07.2017;2017;07;06;Perjantai;1;4;5
624;14.07.2017;2017;07;07;Perjantai;6;24;30
624;14.07.2017;2017;07;08;Perjantai;3;18;21
624;14.07.2017;2017;07;09;Perjantai;2;22;24
624;14.07.2017;2017;07;10;Perjantai;4;10;14
624;14.07.2017;2017;07;11;Perjantai;2;6;8
624;14.07.2017;2017;07;12;Perjantai;7;11;18
624;14.07.2017;2017;07;13;Perjantai;9;8;17
624;14.07.2017;2017;07;14;Perjantai;0;1;1
624;14.07.2017;2017;07;15;Perjantai;8;12;20
624;14.07.2017;2017;07;16;Perjantai;8;31;39
624;14.07.2017;2017;07;17;Perjantai;9;24;33
624;14.07.2017;2017;07;18;Perjantai;8;14;22
624;14.07.2017;2017;07;19;Perjantai;8;9;17
624;14.07.2017;2017;07;20;Perjantai;6;16;22
624;14.07.2017;2017;07;21;Perjantai;6;18;24
624;14.07.2017;2017;07;22;Perjantai;7;9;16
624;14.07.2017;2017;07;23;Perjantai;4;12;16
624;15.07.2017;2017;07;00;Lauantai;8;9;17
624;15.07.2017;2017;07;01;Lauantai;5;4;9
624;15.07.2017;2017;07;02;Lauantai;1;6;7
624;15.07.2017;2017;07;03;Lauantai;0;5;5
624;15.07.2017;2017;07;04;Lauantai;5;0;5
624;15.07.2017;2017;07;05;Lauantai;2;1;3
624;15.07.2017;2017;07;06;Lauantai;2;1;3
624;15.07.2017;2017;07;07;Lauantai;1;2;3
624;15.07.2017;2017;07;08;Lauantai;2;4;6
624;15.07.2017;2017;07;09;Lauantai;2;10;12
624;15.07.2017;2017;07;10;Lauantai;2;4;6
624;15.07.2017;2017;07;11;Lauantai;5;19;24
624;15.07.2017;2017;07;12;Lauantai;4;16;20
624;15.07.2017;2017;07;13;Lauantai;5;16;21
624;15.07.2017;2017;07;14;Lauantai;11;31;42
624;15.07.2017;2017;07;15;Lauantai;16;27;43
624;15.07.2017;2017;07;16;Lauantai;6;21;27
624;15.07.2017;2017;07;17;Lauantai;14;30;44
624;15.07.2017;2017;07;18;Lauantai;9;21;30
624;15.07.2017;2017;07;19;Lauantai;8;19;27
624;15.07.2017;2017;07;20;Lauantai;13;14;27
624;15.07.2017;2017;07;21;Lauantai;6;8;14
624;15.07.2017;2017;07;22;Lauantai;7;12;19
624;15.07.2017;2017;07;23;Lauantai;4;10;14
624;16.07.2017;2017;07;00;Sunnuntai;1;7;8
624;16.07.2017;2017;07;01;Sunnuntai;7;9;16
624;16.07.2017;2017;07;02;Sunnuntai;2;5;7
624;16.07.2017;2017;07;03;Sunnuntai;3;1;4
624;16.07.2017;2017;07;04;Sunnuntai;6;1;7
624;16.07.2017;2017;07;05;Sunnuntai;4;2;6
624;16.07.2017;2017;07;06;Sunnuntai;2;4;6
624;16.07.2017;2017;07;07;Sunnuntai;2;7;9
624;16.07.2017;2017;07;08;Sunnuntai;2;2;4
624;16.07.2017;2017;07;09;Sunnuntai;2;1;3
624;16.07.2017;2017;07;10;Sunnuntai;1;8;9
624;16.07.2017;2017;07;11;Sunnuntai;5;15;20
624;16.07.2017;2017;07;12;Sunnuntai;6;16;22
624;16.07.2017;2017;07;13;Sunnuntai;9;29;38
624;16.07.2017;2017;07;14;Sunnuntai;9;26;35
624;16.07.2017;2017;07;15;Sunnuntai;20;29;49
624;16.07.2017;2017;07;16;Sunnuntai;10;26;36
624;16.07.2017;2017;07;17;Sunnuntai;12;34;46
624;16.07.2017;2017;07;18;Sunnuntai;12;28;40
624;16.07.2017;2017;07;19;Sunnuntai;11;21;32
624;16.07.2017;2017;07;20;Sunnuntai;11;16;27
624;16.07.2017;2017;07;21;Sunnuntai;6;21;27
624;16.07.2017;2017;07;22;Sunnuntai;7;11;18
624;16.07.2017;2017;07;23;Sunnuntai;1;3;4
624;17.07.2017;2017;07;00;Maanantai;2;8;10
624;17.07.2017;2017;07;01;Maanantai;3;1;4
624;17.07.2017;2017;07;02;Maanantai;0;0;0
624;17.07.2017;2017;07;03;Maanantai;0;1;1
624;17.07.2017;2017;07;04;Maanantai;0;0;0
624;17.07.2017;2017;07;05;Maanantai;1;2;3
624;17.07.2017;2017;07;06;Maanantai;0;6;6
624;17.07.2017;2017;07;07;Maanantai;4;30;34
624;17.07.2017;2017;07;08;Maanantai;2;34;36
624;17.07.2017;2017;07;09;Maanantai;6;29;35
624;17.07.2017;2017;07;10;Maanantai;3;23;26
624;17.07.2017;2017;07;11;Maanantai;7;21;28
624;17.07.2017;2017;07;12;Maanantai;9;32;41
624;17.07.2017;2017;07;13;Maanantai;13;35;48
624;17.07.2017;2017;07;14;Maanantai;15;33;48
624;17.07.2017;2017;07;15;Maanantai;7;27;34
624;17.07.2017;2017;07;16;Maanantai;18;42;60
624;17.07.2017;2017;07;17;Maanantai;12;27;39
624;17.07.2017;2017;07;18;Maanantai;12;16;28
624;17.07.2017;2017;07;19;Maanantai;9;16;25
624;17.07.2017;2017;07;20;Maanantai;7;18;25
624;17.07.2017;2017;07;21;Maanantai;4;19;23
624;17.07.2017;2017;07;22;Maanantai;7;11;18
624;17.07.2017;2017;07;23;Maanantai;3;11;14
624;18.07.2017;2017;07;00;Tiistai;1;1;2
624;18.07.2017;2017;07;01;Tiistai;1;4;5
624;18.07.2017;2017;07;02;Tiistai;0;0;0
624;18.07.2017;2017;07;03;Tiistai;0;0;0
624;18.07.2017;2017;07;04;Tiistai;1;0;1
624;18.07.2017;2017;07;05;Tiistai;1;2;3
624;18.07.2017;2017;07;06;Tiistai;1;4;5
624;18.07.2017;2017;07;07;Tiistai;7;15;22
624;18.07.2017;2017;07;08;Tiistai;3;20;23
624;18.07.2017;2017;07;09;Tiistai;4;6;10
624;18.07.2017;2017;07;10;Tiistai;3;6;9
624;18.07.2017;2017;07;11;Tiistai;3;9;12
624;18.07.2017;2017;07;12;Tiistai;2;4;6
624;18.07.2017;2017;07;13;Tiistai;3;6;9
624;18.07.2017;2017;07;14;Tiistai;4;16;20
624;18.07.2017;2017;07;15;Tiistai;6;11;17
624;18.07.2017;2017;07;16;Tiistai;8;33;41
624;18.07.2017;2017;07;17;Tiistai;9;24;33
624;18.07.2017;2017;07;18;Tiistai;6;24;30
624;18.07.2017;2017;07;19;Tiistai;4;9;13
624;18.07.2017;2017;07;20;Tiistai;6;2;8
624;18.07.2017;2017;07;21;Tiistai;7;17;24
624;18.07.2017;2017;07;22;Tiistai;5;4;9
624;18.07.2017;2017;07;23;Tiistai;4;8;12
624;19.07.2017;2017;07;00;Keskiviikko;1;1;2
624;19.07.2017;2017;07;01;Keskiviikko;1;3;4
624;19.07.2017;2017;07;02;Keskiviikko;1;1;2
624;19.07.2017;2017;07;03;Keskiviikko;1;0;1
624;19.07.2017;2017;07;04;Keskiviikko;0;1;1
624;19.07.2017;2017;07;05;Keskiviikko;1;2;3
624;19.07.2017;2017;07;06;Keskiviikko;0;4;4
624;19.07.2017;2017;07;07;Keskiviikko;5;20;25
624;19.07.2017;2017;07;08;Keskiviikko;2;35;37
624;19.07.2017;2017;07;09;Keskiviikko;4;18;22
624;19.07.2017;2017;07;10;Keskiviikko;5;14;19
624;19.07.2017;2017;07;11;Keskiviikko;7;15;22
624;19.07.2017;2017;07;12;Keskiviikko;3;25;28
624;19.07.2017;2017;07;13;Keskiviikko;6;24;30
624;19.07.2017;2017;07;14;Keskiviikko;8;22;30
624;19.07.2017;2017;07;15;Keskiviikko;9;21;30
624;19.07.2017;2017;07;16;Keskiviikko;27;40;67
624;19.07.2017;2017;07;17;Keskiviikko;10;35;45
624;19.07.2017;2017;07;18;Keskiviikko;6;24;30
624;19.07.2017;2017;07;19;Keskiviikko;10;21;31
624;19.07.2017;2017;07;20;Keskiviikko;8;13;21
624;19.07.2017;2017;07;21;Keskiviikko;9;15;24
624;19.07.2017;2017;07;22;Keskiviikko;13;16;29
624;19.07.2017;2017;07;23;Keskiviikko;3;10;13
624;20.07.2017;2017;07;00;Torstai;3;6;9
624;20.07.2017;2017;07;01;Torstai;3;4;7
624;20.07.2017;2017;07;02;Torstai;1;1;2
624;20.07.2017;2017;07;03;Torstai;0;2;2
624;20.07.2017;2017;07;04;Torstai;1;0;1
624;20.07.2017;2017;07;05;Torstai;3;3;6
624;20.07.2017;2017;07;06;Torstai;1;5;6
624;20.07.2017;2017;07;07;Torstai;6;26;32
624;20.07.2017;2017;07;08;Torstai;3;33;36
624;20.07.2017;2017;07;09;Torstai;2;20;22
624;20.07.2017;2017;07;10;Torstai;4;14;18
624;20.07.2017;2017;07;11;Torstai;4;18;22
624;20.07.2017;2017;07;12;Torstai;3;23;26
624;20.07.2017;2017;07;13;Torstai;6;21;27
624;20.07.2017;2017;07;14;Torstai;9;17;26
624;20.07.2017;2017;07;15;Torstai;6;32;38
624;20.07.2017;2017;07;16;Torstai;17;43;60
624;20.07.2017;2017;07;17;Torstai;16;22;38
624;20.07.2017;2017;07;18;Torstai;10;29;39
624;20.07.2017;2017;07;19;Torstai;8;14;22
624;20.07.2017;2017;07;20;Torstai;15;18;33
624;20.07.2017;2017;07;21;Torstai;5;20;25
624;20.07.2017;2017;07;22;Torstai;6;14;20
624;20.07.2017;2017;07;23;Torstai;0;9;9
624;21.07.2017;2017;07;00;Perjantai;0;4;4
624;21.07.2017;2017;07;01;Perjantai;1;4;5
624;21.07.2017;2017;07;02;Perjantai;2;2;4
624;21.07.2017;2017;07;03;Perjantai;0;3;3
624;21.07.2017;2017;07;04;Perjantai;0;0;0
624;21.07.2017;2017;07;05;Perjantai;2;0;2
624;21.07.2017;2017;07;06;Perjantai;0;3;3
624;21.07.2017;2017;07;07;Perjantai;2;28;30
624;21.07.2017;2017;07;08;Perjantai;4;32;36
624;21.07.2017;2017;07;09;Perjantai;3;17;20
624;21.07.2017;2017;07;10;Perjantai;3;15;18
624;21.07.2017;2017;07;11;Perjantai;4;19;23
624;21.07.2017;2017;07;12;Perjantai;8;18;26
624;21.07.2017;2017;07;13;Perjantai;6;27;33
624;21.07.2017;2017;07;14;Perjantai;12;30;42
624;21.07.2017;2017;07;15;Perjantai;19;28;47
624;21.07.2017;2017;07;16;Perjantai;13;22;35
624;21.07.2017;2017;07;17;Perjantai;15;21;36
624;21.07.2017;2017;07;18;Perjantai;14;23;37
624;21.07.2017;2017;07;19;Perjantai;5;21;26
624;21.07.2017;2017;07;20;Perjantai;9;14;23
624;21.07.2017;2017;07;21;Perjantai;3;14;17
624;21.07.2017;2017;07;22;Perjantai;3;13;16
624;21.07.2017;2017;07;23;Perjantai;3;9;12
624;22.07.2017;2017;07;00;Lauantai;1;4;5
624;22.07.2017;2017;07;01;Lauantai;2;5;7
624;22.07.2017;2017;07;02;Lauantai;5;4;9
624;22.07.2017;2017;07;03;Lauantai;0;0;0
624;22.07.2017;2017;07;04;Lauantai;0;0;0
624;22.07.2017;2017;07;05;Lauantai;3;0;3
624;22.07.2017;2017;07;06;Lauantai;4;2;6
624;22.07.2017;2017;07;07;Lauantai;1;3;4
624;22.07.2017;2017;07;08;Lauantai;1;1;2
624;22.07.2017;2017;07;09;Lauantai;1;9;10
624;22.07.2017;2017;07;10;Lauantai;2;16;18
624;22.07.2017;2017;07;11;Lauantai;3;17;20
624;22.07.2017;2017;07;12;Lauantai;6;19;25
624;22.07.2017;2017;07;13;Lauantai;6;11;17
624;22.07.2017;2017;07;14;Lauantai;1;4;5
624;22.07.2017;2017;07;15;Lauantai;10;17;27
624;22.07.2017;2017;07;16;Lauantai;4;20;24
624;22.07.2017;2017;07;17;Lauantai;5;14;19
624;22.07.2017;2017;07;18;Lauantai;13;15;28
624;22.07.2017;2017;07;19;Lauantai;7;18;25
624;22.07.2017;2017;07;20;Lauantai;12;15;27
624;22.07.2017;2017;07;21;Lauantai;3;14;17
624;22.07.2017;2017;07;22;Lauantai;6;4;10
624;22.07.2017;2017;07;23;Lauantai;6;5;11
624;23.07.2017;2017;07;00;Sunnuntai;1;4;5
624;23.07.2017;2017;07;01;Sunnuntai;3;6;9
624;23.07.2017;2017;07;02;Sunnuntai;4;4;8
624;23.07.2017;2017;07;03;Sunnuntai;1;3;4
624;23.07.2017;2017;07;04;Sunnuntai;3;0;3
624;23.07.2017;2017;07;05;Sunnuntai;3;2;5
624;23.07.2017;2017;07;06;Sunnuntai;0;0;0
624;23.07.2017;2017;07;07;Sunnuntai;2;3;5
624;23.07.2017;2017;07;08;Sunnuntai;0;3;3
624;23.07.2017;2017;07;09;Sunnuntai;1;3;4
624;23.07.2017;2017;07;10;Sunnuntai;4;8;12
624;23.07.2017;2017;07;11;Sunnuntai;4;12;16
624;23.07.2017;2017;07;12;Sunnuntai;2;16;18
624;23.07.2017;2017;07;13;Sunnuntai;5;13;18
624;23.07.2017;2017;07;14;Sunnuntai;12;18;30
624;23.07.2017;2017;07;15;Sunnuntai;8;14;22
624;23.07.2017;2017;07;16;Sunnuntai;6;12;18
624;23.07.2017;2017;07;17;Sunnuntai;5;12;17
624;23.07.2017;2017;07;18;Sunnuntai;6;5;11
624;23.07.2017;2017;07;19;Sunnuntai;3;10;13
624;23.07.2017;2017;07;20;Sunnuntai;4;9;13
624;23.07.2017;2017;07;21;Sunnuntai;4;14;18
624;23.07.2017;2017;07;22;Sunnuntai;3;5;8
624;23.07.2017;2017;07;23;Sunnuntai;0;4;4
624;24.07.2017;2017;07;00;Maanantai;3;3;6
624;24.07.2017;2017;07;01;Maanantai;1;1;2
624;24.07.2017;2017;07;02;Maanantai;1;1;2
624;24.07.2017;2017;07;03;Maanantai;0;0;0
624;24.07.2017;2017;07;04;Maanantai;1;1;2
624;24.07.2017;2017;07;05;Maanantai;1;1;2
624;24.07.2017;2017;07;06;Maanantai;2;4;6
624;24.07.2017;2017;07;07;Maanantai;2;27;29
624;24.07.2017;2017;07;08;Maanantai;4;35;39
624;24.07.2017;2017;07;09;Maanantai;2;23;25
624;24.07.2017;2017;07;10;Maanantai;3;27;30
624;24.07.2017;2017;07;11;Maanantai;3;24;27
624;24.07.2017;2017;07;12;Maanantai;1;24;25
624;24.07.2017;2017;07;13;Maanantai;1;31;32
624;24.07.2017;2017;07;14;Maanantai;11;33;44
624;24.07.2017;2017;07;15;Maanantai;11;32;43
624;24.07.2017;2017;07;16;Maanantai;21;62;83
624;24.07.2017;2017;07;17;Maanantai;15;38;53
624;24.07.2017;2017;07;18;Maanantai;15;32;47
624;24.07.2017;2017;07;19;Maanantai;14;25;39
624;24.07.2017;2017;07;20;Maanantai;15;38;53
624;24.07.2017;2017;07;21;Maanantai;7;14;21
624;24.07.2017;2017;07;22;Maanantai;6;17;23
624;24.07.2017;2017;07;23;Maanantai;2;7;9
624;25.07.2017;2017;07;00;Tiistai;3;4;7
624;25.07.2017;2017;07;01;Tiistai;1;3;4
624;25.07.2017;2017;07;02;Tiistai;1;0;1
624;25.07.2017;2017;07;03;Tiistai;1;1;2
624;25.07.2017;2017;07;04;Tiistai;1;1;2
624;25.07.2017;2017;07;05;Tiistai;0;1;1
624;25.07.2017;2017;07;06;Tiistai;1;7;8
624;25.07.2017;2017;07;07;Tiistai;3;23;26
624;25.07.2017;2017;07;08;Tiistai;0;32;32
624;25.07.2017;2017;07;09;Tiistai;7;34;41
624;25.07.2017;2017;07;10;Tiistai;7;28;35
624;25.07.2017;2017;07;11;Tiistai;9;25;34
624;25.07.2017;2017;07;12;Tiistai;11;38;49
624;25.07.2017;2017;07;13;Tiistai;6;30;36
624;25.07.2017;2017;07;14;Tiistai;4;24;28
624;25.07.2017;2017;07;15;Tiistai;11;25;36
624;25.07.2017;2017;07;16;Tiistai;10;38;48
624;25.07.2017;2017;07;17;Tiistai;15;45;60
624;25.07.2017;2017;07;18;Tiistai;14;33;47
624;25.07.2017;2017;07;19;Tiistai;12;30;42
624;25.07.2017;2017;07;20;Tiistai;19;23;42
624;25.07.2017;2017;07;21;Tiistai;5;17;22
624;25.07.2017;2017;07;22;Tiistai;6;22;28
624;25.07.2017;2017;07;23;Tiistai;6;4;10
624;26.07.2017;2017;07;00;Keskiviikko;3;10;13
624;26.07.2017;2017;07;01;Keskiviikko;2;3;5
624;26.07.2017;2017;07;02;Keskiviikko;0;1;1
624;26.07.2017;2017;07;03;Keskiviikko;1;0;1
624;26.07.2017;2017;07;04;Keskiviikko;0;0;0
624;26.07.2017;2017;07;05;Keskiviikko;1;1;2
624;26.07.2017;2017;07;06;Keskiviikko;3;4;7
624;26.07.2017;2017;07;07;Keskiviikko;2;25;27
624;26.07.2017;2017;07;08;Keskiviikko;1;37;38
624;26.07.2017;2017;07;09;Keskiviikko;3;29;32
624;26.07.2017;2017;07;10;Keskiviikko;1;11;12
624;26.07.2017;2017;07;11;Keskiviikko;7;31;38
624;26.07.2017;2017;07;12;Keskiviikko;7;45;52
624;26.07.2017;2017;07;13;Keskiviikko;18;28;46
624;26.07.2017;2017;07;14;Keskiviikko;15;42;57
624;26.07.2017;2017;07;15;Keskiviikko;18;42;60
624;26.07.2017;2017;07;16;Keskiviikko;29;69;98
624;26.07.2017;2017;07;17;Keskiviikko;27;59;86
624;26.07.2017;2017;07;18;Keskiviikko;21;61;82
624;26.07.2017;2017;07;19;Keskiviikko;17;47;64
624;26.07.2017;2017;07;20;Keskiviikko;20;38;58
624;26.07.2017;2017;07;21;Keskiviikko;23;28;51
624;26.07.2017;2017;07;22;Keskiviikko;12;14;26
624;26.07.2017;2017;07;23;Keskiviikko;6;13;19
624;27.07.2017;2017;07;00;Torstai;4;3;7
624;27.07.2017;2017;07;01;Torstai;2;3;5
624;27.07.2017;2017;07;02;Torstai;5;5;10
624;27.07.2017;2017;07;03;Torstai;3;2;5
624;27.07.2017;2017;07;04;Torstai;2;1;3
624;27.07.2017;2017;07;05;Torstai;3;0;3
624;27.07.2017;2017;07;06;Torstai;3;10;13
624;27.07.2017;2017;07;07;Torstai;1;39;40
624;27.07.2017;2017;07;08;Torstai;5;45;50
624;27.07.2017;2017;07;09;Torstai;7;28;35
624;27.07.2017;2017;07;10;Torstai;6;35;41
624;27.07.2017;2017;07;11;Torstai;9;25;34
624;27.07.2017;2017;07;12;Torstai;15;38;53
624;27.07.2017;2017;07;13;Torstai;13;44;57
624;27.07.2017;2017;07;14;Torstai;13;46;59
624;27.07.2017;2017;07;15;Torstai;21;46;67
624;27.07.2017;2017;07;16;Torstai;23;62;85
624;27.07.2017;2017;07;17;Torstai;18;43;61
624;27.07.2017;2017;07;18;Torstai;28;60;88
624;27.07.2017;2017;07;19;Torstai;23;47;70
624;27.07.2017;2017;07;20;Torstai;15;26;41
624;27.07.2017;2017;07;21;Torstai;14;28;42
624;27.07.2017;2017;07;22;Torstai;21;29;50
624;27.07.2017;2017;07;23;Torstai;6;7;13
624;28.07.2017;2017;07;00;Perjantai;3;5;8
624;28.07.2017;2017;07;01;Perjantai;1;6;7
624;28.07.2017;2017;07;02;Perjantai;4;1;5
624;28.07.2017;2017;07;03;Perjantai;4;2;6
624;28.07.2017;2017;07;04;Perjantai;1;0;1
624;28.07.2017;2017;07;05;Perjantai;2;4;6
624;28.07.2017;2017;07;06;Perjantai;2;10;12
624;28.07.2017;2017;07;07;Perjantai;2;18;20
624;28.07.2017;2017;07;08;Perjantai;4;43;47
624;28.07.2017;2017;07;09;Perjantai;5;39;44
624;28.07.2017;2017;07;10;Perjantai;8;30;38
624;28.07.2017;2017;07;11;Perjantai;15;40;55
624;28.07.2017;2017;07;12;Perjantai;16;36;52
624;28.07.2017;2017;07;13;Perjantai;9;39;48
624;28.07.2017;2017;07;14;Perjantai;13;43;56
624;28.07.2017;2017;07;15;Perjantai;26;37;63
624;28.07.2017;2017;07;16;Perjantai;30;60;90
624;28.07.2017;2017;07;17;Perjantai;32;53;85
624;28.07.2017;2017;07;18;Perjantai;14;43;57
624;28.07.2017;2017;07;19;Perjantai;17;34;51
624;28.07.2017;2017;07;20;Perjantai;19;44;63
624;28.07.2017;2017;07;21;Perjantai;15;22;37
624;28.07.2017;2017;07;22;Perjantai;6;17;23
624;28.07.2017;2017;07;23;Perjantai;11;8;19
624;29.07.2017;2017;07;00;Lauantai;10;15;25
624;29.07.2017;2017;07;01;Lauantai;10;5;15
624;29.07.2017;2017;07;02;Lauantai;7;4;11
624;29.07.2017;2017;07;03;Lauantai;8;7;15
624;29.07.2017;2017;07;04;Lauantai;10;4;14
624;29.07.2017;2017;07;05;Lauantai;4;3;7
624;29.07.2017;2017;07;06;Lauantai;2;1;3
624;29.07.2017;2017;07;07;Lauantai;1;4;5
624;29.07.2017;2017;07;08;Lauantai;1;7;8
624;29.07.2017;2017;07;09;Lauantai;2;10;12
624;29.07.2017;2017;07;10;Lauantai;1;18;19
624;29.07.2017;2017;07;11;Lauantai;8;14;22
624;29.07.2017;2017;07;12;Lauantai;5;23;28
624;29.07.2017;2017;07;13;Lauantai;6;17;23
624;29.07.2017;2017;07;14;Lauantai;7;22;29
624;29.07.2017;2017;07;15;Lauantai;7;18;25
624;29.07.2017;2017;07;16;Lauantai;9;15;24
624;29.07.2017;2017;07;17;Lauantai;13;16;29
624;29.07.2017;2017;07;18;Lauantai;10;19;29
624;29.07.2017;2017;07;19;Lauantai;7;21;28
624;29.07.2017;2017;07;20;Lauantai;12;38;50
624;29.07.2017;2017;07;21;Lauantai;7;12;19
624;29.07.2017;2017;07;22;Lauantai;4;11;15
624;29.07.2017;2017;07;23;Lauantai;6;13;19
624;30.07.2017;2017;07;00;Sunnuntai;5;7;12
624;30.07.2017;2017;07;01;Sunnuntai;6;4;10
624;30.07.2017;2017;07;02;Sunnuntai;5;7;12
624;30.07.2017;2017;07;03;Sunnuntai;15;4;19
624;30.07.2017;2017;07;04;Sunnuntai;10;1;11
624;30.07.2017;2017;07;05;Sunnuntai;8;3;11
624;30.07.2017;2017;07;06;Sunnuntai;2;0;2
624;30.07.2017;2017;07;07;Sunnuntai;0;7;7
624;30.07.2017;2017;07;08;Sunnuntai;0;3;3
624;30.07.2017;2017;07;09;Sunnuntai;2;3;5
624;30.07.2017;2017;07;10;Sunnuntai;2;5;7
624;30.07.2017;2017;07;11;Sunnuntai;6;16;22
624;30.07.2017;2017;07;12;Sunnuntai;13;39;52
624;30.07.2017;2017;07;13;Sunnuntai;16;42;58
624;30.07.2017;2017;07;14;Sunnuntai;26;65;91
624;30.07.2017;2017;07;15;Sunnuntai;25;49;74
624;30.07.2017;2017;07;16;Sunnuntai;19;35;54
624;30.07.2017;2017;07;17;Sunnuntai;17;34;51
624;30.07.2017;2017;07;18;Sunnuntai;22;31;53
624;30.07.2017;2017;07;19;Sunnuntai;15;34;49
624;30.07.2017;2017;07;20;Sunnuntai;11;42;53
624;30.07.2017;2017;07;21;Sunnuntai;10;26;36
624;30.07.2017;2017;07;22;Sunnuntai;7;13;20
624;30.07.2017;2017;07;23;Sunnuntai;8;7;15
624;31.07.2017;2017;07;00;Maanantai;5;8;13
624;31.07.2017;2017;07;01;Maanantai;4;5;9
624;31.07.2017;2017;07;02;Maanantai;4;3;7
624;31.07.2017;2017;07;03;Maanantai;1;2;3
624;31.07.2017;2017;07;04;Maanantai;1;0;1
624;31.07.2017;2017;07;05;Maanantai;0;1;1
624;31.07.2017;2017;07;06;Maanantai;2;11;13
624;31.07.2017;2017;07;07;Maanantai;2;30;32
624;31.07.2017;2017;07;08;Maanantai;7;57;64
624;31.07.2017;2017;07;09;Maanantai;7;41;48
624;31.07.2017;2017;07;10;Maanantai;8;34;42
624;31.07.2017;2017;07;11;Maanantai;3;23;26
624;31.07.2017;2017;07;12;Maanantai;12;36;48
624;31.07.2017;2017;07;13;Maanantai;10;32;42
624;31.07.2017;2017;07;14;Maanantai;13;35;48
624;31.07.2017;2017;07;15;Maanantai;17;30;47
624;31.07.2017;2017;07;16;Maanantai;29;57;86
624;31.07.2017;2017;07;17;Maanantai;32;59;91
624;31.07.2017;2017;07;18;Maanantai;24;57;81
624;31.07.2017;2017;07;19;Maanantai;24;35;59
624;31.07.2017;2017;07;20;Maanantai;15;37;52
624;31.07.2017;2017;07;21;Maanantai;16;19;35
624;31.07.2017;2017;07;22;Maanantai;7;16;23
624;31.07.2017;2017;07;23;Maanantai;2;17;19
624;01.08.2017;2017;08;00;Tiistai;3;3;6
624;01.08.2017;2017;08;01;Tiistai;5;3;8
624;01.08.2017;2017;08;02;Tiistai;2;0;2
624;01.08.2017;2017;08;03;Tiistai;1;3;4
624;01.08.2017;2017;08;04;Tiistai;0;0;0
624;01.08.2017;2017;08;05;Tiistai;1;1;2
624;01.08.2017;2017;08;06;Tiistai;2;9;11
624;01.08.2017;2017;08;07;Tiistai;5;28;33
624;01.08.2017;2017;08;08;Tiistai;8;61;69
624;01.08.2017;2017;08;09;Tiistai;6;40;46
624;01.08.2017;2017;08;10;Tiistai;5;25;30
624;01.08.2017;2017;08;11;Tiistai;5;33;38
624;01.08.2017;2017;08;12;Tiistai;9;34;43
624;01.08.2017;2017;08;13;Tiistai;10;43;53
624;01.08.2017;2017;08;14;Tiistai;10;41;51
624;01.08.2017;2017;08;15;Tiistai;17;38;55
624;01.08.2017;2017;08;16;Tiistai;18;58;76
624;01.08.2017;2017;08;17;Tiistai;30;63;93
624;01.08.2017;2017;08;18;Tiistai;21;51;72
624;01.08.2017;2017;08;19;Tiistai;35;47;82
624;01.08.2017;2017;08;20;Tiistai;8;20;28
624;01.08.2017;2017;08;21;Tiistai;13;31;44
624;01.08.2017;2017;08;22;Tiistai;19;26;45
624;01.08.2017;2017;08;23;Tiistai;5;12;17
624;02.08.2017;2017;08;00;Keskiviikko;2;3;5
624;02.08.2017;2017;08;01;Keskiviikko;3;0;3
624;02.08.2017;2017;08;02;Keskiviikko;1;0;1
624;02.08.2017;2017;08;03;Keskiviikko;1;3;4
624;02.08.2017;2017;08;04;Keskiviikko;0;0;0
624;02.08.2017;2017;08;05;Keskiviikko;1;2;3
624;02.08.2017;2017;08;06;Keskiviikko;0;10;10
624;02.08.2017;2017;08;07;Keskiviikko;1;34;35
624;02.08.2017;2017;08;08;Keskiviikko;13;63;76
624;02.08.2017;2017;08;09;Keskiviikko;11;48;59
624;02.08.2017;2017;08;10;Keskiviikko;12;30;42
624;02.08.2017;2017;08;11;Keskiviikko;9;36;45
624;02.08.2017;2017;08;12;Keskiviikko;13;26;39
624;02.08.2017;2017;08;13;Keskiviikko;14;56;70
624;02.08.2017;2017;08;14;Keskiviikko;17;40;57
624;02.08.2017;2017;08;15;Keskiviikko;18;42;60
624;02.08.2017;2017;08;16;Keskiviikko;28;48;76
624;02.08.2017;2017;08;17;Keskiviikko;30;60;90
624;02.08.2017;2017;08;18;Keskiviikko;18;45;63
624;02.08.2017;2017;08;19;Keskiviikko;28;53;81
624;02.08.2017;2017;08;20;Keskiviikko;10;19;29
624;02.08.2017;2017;08;21;Keskiviikko;10;22;32
624;02.08.2017;2017;08;22;Keskiviikko;10;18;28
624;02.08.2017;2017;08;23;Keskiviikko;5;25;30
624;03.08.2017;2017;08;00;Torstai;2;2;4
624;03.08.2017;2017;08;01;Torstai;4;2;6
624;03.08.2017;2017;08;02;Torstai;2;1;3
624;03.08.2017;2017;08;03;Torstai;1;5;6
624;03.08.2017;2017;08;04;Torstai;0;2;2
624;03.08.2017;2017;08;05;Torstai;0;2;2
624;03.08.2017;2017;08;06;Torstai;1;9;10
624;03.08.2017;2017;08;07;Torstai;5;33;38
624;03.08.2017;2017;08;08;Torstai;5;58;63
624;03.08.2017;2017;08;09;Torstai;7;49;56
624;03.08.2017;2017;08;10;Torstai;3;23;26
624;03.08.2017;2017;08;11;Torstai;3;32;35
624;03.08.2017;2017;08;12;Torstai;5;25;30
624;03.08.2017;2017;08;13;Torstai;8;28;36
624;03.08.2017;2017;08;14;Torstai;9;30;39
624;03.08.2017;2017;08;15;Torstai;14;31;45
624;03.08.2017;2017;08;16;Torstai;32;50;82
624;03.08.2017;2017;08;17;Torstai;21;63;84
624;03.08.2017;2017;08;18;Torstai;29;41;70
624;03.08.2017;2017;08;19;Torstai;20;26;46
624;03.08.2017;2017;08;20;Torstai;13;36;49
624;03.08.2017;2017;08;21;Torstai;9;15;24
624;03.08.2017;2017;08;22;Torstai;11;22;33
624;03.08.2017;2017;08;23;Torstai;5;9;14
624;04.08.2017;2017;08;00;Perjantai;8;8;16
624;04.08.2017;2017;08;01;Perjantai;3;1;4
624;04.08.2017;2017;08;02;Perjantai;1;2;3
624;04.08.2017;2017;08;03;Perjantai;1;3;4
624;04.08.2017;2017;08;04;Perjantai;3;0;3
624;04.08.2017;2017;08;05;Perjantai;2;1;3
624;04.08.2017;2017;08;06;Perjantai;2;13;15
624;04.08.2017;2017;08;07;Perjantai;5;22;27
624;04.08.2017;2017;08;08;Perjantai;2;50;52
624;04.08.2017;2017;08;09;Perjantai;12;39;51
624;04.08.2017;2017;08;10;Perjantai;5;28;33
624;04.08.2017;2017;08;11;Perjantai;7;28;35
624;04.08.2017;2017;08;12;Perjantai;9;30;39
624;04.08.2017;2017;08;13;Perjantai;9;41;50
624;04.08.2017;2017;08;14;Perjantai;19;45;64
624;04.08.2017;2017;08;15;Perjantai;15;40;55
624;04.08.2017;2017;08;16;Perjantai;19;55;74
624;04.08.2017;2017;08;17;Perjantai;17;46;63
624;04.08.2017;2017;08;18;Perjantai;20;40;60
624;04.08.2017;2017;08;19;Perjantai;19;26;45
624;04.08.2017;2017;08;20;Perjantai;17;26;43
624;04.08.2017;2017;08;21;Perjantai;20;30;50
624;04.08.2017;2017;08;22;Perjantai;3;16;19
624;04.08.2017;2017;08;23;Perjantai;6;8;14
624;05.08.2017;2017;08;00;Lauantai;2;9;11
624;05.08.2017;2017;08;01;Lauantai;5;20;25
624;05.08.2017;2017;08;02;Lauantai;3;8;11
624;05.08.2017;2017;08;03;Lauantai;2;0;2
624;05.08.2017;2017;08;04;Lauantai;4;2;6
624;05.08.2017;2017;08;05;Lauantai;1;0;1
624;05.08.2017;2017;08;06;Lauantai;0;3;3
624;05.08.2017;2017;08;07;Lauantai;0;8;8
624;05.08.2017;2017;08;08;Lauantai;1;6;7
624;05.08.2017;2017;08;09;Lauantai;2;8;10
624;05.08.2017;2017;08;10;Lauantai;3;20;23
624;05.08.2017;2017;08;11;Lauantai;5;19;24
624;05.08.2017;2017;08;12;Lauantai;7;23;30
624;05.08.2017;2017;08;13;Lauantai;5;18;23
624;05.08.2017;2017;08;14;Lauantai;10;15;25
624;05.08.2017;2017;08;15;Lauantai;7;16;23
624;05.08.2017;2017;08;16;Lauantai;15;14;29
624;05.08.2017;2017;08;17;Lauantai;13;17;30
624;05.08.2017;2017;08;18;Lauantai;11;12;23
624;05.08.2017;2017;08;19;Lauantai;5;14;19
624;05.08.2017;2017;08;20;Lauantai;6;10;16
624;05.08.2017;2017;08;21;Lauantai;8;9;17
624;05.08.2017;2017;08;22;Lauantai;2;8;10
624;05.08.2017;2017;08;23;Lauantai;2;7;9
624;06.08.2017;2017;08;00;Sunnuntai;1;12;13
624;06.08.2017;2017;08;01;Sunnuntai;3;17;20
624;06.08.2017;2017;08;02;Sunnuntai;0;4;4
624;06.08.2017;2017;08;03;Sunnuntai;0;1;1
624;06.08.2017;2017;08;04;Sunnuntai;4;3;7
624;06.08.2017;2017;08;05;Sunnuntai;3;0;3
624;06.08.2017;2017;08;06;Sunnuntai;2;2;4
624;06.08.2017;2017;08;07;Sunnuntai;0;4;4
624;06.08.2017;2017;08;08;Sunnuntai;0;2;2
624;06.08.2017;2017;08;09;Sunnuntai;0;2;2
624;06.08.2017;2017;08;10;Sunnuntai;2;8;10
624;06.08.2017;2017;08;11;Sunnuntai;5;11;16
624;06.08.2017;2017;08;12;Sunnuntai;1;18;19
624;06.08.2017;2017;08;13;Sunnuntai;4;20;24
624;06.08.2017;2017;08;14;Sunnuntai;4;16;20
624;06.08.2017;2017;08;15;Sunnuntai;11;20;31
624;06.08.2017;2017;08;16;Sunnuntai;15;20;35
624;06.08.2017;2017;08;17;Sunnuntai;5;11;16
624;06.08.2017;2017;08;18;Sunnuntai;6;15;21
624;06.08.2017;2017;08;19;Sunnuntai;10;16;26
624;06.08.2017;2017;08;20;Sunnuntai;5;18;23
624;06.08.2017;2017;08;21;Sunnuntai;6;6;12
624;06.08.2017;2017;08;22;Sunnuntai;8;7;15
624;06.08.2017;2017;08;23;Sunnuntai;4;5;9
624;07.08.2017;2017;08;00;Maanantai;2;10;12
624;07.08.2017;2017;08;01;Maanantai;7;12;19
624;07.08.2017;2017;08;02;Maanantai;2;3;5
624;07.08.2017;2017;08;03;Maanantai;0;2;2
624;07.08.2017;2017;08;04;Maanantai;3;0;3
624;07.08.2017;2017;08;05;Maanantai;1;2;3
624;07.08.2017;2017;08;06;Maanantai;4;10;14
624;07.08.2017;2017;08;07;Maanantai;6;34;40
624;07.08.2017;2017;08;08;Maanantai;9;78;87
624;07.08.2017;2017;08;09;Maanantai;12;60;72
624;07.08.2017;2017;08;10;Maanantai;4;43;47
624;07.08.2017;2017;08;11;Maanantai;3;29;32
624;07.08.2017;2017;08;12;Maanantai;5;20;25
624;07.08.2017;2017;08;13;Maanantai;14;27;41
624;07.08.2017;2017;08;14;Maanantai;18;33;51
624;07.08.2017;2017;08;15;Maanantai;24;34;58
624;07.08.2017;2017;08;16;Maanantai;19;42;61
624;07.08.2017;2017;08;17;Maanantai;32;70;102
624;07.08.2017;2017;08;18;Maanantai;20;37;57
624;07.08.2017;2017;08;19;Maanantai;24;25;49
624;07.08.2017;2017;08;20;Maanantai;9;15;24
624;07.08.2017;2017;08;21;Maanantai;13;28;41
624;07.08.2017;2017;08;22;Maanantai;4;14;18
624;07.08.2017;2017;08;23;Maanantai;1;13;14
624;08.08.2017;2017;08;00;Tiistai;1;5;6
624;08.08.2017;2017;08;01;Tiistai;3;9;12
624;08.08.2017;2017;08;02;Tiistai;1;2;3
624;08.08.2017;2017;08;03;Tiistai;1;1;2
624;08.08.2017;2017;08;04;Tiistai;5;1;6
624;08.08.2017;2017;08;05;Tiistai;2;3;5
624;08.08.2017;2017;08;06;Tiistai;0;13;13
624;08.08.2017;2017;08;07;Tiistai;6;35;41
624;08.08.2017;2017;08;08;Tiistai;9;77;86
624;08.08.2017;2017;08;09;Tiistai;8;62;70
624;08.08.2017;2017;08;10;Tiistai;10;36;46
624;08.08.2017;2017;08;11;Tiistai;3;34;37
624;08.08.2017;2017;08;12;Tiistai;9;50;59
624;08.08.2017;2017;08;13;Tiistai;14;34;48
624;08.08.2017;2017;08;14;Tiistai;9;36;45
624;08.08.2017;2017;08;15;Tiistai;26;55;81
624;08.08.2017;2017;08;16;Tiistai;21;59;80
624;08.08.2017;2017;08;17;Tiistai;35;75;110
624;08.08.2017;2017;08;18;Tiistai;28;52;80
624;08.08.2017;2017;08;19;Tiistai;17;33;50
624;08.08.2017;2017;08;20;Tiistai;16;20;36
624;08.08.2017;2017;08;21;Tiistai;12;24;36
624;08.08.2017;2017;08;22;Tiistai;12;16;28
624;08.08.2017;2017;08;23;Tiistai;3;3;6
624;09.08.2017;2017;08;00;Keskiviikko;0;2;2
624;09.08.2017;2017;08;01;Keskiviikko;0;3;3
624;09.08.2017;2017;08;02;Keskiviikko;3;2;5
624;09.08.2017;2017;08;03;Keskiviikko;0;0;0
624;09.08.2017;2017;08;04;Keskiviikko;1;0;1
624;09.08.2017;2017;08;05;Keskiviikko;0;0;0
624;09.08.2017;2017;08;06;Keskiviikko;6;11;17
624;09.08.2017;2017;08;07;Keskiviikko;5;36;41
624;09.08.2017;2017;08;08;Keskiviikko;8;84;92
624;09.08.2017;2017;08;09;Keskiviikko;10;70;80
624;09.08.2017;2017;08;10;Keskiviikko;5;34;39
624;09.08.2017;2017;08;11;Keskiviikko;6;16;22
624;09.08.2017;2017;08;12;Keskiviikko;10;33;43
624;09.08.2017;2017;08;13;Keskiviikko;11;46;57
624;09.08.2017;2017;08;14;Keskiviikko;21;29;50
624;09.08.2017;2017;08;15;Keskiviikko;15;35;50
624;09.08.2017;2017;08;16;Keskiviikko;28;42;70
624;09.08.2017;2017;08;17;Keskiviikko;16;74;90
624;09.08.2017;2017;08;18;Keskiviikko;23;49;72
624;09.08.2017;2017;08;19;Keskiviikko;21;30;51
624;09.08.2017;2017;08;20;Keskiviikko;11;18;29
624;09.08.2017;2017;08;21;Keskiviikko;14;27;41
624;09.08.2017;2017;08;22;Keskiviikko;8;25;33
624;09.08.2017;2017;08;23;Keskiviikko;1;10;11
624;10.08.2017;2017;08;00;Torstai;3;6;9
624;10.08.2017;2017;08;01;Torstai;5;2;7
624;10.08.2017;2017;08;02;Torstai;1;5;6
624;10.08.2017;2017;08;03;Torstai;1;0;1
624;10.08.2017;2017;08;04;Torstai;1;0;1
624;10.08.2017;2017;08;05;Torstai;4;2;6
624;10.08.2017;2017;08;06;Torstai;1;12;13
624;10.08.2017;2017;08;07;Torstai;3;34;37
624;10.08.2017;2017;08;08;Torstai;12;68;80
624;10.08.2017;2017;08;09;Torstai;8;55;63
624;10.08.2017;2017;08;10;Torstai;13;60;73
624;10.08.2017;2017;08;11;Torstai;5;32;37
624;10.08.2017;2017;08;12;Torstai;5;21;26
624;10.08.2017;2017;08;13;Torstai;5;13;18
624;10.08.2017;2017;08;14;Torstai;17;10;27
624;10.08.2017;2017;08;15;Torstai;13;11;24
624;10.08.2017;2017;08;16;Torstai;15;38;53
624;10.08.2017;2017;08;17;Torstai;29;27;56
624;10.08.2017;2017;08;18;Torstai;14;24;38
624;10.08.2017;2017;08;19;Torstai;16;26;42
624;10.08.2017;2017;08;20;Torstai;8;15;23
624;10.08.2017;2017;08;21;Torstai;5;21;26
624;10.08.2017;2017;08;22;Torstai;2;11;13
624;10.08.2017;2017;08;23;Torstai;4;8;12
624;11.08.2017;2017;08;00;Perjantai;1;4;5
624;11.08.2017;2017;08;01;Perjantai;2;5;7
624;11.08.2017;2017;08;02;Perjantai;1;0;1
624;11.08.2017;2017;08;03;Perjantai;2;0;2
624;11.08.2017;2017;08;04;Perjantai;0;2;2
624;11.08.2017;2017;08;05;Perjantai;0;2;2
624;11.08.2017;2017;08;06;Perjantai;2;9;11
624;11.08.2017;2017;08;07;Perjantai;6;35;41
624;11.08.2017;2017;08;08;Perjantai;16;76;92
624;11.08.2017;2017;08;09;Perjantai;19;62;81
624;11.08.2017;2017;08;10;Perjantai;4;32;36
624;11.08.2017;2017;08;11;Perjantai;5;29;34
624;11.08.2017;2017;08;12;Perjantai;5;37;42
624;11.08.2017;2017;08;13;Perjantai;17;27;44
624;11.08.2017;2017;08;14;Perjantai;16;27;43
624;11.08.2017;2017;08;15;Perjantai;20;52;72
624;11.08.2017;2017;08;16;Perjantai;16;47;63
624;11.08.2017;2017;08;17;Perjantai;16;42;58
624;11.08.2017;2017;08;18;Perjantai;10;46;56
624;11.08.2017;2017;08;19;Perjantai;9;32;41
624;11.08.2017;2017;08;20;Perjantai;14;26;40
624;11.08.2017;2017;08;21;Perjantai;10;31;41
624;11.08.2017;2017;08;22;Perjantai;17;21;38
624;11.08.2017;2017;08;23;Perjantai;3;6;9
624;12.08.2017;2017;08;00;Lauantai;4;4;8
624;12.08.2017;2017;08;01;Lauantai;5;4;9
624;12.08.2017;2017;08;02;Lauantai;4;3;7
624;12.08.2017;2017;08;03;Lauantai;4;6;10
624;12.08.2017;2017;08;04;Lauantai;4;1;5
624;12.08.2017;2017;08;05;Lauantai;4;0;4
624;12.08.2017;2017;08;06;Lauantai;1;2;3
624;12.08.2017;2017;08;07;Lauantai;1;5;6
624;12.08.2017;2017;08;08;Lauantai;2;1;3
624;12.08.2017;2017;08;09;Lauantai;8;12;20
624;12.08.2017;2017;08;10;Lauantai;8;21;29
624;12.08.2017;2017;08;11;Lauantai;11;32;43
624;12.08.2017;2017;08;12;Lauantai;11;32;43
624;12.08.2017;2017;08;13;Lauantai;10;34;44
624;12.08.2017;2017;08;14;Lauantai;14;46;60
624;12.08.2017;2017;08;15;Lauantai;13;35;48
624;12.08.2017;2017;08;16;Lauantai;15;38;53
624;12.08.2017;2017;08;17;Lauantai;13;36;49
624;12.08.2017;2017;08;18;Lauantai;20;32;52
624;12.08.2017;2017;08;19;Lauantai;7;43;50
624;12.08.2017;2017;08;20;Lauantai;12;26;38
624;12.08.2017;2017;08;21;Lauantai;5;26;31
624;12.08.2017;2017;08;22;Lauantai;6;13;19
624;12.08.2017;2017;08;23;Lauantai;2;10;12
624;13.08.2017;2017;08;00;Sunnuntai;10;14;24
624;13.08.2017;2017;08;01;Sunnuntai;6;9;15
624;13.08.2017;2017;08;02;Sunnuntai;7;5;12
624;13.08.2017;2017;08;03;Sunnuntai;4;3;7
624;13.08.2017;2017;08;04;Sunnuntai;8;6;14
624;13.08.2017;2017;08;05;Sunnuntai;4;2;6
624;13.08.2017;2017;08;06;Sunnuntai;2;0;2
624;13.08.2017;2017;08;07;Sunnuntai;2;10;12
624;13.08.2017;2017;08;08;Sunnuntai;2;2;4
624;13.08.2017;2017;08;09;Sunnuntai;1;3;4
624;13.08.2017;2017;08;10;Sunnuntai;5;0;5
624;13.08.2017;2017;08;11;Sunnuntai;5;8;13
624;13.08.2017;2017;08;12;Sunnuntai;7;11;18
624;13.08.2017;2017;08;13;Sunnuntai;9;11;20
624;13.08.2017;2017;08;14;Sunnuntai;3;9;12
624;13.08.2017;2017;08;15;Sunnuntai;8;23;31
624;13.08.2017;2017;08;16;Sunnuntai;9;11;20
624;13.08.2017;2017;08;17;Sunnuntai;8;19;27
624;13.08.2017;2017;08;18;Sunnuntai;8;15;23
624;13.08.2017;2017;08;19;Sunnuntai;6;19;25
624;13.08.2017;2017;08;20;Sunnuntai;14;16;30
624;13.08.2017;2017;08;21;Sunnuntai;9;17;26
624;13.08.2017;2017;08;22;Sunnuntai;8;7;15
624;13.08.2017;2017;08;23;Sunnuntai;3;2;5
624;14.08.2017;2017;08;00;Maanantai;1;5;6
624;14.08.2017;2017;08;01;Maanantai;0;2;2
624;14.08.2017;2017;08;02;Maanantai;3;1;4
624;14.08.2017;2017;08;03;Maanantai;1;0;1
624;14.08.2017;2017;08;04;Maanantai;0;2;2
624;14.08.2017;2017;08;05;Maanantai;0;2;2
624;14.08.2017;2017;08;06;Maanantai;3;9;12
624;14.08.2017;2017;08;07;Maanantai;4;38;42
624;14.08.2017;2017;08;08;Maanantai;10;88;98
624;14.08.2017;2017;08;09;Maanantai;22;86;108
624;14.08.2017;2017;08;10;Maanantai;6;29;35
624;14.08.2017;2017;08;11;Maanantai;4;21;25
624;14.08.2017;2017;08;12;Maanantai;4;24;28
624;14.08.2017;2017;08;13;Maanantai;5;34;39
624;14.08.2017;2017;08;14;Maanantai;8;29;37
624;14.08.2017;2017;08;15;Maanantai;18;29;47
624;14.08.2017;2017;08;16;Maanantai;26;54;80
624;14.08.2017;2017;08;17;Maanantai;24;60;84
624;14.08.2017;2017;08;18;Maanantai;22;35;57
624;14.08.2017;2017;08;19;Maanantai;12;26;38
624;14.08.2017;2017;08;20;Maanantai;11;30;41
624;14.08.2017;2017;08;21;Maanantai;12;26;38
624;14.08.2017;2017;08;22;Maanantai;8;14;22
624;14.08.2017;2017;08;23;Maanantai;7;15;22
624;15.08.2017;2017;08;00;Tiistai;2;4;6
624;15.08.2017;2017;08;01;Tiistai;1;1;2
624;15.08.2017;2017;08;02;Tiistai;3;1;4
624;15.08.2017;2017;08;03;Tiistai;0;0;0
624;15.08.2017;2017;08;04;Tiistai;0;1;1
624;15.08.2017;2017;08;05;Tiistai;1;2;3
624;15.08.2017;2017;08;06;Tiistai;1;10;11
624;15.08.2017;2017;08;07;Tiistai;4;41;45
624;15.08.2017;2017;08;08;Tiistai;10;95;105
624;15.08.2017;2017;08;09;Tiistai;10;83;93
624;15.08.2017;2017;08;10;Tiistai;4;31;35
624;15.08.2017;2017;08;11;Tiistai;3;35;38
624;15.08.2017;2017;08;12;Tiistai;7;42;49
624;15.08.2017;2017;08;13;Tiistai;8;36;44
624;15.08.2017;2017;08;14;Tiistai;9;30;39
624;15.08.2017;2017;08;15;Tiistai;18;27;45
624;15.08.2017;2017;08;16;Tiistai;22;42;64
624;15.08.2017;2017;08;17;Tiistai;24;64;88
624;15.08.2017;2017;08;18;Tiistai;21;36;57
624;15.08.2017;2017;08;19;Tiistai;16;47;63
624;15.08.2017;2017;08;20;Tiistai;13;17;30
624;15.08.2017;2017;08;21;Tiistai;8;32;40
624;15.08.2017;2017;08;22;Tiistai;9;16;25
624;15.08.2017;2017;08;23;Tiistai;2;12;14
624;16.08.2017;2017;08;00;Keskiviikko;3;6;9
624;16.08.2017;2017;08;01;Keskiviikko;1;3;4
624;16.08.2017;2017;08;02;Keskiviikko;1;0;1
624;16.08.2017;2017;08;03;Keskiviikko;0;2;2
624;16.08.2017;2017;08;04;Keskiviikko;1;1;2
624;16.08.2017;2017;08;05;Keskiviikko;0;1;1
624;16.08.2017;2017;08;06;Keskiviikko;1;14;15
624;16.08.2017;2017;08;07;Keskiviikko;2;32;34
624;16.08.2017;2017;08;08;Keskiviikko;10;96;106
624;16.08.2017;2017;08;09;Keskiviikko;11;74;85
624;16.08.2017;2017;08;10;Keskiviikko;6;31;37
624;16.08.2017;2017;08;11;Keskiviikko;5;26;31
624;16.08.2017;2017;08;12;Keskiviikko;7;20;27
624;16.08.2017;2017;08;13;Keskiviikko;11;41;52
624;16.08.2017;2017;08;14;Keskiviikko;7;28;35
624;16.08.2017;2017;08;15;Keskiviikko;16;39;55
624;16.08.2017;2017;08;16;Keskiviikko;30;58;88
624;16.08.2017;2017;08;17;Keskiviikko;27;66;93
624;16.08.2017;2017;08;18;Keskiviikko;23;45;68
624;16.08.2017;2017;08;19;Keskiviikko;15;29;44
624;16.08.2017;2017;08;20;Keskiviikko;7;24;31
624;16.08.2017;2017;08;21;Keskiviikko;6;23;29
624;16.08.2017;2017;08;22;Keskiviikko;7;14;21
624;16.08.2017;2017;08;23;Keskiviikko;2;14;16
624;17.08.2017;2017;08;00;Torstai;3;2;5
624;17.08.2017;2017;08;01;Torstai;0;2;2
624;17.08.2017;2017;08;02;Torstai;1;1;2
624;17.08.2017;2017;08;03;Torstai;0;2;2
624;17.08.2017;2017;08;04;Torstai;0;2;2
624;17.08.2017;2017;08;05;Torstai;0;1;1
624;17.08.2017;2017;08;06;Torstai;2;8;10
624;17.08.2017;2017;08;07;Torstai;4;34;38
624;17.08.2017;2017;08;08;Torstai;10;94;104
624;17.08.2017;2017;08;09;Torstai;13;71;84
624;17.08.2017;2017;08;10;Torstai;4;31;35
624;17.08.2017;2017;08;11;Torstai;6;36;42
624;17.08.2017;2017;08;12;Torstai;8;24;32
624;17.08.2017;2017;08;13;Torstai;11;26;37
624;17.08.2017;2017;08;14;Torstai;12;24;36
624;17.08.2017;2017;08;15;Torstai;20;41;61
624;17.08.2017;2017;08;16;Torstai;23;47;70
624;17.08.2017;2017;08;17;Torstai;20;48;68
624;17.08.2017;2017;08;18;Torstai;18;51;69
624;17.08.2017;2017;08;19;Torstai;22;41;63
624;17.08.2017;2017;08;20;Torstai;14;28;42
624;17.08.2017;2017;08;21;Torstai;6;31;37
624;17.08.2017;2017;08;22;Torstai;11;18;29
624;17.08.2017;2017;08;23;Torstai;7;7;14
624;18.08.2017;2017;08;00;Perjantai;4;6;10
624;18.08.2017;2017;08;01;Perjantai;3;4;7
624;18.08.2017;2017;08;02;Perjantai;3;0;3
624;18.08.2017;2017;08;03;Perjantai;2;0;2
624;18.08.2017;2017;08;04;Perjantai;6;0;6
624;18.08.2017;2017;08;05;Perjantai;2;3;5
624;18.08.2017;2017;08;06;Perjantai;3;11;14
624;18.08.2017;2017;08;07;Perjantai;0;29;29
624;18.08.2017;2017;08;08;Perjantai;8;85;93
624;18.08.2017;2017;08;09;Perjantai;9;56;65
624;18.08.2017;2017;08;10;Perjantai;3;27;30
624;18.08.2017;2017;08;11;Perjantai;5;22;27
624;18.08.2017;2017;08;12;Perjantai;8;26;34
624;18.08.2017;2017;08;13;Perjantai;13;24;37
624;18.08.2017;2017;08;14;Perjantai;9;22;31
624;18.08.2017;2017;08;15;Perjantai;18;31;49
624;18.08.2017;2017;08;16;Perjantai;19;31;50
624;18.08.2017;2017;08;17;Perjantai;12;55;67
624;18.08.2017;2017;08;18;Perjantai;12;23;35
624;18.08.2017;2017;08;19;Perjantai;7;28;35
624;18.08.2017;2017;08;20;Perjantai;7;11;18
624;18.08.2017;2017;08;21;Perjantai;6;32;38
624;18.08.2017;2017;08;22;Perjantai;6;9;15
624;18.08.2017;2017;08;23;Perjantai;6;4;10
624;19.08.2017;2017;08;00;Lauantai;3;5;8
624;19.08.2017;2017;08;01;Lauantai;5;2;7
624;19.08.2017;2017;08;02;Lauantai;4;4;8
624;19.08.2017;2017;08;03;Lauantai;2;0;2
624;19.08.2017;2017;08;04;Lauantai;1;1;2
624;19.08.2017;2017;08;05;Lauantai;3;1;4
624;19.08.2017;2017;08;06;Lauantai;1;0;1
624;19.08.2017;2017;08;07;Lauantai;0;6;6
624;19.08.2017;2017;08;08;Lauantai;1;5;6
624;19.08.2017;2017;08;09;Lauantai;1;8;9
624;19.08.2017;2017;08;10;Lauantai;1;11;12
624;19.08.2017;2017;08;11;Lauantai;2;20;22
624;19.08.2017;2017;08;12;Lauantai;9;25;34
624;19.08.2017;2017;08;13;Lauantai;8;18;26
624;19.08.2017;2017;08;14;Lauantai;14;28;42
624;19.08.2017;2017;08;15;Lauantai;9;18;27
624;19.08.2017;2017;08;16;Lauantai;12;21;33
624;19.08.2017;2017;08;17;Lauantai;13;18;31
624;19.08.2017;2017;08;18;Lauantai;9;15;24
624;19.08.2017;2017;08;19;Lauantai;8;19;27
624;19.08.2017;2017;08;20;Lauantai;8;17;25
624;19.08.2017;2017;08;21;Lauantai;6;12;18
624;19.08.2017;2017;08;22;Lauantai;6;9;15
624;19.08.2017;2017;08;23;Lauantai;1;10;11
624;20.08.2017;2017;08;00;Sunnuntai;2;6;8
624;20.08.2017;2017;08;01;Sunnuntai;2;2;4
624;20.08.2017;2017;08;02;Sunnuntai;0;3;3
624;20.08.2017;2017;08;03;Sunnuntai;3;1;4
624;20.08.2017;2017;08;04;Sunnuntai;4;0;4
624;20.08.2017;2017;08;05;Sunnuntai;2;3;5
624;20.08.2017;2017;08;06;Sunnuntai;2;2;4
624;20.08.2017;2017;08;07;Sunnuntai;0;5;5
624;20.08.2017;2017;08;08;Sunnuntai;0;3;3
624;20.08.2017;2017;08;09;Sunnuntai;1;4;5
624;20.08.2017;2017;08;10;Sunnuntai;2;5;7
624;20.08.2017;2017;08;11;Sunnuntai;4;12;16
624;20.08.2017;2017;08;12;Sunnuntai;4;19;23
624;20.08.2017;2017;08;13;Sunnuntai;6;18;24
624;20.08.2017;2017;08;14;Sunnuntai;7;17;24
624;20.08.2017;2017;08;15;Sunnuntai;13;24;37
624;20.08.2017;2017;08;16;Sunnuntai;2;21;23
624;20.08.2017;2017;08;17;Sunnuntai;6;25;31
624;20.08.2017;2017;08;18;Sunnuntai;8;21;29
624;20.08.2017;2017;08;19;Sunnuntai;12;12;24
624;20.08.2017;2017;08;20;Sunnuntai;8;16;24
624;20.08.2017;2017;08;21;Sunnuntai;7;20;27
624;20.08.2017;2017;08;22;Sunnuntai;5;12;17
624;20.08.2017;2017;08;23;Sunnuntai;3;4;7
624;21.08.2017;2017;08;00;Maanantai;1;4;5
624;21.08.2017;2017;08;01;Maanantai;2;2;4
624;21.08.2017;2017;08;02;Maanantai;0;1;1
624;21.08.2017;2017;08;03;Maanantai;1;1;2
624;21.08.2017;2017;08;04;Maanantai;0;3;3
624;21.08.2017;2017;08;05;Maanantai;0;0;0
624;21.08.2017;2017;08;06;Maanantai;1;9;10
624;21.08.2017;2017;08;07;Maanantai;1;31;32
624;21.08.2017;2017;08;08;Maanantai;10;100;110
624;21.08.2017;2017;08;09;Maanantai;17;89;106
624;21.08.2017;2017;08;10;Maanantai;10;48;58
624;21.08.2017;2017;08;11;Maanantai;4;22;26
624;21.08.2017;2017;08;12;Maanantai;11;24;35
624;21.08.2017;2017;08;13;Maanantai;9;32;41
624;21.08.2017;2017;08;14;Maanantai;6;29;35
624;21.08.2017;2017;08;15;Maanantai;21;39;60
624;21.08.2017;2017;08;16;Maanantai;22;37;59
624;21.08.2017;2017;08;17;Maanantai;35;57;92
624;21.08.2017;2017;08;18;Maanantai;23;59;82
624;21.08.2017;2017;08;19;Maanantai;16;30;46
624;21.08.2017;2017;08;20;Maanantai;10;30;40
624;21.08.2017;2017;08;21;Maanantai;8;16;24
624;21.08.2017;2017;08;22;Maanantai;10;13;23
624;21.08.2017;2017;08;23;Maanantai;4;9;13
624;22.08.2017;2017;08;00;Tiistai;0;3;3
624;22.08.2017;2017;08;01;Tiistai;2;2;4
624;22.08.2017;2017;08;02;Tiistai;0;1;1
624;22.08.2017;2017;08;03;Tiistai;0;1;1
624;22.08.2017;2017;08;04;Tiistai;0;0;0
624;22.08.2017;2017;08;05;Tiistai;0;1;1
624;22.08.2017;2017;08;06;Tiistai;3;7;10
624;22.08.2017;2017;08;07;Tiistai;4;35;39
624;22.08.2017;2017;08;08;Tiistai;10;103;113
624;22.08.2017;2017;08;09;Tiistai;12;79;91
624;22.08.2017;2017;08;10;Tiistai;4;42;46
624;22.08.2017;2017;08;11;Tiistai;8;22;30
624;22.08.2017;2017;08;12;Tiistai;8;27;35
624;22.08.2017;2017;08;13;Tiistai;10;23;33
624;22.08.2017;2017;08;14;Tiistai;16;21;37
624;22.08.2017;2017;08;15;Tiistai;11;34;45
624;22.08.2017;2017;08;16;Tiistai;22;39;61
624;22.08.2017;2017;08;17;Tiistai;23;59;82
624;22.08.2017;2017;08;18;Tiistai;16;31;47
624;22.08.2017;2017;08;19;Tiistai;12;20;32
624;22.08.2017;2017;08;20;Tiistai;9;11;20
624;22.08.2017;2017;08;21;Tiistai;11;16;27
624;22.08.2017;2017;08;22;Tiistai;9;11;20
624;22.08.2017;2017;08;23;Tiistai;2;7;9
624;23.08.2017;2017;08;00;Keskiviikko;1;5;6
624;23.08.2017;2017;08;01;Keskiviikko;0;3;3
624;23.08.2017;2017;08;02;Keskiviikko;1;1;2
624;23.08.2017;2017;08;03;Keskiviikko;2;0;2
624;23.08.2017;2017;08;04;Keskiviikko;0;3;3
624;23.08.2017;2017;08;05;Keskiviikko;3;1;4
624;23.08.2017;2017;08;06;Keskiviikko;2;9;11
624;23.08.2017;2017;08;07;Keskiviikko;5;33;38
624;23.08.2017;2017;08;08;Keskiviikko;9;96;105
624;23.08.2017;2017;08;09;Keskiviikko;13;87;100
624;23.08.2017;2017;08;10;Keskiviikko;7;52;59
624;23.08.2017;2017;08;11;Keskiviikko;7;18;25
624;23.08.2017;2017;08;12;Keskiviikko;10;44;54
624;23.08.2017;2017;08;13;Keskiviikko;9;26;35
624;23.08.2017;2017;08;14;Keskiviikko;11;29;40
624;23.08.2017;2017;08;15;Keskiviikko;21;32;53
624;23.08.2017;2017;08;16;Keskiviikko;21;40;61
624;23.08.2017;2017;08;17;Keskiviikko;31;54;85
624;23.08.2017;2017;08;18;Keskiviikko;22;30;52
624;23.08.2017;2017;08;19;Keskiviikko;10;31;41
624;23.08.2017;2017;08;20;Keskiviikko;7;20;27
624;23.08.2017;2017;08;21;Keskiviikko;7;17;24
624;23.08.2017;2017;08;22;Keskiviikko;8;12;20
624;23.08.2017;2017;08;23;Keskiviikko;4;3;7
624;24.08.2017;2017;08;00;Torstai;3;5;8
624;24.08.2017;2017;08;01;Torstai;0;1;1
624;24.08.2017;2017;08;02;Torstai;0;0;0
624;24.08.2017;2017;08;03;Torstai;0;2;2
624;24.08.2017;2017;08;04;Torstai;0;2;2
624;24.08.2017;2017;08;05;Torstai;1;3;4
624;24.08.2017;2017;08;06;Torstai;3;8;11
624;24.08.2017;2017;08;07;Torstai;4;33;37
624;24.08.2017;2017;08;08;Torstai;10;73;83
624;24.08.2017;2017;08;09;Torstai;11;94;105
624;24.08.2017;2017;08;10;Torstai;5;34;39
624;24.08.2017;2017;08;11;Torstai;7;27;34
624;24.08.2017;2017;08;12;Torstai;7;29;36
624;24.08.2017;2017;08;13;Torstai;4;24;28
624;24.08.2017;2017;08;14;Torstai;20;29;49
624;24.08.2017;2017;08;15;Torstai;22;35;57
624;24.08.2017;2017;08;16;Torstai;20;33;53
624;24.08.2017;2017;08;17;Torstai;25;54;79
624;24.08.2017;2017;08;18;Torstai;15;35;50
624;24.08.2017;2017;08;19;Torstai;12;19;31
624;24.08.2017;2017;08;20;Torstai;22;28;50
624;24.08.2017;2017;08;21;Torstai;15;15;30
624;24.08.2017;2017;08;22;Torstai;9;14;23
624;24.08.2017;2017;08;23;Torstai;6;7;13
624;25.08.2017;2017;08;00;Perjantai;2;3;5
624;25.08.2017;2017;08;01;Perjantai;1;4;5
624;25.08.2017;2017;08;02;Perjantai;3;0;3
624;25.08.2017;2017;08;03;Perjantai;0;0;0
624;25.08.2017;2017;08;04;Perjantai;0;2;2
624;25.08.2017;2017;08;05;Perjantai;2;2;4
624;25.08.2017;2017;08;06;Perjantai;2;11;13
624;25.08.2017;2017;08;07;Perjantai;6;24;30
624;25.08.2017;2017;08;08;Perjantai;9;65;74
624;25.08.2017;2017;08;09;Perjantai;15;84;99
624;25.08.2017;2017;08;10;Perjantai;7;20;27
624;25.08.2017;2017;08;11;Perjantai;6;13;19
624;25.08.2017;2017;08;12;Perjantai;3;18;21
624;25.08.2017;2017;08;13;Perjantai;11;19;30
624;25.08.2017;2017;08;14;Perjantai;11;14;25
624;25.08.2017;2017;08;15;Perjantai;21;29;50
624;25.08.2017;2017;08;16;Perjantai;24;19;43
624;25.08.2017;2017;08;17;Perjantai;12;24;36
624;25.08.2017;2017;08;18;Perjantai;5;15;20
624;25.08.2017;2017;08;19;Perjantai;7;19;26
624;25.08.2017;2017;08;20;Perjantai;7;10;17
624;25.08.2017;2017;08;21;Perjantai;8;11;19
624;25.08.2017;2017;08;22;Perjantai;1;11;12
624;25.08.2017;2017;08;23;Perjantai;5;4;9
624;26.08.2017;2017;08;00;Lauantai;2;6;8
624;26.08.2017;2017;08;01;Lauantai;0;3;3
624;26.08.2017;2017;08;02;Lauantai;0;3;3
624;26.08.2017;2017;08;03;Lauantai;2;1;3
624;26.08.2017;2017;08;04;Lauantai;2;0;2
624;26.08.2017;2017;08;05;Lauantai;3;2;5
624;26.08.2017;2017;08;06;Lauantai;0;1;1
624;26.08.2017;2017;08;07;Lauantai;0;4;4
624;26.08.2017;2017;08;08;Lauantai;2;4;6
624;26.08.2017;2017;08;09;Lauantai;1;5;6
624;26.08.2017;2017;08;10;Lauantai;2;10;12
624;26.08.2017;2017;08;11;Lauantai;3;8;11
624;26.08.2017;2017;08;12;Lauantai;7;24;31
624;26.08.2017;2017;08;13;Lauantai;2;15;17
624;26.08.2017;2017;08;14;Lauantai;3;19;22
624;26.08.2017;2017;08;15;Lauantai;6;18;24
624;26.08.2017;2017;08;16;Lauantai;8;15;23
624;26.08.2017;2017;08;17;Lauantai;7;26;33
624;26.08.2017;2017;08;18;Lauantai;8;14;22
624;26.08.2017;2017;08;19;Lauantai;3;5;8
624;26.08.2017;2017;08;20;Lauantai;7;18;25
624;26.08.2017;2017;08;21;Lauantai;8;19;27
624;26.08.2017;2017;08;22;Lauantai;5;9;14
624;26.08.2017;2017;08;23;Lauantai;3;7;10
624;27.08.2017;2017;08;00;Sunnuntai;5;4;9
624;27.08.2017;2017;08;01;Sunnuntai;2;7;9
624;27.08.2017;2017;08;02;Sunnuntai;2;1;3
624;27.08.2017;2017;08;03;Sunnuntai;5;1;6
624;27.08.2017;2017;08;04;Sunnuntai;2;0;2
624;27.08.2017;2017;08;05;Sunnuntai;2;2;4
624;27.08.2017;2017;08;06;Sunnuntai;2;0;2
624;27.08.2017;2017;08;07;Sunnuntai;0;4;4
624;27.08.2017;2017;08;08;Sunnuntai;1;1;2
624;27.08.2017;2017;08;09;Sunnuntai;1;4;5
624;27.08.2017;2017;08;10;Sunnuntai;3;8;11
624;27.08.2017;2017;08;11;Sunnuntai;3;6;9
624;27.08.2017;2017;08;12;Sunnuntai;5;20;25
624;27.08.2017;2017;08;13;Sunnuntai;5;20;25
624;27.08.2017;2017;08;14;Sunnuntai;7;21;28
624;27.08.2017;2017;08;15;Sunnuntai;6;10;16
624;27.08.2017;2017;08;16;Sunnuntai;12;12;24
624;27.08.2017;2017;08;17;Sunnuntai;11;35;46
624;27.08.2017;2017;08;18;Sunnuntai;17;17;34
624;27.08.2017;2017;08;19;Sunnuntai;6;17;23
624;27.08.2017;2017;08;20;Sunnuntai;7;21;28
624;27.08.2017;2017;08;21;Sunnuntai;4;11;15
624;27.08.2017;2017;08;22;Sunnuntai;11;11;22
624;27.08.2017;2017;08;23;Sunnuntai;5;5;10
624;28.08.2017;2017;08;00;Maanantai;3;3;6
624;28.08.2017;2017;08;01;Maanantai;1;1;2
624;28.08.2017;2017;08;02;Maanantai;1;0;1
624;28.08.2017;2017;08;03;Maanantai;0;0;0
624;28.08.2017;2017;08;04;Maanantai;0;0;0
624;28.08.2017;2017;08;05;Maanantai;3;1;4
624;28.08.2017;2017;08;06;Maanantai;0;12;12
624;28.08.2017;2017;08;07;Maanantai;4;29;33
624;28.08.2017;2017;08;08;Maanantai;13;97;110
624;28.08.2017;2017;08;09;Maanantai;9;110;119
624;28.08.2017;2017;08;10;Maanantai;7;41;48
624;28.08.2017;2017;08;11;Maanantai;10;27;37
624;28.08.2017;2017;08;12;Maanantai;16;26;42
624;28.08.2017;2017;08;13;Maanantai;11;28;39
624;28.08.2017;2017;08;14;Maanantai;14;30;44
624;28.08.2017;2017;08;15;Maanantai;8;31;39
624;28.08.2017;2017;08;16;Maanantai;30;45;75
624;28.08.2017;2017;08;17;Maanantai;18;47;65
624;28.08.2017;2017;08;18;Maanantai;14;40;54
624;28.08.2017;2017;08;19;Maanantai;13;18;31
624;28.08.2017;2017;08;20;Maanantai;8;29;37
624;28.08.2017;2017;08;21;Maanantai;5;26;31
624;28.08.2017;2017;08;22;Maanantai;9;13;22
624;28.08.2017;2017;08;23;Maanantai;0;6;6
624;29.08.2017;2017;08;00;Tiistai;0;1;1
624;29.08.2017;2017;08;01;Tiistai;0;0;0
624;29.08.2017;2017;08;02;Tiistai;0;0;0
624;29.08.2017;2017;08;03;Tiistai;0;0;0
624;29.08.2017;2017;08;04;Tiistai;0;0;0
624;29.08.2017;2017;08;05;Tiistai;0;1;1
624;29.08.2017;2017;08;06;Tiistai;1;8;9
624;29.08.2017;2017;08;07;Tiistai;3;28;31
624;29.08.2017;2017;08;08;Tiistai;13;98;111
624;29.08.2017;2017;08;09;Tiistai;10;83;93
624;29.08.2017;2017;08;10;Tiistai;7;43;50
624;29.08.2017;2017;08;11;Tiistai;7;24;31
624;29.08.2017;2017;08;12;Tiistai;11;28;39
624;29.08.2017;2017;08;13;Tiistai;8;20;28
624;29.08.2017;2017;08;14;Tiistai;17;29;46
624;29.08.2017;2017;08;15;Tiistai;18;27;45
624;29.08.2017;2017;08;16;Tiistai;22;25;47
624;29.08.2017;2017;08;17;Tiistai;32;31;63
624;29.08.2017;2017;08;18;Tiistai;22;21;43
624;29.08.2017;2017;08;19;Tiistai;8;10;18
624;29.08.2017;2017;08;20;Tiistai;13;7;20
624;29.08.2017;2017;08;21;Tiistai;4;8;12
624;29.08.2017;2017;08;22;Tiistai;6;11;17
624;29.08.2017;2017;08;23;Tiistai;2;5;7
624;30.08.2017;2017;08;00;Keskiviikko;1;5;6
624;30.08.2017;2017;08;01;Keskiviikko;0;1;1
624;30.08.2017;2017;08;02;Keskiviikko;0;2;2
624;30.08.2017;2017;08;03;Keskiviikko;1;2;3
624;30.08.2017;2017;08;04;Keskiviikko;1;2;3
624;30.08.2017;2017;08;05;Keskiviikko;1;1;2
624;30.08.2017;2017;08;06;Keskiviikko;2;7;9
624;30.08.2017;2017;08;07;Keskiviikko;6;27;33
624;30.08.2017;2017;08;08;Keskiviikko;10;65;75
624;30.08.2017;2017;08;09;Keskiviikko;9;76;85
624;30.08.2017;2017;08;10;Keskiviikko;3;27;30
624;30.08.2017;2017;08;11;Keskiviikko;6;15;21
624;30.08.2017;2017;08;12;Keskiviikko;6;11;17
624;30.08.2017;2017;08;13;Keskiviikko;4;11;15
624;30.08.2017;2017;08;14;Keskiviikko;6;23;29
624;30.08.2017;2017;08;15;Keskiviikko;24;15;39
624;30.08.2017;2017;08;16;Keskiviikko;20;28;48
624;30.08.2017;2017;08;17;Keskiviikko;27;40;67
624;30.08.2017;2017;08;18;Keskiviikko;12;22;34
624;30.08.2017;2017;08;19;Keskiviikko;12;24;36
624;30.08.2017;2017;08;20;Keskiviikko;4;14;18
624;30.08.2017;2017;08;21;Keskiviikko;14;22;36
624;30.08.2017;2017;08;22;Keskiviikko;8;9;17
624;30.08.2017;2017;08;23;Keskiviikko;5;7;12
624;31.08.2017;2017;08;00;Torstai;0;0;0
624;31.08.2017;2017;08;01;Torstai;1;2;3
624;31.08.2017;2017;08;02;Torstai;1;0;1
624;31.08.2017;2017;08;03;Torstai;0;2;2
624;31.08.2017;2017;08;04;Torstai;0;0;0
624;31.08.2017;2017;08;05;Torstai;0;3;3
624;31.08.2017;2017;08;06;Torstai;1;13;14
624;31.08.2017;2017;08;07;Torstai;6;29;35
624;31.08.2017;2017;08;08;Torstai;10;110;120
624;31.08.2017;2017;08;09;Torstai;9;91;100
624;31.08.2017;2017;08;10;Torstai;3;37;40
624;31.08.2017;2017;08;11;Torstai;8;22;30
624;31.08.2017;2017;08;12;Torstai;13;30;43
624;31.08.2017;2017;08;13;Torstai;8;24;32
624;31.08.2017;2017;08;14;Torstai;12;25;37
624;31.08.2017;2017;08;15;Torstai;21;37;58
624;31.08.2017;2017;08;16;Torstai;26;43;69
624;31.08.2017;2017;08;17;Torstai;17;48;65
624;31.08.2017;2017;08;18;Torstai;17;29;46
624;31.08.2017;2017;08;19;Torstai;16;27;43
624;31.08.2017;2017;08;20;Torstai;11;16;27
624;31.08.2017;2017;08;21;Torstai;12;16;28
624;31.08.2017;2017;08;22;Torstai;6;14;20
624;31.08.2017;2017;08;23;Torstai;3;5;8
624;01.09.2017;2017;09;00;Perjantai;4;5;9
624;01.09.2017;2017;09;01;Perjantai;1;2;3
624;01.09.2017;2017;09;02;Perjantai;0;1;1
624;01.09.2017;2017;09;03;Perjantai;1;0;1
624;01.09.2017;2017;09;04;Perjantai;1;1;2
624;01.09.2017;2017;09;05;Perjantai;3;0;3
624;01.09.2017;2017;09;06;Perjantai;3;13;16
624;01.09.2017;2017;09;07;Perjantai;3;13;16
624;01.09.2017;2017;09;08;Perjantai;12;40;52
624;01.09.2017;2017;09;09;Perjantai;5;27;32
624;01.09.2017;2017;09;10;Perjantai;8;11;19
624;01.09.2017;2017;09;11;Perjantai;2;6;8
624;01.09.2017;2017;09;12;Perjantai;6;12;18
624;01.09.2017;2017;09;13;Perjantai;5;7;12
624;01.09.2017;2017;09;14;Perjantai;9;12;21
624;01.09.2017;2017;09;15;Perjantai;11;21;32
624;01.09.2017;2017;09;16;Perjantai;9;14;23
624;01.09.2017;2017;09;17;Perjantai;10;20;30
624;01.09.2017;2017;09;18;Perjantai;10;8;18
624;01.09.2017;2017;09;19;Perjantai;11;16;27
624;01.09.2017;2017;09;20;Perjantai;3;12;15
624;01.09.2017;2017;09;21;Perjantai;4;26;30
624;01.09.2017;2017;09;22;Perjantai;6;8;14
624;01.09.2017;2017;09;23;Perjantai;1;11;12
624;02.09.2017;2017;09;00;Lauantai;4;4;8
624;02.09.2017;2017;09;01;Lauantai;2;2;4
624;02.09.2017;2017;09;02;Lauantai;1;1;2
624;02.09.2017;2017;09;03;Lauantai;1;2;3
624;02.09.2017;2017;09;04;Lauantai;5;3;8
624;02.09.2017;2017;09;05;Lauantai;1;1;2
624;02.09.2017;2017;09;06;Lauantai;0;1;1
624;02.09.2017;2017;09;07;Lauantai;1;4;5
624;02.09.2017;2017;09;08;Lauantai;1;5;6
624;02.09.2017;2017;09;09;Lauantai;1;4;5
624;02.09.2017;2017;09;10;Lauantai;4;25;29
624;02.09.2017;2017;09;11;Lauantai;5;20;25
624;02.09.2017;2017;09;12;Lauantai;5;27;32
624;02.09.2017;2017;09;13;Lauantai;7;29;36
624;02.09.2017;2017;09;14;Lauantai;8;21;29
624;02.09.2017;2017;09;15;Lauantai;8;30;38
624;02.09.2017;2017;09;16;Lauantai;12;17;29
624;02.09.2017;2017;09;17;Lauantai;11;11;22
624;02.09.2017;2017;09;18;Lauantai;4;18;22
624;02.09.2017;2017;09;19;Lauantai;6;22;28
624;02.09.2017;2017;09;20;Lauantai;15;18;33
624;02.09.2017;2017;09;21;Lauantai;3;8;11
624;02.09.2017;2017;09;22;Lauantai;3;10;13
624;02.09.2017;2017;09;23;Lauantai;3;7;10
624;03.09.2017;2017;09;00;Sunnuntai;5;9;14
624;03.09.2017;2017;09;01;Sunnuntai;2;7;9
624;03.09.2017;2017;09;02;Sunnuntai;0;0;0
624;03.09.2017;2017;09;03;Sunnuntai;1;1;2
624;03.09.2017;2017;09;04;Sunnuntai;7;2;9
624;03.09.2017;2017;09;05;Sunnuntai;3;2;5
624;03.09.2017;2017;09;06;Sunnuntai;2;3;5
624;03.09.2017;2017;09;07;Sunnuntai;0;4;4
624;03.09.2017;2017;09;08;Sunnuntai;0;2;2
624;03.09.2017;2017;09;09;Sunnuntai;1;1;2
624;03.09.2017;2017;09;10;Sunnuntai;5;9;14
624;03.09.2017;2017;09;11;Sunnuntai;2;9;11
624;03.09.2017;2017;09;12;Sunnuntai;4;35;39
624;03.09.2017;2017;09;13;Sunnuntai;7;23;30
624;03.09.2017;2017;09;14;Sunnuntai;14;25;39
624;03.09.2017;2017;09;15;Sunnuntai;12;29;41
624;03.09.2017;2017;09;16;Sunnuntai;12;26;38
624;03.09.2017;2017;09;17;Sunnuntai;7;23;30
624;03.09.2017;2017;09;18;Sunnuntai;12;28;40
624;03.09.2017;2017;09;19;Sunnuntai;15;28;43
624;03.09.2017;2017;09;20;Sunnuntai;6;19;25
624;03.09.2017;2017;09;21;Sunnuntai;6;17;23
624;03.09.2017;2017;09;22;Sunnuntai;6;6;12
624;03.09.2017;2017;09;23;Sunnuntai;5;7;12
624;04.09.2017;2017;09;00;Maanantai;0;6;6
624;04.09.2017;2017;09;01;Maanantai;0;0;0
624;04.09.2017;2017;09;02;Maanantai;0;1;1
624;04.09.2017;2017;09;03;Maanantai;0;0;0
624;04.09.2017;2017;09;04;Maanantai;0;1;1
624;04.09.2017;2017;09;05;Maanantai;4;0;4
624;04.09.2017;2017;09;06;Maanantai;1;8;9
624;04.09.2017;2017;09;07;Maanantai;6;31;37
624;04.09.2017;2017;09;08;Maanantai;20;95;115
624;04.09.2017;2017;09;09;Maanantai;14;91;105
624;04.09.2017;2017;09;10;Maanantai;4;52;56
624;04.09.2017;2017;09;11;Maanantai;6;26;32
624;04.09.2017;2017;09;12;Maanantai;9;37;46
624;04.09.2017;2017;09;13;Maanantai;11;44;55
624;04.09.2017;2017;09;14;Maanantai;10;25;35
624;04.09.2017;2017;09;15;Maanantai;14;39;53
624;04.09.2017;2017;09;16;Maanantai;30;48;78
624;04.09.2017;2017;09;17;Maanantai;33;68;101
624;04.09.2017;2017;09;18;Maanantai;27;51;78
624;04.09.2017;2017;09;19;Maanantai;11;32;43
624;04.09.2017;2017;09;20;Maanantai;12;26;38
624;04.09.2017;2017;09;21;Maanantai;10;22;32
624;04.09.2017;2017;09;22;Maanantai;6;18;24
624;04.09.2017;2017;09;23;Maanantai;4;12;16
624;05.09.2017;2017;09;00;Tiistai;3;2;5
624;05.09.2017;2017;09;01;Tiistai;1;2;3
624;05.09.2017;2017;09;02;Tiistai;3;2;5
624;05.09.2017;2017;09;03;Tiistai;0;2;2
624;05.09.2017;2017;09;04;Tiistai;0;2;2
624;05.09.2017;2017;09;05;Tiistai;2;1;3
624;05.09.2017;2017;09;06;Tiistai;1;10;11
624;05.09.2017;2017;09;07;Tiistai;3;39;42
624;05.09.2017;2017;09;08;Tiistai;19;93;112
624;05.09.2017;2017;09;09;Tiistai;22;88;110
624;05.09.2017;2017;09;10;Tiistai;5;45;50
624;05.09.2017;2017;09;11;Tiistai;7;34;41
624;05.09.2017;2017;09;12;Tiistai;14;33;47
624;05.09.2017;2017;09;13;Tiistai;14;31;45
624;05.09.2017;2017;09;14;Tiistai;10;31;41
624;05.09.2017;2017;09;15;Tiistai;18;43;61
624;05.09.2017;2017;09;16;Tiistai;33;54;87
624;05.09.2017;2017;09;17;Tiistai;36;61;97
624;05.09.2017;2017;09;18;Tiistai;26;51;77
624;05.09.2017;2017;09;19;Tiistai;17;37;54
624;05.09.2017;2017;09;20;Tiistai;20;45;65
624;05.09.2017;2017;09;21;Tiistai;21;21;42
624;05.09.2017;2017;09;22;Tiistai;14;15;29
624;05.09.2017;2017;09;23;Tiistai;3;10;13
624;06.09.2017;2017;09;00;Keskiviikko;5;4;9
624;06.09.2017;2017;09;01;Keskiviikko;1;1;2
624;06.09.2017;2017;09;02;Keskiviikko;0;0;0
624;06.09.2017;2017;09;03;Keskiviikko;0;1;1
624;06.09.2017;2017;09;04;Keskiviikko;0;4;4
624;06.09.2017;2017;09;05;Keskiviikko;1;1;2
624;06.09.2017;2017;09;06;Keskiviikko;1;5;6
624;06.09.2017;2017;09;07;Keskiviikko;5;39;44
624;06.09.2017;2017;09;08;Keskiviikko;16;103;119
624;06.09.2017;2017;09;09;Keskiviikko;17;93;110
624;06.09.2017;2017;09;10;Keskiviikko;7;46;53
624;06.09.2017;2017;09;11;Keskiviikko;10;31;41
624;06.09.2017;2017;09;12;Keskiviikko;13;43;56
624;06.09.2017;2017;09;13;Keskiviikko;7;31;38
624;06.09.2017;2017;09;14;Keskiviikko;15;45;60
624;06.09.2017;2017;09;15;Keskiviikko;20;46;66
624;06.09.2017;2017;09;16;Keskiviikko;24;57;81
624;06.09.2017;2017;09;17;Keskiviikko;30;61;91
624;06.09.2017;2017;09;18;Keskiviikko;22;50;72
624;06.09.2017;2017;09;19;Keskiviikko;19;43;62
624;06.09.2017;2017;09;20;Keskiviikko;16;31;47
624;06.09.2017;2017;09;21;Keskiviikko;17;20;37
624;06.09.2017;2017;09;22;Keskiviikko;14;16;30
624;06.09.2017;2017;09;23;Keskiviikko;6;8;14
624;07.09.2017;2017;09;00;Torstai;2;12;14
624;07.09.2017;2017;09;01;Torstai;1;8;9
624;07.09.2017;2017;09;02;Torstai;1;7;8
624;07.09.2017;2017;09;03;Torstai;2;1;3
624;07.09.2017;2017;09;04;Torstai;0;1;1
624;07.09.2017;2017;09;05;Torstai;3;0;3
624;07.09.2017;2017;09;06;Torstai;1;13;14
624;07.09.2017;2017;09;07;Torstai;7;36;43
624;07.09.2017;2017;09;08;Torstai;13;98;111
624;07.09.2017;2017;09;09;Torstai;6;85;91
624;07.09.2017;2017;09;10;Torstai;6;35;41
624;07.09.2017;2017;09;11;Torstai;9;25;34
624;07.09.2017;2017;09;12;Torstai;12;31;43
624;07.09.2017;2017;09;13;Torstai;8;30;38
624;07.09.2017;2017;09;14;Torstai;21;42;63
624;07.09.2017;2017;09;15;Torstai;18;44;62
624;07.09.2017;2017;09;16;Torstai;27;38;65
624;07.09.2017;2017;09;17;Torstai;26;65;91
624;07.09.2017;2017;09;18;Torstai;18;46;64
624;07.09.2017;2017;09;19;Torstai;9;33;42
624;07.09.2017;2017;09;20;Torstai;16;22;38
624;07.09.2017;2017;09;21;Torstai;11;20;31
624;07.09.2017;2017;09;22;Torstai;10;13;23
624;07.09.2017;2017;09;23;Torstai;5;13;18
624;08.09.2017;2017;09;00;Perjantai;2;5;7
624;08.09.2017;2017;09;01;Perjantai;3;2;5
624;08.09.2017;2017;09;02;Perjantai;3;1;4
624;08.09.2017;2017;09;03;Perjantai;4;1;5
624;08.09.2017;2017;09;04;Perjantai;3;0;3
624;08.09.2017;2017;09;05;Perjantai;0;3;3
624;08.09.2017;2017;09;06;Perjantai;1;12;13
624;08.09.2017;2017;09;07;Perjantai;1;25;26
624;08.09.2017;2017;09;08;Perjantai;15;56;71
624;08.09.2017;2017;09;09;Perjantai;10;62;72
624;08.09.2017;2017;09;10;Perjantai;3;27;30
624;08.09.2017;2017;09;11;Perjantai;7;24;31
624;08.09.2017;2017;09;12;Perjantai;6;17;23
624;08.09.2017;2017;09;13;Perjantai;8;17;25
624;08.09.2017;2017;09;14;Perjantai;16;39;55
624;08.09.2017;2017;09;15;Perjantai;8;33;41
624;08.09.2017;2017;09;16;Perjantai;10;27;37
624;08.09.2017;2017;09;17;Perjantai;15;40;55
624;08.09.2017;2017;09;18;Perjantai;19;27;46
624;08.09.2017;2017;09;19;Perjantai;7;17;24
624;08.09.2017;2017;09;20;Perjantai;14;19;33
624;08.09.2017;2017;09;21;Perjantai;3;19;22
624;08.09.2017;2017;09;22;Perjantai;7;7;14
624;08.09.2017;2017;09;23;Perjantai;3;14;17
624;09.09.2017;2017;09;00;Lauantai;7;5;12
624;09.09.2017;2017;09;01;Lauantai;3;3;6
624;09.09.2017;2017;09;02;Lauantai;2;3;5
624;09.09.2017;2017;09;03;Lauantai;1;2;3
624;09.09.2017;2017;09;04;Lauantai;0;0;0
624;09.09.2017;2017;09;05;Lauantai;1;1;2
624;09.09.2017;2017;09;06;Lauantai;2;2;4
624;09.09.2017;2017;09;07;Lauantai;1;6;7
624;09.09.2017;2017;09;08;Lauantai;0;4;4
624;09.09.2017;2017;09;09;Lauantai;3;7;10
624;09.09.2017;2017;09;10;Lauantai;4;17;21
624;09.09.2017;2017;09;11;Lauantai;1;18;19
624;09.09.2017;2017;09;12;Lauantai;7;10;17
624;09.09.2017;2017;09;13;Lauantai;8;14;22
624;09.09.2017;2017;09;14;Lauantai;6;19;25
624;09.09.2017;2017;09;15;Lauantai;7;21;28
624;09.09.2017;2017;09;16;Lauantai;8;16;24
624;09.09.2017;2017;09;17;Lauantai;11;29;40
624;09.09.2017;2017;09;18;Lauantai;6;19;25
624;09.09.2017;2017;09;19;Lauantai;9;7;16
624;09.09.2017;2017;09;20;Lauantai;8;19;27
624;09.09.2017;2017;09;21;Lauantai;6;14;20
624;09.09.2017;2017;09;22;Lauantai;10;6;16
624;09.09.2017;2017;09;23;Lauantai;6;13;19
624;10.09.2017;2017;09;00;Sunnuntai;12;9;21
624;10.09.2017;2017;09;01;Sunnuntai;5;4;9
624;10.09.2017;2017;09;02;Sunnuntai;0;3;3
624;10.09.2017;2017;09;03;Sunnuntai;5;6;11
624;10.09.2017;2017;09;04;Sunnuntai;3;2;5
624;10.09.2017;2017;09;05;Sunnuntai;4;4;8
624;10.09.2017;2017;09;06;Sunnuntai;0;1;1
624;10.09.2017;2017;09;07;Sunnuntai;2;6;8
624;10.09.2017;2017;09;08;Sunnuntai;0;3;3
624;10.09.2017;2017;09;09;Sunnuntai;1;2;3
624;10.09.2017;2017;09;10;Sunnuntai;2;4;6
624;10.09.2017;2017;09;11;Sunnuntai;0;7;7
624;10.09.2017;2017;09;12;Sunnuntai;5;15;20
624;10.09.2017;2017;09;13;Sunnuntai;5;6;11
624;10.09.2017;2017;09;14;Sunnuntai;3;13;16
624;10.09.2017;2017;09;15;Sunnuntai;5;11;16
624;10.09.2017;2017;09;16;Sunnuntai;9;2;11
624;10.09.2017;2017;09;17;Sunnuntai;3;3;6
624;10.09.2017;2017;09;18;Sunnuntai;5;3;8
624;10.09.2017;2017;09;19;Sunnuntai;6;5;11
624;10.09.2017;2017;09;20;Sunnuntai;6;7;13
624;10.09.2017;2017;09;21;Sunnuntai;3;8;11
624;10.09.2017;2017;09;22;Sunnuntai;6;6;12
624;10.09.2017;2017;09;23;Sunnuntai;1;3;4
624;11.09.2017;2017;09;00;Maanantai;2;3;5
624;11.09.2017;2017;09;01;Maanantai;2;2;4
624;11.09.2017;2017;09;02;Maanantai;0;0;0
624;11.09.2017;2017;09;03;Maanantai;1;1;2
624;11.09.2017;2017;09;04;Maanantai;0;1;1
624;11.09.2017;2017;09;05;Maanantai;0;1;1
624;11.09.2017;2017;09;06;Maanantai;4;14;18
624;11.09.2017;2017;09;07;Maanantai;5;35;40
624;11.09.2017;2017;09;08;Maanantai;11;98;109
624;11.09.2017;2017;09;09;Maanantai;16;86;102
624;11.09.2017;2017;09;10;Maanantai;3;38;41
624;11.09.2017;2017;09;11;Maanantai;6;29;35
624;11.09.2017;2017;09;12;Maanantai;12;34;46
624;11.09.2017;2017;09;13;Maanantai;13;37;50
624;11.09.2017;2017;09;14;Maanantai;7;22;29
624;11.09.2017;2017;09;15;Maanantai;12;44;56
624;11.09.2017;2017;09;16;Maanantai;21;49;70
624;11.09.2017;2017;09;17;Maanantai;24;66;90
624;11.09.2017;2017;09;18;Maanantai;20;43;63
624;11.09.2017;2017;09;19;Maanantai;11;46;57
624;11.09.2017;2017;09;20;Maanantai;21;32;53
624;11.09.2017;2017;09;21;Maanantai;9;18;27
624;11.09.2017;2017;09;22;Maanantai;13;16;29
624;11.09.2017;2017;09;23;Maanantai;1;13;14
624;12.09.2017;2017;09;00;Tiistai;2;6;8
624;12.09.2017;2017;09;01;Tiistai;2;1;3
624;12.09.2017;2017;09;02;Tiistai;0;1;1
624;12.09.2017;2017;09;03;Tiistai;0;2;2
624;12.09.2017;2017;09;04;Tiistai;1;1;2
624;12.09.2017;2017;09;05;Tiistai;0;1;1
624;12.09.2017;2017;09;06;Tiistai;1;10;11
624;12.09.2017;2017;09;07;Tiistai;4;33;37
624;12.09.2017;2017;09;08;Tiistai;10;88;98
624;12.09.2017;2017;09;09;Tiistai;10;84;94
624;12.09.2017;2017;09;10;Tiistai;6;46;52
624;12.09.2017;2017;09;11;Tiistai;2;34;36
624;12.09.2017;2017;09;12;Tiistai;9;43;52
624;12.09.2017;2017;09;13;Tiistai;12;23;35
624;12.09.2017;2017;09;14;Tiistai;8;36;44
624;12.09.2017;2017;09;15;Tiistai;11;30;41
624;12.09.2017;2017;09;16;Tiistai;22;27;49
624;12.09.2017;2017;09;17;Tiistai;37;40;77
624;12.09.2017;2017;09;18;Tiistai;16;19;35
624;12.09.2017;2017;09;19;Tiistai;13;19;32
624;12.09.2017;2017;09;20;Tiistai;7;13;20
624;12.09.2017;2017;09;21;Tiistai;9;14;23
624;12.09.2017;2017;09;22;Tiistai;1;6;7
624;12.09.2017;2017;09;23;Tiistai;2;4;6
624;13.09.2017;2017;09;00;Keskiviikko;3;1;4
624;13.09.2017;2017;09;01;Keskiviikko;0;1;1
624;13.09.2017;2017;09;02;Keskiviikko;0;0;0
624;13.09.2017;2017;09;03;Keskiviikko;0;1;1
624;13.09.2017;2017;09;04;Keskiviikko;0;3;3
624;13.09.2017;2017;09;05;Keskiviikko;1;1;2
624;13.09.2017;2017;09;06;Keskiviikko;0;10;10
624;13.09.2017;2017;09;07;Keskiviikko;4;27;31
624;13.09.2017;2017;09;08;Keskiviikko;9;85;94
624;13.09.2017;2017;09;09;Keskiviikko;16;90;106
624;13.09.2017;2017;09;10;Keskiviikko;7;39;46
624;13.09.2017;2017;09;11;Keskiviikko;0;23;23
624;13.09.2017;2017;09;12;Keskiviikko;8;30;38
624;13.09.2017;2017;09;13;Keskiviikko;12;49;61
624;13.09.2017;2017;09;14;Keskiviikko;13;16;29
624;13.09.2017;2017;09;15;Keskiviikko;15;31;46
624;13.09.2017;2017;09;16;Keskiviikko;20;34;54
624;13.09.2017;2017;09;17;Keskiviikko;20;47;67
624;13.09.2017;2017;09;18;Keskiviikko;13;29;42
624;13.09.2017;2017;09;19;Keskiviikko;15;38;53
624;13.09.2017;2017;09;20;Keskiviikko;18;27;45
624;13.09.2017;2017;09;21;Keskiviikko;5;22;27
624;13.09.2017;2017;09;22;Keskiviikko;5;16;21
624;13.09.2017;2017;09;23;Keskiviikko;3;9;12
624;14.09.2017;2017;09;00;Torstai;2;5;7
624;14.09.2017;2017;09;01;Torstai;2;2;4
624;14.09.2017;2017;09;02;Torstai;1;1;2
624;14.09.2017;2017;09;03;Torstai;1;1;2
624;14.09.2017;2017;09;04;Torstai;0;3;3
624;14.09.2017;2017;09;05;Torstai;1;2;3
624;14.09.2017;2017;09;06;Torstai;1;7;8
624;14.09.2017;2017;09;07;Torstai;2;31;33
624;14.09.2017;2017;09;08;Torstai;9;83;92
624;14.09.2017;2017;09;09;Torstai;15;93;108
624;14.09.2017;2017;09;10;Torstai;3;46;49
624;14.09.2017;2017;09;11;Torstai;2;23;25
624;14.09.2017;2017;09;12;Torstai;7;28;35
624;14.09.2017;2017;09;13;Torstai;13;29;42
624;14.09.2017;2017;09;14;Torstai;6;23;29
624;14.09.2017;2017;09;15;Torstai;16;37;53
624;14.09.2017;2017;09;16;Torstai;18;44;62
624;14.09.2017;2017;09;17;Torstai;20;51;71
624;14.09.2017;2017;09;18;Torstai;12;43;55
624;14.09.2017;2017;09;19;Torstai;13;37;50
624;14.09.2017;2017;09;20;Torstai;12;19;31
624;14.09.2017;2017;09;21;Torstai;18;19;37
624;14.09.2017;2017;09;22;Torstai;13;19;32
624;14.09.2017;2017;09;23;Torstai;3;6;9
624;15.09.2017;2017;09;00;Perjantai;1;5;6
624;15.09.2017;2017;09;01;Perjantai;2;2;4
624;15.09.2017;2017;09;02;Perjantai;0;1;1
624;15.09.2017;2017;09;03;Perjantai;1;2;3
624;15.09.2017;2017;09;04;Perjantai;1;1;2
624;15.09.2017;2017;09;05;Perjantai;3;1;4
624;15.09.2017;2017;09;06;Perjantai;1;13;14
624;15.09.2017;2017;09;07;Perjantai;5;23;28
624;15.09.2017;2017;09;08;Perjantai;6;74;80
624;15.09.2017;2017;09;09;Perjantai;13;79;92
624;15.09.2017;2017;09;10;Perjantai;10;29;39
624;15.09.2017;2017;09;11;Perjantai;5;20;25
624;15.09.2017;2017;09;12;Perjantai;3;26;29
624;15.09.2017;2017;09;13;Perjantai;12;33;45
624;15.09.2017;2017;09;14;Perjantai;7;22;29
624;15.09.2017;2017;09;15;Perjantai;16;41;57
624;15.09.2017;2017;09;16;Perjantai;12;31;43
624;15.09.2017;2017;09;17;Perjantai;20;35;55
624;15.09.2017;2017;09;18;Perjantai;5;18;23
624;15.09.2017;2017;09;19;Perjantai;10;15;25
624;15.09.2017;2017;09;20;Perjantai;10;14;24
624;15.09.2017;2017;09;21;Perjantai;7;12;19
624;15.09.2017;2017;09;22;Perjantai;7;8;15
624;15.09.2017;2017;09;23;Perjantai;5;10;15
624;16.09.2017;2017;09;00;Lauantai;6;10;16
624;16.09.2017;2017;09;01;Lauantai;2;7;9
624;16.09.2017;2017;09;02;Lauantai;5;3;8
624;16.09.2017;2017;09;03;Lauantai;2;3;5
624;16.09.2017;2017;09;04;Lauantai;2;2;4
624;16.09.2017;2017;09;05;Lauantai;1;2;3
624;16.09.2017;2017;09;06;Lauantai;1;4;5
624;16.09.2017;2017;09;07;Lauantai;1;7;8
624;16.09.2017;2017;09;08;Lauantai;1;4;5
624;16.09.2017;2017;09;09;Lauantai;1;11;12
624;16.09.2017;2017;09;10;Lauantai;1;12;13
624;16.09.2017;2017;09;11;Lauantai;6;27;33
624;16.09.2017;2017;09;12;Lauantai;2;29;31
624;16.09.2017;2017;09;13;Lauantai;6;28;34
624;16.09.2017;2017;09;14;Lauantai;8;25;33
624;16.09.2017;2017;09;15;Lauantai;18;23;41
624;16.09.2017;2017;09;16;Lauantai;10;17;27
624;16.09.2017;2017;09;17;Lauantai;4;29;33
624;16.09.2017;2017;09;18;Lauantai;9;15;24
624;16.09.2017;2017;09;19;Lauantai;6;19;25
624;16.09.2017;2017;09;20;Lauantai;5;11;16
624;16.09.2017;2017;09;21;Lauantai;6;12;18
624;16.09.2017;2017;09;22;Lauantai;7;7;14
624;16.09.2017;2017;09;23;Lauantai;2;5;7
624;17.09.2017;2017;09;00;Sunnuntai;1;9;10
624;17.09.2017;2017;09;01;Sunnuntai;1;2;3
624;17.09.2017;2017;09;02;Sunnuntai;0;1;1
624;17.09.2017;2017;09;03;Sunnuntai;0;0;0
624;17.09.2017;2017;09;04;Sunnuntai;2;2;4
624;17.09.2017;2017;09;05;Sunnuntai;2;0;2
624;17.09.2017;2017;09;06;Sunnuntai;4;3;7
624;17.09.2017;2017;09;07;Sunnuntai;1;6;7
624;17.09.2017;2017;09;08;Sunnuntai;1;4;5
624;17.09.2017;2017;09;09;Sunnuntai;0;6;6
624;17.09.2017;2017;09;10;Sunnuntai;2;5;7
624;17.09.2017;2017;09;11;Sunnuntai;1;11;12
624;17.09.2017;2017;09;12;Sunnuntai;8;30;38
624;17.09.2017;2017;09;13;Sunnuntai;6;17;23
624;17.09.2017;2017;09;14;Sunnuntai;13;15;28
624;17.09.2017;2017;09;15;Sunnuntai;11;22;33
624;17.09.2017;2017;09;16;Sunnuntai;12;22;34
624;17.09.2017;2017;09;17;Sunnuntai;5;16;21
624;17.09.2017;2017;09;18;Sunnuntai;6;17;23
624;17.09.2017;2017;09;19;Sunnuntai;6;26;32
624;17.09.2017;2017;09;20;Sunnuntai;10;22;32
624;17.09.2017;2017;09;21;Sunnuntai;6;9;15
624;17.09.2017;2017;09;22;Sunnuntai;6;10;16
624;17.09.2017;2017;09;23;Sunnuntai;3;4;7
624;18.09.2017;2017;09;00;Maanantai;1;1;2
624;18.09.2017;2017;09;01;Maanantai;2;1;3
624;18.09.2017;2017;09;02;Maanantai;1;2;3
624;18.09.2017;2017;09;03;Maanantai;0;1;1
624;18.09.2017;2017;09;04;Maanantai;0;0;0
624;18.09.2017;2017;09;05;Maanantai;1;2;3
624;18.09.2017;2017;09;06;Maanantai;1;16;17
624;18.09.2017;2017;09;07;Maanantai;4;36;40
624;18.09.2017;2017;09;08;Maanantai;15;66;81
624;18.09.2017;2017;09;09;Maanantai;14;59;73
624;18.09.2017;2017;09;10;Maanantai;4;30;34
624;18.09.2017;2017;09;11;Maanantai;7;22;29
624;18.09.2017;2017;09;12;Maanantai;5;24;29
624;18.09.2017;2017;09;13;Maanantai;7;31;38
624;18.09.2017;2017;09;14;Maanantai;9;16;25
624;18.09.2017;2017;09;15;Maanantai;18;26;44
624;18.09.2017;2017;09;16;Maanantai;16;39;55
624;18.09.2017;2017;09;17;Maanantai;16;55;71
624;18.09.2017;2017;09;18;Maanantai;10;39;49
624;18.09.2017;2017;09;19;Maanantai;13;24;37
624;18.09.2017;2017;09;20;Maanantai;10;17;27
624;18.09.2017;2017;09;21;Maanantai;10;16;26
624;18.09.2017;2017;09;22;Maanantai;8;12;20
624;18.09.2017;2017;09;23;Maanantai;1;9;10
624;19.09.2017;2017;09;00;Tiistai;0;2;2
624;19.09.2017;2017;09;01;Tiistai;2;3;5
624;19.09.2017;2017;09;02;Tiistai;0;1;1
624;19.09.2017;2017;09;03;Tiistai;0;3;3
624;19.09.2017;2017;09;04;Tiistai;0;1;1
624;19.09.2017;2017;09;05;Tiistai;0;1;1
624;19.09.2017;2017;09;06;Tiistai;0;14;14
624;19.09.2017;2017;09;07;Tiistai;5;32;37
624;19.09.2017;2017;09;08;Tiistai;11;68;79
624;19.09.2017;2017;09;09;Tiistai;10;71;81
624;19.09.2017;2017;09;10;Tiistai;5;26;31
624;19.09.2017;2017;09;11;Tiistai;4;21;25
624;19.09.2017;2017;09;12;Tiistai;12;24;36
624;19.09.2017;2017;09;13;Tiistai;8;18;26
624;19.09.2017;2017;09;14;Tiistai;5;17;22
624;19.09.2017;2017;09;15;Tiistai;13;30;43
624;19.09.2017;2017;09;16;Tiistai;29;45;74
624;19.09.2017;2017;09;17;Tiistai;20;52;72
624;19.09.2017;2017;09;18;Tiistai;7;34;41
624;19.09.2017;2017;09;19;Tiistai;12;21;33
624;19.09.2017;2017;09;20;Tiistai;15;28;43
624;19.09.2017;2017;09;21;Tiistai;16;15;31
624;19.09.2017;2017;09;22;Tiistai;6;10;16
624;19.09.2017;2017;09;23;Tiistai;5;2;7
624;20.09.2017;2017;09;00;Keskiviikko;0;2;2
624;20.09.2017;2017;09;01;Keskiviikko;1;1;2
624;20.09.2017;2017;09;02;Keskiviikko;1;1;2
624;20.09.2017;2017;09;03;Keskiviikko;0;2;2
624;20.09.2017;2017;09;04;Keskiviikko;0;0;0
624;20.09.2017;2017;09;05;Keskiviikko;0;2;2
624;20.09.2017;2017;09;06;Keskiviikko;0;13;13
624;20.09.2017;2017;09;07;Keskiviikko;3;32;35
624;20.09.2017;2017;09;08;Keskiviikko;8;84;92
624;20.09.2017;2017;09;09;Keskiviikko;13;95;108
624;20.09.2017;2017;09;10;Keskiviikko;7;38;45
624;20.09.2017;2017;09;11;Keskiviikko;2;22;24
624;20.09.2017;2017;09;12;Keskiviikko;9;23;32
624;20.09.2017;2017;09;13;Keskiviikko;4;31;35
624;20.09.2017;2017;09;14;Keskiviikko;15;25;40
624;20.09.2017;2017;09;15;Keskiviikko;14;23;37
624;20.09.2017;2017;09;16;Keskiviikko;15;41;56
624;20.09.2017;2017;09;17;Keskiviikko;21;46;67
624;20.09.2017;2017;09;18;Keskiviikko;13;37;50
624;20.09.2017;2017;09;19;Keskiviikko;11;38;49
624;20.09.2017;2017;09;20;Keskiviikko;11;24;35
624;20.09.2017;2017;09;21;Keskiviikko;17;17;34
624;20.09.2017;2017;09;22;Keskiviikko;8;9;17
624;20.09.2017;2017;09;23;Keskiviikko;2;9;11
624;21.09.2017;2017;09;00;Torstai;2;4;6
624;21.09.2017;2017;09;01;Torstai;2;2;4
624;21.09.2017;2017;09;02;Torstai;1;1;2
624;21.09.2017;2017;09;03;Torstai;0;1;1
624;21.09.2017;2017;09;04;Torstai;0;0;0
624;21.09.2017;2017;09;05;Torstai;3;2;5
624;21.09.2017;2017;09;06;Torstai;0;10;10
624;21.09.2017;2017;09;07;Torstai;5;30;35
624;21.09.2017;2017;09;08;Torstai;12;75;87
624;21.09.2017;2017;09;09;Torstai;10;80;90
624;21.09.2017;2017;09;10;Torstai;3;30;33
624;21.09.2017;2017;09;11;Torstai;12;25;37
624;21.09.2017;2017;09;12;Torstai;8;13;21
624;21.09.2017;2017;09;13;Torstai;10;32;42
624;21.09.2017;2017;09;14;Torstai;7;25;32
624;21.09.2017;2017;09;15;Torstai;10;34;44
624;21.09.2017;2017;09;16;Torstai;6;45;51
624;21.09.2017;2017;09;17;Torstai;16;52;68
624;21.09.2017;2017;09;18;Torstai;13;26;39
624;21.09.2017;2017;09;19;Torstai;6;18;24
624;21.09.2017;2017;09;20;Torstai;6;24;30
624;21.09.2017;2017;09;21;Torstai;5;10;15
624;21.09.2017;2017;09;22;Torstai;5;9;14
624;21.09.2017;2017;09;23;Torstai;5;7;12
624;22.09.2017;2017;09;00;Perjantai;2;2;4
624;22.09.2017;2017;09;01;Perjantai;1;0;1
624;22.09.2017;2017;09;02;Perjantai;0;0;0
624;22.09.2017;2017;09;03;Perjantai;0;3;3
624;22.09.2017;2017;09;04;Perjantai;0;1;1
624;22.09.2017;2017;09;05;Perjantai;1;3;4
624;22.09.2017;2017;09;06;Perjantai;3;9;12
624;22.09.2017;2017;09;07;Perjantai;4;25;29
624;22.09.2017;2017;09;08;Perjantai;6;69;75
624;22.09.2017;2017;09;09;Perjantai;9;67;76
624;22.09.2017;2017;09;10;Perjantai;7;34;41
624;22.09.2017;2017;09;11;Perjantai;8;28;36
624;22.09.2017;2017;09;12;Perjantai;6;33;39
624;22.09.2017;2017;09;13;Perjantai;9;41;50
624;22.09.2017;2017;09;14;Perjantai;17;45;62
624;22.09.2017;2017;09;15;Perjantai;26;56;82
624;22.09.2017;2017;09;16;Perjantai;22;43;65
624;22.09.2017;2017;09;17;Perjantai;15;43;58
624;22.09.2017;2017;09;18;Perjantai;15;33;48
624;22.09.2017;2017;09;19;Perjantai;13;29;42
624;22.09.2017;2017;09;20;Perjantai;8;31;39
624;22.09.2017;2017;09;21;Perjantai;11;22;33
624;22.09.2017;2017;09;22;Perjantai;3;9;12
624;22.09.2017;2017;09;23;Perjantai;3;9;12
624;23.09.2017;2017;09;00;Lauantai;3;8;11
624;23.09.2017;2017;09;01;Lauantai;1;1;2
624;23.09.2017;2017;09;02;Lauantai;4;5;9
624;23.09.2017;2017;09;03;Lauantai;5;5;10
624;23.09.2017;2017;09;04;Lauantai;0;1;1
624;23.09.2017;2017;09;05;Lauantai;3;1;4
624;23.09.2017;2017;09;06;Lauantai;0;1;1
624;23.09.2017;2017;09;07;Lauantai;0;7;7
624;23.09.2017;2017;09;08;Lauantai;2;6;8
624;23.09.2017;2017;09;09;Lauantai;0;12;12
624;23.09.2017;2017;09;10;Lauantai;1;20;21
624;23.09.2017;2017;09;11;Lauantai;4;14;18
624;23.09.2017;2017;09;12;Lauantai;7;26;33
624;23.09.2017;2017;09;13;Lauantai;7;28;35
624;23.09.2017;2017;09;14;Lauantai;8;18;26
624;23.09.2017;2017;09;15;Lauantai;11;18;29
624;23.09.2017;2017;09;16;Lauantai;9;17;26
624;23.09.2017;2017;09;17;Lauantai;7;14;21
624;23.09.2017;2017;09;18;Lauantai;6;14;20
624;23.09.2017;2017;09;19;Lauantai;1;30;31
624;23.09.2017;2017;09;20;Lauantai;6;12;18
624;23.09.2017;2017;09;21;Lauantai;5;14;19
624;23.09.2017;2017;09;22;Lauantai;7;7;14
624;23.09.2017;2017;09;23;Lauantai;7;9;16
624;24.09.2017;2017;09;00;Sunnuntai;4;7;11
624;24.09.2017;2017;09;01;Sunnuntai;1;1;2
624;24.09.2017;2017;09;02;Sunnuntai;3;3;6
624;24.09.2017;2017;09;03;Sunnuntai;2;2;4
624;24.09.2017;2017;09;04;Sunnuntai;3;2;5
624;24.09.2017;2017;09;05;Sunnuntai;6;2;8
624;24.09.2017;2017;09;06;Sunnuntai;0;0;0
624;24.09.2017;2017;09;07;Sunnuntai;1;3;4
624;24.09.2017;2017;09;08;Sunnuntai;1;3;4
624;24.09.2017;2017;09;09;Sunnuntai;1;8;9
624;24.09.2017;2017;09;10;Sunnuntai;1;8;9
624;24.09.2017;2017;09;11;Sunnuntai;2;18;20
624;24.09.2017;2017;09;12;Sunnuntai;5;26;31
624;24.09.2017;2017;09;13;Sunnuntai;3;16;19
624;24.09.2017;2017;09;14;Sunnuntai;8;13;21
624;24.09.2017;2017;09;15;Sunnuntai;8;19;27
624;24.09.2017;2017;09;16;Sunnuntai;4;19;23
624;24.09.2017;2017;09;17;Sunnuntai;15;21;36
624;24.09.2017;2017;09;18;Sunnuntai;3;18;21
624;24.09.2017;2017;09;19;Sunnuntai;7;15;22
624;24.09.2017;2017;09;20;Sunnuntai;9;16;25
624;24.09.2017;2017;09;21;Sunnuntai;7;10;17
624;24.09.2017;2017;09;22;Sunnuntai;2;6;8
624;24.09.2017;2017;09;23;Sunnuntai;3;6;9
624;25.09.2017;2017;09;00;Maanantai;2;6;8
624;25.09.2017;2017;09;01;Maanantai;1;1;2
624;25.09.2017;2017;09;02;Maanantai;0;2;2
624;25.09.2017;2017;09;03;Maanantai;0;0;0
624;25.09.2017;2017;09;04;Maanantai;1;0;1
624;25.09.2017;2017;09;05;Maanantai;0;1;1
624;25.09.2017;2017;09;06;Maanantai;0;11;11
624;25.09.2017;2017;09;07;Maanantai;2;38;40
624;25.09.2017;2017;09;08;Maanantai;8;80;88
624;25.09.2017;2017;09;09;Maanantai;4;74;78
624;25.09.2017;2017;09;10;Maanantai;6;38;44
624;25.09.2017;2017;09;11;Maanantai;11;37;48
624;25.09.2017;2017;09;12;Maanantai;8;27;35
624;25.09.2017;2017;09;13;Maanantai;7;33;40
624;25.09.2017;2017;09;14;Maanantai;10;24;34
624;25.09.2017;2017;09;15;Maanantai;17;40;57
624;25.09.2017;2017;09;16;Maanantai;16;42;58
624;25.09.2017;2017;09;17;Maanantai;26;57;83
624;25.09.2017;2017;09;18;Maanantai;17;52;69
624;25.09.2017;2017;09;19;Maanantai;13;35;48
624;25.09.2017;2017;09;20;Maanantai;19;35;54
624;25.09.2017;2017;09;21;Maanantai;10;16;26
624;25.09.2017;2017;09;22;Maanantai;8;10;18
624;25.09.2017;2017;09;23;Maanantai;5;7;12
624;26.09.2017;2017;09;00;Tiistai;1;5;6
624;26.09.2017;2017;09;01;Tiistai;2;2;4
624;26.09.2017;2017;09;02;Tiistai;1;0;1
624;26.09.2017;2017;09;03;Tiistai;0;0;0
624;26.09.2017;2017;09;04;Tiistai;0;2;2
624;26.09.2017;2017;09;05;Tiistai;1;1;2
624;26.09.2017;2017;09;06;Tiistai;0;11;11
624;26.09.2017;2017;09;07;Tiistai;9;40;49
624;26.09.2017;2017;09;08;Tiistai;17;74;91
624;26.09.2017;2017;09;09;Tiistai;11;67;78
624;26.09.2017;2017;09;10;Tiistai;6;42;48
624;26.09.2017;2017;09;11;Tiistai;5;28;33
624;26.09.2017;2017;09;12;Tiistai;9;33;42
624;26.09.2017;2017;09;13;Tiistai;15;25;40
624;26.09.2017;2017;09;14;Tiistai;10;23;33
624;26.09.2017;2017;09;15;Tiistai;16;32;48
624;26.09.2017;2017;09;16;Tiistai;15;30;45
624;26.09.2017;2017;09;17;Tiistai;16;46;62
624;26.09.2017;2017;09;18;Tiistai;19;46;65
624;26.09.2017;2017;09;19;Tiistai;19;27;46
624;26.09.2017;2017;09;20;Tiistai;13;27;40
624;26.09.2017;2017;09;21;Tiistai;10;25;35
624;26.09.2017;2017;09;22;Tiistai;7;5;12
624;26.09.2017;2017;09;23;Tiistai;1;10;11
624;27.09.2017;2017;09;00;Keskiviikko;0;2;2
624;27.09.2017;2017;09;01;Keskiviikko;1;4;5
624;27.09.2017;2017;09;02;Keskiviikko;0;1;1
624;27.09.2017;2017;09;03;Keskiviikko;0;2;2
624;27.09.2017;2017;09;04;Keskiviikko;2;1;3
624;27.09.2017;2017;09;05;Keskiviikko;3;2;5
624;27.09.2017;2017;09;06;Keskiviikko;0;8;8
624;27.09.2017;2017;09;07;Keskiviikko;1;33;34
624;27.09.2017;2017;09;08;Keskiviikko;11;69;80
624;27.09.2017;2017;09;09;Keskiviikko;11;78;89
624;27.09.2017;2017;09;10;Keskiviikko;5;28;33
624;27.09.2017;2017;09;11;Keskiviikko;4;17;21
624;27.09.2017;2017;09;12;Keskiviikko;11;21;32
624;27.09.2017;2017;09;13;Keskiviikko;2;33;35
624;27.09.2017;2017;09;14;Keskiviikko;13;29;42
624;27.09.2017;2017;09;15;Keskiviikko;9;42;51
624;27.09.2017;2017;09;16;Keskiviikko;17;39;56
624;27.09.2017;2017;09;17;Keskiviikko;11;51;62
624;27.09.2017;2017;09;18;Keskiviikko;10;32;42
624;27.09.2017;2017;09;19;Keskiviikko;6;33;39
624;27.09.2017;2017;09;20;Keskiviikko;17;18;35
624;27.09.2017;2017;09;21;Keskiviikko;10;15;25
624;27.09.2017;2017;09;22;Keskiviikko;10;14;24
624;27.09.2017;2017;09;23;Keskiviikko;4;11;15
624;28.09.2017;2017;09;00;Torstai;2;6;8
624;28.09.2017;2017;09;01;Torstai;1;3;4
624;28.09.2017;2017;09;02;Torstai;0;1;1
624;28.09.2017;2017;09;03;Torstai;0;2;2
624;28.09.2017;2017;09;04;Torstai;0;0;0
624;28.09.2017;2017;09;05;Torstai;1;1;2
624;28.09.2017;2017;09;06;Torstai;0;11;11
624;28.09.2017;2017;09;07;Torstai;6;29;35
624;28.09.2017;2017;09;08;Torstai;11;66;77
624;28.09.2017;2017;09;09;Torstai;14;73;87
624;28.09.2017;2017;09;10;Torstai;3;27;30
624;28.09.2017;2017;09;11;Torstai;7;14;21
624;28.09.2017;2017;09;12;Torstai;11;26;37
624;28.09.2017;2017;09;13;Torstai;4;14;18
624;28.09.2017;2017;09;14;Torstai;9;30;39
624;28.09.2017;2017;09;15;Torstai;17;38;55
624;28.09.2017;2017;09;16;Torstai;14;34;48
624;28.09.2017;2017;09;17;Torstai;16;45;61
624;28.09.2017;2017;09;18;Torstai;12;34;46
624;28.09.2017;2017;09;19;Torstai;7;37;44
624;28.09.2017;2017;09;20;Torstai;15;21;36
624;28.09.2017;2017;09;21;Torstai;11;14;25
624;28.09.2017;2017;09;22;Torstai;11;11;22
624;28.09.2017;2017;09;23;Torstai;2;8;10
624;29.09.2017;2017;09;00;Perjantai;4;2;6
624;29.09.2017;2017;09;01;Perjantai;2;2;4
624;29.09.2017;2017;09;02;Perjantai;0;0;0
624;29.09.2017;2017;09;03;Perjantai;2;0;2
624;29.09.2017;2017;09;04;Perjantai;1;2;3
624;29.09.2017;2017;09;05;Perjantai;2;2;4
624;29.09.2017;2017;09;06;Perjantai;1;12;13
624;29.09.2017;2017;09;07;Perjantai;4;27;31
624;29.09.2017;2017;09;08;Perjantai;12;61;73
624;29.09.2017;2017;09;09;Perjantai;6;61;67
624;29.09.2017;2017;09;10;Perjantai;7;27;34
624;29.09.2017;2017;09;11;Perjantai;1;16;17
624;29.09.2017;2017;09;12;Perjantai;9;26;35
624;29.09.2017;2017;09;13;Perjantai;14;25;39
624;29.09.2017;2017;09;14;Perjantai;12;36;48
624;29.09.2017;2017;09;15;Perjantai;7;30;37
624;29.09.2017;2017;09;16;Perjantai;19;37;56
624;29.09.2017;2017;09;17;Perjantai;14;35;49
624;29.09.2017;2017;09;18;Perjantai;9;23;32
624;29.09.2017;2017;09;19;Perjantai;12;23;35
624;29.09.2017;2017;09;20;Perjantai;4;18;22
624;29.09.2017;2017;09;21;Perjantai;5;14;19
624;29.09.2017;2017;09;22;Perjantai;6;14;20
624;29.09.2017;2017;09;23;Perjantai;2;11;13
624;30.09.2017;2017;09;00;Lauantai;3;7;10
624;30.09.2017;2017;09;01;Lauantai;2;2;4
624;30.09.2017;2017;09;02;Lauantai;1;3;4
624;30.09.2017;2017;09;03;Lauantai;5;2;7
624;30.09.2017;2017;09;04;Lauantai;3;2;5
624;30.09.2017;2017;09;05;Lauantai;3;1;4
624;30.09.2017;2017;09;06;Lauantai;0;2;2
624;30.09.2017;2017;09;07;Lauantai;0;8;8
624;30.09.2017;2017;09;08;Lauantai;0;2;2
624;30.09.2017;2017;09;09;Lauantai;1;7;8
624;30.09.2017;2017;09;10;Lauantai;1;19;20
624;30.09.2017;2017;09;11;Lauantai;3;23;26
624;30.09.2017;2017;09;12;Lauantai;5;23;28
624;30.09.2017;2017;09;13;Lauantai;5;17;22
624;30.09.2017;2017;09;14;Lauantai;8;21;29
624;30.09.2017;2017;09;15;Lauantai;8;25;33
624;30.09.2017;2017;09;16;Lauantai;4;14;18
624;30.09.2017;2017;09;17;Lauantai;10;48;58
624;30.09.2017;2017;09;18;Lauantai;8;16;24
624;30.09.2017;2017;09;19;Lauantai;7;10;17
624;30.09.2017;2017;09;20;Lauantai;9;14;23
624;30.09.2017;2017;09;21;Lauantai;3;14;17
624;30.09.2017;2017;09;22;Lauantai;4;8;12
624;30.09.2017;2017;09;23;Lauantai;8;17;25
624;01.10.2017;2017;10;00;Sunnuntai;2;4;6
624;01.10.2017;2017;10;01;Sunnuntai;6;8;14
624;01.10.2017;2017;10;02;Sunnuntai;2;5;7
624;01.10.2017;2017;10;03;Sunnuntai;5;4;9
624;01.10.2017;2017;10;04;Sunnuntai;5;0;5
624;01.10.2017;2017;10;05;Sunnuntai;1;1;2
624;01.10.2017;2017;10;06;Sunnuntai;0;2;2
624;01.10.2017;2017;10;07;Sunnuntai;1;4;5
624;01.10.2017;2017;10;08;Sunnuntai;0;2;2
624;01.10.2017;2017;10;09;Sunnuntai;1;5;6
624;01.10.2017;2017;10;10;Sunnuntai;1;6;7
624;01.10.2017;2017;10;11;Sunnuntai;5;14;19
624;01.10.2017;2017;10;12;Sunnuntai;1;17;18
624;01.10.2017;2017;10;13;Sunnuntai;7;26;33
624;01.10.2017;2017;10;14;Sunnuntai;6;25;31
624;01.10.2017;2017;10;15;Sunnuntai;6;21;27
624;01.10.2017;2017;10;16;Sunnuntai;8;19;27
624;01.10.2017;2017;10;17;Sunnuntai;7;12;19
624;01.10.2017;2017;10;18;Sunnuntai;18;8;26
624;01.10.2017;2017;10;19;Sunnuntai;3;16;19
624;01.10.2017;2017;10;20;Sunnuntai;9;12;21
624;01.10.2017;2017;10;21;Sunnuntai;2;7;9
624;01.10.2017;2017;10;22;Sunnuntai;3;4;7
624;01.10.2017;2017;10;23;Sunnuntai;1;3;4
624;02.10.2017;2017;10;00;Maanantai;0;3;3
624;02.10.2017;2017;10;01;Maanantai;3;1;4
624;02.10.2017;2017;10;02;Maanantai;0;0;0
624;02.10.2017;2017;10;03;Maanantai;1;1;2
624;02.10.2017;2017;10;04;Maanantai;0;0;0
624;02.10.2017;2017;10;05;Maanantai;0;1;1
624;02.10.2017;2017;10;06;Maanantai;1;9;10
624;02.10.2017;2017;10;07;Maanantai;2;29;31
624;02.10.2017;2017;10;08;Maanantai;11;75;86
624;02.10.2017;2017;10;09;Maanantai;11;83;94
624;02.10.2017;2017;10;10;Maanantai;6;35;41
624;02.10.2017;2017;10;11;Maanantai;9;27;36
624;02.10.2017;2017;10;12;Maanantai;11;25;36
624;02.10.2017;2017;10;13;Maanantai;5;34;39
624;02.10.2017;2017;10;14;Maanantai;8;28;36
624;02.10.2017;2017;10;15;Maanantai;10;39;49
624;02.10.2017;2017;10;16;Maanantai;23;27;50
624;02.10.2017;2017;10;17;Maanantai;20;56;76
624;02.10.2017;2017;10;18;Maanantai;7;32;39
624;02.10.2017;2017;10;19;Maanantai;13;28;41
624;02.10.2017;2017;10;20;Maanantai;13;15;28
624;02.10.2017;2017;10;21;Maanantai;6;19;25
624;02.10.2017;2017;10;22;Maanantai;19;8;27
624;02.10.2017;2017;10;23;Maanantai;5;8;13
624;03.10.2017;2017;10;00;Tiistai;4;1;5
624;03.10.2017;2017;10;01;Tiistai;0;0;0
624;03.10.2017;2017;10;02;Tiistai;0;0;0
624;03.10.2017;2017;10;03;Tiistai;2;2;4
624;03.10.2017;2017;10;04;Tiistai;1;1;2
624;03.10.2017;2017;10;05;Tiistai;0;0;0
624;03.10.2017;2017;10;06;Tiistai;1;9;10
624;03.10.2017;2017;10;07;Tiistai;7;31;38
624;03.10.2017;2017;10;08;Tiistai;7;69;76
624;03.10.2017;2017;10;09;Tiistai;9;68;77
624;03.10.2017;2017;10;10;Tiistai;2;27;29
624;03.10.2017;2017;10;11;Tiistai;2;22;24
624;03.10.2017;2017;10;12;Tiistai;5;13;18
624;03.10.2017;2017;10;13;Tiistai;3;18;21
624;03.10.2017;2017;10;14;Tiistai;4;9;13
624;03.10.2017;2017;10;15;Tiistai;7;31;38
624;03.10.2017;2017;10;16;Tiistai;11;32;43
624;03.10.2017;2017;10;17;Tiistai;18;40;58
624;03.10.2017;2017;10;18;Tiistai;14;26;40
624;03.10.2017;2017;10;19;Tiistai;15;22;37
624;03.10.2017;2017;10;20;Tiistai;9;9;18
624;03.10.2017;2017;10;21;Tiistai;8;17;25
624;03.10.2017;2017;10;22;Tiistai;2;4;6
624;03.10.2017;2017;10;23;Tiistai;7;3;10
624;04.10.2017;2017;10;00;Keskiviikko;2;0;2
624;04.10.2017;2017;10;01;Keskiviikko;0;1;1
624;04.10.2017;2017;10;02;Keskiviikko;1;1;2
624;04.10.2017;2017;10;03;Keskiviikko;0;1;1
624;04.10.2017;2017;10;04;Keskiviikko;0;1;1
624;04.10.2017;2017;10;05;Keskiviikko;1;1;2
624;04.10.2017;2017;10;06;Keskiviikko;1;6;7
624;04.10.2017;2017;10;07;Keskiviikko;4;32;36
624;04.10.2017;2017;10;08;Keskiviikko;7;56;63
624;04.10.2017;2017;10;09;Keskiviikko;8;69;77
624;04.10.2017;2017;10;10;Keskiviikko;6;26;32
624;04.10.2017;2017;10;11;Keskiviikko;3;12;15
624;04.10.2017;2017;10;12;Keskiviikko;6;18;24
624;04.10.2017;2017;10;13;Keskiviikko;4;29;33
624;04.10.2017;2017;10;14;Keskiviikko;11;20;31
624;04.10.2017;2017;10;15;Keskiviikko;15;26;41
624;04.10.2017;2017;10;16;Keskiviikko;11;28;39
624;04.10.2017;2017;10;17;Keskiviikko;18;54;72
624;04.10.2017;2017;10;18;Keskiviikko;20;21;41
624;04.10.2017;2017;10;19;Keskiviikko;9;38;47
624;04.10.2017;2017;10;20;Keskiviikko;14;17;31
624;04.10.2017;2017;10;21;Keskiviikko;16;10;26
624;04.10.2017;2017;10;22;Keskiviikko;7;9;16
624;04.10.2017;2017;10;23;Keskiviikko;2;6;8
624;05.10.2017;2017;10;00;Torstai;1;6;7
624;05.10.2017;2017;10;01;Torstai;1;3;4
624;05.10.2017;2017;10;02;Torstai;0;2;2
624;05.10.2017;2017;10;03;Torstai;0;2;2
624;05.10.2017;2017;10;04;Torstai;0;1;1
624;05.10.2017;2017;10;05;Torstai;3;0;3
624;05.10.2017;2017;10;06;Torstai;1;10;11
624;05.10.2017;2017;10;07;Torstai;6;33;39
624;05.10.2017;2017;10;08;Torstai;7;62;69
624;05.10.2017;2017;10;09;Torstai;12;70;82
624;05.10.2017;2017;10;10;Torstai;3;18;21
624;05.10.2017;2017;10;11;Torstai;0;20;20
624;05.10.2017;2017;10;12;Torstai;8;15;23
624;05.10.2017;2017;10;13;Torstai;9;20;29
624;05.10.2017;2017;10;14;Torstai;7;20;27
624;05.10.2017;2017;10;15;Torstai;11;35;46
624;05.10.2017;2017;10;16;Torstai;13;22;35
624;05.10.2017;2017;10;17;Torstai;17;36;53
624;05.10.2017;2017;10;18;Torstai;14;35;49
624;05.10.2017;2017;10;19;Torstai;8;27;35
624;05.10.2017;2017;10;20;Torstai;6;12;18
624;05.10.2017;2017;10;21;Torstai;8;16;24
624;05.10.2017;2017;10;22;Torstai;5;4;9
624;05.10.2017;2017;10;23;Torstai;2;4;6
624;06.10.2017;2017;10;00;Perjantai;2;3;5
624;06.10.2017;2017;10;01;Perjantai;3;2;5
624;06.10.2017;2017;10;02;Perjantai;1;1;2
624;06.10.2017;2017;10;03;Perjantai;0;3;3
624;06.10.2017;2017;10;04;Perjantai;2;1;3
624;06.10.2017;2017;10;05;Perjantai;4;0;4
624;06.10.2017;2017;10;06;Perjantai;2;14;16
624;06.10.2017;2017;10;07;Perjantai;4;24;28
624;06.10.2017;2017;10;08;Perjantai;10;64;74
624;06.10.2017;2017;10;09;Perjantai;12;76;88
624;06.10.2017;2017;10;10;Perjantai;3;23;26
624;06.10.2017;2017;10;11;Perjantai;1;24;25
624;06.10.2017;2017;10;12;Perjantai;6;32;38
624;06.10.2017;2017;10;13;Perjantai;16;30;46
624;06.10.2017;2017;10;14;Perjantai;15;30;45
624;06.10.2017;2017;10;15;Perjantai;17;35;52
624;06.10.2017;2017;10;16;Perjantai;14;27;41
624;06.10.2017;2017;10;17;Perjantai;17;39;56
624;06.10.2017;2017;10;18;Perjantai;14;23;37
624;06.10.2017;2017;10;19;Perjantai;19;20;39
624;06.10.2017;2017;10;20;Perjantai;9;14;23
624;06.10.2017;2017;10;21;Perjantai;8;8;16
624;06.10.2017;2017;10;22;Perjantai;9;9;18
624;06.10.2017;2017;10;23;Perjantai;3;8;11
624;07.10.2017;2017;10;00;Lauantai;3;7;10
624;07.10.2017;2017;10;01;Lauantai;5;6;11
624;07.10.2017;2017;10;02;Lauantai;1;1;2
624;07.10.2017;2017;10;03;Lauantai;2;1;3
624;07.10.2017;2017;10;04;Lauantai;5;3;8
624;07.10.2017;2017;10;05;Lauantai;4;0;4
624;07.10.2017;2017;10;06;Lauantai;1;1;2
624;07.10.2017;2017;10;07;Lauantai;0;4;4
624;07.10.2017;2017;10;08;Lauantai;1;4;5
624;07.10.2017;2017;10;09;Lauantai;2;2;4
624;07.10.2017;2017;10;10;Lauantai;3;15;18
624;07.10.2017;2017;10;11;Lauantai;0;18;18
624;07.10.2017;2017;10;12;Lauantai;2;23;25
624;07.10.2017;2017;10;13;Lauantai;4;15;19
624;07.10.2017;2017;10;14;Lauantai;4;15;19
624;07.10.2017;2017;10;15;Lauantai;8;15;23
624;07.10.2017;2017;10;16;Lauantai;6;15;21
624;07.10.2017;2017;10;17;Lauantai;11;35;46
624;07.10.2017;2017;10;18;Lauantai;10;14;24
624;07.10.2017;2017;10;19;Lauantai;3;11;14
624;07.10.2017;2017;10;20;Lauantai;7;15;22
624;07.10.2017;2017;10;21;Lauantai;5;10;15
624;07.10.2017;2017;10;22;Lauantai;4;6;10
624;07.10.2017;2017;10;23;Lauantai;5;2;7
624;08.10.2017;2017;10;00;Sunnuntai;1;4;5
624;08.10.2017;2017;10;01;Sunnuntai;1;2;3
624;08.10.2017;2017;10;02;Sunnuntai;2;9;11
624;08.10.2017;2017;10;03;Sunnuntai;0;0;0
624;08.10.2017;2017;10;04;Sunnuntai;2;1;3
624;08.10.2017;2017;10;05;Sunnuntai;1;2;3
624;08.10.2017;2017;10;06;Sunnuntai;1;1;2
624;08.10.2017;2017;10;07;Sunnuntai;1;4;5
624;08.10.2017;2017;10;08;Sunnuntai;0;2;2
624;08.10.2017;2017;10;09;Sunnuntai;0;9;9
624;08.10.2017;2017;10;10;Sunnuntai;0;4;4
624;08.10.2017;2017;10;11;Sunnuntai;4;14;18
624;08.10.2017;2017;10;12;Sunnuntai;8;26;34
624;08.10.2017;2017;10;13;Sunnuntai;5;19;24
624;08.10.2017;2017;10;14;Sunnuntai;3;20;23
624;08.10.2017;2017;10;15;Sunnuntai;8;18;26
624;08.10.2017;2017;10;16;Sunnuntai;7;15;22
624;08.10.2017;2017;10;17;Sunnuntai;4;16;20
624;08.10.2017;2017;10;18;Sunnuntai;5;14;19
624;08.10.2017;2017;10;19;Sunnuntai;12;13;25
624;08.10.2017;2017;10;20;Sunnuntai;6;13;19
624;08.10.2017;2017;10;21;Sunnuntai;9;11;20
624;08.10.2017;2017;10;22;Sunnuntai;5;2;7
624;08.10.2017;2017;10;23;Sunnuntai;1;4;5
624;09.10.2017;2017;10;00;Maanantai;1;2;3
624;09.10.2017;2017;10;01;Maanantai;1;6;7
624;09.10.2017;2017;10;02;Maanantai;0;0;0
624;09.10.2017;2017;10;03;Maanantai;0;1;1
624;09.10.2017;2017;10;04;Maanantai;0;1;1
624;09.10.2017;2017;10;05;Maanantai;2;1;3
624;09.10.2017;2017;10;06;Maanantai;1;14;15
624;09.10.2017;2017;10;07;Maanantai;5;32;37
624;09.10.2017;2017;10;08;Maanantai;10;68;78
624;09.10.2017;2017;10;09;Maanantai;16;81;97
624;09.10.2017;2017;10;10;Maanantai;10;42;52
624;09.10.2017;2017;10;11;Maanantai;10;25;35
624;09.10.2017;2017;10;12;Maanantai;11;29;40
624;09.10.2017;2017;10;13;Maanantai;6;36;42
624;09.10.2017;2017;10;14;Maanantai;10;34;44
624;09.10.2017;2017;10;15;Maanantai;14;37;51
624;09.10.2017;2017;10;16;Maanantai;19;34;53
624;09.10.2017;2017;10;17;Maanantai;23;60;83
624;09.10.2017;2017;10;18;Maanantai;16;42;58
624;09.10.2017;2017;10;19;Maanantai;17;38;55
624;09.10.2017;2017;10;20;Maanantai;14;14;28
624;09.10.2017;2017;10;21;Maanantai;9;15;24
624;09.10.2017;2017;10;22;Maanantai;4;6;10
624;09.10.2017;2017;10;23;Maanantai;7;7;14
624;10.10.2017;2017;10;00;Tiistai;0;1;1
624;10.10.2017;2017;10;01;Tiistai;0;1;1
624;10.10.2017;2017;10;02;Tiistai;0;1;1
624;10.10.2017;2017;10;03;Tiistai;0;0;0
624;10.10.2017;2017;10;04;Tiistai;0;2;2
624;10.10.2017;2017;10;05;Tiistai;1;0;1
624;10.10.2017;2017;10;06;Tiistai;2;15;17
624;10.10.2017;2017;10;07;Tiistai;5;25;30
624;10.10.2017;2017;10;08;Tiistai;12;70;82
624;10.10.2017;2017;10;09;Tiistai;9;51;60
624;10.10.2017;2017;10;10;Tiistai;4;18;22
624;10.10.2017;2017;10;11;Tiistai;6;20;26
624;10.10.2017;2017;10;12;Tiistai;11;17;28
624;10.10.2017;2017;10;13;Tiistai;9;22;31
624;10.10.2017;2017;10;14;Tiistai;9;12;21
624;10.10.2017;2017;10;15;Tiistai;16;32;48
624;10.10.2017;2017;10;16;Tiistai;24;23;47
624;10.10.2017;2017;10;17;Tiistai;12;31;43
624;10.10.2017;2017;10;18;Tiistai;9;26;35
624;10.10.2017;2017;10;19;Tiistai;15;23;38
624;10.10.2017;2017;10;20;Tiistai;9;12;21
624;10.10.2017;2017;10;21;Tiistai;8;17;25
624;10.10.2017;2017;10;22;Tiistai;9;9;18
624;10.10.2017;2017;10;23;Tiistai;4;7;11
624;11.10.2017;2017;10;00;Keskiviikko;1;0;1
624;11.10.2017;2017;10;01;Keskiviikko;1;3;4
624;11.10.2017;2017;10;02;Keskiviikko;0;0;0
624;11.10.2017;2017;10;03;Keskiviikko;0;1;1
624;11.10.2017;2017;10;04;Keskiviikko;0;2;2
624;11.10.2017;2017;10;05;Keskiviikko;1;0;1
624;11.10.2017;2017;10;06;Keskiviikko;2;12;14
624;11.10.2017;2017;10;07;Keskiviikko;2;31;33
624;11.10.2017;2017;10;08;Keskiviikko;11;64;75
624;11.10.2017;2017;10;09;Keskiviikko;5;86;91
624;11.10.2017;2017;10;10;Keskiviikko;4;28;32
624;11.10.2017;2017;10;11;Keskiviikko;4;24;28
624;11.10.2017;2017;10;12;Keskiviikko;5;25;30
624;11.10.2017;2017;10;13;Keskiviikko;7;23;30
624;11.10.2017;2017;10;14;Keskiviikko;17;18;35
624;11.10.2017;2017;10;15;Keskiviikko;9;40;49
624;11.10.2017;2017;10;16;Keskiviikko;11;31;42
624;11.10.2017;2017;10;17;Keskiviikko;12;49;61
624;11.10.2017;2017;10;18;Keskiviikko;11;39;50
624;11.10.2017;2017;10;19;Keskiviikko;5;11;16
624;11.10.2017;2017;10;20;Keskiviikko;8;11;19
624;11.10.2017;2017;10;21;Keskiviikko;7;23;30
624;11.10.2017;2017;10;22;Keskiviikko;8;12;20
624;11.10.2017;2017;10;23;Keskiviikko;1;5;6
624;12.10.2017;2017;10;00;Torstai;3;4;7
624;12.10.2017;2017;10;01;Torstai;3;2;5
624;12.10.2017;2017;10;02;Torstai;2;0;2
624;12.10.2017;2017;10;03;Torstai;0;3;3
624;12.10.2017;2017;10;04;Torstai;0;0;0
624;12.10.2017;2017;10;05;Torstai;2;0;2
624;12.10.2017;2017;10;06;Torstai;0;10;10
624;12.10.2017;2017;10;07;Torstai;2;33;35
624;12.10.2017;2017;10;08;Torstai;11;73;84
624;12.10.2017;2017;10;09;Torstai;13;69;82
624;12.10.2017;2017;10;10;Torstai;3;29;32
624;12.10.2017;2017;10;11;Torstai;6;20;26
624;12.10.2017;2017;10;12;Torstai;6;31;37
624;12.10.2017;2017;10;13;Torstai;9;31;40
624;12.10.2017;2017;10;14;Torstai;8;23;31
624;12.10.2017;2017;10;15;Torstai;17;35;52
624;12.10.2017;2017;10;16;Torstai;13;36;49
624;12.10.2017;2017;10;17;Torstai;17;47;64
624;12.10.2017;2017;10;18;Torstai;16;26;42
624;12.10.2017;2017;10;19;Torstai;12;21;33
624;12.10.2017;2017;10;20;Torstai;4;12;16
624;12.10.2017;2017;10;21;Torstai;9;20;29
624;12.10.2017;2017;10;22;Torstai;5;6;11
624;12.10.2017;2017;10;23;Torstai;3;10;13
624;13.10.2017;2017;10;00;Perjantai;0;3;3
624;13.10.2017;2017;10;01;Perjantai;2;1;3
624;13.10.2017;2017;10;02;Perjantai;3;0;3
624;13.10.2017;2017;10;03;Perjantai;0;2;2
624;13.10.2017;2017;10;04;Perjantai;0;0;0
624;13.10.2017;2017;10;05;Perjantai;0;1;1
624;13.10.2017;2017;10;06;Perjantai;0;6;6
624;13.10.2017;2017;10;07;Perjantai;1;20;21
624;13.10.2017;2017;10;08;Perjantai;8;64;72
624;13.10.2017;2017;10;09;Perjantai;6;74;80
624;13.10.2017;2017;10;10;Perjantai;12;30;42
624;13.10.2017;2017;10;11;Perjantai;5;23;28
624;13.10.2017;2017;10;12;Perjantai;10;38;48
624;13.10.2017;2017;10;13;Perjantai;6;33;39
624;13.10.2017;2017;10;14;Perjantai;6;28;34
624;13.10.2017;2017;10;15;Perjantai;19;48;67
624;13.10.2017;2017;10;16;Perjantai;17;25;42
624;13.10.2017;2017;10;17;Perjantai;13;43;56
624;13.10.2017;2017;10;18;Perjantai;9;31;40
624;13.10.2017;2017;10;19;Perjantai;13;16;29
624;13.10.2017;2017;10;20;Perjantai;8;16;24
624;13.10.2017;2017;10;21;Perjantai;8;12;20
624;13.10.2017;2017;10;22;Perjantai;11;14;25
624;13.10.2017;2017;10;23;Perjantai;3;8;11
624;14.10.2017;2017;10;00;Lauantai;1;8;9
624;14.10.2017;2017;10;01;Lauantai;5;10;15
624;14.10.2017;2017;10;02;Lauantai;5;3;8
624;14.10.2017;2017;10;03;Lauantai;5;4;9
624;14.10.2017;2017;10;04;Lauantai;2;1;3
624;14.10.2017;2017;10;05;Lauantai;4;1;5
624;14.10.2017;2017;10;06;Lauantai;1;1;2
624;14.10.2017;2017;10;07;Lauantai;2;6;8
624;14.10.2017;2017;10;08;Lauantai;0;4;4
624;14.10.2017;2017;10;09;Lauantai;0;6;6
624;14.10.2017;2017;10;10;Lauantai;1;15;16
624;14.10.2017;2017;10;11;Lauantai;6;24;30
624;14.10.2017;2017;10;12;Lauantai;7;23;30
624;14.10.2017;2017;10;13;Lauantai;7;25;32
624;14.10.2017;2017;10;14;Lauantai;12;29;41
624;14.10.2017;2017;10;15;Lauantai;6;24;30
624;14.10.2017;2017;10;16;Lauantai;8;20;28
624;14.10.2017;2017;10;17;Lauantai;8;17;25
624;14.10.2017;2017;10;18;Lauantai;4;8;12
624;14.10.2017;2017;10;19;Lauantai;0;7;7
624;14.10.2017;2017;10;20;Lauantai;10;11;21
624;14.10.2017;2017;10;21;Lauantai;5;10;15
624;14.10.2017;2017;10;22;Lauantai;6;8;14
624;14.10.2017;2017;10;23;Lauantai;1;2;3
624;15.10.2017;2017;10;00;Sunnuntai;4;7;11
624;15.10.2017;2017;10;01;Sunnuntai;2;4;6
624;15.10.2017;2017;10;02;Sunnuntai;2;4;6
624;15.10.2017;2017;10;03;Sunnuntai;3;1;4
624;15.10.2017;2017;10;04;Sunnuntai;0;1;1
624;15.10.2017;2017;10;05;Sunnuntai;1;2;3
624;15.10.2017;2017;10;06;Sunnuntai;0;2;2
624;15.10.2017;2017;10;07;Sunnuntai;3;7;10
624;15.10.2017;2017;10;08;Sunnuntai;3;3;6
624;15.10.2017;2017;10;09;Sunnuntai;0;4;4
624;15.10.2017;2017;10;10;Sunnuntai;1;7;8
624;15.10.2017;2017;10;11;Sunnuntai;1;9;10
624;15.10.2017;2017;10;12;Sunnuntai;10;28;38
624;15.10.2017;2017;10;13;Sunnuntai;6;22;28
624;15.10.2017;2017;10;14;Sunnuntai;14;25;39
624;15.10.2017;2017;10;15;Sunnuntai;13;23;36
624;15.10.2017;2017;10;16;Sunnuntai;10;21;31
624;15.10.2017;2017;10;17;Sunnuntai;7;16;23
624;15.10.2017;2017;10;18;Sunnuntai;3;18;21
624;15.10.2017;2017;10;19;Sunnuntai;3;13;16
624;15.10.2017;2017;10;20;Sunnuntai;6;7;13
624;15.10.2017;2017;10;21;Sunnuntai;1;10;11
624;15.10.2017;2017;10;22;Sunnuntai;5;6;11
624;15.10.2017;2017;10;23;Sunnuntai;3;2;5
624;16.10.2017;2017;10;00;Maanantai;0;1;1
624;16.10.2017;2017;10;01;Maanantai;1;1;2
624;16.10.2017;2017;10;02;Maanantai;1;0;1
624;16.10.2017;2017;10;03;Maanantai;1;1;2
624;16.10.2017;2017;10;04;Maanantai;0;0;0
624;16.10.2017;2017;10;05;Maanantai;0;0;0
624;16.10.2017;2017;10;06;Maanantai;1;8;9
624;16.10.2017;2017;10;07;Maanantai;4;28;32
624;16.10.2017;2017;10;08;Maanantai;14;60;74
624;16.10.2017;2017;10;09;Maanantai;4;50;54
624;16.10.2017;2017;10;10;Maanantai;7;26;33
624;16.10.2017;2017;10;11;Maanantai;7;16;23
624;16.10.2017;2017;10;12;Maanantai;14;36;50
624;16.10.2017;2017;10;13;Maanantai;10;20;30
624;16.10.2017;2017;10;14;Maanantai;8;18;26
624;16.10.2017;2017;10;15;Maanantai;24;29;53
624;16.10.2017;2017;10;16;Maanantai;20;25;45
624;16.10.2017;2017;10;17;Maanantai;13;43;56
624;16.10.2017;2017;10;18;Maanantai;3;42;45
624;16.10.2017;2017;10;19;Maanantai;15;32;47
624;16.10.2017;2017;10;20;Maanantai;13;15;28
624;16.10.2017;2017;10;21;Maanantai;7;8;15
624;16.10.2017;2017;10;22;Maanantai;5;7;12
624;16.10.2017;2017;10;23;Maanantai;3;5;8
624;17.10.2017;2017;10;00;Tiistai;1;3;4
624;17.10.2017;2017;10;01;Tiistai;1;0;1
624;17.10.2017;2017;10;02;Tiistai;1;0;1
624;17.10.2017;2017;10;03;Tiistai;0;1;1
624;17.10.2017;2017;10;04;Tiistai;0;1;1
624;17.10.2017;2017;10;05;Tiistai;0;0;0
624;17.10.2017;2017;10;06;Tiistai;0;9;9
624;17.10.2017;2017;10;07;Tiistai;3;26;29
624;17.10.2017;2017;10;08;Tiistai;7;74;81
624;17.10.2017;2017;10;09;Tiistai;10;66;76
624;17.10.2017;2017;10;10;Tiistai;3;21;24
624;17.10.2017;2017;10;11;Tiistai;8;20;28
624;17.10.2017;2017;10;12;Tiistai;9;23;32
624;17.10.2017;2017;10;13;Tiistai;8;17;25
624;17.10.2017;2017;10;14;Tiistai;14;33;47
624;17.10.2017;2017;10;15;Tiistai;10;31;41
624;17.10.2017;2017;10;16;Tiistai;22;32;54
624;17.10.2017;2017;10;17;Tiistai;20;43;63
624;17.10.2017;2017;10;18;Tiistai;9;49;58
624;17.10.2017;2017;10;19;Tiistai;14;20;34
624;17.10.2017;2017;10;20;Tiistai;11;21;32
624;17.10.2017;2017;10;21;Tiistai;11;14;25
624;17.10.2017;2017;10;22;Tiistai;3;10;13
624;17.10.2017;2017;10;23;Tiistai;4;3;7
624;18.10.2017;2017;10;00;Keskiviikko;0;2;2
624;18.10.2017;2017;10;01;Keskiviikko;1;1;2
624;18.10.2017;2017;10;02;Keskiviikko;0;1;1
624;18.10.2017;2017;10;03;Keskiviikko;1;1;2
624;18.10.2017;2017;10;04;Keskiviikko;0;1;1
624;18.10.2017;2017;10;05;Keskiviikko;2;0;2
624;18.10.2017;2017;10;06;Keskiviikko;2;6;8
624;18.10.2017;2017;10;07;Keskiviikko;5;33;38
624;18.10.2017;2017;10;08;Keskiviikko;14;71;85
624;18.10.2017;2017;10;09;Keskiviikko;10;84;94
624;18.10.2017;2017;10;10;Keskiviikko;2;26;28
624;18.10.2017;2017;10;11;Keskiviikko;3;18;21
624;18.10.2017;2017;10;12;Keskiviikko;5;27;32
624;18.10.2017;2017;10;13;Keskiviikko;3;36;39
624;18.10.2017;2017;10;14;Keskiviikko;12;23;35
624;18.10.2017;2017;10;15;Keskiviikko;11;40;51
624;18.10.2017;2017;10;16;Keskiviikko;10;32;42
624;18.10.2017;2017;10;17;Keskiviikko;20;44;64
624;18.10.2017;2017;10;18;Keskiviikko;11;40;51
624;18.10.2017;2017;10;19;Keskiviikko;13;34;47
624;18.10.2017;2017;10;20;Keskiviikko;11;22;33
624;18.10.2017;2017;10;21;Keskiviikko;7;18;25
624;18.10.2017;2017;10;22;Keskiviikko;24;11;35
624;18.10.2017;2017;10;23;Keskiviikko;4;4;8
624;19.10.2017;2017;10;00;Torstai;3;3;6
624;19.10.2017;2017;10;01;Torstai;0;4;4
624;19.10.2017;2017;10;02;Torstai;1;0;1
624;19.10.2017;2017;10;03;Torstai;0;1;1
624;19.10.2017;2017;10;04;Torstai;0;1;1
624;19.10.2017;2017;10;05;Torstai;1;0;1
624;19.10.2017;2017;10;06;Torstai;0;8;8
624;19.10.2017;2017;10;07;Torstai;3;36;39
624;19.10.2017;2017;10;08;Torstai;11;76;87
624;19.10.2017;2017;10;09;Torstai;11;76;87
624;19.10.2017;2017;10;10;Torstai;12;35;47
624;19.10.2017;2017;10;11;Torstai;5;17;22
624;19.10.2017;2017;10;12;Torstai;10;21;31
624;19.10.2017;2017;10;13;Torstai;10;38;48
624;19.10.2017;2017;10;14;Torstai;8;36;44
624;19.10.2017;2017;10;15;Torstai;18;28;46
624;19.10.2017;2017;10;16;Torstai;13;24;37
624;19.10.2017;2017;10;17;Torstai;19;34;53
624;19.10.2017;2017;10;18;Torstai;11;24;35
624;19.10.2017;2017;10;19;Torstai;13;31;44
624;19.10.2017;2017;10;20;Torstai;7;17;24
624;19.10.2017;2017;10;21;Torstai;9;15;24
624;19.10.2017;2017;10;22;Torstai;7;9;16
624;19.10.2017;2017;10;23;Torstai;6;5;11
624;20.10.2017;2017;10;00;Perjantai;1;2;3
624;20.10.2017;2017;10;01;Perjantai;0;3;3
624;20.10.2017;2017;10;02;Perjantai;1;1;2
624;20.10.2017;2017;10;03;Perjantai;0;1;1
624;20.10.2017;2017;10;04;Perjantai;1;2;3
624;20.10.2017;2017;10;05;Perjantai;0;0;0
624;20.10.2017;2017;10;06;Perjantai;0;9;9
624;20.10.2017;2017;10;07;Perjantai;3;23;26
624;20.10.2017;2017;10;08;Perjantai;13;65;78
624;20.10.2017;2017;10;09;Perjantai;6;47;53
624;20.10.2017;2017;10;10;Perjantai;7;22;29
624;20.10.2017;2017;10;11;Perjantai;5;13;18
624;20.10.2017;2017;10;12;Perjantai;7;19;26
624;20.10.2017;2017;10;13;Perjantai;4;26;30
624;20.10.2017;2017;10;14;Perjantai;6;12;18
624;20.10.2017;2017;10;15;Perjantai;14;21;35
624;20.10.2017;2017;10;16;Perjantai;13;29;42
624;20.10.2017;2017;10;17;Perjantai;7;23;30
624;20.10.2017;2017;10;18;Perjantai;7;13;20
624;20.10.2017;2017;10;19;Perjantai;10;10;20
624;20.10.2017;2017;10;20;Perjantai;7;13;20
624;20.10.2017;2017;10;21;Perjantai;7;10;17
624;20.10.2017;2017;10;22;Perjantai;1;7;8
624;20.10.2017;2017;10;23;Perjantai;3;3;6
624;21.10.2017;2017;10;00;Lauantai;3;5;8
624;21.10.2017;2017;10;01;Lauantai;3;3;6
624;21.10.2017;2017;10;02;Lauantai;3;2;5
624;21.10.2017;2017;10;03;Lauantai;2;3;5
624;21.10.2017;2017;10;04;Lauantai;0;1;1
624;21.10.2017;2017;10;05;Lauantai;3;2;5
624;21.10.2017;2017;10;06;Lauantai;1;1;2
624;21.10.2017;2017;10;07;Lauantai;1;4;5
624;21.10.2017;2017;10;08;Lauantai;1;2;3
624;21.10.2017;2017;10;09;Lauantai;3;4;7
624;21.10.2017;2017;10;10;Lauantai;1;8;9
624;21.10.2017;2017;10;11;Lauantai;1;10;11
624;21.10.2017;2017;10;12;Lauantai;6;8;14
624;21.10.2017;2017;10;13;Lauantai;1;17;18
624;21.10.2017;2017;10;14;Lauantai;10;25;35
624;21.10.2017;2017;10;15;Lauantai;6;18;24
624;21.10.2017;2017;10;16;Lauantai;6;13;19
624;21.10.2017;2017;10;17;Lauantai;8;12;20
624;21.10.2017;2017;10;18;Lauantai;8;10;18
624;21.10.2017;2017;10;19;Lauantai;8;11;19
624;21.10.2017;2017;10;20;Lauantai;3;11;14
624;21.10.2017;2017;10;21;Lauantai;2;6;8
624;21.10.2017;2017;10;22;Lauantai;4;6;10
624;21.10.2017;2017;10;23;Lauantai;5;6;11
624;22.10.2017;2017;10;00;Sunnuntai;0;3;3
624;22.10.2017;2017;10;01;Sunnuntai;3;5;8
624;22.10.2017;2017;10;02;Sunnuntai;1;2;3
624;22.10.2017;2017;10;03;Sunnuntai;4;2;6
624;22.10.2017;2017;10;04;Sunnuntai;1;1;2
624;22.10.2017;2017;10;05;Sunnuntai;0;0;0
624;22.10.2017;2017;10;06;Sunnuntai;0;0;0
624;22.10.2017;2017;10;07;Sunnuntai;0;2;2
624;22.10.2017;2017;10;08;Sunnuntai;0;4;4
624;22.10.2017;2017;10;09;Sunnuntai;0;4;4
624;22.10.2017;2017;10;10;Sunnuntai;1;2;3
624;22.10.2017;2017;10;11;Sunnuntai;2;4;6
624;22.10.2017;2017;10;12;Sunnuntai;5;24;29
624;22.10.2017;2017;10;13;Sunnuntai;4;12;16
624;22.10.2017;2017;10;14;Sunnuntai;8;27;35
624;22.10.2017;2017;10;15;Sunnuntai;7;8;15
624;22.10.2017;2017;10;16;Sunnuntai;9;7;16
624;22.10.2017;2017;10;17;Sunnuntai;6;5;11
624;22.10.2017;2017;10;18;Sunnuntai;3;9;12
624;22.10.2017;2017;10;19;Sunnuntai;5;18;23
624;22.10.2017;2017;10;20;Sunnuntai;3;6;9
624;22.10.2017;2017;10;21;Sunnuntai;4;9;13
624;22.10.2017;2017;10;22;Sunnuntai;2;1;3
624;22.10.2017;2017;10;23;Sunnuntai;1;2;3
624;23.10.2017;2017;10;00;Maanantai;1;1;2
624;23.10.2017;2017;10;01;Maanantai;1;2;3
624;23.10.2017;2017;10;02;Maanantai;0;1;1
624;23.10.2017;2017;10;03;Maanantai;0;0;0
624;23.10.2017;2017;10;04;Maanantai;0;0;0
624;23.10.2017;2017;10;05;Maanantai;1;1;2
624;23.10.2017;2017;10;06;Maanantai;0;7;7
624;23.10.2017;2017;10;07;Maanantai;4;17;21
624;23.10.2017;2017;10;08;Maanantai;6;39;45
624;23.10.2017;2017;10;09;Maanantai;3;43;46
624;23.10.2017;2017;10;10;Maanantai;1;11;12
624;23.10.2017;2017;10;11;Maanantai;5;20;25
624;23.10.2017;2017;10;12;Maanantai;9;21;30
624;23.10.2017;2017;10;13;Maanantai;3;11;14
624;23.10.2017;2017;10;14;Maanantai;11;22;33
624;23.10.2017;2017;10;15;Maanantai;5;20;25
624;23.10.2017;2017;10;16;Maanantai;14;25;39
624;23.10.2017;2017;10;17;Maanantai;13;19;32
624;23.10.2017;2017;10;18;Maanantai;9;17;26
624;23.10.2017;2017;10;19;Maanantai;8;9;17
624;23.10.2017;2017;10;20;Maanantai;2;7;9
624;23.10.2017;2017;10;21;Maanantai;3;6;9
624;23.10.2017;2017;10;22;Maanantai;3;5;8
624;23.10.2017;2017;10;23;Maanantai;1;1;2
624;24.10.2017;2017;10;00;Tiistai;0;2;2
624;24.10.2017;2017;10;01;Tiistai;0;1;1
624;24.10.2017;2017;10;02;Tiistai;1;0;1
624;24.10.2017;2017;10;03;Tiistai;0;0;0
624;24.10.2017;2017;10;04;Tiistai;1;0;1
624;24.10.2017;2017;10;05;Tiistai;1;1;2
624;24.10.2017;2017;10;06;Tiistai;0;7;7
624;24.10.2017;2017;10;07;Tiistai;1;24;25
624;24.10.2017;2017;10;08;Tiistai;6;36;42
624;24.10.2017;2017;10;09;Tiistai;3;36;39
624;24.10.2017;2017;10;10;Tiistai;2;15;17
624;24.10.2017;2017;10;11;Tiistai;4;7;11
624;24.10.2017;2017;10;12;Tiistai;1;7;8
624;24.10.2017;2017;10;13;Tiistai;4;14;18
624;24.10.2017;2017;10;14;Tiistai;4;16;20
624;24.10.2017;2017;10;15;Tiistai;3;16;19
624;24.10.2017;2017;10;16;Tiistai;12;22;34
624;24.10.2017;2017;10;17;Tiistai;11;24;35
624;24.10.2017;2017;10;18;Tiistai;2;17;19
624;24.10.2017;2017;10;19;Tiistai;5;7;12
624;24.10.2017;2017;10;20;Tiistai;4;11;15
624;24.10.2017;2017;10;21;Tiistai;4;5;9
624;24.10.2017;2017;10;22;Tiistai;1;3;4
624;24.10.2017;2017;10;23;Tiistai;1;3;4
624;25.10.2017;2017;10;00;Keskiviikko;0;0;0
624;25.10.2017;2017;10;01;Keskiviikko;0;0;0
624;25.10.2017;2017;10;02;Keskiviikko;0;1;1
624;25.10.2017;2017;10;03;Keskiviikko;1;2;3
624;25.10.2017;2017;10;04;Keskiviikko;0;0;0
624;25.10.2017;2017;10;05;Keskiviikko;1;1;2
624;25.10.2017;2017;10;06;Keskiviikko;2;6;8
624;25.10.2017;2017;10;07;Keskiviikko;3;24;27
624;25.10.2017;2017;10;08;Keskiviikko;5;37;42
624;25.10.2017;2017;10;09;Keskiviikko;5;33;38
624;25.10.2017;2017;10;10;Keskiviikko;4;22;26
624;25.10.2017;2017;10;11;Keskiviikko;2;12;14
624;25.10.2017;2017;10;12;Keskiviikko;3;23;26
624;25.10.2017;2017;10;13;Keskiviikko;8;17;25
624;25.10.2017;2017;10;14;Keskiviikko;10;19;29
624;25.10.2017;2017;10;15;Keskiviikko;11;20;31
624;25.10.2017;2017;10;16;Keskiviikko;15;22;37
624;25.10.2017;2017;10;17;Keskiviikko;6;22;28
624;25.10.2017;2017;10;18;Keskiviikko;3;15;18
624;25.10.2017;2017;10;19;Keskiviikko;4;8;12
624;25.10.2017;2017;10;20;Keskiviikko;4;12;16
624;25.10.2017;2017;10;21;Keskiviikko;5;12;17
624;25.10.2017;2017;10;22;Keskiviikko;2;8;10
624;25.10.2017;2017;10;23;Keskiviikko;4;4;8
624;26.10.2017;2017;10;00;Torstai;0;3;3
624;26.10.2017;2017;10;01;Torstai;0;2;2
624;26.10.2017;2017;10;02;Torstai;0;0;0
624;26.10.2017;2017;10;03;Torstai;0;1;1
624;26.10.2017;2017;10;04;Torstai;0;1;1
624;26.10.2017;2017;10;05;Torstai;1;0;1
624;26.10.2017;2017;10;06;Torstai;0;4;4
624;26.10.2017;2017;10;07;Torstai;2;18;20
624;26.10.2017;2017;10;08;Torstai;5;28;33
624;26.10.2017;2017;10;09;Torstai;4;29;33
624;26.10.2017;2017;10;10;Torstai;2;8;10
624;26.10.2017;2017;10;11;Torstai;4;13;17
624;26.10.2017;2017;10;12;Torstai;3;10;13
624;26.10.2017;2017;10;13;Torstai;3;13;16
624;26.10.2017;2017;10;14;Torstai;11;22;33
624;26.10.2017;2017;10;15;Torstai;5;20;25
624;26.10.2017;2017;10;16;Torstai;14;25;39
624;26.10.2017;2017;10;17;Torstai;13;19;32
624;26.10.2017;2017;10;18;Torstai;9;17;26
624;26.10.2017;2017;10;19;Torstai;8;9;17
624;26.10.2017;2017;10;20;Torstai;2;7;9
624;26.10.2017;2017;10;21;Torstai;3;6;9
624;26.10.2017;2017;10;22;Torstai;3;5;8
624;26.10.2017;2017;10;23;Torstai;1;1;2
624;27.10.2017;2017;10;00;Perjantai;1;2;3
624;27.10.2017;2017;10;01;Perjantai;0;3;3
624;27.10.2017;2017;10;02;Perjantai;1;1;2
624;27.10.2017;2017;10;03;Perjantai;0;1;1
624;27.10.2017;2017;10;04;Perjantai;1;2;3
624;27.10.2017;2017;10;05;Perjantai;0;0;0
624;27.10.2017;2017;10;06;Perjantai;0;9;9
624;27.10.2017;2017;10;07;Perjantai;3;23;26
624;27.10.2017;2017;10;08;Perjantai;13;65;78
624;27.10.2017;2017;10;09;Perjantai;6;47;53
624;27.10.2017;2017;10;10;Perjantai;7;22;29
624;27.10.2017;2017;10;11;Perjantai;5;13;18
624;27.10.2017;2017;10;12;Perjantai;7;19;26
624;27.10.2017;2017;10;13;Perjantai;4;26;30
624;27.10.2017;2017;10;14;Perjantai;6;12;18
624;27.10.2017;2017;10;15;Perjantai;14;21;35
624;27.10.2017;2017;10;16;Perjantai;13;29;42
624;27.10.2017;2017;10;17;Perjantai;7;23;30
624;27.10.2017;2017;10;18;Perjantai;6;17;23
624;27.10.2017;2017;10;19;Perjantai;6;17;23
624;27.10.2017;2017;10;20;Perjantai;2;11;13
624;27.10.2017;2017;10;21;Perjantai;4;12;16
624;27.10.2017;2017;10;22;Perjantai;6;9;15
624;27.10.2017;2017;10;23;Perjantai;5;8;13
624;28.10.2017;2017;10;00;Lauantai;5;7;12
624;28.10.2017;2017;10;01;Lauantai;5;3;8
624;28.10.2017;2017;10;02;Lauantai;3;3;6
624;28.10.2017;2017;10;03;Lauantai;0;1;1
624;28.10.2017;2017;10;04;Lauantai;1;3;4
624;28.10.2017;2017;10;05;Lauantai;1;0;1
624;28.10.2017;2017;10;06;Lauantai;0;0;0
624;28.10.2017;2017;10;07;Lauantai;0;6;6
624;28.10.2017;2017;10;08;Lauantai;1;4;5
624;28.10.2017;2017;10;09;Lauantai;1;4;5
624;28.10.2017;2017;10;10;Lauantai;2;9;11
624;28.10.2017;2017;10;11;Lauantai;0;8;8
624;28.10.2017;2017;10;12;Lauantai;7;11;18
624;28.10.2017;2017;10;13;Lauantai;3;8;11
624;28.10.2017;2017;10;14;Lauantai;4;16;20
624;28.10.2017;2017;10;15;Lauantai;3;10;13
624;28.10.2017;2017;10;16;Lauantai;2;11;13
624;28.10.2017;2017;10;17;Lauantai;2;11;13
624;28.10.2017;2017;10;18;Lauantai;1;6;7
624;28.10.2017;2017;10;19;Lauantai;4;9;13
624;28.10.2017;2017;10;20;Lauantai;2;5;7
624;28.10.2017;2017;10;21;Lauantai;2;6;8
624;28.10.2017;2017;10;22;Lauantai;3;5;8
624;28.10.2017;2017;10;23;Lauantai;9;4;13
624;29.10.2017;2017;10;00;Sunnuntai;2;2;4
624;29.10.2017;2017;10;01;Sunnuntai;3;0;3
624;29.10.2017;2017;10;02;Sunnuntai;1;3;4
624;29.10.2017;2017;10;03;Sunnuntai;0;0;0
624;29.10.2017;2017;10;04;Sunnuntai;2;1;3
624;29.10.2017;2017;10;05;Sunnuntai;0;2;2
624;29.10.2017;2017;10;06;Sunnuntai;0;0;0
624;29.10.2017;2017;10;07;Sunnuntai;0;5;5
624;29.10.2017;2017;10;08;Sunnuntai;1;2;3
624;29.10.2017;2017;10;09;Sunnuntai;2;3;5
624;29.10.2017;2017;10;10;Sunnuntai;0;0;0
624;29.10.2017;2017;10;11;Sunnuntai;3;3;6
624;29.10.2017;2017;10;12;Sunnuntai;4;10;14
624;29.10.2017;2017;10;13;Sunnuntai;5;9;14
624;29.10.2017;2017;10;14;Sunnuntai;6;10;16
624;29.10.2017;2017;10;15;Sunnuntai;11;4;15
624;29.10.2017;2017;10;16;Sunnuntai;8;10;18
624;29.10.2017;2017;10;17;Sunnuntai;5;7;12
624;29.10.2017;2017;10;18;Sunnuntai;7;6;13
624;29.10.2017;2017;10;19;Sunnuntai;5;8;13
624;29.10.2017;2017;10;20;Sunnuntai;8;9;17
624;29.10.2017;2017;10;21;Sunnuntai;6;3;9
624;29.10.2017;2017;10;22;Sunnuntai;12;4;16
624;29.10.2017;2017;10;23;Sunnuntai;1;0;1
624;30.10.2017;2017;10;00;Maanantai;1;0;1
624;30.10.2017;2017;10;01;Maanantai;5;0;5
624;30.10.2017;2017;10;02;Maanantai;0;0;0
624;30.10.2017;2017;10;03;Maanantai;1;2;3
624;30.10.2017;2017;10;04;Maanantai;0;0;0
624;30.10.2017;2017;10;05;Maanantai;0;1;1
624;30.10.2017;2017;10;06;Maanantai;3;14;17
624;30.10.2017;2017;10;07;Maanantai;10;15;25
624;30.10.2017;2017;10;08;Maanantai;16;53;69
624;30.10.2017;2017;10;09;Maanantai;6;57;63
624;30.10.2017;2017;10;10;Maanantai;3;4;7
624;30.10.2017;2017;10;11;Maanantai;2;3;5
624;30.10.2017;2017;10;12;Maanantai;9;12;21
624;30.10.2017;2017;10;13;Maanantai;19;16;35
624;30.10.2017;2017;10;14;Maanantai;0;0;0
624;30.10.2017;2017;10;15;Maanantai;19;18;37
624;30.10.2017;2017;10;16;Maanantai;27;18;45
624;30.10.2017;2017;10;17;Maanantai;51;32;83
624;30.10.2017;2017;10;18;Maanantai;27;24;51
624;30.10.2017;2017;10;19;Maanantai;18;19;37
624;30.10.2017;2017;10;20;Maanantai;18;16;34
624;30.10.2017;2017;10;21;Maanantai;15;11;26
624;30.10.2017;2017;10;22;Maanantai;11;3;14
624;30.10.2017;2017;10;23;Maanantai;4;4;8
624;31.10.2017;2017;10;00;Tiistai;3;0;3
624;31.10.2017;2017;10;01;Tiistai;0;1;1
624;31.10.2017;2017;10;02;Tiistai;1;0;1
624;31.10.2017;2017;10;03;Tiistai;2;1;3
624;31.10.2017;2017;10;04;Tiistai;2;0;2
624;31.10.2017;2017;10;05;Tiistai;1;0;1
624;31.10.2017;2017;10;06;Tiistai;4;11;15
624;31.10.2017;2017;10;07;Tiistai;4;21;25
624;31.10.2017;2017;10;08;Tiistai;14;57;71
624;31.10.2017;2017;10;09;Tiistai;13;55;68
624;31.10.2017;2017;10;10;Tiistai;14;19;33
624;31.10.2017;2017;10;11;Tiistai;16;12;28
624;31.10.2017;2017;10;12;Tiistai;10;17;27
624;31.10.2017;2017;10;13;Tiistai;10;15;25
624;31.10.2017;2017;10;14;Tiistai;13;14;27
624;31.10.2017;2017;10;15;Tiistai;19;26;45
624;31.10.2017;2017;10;16;Tiistai;40;24;64
624;31.10.2017;2017;10;17;Tiistai;65;34;99
624;31.10.2017;2017;10;18;Tiistai;25;32;57
624;31.10.2017;2017;10;19;Tiistai;16;12;28
624;31.10.2017;2017;10;20;Tiistai;19;13;32
624;31.10.2017;2017;10;21;Tiistai;9;9;18
624;31.10.2017;2017;10;22;Tiistai;11;6;17
624;31.10.2017;2017;10;23;Tiistai;7;3;10
624;01.11.2017;2017;11;00;Keskiviikko;2;2;4
624;01.11.2017;2017;11;01;Keskiviikko;1;1;2
624;01.11.2017;2017;11;02;Keskiviikko;2;1;3
624;01.11.2017;2017;11;03;Keskiviikko;1;0;1
624;01.11.2017;2017;11;04;Keskiviikko;2;2;4
624;01.11.2017;2017;11;05;Keskiviikko;1;1;2
624;01.11.2017;2017;11;06;Keskiviikko;3;8;11
624;01.11.2017;2017;11;07;Keskiviikko;9;21;30
624;01.11.2017;2017;11;08;Keskiviikko;17;52;69
624;01.11.2017;2017;11;09;Keskiviikko;9;48;57
624;01.11.2017;2017;11;10;Keskiviikko;7;22;29
624;01.11.2017;2017;11;11;Keskiviikko;5;22;27
624;01.11.2017;2017;11;12;Keskiviikko;15;12;27
624;01.11.2017;2017;11;13;Keskiviikko;7;13;20
624;01.11.2017;2017;11;14;Keskiviikko;17;12;29
624;01.11.2017;2017;11;15;Keskiviikko;6;17;23
624;01.11.2017;2017;11;16;Keskiviikko;41;23;64
624;01.11.2017;2017;11;17;Keskiviikko;36;29;65
624;01.11.2017;2017;11;18;Keskiviikko;29;16;45
624;01.11.2017;2017;11;19;Keskiviikko;19;20;39
624;01.11.2017;2017;11;20;Keskiviikko;9;10;19
624;01.11.2017;2017;11;21;Keskiviikko;10;18;28
624;01.11.2017;2017;11;22;Keskiviikko;4;7;11
624;01.11.2017;2017;11;23;Keskiviikko;5;3;8
624;02.11.2017;2017;11;00;Torstai;2;0;2
624;02.11.2017;2017;11;01;Torstai;0;1;1
624;02.11.2017;2017;11;02;Torstai;3;0;3
624;02.11.2017;2017;11;03;Torstai;0;2;2
624;02.11.2017;2017;11;04;Torstai;0;0;0
624;02.11.2017;2017;11;05;Torstai;1;1;2
624;02.11.2017;2017;11;06;Torstai;4;8;12
624;02.11.2017;2017;11;07;Torstai;7;25;32
624;02.11.2017;2017;11;08;Torstai;4;57;61
624;02.11.2017;2017;11;09;Torstai;13;54;67
624;02.11.2017;2017;11;10;Torstai;5;17;22
624;02.11.2017;2017;11;11;Torstai;7;18;25
624;02.11.2017;2017;11;12;Torstai;9;9;18
624;02.11.2017;2017;11;13;Torstai;6;20;26
624;02.11.2017;2017;11;14;Torstai;16;13;29
624;02.11.2017;2017;11;15;Torstai;18;15;33
624;02.11.2017;2017;11;16;Torstai;33;17;50
624;02.11.2017;2017;11;17;Torstai;41;30;71
624;02.11.2017;2017;11;18;Torstai;30;21;51
624;02.11.2017;2017;11;19;Torstai;22;16;38
624;02.11.2017;2017;11;20;Torstai;16;8;24
624;02.11.2017;2017;11;21;Torstai;10;9;19
624;02.11.2017;2017;11;22;Torstai;9;2;11
624;02.11.2017;2017;11;23;Torstai;9;4;13
624;03.11.2017;2017;11;00;Perjantai;4;3;7
624;03.11.2017;2017;11;01;Perjantai;3;1;4
624;03.11.2017;2017;11;02;Perjantai;1;0;1
624;03.11.2017;2017;11;03;Perjantai;0;2;2
624;03.11.2017;2017;11;04;Perjantai;2;0;2
624;03.11.2017;2017;11;05;Perjantai;0;1;1
624;03.11.2017;2017;11;06;Perjantai;6;11;17
624;03.11.2017;2017;11;07;Perjantai;7;32;39
624;03.11.2017;2017;11;08;Perjantai;9;51;60
624;03.11.2017;2017;11;09;Perjantai;17;42;59
624;03.11.2017;2017;11;10;Perjantai;16;24;40
624;03.11.2017;2017;11;11;Perjantai;5;16;21
624;03.11.2017;2017;11;12;Perjantai;2;2;4
624;03.11.2017;2017;11;13;Perjantai;0;0;0
624;03.11.2017;2017;11;14;Perjantai;0;0;0
624;03.11.2017;2017;11;15;Perjantai;26;10;36
624;03.11.2017;2017;11;16;Perjantai;48;26;74
624;03.11.2017;2017;11;17;Perjantai;36;28;64
624;03.11.2017;2017;11;18;Perjantai;17;15;32
624;03.11.2017;2017;11;19;Perjantai;12;23;35
624;03.11.2017;2017;11;20;Perjantai;10;11;21
624;03.11.2017;2017;11;21;Perjantai;9;17;26
624;03.11.2017;2017;11;22;Perjantai;14;7;21
624;03.11.2017;2017;11;23;Perjantai;9;3;12
624;04.11.2017;2017;11;00;Lauantai;1;2;3
624;04.11.2017;2017;11;01;Lauantai;1;2;3
624;04.11.2017;2017;11;02;Lauantai;3;1;4
624;04.11.2017;2017;11;03;Lauantai;2;1;3
624;04.11.2017;2017;11;04;Lauantai;3;2;5
624;04.11.2017;2017;11;05;Lauantai;3;3;6
624;04.11.2017;2017;11;06;Lauantai;0;3;3
624;04.11.2017;2017;11;07;Lauantai;1;4;5
624;04.11.2017;2017;11;08;Lauantai;3;4;7
624;04.11.2017;2017;11;09;Lauantai;2;5;7
624;04.11.2017;2017;11;10;Lauantai;5;12;17
624;04.11.2017;2017;11;11;Lauantai;5;10;15
624;04.11.2017;2017;11;12;Lauantai;8;15;23
624;04.11.2017;2017;11;13;Lauantai;16;19;35
624;04.11.2017;2017;11;14;Lauantai;12;14;26
624;04.11.2017;2017;11;15;Lauantai;12;23;35
624;04.11.2017;2017;11;16;Lauantai;24;15;39
624;04.11.2017;2017;11;17;Lauantai;16;22;38
624;04.11.2017;2017;11;18;Lauantai;11;17;28
624;04.11.2017;2017;11;19;Lauantai;13;19;32
624;04.11.2017;2017;11;20;Lauantai;27;16;43
624;04.11.2017;2017;11;21;Lauantai;9;11;20
624;04.11.2017;2017;11;22;Lauantai;12;5;17
624;04.11.2017;2017;11;23;Lauantai;5;8;13
624;05.11.2017;2017;11;00;Sunnuntai;4;3;7
624;05.11.2017;2017;11;01;Sunnuntai;7;5;12
624;05.11.2017;2017;11;02;Sunnuntai;3;1;4
624;05.11.2017;2017;11;03;Sunnuntai;4;2;6
624;05.11.2017;2017;11;04;Sunnuntai;4;1;5
624;05.11.2017;2017;11;05;Sunnuntai;2;3;5
624;05.11.2017;2017;11;06;Sunnuntai;0;1;1
624;05.11.2017;2017;11;07;Sunnuntai;1;4;5
624;05.11.2017;2017;11;08;Sunnuntai;2;1;3
624;05.11.2017;2017;11;09;Sunnuntai;1;2;3
624;05.11.2017;2017;11;10;Sunnuntai;0;6;6
624;05.11.2017;2017;11;11;Sunnuntai;1;8;9
624;05.11.2017;2017;11;12;Sunnuntai;3;15;18
624;05.11.2017;2017;11;13;Sunnuntai;2;10;12
624;05.11.2017;2017;11;14;Sunnuntai;5;13;18
624;05.11.2017;2017;11;15;Sunnuntai;5;3;8
624;05.11.2017;2017;11;16;Sunnuntai;8;5;13
624;05.11.2017;2017;11;17;Sunnuntai;2;13;15
624;05.11.2017;2017;11;18;Sunnuntai;2;7;9
624;05.11.2017;2017;11;19;Sunnuntai;3;3;6
624;05.11.2017;2017;11;20;Sunnuntai;6;4;10
624;05.11.2017;2017;11;21;Sunnuntai;1;2;3
624;05.11.2017;2017;11;22;Sunnuntai;4;6;10
624;05.11.2017;2017;11;23;Sunnuntai;1;2;3
624;06.11.2017;2017;11;00;Maanantai;4;2;6
624;06.11.2017;2017;11;01;Maanantai;0;3;3
624;06.11.2017;2017;11;02;Maanantai;1;1;2
624;06.11.2017;2017;11;03;Maanantai;1;0;1
624;06.11.2017;2017;11;04;Maanantai;0;0;0
624;06.11.2017;2017;11;05;Maanantai;0;0;0
624;06.11.2017;2017;11;06;Maanantai;0;9;9
624;06.11.2017;2017;11;07;Maanantai;4;24;28
624;06.11.2017;2017;11;08;Maanantai;5;47;52
624;06.11.2017;2017;11;09;Maanantai;5;47;52
624;06.11.2017;2017;11;10;Maanantai;5;16;21
624;06.11.2017;2017;11;11;Maanantai;1;16;17
624;06.11.2017;2017;11;12;Maanantai;6;22;28
624;06.11.2017;2017;11;13;Maanantai;3;20;23
624;06.11.2017;2017;11;14;Maanantai;5;19;24
624;06.11.2017;2017;11;15;Maanantai;7;20;27
624;06.11.2017;2017;11;16;Maanantai;5;17;22
624;06.11.2017;2017;11;17;Maanantai;17;30;47
624;06.11.2017;2017;11;18;Maanantai;9;23;32
624;06.11.2017;2017;11;19;Maanantai;7;10;17
624;06.11.2017;2017;11;20;Maanantai;3;13;16
624;06.11.2017;2017;11;21;Maanantai;9;9;18
624;06.11.2017;2017;11;22;Maanantai;4;4;8
624;06.11.2017;2017;11;23;Maanantai;4;4;8
624;07.11.2017;2017;11;00;Tiistai;1;3;4
624;07.11.2017;2017;11;01;Tiistai;0;2;2
624;07.11.2017;2017;11;02;Tiistai;0;0;0
624;07.11.2017;2017;11;03;Tiistai;0;0;0
624;07.11.2017;2017;11;04;Tiistai;0;1;1
624;07.11.2017;2017;11;05;Tiistai;1;0;1
624;07.11.2017;2017;11;06;Tiistai;0;10;10
624;07.11.2017;2017;11;07;Tiistai;2;20;22
624;07.11.2017;2017;11;08;Tiistai;9;47;56
624;07.11.2017;2017;11;09;Tiistai;11;45;56
624;07.11.2017;2017;11;10;Tiistai;3;18;21
624;07.11.2017;2017;11;11;Tiistai;12;23;35
624;07.11.2017;2017;11;12;Tiistai;9;26;35
624;07.11.2017;2017;11;13;Tiistai;6;17;23
624;07.11.2017;2017;11;14;Tiistai;3;24;27
624;07.11.2017;2017;11;15;Tiistai;9;20;29
624;07.11.2017;2017;11;16;Tiistai;30;22;52
624;07.11.2017;2017;11;17;Tiistai;35;39;74
624;07.11.2017;2017;11;18;Tiistai;31;29;60
624;07.11.2017;2017;11;19;Tiistai;16;21;37
624;07.11.2017;2017;11;20;Tiistai;7;14;21
624;07.11.2017;2017;11;21;Tiistai;10;17;27
624;07.11.2017;2017;11;22;Tiistai;13;10;23
624;07.11.2017;2017;11;23;Tiistai;1;6;7
624;08.11.2017;2017;11;00;Keskiviikko;2;2;4
624;08.11.2017;2017;11;01;Keskiviikko;0;0;0
624;08.11.2017;2017;11;02;Keskiviikko;0;0;0
624;08.11.2017;2017;11;03;Keskiviikko;0;1;1
624;08.11.2017;2017;11;04;Keskiviikko;1;1;2
624;08.11.2017;2017;11;05;Keskiviikko;2;1;3
624;08.11.2017;2017;11;06;Keskiviikko;0;9;9
624;08.11.2017;2017;11;07;Keskiviikko;3;25;28
624;08.11.2017;2017;11;08;Keskiviikko;12;46;58
624;08.11.2017;2017;11;09;Keskiviikko;10;49;59
624;08.11.2017;2017;11;10;Keskiviikko;5;25;30
624;08.11.2017;2017;11;11;Keskiviikko;5;20;25
624;08.11.2017;2017;11;12;Keskiviikko;6;17;23
624;08.11.2017;2017;11;13;Keskiviikko;4;26;30
624;08.11.2017;2017;11;14;Keskiviikko;4;13;17
624;08.11.2017;2017;11;15;Keskiviikko;3;28;31
624;08.11.2017;2017;11;16;Keskiviikko;7;27;34
624;08.11.2017;2017;11;17;Keskiviikko;20;46;66
624;08.11.2017;2017;11;18;Keskiviikko;11;23;34
624;08.11.2017;2017;11;19;Keskiviikko;2;15;17
624;08.11.2017;2017;11;20;Keskiviikko;11;15;26
624;08.11.2017;2017;11;21;Keskiviikko;7;9;16
624;08.11.2017;2017;11;22;Keskiviikko;5;8;13
624;08.11.2017;2017;11;23;Keskiviikko;1;6;7
624;09.11.2017;2017;11;00;Torstai;2;4;6
624;09.11.2017;2017;11;01;Torstai;0;0;0
624;09.11.2017;2017;11;02;Torstai;0;0;0
624;09.11.2017;2017;11;03;Torstai;0;2;2
624;09.11.2017;2017;11;04;Torstai;0;1;1
624;09.11.2017;2017;11;05;Torstai;0;1;1
624;09.11.2017;2017;11;06;Torstai;0;10;10
624;09.11.2017;2017;11;07;Torstai;2;28;30
624;09.11.2017;2017;11;08;Torstai;3;55;58
624;09.11.2017;2017;11;09;Torstai;5;55;60
624;09.11.2017;2017;11;10;Torstai;4;21;25
624;09.11.2017;2017;11;11;Torstai;2;29;31
624;09.11.2017;2017;11;12;Torstai;4;14;18
624;09.11.2017;2017;11;13;Torstai;7;20;27
624;09.11.2017;2017;11;14;Torstai;5;14;19
624;09.11.2017;2017;11;15;Torstai;3;21;24
624;09.11.2017;2017;11;16;Torstai;6;13;19
624;09.11.2017;2017;11;17;Torstai;9;33;42
624;09.11.2017;2017;11;18;Torstai;5;24;29
624;09.11.2017;2017;11;19;Torstai;2;12;14
624;09.11.2017;2017;11;20;Torstai;4;16;20
624;09.11.2017;2017;11;21;Torstai;9;4;13
624;09.11.2017;2017;11;22;Torstai;2;8;10
624;09.11.2017;2017;11;23;Torstai;4;4;8
624;10.11.2017;2017;11;00;Perjantai;1;3;4
624;10.11.2017;2017;11;01;Perjantai;2;4;6
624;10.11.2017;2017;11;02;Perjantai;0;1;1
624;10.11.2017;2017;11;03;Perjantai;0;0;0
624;10.11.2017;2017;11;04;Perjantai;0;2;2
624;10.11.2017;2017;11;05;Perjantai;0;3;3
624;10.11.2017;2017;11;06;Perjantai;0;8;8
624;10.11.2017;2017;11;07;Perjantai;0;26;26
624;10.11.2017;2017;11;08;Perjantai;5;45;50
624;10.11.2017;2017;11;09;Perjantai;6;53;59
624;10.11.2017;2017;11;10;Perjantai;3;25;28
624;10.11.2017;2017;11;11;Perjantai;2;18;20
624;10.11.2017;2017;11;12;Perjantai;2;32;34
624;10.11.2017;2017;11;13;Perjantai;2;19;21
624;10.11.2017;2017;11;14;Perjantai;4;12;16
624;10.11.2017;2017;11;15;Perjantai;8;24;32
624;10.11.2017;2017;11;16;Perjantai;6;16;22
624;10.11.2017;2017;11;17;Perjantai;6;24;30
624;10.11.2017;2017;11;18;Perjantai;7;29;36
624;10.11.2017;2017;11;19;Perjantai;1;14;15
624;10.11.2017;2017;11;20;Perjantai;5;8;13
624;10.11.2017;2017;11;21;Perjantai;1;8;9
624;10.11.2017;2017;11;22;Perjantai;5;5;10
624;10.11.2017;2017;11;23;Perjantai;3;3;6
624;11.11.2017;2017;11;00;Lauantai;2;4;6
624;11.11.2017;2017;11;01;Lauantai;3;1;4
624;11.11.2017;2017;11;02;Lauantai;1;3;4
624;11.11.2017;2017;11;03;Lauantai;1;1;2
624;11.11.2017;2017;11;04;Lauantai;2;2;4
624;11.11.2017;2017;11;05;Lauantai;0;1;1
624;11.11.2017;2017;11;06;Lauantai;1;3;4
624;11.11.2017;2017;11;07;Lauantai;1;8;9
624;11.11.2017;2017;11;08;Lauantai;0;3;3
624;11.11.2017;2017;11;09;Lauantai;2;9;11
624;11.11.2017;2017;11;10;Lauantai;0;8;8
624;11.11.2017;2017;11;11;Lauantai;2;15;17
624;11.11.2017;2017;11;12;Lauantai;3;12;15
624;11.11.2017;2017;11;13;Lauantai;5;17;22
624;11.11.2017;2017;11;14;Lauantai;1;21;22
624;11.11.2017;2017;11;15;Lauantai;2;16;18
624;11.11.2017;2017;11;16;Lauantai;4;11;15
624;11.11.2017;2017;11;17;Lauantai;2;12;14
624;11.11.2017;2017;11;18;Lauantai;2;7;9
624;11.11.2017;2017;11;19;Lauantai;7;12;19
624;11.11.2017;2017;11;20;Lauantai;6;4;10
624;11.11.2017;2017;11;21;Lauantai;4;9;13
624;11.11.2017;2017;11;22;Lauantai;3;6;9
624;11.11.2017;2017;11;23;Lauantai;1;0;1
624;12.11.2017;2017;11;00;Sunnuntai;3;2;5
624;12.11.2017;2017;11;01;Sunnuntai;0;2;2
624;12.11.2017;2017;11;02;Sunnuntai;2;2;4
624;12.11.2017;2017;11;03;Sunnuntai;1;2;3
624;12.11.2017;2017;11;04;Sunnuntai;0;2;2
624;12.11.2017;2017;11;05;Sunnuntai;2;2;4
624;12.11.2017;2017;11;06;Sunnuntai;0;3;3
624;12.11.2017;2017;11;07;Sunnuntai;0;1;1
624;12.11.2017;2017;11;08;Sunnuntai;0;4;4
624;12.11.2017;2017;11;09;Sunnuntai;1;1;2
624;12.11.2017;2017;11;10;Sunnuntai;0;5;5
624;12.11.2017;2017;11;11;Sunnuntai;0;8;8
624;12.11.2017;2017;11;12;Sunnuntai;3;15;18
624;12.11.2017;2017;11;13;Sunnuntai;1;20;21
624;12.11.2017;2017;11;14;Sunnuntai;2;9;11
624;12.11.2017;2017;11;15;Sunnuntai;1;11;12
624;12.11.2017;2017;11;16;Sunnuntai;7;13;20
624;12.11.2017;2017;11;17;Sunnuntai;6;8;14
624;12.11.2017;2017;11;18;Sunnuntai;4;9;13
624;12.11.2017;2017;11;19;Sunnuntai;3;11;14
624;12.11.2017;2017;11;20;Sunnuntai;2;9;11
624;12.11.2017;2017;11;21;Sunnuntai;2;2;4
624;12.11.2017;2017;11;22;Sunnuntai;4;2;6
624;12.11.2017;2017;11;23;Sunnuntai;2;5;7
624;13.11.2017;2017;11;00;Maanantai;2;2;4
624;13.11.2017;2017;11;01;Maanantai;3;1;4
624;13.11.2017;2017;11;02;Maanantai;0;2;2
624;13.11.2017;2017;11;03;Maanantai;0;4;4
624;13.11.2017;2017;11;04;Maanantai;1;1;2
624;13.11.2017;2017;11;05;Maanantai;0;1;1
624;13.11.2017;2017;11;06;Maanantai;0;7;7
624;13.11.2017;2017;11;07;Maanantai;7;21;28
624;13.11.2017;2017;11;08;Maanantai;8;51;59
624;13.11.2017;2017;11;09;Maanantai;17;65;82
624;13.11.2017;2017;11;10;Maanantai;9;23;32
624;13.11.2017;2017;11;11;Maanantai;5;21;26
624;13.11.2017;2017;11;12;Maanantai;6;22;28
624;13.11.2017;2017;11;13;Maanantai;2;22;24
624;13.11.2017;2017;11;14;Maanantai;5;17;22
624;13.11.2017;2017;11;15;Maanantai;10;22;32
624;13.11.2017;2017;11;16;Maanantai;13;23;36
624;13.11.2017;2017;11;17;Maanantai;28;39;67
624;13.11.2017;2017;11;18;Maanantai;12;22;34
624;13.11.2017;2017;11;19;Maanantai;10;24;34
624;13.11.2017;2017;11;20;Maanantai;10;20;30
624;13.11.2017;2017;11;21;Maanantai;4;11;15
624;13.11.2017;2017;11;22;Maanantai;9;8;17
624;13.11.2017;2017;11;23;Maanantai;6;4;10
624;14.11.2017;2017;11;00;Tiistai;1;2;3
624;14.11.2017;2017;11;01;Tiistai;3;2;5
624;14.11.2017;2017;11;02;Tiistai;0;0;0
624;14.11.2017;2017;11;03;Tiistai;0;1;1
624;14.11.2017;2017;11;04;Tiistai;1;0;1
624;14.11.2017;2017;11;05;Tiistai;0;2;2
624;14.11.2017;2017;11;06;Tiistai;5;10;15
624;14.11.2017;2017;11;07;Tiistai;9;21;30
624;14.11.2017;2017;11;08;Tiistai;16;56;72
624;14.11.2017;2017;11;09;Tiistai;22;57;79
624;14.11.2017;2017;11;10;Tiistai;15;28;43
624;14.11.2017;2017;11;11;Tiistai;12;22;34
624;14.11.2017;2017;11;12;Tiistai;9;19;28
624;14.11.2017;2017;11;13;Tiistai;18;13;31
624;14.11.2017;2017;11;14;Tiistai;16;19;35
624;14.11.2017;2017;11;15;Tiistai;16;26;42
624;14.11.2017;2017;11;16;Tiistai;43;25;68
624;14.11.2017;2017;11;17;Tiistai;59;31;90
624;14.11.2017;2017;11;18;Tiistai;31;31;62
624;14.11.2017;2017;11;19;Tiistai;18;31;49
624;14.11.2017;2017;11;20;Tiistai;27;19;46
624;14.11.2017;2017;11;21;Tiistai;16;8;24
624;14.11.2017;2017;11;22;Tiistai;16;7;23
624;14.11.2017;2017;11;23;Tiistai;8;2;10
624;15.11.2017;2017;11;00;Keskiviikko;2;3;5
624;15.11.2017;2017;11;01;Keskiviikko;4;3;7
624;15.11.2017;2017;11;02;Keskiviikko;0;1;1
624;15.11.2017;2017;11;03;Keskiviikko;1;0;1
624;15.11.2017;2017;11;04;Keskiviikko;0;2;2
624;15.11.2017;2017;11;05;Keskiviikko;1;2;3
624;15.11.2017;2017;11;06;Keskiviikko;10;12;22
624;15.11.2017;2017;11;07;Keskiviikko;6;29;35
624;15.11.2017;2017;11;08;Keskiviikko;13;49;62
624;15.11.2017;2017;11;09;Keskiviikko;15;55;70
624;15.11.2017;2017;11;10;Keskiviikko;18;22;40
624;15.11.2017;2017;11;11;Keskiviikko;7;26;33
624;15.11.2017;2017;11;12;Keskiviikko;5;22;27
624;15.11.2017;2017;11;13;Keskiviikko;20;25;45
624;15.11.2017;2017;11;14;Keskiviikko;27;17;44
624;15.11.2017;2017;11;15;Keskiviikko;22;26;48
624;15.11.2017;2017;11;16;Keskiviikko;44;22;66
624;15.11.2017;2017;11;17;Keskiviikko;61;41;102
624;15.11.2017;2017;11;18;Keskiviikko;26;31;57
624;15.11.2017;2017;11;19;Keskiviikko;31;31;62
624;15.11.2017;2017;11;20;Keskiviikko;24;8;32
624;15.11.2017;2017;11;21;Keskiviikko;16;11;27
624;15.11.2017;2017;11;22;Keskiviikko;20;4;24
624;15.11.2017;2017;11;23;Keskiviikko;5;4;9
624;16.11.2017;2017;11;00;Torstai;7;5;12
624;16.11.2017;2017;11;01;Torstai;2;4;6
624;16.11.2017;2017;11;02;Torstai;0;0;0
624;16.11.2017;2017;11;03;Torstai;1;2;3
624;16.11.2017;2017;11;04;Torstai;1;1;2
624;16.11.2017;2017;11;05;Torstai;2;2;4
624;16.11.2017;2017;11;06;Torstai;4;5;9
624;16.11.2017;2017;11;07;Torstai;8;23;31
624;16.11.2017;2017;11;08;Torstai;23;54;77
624;16.11.2017;2017;11;09;Torstai;17;62;79
624;16.11.2017;2017;11;10;Torstai;14;24;38
624;16.11.2017;2017;11;11;Torstai;13;17;30
624;16.11.2017;2017;11;12;Torstai;17;12;29
624;16.11.2017;2017;11;13;Torstai;24;27;51
624;16.11.2017;2017;11;14;Torstai;21;31;52
624;16.11.2017;2017;11;15;Torstai;26;28;54
624;16.11.2017;2017;11;16;Torstai;47;23;70
624;16.11.2017;2017;11;17;Torstai;44;38;82
624;16.11.2017;2017;11;18;Torstai;32;26;58
624;16.11.2017;2017;11;19;Torstai;27;23;50
624;16.11.2017;2017;11;20;Torstai;19;12;31
624;16.11.2017;2017;11;21;Torstai;14;7;21
624;16.11.2017;2017;11;22;Torstai;21;7;28
624;16.11.2017;2017;11;23;Torstai;9;6;15
624;17.11.2017;2017;11;00;Perjantai;5;3;8
624;17.11.2017;2017;11;01;Perjantai;0;2;2
624;17.11.2017;2017;11;02;Perjantai;0;2;2
624;17.11.2017;2017;11;03;Perjantai;1;2;3
624;17.11.2017;2017;11;04;Perjantai;0;0;0
624;17.11.2017;2017;11;05;Perjantai;1;1;2
624;17.11.2017;2017;11;06;Perjantai;2;6;8
624;17.11.2017;2017;11;07;Perjantai;6;21;27
624;17.11.2017;2017;11;08;Perjantai;10;29;39
624;17.11.2017;2017;11;09;Perjantai;10;40;50
624;17.11.2017;2017;11;10;Perjantai;11;16;27
624;17.11.2017;2017;11;11;Perjantai;5;19;24
624;17.11.2017;2017;11;12;Perjantai;8;13;21
624;17.11.2017;2017;11;13;Perjantai;16;17;33
624;17.11.2017;2017;11;14;Perjantai;15;21;36
624;17.11.2017;2017;11;15;Perjantai;16;16;32
624;17.11.2017;2017;11;16;Perjantai;35;21;56
624;17.11.2017;2017;11;17;Perjantai;27;19;46
624;17.11.2017;2017;11;18;Perjantai;7;16;23
624;17.11.2017;2017;11;19;Perjantai;8;14;22
624;17.11.2017;2017;11;20;Perjantai;6;7;13
624;17.11.2017;2017;11;21;Perjantai;9;4;13
624;17.11.2017;2017;11;22;Perjantai;9;5;14
624;17.11.2017;2017;11;23;Perjantai;10;4;14
624;18.11.2017;2017;11;00;Lauantai;1;0;1
624;18.11.2017;2017;11;01;Lauantai;1;2;3
624;18.11.2017;2017;11;02;Lauantai;1;1;2
624;18.11.2017;2017;11;03;Lauantai;0;0;0
624;18.11.2017;2017;11;04;Lauantai;0;2;2
624;18.11.2017;2017;11;05;Lauantai;0;1;1
624;18.11.2017;2017;11;06;Lauantai;2;5;7
624;18.11.2017;2017;11;07;Lauantai;1;3;4
624;18.11.2017;2017;11;08;Lauantai;0;4;4
624;18.11.2017;2017;11;09;Lauantai;0;3;3
624;18.11.2017;2017;11;10;Lauantai;1;5;6
624;18.11.2017;2017;11;11;Lauantai;0;5;5
624;18.11.2017;2017;11;12;Lauantai;5;18;23
624;18.11.2017;2017;11;13;Lauantai;9;23;32
624;18.11.2017;2017;11;14;Lauantai;16;18;34
624;18.11.2017;2017;11;15;Lauantai;10;18;28
624;18.11.2017;2017;11;16;Lauantai;11;7;18
624;18.11.2017;2017;11;17;Lauantai;10;7;17
624;18.11.2017;2017;11;18;Lauantai;11;7;18
624;18.11.2017;2017;11;19;Lauantai;9;10;19
624;18.11.2017;2017;11;20;Lauantai;7;11;18
624;18.11.2017;2017;11;21;Lauantai;3;7;10
624;18.11.2017;2017;11;22;Lauantai;6;9;15
624;18.11.2017;2017;11;23;Lauantai;4;4;8
624;19.11.2017;2017;11;00;Sunnuntai;5;1;6
624;19.11.2017;2017;11;01;Sunnuntai;2;2;4
624;19.11.2017;2017;11;02;Sunnuntai;4;4;8
624;19.11.2017;2017;11;03;Sunnuntai;6;2;8
624;19.11.2017;2017;11;04;Sunnuntai;1;0;1
624;19.11.2017;2017;11;05;Sunnuntai;1;2;3
624;19.11.2017;2017;11;06;Sunnuntai;1;1;2
624;19.11.2017;2017;11;07;Sunnuntai;1;3;4
624;19.11.2017;2017;11;08;Sunnuntai;1;1;2
624;19.11.2017;2017;11;09;Sunnuntai;1;1;2
624;19.11.2017;2017;11;10;Sunnuntai;3;7;10
624;19.11.2017;2017;11;11;Sunnuntai;5;6;11
624;19.11.2017;2017;11;12;Sunnuntai;3;12;15
624;19.11.2017;2017;11;13;Sunnuntai;6;5;11
624;19.11.2017;2017;11;14;Sunnuntai;4;10;14
624;19.11.2017;2017;11;15;Sunnuntai;9;16;25
624;19.11.2017;2017;11;16;Sunnuntai;13;12;25
624;19.11.2017;2017;11;17;Sunnuntai;6;6;12
624;19.11.2017;2017;11;18;Sunnuntai;7;13;20
624;19.11.2017;2017;11;19;Sunnuntai;7;8;15
624;19.11.2017;2017;11;20;Sunnuntai;5;4;9
624;19.11.2017;2017;11;21;Sunnuntai;5;3;8
624;19.11.2017;2017;11;22;Sunnuntai;6;2;8
624;19.11.2017;2017;11;23;Sunnuntai;5;6;11
624;20.11.2017;2017;11;00;Maanantai;0;1;1
624;20.11.2017;2017;11;01;Maanantai;4;0;4
624;20.11.2017;2017;11;02;Maanantai;0;1;1
624;20.11.2017;2017;11;03;Maanantai;0;0;0
624;20.11.2017;2017;11;04;Maanantai;0;0;0
624;20.11.2017;2017;11;05;Maanantai;0;0;0
624;20.11.2017;2017;11;06;Maanantai;5;9;14
624;20.11.2017;2017;11;07;Maanantai;7;16;23
624;20.11.2017;2017;11;08;Maanantai;19;45;64
624;20.11.2017;2017;11;09;Maanantai;15;36;51
624;20.11.2017;2017;11;10;Maanantai;5;29;34
624;20.11.2017;2017;11;11;Maanantai;7;10;17
624;20.11.2017;2017;11;12;Maanantai;9;20;29
624;20.11.2017;2017;11;13;Maanantai;9;18;27
624;20.11.2017;2017;11;14;Maanantai;14;15;29
624;20.11.2017;2017;11;15;Maanantai;10;21;31
624;20.11.2017;2017;11;16;Maanantai;37;23;60
624;20.11.2017;2017;11;17;Maanantai;31;31;62
624;20.11.2017;2017;11;18;Maanantai;22;22;44
624;20.11.2017;2017;11;19;Maanantai;10;18;28
624;20.11.2017;2017;11;20;Maanantai;14;14;28
624;20.11.2017;2017;11;21;Maanantai;10;8;18
624;20.11.2017;2017;11;22;Maanantai;7;4;11
624;20.11.2017;2017;11;23;Maanantai;4;5;9
624;21.11.2017;2017;11;00;Tiistai;0;1;1
624;21.11.2017;2017;11;01;Tiistai;0;1;1
624;21.11.2017;2017;11;02;Tiistai;0;0;0
624;21.11.2017;2017;11;03;Tiistai;0;1;1
624;21.11.2017;2017;11;04;Tiistai;1;0;1
624;21.11.2017;2017;11;05;Tiistai;1;0;1
624;21.11.2017;2017;11;06;Tiistai;3;6;9
624;21.11.2017;2017;11;07;Tiistai;8;25;33
624;21.11.2017;2017;11;08;Tiistai;14;52;66
624;21.11.2017;2017;11;09;Tiistai;11;43;54
624;21.11.2017;2017;11;10;Tiistai;6;19;25
624;21.11.2017;2017;11;11;Tiistai;5;20;25
624;21.11.2017;2017;11;12;Tiistai;4;16;20
624;21.11.2017;2017;11;13;Tiistai;12;15;27
624;21.11.2017;2017;11;14;Tiistai;11;25;36
624;21.11.2017;2017;11;15;Tiistai;14;15;29
624;21.11.2017;2017;11;16;Tiistai;11;12;23
624;21.11.2017;2017;11;17;Tiistai;23;29;52
624;21.11.2017;2017;11;18;Tiistai;12;29;41
624;21.11.2017;2017;11;19;Tiistai;12;13;25
624;21.11.2017;2017;11;20;Tiistai;7;7;14
624;21.11.2017;2017;11;21;Tiistai;6;4;10
624;21.11.2017;2017;11;22;Tiistai;11;6;17
624;21.11.2017;2017;11;23;Tiistai;3;5;8
624;22.11.2017;2017;11;00;Keskiviikko;4;1;5
624;22.11.2017;2017;11;01;Keskiviikko;0;0;0
624;22.11.2017;2017;11;02;Keskiviikko;0;0;0
624;22.11.2017;2017;11;03;Keskiviikko;0;2;2
624;22.11.2017;2017;11;04;Keskiviikko;0;0;0
624;22.11.2017;2017;11;05;Keskiviikko;1;0;1
624;22.11.2017;2017;11;06;Keskiviikko;3;7;10
624;22.11.2017;2017;11;07;Keskiviikko;3;24;27
624;22.11.2017;2017;11;08;Keskiviikko;5;50;55
624;22.11.2017;2017;11;09;Keskiviikko;10;43;53
624;22.11.2017;2017;11;10;Keskiviikko;8;23;31
624;22.11.2017;2017;11;11;Keskiviikko;7;12;19
624;22.11.2017;2017;11;12;Keskiviikko;8;21;29
624;22.11.2017;2017;11;13;Keskiviikko;5;14;19
624;22.11.2017;2017;11;14;Keskiviikko;7;10;17
624;22.11.2017;2017;11;15;Keskiviikko;5;13;18
624;22.11.2017;2017;11;16;Keskiviikko;12;22;34
624;22.11.2017;2017;11;17;Keskiviikko;31;31;62
624;22.11.2017;2017;11;18;Keskiviikko;16;27;43
624;22.11.2017;2017;11;19;Keskiviikko;8;12;20
624;22.11.2017;2017;11;20;Keskiviikko;8;10;18
624;22.11.2017;2017;11;21;Keskiviikko;8;9;17
624;22.11.2017;2017;11;22;Keskiviikko;3;4;7
624;22.11.2017;2017;11;23;Keskiviikko;1;3;4
624;23.11.2017;2017;11;00;Torstai;2;1;3
624;23.11.2017;2017;11;01;Torstai;1;4;5
624;23.11.2017;2017;11;02;Torstai;0;1;1
624;23.11.2017;2017;11;03;Torstai;0;1;1
624;23.11.2017;2017;11;04;Torstai;1;0;1
624;23.11.2017;2017;11;05;Torstai;0;1;1
624;23.11.2017;2017;11;06;Torstai;3;5;8
624;23.11.2017;2017;11;07;Torstai;3;19;22
624;23.11.2017;2017;11;08;Torstai;4;35;39
624;23.11.2017;2017;11;09;Torstai;5;41;46
624;23.11.2017;2017;11;10;Torstai;5;14;19
624;23.11.2017;2017;11;11;Torstai;4;15;19
624;23.11.2017;2017;11;12;Torstai;2;10;12
624;23.11.2017;2017;11;13;Torstai;6;15;21
624;23.11.2017;2017;11;14;Torstai;9;14;23
624;23.11.2017;2017;11;15;Torstai;6;14;20
624;23.11.2017;2017;11;16;Torstai;6;10;16
624;23.11.2017;2017;11;17;Torstai;7;26;33
624;23.11.2017;2017;11;18;Torstai;10;16;26
624;23.11.2017;2017;11;19;Torstai;6;14;20
624;23.11.2017;2017;11;20;Torstai;0;6;6
624;23.11.2017;2017;11;21;Torstai;1;3;4
624;23.11.2017;2017;11;22;Torstai;2;6;8
624;23.11.2017;2017;11;23;Torstai;2;2;4
624;24.11.2017;2017;11;00;Perjantai;1;1;2
624;24.11.2017;2017;11;01;Perjantai;0;0;0
624;24.11.2017;2017;11;02;Perjantai;0;0;0
624;24.11.2017;2017;11;03;Perjantai;0;1;1
624;24.11.2017;2017;11;04;Perjantai;0;0;0
624;24.11.2017;2017;11;05;Perjantai;1;1;2
624;24.11.2017;2017;11;06;Perjantai;2;5;7
624;24.11.2017;2017;11;07;Perjantai;2;14;16
624;24.11.2017;2017;11;08;Perjantai;4;19;23
624;24.11.2017;2017;11;09;Perjantai;5;15;20
624;24.11.2017;2017;11;10;Perjantai;5;18;23
624;24.11.2017;2017;11;11;Perjantai;6;6;12
624;24.11.2017;2017;11;12;Perjantai;4;17;21
624;24.11.2017;2017;11;13;Perjantai;12;15;27
624;24.11.2017;2017;11;14;Perjantai;10;8;18
624;24.11.2017;2017;11;15;Perjantai;20;13;33
624;24.11.2017;2017;11;16;Perjantai;25;17;42
624;24.11.2017;2017;11;17;Perjantai;16;14;30
624;24.11.2017;2017;11;18;Perjantai;10;16;26
624;24.11.2017;2017;11;19;Perjantai;10;13;23
624;24.11.2017;2017;11;20;Perjantai;12;9;21
624;24.11.2017;2017;11;21;Perjantai;5;5;10
624;24.11.2017;2017;11;22;Perjantai;11;6;17
624;24.11.2017;2017;11;23;Perjantai;3;1;4
624;25.11.2017;2017;11;00;Lauantai;3;4;7
624;25.11.2017;2017;11;01;Lauantai;1;2;3
624;25.11.2017;2017;11;02;Lauantai;1;1;2
624;25.11.2017;2017;11;03;Lauantai;3;2;5
624;25.11.2017;2017;11;04;Lauantai;2;1;3
624;25.11.2017;2017;11;05;Lauantai;2;0;2
624;25.11.2017;2017;11;06;Lauantai;0;2;2
624;25.11.2017;2017;11;07;Lauantai;0;2;2
624;25.11.2017;2017;11;08;Lauantai;1;7;8
624;25.11.2017;2017;11;09;Lauantai;3;4;7
624;25.11.2017;2017;11;10;Lauantai;2;6;8
624;25.11.2017;2017;11;11;Lauantai;5;8;13
624;25.11.2017;2017;11;12;Lauantai;2;11;13
624;25.11.2017;2017;11;13;Lauantai;12;8;20
624;25.11.2017;2017;11;14;Lauantai;8;15;23
624;25.11.2017;2017;11;15;Lauantai;8;8;16
624;25.11.2017;2017;11;16;Lauantai;11;7;18
624;25.11.2017;2017;11;17;Lauantai;3;9;12
624;25.11.2017;2017;11;18;Lauantai;12;10;22
624;25.11.2017;2017;11;19;Lauantai;3;7;10
624;25.11.2017;2017;11;20;Lauantai;6;8;14
624;25.11.2017;2017;11;21;Lauantai;1;5;6
624;25.11.2017;2017;11;22;Lauantai;6;3;9
624;25.11.2017;2017;11;23;Lauantai;4;4;8
624;26.11.2017;2017;11;00;Sunnuntai;1;3;4
624;26.11.2017;2017;11;01;Sunnuntai;3;4;7
624;26.11.2017;2017;11;02;Sunnuntai;2;6;8
624;26.11.2017;2017;11;03;Sunnuntai;2;1;3
624;26.11.2017;2017;11;04;Sunnuntai;4;4;8
624;26.11.2017;2017;11;05;Sunnuntai;3;1;4
624;26.11.2017;2017;11;06;Sunnuntai;1;0;1
624;26.11.2017;2017;11;07;Sunnuntai;0;4;4
624;26.11.2017;2017;11;08;Sunnuntai;1;2;3
624;26.11.2017;2017;11;09;Sunnuntai;0;3;3
624;26.11.2017;2017;11;10;Sunnuntai;1;4;5
624;26.11.2017;2017;11;11;Sunnuntai;2;5;7
624;26.11.2017;2017;11;12;Sunnuntai;4;9;13
624;26.11.2017;2017;11;13;Sunnuntai;8;13;21
624;26.11.2017;2017;11;14;Sunnuntai;13;13;26
624;26.11.2017;2017;11;15;Sunnuntai;8;11;19
624;26.11.2017;2017;11;16;Sunnuntai;12;7;19
624;26.11.2017;2017;11;17;Sunnuntai;5;13;18
624;26.11.2017;2017;11;18;Sunnuntai;5;7;12
624;26.11.2017;2017;11;19;Sunnuntai;7;6;13
624;26.11.2017;2017;11;20;Sunnuntai;8;12;20
624;26.11.2017;2017;11;21;Sunnuntai;5;5;10
624;26.11.2017;2017;11;22;Sunnuntai;3;3;6
624;26.11.2017;2017;11;23;Sunnuntai;1;1;2
624;27.11.2017;2017;11;00;Maanantai;1;2;3
624;27.11.2017;2017;11;01;Maanantai;1;1;2
624;27.11.2017;2017;11;02;Maanantai;2;1;3
624;27.11.2017;2017;11;03;Maanantai;1;1;2
624;27.11.2017;2017;11;04;Maanantai;0;0;0
624;27.11.2017;2017;11;05;Maanantai;0;1;1
624;27.11.2017;2017;11;06;Maanantai;2;5;7
624;27.11.2017;2017;11;07;Maanantai;5;21;26
624;27.11.2017;2017;11;08;Maanantai;8;45;53
624;27.11.2017;2017;11;09;Maanantai;13;47;60
624;27.11.2017;2017;11;10;Maanantai;8;17;25
624;27.11.2017;2017;11;11;Maanantai;5;10;15
624;27.11.2017;2017;11;12;Maanantai;12;10;22
624;27.11.2017;2017;11;13;Maanantai;6;17;23
624;27.11.2017;2017;11;14;Maanantai;12;21;33
624;27.11.2017;2017;11;15;Maanantai;17;16;33
624;27.11.2017;2017;11;16;Maanantai;21;15;36
624;27.11.2017;2017;11;17;Maanantai;40;28;68
624;27.11.2017;2017;11;18;Maanantai;20;11;31
624;27.11.2017;2017;11;19;Maanantai;10;8;18
624;27.11.2017;2017;11;20;Maanantai;8;9;17
624;27.11.2017;2017;11;21;Maanantai;5;8;13
624;27.11.2017;2017;11;22;Maanantai;9;6;15
624;27.11.2017;2017;11;23;Maanantai;3;2;5
624;28.11.2017;2017;11;00;Tiistai;1;3;4
624;28.11.2017;2017;11;01;Tiistai;0;1;1
624;28.11.2017;2017;11;02;Tiistai;0;0;0
624;28.11.2017;2017;11;03;Tiistai;1;1;2
624;28.11.2017;2017;11;04;Tiistai;0;0;0
624;28.11.2017;2017;11;05;Tiistai;0;1;1
624;28.11.2017;2017;11;06;Tiistai;0;8;8
624;28.11.2017;2017;11;07;Tiistai;5;23;28
624;28.11.2017;2017;11;08;Tiistai;14;46;60
624;28.11.2017;2017;11;09;Tiistai;10;47;57
624;28.11.2017;2017;11;10;Tiistai;8;20;28
624;28.11.2017;2017;11;11;Tiistai;6;14;20
624;28.11.2017;2017;11;12;Tiistai;6;18;24
624;28.11.2017;2017;11;13;Tiistai;9;7;16
624;28.11.2017;2017;11;14;Tiistai;15;10;25
624;28.11.2017;2017;11;15;Tiistai;15;13;28
624;28.11.2017;2017;11;16;Tiistai;34;20;54
624;28.11.2017;2017;11;17;Tiistai;33;25;58
624;28.11.2017;2017;11;18;Tiistai;27;26;53
624;28.11.2017;2017;11;19;Tiistai;14;16;30
624;28.11.2017;2017;11;20;Tiistai;5;8;13
624;28.11.2017;2017;11;21;Tiistai;9;3;12
624;28.11.2017;2017;11;22;Tiistai;9;6;15
624;28.11.2017;2017;11;23;Tiistai;3;4;7
624;29.11.2017;2017;11;00;Keskiviikko;0;1;1
624;29.11.2017;2017;11;01;Keskiviikko;1;0;1
624;29.11.2017;2017;11;02;Keskiviikko;2;0;2
624;29.11.2017;2017;11;03;Keskiviikko;0;1;1
624;29.11.2017;2017;11;04;Keskiviikko;0;0;0
624;29.11.2017;2017;11;05;Keskiviikko;0;1;1
624;29.11.2017;2017;11;06;Keskiviikko;1;9;10
624;29.11.2017;2017;11;07;Keskiviikko;3;15;18
624;29.11.2017;2017;11;08;Keskiviikko;16;48;64
624;29.11.2017;2017;11;09;Keskiviikko;11;41;52
624;29.11.2017;2017;11;10;Keskiviikko;11;21;32
624;29.11.2017;2017;11;11;Keskiviikko;4;13;17
624;29.11.2017;2017;11;12;Keskiviikko;4;14;18
624;29.11.2017;2017;11;13;Keskiviikko;4;21;25
624;29.11.2017;2017;11;14;Keskiviikko;12;16;28
624;29.11.2017;2017;11;15;Keskiviikko;13;10;23
624;29.11.2017;2017;11;16;Keskiviikko;25;13;38
624;29.11.2017;2017;11;17;Keskiviikko;37;32;69
624;29.11.2017;2017;11;18;Keskiviikko;21;26;47
624;29.11.2017;2017;11;19;Keskiviikko;12;12;24
624;29.11.2017;2017;11;20;Keskiviikko;14;11;25
624;29.11.2017;2017;11;21;Keskiviikko;13;13;26
624;29.11.2017;2017;11;22;Keskiviikko;13;6;19
624;29.11.2017;2017;11;23;Keskiviikko;3;5;8
624;30.11.2017;2017;11;00;Torstai;3;2;5
624;30.11.2017;2017;11;01;Torstai;1;1;2
624;30.11.2017;2017;11;02;Torstai;1;0;1
624;30.11.2017;2017;11;03;Torstai;0;0;0
624;30.11.2017;2017;11;04;Torstai;0;0;0
624;30.11.2017;2017;11;05;Torstai;0;1;1
624;30.11.2017;2017;11;06;Torstai;2;9;11
624;30.11.2017;2017;11;07;Torstai;5;18;23
624;30.11.2017;2017;11;08;Torstai;17;48;65
624;30.11.2017;2017;11;09;Torstai;12;60;72
624;30.11.2017;2017;11;10;Torstai;12;17;29
624;30.11.2017;2017;11;11;Torstai;7;10;17
624;30.11.2017;2017;11;12;Torstai;10;15;25
624;30.11.2017;2017;11;13;Torstai;8;16;24
624;30.11.2017;2017;11;14;Torstai;6;12;18
624;30.11.2017;2017;11;15;Torstai;15;21;36
624;30.11.2017;2017;11;16;Torstai;23;15;38
624;30.11.2017;2017;11;17;Torstai;19;37;56
624;30.11.2017;2017;11;18;Torstai;24;23;47
624;30.11.2017;2017;11;19;Torstai;9;12;21
624;30.11.2017;2017;11;20;Torstai;16;10;26
624;30.11.2017;2017;11;21;Torstai;13;8;21
624;30.11.2017;2017;11;22;Torstai;7;7;14
624;30.11.2017;2017;11;23;Torstai;5;6;11
624;01.12.2017;2017;12;00;Perjantai;4;0;4
624;01.12.2017;2017;12;01;Perjantai;0;1;1
624;01.12.2017;2017;12;02;Perjantai;0;1;1
624;01.12.2017;2017;12;03;Perjantai;0;1;1
624;01.12.2017;2017;12;04;Perjantai;0;1;1
624;01.12.2017;2017;12;05;Perjantai;1;2;3
624;01.12.2017;2017;12;06;Perjantai;1;10;11
624;01.12.2017;2017;12;07;Perjantai;7;27;34
624;01.12.2017;2017;12;08;Perjantai;10;34;44
624;01.12.2017;2017;12;09;Perjantai;9;30;39
624;01.12.2017;2017;12;10;Perjantai;7;18;25
624;01.12.2017;2017;12;11;Perjantai;5;11;16
624;01.12.2017;2017;12;12;Perjantai;12;13;25
624;01.12.2017;2017;12;13;Perjantai;12;20;32
624;01.12.2017;2017;12;14;Perjantai;16;20;36
624;01.12.2017;2017;12;15;Perjantai;20;20;40
624;01.12.2017;2017;12;16;Perjantai;17;27;44
624;01.12.2017;2017;12;17;Perjantai;12;25;37
624;01.12.2017;2017;12;18;Perjantai;12;10;22
624;01.12.2017;2017;12;19;Perjantai;6;8;14
624;01.12.2017;2017;12;20;Perjantai;3;7;10
624;01.12.2017;2017;12;21;Perjantai;1;6;7
624;01.12.2017;2017;12;22;Perjantai;3;5;8
624;01.12.2017;2017;12;23;Perjantai;2;2;4
624;02.12.2017;2017;12;00;Lauantai;0;4;4
624;02.12.2017;2017;12;01;Lauantai;5;3;8
624;02.12.2017;2017;12;02;Lauantai;0;1;1
624;02.12.2017;2017;12;03;Lauantai;1;0;1
624;02.12.2017;2017;12;04;Lauantai;0;3;3
624;02.12.2017;2017;12;05;Lauantai;3;0;3
624;02.12.2017;2017;12;06;Lauantai;1;2;3
624;02.12.2017;2017;12;07;Lauantai;1;3;4
624;02.12.2017;2017;12;08;Lauantai;1;2;3
624;02.12.2017;2017;12;09;Lauantai;2;11;13
624;02.12.2017;2017;12;10;Lauantai;3;9;12
624;02.12.2017;2017;12;11;Lauantai;3;9;12
624;02.12.2017;2017;12;12;Lauantai;7;17;24
624;02.12.2017;2017;12;13;Lauantai;6;9;15
624;02.12.2017;2017;12;14;Lauantai;8;16;24
624;02.12.2017;2017;12;15;Lauantai;3;23;26
624;02.12.2017;2017;12;16;Lauantai;5;21;26
624;02.12.2017;2017;12;17;Lauantai;5;12;17
624;02.12.2017;2017;12;18;Lauantai;1;3;4
624;02.12.2017;2017;12;19;Lauantai;7;14;21
624;02.12.2017;2017;12;20;Lauantai;14;8;22
624;02.12.2017;2017;12;21;Lauantai;1;2;3
624;02.12.2017;2017;12;22;Lauantai;6;1;7
624;02.12.2017;2017;12;23;Lauantai;5;2;7
624;03.12.2017;2017;12;00;Sunnuntai;7;0;7
624;03.12.2017;2017;12;01;Sunnuntai;5;7;12
624;03.12.2017;2017;12;02;Sunnuntai;1;2;3
624;03.12.2017;2017;12;03;Sunnuntai;3;2;5
624;03.12.2017;2017;12;04;Sunnuntai;3;0;3
624;03.12.2017;2017;12;05;Sunnuntai;1;1;2
624;03.12.2017;2017;12;06;Sunnuntai;1;2;3
624;03.12.2017;2017;12;07;Sunnuntai;1;3;4
624;03.12.2017;2017;12;08;Sunnuntai;1;0;1
624;03.12.2017;2017;12;09;Sunnuntai;1;1;2
624;03.12.2017;2017;12;10;Sunnuntai;5;9;14
624;03.12.2017;2017;12;11;Sunnuntai;3;7;10
624;03.12.2017;2017;12;12;Sunnuntai;5;5;10
624;03.12.2017;2017;12;13;Sunnuntai;9;8;17
624;03.12.2017;2017;12;14;Sunnuntai;4;28;32
624;03.12.2017;2017;12;15;Sunnuntai;9;12;21
624;03.12.2017;2017;12;16;Sunnuntai;8;12;20
624;03.12.2017;2017;12;17;Sunnuntai;7;6;13
624;03.12.2017;2017;12;18;Sunnuntai;13;11;24
624;03.12.2017;2017;12;19;Sunnuntai;10;8;18
624;03.12.2017;2017;12;20;Sunnuntai;7;5;12
624;03.12.2017;2017;12;21;Sunnuntai;7;9;16
624;03.12.2017;2017;12;22;Sunnuntai;7;4;11
624;03.12.2017;2017;12;23;Sunnuntai;1;2;3
624;04.12.2017;2017;12;00;Maanantai;0;2;2
624;04.12.2017;2017;12;01;Maanantai;0;1;1
624;04.12.2017;2017;12;02;Maanantai;1;1;2
624;04.12.2017;2017;12;03;Maanantai;1;0;1
624;04.12.2017;2017;12;04;Maanantai;0;0;0
624;04.12.2017;2017;12;05;Maanantai;1;0;1
624;04.12.2017;2017;12;06;Maanantai;2;10;12
624;04.12.2017;2017;12;07;Maanantai;5;17;22
624;04.12.2017;2017;12;08;Maanantai;7;37;44
624;04.12.2017;2017;12;09;Maanantai;5;38;43
624;04.12.2017;2017;12;10;Maanantai;5;29;34
624;04.12.2017;2017;12;11;Maanantai;6;20;26
624;04.12.2017;2017;12;12;Maanantai;11;19;30
624;04.12.2017;2017;12;13;Maanantai;10;13;23
624;04.12.2017;2017;12;14;Maanantai;11;20;31
624;04.12.2017;2017;12;15;Maanantai;10;8;18
624;04.12.2017;2017;12;16;Maanantai;23;16;39
624;04.12.2017;2017;12;17;Maanantai;19;21;40
624;04.12.2017;2017;12;18;Maanantai;16;15;31
624;04.12.2017;2017;12;19;Maanantai;5;8;13
624;04.12.2017;2017;12;20;Maanantai;6;5;11
624;04.12.2017;2017;12;21;Maanantai;4;3;7
624;04.12.2017;2017;12;22;Maanantai;7;6;13
624;04.12.2017;2017;12;23;Maanantai;2;2;4
624;05.12.2017;2017;12;00;Tiistai;0;1;1
624;05.12.2017;2017;12;01;Tiistai;1;2;3
624;05.12.2017;2017;12;02;Tiistai;2;1;3
624;05.12.2017;2017;12;03;Tiistai;1;1;2
624;05.12.2017;2017;12;04;Tiistai;0;0;0
624;05.12.2017;2017;12;05;Tiistai;1;0;1
624;05.12.2017;2017;12;06;Tiistai;3;6;9
624;05.12.2017;2017;12;07;Tiistai;8;21;29
624;05.12.2017;2017;12;08;Tiistai;2;24;26
624;05.12.2017;2017;12;09;Tiistai;3;37;40
624;05.12.2017;2017;12;10;Tiistai;8;17;25
624;05.12.2017;2017;12;11;Tiistai;4;15;19
624;05.12.2017;2017;12;12;Tiistai;6;20;26
624;05.12.2017;2017;12;13;Tiistai;4;9;13
624;05.12.2017;2017;12;14;Tiistai;5;14;19
624;05.12.2017;2017;12;15;Tiistai;7;10;17
624;05.12.2017;2017;12;16;Tiistai;21;24;45
624;05.12.2017;2017;12;17;Tiistai;14;20;34
624;05.12.2017;2017;12;18;Tiistai;10;19;29
624;05.12.2017;2017;12;19;Tiistai;9;12;21
624;05.12.2017;2017;12;20;Tiistai;2;8;10
624;05.12.2017;2017;12;21;Tiistai;3;6;9
624;05.12.2017;2017;12;22;Tiistai;4;4;8
624;05.12.2017;2017;12;23;Tiistai;2;3;5
624;06.12.2017;2017;12;00;Keskiviikko;4;5;9
624;06.12.2017;2017;12;01;Keskiviikko;1;2;3
624;06.12.2017;2017;12;02;Keskiviikko;0;1;1
624;06.12.2017;2017;12;03;Keskiviikko;4;2;6
624;06.12.2017;2017;12;04;Keskiviikko;3;2;5
624;06.12.2017;2017;12;05;Keskiviikko;2;1;3
624;06.12.2017;2017;12;06;Keskiviikko;1;0;1
624;06.12.2017;2017;12;07;Keskiviikko;0;3;3
624;06.12.2017;2017;12;08;Keskiviikko;1;2;3
624;06.12.2017;2017;12;09;Keskiviikko;3;2;5
624;06.12.2017;2017;12;10;Keskiviikko;0;6;6
624;06.12.2017;2017;12;11;Keskiviikko;2;14;16
624;06.12.2017;2017;12;12;Keskiviikko;8;39;47
624;06.12.2017;2017;12;13;Keskiviikko;17;11;28
624;06.12.2017;2017;12;14;Keskiviikko;6;9;15
624;06.12.2017;2017;12;15;Keskiviikko;5;10;15
624;06.12.2017;2017;12;16;Keskiviikko;6;7;13
624;06.12.2017;2017;12;17;Keskiviikko;5;6;11
624;06.12.2017;2017;12;18;Keskiviikko;5;6;11
624;06.12.2017;2017;12;19;Keskiviikko;6;8;14
624;06.12.2017;2017;12;20;Keskiviikko;2;1;3
624;06.12.2017;2017;12;21;Keskiviikko;4;3;7
624;06.12.2017;2017;12;22;Keskiviikko;4;2;6
624;06.12.2017;2017;12;23;Keskiviikko;2;2;4
624;07.12.2017;2017;12;00;Torstai;3;3;6
624;07.12.2017;2017;12;01;Torstai;0;4;4
624;07.12.2017;2017;12;02;Torstai;0;0;0
624;07.12.2017;2017;12;03;Torstai;0;0;0
624;07.12.2017;2017;12;04;Torstai;0;2;2
624;07.12.2017;2017;12;05;Torstai;2;1;3
624;07.12.2017;2017;12;06;Torstai;2;6;8
624;07.12.2017;2017;12;07;Torstai;5;21;26
624;07.12.2017;2017;12;08;Torstai;7;37;44
624;07.12.2017;2017;12;09;Torstai;7;27;34
624;07.12.2017;2017;12;10;Torstai;11;17;28
624;07.12.2017;2017;12;11;Torstai;7;16;23
624;07.12.2017;2017;12;12;Torstai;11;23;34
624;07.12.2017;2017;12;13;Torstai;13;16;29
624;07.12.2017;2017;12;14;Torstai;15;16;31
624;07.12.2017;2017;12;15;Torstai;13;26;39
624;07.12.2017;2017;12;16;Torstai;18;16;34
624;07.12.2017;2017;12;17;Torstai;28;15;43
624;07.12.2017;2017;12;18;Torstai;10;6;16
624;07.12.2017;2017;12;19;Torstai;16;11;27
624;07.12.2017;2017;12;20;Torstai;15;5;20
624;07.12.2017;2017;12;21;Torstai;9;4;13
624;07.12.2017;2017;12;22;Torstai;3;3;6
624;07.12.2017;2017;12;23;Torstai;7;4;11
624;08.12.2017;2017;12;00;Perjantai;3;3;6
624;08.12.2017;2017;12;01;Perjantai;2;2;4
624;08.12.2017;2017;12;02;Perjantai;0;0;0
624;08.12.2017;2017;12;03;Perjantai;1;0;1
624;08.12.2017;2017;12;04;Perjantai;0;1;1
624;08.12.2017;2017;12;05;Perjantai;0;2;2
624;08.12.2017;2017;12;06;Perjantai;3;4;7
624;08.12.2017;2017;12;07;Perjantai;2;14;16
624;08.12.2017;2017;12;08;Perjantai;1;20;21
624;08.12.2017;2017;12;09;Perjantai;7;35;42
624;08.12.2017;2017;12;10;Perjantai;3;12;15
624;08.12.2017;2017;12;11;Perjantai;5;12;17
624;08.12.2017;2017;12;12;Perjantai;5;2;7
624;08.12.2017;2017;12;13;Perjantai;5;14;19
624;08.12.2017;2017;12;14;Perjantai;6;8;14
624;08.12.2017;2017;12;15;Perjantai;6;15;21
624;08.12.2017;2017;12;16;Perjantai;18;13;31
624;08.12.2017;2017;12;17;Perjantai;10;16;26
624;08.12.2017;2017;12;18;Perjantai;2;7;9
624;08.12.2017;2017;12;19;Perjantai;6;11;17
624;08.12.2017;2017;12;20;Perjantai;2;6;8
624;08.12.2017;2017;12;21;Perjantai;2;1;3
624;08.12.2017;2017;12;22;Perjantai;2;6;8
624;08.12.2017;2017;12;23;Perjantai;0;7;7
624;09.12.2017;2017;12;00;Lauantai;3;1;4
624;09.12.2017;2017;12;01;Lauantai;0;2;2
624;09.12.2017;2017;12;02;Lauantai;1;6;7
624;09.12.2017;2017;12;03;Lauantai;0;0;0
624;09.12.2017;2017;12;04;Lauantai;1;1;2
624;09.12.2017;2017;12;05;Lauantai;2;0;2
624;09.12.2017;2017;12;06;Lauantai;0;1;1
624;09.12.2017;2017;12;07;Lauantai;2;1;3
624;09.12.2017;2017;12;08;Lauantai;0;6;6
624;09.12.2017;2017;12;09;Lauantai;2;4;6
624;09.12.2017;2017;12;10;Lauantai;2;6;8
624;09.12.2017;2017;12;11;Lauantai;1;5;6
624;09.12.2017;2017;12;12;Lauantai;3;11;14
624;09.12.2017;2017;12;13;Lauantai;11;8;19
624;09.12.2017;2017;12;14;Lauantai;11;5;16
624;09.12.2017;2017;12;15;Lauantai;7;6;13
624;09.12.2017;2017;12;16;Lauantai;9;4;13
624;09.12.2017;2017;12;17;Lauantai;8;4;12
624;09.12.2017;2017;12;18;Lauantai;2;8;10
624;09.12.2017;2017;12;19;Lauantai;3;6;9
624;09.12.2017;2017;12;20;Lauantai;7;5;12
624;09.12.2017;2017;12;21;Lauantai;5;2;7
624;09.12.2017;2017;12;22;Lauantai;2;4;6
624;09.12.2017;2017;12;23;Lauantai;2;2;4
624;10.12.2017;2017;12;00;Sunnuntai;2;4;6
624;10.12.2017;2017;12;01;Sunnuntai;2;1;3
624;10.12.2017;2017;12;02;Sunnuntai;3;3;6
624;10.12.2017;2017;12;03;Sunnuntai;1;0;1
624;10.12.2017;2017;12;04;Sunnuntai;2;1;3
624;10.12.2017;2017;12;05;Sunnuntai;2;1;3
624;10.12.2017;2017;12;06;Sunnuntai;1;0;1
624;10.12.2017;2017;12;07;Sunnuntai;0;5;5
624;10.12.2017;2017;12;08;Sunnuntai;0;1;1
624;10.12.2017;2017;12;09;Sunnuntai;1;4;5
624;10.12.2017;2017;12;10;Sunnuntai;3;4;7
624;10.12.2017;2017;12;11;Sunnuntai;1;3;4
624;10.12.2017;2017;12;12;Sunnuntai;5;9;14
624;10.12.2017;2017;12;13;Sunnuntai;3;7;10
624;10.12.2017;2017;12;14;Sunnuntai;5;8;13
624;10.12.2017;2017;12;15;Sunnuntai;9;7;16
624;10.12.2017;2017;12;16;Sunnuntai;9;5;14
624;10.12.2017;2017;12;17;Sunnuntai;7;2;9
624;10.12.2017;2017;12;18;Sunnuntai;6;3;9
624;10.12.2017;2017;12;19;Sunnuntai;4;4;8
624;10.12.2017;2017;12;20;Sunnuntai;4;0;4
624;10.12.2017;2017;12;21;Sunnuntai;13;1;14
624;10.12.2017;2017;12;22;Sunnuntai;2;3;5
624;10.12.2017;2017;12;23;Sunnuntai;4;2;6
624;11.12.2017;2017;12;00;Maanantai;2;0;2
624;11.12.2017;2017;12;01;Maanantai;1;2;3
624;11.12.2017;2017;12;02;Maanantai;0;1;1
624;11.12.2017;2017;12;03;Maanantai;0;0;0
624;11.12.2017;2017;12;04;Maanantai;1;0;1
624;11.12.2017;2017;12;05;Maanantai;1;0;1
624;11.12.2017;2017;12;06;Maanantai;1;3;4
624;11.12.2017;2017;12;07;Maanantai;5;16;21
624;11.12.2017;2017;12;08;Maanantai;11;37;48
624;11.12.2017;2017;12;09;Maanantai;18;47;65
624;11.12.2017;2017;12;10;Maanantai;7;21;28
624;11.12.2017;2017;12;11;Maanantai;9;21;30
624;11.12.2017;2017;12;12;Maanantai;15;9;24
624;11.12.2017;2017;12;13;Maanantai;12;16;28
624;11.12.2017;2017;12;14;Maanantai;15;14;29
624;11.12.2017;2017;12;15;Maanantai;16;19;35
624;11.12.2017;2017;12;16;Maanantai;31;23;54
624;11.12.2017;2017;12;17;Maanantai;43;28;71
624;11.12.2017;2017;12;18;Maanantai;32;22;54
624;11.12.2017;2017;12;19;Maanantai;26;13;39
624;11.12.2017;2017;12;20;Maanantai;14;1;15
624;11.12.2017;2017;12;21;Maanantai;16;9;25
624;11.12.2017;2017;12;22;Maanantai;10;3;13
624;11.12.2017;2017;12;23;Maanantai;6;3;9
624;12.12.2017;2017;12;00;Tiistai;1;1;2
624;12.12.2017;2017;12;01;Tiistai;1;0;1
624;12.12.2017;2017;12;02;Tiistai;0;0;0
624;12.12.2017;2017;12;03;Tiistai;0;1;1
624;12.12.2017;2017;12;04;Tiistai;0;0;0
624;12.12.2017;2017;12;05;Tiistai;0;0;0
624;12.12.2017;2017;12;06;Tiistai;4;8;12
624;12.12.2017;2017;12;07;Tiistai;4;18;22
624;12.12.2017;2017;12;08;Tiistai;9;35;44
624;12.12.2017;2017;12;09;Tiistai;19;35;54
624;12.12.2017;2017;12;10;Tiistai;17;16;33
624;12.12.2017;2017;12;11;Tiistai;7;10;17
624;12.12.2017;2017;12;12;Tiistai;16;17;33
624;12.12.2017;2017;12;13;Tiistai;12;15;27
624;12.12.2017;2017;12;14;Tiistai;18;11;29
624;12.12.2017;2017;12;15;Tiistai;19;15;34
624;12.12.2017;2017;12;16;Tiistai;28;18;46
624;12.12.2017;2017;12;17;Tiistai;42;18;60
624;12.12.2017;2017;12;18;Tiistai;22;21;43
624;12.12.2017;2017;12;19;Tiistai;18;4;22
624;12.12.2017;2017;12;20;Tiistai;10;5;15
624;12.12.2017;2017;12;21;Tiistai;10;2;12
624;12.12.2017;2017;12;22;Tiistai;5;5;10
624;12.12.2017;2017;12;23;Tiistai;2;2;4
624;13.12.2017;2017;12;00;Keskiviikko;0;0;0
624;13.12.2017;2017;12;01;Keskiviikko;0;0;0
624;13.12.2017;2017;12;02;Keskiviikko;1;0;1
624;13.12.2017;2017;12;03;Keskiviikko;0;0;0
624;13.12.2017;2017;12;04;Keskiviikko;0;0;0
624;13.12.2017;2017;12;05;Keskiviikko;2;0;2
624;13.12.2017;2017;12;06;Keskiviikko;3;3;6
624;13.12.2017;2017;12;07;Keskiviikko;1;18;19
624;13.12.2017;2017;12;08;Keskiviikko;10;37;47
624;13.12.2017;2017;12;09;Keskiviikko;13;29;42
624;13.12.2017;2017;12;10;Keskiviikko;13;16;29
624;13.12.2017;2017;12;11;Keskiviikko;6;9;15
624;13.12.2017;2017;12;12;Keskiviikko;10;15;25
624;13.12.2017;2017;12;13;Keskiviikko;12;11;23
624;13.12.2017;2017;12;14;Keskiviikko;7;13;20
624;13.12.2017;2017;12;15;Keskiviikko;11;18;29
624;13.12.2017;2017;12;16;Keskiviikko;12;18;30
624;13.12.2017;2017;12;17;Keskiviikko;21;17;38
624;13.12.2017;2017;12;18;Keskiviikko;11;17;28
624;13.12.2017;2017;12;19;Keskiviikko;10;14;24
624;13.12.2017;2017;12;20;Keskiviikko;7;5;12
624;13.12.2017;2017;12;21;Keskiviikko;7;10;17
624;13.12.2017;2017;12;22;Keskiviikko;9;3;12
624;13.12.2017;2017;12;23;Keskiviikko;3;3;6
624;14.12.2017;2017;12;00;Torstai;3;2;5
624;14.12.2017;2017;12;01;Torstai;0;2;2
624;14.12.2017;2017;12;02;Torstai;1;1;2
624;14.12.2017;2017;12;03;Torstai;2;0;2
624;14.12.2017;2017;12;04;Torstai;0;1;1
624;14.12.2017;2017;12;05;Torstai;1;0;1
624;14.12.2017;2017;12;06;Torstai;5;7;12
624;14.12.2017;2017;12;07;Torstai;3;17;20
624;14.12.2017;2017;12;08;Torstai;12;32;44
624;14.12.2017;2017;12;09;Torstai;15;38;53
624;14.12.2017;2017;12;10;Torstai;3;13;16
624;14.12.2017;2017;12;11;Torstai;4;21;25
624;14.12.2017;2017;12;12;Torstai;7;22;29
624;14.12.2017;2017;12;13;Torstai;3;14;17
624;14.12.2017;2017;12;14;Torstai;11;14;25
624;14.12.2017;2017;12;15;Torstai;22;15;37
624;14.12.2017;2017;12;16;Torstai;21;19;40
624;14.12.2017;2017;12;17;Torstai;36;12;48
624;14.12.2017;2017;12;18;Torstai;15;8;23
624;14.12.2017;2017;12;19;Torstai;13;7;20
624;14.12.2017;2017;12;20;Torstai;14;6;20
624;14.12.2017;2017;12;21;Torstai;7;5;12
624;14.12.2017;2017;12;22;Torstai;4;1;5
624;14.12.2017;2017;12;23;Torstai;5;3;8
624;15.12.2017;2017;12;00;Perjantai;5;2;7
624;15.12.2017;2017;12;01;Perjantai;1;1;2
624;15.12.2017;2017;12;02;Perjantai;1;1;2
624;15.12.2017;2017;12;03;Perjantai;0;1;1
624;15.12.2017;2017;12;04;Perjantai;0;0;0
624;15.12.2017;2017;12;05;Perjantai;0;1;1
624;15.12.2017;2017;12;06;Perjantai;2;4;6
624;15.12.2017;2017;12;07;Perjantai;5;15;20
624;15.12.2017;2017;12;08;Perjantai;9;26;35
624;15.12.2017;2017;12;09;Perjantai;17;24;41
624;15.12.2017;2017;12;10;Perjantai;8;19;27
624;15.12.2017;2017;12;11;Perjantai;6;15;21
624;15.12.2017;2017;12;12;Perjantai;12;17;29
624;15.12.2017;2017;12;13;Perjantai;10;6;16
624;15.12.2017;2017;12;14;Perjantai;18;17;35
624;15.12.2017;2017;12;15;Perjantai;21;14;35
624;15.12.2017;2017;12;16;Perjantai;25;16;41
624;15.12.2017;2017;12;17;Perjantai;23;20;43
624;15.12.2017;2017;12;18;Perjantai;16;16;32
624;15.12.2017;2017;12;19;Perjantai;4;4;8
624;15.12.2017;2017;12;20;Perjantai;3;8;11
624;15.12.2017;2017;12;21;Perjantai;14;4;18
624;15.12.2017;2017;12;22;Perjantai;11;3;14
624;15.12.2017;2017;12;23;Perjantai;1;6;7
624;16.12.2017;2017;12;00;Lauantai;3;4;7
624;16.12.2017;2017;12;01;Lauantai;4;2;6
624;16.12.2017;2017;12;02;Lauantai;4;4;8
624;16.12.2017;2017;12;03;Lauantai;1;3;4
624;16.12.2017;2017;12;04;Lauantai;2;1;3
624;16.12.2017;2017;12;05;Lauantai;1;1;2
624;16.12.2017;2017;12;06;Lauantai;3;2;5
624;16.12.2017;2017;12;07;Lauantai;1;4;5
624;16.12.2017;2017;12;08;Lauantai;1;4;5
624;16.12.2017;2017;12;09;Lauantai;2;2;4
624;16.12.2017;2017;12;10;Lauantai;2;5;7
624;16.12.2017;2017;12;11;Lauantai;3;6;9
624;16.12.2017;2017;12;12;Lauantai;3;11;14
624;16.12.2017;2017;12;13;Lauantai;8;14;22
624;16.12.2017;2017;12;14;Lauantai;10;12;22
624;16.12.2017;2017;12;15;Lauantai;13;8;21
624;16.12.2017;2017;12;16;Lauantai;9;2;11
624;16.12.2017;2017;12;17;Lauantai;8;13;21
624;16.12.2017;2017;12;18;Lauantai;8;4;12
624;16.12.2017;2017;12;19;Lauantai;5;6;11
624;16.12.2017;2017;12;20;Lauantai;4;8;12
624;16.12.2017;2017;12;21;Lauantai;6;7;13
624;16.12.2017;2017;12;22;Lauantai;15;6;21
624;16.12.2017;2017;12;23;Lauantai;4;0;4
624;17.12.2017;2017;12;00;Sunnuntai;2;3;5
624;17.12.2017;2017;12;01;Sunnuntai;3;0;3
624;17.12.2017;2017;12;02;Sunnuntai;2;4;6
624;17.12.2017;2017;12;03;Sunnuntai;4;0;4
624;17.12.2017;2017;12;04;Sunnuntai;1;2;3
624;17.12.2017;2017;12;05;Sunnuntai;2;2;4
624;17.12.2017;2017;12;06;Sunnuntai;4;2;6
624;17.12.2017;2017;12;07;Sunnuntai;1;4;5
624;17.12.2017;2017;12;08;Sunnuntai;3;2;5
624;17.12.2017;2017;12;09;Sunnuntai;2;5;7
624;17.12.2017;2017;12;10;Sunnuntai;3;1;4
624;17.12.2017;2017;12;11;Sunnuntai;2;6;8
624;17.12.2017;2017;12;12;Sunnuntai;10;5;15
624;17.12.2017;2017;12;13;Sunnuntai;2;9;11
624;17.12.2017;2017;12;14;Sunnuntai;13;9;22
624;17.12.2017;2017;12;15;Sunnuntai;7;12;19
624;17.12.2017;2017;12;16;Sunnuntai;8;3;11
624;17.12.2017;2017;12;17;Sunnuntai;10;5;15
624;17.12.2017;2017;12;18;Sunnuntai;10;5;15
624;17.12.2017;2017;12;19;Sunnuntai;10;7;17
624;17.12.2017;2017;12;20;Sunnuntai;6;6;12
624;17.12.2017;2017;12;21;Sunnuntai;8;5;13
624;17.12.2017;2017;12;22;Sunnuntai;8;2;10
624;17.12.2017;2017;12;23;Sunnuntai;3;3;6
624;18.12.2017;2017;12;00;Maanantai;0;3;3
624;18.12.2017;2017;12;01;Maanantai;5;0;5
624;18.12.2017;2017;12;02;Maanantai;0;0;0
624;18.12.2017;2017;12;03;Maanantai;0;0;0
624;18.12.2017;2017;12;04;Maanantai;0;0;0
624;18.12.2017;2017;12;05;Maanantai;1;0;1
624;18.12.2017;2017;12;06;Maanantai;2;8;10
624;18.12.2017;2017;12;07;Maanantai;7;17;24
624;18.12.2017;2017;12;08;Maanantai;10;42;52
624;18.12.2017;2017;12;09;Maanantai;15;36;51
624;18.12.2017;2017;12;10;Maanantai;8;22;30
624;18.12.2017;2017;12;11;Maanantai;8;15;23
624;18.12.2017;2017;12;12;Maanantai;5;14;19
624;18.12.2017;2017;12;13;Maanantai;20;13;33
624;18.12.2017;2017;12;14;Maanantai;20;12;32
624;18.12.2017;2017;12;15;Maanantai;17;16;33
624;18.12.2017;2017;12;16;Maanantai;36;15;51
624;18.12.2017;2017;12;17;Maanantai;52;19;71
624;18.12.2017;2017;12;18;Maanantai;27;16;43
624;18.12.2017;2017;12;19;Maanantai;23;12;35
624;18.12.2017;2017;12;20;Maanantai;13;13;26
624;18.12.2017;2017;12;21;Maanantai;13;5;18
624;18.12.2017;2017;12;22;Maanantai;7;5;12
624;18.12.2017;2017;12;23;Maanantai;3;7;10
624;19.12.2017;2017;12;00;Tiistai;1;1;2
624;19.12.2017;2017;12;01;Tiistai;4;0;4
624;19.12.2017;2017;12;02;Tiistai;0;0;0
624;19.12.2017;2017;12;03;Tiistai;0;2;2
624;19.12.2017;2017;12;04;Tiistai;0;0;0
624;19.12.2017;2017;12;05;Tiistai;1;0;1
624;19.12.2017;2017;12;06;Tiistai;3;8;11
624;19.12.2017;2017;12;07;Tiistai;8;18;26
624;19.12.2017;2017;12;08;Tiistai;13;43;56
624;19.12.2017;2017;12;09;Tiistai;13;31;44
624;19.12.2017;2017;12;10;Tiistai;8;11;19
624;19.12.2017;2017;12;11;Tiistai;9;12;21
624;19.12.2017;2017;12;12;Tiistai;7;17;24
624;19.12.2017;2017;12;13;Tiistai;12;19;31
624;19.12.2017;2017;12;14;Tiistai;17;9;26
624;19.12.2017;2017;12;15;Tiistai;17;16;33
624;19.12.2017;2017;12;16;Tiistai;35;16;51
624;19.12.2017;2017;12;17;Tiistai;45;26;71
624;19.12.2017;2017;12;18;Tiistai;21;19;40
624;19.12.2017;2017;12;19;Tiistai;15;13;28
624;19.12.2017;2017;12;20;Tiistai;17;1;18
624;19.12.2017;2017;12;21;Tiistai;16;6;22
624;19.12.2017;2017;12;22;Tiistai;19;5;24
624;19.12.2017;2017;12;23;Tiistai;5;4;9
624;20.12.2017;2017;12;00;Keskiviikko;1;1;2
624;20.12.2017;2017;12;01;Keskiviikko;0;2;2
624;20.12.2017;2017;12;02;Keskiviikko;2;1;3
624;20.12.2017;2017;12;03;Keskiviikko;0;3;3
624;20.12.2017;2017;12;04;Keskiviikko;0;0;0
624;20.12.2017;2017;12;05;Keskiviikko;1;0;1
624;20.12.2017;2017;12;06;Keskiviikko;1;6;7
624;20.12.2017;2017;12;07;Keskiviikko;7;20;27
624;20.12.2017;2017;12;08;Keskiviikko;12;38;50
624;20.12.2017;2017;12;09;Keskiviikko;10;31;41
624;20.12.2017;2017;12;10;Keskiviikko;9;12;21
624;20.12.2017;2017;12;11;Keskiviikko;4;11;15
624;20.12.2017;2017;12;12;Keskiviikko;8;11;19
624;20.12.2017;2017;12;13;Keskiviikko;5;11;16
624;20.12.2017;2017;12;14;Keskiviikko;11;9;20
624;20.12.2017;2017;12;15;Keskiviikko;15;14;29
624;20.12.2017;2017;12;16;Keskiviikko;4;2;6
624;20.12.2017;2017;12;17;Keskiviikko;19;18;37
624;20.12.2017;2017;12;18;Keskiviikko;12;9;21
624;20.12.2017;2017;12;19;Keskiviikko;7;2;9
624;20.12.2017;2017;12;20;Keskiviikko;3;2;5
624;20.12.2017;2017;12;21;Keskiviikko;6;3;9
624;20.12.2017;2017;12;22;Keskiviikko;7;1;8
624;20.12.2017;2017;12;23;Keskiviikko;3;4;7
624;21.12.2017;2017;12;00;Torstai;0;1;1
624;21.12.2017;2017;12;01;Torstai;2;1;3
624;21.12.2017;2017;12;02;Torstai;0;1;1
624;21.12.2017;2017;12;03;Torstai;0;2;2
624;21.12.2017;2017;12;04;Torstai;0;0;0
624;21.12.2017;2017;12;05;Torstai;0;0;0
624;21.12.2017;2017;12;06;Torstai;3;8;11
624;21.12.2017;2017;12;07;Torstai;4;14;18
624;21.12.2017;2017;12;08;Torstai;5;31;36
624;21.12.2017;2017;12;09;Torstai;8;35;43
624;21.12.2017;2017;12;10;Torstai;5;7;12
624;21.12.2017;2017;12;11;Torstai;2;10;12
624;21.12.2017;2017;12;12;Torstai;8;17;25
624;21.12.2017;2017;12;13;Torstai;5;11;16
624;21.12.2017;2017;12;14;Torstai;11;10;21
624;21.12.2017;2017;12;15;Torstai;11;11;22
624;21.12.2017;2017;12;16;Torstai;9;12;21
624;21.12.2017;2017;12;17;Torstai;21;15;36
624;21.12.2017;2017;12;18;Torstai;19;8;27
624;21.12.2017;2017;12;19;Torstai;15;9;24
624;21.12.2017;2017;12;20;Torstai;12;10;22
624;21.12.2017;2017;12;21;Torstai;13;6;19
624;21.12.2017;2017;12;22;Torstai;5;4;9
624;21.12.2017;2017;12;23;Torstai;1;1;2
624;22.12.2017;2017;12;00;Perjantai;3;3;6
624;22.12.2017;2017;12;01;Perjantai;0;2;2
624;22.12.2017;2017;12;02;Perjantai;0;0;0
624;22.12.2017;2017;12;03;Perjantai;1;3;4
624;22.12.2017;2017;12;04;Perjantai;0;1;1
624;22.12.2017;2017;12;05;Perjantai;2;1;3
624;22.12.2017;2017;12;06;Perjantai;3;5;8
624;22.12.2017;2017;12;07;Perjantai;5;20;25
624;22.12.2017;2017;12;08;Perjantai;6;21;27
624;22.12.2017;2017;12;09;Perjantai;5;25;30
624;22.12.2017;2017;12;10;Perjantai;5;8;13
624;22.12.2017;2017;12;11;Perjantai;4;10;14
624;22.12.2017;2017;12;12;Perjantai;8;16;24
624;22.12.2017;2017;12;13;Perjantai;8;21;29
624;22.12.2017;2017;12;14;Perjantai;7;5;12
624;22.12.2017;2017;12;15;Perjantai;5;18;23
624;22.12.2017;2017;12;16;Perjantai;11;15;26
624;22.12.2017;2017;12;17;Perjantai;7;19;26
624;22.12.2017;2017;12;18;Perjantai;7;9;16
624;22.12.2017;2017;12;19;Perjantai;6;6;12
624;22.12.2017;2017;12;20;Perjantai;7;6;13
624;22.12.2017;2017;12;21;Perjantai;4;3;7
624;22.12.2017;2017;12;22;Perjantai;5;3;8
624;22.12.2017;2017;12;23;Perjantai;1;2;3
624;23.12.2017;2017;12;00;Lauantai;0;1;1
624;23.12.2017;2017;12;01;Lauantai;1;3;4
624;23.12.2017;2017;12;02;Lauantai;1;1;2
624;23.12.2017;2017;12;03;Lauantai;1;0;1
624;23.12.2017;2017;12;04;Lauantai;2;0;2
624;23.12.2017;2017;12;05;Lauantai;0;0;0
624;23.12.2017;2017;12;06;Lauantai;1;2;3
624;23.12.2017;2017;12;07;Lauantai;2;2;4
624;23.12.2017;2017;12;08;Lauantai;0;5;5
624;23.12.2017;2017;12;09;Lauantai;0;5;5
624;23.12.2017;2017;12;10;Lauantai;2;4;6
624;23.12.2017;2017;12;11;Lauantai;2;4;6
624;23.12.2017;2017;12;12;Lauantai;4;9;13
624;23.12.2017;2017;12;13;Lauantai;0;2;2
624;23.12.2017;2017;12;14;Lauantai;0;1;1
624;23.12.2017;2017;12;15;Lauantai;1;4;5
624;23.12.2017;2017;12;16;Lauantai;3;3;6
624;23.12.2017;2017;12;17;Lauantai;3;7;10
624;23.12.2017;2017;12;18;Lauantai;1;1;2
624;23.12.2017;2017;12;19;Lauantai;4;2;6
624;23.12.2017;2017;12;20;Lauantai;4;3;7
624;23.12.2017;2017;12;21;Lauantai;1;4;5
624;23.12.2017;2017;12;22;Lauantai;0;0;0
624;23.12.2017;2017;12;23;Lauantai;1;0;1
624;24.12.2017;2017;12;00;Sunnuntai;1;1;2
624;24.12.2017;2017;12;01;Sunnuntai;0;1;1
624;24.12.2017;2017;12;02;Sunnuntai;0;1;1
624;24.12.2017;2017;12;03;Sunnuntai;0;0;0
624;24.12.2017;2017;12;04;Sunnuntai;0;0;0
624;24.12.2017;2017;12;05;Sunnuntai;0;0;0
624;24.12.2017;2017;12;06;Sunnuntai;0;1;1
624;24.12.2017;2017;12;07;Sunnuntai;0;1;1
624;24.12.2017;2017;12;08;Sunnuntai;0;4;4
624;24.12.2017;2017;12;09;Sunnuntai;1;1;2
624;24.12.2017;2017;12;10;Sunnuntai;0;8;8
624;24.12.2017;2017;12;11;Sunnuntai;3;4;7
624;24.12.2017;2017;12;12;Sunnuntai;1;1;2
624;24.12.2017;2017;12;13;Sunnuntai;2;3;5
624;24.12.2017;2017;12;14;Sunnuntai;1;3;4
624;24.12.2017;2017;12;15;Sunnuntai;2;1;3
624;24.12.2017;2017;12;16;Sunnuntai;0;5;5
624;24.12.2017;2017;12;17;Sunnuntai;4;3;7
624;24.12.2017;2017;12;18;Sunnuntai;2;1;3
624;24.12.2017;2017;12;19;Sunnuntai;1;2;3
624;24.12.2017;2017;12;20;Sunnuntai;1;3;4
624;24.12.2017;2017;12;21;Sunnuntai;0;0;0
624;24.12.2017;2017;12;22;Sunnuntai;1;1;2
624;24.12.2017;2017;12;23;Sunnuntai;1;0;1
624;25.12.2017;2017;12;00;Maanantai;0;1;1
624;25.12.2017;2017;12;01;Maanantai;0;2;2
624;25.12.2017;2017;12;02;Maanantai;0;1;1
624;25.12.2017;2017;12;03;Maanantai;0;0;0
624;25.12.2017;2017;12;04;Maanantai;0;0;0
624;25.12.2017;2017;12;05;Maanantai;0;0;0
624;25.12.2017;2017;12;06;Maanantai;0;0;0
624;25.12.2017;2017;12;07;Maanantai;0;5;5
624;25.12.2017;2017;12;08;Maanantai;0;4;4
624;25.12.2017;2017;12;09;Maanantai;1;0;1
624;25.12.2017;2017;12;10;Maanantai;0;0;0
624;25.12.2017;2017;12;11;Maanantai;0;0;0
624;25.12.2017;2017;12;12;Maanantai;1;3;4
624;25.12.2017;2017;12;13;Maanantai;2;1;3
624;25.12.2017;2017;12;14;Maanantai;2;5;7
624;25.12.2017;2017;12;15;Maanantai;2;5;7
624;25.12.2017;2017;12;16;Maanantai;6;1;7
624;25.12.2017;2017;12;17;Maanantai;0;2;2
624;25.12.2017;2017;12;18;Maanantai;0;1;1
624;25.12.2017;2017;12;19;Maanantai;3;2;5
624;25.12.2017;2017;12;20;Maanantai;2;2;4
624;25.12.2017;2017;12;21;Maanantai;1;0;1
624;25.12.2017;2017;12;22;Maanantai;0;0;0
624;25.12.2017;2017;12;23;Maanantai;0;2;2
624;26.12.2017;2017;12;00;Tiistai;0;2;2
624;26.12.2017;2017;12;01;Tiistai;0;0;0
624;26.12.2017;2017;12;02;Tiistai;1;0;1
624;26.12.2017;2017;12;03;Tiistai;1;0;1
624;26.12.2017;2017;12;04;Tiistai;0;0;0
624;26.12.2017;2017;12;05;Tiistai;0;0;0
624;26.12.2017;2017;12;06;Tiistai;0;0;0
624;26.12.2017;2017;12;07;Tiistai;0;3;3
624;26.12.2017;2017;12;08;Tiistai;0;4;4
624;26.12.2017;2017;12;09;Tiistai;0;1;1
624;26.12.2017;2017;12;10;Tiistai;2;4;6
624;26.12.2017;2017;12;11;Tiistai;1;5;6
624;26.12.2017;2017;12;12;Tiistai;1;3;4
624;26.12.2017;2017;12;13;Tiistai;0;3;3
624;26.12.2017;2017;12;14;Tiistai;1;1;2
624;26.12.2017;2017;12;15;Tiistai;1;6;7
624;26.12.2017;2017;12;16;Tiistai;1;4;5
624;26.12.2017;2017;12;17;Tiistai;3;5;8
624;26.12.2017;2017;12;18;Tiistai;2;3;5
624;26.12.2017;2017;12;19;Tiistai;1;2;3
624;26.12.2017;2017;12;20;Tiistai;2;2;4
624;26.12.2017;2017;12;21;Tiistai;1;3;4
624;26.12.2017;2017;12;22;Tiistai;0;2;2
624;26.12.2017;2017;12;23;Tiistai;0;2;2
624;27.12.2017;2017;12;00;Keskiviikko;1;2;3
624;27.12.2017;2017;12;01;Keskiviikko;0;0;0
624;27.12.2017;2017;12;02;Keskiviikko;0;1;1
624;27.12.2017;2017;12;03;Keskiviikko;0;0;0
624;27.12.2017;2017;12;04;Keskiviikko;1;0;1
624;27.12.2017;2017;12;05;Keskiviikko;0;0;0
624;27.12.2017;2017;12;06;Keskiviikko;1;6;7
624;27.12.2017;2017;12;07;Keskiviikko;0;6;6
624;27.12.2017;2017;12;08;Keskiviikko;3;16;19
624;27.12.2017;2017;12;09;Keskiviikko;0;10;10
624;27.12.2017;2017;12;10;Keskiviikko;1;7;8
624;27.12.2017;2017;12;11;Keskiviikko;1;5;6
624;27.12.2017;2017;12;12;Keskiviikko;2;4;6
624;27.12.2017;2017;12;13;Keskiviikko;7;7;14
624;27.12.2017;2017;12;14;Keskiviikko;1;8;9
624;27.12.2017;2017;12;15;Keskiviikko;2;7;9
624;27.12.2017;2017;12;16;Keskiviikko;1;4;5
624;27.12.2017;2017;12;17;Keskiviikko;3;11;14
624;27.12.2017;2017;12;18;Keskiviikko;2;9;11
624;27.12.2017;2017;12;19;Keskiviikko;2;3;5
624;27.12.2017;2017;12;20;Keskiviikko;0;0;0
624;27.12.2017;2017;12;21;Keskiviikko;0;4;4
624;27.12.2017;2017;12;22;Keskiviikko;3;2;5
624;27.12.2017;2017;12;23;Keskiviikko;0;2;2
624;28.12.2017;2017;12;00;Torstai;0;1;1
624;28.12.2017;2017;12;01;Torstai;0;2;2
624;28.12.2017;2017;12;02;Torstai;0;0;0
624;28.12.2017;2017;12;03;Torstai;1;0;1
624;28.12.2017;2017;12;04;Torstai;0;0;0
624;28.12.2017;2017;12;05;Torstai;0;0;0
624;28.12.2017;2017;12;06;Torstai;2;3;5
624;28.12.2017;2017;12;07;Torstai;1;12;13
624;28.12.2017;2017;12;08;Torstai;2;12;14
624;28.12.2017;2017;12;09;Torstai;2;12;14
624;28.12.2017;2017;12;10;Torstai;1;13;14
624;28.12.2017;2017;12;11;Torstai;1;15;16
624;28.12.2017;2017;12;12;Torstai;1;10;11
624;28.12.2017;2017;12;13;Torstai;2;10;12
624;28.12.2017;2017;12;14;Torstai;1;10;11
624;28.12.2017;2017;12;15;Torstai;4;7;11
624;28.12.2017;2017;12;16;Torstai;2;11;13
624;28.12.2017;2017;12;17;Torstai;4;13;17
624;28.12.2017;2017;12;18;Torstai;6;8;14
624;28.12.2017;2017;12;19;Torstai;1;7;8
624;28.12.2017;2017;12;20;Torstai;0;3;3
624;28.12.2017;2017;12;21;Torstai;1;4;5
624;28.12.2017;2017;12;22;Torstai;3;5;8
624;28.12.2017;2017;12;23;Torstai;2;0;2
624;29.12.2017;2017;12;00;Perjantai;0;2;2
624;29.12.2017;2017;12;01;Perjantai;0;2;2
624;29.12.2017;2017;12;02;Perjantai;1;0;1
624;29.12.2017;2017;12;03;Perjantai;0;1;1
624;29.12.2017;2017;12;04;Perjantai;0;2;2
624;29.12.2017;2017;12;05;Perjantai;0;1;1
624;29.12.2017;2017;12;06;Perjantai;1;4;5
624;29.12.2017;2017;12;07;Perjantai;2;12;14
624;29.12.2017;2017;12;08;Perjantai;1;12;13
624;29.12.2017;2017;12;09;Perjantai;1;14;15
624;29.12.2017;2017;12;10;Perjantai;2;4;6
624;29.12.2017;2017;12;11;Perjantai;0;6;6
624;29.12.2017;2017;12;12;Perjantai;1;7;8
624;29.12.2017;2017;12;13;Perjantai;2;6;8
624;29.12.2017;2017;12;14;Perjantai;3;14;17
624;29.12.2017;2017;12;15;Perjantai;4;18;22
624;29.12.2017;2017;12;16;Perjantai;8;6;14
624;29.12.2017;2017;12;17;Perjantai;5;11;16
624;29.12.2017;2017;12;18;Perjantai;2;11;13
624;29.12.2017;2017;12;19;Perjantai;4;7;11
624;29.12.2017;2017;12;20;Perjantai;4;4;8
624;29.12.2017;2017;12;21;Perjantai;2;5;7
624;29.12.2017;2017;12;22;Perjantai;1;3;4
624;29.12.2017;2017;12;23;Perjantai;1;1;2
624;30.12.2017;2017;12;00;Lauantai;0;2;2
624;30.12.2017;2017;12;01;Lauantai;0;0;0
624;30.12.2017;2017;12;02;Lauantai;0;1;1
624;30.12.2017;2017;12;03;Lauantai;1;3;4
624;30.12.2017;2017;12;04;Lauantai;1;0;1
624;30.12.2017;2017;12;05;Lauantai;0;0;0
624;30.12.2017;2017;12;06;Lauantai;0;1;1
624;30.12.2017;2017;12;07;Lauantai;1;0;1
624;30.12.2017;2017;12;08;Lauantai;0;5;5
624;30.12.2017;2017;12;09;Lauantai;1;4;5
624;30.12.2017;2017;12;10;Lauantai;0;3;3
624;30.12.2017;2017;12;11;Lauantai;0;8;8
624;30.12.2017;2017;12;12;Lauantai;1;10;11
624;30.12.2017;2017;12;13;Lauantai;2;7;9
624;30.12.2017;2017;12;14;Lauantai;1;6;7
624;30.12.2017;2017;12;15;Lauantai;7;6;13
624;30.12.2017;2017;12;16;Lauantai;1;5;6
624;30.12.2017;2017;12;17;Lauantai;8;1;9
624;30.12.2017;2017;12;18;Lauantai;5;9;14
624;30.12.2017;2017;12;19;Lauantai;6;6;12
624;30.12.2017;2017;12;20;Lauantai;2;2;4
624;30.12.2017;2017;12;21;Lauantai;2;2;4
624;30.12.2017;2017;12;22;Lauantai;2;2;4
624;30.12.2017;2017;12;23;Lauantai;2;2;4
624;31.12.2017;2017;12;00;Sunnuntai;0;3;3
624;31.12.2017;2017;12;01;Sunnuntai;0;0;0
624;31.12.2017;2017;12;02;Sunnuntai;2;2;4
624;31.12.2017;2017;12;03;Sunnuntai;1;1;2
624;31.12.2017;2017;12;04;Sunnuntai;0;0;0
624;31.12.2017;2017;12;05;Sunnuntai;0;0;0
624;31.12.2017;2017;12;06;Sunnuntai;0;2;2
624;31.12.2017;2017;12;07;Sunnuntai;0;3;3
624;31.12.2017;2017;12;08;Sunnuntai;0;1;1
624;31.12.2017;2017;12;09;Sunnuntai;0;2;2
624;31.12.2017;2017;12;10;Sunnuntai;2;2;4
624;31.12.2017;2017;12;11;Sunnuntai;1;9;10
624;31.12.2017;2017;12;12;Sunnuntai;2;4;6
624;31.12.2017;2017;12;13;Sunnuntai;0;6;6
624;31.12.2017;2017;12;14;Sunnuntai;1;11;12
624;31.12.2017;2017;12;15;Sunnuntai;2;5;7
624;31.12.2017;2017;12;16;Sunnuntai;6;8;14
624;31.12.2017;2017;12;17;Sunnuntai;0;5;5
624;31.12.2017;2017;12;18;Sunnuntai;2;7;9
624;31.12.2017;2017;12;19;Sunnuntai;5;8;13
624;31.12.2017;2017;12;20;Sunnuntai;3;4;7
624;31.12.2017;2017;12;21;Sunnuntai;2;4;6
624;31.12.2017;2017;12;22;Sunnuntai;2;1;3
624;31.12.2017;2017;12;23;Sunnuntai;1;1;2
624;01.01.2018;2018;01;00;Maanantai;2;1;3
624;01.01.2018;2018;01;01;Maanantai;0;2;2
624;01.01.2018;2018;01;02;Maanantai;0;0;0
624;01.01.2018;2018;01;03;Maanantai;3;3;6
624;01.01.2018;2018;01;04;Maanantai;1;0;1
624;01.01.2018;2018;01;05;Maanantai;0;0;0
624;01.01.2018;2018;01;06;Maanantai;0;0;0
624;01.01.2018;2018;01;07;Maanantai;1;3;4
624;01.01.2018;2018;01;08;Maanantai;0;1;1
624;01.01.2018;2018;01;09;Maanantai;0;3;3
624;01.01.2018;2018;01;10;Maanantai;0;0;0
624;01.01.2018;2018;01;11;Maanantai;0;1;1
624;01.01.2018;2018;01;12;Maanantai;0;2;2
624;01.01.2018;2018;01;13;Maanantai;3;5;8
624;01.01.2018;2018;01;14;Maanantai;0;4;4
624;01.01.2018;2018;01;15;Maanantai;4;5;9
624;01.01.2018;2018;01;16;Maanantai;3;6;9
624;01.01.2018;2018;01;17;Maanantai;1;0;1
624;01.01.2018;2018;01;18;Maanantai;2;4;6
624;01.01.2018;2018;01;19;Maanantai;2;1;3
624;01.01.2018;2018;01;20;Maanantai;1;3;4
624;01.01.2018;2018;01;21;Maanantai;2;1;3
624;01.01.2018;2018;01;22;Maanantai;1;1;2
624;01.01.2018;2018;01;23;Maanantai;1;0;1
624;02.01.2018;2018;01;00;Tiistai;0;1;1
624;02.01.2018;2018;01;01;Tiistai;0;1;1
624;02.01.2018;2018;01;02;Tiistai;1;1;2
624;02.01.2018;2018;01;03;Tiistai;0;0;0
624;02.01.2018;2018;01;04;Tiistai;0;0;0
624;02.01.2018;2018;01;05;Tiistai;1;0;1
624;02.01.2018;2018;01;06;Tiistai;2;10;12
624;02.01.2018;2018;01;07;Tiistai;3;24;27
624;02.01.2018;2018;01;08;Tiistai;4;28;32
624;02.01.2018;2018;01;09;Tiistai;3;14;17
624;02.01.2018;2018;01;10;Tiistai;0;9;9
624;02.01.2018;2018;01;11;Tiistai;4;11;15
624;02.01.2018;2018;01;12;Tiistai;1;13;14
624;02.01.2018;2018;01;13;Tiistai;4;14;18
624;02.01.2018;2018;01;14;Tiistai;1;12;13
624;02.01.2018;2018;01;15;Tiistai;4;11;15
624;02.01.2018;2018;01;16;Tiistai;1;8;9
624;02.01.2018;2018;01;17;Tiistai;8;20;28
624;02.01.2018;2018;01;18;Tiistai;5;8;13
624;02.01.2018;2018;01;19;Tiistai;8;9;17
624;02.01.2018;2018;01;20;Tiistai;4;8;12
624;02.01.2018;2018;01;21;Tiistai;2;3;5
624;02.01.2018;2018;01;22;Tiistai;4;4;8
624;02.01.2018;2018;01;23;Tiistai;2;6;8
624;03.01.2018;2018;01;00;Keskiviikko;3;3;6
624;03.01.2018;2018;01;01;Keskiviikko;0;2;2
624;03.01.2018;2018;01;02;Keskiviikko;0;0;0
624;03.01.2018;2018;01;03;Keskiviikko;0;2;2
624;03.01.2018;2018;01;04;Keskiviikko;0;1;1
624;03.01.2018;2018;01;05;Keskiviikko;2;0;2
624;03.01.2018;2018;01;06;Keskiviikko;3;6;9
624;03.01.2018;2018;01;07;Keskiviikko;1;22;23
624;03.01.2018;2018;01;08;Keskiviikko;5;36;41
624;03.01.2018;2018;01;09;Keskiviikko;4;25;29
624;03.01.2018;2018;01;10;Keskiviikko;6;3;9
624;03.01.2018;2018;01;11;Keskiviikko;5;9;14
624;03.01.2018;2018;01;12;Keskiviikko;7;17;24
624;03.01.2018;2018;01;13;Keskiviikko;6;15;21
624;03.01.2018;2018;01;14;Keskiviikko;6;14;20
624;03.01.2018;2018;01;15;Keskiviikko;4;16;20
624;03.01.2018;2018;01;16;Keskiviikko;3;19;22
624;03.01.2018;2018;01;17;Keskiviikko;7;17;24
624;03.01.2018;2018;01;18;Keskiviikko;11;15;26
624;03.01.2018;2018;01;19;Keskiviikko;3;13;16
624;03.01.2018;2018;01;20;Keskiviikko;1;7;8
624;03.01.2018;2018;01;21;Keskiviikko;3;3;6
624;03.01.2018;2018;01;22;Keskiviikko;2;4;6
624;03.01.2018;2018;01;23;Keskiviikko;1;5;6
624;04.01.2018;2018;01;00;Torstai;1;3;4
624;04.01.2018;2018;01;01;Torstai;0;1;1
624;04.01.2018;2018;01;02;Torstai;1;0;1
624;04.01.2018;2018;01;03;Torstai;0;1;1
624;04.01.2018;2018;01;04;Torstai;0;0;0
624;04.01.2018;2018;01;05;Torstai;0;0;0
624;04.01.2018;2018;01;06;Torstai;2;8;10
624;04.01.2018;2018;01;07;Torstai;1;19;20
624;04.01.2018;2018;01;08;Torstai;3;37;40
624;04.01.2018;2018;01;09;Torstai;5;22;27
624;04.01.2018;2018;01;10;Torstai;2;10;12
624;04.01.2018;2018;01;11;Torstai;1;10;11
624;04.01.2018;2018;01;12;Torstai;4;12;16
624;04.01.2018;2018;01;13;Torstai;1;11;12
624;04.01.2018;2018;01;14;Torstai;1;6;7
624;04.01.2018;2018;01;15;Torstai;3;16;19
624;04.01.2018;2018;01;16;Torstai;9;7;16
624;04.01.2018;2018;01;17;Torstai;9;20;29
624;04.01.2018;2018;01;18;Torstai;8;9;17
624;04.01.2018;2018;01;19;Torstai;4;6;10
624;04.01.2018;2018;01;20;Torstai;4;8;12
624;04.01.2018;2018;01;21;Torstai;7;7;14
624;04.01.2018;2018;01;22;Torstai;1;4;5
624;04.01.2018;2018;01;23;Torstai;0;1;1
624;05.01.2018;2018;01;00;Perjantai;0;4;4
624;05.01.2018;2018;01;01;Perjantai;1;3;4
624;05.01.2018;2018;01;02;Perjantai;0;1;1
624;05.01.2018;2018;01;03;Perjantai;0;0;0
624;05.01.2018;2018;01;04;Perjantai;0;0;0
624;05.01.2018;2018;01;05;Perjantai;1;1;2
624;05.01.2018;2018;01;06;Perjantai;1;7;8
624;05.01.2018;2018;01;07;Perjantai;3;19;22
624;05.01.2018;2018;01;08;Perjantai;3;29;32
624;05.01.2018;2018;01;09;Perjantai;8;17;25
624;05.01.2018;2018;01;10;Perjantai;0;3;3
624;05.01.2018;2018;01;11;Perjantai;1;11;12
624;05.01.2018;2018;01;12;Perjantai;4;15;19
624;05.01.2018;2018;01;13;Perjantai;1;5;6
624;05.01.2018;2018;01;14;Perjantai;1;8;9
624;05.01.2018;2018;01;15;Perjantai;6;7;13
624;05.01.2018;2018;01;16;Perjantai;28;10;38
624;05.01.2018;2018;01;17;Perjantai;9;13;22
624;05.01.2018;2018;01;18;Perjantai;2;9;11
624;05.01.2018;2018;01;19;Perjantai;3;3;6
624;05.01.2018;2018;01;20;Perjantai;8;3;11
624;05.01.2018;2018;01;21;Perjantai;3;4;7
624;05.01.2018;2018;01;22;Perjantai;4;5;9
624;05.01.2018;2018;01;23;Perjantai;3;2;5
624;06.01.2018;2018;01;00;Lauantai;1;1;2
624;06.01.2018;2018;01;01;Lauantai;1;4;5
624;06.01.2018;2018;01;02;Lauantai;2;4;6
624;06.01.2018;2018;01;03;Lauantai;2;0;2
624;06.01.2018;2018;01;04;Lauantai;1;0;1
624;06.01.2018;2018;01;05;Lauantai;2;0;2
624;06.01.2018;2018;01;06;Lauantai;0;1;1
624;06.01.2018;2018;01;07;Lauantai;0;4;4
624;06.01.2018;2018;01;08;Lauantai;0;2;2
624;06.01.2018;2018;01;09;Lauantai;3;7;10
624;06.01.2018;2018;01;10;Lauantai;3;6;9
624;06.01.2018;2018;01;11;Lauantai;0;4;4
624;06.01.2018;2018;01;12;Lauantai;3;5;8
624;06.01.2018;2018;01;13;Lauantai;1;6;7
624;06.01.2018;2018;01;14;Lauantai;4;6;10
624;06.01.2018;2018;01;15;Lauantai;18;10;28
624;06.01.2018;2018;01;16;Lauantai;7;8;15
624;06.01.2018;2018;01;17;Lauantai;6;14;20
624;06.01.2018;2018;01;18;Lauantai;3;4;7
624;06.01.2018;2018;01;19;Lauantai;7;9;16
624;06.01.2018;2018;01;20;Lauantai;9;5;14
624;06.01.2018;2018;01;21;Lauantai;5;2;7
624;06.01.2018;2018;01;22;Lauantai;5;4;9
624;06.01.2018;2018;01;23;Lauantai;2;3;5
624;07.01.2018;2018;01;00;Sunnuntai;2;4;6
624;07.01.2018;2018;01;01;Sunnuntai;2;5;7
624;07.01.2018;2018;01;02;Sunnuntai;1;0;1
624;07.01.2018;2018;01;03;Sunnuntai;1;1;2
624;07.01.2018;2018;01;04;Sunnuntai;1;1;2
624;07.01.2018;2018;01;05;Sunnuntai;2;1;3
624;07.01.2018;2018;01;06;Sunnuntai;0;1;1
624;07.01.2018;2018;01;07;Sunnuntai;2;3;5
624;07.01.2018;2018;01;08;Sunnuntai;0;1;1
624;07.01.2018;2018;01;09;Sunnuntai;1;1;2
624;07.01.2018;2018;01;10;Sunnuntai;3;2;5
624;07.01.2018;2018;01;11;Sunnuntai;1;8;9
624;07.01.2018;2018;01;12;Sunnuntai;3;6;9
624;07.01.2018;2018;01;13;Sunnuntai;4;8;12
624;07.01.2018;2018;01;14;Sunnuntai;7;9;16
624;07.01.2018;2018;01;15;Sunnuntai;2;6;8
624;07.01.2018;2018;01;16;Sunnuntai;14;10;24
624;07.01.2018;2018;01;17;Sunnuntai;2;10;12
624;07.01.2018;2018;01;18;Sunnuntai;7;3;10
624;07.01.2018;2018;01;19;Sunnuntai;3;8;11
624;07.01.2018;2018;01;20;Sunnuntai;4;2;6
624;07.01.2018;2018;01;21;Sunnuntai;3;1;4
624;07.01.2018;2018;01;22;Sunnuntai;2;2;4
624;07.01.2018;2018;01;23;Sunnuntai;2;1;3
624;08.01.2018;2018;01;00;Maanantai;1;3;4
624;08.01.2018;2018;01;01;Maanantai;2;3;5
624;08.01.2018;2018;01;02;Maanantai;0;0;0
624;08.01.2018;2018;01;03;Maanantai;0;0;0
624;08.01.2018;2018;01;04;Maanantai;0;0;0
624;08.01.2018;2018;01;05;Maanantai;2;1;3
624;08.01.2018;2018;01;06;Maanantai;0;7;7
624;08.01.2018;2018;01;07;Maanantai;3;18;21
624;08.01.2018;2018;01;08;Maanantai;5;40;45
624;08.01.2018;2018;01;09;Maanantai;3;20;23
624;08.01.2018;2018;01;10;Maanantai;3;11;14
624;08.01.2018;2018;01;11;Maanantai;4;13;17
624;08.01.2018;2018;01;12;Maanantai;2;11;13
624;08.01.2018;2018;01;13;Maanantai;5;9;14
624;08.01.2018;2018;01;14;Maanantai;4;15;19
624;08.01.2018;2018;01;15;Maanantai;5;12;17
624;08.01.2018;2018;01;16;Maanantai;9;20;29
624;08.01.2018;2018;01;17;Maanantai;9;31;40
624;08.01.2018;2018;01;18;Maanantai;10;18;28
624;08.01.2018;2018;01;19;Maanantai;5;15;20
624;08.01.2018;2018;01;20;Maanantai;6;8;14
624;08.01.2018;2018;01;21;Maanantai;2;4;6
624;08.01.2018;2018;01;22;Maanantai;3;2;5
624;08.01.2018;2018;01;23;Maanantai;1;2;3
624;09.01.2018;2018;01;00;Tiistai;0;0;0
624;09.01.2018;2018;01;01;Tiistai;1;1;2
624;09.01.2018;2018;01;02;Tiistai;0;0;0
624;09.01.2018;2018;01;03;Tiistai;0;1;1
624;09.01.2018;2018;01;04;Tiistai;0;0;0
624;09.01.2018;2018;01;05;Tiistai;1;0;1
624;09.01.2018;2018;01;06;Tiistai;1;6;7
624;09.01.2018;2018;01;07;Tiistai;1;21;22
624;09.01.2018;2018;01;08;Tiistai;11;49;60
624;09.01.2018;2018;01;09;Tiistai;9;36;45
624;09.01.2018;2018;01;10;Tiistai;3;14;17
624;09.01.2018;2018;01;11;Tiistai;3;16;19
624;09.01.2018;2018;01;12;Tiistai;4;14;18
624;09.01.2018;2018;01;13;Tiistai;6;13;19
624;09.01.2018;2018;01;14;Tiistai;10;13;23
624;09.01.2018;2018;01;15;Tiistai;5;18;23
624;09.01.2018;2018;01;16;Tiistai;14;18;32
624;09.01.2018;2018;01;17;Tiistai;25;36;61
624;09.01.2018;2018;01;18;Tiistai;14;24;38
624;09.01.2018;2018;01;19;Tiistai;12;13;25
624;09.01.2018;2018;01;20;Tiistai;1;11;12
624;09.01.2018;2018;01;21;Tiistai;9;11;20
624;09.01.2018;2018;01;22;Tiistai;7;9;16
624;09.01.2018;2018;01;23;Tiistai;3;4;7
624;10.01.2018;2018;01;00;Keskiviikko;0;3;3
624;10.01.2018;2018;01;01;Keskiviikko;0;0;0
624;10.01.2018;2018;01;02;Keskiviikko;0;0;0
624;10.01.2018;2018;01;03;Keskiviikko;1;0;1
624;10.01.2018;2018;01;04;Keskiviikko;0;0;0
624;10.01.2018;2018;01;05;Keskiviikko;2;0;2
624;10.01.2018;2018;01;06;Keskiviikko;1;12;13
624;10.01.2018;2018;01;07;Keskiviikko;5;21;26
624;10.01.2018;2018;01;08;Keskiviikko;3;43;46
624;10.01.2018;2018;01;09;Keskiviikko;4;44;48
624;10.01.2018;2018;01;10;Keskiviikko;7;21;28
624;10.01.2018;2018;01;11;Keskiviikko;3;21;24
624;10.01.2018;2018;01;12;Keskiviikko;8;21;29
624;10.01.2018;2018;01;13;Keskiviikko;9;26;35
624;10.01.2018;2018;01;14;Keskiviikko;18;13;31
624;10.01.2018;2018;01;15;Keskiviikko;21;11;32
624;10.01.2018;2018;01;16;Keskiviikko;18;17;35
624;10.01.2018;2018;01;17;Keskiviikko;23;29;52
624;10.01.2018;2018;01;18;Keskiviikko;20;21;41
624;10.01.2018;2018;01;19;Keskiviikko;15;17;32
624;10.01.2018;2018;01;20;Keskiviikko;10;7;17
624;10.01.2018;2018;01;21;Keskiviikko;10;7;17
624;10.01.2018;2018;01;22;Keskiviikko;6;6;12
624;10.01.2018;2018;01;23;Keskiviikko;4;2;6
624;11.01.2018;2018;01;00;Torstai;3;3;6
624;11.01.2018;2018;01;01;Torstai;2;1;3
624;11.01.2018;2018;01;02;Torstai;0;0;0
624;11.01.2018;2018;01;03;Torstai;0;0;0
624;11.01.2018;2018;01;04;Torstai;0;1;1
624;11.01.2018;2018;01;05;Torstai;1;1;2
624;11.01.2018;2018;01;06;Torstai;2;9;11
624;11.01.2018;2018;01;07;Torstai;5;19;24
624;11.01.2018;2018;01;08;Torstai;13;44;57
624;11.01.2018;2018;01;09;Torstai;20;29;49
624;11.01.2018;2018;01;10;Torstai;10;16;26
624;11.01.2018;2018;01;11;Torstai;4;13;17
624;11.01.2018;2018;01;12;Torstai;4;10;14
624;11.01.2018;2018;01;13;Torstai;6;10;16
624;11.01.2018;2018;01;14;Torstai;12;12;24
624;11.01.2018;2018;01;15;Torstai;11;17;28
624;11.01.2018;2018;01;16;Torstai;14;16;30
624;11.01.2018;2018;01;17;Torstai;30;25;55
624;11.01.2018;2018;01;18;Torstai;17;12;29
624;11.01.2018;2018;01;19;Torstai;13;10;23
624;11.01.2018;2018;01;20;Torstai;9;6;15
624;11.01.2018;2018;01;21;Torstai;13;4;17
624;11.01.2018;2018;01;22;Torstai;3;3;6
624;11.01.2018;2018;01;23;Torstai;3;2;5
624;12.01.2018;2018;01;00;Perjantai;3;3;6
624;12.01.2018;2018;01;01;Perjantai;0;2;2
624;12.01.2018;2018;01;02;Perjantai;0;0;0
624;12.01.2018;2018;01;03;Perjantai;0;1;1
624;12.01.2018;2018;01;04;Perjantai;1;0;1
624;12.01.2018;2018;01;05;Perjantai;4;1;5
624;12.01.2018;2018;01;06;Perjantai;1;3;4
624;12.01.2018;2018;01;07;Perjantai;11;18;29
624;12.01.2018;2018;01;08;Perjantai;9;38;47
624;12.01.2018;2018;01;09;Perjantai;10;48;58
624;12.01.2018;2018;01;10;Perjantai;8;14;22
624;12.01.2018;2018;01;11;Perjantai;3;17;20
624;12.01.2018;2018;01;12;Perjantai;4;17;21
624;12.01.2018;2018;01;13;Perjantai;13;12;25
624;12.01.2018;2018;01;14;Perjantai;10;16;26
624;12.01.2018;2018;01;15;Perjantai;12;12;24
624;12.01.2018;2018;01;16;Perjantai;20;21;41
624;12.01.2018;2018;01;17;Perjantai;32;18;50
624;12.01.2018;2018;01;18;Perjantai;18;12;30
624;12.01.2018;2018;01;19;Perjantai;9;8;17
624;12.01.2018;2018;01;20;Perjantai;10;13;23
624;12.01.2018;2018;01;21;Perjantai;13;5;18
624;12.01.2018;2018;01;22;Perjantai;9;4;13
624;12.01.2018;2018;01;23;Perjantai;7;0;7
624;13.01.2018;2018;01;00;Lauantai;6;6;12
624;13.01.2018;2018;01;01;Lauantai;1;5;6
624;13.01.2018;2018;01;02;Lauantai;1;3;4
624;13.01.2018;2018;01;03;Lauantai;0;0;0
624;13.01.2018;2018;01;04;Lauantai;5;2;7
624;13.01.2018;2018;01;05;Lauantai;2;0;2
624;13.01.2018;2018;01;06;Lauantai;1;1;2
624;13.01.2018;2018;01;07;Lauantai;0;3;3
624;13.01.2018;2018;01;08;Lauantai;1;4;5
624;13.01.2018;2018;01;09;Lauantai;0;5;5
624;13.01.2018;2018;01;10;Lauantai;2;10;12
624;13.01.2018;2018;01;11;Lauantai;3;8;11
624;13.01.2018;2018;01;12;Lauantai;8;14;22
624;13.01.2018;2018;01;13;Lauantai;6;13;19
624;13.01.2018;2018;01;14;Lauantai;14;10;24
624;13.01.2018;2018;01;15;Lauantai;4;3;7
624;13.01.2018;2018;01;16;Lauantai;10;7;17
624;13.01.2018;2018;01;17;Lauantai;11;8;19
624;13.01.2018;2018;01;18;Lauantai;4;3;7
624;13.01.2018;2018;01;19;Lauantai;4;7;11
624;13.01.2018;2018;01;20;Lauantai;9;2;11
624;13.01.2018;2018;01;21;Lauantai;5;4;9
624;13.01.2018;2018;01;22;Lauantai;9;4;13
624;13.01.2018;2018;01;23;Lauantai;4;0;4
624;14.01.2018;2018;01;00;Sunnuntai;2;3;5
624;14.01.2018;2018;01;01;Sunnuntai;2;1;3
624;14.01.2018;2018;01;02;Sunnuntai;4;3;7
624;14.01.2018;2018;01;03;Sunnuntai;1;1;2
624;14.01.2018;2018;01;04;Sunnuntai;0;0;0
624;14.01.2018;2018;01;05;Sunnuntai;1;0;1
624;14.01.2018;2018;01;06;Sunnuntai;1;3;4
624;14.01.2018;2018;01;07;Sunnuntai;0;2;2
624;14.01.2018;2018;01;08;Sunnuntai;0;2;2
624;14.01.2018;2018;01;09;Sunnuntai;1;1;2
624;14.01.2018;2018;01;10;Sunnuntai;3;4;7
624;14.01.2018;2018;01;11;Sunnuntai;1;5;6
624;14.01.2018;2018;01;12;Sunnuntai;1;7;8
624;14.01.2018;2018;01;13;Sunnuntai;5;9;14
624;14.01.2018;2018;01;14;Sunnuntai;13;9;22
624;14.01.2018;2018;01;15;Sunnuntai;8;8;16
624;14.01.2018;2018;01;16;Sunnuntai;9;12;21
624;14.01.2018;2018;01;17;Sunnuntai;7;9;16
624;14.01.2018;2018;01;18;Sunnuntai;13;10;23
624;14.01.2018;2018;01;19;Sunnuntai;18;7;25
624;14.01.2018;2018;01;20;Sunnuntai;8;4;12
624;14.01.2018;2018;01;21;Sunnuntai;12;2;14
624;14.01.2018;2018;01;22;Sunnuntai;6;8;14
624;14.01.2018;2018;01;23;Sunnuntai;2;4;6
624;15.01.2018;2018;01;00;Maanantai;1;0;1
624;15.01.2018;2018;01;01;Maanantai;1;3;4
624;15.01.2018;2018;01;02;Maanantai;0;1;1
624;15.01.2018;2018;01;03;Maanantai;0;0;0
624;15.01.2018;2018;01;04;Maanantai;0;0;0
624;15.01.2018;2018;01;05;Maanantai;1;0;1
624;15.01.2018;2018;01;06;Maanantai;1;6;7
624;15.01.2018;2018;01;07;Maanantai;9;21;30
624;15.01.2018;2018;01;08;Maanantai;17;41;58
624;15.01.2018;2018;01;09;Maanantai;11;39;50
624;15.01.2018;2018;01;10;Maanantai;13;22;35
624;15.01.2018;2018;01;11;Maanantai;7;19;26
624;15.01.2018;2018;01;12;Maanantai;6;17;23
624;15.01.2018;2018;01;13;Maanantai;11;13;24
624;15.01.2018;2018;01;14;Maanantai;10;15;25
624;15.01.2018;2018;01;15;Maanantai;20;20;40
624;15.01.2018;2018;01;16;Maanantai;26;15;41
624;15.01.2018;2018;01;17;Maanantai;45;30;75
624;15.01.2018;2018;01;18;Maanantai;28;15;43
624;15.01.2018;2018;01;19;Maanantai;17;14;31
624;15.01.2018;2018;01;20;Maanantai;12;6;18
624;15.01.2018;2018;01;21;Maanantai;13;6;19
624;15.01.2018;2018;01;22;Maanantai;7;3;10
624;15.01.2018;2018;01;23;Maanantai;3;2;5
624;16.01.2018;2018;01;00;Tiistai;1;1;2
624;16.01.2018;2018;01;01;Tiistai;0;0;0
624;16.01.2018;2018;01;02;Tiistai;0;0;0
624;16.01.2018;2018;01;03;Tiistai;1;0;1
624;16.01.2018;2018;01;04;Tiistai;0;0;0
624;16.01.2018;2018;01;05;Tiistai;0;0;0
624;16.01.2018;2018;01;06;Tiistai;1;3;4
624;16.01.2018;2018;01;07;Tiistai;5;18;23
624;16.01.2018;2018;01;08;Tiistai;17;49;66
624;16.01.2018;2018;01;09;Tiistai;5;32;37
624;16.01.2018;2018;01;10;Tiistai;13;19;32
624;16.01.2018;2018;01;11;Tiistai;5;16;21
624;16.01.2018;2018;01;12;Tiistai;10;12;22
624;16.01.2018;2018;01;13;Tiistai;10;12;22
624;16.01.2018;2018;01;14;Tiistai;13;8;21
624;16.01.2018;2018;01;15;Tiistai;14;13;27
624;16.01.2018;2018;01;16;Tiistai;23;17;40
624;16.01.2018;2018;01;17;Tiistai;36;17;53
624;16.01.2018;2018;01;18;Tiistai;22;20;42
624;16.01.2018;2018;01;19;Tiistai;12;8;20
624;16.01.2018;2018;01;20;Tiistai;10;3;13
624;16.01.2018;2018;01;21;Tiistai;7;6;13
624;16.01.2018;2018;01;22;Tiistai;5;4;9
624;16.01.2018;2018;01;23;Tiistai;2;2;4
624;17.01.2018;2018;01;00;Keskiviikko;1;0;1
624;17.01.2018;2018;01;01;Keskiviikko;1;1;2
624;17.01.2018;2018;01;02;Keskiviikko;0;0;0
624;17.01.2018;2018;01;03;Keskiviikko;1;1;2
624;17.01.2018;2018;01;04;Keskiviikko;0;0;0
624;17.01.2018;2018;01;05;Keskiviikko;2;0;2
624;17.01.2018;2018;01;06;Keskiviikko;4;8;12
624;17.01.2018;2018;01;07;Keskiviikko;2;16;18
624;17.01.2018;2018;01;08;Keskiviikko;13;36;49
624;17.01.2018;2018;01;09;Keskiviikko;12;32;44
624;17.01.2018;2018;01;10;Keskiviikko;5;9;14
624;17.01.2018;2018;01;11;Keskiviikko;2;17;19
624;17.01.2018;2018;01;12;Keskiviikko;7;12;19
624;17.01.2018;2018;01;13;Keskiviikko;16;15;31
624;17.01.2018;2018;01;14;Keskiviikko;8;16;24
624;17.01.2018;2018;01;15;Keskiviikko;16;13;29
624;17.01.2018;2018;01;16;Keskiviikko;21;15;36
624;17.01.2018;2018;01;17;Keskiviikko;22;25;47
624;17.01.2018;2018;01;18;Keskiviikko;16;17;33
624;17.01.2018;2018;01;19;Keskiviikko;8;9;17
624;17.01.2018;2018;01;20;Keskiviikko;16;8;24
624;17.01.2018;2018;01;21;Keskiviikko;8;5;13
624;17.01.2018;2018;01;22;Keskiviikko;11;7;18
624;17.01.2018;2018;01;23;Keskiviikko;4;5;9
624;18.01.2018;2018;01;00;Torstai;0;2;2
624;18.01.2018;2018;01;01;Torstai;1;5;6
624;18.01.2018;2018;01;02;Torstai;1;1;2
624;18.01.2018;2018;01;03;Torstai;1;2;3
624;18.01.2018;2018;01;04;Torstai;0;0;0
624;18.01.2018;2018;01;05;Torstai;1;0;1
624;18.01.2018;2018;01;06;Torstai;1;6;7
624;18.01.2018;2018;01;07;Torstai;3;27;30
624;18.01.2018;2018;01;08;Torstai;14;39;53
624;18.01.2018;2018;01;09;Torstai;16;36;52
624;18.01.2018;2018;01;10;Torstai;9;15;24
624;18.01.2018;2018;01;11;Torstai;5;4;9
624;18.01.2018;2018;01;12;Torstai;11;16;27
624;18.01.2018;2018;01;13;Torstai;6;13;19
624;18.01.2018;2018;01;14;Torstai;7;10;17
624;18.01.2018;2018;01;15;Torstai;10;15;25
624;18.01.2018;2018;01;16;Torstai;34;22;56
624;18.01.2018;2018;01;17;Torstai;37;22;59
624;18.01.2018;2018;01;18;Torstai;19;14;33
624;18.01.2018;2018;01;19;Torstai;15;17;32
624;18.01.2018;2018;01;20;Torstai;13;13;26
624;18.01.2018;2018;01;21;Torstai;12;3;15
624;18.01.2018;2018;01;22;Torstai;8;4;12
624;18.01.2018;2018;01;23;Torstai;3;8;11
624;19.01.2018;2018;01;00;Perjantai;2;1;3
624;19.01.2018;2018;01;01;Perjantai;0;2;2
624;19.01.2018;2018;01;02;Perjantai;1;2;3
624;19.01.2018;2018;01;03;Perjantai;0;1;1
624;19.01.2018;2018;01;04;Perjantai;1;1;2
624;19.01.2018;2018;01;05;Perjantai;2;2;4
624;19.01.2018;2018;01;06;Perjantai;2;5;7
624;19.01.2018;2018;01;07;Perjantai;4;17;21
624;19.01.2018;2018;01;08;Perjantai;10;43;53
624;19.01.2018;2018;01;09;Perjantai;14;39;53
624;19.01.2018;2018;01;10;Perjantai;5;14;19
624;19.01.2018;2018;01;11;Perjantai;4;11;15
624;19.01.2018;2018;01;12;Perjantai;8;13;21
624;19.01.2018;2018;01;13;Perjantai;12;10;22
624;19.01.2018;2018;01;14;Perjantai;12;19;31
624;19.01.2018;2018;01;15;Perjantai;16;21;37
624;19.01.2018;2018;01;16;Perjantai;22;14;36
624;19.01.2018;2018;01;17;Perjantai;22;14;36
624;19.01.2018;2018;01;18;Perjantai;20;13;33
624;19.01.2018;2018;01;19;Perjantai;12;11;23
624;19.01.2018;2018;01;20;Perjantai;5;5;10
624;19.01.2018;2018;01;21;Perjantai;7;7;14
624;19.01.2018;2018;01;22;Perjantai;7;3;10
624;19.01.2018;2018;01;23;Perjantai;0;2;2
624;20.01.2018;2018;01;00;Lauantai;2;4;6
624;20.01.2018;2018;01;01;Lauantai;2;2;4
624;20.01.2018;2018;01;02;Lauantai;1;0;1
624;20.01.2018;2018;01;03;Lauantai;1;0;1
624;20.01.2018;2018;01;04;Lauantai;1;0;1
624;20.01.2018;2018;01;05;Lauantai;3;1;4
624;20.01.2018;2018;01;06;Lauantai;0;0;0
624;20.01.2018;2018;01;07;Lauantai;0;4;4
624;20.01.2018;2018;01;08;Lauantai;0;1;1
624;20.01.2018;2018;01;09;Lauantai;2;6;8
624;20.01.2018;2018;01;10;Lauantai;1;3;4
624;20.01.2018;2018;01;11;Lauantai;4;4;8
624;20.01.2018;2018;01;12;Lauantai;2;7;9
624;20.01.2018;2018;01;13;Lauantai;3;6;9
624;20.01.2018;2018;01;14;Lauantai;8;5;13
624;20.01.2018;2018;01;15;Lauantai;6;6;12
624;20.01.2018;2018;01;16;Lauantai;9;7;16
624;20.01.2018;2018;01;17;Lauantai;8;9;17
624;20.01.2018;2018;01;18;Lauantai;1;1;2
624;20.01.2018;2018;01;19;Lauantai;4;5;9
624;20.01.2018;2018;01;20;Lauantai;8;5;13
624;20.01.2018;2018;01;21;Lauantai;4;4;8
624;20.01.2018;2018;01;22;Lauantai;13;3;16
624;20.01.2018;2018;01;23;Lauantai;2;1;3
624;21.01.2018;2018;01;00;Sunnuntai;2;0;2
624;21.01.2018;2018;01;01;Sunnuntai;3;2;5
624;21.01.2018;2018;01;02;Sunnuntai;0;0;0
624;21.01.2018;2018;01;03;Sunnuntai;0;2;2
624;21.01.2018;2018;01;04;Sunnuntai;4;1;5
624;21.01.2018;2018;01;05;Sunnuntai;2;0;2
624;21.01.2018;2018;01;06;Sunnuntai;1;2;3
624;21.01.2018;2018;01;07;Sunnuntai;2;4;6
624;21.01.2018;2018;01;08;Sunnuntai;0;1;1
624;21.01.2018;2018;01;09;Sunnuntai;0;0;0
624;21.01.2018;2018;01;10;Sunnuntai;2;0;2
624;21.01.2018;2018;01;11;Sunnuntai;2;3;5
624;21.01.2018;2018;01;12;Sunnuntai;1;2;3
624;21.01.2018;2018;01;13;Sunnuntai;3;7;10
624;21.01.2018;2018;01;14;Sunnuntai;7;12;19
624;21.01.2018;2018;01;15;Sunnuntai;1;7;8
624;21.01.2018;2018;01;16;Sunnuntai;6;8;14
624;21.01.2018;2018;01;17;Sunnuntai;3;4;7
624;21.01.2018;2018;01;18;Sunnuntai;3;5;8
624;21.01.2018;2018;01;19;Sunnuntai;4;2;6
624;21.01.2018;2018;01;20;Sunnuntai;2;2;4
624;21.01.2018;2018;01;21;Sunnuntai;6;1;7
624;21.01.2018;2018;01;22;Sunnuntai;9;3;12
624;21.01.2018;2018;01;23;Sunnuntai;4;3;7
624;22.01.2018;2018;01;00;Maanantai;0;2;2
624;22.01.2018;2018;01;01;Maanantai;4;0;4
624;22.01.2018;2018;01;02;Maanantai;0;0;0
624;22.01.2018;2018;01;03;Maanantai;0;2;2
624;22.01.2018;2018;01;04;Maanantai;0;0;0
624;22.01.2018;2018;01;05;Maanantai;0;0;0
624;22.01.2018;2018;01;06;Maanantai;0;4;4
624;22.01.2018;2018;01;07;Maanantai;2;14;16
624;22.01.2018;2018;01;08;Maanantai;5;30;35
624;22.01.2018;2018;01;09;Maanantai;8;33;41
624;22.01.2018;2018;01;10;Maanantai;4;10;14
624;22.01.2018;2018;01;11;Maanantai;4;10;14
624;22.01.2018;2018;01;12;Maanantai;5;7;12
624;22.01.2018;2018;01;13;Maanantai;8;10;18
624;22.01.2018;2018;01;14;Maanantai;4;7;11
624;22.01.2018;2018;01;15;Maanantai;10;7;17
624;22.01.2018;2018;01;16;Maanantai;17;9;26
624;22.01.2018;2018;01;17;Maanantai;38;18;56
624;22.01.2018;2018;01;18;Maanantai;15;7;22
624;22.01.2018;2018;01;19;Maanantai;18;9;27
624;22.01.2018;2018;01;20;Maanantai;9;7;16
624;22.01.2018;2018;01;21;Maanantai;7;2;9
624;22.01.2018;2018;01;22;Maanantai;8;0;8
624;22.01.2018;2018;01;23;Maanantai;2;2;4
624;23.01.2018;2018;01;00;Tiistai;0;1;1
624;23.01.2018;2018;01;01;Tiistai;0;0;0
624;23.01.2018;2018;01;02;Tiistai;0;0;0
624;23.01.2018;2018;01;03;Tiistai;0;1;1
624;23.01.2018;2018;01;04;Tiistai;0;0;0
624;23.01.2018;2018;01;05;Tiistai;0;0;0
624;23.01.2018;2018;01;06;Tiistai;3;6;9
624;23.01.2018;2018;01;07;Tiistai;2;11;13
624;23.01.2018;2018;01;08;Tiistai;12;35;47
624;23.01.2018;2018;01;09;Tiistai;10;31;41
624;23.01.2018;2018;01;10;Tiistai;9;13;22
624;23.01.2018;2018;01;11;Tiistai;5;9;14
624;23.01.2018;2018;01;12;Tiistai;7;5;12
624;23.01.2018;2018;01;13;Tiistai;0;8;8
624;23.01.2018;2018;01;14;Tiistai;10;12;22
624;23.01.2018;2018;01;15;Tiistai;6;7;13
624;23.01.2018;2018;01;16;Tiistai;6;9;15
624;23.01.2018;2018;01;17;Tiistai;14;13;27
624;23.01.2018;2018;01;18;Tiistai;18;12;30
624;23.01.2018;2018;01;19;Tiistai;14;9;23
624;23.01.2018;2018;01;20;Tiistai;5;5;10
624;23.01.2018;2018;01;21;Tiistai;9;3;12
624;23.01.2018;2018;01;22;Tiistai;5;0;5
624;23.01.2018;2018;01;23;Tiistai;5;2;7
624;24.01.2018;2018;01;00;Keskiviikko;0;0;0
624;24.01.2018;2018;01;01;Keskiviikko;1;0;1
624;24.01.2018;2018;01;02;Keskiviikko;0;0;0
624;24.01.2018;2018;01;03;Keskiviikko;0;1;1
624;24.01.2018;2018;01;04;Keskiviikko;1;0;1
624;24.01.2018;2018;01;05;Keskiviikko;2;0;2
624;24.01.2018;2018;01;06;Keskiviikko;3;10;13
624;24.01.2018;2018;01;07;Keskiviikko;4;13;17
624;24.01.2018;2018;01;08;Keskiviikko;10;40;50
624;24.01.2018;2018;01;09;Keskiviikko;10;39;49
624;24.01.2018;2018;01;10;Keskiviikko;5;22;27
624;24.01.2018;2018;01;11;Keskiviikko;7;12;19
624;24.01.2018;2018;01;12;Keskiviikko;5;12;17
624;24.01.2018;2018;01;13;Keskiviikko;2;11;13
624;24.01.2018;2018;01;14;Keskiviikko;14;7;21
624;24.01.2018;2018;01;15;Keskiviikko;17;7;24
624;24.01.2018;2018;01;16;Keskiviikko;19;14;33
624;24.01.2018;2018;01;17;Keskiviikko;42;19;61
624;24.01.2018;2018;01;18;Keskiviikko;15;10;25
624;24.01.2018;2018;01;19;Keskiviikko;9;5;14
624;24.01.2018;2018;01;20;Keskiviikko;9;11;20
624;24.01.2018;2018;01;21;Keskiviikko;6;2;8
624;24.01.2018;2018;01;22;Keskiviikko;8;2;10
624;24.01.2018;2018;01;23;Keskiviikko;5;1;6
624;25.01.2018;2018;01;00;Torstai;1;0;1
624;25.01.2018;2018;01;01;Torstai;1;0;1
624;25.01.2018;2018;01;02;Torstai;0;0;0
624;25.01.2018;2018;01;03;Torstai;0;0;0
624;25.01.2018;2018;01;04;Torstai;0;0;0
624;25.01.2018;2018;01;05;Torstai;1;1;2
624;25.01.2018;2018;01;06;Torstai;2;4;6
624;25.01.2018;2018;01;07;Torstai;1;12;13
624;25.01.2018;2018;01;08;Torstai;12;26;38
624;25.01.2018;2018;01;09;Torstai;7;22;29
624;25.01.2018;2018;01;10;Torstai;2;19;21
624;25.01.2018;2018;01;11;Torstai;3;6;9
624;25.01.2018;2018;01;12;Torstai;1;11;12
624;25.01.2018;2018;01;13;Torstai;4;7;11
624;25.01.2018;2018;01;14;Torstai;5;4;9
624;25.01.2018;2018;01;15;Torstai;10;10;20
624;25.01.2018;2018;01;16;Torstai;14;15;29
624;25.01.2018;2018;01;17;Torstai;16;11;27
624;25.01.2018;2018;01;18;Torstai;5;13;18
624;25.01.2018;2018;01;19;Torstai;6;6;12
624;25.01.2018;2018;01;20;Torstai;2;5;7
624;25.01.2018;2018;01;21;Torstai;3;1;4
624;25.01.2018;2018;01;22;Torstai;1;3;4
624;25.01.2018;2018;01;23;Torstai;1;2;3
624;26.01.2018;2018;01;00;Perjantai;0;0;0
624;26.01.2018;2018;01;01;Perjantai;0;1;1
624;26.01.2018;2018;01;02;Perjantai;0;1;1
624;26.01.2018;2018;01;03;Perjantai;0;1;1
624;26.01.2018;2018;01;04;Perjantai;2;0;2
624;26.01.2018;2018;01;05;Perjantai;0;1;1
624;26.01.2018;2018;01;06;Perjantai;1;7;8
624;26.01.2018;2018;01;07;Perjantai;2;16;18
624;26.01.2018;2018;01;08;Perjantai;5;27;32
624;26.01.2018;2018;01;09;Perjantai;9;25;34
624;26.01.2018;2018;01;10;Perjantai;5;15;20
624;26.01.2018;2018;01;11;Perjantai;6;11;17
624;26.01.2018;2018;01;12;Perjantai;6;12;18
624;26.01.2018;2018;01;13;Perjantai;5;8;13
624;26.01.2018;2018;01;14;Perjantai;8;13;21
624;26.01.2018;2018;01;15;Perjantai;17;16;33
624;26.01.2018;2018;01;16;Perjantai;14;14;28
624;26.01.2018;2018;01;17;Perjantai;16;15;31
624;26.01.2018;2018;01;18;Perjantai;6;14;20
624;26.01.2018;2018;01;19;Perjantai;3;6;9
624;26.01.2018;2018;01;20;Perjantai;4;10;14
624;26.01.2018;2018;01;21;Perjantai;7;4;11
624;26.01.2018;2018;01;22;Perjantai;3;2;5
624;26.01.2018;2018;01;23;Perjantai;0;2;2
624;27.01.2018;2018;01;00;Lauantai;5;2;7
624;27.01.2018;2018;01;01;Lauantai;1;3;4
624;27.01.2018;2018;01;02;Lauantai;1;1;2
624;27.01.2018;2018;01;03;Lauantai;2;1;3
624;27.01.2018;2018;01;04;Lauantai;0;0;0
624;27.01.2018;2018;01;05;Lauantai;0;3;3
624;27.01.2018;2018;01;06;Lauantai;0;1;1
624;27.01.2018;2018;01;07;Lauantai;0;3;3
624;27.01.2018;2018;01;08;Lauantai;1;4;5
624;27.01.2018;2018;01;09;Lauantai;2;0;2
624;27.01.2018;2018;01;10;Lauantai;1;7;8
624;27.01.2018;2018;01;11;Lauantai;3;10;13
624;27.01.2018;2018;01;12;Lauantai;2;7;9
624;27.01.2018;2018;01;13;Lauantai;7;9;16
624;27.01.2018;2018;01;14;Lauantai;6;13;19
624;27.01.2018;2018;01;15;Lauantai;12;12;24
624;27.01.2018;2018;01;16;Lauantai;8;12;20
624;27.01.2018;2018;01;17;Lauantai;5;4;9
624;27.01.2018;2018;01;18;Lauantai;7;2;9
624;27.01.2018;2018;01;19;Lauantai;3;3;6
624;27.01.2018;2018;01;20;Lauantai;6;4;10
624;27.01.2018;2018;01;21;Lauantai;4;3;7
624;27.01.2018;2018;01;22;Lauantai;5;4;9
624;27.01.2018;2018;01;23;Lauantai;2;1;3
624;28.01.2018;2018;01;00;Sunnuntai;3;1;4
624;28.01.2018;2018;01;01;Sunnuntai;1;2;3
624;28.01.2018;2018;01;02;Sunnuntai;2;0;2
624;28.01.2018;2018;01;03;Sunnuntai;1;0;1
624;28.01.2018;2018;01;04;Sunnuntai;0;2;2
624;28.01.2018;2018;01;05;Sunnuntai;1;0;1
624;28.01.2018;2018;01;06;Sunnuntai;0;0;0
624;28.01.2018;2018;01;07;Sunnuntai;1;5;6
624;28.01.2018;2018;01;08;Sunnuntai;2;1;3
624;28.01.2018;2018;01;09;Sunnuntai;1;1;2
624;28.01.2018;2018;01;10;Sunnuntai;1;1;2
624;28.01.2018;2018;01;11;Sunnuntai;1;5;6
624;28.01.2018;2018;01;12;Sunnuntai;3;4;7
624;28.01.2018;2018;01;13;Sunnuntai;3;10;13
624;28.01.2018;2018;01;14;Sunnuntai;6;7;13
624;28.01.2018;2018;01;15;Sunnuntai;7;9;16
624;28.01.2018;2018;01;16;Sunnuntai;5;8;13
624;28.01.2018;2018;01;17;Sunnuntai;7;5;12
624;28.01.2018;2018;01;18;Sunnuntai;5;9;14
624;28.01.2018;2018;01;19;Sunnuntai;6;4;10
624;28.01.2018;2018;01;20;Sunnuntai;7;3;10
624;28.01.2018;2018;01;21;Sunnuntai;5;1;6
624;28.01.2018;2018;01;22;Sunnuntai;7;1;8
624;28.01.2018;2018;01;23;Sunnuntai;5;3;8
624;29.01.2018;2018;01;00;Maanantai;1;1;2
624;29.01.2018;2018;01;01;Maanantai;3;1;4
624;29.01.2018;2018;01;02;Maanantai;0;0;0
624;29.01.2018;2018;01;03;Maanantai;0;0;0
624;29.01.2018;2018;01;04;Maanantai;0;0;0
624;29.01.2018;2018;01;05;Maanantai;2;0;2
624;29.01.2018;2018;01;06;Maanantai;3;7;10
624;29.01.2018;2018;01;07;Maanantai;4;21;25
624;29.01.2018;2018;01;08;Maanantai;4;34;38
624;29.01.2018;2018;01;09;Maanantai;7;27;34
624;29.01.2018;2018;01;10;Maanantai;5;15;20
624;29.01.2018;2018;01;11;Maanantai;1;16;17
624;29.01.2018;2018;01;12;Maanantai;4;12;16
624;29.01.2018;2018;01;13;Maanantai;4;14;18
624;29.01.2018;2018;01;14;Maanantai;4;10;14
624;29.01.2018;2018;01;15;Maanantai;4;5;9
624;29.01.2018;2018;01;16;Maanantai;6;13;19
624;29.01.2018;2018;01;17;Maanantai;12;25;37
624;29.01.2018;2018;01;18;Maanantai;12;20;32
624;29.01.2018;2018;01;19;Maanantai;4;9;13
624;29.01.2018;2018;01;20;Maanantai;7;11;18
624;29.01.2018;2018;01;21;Maanantai;5;7;12
624;29.01.2018;2018;01;22;Maanantai;2;2;4
624;29.01.2018;2018;01;23;Maanantai;1;4;5
624;30.01.2018;2018;01;00;Tiistai;1;0;1
624;30.01.2018;2018;01;01;Tiistai;0;0;0
624;30.01.2018;2018;01;02;Tiistai;0;0;0
624;30.01.2018;2018;01;03;Tiistai;0;0;0
624;30.01.2018;2018;01;04;Tiistai;2;0;2
624;30.01.2018;2018;01;05;Tiistai;0;0;0
624;30.01.2018;2018;01;06;Tiistai;2;10;12
624;30.01.2018;2018;01;07;Tiistai;5;27;32
624;30.01.2018;2018;01;08;Tiistai;15;39;54
624;30.01.2018;2018;01;09;Tiistai;12;32;44
624;30.01.2018;2018;01;10;Tiistai;3;18;21
624;30.01.2018;2018;01;11;Tiistai;2;9;11
624;30.01.2018;2018;01;12;Tiistai;1;11;12
624;30.01.2018;2018;01;13;Tiistai;7;6;13
624;30.01.2018;2018;01;14;Tiistai;4;9;13
624;30.01.2018;2018;01;15;Tiistai;6;14;20
624;30.01.2018;2018;01;16;Tiistai;0;13;13
624;30.01.2018;2018;01;17;Tiistai;11;24;35
624;30.01.2018;2018;01;18;Tiistai;10;11;21
624;30.01.2018;2018;01;19;Tiistai;5;10;15
624;30.01.2018;2018;01;20;Tiistai;8;12;20
624;30.01.2018;2018;01;21;Tiistai;2;8;10
624;30.01.2018;2018;01;22;Tiistai;4;4;8
624;30.01.2018;2018;01;23;Tiistai;2;3;5
624;31.01.2018;2018;01;00;Keskiviikko;1;3;4
624;31.01.2018;2018;01;01;Keskiviikko;0;0;0
624;31.01.2018;2018;01;02;Keskiviikko;0;0;0
624;31.01.2018;2018;01;03;Keskiviikko;0;1;1
624;31.01.2018;2018;01;04;Keskiviikko;0;0;0
624;31.01.2018;2018;01;05;Keskiviikko;1;0;1
624;31.01.2018;2018;01;06;Keskiviikko;1;8;9
624;31.01.2018;2018;01;07;Keskiviikko;3;11;14
624;31.01.2018;2018;01;08;Keskiviikko;3;39;42
624;31.01.2018;2018;01;09;Keskiviikko;5;32;37
624;31.01.2018;2018;01;10;Keskiviikko;2;13;15
624;31.01.2018;2018;01;11;Keskiviikko;1;5;6
624;31.01.2018;2018;01;12;Keskiviikko;4;12;16
624;31.01.2018;2018;01;13;Keskiviikko;10;18;28
624;31.01.2018;2018;01;14;Keskiviikko;9;6;15
624;31.01.2018;2018;01;15;Keskiviikko;16;11;27
624;31.01.2018;2018;01;16;Keskiviikko;8;22;30
624;31.01.2018;2018;01;17;Keskiviikko;36;32;68
624;31.01.2018;2018;01;18;Keskiviikko;15;8;23
624;31.01.2018;2018;01;19;Keskiviikko;12;11;23
624;31.01.2018;2018;01;20;Keskiviikko;10;7;17
624;31.01.2018;2018;01;21;Keskiviikko;15;7;22
624;31.01.2018;2018;01;22;Keskiviikko;3;1;4
624;31.01.2018;2018;01;23;Keskiviikko;1;6;7
624;01.02.2018;2018;02;00;Torstai;1;1;2
624;01.02.2018;2018;02;01;Torstai;1;0;1
624;01.02.2018;2018;02;02;Torstai;0;1;1
624;01.02.2018;2018;02;03;Torstai;0;1;1
624;01.02.2018;2018;02;04;Torstai;0;0;0
624;01.02.2018;2018;02;05;Torstai;3;0;3
624;01.02.2018;2018;02;06;Torstai;1;7;8
624;01.02.2018;2018;02;07;Torstai;6;12;18
624;01.02.2018;2018;02;08;Torstai;6;22;28
624;01.02.2018;2018;02;09;Torstai;12;29;41
624;01.02.2018;2018;02;10;Torstai;6;9;15
624;01.02.2018;2018;02;11;Torstai;3;6;9
624;01.02.2018;2018;02;12;Torstai;5;11;16
624;01.02.2018;2018;02;13;Torstai;4;8;12
624;01.02.2018;2018;02;14;Torstai;8;13;21
624;01.02.2018;2018;02;15;Torstai;8;8;16
624;01.02.2018;2018;02;16;Torstai;12;8;20
624;01.02.2018;2018;02;17;Torstai;36;32;68
624;01.02.2018;2018;02;18;Torstai;15;8;23
624;01.02.2018;2018;02;19;Torstai;12;11;23
624;01.02.2018;2018;02;20;Torstai;10;7;17
624;01.02.2018;2018;02;21;Torstai;15;7;22
624;01.02.2018;2018;02;22;Torstai;3;1;4
624;01.02.2018;2018;02;23;Torstai;1;6;7
624;02.02.2018;2018;02;00;Perjantai;1;3;4
624;02.02.2018;2018;02;01;Perjantai;0;0;0
624;02.02.2018;2018;02;02;Perjantai;0;0;0
624;02.02.2018;2018;02;03;Perjantai;0;1;1
624;02.02.2018;2018;02;04;Perjantai;0;0;0
624;02.02.2018;2018;02;05;Perjantai;1;0;1
624;02.02.2018;2018;02;06;Perjantai;1;8;9
624;02.02.2018;2018;02;07;Perjantai;3;11;14
624;02.02.2018;2018;02;08;Perjantai;3;39;42
624;02.02.2018;2018;02;09;Perjantai;5;32;37
624;02.02.2018;2018;02;10;Perjantai;2;13;15
624;02.02.2018;2018;02;11;Perjantai;1;5;6
624;02.02.2018;2018;02;12;Perjantai;4;12;16
624;02.02.2018;2018;02;13;Perjantai;10;18;28
624;02.02.2018;2018;02;14;Perjantai;9;6;15
624;02.02.2018;2018;02;15;Perjantai;16;11;27
624;02.02.2018;2018;02;16;Perjantai;19;12;31
624;02.02.2018;2018;02;17;Perjantai;17;13;30
624;02.02.2018;2018;02;18;Perjantai;15;4;19
624;02.02.2018;2018;02;19;Perjantai;12;12;24
624;02.02.2018;2018;02;20;Perjantai;6;5;11
624;02.02.2018;2018;02;21;Perjantai;7;4;11
624;02.02.2018;2018;02;22;Perjantai;6;5;11
624;02.02.2018;2018;02;23;Perjantai;4;3;7
624;03.02.2018;2018;02;00;Lauantai;0;3;3
624;03.02.2018;2018;02;01;Lauantai;1;4;5
624;03.02.2018;2018;02;02;Lauantai;0;0;0
624;03.02.2018;2018;02;03;Lauantai;1;1;2
624;03.02.2018;2018;02;04;Lauantai;0;0;0
624;03.02.2018;2018;02;05;Lauantai;0;1;1
624;03.02.2018;2018;02;06;Lauantai;1;2;3
624;03.02.2018;2018;02;07;Lauantai;1;1;2
624;03.02.2018;2018;02;08;Lauantai;3;1;4
624;03.02.2018;2018;02;09;Lauantai;1;3;4
624;03.02.2018;2018;02;10;Lauantai;1;5;6
624;03.02.2018;2018;02;11;Lauantai;1;2;3
624;03.02.2018;2018;02;12;Lauantai;0;6;6
624;03.02.2018;2018;02;13;Lauantai;2;7;9
624;03.02.2018;2018;02;14;Lauantai;3;6;9
624;03.02.2018;2018;02;15;Lauantai;5;6;11
624;03.02.2018;2018;02;16;Lauantai;8;2;10
624;03.02.2018;2018;02;17;Lauantai;5;8;13
624;03.02.2018;2018;02;18;Lauantai;3;7;10
624;03.02.2018;2018;02;19;Lauantai;5;6;11
624;03.02.2018;2018;02;20;Lauantai;5;3;8
624;03.02.2018;2018;02;21;Lauantai;1;1;2
624;03.02.2018;2018;02;22;Lauantai;8;1;9
624;03.02.2018;2018;02;23;Lauantai;1;1;2
624;04.02.2018;2018;02;00;Sunnuntai;2;2;4
624;04.02.2018;2018;02;01;Sunnuntai;0;4;4
624;04.02.2018;2018;02;02;Sunnuntai;3;1;4
624;04.02.2018;2018;02;03;Sunnuntai;0;4;4
624;04.02.2018;2018;02;04;Sunnuntai;3;0;3
624;04.02.2018;2018;02;05;Sunnuntai;3;0;3
624;04.02.2018;2018;02;06;Sunnuntai;0;2;2
624;04.02.2018;2018;02;07;Sunnuntai;0;3;3
624;04.02.2018;2018;02;08;Sunnuntai;0;1;1
624;04.02.2018;2018;02;09;Sunnuntai;1;0;1
624;04.02.2018;2018;02;10;Sunnuntai;1;2;3
624;04.02.2018;2018;02;11;Sunnuntai;0;2;2
624;04.02.2018;2018;02;12;Sunnuntai;3;4;7
624;04.02.2018;2018;02;13;Sunnuntai;1;2;3
624;04.02.2018;2018;02;14;Sunnuntai;3;9;12
624;04.02.2018;2018;02;15;Sunnuntai;1;7;8
624;04.02.2018;2018;02;16;Sunnuntai;2;4;6
624;04.02.2018;2018;02;17;Sunnuntai;3;8;11
624;04.02.2018;2018;02;18;Sunnuntai;6;5;11
624;04.02.2018;2018;02;19;Sunnuntai;6;2;8
624;04.02.2018;2018;02;20;Sunnuntai;3;4;7
624;04.02.2018;2018;02;21;Sunnuntai;1;2;3
624;04.02.2018;2018;02;22;Sunnuntai;2;0;2
624;04.02.2018;2018;02;23;Sunnuntai;2;2;4
624;05.02.2018;2018;02;00;Maanantai;0;2;2
624;05.02.2018;2018;02;01;Maanantai;1;1;2
624;05.02.2018;2018;02;02;Maanantai;0;0;0
624;05.02.2018;2018;02;03;Maanantai;0;1;1
624;05.02.2018;2018;02;04;Maanantai;0;0;0
624;05.02.2018;2018;02;05;Maanantai;1;0;1
624;05.02.2018;2018;02;06;Maanantai;2;3;5
624;05.02.2018;2018;02;07;Maanantai;7;16;23
624;05.02.2018;2018;02;08;Maanantai;7;29;36
624;05.02.2018;2018;02;09;Maanantai;6;20;26
624;05.02.2018;2018;02;10;Maanantai;4;6;10
624;05.02.2018;2018;02;11;Maanantai;2;4;6
624;05.02.2018;2018;02;12;Maanantai;3;2;5
624;05.02.2018;2018;02;13;Maanantai;4;7;11
624;05.02.2018;2018;02;14;Maanantai;2;5;7
624;05.02.2018;2018;02;15;Maanantai;5;7;12
624;05.02.2018;2018;02;16;Maanantai;13;8;21
624;05.02.2018;2018;02;17;Maanantai;14;17;31
624;05.02.2018;2018;02;18;Maanantai;9;8;17
624;05.02.2018;2018;02;19;Maanantai;4;5;9
624;05.02.2018;2018;02;20;Maanantai;4;5;9
624;05.02.2018;2018;02;21;Maanantai;7;0;7
624;05.02.2018;2018;02;22;Maanantai;11;3;14
624;05.02.2018;2018;02;23;Maanantai;2;1;3
624;06.02.2018;2018;02;00;Tiistai;1;0;1
624;06.02.2018;2018;02;01;Tiistai;0;0;0
624;06.02.2018;2018;02;02;Tiistai;0;1;1
624;06.02.2018;2018;02;03;Tiistai;0;1;1
624;06.02.2018;2018;02;04;Tiistai;0;0;0
624;06.02.2018;2018;02;05;Tiistai;1;0;1
624;06.02.2018;2018;02;06;Tiistai;2;6;8
624;06.02.2018;2018;02;07;Tiistai;5;16;21
624;06.02.2018;2018;02;08;Tiistai;6;23;29
624;06.02.2018;2018;02;09;Tiistai;10;16;26
624;06.02.2018;2018;02;10;Tiistai;5;7;12
624;06.02.2018;2018;02;11;Tiistai;3;4;7
624;06.02.2018;2018;02;12;Tiistai;1;5;6
624;06.02.2018;2018;02;13;Tiistai;7;12;19
624;06.02.2018;2018;02;14;Tiistai;7;7;14
624;06.02.2018;2018;02;15;Tiistai;16;9;25
624;06.02.2018;2018;02;16;Tiistai;8;13;21
624;06.02.2018;2018;02;17;Tiistai;10;17;27
624;06.02.2018;2018;02;18;Tiistai;10;12;22
624;06.02.2018;2018;02;19;Tiistai;9;11;20
624;06.02.2018;2018;02;20;Tiistai;8;7;15
624;06.02.2018;2018;02;21;Tiistai;7;6;13
624;06.02.2018;2018;02;22;Tiistai;1;1;2
624;06.02.2018;2018;02;23;Tiistai;3;2;5
624;07.02.2018;2018;02;00;Keskiviikko;1;3;4
624;07.02.2018;2018;02;01;Keskiviikko;0;1;1
624;07.02.2018;2018;02;02;Keskiviikko;0;0;0
624;07.02.2018;2018;02;03;Keskiviikko;0;0;0
624;07.02.2018;2018;02;04;Keskiviikko;1;0;1
624;07.02.2018;2018;02;05;Keskiviikko;0;0;0
624;07.02.2018;2018;02;06;Keskiviikko;3;3;6
624;07.02.2018;2018;02;07;Keskiviikko;8;12;20
624;07.02.2018;2018;02;08;Keskiviikko;11;29;40
624;07.02.2018;2018;02;09;Keskiviikko;16;27;43
624;07.02.2018;2018;02;10;Keskiviikko;12;7;19
624;07.02.2018;2018;02;11;Keskiviikko;9;5;14
624;07.02.2018;2018;02;12;Keskiviikko;7;9;16
624;07.02.2018;2018;02;13;Keskiviikko;8;8;16
624;07.02.2018;2018;02;14;Keskiviikko;15;7;22
624;07.02.2018;2018;02;15;Keskiviikko;18;14;32
624;07.02.2018;2018;02;16;Keskiviikko;21;11;32
624;07.02.2018;2018;02;17;Keskiviikko;37;16;53
624;07.02.2018;2018;02;18;Keskiviikko;27;8;35
624;07.02.2018;2018;02;19;Keskiviikko;12;9;21
624;07.02.2018;2018;02;20;Keskiviikko;10;3;13
624;07.02.2018;2018;02;21;Keskiviikko;11;4;15
624;07.02.2018;2018;02;22;Keskiviikko;5;4;9
624;07.02.2018;2018;02;23;Keskiviikko;3;1;4
624;08.02.2018;2018;02;00;Torstai;0;2;2
624;08.02.2018;2018;02;01;Torstai;1;0;1
624;08.02.2018;2018;02;02;Torstai;0;0;0
624;08.02.2018;2018;02;03;Torstai;0;1;1
624;08.02.2018;2018;02;04;Torstai;0;0;0
624;08.02.2018;2018;02;05;Torstai;0;1;1
624;08.02.2018;2018;02;06;Torstai;1;4;5
624;08.02.2018;2018;02;07;Torstai;6;14;20
624;08.02.2018;2018;02;08;Torstai;10;23;33
624;08.02.2018;2018;02;09;Torstai;19;16;35
624;08.02.2018;2018;02;10;Torstai;6;8;14
624;08.02.2018;2018;02;11;Torstai;5;7;12
624;08.02.2018;2018;02;12;Torstai;15;8;23
624;08.02.2018;2018;02;13;Torstai;9;7;16
624;08.02.2018;2018;02;14;Torstai;15;7;22
624;08.02.2018;2018;02;15;Torstai;11;6;17
624;08.02.2018;2018;02;16;Torstai;30;13;43
624;08.02.2018;2018;02;17;Torstai;40;15;55
624;08.02.2018;2018;02;18;Torstai;19;8;27
624;08.02.2018;2018;02;19;Torstai;16;8;24
624;08.02.2018;2018;02;20;Torstai;13;8;21
624;08.02.2018;2018;02;21;Torstai;12;5;17
624;08.02.2018;2018;02;22;Torstai;1;2;3
624;08.02.2018;2018;02;23;Torstai;2;1;3
624;09.02.2018;2018;02;00;Perjantai;5;1;6
624;09.02.2018;2018;02;01;Perjantai;0;0;0
624;09.02.2018;2018;02;02;Perjantai;1;0;1
624;09.02.2018;2018;02;03;Perjantai;2;0;2
624;09.02.2018;2018;02;04;Perjantai;0;0;0
624;09.02.2018;2018;02;05;Perjantai;0;1;1
624;09.02.2018;2018;02;06;Perjantai;2;4;6
624;09.02.2018;2018;02;07;Perjantai;4;12;16
624;09.02.2018;2018;02;08;Perjantai;14;23;37
624;09.02.2018;2018;02;09;Perjantai;7;22;29
624;09.02.2018;2018;02;10;Perjantai;11;4;15
624;09.02.2018;2018;02;11;Perjantai;4;5;9
624;09.02.2018;2018;02;12;Perjantai;11;15;26
624;09.02.2018;2018;02;13;Perjantai;18;10;28
624;09.02.2018;2018;02;14;Perjantai;14;12;26
624;09.02.2018;2018;02;15;Perjantai;25;9;34
624;09.02.2018;2018;02;16;Perjantai;25;12;37
624;09.02.2018;2018;02;17;Perjantai;27;20;47
624;09.02.2018;2018;02;18;Perjantai;12;7;19
624;09.02.2018;2018;02;19;Perjantai;6;5;11
624;09.02.2018;2018;02;20;Perjantai;10;9;19
624;09.02.2018;2018;02;21;Perjantai;5;1;6
624;09.02.2018;2018;02;22;Perjantai;11;3;14
624;09.02.2018;2018;02;23;Perjantai;4;0;4
624;10.02.2018;2018;02;00;Lauantai;3;3;6
624;10.02.2018;2018;02;01;Lauantai;3;1;4
624;10.02.2018;2018;02;02;Lauantai;3;1;4
624;10.02.2018;2018;02;03;Lauantai;0;0;0
624;10.02.2018;2018;02;04;Lauantai;1;0;1
624;10.02.2018;2018;02;05;Lauantai;2;2;4
624;10.02.2018;2018;02;06;Lauantai;1;1;2
624;10.02.2018;2018;02;07;Lauantai;1;2;3
624;10.02.2018;2018;02;08;Lauantai;0;2;2
624;10.02.2018;2018;02;09;Lauantai;1;2;3
624;10.02.2018;2018;02;10;Lauantai;3;4;7
624;10.02.2018;2018;02;11;Lauantai;7;7;14
624;10.02.2018;2018;02;12;Lauantai;5;9;14
624;10.02.2018;2018;02;13;Lauantai;6;5;11
624;10.02.2018;2018;02;14;Lauantai;7;6;13
624;10.02.2018;2018;02;15;Lauantai;7;6;13
624;10.02.2018;2018;02;16;Lauantai;4;5;9
624;10.02.2018;2018;02;17;Lauantai;6;6;12
624;10.02.2018;2018;02;18;Lauantai;9;4;13
624;10.02.2018;2018;02;19;Lauantai;8;5;13
624;10.02.2018;2018;02;20;Lauantai;2;1;3
624;10.02.2018;2018;02;21;Lauantai;2;2;4
624;10.02.2018;2018;02;22;Lauantai;2;2;4
624;10.02.2018;2018;02;23;Lauantai;1;1;2
624;11.02.2018;2018;02;00;Sunnuntai;2;2;4
624;11.02.2018;2018;02;01;Sunnuntai;3;2;5
624;11.02.2018;2018;02;02;Sunnuntai;2;2;4
624;11.02.2018;2018;02;03;Sunnuntai;1;1;2
624;11.02.2018;2018;02;04;Sunnuntai;2;0;2
624;11.02.2018;2018;02;05;Sunnuntai;0;1;1
624;11.02.2018;2018;02;06;Sunnuntai;2;1;3
624;11.02.2018;2018;02;07;Sunnuntai;1;0;1
624;11.02.2018;2018;02;08;Sunnuntai;0;1;1
624;11.02.2018;2018;02;09;Sunnuntai;0;0;0
624;11.02.2018;2018;02;10;Sunnuntai;3;1;4
624;11.02.2018;2018;02;11;Sunnuntai;1;2;3
624;11.02.2018;2018;02;12;Sunnuntai;6;5;11
624;11.02.2018;2018;02;13;Sunnuntai;3;5;8
624;11.02.2018;2018;02;14;Sunnuntai;7;6;13
624;11.02.2018;2018;02;15;Sunnuntai;5;3;8
624;11.02.2018;2018;02;16;Sunnuntai;9;7;16
624;11.02.2018;2018;02;17;Sunnuntai;10;3;13
624;11.02.2018;2018;02;18;Sunnuntai;3;2;5
624;11.02.2018;2018;02;19;Sunnuntai;7;6;13
624;11.02.2018;2018;02;20;Sunnuntai;3;2;5
624;11.02.2018;2018;02;21;Sunnuntai;5;1;6
624;11.02.2018;2018;02;22;Sunnuntai;7;0;7
624;11.02.2018;2018;02;23;Sunnuntai;3;3;6
624;12.02.2018;2018;02;00;Maanantai;2;2;4
624;12.02.2018;2018;02;01;Maanantai;2;1;3
624;12.02.2018;2018;02;02;Maanantai;0;1;1
624;12.02.2018;2018;02;03;Maanantai;1;1;2
624;12.02.2018;2018;02;04;Maanantai;2;0;2
624;12.02.2018;2018;02;05;Maanantai;1;0;1
624;12.02.2018;2018;02;06;Maanantai;2;4;6
624;12.02.2018;2018;02;07;Maanantai;5;13;18
624;12.02.2018;2018;02;08;Maanantai;14;31;45
624;12.02.2018;2018;02;09;Maanantai;20;26;46
624;12.02.2018;2018;02;10;Maanantai;5;11;16
624;12.02.2018;2018;02;11;Maanantai;6;12;18
624;12.02.2018;2018;02;12;Maanantai;3;5;8
624;12.02.2018;2018;02;13;Maanantai;12;8;20
624;12.02.2018;2018;02;14;Maanantai;12;5;17
624;12.02.2018;2018;02;15;Maanantai;18;17;35
624;12.02.2018;2018;02;16;Maanantai;27;14;41
624;12.02.2018;2018;02;17;Maanantai;50;14;64
624;12.02.2018;2018;02;18;Maanantai;22;17;39
624;12.02.2018;2018;02;19;Maanantai;16;3;19
624;12.02.2018;2018;02;20;Maanantai;15;2;17
624;12.02.2018;2018;02;21;Maanantai;9;0;9
624;12.02.2018;2018;02;22;Maanantai;12;3;15
624;12.02.2018;2018;02;23;Maanantai;4;3;7
624;13.02.2018;2018;02;00;Tiistai;1;2;3
624;13.02.2018;2018;02;01;Tiistai;2;1;3
624;13.02.2018;2018;02;02;Tiistai;0;0;0
624;13.02.2018;2018;02;03;Tiistai;1;0;1
624;13.02.2018;2018;02;04;Tiistai;1;0;1
624;13.02.2018;2018;02;05;Tiistai;3;0;3
624;13.02.2018;2018;02;06;Tiistai;3;6;9
624;13.02.2018;2018;02;07;Tiistai;3;17;20
624;13.02.2018;2018;02;08;Tiistai;7;37;44
624;13.02.2018;2018;02;09;Tiistai;9;36;45
624;13.02.2018;2018;02;10;Tiistai;6;11;17
624;13.02.2018;2018;02;11;Tiistai;2;4;6
624;13.02.2018;2018;02;12;Tiistai;6;6;12
624;13.02.2018;2018;02;13;Tiistai;8;14;22
624;13.02.2018;2018;02;14;Tiistai;21;12;33
624;13.02.2018;2018;02;15;Tiistai;6;11;17
624;13.02.2018;2018;02;16;Tiistai;20;19;39
624;13.02.2018;2018;02;17;Tiistai;13;15;28
624;13.02.2018;2018;02;18;Tiistai;24;11;35
624;13.02.2018;2018;02;19;Tiistai;13;12;25
624;13.02.2018;2018;02;20;Tiistai;9;8;17
624;13.02.2018;2018;02;21;Tiistai;8;5;13
624;13.02.2018;2018;02;22;Tiistai;4;0;4
624;13.02.2018;2018;02;23;Tiistai;5;4;9
624;14.02.2018;2018;02;00;Keskiviikko;1;1;2
624;14.02.2018;2018;02;01;Keskiviikko;3;1;4
624;14.02.2018;2018;02;02;Keskiviikko;0;0;0
624;14.02.2018;2018;02;03;Keskiviikko;1;1;2
624;14.02.2018;2018;02;04;Keskiviikko;1;0;1
624;14.02.2018;2018;02;05;Keskiviikko;0;1;1
624;14.02.2018;2018;02;06;Keskiviikko;2;3;5
624;14.02.2018;2018;02;07;Keskiviikko;4;17;21
624;14.02.2018;2018;02;08;Keskiviikko;12;40;52
624;14.02.2018;2018;02;09;Keskiviikko;12;35;47
624;14.02.2018;2018;02;10;Keskiviikko;5;14;19
624;14.02.2018;2018;02;11;Keskiviikko;6;9;15
624;14.02.2018;2018;02;12;Keskiviikko;6;10;16
624;14.02.2018;2018;02;13;Keskiviikko;12;13;25
624;14.02.2018;2018;02;14;Keskiviikko;19;10;29
624;14.02.2018;2018;02;15;Keskiviikko;14;18;32
624;14.02.2018;2018;02;16;Keskiviikko;34;20;54
624;14.02.2018;2018;02;17;Keskiviikko;53;14;67
624;14.02.2018;2018;02;18;Keskiviikko;18;8;26
624;14.02.2018;2018;02;19;Keskiviikko;10;4;14
624;14.02.2018;2018;02;20;Keskiviikko;14;10;24
624;14.02.2018;2018;02;21;Keskiviikko;5;8;13
624;14.02.2018;2018;02;22;Keskiviikko;13;2;15
624;14.02.2018;2018;02;23;Keskiviikko;4;1;5
624;15.02.2018;2018;02;00;Torstai;2;1;3
624;15.02.2018;2018;02;01;Torstai;1;2;3
624;15.02.2018;2018;02;02;Torstai;0;0;0
624;15.02.2018;2018;02;03;Torstai;0;1;1
624;15.02.2018;2018;02;04;Torstai;0;1;1
624;15.02.2018;2018;02;05;Torstai;1;0;1
624;15.02.2018;2018;02;06;Torstai;2;3;5
624;15.02.2018;2018;02;07;Torstai;3;21;24
624;15.02.2018;2018;02;08;Torstai;9;38;47
624;15.02.2018;2018;02;09;Torstai;15;25;40
624;15.02.2018;2018;02;10;Torstai;8;13;21
624;15.02.2018;2018;02;11;Torstai;4;2;6
624;15.02.2018;2018;02;12;Torstai;5;10;15
624;15.02.2018;2018;02;13;Torstai;5;9;14
624;15.02.2018;2018;02;14;Torstai;4;20;24
624;15.02.2018;2018;02;15;Torstai;13;11;24
624;15.02.2018;2018;02;16;Torstai;25;16;41
624;15.02.2018;2018;02;17;Torstai;37;14;51
624;15.02.2018;2018;02;18;Torstai;18;11;29
624;15.02.2018;2018;02;19;Torstai;22;7;29
624;15.02.2018;2018;02;20;Torstai;19;7;26
624;15.02.2018;2018;02;21;Torstai;12;1;13
624;15.02.2018;2018;02;22;Torstai;4;8;12
624;15.02.2018;2018;02;23;Torstai;4;1;5
624;16.02.2018;2018;02;00;Perjantai;2;0;2
624;16.02.2018;2018;02;01;Perjantai;0;1;1
624;16.02.2018;2018;02;02;Perjantai;1;0;1
624;16.02.2018;2018;02;03;Perjantai;1;0;1
624;16.02.2018;2018;02;04;Perjantai;2;2;4
624;16.02.2018;2018;02;05;Perjantai;1;1;2
624;16.02.2018;2018;02;06;Perjantai;3;5;8
624;16.02.2018;2018;02;07;Perjantai;3;12;15
624;16.02.2018;2018;02;08;Perjantai;8;27;35
624;16.02.2018;2018;02;09;Perjantai;16;33;49
624;16.02.2018;2018;02;10;Perjantai;12;10;22
624;16.02.2018;2018;02;11;Perjantai;8;3;11
624;16.02.2018;2018;02;12;Perjantai;7;9;16
624;16.02.2018;2018;02;13;Perjantai;13;14;27
624;16.02.2018;2018;02;14;Perjantai;10;9;19
624;16.02.2018;2018;02;15;Perjantai;23;14;37
624;16.02.2018;2018;02;16;Perjantai;23;14;37
624;16.02.2018;2018;02;17;Perjantai;39;16;55
624;16.02.2018;2018;02;18;Perjantai;22;6;28
624;16.02.2018;2018;02;19;Perjantai;14;4;18
624;16.02.2018;2018;02;20;Perjantai;6;5;11
624;16.02.2018;2018;02;21;Perjantai;12;4;16
624;16.02.2018;2018;02;22;Perjantai;7;3;10
624;16.02.2018;2018;02;23;Perjantai;3;2;5
624;17.02.2018;2018;02;00;Lauantai;3;3;6
624;17.02.2018;2018;02;01;Lauantai;3;0;3
624;17.02.2018;2018;02;02;Lauantai;2;1;3
624;17.02.2018;2018;02;03;Lauantai;1;2;3
624;17.02.2018;2018;02;04;Lauantai;0;1;1
624;17.02.2018;2018;02;05;Lauantai;1;1;2
624;17.02.2018;2018;02;06;Lauantai;1;2;3
624;17.02.2018;2018;02;07;Lauantai;1;3;4
624;17.02.2018;2018;02;08;Lauantai;0;1;1
624;17.02.2018;2018;02;09;Lauantai;2;4;6
624;17.02.2018;2018;02;10;Lauantai;3;2;5
624;17.02.2018;2018;02;11;Lauantai;2;5;7
624;17.02.2018;2018;02;12;Lauantai;5;8;13
624;17.02.2018;2018;02;13;Lauantai;6;7;13
624;17.02.2018;2018;02;14;Lauantai;10;9;19
624;17.02.2018;2018;02;15;Lauantai;12;6;18
624;17.02.2018;2018;02;16;Lauantai;7;4;11
624;17.02.2018;2018;02;17;Lauantai;1;6;7
624;17.02.2018;2018;02;18;Lauantai;5;5;10
624;17.02.2018;2018;02;19;Lauantai;9;6;15
624;17.02.2018;2018;02;20;Lauantai;5;2;7
624;17.02.2018;2018;02;21;Lauantai;7;8;15
624;17.02.2018;2018;02;22;Lauantai;3;6;9
624;17.02.2018;2018;02;23;Lauantai;1;1;2
624;18.02.2018;2018;02;00;Sunnuntai;2;4;6
624;18.02.2018;2018;02;01;Sunnuntai;1;1;2
624;18.02.2018;2018;02;02;Sunnuntai;3;1;4
624;18.02.2018;2018;02;03;Sunnuntai;2;1;3
624;18.02.2018;2018;02;04;Sunnuntai;2;2;4
624;18.02.2018;2018;02;05;Sunnuntai;1;0;1
624;18.02.2018;2018;02;06;Sunnuntai;0;3;3
624;18.02.2018;2018;02;07;Sunnuntai;1;6;7
624;18.02.2018;2018;02;08;Sunnuntai;0;0;0
624;18.02.2018;2018;02;09;Sunnuntai;0;1;1
624;18.02.2018;2018;02;10;Sunnuntai;2;2;4
624;18.02.2018;2018;02;11;Sunnuntai;2;2;4
624;18.02.2018;2018;02;12;Sunnuntai;4;3;7
624;18.02.2018;2018;02;13;Sunnuntai;4;5;9
624;18.02.2018;2018;02;14;Sunnuntai;9;5;14
624;18.02.2018;2018;02;15;Sunnuntai;5;2;7
624;18.02.2018;2018;02;16;Sunnuntai;7;2;9
624;18.02.2018;2018;02;17;Sunnuntai;3;6;9
624;18.02.2018;2018;02;18;Sunnuntai;4;4;8
624;18.02.2018;2018;02;19;Sunnuntai;5;4;9
624;18.02.2018;2018;02;20;Sunnuntai;5;3;8
624;18.02.2018;2018;02;21;Sunnuntai;3;5;8
624;18.02.2018;2018;02;22;Sunnuntai;8;0;8
624;18.02.2018;2018;02;23;Sunnuntai;3;1;4
624;19.02.2018;2018;02;00;Maanantai;2;0;2
624;19.02.2018;2018;02;01;Maanantai;3;0;3
624;19.02.2018;2018;02;02;Maanantai;0;1;1
624;19.02.2018;2018;02;03;Maanantai;0;1;1
624;19.02.2018;2018;02;04;Maanantai;0;0;0
624;19.02.2018;2018;02;05;Maanantai;1;0;1
624;19.02.2018;2018;02;06;Maanantai;2;4;6
624;19.02.2018;2018;02;07;Maanantai;3;12;15
624;19.02.2018;2018;02;08;Maanantai;11;27;38
624;19.02.2018;2018;02;09;Maanantai;5;26;31
624;19.02.2018;2018;02;10;Maanantai;9;10;19
624;19.02.2018;2018;02;11;Maanantai;6;5;11
624;19.02.2018;2018;02;12;Maanantai;10;12;22
624;19.02.2018;2018;02;13;Maanantai;5;2;7
624;19.02.2018;2018;02;14;Maanantai;9;7;16
624;19.02.2018;2018;02;15;Maanantai;17;14;31
624;19.02.2018;2018;02;16;Maanantai;25;15;40
624;19.02.2018;2018;02;17;Maanantai;39;20;59
624;19.02.2018;2018;02;18;Maanantai;22;15;37
624;19.02.2018;2018;02;19;Maanantai;16;12;28
624;19.02.2018;2018;02;20;Maanantai;21;2;23
624;19.02.2018;2018;02;21;Maanantai;10;2;12
624;19.02.2018;2018;02;22;Maanantai;8;2;10
624;19.02.2018;2018;02;23;Maanantai;6;1;7
624;20.02.2018;2018;02;00;Tiistai;0;1;1
624;20.02.2018;2018;02;01;Tiistai;1;0;1
624;20.02.2018;2018;02;02;Tiistai;0;0;0
624;20.02.2018;2018;02;03;Tiistai;1;1;2
624;20.02.2018;2018;02;04;Tiistai;1;1;2
624;20.02.2018;2018;02;05;Tiistai;0;0;0
624;20.02.2018;2018;02;06;Tiistai;1;4;5
624;20.02.2018;2018;02;07;Tiistai;2;8;10
624;20.02.2018;2018;02;08;Tiistai;13;34;47
624;20.02.2018;2018;02;09;Tiistai;12;26;38
624;20.02.2018;2018;02;10;Tiistai;8;12;20
624;20.02.2018;2018;02;11;Tiistai;6;7;13
624;20.02.2018;2018;02;12;Tiistai;5;9;14
624;20.02.2018;2018;02;13;Tiistai;13;8;21
624;20.02.2018;2018;02;14;Tiistai;10;8;18
624;20.02.2018;2018;02;15;Tiistai;8;7;15
624;20.02.2018;2018;02;16;Tiistai;18;8;26
624;20.02.2018;2018;02;17;Tiistai;32;19;51
624;20.02.2018;2018;02;18;Tiistai;16;5;21
624;20.02.2018;2018;02;19;Tiistai;15;7;22
624;20.02.2018;2018;02;20;Tiistai;14;3;17
624;20.02.2018;2018;02;21;Tiistai;5;3;8
624;20.02.2018;2018;02;22;Tiistai;7;5;12
624;20.02.2018;2018;02;23;Tiistai;4;1;5
624;21.02.2018;2018;02;00;Keskiviikko;1;0;1
624;21.02.2018;2018;02;01;Keskiviikko;3;2;5
624;21.02.2018;2018;02;02;Keskiviikko;0;0;0
624;21.02.2018;2018;02;03;Keskiviikko;0;0;0
624;21.02.2018;2018;02;04;Keskiviikko;1;1;2
624;21.02.2018;2018;02;05;Keskiviikko;0;0;0
624;21.02.2018;2018;02;06;Keskiviikko;3;5;8
624;21.02.2018;2018;02;07;Keskiviikko;2;11;13
624;21.02.2018;2018;02;08;Keskiviikko;13;26;39
624;21.02.2018;2018;02;09;Keskiviikko;6;26;32
624;21.02.2018;2018;02;10;Keskiviikko;5;6;11
624;21.02.2018;2018;02;11;Keskiviikko;8;3;11
624;21.02.2018;2018;02;12;Keskiviikko;3;4;7
624;21.02.2018;2018;02;13;Keskiviikko;6;11;17
624;21.02.2018;2018;02;14;Keskiviikko;16;8;24
624;21.02.2018;2018;02;15;Keskiviikko;10;9;19
624;21.02.2018;2018;02;16;Keskiviikko;26;8;34
624;21.02.2018;2018;02;17;Keskiviikko;27;13;40
624;21.02.2018;2018;02;18;Keskiviikko;24;12;36
624;21.02.2018;2018;02;19;Keskiviikko;21;3;24
624;21.02.2018;2018;02;20;Keskiviikko;13;4;17
624;21.02.2018;2018;02;21;Keskiviikko;9;3;12
624;21.02.2018;2018;02;22;Keskiviikko;7;2;9
624;21.02.2018;2018;02;23;Keskiviikko;3;8;11
624;22.02.2018;2018;02;00;Torstai;2;0;2
624;22.02.2018;2018;02;01;Torstai;0;0;0
624;22.02.2018;2018;02;02;Torstai;0;0;0
624;22.02.2018;2018;02;03;Torstai;0;0;0
624;22.02.2018;2018;02;04;Torstai;1;0;1
624;22.02.2018;2018;02;05;Torstai;1;0;1
624;22.02.2018;2018;02;06;Torstai;2;3;5
624;22.02.2018;2018;02;07;Torstai;6;14;20
624;22.02.2018;2018;02;08;Torstai;12;32;44
624;22.02.2018;2018;02;09;Torstai;8;16;24
624;22.02.2018;2018;02;10;Torstai;10;10;20
624;22.02.2018;2018;02;11;Torstai;2;10;12
624;22.02.2018;2018;02;12;Torstai;6;9;15
624;22.02.2018;2018;02;13;Torstai;12;10;22
624;22.02.2018;2018;02;14;Torstai;15;11;26
624;22.02.2018;2018;02;15;Torstai;7;6;13
624;22.02.2018;2018;02;16;Torstai;32;7;39
624;22.02.2018;2018;02;17;Torstai;33;9;42
624;22.02.2018;2018;02;18;Torstai;22;11;33
624;22.02.2018;2018;02;19;Torstai;16;8;24
624;22.02.2018;2018;02;20;Torstai;11;6;17
624;22.02.2018;2018;02;21;Torstai;15;9;24
624;22.02.2018;2018;02;22;Torstai;5;1;6
624;22.02.2018;2018;02;23;Torstai;3;0;3
624;23.02.2018;2018;02;00;Perjantai;3;0;3
624;23.02.2018;2018;02;01;Perjantai;1;2;3
624;23.02.2018;2018;02;02;Perjantai;1;0;1
624;23.02.2018;2018;02;03;Perjantai;0;1;1
624;23.02.2018;2018;02;04;Perjantai;1;1;2
624;23.02.2018;2018;02;05;Perjantai;1;1;2
624;23.02.2018;2018;02;06;Perjantai;2;4;6
624;23.02.2018;2018;02;07;Perjantai;6;12;18
624;23.02.2018;2018;02;08;Perjantai;10;27;37
624;23.02.2018;2018;02;09;Perjantai;14;20;34
624;23.02.2018;2018;02;10;Perjantai;3;7;10
624;23.02.2018;2018;02;11;Perjantai;2;4;6
624;23.02.2018;2018;02;12;Perjantai;11;12;23
624;23.02.2018;2018;02;13;Perjantai;7;9;16
624;23.02.2018;2018;02;14;Perjantai;11;10;21
624;23.02.2018;2018;02;15;Perjantai;17;11;28
624;23.02.2018;2018;02;16;Perjantai;24;12;36
624;23.02.2018;2018;02;17;Perjantai;22;8;30
624;23.02.2018;2018;02;18;Perjantai;16;10;26
624;23.02.2018;2018;02;19;Perjantai;9;4;13
624;23.02.2018;2018;02;20;Perjantai;9;2;11
624;23.02.2018;2018;02;21;Perjantai;5;1;6
624;23.02.2018;2018;02;22;Perjantai;5;2;7
624;23.02.2018;2018;02;23;Perjantai;7;1;8
624;24.02.2018;2018;02;00;Lauantai;2;0;2
624;24.02.2018;2018;02;01;Lauantai;4;1;5
624;24.02.2018;2018;02;02;Lauantai;3;0;3
624;24.02.2018;2018;02;03;Lauantai;1;1;2
624;24.02.2018;2018;02;04;Lauantai;1;0;1
624;24.02.2018;2018;02;05;Lauantai;2;0;2
624;24.02.2018;2018;02;06;Lauantai;1;3;4
624;24.02.2018;2018;02;07;Lauantai;0;3;3
624;24.02.2018;2018;02;08;Lauantai;2;4;6
624;24.02.2018;2018;02;09;Lauantai;2;1;3
624;24.02.2018;2018;02;10;Lauantai;0;0;0
624;24.02.2018;2018;02;11;Lauantai;2;2;4
624;24.02.2018;2018;02;12;Lauantai;2;5;7
624;24.02.2018;2018;02;13;Lauantai;4;5;9
624;24.02.2018;2018;02;14;Lauantai;1;6;7
624;24.02.2018;2018;02;15;Lauantai;3;9;12
624;24.02.2018;2018;02;16;Lauantai;6;4;10
624;24.02.2018;2018;02;17;Lauantai;4;6;10
624;24.02.2018;2018;02;18;Lauantai;8;7;15
624;24.02.2018;2018;02;19;Lauantai;3;3;6
624;24.02.2018;2018;02;20;Lauantai;9;3;12
624;24.02.2018;2018;02;21;Lauantai;3;2;5
624;24.02.2018;2018;02;22;Lauantai;4;0;4
624;24.02.2018;2018;02;23;Lauantai;3;2;5
624;25.02.2018;2018;02;00;Sunnuntai;1;1;2
624;25.02.2018;2018;02;01;Sunnuntai;1;1;2
624;25.02.2018;2018;02;02;Sunnuntai;2;0;2
624;25.02.2018;2018;02;03;Sunnuntai;1;1;2
624;25.02.2018;2018;02;04;Sunnuntai;0;0;0
624;25.02.2018;2018;02;05;Sunnuntai;0;0;0
624;25.02.2018;2018;02;06;Sunnuntai;3;1;4
624;25.02.2018;2018;02;07;Sunnuntai;2;0;2
624;25.02.2018;2018;02;08;Sunnuntai;0;1;1
624;25.02.2018;2018;02;09;Sunnuntai;0;0;0
624;25.02.2018;2018;02;10;Sunnuntai;3;1;4
624;25.02.2018;2018;02;11;Sunnuntai;1;2;3
624;25.02.2018;2018;02;12;Sunnuntai;2;4;6
624;25.02.2018;2018;02;13;Sunnuntai;2;1;3
624;25.02.2018;2018;02;14;Sunnuntai;7;9;16
624;25.02.2018;2018;02;15;Sunnuntai;2;4;6
624;25.02.2018;2018;02;16;Sunnuntai;10;4;14
624;25.02.2018;2018;02;17;Sunnuntai;3;6;9
624;25.02.2018;2018;02;18;Sunnuntai;8;1;9
624;25.02.2018;2018;02;19;Sunnuntai;5;3;8
624;25.02.2018;2018;02;20;Sunnuntai;9;6;15
624;25.02.2018;2018;02;21;Sunnuntai;0;0;0
624;25.02.2018;2018;02;22;Sunnuntai;6;1;7
624;25.02.2018;2018;02;23;Sunnuntai;1;0;1
624;26.02.2018;2018;02;00;Maanantai;2;0;2
624;26.02.2018;2018;02;01;Maanantai;3;0;3
624;26.02.2018;2018;02;02;Maanantai;0;0;0
624;26.02.2018;2018;02;03;Maanantai;0;1;1
624;26.02.2018;2018;02;04;Maanantai;1;0;1
624;26.02.2018;2018;02;05;Maanantai;3;0;3
624;26.02.2018;2018;02;06;Maanantai;5;7;12
624;26.02.2018;2018;02;07;Maanantai;2;14;16
624;26.02.2018;2018;02;08;Maanantai;18;37;55
624;26.02.2018;2018;02;09;Maanantai;17;19;36
624;26.02.2018;2018;02;10;Maanantai;8;7;15
624;26.02.2018;2018;02;11;Maanantai;7;7;14
624;26.02.2018;2018;02;12;Maanantai;4;10;14
624;26.02.2018;2018;02;13;Maanantai;6;15;21
624;26.02.2018;2018;02;14;Maanantai;14;12;26
624;26.02.2018;2018;02;15;Maanantai;21;17;38
624;26.02.2018;2018;02;16;Maanantai;27;14;41
624;26.02.2018;2018;02;17;Maanantai;41;22;63
624;26.02.2018;2018;02;18;Maanantai;20;17;37
624;26.02.2018;2018;02;19;Maanantai;22;5;27
624;26.02.2018;2018;02;20;Maanantai;14;6;20
624;26.02.2018;2018;02;21;Maanantai;10;2;12
624;26.02.2018;2018;02;22;Maanantai;12;0;12
624;26.02.2018;2018;02;23;Maanantai;3;1;4
624;27.02.2018;2018;02;00;Tiistai;0;1;1
624;27.02.2018;2018;02;01;Tiistai;0;0;0
624;27.02.2018;2018;02;02;Tiistai;0;0;0
624;27.02.2018;2018;02;03;Tiistai;1;1;2
624;27.02.2018;2018;02;04;Tiistai;0;0;0
624;27.02.2018;2018;02;05;Tiistai;1;0;1
624;27.02.2018;2018;02;06;Tiistai;2;3;5
624;27.02.2018;2018;02;07;Tiistai;3;17;20
624;27.02.2018;2018;02;08;Tiistai;11;31;42
624;27.02.2018;2018;02;09;Tiistai;13;19;32
624;27.02.2018;2018;02;10;Tiistai;9;8;17
624;27.02.2018;2018;02;11;Tiistai;4;5;9
624;27.02.2018;2018;02;12;Tiistai;11;6;17
624;27.02.2018;2018;02;13;Tiistai;8;5;13
624;27.02.2018;2018;02;14;Tiistai;8;9;17
624;27.02.2018;2018;02;15;Tiistai;12;5;17
624;27.02.2018;2018;02;16;Tiistai;28;15;43
624;27.02.2018;2018;02;17;Tiistai;33;15;48
624;27.02.2018;2018;02;18;Tiistai;19;11;30
624;27.02.2018;2018;02;19;Tiistai;11;10;21
624;27.02.2018;2018;02;20;Tiistai;9;7;16
624;27.02.2018;2018;02;21;Tiistai;16;1;17
624;27.02.2018;2018;02;22;Tiistai;5;3;8
624;27.02.2018;2018;02;23;Tiistai;1;3;4
624;28.02.2018;2018;02;00;Keskiviikko;0;0;0
624;28.02.2018;2018;02;01;Keskiviikko;0;0;0
624;28.02.2018;2018;02;02;Keskiviikko;0;0;0
624;28.02.2018;2018;02;03;Keskiviikko;0;1;1
624;28.02.2018;2018;02;04;Keskiviikko;2;0;2
624;28.02.2018;2018;02;05;Keskiviikko;1;0;1
624;28.02.2018;2018;02;06;Keskiviikko;3;4;7
624;28.02.2018;2018;02;07;Keskiviikko;1;8;9
624;28.02.2018;2018;02;08;Keskiviikko;9;23;32
624;28.02.2018;2018;02;09;Keskiviikko;7;17;24
624;28.02.2018;2018;02;10;Keskiviikko;2;3;5
624;28.02.2018;2018;02;11;Keskiviikko;3;5;8
624;28.02.2018;2018;02;12;Keskiviikko;3;4;7
624;28.02.2018;2018;02;13;Keskiviikko;6;5;11
624;28.02.2018;2018;02;14;Keskiviikko;8;9;17
624;28.02.2018;2018;02;15;Keskiviikko;11;7;18
624;28.02.2018;2018;02;16;Keskiviikko;23;5;28
624;28.02.2018;2018;02;17;Keskiviikko;31;14;45
624;28.02.2018;2018;02;18;Keskiviikko;20;2;22
624;28.02.2018;2018;02;19;Keskiviikko;7;6;13
624;28.02.2018;2018;02;20;Keskiviikko;5;5;10
624;28.02.2018;2018;02;21;Keskiviikko;10;3;13
624;28.02.2018;2018;02;22;Keskiviikko;4;3;7
624;28.02.2018;2018;02;23;Keskiviikko;1;1;2
624;01.03.2018;2018;03;00;Torstai;2;0;2
624;01.03.2018;2018;03;01;Torstai;1;2;3
624;01.03.2018;2018;03;02;Torstai;0;0;0
624;01.03.2018;2018;03;03;Torstai;0;1;1
624;01.03.2018;2018;03;04;Torstai;1;0;1
624;01.03.2018;2018;03;05;Torstai;2;0;2
624;01.03.2018;2018;03;06;Torstai;0;4;4
624;01.03.2018;2018;03;07;Torstai;3;10;13
624;01.03.2018;2018;03;08;Torstai;11;35;46
624;01.03.2018;2018;03;09;Torstai;6;23;29
624;01.03.2018;2018;03;10;Torstai;10;8;18
624;01.03.2018;2018;03;11;Torstai;2;4;6
624;01.03.2018;2018;03;12;Torstai;9;10;19
624;01.03.2018;2018;03;13;Torstai;5;6;11
624;01.03.2018;2018;03;14;Torstai;17;9;26
624;01.03.2018;2018;03;15;Torstai;18;8;26
624;01.03.2018;2018;03;16;Torstai;23;12;35
624;01.03.2018;2018;03;17;Torstai;36;23;59
624;01.03.2018;2018;03;18;Torstai;18;12;30
624;01.03.2018;2018;03;19;Torstai;17;9;26
624;01.03.2018;2018;03;20;Torstai;13;6;19
624;01.03.2018;2018;03;21;Torstai;13;8;21
624;01.03.2018;2018;03;22;Torstai;8;5;13
624;01.03.2018;2018;03;23;Torstai;7;2;9
624;02.03.2018;2018;03;00;Perjantai;3;3;6
624;02.03.2018;2018;03;01;Perjantai;1;1;2
624;02.03.2018;2018;03;02;Perjantai;0;1;1
624;02.03.2018;2018;03;03;Perjantai;0;0;0
624;02.03.2018;2018;03;04;Perjantai;0;0;0
624;02.03.2018;2018;03;05;Perjantai;2;1;3
624;02.03.2018;2018;03;06;Perjantai;2;2;4
624;02.03.2018;2018;03;07;Perjantai;1;12;13
624;02.03.2018;2018;03;08;Perjantai;12;31;43
624;02.03.2018;2018;03;09;Perjantai;10;21;31
624;02.03.2018;2018;03;10;Perjantai;8;10;18
624;02.03.2018;2018;03;11;Perjantai;8;10;18
624;02.03.2018;2018;03;12;Perjantai;12;5;17
624;02.03.2018;2018;03;13;Perjantai;17;7;24
624;02.03.2018;2018;03;14;Perjantai;16;7;23
624;02.03.2018;2018;03;15;Perjantai;16;9;25
624;02.03.2018;2018;03;16;Perjantai;30;9;39
624;02.03.2018;2018;03;17;Perjantai;41;11;52
624;02.03.2018;2018;03;18;Perjantai;22;12;34
624;02.03.2018;2018;03;19;Perjantai;15;6;21
624;02.03.2018;2018;03;20;Perjantai;12;4;16
624;02.03.2018;2018;03;21;Perjantai;6;4;10
624;02.03.2018;2018;03;22;Perjantai;5;3;8
624;02.03.2018;2018;03;23;Perjantai;5;5;10
624;03.03.2018;2018;03;00;Lauantai;1;1;2
624;03.03.2018;2018;03;01;Lauantai;0;1;1
624;03.03.2018;2018;03;02;Lauantai;0;0;0
624;03.03.2018;2018;03;03;Lauantai;1;2;3
624;03.03.2018;2018;03;04;Lauantai;3;2;5
624;03.03.2018;2018;03;05;Lauantai;0;0;0
624;03.03.2018;2018;03;06;Lauantai;3;0;3
624;03.03.2018;2018;03;07;Lauantai;0;1;1
624;03.03.2018;2018;03;08;Lauantai;1;3;4
624;03.03.2018;2018;03;09;Lauantai;2;4;6
624;03.03.2018;2018;03;10;Lauantai;3;4;7
624;03.03.2018;2018;03;11;Lauantai;2;3;5
624;03.03.2018;2018;03;12;Lauantai;7;8;15
624;03.03.2018;2018;03;13;Lauantai;9;7;16
624;03.03.2018;2018;03;14;Lauantai;9;10;19
624;03.03.2018;2018;03;15;Lauantai;8;6;14
624;03.03.2018;2018;03;16;Lauantai;6;4;10
624;03.03.2018;2018;03;17;Lauantai;9;7;16
624;03.03.2018;2018;03;18;Lauantai;4;3;7
624;03.03.2018;2018;03;19;Lauantai;5;4;9
624;03.03.2018;2018;03;20;Lauantai;6;1;7
624;03.03.2018;2018;03;21;Lauantai;8;0;8
624;03.03.2018;2018;03;22;Lauantai;7;1;8
624;03.03.2018;2018;03;23;Lauantai;2;4;6
624;04.03.2018;2018;03;00;Sunnuntai;3;2;5
624;04.03.2018;2018;03;01;Sunnuntai;2;0;2
624;04.03.2018;2018;03;02;Sunnuntai;2;1;3
624;04.03.2018;2018;03;03;Sunnuntai;2;1;3
624;04.03.2018;2018;03;04;Sunnuntai;0;1;1
624;04.03.2018;2018;03;05;Sunnuntai;3;1;4
624;04.03.2018;2018;03;06;Sunnuntai;0;1;1
624;04.03.2018;2018;03;07;Sunnuntai;1;0;1
624;04.03.2018;2018;03;08;Sunnuntai;1;0;1
624;04.03.2018;2018;03;09;Sunnuntai;0;0;0
624;04.03.2018;2018;03;10;Sunnuntai;2;2;4
624;04.03.2018;2018;03;11;Sunnuntai;1;2;3
624;04.03.2018;2018;03;12;Sunnuntai;6;6;12
624;04.03.2018;2018;03;13;Sunnuntai;5;6;11
624;04.03.2018;2018;03;14;Sunnuntai;13;3;16
624;04.03.2018;2018;03;15;Sunnuntai;8;3;11
624;04.03.2018;2018;03;16;Sunnuntai;9;4;13
624;04.03.2018;2018;03;17;Sunnuntai;10;4;14
624;04.03.2018;2018;03;18;Sunnuntai;8;2;10
624;04.03.2018;2018;03;19;Sunnuntai;4;5;9
624;04.03.2018;2018;03;20;Sunnuntai;8;5;13
624;04.03.2018;2018;03;21;Sunnuntai;4;2;6
624;04.03.2018;2018;03;22;Sunnuntai;6;1;7
624;04.03.2018;2018;03;23;Sunnuntai;3;1;4
624;05.03.2018;2018;03;00;Maanantai;2;0;2
624;05.03.2018;2018;03;01;Maanantai;1;1;2
624;05.03.2018;2018;03;02;Maanantai;0;0;0
624;05.03.2018;2018;03;03;Maanantai;0;1;1
624;05.03.2018;2018;03;04;Maanantai;1;0;1
624;05.03.2018;2018;03;05;Maanantai;1;0;1
624;05.03.2018;2018;03;06;Maanantai;5;5;10
624;05.03.2018;2018;03;07;Maanantai;3;10;13
624;05.03.2018;2018;03;08;Maanantai;9;15;24
624;05.03.2018;2018;03;09;Maanantai;5;12;17
624;05.03.2018;2018;03;10;Maanantai;8;5;13
624;05.03.2018;2018;03;11;Maanantai;8;6;14
624;05.03.2018;2018;03;12;Maanantai;3;7;10
624;05.03.2018;2018;03;13;Maanantai;9;5;14
624;05.03.2018;2018;03;14;Maanantai;9;5;14
624;05.03.2018;2018;03;15;Maanantai;8;9;17
624;05.03.2018;2018;03;16;Maanantai;25;9;34
624;05.03.2018;2018;03;17;Maanantai;30;13;43
624;05.03.2018;2018;03;18;Maanantai;16;11;27
624;05.03.2018;2018;03;19;Maanantai;11;4;15
624;05.03.2018;2018;03;20;Maanantai;6;4;10
624;05.03.2018;2018;03;21;Maanantai;13;1;14
624;05.03.2018;2018;03;22;Maanantai;8;1;9
624;05.03.2018;2018;03;23;Maanantai;3;1;4
624;06.03.2018;2018;03;00;Tiistai;2;1;3
624;06.03.2018;2018;03;01;Tiistai;1;0;1
624;06.03.2018;2018;03;02;Tiistai;0;0;0
624;06.03.2018;2018;03;03;Tiistai;0;1;1
624;06.03.2018;2018;03;04;Tiistai;1;0;1
624;06.03.2018;2018;03;05;Tiistai;1;2;3
624;06.03.2018;2018;03;06;Tiistai;2;4;6
624;06.03.2018;2018;03;07;Tiistai;7;7;14
624;06.03.2018;2018;03;08;Tiistai;7;14;21
624;06.03.2018;2018;03;09;Tiistai;8;13;21
624;06.03.2018;2018;03;10;Tiistai;6;2;8
624;06.03.2018;2018;03;11;Tiistai;7;4;11
624;06.03.2018;2018;03;12;Tiistai;6;8;14
624;06.03.2018;2018;03;13;Tiistai;9;7;16
624;06.03.2018;2018;03;14;Tiistai;8;1;9
624;06.03.2018;2018;03;15;Tiistai;12;5;17
624;06.03.2018;2018;03;16;Tiistai;24;9;33
624;06.03.2018;2018;03;17;Tiistai;30;14;44
624;06.03.2018;2018;03;18;Tiistai;18;11;29
624;06.03.2018;2018;03;19;Tiistai;14;3;17
624;06.03.2018;2018;03;20;Tiistai;6;0;6
624;06.03.2018;2018;03;21;Tiistai;3;3;6
624;06.03.2018;2018;03;22;Tiistai;8;0;8
624;06.03.2018;2018;03;23;Tiistai;5;3;8
624;07.03.2018;2018;03;00;Keskiviikko;0;1;1
624;07.03.2018;2018;03;01;Keskiviikko;2;1;3
624;07.03.2018;2018;03;02;Keskiviikko;0;0;0
624;07.03.2018;2018;03;03;Keskiviikko;1;0;1
624;07.03.2018;2018;03;04;Keskiviikko;3;0;3
624;07.03.2018;2018;03;05;Keskiviikko;1;0;1
624;07.03.2018;2018;03;06;Keskiviikko;3;4;7
624;07.03.2018;2018;03;07;Keskiviikko;4;9;13
624;07.03.2018;2018;03;08;Keskiviikko;11;13;24
624;07.03.2018;2018;03;09;Keskiviikko;8;8;16
624;07.03.2018;2018;03;10;Keskiviikko;8;1;9
624;07.03.2018;2018;03;11;Keskiviikko;6;2;8
624;07.03.2018;2018;03;12;Keskiviikko;7;4;11
624;07.03.2018;2018;03;13;Keskiviikko;1;6;7
624;07.03.2018;2018;03;14;Keskiviikko;5;7;12
624;07.03.2018;2018;03;15;Keskiviikko;9;4;13
624;07.03.2018;2018;03;16;Keskiviikko;15;7;22
624;07.03.2018;2018;03;17;Keskiviikko;18;4;22
624;07.03.2018;2018;03;18;Keskiviikko;20;7;27
624;07.03.2018;2018;03;19;Keskiviikko;8;3;11
624;07.03.2018;2018;03;20;Keskiviikko;9;3;12
624;07.03.2018;2018;03;21;Keskiviikko;4;0;4
624;07.03.2018;2018;03;22;Keskiviikko;8;2;10
624;07.03.2018;2018;03;23;Keskiviikko;5;3;8
624;08.03.2018;2018;03;00;Torstai;2;1;3
624;08.03.2018;2018;03;01;Torstai;1;0;1
624;08.03.2018;2018;03;02;Torstai;0;0;0
624;08.03.2018;2018;03;03;Torstai;0;0;0
624;08.03.2018;2018;03;04;Torstai;1;0;1
624;08.03.2018;2018;03;05;Torstai;1;0;1
624;08.03.2018;2018;03;06;Torstai;2;2;4
624;08.03.2018;2018;03;07;Torstai;5;10;15
624;08.03.2018;2018;03;08;Torstai;10;10;20
624;08.03.2018;2018;03;09;Torstai;5;14;19
624;08.03.2018;2018;03;10;Torstai;8;5;13
624;08.03.2018;2018;03;11;Torstai;2;2;4
624;08.03.2018;2018;03;12;Torstai;5;3;8
624;08.03.2018;2018;03;13;Torstai;2;4;6
624;08.03.2018;2018;03;14;Torstai;5;5;10
624;08.03.2018;2018;03;15;Torstai;12;9;21
624;08.03.2018;2018;03;16;Torstai;22;9;31
624;08.03.2018;2018;03;17;Torstai;33;11;44
624;08.03.2018;2018;03;18;Torstai;13;6;19
624;08.03.2018;2018;03;19;Torstai;13;6;19
624;08.03.2018;2018;03;20;Torstai;9;2;11
624;08.03.2018;2018;03;21;Torstai;8;4;12
624;08.03.2018;2018;03;22;Torstai;7;0;7
624;08.03.2018;2018;03;23;Torstai;5;1;6
624;09.03.2018;2018;03;00;Perjantai;0;0;0
624;09.03.2018;2018;03;01;Perjantai;2;1;3
624;09.03.2018;2018;03;02;Perjantai;1;0;1
624;09.03.2018;2018;03;03;Perjantai;0;1;1
624;09.03.2018;2018;03;04;Perjantai;1;0;1
624;09.03.2018;2018;03;05;Perjantai;4;1;5
624;09.03.2018;2018;03;06;Perjantai;4;6;10
624;09.03.2018;2018;03;07;Perjantai;5;12;17
624;09.03.2018;2018;03;08;Perjantai;9;11;20
624;09.03.2018;2018;03;09;Perjantai;4;12;16
624;09.03.2018;2018;03;10;Perjantai;10;6;16
624;09.03.2018;2018;03;11;Perjantai;5;6;11
624;09.03.2018;2018;03;12;Perjantai;9;12;21
624;09.03.2018;2018;03;13;Perjantai;9;7;16
624;09.03.2018;2018;03;14;Perjantai;15;10;25
624;09.03.2018;2018;03;15;Perjantai;10;7;17
624;09.03.2018;2018;03;16;Perjantai;27;8;35
624;09.03.2018;2018;03;17;Perjantai;23;7;30
624;09.03.2018;2018;03;18;Perjantai;10;10;20
624;09.03.2018;2018;03;19;Perjantai;11;4;15
624;09.03.2018;2018;03;20;Perjantai;6;2;8
624;09.03.2018;2018;03;21;Perjantai;3;3;6
624;09.03.2018;2018;03;22;Perjantai;2;1;3
624;09.03.2018;2018;03;23;Perjantai;4;0;4
624;10.03.2018;2018;03;00;Lauantai;0;3;3
624;10.03.2018;2018;03;01;Lauantai;1;1;2
624;10.03.2018;2018;03;02;Lauantai;1;0;1
624;10.03.2018;2018;03;03;Lauantai;0;3;3
624;10.03.2018;2018;03;04;Lauantai;0;0;0
624;10.03.2018;2018;03;05;Lauantai;0;1;1
624;10.03.2018;2018;03;06;Lauantai;1;0;1
624;10.03.2018;2018;03;07;Lauantai;1;3;4
624;10.03.2018;2018;03;08;Lauantai;1;2;3
624;10.03.2018;2018;03;09;Lauantai;3;0;3
624;10.03.2018;2018;03;10;Lauantai;2;5;7
624;10.03.2018;2018;03;11;Lauantai;1;6;7
624;10.03.2018;2018;03;12;Lauantai;6;3;9
624;10.03.2018;2018;03;13;Lauantai;6;11;17
624;10.03.2018;2018;03;14;Lauantai;5;5;10
624;10.03.2018;2018;03;15;Lauantai;4;3;7
624;10.03.2018;2018;03;16;Lauantai;7;6;13
624;10.03.2018;2018;03;17;Lauantai;4;2;6
624;10.03.2018;2018;03;18;Lauantai;8;2;10
624;10.03.2018;2018;03;19;Lauantai;4;5;9
624;10.03.2018;2018;03;20;Lauantai;6;4;10
624;10.03.2018;2018;03;21;Lauantai;2;3;5
624;10.03.2018;2018;03;22;Lauantai;6;5;11
624;10.03.2018;2018;03;23;Lauantai;2;2;4
624;11.03.2018;2018;03;00;Sunnuntai;1;0;1
624;11.03.2018;2018;03;01;Sunnuntai;0;0;0
624;11.03.2018;2018;03;02;Sunnuntai;0;0;0
624;11.03.2018;2018;03;03;Sunnuntai;0;1;1
624;11.03.2018;2018;03;04;Sunnuntai;2;0;2
624;11.03.2018;2018;03;05;Sunnuntai;1;0;1
624;11.03.2018;2018;03;06;Sunnuntai;0;0;0
624;11.03.2018;2018;03;07;Sunnuntai;0;3;3
624;11.03.2018;2018;03;08;Sunnuntai;0;0;0
624;11.03.2018;2018;03;09;Sunnuntai;1;0;1
624;11.03.2018;2018;03;10;Sunnuntai;1;2;3
624;11.03.2018;2018;03;11;Sunnuntai;3;8;11
624;11.03.2018;2018;03;12;Sunnuntai;2;4;6
624;11.03.2018;2018;03;13;Sunnuntai;3;4;7
624;11.03.2018;2018;03;14;Sunnuntai;6;6;12
624;11.03.2018;2018;03;15;Sunnuntai;6;2;8
624;11.03.2018;2018;03;16;Sunnuntai;4;3;7
624;11.03.2018;2018;03;17;Sunnuntai;10;2;12
624;11.03.2018;2018;03;18;Sunnuntai;3;5;8
624;11.03.2018;2018;03;19;Sunnuntai;5;3;8
624;11.03.2018;2018;03;20;Sunnuntai;4;2;6
624;11.03.2018;2018;03;21;Sunnuntai;2;2;4
624;11.03.2018;2018;03;22;Sunnuntai;4;1;5
624;11.03.2018;2018;03;23;Sunnuntai;1;4;5
624;12.03.2018;2018;03;00;Maanantai;2;1;3
624;12.03.2018;2018;03;01;Maanantai;1;1;2
624;12.03.2018;2018;03;02;Maanantai;1;0;1
624;12.03.2018;2018;03;03;Maanantai;0;0;0
624;12.03.2018;2018;03;04;Maanantai;0;0;0
624;12.03.2018;2018;03;05;Maanantai;0;0;0
624;12.03.2018;2018;03;06;Maanantai;2;6;8
624;12.03.2018;2018;03;07;Maanantai;7;9;16
624;12.03.2018;2018;03;08;Maanantai;14;33;47
624;12.03.2018;2018;03;09;Maanantai;11;21;32
624;12.03.2018;2018;03;10;Maanantai;10;12;22
624;12.03.2018;2018;03;11;Maanantai;3;6;9
624;12.03.2018;2018;03;12;Maanantai;7;14;21
624;12.03.2018;2018;03;13;Maanantai;4;8;12
624;12.03.2018;2018;03;14;Maanantai;11;6;17
624;12.03.2018;2018;03;15;Maanantai;13;11;24
624;12.03.2018;2018;03;16;Maanantai;24;13;37
624;12.03.2018;2018;03;17;Maanantai;44;19;63
624;12.03.2018;2018;03;18;Maanantai;20;9;29
624;12.03.2018;2018;03;19;Maanantai;18;12;30
624;12.03.2018;2018;03;20;Maanantai;14;5;19
624;12.03.2018;2018;03;21;Maanantai;8;4;12
624;12.03.2018;2018;03;22;Maanantai;14;2;16
624;12.03.2018;2018;03;23;Maanantai;1;3;4
624;13.03.2018;2018;03;00;Tiistai;1;1;2
624;13.03.2018;2018;03;01;Tiistai;1;1;2
624;13.03.2018;2018;03;02;Tiistai;1;0;1
624;13.03.2018;2018;03;03;Tiistai;0;0;0
624;13.03.2018;2018;03;04;Tiistai;1;0;1
624;13.03.2018;2018;03;05;Tiistai;2;1;3
624;13.03.2018;2018;03;06;Tiistai;4;6;10
624;13.03.2018;2018;03;07;Tiistai;5;6;11
624;13.03.2018;2018;03;08;Tiistai;27;28;55
624;13.03.2018;2018;03;09;Tiistai;5;21;26
624;13.03.2018;2018;03;10;Tiistai;7;4;11
624;13.03.2018;2018;03;11;Tiistai;10;7;17
624;13.03.2018;2018;03;12;Tiistai;7;10;17
624;13.03.2018;2018;03;13;Tiistai;13;12;25
624;13.03.2018;2018;03;14;Tiistai;11;10;21
624;13.03.2018;2018;03;15;Tiistai;9;9;18
624;13.03.2018;2018;03;16;Tiistai;20;19;39
624;13.03.2018;2018;03;17;Tiistai;31;21;52
624;13.03.2018;2018;03;18;Tiistai;25;16;41
624;13.03.2018;2018;03;19;Tiistai;19;8;27
624;13.03.2018;2018;03;20;Tiistai;15;4;19
624;13.03.2018;2018;03;21;Tiistai;5;6;11
624;13.03.2018;2018;03;22;Tiistai;8;5;13
624;13.03.2018;2018;03;23;Tiistai;1;4;5
624;14.03.2018;2018;03;00;Keskiviikko;3;2;5
624;14.03.2018;2018;03;01;Keskiviikko;0;0;0
624;14.03.2018;2018;03;02;Keskiviikko;0;0;0
624;14.03.2018;2018;03;03;Keskiviikko;0;0;0
624;14.03.2018;2018;03;04;Keskiviikko;2;2;4
624;14.03.2018;2018;03;05;Keskiviikko;0;1;1
624;14.03.2018;2018;03;06;Keskiviikko;4;4;8
624;14.03.2018;2018;03;07;Keskiviikko;8;4;12
624;14.03.2018;2018;03;08;Keskiviikko;13;27;40
624;14.03.2018;2018;03;09;Keskiviikko;7;20;27
624;14.03.2018;2018;03;10;Keskiviikko;6;12;18
624;14.03.2018;2018;03;11;Keskiviikko;6;11;17
624;14.03.2018;2018;03;12;Keskiviikko;3;11;14
624;14.03.2018;2018;03;13;Keskiviikko;10;7;17
624;14.03.2018;2018;03;14;Keskiviikko;12;6;18
624;14.03.2018;2018;03;15;Keskiviikko;12;12;24
624;14.03.2018;2018;03;16;Keskiviikko;20;14;34
624;14.03.2018;2018;03;17;Keskiviikko;34;9;43
624;14.03.2018;2018;03;18;Keskiviikko;15;12;27
624;14.03.2018;2018;03;19;Keskiviikko;21;2;23
624;14.03.2018;2018;03;20;Keskiviikko;14;4;18
624;14.03.2018;2018;03;21;Keskiviikko;17;5;22
624;14.03.2018;2018;03;22;Keskiviikko;7;4;11
624;14.03.2018;2018;03;23;Keskiviikko;4;4;8
624;15.03.2018;2018;03;00;Torstai;1;2;3
624;15.03.2018;2018;03;01;Torstai;0;1;1
624;15.03.2018;2018;03;02;Torstai;0;2;2
624;15.03.2018;2018;03;03;Torstai;1;0;1
624;15.03.2018;2018;03;04;Torstai;1;1;2
624;15.03.2018;2018;03;05;Torstai;0;0;0
624;15.03.2018;2018;03;06;Torstai;6;8;14
624;15.03.2018;2018;03;07;Torstai;9;9;18
624;15.03.2018;2018;03;08;Torstai;17;34;51
624;15.03.2018;2018;03;09;Torstai;14;23;37
624;15.03.2018;2018;03;10;Torstai;8;8;16
624;15.03.2018;2018;03;11;Torstai;7;6;13
624;15.03.2018;2018;03;12;Torstai;5;6;11
624;15.03.2018;2018;03;13;Torstai;19;12;31
624;15.03.2018;2018;03;14;Torstai;14;6;20
624;15.03.2018;2018;03;15;Torstai;16;9;25
624;15.03.2018;2018;03;16;Torstai;29;10;39
624;15.03.2018;2018;03;17;Torstai;34;13;47
624;15.03.2018;2018;03;18;Torstai;20;12;32
624;15.03.2018;2018;03;19;Torstai;12;5;17
624;15.03.2018;2018;03;20;Torstai;14;6;20
624;15.03.2018;2018;03;21;Torstai;10;4;14
624;15.03.2018;2018;03;22;Torstai;7;2;9
624;15.03.2018;2018;03;23;Torstai;4;1;5
624;16.03.2018;2018;03;00;Perjantai;3;0;3
624;16.03.2018;2018;03;01;Perjantai;1;1;2
624;16.03.2018;2018;03;02;Perjantai;0;0;0
624;16.03.2018;2018;03;03;Perjantai;1;1;2
624;16.03.2018;2018;03;04;Perjantai;0;0;0
624;16.03.2018;2018;03;05;Perjantai;1;1;2
624;16.03.2018;2018;03;06;Perjantai;2;4;6
624;16.03.2018;2018;03;07;Perjantai;9;9;18
624;16.03.2018;2018;03;08;Perjantai;15;18;33
624;16.03.2018;2018;03;09;Perjantai;12;16;28
624;16.03.2018;2018;03;10;Perjantai;7;4;11
624;16.03.2018;2018;03;11;Perjantai;9;6;15
624;16.03.2018;2018;03;12;Perjantai;5;5;10
624;16.03.2018;2018;03;13;Perjantai;13;8;21
624;16.03.2018;2018;03;14;Perjantai;17;7;24
624;16.03.2018;2018;03;15;Perjantai;13;13;26
624;16.03.2018;2018;03;16;Perjantai;18;13;31
624;16.03.2018;2018;03;17;Perjantai;31;17;48
624;16.03.2018;2018;03;18;Perjantai;12;6;18
624;16.03.2018;2018;03;19;Perjantai;5;3;8
624;16.03.2018;2018;03;20;Perjantai;9;5;14
624;16.03.2018;2018;03;21;Perjantai;8;4;12
624;16.03.2018;2018;03;22;Perjantai;5;1;6
624;16.03.2018;2018;03;23;Perjantai;4;1;5
624;17.03.2018;2018;03;00;Lauantai;3;0;3
624;17.03.2018;2018;03;01;Lauantai;1;1;2
624;17.03.2018;2018;03;02;Lauantai;3;0;3
624;17.03.2018;2018;03;03;Lauantai;0;0;0
624;17.03.2018;2018;03;04;Lauantai;1;0;1
624;17.03.2018;2018;03;05;Lauantai;0;1;1
624;17.03.2018;2018;03;06;Lauantai;2;2;4
624;17.03.2018;2018;03;07;Lauantai;1;4;5
624;17.03.2018;2018;03;08;Lauantai;0;3;3
624;17.03.2018;2018;03;09;Lauantai;3;2;5
624;17.03.2018;2018;03;10;Lauantai;3;2;5
624;17.03.2018;2018;03;11;Lauantai;3;5;8
624;17.03.2018;2018;03;12;Lauantai;5;12;17
624;17.03.2018;2018;03;13;Lauantai;8;7;15
624;17.03.2018;2018;03;14;Lauantai;5;6;11
624;17.03.2018;2018;03;15;Lauantai;9;3;12
624;17.03.2018;2018;03;16;Lauantai;5;6;11
624;17.03.2018;2018;03;17;Lauantai;7;2;9
624;17.03.2018;2018;03;18;Lauantai;2;1;3
624;17.03.2018;2018;03;19;Lauantai;2;1;3
624;17.03.2018;2018;03;20;Lauantai;1;1;2
624;17.03.2018;2018;03;21;Lauantai;1;1;2
624;17.03.2018;2018;03;22;Lauantai;1;1;2
624;17.03.2018;2018;03;23;Lauantai;0;0;0
624;18.03.2018;2018;03;00;Sunnuntai;1;0;1
624;18.03.2018;2018;03;01;Sunnuntai;0;0;0
624;18.03.2018;2018;03;02;Sunnuntai;0;0;0
624;18.03.2018;2018;03;03;Sunnuntai;0;1;1
624;18.03.2018;2018;03;04;Sunnuntai;2;0;2
624;18.03.2018;2018;03;05;Sunnuntai;1;0;1
624;18.03.2018;2018;03;06;Sunnuntai;0;0;0
624;18.03.2018;2018;03;07;Sunnuntai;0;3;3
624;18.03.2018;2018;03;08;Sunnuntai;0;0;0
624;18.03.2018;2018;03;09;Sunnuntai;1;0;1
624;18.03.2018;2018;03;10;Sunnuntai;1;2;3
624;18.03.2018;2018;03;11;Sunnuntai;3;8;11
624;18.03.2018;2018;03;12;Sunnuntai;2;4;6
624;18.03.2018;2018;03;13;Sunnuntai;3;4;7
624;18.03.2018;2018;03;14;Sunnuntai;6;6;12
624;18.03.2018;2018;03;15;Sunnuntai;6;2;8
624;18.03.2018;2018;03;16;Sunnuntai;4;3;7
624;18.03.2018;2018;03;17;Sunnuntai;10;2;12
624;18.03.2018;2018;03;18;Sunnuntai;3;5;8
624;18.03.2018;2018;03;19;Sunnuntai;5;3;8
624;18.03.2018;2018;03;20;Sunnuntai;4;2;6
624;18.03.2018;2018;03;21;Sunnuntai;2;2;4
624;18.03.2018;2018;03;22;Sunnuntai;4;1;5
624;18.03.2018;2018;03;23;Sunnuntai;1;4;5
624;19.03.2018;2018;03;00;Maanantai;1;0;1
624;19.03.2018;2018;03;01;Maanantai;2;0;2
624;19.03.2018;2018;03;02;Maanantai;0;1;1
624;19.03.2018;2018;03;03;Maanantai;1;0;1
624;19.03.2018;2018;03;04;Maanantai;0;1;1
624;19.03.2018;2018;03;05;Maanantai;0;0;0
624;19.03.2018;2018;03;06;Maanantai;3;8;11
624;19.03.2018;2018;03;07;Maanantai;7;11;18
624;19.03.2018;2018;03;08;Maanantai;18;24;42
624;19.03.2018;2018;03;09;Maanantai;20;23;43
624;19.03.2018;2018;03;10;Maanantai;7;4;11
624;19.03.2018;2018;03;11;Maanantai;6;14;20
624;19.03.2018;2018;03;12;Maanantai;12;10;22
624;19.03.2018;2018;03;13;Maanantai;11;10;21
624;19.03.2018;2018;03;14;Maanantai;13;8;21
624;19.03.2018;2018;03;15;Maanantai;9;13;22
624;19.03.2018;2018;03;16;Maanantai;22;17;39
624;19.03.2018;2018;03;17;Maanantai;43;23;66
624;19.03.2018;2018;03;18;Maanantai;22;15;37
624;19.03.2018;2018;03;19;Maanantai;19;13;32
624;19.03.2018;2018;03;20;Maanantai;9;7;16
624;19.03.2018;2018;03;21;Maanantai;14;4;18
624;19.03.2018;2018;03;22;Maanantai;12;0;12
624;19.03.2018;2018;03;23;Maanantai;2;4;6
624;20.03.2018;2018;03;00;Tiistai;1;0;1
624;20.03.2018;2018;03;01;Tiistai;2;1;3
624;20.03.2018;2018;03;02;Tiistai;0;0;0
624;20.03.2018;2018;03;03;Tiistai;1;0;1
624;20.03.2018;2018;03;04;Tiistai;0;1;1
624;20.03.2018;2018;03;05;Tiistai;0;0;0
624;20.03.2018;2018;03;06;Tiistai;3;8;11
624;20.03.2018;2018;03;07;Tiistai;7;11;18
624;20.03.2018;2018;03;08;Tiistai;18;24;42
624;20.03.2018;2018;03;09;Tiistai;20;23;43
624;20.03.2018;2018;03;10;Tiistai;3;7;10
624;20.03.2018;2018;03;11;Tiistai;6;6;12
624;20.03.2018;2018;03;12;Tiistai;4;9;13
624;20.03.2018;2018;03;13;Tiistai;8;15;23
624;20.03.2018;2018;03;14;Tiistai;14;6;20
624;20.03.2018;2018;03;15;Tiistai;10;6;16
624;20.03.2018;2018;03;16;Tiistai;28;15;43
624;20.03.2018;2018;03;17;Tiistai;27;15;42
624;20.03.2018;2018;03;18;Tiistai;28;12;40
624;20.03.2018;2018;03;19;Tiistai;9;6;15
624;20.03.2018;2018;03;20;Tiistai;8;7;15
624;20.03.2018;2018;03;21;Tiistai;13;6;19
624;20.03.2018;2018;03;22;Tiistai;16;2;18
624;20.03.2018;2018;03;23;Tiistai;1;3;4
624;21.03.2018;2018;03;00;Keskiviikko;0;1;1
624;21.03.2018;2018;03;01;Keskiviikko;2;0;2
624;21.03.2018;2018;03;02;Keskiviikko;0;0;0
624;21.03.2018;2018;03;03;Keskiviikko;0;0;0
624;21.03.2018;2018;03;04;Keskiviikko;0;0;0
624;21.03.2018;2018;03;05;Keskiviikko;0;0;0
624;21.03.2018;2018;03;06;Keskiviikko;5;8;13
624;21.03.2018;2018;03;07;Keskiviikko;4;7;11
624;21.03.2018;2018;03;08;Keskiviikko;11;25;36
624;21.03.2018;2018;03;09;Keskiviikko;9;25;34
624;21.03.2018;2018;03;10;Keskiviikko;11;10;21
624;21.03.2018;2018;03;11;Keskiviikko;4;7;11
624;21.03.2018;2018;03;12;Keskiviikko;6;10;16
624;21.03.2018;2018;03;13;Keskiviikko;10;10;20
624;21.03.2018;2018;03;14;Keskiviikko;8;4;12
624;21.03.2018;2018;03;15;Keskiviikko;7;8;15
624;21.03.2018;2018;03;16;Keskiviikko;26;10;36
624;21.03.2018;2018;03;17;Keskiviikko;26;13;39
624;21.03.2018;2018;03;18;Keskiviikko;27;17;44
624;21.03.2018;2018;03;19;Keskiviikko;20;7;27
624;21.03.2018;2018;03;20;Keskiviikko;13;6;19
624;21.03.2018;2018;03;21;Keskiviikko;8;2;10
624;21.03.2018;2018;03;22;Keskiviikko;8;4;12
624;21.03.2018;2018;03;23;Keskiviikko;2;1;3
624;22.03.2018;2018;03;00;Torstai;3;2;5
624;22.03.2018;2018;03;01;Torstai;0;1;1
624;22.03.2018;2018;03;02;Torstai;0;0;0
624;22.03.2018;2018;03;03;Torstai;0;0;0
624;22.03.2018;2018;03;04;Torstai;1;1;2
624;22.03.2018;2018;03;05;Torstai;1;0;1
624;22.03.2018;2018;03;06;Torstai;6;8;14
624;22.03.2018;2018;03;07;Torstai;9;11;20
624;22.03.2018;2018;03;08;Torstai;23;29;52
624;22.03.2018;2018;03;09;Torstai;7;28;35
624;22.03.2018;2018;03;10;Torstai;5;11;16
624;22.03.2018;2018;03;11;Torstai;3;6;9
624;22.03.2018;2018;03;12;Torstai;4;7;11
624;22.03.2018;2018;03;13;Torstai;3;3;6
624;22.03.2018;2018;03;14;Torstai;7;7;14
624;22.03.2018;2018;03;15;Torstai;11;17;28
624;22.03.2018;2018;03;16;Torstai;23;15;38
624;22.03.2018;2018;03;17;Torstai;27;22;49
624;22.03.2018;2018;03;18;Torstai;16;7;23
624;22.03.2018;2018;03;19;Torstai;23;9;32
624;22.03.2018;2018;03;20;Torstai;18;9;27
624;22.03.2018;2018;03;21;Torstai;11;6;17
624;22.03.2018;2018;03;22;Torstai;8;2;10
624;22.03.2018;2018;03;23;Torstai;2;3;5
624;23.03.2018;2018;03;00;Perjantai;2;0;2
624;23.03.2018;2018;03;01;Perjantai;3;1;4
624;23.03.2018;2018;03;02;Perjantai;0;1;1
624;23.03.2018;2018;03;03;Perjantai;0;2;2
624;23.03.2018;2018;03;04;Perjantai;1;1;2
624;23.03.2018;2018;03;05;Perjantai;0;1;1
624;23.03.2018;2018;03;06;Perjantai;2;4;6
624;23.03.2018;2018;03;07;Perjantai;5;11;16
624;23.03.2018;2018;03;08;Perjantai;11;20;31
624;23.03.2018;2018;03;09;Perjantai;10;28;38
624;23.03.2018;2018;03;10;Perjantai;4;8;12
624;23.03.2018;2018;03;11;Perjantai;7;8;15
624;23.03.2018;2018;03;12;Perjantai;9;6;15
624;23.03.2018;2018;03;13;Perjantai;12;14;26
624;23.03.2018;2018;03;14;Perjantai;10;9;19
624;23.03.2018;2018;03;15;Perjantai;17;8;25
624;23.03.2018;2018;03;16;Perjantai;28;13;41
624;23.03.2018;2018;03;17;Perjantai;29;8;37
624;23.03.2018;2018;03;18;Perjantai;15;13;28
624;23.03.2018;2018;03;19;Perjantai;11;6;17
624;23.03.2018;2018;03;20;Perjantai;9;3;12
624;23.03.2018;2018;03;21;Perjantai;9;5;14
624;23.03.2018;2018;03;22;Perjantai;8;3;11
624;23.03.2018;2018;03;23;Perjantai;2;2;4
624;24.03.2018;2018;03;00;Lauantai;4;2;6
624;24.03.2018;2018;03;01;Lauantai;1;0;1
624;24.03.2018;2018;03;02;Lauantai;1;0;1
624;24.03.2018;2018;03;03;Lauantai;1;1;2
624;24.03.2018;2018;03;04;Lauantai;0;2;2
624;24.03.2018;2018;03;05;Lauantai;0;1;1
624;24.03.2018;2018;03;06;Lauantai;0;2;2
624;24.03.2018;2018;03;07;Lauantai;0;1;1
624;24.03.2018;2018;03;08;Lauantai;1;1;2
624;24.03.2018;2018;03;09;Lauantai;3;6;9
624;24.03.2018;2018;03;10;Lauantai;2;7;9
624;24.03.2018;2018;03;11;Lauantai;4;4;8
624;24.03.2018;2018;03;12;Lauantai;6;5;11
624;24.03.2018;2018;03;13;Lauantai;5;6;11
624;24.03.2018;2018;03;14;Lauantai;6;9;15
624;24.03.2018;2018;03;15;Lauantai;4;2;6
624;24.03.2018;2018;03;16;Lauantai;5;2;7
624;24.03.2018;2018;03;17;Lauantai;3;1;4
624;24.03.2018;2018;03;18;Lauantai;3;3;6
624;24.03.2018;2018;03;19;Lauantai;5;2;7
624;24.03.2018;2018;03;20;Lauantai;6;3;9
624;24.03.2018;2018;03;21;Lauantai;5;3;8
624;24.03.2018;2018;03;22;Lauantai;2;4;6
624;24.03.2018;2018;03;23;Lauantai;1;2;3
624;25.03.2018;2018;03;00;Sunnuntai;4;0;4
624;25.03.2018;2018;03;01;Sunnuntai;2;2;4
624;25.03.2018;2018;03;02;Sunnuntai;0;0;0
624;25.03.2018;2018;03;03;Sunnuntai;0;0;0
624;25.03.2018;2018;03;04;Sunnuntai;0;0;0
624;25.03.2018;2018;03;05;Sunnuntai;2;4;6
624;25.03.2018;2018;03;06;Sunnuntai;2;2;4
624;25.03.2018;2018;03;07;Sunnuntai;0;1;1
624;25.03.2018;2018;03;08;Sunnuntai;0;1;1
624;25.03.2018;2018;03;09;Sunnuntai;0;4;4
624;25.03.2018;2018;03;10;Sunnuntai;2;3;5
624;25.03.2018;2018;03;11;Sunnuntai;1;3;4
624;25.03.2018;2018;03;12;Sunnuntai;5;5;10
624;25.03.2018;2018;03;13;Sunnuntai;5;6;11
624;25.03.2018;2018;03;14;Sunnuntai;6;6;12
624;25.03.2018;2018;03;15;Sunnuntai;6;8;14
624;25.03.2018;2018;03;16;Sunnuntai;8;9;17
624;25.03.2018;2018;03;17;Sunnuntai;8;13;21
624;25.03.2018;2018;03;18;Sunnuntai;10;10;20
624;25.03.2018;2018;03;19;Sunnuntai;9;4;13
624;25.03.2018;2018;03;20;Sunnuntai;9;5;14
624;25.03.2018;2018;03;21;Sunnuntai;6;3;9
624;25.03.2018;2018;03;22;Sunnuntai;2;4;6
624;25.03.2018;2018;03;23;Sunnuntai;4;3;7
624;26.03.2018;2018;03;00;Maanantai;1;0;1
624;26.03.2018;2018;03;01;Maanantai;0;0;0
624;26.03.2018;2018;03;02;Maanantai;0;1;1
624;26.03.2018;2018;03;03;Maanantai;0;0;0
624;26.03.2018;2018;03;04;Maanantai;0;0;0
624;26.03.2018;2018;03;05;Maanantai;1;0;1
624;26.03.2018;2018;03;06;Maanantai;3;4;7
624;26.03.2018;2018;03;07;Maanantai;7;13;20
624;26.03.2018;2018;03;08;Maanantai;19;29;48
624;26.03.2018;2018;03;09;Maanantai;11;28;39
624;26.03.2018;2018;03;10;Maanantai;8;11;19
624;26.03.2018;2018;03;11;Maanantai;4;4;8
624;26.03.2018;2018;03;12;Maanantai;8;13;21
624;26.03.2018;2018;03;13;Maanantai;8;6;14
624;26.03.2018;2018;03;14;Maanantai;15;7;22
624;26.03.2018;2018;03;15;Maanantai;17;10;27
624;26.03.2018;2018;03;16;Maanantai;26;15;41
624;26.03.2018;2018;03;17;Maanantai;35;16;51
624;26.03.2018;2018;03;18;Maanantai;26;14;40
624;26.03.2018;2018;03;19;Maanantai;15;9;24
624;26.03.2018;2018;03;20;Maanantai;11;11;22
624;26.03.2018;2018;03;21;Maanantai;22;1;23
624;26.03.2018;2018;03;22;Maanantai;9;2;11
624;26.03.2018;2018;03;23;Maanantai;5;0;5
624;27.03.2018;2018;03;00;Tiistai;5;0;5
624;27.03.2018;2018;03;01;Tiistai;0;0;0
624;27.03.2018;2018;03;02;Tiistai;0;0;0
624;27.03.2018;2018;03;03;Tiistai;1;0;1
624;27.03.2018;2018;03;04;Tiistai;0;0;0
624;27.03.2018;2018;03;05;Tiistai;2;1;3
624;27.03.2018;2018;03;06;Tiistai;3;5;8
624;27.03.2018;2018;03;07;Tiistai;12;11;23
624;27.03.2018;2018;03;08;Tiistai;15;27;42
624;27.03.2018;2018;03;09;Tiistai;17;22;39
624;27.03.2018;2018;03;10;Tiistai;9;9;18
624;27.03.2018;2018;03;11;Tiistai;8;3;11
624;27.03.2018;2018;03;12;Tiistai;5;5;10
624;27.03.2018;2018;03;13;Tiistai;5;9;14
624;27.03.2018;2018;03;14;Tiistai;10;14;24
624;27.03.2018;2018;03;15;Tiistai;11;14;25
624;27.03.2018;2018;03;16;Tiistai;33;15;48
624;27.03.2018;2018;03;17;Tiistai;26;15;41
624;27.03.2018;2018;03;18;Tiistai;14;14;28
624;27.03.2018;2018;03;19;Tiistai;15;8;23
624;27.03.2018;2018;03;20;Tiistai;9;9;18
624;27.03.2018;2018;03;21;Tiistai;20;0;20
624;27.03.2018;2018;03;22;Tiistai;8;2;10
624;27.03.2018;2018;03;23;Tiistai;5;5;10
624;28.03.2018;2018;03;00;Keskiviikko;1;2;3
624;28.03.2018;2018;03;01;Keskiviikko;1;0;1
624;28.03.2018;2018;03;02;Keskiviikko;1;0;1
624;28.03.2018;2018;03;03;Keskiviikko;0;1;1
624;28.03.2018;2018;03;04;Keskiviikko;0;1;1
624;28.03.2018;2018;03;05;Keskiviikko;2;0;2
624;28.03.2018;2018;03;06;Keskiviikko;2;4;6
624;28.03.2018;2018;03;07;Keskiviikko;7;19;26
624;28.03.2018;2018;03;08;Keskiviikko;14;35;49
624;28.03.2018;2018;03;09;Keskiviikko;13;19;32
624;28.03.2018;2018;03;10;Keskiviikko;10;11;21
624;28.03.2018;2018;03;11;Keskiviikko;4;9;13
624;28.03.2018;2018;03;12;Keskiviikko;8;4;12
624;28.03.2018;2018;03;13;Keskiviikko;10;10;20
624;28.03.2018;2018;03;14;Keskiviikko;12;9;21
624;28.03.2018;2018;03;15;Keskiviikko;12;7;19
624;28.03.2018;2018;03;16;Keskiviikko;39;11;50
624;28.03.2018;2018;03;17;Keskiviikko;29;21;50
624;28.03.2018;2018;03;18;Keskiviikko;27;15;42
624;28.03.2018;2018;03;19;Keskiviikko;16;3;19
624;28.03.2018;2018;03;20;Keskiviikko;15;8;23
624;28.03.2018;2018;03;21;Keskiviikko;11;1;12
624;28.03.2018;2018;03;22;Keskiviikko;19;1;20
624;28.03.2018;2018;03;23;Keskiviikko;7;5;12
624;29.03.2018;2018;03;00;Torstai;1;2;3
624;29.03.2018;2018;03;01;Torstai;2;1;3
624;29.03.2018;2018;03;02;Torstai;1;0;1
624;29.03.2018;2018;03;03;Torstai;1;2;3
624;29.03.2018;2018;03;04;Torstai;1;2;3
624;29.03.2018;2018;03;05;Torstai;3;2;5
624;29.03.2018;2018;03;06;Torstai;2;10;12
624;29.03.2018;2018;03;07;Torstai;7;10;17
624;29.03.2018;2018;03;08;Torstai;11;26;37
624;29.03.2018;2018;03;09;Torstai;15;24;39
624;29.03.2018;2018;03;10;Torstai;12;8;20
624;29.03.2018;2018;03;11;Torstai;8;10;18
624;29.03.2018;2018;03;12;Torstai;15;6;21
624;29.03.2018;2018;03;13;Torstai;17;16;33
624;29.03.2018;2018;03;14;Torstai;27;15;42
624;29.03.2018;2018;03;15;Torstai;22;11;33
624;29.03.2018;2018;03;16;Torstai;27;16;43
624;29.03.2018;2018;03;17;Torstai;25;14;39
624;29.03.2018;2018;03;18;Torstai;18;9;27
624;29.03.2018;2018;03;19;Torstai;11;5;16
624;29.03.2018;2018;03;20;Torstai;12;5;17
624;29.03.2018;2018;03;21;Torstai;3;4;7
624;29.03.2018;2018;03;22;Torstai;7;6;13
624;29.03.2018;2018;03;23;Torstai;3;3;6
624;30.03.2018;2018;03;00;Perjantai;4;0;4
624;30.03.2018;2018;03;01;Perjantai;2;1;3
624;30.03.2018;2018;03;02;Perjantai;0;0;0
624;30.03.2018;2018;03;03;Perjantai;1;0;1
624;30.03.2018;2018;03;04;Perjantai;1;0;1
624;30.03.2018;2018;03;05;Perjantai;1;0;1
624;30.03.2018;2018;03;06;Perjantai;4;0;4
624;30.03.2018;2018;03;07;Perjantai;1;2;3
624;30.03.2018;2018;03;08;Perjantai;1;1;2
624;30.03.2018;2018;03;09;Perjantai;0;2;2
624;30.03.2018;2018;03;10;Perjantai;1;1;2
624;30.03.2018;2018;03;11;Perjantai;3;1;4
624;30.03.2018;2018;03;12;Perjantai;3;1;4
624;30.03.2018;2018;03;13;Perjantai;1;3;4
624;30.03.2018;2018;03;14;Perjantai;2;4;6
624;30.03.2018;2018;03;15;Perjantai;10;5;15
624;30.03.2018;2018;03;16;Perjantai;11;8;19
624;30.03.2018;2018;03;17;Perjantai;11;10;21
624;30.03.2018;2018;03;18;Perjantai;8;3;11
624;30.03.2018;2018;03;19;Perjantai;9;6;15
624;30.03.2018;2018;03;20;Perjantai;10;3;13
624;30.03.2018;2018;03;21;Perjantai;4;3;7
624;30.03.2018;2018;03;22;Perjantai;5;3;8
624;30.03.2018;2018;03;23;Perjantai;2;1;3
624;31.03.2018;2018;03;00;Lauantai;0;1;1
624;31.03.2018;2018;03;01;Lauantai;0;0;0
624;31.03.2018;2018;03;02;Lauantai;0;1;1
624;31.03.2018;2018;03;03;Lauantai;0;2;2
624;31.03.2018;2018;03;04;Lauantai;0;2;2
624;31.03.2018;2018;03;05;Lauantai;3;0;3
624;31.03.2018;2018;03;06;Lauantai;0;1;1
624;31.03.2018;2018;03;07;Lauantai;3;3;6
624;31.03.2018;2018;03;08;Lauantai;1;3;4
624;31.03.2018;2018;03;09;Lauantai;1;1;2
624;31.03.2018;2018;03;10;Lauantai;0;5;5
624;31.03.2018;2018;03;11;Lauantai;2;7;9
624;31.03.2018;2018;03;12;Lauantai;8;4;12
624;31.03.2018;2018;03;13;Lauantai;3;10;13
624;31.03.2018;2018;03;14;Lauantai;3;8;11
624;31.03.2018;2018;03;15;Lauantai;2;3;5
624;31.03.2018;2018;03;16;Lauantai;3;5;8
624;31.03.2018;2018;03;17;Lauantai;4;6;10
624;31.03.2018;2018;03;18;Lauantai;0;3;3
624;31.03.2018;2018;03;19;Lauantai;1;1;2
624;31.03.2018;2018;03;20;Lauantai;2;5;7
624;31.03.2018;2018;03;21;Lauantai;5;5;10
624;31.03.2018;2018;03;22;Lauantai;3;3;6
624;31.03.2018;2018;03;23;Lauantai;3;0;3
624;01.04.2018;2018;04;00;Sunnuntai;1;1;2
624;01.04.2018;2018;04;01;Sunnuntai;0;1;1
624;01.04.2018;2018;04;02;Sunnuntai;2;1;3
624;01.04.2018;2018;04;03;Sunnuntai;0;2;2
624;01.04.2018;2018;04;04;Sunnuntai;1;0;1
624;01.04.2018;2018;04;05;Sunnuntai;2;3;5
624;01.04.2018;2018;04;06;Sunnuntai;1;1;2
624;01.04.2018;2018;04;07;Sunnuntai;2;1;3
624;01.04.2018;2018;04;08;Sunnuntai;0;0;0
624;01.04.2018;2018;04;09;Sunnuntai;1;0;1
624;01.04.2018;2018;04;10;Sunnuntai;0;1;1
624;01.04.2018;2018;04;11;Sunnuntai;3;9;12
624;01.04.2018;2018;04;12;Sunnuntai;2;5;7
624;01.04.2018;2018;04;13;Sunnuntai;6;7;13
624;01.04.2018;2018;04;14;Sunnuntai;9;7;16
624;01.04.2018;2018;04;15;Sunnuntai;3;4;7
624;01.04.2018;2018;04;16;Sunnuntai;7;11;18
624;01.04.2018;2018;04;17;Sunnuntai;5;4;9
624;01.04.2018;2018;04;18;Sunnuntai;2;4;6
624;01.04.2018;2018;04;19;Sunnuntai;0;4;4
624;01.04.2018;2018;04;20;Sunnuntai;3;4;7
624;01.04.2018;2018;04;21;Sunnuntai;5;1;6
624;01.04.2018;2018;04;22;Sunnuntai;6;5;11
624;01.04.2018;2018;04;23;Sunnuntai;1;0;1
624;02.04.2018;2018;04;00;Maanantai;1;1;2
624;02.04.2018;2018;04;01;Maanantai;1;0;1
624;02.04.2018;2018;04;02;Maanantai;1;0;1
624;02.04.2018;2018;04;03;Maanantai;0;0;0
624;02.04.2018;2018;04;04;Maanantai;1;0;1
624;02.04.2018;2018;04;05;Maanantai;2;1;3
624;02.04.2018;2018;04;06;Maanantai;0;0;0
624;02.04.2018;2018;04;07;Maanantai;2;0;2
624;02.04.2018;2018;04;08;Maanantai;1;0;1
624;02.04.2018;2018;04;09;Maanantai;0;1;1
624;02.04.2018;2018;04;10;Maanantai;0;1;1
624;02.04.2018;2018;04;11;Maanantai;4;3;7
624;02.04.2018;2018;04;12;Maanantai;0;2;2
624;02.04.2018;2018;04;13;Maanantai;2;13;15
624;02.04.2018;2018;04;14;Maanantai;5;6;11
624;02.04.2018;2018;04;15;Maanantai;1;6;7
624;02.04.2018;2018;04;16;Maanantai;5;2;7
624;02.04.2018;2018;04;17;Maanantai;3;5;8
624;02.04.2018;2018;04;18;Maanantai;3;4;7
624;02.04.2018;2018;04;19;Maanantai;2;8;10
624;02.04.2018;2018;04;20;Maanantai;3;2;5
624;02.04.2018;2018;04;21;Maanantai;6;3;9
624;02.04.2018;2018;04;22;Maanantai;5;2;7
624;02.04.2018;2018;04;23;Maanantai;2;1;3
624;03.04.2018;2018;04;00;Tiistai;2;1;3
624;03.04.2018;2018;04;01;Tiistai;2;0;2
624;03.04.2018;2018;04;02;Tiistai;1;0;1
624;03.04.2018;2018;04;03;Tiistai;0;1;1
624;03.04.2018;2018;04;04;Tiistai;0;0;0
624;03.04.2018;2018;04;05;Tiistai;1;1;2
624;03.04.2018;2018;04;06;Tiistai;2;5;7
624;03.04.2018;2018;04;07;Tiistai;7;13;20
624;03.04.2018;2018;04;08;Tiistai;13;26;39
624;03.04.2018;2018;04;09;Tiistai;10;30;40
624;03.04.2018;2018;04;10;Tiistai;8;12;20
624;03.04.2018;2018;04;11;Tiistai;7;10;17
624;03.04.2018;2018;04;12;Tiistai;12;6;18
624;03.04.2018;2018;04;13;Tiistai;8;10;18
624;03.04.2018;2018;04;14;Tiistai;6;14;20
624;03.04.2018;2018;04;15;Tiistai;11;9;20
624;03.04.2018;2018;04;16;Tiistai;16;18;34
624;03.04.2018;2018;04;17;Tiistai;28;18;46
624;03.04.2018;2018;04;18;Tiistai;15;13;28
624;03.04.2018;2018;04;19;Tiistai;11;9;20
624;03.04.2018;2018;04;20;Tiistai;7;5;12
624;03.04.2018;2018;04;21;Tiistai;8;6;14
624;03.04.2018;2018;04;22;Tiistai;15;5;20
624;03.04.2018;2018;04;23;Tiistai;3;3;6
624;04.04.2018;2018;04;00;Keskiviikko;0;0;0
624;04.04.2018;2018;04;01;Keskiviikko;1;1;2
624;04.04.2018;2018;04;02;Keskiviikko;0;0;0
624;04.04.2018;2018;04;03;Keskiviikko;0;0;0
624;04.04.2018;2018;04;04;Keskiviikko;1;1;2
624;04.04.2018;2018;04;05;Keskiviikko;1;0;1
624;04.04.2018;2018;04;06;Keskiviikko;0;7;7
624;04.04.2018;2018;04;07;Keskiviikko;10;19;29
624;04.04.2018;2018;04;08;Keskiviikko;15;32;47
624;04.04.2018;2018;04;09;Keskiviikko;13;29;42
624;04.04.2018;2018;04;10;Keskiviikko;14;4;18
624;04.04.2018;2018;04;11;Keskiviikko;4;7;11
624;04.04.2018;2018;04;12;Keskiviikko;10;8;18
624;04.04.2018;2018;04;13;Keskiviikko;14;17;31
624;04.04.2018;2018;04;14;Keskiviikko;17;16;33
624;04.04.2018;2018;04;15;Keskiviikko;18;18;36
624;04.04.2018;2018;04;16;Keskiviikko;31;18;49
624;04.04.2018;2018;04;17;Keskiviikko;45;22;67
624;04.04.2018;2018;04;18;Keskiviikko;26;17;43
624;04.04.2018;2018;04;19;Keskiviikko;14;15;29
624;04.04.2018;2018;04;20;Keskiviikko;16;12;28
624;04.04.2018;2018;04;21;Keskiviikko;14;4;18
624;04.04.2018;2018;04;22;Keskiviikko;14;2;16
624;04.04.2018;2018;04;23;Keskiviikko;4;3;7
624;05.04.2018;2018;04;00;Torstai;3;0;3
624;05.04.2018;2018;04;01;Torstai;0;1;1
624;05.04.2018;2018;04;02;Torstai;0;0;0
624;05.04.2018;2018;04;03;Torstai;1;1;2
624;05.04.2018;2018;04;04;Torstai;0;1;1
624;05.04.2018;2018;04;05;Torstai;0;0;0
624;05.04.2018;2018;04;06;Torstai;4;5;9
624;05.04.2018;2018;04;07;Torstai;9;18;27
624;05.04.2018;2018;04;08;Torstai;13;36;49
624;05.04.2018;2018;04;09;Torstai;10;40;50
624;05.04.2018;2018;04;10;Torstai;11;14;25
624;05.04.2018;2018;04;11;Torstai;5;6;11
624;05.04.2018;2018;04;12;Torstai;6;9;15
624;05.04.2018;2018;04;13;Torstai;12;11;23
624;05.04.2018;2018;04;14;Torstai;16;10;26
624;05.04.2018;2018;04;15;Torstai;16;9;25
624;05.04.2018;2018;04;16;Torstai;22;21;43
624;05.04.2018;2018;04;17;Torstai;27;27;54
624;05.04.2018;2018;04;18;Torstai;18;19;37
624;05.04.2018;2018;04;19;Torstai;15;11;26
624;05.04.2018;2018;04;20;Torstai;25;9;34
624;05.04.2018;2018;04;21;Torstai;13;7;20
624;05.04.2018;2018;04;22;Torstai;7;5;12
624;05.04.2018;2018;04;23;Torstai;5;2;7
624;06.04.2018;2018;04;00;Perjantai;2;1;3
624;06.04.2018;2018;04;01;Perjantai;1;1;2
624;06.04.2018;2018;04;02;Perjantai;0;0;0
624;06.04.2018;2018;04;03;Perjantai;0;1;1
624;06.04.2018;2018;04;04;Perjantai;0;1;1
624;06.04.2018;2018;04;05;Perjantai;0;1;1
624;06.04.2018;2018;04;06;Perjantai;1;5;6
624;06.04.2018;2018;04;07;Perjantai;3;17;20
624;06.04.2018;2018;04;08;Perjantai;5;34;39
624;06.04.2018;2018;04;09;Perjantai;10;33;43
624;06.04.2018;2018;04;10;Perjantai;8;15;23
624;06.04.2018;2018;04;11;Perjantai;8;13;21
624;06.04.2018;2018;04;12;Perjantai;4;11;15
624;06.04.2018;2018;04;13;Perjantai;8;11;19
624;06.04.2018;2018;04;14;Perjantai;14;11;25
624;06.04.2018;2018;04;15;Perjantai;8;22;30
624;06.04.2018;2018;04;16;Perjantai;20;11;31
624;06.04.2018;2018;04;17;Perjantai;21;5;26
624;06.04.2018;2018;04;18;Perjantai;13;12;25
624;06.04.2018;2018;04;19;Perjantai;9;15;24
624;06.04.2018;2018;04;20;Perjantai;6;5;11
624;06.04.2018;2018;04;21;Perjantai;6;5;11
624;06.04.2018;2018;04;22;Perjantai;8;2;10
624;06.04.2018;2018;04;23;Perjantai;1;3;4
624;07.04.2018;2018;04;00;Lauantai;2;0;2
624;07.04.2018;2018;04;01;Lauantai;0;0;0
624;07.04.2018;2018;04;02;Lauantai;1;1;2
624;07.04.2018;2018;04;03;Lauantai;0;0;0
624;07.04.2018;2018;04;04;Lauantai;0;0;0
624;07.04.2018;2018;04;05;Lauantai;1;2;3
624;07.04.2018;2018;04;06;Lauantai;0;2;2
624;07.04.2018;2018;04;07;Lauantai;1;6;7
624;07.04.2018;2018;04;08;Lauantai;1;2;3
624;07.04.2018;2018;04;09;Lauantai;1;1;2
624;07.04.2018;2018;04;10;Lauantai;2;4;6
624;07.04.2018;2018;04;11;Lauantai;3;6;9
624;07.04.2018;2018;04;12;Lauantai;1;9;10
624;07.04.2018;2018;04;13;Lauantai;2;12;14
624;07.04.2018;2018;04;14;Lauantai;7;11;18
624;07.04.2018;2018;04;15;Lauantai;1;11;12
624;07.04.2018;2018;04;16;Lauantai;7;7;14
624;07.04.2018;2018;04;17;Lauantai;10;9;19
624;07.04.2018;2018;04;18;Lauantai;9;11;20
624;07.04.2018;2018;04;19;Lauantai;6;3;9
624;07.04.2018;2018;04;20;Lauantai;5;4;9
624;07.04.2018;2018;04;21;Lauantai;5;7;12
624;07.04.2018;2018;04;22;Lauantai;6;1;7
624;07.04.2018;2018;04;23;Lauantai;4;6;10
624;08.04.2018;2018;04;00;Sunnuntai;1;0;1
624;08.04.2018;2018;04;01;Sunnuntai;4;1;5
624;08.04.2018;2018;04;02;Sunnuntai;0;2;2
624;08.04.2018;2018;04;03;Sunnuntai;3;3;6
624;08.04.2018;2018;04;04;Sunnuntai;0;0;0
624;08.04.2018;2018;04;05;Sunnuntai;1;1;2
624;08.04.2018;2018;04;06;Sunnuntai;3;0;3
624;08.04.2018;2018;04;07;Sunnuntai;0;2;2
624;08.04.2018;2018;04;08;Sunnuntai;0;1;1
624;08.04.2018;2018;04;09;Sunnuntai;1;0;1
624;08.04.2018;2018;04;10;Sunnuntai;2;4;6
624;08.04.2018;2018;04;11;Sunnuntai;1;4;5
624;08.04.2018;2018;04;12;Sunnuntai;4;9;13
624;08.04.2018;2018;04;13;Sunnuntai;2;5;7
624;08.04.2018;2018;04;14;Sunnuntai;5;9;14
624;08.04.2018;2018;04;15;Sunnuntai;6;9;15
624;08.04.2018;2018;04;16;Sunnuntai;9;7;16
624;08.04.2018;2018;04;17;Sunnuntai;5;12;17
624;08.04.2018;2018;04;18;Sunnuntai;4;12;16
624;08.04.2018;2018;04;19;Sunnuntai;9;7;16
624;08.04.2018;2018;04;20;Sunnuntai;5;3;8
624;08.04.2018;2018;04;21;Sunnuntai;2;2;4
624;08.04.2018;2018;04;22;Sunnuntai;4;3;7
624;08.04.2018;2018;04;23;Sunnuntai;0;0;0
624;09.04.2018;2018;04;00;Maanantai;0;1;1
624;09.04.2018;2018;04;01;Maanantai;1;1;2
624;09.04.2018;2018;04;02;Maanantai;0;0;0
624;09.04.2018;2018;04;03;Maanantai;0;0;0
624;09.04.2018;2018;04;04;Maanantai;0;0;0
624;09.04.2018;2018;04;05;Maanantai;0;1;1
624;09.04.2018;2018;04;06;Maanantai;3;6;9
624;09.04.2018;2018;04;07;Maanantai;4;14;18
624;09.04.2018;2018;04;08;Maanantai;9;47;56
624;09.04.2018;2018;04;09;Maanantai;15;35;50
624;09.04.2018;2018;04;10;Maanantai;13;18;31
624;09.04.2018;2018;04;11;Maanantai;8;11;19
624;09.04.2018;2018;04;12;Maanantai;4;13;17
624;09.04.2018;2018;04;13;Maanantai;11;11;22
624;09.04.2018;2018;04;14;Maanantai;13;15;28
624;09.04.2018;2018;04;15;Maanantai;10;11;21
624;09.04.2018;2018;04;16;Maanantai;16;12;28
624;09.04.2018;2018;04;17;Maanantai;31;25;56
624;09.04.2018;2018;04;18;Maanantai;16;13;29
624;09.04.2018;2018;04;19;Maanantai;8;13;21
624;09.04.2018;2018;04;20;Maanantai;10;13;23
624;09.04.2018;2018;04;21;Maanantai;8;8;16
624;09.04.2018;2018;04;22;Maanantai;8;5;13
624;09.04.2018;2018;04;23;Maanantai;3;6;9
624;10.04.2018;2018;04;00;Tiistai;0;0;0
624;10.04.2018;2018;04;01;Tiistai;2;0;2
624;10.04.2018;2018;04;02;Tiistai;0;0;0
624;10.04.2018;2018;04;03;Tiistai;0;0;0
624;10.04.2018;2018;04;04;Tiistai;0;1;1
624;10.04.2018;2018;04;05;Tiistai;1;0;1
624;10.04.2018;2018;04;06;Tiistai;0;5;5
624;10.04.2018;2018;04;07;Tiistai;3;20;23
624;10.04.2018;2018;04;08;Tiistai;16;48;64
624;10.04.2018;2018;04;09;Tiistai;7;35;42
624;10.04.2018;2018;04;10;Tiistai;3;16;19
624;10.04.2018;2018;04;11;Tiistai;2;12;14
624;10.04.2018;2018;04;12;Tiistai;7;10;17
624;10.04.2018;2018;04;13;Tiistai;11;10;21
624;10.04.2018;2018;04;14;Tiistai;11;10;21
624;10.04.2018;2018;04;15;Tiistai;10;12;22
624;10.04.2018;2018;04;16;Tiistai;22;15;37
624;10.04.2018;2018;04;17;Tiistai;32;27;59
624;10.04.2018;2018;04;18;Tiistai;24;15;39
624;10.04.2018;2018;04;19;Tiistai;6;4;10
624;10.04.2018;2018;04;20;Tiistai;2;6;8
624;10.04.2018;2018;04;21;Tiistai;3;5;8
624;10.04.2018;2018;04;22;Tiistai;7;7;14
624;10.04.2018;2018;04;23;Tiistai;3;3;6
624;11.04.2018;2018;04;00;Keskiviikko;1;0;1
624;11.04.2018;2018;04;01;Keskiviikko;0;0;0
624;11.04.2018;2018;04;02;Keskiviikko;0;0;0
624;11.04.2018;2018;04;03;Keskiviikko;0;0;0
624;11.04.2018;2018;04;04;Keskiviikko;0;1;1
624;11.04.2018;2018;04;05;Keskiviikko;1;0;1
624;11.04.2018;2018;04;06;Keskiviikko;1;2;3
624;11.04.2018;2018;04;07;Keskiviikko;2;16;18
624;11.04.2018;2018;04;08;Keskiviikko;8;44;52
624;11.04.2018;2018;04;09;Keskiviikko;5;34;39
624;11.04.2018;2018;04;10;Keskiviikko;6;19;25
624;11.04.2018;2018;04;11;Keskiviikko;3;10;13
624;11.04.2018;2018;04;12;Keskiviikko;8;11;19
624;11.04.2018;2018;04;13;Keskiviikko;2;17;19
624;11.04.2018;2018;04;14;Keskiviikko;9;11;20
624;11.04.2018;2018;04;15;Keskiviikko;10;15;25
624;11.04.2018;2018;04;16;Keskiviikko;17;12;29
624;11.04.2018;2018;04;17;Keskiviikko;20;17;37
624;11.04.2018;2018;04;18;Keskiviikko;6;20;26
624;11.04.2018;2018;04;19;Keskiviikko;11;4;15
624;11.04.2018;2018;04;20;Keskiviikko;5;16;21
624;11.04.2018;2018;04;21;Keskiviikko;5;2;7
624;11.04.2018;2018;04;22;Keskiviikko;15;3;18
624;11.04.2018;2018;04;23;Keskiviikko;4;1;5
624;12.04.2018;2018;04;00;Torstai;0;1;1
624;12.04.2018;2018;04;01;Torstai;1;1;2
624;12.04.2018;2018;04;02;Torstai;0;1;1
624;12.04.2018;2018;04;03;Torstai;0;0;0
624;12.04.2018;2018;04;04;Torstai;0;2;2
624;12.04.2018;2018;04;05;Torstai;1;0;1
624;12.04.2018;2018;04;06;Torstai;1;5;6
624;12.04.2018;2018;04;07;Torstai;1;18;19
624;12.04.2018;2018;04;08;Torstai;5;37;42
624;12.04.2018;2018;04;09;Torstai;10;41;51
624;12.04.2018;2018;04;10;Torstai;7;19;26
624;12.04.2018;2018;04;11;Torstai;3;15;18
624;12.04.2018;2018;04;12;Torstai;5;15;20
624;12.04.2018;2018;04;13;Torstai;10;16;26
624;12.04.2018;2018;04;14;Torstai;1;16;17
624;12.04.2018;2018;04;15;Torstai;11;7;18
624;12.04.2018;2018;04;16;Torstai;12;33;45
624;12.04.2018;2018;04;17;Torstai;15;16;31
624;12.04.2018;2018;04;18;Torstai;12;22;34
624;12.04.2018;2018;04;19;Torstai;5;16;21
624;12.04.2018;2018;04;20;Torstai;7;14;21
624;12.04.2018;2018;04;21;Torstai;10;8;18
624;12.04.2018;2018;04;22;Torstai;8;9;17
624;12.04.2018;2018;04;23;Torstai;4;5;9
624;13.04.2018;2018;04;00;Perjantai;3;3;6
624;13.04.2018;2018;04;01;Perjantai;4;2;6
624;13.04.2018;2018;04;02;Perjantai;0;0;0
624;13.04.2018;2018;04;03;Perjantai;1;0;1
624;13.04.2018;2018;04;04;Perjantai;1;0;1
624;13.04.2018;2018;04;05;Perjantai;0;1;1
624;13.04.2018;2018;04;06;Perjantai;1;4;5
624;13.04.2018;2018;04;07;Perjantai;2;21;23
624;13.04.2018;2018;04;08;Perjantai;8;43;51
624;13.04.2018;2018;04;09;Perjantai;7;34;41
624;13.04.2018;2018;04;10;Perjantai;3;13;16
624;13.04.2018;2018;04;11;Perjantai;6;11;17
624;13.04.2018;2018;04;12;Perjantai;5;19;24
624;13.04.2018;2018;04;13;Perjantai;5;25;30
624;13.04.2018;2018;04;14;Perjantai;12;11;23
624;13.04.2018;2018;04;15;Perjantai;9;13;22
624;13.04.2018;2018;04;16;Perjantai;12;17;29
624;13.04.2018;2018;04;17;Perjantai;15;11;26
624;13.04.2018;2018;04;18;Perjantai;10;20;30
624;13.04.2018;2018;04;19;Perjantai;3;15;18
624;13.04.2018;2018;04;20;Perjantai;5;12;17
624;13.04.2018;2018;04;21;Perjantai;4;6;10
624;13.04.2018;2018;04;22;Perjantai;5;6;11
624;13.04.2018;2018;04;23;Perjantai;1;7;8
624;14.04.2018;2018;04;00;Lauantai;2;3;5
624;14.04.2018;2018;04;01;Lauantai;1;1;2
624;14.04.2018;2018;04;02;Lauantai;1;1;2
624;14.04.2018;2018;04;03;Lauantai;1;1;2
624;14.04.2018;2018;04;04;Lauantai;4;0;4
624;14.04.2018;2018;04;05;Lauantai;0;2;2
624;14.04.2018;2018;04;06;Lauantai;0;0;0
624;14.04.2018;2018;04;07;Lauantai;1;4;5
624;14.04.2018;2018;04;08;Lauantai;1;4;5
624;14.04.2018;2018;04;09;Lauantai;3;3;6
624;14.04.2018;2018;04;10;Lauantai;0;11;11
624;14.04.2018;2018;04;11;Lauantai;3;14;17
624;14.04.2018;2018;04;12;Lauantai;1;14;15
624;14.04.2018;2018;04;13;Lauantai;8;11;19
624;14.04.2018;2018;04;14;Lauantai;3;19;22
624;14.04.2018;2018;04;15;Lauantai;4;8;12
624;14.04.2018;2018;04;16;Lauantai;10;16;26
624;14.04.2018;2018;04;17;Lauantai;9;23;32
624;14.04.2018;2018;04;18;Lauantai;12;16;28
624;14.04.2018;2018;04;19;Lauantai;5;14;19
624;14.04.2018;2018;04;20;Lauantai;9;11;20
624;14.04.2018;2018;04;21;Lauantai;6;7;13
624;14.04.2018;2018;04;22;Lauantai;2;5;7
624;14.04.2018;2018;04;23;Lauantai;2;4;6
624;15.04.2018;2018;04;00;Sunnuntai;4;2;6
624;15.04.2018;2018;04;01;Sunnuntai;0;3;3
624;15.04.2018;2018;04;02;Sunnuntai;1;0;1
624;15.04.2018;2018;04;03;Sunnuntai;2;0;2
624;15.04.2018;2018;04;04;Sunnuntai;1;0;1
624;15.04.2018;2018;04;05;Sunnuntai;2;0;2
624;15.04.2018;2018;04;06;Sunnuntai;0;0;0
624;15.04.2018;2018;04;07;Sunnuntai;0;2;2
624;15.04.2018;2018;04;08;Sunnuntai;0;1;1
624;15.04.2018;2018;04;09;Sunnuntai;1;1;2
624;15.04.2018;2018;04;10;Sunnuntai;1;4;5
624;15.04.2018;2018;04;11;Sunnuntai;1;6;7
624;15.04.2018;2018;04;12;Sunnuntai;3;11;14
624;15.04.2018;2018;04;13;Sunnuntai;10;18;28
624;15.04.2018;2018;04;14;Sunnuntai;10;22;32
624;15.04.2018;2018;04;15;Sunnuntai;4;16;20
624;15.04.2018;2018;04;16;Sunnuntai;10;17;27
624;15.04.2018;2018;04;17;Sunnuntai;8;19;27
624;15.04.2018;2018;04;18;Sunnuntai;9;15;24
624;15.04.2018;2018;04;19;Sunnuntai;6;10;16
624;15.04.2018;2018;04;20;Sunnuntai;7;7;14
624;15.04.2018;2018;04;21;Sunnuntai;9;9;18
624;15.04.2018;2018;04;22;Sunnuntai;4;7;11
624;15.04.2018;2018;04;23;Sunnuntai;1;4;5
624;16.04.2018;2018;04;00;Maanantai;3;2;5
624;16.04.2018;2018;04;01;Maanantai;3;0;3
624;16.04.2018;2018;04;02;Maanantai;1;0;1
624;16.04.2018;2018;04;03;Maanantai;0;2;2
624;16.04.2018;2018;04;04;Maanantai;0;0;0
624;16.04.2018;2018;04;05;Maanantai;0;1;1
624;16.04.2018;2018;04;06;Maanantai;2;7;9
624;16.04.2018;2018;04;07;Maanantai;1;26;27
624;16.04.2018;2018;04;08;Maanantai;5;52;57
624;16.04.2018;2018;04;09;Maanantai;5;38;43
624;16.04.2018;2018;04;10;Maanantai;4;32;36
624;16.04.2018;2018;04;11;Maanantai;1;16;17
624;16.04.2018;2018;04;12;Maanantai;4;20;24
624;16.04.2018;2018;04;13;Maanantai;4;21;25
624;16.04.2018;2018;04;14;Maanantai;13;14;27
624;16.04.2018;2018;04;15;Maanantai;15;29;44
624;16.04.2018;2018;04;16;Maanantai;20;25;45
624;16.04.2018;2018;04;17;Maanantai;26;25;51
624;16.04.2018;2018;04;18;Maanantai;15;28;43
624;16.04.2018;2018;04;19;Maanantai;10;19;29
624;16.04.2018;2018;04;20;Maanantai;8;13;21
624;16.04.2018;2018;04;21;Maanantai;10;13;23
624;16.04.2018;2018;04;22;Maanantai;6;5;11
624;16.04.2018;2018;04;23;Maanantai;3;10;13
624;17.04.2018;2018;04;00;Tiistai;1;3;4
624;17.04.2018;2018;04;01;Tiistai;1;0;1
624;17.04.2018;2018;04;02;Tiistai;0;0;0
624;17.04.2018;2018;04;03;Tiistai;0;0;0
624;17.04.2018;2018;04;04;Tiistai;0;2;2
624;17.04.2018;2018;04;05;Tiistai;1;0;1
624;17.04.2018;2018;04;06;Tiistai;0;5;5
624;17.04.2018;2018;04;07;Tiistai;1;28;29
624;17.04.2018;2018;04;08;Tiistai;5;54;59
624;17.04.2018;2018;04;09;Tiistai;7;57;64
624;17.04.2018;2018;04;10;Tiistai;8;33;41
624;17.04.2018;2018;04;11;Tiistai;3;12;15
624;17.04.2018;2018;04;12;Tiistai;2;9;11
624;17.04.2018;2018;04;13;Tiistai;3;19;22
624;17.04.2018;2018;04;14;Tiistai;6;17;23
624;17.04.2018;2018;04;15;Tiistai;14;21;35
624;17.04.2018;2018;04;16;Tiistai;15;25;40
624;17.04.2018;2018;04;17;Tiistai;22;45;67
624;17.04.2018;2018;04;18;Tiistai;14;50;64
624;17.04.2018;2018;04;19;Tiistai;11;31;42
624;17.04.2018;2018;04;20;Tiistai;7;7;14
624;17.04.2018;2018;04;21;Tiistai;5;8;13
624;17.04.2018;2018;04;22;Tiistai;6;12;18
624;17.04.2018;2018;04;23;Tiistai;2;7;9
624;18.04.2018;2018;04;00;Keskiviikko;1;3;4
624;18.04.2018;2018;04;01;Keskiviikko;1;1;2
624;18.04.2018;2018;04;02;Keskiviikko;1;0;1
624;18.04.2018;2018;04;03;Keskiviikko;0;2;2
624;18.04.2018;2018;04;04;Keskiviikko;0;0;0
624;18.04.2018;2018;04;05;Keskiviikko;0;0;0
624;18.04.2018;2018;04;06;Keskiviikko;0;5;5
624;18.04.2018;2018;04;07;Keskiviikko;1;27;28
624;18.04.2018;2018;04;08;Keskiviikko;5;50;55
624;18.04.2018;2018;04;09;Keskiviikko;7;61;68
624;18.04.2018;2018;04;10;Keskiviikko;3;30;33
624;18.04.2018;2018;04;11;Keskiviikko;6;22;28
624;18.04.2018;2018;04;12;Keskiviikko;3;27;30
624;18.04.2018;2018;04;13;Keskiviikko;4;23;27
624;18.04.2018;2018;04;14;Keskiviikko;14;21;35
624;18.04.2018;2018;04;15;Keskiviikko;5;31;36
624;18.04.2018;2018;04;16;Keskiviikko;16;38;54
624;18.04.2018;2018;04;17;Keskiviikko;18;33;51
624;18.04.2018;2018;04;18;Keskiviikko;13;35;48
624;18.04.2018;2018;04;19;Keskiviikko;10;28;38
624;18.04.2018;2018;04;20;Keskiviikko;12;22;34
624;18.04.2018;2018;04;21;Keskiviikko;4;13;17
624;18.04.2018;2018;04;22;Keskiviikko;6;8;14
624;18.04.2018;2018;04;23;Keskiviikko;1;10;11
624;19.04.2018;2018;04;00;Torstai;2;2;4
624;19.04.2018;2018;04;01;Torstai;0;2;2
624;19.04.2018;2018;04;02;Torstai;0;0;0
624;19.04.2018;2018;04;03;Torstai;0;2;2
624;19.04.2018;2018;04;04;Torstai;0;1;1
624;19.04.2018;2018;04;05;Torstai;0;0;0
624;19.04.2018;2018;04;06;Torstai;1;6;7
624;19.04.2018;2018;04;07;Torstai;6;38;44
624;19.04.2018;2018;04;08;Torstai;3;51;54
624;19.04.2018;2018;04;09;Torstai;10;49;59
624;19.04.2018;2018;04;10;Torstai;6;40;46
624;19.04.2018;2018;04;11;Torstai;4;18;22
624;19.04.2018;2018;04;12;Torstai;12;24;36
624;19.04.2018;2018;04;13;Torstai;12;32;44
624;19.04.2018;2018;04;14;Torstai;11;28;39
624;19.04.2018;2018;04;15;Torstai;21;35;56
624;19.04.2018;2018;04;16;Torstai;24;35;59
624;19.04.2018;2018;04;17;Torstai;26;34;60
624;19.04.2018;2018;04;18;Torstai;18;40;58
624;19.04.2018;2018;04;19;Torstai;10;27;37
624;19.04.2018;2018;04;20;Torstai;7;18;25
624;19.04.2018;2018;04;21;Torstai;6;10;16
624;19.04.2018;2018;04;22;Torstai;4;11;15
624;19.04.2018;2018;04;23;Torstai;4;7;11
624;20.04.2018;2018;04;00;Perjantai;2;8;10
624;20.04.2018;2018;04;01;Perjantai;1;3;4
624;20.04.2018;2018;04;02;Perjantai;0;1;1
624;20.04.2018;2018;04;03;Perjantai;0;1;1
624;20.04.2018;2018;04;04;Perjantai;0;1;1
624;20.04.2018;2018;04;05;Perjantai;1;2;3
624;20.04.2018;2018;04;06;Perjantai;1;5;6
624;20.04.2018;2018;04;07;Perjantai;4;27;31
624;20.04.2018;2018;04;08;Perjantai;5;44;49
624;20.04.2018;2018;04;09;Perjantai;10;48;58
624;20.04.2018;2018;04;10;Perjantai;6;13;19
624;20.04.2018;2018;04;11;Perjantai;3;14;17
624;20.04.2018;2018;04;12;Perjantai;6;15;21
624;20.04.2018;2018;04;13;Perjantai;5;20;25
624;20.04.2018;2018;04;14;Perjantai;3;22;25
624;20.04.2018;2018;04;15;Perjantai;6;16;22
624;20.04.2018;2018;04;16;Perjantai;23;19;42
624;20.04.2018;2018;04;17;Perjantai;15;27;42
624;20.04.2018;2018;04;18;Perjantai;18;23;41
624;20.04.2018;2018;04;19;Perjantai;13;20;33
624;20.04.2018;2018;04;20;Perjantai;5;8;13
624;20.04.2018;2018;04;21;Perjantai;4;10;14
624;20.04.2018;2018;04;22;Perjantai;4;12;16
624;20.04.2018;2018;04;23;Perjantai;4;6;10
624;21.04.2018;2018;04;00;Lauantai;1;4;5
624;21.04.2018;2018;04;01;Lauantai;1;4;5
624;21.04.2018;2018;04;02;Lauantai;2;1;3
624;21.04.2018;2018;04;03;Lauantai;1;3;4
624;21.04.2018;2018;04;04;Lauantai;1;3;4
624;21.04.2018;2018;04;05;Lauantai;2;1;3
624;21.04.2018;2018;04;06;Lauantai;1;2;3
624;21.04.2018;2018;04;07;Lauantai;2;4;6
624;21.04.2018;2018;04;08;Lauantai;0;2;2
624;21.04.2018;2018;04;09;Lauantai;1;6;7
624;21.04.2018;2018;04;10;Lauantai;1;15;16
624;21.04.2018;2018;04;11;Lauantai;1;21;22
624;21.04.2018;2018;04;12;Lauantai;3;12;15
624;21.04.2018;2018;04;13;Lauantai;7;15;22
624;21.04.2018;2018;04;14;Lauantai;5;21;26
624;21.04.2018;2018;04;15;Lauantai;12;21;33
624;21.04.2018;2018;04;16;Lauantai;5;15;20
624;21.04.2018;2018;04;17;Lauantai;16;27;43
624;21.04.2018;2018;04;18;Lauantai;3;14;17
624;21.04.2018;2018;04;19;Lauantai;7;9;16
624;21.04.2018;2018;04;20;Lauantai;2;6;8
624;21.04.2018;2018;04;21;Lauantai;7;5;12
624;21.04.2018;2018;04;22;Lauantai;5;6;11
624;21.04.2018;2018;04;23;Lauantai;5;7;12
624;22.04.2018;2018;04;00;Sunnuntai;4;2;6
624;22.04.2018;2018;04;01;Sunnuntai;3;7;10
624;22.04.2018;2018;04;02;Sunnuntai;2;3;5
624;22.04.2018;2018;04;03;Sunnuntai;2;2;4
624;22.04.2018;2018;04;04;Sunnuntai;3;3;6
624;22.04.2018;2018;04;05;Sunnuntai;2;1;3
624;22.04.2018;2018;04;06;Sunnuntai;0;1;1
624;22.04.2018;2018;04;07;Sunnuntai;0;1;1
624;22.04.2018;2018;04;08;Sunnuntai;0;2;2
624;22.04.2018;2018;04;09;Sunnuntai;1;3;4
624;22.04.2018;2018;04;10;Sunnuntai;4;10;14
624;22.04.2018;2018;04;11;Sunnuntai;5;19;24
624;22.04.2018;2018;04;12;Sunnuntai;13;27;40
624;22.04.2018;2018;04;13;Sunnuntai;10;26;36
624;22.04.2018;2018;04;14;Sunnuntai;7;32;39
624;22.04.2018;2018;04;15;Sunnuntai;7;29;36
624;22.04.2018;2018;04;16;Sunnuntai;11;9;20
624;22.04.2018;2018;04;17;Sunnuntai;8;23;31
624;22.04.2018;2018;04;18;Sunnuntai;11;23;34
624;22.04.2018;2018;04;19;Sunnuntai;8;20;28
624;22.04.2018;2018;04;20;Sunnuntai;3;7;10
624;22.04.2018;2018;04;21;Sunnuntai;5;8;13
624;22.04.2018;2018;04;22;Sunnuntai;6;4;10
624;22.04.2018;2018;04;23;Sunnuntai;3;1;4
624;23.04.2018;2018;04;00;Maanantai;1;4;5
624;23.04.2018;2018;04;01;Maanantai;0;0;0
624;23.04.2018;2018;04;02;Maanantai;0;1;1
624;23.04.2018;2018;04;03;Maanantai;0;0;0
624;23.04.2018;2018;04;04;Maanantai;1;2;3
624;23.04.2018;2018;04;05;Maanantai;1;0;1
624;23.04.2018;2018;04;06;Maanantai;0;9;9
624;23.04.2018;2018;04;07;Maanantai;2;24;26
624;23.04.2018;2018;04;08;Maanantai;12;66;78
624;23.04.2018;2018;04;09;Maanantai;5;65;70
624;23.04.2018;2018;04;10;Maanantai;3;32;35
624;23.04.2018;2018;04;11;Maanantai;5;23;28
624;23.04.2018;2018;04;12;Maanantai;15;20;35
624;23.04.2018;2018;04;13;Maanantai;5;24;29
624;23.04.2018;2018;04;14;Maanantai;11;23;34
624;23.04.2018;2018;04;15;Maanantai;15;29;44
624;23.04.2018;2018;04;16;Maanantai;21;27;48
624;23.04.2018;2018;04;17;Maanantai;25;57;82
624;23.04.2018;2018;04;18;Maanantai;23;35;58
624;23.04.2018;2018;04;19;Maanantai;9;29;38
624;23.04.2018;2018;04;20;Maanantai;13;23;36
624;23.04.2018;2018;04;21;Maanantai;10;11;21
624;23.04.2018;2018;04;22;Maanantai;3;13;16
624;23.04.2018;2018;04;23;Maanantai;3;6;9
624;24.04.2018;2018;04;00;Tiistai;1;3;4
624;24.04.2018;2018;04;01;Tiistai;1;1;2
624;24.04.2018;2018;04;02;Tiistai;0;1;1
624;24.04.2018;2018;04;03;Tiistai;1;1;2
624;24.04.2018;2018;04;04;Tiistai;1;1;2
624;24.04.2018;2018;04;05;Tiistai;0;2;2
624;24.04.2018;2018;04;06;Tiistai;0;10;10
624;24.04.2018;2018;04;07;Tiistai;3;31;34
624;24.04.2018;2018;04;08;Tiistai;15;81;96
624;24.04.2018;2018;04;09;Tiistai;4;58;62
624;24.04.2018;2018;04;10;Tiistai;4;33;37
624;24.04.2018;2018;04;11;Tiistai;3;22;25
624;24.04.2018;2018;04;12;Tiistai;5;20;25
624;24.04.2018;2018;04;13;Tiistai;7;19;26
624;24.04.2018;2018;04;14;Tiistai;10;17;27
624;24.04.2018;2018;04;15;Tiistai;12;31;43
624;24.04.2018;2018;04;16;Tiistai;11;34;45
624;24.04.2018;2018;04;17;Tiistai;15;41;56
624;24.04.2018;2018;04;18;Tiistai;7;36;43
624;24.04.2018;2018;04;19;Tiistai;7;22;29
624;24.04.2018;2018;04;20;Tiistai;5;13;18
624;24.04.2018;2018;04;21;Tiistai;8;12;20
624;24.04.2018;2018;04;22;Tiistai;22;8;30
624;24.04.2018;2018;04;23;Tiistai;3;5;8
624;25.04.2018;2018;04;00;Keskiviikko;2;4;6
624;25.04.2018;2018;04;01;Keskiviikko;1;1;2
624;25.04.2018;2018;04;02;Keskiviikko;1;1;2
624;25.04.2018;2018;04;03;Keskiviikko;0;4;4
624;25.04.2018;2018;04;04;Keskiviikko;1;1;2
624;25.04.2018;2018;04;05;Keskiviikko;0;1;1
624;25.04.2018;2018;04;06;Keskiviikko;0;7;7
624;25.04.2018;2018;04;07;Keskiviikko;6;22;28
624;25.04.2018;2018;04;08;Keskiviikko;10;57;67
624;25.04.2018;2018;04;09;Keskiviikko;6;58;64
624;25.04.2018;2018;04;10;Keskiviikko;5;31;36
624;25.04.2018;2018;04;11;Keskiviikko;2;25;27
624;25.04.2018;2018;04;12;Keskiviikko;10;27;37
624;25.04.2018;2018;04;13;Keskiviikko;6;26;32
624;25.04.2018;2018;04;14;Keskiviikko;7;24;31
624;25.04.2018;2018;04;15;Keskiviikko;13;35;48
624;25.04.2018;2018;04;16;Keskiviikko;14;25;39
624;25.04.2018;2018;04;17;Keskiviikko;22;36;58
624;25.04.2018;2018;04;18;Keskiviikko;7;31;38
624;25.04.2018;2018;04;19;Keskiviikko;8;22;30
624;25.04.2018;2018;04;20;Keskiviikko;9;14;23
624;25.04.2018;2018;04;21;Keskiviikko;13;15;28
624;25.04.2018;2018;04;22;Keskiviikko;5;9;14
624;25.04.2018;2018;04;23;Keskiviikko;3;6;9
624;26.04.2018;2018;04;00;Torstai;4;2;6
624;26.04.2018;2018;04;01;Torstai;3;2;5
624;26.04.2018;2018;04;02;Torstai;1;0;1
624;26.04.2018;2018;04;03;Torstai;1;1;2
624;26.04.2018;2018;04;04;Torstai;0;1;1
624;26.04.2018;2018;04;05;Torstai;1;1;2
624;26.04.2018;2018;04;06;Torstai;1;6;7
624;26.04.2018;2018;04;07;Torstai;6;28;34
624;26.04.2018;2018;04;08;Torstai;4;73;77
624;26.04.2018;2018;04;09;Torstai;10;70;80
624;26.04.2018;2018;04;10;Torstai;6;29;35
624;26.04.2018;2018;04;11;Torstai;3;16;19
624;26.04.2018;2018;04;12;Torstai;8;25;33
624;26.04.2018;2018;04;13;Torstai;9;20;29
624;26.04.2018;2018;04;14;Torstai;15;24;39
624;26.04.2018;2018;04;15;Torstai;19;30;49
624;26.04.2018;2018;04;16;Torstai;21;37;58
624;26.04.2018;2018;04;17;Torstai;19;33;52
624;26.04.2018;2018;04;18;Torstai;19;42;61
624;26.04.2018;2018;04;19;Torstai;15;27;42
624;26.04.2018;2018;04;20;Torstai;4;20;24
624;26.04.2018;2018;04;21;Torstai;9;15;24
624;26.04.2018;2018;04;22;Torstai;6;8;14
624;26.04.2018;2018;04;23;Torstai;1;9;10
624;27.04.2018;2018;04;00;Perjantai;5;7;12
624;27.04.2018;2018;04;01;Perjantai;0;1;1
624;27.04.2018;2018;04;02;Perjantai;0;0;0
624;27.04.2018;2018;04;03;Perjantai;4;1;5
624;27.04.2018;2018;04;04;Perjantai;3;0;3
624;27.04.2018;2018;04;05;Perjantai;3;1;4
624;27.04.2018;2018;04;06;Perjantai;4;7;11
624;27.04.2018;2018;04;07;Perjantai;3;29;32
624;27.04.2018;2018;04;08;Perjantai;6;65;71
624;27.04.2018;2018;04;09;Perjantai;8;60;68
624;27.04.2018;2018;04;10;Perjantai;12;34;46
624;27.04.2018;2018;04;11;Perjantai;9;22;31
624;27.04.2018;2018;04;12;Perjantai;6;26;32
624;27.04.2018;2018;04;13;Perjantai;8;23;31
624;27.04.2018;2018;04;14;Perjantai;13;37;50
624;27.04.2018;2018;04;15;Perjantai;14;34;48
624;27.04.2018;2018;04;16;Perjantai;20;34;54
624;27.04.2018;2018;04;17;Perjantai;19;38;57
624;27.04.2018;2018;04;18;Perjantai;11;27;38
624;27.04.2018;2018;04;19;Perjantai;4;23;27
624;27.04.2018;2018;04;20;Perjantai;10;19;29
624;27.04.2018;2018;04;21;Perjantai;13;12;25
624;27.04.2018;2018;04;22;Perjantai;4;9;13
624;27.04.2018;2018;04;23;Perjantai;4;7;11
624;28.04.2018;2018;04;00;Lauantai;1;4;5
624;28.04.2018;2018;04;01;Lauantai;1;6;7
624;28.04.2018;2018;04;02;Lauantai;2;4;6
624;28.04.2018;2018;04;03;Lauantai;1;3;4
624;28.04.2018;2018;04;04;Lauantai;0;4;4
624;28.04.2018;2018;04;05;Lauantai;4;3;7
624;28.04.2018;2018;04;06;Lauantai;2;3;5
624;28.04.2018;2018;04;07;Lauantai;0;5;5
624;28.04.2018;2018;04;08;Lauantai;1;3;4
624;28.04.2018;2018;04;09;Lauantai;0;9;9
624;28.04.2018;2018;04;10;Lauantai;6;15;21
624;28.04.2018;2018;04;11;Lauantai;6;20;26
624;28.04.2018;2018;04;12;Lauantai;6;34;40
624;28.04.2018;2018;04;13;Lauantai;8;29;37
624;28.04.2018;2018;04;14;Lauantai;9;38;47
624;28.04.2018;2018;04;15;Lauantai;11;16;27
624;28.04.2018;2018;04;16;Lauantai;13;14;27
624;28.04.2018;2018;04;17;Lauantai;9;28;37
624;28.04.2018;2018;04;18;Lauantai;12;16;28
624;28.04.2018;2018;04;19;Lauantai;9;22;31
624;28.04.2018;2018;04;20;Lauantai;3;24;27
624;28.04.2018;2018;04;21;Lauantai;4;8;12
624;28.04.2018;2018;04;22;Lauantai;3;7;10
624;28.04.2018;2018;04;23;Lauantai;4;4;8
624;29.04.2018;2018;04;00;Sunnuntai;5;8;13
624;29.04.2018;2018;04;01;Sunnuntai;3;7;10
624;29.04.2018;2018;04;02;Sunnuntai;4;6;10
624;29.04.2018;2018;04;03;Sunnuntai;3;3;6
624;29.04.2018;2018;04;04;Sunnuntai;1;0;1
624;29.04.2018;2018;04;05;Sunnuntai;1;2;3
624;29.04.2018;2018;04;06;Sunnuntai;1;0;1
624;29.04.2018;2018;04;07;Sunnuntai;0;1;1
624;29.04.2018;2018;04;08;Sunnuntai;2;5;7
624;29.04.2018;2018;04;09;Sunnuntai;0;2;2
624;29.04.2018;2018;04;10;Sunnuntai;2;9;11
624;29.04.2018;2018;04;11;Sunnuntai;6;11;17
624;29.04.2018;2018;04;12;Sunnuntai;9;11;20
624;29.04.2018;2018;04;13;Sunnuntai;5;20;25
624;29.04.2018;2018;04;14;Sunnuntai;10;18;28
624;29.04.2018;2018;04;15;Sunnuntai;12;25;37
624;29.04.2018;2018;04;16;Sunnuntai;11;18;29
624;29.04.2018;2018;04;17;Sunnuntai;7;22;29
624;29.04.2018;2018;04;18;Sunnuntai;10;25;35
624;29.04.2018;2018;04;19;Sunnuntai;10;21;31
624;29.04.2018;2018;04;20;Sunnuntai;6;11;17
624;29.04.2018;2018;04;21;Sunnuntai;8;16;24
624;29.04.2018;2018;04;22;Sunnuntai;7;8;15
624;29.04.2018;2018;04;23;Sunnuntai;1;3;4
624;30.04.2018;2018;04;00;Maanantai;1;4;5
624;30.04.2018;2018;04;01;Maanantai;2;5;7
624;30.04.2018;2018;04;02;Maanantai;0;0;0
624;30.04.2018;2018;04;03;Maanantai;1;1;2
624;30.04.2018;2018;04;04;Maanantai;0;1;1
624;30.04.2018;2018;04;05;Maanantai;0;2;2
624;30.04.2018;2018;04;06;Maanantai;5;5;10
624;30.04.2018;2018;04;07;Maanantai;1;28;29
624;30.04.2018;2018;04;08;Maanantai;3;36;39
624;30.04.2018;2018;04;09;Maanantai;3;35;38
624;30.04.2018;2018;04;10;Maanantai;4;23;27
624;30.04.2018;2018;04;11;Maanantai;5;20;25
624;30.04.2018;2018;04;12;Maanantai;5;36;41
624;30.04.2018;2018;04;13;Maanantai;6;30;36
624;30.04.2018;2018;04;14;Maanantai;7;38;45
624;30.04.2018;2018;04;15;Maanantai;13;27;40
624;30.04.2018;2018;04;16;Maanantai;23;26;49
624;30.04.2018;2018;04;17;Maanantai;17;32;49
624;30.04.2018;2018;04;18;Maanantai;12;23;35
624;30.04.2018;2018;04;19;Maanantai;5;18;23
624;30.04.2018;2018;04;20;Maanantai;5;17;22
624;30.04.2018;2018;04;21;Maanantai;6;13;19
624;30.04.2018;2018;04;22;Maanantai;4;4;8
624;30.04.2018;2018;04;23;Maanantai;8;7;15
624;01.05.2018;2018;05;00;Tiistai;4;4;8
624;01.05.2018;2018;05;01;Tiistai;4;2;6
624;01.05.2018;2018;05;02;Tiistai;7;8;15
624;01.05.2018;2018;05;03;Tiistai;3;1;4
624;01.05.2018;2018;05;04;Tiistai;5;2;7
624;01.05.2018;2018;05;05;Tiistai;8;3;11
624;01.05.2018;2018;05;06;Tiistai;1;0;1
624;01.05.2018;2018;05;07;Tiistai;1;4;5
624;01.05.2018;2018;05;08;Tiistai;1;4;5
624;01.05.2018;2018;05;09;Tiistai;1;1;2
624;01.05.2018;2018;05;10;Tiistai;2;15;17
624;01.05.2018;2018;05;11;Tiistai;5;14;19
624;01.05.2018;2018;05;12;Tiistai;5;13;18
624;01.05.2018;2018;05;13;Tiistai;13;50;63
624;01.05.2018;2018;05;14;Tiistai;12;59;71
624;01.05.2018;2018;05;15;Tiistai;16;21;37
624;01.05.2018;2018;05;16;Tiistai;11;15;26
624;01.05.2018;2018;05;17;Tiistai;4;11;15
624;01.05.2018;2018;05;18;Tiistai;4;10;14
624;01.05.2018;2018;05;19;Tiistai;10;11;21
624;01.05.2018;2018;05;20;Tiistai;7;14;21
624;01.05.2018;2018;05;21;Tiistai;6;8;14
624;01.05.2018;2018;05;22;Tiistai;5;9;14
624;01.05.2018;2018;05;23;Tiistai;1;1;2
624;02.05.2018;2018;05;00;Keskiviikko;2;3;5
624;02.05.2018;2018;05;01;Keskiviikko;1;4;5
624;02.05.2018;2018;05;02;Keskiviikko;0;1;1
624;02.05.2018;2018;05;03;Keskiviikko;0;2;2
624;02.05.2018;2018;05;04;Keskiviikko;1;0;1
624;02.05.2018;2018;05;05;Keskiviikko;0;1;1
624;02.05.2018;2018;05;06;Keskiviikko;1;10;11
624;02.05.2018;2018;05;07;Keskiviikko;5;30;35
624;02.05.2018;2018;05;08;Keskiviikko;9;59;68
624;02.05.2018;2018;05;09;Keskiviikko;8;67;75
624;02.05.2018;2018;05;10;Keskiviikko;3;24;27
624;02.05.2018;2018;05;11;Keskiviikko;13;27;40
624;02.05.2018;2018;05;12;Keskiviikko;7;14;21
624;02.05.2018;2018;05;13;Keskiviikko;9;16;25
624;02.05.2018;2018;05;14;Keskiviikko;7;25;32
624;02.05.2018;2018;05;15;Keskiviikko;7;22;29
624;02.05.2018;2018;05;16;Keskiviikko;17;22;39
624;02.05.2018;2018;05;17;Keskiviikko;19;34;53
624;02.05.2018;2018;05;18;Keskiviikko;10;19;29
624;02.05.2018;2018;05;19;Keskiviikko;7;18;25
624;02.05.2018;2018;05;20;Keskiviikko;10;16;26
624;02.05.2018;2018;05;21;Keskiviikko;8;10;18
624;02.05.2018;2018;05;22;Keskiviikko;5;6;11
624;02.05.2018;2018;05;23;Keskiviikko;1;3;4
624;03.05.2018;2018;05;00;Torstai;4;5;9
624;03.05.2018;2018;05;01;Torstai;1;3;4
624;03.05.2018;2018;05;02;Torstai;0;0;0
624;03.05.2018;2018;05;03;Torstai;1;1;2
624;03.05.2018;2018;05;04;Torstai;0;0;0
624;03.05.2018;2018;05;05;Torstai;0;1;1
624;03.05.2018;2018;05;06;Torstai;3;9;12
624;03.05.2018;2018;05;07;Torstai;5;43;48
624;03.05.2018;2018;05;08;Torstai;8;85;93
624;03.05.2018;2018;05;09;Torstai;4;52;56
624;03.05.2018;2018;05;10;Torstai;10;37;47
624;03.05.2018;2018;05;11;Torstai;4;23;27
624;03.05.2018;2018;05;12;Torstai;8;24;32
624;03.05.2018;2018;05;13;Torstai;10;31;41
624;03.05.2018;2018;05;14;Torstai;9;24;33
624;03.05.2018;2018;05;15;Torstai;9;32;41
624;03.05.2018;2018;05;16;Torstai;18;42;60
624;03.05.2018;2018;05;17;Torstai;21;41;62
624;03.05.2018;2018;05;18;Torstai;23;34;57
624;03.05.2018;2018;05;19;Torstai;13;29;42
624;03.05.2018;2018;05;20;Torstai;15;31;46
624;03.05.2018;2018;05;21;Torstai;8;14;22
624;03.05.2018;2018;05;22;Torstai;9;8;17
624;03.05.2018;2018;05;23;Torstai;6;7;13
624;04.05.2018;2018;05;00;Perjantai;0;5;5
624;04.05.2018;2018;05;01;Perjantai;1;2;3
624;04.05.2018;2018;05;02;Perjantai;1;1;2
624;04.05.2018;2018;05;03;Perjantai;0;2;2
624;04.05.2018;2018;05;04;Perjantai;0;0;0
624;04.05.2018;2018;05;05;Perjantai;0;0;0
624;04.05.2018;2018;05;06;Perjantai;2;7;9
624;04.05.2018;2018;05;07;Perjantai;8;25;33
624;04.05.2018;2018;05;08;Perjantai;7;65;72
624;04.05.2018;2018;05;09;Perjantai;7;42;49
624;04.05.2018;2018;05;10;Perjantai;3;19;22
624;04.05.2018;2018;05;11;Perjantai;5;17;22
624;04.05.2018;2018;05;12;Perjantai;4;9;13
624;04.05.2018;2018;05;13;Perjantai;5;12;17
624;04.05.2018;2018;05;14;Perjantai;10;12;22
624;04.05.2018;2018;05;15;Perjantai;8;7;15
624;04.05.2018;2018;05;16;Perjantai;11;12;23
624;04.05.2018;2018;05;17;Perjantai;16;17;33
624;04.05.2018;2018;05;18;Perjantai;9;14;23
624;04.05.2018;2018;05;19;Perjantai;11;15;26
624;04.05.2018;2018;05;20;Perjantai;2;16;18
624;04.05.2018;2018;05;21;Perjantai;4;14;18
624;04.05.2018;2018;05;22;Perjantai;6;10;16
624;04.05.2018;2018;05;23;Perjantai;4;5;9
624;05.05.2018;2018;05;00;Lauantai;2;3;5
624;05.05.2018;2018;05;01;Lauantai;1;1;2
624;05.05.2018;2018;05;02;Lauantai;1;2;3
624;05.05.2018;2018;05;03;Lauantai;1;4;5
624;05.05.2018;2018;05;04;Lauantai;0;0;0
624;05.05.2018;2018;05;05;Lauantai;0;1;1
624;05.05.2018;2018;05;06;Lauantai;0;1;1
624;05.05.2018;2018;05;07;Lauantai;0;3;3
624;05.05.2018;2018;05;08;Lauantai;0;5;5
624;05.05.2018;2018;05;09;Lauantai;0;7;7
624;05.05.2018;2018;05;10;Lauantai;1;20;21
624;05.05.2018;2018;05;11;Lauantai;3;18;21
624;05.05.2018;2018;05;12;Lauantai;2;22;24
624;05.05.2018;2018;05;13;Lauantai;5;24;29
624;05.05.2018;2018;05;14;Lauantai;7;29;36
624;05.05.2018;2018;05;15;Lauantai;18;37;55
624;05.05.2018;2018;05;16;Lauantai;16;29;45
624;05.05.2018;2018;05;17;Lauantai;13;27;40
624;05.05.2018;2018;05;18;Lauantai;12;14;26
624;05.05.2018;2018;05;19;Lauantai;5;21;26
624;05.05.2018;2018;05;20;Lauantai;7;14;21
624;05.05.2018;2018;05;21;Lauantai;9;16;25
624;05.05.2018;2018;05;22;Lauantai;4;10;14
624;05.05.2018;2018;05;23;Lauantai;3;6;9
624;06.05.2018;2018;05;00;Sunnuntai;3;0;3
624;06.05.2018;2018;05;01;Sunnuntai;3;3;6
624;06.05.2018;2018;05;02;Sunnuntai;1;1;2
624;06.05.2018;2018;05;03;Sunnuntai;1;3;4
624;06.05.2018;2018;05;04;Sunnuntai;0;0;0
624;06.05.2018;2018;05;05;Sunnuntai;2;1;3
624;06.05.2018;2018;05;06;Sunnuntai;4;3;7
624;06.05.2018;2018;05;07;Sunnuntai;0;4;4
624;06.05.2018;2018;05;08;Sunnuntai;2;1;3
624;06.05.2018;2018;05;09;Sunnuntai;5;3;8
624;06.05.2018;2018;05;10;Sunnuntai;2;13;15
624;06.05.2018;2018;05;11;Sunnuntai;5;12;17
624;06.05.2018;2018;05;12;Sunnuntai;12;33;45
624;06.05.2018;2018;05;13;Sunnuntai;11;22;33
624;06.05.2018;2018;05;14;Sunnuntai;12;32;44
624;06.05.2018;2018;05;15;Sunnuntai;9;13;22
624;06.05.2018;2018;05;16;Sunnuntai;16;18;34
624;06.05.2018;2018;05;17;Sunnuntai;26;30;56
624;06.05.2018;2018;05;18;Sunnuntai;15;40;55
624;06.05.2018;2018;05;19;Sunnuntai;5;20;25
624;06.05.2018;2018;05;20;Sunnuntai;7;25;32
624;06.05.2018;2018;05;21;Sunnuntai;11;14;25
624;06.05.2018;2018;05;22;Sunnuntai;9;6;15
624;06.05.2018;2018;05;23;Sunnuntai;2;6;8
624;07.05.2018;2018;05;00;Maanantai;1;1;2
624;07.05.2018;2018;05;01;Maanantai;3;1;4
624;07.05.2018;2018;05;02;Maanantai;0;0;0
624;07.05.2018;2018;05;03;Maanantai;3;0;3
624;07.05.2018;2018;05;04;Maanantai;1;0;1
624;07.05.2018;2018;05;05;Maanantai;1;1;2
624;07.05.2018;2018;05;06;Maanantai;1;13;14
624;07.05.2018;2018;05;07;Maanantai;3;34;37
624;07.05.2018;2018;05;08;Maanantai;11;77;88
624;07.05.2018;2018;05;09;Maanantai;9;61;70
624;07.05.2018;2018;05;10;Maanantai;11;38;49
624;07.05.2018;2018;05;11;Maanantai;4;15;19
624;07.05.2018;2018;05;12;Maanantai;7;31;38
624;07.05.2018;2018;05;13;Maanantai;8;33;41
624;07.05.2018;2018;05;14;Maanantai;8;19;27
624;07.05.2018;2018;05;15;Maanantai;12;32;44
624;07.05.2018;2018;05;16;Maanantai;26;30;56
624;07.05.2018;2018;05;17;Maanantai;17;51;68
624;07.05.2018;2018;05;18;Maanantai;21;18;39
624;07.05.2018;2018;05;19;Maanantai;9;15;24
624;07.05.2018;2018;05;20;Maanantai;11;18;29
624;07.05.2018;2018;05;21;Maanantai;11;12;23
624;07.05.2018;2018;05;22;Maanantai;14;13;27
624;07.05.2018;2018;05;23;Maanantai;2;6;8
624;08.05.2018;2018;05;00;Tiistai;2;1;3
624;08.05.2018;2018;05;01;Tiistai;2;3;5
624;08.05.2018;2018;05;02;Tiistai;0;0;0
624;08.05.2018;2018;05;03;Tiistai;0;0;0
624;08.05.2018;2018;05;04;Tiistai;0;1;1
624;08.05.2018;2018;05;05;Tiistai;2;1;3
624;08.05.2018;2018;05;06;Tiistai;2;9;11
624;08.05.2018;2018;05;07;Tiistai;3;35;38
624;08.05.2018;2018;05;08;Tiistai;17;91;108
624;08.05.2018;2018;05;09;Tiistai;18;73;91
624;08.05.2018;2018;05;10;Tiistai;6;42;48
624;08.05.2018;2018;05;11;Tiistai;8;22;30
624;08.05.2018;2018;05;12;Tiistai;15;25;40
624;08.05.2018;2018;05;13;Tiistai;15;35;50
624;08.05.2018;2018;05;14;Tiistai;4;34;38
624;08.05.2018;2018;05;15;Tiistai;17;15;32
624;08.05.2018;2018;05;16;Tiistai;23;50;73
624;08.05.2018;2018;05;17;Tiistai;21;67;88
624;08.05.2018;2018;05;18;Tiistai;20;30;50
624;08.05.2018;2018;05;19;Tiistai;12;30;42
624;08.05.2018;2018;05;20;Tiistai;18;21;39
624;08.05.2018;2018;05;21;Tiistai;8;30;38
624;08.05.2018;2018;05;22;Tiistai;17;17;34
624;08.05.2018;2018;05;23;Tiistai;1;8;9
624;09.05.2018;2018;05;00;Keskiviikko;2;4;6
624;09.05.2018;2018;05;01;Keskiviikko;2;2;4
624;09.05.2018;2018;05;02;Keskiviikko;0;1;1
624;09.05.2018;2018;05;03;Keskiviikko;0;0;0
624;09.05.2018;2018;05;04;Keskiviikko;0;3;3
624;09.05.2018;2018;05;05;Keskiviikko;1;1;2
624;09.05.2018;2018;05;06;Keskiviikko;2;6;8
624;09.05.2018;2018;05;07;Keskiviikko;2;45;47
624;09.05.2018;2018;05;08;Keskiviikko;12;71;83
624;09.05.2018;2018;05;09;Keskiviikko;8;86;94
624;09.05.2018;2018;05;10;Keskiviikko;5;37;42
624;09.05.2018;2018;05;11;Keskiviikko;6;27;33
624;09.05.2018;2018;05;12;Keskiviikko;13;32;45
624;09.05.2018;2018;05;13;Keskiviikko;14;41;55
624;09.05.2018;2018;05;14;Keskiviikko;15;24;39
624;09.05.2018;2018;05;15;Keskiviikko;12;38;50
624;09.05.2018;2018;05;16;Keskiviikko;38;64;102
624;09.05.2018;2018;05;17;Keskiviikko;27;60;87
624;09.05.2018;2018;05;18;Keskiviikko;30;50;80
624;09.05.2018;2018;05;19;Keskiviikko;20;34;54
624;09.05.2018;2018;05;20;Keskiviikko;12;20;32
624;09.05.2018;2018;05;21;Keskiviikko;12;19;31
624;09.05.2018;2018;05;22;Keskiviikko;8;20;28
624;09.05.2018;2018;05;23;Keskiviikko;4;7;11
624;10.05.2018;2018;05;00;Torstai;6;4;10
624;10.05.2018;2018;05;01;Torstai;6;5;11
624;10.05.2018;2018;05;02;Torstai;2;4;6
624;10.05.2018;2018;05;03;Torstai;6;2;8
624;10.05.2018;2018;05;04;Torstai;5;4;9
624;10.05.2018;2018;05;05;Torstai;0;2;2
624;10.05.2018;2018;05;06;Torstai;2;7;9
624;10.05.2018;2018;05;07;Torstai;2;12;14
624;10.05.2018;2018;05;08;Torstai;3;9;12
624;10.05.2018;2018;05;09;Torstai;4;12;16
624;10.05.2018;2018;05;10;Torstai;10;18;28
624;10.05.2018;2018;05;11;Torstai;7;25;32
624;10.05.2018;2018;05;12;Torstai;15;40;55
624;10.05.2018;2018;05;13;Torstai;16;47;63
624;10.05.2018;2018;05;14;Torstai;17;36;53
624;10.05.2018;2018;05;15;Torstai;24;38;62
624;10.05.2018;2018;05;16;Torstai;27;41;68
624;10.05.2018;2018;05;17;Torstai;24;62;86
624;10.05.2018;2018;05;18;Torstai;15;31;46
624;10.05.2018;2018;05;19;Torstai;20;50;70
624;10.05.2018;2018;05;20;Torstai;24;33;57
624;10.05.2018;2018;05;21;Torstai;8;17;25
624;10.05.2018;2018;05;22;Torstai;5;8;13
624;10.05.2018;2018;05;23;Torstai;7;3;10
624;11.05.2018;2018;05;00;Perjantai;3;8;11
624;11.05.2018;2018;05;01;Perjantai;3;3;6
624;11.05.2018;2018;05;02;Perjantai;1;1;2
624;11.05.2018;2018;05;03;Perjantai;0;1;1
624;11.05.2018;2018;05;04;Perjantai;2;1;3
624;11.05.2018;2018;05;05;Perjantai;2;1;3
624;11.05.2018;2018;05;06;Perjantai;4;8;12
624;11.05.2018;2018;05;07;Perjantai;2;28;30
624;11.05.2018;2018;05;08;Perjantai;11;65;76
624;11.05.2018;2018;05;09;Perjantai;16;69;85
624;11.05.2018;2018;05;10;Perjantai;4;41;45
624;11.05.2018;2018;05;11;Perjantai;9;33;42
624;11.05.2018;2018;05;12;Perjantai;22;51;73
624;11.05.2018;2018;05;13;Perjantai;19;44;63
624;11.05.2018;2018;05;14;Perjantai;20;53;73
624;11.05.2018;2018;05;15;Perjantai;24;50;74
624;11.05.2018;2018;05;16;Perjantai;34;73;107
624;11.05.2018;2018;05;17;Perjantai;34;51;85
624;11.05.2018;2018;05;18;Perjantai;14;31;45
624;11.05.2018;2018;05;19;Perjantai;17;42;59
624;11.05.2018;2018;05;20;Perjantai;13;31;44
624;11.05.2018;2018;05;21;Perjantai;11;17;28
624;11.05.2018;2018;05;22;Perjantai;8;8;16
624;11.05.2018;2018;05;23;Perjantai;4;13;17
624;12.05.2018;2018;05;00;Lauantai;6;8;14
624;12.05.2018;2018;05;01;Lauantai;2;6;8
624;12.05.2018;2018;05;02;Lauantai;5;4;9
624;12.05.2018;2018;05;03;Lauantai;4;2;6
624;12.05.2018;2018;05;04;Lauantai;2;1;3
624;12.05.2018;2018;05;05;Lauantai;1;4;5
624;12.05.2018;2018;05;06;Lauantai;1;4;5
624;12.05.2018;2018;05;07;Lauantai;3;5;8
624;12.05.2018;2018;05;08;Lauantai;1;3;4
624;12.05.2018;2018;05;09;Lauantai;2;13;15
624;12.05.2018;2018;05;10;Lauantai;6;21;27
624;12.05.2018;2018;05;11;Lauantai;15;22;37
624;12.05.2018;2018;05;12;Lauantai;21;41;62
624;12.05.2018;2018;05;13;Lauantai;20;42;62
624;12.05.2018;2018;05;14;Lauantai;22;32;54
624;12.05.2018;2018;05;15;Lauantai;15;36;51
624;12.05.2018;2018;05;16;Lauantai;23;49;72
624;12.05.2018;2018;05;17;Lauantai;16;35;51
624;12.05.2018;2018;05;18;Lauantai;23;32;55
624;12.05.2018;2018;05;19;Lauantai;14;40;54
624;12.05.2018;2018;05;20;Lauantai;14;21;35
624;12.05.2018;2018;05;21;Lauantai;12;31;43
624;12.05.2018;2018;05;22;Lauantai;17;10;27
624;12.05.2018;2018;05;23;Lauantai;8;4;12
624;13.05.2018;2018;05;00;Sunnuntai;4;4;8
624;13.05.2018;2018;05;01;Sunnuntai;11;8;19
624;13.05.2018;2018;05;02;Sunnuntai;2;4;6
624;13.05.2018;2018;05;03;Sunnuntai;6;7;13
624;13.05.2018;2018;05;04;Sunnuntai;2;2;4
624;13.05.2018;2018;05;05;Sunnuntai;0;0;0
624;13.05.2018;2018;05;06;Sunnuntai;0;0;0
624;13.05.2018;2018;05;07;Sunnuntai;2;6;8
624;13.05.2018;2018;05;08;Sunnuntai;2;3;5
624;13.05.2018;2018;05;09;Sunnuntai;0;6;6
624;13.05.2018;2018;05;10;Sunnuntai;8;19;27
624;13.05.2018;2018;05;11;Sunnuntai;9;33;42
624;13.05.2018;2018;05;12;Sunnuntai;16;43;59
624;13.05.2018;2018;05;13;Sunnuntai;15;51;66
624;13.05.2018;2018;05;14;Sunnuntai;16;44;60
624;13.05.2018;2018;05;15;Sunnuntai;23;46;69
624;13.05.2018;2018;05;16;Sunnuntai;24;35;59
624;13.05.2018;2018;05;17;Sunnuntai;14;48;62
624;13.05.2018;2018;05;18;Sunnuntai;19;31;50
624;13.05.2018;2018;05;19;Sunnuntai;16;28;44
624;13.05.2018;2018;05;20;Sunnuntai;20;20;40
624;13.05.2018;2018;05;21;Sunnuntai;15;24;39
624;13.05.2018;2018;05;22;Sunnuntai;6;11;17
624;13.05.2018;2018;05;23;Sunnuntai;3;6;9
624;14.05.2018;2018;05;00;Maanantai;1;5;6
624;14.05.2018;2018;05;01;Maanantai;1;2;3
624;14.05.2018;2018;05;02;Maanantai;1;1;2
624;14.05.2018;2018;05;03;Maanantai;2;1;3
624;14.05.2018;2018;05;04;Maanantai;0;1;1
624;14.05.2018;2018;05;05;Maanantai;3;2;5
624;14.05.2018;2018;05;06;Maanantai;1;20;21
624;14.05.2018;2018;05;07;Maanantai;3;51;54
624;14.05.2018;2018;05;08;Maanantai;24;104;128
624;14.05.2018;2018;05;09;Maanantai;20;85;105
624;14.05.2018;2018;05;10;Maanantai;5;53;58
624;14.05.2018;2018;05;11;Maanantai;10;37;47
624;14.05.2018;2018;05;12;Maanantai;10;41;51
624;14.05.2018;2018;05;13;Maanantai;15;46;61
624;14.05.2018;2018;05;14;Maanantai;17;44;61
624;14.05.2018;2018;05;15;Maanantai;29;59;88
624;14.05.2018;2018;05;16;Maanantai;31;53;84
624;14.05.2018;2018;05;17;Maanantai;43;89;132
624;14.05.2018;2018;05;18;Maanantai;40;54;94
624;14.05.2018;2018;05;19;Maanantai;22;38;60
624;14.05.2018;2018;05;20;Maanantai;22;33;55
624;14.05.2018;2018;05;21;Maanantai;10;30;40
624;14.05.2018;2018;05;22;Maanantai;11;9;20
624;14.05.2018;2018;05;23;Maanantai;1;6;7
624;15.05.2018;2018;05;00;Tiistai;1;4;5
624;15.05.2018;2018;05;01;Tiistai;3;2;5
624;15.05.2018;2018;05;02;Tiistai;0;0;0
624;15.05.2018;2018;05;03;Tiistai;0;2;2
624;15.05.2018;2018;05;04;Tiistai;0;2;2
624;15.05.2018;2018;05;05;Tiistai;0;3;3
624;15.05.2018;2018;05;06;Tiistai;2;13;15
624;15.05.2018;2018;05;07;Tiistai;3;51;54
624;15.05.2018;2018;05;08;Tiistai;20;120;140
624;15.05.2018;2018;05;09;Tiistai;7;100;107
624;15.05.2018;2018;05;10;Tiistai;7;63;70
624;15.05.2018;2018;05;11;Tiistai;10;27;37
624;15.05.2018;2018;05;12;Tiistai;13;42;55
624;15.05.2018;2018;05;13;Tiistai;12;30;42
624;15.05.2018;2018;05;14;Tiistai;14;37;51
624;15.05.2018;2018;05;15;Tiistai;19;47;66
624;15.05.2018;2018;05;16;Tiistai;33;48;81
624;15.05.2018;2018;05;17;Tiistai;39;85;124
624;15.05.2018;2018;05;18;Tiistai;20;47;67
624;15.05.2018;2018;05;19;Tiistai;15;46;61
624;15.05.2018;2018;05;20;Tiistai;12;27;39
624;15.05.2018;2018;05;21;Tiistai;14;29;43
624;15.05.2018;2018;05;22;Tiistai;11;15;26
624;15.05.2018;2018;05;23;Tiistai;4;9;13
624;16.05.2018;2018;05;00;Keskiviikko;4;3;7
624;16.05.2018;2018;05;01;Keskiviikko;1;4;5
624;16.05.2018;2018;05;02;Keskiviikko;1;0;1
624;16.05.2018;2018;05;03;Keskiviikko;1;2;3
624;16.05.2018;2018;05;04;Keskiviikko;0;1;1
624;16.05.2018;2018;05;05;Keskiviikko;0;2;2
624;16.05.2018;2018;05;06;Keskiviikko;2;13;15
624;16.05.2018;2018;05;07;Keskiviikko;5;53;58
624;16.05.2018;2018;05;08;Keskiviikko;22;131;153
624;16.05.2018;2018;05;09;Keskiviikko;15;90;105
624;16.05.2018;2018;05;10;Keskiviikko;9;57;66
624;16.05.2018;2018;05;11;Keskiviikko;6;34;40
624;16.05.2018;2018;05;12;Keskiviikko;15;36;51
624;16.05.2018;2018;05;13;Keskiviikko;3;9;12
624;16.05.2018;2018;05;14;Keskiviikko;27;78;105
624;16.05.2018;2018;05;15;Keskiviikko;8;11;19
624;16.05.2018;2018;05;16;Keskiviikko;63;110;173
624;16.05.2018;2018;05;17;Keskiviikko;51;83;134
624;16.05.2018;2018;05;18;Keskiviikko;31;67;98
624;16.05.2018;2018;05;19;Keskiviikko;27;66;93
624;16.05.2018;2018;05;20;Keskiviikko;17;32;49
624;16.05.2018;2018;05;21;Keskiviikko;11;27;38
624;16.05.2018;2018;05;22;Keskiviikko;4;22;26
624;16.05.2018;2018;05;23;Keskiviikko;4;7;11
624;17.05.2018;2018;05;00;Torstai;4;4;8
624;17.05.2018;2018;05;01;Torstai;1;2;3
624;17.05.2018;2018;05;02;Torstai;1;2;3
624;17.05.2018;2018;05;03;Torstai;2;0;2
624;17.05.2018;2018;05;04;Torstai;0;1;1
624;17.05.2018;2018;05;05;Torstai;0;4;4
624;17.05.2018;2018;05;06;Torstai;3;12;15
624;17.05.2018;2018;05;07;Torstai;5;47;52
624;17.05.2018;2018;05;08;Torstai;17;110;127
624;17.05.2018;2018;05;09;Torstai;13;88;101
624;17.05.2018;2018;05;10;Torstai;8;46;54
624;17.05.2018;2018;05;11;Torstai;3;34;37
624;17.05.2018;2018;05;12;Torstai;13;49;62
624;17.05.2018;2018;05;13;Torstai;12;41;53
624;17.05.2018;2018;05;14;Torstai;9;37;46
624;17.05.2018;2018;05;15;Torstai;41;55;96
624;17.05.2018;2018;05;16;Torstai;38;53;91
624;17.05.2018;2018;05;17;Torstai;41;74;115
624;17.05.2018;2018;05;18;Torstai;32;46;78
624;17.05.2018;2018;05;19;Torstai;22;51;73
624;17.05.2018;2018;05;20;Torstai;13;19;32
624;17.05.2018;2018;05;21;Torstai;7;20;27
624;17.05.2018;2018;05;22;Torstai;11;14;25
624;17.05.2018;2018;05;23;Torstai;5;3;8
624;18.05.2018;2018;05;00;Perjantai;4;6;10
624;18.05.2018;2018;05;01;Perjantai;2;3;5
624;18.05.2018;2018;05;02;Perjantai;1;0;1
624;18.05.2018;2018;05;03;Perjantai;0;1;1
624;18.05.2018;2018;05;04;Perjantai;0;4;4
624;18.05.2018;2018;05;05;Perjantai;0;2;2
624;18.05.2018;2018;05;06;Perjantai;4;12;16
624;18.05.2018;2018;05;07;Perjantai;2;38;40
624;18.05.2018;2018;05;08;Perjantai;12;75;87
624;18.05.2018;2018;05;09;Perjantai;11;80;91
624;18.05.2018;2018;05;10;Perjantai;9;33;42
624;18.05.2018;2018;05;11;Perjantai;7;26;33
624;18.05.2018;2018;05;12;Perjantai;4;27;31
624;18.05.2018;2018;05;13;Perjantai;10;35;45
624;18.05.2018;2018;05;14;Perjantai;6;41;47
624;18.05.2018;2018;05;15;Perjantai;14;44;58
624;18.05.2018;2018;05;16;Perjantai;31;45;76
624;18.05.2018;2018;05;17;Perjantai;31;53;84
624;18.05.2018;2018;05;18;Perjantai;13;42;55
624;18.05.2018;2018;05;19;Perjantai;13;26;39
624;18.05.2018;2018;05;20;Perjantai;8;26;34
624;18.05.2018;2018;05;21;Perjantai;22;25;47
624;18.05.2018;2018;05;22;Perjantai;16;10;26
624;18.05.2018;2018;05;23;Perjantai;6;7;13
624;19.05.2018;2018;05;00;Lauantai;4;2;6
624;19.05.2018;2018;05;01;Lauantai;7;7;14
624;19.05.2018;2018;05;02;Lauantai;4;2;6
624;19.05.2018;2018;05;03;Lauantai;4;2;6
624;19.05.2018;2018;05;04;Lauantai;1;2;3
624;19.05.2018;2018;05;05;Lauantai;1;0;1
624;19.05.2018;2018;05;06;Lauantai;0;2;2
624;19.05.2018;2018;05;07;Lauantai;1;5;6
624;19.05.2018;2018;05;08;Lauantai;3;8;11
624;19.05.2018;2018;05;09;Lauantai;2;9;11
624;19.05.2018;2018;05;10;Lauantai;4;22;26
624;19.05.2018;2018;05;11;Lauantai;8;27;35
624;19.05.2018;2018;05;12;Lauantai;2;26;28
624;19.05.2018;2018;05;13;Lauantai;9;34;43
624;19.05.2018;2018;05;14;Lauantai;10;24;34
624;19.05.2018;2018;05;15;Lauantai;21;28;49
624;19.05.2018;2018;05;16;Lauantai;13;24;37
624;19.05.2018;2018;05;17;Lauantai;14;20;34
624;19.05.2018;2018;05;18;Lauantai;13;16;29
624;19.05.2018;2018;05;19;Lauantai;14;34;48
624;19.05.2018;2018;05;20;Lauantai;9;26;35
624;19.05.2018;2018;05;21;Lauantai;10;20;30
624;19.05.2018;2018;05;22;Lauantai;9;15;24
624;19.05.2018;2018;05;23;Lauantai;14;8;22
624;20.05.2018;2018;05;00;Sunnuntai;5;8;13
624;20.05.2018;2018;05;01;Sunnuntai;1;7;8
624;20.05.2018;2018;05;02;Sunnuntai;3;8;11
624;20.05.2018;2018;05;03;Sunnuntai;7;3;10
624;20.05.2018;2018;05;04;Sunnuntai;5;0;5
624;20.05.2018;2018;05;05;Sunnuntai;2;4;6
624;20.05.2018;2018;05;06;Sunnuntai;2;2;4
624;20.05.2018;2018;05;07;Sunnuntai;1;4;5
624;20.05.2018;2018;05;08;Sunnuntai;1;4;5
624;20.05.2018;2018;05;09;Sunnuntai;3;7;10
624;20.05.2018;2018;05;10;Sunnuntai;4;9;13
624;20.05.2018;2018;05;11;Sunnuntai;8;20;28
624;20.05.2018;2018;05;12;Sunnuntai;14;32;46
624;20.05.2018;2018;05;13;Sunnuntai;11;26;37
624;20.05.2018;2018;05;14;Sunnuntai;16;27;43
624;20.05.2018;2018;05;15;Sunnuntai;13;22;35
624;20.05.2018;2018;05;16;Sunnuntai;12;23;35
624;20.05.2018;2018;05;17;Sunnuntai;12;30;42
624;20.05.2018;2018;05;18;Sunnuntai;12;24;36
624;20.05.2018;2018;05;19;Sunnuntai;12;22;34
624;20.05.2018;2018;05;20;Sunnuntai;9;16;25
624;20.05.2018;2018;05;21;Sunnuntai;7;11;18
624;20.05.2018;2018;05;22;Sunnuntai;8;9;17
624;20.05.2018;2018;05;23;Sunnuntai;4;3;7
624;21.05.2018;2018;05;00;Maanantai;3;5;8
624;21.05.2018;2018;05;01;Maanantai;0;4;4
624;21.05.2018;2018;05;02;Maanantai;0;0;0
624;21.05.2018;2018;05;03;Maanantai;2;0;2
624;21.05.2018;2018;05;04;Maanantai;0;0;0
624;21.05.2018;2018;05;05;Maanantai;0;2;2
624;21.05.2018;2018;05;06;Maanantai;2;11;13
624;21.05.2018;2018;05;07;Maanantai;5;61;66
624;21.05.2018;2018;05;08;Maanantai;17;102;119
624;21.05.2018;2018;05;09;Maanantai;11;81;92
624;21.05.2018;2018;05;10;Maanantai;11;48;59
624;21.05.2018;2018;05;11;Maanantai;7;30;37
624;21.05.2018;2018;05;12;Maanantai;18;43;61
624;21.05.2018;2018;05;13;Maanantai;7;24;31
624;21.05.2018;2018;05;14;Maanantai;20;38;58
624;21.05.2018;2018;05;15;Maanantai;23;36;59
624;21.05.2018;2018;05;16;Maanantai;32;47;79
624;21.05.2018;2018;05;17;Maanantai;34;78;112
624;21.05.2018;2018;05;18;Maanantai;15;45;60
624;21.05.2018;2018;05;19;Maanantai;13;35;48
624;21.05.2018;2018;05;20;Maanantai;13;21;34
624;21.05.2018;2018;05;21;Maanantai;15;25;40
624;21.05.2018;2018;05;22;Maanantai;12;12;24
624;21.05.2018;2018;05;23;Maanantai;2;7;9
624;22.05.2018;2018;05;00;Tiistai;1;9;10
624;22.05.2018;2018;05;01;Tiistai;2;3;5
624;22.05.2018;2018;05;02;Tiistai;3;2;5
624;22.05.2018;2018;05;03;Tiistai;0;0;0
624;22.05.2018;2018;05;04;Tiistai;0;3;3
624;22.05.2018;2018;05;05;Tiistai;1;1;2
624;22.05.2018;2018;05;06;Tiistai;3;12;15
624;22.05.2018;2018;05;07;Tiistai;5;51;56
624;22.05.2018;2018;05;08;Tiistai;18;118;136
624;22.05.2018;2018;05;09;Tiistai;15;79;94
624;22.05.2018;2018;05;10;Tiistai;6;42;48
624;22.05.2018;2018;05;11;Tiistai;22;35;57
624;22.05.2018;2018;05;12;Tiistai;13;29;42
624;22.05.2018;2018;05;13;Tiistai;13;48;61
624;22.05.2018;2018;05;14;Tiistai;14;42;56
624;22.05.2018;2018;05;15;Tiistai;30;54;84
624;22.05.2018;2018;05;16;Tiistai;36;54;90
624;22.05.2018;2018;05;17;Tiistai;25;76;101
624;22.05.2018;2018;05;18;Tiistai;13;57;70
624;22.05.2018;2018;05;19;Tiistai;10;42;52
624;22.05.2018;2018;05;20;Tiistai;27;40;67
624;22.05.2018;2018;05;21;Tiistai;14;35;49
624;22.05.2018;2018;05;22;Tiistai;7;16;23
624;22.05.2018;2018;05;23;Tiistai;7;13;20
624;23.05.2018;2018;05;00;Keskiviikko;2;2;4
624;23.05.2018;2018;05;01;Keskiviikko;0;4;4
624;23.05.2018;2018;05;02;Keskiviikko;0;1;1
624;23.05.2018;2018;05;03;Keskiviikko;2;0;2
624;23.05.2018;2018;05;04;Keskiviikko;0;1;1
624;23.05.2018;2018;05;05;Keskiviikko;0;1;1
624;23.05.2018;2018;05;06;Keskiviikko;3;10;13
624;23.05.2018;2018;05;07;Keskiviikko;5;53;58
624;23.05.2018;2018;05;08;Keskiviikko;23;86;109
624;23.05.2018;2018;05;09;Keskiviikko;13;85;98
624;23.05.2018;2018;05;10;Keskiviikko;13;37;50
624;23.05.2018;2018;05;11;Keskiviikko;12;41;53
624;23.05.2018;2018;05;12;Keskiviikko;17;48;65
624;23.05.2018;2018;05;13;Keskiviikko;14;30;44
624;23.05.2018;2018;05;14;Keskiviikko;18;44;62
624;23.05.2018;2018;05;15;Keskiviikko;17;42;59
624;23.05.2018;2018;05;16;Keskiviikko;17;38;55
624;23.05.2018;2018;05;17;Keskiviikko;39;72;111
624;23.05.2018;2018;05;18;Keskiviikko;16;29;45
624;23.05.2018;2018;05;19;Keskiviikko;14;34;48
624;23.05.2018;2018;05;20;Keskiviikko;20;24;44
624;23.05.2018;2018;05;21;Keskiviikko;22;23;45
624;23.05.2018;2018;05;22;Keskiviikko;9;13;22
624;23.05.2018;2018;05;23;Keskiviikko;2;9;11
624;24.05.2018;2018;05;00;Torstai;1;2;3
624;24.05.2018;2018;05;01;Torstai;2;2;4
624;24.05.2018;2018;05;02;Torstai;1;1;2
624;24.05.2018;2018;05;03;Torstai;0;2;2
624;24.05.2018;2018;05;04;Torstai;0;0;0
624;24.05.2018;2018;05;05;Torstai;2;1;3
624;24.05.2018;2018;05;06;Torstai;0;9;9
624;24.05.2018;2018;05;07;Torstai;4;39;43
624;24.05.2018;2018;05;08;Torstai;16;99;115
624;24.05.2018;2018;05;09;Torstai;18;105;123
624;24.05.2018;2018;05;10;Torstai;7;34;41
624;24.05.2018;2018;05;11;Torstai;17;56;73
624;24.05.2018;2018;05;12;Torstai;5;39;44
624;24.05.2018;2018;05;13;Torstai;16;28;44
624;24.05.2018;2018;05;14;Torstai;17;43;60
624;24.05.2018;2018;05;15;Torstai;11;34;45
624;24.05.2018;2018;05;16;Torstai;20;40;60
624;24.05.2018;2018;05;17;Torstai;34;62;96
624;24.05.2018;2018;05;18;Torstai;16;47;63
624;24.05.2018;2018;05;19;Torstai;18;33;51
624;24.05.2018;2018;05;20;Torstai;11;26;37
624;24.05.2018;2018;05;21;Torstai;11;21;32
624;24.05.2018;2018;05;22;Torstai;9;15;24
624;24.05.2018;2018;05;23;Torstai;3;8;11
624;25.05.2018;2018;05;00;Perjantai;3;3;6
624;25.05.2018;2018;05;01;Perjantai;1;4;5
624;25.05.2018;2018;05;02;Perjantai;0;5;5
624;25.05.2018;2018;05;03;Perjantai;2;5;7
624;25.05.2018;2018;05;04;Perjantai;0;4;4
624;25.05.2018;2018;05;05;Perjantai;1;0;1
624;25.05.2018;2018;05;06;Perjantai;1;10;11
624;25.05.2018;2018;05;07;Perjantai;3;44;47
624;25.05.2018;2018;05;08;Perjantai;8;82;90
624;25.05.2018;2018;05;09;Perjantai;14;73;87
624;25.05.2018;2018;05;10;Perjantai;7;40;47
624;25.05.2018;2018;05;11;Perjantai;8;31;39
624;25.05.2018;2018;05;12;Perjantai;10;29;39
624;25.05.2018;2018;05;13;Perjantai;14;28;42
624;25.05.2018;2018;05;14;Perjantai;25;36;61
624;25.05.2018;2018;05;15;Perjantai;25;42;67
624;25.05.2018;2018;05;16;Perjantai;25;44;69
624;25.05.2018;2018;05;17;Perjantai;27;58;85
624;25.05.2018;2018;05;18;Perjantai;17;46;63
624;25.05.2018;2018;05;19;Perjantai;15;25;40
624;25.05.2018;2018;05;20;Perjantai;13;16;29
624;25.05.2018;2018;05;21;Perjantai;11;18;29
624;25.05.2018;2018;05;22;Perjantai;8;8;16
624;25.05.2018;2018;05;23;Perjantai;2;12;14
624;26.05.2018;2018;05;00;Lauantai;1;12;13
624;26.05.2018;2018;05;01;Lauantai;2;1;3
624;26.05.2018;2018;05;02;Lauantai;4;6;10
624;26.05.2018;2018;05;03;Lauantai;4;5;9
624;26.05.2018;2018;05;04;Lauantai;4;1;5
624;26.05.2018;2018;05;05;Lauantai;1;1;2
624;26.05.2018;2018;05;06;Lauantai;1;1;2
624;26.05.2018;2018;05;07;Lauantai;0;3;3
624;26.05.2018;2018;05;08;Lauantai;2;10;12
624;26.05.2018;2018;05;09;Lauantai;4;11;15
624;26.05.2018;2018;05;10;Lauantai;3;19;22
624;26.05.2018;2018;05;11;Lauantai;5;17;22
624;26.05.2018;2018;05;12;Lauantai;3;17;20
624;26.05.2018;2018;05;13;Lauantai;6;26;32
624;26.05.2018;2018;05;14;Lauantai;12;26;38
624;26.05.2018;2018;05;15;Lauantai;10;34;44
624;26.05.2018;2018;05;16;Lauantai;12;19;31
624;26.05.2018;2018;05;17;Lauantai;15;20;35
624;26.05.2018;2018;05;18;Lauantai;13;11;24
624;26.05.2018;2018;05;19;Lauantai;13;19;32
624;26.05.2018;2018;05;20;Lauantai;5;14;19
624;26.05.2018;2018;05;21;Lauantai;8;16;24
624;26.05.2018;2018;05;22;Lauantai;6;4;10
624;26.05.2018;2018;05;23;Lauantai;2;7;9
624;27.05.2018;2018;05;00;Sunnuntai;4;5;9
624;27.05.2018;2018;05;01;Sunnuntai;3;8;11
624;27.05.2018;2018;05;02;Sunnuntai;2;4;6
624;27.05.2018;2018;05;03;Sunnuntai;4;4;8
624;27.05.2018;2018;05;04;Sunnuntai;1;0;1
624;27.05.2018;2018;05;05;Sunnuntai;2;1;3
624;27.05.2018;2018;05;06;Sunnuntai;3;0;3
624;27.05.2018;2018;05;07;Sunnuntai;0;7;7
624;27.05.2018;2018;05;08;Sunnuntai;0;0;0
624;27.05.2018;2018;05;09;Sunnuntai;2;6;8
624;27.05.2018;2018;05;10;Sunnuntai;4;12;16
624;27.05.2018;2018;05;11;Sunnuntai;7;13;20
624;27.05.2018;2018;05;12;Sunnuntai;4;11;15
624;27.05.2018;2018;05;13;Sunnuntai;0;26;26
624;27.05.2018;2018;05;14;Sunnuntai;0;27;27
624;27.05.2018;2018;05;15;Sunnuntai;0;22;22
624;27.05.2018;2018;05;16;Sunnuntai;0;23;23
624;27.05.2018;2018;05;17;Sunnuntai;0;30;30
624;27.05.2018;2018;05;18;Sunnuntai;0;24;24
624;27.05.2018;2018;05;19;Sunnuntai;0;22;22
624;27.05.2018;2018;05;20;Sunnuntai;0;16;16
624;27.05.2018;2018;05;21;Sunnuntai;0;11;11
624;27.05.2018;2018;05;22;Sunnuntai;0;9;9
624;27.05.2018;2018;05;23;Sunnuntai;0;3;3
624;28.05.2018;2018;05;00;Maanantai;0;5;5
624;28.05.2018;2018;05;01;Maanantai;0;4;4
624;28.05.2018;2018;05;02;Maanantai;0;0;0
624;28.05.2018;2018;05;03;Maanantai;0;0;0
624;28.05.2018;2018;05;04;Maanantai;0;0;0
624;28.05.2018;2018;05;05;Maanantai;0;2;2
624;28.05.2018;2018;05;06;Maanantai;0;11;11
624;28.05.2018;2018;05;07;Maanantai;0;61;61
624;28.05.2018;2018;05;08;Maanantai;0;102;102
624;28.05.2018;2018;05;09;Maanantai;0;81;81
624;28.05.2018;2018;05;10;Maanantai;0;48;48
624;28.05.2018;2018;05;11;Maanantai;0;30;30
624;28.05.2018;2018;05;12;Maanantai;11;27;38
624;28.05.2018;2018;05;13;Maanantai;17;25;42
624;28.05.2018;2018;05;14;Maanantai;25;38;63
624;28.05.2018;2018;05;15;Maanantai;13;43;56
624;28.05.2018;2018;05;16;Maanantai;34;62;96
624;28.05.2018;2018;05;17;Maanantai;32;79;111
624;28.05.2018;2018;05;18;Maanantai;15;51;66
624;28.05.2018;2018;05;19;Maanantai;22;37;59
624;28.05.2018;2018;05;20;Maanantai;18;38;56
624;28.05.2018;2018;05;21;Maanantai;17;27;44
624;28.05.2018;2018;05;22;Maanantai;7;17;24
624;28.05.2018;2018;05;23;Maanantai;3;10;13
624;29.05.2018;2018;05;00;Tiistai;1;5;6
624;29.05.2018;2018;05;01;Tiistai;1;4;5
624;29.05.2018;2018;05;02;Tiistai;0;3;3
624;29.05.2018;2018;05;03;Tiistai;0;1;1
624;29.05.2018;2018;05;04;Tiistai;0;0;0
624;29.05.2018;2018;05;05;Tiistai;1;2;3
624;29.05.2018;2018;05;06;Tiistai;0;16;16
624;29.05.2018;2018;05;07;Tiistai;6;64;70
624;29.05.2018;2018;05;08;Tiistai;14;86;100
624;29.05.2018;2018;05;09;Tiistai;13;90;103
624;29.05.2018;2018;05;10;Tiistai;8;65;73
624;29.05.2018;2018;05;11;Tiistai;7;36;43
624;29.05.2018;2018;05;12;Tiistai;8;27;35
624;29.05.2018;2018;05;13;Tiistai;15;43;58
624;29.05.2018;2018;05;14;Tiistai;23;50;73
624;29.05.2018;2018;05;15;Tiistai;30;46;76
624;29.05.2018;2018;05;16;Tiistai;34;61;95
624;29.05.2018;2018;05;17;Tiistai;49;84;133
624;29.05.2018;2018;05;18;Tiistai;16;48;64
624;29.05.2018;2018;05;19;Tiistai;15;31;46
624;29.05.2018;2018;05;20;Tiistai;7;21;28
624;29.05.2018;2018;05;21;Tiistai;8;33;41
624;29.05.2018;2018;05;22;Tiistai;8;16;24
624;29.05.2018;2018;05;23;Tiistai;9;6;15
624;30.05.2018;2018;05;00;Keskiviikko;3;3;6
624;30.05.2018;2018;05;01;Keskiviikko;5;3;8
624;30.05.2018;2018;05;02;Keskiviikko;0;0;0
624;30.05.2018;2018;05;03;Keskiviikko;1;2;3
624;30.05.2018;2018;05;04;Keskiviikko;0;0;0
624;30.05.2018;2018;05;05;Keskiviikko;0;4;4
624;30.05.2018;2018;05;06;Keskiviikko;3;14;17
624;30.05.2018;2018;05;07;Keskiviikko;7;53;60
624;30.05.2018;2018;05;08;Keskiviikko;17;108;125
624;30.05.2018;2018;05;09;Keskiviikko;34;120;154
624;30.05.2018;2018;05;10;Keskiviikko;4;44;48
624;30.05.2018;2018;05;11;Keskiviikko;9;40;49
624;30.05.2018;2018;05;12;Keskiviikko;11;32;43
624;30.05.2018;2018;05;13;Keskiviikko;20;34;54
624;30.05.2018;2018;05;14;Keskiviikko;17;29;46
624;30.05.2018;2018;05;15;Keskiviikko;21;46;67
624;30.05.2018;2018;05;16;Keskiviikko;34;41;75
624;30.05.2018;2018;05;17;Keskiviikko;30;68;98
624;30.05.2018;2018;05;18;Keskiviikko;19;60;79
624;30.05.2018;2018;05;19;Keskiviikko;8;40;48
624;30.05.2018;2018;05;20;Keskiviikko;11;22;33
624;30.05.2018;2018;05;21;Keskiviikko;11;20;31
624;30.05.2018;2018;05;22;Keskiviikko;12;15;27
624;30.05.2018;2018;05;23;Keskiviikko;3;8;11
624;31.05.2018;2018;05;00;Torstai;2;6;8
624;31.05.2018;2018;05;01;Torstai;1;5;6
624;31.05.2018;2018;05;02;Torstai;1;2;3
624;31.05.2018;2018;05;03;Torstai;0;0;0
624;31.05.2018;2018;05;04;Torstai;0;1;1
624;31.05.2018;2018;05;05;Torstai;1;2;3
624;31.05.2018;2018;05;06;Torstai;4;16;20
624;31.05.2018;2018;05;07;Torstai;5;51;56
624;31.05.2018;2018;05;08;Torstai;12;97;109
624;31.05.2018;2018;05;09;Torstai;10;98;108
624;31.05.2018;2018;05;10;Torstai;11;34;45
624;31.05.2018;2018;05;11;Torstai;8;48;56
624;31.05.2018;2018;05;12;Torstai;15;39;54
624;31.05.2018;2018;05;13;Torstai;13;29;42
624;31.05.2018;2018;05;14;Torstai;10;30;40
624;31.05.2018;2018;05;15;Torstai;20;46;66
624;31.05.2018;2018;05;16;Torstai;29;57;86
624;31.05.2018;2018;05;17;Torstai;32;54;86
624;31.05.2018;2018;05;18;Torstai;26;54;80
624;31.05.2018;2018;05;19;Torstai;23;32;55
624;31.05.2018;2018;05;20;Torstai;16;40;56
624;31.05.2018;2018;05;21;Torstai;17;18;35
624;31.05.2018;2018;05;22;Torstai;14;14;28
624;31.05.2018;2018;05;23;Torstai;2;14;16
624;01.06.2018;2018;06;00;Perjantai;4;4;8
624;01.06.2018;2018;06;01;Perjantai;3;7;10
624;01.06.2018;2018;06;02;Perjantai;0;2;2
624;01.06.2018;2018;06;03;Perjantai;0;1;1
624;01.06.2018;2018;06;04;Perjantai;1;2;3
624;01.06.2018;2018;06;05;Perjantai;0;4;4
624;01.06.2018;2018;06;06;Perjantai;3;7;10
624;01.06.2018;2018;06;07;Perjantai;4;52;56
624;01.06.2018;2018;06;08;Perjantai;19;89;108
624;01.06.2018;2018;06;09;Perjantai;13;80;93
624;01.06.2018;2018;06;10;Perjantai;8;49;57
624;01.06.2018;2018;06;11;Perjantai;12;33;45
624;01.06.2018;2018;06;12;Perjantai;9;39;48
624;01.06.2018;2018;06;13;Perjantai;17;38;55
624;01.06.2018;2018;06;14;Perjantai;6;41;47
624;01.06.2018;2018;06;15;Perjantai;20;29;49
624;01.06.2018;2018;06;16;Perjantai;38;47;85
624;01.06.2018;2018;06;17;Perjantai;17;51;68
624;01.06.2018;2018;06;18;Perjantai;18;29;47
624;01.06.2018;2018;06;19;Perjantai;15;32;47
624;01.06.2018;2018;06;20;Perjantai;10;25;35
624;01.06.2018;2018;06;21;Perjantai;9;21;30
624;01.06.2018;2018;06;22;Perjantai;7;10;17
624;01.06.2018;2018;06;23;Perjantai;3;10;13
624;02.06.2018;2018;06;00;Lauantai;2;5;7
624;02.06.2018;2018;06;01;Lauantai;1;4;5
624;02.06.2018;2018;06;02;Lauantai;1;0;1
624;02.06.2018;2018;06;03;Lauantai;1;5;6
624;02.06.2018;2018;06;04;Lauantai;1;2;3
624;02.06.2018;2018;06;05;Lauantai;2;1;3
624;02.06.2018;2018;06;06;Lauantai;1;1;2
624;02.06.2018;2018;06;07;Lauantai;0;5;5
624;02.06.2018;2018;06;08;Lauantai;0;12;12
624;02.06.2018;2018;06;09;Lauantai;5;19;24
624;02.06.2018;2018;06;10;Lauantai;4;21;25
624;02.06.2018;2018;06;11;Lauantai;7;24;31
624;02.06.2018;2018;06;12;Lauantai;7;26;33
624;02.06.2018;2018;06;13;Lauantai;17;48;65
624;02.06.2018;2018;06;14;Lauantai;17;22;39
624;02.06.2018;2018;06;15;Lauantai;14;25;39
624;02.06.2018;2018;06;16;Lauantai;18;32;50
624;02.06.2018;2018;06;17;Lauantai;21;25;46
624;02.06.2018;2018;06;18;Lauantai;13;24;37
624;02.06.2018;2018;06;19;Lauantai;14;32;46
624;02.06.2018;2018;06;20;Lauantai;11;24;35
624;02.06.2018;2018;06;21;Lauantai;6;20;26
624;02.06.2018;2018;06;22;Lauantai;12;11;23
624;02.06.2018;2018;06;23;Lauantai;4;7;11
624;03.06.2018;2018;06;00;Sunnuntai;3;11;14
624;03.06.2018;2018;06;01;Sunnuntai;2;7;9
624;03.06.2018;2018;06;02;Sunnuntai;5;2;7
624;03.06.2018;2018;06;03;Sunnuntai;4;4;8
624;03.06.2018;2018;06;04;Sunnuntai;3;1;4
624;03.06.2018;2018;06;05;Sunnuntai;3;1;4
624;03.06.2018;2018;06;06;Sunnuntai;0;1;1
624;03.06.2018;2018;06;07;Sunnuntai;0;4;4
624;03.06.2018;2018;06;08;Sunnuntai;1;6;7
624;03.06.2018;2018;06;09;Sunnuntai;3;10;13
624;03.06.2018;2018;06;10;Sunnuntai;2;22;24
624;03.06.2018;2018;06;11;Sunnuntai;3;19;22
624;03.06.2018;2018;06;12;Sunnuntai;10;26;36
624;03.06.2018;2018;06;13;Sunnuntai;9;19;28
624;03.06.2018;2018;06;14;Sunnuntai;9;27;36
624;03.06.2018;2018;06;15;Sunnuntai;6;28;34
624;03.06.2018;2018;06;16;Sunnuntai;10;42;52
624;03.06.2018;2018;06;17;Sunnuntai;11;23;34
624;03.06.2018;2018;06;18;Sunnuntai;6;25;31
624;03.06.2018;2018;06;19;Sunnuntai;21;25;46
624;03.06.2018;2018;06;20;Sunnuntai;7;18;25
624;03.06.2018;2018;06;21;Sunnuntai;10;15;25
624;03.06.2018;2018;06;22;Sunnuntai;4;9;13
624;03.06.2018;2018;06;23;Sunnuntai;2;2;4
624;04.06.2018;2018;06;00;Maanantai;2;2;4
624;04.06.2018;2018;06;01;Maanantai;0;3;3
624;04.06.2018;2018;06;02;Maanantai;1;4;5
624;04.06.2018;2018;06;03;Maanantai;1;3;4
624;04.06.2018;2018;06;04;Maanantai;2;3;5
624;04.06.2018;2018;06;05;Maanantai;1;1;2
624;04.06.2018;2018;06;06;Maanantai;2;12;14
624;04.06.2018;2018;06;07;Maanantai;7;51;58
624;04.06.2018;2018;06;08;Maanantai;13;80;93
624;04.06.2018;2018;06;09;Maanantai;10;64;74
624;04.06.2018;2018;06;10;Maanantai;6;30;36
624;04.06.2018;2018;06;11;Maanantai;5;17;22
624;04.06.2018;2018;06;12;Maanantai;12;26;38
624;04.06.2018;2018;06;13;Maanantai;8;23;31
624;04.06.2018;2018;06;14;Maanantai;8;19;27
624;04.06.2018;2018;06;15;Maanantai;8;20;28
624;04.06.2018;2018;06;16;Maanantai;23;37;60
624;04.06.2018;2018;06;17;Maanantai;15;39;54
624;04.06.2018;2018;06;18;Maanantai;24;15;39
624;04.06.2018;2018;06;19;Maanantai;15;16;31
624;04.06.2018;2018;06;20;Maanantai;3;11;14
624;04.06.2018;2018;06;21;Maanantai;9;5;14
624;04.06.2018;2018;06;22;Maanantai;12;4;16
624;04.06.2018;2018;06;23;Maanantai;4;6;10
624;05.06.2018;2018;06;00;Tiistai;1;1;2
624;05.06.2018;2018;06;01;Tiistai;0;1;1
624;05.06.2018;2018;06;02;Tiistai;1;0;1
624;05.06.2018;2018;06;03;Tiistai;0;2;2
624;05.06.2018;2018;06;04;Tiistai;0;2;2
624;05.06.2018;2018;06;05;Tiistai;1;1;2
624;05.06.2018;2018;06;06;Tiistai;1;11;12
624;05.06.2018;2018;06;07;Tiistai;6;39;45
624;05.06.2018;2018;06;08;Tiistai;10;80;90
624;05.06.2018;2018;06;09;Tiistai;11;52;63
624;05.06.2018;2018;06;10;Tiistai;7;42;49
624;05.06.2018;2018;06;11;Tiistai;3;27;30
624;05.06.2018;2018;06;12;Tiistai;16;29;45
624;05.06.2018;2018;06;13;Tiistai;10;19;29
624;05.06.2018;2018;06;14;Tiistai;8;29;37
624;05.06.2018;2018;06;15;Tiistai;14;33;47
624;05.06.2018;2018;06;16;Tiistai;18;47;65
624;05.06.2018;2018;06;17;Tiistai;20;58;78
624;05.06.2018;2018;06;18;Tiistai;11;43;54
624;05.06.2018;2018;06;19;Tiistai;16;22;38
624;05.06.2018;2018;06;20;Tiistai;19;22;41
624;05.06.2018;2018;06;21;Tiistai;19;9;28
624;05.06.2018;2018;06;22;Tiistai;8;10;18
624;05.06.2018;2018;06;23;Tiistai;2;5;7
624;06.06.2018;2018;06;00;Keskiviikko;1;1;2
624;06.06.2018;2018;06;01;Keskiviikko;2;0;2
624;06.06.2018;2018;06;02;Keskiviikko;1;2;3
624;06.06.2018;2018;06;03;Keskiviikko;2;2;4
624;06.06.2018;2018;06;04;Keskiviikko;0;1;1
624;06.06.2018;2018;06;05;Keskiviikko;1;2;3
624;06.06.2018;2018;06;06;Keskiviikko;3;10;13
624;06.06.2018;2018;06;07;Keskiviikko;10;54;64
624;06.06.2018;2018;06;08;Keskiviikko;11;85;96
624;06.06.2018;2018;06;09;Keskiviikko;9;72;81
624;06.06.2018;2018;06;10;Keskiviikko;8;37;45
624;06.06.2018;2018;06;11;Keskiviikko;6;23;29
624;06.06.2018;2018;06;12;Keskiviikko;10;22;32
624;06.06.2018;2018;06;13;Keskiviikko;7;33;40
624;06.06.2018;2018;06;14;Keskiviikko;11;24;35
624;06.06.2018;2018;06;15;Keskiviikko;11;38;49
624;06.06.2018;2018;06;16;Keskiviikko;28;43;71
624;06.06.2018;2018;06;17;Keskiviikko;16;56;72
624;06.06.2018;2018;06;18;Keskiviikko;19;28;47
624;06.06.2018;2018;06;19;Keskiviikko;15;36;51
624;06.06.2018;2018;06;20;Keskiviikko;13;18;31
624;06.06.2018;2018;06;21;Keskiviikko;4;13;17
624;06.06.2018;2018;06;22;Keskiviikko;6;4;10
624;06.06.2018;2018;06;23;Keskiviikko;0;8;8
624;07.06.2018;2018;06;00;Torstai;2;3;5
624;07.06.2018;2018;06;01;Torstai;1;2;3
624;07.06.2018;2018;06;02;Torstai;1;3;4
624;07.06.2018;2018;06;03;Torstai;2;1;3
624;07.06.2018;2018;06;04;Torstai;1;0;1
624;07.06.2018;2018;06;05;Torstai;0;3;3
624;07.06.2018;2018;06;06;Torstai;3;12;15
624;07.06.2018;2018;06;07;Torstai;1;38;39
624;07.06.2018;2018;06;08;Torstai;13;55;68
624;07.06.2018;2018;06;09;Torstai;3;44;47
624;07.06.2018;2018;06;10;Torstai;8;16;24
624;07.06.2018;2018;06;11;Torstai;3;8;11
624;07.06.2018;2018;06;12;Torstai;7;16;23
624;07.06.2018;2018;06;13;Torstai;4;13;17
624;07.06.2018;2018;06;14;Torstai;8;19;27
624;07.06.2018;2018;06;15;Torstai;12;25;37
624;07.06.2018;2018;06;16;Torstai;26;28;54
624;07.06.2018;2018;06;17;Torstai;15;42;57
624;07.06.2018;2018;06;18;Torstai;10;14;24
624;07.06.2018;2018;06;19;Torstai;13;18;31
624;07.06.2018;2018;06;20;Torstai;2;14;16
624;07.06.2018;2018;06;21;Torstai;6;9;15
624;07.06.2018;2018;06;22;Torstai;9;7;16
624;07.06.2018;2018;06;23;Torstai;4;6;10
624;08.06.2018;2018;06;00;Perjantai;5;0;5
624;08.06.2018;2018;06;01;Perjantai;4;3;7
624;08.06.2018;2018;06;02;Perjantai;0;2;2
624;08.06.2018;2018;06;03;Perjantai;0;1;1
624;08.06.2018;2018;06;04;Perjantai;4;0;4
624;08.06.2018;2018;06;05;Perjantai;0;2;2
624;08.06.2018;2018;06;06;Perjantai;1;11;12
624;08.06.2018;2018;06;07;Perjantai;5;50;55
624;08.06.2018;2018;06;08;Perjantai;9;67;76
624;08.06.2018;2018;06;09;Perjantai;8;60;68
624;08.06.2018;2018;06;10;Perjantai;8;27;35
624;08.06.2018;2018;06;11;Perjantai;3;34;37
624;08.06.2018;2018;06;12;Perjantai;9;23;32
624;08.06.2018;2018;06;13;Perjantai;11;26;37
624;08.06.2018;2018;06;14;Perjantai;8;39;47
624;08.06.2018;2018;06;15;Perjantai;18;41;59
624;08.06.2018;2018;06;16;Perjantai;25;51;76
624;08.06.2018;2018;06;17;Perjantai;7;41;48
624;08.06.2018;2018;06;18;Perjantai;9;26;35
624;08.06.2018;2018;06;19;Perjantai;9;25;34
624;08.06.2018;2018;06;20;Perjantai;8;13;21
624;08.06.2018;2018;06;21;Perjantai;5;19;24
624;08.06.2018;2018;06;22;Perjantai;7;8;15
624;08.06.2018;2018;06;23;Perjantai;6;8;14
624;09.06.2018;2018;06;00;Lauantai;0;7;7
624;09.06.2018;2018;06;01;Lauantai;0;1;1
624;09.06.2018;2018;06;02;Lauantai;0;1;1
624;09.06.2018;2018;06;03;Lauantai;0;4;4
624;09.06.2018;2018;06;04;Lauantai;0;0;0
624;09.06.2018;2018;06;05;Lauantai;0;1;1
624;09.06.2018;2018;06;06;Lauantai;0;1;1
624;09.06.2018;2018;06;07;Lauantai;0;5;5
624;09.06.2018;2018;06;08;Lauantai;0;12;12
624;09.06.2018;2018;06;09;Lauantai;0;19;19
624;09.06.2018;2018;06;10;Lauantai;0;21;21
624;09.06.2018;2018;06;11;Lauantai;0;24;24
624;09.06.2018;2018;06;12;Lauantai;0;26;26
624;09.06.2018;2018;06;13;Lauantai;0;48;48
624;09.06.2018;2018;06;14;Lauantai;0;22;22
624;09.06.2018;2018;06;15;Lauantai;0;25;25
624;09.06.2018;2018;06;16;Lauantai;0;32;32
624;09.06.2018;2018;06;17;Lauantai;0;25;25
624;09.06.2018;2018;06;18;Lauantai;0;24;24
624;09.06.2018;2018;06;19;Lauantai;0;32;32
624;09.06.2018;2018;06;20;Lauantai;0;24;24
624;09.06.2018;2018;06;21;Lauantai;0;20;20
624;09.06.2018;2018;06;22;Lauantai;0;11;11
624;09.06.2018;2018;06;23;Lauantai;0;7;7
624;10.06.2018;2018;06;00;Sunnuntai;0;11;11
624;10.06.2018;2018;06;01;Sunnuntai;0;7;7
624;10.06.2018;2018;06;02;Sunnuntai;0;2;2
624;10.06.2018;2018;06;03;Sunnuntai;0;4;4
624;10.06.2018;2018;06;04;Sunnuntai;0;1;1
624;10.06.2018;2018;06;05;Sunnuntai;0;1;1
624;10.06.2018;2018;06;06;Sunnuntai;0;1;1
624;10.06.2018;2018;06;07;Sunnuntai;0;4;4
624;10.06.2018;2018;06;08;Sunnuntai;0;6;6
624;10.06.2018;2018;06;09;Sunnuntai;0;10;10
624;10.06.2018;2018;06;10;Sunnuntai;0;22;22
624;10.06.2018;2018;06;11;Sunnuntai;0;19;19
624;10.06.2018;2018;06;12;Sunnuntai;0;26;26
624;10.06.2018;2018;06;13;Sunnuntai;0;19;19
624;10.06.2018;2018;06;14;Sunnuntai;0;27;27
624;10.06.2018;2018;06;15;Sunnuntai;0;28;28
624;10.06.2018;2018;06;16;Sunnuntai;0;42;42
624;10.06.2018;2018;06;17;Sunnuntai;0;23;23
624;10.06.2018;2018;06;18;Sunnuntai;0;25;25
624;10.06.2018;2018;06;19;Sunnuntai;0;25;25
624;10.06.2018;2018;06;20;Sunnuntai;0;18;18
624;10.06.2018;2018;06;21;Sunnuntai;0;15;15
624;10.06.2018;2018;06;22;Sunnuntai;0;9;9
624;10.06.2018;2018;06;23;Sunnuntai;0;2;2
624;11.06.2018;2018;06;00;Maanantai;2;1;3
624;11.06.2018;2018;06;01;Maanantai;2;6;8
624;11.06.2018;2018;06;02;Maanantai;2;1;3
624;11.06.2018;2018;06;03;Maanantai;0;2;2
624;11.06.2018;2018;06;04;Maanantai;0;0;0
624;11.06.2018;2018;06;05;Maanantai;1;2;3
624;11.06.2018;2018;06;06;Maanantai;5;11;16
624;11.06.2018;2018;06;07;Maanantai;9;41;50
624;11.06.2018;2018;06;08;Maanantai;12;90;102
624;11.06.2018;2018;06;09;Maanantai;13;73;86
624;11.06.2018;2018;06;10;Maanantai;8;38;46
624;11.06.2018;2018;06;11;Maanantai;7;34;41
624;11.06.2018;2018;06;12;Maanantai;14;42;56
624;11.06.2018;2018;06;13;Maanantai;12;34;46
624;11.06.2018;2018;06;14;Maanantai;7;28;35
624;11.06.2018;2018;06;15;Maanantai;19;37;56
624;11.06.2018;2018;06;16;Maanantai;37;53;90
624;11.06.2018;2018;06;17;Maanantai;30;59;89
624;11.06.2018;2018;06;18;Maanantai;17;48;65
624;11.06.2018;2018;06;19;Maanantai;17;32;49
624;11.06.2018;2018;06;20;Maanantai;22;26;48
624;11.06.2018;2018;06;21;Maanantai;11;11;22
624;11.06.2018;2018;06;22;Maanantai;15;19;34
624;11.06.2018;2018;06;23;Maanantai;4;10;14
624;12.06.2018;2018;06;00;Tiistai;2;1;3
624;12.06.2018;2018;06;01;Tiistai;2;6;8
624;12.06.2018;2018;06;02;Tiistai;2;1;3
624;12.06.2018;2018;06;03;Tiistai;0;2;2
624;12.06.2018;2018;06;04;Tiistai;0;0;0
624;12.06.2018;2018;06;05;Tiistai;1;2;3
624;12.06.2018;2018;06;06;Tiistai;5;11;16
624;12.06.2018;2018;06;07;Tiistai;9;41;50
624;12.06.2018;2018;06;08;Tiistai;12;90;102
624;12.06.2018;2018;06;09;Tiistai;13;73;86
624;12.06.2018;2018;06;10;Tiistai;8;38;46
624;12.06.2018;2018;06;11;Tiistai;7;34;41
624;12.06.2018;2018;06;12;Tiistai;14;42;56
624;12.06.2018;2018;06;13;Tiistai;15;46;61
624;12.06.2018;2018;06;14;Tiistai;12;33;45
624;12.06.2018;2018;06;15;Tiistai;22;32;54
624;12.06.2018;2018;06;16;Tiistai;29;56;85
624;12.06.2018;2018;06;17;Tiistai;24;77;101
624;12.06.2018;2018;06;18;Tiistai;11;45;56
624;12.06.2018;2018;06;19;Tiistai;17;28;45
624;12.06.2018;2018;06;20;Tiistai;14;28;42
624;12.06.2018;2018;06;21;Tiistai;11;20;31
624;12.06.2018;2018;06;22;Tiistai;8;10;18
624;12.06.2018;2018;06;23;Tiistai;3;10;13
624;13.06.2018;2018;06;00;Keskiviikko;3;4;7
624;13.06.2018;2018;06;01;Keskiviikko;0;3;3
624;13.06.2018;2018;06;02;Keskiviikko;1;2;3
624;13.06.2018;2018;06;03;Keskiviikko;0;0;0
624;13.06.2018;2018;06;04;Keskiviikko;0;1;1
624;13.06.2018;2018;06;05;Keskiviikko;0;3;3
624;13.06.2018;2018;06;06;Keskiviikko;3;11;14
624;13.06.2018;2018;06;07;Keskiviikko;11;48;59
624;13.06.2018;2018;06;08;Keskiviikko;17;92;109
624;13.06.2018;2018;06;09;Keskiviikko;14;64;78
624;13.06.2018;2018;06;10;Keskiviikko;5;33;38
624;13.06.2018;2018;06;11;Keskiviikko;7;30;37
624;13.06.2018;2018;06;12;Keskiviikko;13;47;60
624;13.06.2018;2018;06;13;Keskiviikko;9;46;55
624;13.06.2018;2018;06;14;Keskiviikko;8;38;46
624;13.06.2018;2018;06;15;Keskiviikko;14;28;42
624;13.06.2018;2018;06;16;Keskiviikko;30;56;86
624;13.06.2018;2018;06;17;Keskiviikko;27;62;89
624;13.06.2018;2018;06;18;Keskiviikko;18;46;64
624;13.06.2018;2018;06;19;Keskiviikko;11;40;51
624;13.06.2018;2018;06;20;Keskiviikko;14;21;35
624;13.06.2018;2018;06;21;Keskiviikko;19;18;37
624;13.06.2018;2018;06;22;Keskiviikko;14;18;32
624;13.06.2018;2018;06;23;Keskiviikko;6;11;17
624;14.06.2018;2018;06;00;Torstai;2;5;7
624;14.06.2018;2018;06;01;Torstai;4;2;6
624;14.06.2018;2018;06;02;Torstai;0;2;2
624;14.06.2018;2018;06;03;Torstai;1;0;1
624;14.06.2018;2018;06;04;Torstai;0;0;0
624;14.06.2018;2018;06;05;Torstai;0;4;4
624;14.06.2018;2018;06;06;Torstai;0;9;9
624;14.06.2018;2018;06;07;Torstai;9;46;55
624;14.06.2018;2018;06;08;Torstai;12;79;91
624;14.06.2018;2018;06;09;Torstai;8;54;62
624;14.06.2018;2018;06;10;Torstai;6;36;42
624;14.06.2018;2018;06;11;Torstai;10;33;43
624;14.06.2018;2018;06;12;Torstai;14;34;48
624;14.06.2018;2018;06;13;Torstai;10;42;52
624;14.06.2018;2018;06;14;Torstai;20;42;62
624;14.06.2018;2018;06;15;Torstai;17;49;66
624;14.06.2018;2018;06;16;Torstai;31;61;92
624;14.06.2018;2018;06;17;Torstai;24;61;85
624;14.06.2018;2018;06;18;Torstai;14;38;52
624;14.06.2018;2018;06;19;Torstai;20;30;50
624;14.06.2018;2018;06;20;Torstai;11;23;34
624;14.06.2018;2018;06;21;Torstai;9;28;37
624;14.06.2018;2018;06;22;Torstai;7;16;23
624;14.06.2018;2018;06;23;Torstai;3;7;10
624;15.06.2018;2018;06;00;Perjantai;2;3;5
624;15.06.2018;2018;06;01;Perjantai;1;1;2
624;15.06.2018;2018;06;02;Perjantai;2;1;3
624;15.06.2018;2018;06;03;Perjantai;1;3;4
624;15.06.2018;2018;06;04;Perjantai;1;0;1
624;15.06.2018;2018;06;05;Perjantai;0;3;3
624;15.06.2018;2018;06;06;Perjantai;2;8;10
624;15.06.2018;2018;06;07;Perjantai;6;59;65
624;15.06.2018;2018;06;08;Perjantai;9;80;89
624;15.06.2018;2018;06;09;Perjantai;14;63;77
624;15.06.2018;2018;06;10;Perjantai;6;32;38
624;15.06.2018;2018;06;11;Perjantai;4;34;38
624;15.06.2018;2018;06;12;Perjantai;10;43;53
624;15.06.2018;2018;06;13;Perjantai;16;33;49
624;15.06.2018;2018;06;14;Perjantai;16;38;54
624;15.06.2018;2018;06;15;Perjantai;15;39;54
624;15.06.2018;2018;06;16;Perjantai;27;40;67
624;15.06.2018;2018;06;17;Perjantai;5;54;59
624;15.06.2018;2018;06;18;Perjantai;14;33;47
624;15.06.2018;2018;06;19;Perjantai;19;43;62
624;15.06.2018;2018;06;20;Perjantai;8;29;37
624;15.06.2018;2018;06;21;Perjantai;15;20;35
624;15.06.2018;2018;06;22;Perjantai;8;7;15
624;15.06.2018;2018;06;23;Perjantai;7;9;16
624;16.06.2018;2018;06;00;Lauantai;6;14;20
624;16.06.2018;2018;06;01;Lauantai;10;5;15
624;16.06.2018;2018;06;02;Lauantai;5;4;9
624;16.06.2018;2018;06;03;Lauantai;1;4;5
624;16.06.2018;2018;06;04;Lauantai;3;0;3
624;16.06.2018;2018;06;05;Lauantai;0;1;1
624;16.06.2018;2018;06;06;Lauantai;0;3;3
624;16.06.2018;2018;06;07;Lauantai;0;9;9
624;16.06.2018;2018;06;08;Lauantai;0;9;9
624;16.06.2018;2018;06;09;Lauantai;1;16;17
624;16.06.2018;2018;06;10;Lauantai;2;22;24
624;16.06.2018;2018;06;11;Lauantai;7;29;36
624;16.06.2018;2018;06;12;Lauantai;11;33;44
624;16.06.2018;2018;06;13;Lauantai;14;44;58
624;16.06.2018;2018;06;14;Lauantai;12;49;61
624;16.06.2018;2018;06;15;Lauantai;15;39;54
624;16.06.2018;2018;06;16;Lauantai;17;29;46
624;16.06.2018;2018;06;17;Lauantai;15;15;30
624;16.06.2018;2018;06;18;Lauantai;12;27;39
624;16.06.2018;2018;06;19;Lauantai;12;32;44
624;16.06.2018;2018;06;20;Lauantai;10;17;27
624;16.06.2018;2018;06;21;Lauantai;10;23;33
624;16.06.2018;2018;06;22;Lauantai;6;11;17
624;16.06.2018;2018;06;23;Lauantai;6;9;15
624;17.06.2018;2018;06;00;Sunnuntai;3;10;13
624;17.06.2018;2018;06;01;Sunnuntai;6;9;15
624;17.06.2018;2018;06;02;Sunnuntai;4;5;9
624;17.06.2018;2018;06;03;Sunnuntai;1;4;5
624;17.06.2018;2018;06;04;Sunnuntai;2;2;4
624;17.06.2018;2018;06;05;Sunnuntai;5;2;7
624;17.06.2018;2018;06;06;Sunnuntai;1;4;5
624;17.06.2018;2018;06;07;Sunnuntai;2;6;8
624;17.06.2018;2018;06;08;Sunnuntai;1;7;8
624;17.06.2018;2018;06;09;Sunnuntai;5;12;17
624;17.06.2018;2018;06;10;Sunnuntai;3;11;14
624;17.06.2018;2018;06;11;Sunnuntai;9;33;42
624;17.06.2018;2018;06;12;Sunnuntai;20;43;63
624;17.06.2018;2018;06;13;Sunnuntai;4;37;41
624;17.06.2018;2018;06;14;Sunnuntai;14;29;43
624;17.06.2018;2018;06;15;Sunnuntai;29;50;79
624;17.06.2018;2018;06;16;Sunnuntai;21;31;52
624;17.06.2018;2018;06;17;Sunnuntai;19;57;76
624;17.06.2018;2018;06;18;Sunnuntai;15;25;40
624;17.06.2018;2018;06;19;Sunnuntai;16;35;51
624;17.06.2018;2018;06;20;Sunnuntai;20;19;39
624;17.06.2018;2018;06;21;Sunnuntai;7;30;37
624;17.06.2018;2018;06;22;Sunnuntai;14;15;29
624;17.06.2018;2018;06;23;Sunnuntai;2;9;11
624;18.06.2018;2018;06;00;Maanantai;2;3;5
624;18.06.2018;2018;06;01;Maanantai;4;3;7
624;18.06.2018;2018;06;02;Maanantai;0;1;1
624;18.06.2018;2018;06;03;Maanantai;1;3;4
624;18.06.2018;2018;06;04;Maanantai;0;1;1
624;18.06.2018;2018;06;05;Maanantai;1;1;2
624;18.06.2018;2018;06;06;Maanantai;3;6;9
624;18.06.2018;2018;06;07;Maanantai;4;43;47
624;18.06.2018;2018;06;08;Maanantai;8;80;88
624;18.06.2018;2018;06;09;Maanantai;9;51;60
624;18.06.2018;2018;06;10;Maanantai;4;23;27
624;18.06.2018;2018;06;11;Maanantai;7;24;31
624;18.06.2018;2018;06;12;Maanantai;1;23;24
624;18.06.2018;2018;06;13;Maanantai;4;25;29
624;18.06.2018;2018;06;14;Maanantai;8;18;26
624;18.06.2018;2018;06;15;Maanantai;8;35;43
624;18.06.2018;2018;06;16;Maanantai;20;43;63
624;18.06.2018;2018;06;17;Maanantai;22;56;78
624;18.06.2018;2018;06;18;Maanantai;10;35;45
624;18.06.2018;2018;06;19;Maanantai;10;24;34
624;18.06.2018;2018;06;20;Maanantai;9;19;28
624;18.06.2018;2018;06;21;Maanantai;9;13;22
624;18.06.2018;2018;06;22;Maanantai;4;11;15
624;18.06.2018;2018;06;23;Maanantai;0;6;6
624;19.06.2018;2018;06;00;Tiistai;1;9;10
624;19.06.2018;2018;06;01;Tiistai;0;3;3
624;19.06.2018;2018;06;02;Tiistai;2;3;5
624;19.06.2018;2018;06;03;Tiistai;0;1;1
624;19.06.2018;2018;06;04;Tiistai;0;1;1
624;19.06.2018;2018;06;05;Tiistai;0;5;5
624;19.06.2018;2018;06;06;Tiistai;2;8;10
624;19.06.2018;2018;06;07;Tiistai;8;43;51
624;19.06.2018;2018;06;08;Tiistai;8;82;90
624;19.06.2018;2018;06;09;Tiistai;8;61;69
624;19.06.2018;2018;06;10;Tiistai;2;42;44
624;19.06.2018;2018;06;11;Tiistai;5;23;28
624;19.06.2018;2018;06;12;Tiistai;6;30;36
624;19.06.2018;2018;06;13;Tiistai;11;16;27
624;19.06.2018;2018;06;14;Tiistai;15;13;28
624;19.06.2018;2018;06;15;Tiistai;20;15;35
624;19.06.2018;2018;06;16;Tiistai;28;30;58
624;19.06.2018;2018;06;17;Tiistai;18;38;56
624;19.06.2018;2018;06;18;Tiistai;6;18;24
624;19.06.2018;2018;06;19;Tiistai;2;16;18
624;19.06.2018;2018;06;20;Tiistai;11;13;24
624;19.06.2018;2018;06;21;Tiistai;11;15;26
624;19.06.2018;2018;06;22;Tiistai;5;5;10
624;19.06.2018;2018;06;23;Tiistai;2;4;6
624;20.06.2018;2018;06;00;Keskiviikko;1;4;5
624;20.06.2018;2018;06;01;Keskiviikko;1;2;3
624;20.06.2018;2018;06;02;Keskiviikko;1;0;1
624;20.06.2018;2018;06;03;Keskiviikko;0;3;3
624;20.06.2018;2018;06;04;Keskiviikko;1;1;2
624;20.06.2018;2018;06;05;Keskiviikko;0;2;2
624;20.06.2018;2018;06;06;Keskiviikko;5;12;17
624;20.06.2018;2018;06;07;Keskiviikko;2;49;51
624;20.06.2018;2018;06;08;Keskiviikko;5;88;93
624;20.06.2018;2018;06;09;Keskiviikko;6;54;60
624;20.06.2018;2018;06;10;Keskiviikko;7;40;47
624;20.06.2018;2018;06;11;Keskiviikko;3;19;22
624;20.06.2018;2018;06;12;Keskiviikko;4;18;22
624;20.06.2018;2018;06;13;Keskiviikko;7;32;39
624;20.06.2018;2018;06;14;Keskiviikko;10;44;54
624;20.06.2018;2018;06;15;Keskiviikko;18;38;56
624;20.06.2018;2018;06;16;Keskiviikko;31;44;75
624;20.06.2018;2018;06;17;Keskiviikko;22;60;82
624;20.06.2018;2018;06;18;Keskiviikko;12;44;56
624;20.06.2018;2018;06;19;Keskiviikko;8;28;36
624;20.06.2018;2018;06;20;Keskiviikko;14;40;54
624;20.06.2018;2018;06;21;Keskiviikko;4;20;24
624;20.06.2018;2018;06;22;Keskiviikko;11;14;25
624;20.06.2018;2018;06;23;Keskiviikko;4;10;14
624;21.06.2018;2018;06;00;Torstai;1;4;5
624;21.06.2018;2018;06;01;Torstai;2;3;5
624;21.06.2018;2018;06;02;Torstai;4;1;5
624;21.06.2018;2018;06;03;Torstai;0;4;4
624;21.06.2018;2018;06;04;Torstai;2;2;4
624;21.06.2018;2018;06;05;Torstai;0;3;3
624;21.06.2018;2018;06;06;Torstai;3;11;14
624;21.06.2018;2018;06;07;Torstai;7;46;53
624;21.06.2018;2018;06;08;Torstai;9;88;97
624;21.06.2018;2018;06;09;Torstai;12;55;67
624;21.06.2018;2018;06;10;Torstai;12;45;57
624;21.06.2018;2018;06;11;Torstai;11;33;44
624;21.06.2018;2018;06;12;Torstai;4;40;44
624;21.06.2018;2018;06;13;Torstai;8;44;52
624;21.06.2018;2018;06;14;Torstai;16;39;55
624;21.06.2018;2018;06;15;Torstai;20;43;63
624;21.06.2018;2018;06;16;Torstai;25;47;72
624;21.06.2018;2018;06;17;Torstai;20;46;66
624;21.06.2018;2018;06;18;Torstai;12;34;46
624;21.06.2018;2018;06;19;Torstai;14;43;57
624;21.06.2018;2018;06;20;Torstai;10;21;31
624;21.06.2018;2018;06;21;Torstai;7;16;23
624;21.06.2018;2018;06;22;Torstai;6;8;14
624;21.06.2018;2018;06;23;Torstai;5;6;11
624;22.06.2018;2018;06;00;Perjantai;3;7;10
624;22.06.2018;2018;06;01;Perjantai;3;7;10
624;22.06.2018;2018;06;02;Perjantai;6;5;11
624;22.06.2018;2018;06;03;Perjantai;1;7;8
624;22.06.2018;2018;06;04;Perjantai;1;0;1
624;22.06.2018;2018;06;05;Perjantai;1;1;2
624;22.06.2018;2018;06;06;Perjantai;0;4;4
624;22.06.2018;2018;06;07;Perjantai;0;4;4
624;22.06.2018;2018;06;08;Perjantai;1;5;6
624;22.06.2018;2018;06;09;Perjantai;0;3;3
624;22.06.2018;2018;06;10;Perjantai;0;4;4
624;22.06.2018;2018;06;11;Perjantai;1;5;6
624;22.06.2018;2018;06;12;Perjantai;1;4;5
624;22.06.2018;2018;06;13;Perjantai;1;4;5
624;22.06.2018;2018;06;14;Perjantai;1;6;7
624;22.06.2018;2018;06;15;Perjantai;1;11;12
624;22.06.2018;2018;06;16;Perjantai;5;4;9
624;22.06.2018;2018;06;17;Perjantai;5;5;10
624;22.06.2018;2018;06;18;Perjantai;3;10;13
624;22.06.2018;2018;06;19;Perjantai;6;13;19
624;22.06.2018;2018;06;20;Perjantai;2;9;11
624;22.06.2018;2018;06;21;Perjantai;3;6;9
624;22.06.2018;2018;06;22;Perjantai;4;6;10
624;22.06.2018;2018;06;23;Perjantai;0;3;3
624;23.06.2018;2018;06;00;Lauantai;1;3;4
624;23.06.2018;2018;06;01;Lauantai;1;6;7
624;23.06.2018;2018;06;02;Lauantai;4;3;7
624;23.06.2018;2018;06;03;Lauantai;2;1;3
624;23.06.2018;2018;06;04;Lauantai;1;1;2
624;23.06.2018;2018;06;05;Lauantai;0;3;3
624;23.06.2018;2018;06;06;Lauantai;0;6;6
624;23.06.2018;2018;06;07;Lauantai;1;2;3
624;23.06.2018;2018;06;08;Lauantai;1;3;4
624;23.06.2018;2018;06;09;Lauantai;1;3;4
624;23.06.2018;2018;06;10;Lauantai;3;6;9
624;23.06.2018;2018;06;11;Lauantai;2;4;6
624;23.06.2018;2018;06;12;Lauantai;1;6;7
624;23.06.2018;2018;06;13;Lauantai;3;8;11
624;23.06.2018;2018;06;14;Lauantai;1;8;9
624;23.06.2018;2018;06;15;Lauantai;5;3;8
624;23.06.2018;2018;06;16;Lauantai;3;4;7
624;23.06.2018;2018;06;17;Lauantai;0;5;5
624;23.06.2018;2018;06;18;Lauantai;3;10;13
624;23.06.2018;2018;06;19;Lauantai;4;8;12
624;23.06.2018;2018;06;20;Lauantai;1;7;8
624;23.06.2018;2018;06;21;Lauantai;1;7;8
624;23.06.2018;2018;06;22;Lauantai;1;4;5
624;23.06.2018;2018;06;23;Lauantai;0;1;1
624;24.06.2018;2018;06;00;Sunnuntai;2;2;4
624;24.06.2018;2018;06;01;Sunnuntai;0;4;4
624;24.06.2018;2018;06;02;Sunnuntai;1;1;2
624;24.06.2018;2018;06;03;Sunnuntai;0;2;2
624;24.06.2018;2018;06;04;Sunnuntai;0;0;0
624;24.06.2018;2018;06;05;Sunnuntai;1;0;1
624;24.06.2018;2018;06;06;Sunnuntai;0;1;1
624;24.06.2018;2018;06;07;Sunnuntai;0;6;6
624;24.06.2018;2018;06;08;Sunnuntai;3;3;6
624;24.06.2018;2018;06;09;Sunnuntai;4;8;12
624;24.06.2018;2018;06;10;Sunnuntai;1;11;12
624;24.06.2018;2018;06;11;Sunnuntai;2;22;24
624;24.06.2018;2018;06;12;Sunnuntai;5;17;22
624;24.06.2018;2018;06;13;Sunnuntai;7;31;38
624;24.06.2018;2018;06;14;Sunnuntai;7;28;35
624;24.06.2018;2018;06;15;Sunnuntai;8;21;29
624;24.06.2018;2018;06;16;Sunnuntai;15;15;30
624;24.06.2018;2018;06;17;Sunnuntai;16;15;31
624;24.06.2018;2018;06;18;Sunnuntai;8;22;30
624;24.06.2018;2018;06;19;Sunnuntai;6;19;25
624;24.06.2018;2018;06;20;Sunnuntai;9;15;24
624;24.06.2018;2018;06;21;Sunnuntai;11;13;24
624;24.06.2018;2018;06;22;Sunnuntai;7;7;14
624;24.06.2018;2018;06;23;Sunnuntai;3;3;6
624;25.06.2018;2018;06;00;Maanantai;6;4;10
624;25.06.2018;2018;06;01;Maanantai;3;2;5
624;25.06.2018;2018;06;02;Maanantai;0;2;2
624;25.06.2018;2018;06;03;Maanantai;1;3;4
624;25.06.2018;2018;06;04;Maanantai;2;1;3
624;25.06.2018;2018;06;05;Maanantai;0;1;1
624;25.06.2018;2018;06;06;Maanantai;2;8;10
624;25.06.2018;2018;06;07;Maanantai;7;43;50
624;25.06.2018;2018;06;08;Maanantai;3;77;80
624;25.06.2018;2018;06;09;Maanantai;9;62;71
624;25.06.2018;2018;06;10;Maanantai;4;41;45
624;25.06.2018;2018;06;11;Maanantai;6;26;32
624;25.06.2018;2018;06;12;Maanantai;11;37;48
624;25.06.2018;2018;06;13;Maanantai;8;30;38
624;25.06.2018;2018;06;14;Maanantai;17;37;54
624;25.06.2018;2018;06;15;Maanantai;12;36;48
624;25.06.2018;2018;06;16;Maanantai;28;54;82
624;25.06.2018;2018;06;17;Maanantai;25;68;93
624;25.06.2018;2018;06;18;Maanantai;23;66;89
624;25.06.2018;2018;06;19;Maanantai;11;42;53
624;25.06.2018;2018;06;20;Maanantai;13;45;58
624;25.06.2018;2018;06;21;Maanantai;21;28;49
624;25.06.2018;2018;06;22;Maanantai;5;8;13
624;25.06.2018;2018;06;23;Maanantai;7;11;18
624;26.06.2018;2018;06;00;Tiistai;0;6;6
624;26.06.2018;2018;06;01;Tiistai;4;3;7
624;26.06.2018;2018;06;02;Tiistai;1;0;1
624;26.06.2018;2018;06;03;Tiistai;2;2;4
624;26.06.2018;2018;06;04;Tiistai;0;3;3
624;26.06.2018;2018;06;05;Tiistai;0;2;2
624;26.06.2018;2018;06;06;Tiistai;1;10;11
624;26.06.2018;2018;06;07;Tiistai;10;53;63
624;26.06.2018;2018;06;08;Tiistai;8;77;85
624;26.06.2018;2018;06;09;Tiistai;15;67;82
624;26.06.2018;2018;06;10;Tiistai;12;32;44
624;26.06.2018;2018;06;11;Tiistai;8;42;50
624;26.06.2018;2018;06;12;Tiistai;8;42;50
624;26.06.2018;2018;06;13;Tiistai;9;44;53
624;26.06.2018;2018;06;14;Tiistai;9;40;49
624;26.06.2018;2018;06;15;Tiistai;15;39;54
624;26.06.2018;2018;06;16;Tiistai;22;62;84
624;26.06.2018;2018;06;17;Tiistai;25;57;82
624;26.06.2018;2018;06;18;Tiistai;13;43;56
624;26.06.2018;2018;06;19;Tiistai;11;33;44
624;26.06.2018;2018;06;20;Tiistai;16;20;36
624;26.06.2018;2018;06;21;Tiistai;13;19;32
624;26.06.2018;2018;06;22;Tiistai;10;10;20
624;26.06.2018;2018;06;23;Tiistai;4;10;14
624;27.06.2018;2018;06;00;Keskiviikko;2;8;10
624;27.06.2018;2018;06;01;Keskiviikko;3;4;7
624;27.06.2018;2018;06;02;Keskiviikko;0;4;4
624;27.06.2018;2018;06;03;Keskiviikko;0;3;3
624;27.06.2018;2018;06;04;Keskiviikko;0;4;4
624;27.06.2018;2018;06;05;Keskiviikko;0;1;1
624;27.06.2018;2018;06;06;Keskiviikko;2;13;15
624;27.06.2018;2018;06;07;Keskiviikko;3;47;50
624;27.06.2018;2018;06;08;Keskiviikko;5;81;86
624;27.06.2018;2018;06;09;Keskiviikko;16;50;66
624;27.06.2018;2018;06;10;Keskiviikko;7;40;47
624;27.06.2018;2018;06;11;Keskiviikko;7;30;37
624;27.06.2018;2018;06;12;Keskiviikko;7;35;42
624;27.06.2018;2018;06;13;Keskiviikko;10;28;38
624;27.06.2018;2018;06;14;Keskiviikko;2;42;44
624;27.06.2018;2018;06;15;Keskiviikko;10;35;45
624;27.06.2018;2018;06;16;Keskiviikko;16;58;74
624;27.06.2018;2018;06;17;Keskiviikko;21;56;77
624;27.06.2018;2018;06;18;Keskiviikko;19;45;64
624;27.06.2018;2018;06;19;Keskiviikko;13;35;48
624;27.06.2018;2018;06;20;Keskiviikko;12;24;36
624;27.06.2018;2018;06;21;Keskiviikko;18;27;45
624;27.06.2018;2018;06;22;Keskiviikko;8;16;24
624;27.06.2018;2018;06;23;Keskiviikko;2;4;6
624;28.06.2018;2018;06;00;Torstai;2;8;10
624;28.06.2018;2018;06;01;Torstai;4;6;10
624;28.06.2018;2018;06;02;Torstai;0;1;1
624;28.06.2018;2018;06;03;Torstai;0;1;1
624;28.06.2018;2018;06;04;Torstai;0;2;2
624;28.06.2018;2018;06;05;Torstai;0;2;2
624;28.06.2018;2018;06;06;Torstai;2;7;9
624;28.06.2018;2018;06;07;Torstai;4;42;46
624;28.06.2018;2018;06;08;Torstai;0;55;55
624;28.06.2018;2018;06;09;Torstai;6;37;43
624;28.06.2018;2018;06;10;Torstai;4;15;19
624;28.06.2018;2018;06;11;Torstai;5;12;17
624;28.06.2018;2018;06;12;Torstai;5;23;28
624;28.06.2018;2018;06;13;Torstai;6;12;18
624;28.06.2018;2018;06;14;Torstai;4;11;15
624;28.06.2018;2018;06;15;Torstai;9;11;20
624;28.06.2018;2018;06;16;Torstai;20;20;40
624;28.06.2018;2018;06;17;Torstai;12;26;38
624;28.06.2018;2018;06;18;Torstai;13;14;27
624;28.06.2018;2018;06;19;Torstai;11;17;28
624;28.06.2018;2018;06;20;Torstai;8;10;18
624;28.06.2018;2018;06;21;Torstai;5;4;9
624;28.06.2018;2018;06;22;Torstai;9;4;13
624;28.06.2018;2018;06;23;Torstai;0;3;3
624;29.06.2018;2018;06;00;Perjantai;2;3;5
624;29.06.2018;2018;06;01;Perjantai;1;2;3
624;29.06.2018;2018;06;02;Perjantai;2;1;3
624;29.06.2018;2018;06;03;Perjantai;0;2;2
624;29.06.2018;2018;06;04;Perjantai;0;0;0
624;29.06.2018;2018;06;05;Perjantai;0;1;1
624;29.06.2018;2018;06;06;Perjantai;1;12;13
624;29.06.2018;2018;06;07;Perjantai;6;41;47
624;29.06.2018;2018;06;08;Perjantai;3;49;52
624;29.06.2018;2018;06;09;Perjantai;5;46;51
624;29.06.2018;2018;06;10;Perjantai;6;29;35
624;29.06.2018;2018;06;11;Perjantai;7;24;31
624;29.06.2018;2018;06;12;Perjantai;11;31;42
624;29.06.2018;2018;06;13;Perjantai;8;13;21
624;29.06.2018;2018;06;14;Perjantai;6;34;40
624;29.06.2018;2018;06;15;Perjantai;10;36;46
624;29.06.2018;2018;06;16;Perjantai;14;41;55
624;29.06.2018;2018;06;17;Perjantai;12;37;49
624;29.06.2018;2018;06;18;Perjantai;13;18;31
624;29.06.2018;2018;06;19;Perjantai;12;28;40
624;29.06.2018;2018;06;20;Perjantai;6;14;20
624;29.06.2018;2018;06;21;Perjantai;8;22;30
624;29.06.2018;2018;06;22;Perjantai;6;11;17
624;29.06.2018;2018;06;23;Perjantai;3;11;14
624;30.06.2018;2018;06;00;Lauantai;4;3;7
624;30.06.2018;2018;06;01;Lauantai;6;4;10
624;30.06.2018;2018;06;02;Lauantai;1;3;4
624;30.06.2018;2018;06;03;Lauantai;6;4;10
624;30.06.2018;2018;06;04;Lauantai;3;4;7
624;30.06.2018;2018;06;05;Lauantai;1;0;1
624;30.06.2018;2018;06;06;Lauantai;1;6;7
624;30.06.2018;2018;06;07;Lauantai;2;7;9
624;30.06.2018;2018;06;08;Lauantai;2;6;8
624;30.06.2018;2018;06;09;Lauantai;2;10;12
624;30.06.2018;2018;06;10;Lauantai;0;13;13
624;30.06.2018;2018;06;11;Lauantai;3;21;24
624;30.06.2018;2018;06;12;Lauantai;3;15;18
624;30.06.2018;2018;06;13;Lauantai;6;30;36
624;30.06.2018;2018;06;14;Lauantai;11;39;50
624;30.06.2018;2018;06;15;Lauantai;9;26;35
624;30.06.2018;2018;06;16;Lauantai;6;16;22
624;30.06.2018;2018;06;17;Lauantai;10;17;27
624;30.06.2018;2018;06;18;Lauantai;9;17;26
624;30.06.2018;2018;06;19;Lauantai;10;13;23
624;30.06.2018;2018;06;20;Lauantai;5;13;18
624;30.06.2018;2018;06;21;Lauantai;6;24;30
624;30.06.2018;2018;06;22;Lauantai;2;9;11
624;30.06.2018;2018;06;23;Lauantai;6;0;6
624;01.07.2018;2018;07;00;Sunnuntai;3;7;10
624;01.07.2018;2018;07;01;Sunnuntai;1;5;6
624;01.07.2018;2018;07;02;Sunnuntai;3;5;8
624;01.07.2018;2018;07;03;Sunnuntai;2;3;5
624;01.07.2018;2018;07;04;Sunnuntai;2;2;4
624;01.07.2018;2018;07;05;Sunnuntai;1;0;1
624;01.07.2018;2018;07;06;Sunnuntai;1;1;2
624;01.07.2018;2018;07;07;Sunnuntai;2;10;12
624;01.07.2018;2018;07;08;Sunnuntai;1;1;2
624;01.07.2018;2018;07;09;Sunnuntai;1;9;10
624;01.07.2018;2018;07;10;Sunnuntai;2;11;13
624;01.07.2018;2018;07;11;Sunnuntai;2;19;21
624;01.07.2018;2018;07;12;Sunnuntai;12;26;38
624;01.07.2018;2018;07;13;Sunnuntai;13;28;41
624;01.07.2018;2018;07;14;Sunnuntai;12;28;40
624;01.07.2018;2018;07;15;Sunnuntai;16;33;49
624;01.07.2018;2018;07;16;Sunnuntai;13;28;41
624;01.07.2018;2018;07;17;Sunnuntai;15;29;44
624;01.07.2018;2018;07;18;Sunnuntai;20;31;51
624;01.07.2018;2018;07;19;Sunnuntai;12;14;26
624;01.07.2018;2018;07;20;Sunnuntai;8;19;27
624;01.07.2018;2018;07;21;Sunnuntai;4;23;27
624;01.07.2018;2018;07;22;Sunnuntai;9;14;23
624;01.07.2018;2018;07;23;Sunnuntai;2;6;8
624;02.07.2018;2018;07;00;Maanantai;3;4;7
624;02.07.2018;2018;07;01;Maanantai;1;7;8
624;02.07.2018;2018;07;02;Maanantai;3;2;5
624;02.07.2018;2018;07;03;Maanantai;0;0;0
624;02.07.2018;2018;07;04;Maanantai;0;1;1
624;02.07.2018;2018;07;05;Maanantai;1;2;3
624;02.07.2018;2018;07;06;Maanantai;3;12;15
624;02.07.2018;2018;07;07;Maanantai;6;59;65
624;02.07.2018;2018;07;08;Maanantai;11;63;74
624;02.07.2018;2018;07;09;Maanantai;10;54;64
624;02.07.2018;2018;07;10;Maanantai;9;29;38
624;02.07.2018;2018;07;11;Maanantai;7;34;41
624;02.07.2018;2018;07;12;Maanantai;9;37;46
624;02.07.2018;2018;07;13;Maanantai;23;57;80
624;02.07.2018;2018;07;14;Maanantai;23;31;54
624;02.07.2018;2018;07;15;Maanantai;15;47;62
624;02.07.2018;2018;07;16;Maanantai;31;70;101
624;02.07.2018;2018;07;17;Maanantai;34;64;98
624;02.07.2018;2018;07;18;Maanantai;28;41;69
624;02.07.2018;2018;07;19;Maanantai;14;47;61
624;02.07.2018;2018;07;20;Maanantai;17;39;56
624;02.07.2018;2018;07;21;Maanantai;8;28;36
624;02.07.2018;2018;07;22;Maanantai;7;19;26
624;02.07.2018;2018;07;23;Maanantai;1;12;13
624;03.07.2018;2018;07;00;Tiistai;2;2;4
624;03.07.2018;2018;07;01;Tiistai;4;5;9
624;03.07.2018;2018;07;02;Tiistai;0;2;2
624;03.07.2018;2018;07;03;Tiistai;1;4;5
624;03.07.2018;2018;07;04;Tiistai;0;5;5
624;03.07.2018;2018;07;05;Tiistai;1;0;1
624;03.07.2018;2018;07;06;Tiistai;2;9;11
624;03.07.2018;2018;07;07;Tiistai;6;50;56
624;03.07.2018;2018;07;08;Tiistai;5;63;68
624;03.07.2018;2018;07;09;Tiistai;5;61;66
624;03.07.2018;2018;07;10;Tiistai;9;36;45
624;03.07.2018;2018;07;11;Tiistai;9;33;42
624;03.07.2018;2018;07;12;Tiistai;4;26;30
624;03.07.2018;2018;07;13;Tiistai;12;55;67
624;03.07.2018;2018;07;14;Tiistai;10;37;47
624;03.07.2018;2018;07;15;Tiistai;18;38;56
624;03.07.2018;2018;07;16;Tiistai;18;50;68
624;03.07.2018;2018;07;17;Tiistai;22;58;80
624;03.07.2018;2018;07;18;Tiistai;15;38;53
624;03.07.2018;2018;07;19;Tiistai;10;25;35
624;03.07.2018;2018;07;20;Tiistai;9;19;28
624;03.07.2018;2018;07;21;Tiistai;8;15;23
624;03.07.2018;2018;07;22;Tiistai;3;14;17
624;03.07.2018;2018;07;23;Tiistai;3;13;16
624;04.07.2018;2018;07;00;Keskiviikko;2;5;7
624;04.07.2018;2018;07;01;Keskiviikko;2;1;3
624;04.07.2018;2018;07;02;Keskiviikko;0;0;0
624;04.07.2018;2018;07;03;Keskiviikko;0;0;0
624;04.07.2018;2018;07;04;Keskiviikko;0;0;0
624;04.07.2018;2018;07;05;Keskiviikko;0;0;0
624;04.07.2018;2018;07;06;Keskiviikko;0;0;0
624;04.07.2018;2018;07;07;Keskiviikko;0;0;0
624;04.07.2018;2018;07;08;Keskiviikko;0;0;0
624;04.07.2018;2018;07;09;Keskiviikko;25;102;127
624;04.07.2018;2018;07;10;Keskiviikko;4;18;22
624;04.07.2018;2018;07;11;Keskiviikko;5;16;21
624;04.07.2018;2018;07;12;Keskiviikko;7;14;21
624;04.07.2018;2018;07;13;Keskiviikko;4;14;18
624;04.07.2018;2018;07;14;Keskiviikko;12;14;26
624;04.07.2018;2018;07;15;Keskiviikko;13;26;39
624;04.07.2018;2018;07;16;Keskiviikko;12;32;44
624;04.07.2018;2018;07;17;Keskiviikko;17;29;46
624;04.07.2018;2018;07;18;Keskiviikko;8;27;35
624;04.07.2018;2018;07;19;Keskiviikko;14;27;41
624;04.07.2018;2018;07;20;Keskiviikko;14;27;41
624;04.07.2018;2018;07;21;Keskiviikko;7;27;34
624;04.07.2018;2018;07;22;Keskiviikko;8;9;17
624;04.07.2018;2018;07;23;Keskiviikko;6;14;20
624;05.07.2018;2018;07;00;Torstai;3;3;6
624;05.07.2018;2018;07;01;Torstai;2;2;4
624;05.07.2018;2018;07;02;Torstai;0;2;2
624;05.07.2018;2018;07;03;Torstai;2;5;7
624;05.07.2018;2018;07;04;Torstai;0;2;2
624;05.07.2018;2018;07;05;Torstai;0;1;1
624;05.07.2018;2018;07;06;Torstai;0;12;12
624;05.07.2018;2018;07;07;Torstai;5;49;54
624;05.07.2018;2018;07;08;Torstai;4;63;67
624;05.07.2018;2018;07;09;Torstai;5;38;43
624;05.07.2018;2018;07;10;Torstai;7;27;34
624;05.07.2018;2018;07;11;Torstai;7;36;43
624;05.07.2018;2018;07;12;Torstai;13;38;51
624;05.07.2018;2018;07;13;Torstai;18;33;51
624;05.07.2018;2018;07;14;Torstai;20;44;64
624;05.07.2018;2018;07;15;Torstai;20;52;72
624;05.07.2018;2018;07;16;Torstai;12;50;62
624;05.07.2018;2018;07;17;Torstai;18;42;60
624;05.07.2018;2018;07;18;Torstai;10;31;41
624;05.07.2018;2018;07;19;Torstai;8;28;36
624;05.07.2018;2018;07;20;Torstai;13;19;32
624;05.07.2018;2018;07;21;Torstai;3;15;18
624;05.07.2018;2018;07;22;Torstai;6;9;15
624;05.07.2018;2018;07;23;Torstai;5;11;16
624;06.07.2018;2018;07;00;Perjantai;2;2;4
624;06.07.2018;2018;07;01;Perjantai;2;3;5
624;06.07.2018;2018;07;02;Perjantai;3;1;4
624;06.07.2018;2018;07;03;Perjantai;0;0;0
624;06.07.2018;2018;07;04;Perjantai;1;3;4
624;06.07.2018;2018;07;05;Perjantai;0;1;1
624;06.07.2018;2018;07;06;Perjantai;0;10;10
624;06.07.2018;2018;07;07;Perjantai;11;41;52
624;06.07.2018;2018;07;08;Perjantai;7;53;60
624;06.07.2018;2018;07;09;Perjantai;4;47;51
624;06.07.2018;2018;07;10;Perjantai;5;28;33
624;06.07.2018;2018;07;11;Perjantai;8;26;34
624;06.07.2018;2018;07;12;Perjantai;7;30;37
624;06.07.2018;2018;07;13;Perjantai;12;43;55
624;06.07.2018;2018;07;14;Perjantai;8;45;53
624;06.07.2018;2018;07;15;Perjantai;25;50;75
624;06.07.2018;2018;07;16;Perjantai;19;54;73
624;06.07.2018;2018;07;17;Perjantai;21;39;60
624;06.07.2018;2018;07;18;Perjantai;11;34;45
624;06.07.2018;2018;07;19;Perjantai;13;32;45
624;06.07.2018;2018;07;20;Perjantai;17;31;48
624;06.07.2018;2018;07;21;Perjantai;10;29;39
624;06.07.2018;2018;07;22;Perjantai;9;12;21
624;06.07.2018;2018;07;23;Perjantai;4;5;9
624;07.07.2018;2018;07;00;Lauantai;4;6;10
624;07.07.2018;2018;07;01;Lauantai;3;14;17
624;07.07.2018;2018;07;02;Lauantai;6;12;18
624;07.07.2018;2018;07;03;Lauantai;3;4;7
624;07.07.2018;2018;07;04;Lauantai;2;3;5
624;07.07.2018;2018;07;05;Lauantai;4;2;6
624;07.07.2018;2018;07;06;Lauantai;0;3;3
624;07.07.2018;2018;07;07;Lauantai;0;6;6
624;07.07.2018;2018;07;08;Lauantai;3;7;10
624;07.07.2018;2018;07;09;Lauantai;2;17;19
624;07.07.2018;2018;07;10;Lauantai;5;28;33
624;07.07.2018;2018;07;11;Lauantai;6;21;27
624;07.07.2018;2018;07;12;Lauantai;4;25;29
624;07.07.2018;2018;07;13;Lauantai;13;46;59
624;07.07.2018;2018;07;14;Lauantai;20;52;72
624;07.07.2018;2018;07;15;Lauantai;17;56;73
624;07.07.2018;2018;07;16;Lauantai;26;29;55
624;07.07.2018;2018;07;17;Lauantai;18;45;63
624;07.07.2018;2018;07;18;Lauantai;12;18;30
624;07.07.2018;2018;07;19;Lauantai;16;19;35
624;07.07.2018;2018;07;20;Lauantai;11;20;31
624;07.07.2018;2018;07;21;Lauantai;10;14;24
624;07.07.2018;2018;07;22;Lauantai;7;7;14
624;07.07.2018;2018;07;23;Lauantai;8;7;15
624;08.07.2018;2018;07;00;Sunnuntai;2;7;9
624;08.07.2018;2018;07;01;Sunnuntai;6;7;13
624;08.07.2018;2018;07;02;Sunnuntai;1;2;3
624;08.07.2018;2018;07;03;Sunnuntai;4;4;8
624;08.07.2018;2018;07;04;Sunnuntai;2;2;4
624;08.07.2018;2018;07;05;Sunnuntai;3;3;6
624;08.07.2018;2018;07;06;Sunnuntai;1;3;4
624;08.07.2018;2018;07;07;Sunnuntai;1;6;7
624;08.07.2018;2018;07;08;Sunnuntai;0;1;1
624;08.07.2018;2018;07;09;Sunnuntai;0;7;7
624;08.07.2018;2018;07;10;Sunnuntai;2;10;12
624;08.07.2018;2018;07;11;Sunnuntai;2;22;24
624;08.07.2018;2018;07;12;Sunnuntai;8;25;33
624;08.07.2018;2018;07;13;Sunnuntai;13;32;45
624;08.07.2018;2018;07;14;Sunnuntai;17;42;59
624;08.07.2018;2018;07;15;Sunnuntai;18;27;45
624;08.07.2018;2018;07;16;Sunnuntai;13;39;52
624;08.07.2018;2018;07;17;Sunnuntai;16;33;49
624;08.07.2018;2018;07;18;Sunnuntai;19;22;41
624;08.07.2018;2018;07;19;Sunnuntai;15;30;45
624;08.07.2018;2018;07;20;Sunnuntai;12;32;44
624;08.07.2018;2018;07;21;Sunnuntai;11;24;35
624;08.07.2018;2018;07;22;Sunnuntai;6;13;19
624;08.07.2018;2018;07;23;Sunnuntai;1;4;5
624;09.07.2018;2018;07;00;Maanantai;1;2;3
624;09.07.2018;2018;07;01;Maanantai;2;9;11
624;09.07.2018;2018;07;02;Maanantai;1;1;2
624;09.07.2018;2018;07;03;Maanantai;0;3;3
624;09.07.2018;2018;07;04;Maanantai;4;2;6
624;09.07.2018;2018;07;05;Maanantai;2;1;3
624;09.07.2018;2018;07;06;Maanantai;2;15;17
624;09.07.2018;2018;07;07;Maanantai;5;51;56
624;09.07.2018;2018;07;08;Maanantai;7;61;68
624;09.07.2018;2018;07;09;Maanantai;11;26;37
624;09.07.2018;2018;07;10;Maanantai;4;38;42
624;09.07.2018;2018;07;11;Maanantai;13;37;50
624;09.07.2018;2018;07;12;Maanantai;19;42;61
624;09.07.2018;2018;07;13;Maanantai;7;42;49
624;09.07.2018;2018;07;14;Maanantai;16;48;64
624;09.07.2018;2018;07;15;Maanantai;20;36;56
624;09.07.2018;2018;07;16;Maanantai;28;44;72
624;09.07.2018;2018;07;17;Maanantai;34;70;104
624;09.07.2018;2018;07;18;Maanantai;13;62;75
624;09.07.2018;2018;07;19;Maanantai;20;48;68
624;09.07.2018;2018;07;20;Maanantai;19;35;54
624;09.07.2018;2018;07;21;Maanantai;10;34;44
624;09.07.2018;2018;07;22;Maanantai;8;18;26
624;09.07.2018;2018;07;23;Maanantai;1;8;9
624;10.07.2018;2018;07;00;Tiistai;2;5;7
624;10.07.2018;2018;07;01;Tiistai;1;5;6
624;10.07.2018;2018;07;02;Tiistai;0;1;1
624;10.07.2018;2018;07;03;Tiistai;1;1;2
624;10.07.2018;2018;07;04;Tiistai;1;1;2
624;10.07.2018;2018;07;05;Tiistai;0;3;3
624;10.07.2018;2018;07;06;Tiistai;2;9;11
624;10.07.2018;2018;07;07;Tiistai;2;53;55
624;10.07.2018;2018;07;08;Tiistai;10;59;69
624;10.07.2018;2018;07;09;Tiistai;3;35;38
624;10.07.2018;2018;07;10;Tiistai;5;30;35
624;10.07.2018;2018;07;11;Tiistai;11;37;48
624;10.07.2018;2018;07;12;Tiistai;18;36;54
624;10.07.2018;2018;07;13;Tiistai;14;52;66
624;10.07.2018;2018;07;14;Tiistai;17;48;65
624;10.07.2018;2018;07;15;Tiistai;23;51;74
624;10.07.2018;2018;07;16;Tiistai;31;79;110
624;10.07.2018;2018;07;17;Tiistai;33;64;97
624;10.07.2018;2018;07;18;Tiistai;20;35;55
624;10.07.2018;2018;07;19;Tiistai;11;42;53
624;10.07.2018;2018;07;20;Tiistai;18;44;62
624;10.07.2018;2018;07;21;Tiistai;15;46;61
624;10.07.2018;2018;07;22;Tiistai;8;24;32
624;10.07.2018;2018;07;23;Tiistai;3;10;13
624;11.07.2018;2018;07;00;Keskiviikko;5;4;9
624;11.07.2018;2018;07;01;Keskiviikko;1;2;3
624;11.07.2018;2018;07;02;Keskiviikko;3;3;6
624;11.07.2018;2018;07;03;Keskiviikko;2;3;5
624;11.07.2018;2018;07;04;Keskiviikko;1;3;4
624;11.07.2018;2018;07;05;Keskiviikko;0;2;2
624;11.07.2018;2018;07;06;Keskiviikko;0;10;10
624;11.07.2018;2018;07;07;Keskiviikko;4;55;59
624;11.07.2018;2018;07;08;Keskiviikko;6;59;65
624;11.07.2018;2018;07;09;Keskiviikko;4;31;35
624;11.07.2018;2018;07;10;Keskiviikko;3;34;37
624;11.07.2018;2018;07;11;Keskiviikko;10;27;37
624;11.07.2018;2018;07;12;Keskiviikko;20;45;65
624;11.07.2018;2018;07;13;Keskiviikko;15;50;65
624;11.07.2018;2018;07;14;Keskiviikko;19;42;61
624;11.07.2018;2018;07;15;Keskiviikko;18;35;53
624;11.07.2018;2018;07;16;Keskiviikko;32;72;104
624;11.07.2018;2018;07;17;Keskiviikko;25;73;98
624;11.07.2018;2018;07;18;Keskiviikko;22;58;80
624;11.07.2018;2018;07;19;Keskiviikko;18;36;54
624;11.07.2018;2018;07;20;Keskiviikko;10;41;51
624;11.07.2018;2018;07;21;Keskiviikko;17;41;58
624;11.07.2018;2018;07;22;Keskiviikko;7;21;28
624;11.07.2018;2018;07;23;Keskiviikko;2;13;15
624;12.07.2018;2018;07;00;Torstai;4;7;11
624;12.07.2018;2018;07;01;Torstai;1;4;5
624;12.07.2018;2018;07;02;Torstai;2;4;6
624;12.07.2018;2018;07;03;Torstai;3;4;7
624;12.07.2018;2018;07;04;Torstai;2;1;3
624;12.07.2018;2018;07;05;Torstai;0;3;3
624;12.07.2018;2018;07;06;Torstai;1;9;10
624;12.07.2018;2018;07;07;Torstai;2;52;54
624;12.07.2018;2018;07;08;Torstai;3;58;61
624;12.07.2018;2018;07;09;Torstai;8;38;46
624;12.07.2018;2018;07;10;Torstai;2;37;39
624;12.07.2018;2018;07;11;Torstai;9;27;36
624;12.07.2018;2018;07;12;Torstai;7;35;42
624;12.07.2018;2018;07;13;Torstai;12;46;58
624;12.07.2018;2018;07;14;Torstai;14;35;49
624;12.07.2018;2018;07;15;Torstai;15;49;64
624;12.07.2018;2018;07;16;Torstai;21;79;100
624;12.07.2018;2018;07;17;Torstai;36;67;103
624;12.07.2018;2018;07;18;Torstai;15;53;68
624;12.07.2018;2018;07;19;Torstai;12;45;57
624;12.07.2018;2018;07;20;Torstai;16;31;47
624;12.07.2018;2018;07;21;Torstai;14;34;48
624;12.07.2018;2018;07;22;Torstai;9;20;29
624;12.07.2018;2018;07;23;Torstai;5;15;20
624;13.07.2018;2018;07;00;Perjantai;3;8;11
624;13.07.2018;2018;07;01;Perjantai;2;6;8
624;13.07.2018;2018;07;02;Perjantai;0;3;3
624;13.07.2018;2018;07;03;Perjantai;2;3;5
624;13.07.2018;2018;07;04;Perjantai;1;3;4
624;13.07.2018;2018;07;05;Perjantai;1;5;6
624;13.07.2018;2018;07;06;Perjantai;0;7;7
624;13.07.2018;2018;07;07;Perjantai;3;53;56
624;13.07.2018;2018;07;08;Perjantai;5;40;45
624;13.07.2018;2018;07;09;Perjantai;7;32;39
624;13.07.2018;2018;07;10;Perjantai;3;27;30
624;13.07.2018;2018;07;11;Perjantai;6;32;38
624;13.07.2018;2018;07;12;Perjantai;12;30;42
624;13.07.2018;2018;07;13;Perjantai;14;38;52
624;13.07.2018;2018;07;14;Perjantai;15;44;59
624;13.07.2018;2018;07;15;Perjantai;24;57;81
624;13.07.2018;2018;07;16;Perjantai;15;59;74
624;13.07.2018;2018;07;17;Perjantai;27;56;83
624;13.07.2018;2018;07;18;Perjantai;12;41;53
624;13.07.2018;2018;07;19;Perjantai;13;49;62
624;13.07.2018;2018;07;20;Perjantai;12;27;39
624;13.07.2018;2018;07;21;Perjantai;12;23;35
624;13.07.2018;2018;07;22;Perjantai;3;18;21
624;13.07.2018;2018;07;23;Perjantai;4;7;11
624;14.07.2018;2018;07;00;Lauantai;7;9;16
624;14.07.2018;2018;07;01;Lauantai;4;6;10
624;14.07.2018;2018;07;02;Lauantai;2;8;10
624;14.07.2018;2018;07;03;Lauantai;6;8;14
624;14.07.2018;2018;07;04;Lauantai;0;2;2
624;14.07.2018;2018;07;05;Lauantai;2;0;2
624;14.07.2018;2018;07;06;Lauantai;1;3;4
624;14.07.2018;2018;07;07;Lauantai;0;3;3
624;14.07.2018;2018;07;08;Lauantai;0;8;8
624;14.07.2018;2018;07;09;Lauantai;0;7;7
624;14.07.2018;2018;07;10;Lauantai;0;7;7
624;14.07.2018;2018;07;11;Lauantai;2;16;18
624;14.07.2018;2018;07;12;Lauantai;9;19;28
624;14.07.2018;2018;07;13;Lauantai;5;18;23
624;14.07.2018;2018;07;14;Lauantai;15;25;40
624;14.07.2018;2018;07;15;Lauantai;9;30;39
624;14.07.2018;2018;07;16;Lauantai;15;27;42
624;14.07.2018;2018;07;17;Lauantai;12;27;39
624;14.07.2018;2018;07;18;Lauantai;13;32;45
624;14.07.2018;2018;07;19;Lauantai;12;26;38
624;14.07.2018;2018;07;20;Lauantai;10;21;31
624;14.07.2018;2018;07;21;Lauantai;6;29;35
624;14.07.2018;2018;07;22;Lauantai;10;18;28
624;14.07.2018;2018;07;23;Lauantai;7;10;17
624;15.07.2018;2018;07;00;Sunnuntai;4;11;15
624;15.07.2018;2018;07;01;Sunnuntai;3;8;11
624;15.07.2018;2018;07;02;Sunnuntai;5;6;11
624;15.07.2018;2018;07;03;Sunnuntai;7;4;11
624;15.07.2018;2018;07;04;Sunnuntai;5;4;9
624;15.07.2018;2018;07;05;Sunnuntai;6;2;8
624;15.07.2018;2018;07;06;Sunnuntai;3;3;6
624;15.07.2018;2018;07;07;Sunnuntai;1;6;7
624;15.07.2018;2018;07;08;Sunnuntai;1;3;4
624;15.07.2018;2018;07;09;Sunnuntai;5;14;19
624;15.07.2018;2018;07;10;Sunnuntai;3;9;12
624;15.07.2018;2018;07;11;Sunnuntai;5;15;20
624;15.07.2018;2018;07;12;Sunnuntai;9;31;40
624;15.07.2018;2018;07;13;Sunnuntai;8;26;34
624;15.07.2018;2018;07;14;Sunnuntai;21;32;53
624;15.07.2018;2018;07;15;Sunnuntai;23;47;70
624;15.07.2018;2018;07;16;Sunnuntai;24;36;60
624;15.07.2018;2018;07;17;Sunnuntai;11;36;47
624;15.07.2018;2018;07;18;Sunnuntai;9;52;61
624;15.07.2018;2018;07;19;Sunnuntai;14;31;45
624;15.07.2018;2018;07;20;Sunnuntai;6;23;29
624;15.07.2018;2018;07;21;Sunnuntai;9;17;26
624;15.07.2018;2018;07;22;Sunnuntai;14;19;33
624;15.07.2018;2018;07;23;Sunnuntai;3;9;12
624;16.07.2018;2018;07;00;Maanantai;0;3;3
624;16.07.2018;2018;07;01;Maanantai;3;4;7
624;16.07.2018;2018;07;02;Maanantai;0;2;2
624;16.07.2018;2018;07;03;Maanantai;2;4;6
624;16.07.2018;2018;07;04;Maanantai;1;2;3
624;16.07.2018;2018;07;05;Maanantai;1;2;3
624;16.07.2018;2018;07;06;Maanantai;0;8;8
624;16.07.2018;2018;07;07;Maanantai;4;45;49
624;16.07.2018;2018;07;08;Maanantai;2;49;51
624;16.07.2018;2018;07;09;Maanantai;8;32;40
624;16.07.2018;2018;07;10;Maanantai;5;39;44
624;16.07.2018;2018;07;11;Maanantai;9;31;40
624;16.07.2018;2018;07;12;Maanantai;10;39;49
624;16.07.2018;2018;07;13;Maanantai;13;38;51
624;16.07.2018;2018;07;14;Maanantai;13;36;49
624;16.07.2018;2018;07;15;Maanantai;21;52;73
624;16.07.2018;2018;07;16;Maanantai;21;62;83
624;16.07.2018;2018;07;17;Maanantai;34;60;94
624;16.07.2018;2018;07;18;Maanantai;18;67;85
624;16.07.2018;2018;07;19;Maanantai;15;29;44
624;16.07.2018;2018;07;20;Maanantai;19;37;56
624;16.07.2018;2018;07;21;Maanantai;9;35;44
624;16.07.2018;2018;07;22;Maanantai;4;22;26
624;16.07.2018;2018;07;23;Maanantai;3;11;14
624;17.07.2018;2018;07;00;Tiistai;3;6;9
624;17.07.2018;2018;07;01;Tiistai;1;6;7
624;17.07.2018;2018;07;02;Tiistai;0;1;1
624;17.07.2018;2018;07;03;Tiistai;1;0;1
624;17.07.2018;2018;07;04;Tiistai;0;3;3
624;17.07.2018;2018;07;05;Tiistai;1;2;3
624;17.07.2018;2018;07;06;Tiistai;1;11;12
624;17.07.2018;2018;07;07;Tiistai;2;50;52
624;17.07.2018;2018;07;08;Tiistai;5;56;61
624;17.07.2018;2018;07;09;Tiistai;10;37;47
624;17.07.2018;2018;07;10;Tiistai;8;31;39
624;17.07.2018;2018;07;11;Tiistai;13;43;56
624;17.07.2018;2018;07;12;Tiistai;10;48;58
624;17.07.2018;2018;07;13;Tiistai;15;34;49
624;17.07.2018;2018;07;14;Tiistai;11;44;55
624;17.07.2018;2018;07;15;Tiistai;29;36;65
624;17.07.2018;2018;07;16;Tiistai;29;72;101
624;17.07.2018;2018;07;17;Tiistai;28;75;103
624;17.07.2018;2018;07;18;Tiistai;27;71;98
624;17.07.2018;2018;07;19;Tiistai;18;49;67
624;17.07.2018;2018;07;20;Tiistai;21;61;82
624;17.07.2018;2018;07;21;Tiistai;16;43;59
624;17.07.2018;2018;07;22;Tiistai;6;37;43
624;17.07.2018;2018;07;23;Tiistai;7;29;36
624;18.07.2018;2018;07;00;Keskiviikko;4;12;16
624;18.07.2018;2018;07;01;Keskiviikko;2;7;9
624;18.07.2018;2018;07;02;Keskiviikko;2;0;2
624;18.07.2018;2018;07;03;Keskiviikko;1;1;2
624;18.07.2018;2018;07;04;Keskiviikko;0;3;3
624;18.07.2018;2018;07;05;Keskiviikko;0;3;3
624;18.07.2018;2018;07;06;Keskiviikko;3;7;10
624;18.07.2018;2018;07;07;Keskiviikko;5;44;49
624;18.07.2018;2018;07;08;Keskiviikko;7;55;62
624;18.07.2018;2018;07;09;Keskiviikko;3;45;48
624;18.07.2018;2018;07;10;Keskiviikko;5;31;36
624;18.07.2018;2018;07;11;Keskiviikko;11;42;53
624;18.07.2018;2018;07;12;Keskiviikko;14;29;43
624;18.07.2018;2018;07;13;Keskiviikko;16;41;57
624;18.07.2018;2018;07;14;Keskiviikko;25;49;74
624;18.07.2018;2018;07;15;Keskiviikko;19;38;57
624;18.07.2018;2018;07;16;Keskiviikko;27;68;95
624;18.07.2018;2018;07;17;Keskiviikko;26;65;91
624;18.07.2018;2018;07;18;Keskiviikko;28;52;80
624;18.07.2018;2018;07;19;Keskiviikko;9;43;52
624;18.07.2018;2018;07;20;Keskiviikko;25;41;66
624;18.07.2018;2018;07;21;Keskiviikko;23;59;82
624;18.07.2018;2018;07;22;Keskiviikko;12;16;28
624;18.07.2018;2018;07;23;Keskiviikko;4;17;21
624;19.07.2018;2018;07;00;Torstai;6;13;19
624;19.07.2018;2018;07;01;Torstai;3;4;7
624;19.07.2018;2018;07;02;Torstai;4;4;8
624;19.07.2018;2018;07;03;Torstai;6;4;10
624;19.07.2018;2018;07;04;Torstai;2;3;5
624;19.07.2018;2018;07;05;Torstai;1;5;6
624;19.07.2018;2018;07;06;Torstai;0;8;8
624;19.07.2018;2018;07;07;Torstai;5;46;51
624;19.07.2018;2018;07;08;Torstai;9;45;54
624;19.07.2018;2018;07;09;Torstai;1;36;37
624;19.07.2018;2018;07;10;Torstai;8;34;42
624;19.07.2018;2018;07;11;Torstai;7;30;37
624;19.07.2018;2018;07;12;Torstai;12;28;40
624;19.07.2018;2018;07;13;Torstai;14;33;47
624;19.07.2018;2018;07;14;Torstai;12;40;52
624;19.07.2018;2018;07;15;Torstai;13;38;51
624;19.07.2018;2018;07;16;Torstai;29;74;103
624;19.07.2018;2018;07;17;Torstai;32;48;80
624;19.07.2018;2018;07;18;Torstai;18;41;59
624;19.07.2018;2018;07;19;Torstai;15;39;54
624;19.07.2018;2018;07;20;Torstai;16;38;54
624;19.07.2018;2018;07;21;Torstai;16;34;50
624;19.07.2018;2018;07;22;Torstai;5;28;33
624;19.07.2018;2018;07;23;Torstai;11;21;32
624;20.07.2018;2018;07;00;Perjantai;4;12;16
624;20.07.2018;2018;07;01;Perjantai;4;5;9
624;20.07.2018;2018;07;02;Perjantai;2;3;5
624;20.07.2018;2018;07;03;Perjantai;4;1;5
624;20.07.2018;2018;07;04;Perjantai;2;3;5
624;20.07.2018;2018;07;05;Perjantai;0;6;6
624;20.07.2018;2018;07;06;Perjantai;2;13;15
624;20.07.2018;2018;07;07;Perjantai;3;41;44
624;20.07.2018;2018;07;08;Perjantai;5;43;48
624;20.07.2018;2018;07;09;Perjantai;6;49;55
624;20.07.2018;2018;07;10;Perjantai;5;29;34
624;20.07.2018;2018;07;11;Perjantai;7;32;39
624;20.07.2018;2018;07;12;Perjantai;8;35;43
624;20.07.2018;2018;07;13;Perjantai;19;46;65
624;20.07.2018;2018;07;14;Perjantai;12;41;53
624;20.07.2018;2018;07;15;Perjantai;25;52;77
624;20.07.2018;2018;07;16;Perjantai;22;65;87
624;20.07.2018;2018;07;17;Perjantai;22;44;66
624;20.07.2018;2018;07;18;Perjantai;18;37;55
624;20.07.2018;2018;07;19;Perjantai;18;36;54
624;20.07.2018;2018;07;20;Perjantai;24;29;53
624;20.07.2018;2018;07;21;Perjantai;13;34;47
624;20.07.2018;2018;07;22;Perjantai;11;30;41
624;20.07.2018;2018;07;23;Perjantai;9;22;31
624;21.07.2018;2018;07;00;Lauantai;2;11;13
624;21.07.2018;2018;07;01;Lauantai;4;7;11
624;21.07.2018;2018;07;02;Lauantai;5;8;13
624;21.07.2018;2018;07;03;Lauantai;3;0;3
624;21.07.2018;2018;07;04;Lauantai;2;3;5
624;21.07.2018;2018;07;05;Lauantai;4;4;8
624;21.07.2018;2018;07;06;Lauantai;4;3;7
624;21.07.2018;2018;07;07;Lauantai;1;7;8
624;21.07.2018;2018;07;08;Lauantai;1;5;6
624;21.07.2018;2018;07;09;Lauantai;1;5;6
624;21.07.2018;2018;07;10;Lauantai;1;16;17
624;21.07.2018;2018;07;11;Lauantai;8;26;34
624;21.07.2018;2018;07;12;Lauantai;0;12;12
624;21.07.2018;2018;07;13;Lauantai;6;27;33
624;21.07.2018;2018;07;14;Lauantai;4;14;18
624;21.07.2018;2018;07;15;Lauantai;5;20;25
624;21.07.2018;2018;07;16;Lauantai;17;16;33
624;21.07.2018;2018;07;17;Lauantai;15;28;43
624;21.07.2018;2018;07;18;Lauantai;11;24;35
624;21.07.2018;2018;07;19;Lauantai;17;26;43
624;21.07.2018;2018;07;20;Lauantai;4;15;19
624;21.07.2018;2018;07;21;Lauantai;7;12;19
624;21.07.2018;2018;07;22;Lauantai;8;10;18
624;21.07.2018;2018;07;23;Lauantai;5;7;12
624;22.07.2018;2018;07;00;Sunnuntai;2;12;14
624;22.07.2018;2018;07;01;Sunnuntai;3;5;8
624;22.07.2018;2018;07;02;Sunnuntai;4;7;11
624;22.07.2018;2018;07;03;Sunnuntai;3;2;5
624;22.07.2018;2018;07;04;Sunnuntai;0;3;3
624;22.07.2018;2018;07;05;Sunnuntai;4;0;4
624;22.07.2018;2018;07;06;Sunnuntai;0;6;6
624;22.07.2018;2018;07;07;Sunnuntai;0;5;5
624;22.07.2018;2018;07;08;Sunnuntai;1;2;3
624;22.07.2018;2018;07;09;Sunnuntai;1;4;5
624;22.07.2018;2018;07;10;Sunnuntai;0;6;6
624;22.07.2018;2018;07;11;Sunnuntai;3;12;15
624;22.07.2018;2018;07;12;Sunnuntai;10;15;25
624;22.07.2018;2018;07;13;Sunnuntai;4;21;25
624;22.07.2018;2018;07;14;Sunnuntai;16;27;43
624;22.07.2018;2018;07;15;Sunnuntai;9;26;35
624;22.07.2018;2018;07;16;Sunnuntai;4;10;14
624;22.07.2018;2018;07;17;Sunnuntai;4;12;16
624;22.07.2018;2018;07;18;Sunnuntai;7;17;24
624;22.07.2018;2018;07;19;Sunnuntai;7;15;22
624;22.07.2018;2018;07;20;Sunnuntai;11;23;34
624;22.07.2018;2018;07;21;Sunnuntai;9;18;27
624;22.07.2018;2018;07;22;Sunnuntai;13;12;25
624;22.07.2018;2018;07;23;Sunnuntai;9;6;15
624;23.07.2018;2018;07;00;Maanantai;2;1;3
624;23.07.2018;2018;07;01;Maanantai;5;3;8
624;23.07.2018;2018;07;02;Maanantai;1;1;2
624;23.07.2018;2018;07;03;Maanantai;1;1;2
624;23.07.2018;2018;07;04;Maanantai;0;1;1
624;23.07.2018;2018;07;05;Maanantai;3;3;6
624;23.07.2018;2018;07;06;Maanantai;1;10;11
624;23.07.2018;2018;07;07;Maanantai;2;44;46
624;23.07.2018;2018;07;08;Maanantai;6;48;54
624;23.07.2018;2018;07;09;Maanantai;8;31;39
624;23.07.2018;2018;07;10;Maanantai;1;36;37
624;23.07.2018;2018;07;11;Maanantai;8;24;32
624;23.07.2018;2018;07;12;Maanantai;8;41;49
624;23.07.2018;2018;07;13;Maanantai;10;30;40
624;23.07.2018;2018;07;14;Maanantai;7;41;48
624;23.07.2018;2018;07;15;Maanantai;17;35;52
624;23.07.2018;2018;07;16;Maanantai;29;55;84
624;23.07.2018;2018;07;17;Maanantai;18;62;80
624;23.07.2018;2018;07;18;Maanantai;19;54;73
624;23.07.2018;2018;07;19;Maanantai;14;41;55
624;23.07.2018;2018;07;20;Maanantai;21;42;63
624;23.07.2018;2018;07;21;Maanantai;13;41;54
624;23.07.2018;2018;07;22;Maanantai;15;23;38
624;23.07.2018;2018;07;23;Maanantai;9;20;29
624;24.07.2018;2018;07;00;Tiistai;2;6;8
624;24.07.2018;2018;07;01;Tiistai;6;5;11
624;24.07.2018;2018;07;02;Tiistai;2;0;2
624;24.07.2018;2018;07;03;Tiistai;5;2;7
624;24.07.2018;2018;07;04;Tiistai;1;3;4
624;24.07.2018;2018;07;05;Tiistai;0;2;2
624;24.07.2018;2018;07;06;Tiistai;0;12;12
624;24.07.2018;2018;07;07;Tiistai;2;45;47
624;24.07.2018;2018;07;08;Tiistai;13;54;67
624;24.07.2018;2018;07;09;Tiistai;7;38;45
624;24.07.2018;2018;07;10;Tiistai;6;39;45
624;24.07.2018;2018;07;11;Tiistai;7;37;44
624;24.07.2018;2018;07;12;Tiistai;17;41;58
624;24.07.2018;2018;07;13;Tiistai;15;48;63
624;24.07.2018;2018;07;14;Tiistai;18;42;60
624;24.07.2018;2018;07;15;Tiistai;17;43;60
624;24.07.2018;2018;07;16;Tiistai;20;70;90
624;24.07.2018;2018;07;17;Tiistai;21;67;88
624;24.07.2018;2018;07;18;Tiistai;23;49;72
624;24.07.2018;2018;07;19;Tiistai;13;47;60
624;24.07.2018;2018;07;20;Tiistai;19;41;60
624;24.07.2018;2018;07;21;Tiistai;16;37;53
624;24.07.2018;2018;07;22;Tiistai;21;32;53
624;24.07.2018;2018;07;23;Tiistai;6;13;19
624;25.07.2018;2018;07;00;Keskiviikko;3;9;12
624;25.07.2018;2018;07;01;Keskiviikko;4;5;9
624;25.07.2018;2018;07;02;Keskiviikko;3;0;3
624;25.07.2018;2018;07;03;Keskiviikko;1;3;4
624;25.07.2018;2018;07;04;Keskiviikko;3;3;6
624;25.07.2018;2018;07;05;Keskiviikko;1;4;5
624;25.07.2018;2018;07;06;Keskiviikko;2;14;16
624;25.07.2018;2018;07;07;Keskiviikko;2;46;48
624;25.07.2018;2018;07;08;Keskiviikko;9;55;64
624;25.07.2018;2018;07;09;Keskiviikko;8;46;54
624;25.07.2018;2018;07;10;Keskiviikko;7;22;29
624;25.07.2018;2018;07;11;Keskiviikko;7;38;45
624;25.07.2018;2018;07;12;Keskiviikko;11;25;36
624;25.07.2018;2018;07;13;Keskiviikko;6;42;48
624;25.07.2018;2018;07;14;Keskiviikko;12;32;44
624;25.07.2018;2018;07;15;Keskiviikko;23;43;66
624;25.07.2018;2018;07;16;Keskiviikko;22;67;89
624;25.07.2018;2018;07;17;Keskiviikko;28;70;98
624;25.07.2018;2018;07;18;Keskiviikko;19;67;86
624;25.07.2018;2018;07;19;Keskiviikko;21;57;78
624;25.07.2018;2018;07;20;Keskiviikko;29;49;78
624;25.07.2018;2018;07;21;Keskiviikko;20;43;63
624;25.07.2018;2018;07;22;Keskiviikko;18;30;48
624;25.07.2018;2018;07;23;Keskiviikko;7;20;27
624;26.07.2018;2018;07;00;Torstai;8;9;17
624;26.07.2018;2018;07;01;Torstai;5;6;11
624;26.07.2018;2018;07;02;Torstai;1;2;3
624;26.07.2018;2018;07;03;Torstai;1;3;4
624;26.07.2018;2018;07;04;Torstai;0;2;2
624;26.07.2018;2018;07;05;Torstai;1;2;3
624;26.07.2018;2018;07;06;Torstai;0;11;11
624;26.07.2018;2018;07;07;Torstai;4;48;52
624;26.07.2018;2018;07;08;Torstai;5;48;53
624;26.07.2018;2018;07;09;Torstai;11;48;59
624;26.07.2018;2018;07;10;Torstai;9;38;47
624;26.07.2018;2018;07;11;Torstai;8;37;45
624;26.07.2018;2018;07;12;Torstai;10;40;50
624;26.07.2018;2018;07;13;Torstai;8;38;46
624;26.07.2018;2018;07;14;Torstai;10;48;58
624;26.07.2018;2018;07;15;Torstai;11;41;52
624;26.07.2018;2018;07;16;Torstai;31;64;95
624;26.07.2018;2018;07;17;Torstai;13;47;60
624;26.07.2018;2018;07;18;Torstai;19;47;66
624;26.07.2018;2018;07;19;Torstai;16;51;67
624;26.07.2018;2018;07;20;Torstai;11;37;48
624;26.07.2018;2018;07;21;Torstai;19;34;53
624;26.07.2018;2018;07;22;Torstai;14;25;39
624;26.07.2018;2018;07;23;Torstai;7;13;20
624;27.07.2018;2018;07;00;Perjantai;8;4;12
624;27.07.2018;2018;07;01;Perjantai;0;2;2
624;27.07.2018;2018;07;02;Perjantai;1;3;4
624;27.07.2018;2018;07;03;Perjantai;1;0;1
624;27.07.2018;2018;07;04;Perjantai;0;2;2
624;27.07.2018;2018;07;05;Perjantai;1;3;4
624;27.07.2018;2018;07;06;Perjantai;2;8;10
624;27.07.2018;2018;07;07;Perjantai;4;41;45
624;27.07.2018;2018;07;08;Perjantai;6;41;47
624;27.07.2018;2018;07;09;Perjantai;9;38;47
624;27.07.2018;2018;07;10;Perjantai;1;28;29
624;27.07.2018;2018;07;11;Perjantai;11;36;47
624;27.07.2018;2018;07;12;Perjantai;18;44;62
624;27.07.2018;2018;07;13;Perjantai;8;35;43
624;27.07.2018;2018;07;14;Perjantai;21;46;67
624;27.07.2018;2018;07;15;Perjantai;17;54;71
624;27.07.2018;2018;07;16;Perjantai;20;55;75
624;27.07.2018;2018;07;17;Perjantai;20;59;79
624;27.07.2018;2018;07;18;Perjantai;10;38;48
624;27.07.2018;2018;07;19;Perjantai;14;37;51
624;27.07.2018;2018;07;20;Perjantai;20;36;56
624;27.07.2018;2018;07;21;Perjantai;11;22;33
624;27.07.2018;2018;07;22;Perjantai;7;19;26
624;27.07.2018;2018;07;23;Perjantai;7;15;22
624;28.07.2018;2018;07;00;Lauantai;7;15;22
624;28.07.2018;2018;07;01;Lauantai;10;9;19
624;28.07.2018;2018;07;02;Lauantai;12;6;18
624;28.07.2018;2018;07;03;Lauantai;8;2;10
624;28.07.2018;2018;07;04;Lauantai;1;1;2
624;28.07.2018;2018;07;05;Lauantai;3;0;3
624;28.07.2018;2018;07;06;Lauantai;1;3;4
624;28.07.2018;2018;07;07;Lauantai;1;5;6
624;28.07.2018;2018;07;08;Lauantai;2;10;12
624;28.07.2018;2018;07;09;Lauantai;4;7;11
624;28.07.2018;2018;07;10;Lauantai;3;14;17
624;28.07.2018;2018;07;11;Lauantai;9;21;30
624;28.07.2018;2018;07;12;Lauantai;7;28;35
624;28.07.2018;2018;07;13;Lauantai;10;27;37
624;28.07.2018;2018;07;14;Lauantai;17;32;49
624;28.07.2018;2018;07;15;Lauantai;7;36;43
624;28.07.2018;2018;07;16;Lauantai;15;25;40
624;28.07.2018;2018;07;17;Lauantai;11;29;40
624;28.07.2018;2018;07;18;Lauantai;13;30;43
624;28.07.2018;2018;07;19;Lauantai;11;37;48
624;28.07.2018;2018;07;20;Lauantai;14;22;36
624;28.07.2018;2018;07;21;Lauantai;14;19;33
624;28.07.2018;2018;07;22;Lauantai;8;12;20
624;28.07.2018;2018;07;23;Lauantai;4;6;10
624;29.07.2018;2018;07;00;Sunnuntai;1;6;7
624;29.07.2018;2018;07;01;Sunnuntai;5;2;7
624;29.07.2018;2018;07;02;Sunnuntai;6;8;14
624;29.07.2018;2018;07;03;Sunnuntai;6;3;9
624;29.07.2018;2018;07;04;Sunnuntai;3;0;3
624;29.07.2018;2018;07;05;Sunnuntai;2;2;4
624;29.07.2018;2018;07;06;Sunnuntai;1;3;4
624;29.07.2018;2018;07;07;Sunnuntai;3;6;9
624;29.07.2018;2018;07;08;Sunnuntai;1;0;1
624;29.07.2018;2018;07;09;Sunnuntai;3;4;7
624;29.07.2018;2018;07;10;Sunnuntai;2;15;17
624;29.07.2018;2018;07;11;Sunnuntai;17;26;43
624;29.07.2018;2018;07;12;Sunnuntai;6;22;28
624;29.07.2018;2018;07;13;Sunnuntai;7;36;43
624;29.07.2018;2018;07;14;Sunnuntai;13;24;37
624;29.07.2018;2018;07;15;Sunnuntai;7;16;23
624;29.07.2018;2018;07;16;Sunnuntai;18;43;61
624;29.07.2018;2018;07;17;Sunnuntai;15;45;60
624;29.07.2018;2018;07;18;Sunnuntai;13;30;43
624;29.07.2018;2018;07;19;Sunnuntai;20;36;56
624;29.07.2018;2018;07;20;Sunnuntai;8;33;41
624;29.07.2018;2018;07;21;Sunnuntai;10;28;38
624;29.07.2018;2018;07;22;Sunnuntai;15;22;37
624;29.07.2018;2018;07;23;Sunnuntai;7;11;18
624;30.07.2018;2018;07;00;Maanantai;1;3;4
624;30.07.2018;2018;07;01;Maanantai;4;5;9
624;30.07.2018;2018;07;02;Maanantai;1;1;2
624;30.07.2018;2018;07;03;Maanantai;1;0;1
624;30.07.2018;2018;07;04;Maanantai;0;0;0
624;30.07.2018;2018;07;05;Maanantai;3;1;4
624;30.07.2018;2018;07;06;Maanantai;1;10;11
624;30.07.2018;2018;07;07;Maanantai;5;48;53
624;30.07.2018;2018;07;08;Maanantai;11;71;82
624;30.07.2018;2018;07;09;Maanantai;10;43;53
624;30.07.2018;2018;07;10;Maanantai;3;23;26
624;30.07.2018;2018;07;11;Maanantai;5;29;34
624;30.07.2018;2018;07;12;Maanantai;5;28;33
624;30.07.2018;2018;07;13;Maanantai;9;34;43
624;30.07.2018;2018;07;14;Maanantai;17;37;54
624;30.07.2018;2018;07;15;Maanantai;16;51;67
624;30.07.2018;2018;07;16;Maanantai;23;55;78
624;30.07.2018;2018;07;17;Maanantai;32;63;95
624;30.07.2018;2018;07;18;Maanantai;20;59;79
624;30.07.2018;2018;07;19;Maanantai;18;54;72
624;30.07.2018;2018;07;20;Maanantai;15;45;60
624;30.07.2018;2018;07;21;Maanantai;16;60;76
624;30.07.2018;2018;07;22;Maanantai;8;20;28
624;30.07.2018;2018;07;23;Maanantai;1;6;7
624;31.07.2018;2018;07;00;Tiistai;4;3;7
624;31.07.2018;2018;07;01;Tiistai;1;4;5
624;31.07.2018;2018;07;02;Tiistai;1;0;1
624;31.07.2018;2018;07;03;Tiistai;1;1;2
624;31.07.2018;2018;07;04;Tiistai;0;2;2
624;31.07.2018;2018;07;05;Tiistai;2;2;4
624;31.07.2018;2018;07;06;Tiistai;4;9;13
624;31.07.2018;2018;07;07;Tiistai;0;36;36
624;31.07.2018;2018;07;08;Tiistai;8;55;63
624;31.07.2018;2018;07;09;Tiistai;5;45;50
624;31.07.2018;2018;07;10;Tiistai;6;36;42
624;31.07.2018;2018;07;11;Tiistai;4;32;36
624;31.07.2018;2018;07;12;Tiistai;10;31;41
624;31.07.2018;2018;07;13;Tiistai;6;33;39
624;31.07.2018;2018;07;14;Tiistai;14;36;50
624;31.07.2018;2018;07;15;Tiistai;18;33;51
624;31.07.2018;2018;07;16;Tiistai;38;72;110
624;31.07.2018;2018;07;17;Tiistai;35;68;103
624;31.07.2018;2018;07;18;Tiistai;19;44;63
624;31.07.2018;2018;07;19;Tiistai;33;51;84
624;31.07.2018;2018;07;20;Tiistai;21;32;53
624;31.07.2018;2018;07;21;Tiistai;7;73;80
624;31.07.2018;2018;07;22;Tiistai;14;29;43
624;31.07.2018;2018;07;23;Tiistai;5;14;19
624;01.08.2018;2018;08;00;Keskiviikko;2;7;9
624;01.08.2018;2018;08;01;Keskiviikko;3;8;11
624;01.08.2018;2018;08;02;Keskiviikko;2;3;5
624;01.08.2018;2018;08;03;Keskiviikko;4;2;6
624;01.08.2018;2018;08;04;Keskiviikko;2;4;6
624;01.08.2018;2018;08;05;Keskiviikko;2;2;4
624;01.08.2018;2018;08;06;Keskiviikko;1;13;14
624;01.08.2018;2018;08;07;Keskiviikko;6;42;48
624;01.08.2018;2018;08;08;Keskiviikko;12;51;63
624;01.08.2018;2018;08;09;Keskiviikko;5;54;59
624;01.08.2018;2018;08;10;Keskiviikko;9;34;43
624;01.08.2018;2018;08;11;Keskiviikko;8;38;46
624;01.08.2018;2018;08;12;Keskiviikko;7;28;35
624;01.08.2018;2018;08;13;Keskiviikko;12;33;45
624;01.08.2018;2018;08;14;Keskiviikko;9;43;52
624;01.08.2018;2018;08;15;Keskiviikko;14;30;44
624;01.08.2018;2018;08;16;Keskiviikko;19;65;84
624;01.08.2018;2018;08;17;Keskiviikko;29;49;78
624;01.08.2018;2018;08;18;Keskiviikko;26;39;65
624;01.08.2018;2018;08;19;Keskiviikko;26;48;74
624;01.08.2018;2018;08;20;Keskiviikko;14;39;53
624;01.08.2018;2018;08;21;Keskiviikko;8;35;43
624;01.08.2018;2018;08;22;Keskiviikko;11;19;30
624;01.08.2018;2018;08;23;Keskiviikko;3;17;20
624;02.08.2018;2018;08;00;Torstai;8;9;17
624;02.08.2018;2018;08;01;Torstai;3;6;9
624;02.08.2018;2018;08;02;Torstai;0;2;2
624;02.08.2018;2018;08;03;Torstai;0;3;3
624;02.08.2018;2018;08;04;Torstai;0;2;2
624;02.08.2018;2018;08;05;Torstai;0;2;2
624;02.08.2018;2018;08;06;Torstai;0;11;11
624;02.08.2018;2018;08;07;Torstai;0;48;48
624;02.08.2018;2018;08;08;Torstai;0;48;48
624;02.08.2018;2018;08;09;Torstai;0;48;48
624;02.08.2018;2018;08;10;Torstai;0;38;38
624;02.08.2018;2018;08;11;Torstai;0;37;37
624;02.08.2018;2018;08;12;Torstai;0;40;40
624;02.08.2018;2018;08;13;Torstai;0;38;38
624;02.08.2018;2018;08;14;Torstai;0;48;48
624;02.08.2018;2018;08;15;Torstai;0;41;41
624;02.08.2018;2018;08;16;Torstai;0;64;64
624;02.08.2018;2018;08;17;Torstai;0;47;47
624;02.08.2018;2018;08;18;Torstai;0;47;47
624;02.08.2018;2018;08;19;Torstai;0;51;51
624;02.08.2018;2018;08;20;Torstai;0;37;37
624;02.08.2018;2018;08;21;Torstai;0;34;34
624;02.08.2018;2018;08;22;Torstai;0;25;25
624;02.08.2018;2018;08;23;Torstai;0;13;13
624;03.08.2018;2018;08;00;Perjantai;0;12;12
624;03.08.2018;2018;08;01;Perjantai;0;5;5
624;03.08.2018;2018;08;02;Perjantai;0;3;3
624;03.08.2018;2018;08;03;Perjantai;0;1;1
624;03.08.2018;2018;08;04;Perjantai;0;3;3
624;03.08.2018;2018;08;05;Perjantai;0;6;6
624;03.08.2018;2018;08;06;Perjantai;0;13;13
624;03.08.2018;2018;08;07;Perjantai;0;41;41
624;03.08.2018;2018;08;08;Perjantai;0;43;43
624;03.08.2018;2018;08;09;Perjantai;0;49;49
624;03.08.2018;2018;08;10;Perjantai;0;29;29
624;03.08.2018;2018;08;11;Perjantai;0;32;32
624;03.08.2018;2018;08;12;Perjantai;0;35;35
624;03.08.2018;2018;08;13;Perjantai;0;46;46
624;03.08.2018;2018;08;14;Perjantai;0;41;41
624;03.08.2018;2018;08;15;Perjantai;0;52;52
624;03.08.2018;2018;08;16;Perjantai;0;65;65
624;03.08.2018;2018;08;17;Perjantai;0;44;44
624;03.08.2018;2018;08;18;Perjantai;0;37;37
624;03.08.2018;2018;08;19;Perjantai;0;36;36
624;03.08.2018;2018;08;20;Perjantai;0;29;29
624;03.08.2018;2018;08;21;Perjantai;0;34;34
624;03.08.2018;2018;08;22;Perjantai;0;30;30
624;03.08.2018;2018;08;23;Perjantai;0;22;22
624;04.08.2018;2018;08;00;Lauantai;0;11;11
624;04.08.2018;2018;08;01;Lauantai;0;7;7
624;04.08.2018;2018;08;02;Lauantai;0;8;8
624;04.08.2018;2018;08;03;Lauantai;0;0;0
624;04.08.2018;2018;08;04;Lauantai;0;3;3
624;04.08.2018;2018;08;05;Lauantai;0;4;4
624;04.08.2018;2018;08;06;Lauantai;0;3;3
624;04.08.2018;2018;08;07;Lauantai;0;7;7
624;04.08.2018;2018;08;08;Lauantai;0;5;5
624;04.08.2018;2018;08;09;Lauantai;0;5;5
624;04.08.2018;2018;08;10;Lauantai;0;16;16
624;04.08.2018;2018;08;11;Lauantai;0;26;26
624;04.08.2018;2018;08;12;Lauantai;0;12;12
624;04.08.2018;2018;08;13;Lauantai;0;27;27
624;04.08.2018;2018;08;14;Lauantai;0;14;14
624;04.08.2018;2018;08;15;Lauantai;0;20;20
624;04.08.2018;2018;08;16;Lauantai;0;16;16
624;04.08.2018;2018;08;17;Lauantai;0;28;28
624;04.08.2018;2018;08;18;Lauantai;0;24;24
624;04.08.2018;2018;08;19;Lauantai;0;26;26
624;04.08.2018;2018;08;20;Lauantai;0;15;15
624;04.08.2018;2018;08;21;Lauantai;0;12;12
624;04.08.2018;2018;08;22;Lauantai;0;10;10
624;04.08.2018;2018;08;23;Lauantai;0;7;7
624;05.08.2018;2018;08;00;Sunnuntai;0;12;12
624;05.08.2018;2018;08;01;Sunnuntai;0;5;5
624;05.08.2018;2018;08;02;Sunnuntai;0;7;7
624;05.08.2018;2018;08;03;Sunnuntai;0;2;2
624;05.08.2018;2018;08;04;Sunnuntai;0;3;3
624;05.08.2018;2018;08;05;Sunnuntai;0;0;0
624;05.08.2018;2018;08;06;Sunnuntai;0;6;6
624;05.08.2018;2018;08;07;Sunnuntai;0;5;5
624;05.08.2018;2018;08;08;Sunnuntai;0;2;2
624;05.08.2018;2018;08;09;Sunnuntai;0;4;4
624;05.08.2018;2018;08;10;Sunnuntai;0;6;6
624;05.08.2018;2018;08;11;Sunnuntai;0;12;12
624;05.08.2018;2018;08;12;Sunnuntai;0;15;15
624;05.08.2018;2018;08;13;Sunnuntai;0;21;21
624;05.08.2018;2018;08;14;Sunnuntai;0;27;27
624;05.08.2018;2018;08;15;Sunnuntai;0;26;26
624;05.08.2018;2018;08;16;Sunnuntai;0;10;10
624;05.08.2018;2018;08;17;Sunnuntai;0;12;12
624;05.08.2018;2018;08;18;Sunnuntai;0;17;17
624;05.08.2018;2018;08;19;Sunnuntai;0;15;15
624;05.08.2018;2018;08;20;Sunnuntai;0;23;23
624;05.08.2018;2018;08;21;Sunnuntai;0;18;18
624;05.08.2018;2018;08;22;Sunnuntai;0;12;12
624;05.08.2018;2018;08;23;Sunnuntai;0;6;6
624;06.08.2018;2018;08;00;Maanantai;0;0;0
624;06.08.2018;2018;08;01;Maanantai;0;0;0
624;06.08.2018;2018;08;02;Maanantai;0;0;0
624;06.08.2018;2018;08;03;Maanantai;0;0;0
624;06.08.2018;2018;08;04;Maanantai;0;0;0
624;06.08.2018;2018;08;05;Maanantai;0;5;5
624;06.08.2018;2018;08;06;Maanantai;0;10;10
624;06.08.2018;2018;08;07;Maanantai;0;20;20
624;06.08.2018;2018;08;08;Maanantai;0;25;25
624;06.08.2018;2018;08;09;Maanantai;3;25;28
624;06.08.2018;2018;08;10;Maanantai;3;31;34
624;06.08.2018;2018;08;11;Maanantai;4;27;31
624;06.08.2018;2018;08;12;Maanantai;6;13;19
624;06.08.2018;2018;08;13;Maanantai;8;10;18
624;06.08.2018;2018;08;14;Maanantai;13;25;38
624;06.08.2018;2018;08;15;Maanantai;19;18;37
624;06.08.2018;2018;08;16;Maanantai;25;27;52
624;06.08.2018;2018;08;17;Maanantai;18;47;65
624;06.08.2018;2018;08;18;Maanantai;13;22;35
624;06.08.2018;2018;08;19;Maanantai;10;29;39
624;06.08.2018;2018;08;20;Maanantai;5;19;24
624;06.08.2018;2018;08;21;Maanantai;15;21;36
624;06.08.2018;2018;08;22;Maanantai;11;10;21
624;06.08.2018;2018;08;23;Maanantai;3;9;12
624;07.08.2018;2018;08;00;Tiistai;6;6;12
624;07.08.2018;2018;08;01;Tiistai;2;2;4
624;07.08.2018;2018;08;02;Tiistai;4;0;4
624;07.08.2018;2018;08;03;Tiistai;0;2;2
624;07.08.2018;2018;08;04;Tiistai;0;3;3
624;07.08.2018;2018;08;05;Tiistai;0;1;1
624;07.08.2018;2018;08;06;Tiistai;2;10;12
624;07.08.2018;2018;08;07;Tiistai;3;48;51
624;07.08.2018;2018;08;08;Tiistai;14;82;96
624;07.08.2018;2018;08;09;Tiistai;6;62;68
624;07.08.2018;2018;08;10;Tiistai;10;41;51
624;07.08.2018;2018;08;11;Tiistai;4;37;41
624;07.08.2018;2018;08;12;Tiistai;8;39;47
624;07.08.2018;2018;08;13;Tiistai;18;39;57
624;07.08.2018;2018;08;14;Tiistai;15;26;41
624;07.08.2018;2018;08;15;Tiistai;15;47;62
624;07.08.2018;2018;08;16;Tiistai;23;48;71
624;07.08.2018;2018;08;17;Tiistai;23;72;95
624;07.08.2018;2018;08;18;Tiistai;24;43;67
624;07.08.2018;2018;08;19;Tiistai;17;41;58
624;07.08.2018;2018;08;20;Tiistai;28;42;70
624;07.08.2018;2018;08;21;Tiistai;11;33;44
624;07.08.2018;2018;08;22;Tiistai;9;18;27
624;07.08.2018;2018;08;23;Tiistai;8;10;18
624;08.08.2018;2018;08;00;Keskiviikko;3;1;4
624;08.08.2018;2018;08;01;Keskiviikko;2;6;8
624;08.08.2018;2018;08;02;Keskiviikko;2;4;6
624;08.08.2018;2018;08;03;Keskiviikko;1;0;1
624;08.08.2018;2018;08;04;Keskiviikko;3;0;3
624;08.08.2018;2018;08;05;Keskiviikko;2;1;3
624;08.08.2018;2018;08;06;Keskiviikko;1;13;14
624;08.08.2018;2018;08;07;Keskiviikko;6;52;58
624;08.08.2018;2018;08;08;Keskiviikko;16;95;111
624;08.08.2018;2018;08;09;Keskiviikko;6;79;85
624;08.08.2018;2018;08;10;Keskiviikko;4;52;56
624;08.08.2018;2018;08;11;Keskiviikko;5;28;33
624;08.08.2018;2018;08;12;Keskiviikko;11;29;40
624;08.08.2018;2018;08;13;Keskiviikko;12;39;51
624;08.08.2018;2018;08;14;Keskiviikko;13;43;56
624;08.08.2018;2018;08;15;Keskiviikko;24;51;75
624;08.08.2018;2018;08;16;Keskiviikko;38;55;93
624;08.08.2018;2018;08;17;Keskiviikko;37;93;130
624;08.08.2018;2018;08;18;Keskiviikko;30;48;78
624;08.08.2018;2018;08;19;Keskiviikko;18;45;63
624;08.08.2018;2018;08;20;Keskiviikko;18;39;57
624;08.08.2018;2018;08;21;Keskiviikko;9;32;41
624;08.08.2018;2018;08;22;Keskiviikko;7;23;30
624;08.08.2018;2018;08;23;Keskiviikko;7;18;25
624;09.08.2018;2018;08;00;Torstai;2;6;8
624;09.08.2018;2018;08;01;Torstai;4;3;7
624;09.08.2018;2018;08;02;Torstai;1;3;4
624;09.08.2018;2018;08;03;Torstai;2;3;5
624;09.08.2018;2018;08;04;Torstai;2;1;3
624;09.08.2018;2018;08;05;Torstai;1;4;5
624;09.08.2018;2018;08;06;Torstai;2;13;15
624;09.08.2018;2018;08;07;Torstai;4;42;46
624;09.08.2018;2018;08;08;Torstai;10;70;80
624;09.08.2018;2018;08;09;Torstai;6;48;54
624;09.08.2018;2018;08;10;Torstai;5;43;48
624;09.08.2018;2018;08;11;Torstai;11;27;38
624;09.08.2018;2018;08;12;Torstai;8;22;30
624;09.08.2018;2018;08;13;Torstai;7;37;44
624;09.08.2018;2018;08;14;Torstai;16;39;55
624;09.08.2018;2018;08;15;Torstai;15;37;52
624;09.08.2018;2018;08;16;Torstai;23;49;72
624;09.08.2018;2018;08;17;Torstai;26;44;70
624;09.08.2018;2018;08;18;Torstai;16;38;54
624;09.08.2018;2018;08;19;Torstai;15;40;55
624;09.08.2018;2018;08;20;Torstai;13;36;49
624;09.08.2018;2018;08;21;Torstai;9;22;31
624;09.08.2018;2018;08;22;Torstai;7;20;27
624;09.08.2018;2018;08;23;Torstai;4;8;12
624;10.08.2018;2018;08;00;Perjantai;0;4;4
624;10.08.2018;2018;08;01;Perjantai;2;4;6
624;10.08.2018;2018;08;02;Perjantai;1;2;3
624;10.08.2018;2018;08;03;Perjantai;1;0;1
624;10.08.2018;2018;08;04;Perjantai;0;1;1
624;10.08.2018;2018;08;05;Perjantai;0;4;4
624;10.08.2018;2018;08;06;Perjantai;1;10;11
624;10.08.2018;2018;08;07;Perjantai;3;34;37
624;10.08.2018;2018;08;08;Perjantai;14;76;90
624;10.08.2018;2018;08;09;Perjantai;12;88;100
624;10.08.2018;2018;08;10;Perjantai;6;37;43
624;10.08.2018;2018;08;11;Perjantai;10;34;44
624;10.08.2018;2018;08;12;Perjantai;19;48;67
624;10.08.2018;2018;08;13;Perjantai;17;45;62
624;10.08.2018;2018;08;14;Perjantai;16;44;60
624;10.08.2018;2018;08;15;Perjantai;34;56;90
624;10.08.2018;2018;08;16;Perjantai;24;58;82
624;10.08.2018;2018;08;17;Perjantai;27;57;84
624;10.08.2018;2018;08;18;Perjantai;16;54;70
624;10.08.2018;2018;08;19;Perjantai;16;42;58
624;10.08.2018;2018;08;20;Perjantai;7;19;26
624;10.08.2018;2018;08;21;Perjantai;2;20;22
624;10.08.2018;2018;08;22;Perjantai;5;7;12
624;10.08.2018;2018;08;23;Perjantai;7;5;12
624;11.08.2018;2018;08;00;Lauantai;2;6;8
624;11.08.2018;2018;08;01;Lauantai;4;5;9
624;11.08.2018;2018;08;02;Lauantai;2;3;5
624;11.08.2018;2018;08;03;Lauantai;3;1;4
624;11.08.2018;2018;08;04;Lauantai;3;2;5
624;11.08.2018;2018;08;05;Lauantai;3;2;5
624;11.08.2018;2018;08;06;Lauantai;1;2;3
624;11.08.2018;2018;08;07;Lauantai;1;8;9
624;11.08.2018;2018;08;08;Lauantai;0;6;6
624;11.08.2018;2018;08;09;Lauantai;2;3;5
624;11.08.2018;2018;08;10;Lauantai;4;23;27
624;11.08.2018;2018;08;11;Lauantai;4;30;34
624;11.08.2018;2018;08;12;Lauantai;8;32;40
624;11.08.2018;2018;08;13;Lauantai;20;46;66
624;11.08.2018;2018;08;14;Lauantai;14;32;46
624;11.08.2018;2018;08;15;Lauantai;16;21;37
624;11.08.2018;2018;08;16;Lauantai;8;12;20
624;11.08.2018;2018;08;17;Lauantai;12;17;29
624;11.08.2018;2018;08;18;Lauantai;9;23;32
624;11.08.2018;2018;08;19;Lauantai;8;27;35
624;11.08.2018;2018;08;20;Lauantai;9;32;41
624;11.08.2018;2018;08;21;Lauantai;6;13;19
624;11.08.2018;2018;08;22;Lauantai;5;13;18
624;11.08.2018;2018;08;23;Lauantai;4;8;12
624;12.08.2018;2018;08;00;Sunnuntai;2;6;8
624;12.08.2018;2018;08;01;Sunnuntai;4;8;12
624;12.08.2018;2018;08;02;Sunnuntai;5;7;12
624;12.08.2018;2018;08;03;Sunnuntai;3;5;8
624;12.08.2018;2018;08;04;Sunnuntai;5;6;11
624;12.08.2018;2018;08;05;Sunnuntai;1;1;2
624;12.08.2018;2018;08;06;Sunnuntai;5;5;10
624;12.08.2018;2018;08;07;Sunnuntai;3;5;8
624;12.08.2018;2018;08;08;Sunnuntai;2;5;7
624;12.08.2018;2018;08;09;Sunnuntai;1;4;5
624;12.08.2018;2018;08;10;Sunnuntai;5;10;15
624;12.08.2018;2018;08;11;Sunnuntai;11;23;34
624;12.08.2018;2018;08;12;Sunnuntai;7;17;24
624;12.08.2018;2018;08;13;Sunnuntai;8;34;42
624;12.08.2018;2018;08;14;Sunnuntai;14;48;62
624;12.08.2018;2018;08;15;Sunnuntai;10;31;41
624;12.08.2018;2018;08;16;Sunnuntai;15;31;46
624;12.08.2018;2018;08;17;Sunnuntai;23;29;52
624;12.08.2018;2018;08;18;Sunnuntai;15;26;41
624;12.08.2018;2018;08;19;Sunnuntai;21;40;61
624;12.08.2018;2018;08;20;Sunnuntai;15;24;39
624;12.08.2018;2018;08;21;Sunnuntai;8;26;34
624;12.08.2018;2018;08;22;Sunnuntai;6;17;23
624;12.08.2018;2018;08;23;Sunnuntai;3;3;6
624;13.08.2018;2018;08;00;Maanantai;3;2;5
624;13.08.2018;2018;08;01;Maanantai;2;5;7
624;13.08.2018;2018;08;02;Maanantai;0;0;0
624;13.08.2018;2018;08;03;Maanantai;1;0;1
624;13.08.2018;2018;08;04;Maanantai;1;0;1
624;13.08.2018;2018;08;05;Maanantai;1;2;3
624;13.08.2018;2018;08;06;Maanantai;1;9;10
624;13.08.2018;2018;08;07;Maanantai;7;35;42
624;13.08.2018;2018;08;08;Maanantai;16;68;84
624;13.08.2018;2018;08;09;Maanantai;9;83;92
624;13.08.2018;2018;08;10;Maanantai;15;40;55
624;13.08.2018;2018;08;11;Maanantai;9;26;35
624;13.08.2018;2018;08;12;Maanantai;4;25;29
624;13.08.2018;2018;08;13;Maanantai;8;24;32
624;13.08.2018;2018;08;14;Maanantai;5;19;24
624;13.08.2018;2018;08;15;Maanantai;20;31;51
624;13.08.2018;2018;08;16;Maanantai;16;32;48
624;13.08.2018;2018;08;17;Maanantai;18;52;70
624;13.08.2018;2018;08;18;Maanantai;14;34;48
624;13.08.2018;2018;08;19;Maanantai;13;27;40
624;13.08.2018;2018;08;20;Maanantai;13;17;30
624;13.08.2018;2018;08;21;Maanantai;7;11;18
624;13.08.2018;2018;08;22;Maanantai;8;10;18
624;13.08.2018;2018;08;23;Maanantai;5;16;21
624;14.08.2018;2018;08;00;Tiistai;1;5;6
624;14.08.2018;2018;08;01;Tiistai;2;4;6
624;14.08.2018;2018;08;02;Tiistai;0;0;0
624;14.08.2018;2018;08;03;Tiistai;0;2;2
624;14.08.2018;2018;08;04;Tiistai;0;1;1
624;14.08.2018;2018;08;05;Tiistai;0;2;2
624;14.08.2018;2018;08;06;Tiistai;2;8;10
624;14.08.2018;2018;08;07;Tiistai;6;45;51
624;14.08.2018;2018;08;08;Tiistai;16;108;124
624;14.08.2018;2018;08;09;Tiistai;17;83;100
624;14.08.2018;2018;08;10;Tiistai;9;49;58
624;14.08.2018;2018;08;11;Tiistai;4;37;41
624;14.08.2018;2018;08;12;Tiistai;15;40;55
624;14.08.2018;2018;08;13;Tiistai;6;27;33
624;14.08.2018;2018;08;14;Tiistai;10;32;42
624;14.08.2018;2018;08;15;Tiistai;22;34;56
624;14.08.2018;2018;08;16;Tiistai;28;49;77
624;14.08.2018;2018;08;17;Tiistai;38;70;108
624;14.08.2018;2018;08;18;Tiistai;23;49;72
624;14.08.2018;2018;08;19;Tiistai;17;33;50
624;14.08.2018;2018;08;20;Tiistai;12;27;39
624;14.08.2018;2018;08;21;Tiistai;7;29;36
624;14.08.2018;2018;08;22;Tiistai;9;9;18
624;14.08.2018;2018;08;23;Tiistai;4;14;18
624;15.08.2018;2018;08;00;Keskiviikko;1;5;6
624;15.08.2018;2018;08;01;Keskiviikko;1;3;4
624;15.08.2018;2018;08;02;Keskiviikko;1;2;3
624;15.08.2018;2018;08;03;Keskiviikko;1;2;3
624;15.08.2018;2018;08;04;Keskiviikko;1;0;1
624;15.08.2018;2018;08;05;Keskiviikko;0;3;3
624;15.08.2018;2018;08;06;Keskiviikko;1;9;10
624;15.08.2018;2018;08;07;Keskiviikko;7;40;47
624;15.08.2018;2018;08;08;Keskiviikko;13;112;125
624;15.08.2018;2018;08;09;Keskiviikko;14;82;96
624;15.08.2018;2018;08;10;Keskiviikko;9;46;55
624;15.08.2018;2018;08;11;Keskiviikko;5;28;33
624;15.08.2018;2018;08;12;Keskiviikko;4;33;37
624;15.08.2018;2018;08;13;Keskiviikko;5;27;32
624;15.08.2018;2018;08;14;Keskiviikko;11;30;41
624;15.08.2018;2018;08;15;Keskiviikko;20;30;50
624;15.08.2018;2018;08;16;Keskiviikko;20;45;65
624;15.08.2018;2018;08;17;Keskiviikko;22;58;80
624;15.08.2018;2018;08;18;Keskiviikko;18;44;62
624;15.08.2018;2018;08;19;Keskiviikko;17;42;59
624;15.08.2018;2018;08;20;Keskiviikko;21;34;55
624;15.08.2018;2018;08;21;Keskiviikko;12;21;33
624;15.08.2018;2018;08;22;Keskiviikko;9;13;22
624;15.08.2018;2018;08;23;Keskiviikko;3;9;12
624;16.08.2018;2018;08;00;Torstai;3;8;11
624;16.08.2018;2018;08;01;Torstai;0;6;6
624;16.08.2018;2018;08;02;Torstai;1;2;3
624;16.08.2018;2018;08;03;Torstai;0;2;2
624;16.08.2018;2018;08;04;Torstai;0;1;1
624;16.08.2018;2018;08;05;Torstai;0;2;2
624;16.08.2018;2018;08;06;Torstai;1;10;11
624;16.08.2018;2018;08;07;Torstai;1;36;37
624;16.08.2018;2018;08;08;Torstai;9;97;106
624;16.08.2018;2018;08;09;Torstai;11;86;97
624;16.08.2018;2018;08;10;Torstai;9;57;66
624;16.08.2018;2018;08;11;Torstai;4;36;40
624;16.08.2018;2018;08;12;Torstai;6;28;34
624;16.08.2018;2018;08;13;Torstai;6;39;45
624;16.08.2018;2018;08;14;Torstai;9;37;46
624;16.08.2018;2018;08;15;Torstai;9;40;49
624;16.08.2018;2018;08;16;Torstai;22;44;66
624;16.08.2018;2018;08;17;Torstai;27;59;86
624;16.08.2018;2018;08;18;Torstai;13;41;54
624;16.08.2018;2018;08;19;Torstai;16;34;50
624;16.08.2018;2018;08;20;Torstai;10;33;43
624;16.08.2018;2018;08;21;Torstai;6;20;26
624;16.08.2018;2018;08;22;Torstai;6;16;22
624;16.08.2018;2018;08;23;Torstai;8;8;16
624;17.08.2018;2018;08;00;Perjantai;9;2;11
624;17.08.2018;2018;08;01;Perjantai;1;3;4
624;17.08.2018;2018;08;02;Perjantai;3;3;6
624;17.08.2018;2018;08;03;Perjantai;0;1;1
624;17.08.2018;2018;08;04;Perjantai;0;0;0
624;17.08.2018;2018;08;05;Perjantai;0;2;2
624;17.08.2018;2018;08;06;Perjantai;0;7;7
624;17.08.2018;2018;08;07;Perjantai;3;36;39
624;17.08.2018;2018;08;08;Perjantai;8;72;80
624;17.08.2018;2018;08;09;Perjantai;13;61;74
624;17.08.2018;2018;08;10;Perjantai;3;38;41
624;17.08.2018;2018;08;11;Perjantai;4;22;26
624;17.08.2018;2018;08;12;Perjantai;8;29;37
624;17.08.2018;2018;08;13;Perjantai;15;26;41
624;17.08.2018;2018;08;14;Perjantai;6;32;38
624;17.08.2018;2018;08;15;Perjantai;20;45;65
624;17.08.2018;2018;08;16;Perjantai;19;43;62
624;17.08.2018;2018;08;17;Perjantai;16;42;58
624;17.08.2018;2018;08;18;Perjantai;9;33;42
624;17.08.2018;2018;08;19;Perjantai;12;25;37
624;17.08.2018;2018;08;20;Perjantai;11;20;31
624;17.08.2018;2018;08;21;Perjantai;7;12;19
624;17.08.2018;2018;08;22;Perjantai;5;9;14
624;17.08.2018;2018;08;23;Perjantai;5;8;13
624;18.08.2018;2018;08;00;Lauantai;2;7;9
624;18.08.2018;2018;08;01;Lauantai;4;5;9
624;18.08.2018;2018;08;02;Lauantai;1;1;2
624;18.08.2018;2018;08;03;Lauantai;0;3;3
624;18.08.2018;2018;08;04;Lauantai;1;6;7
624;18.08.2018;2018;08;05;Lauantai;1;1;2
624;18.08.2018;2018;08;06;Lauantai;1;4;5
624;18.08.2018;2018;08;07;Lauantai;0;6;6
624;18.08.2018;2018;08;08;Lauantai;0;6;6
624;18.08.2018;2018;08;09;Lauantai;0;13;13
624;18.08.2018;2018;08;10;Lauantai;1;16;17
624;18.08.2018;2018;08;11;Lauantai;8;24;32
624;18.08.2018;2018;08;12;Lauantai;6;26;32
624;18.08.2018;2018;08;13;Lauantai;11;26;37
624;18.08.2018;2018;08;14;Lauantai;9;34;43
624;18.08.2018;2018;08;15;Lauantai;11;29;40
624;18.08.2018;2018;08;16;Lauantai;9;17;26
624;18.08.2018;2018;08;17;Lauantai;16;30;46
624;18.08.2018;2018;08;18;Lauantai;12;25;37
624;18.08.2018;2018;08;19;Lauantai;12;24;36
624;18.08.2018;2018;08;20;Lauantai;12;25;37
624;18.08.2018;2018;08;21;Lauantai;9;15;24
624;18.08.2018;2018;08;22;Lauantai;3;13;16
624;18.08.2018;2018;08;23;Lauantai;5;8;13
624;19.08.2018;2018;08;00;Sunnuntai;2;4;6
624;19.08.2018;2018;08;01;Sunnuntai;2;4;6
624;19.08.2018;2018;08;02;Sunnuntai;4;4;8
624;19.08.2018;2018;08;03;Sunnuntai;0;0;0
624;19.08.2018;2018;08;04;Sunnuntai;9;5;14
624;19.08.2018;2018;08;05;Sunnuntai;7;4;11
624;19.08.2018;2018;08;06;Sunnuntai;0;0;0
624;19.08.2018;2018;08;07;Sunnuntai;1;2;3
624;19.08.2018;2018;08;08;Sunnuntai;2;3;5
624;19.08.2018;2018;08;09;Sunnuntai;3;3;6
624;19.08.2018;2018;08;10;Sunnuntai;1;10;11
624;19.08.2018;2018;08;11;Sunnuntai;2;14;16
624;19.08.2018;2018;08;12;Sunnuntai;4;23;27
624;19.08.2018;2018;08;13;Sunnuntai;12;25;37
624;19.08.2018;2018;08;14;Sunnuntai;14;28;42
624;19.08.2018;2018;08;15;Sunnuntai;11;18;29
624;19.08.2018;2018;08;16;Sunnuntai;13;24;37
624;19.08.2018;2018;08;17;Sunnuntai;9;26;35
624;19.08.2018;2018;08;18;Sunnuntai;6;33;39
624;19.08.2018;2018;08;19;Sunnuntai;16;20;36
624;19.08.2018;2018;08;20;Sunnuntai;8;15;23
624;19.08.2018;2018;08;21;Sunnuntai;5;10;15
624;19.08.2018;2018;08;22;Sunnuntai;9;12;21
624;19.08.2018;2018;08;23;Sunnuntai;1;9;10
624;20.08.2018;2018;08;00;Maanantai;1;2;3
624;20.08.2018;2018;08;01;Maanantai;1;5;6
624;20.08.2018;2018;08;02;Maanantai;0;0;0
624;20.08.2018;2018;08;03;Maanantai;1;1;2
624;20.08.2018;2018;08;04;Maanantai;0;0;0
624;20.08.2018;2018;08;05;Maanantai;0;2;2
624;20.08.2018;2018;08;06;Maanantai;1;5;6
624;20.08.2018;2018;08;07;Maanantai;4;40;44
624;20.08.2018;2018;08;08;Maanantai;10;99;109
624;20.08.2018;2018;08;09;Maanantai;7;78;85
624;20.08.2018;2018;08;10;Maanantai;3;47;50
624;20.08.2018;2018;08;11;Maanantai;4;39;43
624;20.08.2018;2018;08;12;Maanantai;6;24;30
624;20.08.2018;2018;08;13;Maanantai;9;30;39
624;20.08.2018;2018;08;14;Maanantai;11;39;50
624;20.08.2018;2018;08;15;Maanantai;11;42;53
624;20.08.2018;2018;08;16;Maanantai;32;36;68
624;20.08.2018;2018;08;17;Maanantai;28;69;97
624;20.08.2018;2018;08;18;Maanantai;19;44;63
624;20.08.2018;2018;08;19;Maanantai;15;38;53
624;20.08.2018;2018;08;20;Maanantai;9;23;32
624;20.08.2018;2018;08;21;Maanantai;8;16;24
624;20.08.2018;2018;08;22;Maanantai;10;10;20
624;20.08.2018;2018;08;23;Maanantai;3;12;15
624;21.08.2018;2018;08;00;Tiistai;2;1;3
624;21.08.2018;2018;08;01;Tiistai;2;2;4
624;21.08.2018;2018;08;02;Tiistai;0;0;0
624;21.08.2018;2018;08;03;Tiistai;1;2;3
624;21.08.2018;2018;08;04;Tiistai;0;0;0
624;21.08.2018;2018;08;05;Tiistai;1;1;2
624;21.08.2018;2018;08;06;Tiistai;1;8;9
624;21.08.2018;2018;08;07;Tiistai;6;44;50
624;21.08.2018;2018;08;08;Tiistai;16;106;122
624;21.08.2018;2018;08;09;Tiistai;15;83;98
624;21.08.2018;2018;08;10;Tiistai;7;41;48
624;21.08.2018;2018;08;11;Tiistai;9;33;42
624;21.08.2018;2018;08;12;Tiistai;11;31;42
624;21.08.2018;2018;08;13;Tiistai;10;36;46
624;21.08.2018;2018;08;14;Tiistai;6;25;31
624;21.08.2018;2018;08;15;Tiistai;19;41;60
624;21.08.2018;2018;08;16;Tiistai;26;56;82
624;21.08.2018;2018;08;17;Tiistai;20;68;88
624;21.08.2018;2018;08;18;Tiistai;19;44;63
624;21.08.2018;2018;08;19;Tiistai;15;26;41
624;21.08.2018;2018;08;20;Tiistai;9;22;31
624;21.08.2018;2018;08;21;Tiistai;7;20;27
624;21.08.2018;2018;08;22;Tiistai;4;16;20
624;21.08.2018;2018;08;23;Tiistai;1;11;12
624;22.08.2018;2018;08;00;Keskiviikko;0;4;4
624;22.08.2018;2018;08;01;Keskiviikko;2;5;7
624;22.08.2018;2018;08;02;Keskiviikko;2;0;2
624;22.08.2018;2018;08;03;Keskiviikko;2;0;2
624;22.08.2018;2018;08;04;Keskiviikko;0;1;1
624;22.08.2018;2018;08;05;Keskiviikko;1;4;5
624;22.08.2018;2018;08;06;Keskiviikko;1;13;14
624;22.08.2018;2018;08;07;Keskiviikko;3;44;47
624;22.08.2018;2018;08;08;Keskiviikko;19;116;135
624;22.08.2018;2018;08;09;Keskiviikko;11;87;98
624;22.08.2018;2018;08;10;Keskiviikko;4;51;55
624;22.08.2018;2018;08;11;Keskiviikko;6;33;39
624;22.08.2018;2018;08;12;Keskiviikko;11;24;35
624;22.08.2018;2018;08;13;Keskiviikko;10;35;45
624;22.08.2018;2018;08;14;Keskiviikko;15;44;59
624;22.08.2018;2018;08;15;Keskiviikko;19;47;66
624;22.08.2018;2018;08;16;Keskiviikko;21;45;66
624;22.08.2018;2018;08;17;Keskiviikko;22;48;70
624;22.08.2018;2018;08;18;Keskiviikko;25;28;53
624;22.08.2018;2018;08;19;Keskiviikko;14;30;44
624;22.08.2018;2018;08;20;Keskiviikko;7;16;23
624;22.08.2018;2018;08;21;Keskiviikko;7;28;35
624;22.08.2018;2018;08;22;Keskiviikko;6;10;16
624;22.08.2018;2018;08;23;Keskiviikko;2;5;7
624;23.08.2018;2018;08;00;Torstai;4;1;5
624;23.08.2018;2018;08;01;Torstai;0;0;0
624;23.08.2018;2018;08;02;Torstai;0;3;3
624;23.08.2018;2018;08;03;Torstai;0;1;1
624;23.08.2018;2018;08;04;Torstai;0;1;1
624;23.08.2018;2018;08;05;Torstai;2;2;4
624;23.08.2018;2018;08;06;Torstai;2;9;11
624;23.08.2018;2018;08;07;Torstai;1;19;20
624;23.08.2018;2018;08;08;Torstai;8;71;79
624;23.08.2018;2018;08;09;Torstai;7;58;65
624;23.08.2018;2018;08;10;Torstai;6;16;22
624;23.08.2018;2018;08;11;Torstai;1;11;12
624;23.08.2018;2018;08;12;Torstai;4;7;11
624;23.08.2018;2018;08;13;Torstai;0;12;12
624;23.08.2018;2018;08;14;Torstai;14;22;36
624;23.08.2018;2018;08;15;Torstai;8;37;45
624;23.08.2018;2018;08;16;Torstai;14;38;52
624;23.08.2018;2018;08;17;Torstai;25;63;88
624;23.08.2018;2018;08;18;Torstai;14;43;57
624;23.08.2018;2018;08;19;Torstai;14;27;41
624;23.08.2018;2018;08;20;Torstai;6;16;22
624;23.08.2018;2018;08;21;Torstai;12;22;34
624;23.08.2018;2018;08;22;Torstai;5;3;8
624;23.08.2018;2018;08;23;Torstai;6;10;16
624;24.08.2018;2018;08;00;Perjantai;3;5;8
624;24.08.2018;2018;08;01;Perjantai;0;3;3
624;24.08.2018;2018;08;02;Perjantai;0;1;1
624;24.08.2018;2018;08;03;Perjantai;1;2;3
624;24.08.2018;2018;08;04;Perjantai;0;1;1
624;24.08.2018;2018;08;05;Perjantai;2;1;3
624;24.08.2018;2018;08;06;Perjantai;0;8;8
624;24.08.2018;2018;08;07;Perjantai;4;39;43
624;24.08.2018;2018;08;08;Perjantai;9;64;73
624;24.08.2018;2018;08;09;Perjantai;9;62;71
624;24.08.2018;2018;08;10;Perjantai;3;23;26
624;24.08.2018;2018;08;11;Perjantai;2;13;15
624;24.08.2018;2018;08;12;Perjantai;12;17;29
624;24.08.2018;2018;08;13;Perjantai;6;12;18
624;24.08.2018;2018;08;14;Perjantai;8;10;18
624;24.08.2018;2018;08;15;Perjantai;18;22;40
624;24.08.2018;2018;08;16;Perjantai;16;23;39
624;24.08.2018;2018;08;17;Perjantai;6;23;29
624;24.08.2018;2018;08;18;Perjantai;8;34;42
624;24.08.2018;2018;08;19;Perjantai;5;15;20
624;24.08.2018;2018;08;20;Perjantai;7;9;16
624;24.08.2018;2018;08;21;Perjantai;11;12;23
624;24.08.2018;2018;08;22;Perjantai;4;9;13
624;24.08.2018;2018;08;23;Perjantai;4;4;8
624;25.08.2018;2018;08;00;Lauantai;5;0;5
624;25.08.2018;2018;08;01;Lauantai;2;1;3
624;25.08.2018;2018;08;02;Lauantai;2;2;4
624;25.08.2018;2018;08;03;Lauantai;3;1;4
624;25.08.2018;2018;08;04;Lauantai;1;2;3
624;25.08.2018;2018;08;05;Lauantai;2;1;3
624;25.08.2018;2018;08;06;Lauantai;0;2;2
624;25.08.2018;2018;08;07;Lauantai;0;6;6
624;25.08.2018;2018;08;08;Lauantai;2;5;7
624;25.08.2018;2018;08;09;Lauantai;3;7;10
624;25.08.2018;2018;08;10;Lauantai;1;11;12
624;25.08.2018;2018;08;11;Lauantai;1;6;7
624;25.08.2018;2018;08;12;Lauantai;1;13;14
624;25.08.2018;2018;08;13;Lauantai;7;22;29
624;25.08.2018;2018;08;14;Lauantai;4;17;21
624;25.08.2018;2018;08;15;Lauantai;6;32;38
624;25.08.2018;2018;08;16;Lauantai;10;17;27
624;25.08.2018;2018;08;17;Lauantai;10;15;25
624;25.08.2018;2018;08;18;Lauantai;14;21;35
624;25.08.2018;2018;08;19;Lauantai;6;18;24
624;25.08.2018;2018;08;20;Lauantai;5;12;17
624;25.08.2018;2018;08;21;Lauantai;2;6;8
624;25.08.2018;2018;08;22;Lauantai;3;5;8
624;25.08.2018;2018;08;23;Lauantai;4;5;9
624;26.08.2018;2018;08;00;Sunnuntai;1;10;11
624;26.08.2018;2018;08;01;Sunnuntai;2;7;9
624;26.08.2018;2018;08;02;Sunnuntai;2;5;7
624;26.08.2018;2018;08;03;Sunnuntai;0;3;3
624;26.08.2018;2018;08;04;Sunnuntai;3;3;6
624;26.08.2018;2018;08;05;Sunnuntai;2;0;2
624;26.08.2018;2018;08;06;Sunnuntai;0;1;1
624;26.08.2018;2018;08;07;Sunnuntai;2;3;5
624;26.08.2018;2018;08;08;Sunnuntai;0;1;1
624;26.08.2018;2018;08;09;Sunnuntai;0;4;4
624;26.08.2018;2018;08;10;Sunnuntai;2;6;8
624;26.08.2018;2018;08;11;Sunnuntai;2;10;12
624;26.08.2018;2018;08;12;Sunnuntai;2;26;28
624;26.08.2018;2018;08;13;Sunnuntai;10;19;29
624;26.08.2018;2018;08;14;Sunnuntai;10;28;38
624;26.08.2018;2018;08;15;Sunnuntai;7;23;30
624;26.08.2018;2018;08;16;Sunnuntai;12;17;29
624;26.08.2018;2018;08;17;Sunnuntai;1;5;6
624;26.08.2018;2018;08;18;Sunnuntai;4;13;17
624;26.08.2018;2018;08;19;Sunnuntai;10;13;23
624;26.08.2018;2018;08;20;Sunnuntai;7;8;15
624;26.08.2018;2018;08;21;Sunnuntai;6;6;12
624;26.08.2018;2018;08;22;Sunnuntai;5;7;12
624;26.08.2018;2018;08;23;Sunnuntai;1;0;1
624;27.08.2018;2018;08;00;Maanantai;0;1;1
624;27.08.2018;2018;08;01;Maanantai;0;0;0
624;27.08.2018;2018;08;02;Maanantai;1;0;1
624;27.08.2018;2018;08;03;Maanantai;0;1;1
624;27.08.2018;2018;08;04;Maanantai;0;3;3
624;27.08.2018;2018;08;05;Maanantai;1;1;2
624;27.08.2018;2018;08;06;Maanantai;0;9;9
624;27.08.2018;2018;08;07;Maanantai;5;34;39
624;27.08.2018;2018;08;08;Maanantai;17;81;98
624;27.08.2018;2018;08;09;Maanantai;7;88;95
624;27.08.2018;2018;08;10;Maanantai;6;44;50
624;27.08.2018;2018;08;11;Maanantai;6;31;37
624;27.08.2018;2018;08;12;Maanantai;11;32;43
624;27.08.2018;2018;08;13;Maanantai;7;12;19
624;27.08.2018;2018;08;14;Maanantai;6;18;24
624;27.08.2018;2018;08;15;Maanantai;18;32;50
624;27.08.2018;2018;08;16;Maanantai;24;40;64
624;27.08.2018;2018;08;17;Maanantai;31;58;89
624;27.08.2018;2018;08;18;Maanantai;16;43;59
624;27.08.2018;2018;08;19;Maanantai;15;33;48
624;27.08.2018;2018;08;20;Maanantai;15;30;45
624;27.08.2018;2018;08;21;Maanantai;12;19;31
624;27.08.2018;2018;08;22;Maanantai;9;7;16
624;27.08.2018;2018;08;23;Maanantai;6;6;12
624;28.08.2018;2018;08;00;Tiistai;1;0;1
624;28.08.2018;2018;08;01;Tiistai;0;1;1
624;28.08.2018;2018;08;02;Tiistai;0;1;1
624;28.08.2018;2018;08;03;Tiistai;0;0;0
624;28.08.2018;2018;08;04;Tiistai;0;1;1
624;28.08.2018;2018;08;05;Tiistai;0;1;1
624;28.08.2018;2018;08;06;Tiistai;0;7;7
624;28.08.2018;2018;08;07;Tiistai;1;49;50
624;28.08.2018;2018;08;08;Tiistai;10;113;123
624;28.08.2018;2018;08;09;Tiistai;15;88;103
624;28.08.2018;2018;08;10;Tiistai;7;47;54
624;28.08.2018;2018;08;11;Tiistai;4;42;46
624;28.08.2018;2018;08;12;Tiistai;8;33;41
624;28.08.2018;2018;08;13;Tiistai;10;33;43
624;28.08.2018;2018;08;14;Tiistai;10;45;55
624;28.08.2018;2018;08;15;Tiistai;16;40;56
624;28.08.2018;2018;08;16;Tiistai;24;44;68
624;28.08.2018;2018;08;17;Tiistai;26;61;87
624;28.08.2018;2018;08;18;Tiistai;13;38;51
624;28.08.2018;2018;08;19;Tiistai;14;32;46
624;28.08.2018;2018;08;20;Tiistai;10;25;35
624;28.08.2018;2018;08;21;Tiistai;6;21;27
624;28.08.2018;2018;08;22;Tiistai;7;15;22
624;28.08.2018;2018;08;23;Tiistai;2;9;11
624;29.08.2018;2018;08;00;Keskiviikko;1;2;3
624;29.08.2018;2018;08;01;Keskiviikko;0;0;0
624;29.08.2018;2018;08;02;Keskiviikko;0;0;0
624;29.08.2018;2018;08;03;Keskiviikko;1;1;2
624;29.08.2018;2018;08;04;Keskiviikko;0;0;0
624;29.08.2018;2018;08;05;Keskiviikko;0;1;1
624;29.08.2018;2018;08;06;Keskiviikko;2;8;10
624;29.08.2018;2018;08;07;Keskiviikko;3;42;45
624;29.08.2018;2018;08;08;Keskiviikko;12;115;127
624;29.08.2018;2018;08;09;Keskiviikko;13;100;113
624;29.08.2018;2018;08;10;Keskiviikko;2;22;24
624;29.08.2018;2018;08;11;Keskiviikko;6;58;64
624;29.08.2018;2018;08;12;Keskiviikko;3;27;30
624;29.08.2018;2018;08;13;Keskiviikko;13;33;46
624;29.08.2018;2018;08;14;Keskiviikko;11;35;46
624;29.08.2018;2018;08;15;Keskiviikko;12;31;43
624;29.08.2018;2018;08;16;Keskiviikko;16;36;52
624;29.08.2018;2018;08;17;Keskiviikko;32;79;111
624;29.08.2018;2018;08;18;Keskiviikko;22;37;59
624;29.08.2018;2018;08;19;Keskiviikko;20;28;48
624;29.08.2018;2018;08;20;Keskiviikko;8;30;38
624;29.08.2018;2018;08;21;Keskiviikko;13;11;24
624;29.08.2018;2018;08;22;Keskiviikko;7;8;15
624;29.08.2018;2018;08;23;Keskiviikko;5;11;16
624;30.08.2018;2018;08;00;Torstai;1;4;5
624;30.08.2018;2018;08;01;Torstai;0;0;0
624;30.08.2018;2018;08;02;Torstai;0;2;2
624;30.08.2018;2018;08;03;Torstai;0;1;1
624;30.08.2018;2018;08;04;Torstai;0;1;1
624;30.08.2018;2018;08;05;Torstai;0;2;2
624;30.08.2018;2018;08;06;Torstai;1;5;6
624;30.08.2018;2018;08;07;Torstai;3;44;47
624;30.08.2018;2018;08;08;Torstai;14;94;108
624;30.08.2018;2018;08;09;Torstai;14;88;102
624;30.08.2018;2018;08;10;Torstai;5;34;39
624;30.08.2018;2018;08;11;Torstai;3;23;26
624;30.08.2018;2018;08;12;Torstai;8;31;39
624;30.08.2018;2018;08;13;Torstai;8;34;42
624;30.08.2018;2018;08;14;Torstai;8;36;44
624;30.08.2018;2018;08;15;Torstai;16;28;44
624;30.08.2018;2018;08;16;Torstai;17;46;63
624;30.08.2018;2018;08;17;Torstai;23;48;71
624;30.08.2018;2018;08;18;Torstai;19;36;55
624;30.08.2018;2018;08;19;Torstai;9;25;34
624;30.08.2018;2018;08;20;Torstai;13;24;37
624;30.08.2018;2018;08;21;Torstai;11;20;31
624;30.08.2018;2018;08;22;Torstai;11;12;23
624;30.08.2018;2018;08;23;Torstai;6;9;15
624;31.08.2018;2018;08;00;Perjantai;1;2;3
624;31.08.2018;2018;08;01;Perjantai;1;1;2
624;31.08.2018;2018;08;02;Perjantai;1;3;4
624;31.08.2018;2018;08;03;Perjantai;1;1;2
624;31.08.2018;2018;08;04;Perjantai;1;1;2
624;31.08.2018;2018;08;05;Perjantai;0;2;2
624;31.08.2018;2018;08;06;Perjantai;2;7;9
624;31.08.2018;2018;08;07;Perjantai;2;43;45
624;31.08.2018;2018;08;08;Perjantai;14;85;99
624;31.08.2018;2018;08;09;Perjantai;14;68;82
624;31.08.2018;2018;08;10;Perjantai;6;38;44
624;31.08.2018;2018;08;11;Perjantai;1;22;23
624;31.08.2018;2018;08;12;Perjantai;11;33;44
624;31.08.2018;2018;08;13;Perjantai;4;21;25
624;31.08.2018;2018;08;14;Perjantai;8;31;39
624;31.08.2018;2018;08;15;Perjantai;10;39;49
624;31.08.2018;2018;08;16;Perjantai;22;42;64
624;31.08.2018;2018;08;17;Perjantai;15;55;70
624;31.08.2018;2018;08;18;Perjantai;11;44;55
624;31.08.2018;2018;08;19;Perjantai;8;31;39
624;31.08.2018;2018;08;20;Perjantai;9;15;24
624;31.08.2018;2018;08;21;Perjantai;8;13;21
624;31.08.2018;2018;08;22;Perjantai;4;7;11
624;31.08.2018;2018;08;23;Perjantai;9;4;13
624;01.09.2018;2018;09;00;Lauantai;6;1;7
624;01.09.2018;2018;09;01;Lauantai;5;6;11
624;01.09.2018;2018;09;02;Lauantai;1;3;4
624;01.09.2018;2018;09;03;Lauantai;1;0;1
624;01.09.2018;2018;09;04;Lauantai;1;3;4
624;01.09.2018;2018;09;05;Lauantai;0;1;1
624;01.09.2018;2018;09;06;Lauantai;0;2;2
624;01.09.2018;2018;09;07;Lauantai;0;5;5
624;01.09.2018;2018;09;08;Lauantai;0;8;8
624;01.09.2018;2018;09;09;Lauantai;2;9;11
624;01.09.2018;2018;09;10;Lauantai;2;17;19
624;01.09.2018;2018;09;11;Lauantai;1;15;16
624;01.09.2018;2018;09;12;Lauantai;3;25;28
624;01.09.2018;2018;09;13;Lauantai;10;23;33
624;01.09.2018;2018;09;14;Lauantai;12;29;41
624;01.09.2018;2018;09;15;Lauantai;8;37;45
624;01.09.2018;2018;09;16;Lauantai;12;31;43
624;01.09.2018;2018;09;17;Lauantai;12;22;34
624;01.09.2018;2018;09;18;Lauantai;12;17;29
624;01.09.2018;2018;09;19;Lauantai;14;13;27
624;01.09.2018;2018;09;20;Lauantai;7;13;20
624;01.09.2018;2018;09;21;Lauantai;7;14;21
624;01.09.2018;2018;09;22;Lauantai;8;6;14
624;01.09.2018;2018;09;23;Lauantai;7;9;16
624;02.09.2018;2018;09;00;Sunnuntai;1;7;8
624;02.09.2018;2018;09;01;Sunnuntai;3;6;9
624;02.09.2018;2018;09;02;Sunnuntai;1;5;6
624;02.09.2018;2018;09;03;Sunnuntai;1;1;2
624;02.09.2018;2018;09;04;Sunnuntai;0;1;1
624;02.09.2018;2018;09;05;Sunnuntai;2;1;3
624;02.09.2018;2018;09;06;Sunnuntai;2;0;2
624;02.09.2018;2018;09;07;Sunnuntai;0;0;0
624;02.09.2018;2018;09;08;Sunnuntai;4;3;7
624;02.09.2018;2018;09;09;Sunnuntai;0;3;3
624;02.09.2018;2018;09;10;Sunnuntai;2;11;13
624;02.09.2018;2018;09;11;Sunnuntai;3;16;19
624;02.09.2018;2018;09;12;Sunnuntai;7;20;27
624;02.09.2018;2018;09;13;Sunnuntai;10;38;48
624;02.09.2018;2018;09;14;Sunnuntai;7;38;45
624;02.09.2018;2018;09;15;Sunnuntai;14;16;30
624;02.09.2018;2018;09;16;Sunnuntai;18;29;47
624;02.09.2018;2018;09;17;Sunnuntai;11;42;53
624;02.09.2018;2018;09;18;Sunnuntai;16;38;54
624;02.09.2018;2018;09;19;Sunnuntai;17;30;47
624;02.09.2018;2018;09;20;Sunnuntai;8;21;29
624;02.09.2018;2018;09;21;Sunnuntai;4;19;23
624;02.09.2018;2018;09;22;Sunnuntai;2;3;5
624;02.09.2018;2018;09;23;Sunnuntai;0;0;0
624;03.09.2018;2018;09;00;Maanantai;0;1;1
624;03.09.2018;2018;09;01;Maanantai;0;4;4
624;03.09.2018;2018;09;02;Maanantai;0;1;1
624;03.09.2018;2018;09;03;Maanantai;0;1;1
624;03.09.2018;2018;09;04;Maanantai;0;1;1
624;03.09.2018;2018;09;05;Maanantai;0;2;2
624;03.09.2018;2018;09;06;Maanantai;0;8;8
624;03.09.2018;2018;09;07;Maanantai;0;50;50
624;03.09.2018;2018;09;08;Maanantai;0;118;118
624;03.09.2018;2018;09;09;Maanantai;0;82;82
624;03.09.2018;2018;09;10;Maanantai;6;42;48
624;03.09.2018;2018;09;11;Maanantai;8;49;57
624;03.09.2018;2018;09;12;Maanantai;11;44;55
624;03.09.2018;2018;09;13;Maanantai;14;51;65
624;03.09.2018;2018;09;14;Maanantai;10;51;61
624;03.09.2018;2018;09;15;Maanantai;18;27;45
624;03.09.2018;2018;09;16;Maanantai;26;67;93
624;03.09.2018;2018;09;17;Maanantai;29;64;93
624;03.09.2018;2018;09;18;Maanantai;22;56;78
624;03.09.2018;2018;09;19;Maanantai;23;44;67
624;03.09.2018;2018;09;20;Maanantai;20;31;51
624;03.09.2018;2018;09;21;Maanantai;21;19;40
624;03.09.2018;2018;09;22;Maanantai;12;13;25
624;03.09.2018;2018;09;23;Maanantai;5;14;19
624;04.09.2018;2018;09;00;Tiistai;4;1;5
624;04.09.2018;2018;09;01;Tiistai;1;4;5
624;04.09.2018;2018;09;02;Tiistai;0;1;1
624;04.09.2018;2018;09;03;Tiistai;1;1;2
624;04.09.2018;2018;09;04;Tiistai;0;1;1
624;04.09.2018;2018;09;05;Tiistai;0;2;2
624;04.09.2018;2018;09;06;Tiistai;0;8;8
624;04.09.2018;2018;09;07;Tiistai;3;50;53
624;04.09.2018;2018;09;08;Tiistai;28;118;146
624;04.09.2018;2018;09;09;Tiistai;7;82;89
624;04.09.2018;2018;09;10;Tiistai;17;42;59
624;04.09.2018;2018;09;11;Tiistai;13;44;57
624;04.09.2018;2018;09;12;Tiistai;3;29;32
624;04.09.2018;2018;09;13;Tiistai;9;45;54
624;04.09.2018;2018;09;14;Tiistai;17;43;60
624;04.09.2018;2018;09;15;Tiistai;16;42;58
624;04.09.2018;2018;09;16;Tiistai;37;74;111
624;04.09.2018;2018;09;17;Tiistai;36;103;139
624;04.09.2018;2018;09;18;Tiistai;31;69;100
624;04.09.2018;2018;09;19;Tiistai;19;53;72
624;04.09.2018;2018;09;20;Tiistai;12;32;44
624;04.09.2018;2018;09;21;Tiistai;12;22;34
624;04.09.2018;2018;09;22;Tiistai;15;21;36
624;04.09.2018;2018;09;23;Tiistai;13;13;26
624;05.09.2018;2018;09;00;Keskiviikko;5;5;10
624;05.09.2018;2018;09;01;Keskiviikko;3;4;7
624;05.09.2018;2018;09;02;Keskiviikko;0;1;1
624;05.09.2018;2018;09;03;Keskiviikko;0;3;3
624;05.09.2018;2018;09;04;Keskiviikko;0;2;2
624;05.09.2018;2018;09;05;Keskiviikko;2;4;6
624;05.09.2018;2018;09;06;Keskiviikko;1;15;16
624;05.09.2018;2018;09;07;Keskiviikko;6;42;48
624;05.09.2018;2018;09;08;Keskiviikko;2;60;62
624;05.09.2018;2018;09;09;Keskiviikko;17;105;122
624;05.09.2018;2018;09;10;Keskiviikko;16;61;77
624;05.09.2018;2018;09;11;Keskiviikko;14;44;58
624;05.09.2018;2018;09;12;Keskiviikko;8;31;39
624;05.09.2018;2018;09;13;Keskiviikko;9;46;55
624;05.09.2018;2018;09;14;Keskiviikko;24;37;61
624;05.09.2018;2018;09;15;Keskiviikko;16;39;55
624;05.09.2018;2018;09;16;Keskiviikko;21;52;73
624;05.09.2018;2018;09;17;Keskiviikko;18;77;95
624;05.09.2018;2018;09;18;Keskiviikko;21;40;61
624;05.09.2018;2018;09;19;Keskiviikko;12;49;61
624;05.09.2018;2018;09;20;Keskiviikko;20;30;50
624;05.09.2018;2018;09;21;Keskiviikko;15;23;38
624;05.09.2018;2018;09;22;Keskiviikko;12;23;35
624;05.09.2018;2018;09;23;Keskiviikko;4;9;13
624;06.09.2018;2018;09;00;Torstai;1;2;3
624;06.09.2018;2018;09;01;Torstai;3;3;6
624;06.09.2018;2018;09;02;Torstai;0;0;0
624;06.09.2018;2018;09;03;Torstai;0;2;2
624;06.09.2018;2018;09;04;Torstai;1;1;2
624;06.09.2018;2018;09;05;Torstai;1;2;3
624;06.09.2018;2018;09;06;Torstai;3;11;14
624;06.09.2018;2018;09;07;Torstai;6;51;57
624;06.09.2018;2018;09;08;Torstai;6;71;77
624;06.09.2018;2018;09;09;Torstai;10;82;92
624;06.09.2018;2018;09;10;Torstai;15;49;64
624;06.09.2018;2018;09;11;Torstai;0;30;30
624;06.09.2018;2018;09;12;Torstai;12;26;38
624;06.09.2018;2018;09;13;Torstai;5;46;51
624;06.09.2018;2018;09;14;Torstai;18;40;58
624;06.09.2018;2018;09;15;Torstai;22;38;60
624;06.09.2018;2018;09;16;Torstai;29;53;82
624;06.09.2018;2018;09;17;Torstai;23;71;94
624;06.09.2018;2018;09;18;Torstai;19;42;61
624;06.09.2018;2018;09;19;Torstai;20;51;71
624;06.09.2018;2018;09;20;Torstai;13;32;45
624;06.09.2018;2018;09;21;Torstai;19;16;35
624;06.09.2018;2018;09;22;Torstai;4;21;25
624;06.09.2018;2018;09;23;Torstai;5;16;21
624;07.09.2018;2018;09;00;Perjantai;2;3;5
624;07.09.2018;2018;09;01;Perjantai;8;3;11
624;07.09.2018;2018;09;02;Perjantai;4;0;4
624;07.09.2018;2018;09;03;Perjantai;2;2;4
624;07.09.2018;2018;09;04;Perjantai;3;1;4
624;07.09.2018;2018;09;05;Perjantai;1;1;2
624;07.09.2018;2018;09;06;Perjantai;2;7;9
624;07.09.2018;2018;09;07;Perjantai;5;26;31
624;07.09.2018;2018;09;08;Perjantai;13;92;105
624;07.09.2018;2018;09;09;Perjantai;7;81;88
624;07.09.2018;2018;09;10;Perjantai;2;43;45
624;07.09.2018;2018;09;11;Perjantai;6;23;29
624;07.09.2018;2018;09;12;Perjantai;14;47;61
624;07.09.2018;2018;09;13;Perjantai;6;34;40
624;07.09.2018;2018;09;14;Perjantai;10;27;37
624;07.09.2018;2018;09;15;Perjantai;21;54;75
624;07.09.2018;2018;09;16;Perjantai;35;46;81
624;07.09.2018;2018;09;17;Perjantai;23;51;74
624;07.09.2018;2018;09;18;Perjantai;22;36;58
624;07.09.2018;2018;09;19;Perjantai;6;28;34
624;07.09.2018;2018;09;20;Perjantai;14;34;48
624;07.09.2018;2018;09;21;Perjantai;12;13;25
624;07.09.2018;2018;09;22;Perjantai;17;20;37
624;07.09.2018;2018;09;23;Perjantai;9;8;17
624;08.09.2018;2018;09;00;Lauantai;3;5;8
624;08.09.2018;2018;09;01;Lauantai;4;4;8
624;08.09.2018;2018;09;02;Lauantai;3;3;6
624;08.09.2018;2018;09;03;Lauantai;1;3;4
624;08.09.2018;2018;09;04;Lauantai;3;0;3
624;08.09.2018;2018;09;05;Lauantai;1;1;2
624;08.09.2018;2018;09;06;Lauantai;0;1;1
624;08.09.2018;2018;09;07;Lauantai;0;11;11
624;08.09.2018;2018;09;08;Lauantai;0;5;5
624;08.09.2018;2018;09;09;Lauantai;3;10;13
624;08.09.2018;2018;09;10;Lauantai;2;24;26
624;08.09.2018;2018;09;11;Lauantai;7;21;28
624;08.09.2018;2018;09;12;Lauantai;9;33;42
624;08.09.2018;2018;09;13;Lauantai;9;34;43
624;08.09.2018;2018;09;14;Lauantai;12;36;48
624;08.09.2018;2018;09;15;Lauantai;12;27;39
624;08.09.2018;2018;09;16;Lauantai;9;33;42
624;08.09.2018;2018;09;17;Lauantai;8;24;32
624;08.09.2018;2018;09;18;Lauantai;9;24;33
624;08.09.2018;2018;09;19;Lauantai;15;25;40
624;08.09.2018;2018;09;20;Lauantai;7;18;25
624;08.09.2018;2018;09;21;Lauantai;7;27;34
624;08.09.2018;2018;09;22;Lauantai;8;10;18
624;08.09.2018;2018;09;23;Lauantai;3;8;11
624;09.09.2018;2018;09;00;Sunnuntai;9;9;18
624;09.09.2018;2018;09;01;Sunnuntai;5;7;12
624;09.09.2018;2018;09;02;Sunnuntai;2;8;10
624;09.09.2018;2018;09;03;Sunnuntai;2;0;2
624;09.09.2018;2018;09;04;Sunnuntai;6;3;9
624;09.09.2018;2018;09;05;Sunnuntai;2;1;3
624;09.09.2018;2018;09;06;Sunnuntai;0;0;0
624;09.09.2018;2018;09;07;Sunnuntai;1;6;7
624;09.09.2018;2018;09;08;Sunnuntai;0;5;5
624;09.09.2018;2018;09;09;Sunnuntai;0;2;2
624;09.09.2018;2018;09;10;Sunnuntai;4;8;12
624;09.09.2018;2018;09;11;Sunnuntai;4;14;18
624;09.09.2018;2018;09;12;Sunnuntai;2;20;22
624;09.09.2018;2018;09;13;Sunnuntai;5;26;31
624;09.09.2018;2018;09;14;Sunnuntai;12;29;41
624;09.09.2018;2018;09;15;Sunnuntai;6;25;31
624;09.09.2018;2018;09;16;Sunnuntai;14;19;33
624;09.09.2018;2018;09;17;Sunnuntai;7;20;27
624;09.09.2018;2018;09;18;Sunnuntai;20;29;49
624;09.09.2018;2018;09;19;Sunnuntai;13;32;45
624;09.09.2018;2018;09;20;Sunnuntai;8;19;27
624;09.09.2018;2018;09;21;Sunnuntai;10;10;20
624;09.09.2018;2018;09;22;Sunnuntai;11;6;17
624;09.09.2018;2018;09;23;Sunnuntai;3;5;8
624;10.09.2018;2018;09;00;Maanantai;1;5;6
624;10.09.2018;2018;09;01;Maanantai;1;0;1
624;10.09.2018;2018;09;02;Maanantai;0;1;1
624;10.09.2018;2018;09;03;Maanantai;1;0;1
624;10.09.2018;2018;09;04;Maanantai;1;2;3
624;10.09.2018;2018;09;05;Maanantai;1;2;3
624;10.09.2018;2018;09;06;Maanantai;0;9;9
624;10.09.2018;2018;09;07;Maanantai;3;34;37
624;10.09.2018;2018;09;08;Maanantai;14;107;121
624;10.09.2018;2018;09;09;Maanantai;7;81;88
624;10.09.2018;2018;09;10;Maanantai;9;60;69
624;10.09.2018;2018;09;11;Maanantai;5;44;49
624;10.09.2018;2018;09;12;Maanantai;9;24;33
624;10.09.2018;2018;09;13;Maanantai;9;54;63
624;10.09.2018;2018;09;14;Maanantai;11;35;46
624;10.09.2018;2018;09;15;Maanantai;13;57;70
624;10.09.2018;2018;09;16;Maanantai;24;46;70
624;10.09.2018;2018;09;17;Maanantai;31;67;98
624;10.09.2018;2018;09;18;Maanantai;13;56;69
624;10.09.2018;2018;09;19;Maanantai;17;43;60
624;10.09.2018;2018;09;20;Maanantai;16;34;50
624;10.09.2018;2018;09;21;Maanantai;21;23;44
624;10.09.2018;2018;09;22;Maanantai;20;14;34
624;10.09.2018;2018;09;23;Maanantai;3;11;14
624;11.09.2018;2018;09;00;Tiistai;2;3;5
624;11.09.2018;2018;09;01;Tiistai;0;3;3
624;11.09.2018;2018;09;02;Tiistai;0;2;2
624;11.09.2018;2018;09;03;Tiistai;0;0;0
624;11.09.2018;2018;09;04;Tiistai;0;2;2
624;11.09.2018;2018;09;05;Tiistai;0;1;1
624;11.09.2018;2018;09;06;Tiistai;1;9;10
624;11.09.2018;2018;09;07;Tiistai;3;29;32
624;11.09.2018;2018;09;08;Tiistai;17;114;131
624;11.09.2018;2018;09;09;Tiistai;16;97;113
624;11.09.2018;2018;09;10;Tiistai;6;41;47
624;11.09.2018;2018;09;11;Tiistai;9;29;38
624;11.09.2018;2018;09;12;Tiistai;8;27;35
624;11.09.2018;2018;09;13;Tiistai;4;35;39
624;11.09.2018;2018;09;14;Tiistai;14;27;41
624;11.09.2018;2018;09;15;Tiistai;18;45;63
624;11.09.2018;2018;09;16;Tiistai;24;36;60
624;11.09.2018;2018;09;17;Tiistai;18;64;82
624;11.09.2018;2018;09;18;Tiistai;18;20;38
624;11.09.2018;2018;09;19;Tiistai;13;15;28
624;11.09.2018;2018;09;20;Tiistai;7;9;16
624;11.09.2018;2018;09;21;Tiistai;11;4;15
624;11.09.2018;2018;09;22;Tiistai;8;6;14
624;11.09.2018;2018;09;23;Tiistai;2;10;12
624;12.09.2018;2018;09;00;Keskiviikko;2;3;5
624;12.09.2018;2018;09;01;Keskiviikko;3;4;7
624;12.09.2018;2018;09;02;Keskiviikko;0;1;1
624;12.09.2018;2018;09;03;Keskiviikko;0;0;0
624;12.09.2018;2018;09;04;Keskiviikko;0;0;0
624;12.09.2018;2018;09;05;Keskiviikko;0;1;1
624;12.09.2018;2018;09;06;Keskiviikko;1;5;6
624;12.09.2018;2018;09;07;Keskiviikko;6;26;32
624;12.09.2018;2018;09;08;Keskiviikko;13;69;82
624;12.09.2018;2018;09;09;Keskiviikko;15;79;94
624;12.09.2018;2018;09;10;Keskiviikko;5;36;41
624;12.09.2018;2018;09;11;Keskiviikko;4;15;19
624;12.09.2018;2018;09;12;Keskiviikko;8;21;29
624;12.09.2018;2018;09;13;Keskiviikko;8;24;32
624;12.09.2018;2018;09;14;Keskiviikko;17;14;31
624;12.09.2018;2018;09;15;Keskiviikko;20;24;44
624;12.09.2018;2018;09;16;Keskiviikko;21;28;49
624;12.09.2018;2018;09;17;Keskiviikko;28;48;76
624;12.09.2018;2018;09;18;Keskiviikko;14;24;38
624;12.09.2018;2018;09;19;Keskiviikko;17;20;37
624;12.09.2018;2018;09;20;Keskiviikko;11;16;27
624;12.09.2018;2018;09;21;Keskiviikko;6;11;17
624;12.09.2018;2018;09;22;Keskiviikko;8;10;18
624;12.09.2018;2018;09;23;Keskiviikko;7;10;17
624;13.09.2018;2018;09;00;Torstai;2;7;9
624;13.09.2018;2018;09;01;Torstai;4;2;6
624;13.09.2018;2018;09;02;Torstai;2;1;3
624;13.09.2018;2018;09;03;Torstai;2;1;3
624;13.09.2018;2018;09;04;Torstai;2;1;3
624;13.09.2018;2018;09;05;Torstai;0;0;0
624;13.09.2018;2018;09;06;Torstai;2;7;9
624;13.09.2018;2018;09;07;Torstai;4;26;30
624;13.09.2018;2018;09;08;Torstai;12;101;113
624;13.09.2018;2018;09;09;Torstai;16;95;111
624;13.09.2018;2018;09;10;Torstai;10;47;57
624;13.09.2018;2018;09;11;Torstai;6;16;22
624;13.09.2018;2018;09;12;Torstai;9;35;44
624;13.09.2018;2018;09;13;Torstai;8;30;38
624;13.09.2018;2018;09;14;Torstai;9;46;55
624;13.09.2018;2018;09;15;Torstai;19;46;65
624;13.09.2018;2018;09;16;Torstai;19;46;65
624;13.09.2018;2018;09;17;Torstai;25;57;82
624;13.09.2018;2018;09;18;Torstai;16;35;51
624;13.09.2018;2018;09;19;Torstai;9;31;40
624;13.09.2018;2018;09;20;Torstai;18;26;44
624;13.09.2018;2018;09;21;Torstai;9;19;28
624;13.09.2018;2018;09;22;Torstai;12;11;23
624;13.09.2018;2018;09;23;Torstai;2;7;9
624;14.09.2018;2018;09;00;Perjantai;3;4;7
624;14.09.2018;2018;09;01;Perjantai;2;3;5
624;14.09.2018;2018;09;02;Perjantai;1;3;4
624;14.09.2018;2018;09;03;Perjantai;0;0;0
624;14.09.2018;2018;09;04;Perjantai;0;1;1
624;14.09.2018;2018;09;05;Perjantai;0;3;3
624;14.09.2018;2018;09;06;Perjantai;3;8;11
624;14.09.2018;2018;09;07;Perjantai;3;36;39
624;14.09.2018;2018;09;08;Perjantai;10;92;102
624;14.09.2018;2018;09;09;Perjantai;7;75;82
624;14.09.2018;2018;09;10;Perjantai;10;52;62
624;14.09.2018;2018;09;11;Perjantai;4;20;24
624;14.09.2018;2018;09;12;Perjantai;19;45;64
624;14.09.2018;2018;09;13;Perjantai;12;41;53
624;14.09.2018;2018;09;14;Perjantai;22;36;58
624;14.09.2018;2018;09;15;Perjantai;18;38;56
624;14.09.2018;2018;09;16;Perjantai;16;45;61
624;14.09.2018;2018;09;17;Perjantai;13;42;55
624;14.09.2018;2018;09;18;Perjantai;12;22;34
624;14.09.2018;2018;09;19;Perjantai;8;25;33
624;14.09.2018;2018;09;20;Perjantai;7;13;20
624;14.09.2018;2018;09;21;Perjantai;6;14;20
624;14.09.2018;2018;09;22;Perjantai;7;10;17
624;14.09.2018;2018;09;23;Perjantai;2;6;8
624;15.09.2018;2018;09;00;Lauantai;2;8;10
624;15.09.2018;2018;09;01;Lauantai;2;2;4
624;15.09.2018;2018;09;02;Lauantai;0;4;4
624;15.09.2018;2018;09;03;Lauantai;3;1;4
624;15.09.2018;2018;09;04;Lauantai;1;1;2
624;15.09.2018;2018;09;05;Lauantai;3;2;5
624;15.09.2018;2018;09;06;Lauantai;0;1;1
624;15.09.2018;2018;09;07;Lauantai;0;4;4
624;15.09.2018;2018;09;08;Lauantai;0;10;10
624;15.09.2018;2018;09;09;Lauantai;3;9;12
624;15.09.2018;2018;09;10;Lauantai;6;18;24
624;15.09.2018;2018;09;11;Lauantai;3;30;33
624;15.09.2018;2018;09;12;Lauantai;16;30;46
624;15.09.2018;2018;09;13;Lauantai;6;24;30
624;15.09.2018;2018;09;14;Lauantai;12;8;20
624;15.09.2018;2018;09;15;Lauantai;8;5;13
624;15.09.2018;2018;09;16;Lauantai;5;10;15
624;15.09.2018;2018;09;17;Lauantai;6;23;29
624;15.09.2018;2018;09;18;Lauantai;10;19;29
624;15.09.2018;2018;09;19;Lauantai;4;17;21
624;15.09.2018;2018;09;20;Lauantai;6;12;18
624;15.09.2018;2018;09;21;Lauantai;8;9;17
624;15.09.2018;2018;09;22;Lauantai;3;2;5
624;15.09.2018;2018;09;23;Lauantai;5;6;11
624;16.09.2018;2018;09;00;Sunnuntai;0;1;1
624;16.09.2018;2018;09;01;Sunnuntai;3;3;6
624;16.09.2018;2018;09;02;Sunnuntai;0;1;1
624;16.09.2018;2018;09;03;Sunnuntai;3;1;4
624;16.09.2018;2018;09;04;Sunnuntai;1;1;2
624;16.09.2018;2018;09;05;Sunnuntai;0;0;0
624;16.09.2018;2018;09;06;Sunnuntai;2;4;6
624;16.09.2018;2018;09;07;Sunnuntai;2;4;6
624;16.09.2018;2018;09;08;Sunnuntai;5;4;9
624;16.09.2018;2018;09;09;Sunnuntai;0;3;3
624;16.09.2018;2018;09;10;Sunnuntai;1;11;12
624;16.09.2018;2018;09;11;Sunnuntai;4;25;29
624;16.09.2018;2018;09;12;Sunnuntai;10;33;43
624;16.09.2018;2018;09;13;Sunnuntai;9;34;43
624;16.09.2018;2018;09;14;Sunnuntai;11;19;30
624;16.09.2018;2018;09;15;Sunnuntai;11;23;34
624;16.09.2018;2018;09;16;Sunnuntai;7;30;37
624;16.09.2018;2018;09;17;Sunnuntai;8;29;37
624;16.09.2018;2018;09;18;Sunnuntai;8;24;32
624;16.09.2018;2018;09;19;Sunnuntai;8;17;25
624;16.09.2018;2018;09;20;Sunnuntai;3;16;19
624;16.09.2018;2018;09;21;Sunnuntai;8;10;18
624;16.09.2018;2018;09;22;Sunnuntai;8;7;15
624;16.09.2018;2018;09;23;Sunnuntai;5;0;5
624;17.09.2018;2018;09;00;Maanantai;1;1;2
624;17.09.2018;2018;09;01;Maanantai;2;2;4
624;17.09.2018;2018;09;02;Maanantai;0;0;0
624;17.09.2018;2018;09;03;Maanantai;0;2;2
624;17.09.2018;2018;09;04;Maanantai;0;1;1
624;17.09.2018;2018;09;05;Maanantai;0;2;2
624;17.09.2018;2018;09;06;Maanantai;1;8;9
624;17.09.2018;2018;09;07;Maanantai;4;32;36
624;17.09.2018;2018;09;08;Maanantai;19;77;96
624;17.09.2018;2018;09;09;Maanantai;7;80;87
624;17.09.2018;2018;09;10;Maanantai;2;45;47
624;17.09.2018;2018;09;11;Maanantai;6;31;37
624;17.09.2018;2018;09;12;Maanantai;4;29;33
624;17.09.2018;2018;09;13;Maanantai;8;37;45
624;17.09.2018;2018;09;14;Maanantai;6;24;30
624;17.09.2018;2018;09;15;Maanantai;16;43;59
624;17.09.2018;2018;09;16;Maanantai;30;46;76
624;17.09.2018;2018;09;17;Maanantai;21;77;98
624;17.09.2018;2018;09;18;Maanantai;17;37;54
624;17.09.2018;2018;09;19;Maanantai;7;30;37
624;17.09.2018;2018;09;20;Maanantai;19;20;39
624;17.09.2018;2018;09;21;Maanantai;14;10;24
624;17.09.2018;2018;09;22;Maanantai;6;14;20
624;17.09.2018;2018;09;23;Maanantai;0;4;4
624;18.09.2018;2018;09;00;Tiistai;1;3;4
624;18.09.2018;2018;09;01;Tiistai;3;0;3
624;18.09.2018;2018;09;02;Tiistai;0;0;0
624;18.09.2018;2018;09;03;Tiistai;1;1;2
624;18.09.2018;2018;09;04;Tiistai;1;0;1
624;18.09.2018;2018;09;05;Tiistai;0;3;3
624;18.09.2018;2018;09;06;Tiistai;1;13;14
624;18.09.2018;2018;09;07;Tiistai;4;30;34
624;18.09.2018;2018;09;08;Tiistai;11;96;107
624;18.09.2018;2018;09;09;Tiistai;12;87;99
624;18.09.2018;2018;09;10;Tiistai;7;39;46
624;18.09.2018;2018;09;11;Tiistai;10;33;43
624;18.09.2018;2018;09;12;Tiistai;7;33;40
624;18.09.2018;2018;09;13;Tiistai;4;39;43
624;18.09.2018;2018;09;14;Tiistai;7;39;46
624;18.09.2018;2018;09;15;Tiistai;19;47;66
624;18.09.2018;2018;09;16;Tiistai;19;50;69
624;18.09.2018;2018;09;17;Tiistai;28;55;83
624;18.09.2018;2018;09;18;Tiistai;17;39;56
624;18.09.2018;2018;09;19;Tiistai;16;43;59
624;18.09.2018;2018;09;20;Tiistai;10;17;27
624;18.09.2018;2018;09;21;Tiistai;21;24;45
624;18.09.2018;2018;09;22;Tiistai;10;21;31
624;18.09.2018;2018;09;23;Tiistai;2;13;15
624;19.09.2018;2018;09;00;Keskiviikko;1;4;5
624;19.09.2018;2018;09;01;Keskiviikko;1;3;4
624;19.09.2018;2018;09;02;Keskiviikko;2;1;3
624;19.09.2018;2018;09;03;Keskiviikko;0;2;2
624;19.09.2018;2018;09;04;Keskiviikko;1;0;1
624;19.09.2018;2018;09;05;Keskiviikko;0;3;3
624;19.09.2018;2018;09;06;Keskiviikko;1;9;10
624;19.09.2018;2018;09;07;Keskiviikko;1;37;38
624;19.09.2018;2018;09;08;Keskiviikko;7;69;76
624;19.09.2018;2018;09;09;Keskiviikko;9;74;83
624;19.09.2018;2018;09;10;Keskiviikko;8;42;50
624;19.09.2018;2018;09;11;Keskiviikko;5;30;35
624;19.09.2018;2018;09;12;Keskiviikko;8;24;32
624;19.09.2018;2018;09;13;Keskiviikko;10;26;36
624;19.09.2018;2018;09;14;Keskiviikko;14;23;37
624;19.09.2018;2018;09;15;Keskiviikko;18;35;53
624;19.09.2018;2018;09;16;Keskiviikko;22;26;48
624;19.09.2018;2018;09;17;Keskiviikko;20;47;67
624;19.09.2018;2018;09;18;Keskiviikko;21;31;52
624;19.09.2018;2018;09;19;Keskiviikko;9;21;30
624;19.09.2018;2018;09;20;Keskiviikko;23;22;45
624;19.09.2018;2018;09;21;Keskiviikko;10;12;22
624;19.09.2018;2018;09;22;Keskiviikko;6;11;17
624;19.09.2018;2018;09;23;Keskiviikko;2;6;8
624;20.09.2018;2018;09;00;Torstai;2;3;5
624;20.09.2018;2018;09;01;Torstai;1;1;2
624;20.09.2018;2018;09;02;Torstai;1;1;2
624;20.09.2018;2018;09;03;Torstai;1;1;2
624;20.09.2018;2018;09;04;Torstai;1;2;3
624;20.09.2018;2018;09;05;Torstai;1;4;5
624;20.09.2018;2018;09;06;Torstai;0;5;5
624;20.09.2018;2018;09;07;Torstai;5;34;39
624;20.09.2018;2018;09;08;Torstai;9;79;88
624;20.09.2018;2018;09;09;Torstai;17;88;105
624;20.09.2018;2018;09;10;Torstai;8;39;47
624;20.09.2018;2018;09;11;Torstai;5;38;43
624;20.09.2018;2018;09;12;Torstai;9;32;41
624;20.09.2018;2018;09;13;Torstai;8;26;34
624;20.09.2018;2018;09;14;Torstai;8;20;28
624;20.09.2018;2018;09;15;Torstai;42;49;91
624;20.09.2018;2018;09;16;Torstai;22;36;58
624;20.09.2018;2018;09;17;Torstai;29;58;87
624;20.09.2018;2018;09;18;Torstai;13;26;39
624;20.09.2018;2018;09;19;Torstai;16;39;55
624;20.09.2018;2018;09;20;Torstai;15;29;44
624;20.09.2018;2018;09;21;Torstai;6;8;14
624;20.09.2018;2018;09;22;Torstai;14;12;26
624;20.09.2018;2018;09;23;Torstai;5;6;11
624;21.09.2018;2018;09;00;Perjantai;1;1;2
624;21.09.2018;2018;09;01;Perjantai;0;2;2
624;21.09.2018;2018;09;02;Perjantai;2;4;6
624;21.09.2018;2018;09;03;Perjantai;0;3;3
624;21.09.2018;2018;09;04;Perjantai;1;2;3
624;21.09.2018;2018;09;05;Perjantai;0;1;1
624;21.09.2018;2018;09;06;Perjantai;0;8;8
624;21.09.2018;2018;09;07;Perjantai;0;27;27
624;21.09.2018;2018;09;08;Perjantai;7;71;78
624;21.09.2018;2018;09;09;Perjantai;9;73;82
624;21.09.2018;2018;09;10;Perjantai;12;35;47
624;21.09.2018;2018;09;11;Perjantai;5;37;42
624;21.09.2018;2018;09;12;Perjantai;4;23;27
624;21.09.2018;2018;09;13;Perjantai;9;20;29
624;21.09.2018;2018;09;14;Perjantai;6;38;44
624;21.09.2018;2018;09;15;Perjantai;9;43;52
624;21.09.2018;2018;09;16;Perjantai;23;41;64
624;21.09.2018;2018;09;17;Perjantai;13;46;59
624;21.09.2018;2018;09;18;Perjantai;9;24;33
624;21.09.2018;2018;09;19;Perjantai;11;19;30
624;21.09.2018;2018;09;20;Perjantai;7;19;26
624;21.09.2018;2018;09;21;Perjantai;11;7;18
624;21.09.2018;2018;09;22;Perjantai;3;6;9
624;21.09.2018;2018;09;23;Perjantai;9;3;12
624;22.09.2018;2018;09;00;Lauantai;2;1;3
624;22.09.2018;2018;09;01;Lauantai;4;6;10
624;22.09.2018;2018;09;02;Lauantai;3;4;7
624;22.09.2018;2018;09;03;Lauantai;3;1;4
624;22.09.2018;2018;09;04;Lauantai;0;1;1
624;22.09.2018;2018;09;05;Lauantai;0;1;1
624;22.09.2018;2018;09;06;Lauantai;2;4;6
624;22.09.2018;2018;09;07;Lauantai;1;5;6
624;22.09.2018;2018;09;08;Lauantai;0;5;5
624;22.09.2018;2018;09;09;Lauantai;2;9;11
624;22.09.2018;2018;09;10;Lauantai;0;6;6
624;22.09.2018;2018;09;11;Lauantai;3;6;9
624;22.09.2018;2018;09;12;Lauantai;3;9;12
624;22.09.2018;2018;09;13;Lauantai;5;24;29
624;22.09.2018;2018;09;14;Lauantai;6;23;29
624;22.09.2018;2018;09;15;Lauantai;9;24;33
624;22.09.2018;2018;09;16;Lauantai;9;25;34
624;22.09.2018;2018;09;17;Lauantai;7;16;23
624;22.09.2018;2018;09;18;Lauantai;9;10;19
624;22.09.2018;2018;09;19;Lauantai;13;13;26
624;22.09.2018;2018;09;20;Lauantai;4;9;13
624;22.09.2018;2018;09;21;Lauantai;5;10;15
624;22.09.2018;2018;09;22;Lauantai;3;6;9
624;22.09.2018;2018;09;23;Lauantai;3;4;7
624;23.09.2018;2018;09;00;Sunnuntai;3;1;4
624;23.09.2018;2018;09;01;Sunnuntai;4;6;10
624;23.09.2018;2018;09;02;Sunnuntai;0;2;2
624;23.09.2018;2018;09;03;Sunnuntai;1;3;4
624;23.09.2018;2018;09;04;Sunnuntai;1;1;2
624;23.09.2018;2018;09;05;Sunnuntai;4;2;6
624;23.09.2018;2018;09;06;Sunnuntai;2;1;3
624;23.09.2018;2018;09;07;Sunnuntai;1;2;3
624;23.09.2018;2018;09;08;Sunnuntai;0;1;1
624;23.09.2018;2018;09;09;Sunnuntai;4;8;12
624;23.09.2018;2018;09;10;Sunnuntai;2;4;6
624;23.09.2018;2018;09;11;Sunnuntai;2;15;17
624;23.09.2018;2018;09;12;Sunnuntai;3;20;23
624;23.09.2018;2018;09;13;Sunnuntai;5;24;29
624;23.09.2018;2018;09;14;Sunnuntai;4;17;21
624;23.09.2018;2018;09;15;Sunnuntai;13;28;41
624;23.09.2018;2018;09;16;Sunnuntai;12;19;31
624;23.09.2018;2018;09;17;Sunnuntai;4;17;21
624;23.09.2018;2018;09;18;Sunnuntai;6;25;31
624;23.09.2018;2018;09;19;Sunnuntai;10;14;24
624;23.09.2018;2018;09;20;Sunnuntai;10;20;30
624;23.09.2018;2018;09;21;Sunnuntai;6;5;11
624;23.09.2018;2018;09;22;Sunnuntai;3;4;7
624;23.09.2018;2018;09;23;Sunnuntai;1;3;4
624;24.09.2018;2018;09;00;Maanantai;3;2;5
624;24.09.2018;2018;09;01;Maanantai;2;0;2
624;24.09.2018;2018;09;02;Maanantai;0;0;0
624;24.09.2018;2018;09;03;Maanantai;0;0;0
624;24.09.2018;2018;09;04;Maanantai;0;0;0
624;24.09.2018;2018;09;05;Maanantai;0;1;1
624;24.09.2018;2018;09;06;Maanantai;2;10;12
624;24.09.2018;2018;09;07;Maanantai;5;39;44
624;24.09.2018;2018;09;08;Maanantai;11;79;90
624;24.09.2018;2018;09;09;Maanantai;6;79;85
624;24.09.2018;2018;09;10;Maanantai;5;36;41
624;24.09.2018;2018;09;11;Maanantai;6;32;38
624;24.09.2018;2018;09;12;Maanantai;8;36;44
624;24.09.2018;2018;09;13;Maanantai;7;33;40
624;24.09.2018;2018;09;14;Maanantai;9;24;33
624;24.09.2018;2018;09;15;Maanantai;13;33;46
624;24.09.2018;2018;09;16;Maanantai;22;38;60
624;24.09.2018;2018;09;17;Maanantai;30;51;81
624;24.09.2018;2018;09;18;Maanantai;20;42;62
624;24.09.2018;2018;09;19;Maanantai;10;30;40
624;24.09.2018;2018;09;20;Maanantai;16;23;39
624;24.09.2018;2018;09;21;Maanantai;15;12;27
624;24.09.2018;2018;09;22;Maanantai;8;10;18
624;24.09.2018;2018;09;23;Maanantai;3;5;8
624;25.09.2018;2018;09;00;Tiistai;0;5;5
624;25.09.2018;2018;09;01;Tiistai;0;1;1
624;25.09.2018;2018;09;02;Tiistai;1;0;1
624;25.09.2018;2018;09;03;Tiistai;0;0;0
624;25.09.2018;2018;09;04;Tiistai;0;0;0
624;25.09.2018;2018;09;05;Tiistai;1;1;2
624;25.09.2018;2018;09;06;Tiistai;1;6;7
624;25.09.2018;2018;09;07;Tiistai;4;34;38
624;25.09.2018;2018;09;08;Tiistai;18;106;124
624;25.09.2018;2018;09;09;Tiistai;6;84;90
624;25.09.2018;2018;09;10;Tiistai;8;40;48
624;25.09.2018;2018;09;11;Tiistai;9;31;40
624;25.09.2018;2018;09;12;Tiistai;10;35;45
624;25.09.2018;2018;09;13;Tiistai;9;23;32
624;25.09.2018;2018;09;14;Tiistai;10;37;47
624;25.09.2018;2018;09;15;Tiistai;9;37;46
624;25.09.2018;2018;09;16;Tiistai;19;41;60
624;25.09.2018;2018;09;17;Tiistai;34;52;86
624;25.09.2018;2018;09;18;Tiistai;13;44;57
624;25.09.2018;2018;09;19;Tiistai;14;38;52
624;25.09.2018;2018;09;20;Tiistai;12;32;44
624;25.09.2018;2018;09;21;Tiistai;9;12;21
624;25.09.2018;2018;09;22;Tiistai;14;19;33
624;25.09.2018;2018;09;23;Tiistai;3;6;9
624;26.09.2018;2018;09;00;Keskiviikko;3;3;6
624;26.09.2018;2018;09;01;Keskiviikko;3;3;6
624;26.09.2018;2018;09;02;Keskiviikko;2;1;3
624;26.09.2018;2018;09;03;Keskiviikko;1;2;3
624;26.09.2018;2018;09;04;Keskiviikko;0;0;0
624;26.09.2018;2018;09;05;Keskiviikko;0;1;1
624;26.09.2018;2018;09;06;Keskiviikko;0;7;7
624;26.09.2018;2018;09;07;Keskiviikko;5;28;33
624;26.09.2018;2018;09;08;Keskiviikko;11;61;72
624;26.09.2018;2018;09;09;Keskiviikko;7;64;71
624;26.09.2018;2018;09;10;Keskiviikko;6;26;32
624;26.09.2018;2018;09;11;Keskiviikko;3;23;26
624;26.09.2018;2018;09;12;Keskiviikko;6;19;25
624;26.09.2018;2018;09;13;Keskiviikko;7;15;22
624;26.09.2018;2018;09;14;Keskiviikko;9;15;24
624;26.09.2018;2018;09;15;Keskiviikko;12;26;38
624;26.09.2018;2018;09;16;Keskiviikko;23;14;37
624;26.09.2018;2018;09;17;Keskiviikko;19;43;62
624;26.09.2018;2018;09;18;Keskiviikko;14;18;32
624;26.09.2018;2018;09;19;Keskiviikko;12;22;34
624;26.09.2018;2018;09;20;Keskiviikko;13;11;24
624;26.09.2018;2018;09;21;Keskiviikko;6;8;14
624;26.09.2018;2018;09;22;Keskiviikko;8;11;19
624;26.09.2018;2018;09;23;Keskiviikko;1;9;10
624;27.09.2018;2018;09;00;Torstai;3;2;5
624;27.09.2018;2018;09;01;Torstai;2;2;4
624;27.09.2018;2018;09;02;Torstai;1;2;3
624;27.09.2018;2018;09;03;Torstai;0;0;0
624;27.09.2018;2018;09;04;Torstai;1;1;2
624;27.09.2018;2018;09;05;Torstai;1;1;2
624;27.09.2018;2018;09;06;Torstai;2;7;9
624;27.09.2018;2018;09;07;Torstai;3;25;28
624;27.09.2018;2018;09;08;Torstai;15;64;79
624;27.09.2018;2018;09;09;Torstai;13;58;71
624;27.09.2018;2018;09;10;Torstai;9;32;41
624;27.09.2018;2018;09;11;Torstai;3;22;25
624;27.09.2018;2018;09;12;Torstai;8;12;20
624;27.09.2018;2018;09;13;Torstai;9;11;20
624;27.09.2018;2018;09;14;Torstai;5;23;28
624;27.09.2018;2018;09;15;Torstai;17;32;49
624;27.09.2018;2018;09;16;Torstai;17;31;48
624;27.09.2018;2018;09;17;Torstai;11;42;53
624;27.09.2018;2018;09;18;Torstai;16;34;50
624;27.09.2018;2018;09;19;Torstai;11;17;28
624;27.09.2018;2018;09;20;Torstai;5;23;28
624;27.09.2018;2018;09;21;Torstai;10;18;28
624;27.09.2018;2018;09;22;Torstai;8;8;16
624;27.09.2018;2018;09;23;Torstai;2;9;11
624;28.09.2018;2018;09;00;Perjantai;4;1;5
624;28.09.2018;2018;09;01;Perjantai;4;3;7
624;28.09.2018;2018;09;02;Perjantai;0;0;0
624;28.09.2018;2018;09;03;Perjantai;0;0;0
624;28.09.2018;2018;09;04;Perjantai;1;0;1
624;28.09.2018;2018;09;05;Perjantai;0;1;1
624;28.09.2018;2018;09;06;Perjantai;0;5;5
624;28.09.2018;2018;09;07;Perjantai;3;26;29
624;28.09.2018;2018;09;08;Perjantai;6;79;85
624;28.09.2018;2018;09;09;Perjantai;8;46;54
624;28.09.2018;2018;09;10;Perjantai;10;24;34
624;28.09.2018;2018;09;11;Perjantai;5;33;38
624;28.09.2018;2018;09;12;Perjantai;10;32;42
624;28.09.2018;2018;09;13;Perjantai;7;16;23
624;28.09.2018;2018;09;14;Perjantai;13;33;46
624;28.09.2018;2018;09;15;Perjantai;18;38;56
624;28.09.2018;2018;09;16;Perjantai;23;32;55
624;28.09.2018;2018;09;17;Perjantai;21;46;67
624;28.09.2018;2018;09;18;Perjantai;14;28;42
624;28.09.2018;2018;09;19;Perjantai;8;15;23
624;28.09.2018;2018;09;20;Perjantai;6;22;28
624;28.09.2018;2018;09;21;Perjantai;9;16;25
624;28.09.2018;2018;09;22;Perjantai;8;10;18
624;28.09.2018;2018;09;23;Perjantai;2;9;11
624;29.09.2018;2018;09;00;Lauantai;0;5;5
624;29.09.2018;2018;09;01;Lauantai;2;3;5
624;29.09.2018;2018;09;02;Lauantai;5;2;7
624;29.09.2018;2018;09;03;Lauantai;2;0;2
624;29.09.2018;2018;09;04;Lauantai;1;3;4
624;29.09.2018;2018;09;05;Lauantai;0;1;1
624;29.09.2018;2018;09;06;Lauantai;1;3;4
624;29.09.2018;2018;09;07;Lauantai;0;3;3
624;29.09.2018;2018;09;08;Lauantai;0;5;5
624;29.09.2018;2018;09;09;Lauantai;3;8;11
624;29.09.2018;2018;09;10;Lauantai;0;27;27
624;29.09.2018;2018;09;11;Lauantai;5;18;23
624;29.09.2018;2018;09;12;Lauantai;5;21;26
624;29.09.2018;2018;09;13;Lauantai;5;24;29
624;29.09.2018;2018;09;14;Lauantai;10;25;35
624;29.09.2018;2018;09;15;Lauantai;13;23;36
624;29.09.2018;2018;09;16;Lauantai;12;27;39
624;29.09.2018;2018;09;17;Lauantai;12;20;32
624;29.09.2018;2018;09;18;Lauantai;5;14;19
624;29.09.2018;2018;09;19;Lauantai;4;15;19
624;29.09.2018;2018;09;20;Lauantai;12;13;25
624;29.09.2018;2018;09;21;Lauantai;11;7;18
624;29.09.2018;2018;09;22;Lauantai;5;8;13
624;29.09.2018;2018;09;23;Lauantai;3;7;10
624;30.09.2018;2018;09;00;Sunnuntai;0;9;9
624;30.09.2018;2018;09;01;Sunnuntai;1;1;2
624;30.09.2018;2018;09;02;Sunnuntai;1;1;2
624;30.09.2018;2018;09;03;Sunnuntai;1;0;1
624;30.09.2018;2018;09;04;Sunnuntai;2;1;3
624;30.09.2018;2018;09;05;Sunnuntai;1;0;1
624;30.09.2018;2018;09;06;Sunnuntai;0;1;1
624;30.09.2018;2018;09;07;Sunnuntai;1;3;4
624;30.09.2018;2018;09;08;Sunnuntai;1;2;3
624;30.09.2018;2018;09;09;Sunnuntai;1;0;1
624;30.09.2018;2018;09;10;Sunnuntai;1;4;5
624;30.09.2018;2018;09;11;Sunnuntai;5;22;27
624;30.09.2018;2018;09;12;Sunnuntai;6;24;30
624;30.09.2018;2018;09;13;Sunnuntai;14;25;39
624;30.09.2018;2018;09;14;Sunnuntai;7;24;31
624;30.09.2018;2018;09;15;Sunnuntai;5;25;30
624;30.09.2018;2018;09;16;Sunnuntai;15;28;43
624;30.09.2018;2018;09;17;Sunnuntai;4;15;19
624;30.09.2018;2018;09;18;Sunnuntai;6;13;19
624;30.09.2018;2018;09;19;Sunnuntai;4;10;14
624;30.09.2018;2018;09;20;Sunnuntai;5;15;20
624;30.09.2018;2018;09;21;Sunnuntai;5;10;15
624;30.09.2018;2018;09;22;Sunnuntai;5;3;8
624;30.09.2018;2018;09;23;Sunnuntai;1;3;4