MittausID;Pvm;Vuosi;Kuukausi;Tunti;Viikonpäivä;PP_1;PP_2;PP_YHT
623;02.01.2017;2017;01;00;Maanantai;5;2;7
623;02.01.2017;2017;01;01;Maanantai;5;1;6
623;02.01.2017;2017;01;02;Maanantai;1;1;2
623;02.01.2017;2017;01;03;Maanantai;0;1;1
623;02.01.2017;2017;01;04;Maanantai;0;2;2
623;02.01.2017;2017;01;05;Maanantai;0;4;4
623;02.01.2017;2017;01;06;Maanantai;2;3;5
623;02.01.2017;2017;01;07;Maanantai;3;18;21
623;02.01.2017;2017;01;08;Maanantai;13;55;68
623;02.01.2017;2017;01;09;Maanantai;17;38;55
623;02.01.2017;2017;01;10;Maanantai;8;13;21
623;02.01.2017;2017;01;11;Maanantai;14;10;24
623;02.01.2017;2017;01;12;Maanantai;12;13;25
623;02.01.2017;2017;01;13;Maanantai;15;12;27
623;02.01.2017;2017;01;14;Maanantai;17;13;30
623;02.01.2017;2017;01;15;Maanantai;16;11;27
623;02.01.2017;2017;01;16;Maanantai;36;13;49
623;02.01.2017;2017;01;17;Maanantai;46;24;70
623;02.01.2017;2017;01;18;Maanantai;28;23;51
623;02.01.2017;2017;01;19;Maanantai;16;7;23
623;02.01.2017;2017;01;20;Maanantai;10;7;17
623;02.01.2017;2017;01;21;Maanantai;9;10;19
623;02.01.2017;2017;01;22;Maanantai;10;7;17
623;02.01.2017;2017;01;23;Maanantai;10;3;13
623;03.01.2017;2017;01;00;Tiistai;5;3;8
623;03.01.2017;2017;01;01;Tiistai;1;2;3
623;03.01.2017;2017;01;02;Tiistai;2;0;2
623;03.01.2017;2017;01;03;Tiistai;2;2;4
623;03.01.2017;2017;01;04;Tiistai;1;2;3
623;03.01.2017;2017;01;05;Tiistai;1;5;6
623;03.01.2017;2017;01;06;Tiistai;1;2;3
623;03.01.2017;2017;01;07;Tiistai;4;23;27
623;03.01.2017;2017;01;08;Tiistai;12;41;53
623;03.01.2017;2017;01;09;Tiistai;7;36;43
623;03.01.2017;2017;01;10;Tiistai;12;4;16
623;03.01.2017;2017;01;11;Tiistai;6;7;13
623;03.01.2017;2017;01;12;Tiistai;5;10;15
623;03.01.2017;2017;01;13;Tiistai;13;11;24
623;03.01.2017;2017;01;14;Tiistai;9;17;26
623;03.01.2017;2017;01;15;Tiistai;18;11;29
623;03.01.2017;2017;01;16;Tiistai;39;7;46
623;03.01.2017;2017;01;17;Tiistai;42;18;60
623;03.01.2017;2017;01;18;Tiistai;31;16;47
623;03.01.2017;2017;01;19;Tiistai;17;6;23
623;03.01.2017;2017;01;20;Tiistai;6;11;17
623;03.01.2017;2017;01;21;Tiistai;9;10;19
623;03.01.2017;2017;01;22;Tiistai;5;6;11
623;03.01.2017;2017;01;23;Tiistai;8;5;13
623;04.01.2017;2017;01;00;Keskiviikko;4;1;5
623;04.01.2017;2017;01;01;Keskiviikko;3;0;3
623;04.01.2017;2017;01;02;Keskiviikko;0;0;0
623;04.01.2017;2017;01;03;Keskiviikko;1;0;1
623;04.01.2017;2017;01;04;Keskiviikko;3;2;5
623;04.01.2017;2017;01;05;Keskiviikko;0;0;0
623;04.01.2017;2017;01;06;Keskiviikko;0;4;4
623;04.01.2017;2017;01;07;Keskiviikko;4;19;23
623;04.01.2017;2017;01;08;Keskiviikko;7;29;36
623;04.01.2017;2017;01;09;Keskiviikko;9;16;25
623;04.01.2017;2017;01;10;Keskiviikko;7;13;20
623;04.01.2017;2017;01;11;Keskiviikko;4;3;7
623;04.01.2017;2017;01;12;Keskiviikko;6;11;17
623;04.01.2017;2017;01;13;Keskiviikko;5;10;15
623;04.01.2017;2017;01;14;Keskiviikko;11;5;16
623;04.01.2017;2017;01;15;Keskiviikko;11;9;20
623;04.01.2017;2017;01;16;Keskiviikko;30;12;42
623;04.01.2017;2017;01;17;Keskiviikko;30;13;43
623;04.01.2017;2017;01;18;Keskiviikko;15;10;25
623;04.01.2017;2017;01;19;Keskiviikko;8;8;16
623;04.01.2017;2017;01;20;Keskiviikko;6;5;11
623;04.01.2017;2017;01;21;Keskiviikko;5;2;7
623;04.01.2017;2017;01;22;Keskiviikko;6;7;13
623;04.01.2017;2017;01;23;Keskiviikko;6;1;7
623;05.01.2017;2017;01;00;Torstai;2;0;2
623;05.01.2017;2017;01;01;Torstai;3;0;3
623;05.01.2017;2017;01;02;Torstai;0;0;0
623;05.01.2017;2017;01;03;Torstai;0;1;1
623;05.01.2017;2017;01;04;Torstai;2;2;4
623;05.01.2017;2017;01;05;Torstai;0;4;4
623;05.01.2017;2017;01;06;Torstai;2;3;5
623;05.01.2017;2017;01;07;Torstai;4;13;17
623;05.01.2017;2017;01;08;Torstai;3;16;19
623;05.01.2017;2017;01;09;Torstai;4;19;23
623;05.01.2017;2017;01;10;Torstai;6;2;8
623;05.01.2017;2017;01;11;Torstai;3;6;9
623;05.01.2017;2017;01;12;Torstai;5;2;7
623;05.01.2017;2017;01;13;Torstai;8;4;12
623;05.01.2017;2017;01;14;Torstai;6;8;14
623;05.01.2017;2017;01;15;Torstai;10;7;17
623;05.01.2017;2017;01;16;Torstai;17;8;25
623;05.01.2017;2017;01;17;Torstai;18;9;27
623;05.01.2017;2017;01;18;Torstai;11;8;19
623;05.01.2017;2017;01;19;Torstai;11;3;14
623;05.01.2017;2017;01;20;Torstai;4;8;12
623;05.01.2017;2017;01;21;Torstai;5;2;7
623;05.01.2017;2017;01;22;Torstai;5;3;8
623;05.01.2017;2017;01;23;Torstai;2;2;4
623;06.01.2017;2017;01;00;Perjantai;2;1;3
623;06.01.2017;2017;01;01;Perjantai;2;2;4
623;06.01.2017;2017;01;02;Perjantai;0;0;0
623;06.01.2017;2017;01;03;Perjantai;0;0;0
623;06.01.2017;2017;01;04;Perjantai;3;1;4
623;06.01.2017;2017;01;05;Perjantai;0;2;2
623;06.01.2017;2017;01;06;Perjantai;0;1;1
623;06.01.2017;2017;01;07;Perjantai;0;4;4
623;06.01.2017;2017;01;08;Perjantai;1;3;4
623;06.01.2017;2017;01;09;Perjantai;2;4;6
623;06.01.2017;2017;01;10;Perjantai;4;7;11
623;06.01.2017;2017;01;11;Perjantai;8;0;8
623;06.01.2017;2017;01;12;Perjantai;4;8;12
623;06.01.2017;2017;01;13;Perjantai;5;6;11
623;06.01.2017;2017;01;14;Perjantai;5;10;15
623;06.01.2017;2017;01;15;Perjantai;10;8;18
623;06.01.2017;2017;01;16;Perjantai;7;3;10
623;06.01.2017;2017;01;17;Perjantai;8;5;13
623;06.01.2017;2017;01;18;Perjantai;5;15;20
623;06.01.2017;2017;01;19;Perjantai;3;7;10
623;06.01.2017;2017;01;20;Perjantai;7;6;13
623;06.01.2017;2017;01;21;Perjantai;4;7;11
623;06.01.2017;2017;01;22;Perjantai;4;3;7
623;06.01.2017;2017;01;23;Perjantai;6;5;11
623;07.01.2017;2017;01;00;Lauantai;4;3;7
623;07.01.2017;2017;01;01;Lauantai;1;2;3
623;07.01.2017;2017;01;02;Lauantai;3;0;3
623;07.01.2017;2017;01;03;Lauantai;1;0;1
623;07.01.2017;2017;01;04;Lauantai;2;1;3
623;07.01.2017;2017;01;05;Lauantai;4;3;7
623;07.01.2017;2017;01;06;Lauantai;2;1;3
623;07.01.2017;2017;01;07;Lauantai;1;1;2
623;07.01.2017;2017;01;08;Lauantai;2;2;4
623;07.01.2017;2017;01;09;Lauantai;2;3;5
623;07.01.2017;2017;01;10;Lauantai;2;8;10
623;07.01.2017;2017;01;11;Lauantai;4;10;14
623;07.01.2017;2017;01;12;Lauantai;8;17;25
623;07.01.2017;2017;01;13;Lauantai;13;17;30
623;07.01.2017;2017;01;14;Lauantai;15;20;35
623;07.01.2017;2017;01;15;Lauantai;13;12;25
623;07.01.2017;2017;01;16;Lauantai;17;14;31
623;07.01.2017;2017;01;17;Lauantai;9;15;24
623;07.01.2017;2017;01;18;Lauantai;10;10;20
623;07.01.2017;2017;01;19;Lauantai;13;8;21
623;07.01.2017;2017;01;20;Lauantai;14;10;24
623;07.01.2017;2017;01;21;Lauantai;4;8;12
623;07.01.2017;2017;01;22;Lauantai;6;8;14
623;07.01.2017;2017;01;23;Lauantai;8;3;11
623;08.01.2017;2017;01;00;Sunnuntai;3;3;6
623;08.01.2017;2017;01;01;Sunnuntai;0;3;3
623;08.01.2017;2017;01;02;Sunnuntai;2;2;4
623;08.01.2017;2017;01;03;Sunnuntai;5;0;5
623;08.01.2017;2017;01;04;Sunnuntai;1;0;1
623;08.01.2017;2017;01;05;Sunnuntai;1;0;1
623;08.01.2017;2017;01;06;Sunnuntai;0;1;1
623;08.01.2017;2017;01;07;Sunnuntai;0;1;1
623;08.01.2017;2017;01;08;Sunnuntai;3;2;5
623;08.01.2017;2017;01;09;Sunnuntai;2;3;5
623;08.01.2017;2017;01;10;Sunnuntai;4;3;7
623;08.01.2017;2017;01;11;Sunnuntai;2;12;14
623;08.01.2017;2017;01;12;Sunnuntai;6;10;16
623;08.01.2017;2017;01;13;Sunnuntai;5;9;14
623;08.01.2017;2017;01;14;Sunnuntai;16;16;32
623;08.01.2017;2017;01;15;Sunnuntai;16;10;26
623;08.01.2017;2017;01;16;Sunnuntai;13;10;23
623;08.01.2017;2017;01;17;Sunnuntai;8;8;16
623;08.01.2017;2017;01;18;Sunnuntai;13;8;21
623;08.01.2017;2017;01;19;Sunnuntai;7;7;14
623;08.01.2017;2017;01;20;Sunnuntai;9;13;22
623;08.01.2017;2017;01;21;Sunnuntai;7;3;10
623;08.01.2017;2017;01;22;Sunnuntai;4;7;11
623;08.01.2017;2017;01;23;Sunnuntai;2;2;4
623;09.01.2017;2017;01;00;Maanantai;3;1;4
623;09.01.2017;2017;01;01;Maanantai;0;2;2
623;09.01.2017;2017;01;02;Maanantai;3;0;3
623;09.01.2017;2017;01;03;Maanantai;0;0;0
623;09.01.2017;2017;01;04;Maanantai;0;1;1
623;09.01.2017;2017;01;05;Maanantai;0;6;6
623;09.01.2017;2017;01;06;Maanantai;1;9;10
623;09.01.2017;2017;01;07;Maanantai;7;20;27
623;09.01.2017;2017;01;08;Maanantai;23;70;93
623;09.01.2017;2017;01;09;Maanantai;42;80;122
623;09.01.2017;2017;01;10;Maanantai;29;32;61
623;09.01.2017;2017;01;11;Maanantai;18;20;38
623;09.01.2017;2017;01;12;Maanantai;24;18;42
623;09.01.2017;2017;01;13;Maanantai;20;22;42
623;09.01.2017;2017;01;14;Maanantai;29;21;50
623;09.01.2017;2017;01;15;Maanantai;49;31;80
623;09.01.2017;2017;01;16;Maanantai;63;30;93
623;09.01.2017;2017;01;17;Maanantai;72;54;126
623;09.01.2017;2017;01;18;Maanantai;33;45;78
623;09.01.2017;2017;01;19;Maanantai;24;25;49
623;09.01.2017;2017;01;20;Maanantai;26;10;36
623;09.01.2017;2017;01;21;Maanantai;26;8;34
623;09.01.2017;2017;01;22;Maanantai;7;10;17
623;09.01.2017;2017;01;23;Maanantai;11;6;17
623;10.01.2017;2017;01;00;Tiistai;2;1;3
623;10.01.2017;2017;01;01;Tiistai;4;0;4
623;10.01.2017;2017;01;02;Tiistai;1;0;1
623;10.01.2017;2017;01;03;Tiistai;0;1;1
623;10.01.2017;2017;01;04;Tiistai;0;0;0
623;10.01.2017;2017;01;05;Tiistai;1;7;8
623;10.01.2017;2017;01;06;Tiistai;2;8;10
623;10.01.2017;2017;01;07;Tiistai;7;22;29
623;10.01.2017;2017;01;08;Tiistai;33;65;98
623;10.01.2017;2017;01;09;Tiistai;43;89;132
623;10.01.2017;2017;01;10;Tiistai;21;34;55
623;10.01.2017;2017;01;11;Tiistai;20;23;43
623;10.01.2017;2017;01;12;Tiistai;24;24;48
623;10.01.2017;2017;01;13;Tiistai;26;22;48
623;10.01.2017;2017;01;14;Tiistai;27;23;50
623;10.01.2017;2017;01;15;Tiistai;39;26;65
623;10.01.2017;2017;01;16;Tiistai;65;28;93
623;10.01.2017;2017;01;17;Tiistai;77;53;130
623;10.01.2017;2017;01;18;Tiistai;37;41;78
623;10.01.2017;2017;01;19;Tiistai;29;19;48
623;10.01.2017;2017;01;20;Tiistai;23;18;41
623;10.01.2017;2017;01;21;Tiistai;15;11;26
623;10.01.2017;2017;01;22;Tiistai;6;6;12
623;10.01.2017;2017;01;23;Tiistai;6;6;12
623;11.01.2017;2017;01;00;Keskiviikko;2;2;4
623;11.01.2017;2017;01;01;Keskiviikko;1;1;2
623;11.01.2017;2017;01;02;Keskiviikko;1;0;1
623;11.01.2017;2017;01;03;Keskiviikko;1;1;2
623;11.01.2017;2017;01;04;Keskiviikko;1;0;1
623;11.01.2017;2017;01;05;Keskiviikko;0;3;3
623;11.01.2017;2017;01;06;Keskiviikko;4;9;13
623;11.01.2017;2017;01;07;Keskiviikko;5;25;30
623;11.01.2017;2017;01;08;Keskiviikko;31;56;87
623;11.01.2017;2017;01;09;Keskiviikko;35;71;106
623;11.01.2017;2017;01;10;Keskiviikko;28;40;68
623;11.01.2017;2017;01;11;Keskiviikko;15;26;41
623;11.01.2017;2017;01;12;Keskiviikko;28;19;47
623;11.01.2017;2017;01;13;Keskiviikko;29;27;56
623;11.01.2017;2017;01;14;Keskiviikko;25;21;46
623;11.01.2017;2017;01;15;Keskiviikko;46;31;77
623;11.01.2017;2017;01;16;Keskiviikko;53;30;83
623;11.01.2017;2017;01;17;Keskiviikko;67;50;117
623;11.01.2017;2017;01;18;Keskiviikko;42;26;68
623;11.01.2017;2017;01;19;Keskiviikko;34;24;58
623;11.01.2017;2017;01;20;Keskiviikko;20;13;33
623;11.01.2017;2017;01;21;Keskiviikko;19;8;27
623;11.01.2017;2017;01;22;Keskiviikko;13;7;20
623;11.01.2017;2017;01;23;Keskiviikko;4;5;9
623;12.01.2017;2017;01;00;Torstai;5;4;9
623;12.01.2017;2017;01;01;Torstai;2;2;4
623;12.01.2017;2017;01;02;Torstai;3;0;3
623;12.01.2017;2017;01;03;Torstai;0;0;0
623;12.01.2017;2017;01;04;Torstai;0;4;4
623;12.01.2017;2017;01;05;Torstai;1;4;5
623;12.01.2017;2017;01;06;Torstai;4;9;13
623;12.01.2017;2017;01;07;Torstai;8;29;37
623;12.01.2017;2017;01;08;Torstai;33;55;88
623;12.01.2017;2017;01;09;Torstai;32;67;99
623;12.01.2017;2017;01;10;Torstai;23;36;59
623;12.01.2017;2017;01;11;Torstai;15;24;39
623;12.01.2017;2017;01;12;Torstai;20;23;43
623;12.01.2017;2017;01;13;Torstai;17;13;30
623;12.01.2017;2017;01;14;Torstai;31;23;54
623;12.01.2017;2017;01;15;Torstai;40;23;63
623;12.01.2017;2017;01;16;Torstai;57;26;83
623;12.01.2017;2017;01;17;Torstai;72;52;124
623;12.01.2017;2017;01;18;Torstai;38;31;69
623;12.01.2017;2017;01;19;Torstai;24;13;37
623;12.01.2017;2017;01;20;Torstai;6;19;25
623;12.01.2017;2017;01;21;Torstai;12;11;23
623;12.01.2017;2017;01;22;Torstai;21;4;25
623;12.01.2017;2017;01;23;Torstai;1;1;2
623;13.01.2017;2017;01;00;Perjantai;1;2;3
623;13.01.2017;2017;01;01;Perjantai;6;8;14
623;13.01.2017;2017;01;02;Perjantai;0;0;0
623;13.01.2017;2017;01;03;Perjantai;1;1;2
623;13.01.2017;2017;01;04;Perjantai;8;2;10
623;13.01.2017;2017;01;05;Perjantai;1;2;3
623;13.01.2017;2017;01;06;Perjantai;2;9;11
623;13.01.2017;2017;01;07;Perjantai;4;30;34
623;13.01.2017;2017;01;08;Perjantai;27;61;88
623;13.01.2017;2017;01;09;Perjantai;29;54;83
623;13.01.2017;2017;01;10;Perjantai;17;32;49
623;13.01.2017;2017;01;11;Perjantai;14;19;33
623;13.01.2017;2017;01;12;Perjantai;23;21;44
623;13.01.2017;2017;01;13;Perjantai;25;20;45
623;13.01.2017;2017;01;14;Perjantai;32;15;47
623;13.01.2017;2017;01;15;Perjantai;51;31;82
623;13.01.2017;2017;01;16;Perjantai;56;19;75
623;13.01.2017;2017;01;17;Perjantai;49;26;75
623;13.01.2017;2017;01;18;Perjantai;29;34;63
623;13.01.2017;2017;01;19;Perjantai;22;18;40
623;13.01.2017;2017;01;20;Perjantai;11;14;25
623;13.01.2017;2017;01;21;Perjantai;18;7;25
623;13.01.2017;2017;01;22;Perjantai;11;8;19
623;13.01.2017;2017;01;23;Perjantai;6;7;13
623;14.01.2017;2017;01;00;Lauantai;6;4;10
623;14.01.2017;2017;01;01;Lauantai;6;5;11
623;14.01.2017;2017;01;02;Lauantai;7;1;8
623;14.01.2017;2017;01;03;Lauantai;0;0;0
623;14.01.2017;2017;01;04;Lauantai;3;0;3
623;14.01.2017;2017;01;05;Lauantai;1;3;4
623;14.01.2017;2017;01;06;Lauantai;3;3;6
623;14.01.2017;2017;01;07;Lauantai;2;5;7
623;14.01.2017;2017;01;08;Lauantai;1;5;6
623;14.01.2017;2017;01;09;Lauantai;4;8;12
623;14.01.2017;2017;01;10;Lauantai;4;9;13
623;14.01.2017;2017;01;11;Lauantai;4;11;15
623;14.01.2017;2017;01;12;Lauantai;11;16;27
623;14.01.2017;2017;01;13;Lauantai;8;13;21
623;14.01.2017;2017;01;14;Lauantai;13;21;34
623;14.01.2017;2017;01;15;Lauantai;16;12;28
623;14.01.2017;2017;01;16;Lauantai;15;16;31
623;14.01.2017;2017;01;17;Lauantai;13;17;30
623;14.01.2017;2017;01;18;Lauantai;16;18;34
623;14.01.2017;2017;01;19;Lauantai;15;6;21
623;14.01.2017;2017;01;20;Lauantai;6;13;19
623;14.01.2017;2017;01;21;Lauantai;9;5;14
623;14.01.2017;2017;01;22;Lauantai;11;9;20
623;14.01.2017;2017;01;23;Lauantai;6;4;10
623;15.01.2017;2017;01;00;Sunnuntai;9;3;12
623;15.01.2017;2017;01;01;Sunnuntai;8;0;8
623;15.01.2017;2017;01;02;Sunnuntai;4;2;6
623;15.01.2017;2017;01;03;Sunnuntai;2;1;3
623;15.01.2017;2017;01;04;Sunnuntai;4;2;6
623;15.01.2017;2017;01;05;Sunnuntai;5;1;6
623;15.01.2017;2017;01;06;Sunnuntai;0;1;1
623;15.01.2017;2017;01;07;Sunnuntai;2;5;7
623;15.01.2017;2017;01;08;Sunnuntai;0;2;2
623;15.01.2017;2017;01;09;Sunnuntai;2;1;3
623;15.01.2017;2017;01;10;Sunnuntai;1;1;2
623;15.01.2017;2017;01;11;Sunnuntai;4;10;14
623;15.01.2017;2017;01;12;Sunnuntai;5;18;23
623;15.01.2017;2017;01;13;Sunnuntai;9;14;23
623;15.01.2017;2017;01;14;Sunnuntai;17;23;40
623;15.01.2017;2017;01;15;Sunnuntai;20;15;35
623;15.01.2017;2017;01;16;Sunnuntai;16;11;27
623;15.01.2017;2017;01;17;Sunnuntai;14;14;28
623;15.01.2017;2017;01;18;Sunnuntai;22;19;41
623;15.01.2017;2017;01;19;Sunnuntai;16;11;27
623;15.01.2017;2017;01;20;Sunnuntai;10;8;18
623;15.01.2017;2017;01;21;Sunnuntai;9;5;14
623;15.01.2017;2017;01;22;Sunnuntai;11;1;12
623;15.01.2017;2017;01;23;Sunnuntai;6;3;9
623;16.01.2017;2017;01;00;Maanantai;0;3;3
623;16.01.2017;2017;01;01;Maanantai;2;0;2
623;16.01.2017;2017;01;02;Maanantai;1;0;1
623;16.01.2017;2017;01;03;Maanantai;1;0;1
623;16.01.2017;2017;01;04;Maanantai;1;0;1
623;16.01.2017;2017;01;05;Maanantai;0;5;5
623;16.01.2017;2017;01;06;Maanantai;0;7;7
623;16.01.2017;2017;01;07;Maanantai;6;27;33
623;16.01.2017;2017;01;08;Maanantai;27;59;86
623;16.01.2017;2017;01;09;Maanantai;31;80;111
623;16.01.2017;2017;01;10;Maanantai;23;35;58
623;16.01.2017;2017;01;11;Maanantai;20;18;38
623;16.01.2017;2017;01;12;Maanantai;29;22;51
623;16.01.2017;2017;01;13;Maanantai;26;24;50
623;16.01.2017;2017;01;14;Maanantai;27;19;46
623;16.01.2017;2017;01;15;Maanantai;55;39;94
623;16.01.2017;2017;01;16;Maanantai;60;29;89
623;16.01.2017;2017;01;17;Maanantai;73;47;120
623;16.01.2017;2017;01;18;Maanantai;25;39;64
623;16.01.2017;2017;01;19;Maanantai;29;10;39
623;16.01.2017;2017;01;20;Maanantai;21;8;29
623;16.01.2017;2017;01;21;Maanantai;25;9;34
623;16.01.2017;2017;01;22;Maanantai;15;12;27
623;16.01.2017;2017;01;23;Maanantai;5;4;9
623;17.01.2017;2017;01;00;Tiistai;3;1;4
623;17.01.2017;2017;01;01;Tiistai;0;0;0
623;17.01.2017;2017;01;02;Tiistai;0;0;0
623;17.01.2017;2017;01;03;Tiistai;0;1;1
623;17.01.2017;2017;01;04;Tiistai;0;0;0
623;17.01.2017;2017;01;05;Tiistai;0;3;3
623;17.01.2017;2017;01;06;Tiistai;3;4;7
623;17.01.2017;2017;01;07;Tiistai;6;35;41
623;17.01.2017;2017;01;08;Tiistai;36;79;115
623;17.01.2017;2017;01;09;Tiistai;33;75;108
623;17.01.2017;2017;01;10;Tiistai;20;33;53
623;17.01.2017;2017;01;11;Tiistai;26;16;42
623;17.01.2017;2017;01;12;Tiistai;21;15;36
623;17.01.2017;2017;01;13;Tiistai;24;14;38
623;17.01.2017;2017;01;14;Tiistai;27;28;55
623;17.01.2017;2017;01;15;Tiistai;50;26;76
623;17.01.2017;2017;01;16;Tiistai;61;22;83
623;17.01.2017;2017;01;17;Tiistai;76;48;124
623;17.01.2017;2017;01;18;Tiistai;46;45;91
623;17.01.2017;2017;01;19;Tiistai;36;19;55
623;17.01.2017;2017;01;20;Tiistai;27;15;42
623;17.01.2017;2017;01;21;Tiistai;13;12;25
623;17.01.2017;2017;01;22;Tiistai;13;7;20
623;17.01.2017;2017;01;23;Tiistai;10;2;12
623;18.01.2017;2017;01;00;Keskiviikko;5;2;7
623;18.01.2017;2017;01;01;Keskiviikko;3;2;5
623;18.01.2017;2017;01;02;Keskiviikko;1;0;1
623;18.01.2017;2017;01;03;Keskiviikko;0;1;1
623;18.01.2017;2017;01;04;Keskiviikko;0;0;0
623;18.01.2017;2017;01;05;Keskiviikko;0;2;2
623;18.01.2017;2017;01;06;Keskiviikko;0;3;3
623;18.01.2017;2017;01;07;Keskiviikko;3;11;14
623;18.01.2017;2017;01;08;Keskiviikko;38;87;125
623;18.01.2017;2017;01;09;Keskiviikko;31;56;87
623;18.01.2017;2017;01;10;Keskiviikko;26;48;74
623;18.01.2017;2017;01;11;Keskiviikko;26;24;50
623;18.01.2017;2017;01;12;Keskiviikko;30;28;58
623;18.01.2017;2017;01;13;Keskiviikko;26;23;49
623;18.01.2017;2017;01;14;Keskiviikko;27;28;55
623;18.01.2017;2017;01;15;Keskiviikko;50;26;76
623;18.01.2017;2017;01;16;Keskiviikko;61;22;83
623;18.01.2017;2017;01;17;Keskiviikko;76;49;125
623;18.01.2017;2017;01;18;Keskiviikko;46;45;91
623;18.01.2017;2017;01;19;Keskiviikko;36;19;55
623;18.01.2017;2017;01;20;Keskiviikko;27;15;42
623;18.01.2017;2017;01;21;Keskiviikko;33;15;48
623;18.01.2017;2017;01;22;Keskiviikko;14;9;23
623;18.01.2017;2017;01;23;Keskiviikko;9;4;13
623;19.01.2017;2017;01;00;Torstai;3;4;7
623;19.01.2017;2017;01;01;Torstai;3;4;7
623;19.01.2017;2017;01;02;Torstai;1;1;2
623;19.01.2017;2017;01;03;Torstai;1;0;1
623;19.01.2017;2017;01;04;Torstai;1;2;3
623;19.01.2017;2017;01;05;Torstai;2;1;3
623;19.01.2017;2017;01;06;Torstai;0;5;5
623;19.01.2017;2017;01;07;Torstai;7;25;32
623;19.01.2017;2017;01;08;Torstai;31;67;98
623;19.01.2017;2017;01;09;Torstai;31;72;103
623;19.01.2017;2017;01;10;Torstai;23;25;48
623;19.01.2017;2017;01;11;Torstai;13;27;40
623;19.01.2017;2017;01;12;Torstai;24;20;44
623;19.01.2017;2017;01;13;Torstai;34;23;57
623;19.01.2017;2017;01;14;Torstai;20;19;39
623;19.01.2017;2017;01;15;Torstai;42;17;59
623;19.01.2017;2017;01;16;Torstai;36;25;61
623;19.01.2017;2017;01;17;Torstai;56;40;96
623;19.01.2017;2017;01;18;Torstai;33;34;67
623;19.01.2017;2017;01;19;Torstai;30;20;50
623;19.01.2017;2017;01;20;Torstai;13;10;23
623;19.01.2017;2017;01;21;Torstai;11;10;21
623;19.01.2017;2017;01;22;Torstai;14;5;19
623;19.01.2017;2017;01;23;Torstai;2;3;5
623;20.01.2017;2017;01;00;Perjantai;1;5;6
623;20.01.2017;2017;01;01;Perjantai;1;0;1
623;20.01.2017;2017;01;02;Perjantai;2;0;2
623;20.01.2017;2017;01;03;Perjantai;1;0;1
623;20.01.2017;2017;01;04;Perjantai;1;2;3
623;20.01.2017;2017;01;05;Perjantai;2;2;4
623;20.01.2017;2017;01;06;Perjantai;1;5;6
623;20.01.2017;2017;01;07;Perjantai;5;26;31
623;20.01.2017;2017;01;08;Perjantai;24;55;79
623;20.01.2017;2017;01;09;Perjantai;30;61;91
623;20.01.2017;2017;01;10;Perjantai;18;28;46
623;20.01.2017;2017;01;11;Perjantai;16;24;40
623;20.01.2017;2017;01;12;Perjantai;24;23;47
623;20.01.2017;2017;01;13;Perjantai;26;22;48
623;20.01.2017;2017;01;14;Perjantai;33;30;63
623;20.01.2017;2017;01;15;Perjantai;42;32;74
623;20.01.2017;2017;01;16;Perjantai;41;22;63
623;20.01.2017;2017;01;17;Perjantai;51;31;82
623;20.01.2017;2017;01;18;Perjantai;19;18;37
623;20.01.2017;2017;01;19;Perjantai;25;17;42
623;20.01.2017;2017;01;20;Perjantai;11;11;22
623;20.01.2017;2017;01;21;Perjantai;17;9;26
623;20.01.2017;2017;01;22;Perjantai;10;4;14
623;20.01.2017;2017;01;23;Perjantai;10;6;16
623;21.01.2017;2017;01;00;Lauantai;6;2;8
623;21.01.2017;2017;01;01;Lauantai;3;1;4
623;21.01.2017;2017;01;02;Lauantai;4;4;8
623;21.01.2017;2017;01;03;Lauantai;2;1;3
623;21.01.2017;2017;01;04;Lauantai;2;0;2
623;21.01.2017;2017;01;05;Lauantai;2;3;5
623;21.01.2017;2017;01;06;Lauantai;1;5;6
623;21.01.2017;2017;01;07;Lauantai;4;4;8
623;21.01.2017;2017;01;08;Lauantai;0;7;7
623;21.01.2017;2017;01;09;Lauantai;3;5;8
623;21.01.2017;2017;01;10;Lauantai;2;11;13
623;21.01.2017;2017;01;11;Lauantai;6;12;18
623;21.01.2017;2017;01;12;Lauantai;7;13;20
623;21.01.2017;2017;01;13;Lauantai;8;22;30
623;21.01.2017;2017;01;14;Lauantai;20;17;37
623;21.01.2017;2017;01;15;Lauantai;20;19;39
623;21.01.2017;2017;01;16;Lauantai;20;15;35
623;21.01.2017;2017;01;17;Lauantai;11;14;25
623;21.01.2017;2017;01;18;Lauantai;8;14;22
623;21.01.2017;2017;01;19;Lauantai;12;7;19
623;21.01.2017;2017;01;20;Lauantai;12;8;20
623;21.01.2017;2017;01;21;Lauantai;7;11;18
623;21.01.2017;2017;01;22;Lauantai;5;8;13
623;21.01.2017;2017;01;23;Lauantai;7;4;11
623;22.01.2017;2017;01;00;Sunnuntai;8;3;11
623;22.01.2017;2017;01;01;Sunnuntai;1;1;2
623;22.01.2017;2017;01;02;Sunnuntai;8;3;11
623;22.01.2017;2017;01;03;Sunnuntai;5;2;7
623;22.01.2017;2017;01;04;Sunnuntai;1;1;2
623;22.01.2017;2017;01;05;Sunnuntai;3;1;4
623;22.01.2017;2017;01;06;Sunnuntai;1;2;3
623;22.01.2017;2017;01;07;Sunnuntai;3;2;5
623;22.01.2017;2017;01;08;Sunnuntai;2;4;6
623;22.01.2017;2017;01;09;Sunnuntai;1;2;3
623;22.01.2017;2017;01;10;Sunnuntai;2;5;7
623;22.01.2017;2017;01;11;Sunnuntai;3;11;14
623;22.01.2017;2017;01;12;Sunnuntai;15;12;27
623;22.01.2017;2017;01;13;Sunnuntai;11;10;21
623;22.01.2017;2017;01;14;Sunnuntai;13;14;27
623;22.01.2017;2017;01;15;Sunnuntai;12;17;29
623;22.01.2017;2017;01;16;Sunnuntai;12;23;35
623;22.01.2017;2017;01;17;Sunnuntai;15;10;25
623;22.01.2017;2017;01;18;Sunnuntai;18;14;32
623;22.01.2017;2017;01;19;Sunnuntai;12;10;22
623;22.01.2017;2017;01;20;Sunnuntai;14;11;25
623;22.01.2017;2017;01;21;Sunnuntai;13;10;23
623;22.01.2017;2017;01;22;Sunnuntai;14;6;20
623;22.01.2017;2017;01;23;Sunnuntai;2;3;5
623;23.01.2017;2017;01;00;Maanantai;0;3;3
623;23.01.2017;2017;01;01;Maanantai;1;0;1
623;23.01.2017;2017;01;02;Maanantai;2;1;3
623;23.01.2017;2017;01;03;Maanantai;1;1;2
623;23.01.2017;2017;01;04;Maanantai;1;0;1
623;23.01.2017;2017;01;05;Maanantai;0;2;2
623;23.01.2017;2017;01;06;Maanantai;0;8;8
623;23.01.2017;2017;01;07;Maanantai;6;29;35
623;23.01.2017;2017;01;08;Maanantai;35;53;88
623;23.01.2017;2017;01;09;Maanantai;37;77;114
623;23.01.2017;2017;01;10;Maanantai;33;38;71
623;23.01.2017;2017;01;11;Maanantai;17;23;40
623;23.01.2017;2017;01;12;Maanantai;30;20;50
623;23.01.2017;2017;01;13;Maanantai;24;31;55
623;23.01.2017;2017;01;14;Maanantai;25;26;51
623;23.01.2017;2017;01;15;Maanantai;56;29;85
623;23.01.2017;2017;01;16;Maanantai;42;39;81
623;23.01.2017;2017;01;17;Maanantai;88;59;147
623;23.01.2017;2017;01;18;Maanantai;36;44;80
623;23.01.2017;2017;01;19;Maanantai;33;16;49
623;23.01.2017;2017;01;20;Maanantai;30;8;38
623;23.01.2017;2017;01;21;Maanantai;19;9;28
623;23.01.2017;2017;01;22;Maanantai;9;10;19
623;23.01.2017;2017;01;23;Maanantai;4;4;8
623;24.01.2017;2017;01;00;Tiistai;2;1;3
623;24.01.2017;2017;01;01;Tiistai;2;2;4
623;24.01.2017;2017;01;02;Tiistai;1;0;1
623;24.01.2017;2017;01;03;Tiistai;0;1;1
623;24.01.2017;2017;01;04;Tiistai;1;1;2
623;24.01.2017;2017;01;05;Tiistai;1;5;6
623;24.01.2017;2017;01;06;Tiistai;1;8;9
623;24.01.2017;2017;01;07;Tiistai;11;32;43
623;24.01.2017;2017;01;08;Tiistai;40;60;100
623;24.01.2017;2017;01;09;Tiistai;44;81;125
623;24.01.2017;2017;01;10;Tiistai;20;18;38
623;24.01.2017;2017;01;11;Tiistai;23;15;38
623;24.01.2017;2017;01;12;Tiistai;14;14;28
623;24.01.2017;2017;01;13;Tiistai;36;20;56
623;24.01.2017;2017;01;14;Tiistai;26;18;44
623;24.01.2017;2017;01;15;Tiistai;30;30;60
623;24.01.2017;2017;01;16;Tiistai;53;36;89
623;24.01.2017;2017;01;17;Tiistai;60;51;111
623;24.01.2017;2017;01;18;Tiistai;40;33;73
623;24.01.2017;2017;01;19;Tiistai;19;14;33
623;24.01.2017;2017;01;20;Tiistai;0;0;0
623;24.01.2017;2017;01;21;Tiistai;26;19;45
623;24.01.2017;2017;01;22;Tiistai;14;6;20
623;24.01.2017;2017;01;23;Tiistai;2;2;4
623;25.01.2017;2017;01;00;Keskiviikko;2;0;2
623;25.01.2017;2017;01;01;Keskiviikko;4;0;4
623;25.01.2017;2017;01;02;Keskiviikko;2;0;2
623;25.01.2017;2017;01;03;Keskiviikko;0;1;1
623;25.01.2017;2017;01;04;Keskiviikko;0;0;0
623;25.01.2017;2017;01;05;Keskiviikko;2;11;13
623;25.01.2017;2017;01;06;Keskiviikko;0;3;3
623;25.01.2017;2017;01;07;Keskiviikko;7;31;38
623;25.01.2017;2017;01;08;Keskiviikko;32;69;101
623;25.01.2017;2017;01;09;Keskiviikko;31;59;90
623;25.01.2017;2017;01;10;Keskiviikko;21;25;46
623;25.01.2017;2017;01;11;Keskiviikko;21;28;49
623;25.01.2017;2017;01;12;Keskiviikko;25;28;53
623;25.01.2017;2017;01;13;Keskiviikko;21;26;47
623;25.01.2017;2017;01;14;Keskiviikko;37;26;63
623;25.01.2017;2017;01;15;Keskiviikko;32;23;55
623;25.01.2017;2017;01;16;Keskiviikko;61;31;92
623;25.01.2017;2017;01;17;Keskiviikko;59;33;92
623;25.01.2017;2017;01;18;Keskiviikko;45;39;84
623;25.01.2017;2017;01;19;Keskiviikko;36;16;52
623;25.01.2017;2017;01;20;Keskiviikko;20;14;34
623;25.01.2017;2017;01;21;Keskiviikko;21;11;32
623;25.01.2017;2017;01;22;Keskiviikko;7;13;20
623;25.01.2017;2017;01;23;Keskiviikko;11;5;16
623;26.01.2017;2017;01;00;Torstai;5;3;8
623;26.01.2017;2017;01;01;Torstai;1;1;2
623;26.01.2017;2017;01;02;Torstai;3;0;3
623;26.01.2017;2017;01;03;Torstai;1;2;3
623;26.01.2017;2017;01;04;Torstai;0;0;0
623;26.01.2017;2017;01;05;Torstai;0;4;4
623;26.01.2017;2017;01;06;Torstai;1;11;12
623;26.01.2017;2017;01;07;Torstai;7;33;40
623;26.01.2017;2017;01;08;Torstai;28;62;90
623;26.01.2017;2017;01;09;Torstai;32;54;86
623;26.01.2017;2017;01;10;Torstai;27;28;55
623;26.01.2017;2017;01;11;Torstai;18;25;43
623;26.01.2017;2017;01;12;Torstai;17;23;40
623;26.01.2017;2017;01;13;Torstai;33;28;61
623;26.01.2017;2017;01;14;Torstai;34;25;59
623;26.01.2017;2017;01;15;Torstai;41;36;77
623;26.01.2017;2017;01;16;Torstai;53;26;79
623;26.01.2017;2017;01;17;Torstai;56;40;96
623;26.01.2017;2017;01;18;Torstai;40;33;73
623;26.01.2017;2017;01;19;Torstai;31;23;54
623;26.01.2017;2017;01;20;Torstai;16;19;35
623;26.01.2017;2017;01;21;Torstai;15;9;24
623;26.01.2017;2017;01;22;Torstai;19;3;22
623;26.01.2017;2017;01;23;Torstai;4;3;7
623;27.01.2017;2017;01;00;Perjantai;7;3;10
623;27.01.2017;2017;01;01;Perjantai;2;2;4
623;27.01.2017;2017;01;02;Perjantai;2;0;2
623;27.01.2017;2017;01;03;Perjantai;1;2;3
623;27.01.2017;2017;01;04;Perjantai;0;0;0
623;27.01.2017;2017;01;05;Perjantai;0;3;3
623;27.01.2017;2017;01;06;Perjantai;0;9;9
623;27.01.2017;2017;01;07;Perjantai;7;29;36
623;27.01.2017;2017;01;08;Perjantai;26;65;91
623;27.01.2017;2017;01;09;Perjantai;30;57;87
623;27.01.2017;2017;01;10;Perjantai;24;39;63
623;27.01.2017;2017;01;11;Perjantai;18;27;45
623;27.01.2017;2017;01;12;Perjantai;19;22;41
623;27.01.2017;2017;01;13;Perjantai;38;39;77
623;27.01.2017;2017;01;14;Perjantai;45;33;78
623;27.01.2017;2017;01;15;Perjantai;53;36;89
623;27.01.2017;2017;01;16;Perjantai;47;25;72
623;27.01.2017;2017;01;17;Perjantai;49;37;86
623;27.01.2017;2017;01;18;Perjantai;27;22;49
623;27.01.2017;2017;01;19;Perjantai;30;15;45
623;27.01.2017;2017;01;20;Perjantai;14;14;28
623;27.01.2017;2017;01;21;Perjantai;11;15;26
623;27.01.2017;2017;01;22;Perjantai;11;5;16
623;27.01.2017;2017;01;23;Perjantai;11;1;12
623;28.01.2017;2017;01;00;Lauantai;7;4;11
623;28.01.2017;2017;01;01;Lauantai;5;1;6
623;28.01.2017;2017;01;02;Lauantai;4;2;6
623;28.01.2017;2017;01;03;Lauantai;2;2;4
623;28.01.2017;2017;01;04;Lauantai;4;1;5
623;28.01.2017;2017;01;05;Lauantai;2;4;6
623;28.01.2017;2017;01;06;Lauantai;1;6;7
623;28.01.2017;2017;01;07;Lauantai;1;4;5
623;28.01.2017;2017;01;08;Lauantai;6;7;13
623;28.01.2017;2017;01;09;Lauantai;6;9;15
623;28.01.2017;2017;01;10;Lauantai;4;16;20
623;28.01.2017;2017;01;11;Lauantai;10;13;23
623;28.01.2017;2017;01;12;Lauantai;23;27;50
623;28.01.2017;2017;01;13;Lauantai;20;27;47
623;28.01.2017;2017;01;14;Lauantai;19;22;41
623;28.01.2017;2017;01;15;Lauantai;14;10;24
623;28.01.2017;2017;01;16;Lauantai;20;14;34
623;28.01.2017;2017;01;17;Lauantai;14;12;26
623;28.01.2017;2017;01;18;Lauantai;11;14;25
623;28.01.2017;2017;01;19;Lauantai;11;13;24
623;28.01.2017;2017;01;20;Lauantai;16;11;27
623;28.01.2017;2017;01;21;Lauantai;10;10;20
623;28.01.2017;2017;01;22;Lauantai;11;6;17
623;28.01.2017;2017;01;23;Lauantai;7;5;12
623;29.01.2017;2017;01;00;Sunnuntai;2;1;3
623;29.01.2017;2017;01;01;Sunnuntai;2;6;8
623;29.01.2017;2017;01;02;Sunnuntai;2;2;4
623;29.01.2017;2017;01;03;Sunnuntai;2;1;3
623;29.01.2017;2017;01;04;Sunnuntai;1;1;2
623;29.01.2017;2017;01;05;Sunnuntai;5;1;6
623;29.01.2017;2017;01;06;Sunnuntai;1;2;3
623;29.01.2017;2017;01;07;Sunnuntai;3;5;8
623;29.01.2017;2017;01;08;Sunnuntai;2;4;6
623;29.01.2017;2017;01;09;Sunnuntai;2;3;5
623;29.01.2017;2017;01;10;Sunnuntai;6;9;15
623;29.01.2017;2017;01;11;Sunnuntai;1;18;19
623;29.01.2017;2017;01;12;Sunnuntai;13;8;21
623;29.01.2017;2017;01;13;Sunnuntai;11;19;30
623;29.01.2017;2017;01;14;Sunnuntai;15;21;36
623;29.01.2017;2017;01;15;Sunnuntai;16;13;29
623;29.01.2017;2017;01;16;Sunnuntai;33;14;47
623;29.01.2017;2017;01;17;Sunnuntai;8;13;21
623;29.01.2017;2017;01;18;Sunnuntai;27;21;48
623;29.01.2017;2017;01;19;Sunnuntai;17;11;28
623;29.01.2017;2017;01;20;Sunnuntai;10;11;21
623;29.01.2017;2017;01;21;Sunnuntai;10;6;16
623;29.01.2017;2017;01;22;Sunnuntai;11;9;20
623;29.01.2017;2017;01;23;Sunnuntai;3;3;6
623;30.01.2017;2017;01;00;Maanantai;3;3;6
623;30.01.2017;2017;01;01;Maanantai;8;2;10
623;30.01.2017;2017;01;02;Maanantai;0;2;2
623;30.01.2017;2017;01;03;Maanantai;1;1;2
623;30.01.2017;2017;01;04;Maanantai;0;2;2
623;30.01.2017;2017;01;05;Maanantai;0;3;3
623;30.01.2017;2017;01;06;Maanantai;1;7;8
623;30.01.2017;2017;01;07;Maanantai;7;34;41
623;30.01.2017;2017;01;08;Maanantai;23;60;83
623;30.01.2017;2017;01;09;Maanantai;29;73;102
623;30.01.2017;2017;01;10;Maanantai;29;29;58
623;30.01.2017;2017;01;11;Maanantai;16;17;33
623;30.01.2017;2017;01;12;Maanantai;29;17;46
623;30.01.2017;2017;01;13;Maanantai;27;14;41
623;30.01.2017;2017;01;14;Maanantai;13;22;35
623;30.01.2017;2017;01;15;Maanantai;40;26;66
623;30.01.2017;2017;01;16;Maanantai;76;33;109
623;30.01.2017;2017;01;17;Maanantai;71;50;121
623;30.01.2017;2017;01;18;Maanantai;43;38;81
623;30.01.2017;2017;01;19;Maanantai;27;25;52
623;30.01.2017;2017;01;20;Maanantai;22;10;32
623;30.01.2017;2017;01;21;Maanantai;14;13;27
623;30.01.2017;2017;01;22;Maanantai;13;6;19
623;30.01.2017;2017;01;23;Maanantai;6;7;13
623;31.01.2017;2017;01;00;Tiistai;5;1;6
623;31.01.2017;2017;01;01;Tiistai;3;0;3
623;31.01.2017;2017;01;02;Tiistai;1;0;1
623;31.01.2017;2017;01;03;Tiistai;0;1;1
623;31.01.2017;2017;01;04;Tiistai;1;2;3
623;31.01.2017;2017;01;05;Tiistai;0;4;4
623;31.01.2017;2017;01;06;Tiistai;1;5;6
623;31.01.2017;2017;01;07;Tiistai;11;36;47
623;31.01.2017;2017;01;08;Tiistai;37;67;104
623;31.01.2017;2017;01;09;Tiistai;38;78;116
623;31.01.2017;2017;01;10;Tiistai;21;30;51
623;31.01.2017;2017;01;11;Tiistai;26;18;44
623;31.01.2017;2017;01;12;Tiistai;26;18;44
623;31.01.2017;2017;01;13;Tiistai;23;24;47
623;31.01.2017;2017;01;14;Tiistai;32;29;61
623;31.01.2017;2017;01;15;Tiistai;37;34;71
623;31.01.2017;2017;01;16;Tiistai;66;38;104
623;31.01.2017;2017;01;17;Tiistai;65;46;111
623;31.01.2017;2017;01;18;Tiistai;37;37;74
623;31.01.2017;2017;01;19;Tiistai;42;20;62
623;31.01.2017;2017;01;20;Tiistai;21;15;36
623;31.01.2017;2017;01;21;Tiistai;18;8;26
623;31.01.2017;2017;01;22;Tiistai;20;5;25
623;31.01.2017;2017;01;23;Tiistai;4;7;11
623;01.02.2017;2017;02;00;Keskiviikko;2;0;2
623;01.02.2017;2017;02;01;Keskiviikko;4;1;5
623;01.02.2017;2017;02;02;Keskiviikko;4;0;4
623;01.02.2017;2017;02;03;Keskiviikko;2;0;2
623;01.02.2017;2017;02;04;Keskiviikko;0;1;1
623;01.02.2017;2017;02;05;Keskiviikko;0;1;1
623;01.02.2017;2017;02;06;Keskiviikko;0;8;8
623;01.02.2017;2017;02;07;Keskiviikko;7;24;31
623;01.02.2017;2017;02;08;Keskiviikko;31;67;98
623;01.02.2017;2017;02;09;Keskiviikko;34;72;106
623;01.02.2017;2017;02;10;Keskiviikko;25;23;48
623;01.02.2017;2017;02;11;Keskiviikko;18;20;38
623;01.02.2017;2017;02;12;Keskiviikko;34;24;58
623;01.02.2017;2017;02;13;Keskiviikko;23;15;38
623;01.02.2017;2017;02;14;Keskiviikko;33;30;63
623;01.02.2017;2017;02;15;Keskiviikko;40;25;65
623;01.02.2017;2017;02;16;Keskiviikko;49;36;85
623;01.02.2017;2017;02;17;Keskiviikko;63;47;110
623;01.02.2017;2017;02;18;Keskiviikko;35;36;71
623;01.02.2017;2017;02;19;Keskiviikko;34;27;61
623;01.02.2017;2017;02;20;Keskiviikko;18;14;32
623;01.02.2017;2017;02;21;Keskiviikko;18;11;29
623;01.02.2017;2017;02;22;Keskiviikko;20;11;31
623;01.02.2017;2017;02;23;Keskiviikko;13;5;18
623;02.02.2017;2017;02;00;Torstai;3;0;3
623;02.02.2017;2017;02;01;Torstai;4;1;5
623;02.02.2017;2017;02;02;Torstai;1;0;1
623;02.02.2017;2017;02;03;Torstai;2;2;4
623;02.02.2017;2017;02;04;Torstai;2;1;3
623;02.02.2017;2017;02;05;Torstai;0;1;1
623;02.02.2017;2017;02;06;Torstai;3;6;9
623;02.02.2017;2017;02;07;Torstai;8;28;36
623;02.02.2017;2017;02;08;Torstai;39;67;106
623;02.02.2017;2017;02;09;Torstai;26;60;86
623;02.02.2017;2017;02;10;Torstai;24;26;50
623;02.02.2017;2017;02;11;Torstai;24;27;51
623;02.02.2017;2017;02;12;Torstai;25;19;44
623;02.02.2017;2017;02;13;Torstai;21;17;38
623;02.02.2017;2017;02;14;Torstai;34;26;60
623;02.02.2017;2017;02;15;Torstai;34;31;65
623;02.02.2017;2017;02;16;Torstai;62;30;92
623;02.02.2017;2017;02;17;Torstai;45;33;78
623;02.02.2017;2017;02;18;Torstai;31;33;64
623;02.02.2017;2017;02;19;Torstai;22;16;38
623;02.02.2017;2017;02;20;Torstai;7;10;17
623;02.02.2017;2017;02;21;Torstai;12;10;22
623;02.02.2017;2017;02;22;Torstai;10;3;13
623;02.02.2017;2017;02;23;Torstai;5;3;8
623;03.02.2017;2017;02;00;Perjantai;3;4;7
623;03.02.2017;2017;02;01;Perjantai;6;1;7
623;03.02.2017;2017;02;02;Perjantai;2;1;3
623;03.02.2017;2017;02;03;Perjantai;3;0;3
623;03.02.2017;2017;02;04;Perjantai;2;2;4
623;03.02.2017;2017;02;05;Perjantai;1;2;3
623;03.02.2017;2017;02;06;Perjantai;2;5;7
623;03.02.2017;2017;02;07;Perjantai;3;18;21
623;03.02.2017;2017;02;08;Perjantai;28;51;79
623;03.02.2017;2017;02;09;Perjantai;32;62;94
623;03.02.2017;2017;02;10;Perjantai;17;22;39
623;03.02.2017;2017;02;11;Perjantai;18;17;35
623;03.02.2017;2017;02;12;Perjantai;15;21;36
623;03.02.2017;2017;02;13;Perjantai;21;25;46
623;03.02.2017;2017;02;14;Perjantai;35;26;61
623;03.02.2017;2017;02;15;Perjantai;36;24;60
623;03.02.2017;2017;02;16;Perjantai;45;32;77
623;03.02.2017;2017;02;17;Perjantai;45;32;77
623;03.02.2017;2017;02;18;Perjantai;26;28;54
623;03.02.2017;2017;02;19;Perjantai;27;16;43
623;03.02.2017;2017;02;20;Perjantai;15;12;27
623;03.02.2017;2017;02;21;Perjantai;12;12;24
623;03.02.2017;2017;02;22;Perjantai;15;8;23
623;03.02.2017;2017;02;23;Perjantai;6;8;14
623;04.02.2017;2017;02;00;Lauantai;4;1;5
623;04.02.2017;2017;02;01;Lauantai;5;3;8
623;04.02.2017;2017;02;02;Lauantai;6;0;6
623;04.02.2017;2017;02;03;Lauantai;2;3;5
623;04.02.2017;2017;02;04;Lauantai;1;0;1
623;04.02.2017;2017;02;05;Lauantai;5;0;5
623;04.02.2017;2017;02;06;Lauantai;2;1;3
623;04.02.2017;2017;02;07;Lauantai;2;4;6
623;04.02.2017;2017;02;08;Lauantai;2;5;7
623;04.02.2017;2017;02;09;Lauantai;6;9;15
623;04.02.2017;2017;02;10;Lauantai;4;17;21
623;04.02.2017;2017;02;11;Lauantai;11;16;27
623;04.02.2017;2017;02;12;Lauantai;9;19;28
623;04.02.2017;2017;02;13;Lauantai;16;14;30
623;04.02.2017;2017;02;14;Lauantai;12;10;22
623;04.02.2017;2017;02;15;Lauantai;17;13;30
623;04.02.2017;2017;02;16;Lauantai;15;15;30
623;04.02.2017;2017;02;17;Lauantai;17;14;31
623;04.02.2017;2017;02;18;Lauantai;23;11;34
623;04.02.2017;2017;02;19;Lauantai;8;12;20
623;04.02.2017;2017;02;20;Lauantai;13;14;27
623;04.02.2017;2017;02;21;Lauantai;8;6;14
623;04.02.2017;2017;02;22;Lauantai;10;4;14
623;04.02.2017;2017;02;23;Lauantai;7;6;13
623;05.02.2017;2017;02;00;Sunnuntai;8;7;15
623;05.02.2017;2017;02;01;Sunnuntai;4;4;8
623;05.02.2017;2017;02;02;Sunnuntai;7;0;7
623;05.02.2017;2017;02;03;Sunnuntai;3;1;4
623;05.02.2017;2017;02;04;Sunnuntai;6;1;7
623;05.02.2017;2017;02;05;Sunnuntai;3;1;4
623;05.02.2017;2017;02;06;Sunnuntai;2;2;4
623;05.02.2017;2017;02;07;Sunnuntai;0;4;4
623;05.02.2017;2017;02;08;Sunnuntai;2;1;3
623;05.02.2017;2017;02;09;Sunnuntai;2;2;4
623;05.02.2017;2017;02;10;Sunnuntai;3;10;13
623;05.02.2017;2017;02;11;Sunnuntai;4;8;12
623;05.02.2017;2017;02;12;Sunnuntai;10;13;23
623;05.02.2017;2017;02;13;Sunnuntai;8;17;25
623;05.02.2017;2017;02;14;Sunnuntai;13;23;36
623;05.02.2017;2017;02;15;Sunnuntai;19;19;38
623;05.02.2017;2017;02;16;Sunnuntai;19;7;26
623;05.02.2017;2017;02;17;Sunnuntai;15;11;26
623;05.02.2017;2017;02;18;Sunnuntai;14;17;31
623;05.02.2017;2017;02;19;Sunnuntai;9;11;20
623;05.02.2017;2017;02;20;Sunnuntai;5;9;14
623;05.02.2017;2017;02;21;Sunnuntai;6;4;10
623;05.02.2017;2017;02;22;Sunnuntai;12;6;18
623;05.02.2017;2017;02;23;Sunnuntai;3;4;7
623;06.02.2017;2017;02;00;Maanantai;1;0;1
623;06.02.2017;2017;02;01;Maanantai;4;0;4
623;06.02.2017;2017;02;02;Maanantai;2;1;3
623;06.02.2017;2017;02;03;Maanantai;1;1;2
623;06.02.2017;2017;02;04;Maanantai;0;1;1
623;06.02.2017;2017;02;05;Maanantai;0;1;1
623;06.02.2017;2017;02;06;Maanantai;1;7;8
623;06.02.2017;2017;02;07;Maanantai;6;27;33
623;06.02.2017;2017;02;08;Maanantai;24;65;89
623;06.02.2017;2017;02;09;Maanantai;33;64;97
623;06.02.2017;2017;02;10;Maanantai;25;23;48
623;06.02.2017;2017;02;11;Maanantai;13;24;37
623;06.02.2017;2017;02;12;Maanantai;23;15;38
623;06.02.2017;2017;02;13;Maanantai;23;16;39
623;06.02.2017;2017;02;14;Maanantai;28;23;51
623;06.02.2017;2017;02;15;Maanantai;40;24;64
623;06.02.2017;2017;02;16;Maanantai;58;21;79
623;06.02.2017;2017;02;17;Maanantai;58;43;101
623;06.02.2017;2017;02;18;Maanantai;60;40;100
623;06.02.2017;2017;02;19;Maanantai;24;17;41
623;06.02.2017;2017;02;20;Maanantai;23;18;41
623;06.02.2017;2017;02;21;Maanantai;18;14;32
623;06.02.2017;2017;02;22;Maanantai;13;6;19
623;06.02.2017;2017;02;23;Maanantai;3;6;9
623;07.02.2017;2017;02;00;Tiistai;2;1;3
623;07.02.2017;2017;02;01;Tiistai;0;1;1
623;07.02.2017;2017;02;02;Tiistai;0;0;0
623;07.02.2017;2017;02;03;Tiistai;2;1;3
623;07.02.2017;2017;02;04;Tiistai;0;0;0
623;07.02.2017;2017;02;05;Tiistai;1;2;3
623;07.02.2017;2017;02;06;Tiistai;1;2;3
623;07.02.2017;2017;02;07;Tiistai;7;30;37
623;07.02.2017;2017;02;08;Tiistai;34;64;98
623;07.02.2017;2017;02;09;Tiistai;30;73;103
623;07.02.2017;2017;02;10;Tiistai;26;25;51
623;07.02.2017;2017;02;11;Tiistai;21;21;42
623;07.02.2017;2017;02;12;Tiistai;26;17;43
623;07.02.2017;2017;02;13;Tiistai;30;26;56
623;07.02.2017;2017;02;14;Tiistai;26;20;46
623;07.02.2017;2017;02;15;Tiistai;30;21;51
623;07.02.2017;2017;02;16;Tiistai;55;35;90
623;07.02.2017;2017;02;17;Tiistai;68;44;112
623;07.02.2017;2017;02;18;Tiistai;33;38;71
623;07.02.2017;2017;02;19;Tiistai;31;19;50
623;07.02.2017;2017;02;20;Tiistai;25;15;40
623;07.02.2017;2017;02;21;Tiistai;11;6;17
623;07.02.2017;2017;02;22;Tiistai;13;10;23
623;07.02.2017;2017;02;23;Tiistai;6;6;12
623;08.02.2017;2017;02;00;Keskiviikko;1;0;1
623;08.02.2017;2017;02;01;Keskiviikko;1;1;2
623;08.02.2017;2017;02;02;Keskiviikko;1;1;2
623;08.02.2017;2017;02;03;Keskiviikko;1;1;2
623;08.02.2017;2017;02;04;Keskiviikko;2;1;3
623;08.02.2017;2017;02;05;Keskiviikko;1;2;3
623;08.02.2017;2017;02;06;Keskiviikko;0;9;9
623;08.02.2017;2017;02;07;Keskiviikko;4;31;35
623;08.02.2017;2017;02;08;Keskiviikko;20;40;60
623;08.02.2017;2017;02;09;Keskiviikko;31;51;82
623;08.02.2017;2017;02;10;Keskiviikko;15;22;37
623;08.02.2017;2017;02;11;Keskiviikko;17;13;30
623;08.02.2017;2017;02;12;Keskiviikko;14;22;36
623;08.02.2017;2017;02;13;Keskiviikko;18;20;38
623;08.02.2017;2017;02;14;Keskiviikko;23;19;42
623;08.02.2017;2017;02;15;Keskiviikko;38;31;69
623;08.02.2017;2017;02;16;Keskiviikko;49;32;81
623;08.02.2017;2017;02;17;Keskiviikko;52;37;89
623;08.02.2017;2017;02;18;Keskiviikko;26;16;42
623;08.02.2017;2017;02;19;Keskiviikko;27;21;48
623;08.02.2017;2017;02;20;Keskiviikko;17;8;25
623;08.02.2017;2017;02;21;Keskiviikko;10;6;16
623;08.02.2017;2017;02;22;Keskiviikko;12;13;25
623;08.02.2017;2017;02;23;Keskiviikko;8;2;10
623;09.02.2017;2017;02;00;Torstai;5;6;11
623;09.02.2017;2017;02;01;Torstai;4;1;5
623;09.02.2017;2017;02;02;Torstai;1;1;2
623;09.02.2017;2017;02;03;Torstai;2;1;3
623;09.02.2017;2017;02;04;Torstai;0;1;1
623;09.02.2017;2017;02;05;Torstai;0;5;5
623;09.02.2017;2017;02;06;Torstai;0;5;5
623;09.02.2017;2017;02;07;Torstai;2;25;27
623;09.02.2017;2017;02;08;Torstai;19;51;70
623;09.02.2017;2017;02;09;Torstai;19;44;63
623;09.02.2017;2017;02;10;Torstai;21;13;34
623;09.02.2017;2017;02;11;Torstai;11;23;34
623;09.02.2017;2017;02;12;Torstai;14;19;33
623;09.02.2017;2017;02;13;Torstai;21;18;39
623;09.02.2017;2017;02;14;Torstai;21;22;43
623;09.02.2017;2017;02;15;Torstai;33;20;53
623;09.02.2017;2017;02;16;Torstai;45;14;59
623;09.02.2017;2017;02;17;Torstai;36;36;72
623;09.02.2017;2017;02;18;Torstai;25;28;53
623;09.02.2017;2017;02;19;Torstai;18;18;36
623;09.02.2017;2017;02;20;Torstai;16;13;29
623;09.02.2017;2017;02;21;Torstai;16;10;26
623;09.02.2017;2017;02;22;Torstai;15;3;18
623;09.02.2017;2017;02;23;Torstai;1;2;3
623;10.02.2017;2017;02;00;Perjantai;4;5;9
623;10.02.2017;2017;02;01;Perjantai;5;1;6
623;10.02.2017;2017;02;02;Perjantai;0;0;0
623;10.02.2017;2017;02;03;Perjantai;0;1;1
623;10.02.2017;2017;02;04;Perjantai;3;1;4
623;10.02.2017;2017;02;05;Perjantai;2;5;7
623;10.02.2017;2017;02;06;Perjantai;1;3;4
623;10.02.2017;2017;02;07;Perjantai;4;23;27
623;10.02.2017;2017;02;08;Perjantai;24;67;91
623;10.02.2017;2017;02;09;Perjantai;32;57;89
623;10.02.2017;2017;02;10;Perjantai;13;32;45
623;10.02.2017;2017;02;11;Perjantai;18;18;36
623;10.02.2017;2017;02;12;Perjantai;19;25;44
623;10.02.2017;2017;02;13;Perjantai;31;37;68
623;10.02.2017;2017;02;14;Perjantai;26;26;52
623;10.02.2017;2017;02;15;Perjantai;57;31;88
623;10.02.2017;2017;02;16;Perjantai;44;31;75
623;10.02.2017;2017;02;17;Perjantai;43;34;77
623;10.02.2017;2017;02;18;Perjantai;33;29;62
623;10.02.2017;2017;02;19;Perjantai;19;22;41
623;10.02.2017;2017;02;20;Perjantai;12;14;26
623;10.02.2017;2017;02;21;Perjantai;8;12;20
623;10.02.2017;2017;02;22;Perjantai;13;3;16
623;10.02.2017;2017;02;23;Perjantai;13;7;20
623;11.02.2017;2017;02;00;Lauantai;4;5;9
623;11.02.2017;2017;02;01;Lauantai;3;2;5
623;11.02.2017;2017;02;02;Lauantai;2;0;2
623;11.02.2017;2017;02;03;Lauantai;6;1;7
623;11.02.2017;2017;02;04;Lauantai;2;0;2
623;11.02.2017;2017;02;05;Lauantai;3;3;6
623;11.02.2017;2017;02;06;Lauantai;0;2;2
623;11.02.2017;2017;02;07;Lauantai;1;5;6
623;11.02.2017;2017;02;08;Lauantai;0;7;7
623;11.02.2017;2017;02;09;Lauantai;1;12;13
623;11.02.2017;2017;02;10;Lauantai;2;16;18
623;11.02.2017;2017;02;11;Lauantai;4;10;14
623;11.02.2017;2017;02;12;Lauantai;11;16;27
623;11.02.2017;2017;02;13;Lauantai;18;15;33
623;11.02.2017;2017;02;14;Lauantai;17;11;28
623;11.02.2017;2017;02;15;Lauantai;14;14;28
623;11.02.2017;2017;02;16;Lauantai;12;18;30
623;11.02.2017;2017;02;17;Lauantai;16;15;31
623;11.02.2017;2017;02;18;Lauantai;15;11;26
623;11.02.2017;2017;02;19;Lauantai;8;15;23
623;11.02.2017;2017;02;20;Lauantai;14;9;23
623;11.02.2017;2017;02;21;Lauantai;10;5;15
623;11.02.2017;2017;02;22;Lauantai;11;8;19
623;11.02.2017;2017;02;23;Lauantai;10;3;13
623;12.02.2017;2017;02;00;Sunnuntai;2;4;6
623;12.02.2017;2017;02;01;Sunnuntai;8;2;10
623;12.02.2017;2017;02;02;Sunnuntai;3;1;4
623;12.02.2017;2017;02;03;Sunnuntai;1;1;2
623;12.02.2017;2017;02;04;Sunnuntai;4;1;5
623;12.02.2017;2017;02;05;Sunnuntai;3;0;3
623;12.02.2017;2017;02;06;Sunnuntai;1;2;3
623;12.02.2017;2017;02;07;Sunnuntai;0;7;7
623;12.02.2017;2017;02;08;Sunnuntai;1;0;1
623;12.02.2017;2017;02;09;Sunnuntai;0;4;4
623;12.02.2017;2017;02;10;Sunnuntai;1;10;11
623;12.02.2017;2017;02;11;Sunnuntai;1;9;10
623;12.02.2017;2017;02;12;Sunnuntai;10;18;28
623;12.02.2017;2017;02;13;Sunnuntai;11;13;24
623;12.02.2017;2017;02;14;Sunnuntai;10;13;23
623;12.02.2017;2017;02;15;Sunnuntai;22;12;34
623;12.02.2017;2017;02;16;Sunnuntai;11;10;21
623;12.02.2017;2017;02;17;Sunnuntai;13;9;22
623;12.02.2017;2017;02;18;Sunnuntai;6;12;18
623;12.02.2017;2017;02;19;Sunnuntai;12;5;17
623;12.02.2017;2017;02;20;Sunnuntai;9;6;15
623;12.02.2017;2017;02;21;Sunnuntai;14;3;17
623;12.02.2017;2017;02;22;Sunnuntai;4;3;7
623;12.02.2017;2017;02;23;Sunnuntai;3;2;5
623;13.02.2017;2017;02;00;Maanantai;3;2;5
623;13.02.2017;2017;02;01;Maanantai;2;0;2
623;13.02.2017;2017;02;02;Maanantai;0;0;0
623;13.02.2017;2017;02;03;Maanantai;1;1;2
623;13.02.2017;2017;02;04;Maanantai;0;1;1
623;13.02.2017;2017;02;05;Maanantai;1;3;4
623;13.02.2017;2017;02;06;Maanantai;1;7;8
623;13.02.2017;2017;02;07;Maanantai;8;26;34
623;13.02.2017;2017;02;08;Maanantai;24;64;88
623;13.02.2017;2017;02;09;Maanantai;35;62;97
623;13.02.2017;2017;02;10;Maanantai;30;47;77
623;13.02.2017;2017;02;11;Maanantai;21;23;44
623;13.02.2017;2017;02;12;Maanantai;25;23;48
623;13.02.2017;2017;02;13;Maanantai;21;23;44
623;13.02.2017;2017;02;14;Maanantai;38;28;66
623;13.02.2017;2017;02;15;Maanantai;53;28;81
623;13.02.2017;2017;02;16;Maanantai;65;31;96
623;13.02.2017;2017;02;17;Maanantai;75;44;119
623;13.02.2017;2017;02;18;Maanantai;43;37;80
623;13.02.2017;2017;02;19;Maanantai;21;17;38
623;13.02.2017;2017;02;20;Maanantai;26;22;48
623;13.02.2017;2017;02;21;Maanantai;18;6;24
623;13.02.2017;2017;02;22;Maanantai;12;8;20
623;13.02.2017;2017;02;23;Maanantai;4;3;7
623;14.02.2017;2017;02;00;Tiistai;0;1;1
623;14.02.2017;2017;02;01;Tiistai;6;1;7
623;14.02.2017;2017;02;02;Tiistai;3;0;3
623;14.02.2017;2017;02;03;Tiistai;1;2;3
623;14.02.2017;2017;02;04;Tiistai;0;2;2
623;14.02.2017;2017;02;05;Tiistai;4;7;11
623;14.02.2017;2017;02;06;Tiistai;1;5;6
623;14.02.2017;2017;02;07;Tiistai;6;26;32
623;14.02.2017;2017;02;08;Tiistai;25;69;94
623;14.02.2017;2017;02;09;Tiistai;25;66;91
623;14.02.2017;2017;02;10;Tiistai;22;49;71
623;14.02.2017;2017;02;11;Tiistai;19;23;42
623;14.02.2017;2017;02;12;Tiistai;26;25;51
623;14.02.2017;2017;02;13;Tiistai;23;32;55
623;14.02.2017;2017;02;14;Tiistai;35;28;63
623;14.02.2017;2017;02;15;Tiistai;43;29;72
623;14.02.2017;2017;02;16;Tiistai;59;27;86
623;14.02.2017;2017;02;17;Tiistai;68;44;112
623;14.02.2017;2017;02;18;Tiistai;46;48;94
623;14.02.2017;2017;02;19;Tiistai;19;19;38
623;14.02.2017;2017;02;20;Tiistai;25;13;38
623;14.02.2017;2017;02;21;Tiistai;25;7;32
623;14.02.2017;2017;02;22;Tiistai;17;5;22
623;14.02.2017;2017;02;23;Tiistai;5;3;8
623;15.02.2017;2017;02;00;Keskiviikko;1;2;3
623;15.02.2017;2017;02;01;Keskiviikko;2;2;4
623;15.02.2017;2017;02;02;Keskiviikko;1;0;1
623;15.02.2017;2017;02;03;Keskiviikko;0;1;1
623;15.02.2017;2017;02;04;Keskiviikko;2;1;3
623;15.02.2017;2017;02;05;Keskiviikko;3;4;7
623;15.02.2017;2017;02;06;Keskiviikko;0;6;6
623;15.02.2017;2017;02;07;Keskiviikko;4;27;31
623;15.02.2017;2017;02;08;Keskiviikko;33;67;100
623;15.02.2017;2017;02;09;Keskiviikko;37;73;110
623;15.02.2017;2017;02;10;Keskiviikko;19;34;53
623;15.02.2017;2017;02;11;Keskiviikko;18;23;41
623;15.02.2017;2017;02;12;Keskiviikko;29;20;49
623;15.02.2017;2017;02;13;Keskiviikko;25;34;59
623;15.02.2017;2017;02;14;Keskiviikko;31;21;52
623;15.02.2017;2017;02;15;Keskiviikko;45;47;92
623;15.02.2017;2017;02;16;Keskiviikko;54;28;82
623;15.02.2017;2017;02;17;Keskiviikko;61;43;104
623;15.02.2017;2017;02;18;Keskiviikko;48;39;87
623;15.02.2017;2017;02;19;Keskiviikko;28;23;51
623;15.02.2017;2017;02;20;Keskiviikko;16;18;34
623;15.02.2017;2017;02;21;Keskiviikko;25;13;38
623;15.02.2017;2017;02;22;Keskiviikko;13;7;20
623;15.02.2017;2017;02;23;Keskiviikko;4;2;6
623;16.02.2017;2017;02;00;Torstai;3;2;5
623;16.02.2017;2017;02;01;Torstai;0;1;1
623;16.02.2017;2017;02;02;Torstai;2;1;3
623;16.02.2017;2017;02;03;Torstai;2;1;3
623;16.02.2017;2017;02;04;Torstai;1;3;4
623;16.02.2017;2017;02;05;Torstai;2;2;4
623;16.02.2017;2017;02;06;Torstai;2;5;7
623;16.02.2017;2017;02;07;Torstai;4;23;27
623;16.02.2017;2017;02;08;Torstai;29;78;107
623;16.02.2017;2017;02;09;Torstai;34;71;105
623;16.02.2017;2017;02;10;Torstai;22;26;48
623;16.02.2017;2017;02;11;Torstai;15;26;41
623;16.02.2017;2017;02;12;Torstai;33;26;59
623;16.02.2017;2017;02;13;Torstai;40;41;81
623;16.02.2017;2017;02;14;Torstai;34;31;65
623;16.02.2017;2017;02;15;Torstai;44;31;75
623;16.02.2017;2017;02;16;Torstai;61;36;97
623;16.02.2017;2017;02;17;Torstai;58;42;100
623;16.02.2017;2017;02;18;Torstai;41;37;78
623;16.02.2017;2017;02;19;Torstai;35;24;59
623;16.02.2017;2017;02;20;Torstai;8;21;29
623;16.02.2017;2017;02;21;Torstai;27;16;43
623;16.02.2017;2017;02;22;Torstai;12;9;21
623;16.02.2017;2017;02;23;Torstai;11;5;16
623;17.02.2017;2017;02;00;Perjantai;3;5;8
623;17.02.2017;2017;02;01;Perjantai;2;1;3
623;17.02.2017;2017;02;02;Perjantai;4;3;7
623;17.02.2017;2017;02;03;Perjantai;1;1;2
623;17.02.2017;2017;02;04;Perjantai;1;1;2
623;17.02.2017;2017;02;05;Perjantai;4;2;6
623;17.02.2017;2017;02;06;Perjantai;0;8;8
623;17.02.2017;2017;02;07;Perjantai;2;21;23
623;17.02.2017;2017;02;08;Perjantai;29;56;85
623;17.02.2017;2017;02;09;Perjantai;34;54;88
623;17.02.2017;2017;02;10;Perjantai;13;35;48
623;17.02.2017;2017;02;11;Perjantai;24;23;47
623;17.02.2017;2017;02;12;Perjantai;23;26;49
623;17.02.2017;2017;02;13;Perjantai;19;31;50
623;17.02.2017;2017;02;14;Perjantai;40;22;62
623;17.02.2017;2017;02;15;Perjantai;33;38;71
623;17.02.2017;2017;02;16;Perjantai;48;37;85
623;17.02.2017;2017;02;17;Perjantai;47;31;78
623;17.02.2017;2017;02;18;Perjantai;39;40;79
623;17.02.2017;2017;02;19;Perjantai;24;15;39
623;17.02.2017;2017;02;20;Perjantai;13;10;23
623;17.02.2017;2017;02;21;Perjantai;10;10;20
623;17.02.2017;2017;02;22;Perjantai;19;5;24
623;17.02.2017;2017;02;23;Perjantai;10;5;15
623;18.02.2017;2017;02;00;Lauantai;2;3;5
623;18.02.2017;2017;02;01;Lauantai;4;4;8
623;18.02.2017;2017;02;02;Lauantai;5;1;6
623;18.02.2017;2017;02;03;Lauantai;3;2;5
623;18.02.2017;2017;02;04;Lauantai;5;0;5
623;18.02.2017;2017;02;05;Lauantai;1;1;2
623;18.02.2017;2017;02;06;Lauantai;0;3;3
623;18.02.2017;2017;02;07;Lauantai;1;6;7
623;18.02.2017;2017;02;08;Lauantai;3;7;10
623;18.02.2017;2017;02;09;Lauantai;2;5;7
623;18.02.2017;2017;02;10;Lauantai;3;13;16
623;18.02.2017;2017;02;11;Lauantai;11;25;36
623;18.02.2017;2017;02;12;Lauantai;11;16;27
623;18.02.2017;2017;02;13;Lauantai;16;23;39
623;18.02.2017;2017;02;14;Lauantai;18;15;33
623;18.02.2017;2017;02;15;Lauantai;15;20;35
623;18.02.2017;2017;02;16;Lauantai;27;12;39
623;18.02.2017;2017;02;17;Lauantai;16;18;34
623;18.02.2017;2017;02;18;Lauantai;24;16;40
623;18.02.2017;2017;02;19;Lauantai;11;8;19
623;18.02.2017;2017;02;20;Lauantai;18;18;36
623;18.02.2017;2017;02;21;Lauantai;11;11;22
623;18.02.2017;2017;02;22;Lauantai;13;9;22
623;18.02.2017;2017;02;23;Lauantai;0;8;8
623;19.02.2017;2017;02;00;Sunnuntai;5;4;9
623;19.02.2017;2017;02;01;Sunnuntai;6;5;11
623;19.02.2017;2017;02;02;Sunnuntai;7;3;10
623;19.02.2017;2017;02;03;Sunnuntai;4;0;4
623;19.02.2017;2017;02;04;Sunnuntai;3;1;4
623;19.02.2017;2017;02;05;Sunnuntai;6;3;9
623;19.02.2017;2017;02;06;Sunnuntai;3;2;5
623;19.02.2017;2017;02;07;Sunnuntai;1;4;5
623;19.02.2017;2017;02;08;Sunnuntai;1;4;5
623;19.02.2017;2017;02;09;Sunnuntai;1;3;4
623;19.02.2017;2017;02;10;Sunnuntai;4;9;13
623;19.02.2017;2017;02;11;Sunnuntai;3;11;14
623;19.02.2017;2017;02;12;Sunnuntai;9;16;25
623;19.02.2017;2017;02;13;Sunnuntai;7;13;20
623;19.02.2017;2017;02;14;Sunnuntai;17;21;38
623;19.02.2017;2017;02;15;Sunnuntai;22;16;38
623;19.02.2017;2017;02;16;Sunnuntai;19;10;29
623;19.02.2017;2017;02;17;Sunnuntai;18;7;25
623;19.02.2017;2017;02;18;Sunnuntai;13;20;33
623;19.02.2017;2017;02;19;Sunnuntai;9;3;12
623;19.02.2017;2017;02;20;Sunnuntai;10;10;20
623;19.02.2017;2017;02;21;Sunnuntai;11;10;21
623;19.02.2017;2017;02;22;Sunnuntai;14;2;16
623;19.02.2017;2017;02;23;Sunnuntai;3;3;6
623;20.02.2017;2017;02;00;Maanantai;1;0;1
623;20.02.2017;2017;02;01;Maanantai;3;1;4
623;20.02.2017;2017;02;02;Maanantai;0;0;0
623;20.02.2017;2017;02;03;Maanantai;1;2;3
623;20.02.2017;2017;02;04;Maanantai;1;2;3
623;20.02.2017;2017;02;05;Maanantai;0;2;2
623;20.02.2017;2017;02;06;Maanantai;2;8;10
623;20.02.2017;2017;02;07;Maanantai;2;28;30
623;20.02.2017;2017;02;08;Maanantai;19;64;83
623;20.02.2017;2017;02;09;Maanantai;27;69;96
623;20.02.2017;2017;02;10;Maanantai;32;33;65
623;20.02.2017;2017;02;11;Maanantai;10;14;24
623;20.02.2017;2017;02;12;Maanantai;15;25;40
623;20.02.2017;2017;02;13;Maanantai;24;19;43
623;20.02.2017;2017;02;14;Maanantai;28;21;49
623;20.02.2017;2017;02;15;Maanantai;45;23;68
623;20.02.2017;2017;02;16;Maanantai;55;29;84
623;20.02.2017;2017;02;17;Maanantai;78;47;125
623;20.02.2017;2017;02;18;Maanantai;37;38;75
623;20.02.2017;2017;02;19;Maanantai;25;15;40
623;20.02.2017;2017;02;20;Maanantai;25;16;41
623;20.02.2017;2017;02;21;Maanantai;20;12;32
623;20.02.2017;2017;02;22;Maanantai;11;10;21
623;20.02.2017;2017;02;23;Maanantai;5;5;10
623;21.02.2017;2017;02;00;Tiistai;2;1;3
623;21.02.2017;2017;02;01;Tiistai;2;3;5
623;21.02.2017;2017;02;02;Tiistai;1;1;2
623;21.02.2017;2017;02;03;Tiistai;0;1;1
623;21.02.2017;2017;02;04;Tiistai;0;2;2
623;21.02.2017;2017;02;05;Tiistai;0;2;2
623;21.02.2017;2017;02;06;Tiistai;0;9;9
623;21.02.2017;2017;02;07;Tiistai;8;28;36
623;21.02.2017;2017;02;08;Tiistai;26;70;96
623;21.02.2017;2017;02;09;Tiistai;35;66;101
623;21.02.2017;2017;02;10;Tiistai;23;38;61
623;21.02.2017;2017;02;11;Tiistai;16;20;36
623;21.02.2017;2017;02;12;Tiistai;19;20;39
623;21.02.2017;2017;02;13;Tiistai;20;22;42
623;21.02.2017;2017;02;14;Tiistai;21;19;40
623;21.02.2017;2017;02;15;Tiistai;43;22;65
623;21.02.2017;2017;02;16;Tiistai;62;32;94
623;21.02.2017;2017;02;17;Tiistai;61;47;108
623;21.02.2017;2017;02;18;Tiistai;47;42;89
623;21.02.2017;2017;02;19;Tiistai;28;23;51
623;21.02.2017;2017;02;20;Tiistai;28;13;41
623;21.02.2017;2017;02;21;Tiistai;14;10;24
623;21.02.2017;2017;02;22;Tiistai;12;3;15
623;21.02.2017;2017;02;23;Tiistai;3;7;10
623;22.02.2017;2017;02;00;Keskiviikko;1;0;1
623;22.02.2017;2017;02;01;Keskiviikko;2;3;5
623;22.02.2017;2017;02;02;Keskiviikko;1;0;1
623;22.02.2017;2017;02;03;Keskiviikko;1;2;3
623;22.02.2017;2017;02;04;Keskiviikko;2;1;3
623;22.02.2017;2017;02;05;Keskiviikko;0;4;4
623;22.02.2017;2017;02;06;Keskiviikko;0;3;3
623;22.02.2017;2017;02;07;Keskiviikko;6;33;39
623;22.02.2017;2017;02;08;Keskiviikko;25;68;93
623;22.02.2017;2017;02;09;Keskiviikko;35;69;104
623;22.02.2017;2017;02;10;Keskiviikko;23;25;48
623;22.02.2017;2017;02;11;Keskiviikko;16;20;36
623;22.02.2017;2017;02;12;Keskiviikko;28;24;52
623;22.02.2017;2017;02;13;Keskiviikko;31;23;54
623;22.02.2017;2017;02;14;Keskiviikko;35;18;53
623;22.02.2017;2017;02;15;Keskiviikko;34;24;58
623;22.02.2017;2017;02;16;Keskiviikko;49;27;76
623;22.02.2017;2017;02;17;Keskiviikko;59;42;101
623;22.02.2017;2017;02;18;Keskiviikko;34;30;64
623;22.02.2017;2017;02;19;Keskiviikko;32;18;50
623;22.02.2017;2017;02;20;Keskiviikko;22;15;37
623;22.02.2017;2017;02;21;Keskiviikko;14;10;24
623;22.02.2017;2017;02;22;Keskiviikko;20;7;27
623;22.02.2017;2017;02;23;Keskiviikko;6;3;9
623;23.02.2017;2017;02;00;Torstai;2;2;4
623;23.02.2017;2017;02;01;Torstai;1;0;1
623;23.02.2017;2017;02;02;Torstai;2;0;2
623;23.02.2017;2017;02;03;Torstai;0;1;1
623;23.02.2017;2017;02;04;Torstai;1;2;3
623;23.02.2017;2017;02;05;Torstai;3;6;9
623;23.02.2017;2017;02;06;Torstai;1;6;7
623;23.02.2017;2017;02;07;Torstai;4;21;25
623;23.02.2017;2017;02;08;Torstai;33;62;95
623;23.02.2017;2017;02;09;Torstai;22;54;76
623;23.02.2017;2017;02;10;Torstai;16;27;43
623;23.02.2017;2017;02;11;Torstai;11;20;31
623;23.02.2017;2017;02;12;Torstai;28;17;45
623;23.02.2017;2017;02;13;Torstai;13;23;36
623;23.02.2017;2017;02;14;Torstai;27;15;42
623;23.02.2017;2017;02;15;Torstai;36;33;69
623;23.02.2017;2017;02;16;Torstai;56;28;84
623;23.02.2017;2017;02;17;Torstai;48;39;87
623;23.02.2017;2017;02;18;Torstai;36;30;66
623;23.02.2017;2017;02;19;Torstai;21;24;45
623;23.02.2017;2017;02;20;Torstai;23;17;40
623;23.02.2017;2017;02;21;Torstai;15;8;23
623;23.02.2017;2017;02;22;Torstai;13;7;20
623;23.02.2017;2017;02;23;Torstai;2;1;3
623;24.02.2017;2017;02;00;Perjantai;5;2;7
623;24.02.2017;2017;02;01;Perjantai;3;2;5
623;24.02.2017;2017;02;02;Perjantai;3;2;5
623;24.02.2017;2017;02;03;Perjantai;0;2;2
623;24.02.2017;2017;02;04;Perjantai;0;1;1
623;24.02.2017;2017;02;05;Perjantai;1;2;3
623;24.02.2017;2017;02;06;Perjantai;3;8;11
623;24.02.2017;2017;02;07;Perjantai;4;24;28
623;24.02.2017;2017;02;08;Perjantai;21;53;74
623;24.02.2017;2017;02;09;Perjantai;23;52;75
623;24.02.2017;2017;02;10;Perjantai;18;29;47
623;24.02.2017;2017;02;11;Perjantai;10;17;27
623;24.02.2017;2017;02;12;Perjantai;22;22;44
623;24.02.2017;2017;02;13;Perjantai;28;24;52
623;24.02.2017;2017;02;14;Perjantai;29;19;48
623;24.02.2017;2017;02;15;Perjantai;39;31;70
623;24.02.2017;2017;02;16;Perjantai;49;24;73
623;24.02.2017;2017;02;17;Perjantai;39;44;83
623;24.02.2017;2017;02;18;Perjantai;23;30;53
623;24.02.2017;2017;02;19;Perjantai;15;19;34
623;24.02.2017;2017;02;20;Perjantai;19;18;37
623;24.02.2017;2017;02;21;Perjantai;10;15;25
623;24.02.2017;2017;02;22;Perjantai;15;3;18
623;24.02.2017;2017;02;23;Perjantai;12;7;19
623;25.02.2017;2017;02;00;Lauantai;8;1;9
623;25.02.2017;2017;02;01;Lauantai;2;2;4
623;25.02.2017;2017;02;02;Lauantai;5;0;5
623;25.02.2017;2017;02;03;Lauantai;5;1;6
623;25.02.2017;2017;02;04;Lauantai;2;2;4
623;25.02.2017;2017;02;05;Lauantai;4;1;5
623;25.02.2017;2017;02;06;Lauantai;0;4;4
623;25.02.2017;2017;02;07;Lauantai;2;8;10
623;25.02.2017;2017;02;08;Lauantai;3;7;10
623;25.02.2017;2017;02;09;Lauantai;4;7;11
623;25.02.2017;2017;02;10;Lauantai;6;15;21
623;25.02.2017;2017;02;11;Lauantai;4;10;14
623;25.02.2017;2017;02;12;Lauantai;13;13;26
623;25.02.2017;2017;02;13;Lauantai;13;9;22
623;25.02.2017;2017;02;14;Lauantai;11;18;29
623;25.02.2017;2017;02;15;Lauantai;17;17;34
623;25.02.2017;2017;02;16;Lauantai;14;17;31
623;25.02.2017;2017;02;17;Lauantai;23;16;39
623;25.02.2017;2017;02;18;Lauantai;12;12;24
623;25.02.2017;2017;02;19;Lauantai;8;10;18
623;25.02.2017;2017;02;20;Lauantai;9;10;19
623;25.02.2017;2017;02;21;Lauantai;7;9;16
623;25.02.2017;2017;02;22;Lauantai;7;3;10
623;25.02.2017;2017;02;23;Lauantai;4;1;5
623;26.02.2017;2017;02;00;Sunnuntai;5;3;8
623;26.02.2017;2017;02;01;Sunnuntai;6;4;10
623;26.02.2017;2017;02;02;Sunnuntai;3;2;5
623;26.02.2017;2017;02;03;Sunnuntai;2;1;3
623;26.02.2017;2017;02;04;Sunnuntai;5;0;5
623;26.02.2017;2017;02;05;Sunnuntai;6;2;8
623;26.02.2017;2017;02;06;Sunnuntai;2;4;6
623;26.02.2017;2017;02;07;Sunnuntai;1;5;6
623;26.02.2017;2017;02;08;Sunnuntai;3;3;6
623;26.02.2017;2017;02;09;Sunnuntai;2;1;3
623;26.02.2017;2017;02;10;Sunnuntai;5;10;15
623;26.02.2017;2017;02;11;Sunnuntai;7;9;16
623;26.02.2017;2017;02;12;Sunnuntai;8;10;18
623;26.02.2017;2017;02;13;Sunnuntai;9;12;21
623;26.02.2017;2017;02;14;Sunnuntai;13;16;29
623;26.02.2017;2017;02;15;Sunnuntai;15;19;34
623;26.02.2017;2017;02;16;Sunnuntai;12;22;34
623;26.02.2017;2017;02;17;Sunnuntai;13;13;26
623;26.02.2017;2017;02;18;Sunnuntai;12;14;26
623;26.02.2017;2017;02;19;Sunnuntai;12;9;21
623;26.02.2017;2017;02;20;Sunnuntai;9;11;20
623;26.02.2017;2017;02;21;Sunnuntai;13;7;20
623;26.02.2017;2017;02;22;Sunnuntai;11;5;16
623;26.02.2017;2017;02;23;Sunnuntai;6;3;9
623;27.02.2017;2017;02;00;Maanantai;4;2;6
623;27.02.2017;2017;02;01;Maanantai;1;0;1
623;27.02.2017;2017;02;02;Maanantai;0;0;0
623;27.02.2017;2017;02;03;Maanantai;1;2;3
623;27.02.2017;2017;02;04;Maanantai;1;1;2
623;27.02.2017;2017;02;05;Maanantai;0;1;1
623;27.02.2017;2017;02;06;Maanantai;0;6;6
623;27.02.2017;2017;02;07;Maanantai;2;19;21
623;27.02.2017;2017;02;08;Maanantai;18;51;69
623;27.02.2017;2017;02;09;Maanantai;22;54;76
623;27.02.2017;2017;02;10;Maanantai;19;27;46
623;27.02.2017;2017;02;11;Maanantai;11;5;16
623;27.02.2017;2017;02;12;Maanantai;25;16;41
623;27.02.2017;2017;02;13;Maanantai;17;22;39
623;27.02.2017;2017;02;14;Maanantai;26;18;44
623;27.02.2017;2017;02;15;Maanantai;45;28;73
623;27.02.2017;2017;02;16;Maanantai;51;19;70
623;27.02.2017;2017;02;17;Maanantai;52;40;92
623;27.02.2017;2017;02;18;Maanantai;31;34;65
623;27.02.2017;2017;02;19;Maanantai;17;19;36
623;27.02.2017;2017;02;20;Maanantai;17;13;30
623;27.02.2017;2017;02;21;Maanantai;19;9;28
623;27.02.2017;2017;02;22;Maanantai;12;10;22
623;27.02.2017;2017;02;23;Maanantai;9;4;13
623;28.02.2017;2017;02;00;Tiistai;3;2;5
623;28.02.2017;2017;02;01;Tiistai;0;1;1
623;28.02.2017;2017;02;02;Tiistai;1;1;2
623;28.02.2017;2017;02;03;Tiistai;3;1;4
623;28.02.2017;2017;02;04;Tiistai;1;1;2
623;28.02.2017;2017;02;05;Tiistai;0;4;4
623;28.02.2017;2017;02;06;Tiistai;0;8;8
623;28.02.2017;2017;02;07;Tiistai;7;32;39
623;28.02.2017;2017;02;08;Tiistai;33;60;93
623;28.02.2017;2017;02;09;Tiistai;28;88;116
623;28.02.2017;2017;02;10;Tiistai;18;32;50
623;28.02.2017;2017;02;11;Tiistai;20;21;41
623;28.02.2017;2017;02;12;Tiistai;30;35;65
623;28.02.2017;2017;02;13;Tiistai;15;27;42
623;28.02.2017;2017;02;14;Tiistai;20;19;39
623;28.02.2017;2017;02;15;Tiistai;39;35;74
623;28.02.2017;2017;02;16;Tiistai;54;33;87
623;28.02.2017;2017;02;17;Tiistai;50;47;97
623;28.02.2017;2017;02;18;Tiistai;46;32;78
623;28.02.2017;2017;02;19;Tiistai;32;30;62
623;28.02.2017;2017;02;20;Tiistai;24;10;34
623;28.02.2017;2017;02;21;Tiistai;19;20;39
623;28.02.2017;2017;02;22;Tiistai;20;10;30
623;28.02.2017;2017;02;23;Tiistai;7;4;11
623;01.03.2017;2017;03;00;Keskiviikko;5;1;6
623;01.03.2017;2017;03;01;Keskiviikko;3;1;4
623;01.03.2017;2017;03;02;Keskiviikko;1;2;3
623;01.03.2017;2017;03;03;Keskiviikko;6;2;8
623;01.03.2017;2017;03;04;Keskiviikko;5;2;7
623;01.03.2017;2017;03;05;Keskiviikko;3;4;7
623;01.03.2017;2017;03;06;Keskiviikko;0;6;6
623;01.03.2017;2017;03;07;Keskiviikko;6;30;36
623;01.03.2017;2017;03;08;Keskiviikko;18;71;89
623;01.03.2017;2017;03;09;Keskiviikko;23;69;92
623;01.03.2017;2017;03;10;Keskiviikko;9;25;34
623;01.03.2017;2017;03;11;Keskiviikko;12;22;34
623;01.03.2017;2017;03;12;Keskiviikko;30;16;46
623;01.03.2017;2017;03;13;Keskiviikko;19;21;40
623;01.03.2017;2017;03;14;Keskiviikko;29;21;50
623;01.03.2017;2017;03;15;Keskiviikko;20;17;37
623;01.03.2017;2017;03;16;Keskiviikko;48;17;65
623;01.03.2017;2017;03;17;Keskiviikko;51;34;85
623;01.03.2017;2017;03;18;Keskiviikko;33;29;62
623;01.03.2017;2017;03;19;Keskiviikko;19;18;37
623;01.03.2017;2017;03;20;Keskiviikko;21;10;31
623;01.03.2017;2017;03;21;Keskiviikko;17;8;25
623;01.03.2017;2017;03;22;Keskiviikko;17;6;23
623;01.03.2017;2017;03;23;Keskiviikko;7;3;10
623;02.03.2017;2017;03;00;Torstai;5;4;9
623;02.03.2017;2017;03;01;Torstai;1;1;2
623;02.03.2017;2017;03;02;Torstai;1;0;1
623;02.03.2017;2017;03;03;Torstai;1;1;2
623;02.03.2017;2017;03;04;Torstai;0;1;1
623;02.03.2017;2017;03;05;Torstai;1;5;6
623;02.03.2017;2017;03;06;Torstai;0;2;2
623;02.03.2017;2017;03;07;Torstai;4;31;35
623;02.03.2017;2017;03;08;Torstai;25;62;87
623;02.03.2017;2017;03;09;Torstai;21;52;73
623;02.03.2017;2017;03;10;Torstai;23;42;65
623;02.03.2017;2017;03;11;Torstai;16;24;40
623;02.03.2017;2017;03;12;Torstai;20;30;50
623;02.03.2017;2017;03;13;Torstai;24;35;59
623;02.03.2017;2017;03;14;Torstai;38;25;63
623;02.03.2017;2017;03;15;Torstai;40;16;56
623;02.03.2017;2017;03;16;Torstai;39;23;62
623;02.03.2017;2017;03;17;Torstai;51;21;72
623;02.03.2017;2017;03;18;Torstai;33;25;58
623;02.03.2017;2017;03;19;Torstai;31;20;51
623;02.03.2017;2017;03;20;Torstai;13;16;29
623;02.03.2017;2017;03;21;Torstai;12;14;26
623;02.03.2017;2017;03;22;Torstai;13;5;18
623;02.03.2017;2017;03;23;Torstai;7;2;9
623;03.03.2017;2017;03;00;Perjantai;3;1;4
623;03.03.2017;2017;03;01;Perjantai;5;2;7
623;03.03.2017;2017;03;02;Perjantai;3;1;4
623;03.03.2017;2017;03;03;Perjantai;0;2;2
623;03.03.2017;2017;03;04;Perjantai;0;2;2
623;03.03.2017;2017;03;05;Perjantai;0;2;2
623;03.03.2017;2017;03;06;Perjantai;2;5;7
623;03.03.2017;2017;03;07;Perjantai;3;29;32
623;03.03.2017;2017;03;08;Perjantai;13;50;63
623;03.03.2017;2017;03;09;Perjantai;20;61;81
623;03.03.2017;2017;03;10;Perjantai;11;12;23
623;03.03.2017;2017;03;11;Perjantai;27;35;62
623;03.03.2017;2017;03;12;Perjantai;24;25;49
623;03.03.2017;2017;03;13;Perjantai;28;30;58
623;03.03.2017;2017;03;14;Perjantai;26;17;43
623;03.03.2017;2017;03;15;Perjantai;39;21;60
623;03.03.2017;2017;03;16;Perjantai;41;30;71
623;03.03.2017;2017;03;17;Perjantai;39;25;64
623;03.03.2017;2017;03;18;Perjantai;24;17;41
623;03.03.2017;2017;03;19;Perjantai;20;16;36
623;03.03.2017;2017;03;20;Perjantai;13;12;25
623;03.03.2017;2017;03;21;Perjantai;9;9;18
623;03.03.2017;2017;03;22;Perjantai;5;12;17
623;03.03.2017;2017;03;23;Perjantai;6;4;10
623;04.03.2017;2017;03;00;Lauantai;5;4;9
623;04.03.2017;2017;03;01;Lauantai;4;3;7
623;04.03.2017;2017;03;02;Lauantai;7;0;7
623;04.03.2017;2017;03;03;Lauantai;1;2;3
623;04.03.2017;2017;03;04;Lauantai;1;0;1
623;04.03.2017;2017;03;05;Lauantai;3;1;4
623;04.03.2017;2017;03;06;Lauantai;0;4;4
623;04.03.2017;2017;03;07;Lauantai;2;4;6
623;04.03.2017;2017;03;08;Lauantai;0;5;5
623;04.03.2017;2017;03;09;Lauantai;2;5;7
623;04.03.2017;2017;03;10;Lauantai;5;16;21
623;04.03.2017;2017;03;11;Lauantai;12;20;32
623;04.03.2017;2017;03;12;Lauantai;13;22;35
623;04.03.2017;2017;03;13;Lauantai;8;19;27
623;04.03.2017;2017;03;14;Lauantai;13;15;28
623;04.03.2017;2017;03;15;Lauantai;21;18;39
623;04.03.2017;2017;03;16;Lauantai;20;8;28
623;04.03.2017;2017;03;17;Lauantai;9;18;27
623;04.03.2017;2017;03;18;Lauantai;19;15;34
623;04.03.2017;2017;03;19;Lauantai;9;11;20
623;04.03.2017;2017;03;20;Lauantai;18;8;26
623;04.03.2017;2017;03;21;Lauantai;14;7;21
623;04.03.2017;2017;03;22;Lauantai;14;8;22
623;04.03.2017;2017;03;23;Lauantai;5;4;9
623;05.03.2017;2017;03;00;Sunnuntai;5;1;6
623;05.03.2017;2017;03;01;Sunnuntai;1;3;4
623;05.03.2017;2017;03;02;Sunnuntai;3;0;3
623;05.03.2017;2017;03;03;Sunnuntai;2;0;2
623;05.03.2017;2017;03;04;Sunnuntai;1;2;3
623;05.03.2017;2017;03;05;Sunnuntai;4;1;5
623;05.03.2017;2017;03;06;Sunnuntai;0;2;2
623;05.03.2017;2017;03;07;Sunnuntai;2;5;7
623;05.03.2017;2017;03;08;Sunnuntai;0;5;5
623;05.03.2017;2017;03;09;Sunnuntai;0;2;2
623;05.03.2017;2017;03;10;Sunnuntai;2;5;7
623;05.03.2017;2017;03;11;Sunnuntai;5;6;11
623;05.03.2017;2017;03;12;Sunnuntai;5;9;14
623;05.03.2017;2017;03;13;Sunnuntai;11;10;21
623;05.03.2017;2017;03;14;Sunnuntai;7;12;19
623;05.03.2017;2017;03;15;Sunnuntai;14;15;29
623;05.03.2017;2017;03;16;Sunnuntai;11;9;20
623;05.03.2017;2017;03;17;Sunnuntai;10;10;20
623;05.03.2017;2017;03;18;Sunnuntai;10;11;21
623;05.03.2017;2017;03;19;Sunnuntai;12;3;15
623;05.03.2017;2017;03;20;Sunnuntai;7;4;11
623;05.03.2017;2017;03;21;Sunnuntai;8;2;10
623;05.03.2017;2017;03;22;Sunnuntai;5;1;6
623;05.03.2017;2017;03;23;Sunnuntai;1;3;4
623;06.03.2017;2017;03;00;Maanantai;1;2;3
623;06.03.2017;2017;03;01;Maanantai;3;0;3
623;06.03.2017;2017;03;02;Maanantai;0;0;0
623;06.03.2017;2017;03;03;Maanantai;1;1;2
623;06.03.2017;2017;03;04;Maanantai;0;1;1
623;06.03.2017;2017;03;05;Maanantai;0;0;0
623;06.03.2017;2017;03;06;Maanantai;0;7;7
623;06.03.2017;2017;03;07;Maanantai;4;12;16
623;06.03.2017;2017;03;08;Maanantai;9;49;58
623;06.03.2017;2017;03;09;Maanantai;10;21;31
623;06.03.2017;2017;03;10;Maanantai;11;18;29
623;06.03.2017;2017;03;11;Maanantai;8;8;16
623;06.03.2017;2017;03;12;Maanantai;12;14;26
623;06.03.2017;2017;03;13;Maanantai;15;20;35
623;06.03.2017;2017;03;14;Maanantai;14;13;27
623;06.03.2017;2017;03;15;Maanantai;18;11;29
623;06.03.2017;2017;03;16;Maanantai;38;25;63
623;06.03.2017;2017;03;17;Maanantai;39;27;66
623;06.03.2017;2017;03;18;Maanantai;28;17;45
623;06.03.2017;2017;03;19;Maanantai;13;13;26
623;06.03.2017;2017;03;20;Maanantai;6;10;16
623;06.03.2017;2017;03;21;Maanantai;14;8;22
623;06.03.2017;2017;03;22;Maanantai;7;4;11
623;06.03.2017;2017;03;23;Maanantai;11;4;15
623;07.03.2017;2017;03;00;Tiistai;2;4;6
623;07.03.2017;2017;03;01;Tiistai;2;0;2
623;07.03.2017;2017;03;02;Tiistai;1;0;1
623;07.03.2017;2017;03;03;Tiistai;0;1;1
623;07.03.2017;2017;03;04;Tiistai;0;1;1
623;07.03.2017;2017;03;05;Tiistai;0;1;1
623;07.03.2017;2017;03;06;Tiistai;2;5;7
623;07.03.2017;2017;03;07;Tiistai;3;21;24
623;07.03.2017;2017;03;08;Tiistai;14;36;50
623;07.03.2017;2017;03;09;Tiistai;14;27;41
623;07.03.2017;2017;03;10;Tiistai;15;19;34
623;07.03.2017;2017;03;11;Tiistai;8;11;19
623;07.03.2017;2017;03;12;Tiistai;15;18;33
623;07.03.2017;2017;03;13;Tiistai;19;20;39
623;07.03.2017;2017;03;14;Tiistai;17;15;32
623;07.03.2017;2017;03;15;Tiistai;16;15;31
623;07.03.2017;2017;03;16;Tiistai;42;18;60
623;07.03.2017;2017;03;17;Tiistai;36;27;63
623;07.03.2017;2017;03;18;Tiistai;31;22;53
623;07.03.2017;2017;03;19;Tiistai;21;19;40
623;07.03.2017;2017;03;20;Tiistai;16;15;31
623;07.03.2017;2017;03;21;Tiistai;8;9;17
623;07.03.2017;2017;03;22;Tiistai;10;1;11
623;07.03.2017;2017;03;23;Tiistai;5;4;9
623;08.03.2017;2017;03;00;Keskiviikko;3;0;3
623;08.03.2017;2017;03;01;Keskiviikko;1;0;1
623;08.03.2017;2017;03;02;Keskiviikko;0;0;0
623;08.03.2017;2017;03;03;Keskiviikko;0;1;1
623;08.03.2017;2017;03;04;Keskiviikko;1;1;2
623;08.03.2017;2017;03;05;Keskiviikko;0;2;2
623;08.03.2017;2017;03;06;Keskiviikko;1;6;7
623;08.03.2017;2017;03;07;Keskiviikko;1;24;25
623;08.03.2017;2017;03;08;Keskiviikko;12;31;43
623;08.03.2017;2017;03;09;Keskiviikko;15;24;39
623;08.03.2017;2017;03;10;Keskiviikko;7;15;22
623;08.03.2017;2017;03;11;Keskiviikko;9;16;25
623;08.03.2017;2017;03;12;Keskiviikko;20;25;45
623;08.03.2017;2017;03;13;Keskiviikko;12;24;36
623;08.03.2017;2017;03;14;Keskiviikko;22;18;40
623;08.03.2017;2017;03;15;Keskiviikko;12;8;20
623;08.03.2017;2017;03;16;Keskiviikko;29;18;47
623;08.03.2017;2017;03;17;Keskiviikko;51;27;78
623;08.03.2017;2017;03;18;Keskiviikko;30;20;50
623;08.03.2017;2017;03;19;Keskiviikko;25;12;37
623;08.03.2017;2017;03;20;Keskiviikko;10;12;22
623;08.03.2017;2017;03;21;Keskiviikko;8;8;16
623;08.03.2017;2017;03;22;Keskiviikko;6;3;9
623;08.03.2017;2017;03;23;Keskiviikko;10;4;14
623;09.03.2017;2017;03;00;Torstai;2;0;2
623;09.03.2017;2017;03;01;Torstai;3;1;4
623;09.03.2017;2017;03;02;Torstai;0;0;0
623;09.03.2017;2017;03;03;Torstai;1;1;2
623;09.03.2017;2017;03;04;Torstai;0;1;1
623;09.03.2017;2017;03;05;Torstai;0;2;2
623;09.03.2017;2017;03;06;Torstai;0;5;5
623;09.03.2017;2017;03;07;Torstai;2;15;17
623;09.03.2017;2017;03;08;Torstai;10;35;45
623;09.03.2017;2017;03;09;Torstai;10;27;37
623;09.03.2017;2017;03;10;Torstai;8;21;29
623;09.03.2017;2017;03;11;Torstai;11;11;22
623;09.03.2017;2017;03;12;Torstai;13;21;34
623;09.03.2017;2017;03;13;Torstai;18;16;34
623;09.03.2017;2017;03;14;Torstai;20;23;43
623;09.03.2017;2017;03;15;Torstai;15;15;30
623;09.03.2017;2017;03;16;Torstai;27;17;44
623;09.03.2017;2017;03;17;Torstai;37;27;64
623;09.03.2017;2017;03;18;Torstai;29;22;51
623;09.03.2017;2017;03;19;Torstai;19;10;29
623;09.03.2017;2017;03;20;Torstai;16;13;29
623;09.03.2017;2017;03;21;Torstai;10;11;21
623;09.03.2017;2017;03;22;Torstai;10;6;16
623;09.03.2017;2017;03;23;Torstai;5;5;10
623;10.03.2017;2017;03;00;Perjantai;7;0;7
623;10.03.2017;2017;03;01;Perjantai;2;0;2
623;10.03.2017;2017;03;02;Perjantai;1;2;3
623;10.03.2017;2017;03;03;Perjantai;1;3;4
623;10.03.2017;2017;03;04;Perjantai;1;1;2
623;10.03.2017;2017;03;05;Perjantai;0;3;3
623;10.03.2017;2017;03;06;Perjantai;1;3;4
623;10.03.2017;2017;03;07;Perjantai;4;19;23
623;10.03.2017;2017;03;08;Perjantai;9;38;47
623;10.03.2017;2017;03;09;Perjantai;11;25;36
623;10.03.2017;2017;03;10;Perjantai;6;22;28
623;10.03.2017;2017;03;11;Perjantai;16;17;33
623;10.03.2017;2017;03;12;Perjantai;16;11;27
623;10.03.2017;2017;03;13;Perjantai;15;22;37
623;10.03.2017;2017;03;14;Perjantai;21;11;32
623;10.03.2017;2017;03;15;Perjantai;21;12;33
623;10.03.2017;2017;03;16;Perjantai;36;11;47
623;10.03.2017;2017;03;17;Perjantai;28;20;48
623;10.03.2017;2017;03;18;Perjantai;18;15;33
623;10.03.2017;2017;03;19;Perjantai;9;12;21
623;10.03.2017;2017;03;20;Perjantai;12;14;26
623;10.03.2017;2017;03;21;Perjantai;11;10;21
623;10.03.2017;2017;03;22;Perjantai;12;3;15
623;10.03.2017;2017;03;23;Perjantai;5;6;11
623;11.03.2017;2017;03;00;Lauantai;7;6;13
623;11.03.2017;2017;03;01;Lauantai;6;4;10
623;11.03.2017;2017;03;02;Lauantai;1;2;3
623;11.03.2017;2017;03;03;Lauantai;3;0;3
623;11.03.2017;2017;03;04;Lauantai;1;1;2
623;11.03.2017;2017;03;05;Lauantai;2;1;3
623;11.03.2017;2017;03;06;Lauantai;2;2;4
623;11.03.2017;2017;03;07;Lauantai;1;7;8
623;11.03.2017;2017;03;08;Lauantai;2;2;4
623;11.03.2017;2017;03;09;Lauantai;2;12;14
623;11.03.2017;2017;03;10;Lauantai;3;14;17
623;11.03.2017;2017;03;11;Lauantai;9;23;32
623;11.03.2017;2017;03;12;Lauantai;24;19;43
623;11.03.2017;2017;03;13;Lauantai;11;19;30
623;11.03.2017;2017;03;14;Lauantai;14;22;36
623;11.03.2017;2017;03;15;Lauantai;18;9;27
623;11.03.2017;2017;03;16;Lauantai;19;11;30
623;11.03.2017;2017;03;17;Lauantai;16;14;30
623;11.03.2017;2017;03;18;Lauantai;10;11;21
623;11.03.2017;2017;03;19;Lauantai;13;7;20
623;11.03.2017;2017;03;20;Lauantai;13;11;24
623;11.03.2017;2017;03;21;Lauantai;7;7;14
623;11.03.2017;2017;03;22;Lauantai;8;4;12
623;11.03.2017;2017;03;23;Lauantai;9;9;18
623;12.03.2017;2017;03;00;Sunnuntai;5;2;7
623;12.03.2017;2017;03;01;Sunnuntai;2;3;5
623;12.03.2017;2017;03;02;Sunnuntai;4;1;5
623;12.03.2017;2017;03;03;Sunnuntai;2;2;4
623;12.03.2017;2017;03;04;Sunnuntai;8;2;10
623;12.03.2017;2017;03;05;Sunnuntai;5;0;5
623;12.03.2017;2017;03;06;Sunnuntai;1;1;2
623;12.03.2017;2017;03;07;Sunnuntai;3;11;14
623;12.03.2017;2017;03;08;Sunnuntai;1;2;3
623;12.03.2017;2017;03;09;Sunnuntai;2;4;6
623;12.03.2017;2017;03;10;Sunnuntai;4;10;14
623;12.03.2017;2017;03;11;Sunnuntai;6;12;18
623;12.03.2017;2017;03;12;Sunnuntai;10;9;19
623;12.03.2017;2017;03;13;Sunnuntai;8;16;24
623;12.03.2017;2017;03;14;Sunnuntai;13;15;28
623;12.03.2017;2017;03;15;Sunnuntai;10;21;31
623;12.03.2017;2017;03;16;Sunnuntai;21;14;35
623;12.03.2017;2017;03;17;Sunnuntai;11;15;26
623;12.03.2017;2017;03;18;Sunnuntai;10;12;22
623;12.03.2017;2017;03;19;Sunnuntai;16;9;25
623;12.03.2017;2017;03;20;Sunnuntai;7;5;12
623;12.03.2017;2017;03;21;Sunnuntai;11;6;17
623;12.03.2017;2017;03;22;Sunnuntai;11;4;15
623;12.03.2017;2017;03;23;Sunnuntai;3;4;7
623;13.03.2017;2017;03;00;Maanantai;3;2;5
623;13.03.2017;2017;03;01;Maanantai;2;0;2
623;13.03.2017;2017;03;02;Maanantai;0;0;0
623;13.03.2017;2017;03;03;Maanantai;0;0;0
623;13.03.2017;2017;03;04;Maanantai;1;3;4
623;13.03.2017;2017;03;05;Maanantai;1;2;3
623;13.03.2017;2017;03;06;Maanantai;1;8;9
623;13.03.2017;2017;03;07;Maanantai;7;29;36
623;13.03.2017;2017;03;08;Maanantai;28;75;103
623;13.03.2017;2017;03;09;Maanantai;30;77;107
623;13.03.2017;2017;03;10;Maanantai;25;33;58
623;13.03.2017;2017;03;11;Maanantai;12;18;30
623;13.03.2017;2017;03;12;Maanantai;27;24;51
623;13.03.2017;2017;03;13;Maanantai;33;25;58
623;13.03.2017;2017;03;14;Maanantai;25;28;53
623;13.03.2017;2017;03;15;Maanantai;53;36;89
623;13.03.2017;2017;03;16;Maanantai;54;32;86
623;13.03.2017;2017;03;17;Maanantai;67;54;121
623;13.03.2017;2017;03;18;Maanantai;44;50;94
623;13.03.2017;2017;03;19;Maanantai;27;29;56
623;13.03.2017;2017;03;20;Maanantai;22;12;34
623;13.03.2017;2017;03;21;Maanantai;23;5;28
623;13.03.2017;2017;03;22;Maanantai;17;8;25
623;13.03.2017;2017;03;23;Maanantai;9;6;15
623;14.03.2017;2017;03;00;Tiistai;3;2;5
623;14.03.2017;2017;03;01;Tiistai;0;1;1
623;14.03.2017;2017;03;02;Tiistai;0;0;0
623;14.03.2017;2017;03;03;Tiistai;2;0;2
623;14.03.2017;2017;03;04;Tiistai;1;5;6
623;14.03.2017;2017;03;05;Tiistai;0;3;3
623;14.03.2017;2017;03;06;Tiistai;1;7;8
623;14.03.2017;2017;03;07;Tiistai;7;26;33
623;14.03.2017;2017;03;08;Tiistai;25;71;96
623;14.03.2017;2017;03;09;Tiistai;22;59;81
623;14.03.2017;2017;03;10;Tiistai;20;27;47
623;14.03.2017;2017;03;11;Tiistai;17;16;33
623;14.03.2017;2017;03;12;Tiistai;18;18;36
623;14.03.2017;2017;03;13;Tiistai;15;20;35
623;14.03.2017;2017;03;14;Tiistai;26;21;47
623;14.03.2017;2017;03;15;Tiistai;35;27;62
623;14.03.2017;2017;03;16;Tiistai;60;22;82
623;14.03.2017;2017;03;17;Tiistai;61;41;102
623;14.03.2017;2017;03;18;Tiistai;42;41;83
623;14.03.2017;2017;03;19;Tiistai;29;13;42
623;14.03.2017;2017;03;20;Tiistai;23;12;35
623;14.03.2017;2017;03;21;Tiistai;11;10;21
623;14.03.2017;2017;03;22;Tiistai;14;4;18
623;14.03.2017;2017;03;23;Tiistai;4;4;8
623;15.03.2017;2017;03;00;Keskiviikko;0;0;0
623;15.03.2017;2017;03;01;Keskiviikko;1;1;2
623;15.03.2017;2017;03;02;Keskiviikko;0;0;0
623;15.03.2017;2017;03;03;Keskiviikko;1;1;2
623;15.03.2017;2017;03;04;Keskiviikko;2;1;3
623;15.03.2017;2017;03;05;Keskiviikko;0;2;2
623;15.03.2017;2017;03;06;Keskiviikko;2;7;9
623;15.03.2017;2017;03;07;Keskiviikko;7;29;36
623;15.03.2017;2017;03;08;Keskiviikko;26;49;75
623;15.03.2017;2017;03;09;Keskiviikko;27;81;108
623;15.03.2017;2017;03;10;Keskiviikko;19;32;51
623;15.03.2017;2017;03;11;Keskiviikko;13;13;26
623;15.03.2017;2017;03;12;Keskiviikko;23;31;54
623;15.03.2017;2017;03;13;Keskiviikko;22;27;49
623;15.03.2017;2017;03;14;Keskiviikko;26;18;44
623;15.03.2017;2017;03;15;Keskiviikko;44;25;69
623;15.03.2017;2017;03;16;Keskiviikko;49;29;78
623;15.03.2017;2017;03;17;Keskiviikko;66;46;112
623;15.03.2017;2017;03;18;Keskiviikko;34;32;66
623;15.03.2017;2017;03;19;Keskiviikko;29;18;47
623;15.03.2017;2017;03;20;Keskiviikko;18;16;34
623;15.03.2017;2017;03;21;Keskiviikko;29;10;39
623;15.03.2017;2017;03;22;Keskiviikko;24;13;37
623;15.03.2017;2017;03;23;Keskiviikko;9;4;13
623;16.03.2017;2017;03;00;Torstai;2;2;4
623;16.03.2017;2017;03;01;Torstai;3;1;4
623;16.03.2017;2017;03;02;Torstai;2;0;2
623;16.03.2017;2017;03;03;Torstai;1;1;2
623;16.03.2017;2017;03;04;Torstai;0;2;2
623;16.03.2017;2017;03;05;Torstai;1;4;5
623;16.03.2017;2017;03;06;Torstai;1;3;4
623;16.03.2017;2017;03;07;Torstai;5;26;31
623;16.03.2017;2017;03;08;Torstai;30;48;78
623;16.03.2017;2017;03;09;Torstai;26;62;88
623;16.03.2017;2017;03;10;Torstai;25;25;50
623;16.03.2017;2017;03;11;Torstai;12;24;36
623;16.03.2017;2017;03;12;Torstai;20;21;41
623;16.03.2017;2017;03;13;Torstai;23;20;43
623;16.03.2017;2017;03;14;Torstai;30;27;57
623;16.03.2017;2017;03;15;Torstai;28;33;61
623;16.03.2017;2017;03;16;Torstai;40;37;77
623;16.03.2017;2017;03;17;Torstai;69;52;121
623;16.03.2017;2017;03;18;Torstai;38;25;63
623;16.03.2017;2017;03;19;Torstai;31;19;50
623;16.03.2017;2017;03;20;Torstai;16;19;35
623;16.03.2017;2017;03;21;Torstai;20;12;32
623;16.03.2017;2017;03;22;Torstai;26;9;35
623;16.03.2017;2017;03;23;Torstai;4;3;7
623;17.03.2017;2017;03;00;Perjantai;8;2;10
623;17.03.2017;2017;03;01;Perjantai;6;0;6
623;17.03.2017;2017;03;02;Perjantai;2;1;3
623;17.03.2017;2017;03;03;Perjantai;1;0;1
623;17.03.2017;2017;03;04;Perjantai;3;3;6
623;17.03.2017;2017;03;05;Perjantai;0;1;1
623;17.03.2017;2017;03;06;Perjantai;1;7;8
623;17.03.2017;2017;03;07;Perjantai;3;18;21
623;17.03.2017;2017;03;08;Perjantai;12;31;43
623;17.03.2017;2017;03;09;Perjantai;24;37;61
623;17.03.2017;2017;03;10;Perjantai;12;24;36
623;17.03.2017;2017;03;11;Perjantai;15;16;31
623;17.03.2017;2017;03;12;Perjantai;20;24;44
623;17.03.2017;2017;03;13;Perjantai;26;20;46
623;17.03.2017;2017;03;14;Perjantai;18;16;34
623;17.03.2017;2017;03;15;Perjantai;39;27;66
623;17.03.2017;2017;03;16;Perjantai;21;12;33
623;17.03.2017;2017;03;17;Perjantai;30;15;45
623;17.03.2017;2017;03;18;Perjantai;16;12;28
623;17.03.2017;2017;03;19;Perjantai;8;14;22
623;17.03.2017;2017;03;20;Perjantai;6;6;12
623;17.03.2017;2017;03;21;Perjantai;11;11;22
623;17.03.2017;2017;03;22;Perjantai;12;3;15
623;17.03.2017;2017;03;23;Perjantai;4;2;6
623;18.03.2017;2017;03;00;Lauantai;4;2;6
623;18.03.2017;2017;03;01;Lauantai;1;1;2
623;18.03.2017;2017;03;02;Lauantai;4;0;4
623;18.03.2017;2017;03;03;Lauantai;3;1;4
623;18.03.2017;2017;03;04;Lauantai;2;1;3
623;18.03.2017;2017;03;05;Lauantai;1;3;4
623;18.03.2017;2017;03;06;Lauantai;2;3;5
623;18.03.2017;2017;03;07;Lauantai;1;3;4
623;18.03.2017;2017;03;08;Lauantai;2;2;4
623;18.03.2017;2017;03;09;Lauantai;1;6;7
623;18.03.2017;2017;03;10;Lauantai;6;10;16
623;18.03.2017;2017;03;11;Lauantai;6;8;14
623;18.03.2017;2017;03;12;Lauantai;8;15;23
623;18.03.2017;2017;03;13;Lauantai;10;15;25
623;18.03.2017;2017;03;14;Lauantai;12;14;26
623;18.03.2017;2017;03;15;Lauantai;14;18;32
623;18.03.2017;2017;03;16;Lauantai;15;15;30
623;18.03.2017;2017;03;17;Lauantai;20;13;33
623;18.03.2017;2017;03;18;Lauantai;10;10;20
623;18.03.2017;2017;03;19;Lauantai;14;3;17
623;18.03.2017;2017;03;20;Lauantai;9;7;16
623;18.03.2017;2017;03;21;Lauantai;16;7;23
623;18.03.2017;2017;03;22;Lauantai;8;4;12
623;18.03.2017;2017;03;23;Lauantai;4;3;7
623;19.03.2017;2017;03;00;Sunnuntai;4;1;5
623;19.03.2017;2017;03;01;Sunnuntai;6;2;8
623;19.03.2017;2017;03;02;Sunnuntai;3;1;4
623;19.03.2017;2017;03;03;Sunnuntai;2;1;3
623;19.03.2017;2017;03;04;Sunnuntai;3;3;6
623;19.03.2017;2017;03;05;Sunnuntai;1;1;2
623;19.03.2017;2017;03;06;Sunnuntai;3;2;5
623;19.03.2017;2017;03;07;Sunnuntai;2;1;3
623;19.03.2017;2017;03;08;Sunnuntai;3;3;6
623;19.03.2017;2017;03;09;Sunnuntai;1;6;7
623;19.03.2017;2017;03;10;Sunnuntai;7;12;19
623;19.03.2017;2017;03;11;Sunnuntai;8;9;17
623;19.03.2017;2017;03;12;Sunnuntai;10;15;25
623;19.03.2017;2017;03;13;Sunnuntai;12;14;26
623;19.03.2017;2017;03;14;Sunnuntai;16;13;29
623;19.03.2017;2017;03;15;Sunnuntai;17;14;31
623;19.03.2017;2017;03;16;Sunnuntai;11;11;22
623;19.03.2017;2017;03;17;Sunnuntai;12;17;29
623;19.03.2017;2017;03;18;Sunnuntai;16;9;25
623;19.03.2017;2017;03;19;Sunnuntai;11;13;24
623;19.03.2017;2017;03;20;Sunnuntai;2;1;3
623;19.03.2017;2017;03;21;Sunnuntai;24;10;34
623;19.03.2017;2017;03;22;Sunnuntai;12;5;17
623;19.03.2017;2017;03;23;Sunnuntai;4;5;9
623;20.03.2017;2017;03;00;Maanantai;7;0;7
623;20.03.2017;2017;03;01;Maanantai;1;0;1
623;20.03.2017;2017;03;02;Maanantai;1;0;1
623;20.03.2017;2017;03;03;Maanantai;0;1;1
623;20.03.2017;2017;03;04;Maanantai;0;2;2
623;20.03.2017;2017;03;05;Maanantai;1;0;1
623;20.03.2017;2017;03;06;Maanantai;0;7;7
623;20.03.2017;2017;03;07;Maanantai;3;18;21
623;20.03.2017;2017;03;08;Maanantai;20;65;85
623;20.03.2017;2017;03;09;Maanantai;31;67;98
623;20.03.2017;2017;03;10;Maanantai;20;32;52
623;20.03.2017;2017;03;11;Maanantai;13;22;35
623;20.03.2017;2017;03;12;Maanantai;20;19;39
623;20.03.2017;2017;03;13;Maanantai;27;14;41
623;20.03.2017;2017;03;14;Maanantai;27;38;65
623;20.03.2017;2017;03;15;Maanantai;48;27;75
623;20.03.2017;2017;03;16;Maanantai;46;28;74
623;20.03.2017;2017;03;17;Maanantai;56;40;96
623;20.03.2017;2017;03;18;Maanantai;34;32;66
623;20.03.2017;2017;03;19;Maanantai;20;24;44
623;20.03.2017;2017;03;20;Maanantai;20;18;38
623;20.03.2017;2017;03;21;Maanantai;22;7;29
623;20.03.2017;2017;03;22;Maanantai;12;3;15
623;20.03.2017;2017;03;23;Maanantai;8;1;9
623;21.03.2017;2017;03;00;Tiistai;6;5;11
623;21.03.2017;2017;03;01;Tiistai;3;1;4
623;21.03.2017;2017;03;02;Tiistai;1;0;1
623;21.03.2017;2017;03;03;Tiistai;0;1;1
623;21.03.2017;2017;03;04;Tiistai;0;0;0
623;21.03.2017;2017;03;05;Tiistai;0;4;4
623;21.03.2017;2017;03;06;Tiistai;1;4;5
623;21.03.2017;2017;03;07;Tiistai;4;22;26
623;21.03.2017;2017;03;08;Tiistai;30;73;103
623;21.03.2017;2017;03;09;Tiistai;30;71;101
623;21.03.2017;2017;03;10;Tiistai;14;26;40
623;21.03.2017;2017;03;11;Tiistai;28;24;52
623;21.03.2017;2017;03;12;Tiistai;23;21;44
623;21.03.2017;2017;03;13;Tiistai;21;22;43
623;21.03.2017;2017;03;14;Tiistai;18;11;29
623;21.03.2017;2017;03;15;Tiistai;38;31;69
623;21.03.2017;2017;03;16;Tiistai;51;26;77
623;21.03.2017;2017;03;17;Tiistai;56;34;90
623;21.03.2017;2017;03;18;Tiistai;43;40;83
623;21.03.2017;2017;03;19;Tiistai;25;15;40
623;21.03.2017;2017;03;20;Tiistai;25;12;37
623;21.03.2017;2017;03;21;Tiistai;18;8;26
623;21.03.2017;2017;03;22;Tiistai;10;5;15
623;21.03.2017;2017;03;23;Tiistai;6;7;13
623;22.03.2017;2017;03;00;Keskiviikko;2;1;3
623;22.03.2017;2017;03;01;Keskiviikko;2;0;2
623;22.03.2017;2017;03;02;Keskiviikko;1;0;1
623;22.03.2017;2017;03;03;Keskiviikko;1;2;3
623;22.03.2017;2017;03;04;Keskiviikko;1;1;2
623;22.03.2017;2017;03;05;Keskiviikko;0;3;3
623;22.03.2017;2017;03;06;Keskiviikko;0;8;8
623;22.03.2017;2017;03;07;Keskiviikko;7;23;30
623;22.03.2017;2017;03;08;Keskiviikko;25;55;80
623;22.03.2017;2017;03;09;Keskiviikko;26;52;78
623;22.03.2017;2017;03;10;Keskiviikko;12;19;31
623;22.03.2017;2017;03;11;Keskiviikko;13;19;32
623;22.03.2017;2017;03;12;Keskiviikko;25;17;42
623;22.03.2017;2017;03;13;Keskiviikko;21;29;50
623;22.03.2017;2017;03;14;Keskiviikko;25;15;40
623;22.03.2017;2017;03;15;Keskiviikko;33;33;66
623;22.03.2017;2017;03;16;Keskiviikko;41;22;63
623;22.03.2017;2017;03;17;Keskiviikko;62;44;106
623;22.03.2017;2017;03;18;Keskiviikko;38;25;63
623;22.03.2017;2017;03;19;Keskiviikko;28;18;46
623;22.03.2017;2017;03;20;Keskiviikko;18;12;30
623;22.03.2017;2017;03;21;Keskiviikko;23;11;34
623;22.03.2017;2017;03;22;Keskiviikko;13;5;18
623;22.03.2017;2017;03;23;Keskiviikko;5;3;8
623;23.03.2017;2017;03;00;Torstai;5;3;8
623;23.03.2017;2017;03;01;Torstai;2;2;4
623;23.03.2017;2017;03;02;Torstai;1;0;1
623;23.03.2017;2017;03;03;Torstai;0;1;1
623;23.03.2017;2017;03;04;Torstai;0;1;1
623;23.03.2017;2017;03;05;Torstai;0;2;2
623;23.03.2017;2017;03;06;Torstai;0;3;3
623;23.03.2017;2017;03;07;Torstai;4;25;29
623;23.03.2017;2017;03;08;Torstai;29;53;82
623;23.03.2017;2017;03;09;Torstai;34;74;108
623;23.03.2017;2017;03;10;Torstai;21;20;41
623;23.03.2017;2017;03;11;Torstai;13;29;42
623;23.03.2017;2017;03;12;Torstai;24;21;45
623;23.03.2017;2017;03;13;Torstai;30;19;49
623;23.03.2017;2017;03;14;Torstai;31;27;58
623;23.03.2017;2017;03;15;Torstai;30;24;54
623;23.03.2017;2017;03;16;Torstai;54;27;81
623;23.03.2017;2017;03;17;Torstai;65;43;108
623;23.03.2017;2017;03;18;Torstai;38;25;63
623;23.03.2017;2017;03;19;Torstai;31;26;57
623;23.03.2017;2017;03;20;Torstai;18;15;33
623;23.03.2017;2017;03;21;Torstai;12;10;22
623;23.03.2017;2017;03;22;Torstai;13;4;17
623;23.03.2017;2017;03;23;Torstai;4;5;9
623;24.03.2017;2017;03;00;Perjantai;6;3;9
623;24.03.2017;2017;03;01;Perjantai;4;0;4
623;24.03.2017;2017;03;02;Perjantai;1;0;1
623;24.03.2017;2017;03;03;Perjantai;2;1;3
623;24.03.2017;2017;03;04;Perjantai;4;2;6
623;24.03.2017;2017;03;05;Perjantai;1;1;2
623;24.03.2017;2017;03;06;Perjantai;1;6;7
623;24.03.2017;2017;03;07;Perjantai;4;19;23
623;24.03.2017;2017;03;08;Perjantai;23;49;72
623;24.03.2017;2017;03;09;Perjantai;23;52;75
623;24.03.2017;2017;03;10;Perjantai;23;29;52
623;24.03.2017;2017;03;11;Perjantai;12;15;27
623;24.03.2017;2017;03;12;Perjantai;23;27;50
623;24.03.2017;2017;03;13;Perjantai;19;27;46
623;24.03.2017;2017;03;14;Perjantai;24;25;49
623;24.03.2017;2017;03;15;Perjantai;48;33;81
623;24.03.2017;2017;03;16;Perjantai;50;25;75
623;24.03.2017;2017;03;17;Perjantai;43;27;70
623;24.03.2017;2017;03;18;Perjantai;29;21;50
623;24.03.2017;2017;03;19;Perjantai;16;22;38
623;24.03.2017;2017;03;20;Perjantai;18;13;31
623;24.03.2017;2017;03;21;Perjantai;12;13;25
623;24.03.2017;2017;03;22;Perjantai;10;5;15
623;24.03.2017;2017;03;23;Perjantai;8;7;15
623;25.03.2017;2017;03;00;Lauantai;7;4;11
623;25.03.2017;2017;03;01;Lauantai;5;2;7
623;25.03.2017;2017;03;02;Lauantai;9;3;12
623;25.03.2017;2017;03;03;Lauantai;10;4;14
623;25.03.2017;2017;03;04;Lauantai;2;0;2
623;25.03.2017;2017;03;05;Lauantai;0;3;3
623;25.03.2017;2017;03;06;Lauantai;1;2;3
623;25.03.2017;2017;03;07;Lauantai;1;5;6
623;25.03.2017;2017;03;08;Lauantai;0;5;5
623;25.03.2017;2017;03;09;Lauantai;2;6;8
623;25.03.2017;2017;03;10;Lauantai;5;14;19
623;25.03.2017;2017;03;11;Lauantai;11;8;19
623;25.03.2017;2017;03;12;Lauantai;4;19;23
623;25.03.2017;2017;03;13;Lauantai;16;22;38
623;25.03.2017;2017;03;14;Lauantai;11;19;30
623;25.03.2017;2017;03;15;Lauantai;18;15;33
623;25.03.2017;2017;03;16;Lauantai;13;22;35
623;25.03.2017;2017;03;17;Lauantai;14;13;27
623;25.03.2017;2017;03;18;Lauantai;17;19;36
623;25.03.2017;2017;03;19;Lauantai;28;14;42
623;25.03.2017;2017;03;20;Lauantai;12;5;17
623;25.03.2017;2017;03;21;Lauantai;11;7;18
623;25.03.2017;2017;03;22;Lauantai;15;12;27
623;25.03.2017;2017;03;23;Lauantai;3;4;7
623;26.03.2017;2017;03;00;Sunnuntai;1;3;4
623;26.03.2017;2017;03;01;Sunnuntai;4;2;6
623;26.03.2017;2017;03;02;Sunnuntai;6;3;9
623;26.03.2017;2017;03;03;Sunnuntai;0;0;0
623;26.03.2017;2017;03;04;Sunnuntai;5;3;8
623;26.03.2017;2017;03;05;Sunnuntai;3;2;5
623;26.03.2017;2017;03;06;Sunnuntai;0;1;1
623;26.03.2017;2017;03;07;Sunnuntai;1;2;3
623;26.03.2017;2017;03;08;Sunnuntai;1;5;6
623;26.03.2017;2017;03;09;Sunnuntai;3;2;5
623;26.03.2017;2017;03;10;Sunnuntai;3;13;16
623;26.03.2017;2017;03;11;Sunnuntai;1;7;8
623;26.03.2017;2017;03;12;Sunnuntai;13;14;27
623;26.03.2017;2017;03;13;Sunnuntai;12;10;22
623;26.03.2017;2017;03;14;Sunnuntai;12;17;29
623;26.03.2017;2017;03;15;Sunnuntai;24;24;48
623;26.03.2017;2017;03;16;Sunnuntai;21;17;38
623;26.03.2017;2017;03;17;Sunnuntai;26;12;38
623;26.03.2017;2017;03;18;Sunnuntai;19;20;39
623;26.03.2017;2017;03;19;Sunnuntai;26;14;40
623;26.03.2017;2017;03;20;Sunnuntai;15;11;26
623;26.03.2017;2017;03;21;Sunnuntai;14;2;16
623;26.03.2017;2017;03;22;Sunnuntai;12;3;15
623;26.03.2017;2017;03;23;Sunnuntai;5;0;5
623;27.03.2017;2017;03;00;Maanantai;1;1;2
623;27.03.2017;2017;03;01;Maanantai;1;1;2
623;27.03.2017;2017;03;02;Maanantai;2;0;2
623;27.03.2017;2017;03;03;Maanantai;0;1;1
623;27.03.2017;2017;03;04;Maanantai;0;1;1
623;27.03.2017;2017;03;05;Maanantai;0;2;2
623;27.03.2017;2017;03;06;Maanantai;0;6;6
623;27.03.2017;2017;03;07;Maanantai;2;27;29
623;27.03.2017;2017;03;08;Maanantai;25;62;87
623;27.03.2017;2017;03;09;Maanantai;38;83;121
623;27.03.2017;2017;03;10;Maanantai;18;34;52
623;27.03.2017;2017;03;11;Maanantai;14;19;33
623;27.03.2017;2017;03;12;Maanantai;13;20;33
623;27.03.2017;2017;03;13;Maanantai;35;38;73
623;27.03.2017;2017;03;14;Maanantai;20;28;48
623;27.03.2017;2017;03;15;Maanantai;50;26;76
623;27.03.2017;2017;03;16;Maanantai;60;28;88
623;27.03.2017;2017;03;17;Maanantai;59;30;89
623;27.03.2017;2017;03;18;Maanantai;35;35;70
623;27.03.2017;2017;03;19;Maanantai;30;22;52
623;27.03.2017;2017;03;20;Maanantai;22;19;41
623;27.03.2017;2017;03;21;Maanantai;13;12;25
623;27.03.2017;2017;03;22;Maanantai;15;4;19
623;27.03.2017;2017;03;23;Maanantai;4;3;7
623;28.03.2017;2017;03;00;Tiistai;2;2;4
623;28.03.2017;2017;03;01;Tiistai;2;1;3
623;28.03.2017;2017;03;02;Tiistai;0;0;0
623;28.03.2017;2017;03;03;Tiistai;0;2;2
623;28.03.2017;2017;03;04;Tiistai;1;1;2
623;28.03.2017;2017;03;05;Tiistai;0;0;0
623;28.03.2017;2017;03;06;Tiistai;2;6;8
623;28.03.2017;2017;03;07;Tiistai;5;28;33
623;28.03.2017;2017;03;08;Tiistai;24;66;90
623;28.03.2017;2017;03;09;Tiistai;33;68;101
623;28.03.2017;2017;03;10;Tiistai;20;37;57
623;28.03.2017;2017;03;11;Tiistai;21;22;43
623;28.03.2017;2017;03;12;Tiistai;22;18;40
623;28.03.2017;2017;03;13;Tiistai;26;18;44
623;28.03.2017;2017;03;14;Tiistai;30;32;62
623;28.03.2017;2017;03;15;Tiistai;37;31;68
623;28.03.2017;2017;03;16;Tiistai;59;39;98
623;28.03.2017;2017;03;17;Tiistai;76;39;115
623;28.03.2017;2017;03;18;Tiistai;38;36;74
623;28.03.2017;2017;03;19;Tiistai;38;30;68
623;28.03.2017;2017;03;20;Tiistai;27;22;49
623;28.03.2017;2017;03;21;Tiistai;23;12;35
623;28.03.2017;2017;03;22;Tiistai;16;8;24
623;28.03.2017;2017;03;23;Tiistai;9;4;13
623;29.03.2017;2017;03;00;Keskiviikko;2;1;3
623;29.03.2017;2017;03;01;Keskiviikko;2;0;2
623;29.03.2017;2017;03;02;Keskiviikko;2;0;2
623;29.03.2017;2017;03;03;Keskiviikko;2;0;2
623;29.03.2017;2017;03;04;Keskiviikko;2;3;5
623;29.03.2017;2017;03;05;Keskiviikko;0;0;0
623;29.03.2017;2017;03;06;Keskiviikko;0;4;4
623;29.03.2017;2017;03;07;Keskiviikko;5;27;32
623;29.03.2017;2017;03;08;Keskiviikko;30;62;92
623;29.03.2017;2017;03;09;Keskiviikko;39;64;103
623;29.03.2017;2017;03;10;Keskiviikko;14;39;53
623;29.03.2017;2017;03;11;Keskiviikko;17;26;43
623;29.03.2017;2017;03;12;Keskiviikko;19;32;51
623;29.03.2017;2017;03;13;Keskiviikko;27;32;59
623;29.03.2017;2017;03;14;Keskiviikko;42;24;66
623;29.03.2017;2017;03;15;Keskiviikko;38;40;78
623;29.03.2017;2017;03;16;Keskiviikko;58;34;92
623;29.03.2017;2017;03;17;Keskiviikko;61;47;108
623;29.03.2017;2017;03;18;Keskiviikko;45;43;88
623;29.03.2017;2017;03;19;Keskiviikko;34;24;58
623;29.03.2017;2017;03;20;Keskiviikko;34;15;49
623;29.03.2017;2017;03;21;Keskiviikko;30;16;46
623;29.03.2017;2017;03;22;Keskiviikko;14;14;28
623;29.03.2017;2017;03;23;Keskiviikko;10;5;15
623;30.03.2017;2017;03;00;Torstai;3;4;7
623;30.03.2017;2017;03;01;Torstai;3;5;8
623;30.03.2017;2017;03;02;Torstai;2;0;2
623;30.03.2017;2017;03;03;Torstai;2;1;3
623;30.03.2017;2017;03;04;Torstai;0;2;2
623;30.03.2017;2017;03;05;Torstai;0;2;2
623;30.03.2017;2017;03;06;Torstai;2;6;8
623;30.03.2017;2017;03;07;Torstai;5;20;25
623;30.03.2017;2017;03;08;Torstai;26;49;75
623;30.03.2017;2017;03;09;Torstai;33;73;106
623;30.03.2017;2017;03;10;Torstai;14;26;40
623;30.03.2017;2017;03;11;Torstai;15;27;42
623;30.03.2017;2017;03;12;Torstai;27;21;48
623;30.03.2017;2017;03;13;Torstai;31;34;65
623;30.03.2017;2017;03;14;Torstai;43;25;68
623;30.03.2017;2017;03;15;Torstai;43;39;82
623;30.03.2017;2017;03;16;Torstai;54;43;97
623;30.03.2017;2017;03;17;Torstai;62;43;105
623;30.03.2017;2017;03;18;Torstai;46;42;88
623;30.03.2017;2017;03;19;Torstai;32;21;53
623;30.03.2017;2017;03;20;Torstai;21;17;38
623;30.03.2017;2017;03;21;Torstai;14;15;29
623;30.03.2017;2017;03;22;Torstai;15;8;23
623;30.03.2017;2017;03;23;Torstai;6;6;12
623;31.03.2017;2017;03;00;Perjantai;5;4;9
623;31.03.2017;2017;03;01;Perjantai;3;0;3
623;31.03.2017;2017;03;02;Perjantai;2;0;2
623;31.03.2017;2017;03;03;Perjantai;3;1;4
623;31.03.2017;2017;03;04;Perjantai;3;2;5
623;31.03.2017;2017;03;05;Perjantai;1;2;3
623;31.03.2017;2017;03;06;Perjantai;2;5;7
623;31.03.2017;2017;03;07;Perjantai;5;19;24
623;31.03.2017;2017;03;08;Perjantai;18;60;78
623;31.03.2017;2017;03;09;Perjantai;33;62;95
623;31.03.2017;2017;03;10;Perjantai;21;34;55
623;31.03.2017;2017;03;11;Perjantai;15;21;36
623;31.03.2017;2017;03;12;Perjantai;20;27;47
623;31.03.2017;2017;03;13;Perjantai;24;21;45
623;31.03.2017;2017;03;14;Perjantai;42;29;71
623;31.03.2017;2017;03;15;Perjantai;45;46;91
623;31.03.2017;2017;03;16;Perjantai;48;26;74
623;31.03.2017;2017;03;17;Perjantai;40;35;75
623;31.03.2017;2017;03;18;Perjantai;29;17;46
623;31.03.2017;2017;03;19;Perjantai;22;16;38
623;31.03.2017;2017;03;20;Perjantai;17;21;38
623;31.03.2017;2017;03;21;Perjantai;14;8;22
623;31.03.2017;2017;03;22;Perjantai;13;5;18
623;31.03.2017;2017;03;23;Perjantai;10;3;13
623;01.04.2017;2017;04;00;Lauantai;7;5;12
623;01.04.2017;2017;04;01;Lauantai;6;1;7
623;01.04.2017;2017;04;02;Lauantai;2;0;2
623;01.04.2017;2017;04;03;Lauantai;3;1;4
623;01.04.2017;2017;04;04;Lauantai;3;2;5
623;01.04.2017;2017;04;05;Lauantai;3;1;4
623;01.04.2017;2017;04;06;Lauantai;2;5;7
623;01.04.2017;2017;04;07;Lauantai;0;5;5
623;01.04.2017;2017;04;08;Lauantai;1;3;4
623;01.04.2017;2017;04;09;Lauantai;2;8;10
623;01.04.2017;2017;04;10;Lauantai;4;11;15
623;01.04.2017;2017;04;11;Lauantai;7;13;20
623;01.04.2017;2017;04;12;Lauantai;6;15;21
623;01.04.2017;2017;04;13;Lauantai;10;25;35
623;01.04.2017;2017;04;14;Lauantai;10;25;35
623;01.04.2017;2017;04;15;Lauantai;25;21;46
623;01.04.2017;2017;04;16;Lauantai;16;8;24
623;01.04.2017;2017;04;17;Lauantai;6;10;16
623;01.04.2017;2017;04;18;Lauantai;18;11;29
623;01.04.2017;2017;04;19;Lauantai;9;10;19
623;01.04.2017;2017;04;20;Lauantai;4;7;11
623;01.04.2017;2017;04;21;Lauantai;7;4;11
623;01.04.2017;2017;04;22;Lauantai;8;8;16
623;01.04.2017;2017;04;23;Lauantai;5;4;9
623;02.04.2017;2017;04;00;Sunnuntai;2;4;6
623;02.04.2017;2017;04;01;Sunnuntai;3;2;5
623;02.04.2017;2017;04;02;Sunnuntai;7;0;7
623;02.04.2017;2017;04;03;Sunnuntai;1;2;3
623;02.04.2017;2017;04;04;Sunnuntai;2;2;4
623;02.04.2017;2017;04;05;Sunnuntai;4;1;5
623;02.04.2017;2017;04;06;Sunnuntai;1;0;1
623;02.04.2017;2017;04;07;Sunnuntai;4;3;7
623;02.04.2017;2017;04;08;Sunnuntai;3;4;7
623;02.04.2017;2017;04;09;Sunnuntai;0;3;3
623;02.04.2017;2017;04;10;Sunnuntai;3;8;11
623;02.04.2017;2017;04;11;Sunnuntai;5;4;9
623;02.04.2017;2017;04;12;Sunnuntai;9;7;16
623;02.04.2017;2017;04;13;Sunnuntai;9;26;35
623;02.04.2017;2017;04;14;Sunnuntai;17;17;34
623;02.04.2017;2017;04;15;Sunnuntai;14;12;26
623;02.04.2017;2017;04;16;Sunnuntai;22;18;40
623;02.04.2017;2017;04;17;Sunnuntai;11;7;18
623;02.04.2017;2017;04;18;Sunnuntai;17;13;30
623;02.04.2017;2017;04;19;Sunnuntai;18;13;31
623;02.04.2017;2017;04;20;Sunnuntai;10;10;20
623;02.04.2017;2017;04;21;Sunnuntai;13;5;18
623;02.04.2017;2017;04;22;Sunnuntai;11;6;17
623;02.04.2017;2017;04;23;Sunnuntai;7;1;8
623;03.04.2017;2017;04;00;Maanantai;1;0;1
623;03.04.2017;2017;04;01;Maanantai;1;1;2
623;03.04.2017;2017;04;02;Maanantai;2;1;3
623;03.04.2017;2017;04;03;Maanantai;1;1;2
623;03.04.2017;2017;04;04;Maanantai;0;0;0
623;03.04.2017;2017;04;05;Maanantai;0;0;0
623;03.04.2017;2017;04;06;Maanantai;2;5;7
623;03.04.2017;2017;04;07;Maanantai;4;34;38
623;03.04.2017;2017;04;08;Maanantai;33;64;97
623;03.04.2017;2017;04;09;Maanantai;36;68;104
623;03.04.2017;2017;04;10;Maanantai;22;36;58
623;03.04.2017;2017;04;11;Maanantai;25;22;47
623;03.04.2017;2017;04;12;Maanantai;19;28;47
623;03.04.2017;2017;04;13;Maanantai;27;31;58
623;03.04.2017;2017;04;14;Maanantai;28;29;57
623;03.04.2017;2017;04;15;Maanantai;55;30;85
623;03.04.2017;2017;04;16;Maanantai;59;30;89
623;03.04.2017;2017;04;17;Maanantai;68;48;116
623;03.04.2017;2017;04;18;Maanantai;50;50;100
623;03.04.2017;2017;04;19;Maanantai;23;24;47
623;03.04.2017;2017;04;20;Maanantai;38;19;57
623;03.04.2017;2017;04;21;Maanantai;22;14;36
623;03.04.2017;2017;04;22;Maanantai;14;8;22
623;03.04.2017;2017;04;23;Maanantai;18;7;25
623;04.04.2017;2017;04;00;Tiistai;3;2;5
623;04.04.2017;2017;04;01;Tiistai;1;0;1
623;04.04.2017;2017;04;02;Tiistai;2;0;2
623;04.04.2017;2017;04;03;Tiistai;0;1;1
623;04.04.2017;2017;04;04;Tiistai;0;0;0
623;04.04.2017;2017;04;05;Tiistai;0;1;1
623;04.04.2017;2017;04;06;Tiistai;1;5;6
623;04.04.2017;2017;04;07;Tiistai;4;27;31
623;04.04.2017;2017;04;08;Tiistai;29;75;104
623;04.04.2017;2017;04;09;Tiistai;41;70;111
623;04.04.2017;2017;04;10;Tiistai;25;37;62
623;04.04.2017;2017;04;11;Tiistai;24;25;49
623;04.04.2017;2017;04;12;Tiistai;22;27;49
623;04.04.2017;2017;04;13;Tiistai;24;38;62
623;04.04.2017;2017;04;14;Tiistai;34;30;64
623;04.04.2017;2017;04;15;Tiistai;49;42;91
623;04.04.2017;2017;04;16;Tiistai;67;37;104
623;04.04.2017;2017;04;17;Tiistai;70;54;124
623;04.04.2017;2017;04;18;Tiistai;54;50;104
623;04.04.2017;2017;04;19;Tiistai;39;22;61
623;04.04.2017;2017;04;20;Tiistai;34;17;51
623;04.04.2017;2017;04;21;Tiistai;24;17;41
623;04.04.2017;2017;04;22;Tiistai;18;9;27
623;04.04.2017;2017;04;23;Tiistai;12;8;20
623;05.04.2017;2017;04;00;Keskiviikko;3;3;6
623;05.04.2017;2017;04;01;Keskiviikko;1;0;1
623;05.04.2017;2017;04;02;Keskiviikko;1;0;1
623;05.04.2017;2017;04;03;Keskiviikko;0;1;1
623;05.04.2017;2017;04;04;Keskiviikko;0;1;1
623;05.04.2017;2017;04;05;Keskiviikko;0;2;2
623;05.04.2017;2017;04;06;Keskiviikko;1;6;7
623;05.04.2017;2017;04;07;Keskiviikko;9;37;46
623;05.04.2017;2017;04;08;Keskiviikko;34;77;111
623;05.04.2017;2017;04;09;Keskiviikko;35;73;108
623;05.04.2017;2017;04;10;Keskiviikko;33;43;76
623;05.04.2017;2017;04;11;Keskiviikko;19;33;52
623;05.04.2017;2017;04;12;Keskiviikko;34;38;72
623;05.04.2017;2017;04;13;Keskiviikko;30;32;62
623;05.04.2017;2017;04;14;Keskiviikko;45;32;77
623;05.04.2017;2017;04;15;Keskiviikko;55;41;96
623;05.04.2017;2017;04;16;Keskiviikko;78;45;123
623;05.04.2017;2017;04;17;Keskiviikko;82;48;130
623;05.04.2017;2017;04;18;Keskiviikko;49;49;98
623;05.04.2017;2017;04;19;Keskiviikko;36;34;70
623;05.04.2017;2017;04;20;Keskiviikko;29;30;59
623;05.04.2017;2017;04;21;Keskiviikko;33;15;48
623;05.04.2017;2017;04;22;Keskiviikko;14;5;19
623;05.04.2017;2017;04;23;Keskiviikko;12;4;16
623;06.04.2017;2017;04;00;Torstai;5;3;8
623;06.04.2017;2017;04;01;Torstai;4;4;8
623;06.04.2017;2017;04;02;Torstai;3;1;4
623;06.04.2017;2017;04;03;Torstai;2;2;4
623;06.04.2017;2017;04;04;Torstai;1;0;1
623;06.04.2017;2017;04;05;Torstai;0;2;2
623;06.04.2017;2017;04;06;Torstai;3;5;8
623;06.04.2017;2017;04;07;Torstai;6;29;35
623;06.04.2017;2017;04;08;Torstai;40;64;104
623;06.04.2017;2017;04;09;Torstai;51;85;136
623;06.04.2017;2017;04;10;Torstai;21;40;61
623;06.04.2017;2017;04;11;Torstai;19;32;51
623;06.04.2017;2017;04;12;Torstai;28;33;61
623;06.04.2017;2017;04;13;Torstai;40;46;86
623;06.04.2017;2017;04;14;Torstai;50;35;85
623;06.04.2017;2017;04;15;Torstai;31;32;63
623;06.04.2017;2017;04;16;Torstai;67;34;101
623;06.04.2017;2017;04;17;Torstai;67;55;122
623;06.04.2017;2017;04;18;Torstai;51;36;87
623;06.04.2017;2017;04;19;Torstai;35;29;64
623;06.04.2017;2017;04;20;Torstai;21;15;36
623;06.04.2017;2017;04;21;Torstai;31;15;46
623;06.04.2017;2017;04;22;Torstai;16;8;24
623;06.04.2017;2017;04;23;Torstai;11;7;18
623;07.04.2017;2017;04;00;Perjantai;5;2;7
623;07.04.2017;2017;04;01;Perjantai;2;2;4
623;07.04.2017;2017;04;02;Perjantai;2;3;5
623;07.04.2017;2017;04;03;Perjantai;2;0;2
623;07.04.2017;2017;04;04;Perjantai;0;1;1
623;07.04.2017;2017;04;05;Perjantai;1;1;2
623;07.04.2017;2017;04;06;Perjantai;2;6;8
623;07.04.2017;2017;04;07;Perjantai;8;29;37
623;07.04.2017;2017;04;08;Perjantai;26;76;102
623;07.04.2017;2017;04;09;Perjantai;34;67;101
623;07.04.2017;2017;04;10;Perjantai;25;30;55
623;07.04.2017;2017;04;11;Perjantai;20;32;52
623;07.04.2017;2017;04;12;Perjantai;29;28;57
623;07.04.2017;2017;04;13;Perjantai;33;46;79
623;07.04.2017;2017;04;14;Perjantai;48;30;78
623;07.04.2017;2017;04;15;Perjantai;49;37;86
623;07.04.2017;2017;04;16;Perjantai;58;38;96
623;07.04.2017;2017;04;17;Perjantai;51;32;83
623;07.04.2017;2017;04;18;Perjantai;48;34;82
623;07.04.2017;2017;04;19;Perjantai;28;17;45
623;07.04.2017;2017;04;20;Perjantai;24;21;45
623;07.04.2017;2017;04;21;Perjantai;21;19;40
623;07.04.2017;2017;04;22;Perjantai;16;8;24
623;07.04.2017;2017;04;23;Perjantai;16;12;28
623;08.04.2017;2017;04;00;Lauantai;6;11;17
623;08.04.2017;2017;04;01;Lauantai;5;2;7
623;08.04.2017;2017;04;02;Lauantai;11;1;12
623;08.04.2017;2017;04;03;Lauantai;7;3;10
623;08.04.2017;2017;04;04;Lauantai;3;0;3
623;08.04.2017;2017;04;05;Lauantai;4;3;7
623;08.04.2017;2017;04;06;Lauantai;0;0;0
623;08.04.2017;2017;04;07;Lauantai;4;4;8
623;08.04.2017;2017;04;08;Lauantai;3;7;10
623;08.04.2017;2017;04;09;Lauantai;4;8;12
623;08.04.2017;2017;04;10;Lauantai;5;6;11
623;08.04.2017;2017;04;11;Lauantai;0;0;0
623;08.04.2017;2017;04;12;Lauantai;10;20;30
623;08.04.2017;2017;04;13;Lauantai;23;36;59
623;08.04.2017;2017;04;14;Lauantai;22;39;61
623;08.04.2017;2017;04;15;Lauantai;30;17;47
623;08.04.2017;2017;04;16;Lauantai;30;25;55
623;08.04.2017;2017;04;17;Lauantai;27;19;46
623;08.04.2017;2017;04;18;Lauantai;19;19;38
623;08.04.2017;2017;04;19;Lauantai;21;26;47
623;08.04.2017;2017;04;20;Lauantai;18;9;27
623;08.04.2017;2017;04;21;Lauantai;11;14;25
623;08.04.2017;2017;04;22;Lauantai;15;6;21
623;08.04.2017;2017;04;23;Lauantai;7;6;13
623;09.04.2017;2017;04;00;Sunnuntai;6;5;11
623;09.04.2017;2017;04;01;Sunnuntai;8;7;15
623;09.04.2017;2017;04;02;Sunnuntai;4;1;5
623;09.04.2017;2017;04;03;Sunnuntai;7;0;7
623;09.04.2017;2017;04;04;Sunnuntai;7;1;8
623;09.04.2017;2017;04;05;Sunnuntai;6;2;8
623;09.04.2017;2017;04;06;Sunnuntai;6;1;7
623;09.04.2017;2017;04;07;Sunnuntai;0;4;4
623;09.04.2017;2017;04;08;Sunnuntai;6;3;9
623;09.04.2017;2017;04;09;Sunnuntai;1;1;2
623;09.04.2017;2017;04;10;Sunnuntai;1;7;8
623;09.04.2017;2017;04;11;Sunnuntai;9;16;25
623;09.04.2017;2017;04;12;Sunnuntai;8;13;21
623;09.04.2017;2017;04;13;Sunnuntai;9;19;28
623;09.04.2017;2017;04;14;Sunnuntai;17;27;44
623;09.04.2017;2017;04;15;Sunnuntai;16;15;31
623;09.04.2017;2017;04;16;Sunnuntai;26;23;49
623;09.04.2017;2017;04;17;Sunnuntai;23;12;35
623;09.04.2017;2017;04;18;Sunnuntai;16;21;37
623;09.04.2017;2017;04;19;Sunnuntai;19;19;38
623;09.04.2017;2017;04;20;Sunnuntai;22;16;38
623;09.04.2017;2017;04;21;Sunnuntai;14;9;23
623;09.04.2017;2017;04;22;Sunnuntai;13;7;20
623;09.04.2017;2017;04;23;Sunnuntai;6;5;11
623;10.04.2017;2017;04;00;Maanantai;3;2;5
623;10.04.2017;2017;04;01;Maanantai;1;2;3
623;10.04.2017;2017;04;02;Maanantai;3;0;3
623;10.04.2017;2017;04;03;Maanantai;0;1;1
623;10.04.2017;2017;04;04;Maanantai;1;3;4
623;10.04.2017;2017;04;05;Maanantai;1;1;2
623;10.04.2017;2017;04;06;Maanantai;0;4;4
623;10.04.2017;2017;04;07;Maanantai;6;31;37
623;10.04.2017;2017;04;08;Maanantai;21;63;84
623;10.04.2017;2017;04;09;Maanantai;36;81;117
623;10.04.2017;2017;04;10;Maanantai;24;36;60
623;10.04.2017;2017;04;11;Maanantai;14;22;36
623;10.04.2017;2017;04;12;Maanantai;26;25;51
623;10.04.2017;2017;04;13;Maanantai;32;24;56
623;10.04.2017;2017;04;14;Maanantai;33;23;56
623;10.04.2017;2017;04;15;Maanantai;38;15;53
623;10.04.2017;2017;04;16;Maanantai;50;25;75
623;10.04.2017;2017;04;17;Maanantai;66;41;107
623;10.04.2017;2017;04;18;Maanantai;34;26;60
623;10.04.2017;2017;04;19;Maanantai;21;14;35
623;10.04.2017;2017;04;20;Maanantai;17;11;28
623;10.04.2017;2017;04;21;Maanantai;15;6;21
623;10.04.2017;2017;04;22;Maanantai;15;9;24
623;10.04.2017;2017;04;23;Maanantai;4;3;7
623;11.04.2017;2017;04;00;Tiistai;3;2;5
623;11.04.2017;2017;04;01;Tiistai;4;0;4
623;11.04.2017;2017;04;02;Tiistai;1;1;2
623;11.04.2017;2017;04;03;Tiistai;0;1;1
623;11.04.2017;2017;04;04;Tiistai;0;2;2
623;11.04.2017;2017;04;05;Tiistai;0;1;1
623;11.04.2017;2017;04;06;Tiistai;0;6;6
623;11.04.2017;2017;04;07;Tiistai;3;22;25
623;11.04.2017;2017;04;08;Tiistai;16;45;61
623;11.04.2017;2017;04;09;Tiistai;34;68;102
623;11.04.2017;2017;04;10;Tiistai;23;23;46
623;11.04.2017;2017;04;11;Tiistai;15;14;29
623;11.04.2017;2017;04;12;Tiistai;26;18;44
623;11.04.2017;2017;04;13;Tiistai;15;17;32
623;11.04.2017;2017;04;14;Tiistai;29;17;46
623;11.04.2017;2017;04;15;Tiistai;42;22;64
623;11.04.2017;2017;04;16;Tiistai;47;28;75
623;11.04.2017;2017;04;17;Tiistai;52;51;103
623;11.04.2017;2017;04;18;Tiistai;24;31;55
623;11.04.2017;2017;04;19;Tiistai;25;15;40
623;11.04.2017;2017;04;20;Tiistai;17;6;23
623;11.04.2017;2017;04;21;Tiistai;15;12;27
623;11.04.2017;2017;04;22;Tiistai;13;13;26
623;11.04.2017;2017;04;23;Tiistai;10;5;15
623;12.04.2017;2017;04;00;Keskiviikko;4;1;5
623;12.04.2017;2017;04;01;Keskiviikko;2;4;6
623;12.04.2017;2017;04;02;Keskiviikko;2;0;2
623;12.04.2017;2017;04;03;Keskiviikko;1;0;1
623;12.04.2017;2017;04;04;Keskiviikko;1;2;3
623;12.04.2017;2017;04;05;Keskiviikko;1;3;4
623;12.04.2017;2017;04;06;Keskiviikko;0;5;5
623;12.04.2017;2017;04;07;Keskiviikko;0;30;30
623;12.04.2017;2017;04;08;Keskiviikko;31;65;96
623;12.04.2017;2017;04;09;Keskiviikko;27;75;102
623;12.04.2017;2017;04;10;Keskiviikko;27;36;63
623;12.04.2017;2017;04;11;Keskiviikko;18;16;34
623;12.04.2017;2017;04;12;Keskiviikko;39;38;77
623;12.04.2017;2017;04;13;Keskiviikko;28;23;51
623;12.04.2017;2017;04;14;Keskiviikko;40;30;70
623;12.04.2017;2017;04;15;Keskiviikko;33;38;71
623;12.04.2017;2017;04;16;Keskiviikko;83;44;127
623;12.04.2017;2017;04;17;Keskiviikko;67;57;124
623;12.04.2017;2017;04;18;Keskiviikko;36;41;77
623;12.04.2017;2017;04;19;Keskiviikko;33;27;60
623;12.04.2017;2017;04;20;Keskiviikko;26;17;43
623;12.04.2017;2017;04;21;Keskiviikko;23;12;35
623;12.04.2017;2017;04;22;Keskiviikko;18;6;24
623;12.04.2017;2017;04;23;Keskiviikko;15;7;22
623;13.04.2017;2017;04;00;Torstai;5;4;9
623;13.04.2017;2017;04;01;Torstai;4;2;6
623;13.04.2017;2017;04;02;Torstai;5;0;5
623;13.04.2017;2017;04;03;Torstai;0;1;1
623;13.04.2017;2017;04;04;Torstai;1;3;4
623;13.04.2017;2017;04;05;Torstai;2;3;5
623;13.04.2017;2017;04;06;Torstai;0;9;9
623;13.04.2017;2017;04;07;Torstai;6;32;38
623;13.04.2017;2017;04;08;Torstai;30;55;85
623;13.04.2017;2017;04;09;Torstai;22;50;72
623;13.04.2017;2017;04;10;Torstai;15;28;43
623;13.04.2017;2017;04;11;Torstai;22;29;51
623;13.04.2017;2017;04;12;Torstai;22;26;48
623;13.04.2017;2017;04;13;Torstai;24;13;37
623;13.04.2017;2017;04;14;Torstai;52;57;109
623;13.04.2017;2017;04;15;Torstai;43;21;64
623;13.04.2017;2017;04;16;Torstai;55;31;86
623;13.04.2017;2017;04;17;Torstai;44;37;81
623;13.04.2017;2017;04;18;Torstai;25;24;49
623;13.04.2017;2017;04;19;Torstai;23;20;43
623;13.04.2017;2017;04;20;Torstai;7;16;23
623;13.04.2017;2017;04;21;Torstai;19;10;29
623;13.04.2017;2017;04;22;Torstai;18;11;29
623;13.04.2017;2017;04;23;Torstai;8;11;19
623;14.04.2017;2017;04;00;Perjantai;6;5;11
623;14.04.2017;2017;04;01;Perjantai;5;0;5
623;14.04.2017;2017;04;02;Perjantai;2;2;4
623;14.04.2017;2017;04;03;Perjantai;3;0;3
623;14.04.2017;2017;04;04;Perjantai;4;1;5
623;14.04.2017;2017;04;05;Perjantai;2;1;3
623;14.04.2017;2017;04;06;Perjantai;1;1;2
623;14.04.2017;2017;04;07;Perjantai;1;8;9
623;14.04.2017;2017;04;08;Perjantai;0;1;1
623;14.04.2017;2017;04;09;Perjantai;1;5;6
623;14.04.2017;2017;04;10;Perjantai;4;11;15
623;14.04.2017;2017;04;11;Perjantai;10;6;16
623;14.04.2017;2017;04;12;Perjantai;7;9;16
623;14.04.2017;2017;04;13;Perjantai;14;10;24
623;14.04.2017;2017;04;14;Perjantai;12;18;30
623;14.04.2017;2017;04;15;Perjantai;13;12;25
623;14.04.2017;2017;04;16;Perjantai;16;11;27
623;14.04.2017;2017;04;17;Perjantai;13;8;21
623;14.04.2017;2017;04;18;Perjantai;13;16;29
623;14.04.2017;2017;04;19;Perjantai;9;13;22
623;14.04.2017;2017;04;20;Perjantai;7;17;24
623;14.04.2017;2017;04;21;Perjantai;11;12;23
623;14.04.2017;2017;04;22;Perjantai;16;11;27
623;14.04.2017;2017;04;23;Perjantai;2;5;7
623;15.04.2017;2017;04;00;Lauantai;5;2;7
623;15.04.2017;2017;04;01;Lauantai;6;0;6
623;15.04.2017;2017;04;02;Lauantai;5;5;10
623;15.04.2017;2017;04;03;Lauantai;2;2;4
623;15.04.2017;2017;04;04;Lauantai;0;0;0
623;15.04.2017;2017;04;05;Lauantai;2;0;2
623;15.04.2017;2017;04;06;Lauantai;0;4;4
623;15.04.2017;2017;04;07;Lauantai;2;2;4
623;15.04.2017;2017;04;08;Lauantai;2;4;6
623;15.04.2017;2017;04;09;Lauantai;4;5;9
623;15.04.2017;2017;04;10;Lauantai;5;12;17
623;15.04.2017;2017;04;11;Lauantai;6;12;18
623;15.04.2017;2017;04;12;Lauantai;3;9;12
623;15.04.2017;2017;04;13;Lauantai;10;19;29
623;15.04.2017;2017;04;14;Lauantai;6;15;21
623;15.04.2017;2017;04;15;Lauantai;16;14;30
623;15.04.2017;2017;04;16;Lauantai;26;26;52
623;15.04.2017;2017;04;17;Lauantai;16;15;31
623;15.04.2017;2017;04;18;Lauantai;21;12;33
623;15.04.2017;2017;04;19;Lauantai;16;19;35
623;15.04.2017;2017;04;20;Lauantai;16;19;35
623;15.04.2017;2017;04;21;Lauantai;10;10;20
623;15.04.2017;2017;04;22;Lauantai;13;3;16
623;15.04.2017;2017;04;23;Lauantai;12;5;17
623;16.04.2017;2017;04;00;Sunnuntai;7;2;9
623;16.04.2017;2017;04;01;Sunnuntai;2;3;5
623;16.04.2017;2017;04;02;Sunnuntai;2;4;6
623;16.04.2017;2017;04;03;Sunnuntai;8;3;11
623;16.04.2017;2017;04;04;Sunnuntai;1;0;1
623;16.04.2017;2017;04;05;Sunnuntai;5;1;6
623;16.04.2017;2017;04;06;Sunnuntai;0;1;1
623;16.04.2017;2017;04;07;Sunnuntai;2;6;8
623;16.04.2017;2017;04;08;Sunnuntai;3;6;9
623;16.04.2017;2017;04;09;Sunnuntai;2;0;2
623;16.04.2017;2017;04;10;Sunnuntai;3;8;11
623;16.04.2017;2017;04;11;Sunnuntai;6;13;19
623;16.04.2017;2017;04;12;Sunnuntai;8;10;18
623;16.04.2017;2017;04;13;Sunnuntai;18;21;39
623;16.04.2017;2017;04;14;Sunnuntai;17;13;30
623;16.04.2017;2017;04;15;Sunnuntai;24;23;47
623;16.04.2017;2017;04;16;Sunnuntai;25;15;40
623;16.04.2017;2017;04;17;Sunnuntai;13;9;22
623;16.04.2017;2017;04;18;Sunnuntai;30;13;43
623;16.04.2017;2017;04;19;Sunnuntai;14;9;23
623;16.04.2017;2017;04;20;Sunnuntai;14;15;29
623;16.04.2017;2017;04;21;Sunnuntai;11;7;18
623;16.04.2017;2017;04;22;Sunnuntai;9;8;17
623;16.04.2017;2017;04;23;Sunnuntai;3;4;7
623;17.04.2017;2017;04;00;Maanantai;4;0;4
623;17.04.2017;2017;04;01;Maanantai;4;4;8
623;17.04.2017;2017;04;02;Maanantai;1;0;1
623;17.04.2017;2017;04;03;Maanantai;2;2;4
623;17.04.2017;2017;04;04;Maanantai;0;0;0
623;17.04.2017;2017;04;05;Maanantai;1;1;2
623;17.04.2017;2017;04;06;Maanantai;0;1;1
623;17.04.2017;2017;04;07;Maanantai;1;8;9
623;17.04.2017;2017;04;08;Maanantai;2;3;5
623;17.04.2017;2017;04;09;Maanantai;0;7;7
623;17.04.2017;2017;04;10;Maanantai;1;2;3
623;17.04.2017;2017;04;11;Maanantai;8;23;31
623;17.04.2017;2017;04;12;Maanantai;9;19;28
623;17.04.2017;2017;04;13;Maanantai;28;24;52
623;17.04.2017;2017;04;14;Maanantai;21;24;45
623;17.04.2017;2017;04;15;Maanantai;30;37;67
623;17.04.2017;2017;04;16;Maanantai;32;22;54
623;17.04.2017;2017;04;17;Maanantai;20;19;39
623;17.04.2017;2017;04;18;Maanantai;23;12;35
623;17.04.2017;2017;04;19;Maanantai;24;15;39
623;17.04.2017;2017;04;20;Maanantai;8;4;12
623;17.04.2017;2017;04;21;Maanantai;27;13;40
623;17.04.2017;2017;04;22;Maanantai;12;6;18
623;17.04.2017;2017;04;23;Maanantai;4;2;6
623;18.04.2017;2017;04;00;Tiistai;5;1;6
623;18.04.2017;2017;04;01;Tiistai;3;1;4
623;18.04.2017;2017;04;02;Tiistai;0;1;1
623;18.04.2017;2017;04;03;Tiistai;0;1;1
623;18.04.2017;2017;04;04;Tiistai;0;0;0
623;18.04.2017;2017;04;05;Tiistai;0;3;3
623;18.04.2017;2017;04;06;Tiistai;1;8;9
623;18.04.2017;2017;04;07;Tiistai;4;33;37
623;18.04.2017;2017;04;08;Tiistai;35;78;113
623;18.04.2017;2017;04;09;Tiistai;44;95;139
623;18.04.2017;2017;04;10;Tiistai;29;44;73
623;18.04.2017;2017;04;11;Tiistai;22;25;47
623;18.04.2017;2017;04;12;Tiistai;29;29;58
623;18.04.2017;2017;04;13;Tiistai;35;38;73
623;18.04.2017;2017;04;14;Tiistai;35;39;74
623;18.04.2017;2017;04;15;Tiistai;57;35;92
623;18.04.2017;2017;04;16;Tiistai;75;39;114
623;18.04.2017;2017;04;17;Tiistai;99;57;156
623;18.04.2017;2017;04;18;Tiistai;51;49;100
623;18.04.2017;2017;04;19;Tiistai;35;26;61
623;18.04.2017;2017;04;20;Tiistai;39;10;49
623;18.04.2017;2017;04;21;Tiistai;30;16;46
623;18.04.2017;2017;04;22;Tiistai;18;9;27
623;18.04.2017;2017;04;23;Tiistai;10;6;16
623;19.04.2017;2017;04;00;Keskiviikko;5;3;8
623;19.04.2017;2017;04;01;Keskiviikko;1;0;1
623;19.04.2017;2017;04;02;Keskiviikko;1;1;2
623;19.04.2017;2017;04;03;Keskiviikko;0;0;0
623;19.04.2017;2017;04;04;Keskiviikko;3;6;9
623;19.04.2017;2017;04;05;Keskiviikko;0;1;1
623;19.04.2017;2017;04;06;Keskiviikko;1;10;11
623;19.04.2017;2017;04;07;Keskiviikko;7;41;48
623;19.04.2017;2017;04;08;Keskiviikko;47;93;140
623;19.04.2017;2017;04;09;Keskiviikko;48;100;148
623;19.04.2017;2017;04;10;Keskiviikko;24;55;79
623;19.04.2017;2017;04;11;Keskiviikko;31;36;67
623;19.04.2017;2017;04;12;Keskiviikko;47;47;94
623;19.04.2017;2017;04;13;Keskiviikko;37;49;86
623;19.04.2017;2017;04;14;Keskiviikko;58;46;104
623;19.04.2017;2017;04;15;Keskiviikko;70;40;110
623;19.04.2017;2017;04;16;Keskiviikko;65;43;108
623;19.04.2017;2017;04;17;Keskiviikko;106;66;172
623;19.04.2017;2017;04;18;Keskiviikko;64;49;113
623;19.04.2017;2017;04;19;Keskiviikko;42;44;86
623;19.04.2017;2017;04;20;Keskiviikko;34;14;48
623;19.04.2017;2017;04;21;Keskiviikko;38;18;56
623;19.04.2017;2017;04;22;Keskiviikko;25;11;36
623;19.04.2017;2017;04;23;Keskiviikko;11;8;19
623;20.04.2017;2017;04;00;Torstai;4;6;10
623;20.04.2017;2017;04;01;Torstai;4;3;7
623;20.04.2017;2017;04;02;Torstai;3;0;3
623;20.04.2017;2017;04;03;Torstai;3;1;4
623;20.04.2017;2017;04;04;Torstai;0;3;3
623;20.04.2017;2017;04;05;Torstai;1;5;6
623;20.04.2017;2017;04;06;Torstai;0;5;5
623;20.04.2017;2017;04;07;Torstai;4;31;35
623;20.04.2017;2017;04;08;Torstai;38;68;106
623;20.04.2017;2017;04;09;Torstai;50;99;149
623;20.04.2017;2017;04;10;Torstai;22;38;60
623;20.04.2017;2017;04;11;Torstai;27;32;59
623;20.04.2017;2017;04;12;Torstai;36;25;61
623;20.04.2017;2017;04;13;Torstai;48;41;89
623;20.04.2017;2017;04;14;Torstai;38;35;73
623;20.04.2017;2017;04;15;Torstai;47;31;78
623;20.04.2017;2017;04;16;Torstai;64;25;89
623;20.04.2017;2017;04;17;Torstai;58;36;94
623;20.04.2017;2017;04;18;Torstai;28;27;55
623;20.04.2017;2017;04;19;Torstai;24;19;43
623;20.04.2017;2017;04;20;Torstai;13;15;28
623;20.04.2017;2017;04;21;Torstai;14;12;26
623;20.04.2017;2017;04;22;Torstai;18;10;28
623;20.04.2017;2017;04;23;Torstai;9;4;13
623;21.04.2017;2017;04;00;Perjantai;3;1;4
623;21.04.2017;2017;04;01;Perjantai;2;2;4
623;21.04.2017;2017;04;02;Perjantai;4;3;7
623;21.04.2017;2017;04;03;Perjantai;4;1;5
623;21.04.2017;2017;04;04;Perjantai;0;4;4
623;21.04.2017;2017;04;05;Perjantai;1;3;4
623;21.04.2017;2017;04;06;Perjantai;0;6;6
623;21.04.2017;2017;04;07;Perjantai;8;35;43
623;21.04.2017;2017;04;08;Perjantai;36;67;103
623;21.04.2017;2017;04;09;Perjantai;52;84;136
623;21.04.2017;2017;04;10;Perjantai;23;39;62
623;21.04.2017;2017;04;11;Perjantai;15;24;39
623;21.04.2017;2017;04;12;Perjantai;31;29;60
623;21.04.2017;2017;04;13;Perjantai;39;37;76
623;21.04.2017;2017;04;14;Perjantai;54;49;103
623;21.04.2017;2017;04;15;Perjantai;75;45;120
623;21.04.2017;2017;04;16;Perjantai;71;39;110
623;21.04.2017;2017;04;17;Perjantai;65;45;110
623;21.04.2017;2017;04;18;Perjantai;42;30;72
623;21.04.2017;2017;04;19;Perjantai;35;28;63
623;21.04.2017;2017;04;20;Perjantai;23;15;38
623;21.04.2017;2017;04;21;Perjantai;15;18;33
623;21.04.2017;2017;04;22;Perjantai;19;11;30
623;21.04.2017;2017;04;23;Perjantai;13;7;20
623;22.04.2017;2017;04;00;Lauantai;12;6;18
623;22.04.2017;2017;04;01;Lauantai;7;3;10
623;22.04.2017;2017;04;02;Lauantai;8;2;10
623;22.04.2017;2017;04;03;Lauantai;4;0;4
623;22.04.2017;2017;04;04;Lauantai;3;1;4
623;22.04.2017;2017;04;05;Lauantai;3;3;6
623;22.04.2017;2017;04;06;Lauantai;1;4;5
623;22.04.2017;2017;04;07;Lauantai;2;5;7
623;22.04.2017;2017;04;08;Lauantai;4;9;13
623;22.04.2017;2017;04;09;Lauantai;10;6;16
623;22.04.2017;2017;04;10;Lauantai;7;17;24
623;22.04.2017;2017;04;11;Lauantai;10;28;38
623;22.04.2017;2017;04;12;Lauantai;19;38;57
623;22.04.2017;2017;04;13;Lauantai;22;37;59
623;22.04.2017;2017;04;14;Lauantai;34;45;79
623;22.04.2017;2017;04;15;Lauantai;35;26;61
623;22.04.2017;2017;04;16;Lauantai;32;22;54
623;22.04.2017;2017;04;17;Lauantai;35;20;55
623;22.04.2017;2017;04;18;Lauantai;31;27;58
623;22.04.2017;2017;04;19;Lauantai;25;14;39
623;22.04.2017;2017;04;20;Lauantai;13;13;26
623;22.04.2017;2017;04;21;Lauantai;18;14;32
623;22.04.2017;2017;04;22;Lauantai;16;8;24
623;22.04.2017;2017;04;23;Lauantai;10;5;15
623;23.04.2017;2017;04;00;Sunnuntai;8;6;14
623;23.04.2017;2017;04;01;Sunnuntai;6;4;10
623;23.04.2017;2017;04;02;Sunnuntai;4;7;11
623;23.04.2017;2017;04;03;Sunnuntai;5;3;8
623;23.04.2017;2017;04;04;Sunnuntai;4;6;10
623;23.04.2017;2017;04;05;Sunnuntai;4;1;5
623;23.04.2017;2017;04;06;Sunnuntai;1;2;3
623;23.04.2017;2017;04;07;Sunnuntai;1;8;9
623;23.04.2017;2017;04;08;Sunnuntai;0;4;4
623;23.04.2017;2017;04;09;Sunnuntai;2;1;3
623;23.04.2017;2017;04;10;Sunnuntai;6;8;14
623;23.04.2017;2017;04;11;Sunnuntai;10;21;31
623;23.04.2017;2017;04;12;Sunnuntai;20;58;78
623;23.04.2017;2017;04;13;Sunnuntai;38;73;111
623;23.04.2017;2017;04;14;Sunnuntai;23;42;65
623;23.04.2017;2017;04;15;Sunnuntai;38;19;57
623;23.04.2017;2017;04;16;Sunnuntai;53;29;82
623;23.04.2017;2017;04;17;Sunnuntai;34;20;54
623;23.04.2017;2017;04;18;Sunnuntai;26;15;41
623;23.04.2017;2017;04;19;Sunnuntai;21;19;40
623;23.04.2017;2017;04;20;Sunnuntai;20;9;29
623;23.04.2017;2017;04;21;Sunnuntai;18;10;28
623;23.04.2017;2017;04;22;Sunnuntai;8;5;13
623;23.04.2017;2017;04;23;Sunnuntai;5;8;13
623;24.04.2017;2017;04;00;Maanantai;5;4;9
623;24.04.2017;2017;04;01;Maanantai;4;1;5
623;24.04.2017;2017;04;02;Maanantai;3;0;3
623;24.04.2017;2017;04;03;Maanantai;6;2;8
623;24.04.2017;2017;04;04;Maanantai;4;2;6
623;24.04.2017;2017;04;05;Maanantai;0;4;4
623;24.04.2017;2017;04;06;Maanantai;0;9;9
623;24.04.2017;2017;04;07;Maanantai;10;42;52
623;24.04.2017;2017;04;08;Maanantai;41;84;125
623;24.04.2017;2017;04;09;Maanantai;58;88;146
623;24.04.2017;2017;04;10;Maanantai;27;58;85
623;24.04.2017;2017;04;11;Maanantai;33;25;58
623;24.04.2017;2017;04;12;Maanantai;30;32;62
623;24.04.2017;2017;04;13;Maanantai;36;41;77
623;24.04.2017;2017;04;14;Maanantai;30;36;66
623;24.04.2017;2017;04;15;Maanantai;73;37;110
623;24.04.2017;2017;04;16;Maanantai;88;53;141
623;24.04.2017;2017;04;17;Maanantai;87;60;147
623;24.04.2017;2017;04;18;Maanantai;59;40;99
623;24.04.2017;2017;04;19;Maanantai;40;29;69
623;24.04.2017;2017;04;20;Maanantai;34;20;54
623;24.04.2017;2017;04;21;Maanantai;23;12;35
623;24.04.2017;2017;04;22;Maanantai;19;12;31
623;24.04.2017;2017;04;23;Maanantai;14;11;25
623;25.04.2017;2017;04;00;Tiistai;9;4;13
623;25.04.2017;2017;04;01;Tiistai;3;1;4
623;25.04.2017;2017;04;02;Tiistai;5;1;6
623;25.04.2017;2017;04;03;Tiistai;2;5;7
623;25.04.2017;2017;04;04;Tiistai;5;1;6
623;25.04.2017;2017;04;05;Tiistai;0;5;5
623;25.04.2017;2017;04;06;Tiistai;2;12;14
623;25.04.2017;2017;04;07;Tiistai;15;47;62
623;25.04.2017;2017;04;08;Tiistai;48;90;138
623;25.04.2017;2017;04;09;Tiistai;49;106;155
623;25.04.2017;2017;04;10;Tiistai;30;39;69
623;25.04.2017;2017;04;11;Tiistai;33;36;69
623;25.04.2017;2017;04;12;Tiistai;35;31;66
623;25.04.2017;2017;04;13;Tiistai;46;54;100
623;25.04.2017;2017;04;14;Tiistai;37;40;77
623;25.04.2017;2017;04;15;Tiistai;64;48;112
623;25.04.2017;2017;04;16;Tiistai;106;56;162
623;25.04.2017;2017;04;17;Tiistai;111;94;205
623;25.04.2017;2017;04;18;Tiistai;58;51;109
623;25.04.2017;2017;04;19;Tiistai;53;30;83
623;25.04.2017;2017;04;20;Tiistai;27;21;48
623;25.04.2017;2017;04;21;Tiistai;46;19;65
623;25.04.2017;2017;04;22;Tiistai;23;12;35
623;25.04.2017;2017;04;23;Tiistai;15;6;21
623;26.04.2017;2017;04;00;Keskiviikko;5;2;7
623;26.04.2017;2017;04;01;Keskiviikko;2;2;4
623;26.04.2017;2017;04;02;Keskiviikko;3;1;4
623;26.04.2017;2017;04;03;Keskiviikko;3;1;4
623;26.04.2017;2017;04;04;Keskiviikko;1;2;3
623;26.04.2017;2017;04;05;Keskiviikko;0;2;2
623;26.04.2017;2017;04;06;Keskiviikko;2;11;13
623;26.04.2017;2017;04;07;Keskiviikko;8;40;48
623;26.04.2017;2017;04;08;Keskiviikko;30;89;119
623;26.04.2017;2017;04;09;Keskiviikko;50;100;150
623;26.04.2017;2017;04;10;Keskiviikko;22;29;51
623;26.04.2017;2017;04;11;Keskiviikko;20;17;37
623;26.04.2017;2017;04;12;Keskiviikko;24;24;48
623;26.04.2017;2017;04;13;Keskiviikko;17;14;31
623;26.04.2017;2017;04;14;Keskiviikko;31;18;49
623;26.04.2017;2017;04;15;Keskiviikko;51;26;77
623;26.04.2017;2017;04;16;Keskiviikko;65;25;90
623;26.04.2017;2017;04;17;Keskiviikko;67;41;108
623;26.04.2017;2017;04;18;Keskiviikko;35;31;66
623;26.04.2017;2017;04;19;Keskiviikko;33;21;54
623;26.04.2017;2017;04;20;Keskiviikko;15;7;22
623;26.04.2017;2017;04;21;Keskiviikko;12;11;23
623;26.04.2017;2017;04;22;Keskiviikko;14;12;26
623;26.04.2017;2017;04;23;Keskiviikko;9;7;16
623;27.04.2017;2017;04;00;Torstai;4;3;7
623;27.04.2017;2017;04;01;Torstai;4;1;5
623;27.04.2017;2017;04;02;Torstai;0;1;1
623;27.04.2017;2017;04;03;Torstai;0;1;1
623;27.04.2017;2017;04;04;Torstai;1;3;4
623;27.04.2017;2017;04;05;Torstai;1;1;2
623;27.04.2017;2017;04;06;Torstai;3;7;10
623;27.04.2017;2017;04;07;Torstai;7;34;41
623;27.04.2017;2017;04;08;Torstai;27;64;91
623;27.04.2017;2017;04;09;Torstai;39;83;122
623;27.04.2017;2017;04;10;Torstai;29;42;71
623;27.04.2017;2017;04;11;Torstai;12;20;32
623;27.04.2017;2017;04;12;Torstai;26;37;63
623;27.04.2017;2017;04;13;Torstai;31;28;59
623;27.04.2017;2017;04;14;Torstai;47;30;77
623;27.04.2017;2017;04;15;Torstai;52;47;99
623;27.04.2017;2017;04;16;Torstai;66;36;102
623;27.04.2017;2017;04;17;Torstai;57;47;104
623;27.04.2017;2017;04;18;Torstai;51;44;95
623;27.04.2017;2017;04;19;Torstai;37;30;67
623;27.04.2017;2017;04;20;Torstai;29;23;52
623;27.04.2017;2017;04;21;Torstai;28;19;47
623;27.04.2017;2017;04;22;Torstai;17;7;24
623;27.04.2017;2017;04;23;Torstai;11;9;20
623;28.04.2017;2017;04;00;Perjantai;6;6;12
623;28.04.2017;2017;04;01;Perjantai;5;9;14
623;28.04.2017;2017;04;02;Perjantai;8;2;10
623;28.04.2017;2017;04;03;Perjantai;3;2;5
623;28.04.2017;2017;04;04;Perjantai;4;2;6
623;28.04.2017;2017;04;05;Perjantai;4;5;9
623;28.04.2017;2017;04;06;Perjantai;1;11;12
623;28.04.2017;2017;04;07;Perjantai;4;39;43
623;28.04.2017;2017;04;08;Perjantai;39;69;108
623;28.04.2017;2017;04;09;Perjantai;44;81;125
623;28.04.2017;2017;04;10;Perjantai;17;53;70
623;28.04.2017;2017;04;11;Perjantai;27;26;53
623;28.04.2017;2017;04;12;Perjantai;25;43;68
623;28.04.2017;2017;04;13;Perjantai;50;30;80
623;28.04.2017;2017;04;14;Perjantai;44;35;79
623;28.04.2017;2017;04;15;Perjantai;71;43;114
623;28.04.2017;2017;04;16;Perjantai;70;51;121
623;28.04.2017;2017;04;17;Perjantai;63;35;98
623;28.04.2017;2017;04;18;Perjantai;31;30;61
623;28.04.2017;2017;04;19;Perjantai;27;26;53
623;28.04.2017;2017;04;20;Perjantai;34;27;61
623;28.04.2017;2017;04;21;Perjantai;29;19;48
623;28.04.2017;2017;04;22;Perjantai;26;13;39
623;28.04.2017;2017;04;23;Perjantai;13;12;25
623;29.04.2017;2017;04;00;Lauantai;7;10;17
623;29.04.2017;2017;04;01;Lauantai;12;9;21
623;29.04.2017;2017;04;02;Lauantai;5;3;8
623;29.04.2017;2017;04;03;Lauantai;7;3;10
623;29.04.2017;2017;04;04;Lauantai;3;2;5
623;29.04.2017;2017;04;05;Lauantai;3;1;4
623;29.04.2017;2017;04;06;Lauantai;2;2;4
623;29.04.2017;2017;04;07;Lauantai;3;6;9
623;29.04.2017;2017;04;08;Lauantai;3;10;13
623;29.04.2017;2017;04;09;Lauantai;10;6;16
623;29.04.2017;2017;04;10;Lauantai;7;17;24
623;29.04.2017;2017;04;11;Lauantai;10;28;38
623;29.04.2017;2017;04;12;Lauantai;19;38;57
623;29.04.2017;2017;04;13;Lauantai;22;37;59
623;29.04.2017;2017;04;14;Lauantai;34;45;79
623;29.04.2017;2017;04;15;Lauantai;35;26;61
623;29.04.2017;2017;04;16;Lauantai;32;22;54
623;29.04.2017;2017;04;17;Lauantai;35;20;55
623;29.04.2017;2017;04;18;Lauantai;31;27;58
623;29.04.2017;2017;04;19;Lauantai;25;14;39
623;29.04.2017;2017;04;20;Lauantai;13;13;26
623;29.04.2017;2017;04;21;Lauantai;18;14;32
623;29.04.2017;2017;04;22;Lauantai;16;8;24
623;29.04.2017;2017;04;23;Lauantai;10;5;15
623;30.04.2017;2017;04;00;Sunnuntai;8;6;14
623;30.04.2017;2017;04;01;Sunnuntai;6;4;10
623;30.04.2017;2017;04;02;Sunnuntai;4;7;11
623;30.04.2017;2017;04;03;Sunnuntai;5;3;8
623;30.04.2017;2017;04;04;Sunnuntai;4;6;10
623;30.04.2017;2017;04;05;Sunnuntai;4;1;5
623;30.04.2017;2017;04;06;Sunnuntai;1;2;3
623;30.04.2017;2017;04;07;Sunnuntai;1;8;9
623;30.04.2017;2017;04;08;Sunnuntai;0;4;4
623;30.04.2017;2017;04;09;Sunnuntai;2;1;3
623;30.04.2017;2017;04;10;Sunnuntai;6;8;14
623;30.04.2017;2017;04;11;Sunnuntai;10;21;31
623;30.04.2017;2017;04;12;Sunnuntai;20;58;78
623;30.04.2017;2017;04;13;Sunnuntai;38;73;111
623;30.04.2017;2017;04;14;Sunnuntai;23;42;65
623;30.04.2017;2017;04;15;Sunnuntai;38;19;57
623;30.04.2017;2017;04;16;Sunnuntai;53;29;82
623;30.04.2017;2017;04;17;Sunnuntai;34;20;54
623;30.04.2017;2017;04;18;Sunnuntai;26;15;41
623;30.04.2017;2017;04;19;Sunnuntai;21;19;40
623;30.04.2017;2017;04;20;Sunnuntai;20;9;29
623;30.04.2017;2017;04;21;Sunnuntai;18;10;28
623;30.04.2017;2017;04;22;Sunnuntai;8;5;13
623;30.04.2017;2017;04;23;Sunnuntai;5;8;13
623;01.05.2017;2017;05;00;Maanantai;8;6;14
623;01.05.2017;2017;05;01;Maanantai;6;4;10
623;01.05.2017;2017;05;02;Maanantai;4;7;11
623;01.05.2017;2017;05;03;Maanantai;5;3;8
623;01.05.2017;2017;05;04;Maanantai;4;6;10
623;01.05.2017;2017;05;05;Maanantai;4;1;5
623;01.05.2017;2017;05;06;Maanantai;1;2;3
623;01.05.2017;2017;05;07;Maanantai;1;8;9
623;01.05.2017;2017;05;08;Maanantai;0;4;4
623;01.05.2017;2017;05;09;Maanantai;2;1;3
623;01.05.2017;2017;05;10;Maanantai;6;8;14
623;01.05.2017;2017;05;11;Maanantai;10;21;31
623;01.05.2017;2017;05;12;Maanantai;20;58;78
623;01.05.2017;2017;05;13;Maanantai;38;73;111
623;01.05.2017;2017;05;14;Maanantai;23;42;65
623;01.05.2017;2017;05;15;Maanantai;38;19;57
623;01.05.2017;2017;05;16;Maanantai;53;29;82
623;01.05.2017;2017;05;17;Maanantai;34;20;54
623;01.05.2017;2017;05;18;Maanantai;26;15;41
623;01.05.2017;2017;05;19;Maanantai;21;19;40
623;01.05.2017;2017;05;20;Maanantai;20;9;29
623;01.05.2017;2017;05;21;Maanantai;18;10;28
623;01.05.2017;2017;05;22;Maanantai;8;5;13
623;01.05.2017;2017;05;23;Maanantai;5;8;13
623;02.05.2017;2017;05;00;Tiistai;9;4;13
623;02.05.2017;2017;05;01;Tiistai;3;1;4
623;02.05.2017;2017;05;02;Tiistai;5;1;6
623;02.05.2017;2017;05;03;Tiistai;2;5;7
623;02.05.2017;2017;05;04;Tiistai;5;1;6
623;02.05.2017;2017;05;05;Tiistai;0;5;5
623;02.05.2017;2017;05;06;Tiistai;2;12;14
623;02.05.2017;2017;05;07;Tiistai;15;47;62
623;02.05.2017;2017;05;08;Tiistai;48;90;138
623;02.05.2017;2017;05;09;Tiistai;49;106;155
623;02.05.2017;2017;05;10;Tiistai;30;39;69
623;02.05.2017;2017;05;11;Tiistai;33;36;69
623;02.05.2017;2017;05;12;Tiistai;35;31;66
623;02.05.2017;2017;05;13;Tiistai;46;54;100
623;02.05.2017;2017;05;14;Tiistai;37;40;77
623;02.05.2017;2017;05;15;Tiistai;64;48;112
623;02.05.2017;2017;05;16;Tiistai;106;56;162
623;02.05.2017;2017;05;17;Tiistai;111;94;205
623;02.05.2017;2017;05;18;Tiistai;58;51;109
623;02.05.2017;2017;05;19;Tiistai;53;30;83
623;02.05.2017;2017;05;20;Tiistai;27;21;48
623;02.05.2017;2017;05;21;Tiistai;46;19;65
623;02.05.2017;2017;05;22;Tiistai;23;12;35
623;02.05.2017;2017;05;23;Tiistai;15;6;21
623;03.05.2017;2017;05;00;Keskiviikko;5;2;7
623;03.05.2017;2017;05;01;Keskiviikko;2;2;4
623;03.05.2017;2017;05;02;Keskiviikko;3;1;4
623;03.05.2017;2017;05;03;Keskiviikko;3;1;4
623;03.05.2017;2017;05;04;Keskiviikko;1;2;3
623;03.05.2017;2017;05;05;Keskiviikko;0;2;2
623;03.05.2017;2017;05;06;Keskiviikko;2;11;13
623;03.05.2017;2017;05;07;Keskiviikko;8;40;48
623;03.05.2017;2017;05;08;Keskiviikko;30;89;119
623;03.05.2017;2017;05;09;Keskiviikko;50;100;150
623;03.05.2017;2017;05;10;Keskiviikko;22;29;51
623;03.05.2017;2017;05;11;Keskiviikko;20;17;37
623;03.05.2017;2017;05;12;Keskiviikko;24;24;48
623;03.05.2017;2017;05;13;Keskiviikko;17;14;31
623;03.05.2017;2017;05;14;Keskiviikko;31;18;49
623;03.05.2017;2017;05;15;Keskiviikko;51;26;77
623;03.05.2017;2017;05;16;Keskiviikko;65;25;90
623;03.05.2017;2017;05;17;Keskiviikko;67;41;108
623;03.05.2017;2017;05;18;Keskiviikko;35;31;66
623;03.05.2017;2017;05;19;Keskiviikko;33;21;54
623;03.05.2017;2017;05;20;Keskiviikko;15;7;22
623;03.05.2017;2017;05;21;Keskiviikko;12;11;23
623;03.05.2017;2017;05;22;Keskiviikko;14;12;26
623;03.05.2017;2017;05;23;Keskiviikko;9;7;16
623;04.05.2017;2017;05;00;Torstai;10;5;15
623;04.05.2017;2017;05;01;Torstai;3;3;6
623;04.05.2017;2017;05;02;Torstai;4;1;5
623;04.05.2017;2017;05;03;Torstai;2;2;4
623;04.05.2017;2017;05;04;Torstai;0;2;2
623;04.05.2017;2017;05;05;Torstai;1;4;5
623;04.05.2017;2017;05;06;Torstai;1;10;11
623;04.05.2017;2017;05;07;Torstai;10;51;61
623;04.05.2017;2017;05;08;Torstai;40;105;145
623;04.05.2017;2017;05;09;Torstai;56;106;162
623;04.05.2017;2017;05;10;Torstai;39;57;96
623;04.05.2017;2017;05;11;Torstai;31;29;60
623;04.05.2017;2017;05;12;Torstai;40;42;82
623;04.05.2017;2017;05;13;Torstai;53;49;102
623;04.05.2017;2017;05;14;Torstai;57;44;101
623;04.05.2017;2017;05;15;Torstai;68;50;118
623;04.05.2017;2017;05;16;Torstai;105;47;152
623;04.05.2017;2017;05;17;Torstai;122;75;197
623;04.05.2017;2017;05;18;Torstai;75;61;136
623;04.05.2017;2017;05;19;Torstai;60;41;101
623;04.05.2017;2017;05;20;Torstai;35;28;63
623;04.05.2017;2017;05;21;Torstai;42;25;67
623;04.05.2017;2017;05;22;Torstai;26;9;35
623;04.05.2017;2017;05;23;Torstai;19;8;27
623;05.05.2017;2017;05;00;Perjantai;10;5;15
623;05.05.2017;2017;05;01;Perjantai;3;3;6
623;05.05.2017;2017;05;02;Perjantai;4;1;5
623;05.05.2017;2017;05;03;Perjantai;2;2;4
623;05.05.2017;2017;05;04;Perjantai;0;2;2
623;05.05.2017;2017;05;05;Perjantai;1;4;5
623;05.05.2017;2017;05;06;Perjantai;1;10;11
623;05.05.2017;2017;05;07;Perjantai;10;51;61
623;05.05.2017;2017;05;08;Perjantai;40;105;145
623;05.05.2017;2017;05;09;Perjantai;56;106;162
623;05.05.2017;2017;05;10;Perjantai;39;57;96
623;05.05.2017;2017;05;11;Perjantai;28;44;72
623;05.05.2017;2017;05;12;Perjantai;49;50;99
623;05.05.2017;2017;05;13;Perjantai;57;52;109
623;05.05.2017;2017;05;14;Perjantai;74;43;117
623;05.05.2017;2017;05;15;Perjantai;74;68;142
623;05.05.2017;2017;05;16;Perjantai;112;64;176
623;05.05.2017;2017;05;17;Perjantai;98;67;165
623;05.05.2017;2017;05;18;Perjantai;68;35;103
623;05.05.2017;2017;05;19;Perjantai;38;33;71
623;05.05.2017;2017;05;20;Perjantai;30;33;63
623;05.05.2017;2017;05;21;Perjantai;37;20;57
623;05.05.2017;2017;05;22;Perjantai;30;11;41
623;05.05.2017;2017;05;23;Perjantai;13;15;28
623;06.05.2017;2017;05;00;Lauantai;14;5;19
623;06.05.2017;2017;05;01;Lauantai;13;6;19
623;06.05.2017;2017;05;02;Lauantai;10;6;16
623;06.05.2017;2017;05;03;Lauantai;7;1;8
623;06.05.2017;2017;05;04;Lauantai;7;0;7
623;06.05.2017;2017;05;05;Lauantai;9;3;12
623;06.05.2017;2017;05;06;Lauantai;1;3;4
623;06.05.2017;2017;05;07;Lauantai;3;6;9
623;06.05.2017;2017;05;08;Lauantai;0;8;8
623;06.05.2017;2017;05;09;Lauantai;6;10;16
623;06.05.2017;2017;05;10;Lauantai;8;21;29
623;06.05.2017;2017;05;11;Lauantai;10;24;34
623;06.05.2017;2017;05;12;Lauantai;21;37;58
623;06.05.2017;2017;05;13;Lauantai;27;32;59
623;06.05.2017;2017;05;14;Lauantai;15;38;53
623;06.05.2017;2017;05;15;Lauantai;38;34;72
623;06.05.2017;2017;05;16;Lauantai;46;25;71
623;06.05.2017;2017;05;17;Lauantai;35;39;74
623;06.05.2017;2017;05;18;Lauantai;37;42;79
623;06.05.2017;2017;05;19;Lauantai;27;26;53
623;06.05.2017;2017;05;20;Lauantai;36;27;63
623;06.05.2017;2017;05;21;Lauantai;23;14;37
623;06.05.2017;2017;05;22;Lauantai;17;8;25
623;06.05.2017;2017;05;23;Lauantai;13;13;26
623;07.05.2017;2017;05;00;Sunnuntai;8;6;14
623;07.05.2017;2017;05;01;Sunnuntai;7;7;14
623;07.05.2017;2017;05;02;Sunnuntai;7;3;10
623;07.05.2017;2017;05;03;Sunnuntai;9;2;11
623;07.05.2017;2017;05;04;Sunnuntai;3;1;4
623;07.05.2017;2017;05;05;Sunnuntai;6;1;7
623;07.05.2017;2017;05;06;Sunnuntai;1;3;4
623;07.05.2017;2017;05;07;Sunnuntai;3;3;6
623;07.05.2017;2017;05;08;Sunnuntai;0;5;5
623;07.05.2017;2017;05;09;Sunnuntai;2;3;5
623;07.05.2017;2017;05;10;Sunnuntai;4;13;17
623;07.05.2017;2017;05;11;Sunnuntai;4;18;22
623;07.05.2017;2017;05;12;Sunnuntai;24;22;46
623;07.05.2017;2017;05;13;Sunnuntai;25;24;49
623;07.05.2017;2017;05;14;Sunnuntai;30;35;65
623;07.05.2017;2017;05;15;Sunnuntai;32;27;59
623;07.05.2017;2017;05;16;Sunnuntai;37;42;79
623;07.05.2017;2017;05;17;Sunnuntai;44;27;71
623;07.05.2017;2017;05;18;Sunnuntai;31;31;62
623;07.05.2017;2017;05;19;Sunnuntai;24;26;50
623;07.05.2017;2017;05;20;Sunnuntai;24;18;42
623;07.05.2017;2017;05;21;Sunnuntai;27;12;39
623;07.05.2017;2017;05;22;Sunnuntai;14;7;21
623;07.05.2017;2017;05;23;Sunnuntai;5;3;8
623;08.05.2017;2017;05;00;Maanantai;5;5;10
623;08.05.2017;2017;05;01;Maanantai;0;0;0
623;08.05.2017;2017;05;02;Maanantai;3;1;4
623;08.05.2017;2017;05;03;Maanantai;1;1;2
623;08.05.2017;2017;05;04;Maanantai;0;1;1
623;08.05.2017;2017;05;05;Maanantai;1;3;4
623;08.05.2017;2017;05;06;Maanantai;1;12;13
623;08.05.2017;2017;05;07;Maanantai;11;51;62
623;08.05.2017;2017;05;08;Maanantai;37;115;152
623;08.05.2017;2017;05;09;Maanantai;63;122;185
623;08.05.2017;2017;05;10;Maanantai;39;62;101
623;08.05.2017;2017;05;11;Maanantai;23;24;47
623;08.05.2017;2017;05;12;Maanantai;37;49;86
623;08.05.2017;2017;05;13;Maanantai;37;36;73
623;08.05.2017;2017;05;14;Maanantai;34;37;71
623;08.05.2017;2017;05;15;Maanantai;63;26;89
623;08.05.2017;2017;05;16;Maanantai;90;40;130
623;08.05.2017;2017;05;17;Maanantai;112;66;178
623;08.05.2017;2017;05;18;Maanantai;71;38;109
623;08.05.2017;2017;05;19;Maanantai;49;34;83
623;08.05.2017;2017;05;20;Maanantai;46;24;70
623;08.05.2017;2017;05;21;Maanantai;40;15;55
623;08.05.2017;2017;05;22;Maanantai;19;10;29
623;08.05.2017;2017;05;23;Maanantai;4;7;11
623;09.05.2017;2017;05;00;Tiistai;4;2;6
623;09.05.2017;2017;05;01;Tiistai;5;3;8
623;09.05.2017;2017;05;02;Tiistai;0;1;1
623;09.05.2017;2017;05;03;Tiistai;1;1;2
623;09.05.2017;2017;05;04;Tiistai;0;1;1
623;09.05.2017;2017;05;05;Tiistai;0;4;4
623;09.05.2017;2017;05;06;Tiistai;0;8;8
623;09.05.2017;2017;05;07;Tiistai;6;53;59
623;09.05.2017;2017;05;08;Tiistai;37;99;136
623;09.05.2017;2017;05;09;Tiistai;41;111;152
623;09.05.2017;2017;05;10;Tiistai;23;41;64
623;09.05.2017;2017;05;11;Tiistai;23;26;49
623;09.05.2017;2017;05;12;Tiistai;22;36;58
623;09.05.2017;2017;05;13;Tiistai;30;33;63
623;09.05.2017;2017;05;14;Tiistai;40;22;62
623;09.05.2017;2017;05;15;Tiistai;75;38;113
623;09.05.2017;2017;05;16;Tiistai;77;43;120
623;09.05.2017;2017;05;17;Tiistai;98;60;158
623;09.05.2017;2017;05;18;Tiistai;58;39;97
623;09.05.2017;2017;05;19;Tiistai;52;37;89
623;09.05.2017;2017;05;20;Tiistai;33;26;59
623;09.05.2017;2017;05;21;Tiistai;33;22;55
623;09.05.2017;2017;05;22;Tiistai;16;8;24
623;09.05.2017;2017;05;23;Tiistai;9;7;16
623;10.05.2017;2017;05;00;Keskiviikko;5;3;8
623;10.05.2017;2017;05;01;Keskiviikko;3;1;4
623;10.05.2017;2017;05;02;Keskiviikko;5;0;5
623;10.05.2017;2017;05;03;Keskiviikko;3;2;5
623;10.05.2017;2017;05;04;Keskiviikko;1;1;2
623;10.05.2017;2017;05;05;Keskiviikko;0;3;3
623;10.05.2017;2017;05;06;Keskiviikko;0;10;10
623;10.05.2017;2017;05;07;Keskiviikko;5;49;54
623;10.05.2017;2017;05;08;Keskiviikko;35;99;134
623;10.05.2017;2017;05;09;Keskiviikko;53;108;161
623;10.05.2017;2017;05;10;Keskiviikko;28;66;94
623;10.05.2017;2017;05;11;Keskiviikko;16;37;53
623;10.05.2017;2017;05;12;Keskiviikko;39;47;86
623;10.05.2017;2017;05;13;Keskiviikko;39;35;74
623;10.05.2017;2017;05;14;Keskiviikko;51;40;91
623;10.05.2017;2017;05;15;Keskiviikko;60;39;99
623;10.05.2017;2017;05;16;Keskiviikko;91;51;142
623;10.05.2017;2017;05;17;Keskiviikko;77;52;129
623;10.05.2017;2017;05;18;Keskiviikko;62;48;110
623;10.05.2017;2017;05;19;Keskiviikko;48;38;86
623;10.05.2017;2017;05;20;Keskiviikko;33;16;49
623;10.05.2017;2017;05;21;Keskiviikko;22;14;36
623;10.05.2017;2017;05;22;Keskiviikko;18;12;30
623;10.05.2017;2017;05;23;Keskiviikko;14;9;23
623;11.05.2017;2017;05;00;Torstai;8;3;11
623;11.05.2017;2017;05;01;Torstai;3;1;4
623;11.05.2017;2017;05;02;Torstai;1;1;2
623;11.05.2017;2017;05;03;Torstai;1;3;4
623;11.05.2017;2017;05;04;Torstai;1;1;2
623;11.05.2017;2017;05;05;Torstai;1;1;2
623;11.05.2017;2017;05;06;Torstai;1;6;7
623;11.05.2017;2017;05;07;Torstai;11;48;59
623;11.05.2017;2017;05;08;Torstai;33;89;122
623;11.05.2017;2017;05;09;Torstai;52;123;175
623;11.05.2017;2017;05;10;Torstai;20;39;59
623;11.05.2017;2017;05;11;Torstai;30;44;74
623;11.05.2017;2017;05;12;Torstai;29;28;57
623;11.05.2017;2017;05;13;Torstai;29;43;72
623;11.05.2017;2017;05;14;Torstai;35;35;70
623;11.05.2017;2017;05;15;Torstai;45;36;81
623;11.05.2017;2017;05;16;Torstai;81;36;117
623;11.05.2017;2017;05;17;Torstai;98;52;150
623;11.05.2017;2017;05;18;Torstai;53;55;108
623;11.05.2017;2017;05;19;Torstai;45;40;85
623;11.05.2017;2017;05;20;Torstai;26;26;52
623;11.05.2017;2017;05;21;Torstai;43;23;66
623;11.05.2017;2017;05;22;Torstai;17;6;23
623;11.05.2017;2017;05;23;Torstai;11;6;17
623;12.05.2017;2017;05;00;Perjantai;5;2;7
623;12.05.2017;2017;05;01;Perjantai;8;0;8
623;12.05.2017;2017;05;02;Perjantai;3;2;5
623;12.05.2017;2017;05;03;Perjantai;1;1;2
623;12.05.2017;2017;05;04;Perjantai;0;2;2
623;12.05.2017;2017;05;05;Perjantai;0;1;1
623;12.05.2017;2017;05;06;Perjantai;1;6;7
623;12.05.2017;2017;05;07;Perjantai;8;46;54
623;12.05.2017;2017;05;08;Perjantai;41;97;138
623;12.05.2017;2017;05;09;Perjantai;39;120;159
623;12.05.2017;2017;05;10;Perjantai;23;58;81
623;12.05.2017;2017;05;11;Perjantai;34;31;65
623;12.05.2017;2017;05;12;Perjantai;44;39;83
623;12.05.2017;2017;05;13;Perjantai;43;39;82
623;12.05.2017;2017;05;14;Perjantai;54;35;89
623;12.05.2017;2017;05;15;Perjantai;76;57;133
623;12.05.2017;2017;05;16;Perjantai;79;44;123
623;12.05.2017;2017;05;17;Perjantai;80;43;123
623;12.05.2017;2017;05;18;Perjantai;51;43;94
623;12.05.2017;2017;05;19;Perjantai;42;28;70
623;12.05.2017;2017;05;20;Perjantai;29;27;56
623;12.05.2017;2017;05;21;Perjantai;19;29;48
623;12.05.2017;2017;05;22;Perjantai;23;7;30
623;12.05.2017;2017;05;23;Perjantai;20;13;33
623;13.05.2017;2017;05;00;Lauantai;14;7;21
623;13.05.2017;2017;05;01;Lauantai;7;5;12
623;13.05.2017;2017;05;02;Lauantai;13;4;17
623;13.05.2017;2017;05;03;Lauantai;10;0;10
623;13.05.2017;2017;05;04;Lauantai;4;2;6
623;13.05.2017;2017;05;05;Lauantai;2;2;4
623;13.05.2017;2017;05;06;Lauantai;5;1;6
623;13.05.2017;2017;05;07;Lauantai;5;7;12
623;13.05.2017;2017;05;08;Lauantai;6;7;13
623;13.05.2017;2017;05;09;Lauantai;3;9;12
623;13.05.2017;2017;05;10;Lauantai;6;19;25
623;13.05.2017;2017;05;11;Lauantai;23;39;62
623;13.05.2017;2017;05;12;Lauantai;18;26;44
623;13.05.2017;2017;05;13;Lauantai;21;36;57
623;13.05.2017;2017;05;14;Lauantai;33;41;74
623;13.05.2017;2017;05;15;Lauantai;32;27;59
623;13.05.2017;2017;05;16;Lauantai;37;41;78
623;13.05.2017;2017;05;17;Lauantai;36;26;62
623;13.05.2017;2017;05;18;Lauantai;33;25;58
623;13.05.2017;2017;05;19;Lauantai;34;25;59
623;13.05.2017;2017;05;20;Lauantai;28;25;53
623;13.05.2017;2017;05;21;Lauantai;21;24;45
623;13.05.2017;2017;05;22;Lauantai;13;10;23
623;13.05.2017;2017;05;23;Lauantai;9;14;23
623;14.05.2017;2017;05;00;Sunnuntai;7;4;11
623;14.05.2017;2017;05;01;Sunnuntai;11;10;21
623;14.05.2017;2017;05;02;Sunnuntai;3;3;6
623;14.05.2017;2017;05;03;Sunnuntai;13;4;17
623;14.05.2017;2017;05;04;Sunnuntai;4;1;5
623;14.05.2017;2017;05;05;Sunnuntai;6;2;8
623;14.05.2017;2017;05;06;Sunnuntai;5;3;8
623;14.05.2017;2017;05;07;Sunnuntai;1;10;11
623;14.05.2017;2017;05;08;Sunnuntai;2;7;9
623;14.05.2017;2017;05;09;Sunnuntai;4;5;9
623;14.05.2017;2017;05;10;Sunnuntai;2;11;13
623;14.05.2017;2017;05;11;Sunnuntai;6;5;11
623;14.05.2017;2017;05;12;Sunnuntai;8;12;20
623;14.05.2017;2017;05;13;Sunnuntai;11;10;21
623;14.05.2017;2017;05;14;Sunnuntai;8;9;17
623;14.05.2017;2017;05;15;Sunnuntai;5;12;17
623;14.05.2017;2017;05;16;Sunnuntai;15;11;26
623;14.05.2017;2017;05;17;Sunnuntai;11;5;16
623;14.05.2017;2017;05;18;Sunnuntai;12;12;24
623;14.05.2017;2017;05;19;Sunnuntai;14;6;20
623;14.05.2017;2017;05;20;Sunnuntai;14;19;33
623;14.05.2017;2017;05;21;Sunnuntai;15;4;19
623;14.05.2017;2017;05;22;Sunnuntai;7;3;10
623;14.05.2017;2017;05;23;Sunnuntai;0;5;5
623;15.05.2017;2017;05;00;Maanantai;6;3;9
623;15.05.2017;2017;05;01;Maanantai;3;3;6
623;15.05.2017;2017;05;02;Maanantai;2;1;3
623;15.05.2017;2017;05;03;Maanantai;1;1;2
623;15.05.2017;2017;05;04;Maanantai;0;2;2
623;15.05.2017;2017;05;05;Maanantai;0;2;2
623;15.05.2017;2017;05;06;Maanantai;4;10;14
623;15.05.2017;2017;05;07;Maanantai;9;36;45
623;15.05.2017;2017;05;08;Maanantai;39;96;135
623;15.05.2017;2017;05;09;Maanantai;56;114;170
623;15.05.2017;2017;05;10;Maanantai;33;56;89
623;15.05.2017;2017;05;11;Maanantai;25;28;53
623;15.05.2017;2017;05;12;Maanantai;39;34;73
623;15.05.2017;2017;05;13;Maanantai;44;43;87
623;15.05.2017;2017;05;14;Maanantai;41;42;83
623;15.05.2017;2017;05;15;Maanantai;68;33;101
623;15.05.2017;2017;05;16;Maanantai;83;51;134
623;15.05.2017;2017;05;17;Maanantai;103;62;165
623;15.05.2017;2017;05;18;Maanantai;78;65;143
623;15.05.2017;2017;05;19;Maanantai;44;32;76
623;15.05.2017;2017;05;20;Maanantai;45;35;80
623;15.05.2017;2017;05;21;Maanantai;42;28;70
623;15.05.2017;2017;05;22;Maanantai;24;12;36
623;15.05.2017;2017;05;23;Maanantai;10;8;18
623;16.05.2017;2017;05;00;Tiistai;6;3;9
623;16.05.2017;2017;05;01;Tiistai;0;2;2
623;16.05.2017;2017;05;02;Tiistai;2;0;2
623;16.05.2017;2017;05;03;Tiistai;1;1;2
623;16.05.2017;2017;05;04;Tiistai;2;1;3
623;16.05.2017;2017;05;05;Tiistai;3;2;5
623;16.05.2017;2017;05;06;Tiistai;3;11;14
623;16.05.2017;2017;05;07;Tiistai;17;61;78
623;16.05.2017;2017;05;08;Tiistai;36;109;145
623;16.05.2017;2017;05;09;Tiistai;67;136;203
623;16.05.2017;2017;05;10;Tiistai;31;49;80
623;16.05.2017;2017;05;11;Tiistai;21;32;53
623;16.05.2017;2017;05;12;Tiistai;37;61;98
623;16.05.2017;2017;05;13;Tiistai;53;50;103
623;16.05.2017;2017;05;14;Tiistai;59;55;114
623;16.05.2017;2017;05;15;Tiistai;78;40;118
623;16.05.2017;2017;05;16;Tiistai;93;50;143
623;16.05.2017;2017;05;17;Tiistai;120;71;191
623;16.05.2017;2017;05;18;Tiistai;89;72;161
623;16.05.2017;2017;05;19;Tiistai;54;42;96
623;16.05.2017;2017;05;20;Tiistai;64;25;89
623;16.05.2017;2017;05;21;Tiistai;38;27;65
623;16.05.2017;2017;05;22;Tiistai;27;9;36
623;16.05.2017;2017;05;23;Tiistai;8;5;13
623;17.05.2017;2017;05;00;Keskiviikko;9;5;14
623;17.05.2017;2017;05;01;Keskiviikko;0;1;1
623;17.05.2017;2017;05;02;Keskiviikko;2;0;2
623;17.05.2017;2017;05;03;Keskiviikko;0;1;1
623;17.05.2017;2017;05;04;Keskiviikko;1;1;2
623;17.05.2017;2017;05;05;Keskiviikko;2;2;4
623;17.05.2017;2017;05;06;Keskiviikko;2;8;10
623;17.05.2017;2017;05;07;Keskiviikko;3;45;48
623;17.05.2017;2017;05;08;Keskiviikko;29;72;101
623;17.05.2017;2017;05;09;Keskiviikko;66;117;183
623;17.05.2017;2017;05;10;Keskiviikko;26;39;65
623;17.05.2017;2017;05;11;Keskiviikko;13;18;31
623;17.05.2017;2017;05;12;Keskiviikko;30;37;67
623;17.05.2017;2017;05;13;Keskiviikko;30;21;51
623;17.05.2017;2017;05;14;Keskiviikko;29;17;46
623;17.05.2017;2017;05;15;Keskiviikko;48;25;73
623;17.05.2017;2017;05;16;Keskiviikko;53;23;76
623;17.05.2017;2017;05;17;Keskiviikko;81;35;116
623;17.05.2017;2017;05;18;Keskiviikko;56;35;91
623;17.05.2017;2017;05;19;Keskiviikko;33;29;62
623;17.05.2017;2017;05;20;Keskiviikko;27;15;42
623;17.05.2017;2017;05;21;Keskiviikko;23;8;31
623;17.05.2017;2017;05;22;Keskiviikko;14;6;20
623;17.05.2017;2017;05;23;Keskiviikko;10;5;15
623;18.05.2017;2017;05;00;Torstai;5;1;6
623;18.05.2017;2017;05;01;Torstai;3;3;6
623;18.05.2017;2017;05;02;Torstai;0;1;1
623;18.05.2017;2017;05;03;Torstai;2;3;5
623;18.05.2017;2017;05;04;Torstai;1;0;1
623;18.05.2017;2017;05;05;Torstai;1;7;8
623;18.05.2017;2017;05;06;Torstai;3;6;9
623;18.05.2017;2017;05;07;Torstai;11;51;62
623;18.05.2017;2017;05;08;Torstai;32;96;128
623;18.05.2017;2017;05;09;Torstai;58;114;172
623;18.05.2017;2017;05;10;Torstai;21;55;76
623;18.05.2017;2017;05;11;Torstai;19;39;58
623;18.05.2017;2017;05;12;Torstai;37;36;73
623;18.05.2017;2017;05;13;Torstai;39;41;80
623;18.05.2017;2017;05;14;Torstai;33;49;82
623;18.05.2017;2017;05;15;Torstai;80;37;117
623;18.05.2017;2017;05;16;Torstai;73;47;120
623;18.05.2017;2017;05;17;Torstai;110;73;183
623;18.05.2017;2017;05;18;Torstai;67;46;113
623;18.05.2017;2017;05;19;Torstai;28;21;49
623;18.05.2017;2017;05;20;Torstai;40;28;68
623;18.05.2017;2017;05;21;Torstai;38;17;55
623;18.05.2017;2017;05;22;Torstai;20;11;31
623;18.05.2017;2017;05;23;Torstai;8;6;14
623;19.05.2017;2017;05;00;Perjantai;3;2;5
623;19.05.2017;2017;05;01;Perjantai;3;1;4
623;19.05.2017;2017;05;02;Perjantai;1;0;1
623;19.05.2017;2017;05;03;Perjantai;1;0;1
623;19.05.2017;2017;05;04;Perjantai;0;1;1
623;19.05.2017;2017;05;05;Perjantai;2;4;6
623;19.05.2017;2017;05;06;Perjantai;2;8;10
623;19.05.2017;2017;05;07;Perjantai;6;28;34
623;19.05.2017;2017;05;08;Perjantai;13;49;62
623;19.05.2017;2017;05;09;Perjantai;19;66;85
623;19.05.2017;2017;05;10;Perjantai;19;23;42
623;19.05.2017;2017;05;11;Perjantai;9;12;21
623;19.05.2017;2017;05;12;Perjantai;15;18;33
623;19.05.2017;2017;05;13;Perjantai;21;28;49
623;19.05.2017;2017;05;14;Perjantai;36;32;68
623;19.05.2017;2017;05;15;Perjantai;35;30;65
623;19.05.2017;2017;05;16;Perjantai;49;32;81
623;19.05.2017;2017;05;17;Perjantai;46;31;77
623;19.05.2017;2017;05;18;Perjantai;37;37;74
623;19.05.2017;2017;05;19;Perjantai;28;32;60
623;19.05.2017;2017;05;20;Perjantai;9;12;21
623;19.05.2017;2017;05;21;Perjantai;19;15;34
623;19.05.2017;2017;05;22;Perjantai;21;10;31
623;19.05.2017;2017;05;23;Perjantai;7;5;12
623;20.05.2017;2017;05;00;Lauantai;7;3;10
623;20.05.2017;2017;05;01;Lauantai;3;2;5
623;20.05.2017;2017;05;02;Lauantai;8;1;9
623;20.05.2017;2017;05;03;Lauantai;2;3;5
623;20.05.2017;2017;05;04;Lauantai;6;0;6
623;20.05.2017;2017;05;05;Lauantai;2;0;2
623;20.05.2017;2017;05;06;Lauantai;4;1;5
623;20.05.2017;2017;05;07;Lauantai;2;5;7
623;20.05.2017;2017;05;08;Lauantai;3;9;12
623;20.05.2017;2017;05;09;Lauantai;5;22;27
623;20.05.2017;2017;05;10;Lauantai;6;21;27
623;20.05.2017;2017;05;11;Lauantai;26;37;63
623;20.05.2017;2017;05;12;Lauantai;22;35;57
623;20.05.2017;2017;05;13;Lauantai;27;52;79
623;20.05.2017;2017;05;14;Lauantai;43;39;82
623;20.05.2017;2017;05;15;Lauantai;46;55;101
623;20.05.2017;2017;05;16;Lauantai;52;29;81
623;20.05.2017;2017;05;17;Lauantai;46;47;93
623;20.05.2017;2017;05;18;Lauantai;52;35;87
623;20.05.2017;2017;05;19;Lauantai;31;26;57
623;20.05.2017;2017;05;20;Lauantai;37;33;70
623;20.05.2017;2017;05;21;Lauantai;28;24;52
623;20.05.2017;2017;05;22;Lauantai;22;13;35
623;20.05.2017;2017;05;23;Lauantai;21;7;28
623;21.05.2017;2017;05;00;Sunnuntai;12;18;30
623;21.05.2017;2017;05;01;Sunnuntai;14;5;19
623;21.05.2017;2017;05;02;Sunnuntai;13;5;18
623;21.05.2017;2017;05;03;Sunnuntai;13;1;14
623;21.05.2017;2017;05;04;Sunnuntai;7;3;10
623;21.05.2017;2017;05;05;Sunnuntai;8;1;9
623;21.05.2017;2017;05;06;Sunnuntai;3;2;5
623;21.05.2017;2017;05;07;Sunnuntai;3;5;8
623;21.05.2017;2017;05;08;Sunnuntai;4;9;13
623;21.05.2017;2017;05;09;Sunnuntai;6;7;13
623;21.05.2017;2017;05;10;Sunnuntai;5;16;21
623;21.05.2017;2017;05;11;Sunnuntai;7;19;26
623;21.05.2017;2017;05;12;Sunnuntai;21;29;50
623;21.05.2017;2017;05;13;Sunnuntai;23;31;54
623;21.05.2017;2017;05;14;Sunnuntai;24;35;59
623;21.05.2017;2017;05;15;Sunnuntai;41;42;83
623;21.05.2017;2017;05;16;Sunnuntai;42;61;103
623;21.05.2017;2017;05;17;Sunnuntai;52;50;102
623;21.05.2017;2017;05;18;Sunnuntai;50;35;85
623;21.05.2017;2017;05;19;Sunnuntai;45;30;75
623;21.05.2017;2017;05;20;Sunnuntai;26;32;58
623;21.05.2017;2017;05;21;Sunnuntai;27;30;57
623;21.05.2017;2017;05;22;Sunnuntai;19;9;28
623;21.05.2017;2017;05;23;Sunnuntai;12;2;14
623;22.05.2017;2017;05;00;Maanantai;0;0;0
623;22.05.2017;2017;05;01;Maanantai;11;5;16
623;22.05.2017;2017;05;02;Maanantai;2;0;2
623;22.05.2017;2017;05;03;Maanantai;1;1;2
623;22.05.2017;2017;05;04;Maanantai;0;2;2
623;22.05.2017;2017;05;05;Maanantai;1;5;6
623;22.05.2017;2017;05;06;Maanantai;1;13;14
623;22.05.2017;2017;05;07;Maanantai;10;53;63
623;22.05.2017;2017;05;08;Maanantai;44;122;166
623;22.05.2017;2017;05;09;Maanantai;55;122;177
623;22.05.2017;2017;05;10;Maanantai;28;54;82
623;22.05.2017;2017;05;11;Maanantai;28;49;77
623;22.05.2017;2017;05;12;Maanantai;39;50;89
623;22.05.2017;2017;05;13;Maanantai;52;50;102
623;22.05.2017;2017;05;14;Maanantai;57;57;114
623;22.05.2017;2017;05;15;Maanantai;80;44;124
623;22.05.2017;2017;05;16;Maanantai;113;65;178
623;22.05.2017;2017;05;17;Maanantai;150;77;227
623;22.05.2017;2017;05;18;Maanantai;85;50;135
623;22.05.2017;2017;05;19;Maanantai;51;46;97
623;22.05.2017;2017;05;20;Maanantai;35;45;80
623;22.05.2017;2017;05;21;Maanantai;52;30;82
623;22.05.2017;2017;05;22;Maanantai;24;12;36
623;22.05.2017;2017;05;23;Maanantai;12;8;20
623;23.05.2017;2017;05;00;Tiistai;5;0;5
623;23.05.2017;2017;05;01;Tiistai;4;1;5
623;23.05.2017;2017;05;02;Tiistai;6;1;7
623;23.05.2017;2017;05;03;Tiistai;2;1;3
623;23.05.2017;2017;05;04;Tiistai;4;2;6
623;23.05.2017;2017;05;05;Tiistai;0;6;6
623;23.05.2017;2017;05;06;Tiistai;1;11;12
623;23.05.2017;2017;05;07;Tiistai;14;61;75
623;23.05.2017;2017;05;08;Tiistai;44;146;190
623;23.05.2017;2017;05;09;Tiistai;58;142;200
623;23.05.2017;2017;05;10;Tiistai;28;51;79
623;23.05.2017;2017;05;11;Tiistai;32;45;77
623;23.05.2017;2017;05;12;Tiistai;46;41;87
623;23.05.2017;2017;05;13;Tiistai;53;66;119
623;23.05.2017;2017;05;14;Tiistai;56;40;96
623;23.05.2017;2017;05;15;Tiistai;87;62;149
623;23.05.2017;2017;05;16;Tiistai;112;60;172
623;23.05.2017;2017;05;17;Tiistai;141;89;230
623;23.05.2017;2017;05;18;Tiistai;91;72;163
623;23.05.2017;2017;05;19;Tiistai;57;45;102
623;23.05.2017;2017;05;20;Tiistai;61;36;97
623;23.05.2017;2017;05;21;Tiistai;46;32;78
623;23.05.2017;2017;05;22;Tiistai;25;16;41
623;23.05.2017;2017;05;23;Tiistai;15;6;21
623;24.05.2017;2017;05;00;Keskiviikko;10;7;17
623;24.05.2017;2017;05;01;Keskiviikko;4;2;6
623;24.05.2017;2017;05;02;Keskiviikko;3;1;4
623;24.05.2017;2017;05;03;Keskiviikko;1;1;2
623;24.05.2017;2017;05;04;Keskiviikko;0;2;2
623;24.05.2017;2017;05;05;Keskiviikko;0;1;1
623;24.05.2017;2017;05;06;Keskiviikko;1;10;11
623;24.05.2017;2017;05;07;Keskiviikko;13;53;66
623;24.05.2017;2017;05;08;Keskiviikko;47;120;167
623;24.05.2017;2017;05;09;Keskiviikko;59;152;211
623;24.05.2017;2017;05;10;Keskiviikko;49;70;119
623;24.05.2017;2017;05;11;Keskiviikko;31;41;72
623;24.05.2017;2017;05;12;Keskiviikko;49;55;104
623;24.05.2017;2017;05;13;Keskiviikko;54;61;115
623;24.05.2017;2017;05;14;Keskiviikko;62;48;110
623;24.05.2017;2017;05;15;Keskiviikko;97;49;146
623;24.05.2017;2017;05;16;Keskiviikko;111;77;188
623;24.05.2017;2017;05;17;Keskiviikko;105;83;188
623;24.05.2017;2017;05;18;Keskiviikko;70;63;133
623;24.05.2017;2017;05;19;Keskiviikko;79;57;136
623;24.05.2017;2017;05;20;Keskiviikko;45;50;95
623;24.05.2017;2017;05;21;Keskiviikko;43;28;71
623;24.05.2017;2017;05;22;Keskiviikko;43;27;70
623;24.05.2017;2017;05;23;Keskiviikko;32;13;45
623;25.05.2017;2017;05;00;Torstai;17;11;28
623;25.05.2017;2017;05;01;Torstai;15;6;21
623;25.05.2017;2017;05;02;Torstai;15;3;18
623;25.05.2017;2017;05;03;Torstai;9;1;10
623;25.05.2017;2017;05;04;Torstai;10;2;12
623;25.05.2017;2017;05;05;Torstai;8;4;12
623;25.05.2017;2017;05;06;Torstai;1;0;1
623;25.05.2017;2017;05;07;Torstai;5;15;20
623;25.05.2017;2017;05;08;Torstai;5;6;11
623;25.05.2017;2017;05;09;Torstai;10;13;23
623;25.05.2017;2017;05;10;Torstai;10;30;40
623;25.05.2017;2017;05;11;Torstai;14;27;41
623;25.05.2017;2017;05;12;Torstai;23;32;55
623;25.05.2017;2017;05;13;Torstai;24;43;67
623;25.05.2017;2017;05;14;Torstai;24;33;57
623;25.05.2017;2017;05;15;Torstai;48;42;90
623;25.05.2017;2017;05;16;Torstai;33;42;75
623;25.05.2017;2017;05;17;Torstai;41;32;73
623;25.05.2017;2017;05;18;Torstai;46;41;87
623;25.05.2017;2017;05;19;Torstai;42;36;78
623;25.05.2017;2017;05;20;Torstai;50;38;88
623;25.05.2017;2017;05;21;Torstai;32;22;54
623;25.05.2017;2017;05;22;Torstai;29;16;45
623;25.05.2017;2017;05;23;Torstai;15;9;24
623;26.05.2017;2017;05;00;Perjantai;9;6;15
623;26.05.2017;2017;05;01;Perjantai;7;4;11
623;26.05.2017;2017;05;02;Perjantai;3;0;3
623;26.05.2017;2017;05;03;Perjantai;5;1;6
623;26.05.2017;2017;05;04;Perjantai;2;3;5
623;26.05.2017;2017;05;05;Perjantai;1;3;4
623;26.05.2017;2017;05;06;Perjantai;2;9;11
623;26.05.2017;2017;05;07;Perjantai;5;32;37
623;26.05.2017;2017;05;08;Perjantai;28;64;92
623;26.05.2017;2017;05;09;Perjantai;23;81;104
623;26.05.2017;2017;05;10;Perjantai;16;50;66
623;26.05.2017;2017;05;11;Perjantai;23;34;57
623;26.05.2017;2017;05;12;Perjantai;34;52;86
623;26.05.2017;2017;05;13;Perjantai;57;51;108
623;26.05.2017;2017;05;14;Perjantai;54;53;107
623;26.05.2017;2017;05;15;Perjantai;54;39;93
623;26.05.2017;2017;05;16;Perjantai;80;39;119
623;26.05.2017;2017;05;17;Perjantai;88;43;131
623;26.05.2017;2017;05;18;Perjantai;48;41;89
623;26.05.2017;2017;05;19;Perjantai;54;43;97
623;26.05.2017;2017;05;20;Perjantai;42;37;79
623;26.05.2017;2017;05;21;Perjantai;26;36;62
623;26.05.2017;2017;05;22;Perjantai;33;21;54
623;26.05.2017;2017;05;23;Perjantai;27;19;46
623;27.05.2017;2017;05;00;Lauantai;16;5;21
623;27.05.2017;2017;05;01;Lauantai;8;7;15
623;27.05.2017;2017;05;02;Lauantai;7;6;13
623;27.05.2017;2017;05;03;Lauantai;7;3;10
623;27.05.2017;2017;05;04;Lauantai;2;2;4
623;27.05.2017;2017;05;05;Lauantai;1;3;4
623;27.05.2017;2017;05;06;Lauantai;4;4;8
623;27.05.2017;2017;05;07;Lauantai;9;7;16
623;27.05.2017;2017;05;08;Lauantai;4;4;8
623;27.05.2017;2017;05;09;Lauantai;1;12;13
623;27.05.2017;2017;05;10;Lauantai;8;20;28
623;27.05.2017;2017;05;11;Lauantai;23;43;66
623;27.05.2017;2017;05;12;Lauantai;22;50;72
623;27.05.2017;2017;05;13;Lauantai;38;40;78
623;27.05.2017;2017;05;14;Lauantai;22;36;58
623;27.05.2017;2017;05;15;Lauantai;39;37;76
623;27.05.2017;2017;05;16;Lauantai;37;37;74
623;27.05.2017;2017;05;17;Lauantai;36;23;59
623;27.05.2017;2017;05;18;Lauantai;31;19;50
623;27.05.2017;2017;05;19;Lauantai;26;28;54
623;27.05.2017;2017;05;20;Lauantai;20;6;26
623;27.05.2017;2017;05;21;Lauantai;9;20;29
623;27.05.2017;2017;05;22;Lauantai;18;9;27
623;27.05.2017;2017;05;23;Lauantai;16;16;32
623;28.05.2017;2017;05;00;Sunnuntai;7;4;11
623;28.05.2017;2017;05;01;Sunnuntai;9;6;15
623;28.05.2017;2017;05;02;Sunnuntai;13;4;17
623;28.05.2017;2017;05;03;Sunnuntai;1;3;4
623;28.05.2017;2017;05;04;Sunnuntai;12;1;13
623;28.05.2017;2017;05;05;Sunnuntai;4;1;5
623;28.05.2017;2017;05;06;Sunnuntai;0;4;4
623;28.05.2017;2017;05;07;Sunnuntai;4;6;10
623;28.05.2017;2017;05;08;Sunnuntai;1;6;7
623;28.05.2017;2017;05;09;Sunnuntai;3;5;8
623;28.05.2017;2017;05;10;Sunnuntai;6;11;17
623;28.05.2017;2017;05;11;Sunnuntai;8;14;22
623;28.05.2017;2017;05;12;Sunnuntai;9;12;21
623;28.05.2017;2017;05;13;Sunnuntai;4;5;9
623;28.05.2017;2017;05;14;Sunnuntai;9;10;19
623;28.05.2017;2017;05;15;Sunnuntai;6;8;14
623;28.05.2017;2017;05;16;Sunnuntai;14;18;32
623;28.05.2017;2017;05;17;Sunnuntai;17;20;37
623;28.05.2017;2017;05;18;Sunnuntai;16;19;35
623;28.05.2017;2017;05;19;Sunnuntai;21;19;40
623;28.05.2017;2017;05;20;Sunnuntai;9;12;21
623;28.05.2017;2017;05;21;Sunnuntai;17;8;25
623;28.05.2017;2017;05;22;Sunnuntai;15;9;24
623;28.05.2017;2017;05;23;Sunnuntai;6;6;12
623;29.05.2017;2017;05;00;Maanantai;7;1;8
623;29.05.2017;2017;05;01;Maanantai;1;2;3
623;29.05.2017;2017;05;02;Maanantai;0;0;0
623;29.05.2017;2017;05;03;Maanantai;3;1;4
623;29.05.2017;2017;05;04;Maanantai;1;3;4
623;29.05.2017;2017;05;05;Maanantai;1;2;3
623;29.05.2017;2017;05;06;Maanantai;3;12;15
623;29.05.2017;2017;05;07;Maanantai;10;51;61
623;29.05.2017;2017;05;08;Maanantai;31;108;139
623;29.05.2017;2017;05;09;Maanantai;37;115;152
623;29.05.2017;2017;05;10;Maanantai;31;66;97
623;29.05.2017;2017;05;11;Maanantai;28;37;65
623;29.05.2017;2017;05;12;Maanantai;38;46;84
623;29.05.2017;2017;05;13;Maanantai;48;55;103
623;29.05.2017;2017;05;14;Maanantai;76;36;112
623;29.05.2017;2017;05;15;Maanantai;69;46;115
623;29.05.2017;2017;05;16;Maanantai;93;49;142
623;29.05.2017;2017;05;17;Maanantai;143;67;210
623;29.05.2017;2017;05;18;Maanantai;65;55;120
623;29.05.2017;2017;05;19;Maanantai;60;47;107
623;29.05.2017;2017;05;20;Maanantai;46;26;72
623;29.05.2017;2017;05;21;Maanantai;52;25;77
623;29.05.2017;2017;05;22;Maanantai;22;12;34
623;29.05.2017;2017;05;23;Maanantai;7;8;15
623;30.05.2017;2017;05;00;Tiistai;4;2;6
623;30.05.2017;2017;05;01;Tiistai;2;1;3
623;30.05.2017;2017;05;02;Tiistai;2;3;5
623;30.05.2017;2017;05;03;Tiistai;4;3;7
623;30.05.2017;2017;05;04;Tiistai;1;2;3
623;30.05.2017;2017;05;05;Tiistai;3;3;6
623;30.05.2017;2017;05;06;Tiistai;2;8;10
623;30.05.2017;2017;05;07;Tiistai;18;62;80
623;30.05.2017;2017;05;08;Tiistai;34;123;157
623;30.05.2017;2017;05;09;Tiistai;65;137;202
623;30.05.2017;2017;05;10;Tiistai;34;56;90
623;30.05.2017;2017;05;11;Tiistai;39;41;80
623;30.05.2017;2017;05;12;Tiistai;38;48;86
623;30.05.2017;2017;05;13;Tiistai;67;58;125
623;30.05.2017;2017;05;14;Tiistai;66;42;108
623;30.05.2017;2017;05;15;Tiistai;57;48;105
623;30.05.2017;2017;05;16;Tiistai;108;77;185
623;30.05.2017;2017;05;17;Tiistai;127;76;203
623;30.05.2017;2017;05;18;Tiistai;84;52;136
623;30.05.2017;2017;05;19;Tiistai;63;47;110
623;30.05.2017;2017;05;20;Tiistai;54;37;91
623;30.05.2017;2017;05;21;Tiistai;37;20;57
623;30.05.2017;2017;05;22;Tiistai;27;15;42
623;30.05.2017;2017;05;23;Tiistai;14;7;21
623;31.05.2017;2017;05;00;Keskiviikko;9;6;15
623;31.05.2017;2017;05;01;Keskiviikko;7;0;7
623;31.05.2017;2017;05;02;Keskiviikko;3;0;3
623;31.05.2017;2017;05;03;Keskiviikko;1;2;3
623;31.05.2017;2017;05;04;Keskiviikko;1;3;4
623;31.05.2017;2017;05;05;Keskiviikko;1;1;2
623;31.05.2017;2017;05;06;Keskiviikko;0;8;8
623;31.05.2017;2017;05;07;Keskiviikko;17;46;63
623;31.05.2017;2017;05;08;Keskiviikko;29;101;130
623;31.05.2017;2017;05;09;Keskiviikko;42;130;172
623;31.05.2017;2017;05;10;Keskiviikko;18;46;64
623;31.05.2017;2017;05;11;Keskiviikko;21;19;40
623;31.05.2017;2017;05;12;Keskiviikko;41;29;70
623;31.05.2017;2017;05;13;Keskiviikko;25;41;66
623;31.05.2017;2017;05;14;Keskiviikko;45;28;73
623;31.05.2017;2017;05;15;Keskiviikko;48;34;82
623;31.05.2017;2017;05;16;Keskiviikko;65;40;105
623;31.05.2017;2017;05;17;Keskiviikko;93;46;139
623;31.05.2017;2017;05;18;Keskiviikko;61;47;108
623;31.05.2017;2017;05;19;Keskiviikko;50;28;78
623;31.05.2017;2017;05;20;Keskiviikko;28;29;57
623;31.05.2017;2017;05;21;Keskiviikko;32;18;50
623;31.05.2017;2017;05;22;Keskiviikko;15;12;27
623;31.05.2017;2017;05;23;Keskiviikko;19;18;37
623;01.06.2017;2017;06;00;Torstai;11;2;13
623;01.06.2017;2017;06;01;Torstai;3;3;6
623;01.06.2017;2017;06;02;Torstai;3;1;4
623;01.06.2017;2017;06;03;Torstai;2;2;4
623;01.06.2017;2017;06;04;Torstai;2;4;6
623;01.06.2017;2017;06;05;Torstai;1;2;3
623;01.06.2017;2017;06;06;Torstai;2;8;10
623;01.06.2017;2017;06;07;Torstai;17;47;64
623;01.06.2017;2017;06;08;Torstai;34;101;135
623;01.06.2017;2017;06;09;Torstai;53;143;196
623;01.06.2017;2017;06;10;Torstai;18;45;63
623;01.06.2017;2017;06;11;Torstai;27;34;61
623;01.06.2017;2017;06;12;Torstai;52;59;111
623;01.06.2017;2017;06;13;Torstai;34;26;60
623;01.06.2017;2017;06;14;Torstai;39;39;78
623;01.06.2017;2017;06;15;Torstai;62;27;89
623;01.06.2017;2017;06;16;Torstai;65;40;105
623;01.06.2017;2017;06;17;Torstai;93;46;139
623;01.06.2017;2017;06;18;Torstai;61;47;108
623;01.06.2017;2017;06;19;Torstai;50;28;78
623;01.06.2017;2017;06;20;Torstai;28;29;57
623;01.06.2017;2017;06;21;Torstai;32;18;50
623;01.06.2017;2017;06;22;Torstai;15;12;27
623;01.06.2017;2017;06;23;Torstai;19;18;37
623;02.06.2017;2017;06;00;Perjantai;9;6;15
623;02.06.2017;2017;06;01;Perjantai;7;0;7
623;02.06.2017;2017;06;02;Perjantai;3;0;3
623;02.06.2017;2017;06;03;Perjantai;1;2;3
623;02.06.2017;2017;06;04;Perjantai;1;3;4
623;02.06.2017;2017;06;05;Perjantai;1;1;2
623;02.06.2017;2017;06;06;Perjantai;0;8;8
623;02.06.2017;2017;06;07;Perjantai;17;46;63
623;02.06.2017;2017;06;08;Perjantai;29;101;130
623;02.06.2017;2017;06;09;Perjantai;42;130;172
623;02.06.2017;2017;06;10;Perjantai;18;46;64
623;02.06.2017;2017;06;11;Perjantai;21;19;40
623;02.06.2017;2017;06;12;Perjantai;41;29;70
623;02.06.2017;2017;06;13;Perjantai;25;41;66
623;02.06.2017;2017;06;14;Perjantai;45;28;73
623;02.06.2017;2017;06;15;Perjantai;48;34;82
623;02.06.2017;2017;06;16;Perjantai;65;40;105
623;02.06.2017;2017;06;17;Perjantai;93;46;139
623;02.06.2017;2017;06;18;Perjantai;48;28;76
623;02.06.2017;2017;06;19;Perjantai;30;28;58
623;02.06.2017;2017;06;20;Perjantai;23;15;38
623;02.06.2017;2017;06;21;Perjantai;24;20;44
623;02.06.2017;2017;06;22;Perjantai;15;18;33
623;02.06.2017;2017;06;23;Perjantai;9;9;18
623;03.06.2017;2017;06;00;Lauantai;12;3;15
623;03.06.2017;2017;06;01;Lauantai;7;8;15
623;03.06.2017;2017;06;02;Lauantai;4;4;8
623;03.06.2017;2017;06;03;Lauantai;5;2;7
623;03.06.2017;2017;06;04;Lauantai;7;1;8
623;03.06.2017;2017;06;05;Lauantai;8;1;9
623;03.06.2017;2017;06;06;Lauantai;2;6;8
623;03.06.2017;2017;06;07;Lauantai;5;12;17
623;03.06.2017;2017;06;08;Lauantai;3;12;15
623;03.06.2017;2017;06;09;Lauantai;23;46;69
623;03.06.2017;2017;06;10;Lauantai;12;27;39
623;03.06.2017;2017;06;11;Lauantai;25;12;37
623;03.06.2017;2017;06;12;Lauantai;16;28;44
623;03.06.2017;2017;06;13;Lauantai;19;21;40
623;03.06.2017;2017;06;14;Lauantai;35;28;63
623;03.06.2017;2017;06;15;Lauantai;27;23;50
623;03.06.2017;2017;06;16;Lauantai;31;19;50
623;03.06.2017;2017;06;17;Lauantai;23;27;50
623;03.06.2017;2017;06;18;Lauantai;27;40;67
623;03.06.2017;2017;06;19;Lauantai;18;23;41
623;03.06.2017;2017;06;20;Lauantai;18;29;47
623;03.06.2017;2017;06;21;Lauantai;13;26;39
623;03.06.2017;2017;06;22;Lauantai;10;13;23
623;03.06.2017;2017;06;23;Lauantai;14;10;24
623;04.06.2017;2017;06;00;Sunnuntai;11;5;16
623;04.06.2017;2017;06;01;Sunnuntai;9;9;18
623;04.06.2017;2017;06;02;Sunnuntai;13;8;21
623;04.06.2017;2017;06;03;Sunnuntai;13;3;16
623;04.06.2017;2017;06;04;Sunnuntai;12;0;12
623;04.06.2017;2017;06;05;Sunnuntai;9;1;10
623;04.06.2017;2017;06;06;Sunnuntai;2;4;6
623;04.06.2017;2017;06;07;Sunnuntai;2;8;10
623;04.06.2017;2017;06;08;Sunnuntai;4;3;7
623;04.06.2017;2017;06;09;Sunnuntai;2;3;5
623;04.06.2017;2017;06;10;Sunnuntai;8;13;21
623;04.06.2017;2017;06;11;Sunnuntai;10;17;27
623;04.06.2017;2017;06;12;Sunnuntai;18;29;47
623;04.06.2017;2017;06;13;Sunnuntai;24;31;55
623;04.06.2017;2017;06;14;Sunnuntai;32;34;66
623;04.06.2017;2017;06;15;Sunnuntai;32;28;60
623;04.06.2017;2017;06;16;Sunnuntai;50;41;91
623;04.06.2017;2017;06;17;Sunnuntai;31;33;64
623;04.06.2017;2017;06;18;Sunnuntai;34;39;73
623;04.06.2017;2017;06;19;Sunnuntai;38;37;75
623;04.06.2017;2017;06;20;Sunnuntai;18;23;41
623;04.06.2017;2017;06;21;Sunnuntai;30;20;50
623;04.06.2017;2017;06;22;Sunnuntai;19;14;33
623;04.06.2017;2017;06;23;Sunnuntai;10;10;20
623;05.06.2017;2017;06;00;Maanantai;9;2;11
623;05.06.2017;2017;06;01;Maanantai;5;2;7
623;05.06.2017;2017;06;02;Maanantai;4;1;5
623;05.06.2017;2017;06;03;Maanantai;1;3;4
623;05.06.2017;2017;06;04;Maanantai;0;2;2
623;05.06.2017;2017;06;05;Maanantai;2;3;5
623;05.06.2017;2017;06;06;Maanantai;3;9;12
623;05.06.2017;2017;06;07;Maanantai;10;38;48
623;05.06.2017;2017;06;08;Maanantai;40;110;150
623;05.06.2017;2017;06;09;Maanantai;41;90;131
623;05.06.2017;2017;06;10;Maanantai;26;59;85
623;05.06.2017;2017;06;11;Maanantai;30;40;70
623;05.06.2017;2017;06;12;Maanantai;35;51;86
623;05.06.2017;2017;06;13;Maanantai;31;46;77
623;05.06.2017;2017;06;14;Maanantai;38;41;79
623;05.06.2017;2017;06;15;Maanantai;62;40;102
623;05.06.2017;2017;06;16;Maanantai;97;55;152
623;05.06.2017;2017;06;17;Maanantai;127;85;212
623;05.06.2017;2017;06;18;Maanantai;87;56;143
623;05.06.2017;2017;06;19;Maanantai;62;37;99
623;05.06.2017;2017;06;20;Maanantai;68;41;109
623;05.06.2017;2017;06;21;Maanantai;33;20;53
623;05.06.2017;2017;06;22;Maanantai;27;21;48
623;05.06.2017;2017;06;23;Maanantai;14;6;20
623;06.06.2017;2017;06;00;Tiistai;9;4;13
623;06.06.2017;2017;06;01;Tiistai;6;1;7
623;06.06.2017;2017;06;02;Tiistai;4;2;6
623;06.06.2017;2017;06;03;Tiistai;2;1;3
623;06.06.2017;2017;06;04;Tiistai;0;1;1
623;06.06.2017;2017;06;05;Tiistai;1;3;4
623;06.06.2017;2017;06;06;Tiistai;3;3;6
623;06.06.2017;2017;06;07;Tiistai;2;42;44
623;06.06.2017;2017;06;08;Tiistai;41;87;128
623;06.06.2017;2017;06;09;Tiistai;28;63;91
623;06.06.2017;2017;06;10;Tiistai;18;32;50
623;06.06.2017;2017;06;11;Tiistai;25;23;48
623;06.06.2017;2017;06;12;Tiistai;25;27;52
623;06.06.2017;2017;06;13;Tiistai;19;32;51
623;06.06.2017;2017;06;14;Tiistai;28;32;60
623;06.06.2017;2017;06;15;Tiistai;54;43;97
623;06.06.2017;2017;06;16;Tiistai;86;51;137
623;06.06.2017;2017;06;17;Tiistai;112;76;188
623;06.06.2017;2017;06;18;Tiistai;73;58;131
623;06.06.2017;2017;06;19;Tiistai;51;47;98
623;06.06.2017;2017;06;20;Tiistai;65;44;109
623;06.06.2017;2017;06;21;Tiistai;40;41;81
623;06.06.2017;2017;06;22;Tiistai;32;21;53
623;06.06.2017;2017;06;23;Tiistai;26;10;36
623;07.06.2017;2017;06;00;Keskiviikko;4;6;10
623;07.06.2017;2017;06;01;Keskiviikko;6;5;11
623;07.06.2017;2017;06;02;Keskiviikko;4;2;6
623;07.06.2017;2017;06;03;Keskiviikko;3;2;5
623;07.06.2017;2017;06;04;Keskiviikko;1;1;2
623;07.06.2017;2017;06;05;Keskiviikko;0;4;4
623;07.06.2017;2017;06;06;Keskiviikko;6;8;14
623;07.06.2017;2017;06;07;Keskiviikko;18;53;71
623;07.06.2017;2017;06;08;Keskiviikko;53;117;170
623;07.06.2017;2017;06;09;Keskiviikko;60;100;160
623;07.06.2017;2017;06;10;Keskiviikko;30;75;105
623;07.06.2017;2017;06;11;Keskiviikko;32;49;81
623;07.06.2017;2017;06;12;Keskiviikko;48;61;109
623;07.06.2017;2017;06;13;Keskiviikko;49;61;110
623;07.06.2017;2017;06;14;Keskiviikko;61;74;135
623;07.06.2017;2017;06;15;Keskiviikko;76;75;151
623;07.06.2017;2017;06;16;Keskiviikko;123;79;202
623;07.06.2017;2017;06;17;Keskiviikko;149;99;248
623;07.06.2017;2017;06;18;Keskiviikko;85;91;176
623;07.06.2017;2017;06;19;Keskiviikko;84;71;155
623;07.06.2017;2017;06;20;Keskiviikko;90;63;153
623;07.06.2017;2017;06;21;Keskiviikko;68;52;120
623;07.06.2017;2017;06;22;Keskiviikko;56;23;79
623;07.06.2017;2017;06;23;Keskiviikko;25;14;39
623;08.06.2017;2017;06;00;Torstai;25;5;30
623;08.06.2017;2017;06;01;Torstai;9;2;11
623;08.06.2017;2017;06;02;Torstai;11;3;14
623;08.06.2017;2017;06;03;Torstai;2;2;4
623;08.06.2017;2017;06;04;Torstai;3;1;4
623;08.06.2017;2017;06;05;Torstai;4;2;6
623;08.06.2017;2017;06;06;Torstai;4;9;13
623;08.06.2017;2017;06;07;Torstai;17;48;65
623;08.06.2017;2017;06;08;Torstai;46;116;162
623;08.06.2017;2017;06;09;Torstai;51;110;161
623;08.06.2017;2017;06;10;Torstai;28;61;89
623;08.06.2017;2017;06;11;Torstai;39;50;89
623;08.06.2017;2017;06;12;Torstai;36;64;100
623;08.06.2017;2017;06;13;Torstai;44;57;101
623;08.06.2017;2017;06;14;Torstai;60;66;126
623;08.06.2017;2017;06;15;Torstai;74;78;152
623;08.06.2017;2017;06;16;Torstai;100;71;171
623;08.06.2017;2017;06;17;Torstai;143;94;237
623;08.06.2017;2017;06;18;Torstai;98;87;185
623;08.06.2017;2017;06;19;Torstai;70;62;132
623;08.06.2017;2017;06;20;Torstai;69;46;115
623;08.06.2017;2017;06;21;Torstai;61;36;97
623;08.06.2017;2017;06;22;Torstai;53;22;75
623;08.06.2017;2017;06;23;Torstai;32;16;48
623;09.06.2017;2017;06;00;Perjantai;14;9;23
623;09.06.2017;2017;06;01;Perjantai;12;1;13
623;09.06.2017;2017;06;02;Perjantai;7;2;9
623;09.06.2017;2017;06;03;Perjantai;2;1;3
623;09.06.2017;2017;06;04;Perjantai;3;1;4
623;09.06.2017;2017;06;05;Perjantai;1;2;3
623;09.06.2017;2017;06;06;Perjantai;4;8;12
623;09.06.2017;2017;06;07;Perjantai;14;53;67
623;09.06.2017;2017;06;08;Perjantai;43;96;139
623;09.06.2017;2017;06;09;Perjantai;40;84;124
623;09.06.2017;2017;06;10;Perjantai;22;58;80
623;09.06.2017;2017;06;11;Perjantai;22;52;74
623;09.06.2017;2017;06;12;Perjantai;41;58;99
623;09.06.2017;2017;06;13;Perjantai;43;59;102
623;09.06.2017;2017;06;14;Perjantai;65;52;117
623;09.06.2017;2017;06;15;Perjantai;64;72;136
623;09.06.2017;2017;06;16;Perjantai;120;74;194
623;09.06.2017;2017;06;17;Perjantai;104;76;180
623;09.06.2017;2017;06;18;Perjantai;70;68;138
623;09.06.2017;2017;06;19;Perjantai;52;66;118
623;09.06.2017;2017;06;20;Perjantai;52;40;92
623;09.06.2017;2017;06;21;Perjantai;43;50;93
623;09.06.2017;2017;06;22;Perjantai;49;31;80
623;09.06.2017;2017;06;23;Perjantai;32;29;61
623;10.06.2017;2017;06;00;Lauantai;27;6;33
623;10.06.2017;2017;06;01;Lauantai;17;6;23
623;10.06.2017;2017;06;02;Lauantai;19;3;22
623;10.06.2017;2017;06;03;Lauantai;12;4;16
623;10.06.2017;2017;06;04;Lauantai;12;3;15
623;10.06.2017;2017;06;05;Lauantai;6;4;10
623;10.06.2017;2017;06;06;Lauantai;8;1;9
623;10.06.2017;2017;06;07;Lauantai;1;10;11
623;10.06.2017;2017;06;08;Lauantai;4;7;11
623;10.06.2017;2017;06;09;Lauantai;2;14;16
623;10.06.2017;2017;06;10;Lauantai;17;28;45
623;10.06.2017;2017;06;11;Lauantai;9;27;36
623;10.06.2017;2017;06;12;Lauantai;28;44;72
623;10.06.2017;2017;06;13;Lauantai;37;49;86
623;10.06.2017;2017;06;14;Lauantai;42;59;101
623;10.06.2017;2017;06;15;Lauantai;57;58;115
623;10.06.2017;2017;06;16;Lauantai;68;61;129
623;10.06.2017;2017;06;17;Lauantai;54;51;105
623;10.06.2017;2017;06;18;Lauantai;62;62;124
623;10.06.2017;2017;06;19;Lauantai;41;44;85
623;10.06.2017;2017;06;20;Lauantai;19;30;49
623;10.06.2017;2017;06;21;Lauantai;39;40;79
623;10.06.2017;2017;06;22;Lauantai;36;22;58
623;10.06.2017;2017;06;23;Lauantai;33;18;51
623;11.06.2017;2017;06;00;Sunnuntai;22;12;34
623;11.06.2017;2017;06;01;Sunnuntai;23;10;33
623;11.06.2017;2017;06;02;Sunnuntai;16;10;26
623;11.06.2017;2017;06;03;Sunnuntai;21;3;24
623;11.06.2017;2017;06;04;Sunnuntai;11;1;12
623;11.06.2017;2017;06;05;Sunnuntai;8;2;10
623;11.06.2017;2017;06;06;Sunnuntai;3;6;9
623;11.06.2017;2017;06;07;Sunnuntai;2;12;14
623;11.06.2017;2017;06;08;Sunnuntai;4;6;10
623;11.06.2017;2017;06;09;Sunnuntai;4;6;10
623;11.06.2017;2017;06;10;Sunnuntai;15;22;37
623;11.06.2017;2017;06;11;Sunnuntai;13;24;37
623;11.06.2017;2017;06;12;Sunnuntai;26;53;79
623;11.06.2017;2017;06;13;Sunnuntai;26;49;75
623;11.06.2017;2017;06;14;Sunnuntai;61;62;123
623;11.06.2017;2017;06;15;Sunnuntai;44;50;94
623;11.06.2017;2017;06;16;Sunnuntai;53;47;100
623;11.06.2017;2017;06;17;Sunnuntai;44;54;98
623;11.06.2017;2017;06;18;Sunnuntai;50;35;85
623;11.06.2017;2017;06;19;Sunnuntai;50;46;96
623;11.06.2017;2017;06;20;Sunnuntai;41;25;66
623;11.06.2017;2017;06;21;Sunnuntai;29;28;57
623;11.06.2017;2017;06;22;Sunnuntai;29;17;46
623;11.06.2017;2017;06;23;Sunnuntai;24;9;33
623;12.06.2017;2017;06;00;Maanantai;5;2;7
623;12.06.2017;2017;06;01;Maanantai;4;1;5
623;12.06.2017;2017;06;02;Maanantai;3;0;3
623;12.06.2017;2017;06;03;Maanantai;3;2;5
623;12.06.2017;2017;06;04;Maanantai;3;0;3
623;12.06.2017;2017;06;05;Maanantai;1;1;2
623;12.06.2017;2017;06;06;Maanantai;3;10;13
623;12.06.2017;2017;06;07;Maanantai;13;38;51
623;12.06.2017;2017;06;08;Maanantai;25;104;129
623;12.06.2017;2017;06;09;Maanantai;29;84;113
623;12.06.2017;2017;06;10;Maanantai;15;28;43
623;12.06.2017;2017;06;11;Maanantai;7;20;27
623;12.06.2017;2017;06;12;Maanantai;20;21;41
623;12.06.2017;2017;06;13;Maanantai;20;41;61
623;12.06.2017;2017;06;14;Maanantai;35;40;75
623;12.06.2017;2017;06;15;Maanantai;50;36;86
623;12.06.2017;2017;06;16;Maanantai;92;45;137
623;12.06.2017;2017;06;17;Maanantai;108;58;166
623;12.06.2017;2017;06;18;Maanantai;70;61;131
623;12.06.2017;2017;06;19;Maanantai;34;32;66
623;12.06.2017;2017;06;20;Maanantai;40;27;67
623;12.06.2017;2017;06;21;Maanantai;26;24;50
623;12.06.2017;2017;06;22;Maanantai;22;11;33
623;12.06.2017;2017;06;23;Maanantai;7;8;15
623;13.06.2017;2017;06;00;Tiistai;10;5;15
623;13.06.2017;2017;06;01;Tiistai;5;1;6
623;13.06.2017;2017;06;02;Tiistai;3;1;4
623;13.06.2017;2017;06;03;Tiistai;3;0;3
623;13.06.2017;2017;06;04;Tiistai;0;1;1
623;13.06.2017;2017;06;05;Tiistai;1;3;4
623;13.06.2017;2017;06;06;Tiistai;2;8;10
623;13.06.2017;2017;06;07;Tiistai;12;51;63
623;13.06.2017;2017;06;08;Tiistai;33;104;137
623;13.06.2017;2017;06;09;Tiistai;48;97;145
623;13.06.2017;2017;06;10;Tiistai;23;47;70
623;13.06.2017;2017;06;11;Tiistai;24;48;72
623;13.06.2017;2017;06;12;Tiistai;34;39;73
623;13.06.2017;2017;06;13;Tiistai;32;48;80
623;13.06.2017;2017;06;14;Tiistai;52;33;85
623;13.06.2017;2017;06;15;Tiistai;68;58;126
623;13.06.2017;2017;06;16;Tiistai;110;74;184
623;13.06.2017;2017;06;17;Tiistai;111;82;193
623;13.06.2017;2017;06;18;Tiistai;95;76;171
623;13.06.2017;2017;06;19;Tiistai;66;46;112
623;13.06.2017;2017;06;20;Tiistai;50;20;70
623;13.06.2017;2017;06;21;Tiistai;55;25;80
623;13.06.2017;2017;06;22;Tiistai;27;12;39
623;13.06.2017;2017;06;23;Tiistai;21;6;27
623;14.06.2017;2017;06;00;Keskiviikko;9;10;19
623;14.06.2017;2017;06;01;Keskiviikko;7;4;11
623;14.06.2017;2017;06;02;Keskiviikko;7;4;11
623;14.06.2017;2017;06;03;Keskiviikko;2;0;2
623;14.06.2017;2017;06;04;Keskiviikko;0;2;2
623;14.06.2017;2017;06;05;Keskiviikko;2;1;3
623;14.06.2017;2017;06;06;Keskiviikko;3;7;10
623;14.06.2017;2017;06;07;Keskiviikko;8;44;52
623;14.06.2017;2017;06;08;Keskiviikko;40;115;155
623;14.06.2017;2017;06;09;Keskiviikko;47;92;139
623;14.06.2017;2017;06;10;Keskiviikko;25;58;83
623;14.06.2017;2017;06;11;Keskiviikko;21;42;63
623;14.06.2017;2017;06;12;Keskiviikko;39;45;84
623;14.06.2017;2017;06;13;Keskiviikko;34;57;91
623;14.06.2017;2017;06;14;Keskiviikko;43;46;89
623;14.06.2017;2017;06;15;Keskiviikko;68;57;125
623;14.06.2017;2017;06;16;Keskiviikko;108;66;174
623;14.06.2017;2017;06;17;Keskiviikko;127;77;204
623;14.06.2017;2017;06;18;Keskiviikko;73;81;154
623;14.06.2017;2017;06;19;Keskiviikko;74;56;130
623;14.06.2017;2017;06;20;Keskiviikko;58;33;91
623;14.06.2017;2017;06;21;Keskiviikko;44;28;72
623;14.06.2017;2017;06;22;Keskiviikko;40;28;68
623;14.06.2017;2017;06;23;Keskiviikko;26;12;38
623;15.06.2017;2017;06;00;Torstai;5;5;10
623;15.06.2017;2017;06;01;Torstai;8;3;11
623;15.06.2017;2017;06;02;Torstai;5;0;5
623;15.06.2017;2017;06;03;Torstai;4;4;8
623;15.06.2017;2017;06;04;Torstai;4;2;6
623;15.06.2017;2017;06;05;Torstai;1;2;3
623;15.06.2017;2017;06;06;Torstai;3;7;10
623;15.06.2017;2017;06;07;Torstai;14;45;59
623;15.06.2017;2017;06;08;Torstai;44;110;154
623;15.06.2017;2017;06;09;Torstai;60;100;160
623;15.06.2017;2017;06;10;Torstai;26;48;74
623;15.06.2017;2017;06;11;Torstai;25;48;73
623;15.06.2017;2017;06;12;Torstai;43;55;98
623;15.06.2017;2017;06;13;Torstai;52;64;116
623;15.06.2017;2017;06;14;Torstai;56;56;112
623;15.06.2017;2017;06;15;Torstai;65;66;131
623;15.06.2017;2017;06;16;Torstai;107;67;174
623;15.06.2017;2017;06;17;Torstai;128;99;227
623;15.06.2017;2017;06;18;Torstai;92;70;162
623;15.06.2017;2017;06;19;Torstai;60;65;125
623;15.06.2017;2017;06;20;Torstai;59;35;94
623;15.06.2017;2017;06;21;Torstai;52;31;83
623;15.06.2017;2017;06;22;Torstai;45;35;80
623;15.06.2017;2017;06;23;Torstai;23;11;34
623;16.06.2017;2017;06;00;Perjantai;12;3;15
623;16.06.2017;2017;06;01;Perjantai;10;1;11
623;16.06.2017;2017;06;02;Perjantai;2;1;3
623;16.06.2017;2017;06;03;Perjantai;7;0;7
623;16.06.2017;2017;06;04;Perjantai;7;4;11
623;16.06.2017;2017;06;05;Perjantai;1;2;3
623;16.06.2017;2017;06;06;Perjantai;1;8;9
623;16.06.2017;2017;06;07;Perjantai;12;50;62
623;16.06.2017;2017;06;08;Perjantai;34;86;120
623;16.06.2017;2017;06;09;Perjantai;35;77;112
623;16.06.2017;2017;06;10;Perjantai;25;60;85
623;16.06.2017;2017;06;11;Perjantai;24;46;70
623;16.06.2017;2017;06;12;Perjantai;33;57;90
623;16.06.2017;2017;06;13;Perjantai;43;53;96
623;16.06.2017;2017;06;14;Perjantai;72;54;126
623;16.06.2017;2017;06;15;Perjantai;57;51;108
623;16.06.2017;2017;06;16;Perjantai;114;75;189
623;16.06.2017;2017;06;17;Perjantai;112;88;200
623;16.06.2017;2017;06;18;Perjantai;60;57;117
623;16.06.2017;2017;06;19;Perjantai;46;40;86
623;16.06.2017;2017;06;20;Perjantai;43;53;96
623;16.06.2017;2017;06;21;Perjantai;40;44;84
623;16.06.2017;2017;06;22;Perjantai;25;38;63
623;16.06.2017;2017;06;23;Perjantai;36;16;52
623;17.06.2017;2017;06;00;Lauantai;19;4;23
623;17.06.2017;2017;06;01;Lauantai;20;6;26
623;17.06.2017;2017;06;02;Lauantai;16;5;21
623;17.06.2017;2017;06;03;Lauantai;13;6;19
623;17.06.2017;2017;06;04;Lauantai;14;0;14
623;17.06.2017;2017;06;05;Lauantai;14;3;17
623;17.06.2017;2017;06;06;Lauantai;2;7;9
623;17.06.2017;2017;06;07;Lauantai;3;10;13
623;17.06.2017;2017;06;08;Lauantai;4;9;13
623;17.06.2017;2017;06;09;Lauantai;14;16;30
623;17.06.2017;2017;06;10;Lauantai;21;35;56
623;17.06.2017;2017;06;11;Lauantai;18;41;59
623;17.06.2017;2017;06;12;Lauantai;32;73;105
623;17.06.2017;2017;06;13;Lauantai;43;73;116
623;17.06.2017;2017;06;14;Lauantai;69;68;137
623;17.06.2017;2017;06;15;Lauantai;57;61;118
623;17.06.2017;2017;06;16;Lauantai;68;64;132
623;17.06.2017;2017;06;17;Lauantai;54;60;114
623;17.06.2017;2017;06;18;Lauantai;49;59;108
623;17.06.2017;2017;06;19;Lauantai;32;35;67
623;17.06.2017;2017;06;20;Lauantai;39;36;75
623;17.06.2017;2017;06;21;Lauantai;20;31;51
623;17.06.2017;2017;06;22;Lauantai;19;19;38
623;17.06.2017;2017;06;23;Lauantai;27;20;47
623;18.06.2017;2017;06;00;Sunnuntai;34;11;45
623;18.06.2017;2017;06;01;Sunnuntai;20;8;28
623;18.06.2017;2017;06;02;Sunnuntai;14;3;17
623;18.06.2017;2017;06;03;Sunnuntai;9;4;13
623;18.06.2017;2017;06;04;Sunnuntai;9;2;11
623;18.06.2017;2017;06;05;Sunnuntai;11;3;14
623;18.06.2017;2017;06;06;Sunnuntai;5;3;8
623;18.06.2017;2017;06;07;Sunnuntai;3;7;10
623;18.06.2017;2017;06;08;Sunnuntai;4;2;6
623;18.06.2017;2017;06;09;Sunnuntai;3;2;5
623;18.06.2017;2017;06;10;Sunnuntai;6;8;14
623;18.06.2017;2017;06;11;Sunnuntai;4;6;10
623;18.06.2017;2017;06;12;Sunnuntai;8;17;25
623;18.06.2017;2017;06;13;Sunnuntai;21;21;42
623;18.06.2017;2017;06;14;Sunnuntai;21;42;63
623;18.06.2017;2017;06;15;Sunnuntai;38;55;93
623;18.06.2017;2017;06;16;Sunnuntai;33;58;91
623;18.06.2017;2017;06;17;Sunnuntai;36;30;66
623;18.06.2017;2017;06;18;Sunnuntai;31;31;62
623;18.06.2017;2017;06;19;Sunnuntai;34;27;61
623;18.06.2017;2017;06;20;Sunnuntai;22;32;54
623;18.06.2017;2017;06;21;Sunnuntai;22;11;33
623;18.06.2017;2017;06;22;Sunnuntai;19;18;37
623;18.06.2017;2017;06;23;Sunnuntai;11;3;14
623;19.06.2017;2017;06;00;Maanantai;5;7;12
623;19.06.2017;2017;06;01;Maanantai;2;0;2
623;19.06.2017;2017;06;02;Maanantai;2;1;3
623;19.06.2017;2017;06;03;Maanantai;7;4;11
623;19.06.2017;2017;06;04;Maanantai;0;1;1
623;19.06.2017;2017;06;05;Maanantai;0;1;1
623;19.06.2017;2017;06;06;Maanantai;1;11;12
623;19.06.2017;2017;06;07;Maanantai;9;46;55
623;19.06.2017;2017;06;08;Maanantai;42;106;148
623;19.06.2017;2017;06;09;Maanantai;35;88;123
623;19.06.2017;2017;06;10;Maanantai;21;53;74
623;19.06.2017;2017;06;11;Maanantai;22;33;55
623;19.06.2017;2017;06;12;Maanantai;36;46;82
623;19.06.2017;2017;06;13;Maanantai;39;46;85
623;19.06.2017;2017;06;14;Maanantai;51;43;94
623;19.06.2017;2017;06;15;Maanantai;53;36;89
623;19.06.2017;2017;06;16;Maanantai;85;43;128
623;19.06.2017;2017;06;17;Maanantai;101;78;179
623;19.06.2017;2017;06;18;Maanantai;73;62;135
623;19.06.2017;2017;06;19;Maanantai;39;27;66
623;19.06.2017;2017;06;20;Maanantai;49;31;80
623;19.06.2017;2017;06;21;Maanantai;36;32;68
623;19.06.2017;2017;06;22;Maanantai;29;23;52
623;19.06.2017;2017;06;23;Maanantai;14;5;19
623;20.06.2017;2017;06;00;Tiistai;2;0;2
623;20.06.2017;2017;06;01;Tiistai;0;0;0
623;20.06.2017;2017;06;02;Tiistai;0;0;0
623;20.06.2017;2017;06;03;Tiistai;0;0;0
623;20.06.2017;2017;06;04;Tiistai;0;0;0
623;20.06.2017;2017;06;05;Tiistai;0;0;0
623;20.06.2017;2017;06;06;Tiistai;0;0;0
623;20.06.2017;2017;06;07;Tiistai;0;0;0
623;20.06.2017;2017;06;08;Tiistai;0;0;0
623;20.06.2017;2017;06;09;Tiistai;0;0;0
623;20.06.2017;2017;06;10;Tiistai;0;3;3
623;20.06.2017;2017;06;11;Tiistai;20;41;61
623;20.06.2017;2017;06;12;Tiistai;39;52;91
623;20.06.2017;2017;06;13;Tiistai;38;41;79
623;20.06.2017;2017;06;14;Tiistai;56;58;114
623;20.06.2017;2017;06;15;Tiistai;67;66;133
623;20.06.2017;2017;06;16;Tiistai;103;70;173
623;20.06.2017;2017;06;17;Tiistai;132;94;226
623;20.06.2017;2017;06;18;Tiistai;84;67;151
623;20.06.2017;2017;06;19;Tiistai;71;56;127
623;20.06.2017;2017;06;20;Tiistai;69;45;114
623;20.06.2017;2017;06;21;Tiistai;45;25;70
623;20.06.2017;2017;06;22;Tiistai;41;20;61
623;20.06.2017;2017;06;23;Tiistai;12;19;31
623;21.06.2017;2017;06;00;Keskiviikko;10;7;17
623;21.06.2017;2017;06;01;Keskiviikko;6;5;11
623;21.06.2017;2017;06;02;Keskiviikko;10;1;11
623;21.06.2017;2017;06;03;Keskiviikko;2;3;5
623;21.06.2017;2017;06;04;Keskiviikko;5;3;8
623;21.06.2017;2017;06;05;Keskiviikko;0;1;1
623;21.06.2017;2017;06;06;Keskiviikko;4;13;17
623;21.06.2017;2017;06;07;Keskiviikko;10;46;56
623;21.06.2017;2017;06;08;Keskiviikko;33;102;135
623;21.06.2017;2017;06;09;Keskiviikko;28;80;108
623;21.06.2017;2017;06;10;Keskiviikko;25;44;69
623;21.06.2017;2017;06;11;Keskiviikko;22;30;52
623;21.06.2017;2017;06;12;Keskiviikko;39;65;104
623;21.06.2017;2017;06;13;Keskiviikko;32;40;72
623;21.06.2017;2017;06;14;Keskiviikko;31;28;59
623;21.06.2017;2017;06;15;Keskiviikko;49;38;87
623;21.06.2017;2017;06;16;Keskiviikko;67;39;106
623;21.06.2017;2017;06;17;Keskiviikko;90;54;144
623;21.06.2017;2017;06;18;Keskiviikko;54;28;82
623;21.06.2017;2017;06;19;Keskiviikko;45;19;64
623;21.06.2017;2017;06;20;Keskiviikko;29;22;51
623;21.06.2017;2017;06;21;Keskiviikko;32;24;56
623;21.06.2017;2017;06;22;Keskiviikko;21;13;34
623;21.06.2017;2017;06;23;Keskiviikko;8;11;19
623;22.06.2017;2017;06;00;Torstai;7;2;9
623;22.06.2017;2017;06;01;Torstai;3;4;7
623;22.06.2017;2017;06;02;Torstai;6;1;7
623;22.06.2017;2017;06;03;Torstai;1;3;4
623;22.06.2017;2017;06;04;Torstai;3;4;7
623;22.06.2017;2017;06;05;Torstai;2;5;7
623;22.06.2017;2017;06;06;Torstai;3;5;8
623;22.06.2017;2017;06;07;Torstai;6;36;42
623;22.06.2017;2017;06;08;Torstai;21;69;90
623;22.06.2017;2017;06;09;Torstai;22;55;77
623;22.06.2017;2017;06;10;Torstai;17;21;38
623;22.06.2017;2017;06;11;Torstai;18;27;45
623;22.06.2017;2017;06;12;Torstai;26;24;50
623;22.06.2017;2017;06;13;Torstai;24;30;54
623;22.06.2017;2017;06;14;Torstai;32;35;67
623;22.06.2017;2017;06;15;Torstai;58;30;88
623;22.06.2017;2017;06;16;Torstai;55;37;92
623;22.06.2017;2017;06;17;Torstai;46;35;81
623;22.06.2017;2017;06;18;Torstai;34;23;57
623;22.06.2017;2017;06;19;Torstai;22;21;43
623;22.06.2017;2017;06;20;Torstai;27;19;46
623;22.06.2017;2017;06;21;Torstai;23;9;32
623;22.06.2017;2017;06;22;Torstai;18;10;28
623;22.06.2017;2017;06;23;Torstai;10;3;13
623;23.06.2017;2017;06;00;Perjantai;7;2;9
623;23.06.2017;2017;06;01;Perjantai;3;2;5
623;23.06.2017;2017;06;02;Perjantai;5;1;6
623;23.06.2017;2017;06;03;Perjantai;6;2;8
623;23.06.2017;2017;06;04;Perjantai;3;2;5
623;23.06.2017;2017;06;05;Perjantai;0;2;2
623;23.06.2017;2017;06;06;Perjantai;1;3;4
623;23.06.2017;2017;06;07;Perjantai;2;4;6
623;23.06.2017;2017;06;08;Perjantai;1;8;9
623;23.06.2017;2017;06;09;Perjantai;6;9;15
623;23.06.2017;2017;06;10;Perjantai;8;9;17
623;23.06.2017;2017;06;11;Perjantai;12;18;30
623;23.06.2017;2017;06;12;Perjantai;15;19;34
623;23.06.2017;2017;06;13;Perjantai;25;27;52
623;23.06.2017;2017;06;14;Perjantai;18;17;35
623;23.06.2017;2017;06;15;Perjantai;26;15;41
623;23.06.2017;2017;06;16;Perjantai;23;25;48
623;23.06.2017;2017;06;17;Perjantai;26;14;40
623;23.06.2017;2017;06;18;Perjantai;10;11;21
623;23.06.2017;2017;06;19;Perjantai;20;16;36
623;23.06.2017;2017;06;20;Perjantai;22;16;38
623;23.06.2017;2017;06;21;Perjantai;17;22;39
623;23.06.2017;2017;06;22;Perjantai;16;16;32
623;23.06.2017;2017;06;23;Perjantai;16;14;30
623;24.06.2017;2017;06;00;Lauantai;12;3;15
623;24.06.2017;2017;06;01;Lauantai;8;12;20
623;24.06.2017;2017;06;02;Lauantai;9;8;17
623;24.06.2017;2017;06;03;Lauantai;8;8;16
623;24.06.2017;2017;06;04;Lauantai;13;4;17
623;24.06.2017;2017;06;05;Lauantai;7;5;12
623;24.06.2017;2017;06;06;Lauantai;2;1;3
623;24.06.2017;2017;06;07;Lauantai;6;9;15
623;24.06.2017;2017;06;08;Lauantai;1;0;1
623;24.06.2017;2017;06;09;Lauantai;2;7;9
623;24.06.2017;2017;06;10;Lauantai;1;7;8
623;24.06.2017;2017;06;11;Lauantai;8;13;21
623;24.06.2017;2017;06;12;Lauantai;22;20;42
623;24.06.2017;2017;06;13;Lauantai;14;28;42
623;24.06.2017;2017;06;14;Lauantai;23;33;56
623;24.06.2017;2017;06;15;Lauantai;31;30;61
623;24.06.2017;2017;06;16;Lauantai;27;24;51
623;24.06.2017;2017;06;17;Lauantai;26;20;46
623;24.06.2017;2017;06;18;Lauantai;27;33;60
623;24.06.2017;2017;06;19;Lauantai;17;28;45
623;24.06.2017;2017;06;20;Lauantai;22;19;41
623;24.06.2017;2017;06;21;Lauantai;21;17;38
623;24.06.2017;2017;06;22;Lauantai;18;20;38
623;24.06.2017;2017;06;23;Lauantai;14;9;23
623;25.06.2017;2017;06;00;Sunnuntai;9;6;15
623;25.06.2017;2017;06;01;Sunnuntai;5;4;9
623;25.06.2017;2017;06;02;Sunnuntai;7;5;12
623;25.06.2017;2017;06;03;Sunnuntai;5;6;11
623;25.06.2017;2017;06;04;Sunnuntai;7;0;7
623;25.06.2017;2017;06;05;Sunnuntai;7;3;10
623;25.06.2017;2017;06;06;Sunnuntai;1;2;3
623;25.06.2017;2017;06;07;Sunnuntai;4;8;12
623;25.06.2017;2017;06;08;Sunnuntai;2;4;6
623;25.06.2017;2017;06;09;Sunnuntai;2;9;11
623;25.06.2017;2017;06;10;Sunnuntai;6;5;11
623;25.06.2017;2017;06;11;Sunnuntai;16;15;31
623;25.06.2017;2017;06;12;Sunnuntai;10;15;25
623;25.06.2017;2017;06;13;Sunnuntai;6;12;18
623;25.06.2017;2017;06;14;Sunnuntai;10;5;15
623;25.06.2017;2017;06;15;Sunnuntai;14;9;23
623;25.06.2017;2017;06;16;Sunnuntai;15;18;33
623;25.06.2017;2017;06;17;Sunnuntai;12;14;26
623;25.06.2017;2017;06;18;Sunnuntai;10;9;19
623;25.06.2017;2017;06;19;Sunnuntai;18;12;30
623;25.06.2017;2017;06;20;Sunnuntai;9;16;25
623;25.06.2017;2017;06;21;Sunnuntai;15;17;32
623;25.06.2017;2017;06;22;Sunnuntai;14;4;18
623;25.06.2017;2017;06;23;Sunnuntai;7;6;13
623;26.06.2017;2017;06;00;Maanantai;8;2;10
623;26.06.2017;2017;06;01;Maanantai;2;1;3
623;26.06.2017;2017;06;02;Maanantai;0;2;2
623;26.06.2017;2017;06;03;Maanantai;1;2;3
623;26.06.2017;2017;06;04;Maanantai;2;1;3
623;26.06.2017;2017;06;05;Maanantai;0;1;1
623;26.06.2017;2017;06;06;Maanantai;2;7;9
623;26.06.2017;2017;06;07;Maanantai;7;28;35
623;26.06.2017;2017;06;08;Maanantai;14;55;69
623;26.06.2017;2017;06;09;Maanantai;18;72;90
623;26.06.2017;2017;06;10;Maanantai;14;29;43
623;26.06.2017;2017;06;11;Maanantai;6;15;21
623;26.06.2017;2017;06;12;Maanantai;14;20;34
623;26.06.2017;2017;06;13;Maanantai;11;8;19
623;26.06.2017;2017;06;14;Maanantai;26;34;60
623;26.06.2017;2017;06;15;Maanantai;46;34;80
623;26.06.2017;2017;06;16;Maanantai;66;34;100
623;26.06.2017;2017;06;17;Maanantai;74;61;135
623;26.06.2017;2017;06;18;Maanantai;64;55;119
623;26.06.2017;2017;06;19;Maanantai;43;31;74
623;26.06.2017;2017;06;20;Maanantai;63;37;100
623;26.06.2017;2017;06;21;Maanantai;39;34;73
623;26.06.2017;2017;06;22;Maanantai;23;15;38
623;26.06.2017;2017;06;23;Maanantai;23;15;38
623;27.06.2017;2017;06;00;Tiistai;10;4;14
623;27.06.2017;2017;06;01;Tiistai;7;3;10
623;27.06.2017;2017;06;02;Tiistai;4;3;7
623;27.06.2017;2017;06;03;Tiistai;2;2;4
623;27.06.2017;2017;06;04;Tiistai;1;1;2
623;27.06.2017;2017;06;05;Tiistai;2;1;3
623;27.06.2017;2017;06;06;Tiistai;3;8;11
623;27.06.2017;2017;06;07;Tiistai;12;45;57
623;27.06.2017;2017;06;08;Tiistai;28;97;125
623;27.06.2017;2017;06;09;Tiistai;29;65;94
623;27.06.2017;2017;06;10;Tiistai;14;57;71
623;27.06.2017;2017;06;11;Tiistai;30;40;70
623;27.06.2017;2017;06;12;Tiistai;37;43;80
623;27.06.2017;2017;06;13;Tiistai;42;56;98
623;27.06.2017;2017;06;14;Tiistai;36;46;82
623;27.06.2017;2017;06;15;Tiistai;71;61;132
623;27.06.2017;2017;06;16;Tiistai;77;47;124
623;27.06.2017;2017;06;17;Tiistai;116;66;182
623;27.06.2017;2017;06;18;Tiistai;70;53;123
623;27.06.2017;2017;06;19;Tiistai;62;36;98
623;27.06.2017;2017;06;20;Tiistai;58;30;88
623;27.06.2017;2017;06;21;Tiistai;44;37;81
623;27.06.2017;2017;06;22;Tiistai;22;26;48
623;27.06.2017;2017;06;23;Tiistai;19;14;33
623;28.06.2017;2017;06;00;Keskiviikko;12;9;21
623;28.06.2017;2017;06;01;Keskiviikko;11;3;14
623;28.06.2017;2017;06;02;Keskiviikko;6;2;8
623;28.06.2017;2017;06;03;Keskiviikko;4;1;5
623;28.06.2017;2017;06;04;Keskiviikko;1;1;2
623;28.06.2017;2017;06;05;Keskiviikko;0;1;1
623;28.06.2017;2017;06;06;Keskiviikko;4;13;17
623;28.06.2017;2017;06;07;Keskiviikko;15;51;66
623;28.06.2017;2017;06;08;Keskiviikko;16;79;95
623;28.06.2017;2017;06;09;Keskiviikko;26;71;97
623;28.06.2017;2017;06;10;Keskiviikko;14;32;46
623;28.06.2017;2017;06;11;Keskiviikko;20;24;44
623;28.06.2017;2017;06;12;Keskiviikko;23;28;51
623;28.06.2017;2017;06;13;Keskiviikko;27;27;54
623;28.06.2017;2017;06;14;Keskiviikko;32;28;60
623;28.06.2017;2017;06;15;Keskiviikko;41;21;62
623;28.06.2017;2017;06;16;Keskiviikko;63;45;108
623;28.06.2017;2017;06;17;Keskiviikko;82;48;130
623;28.06.2017;2017;06;18;Keskiviikko;52;54;106
623;28.06.2017;2017;06;19;Keskiviikko;29;36;65
623;28.06.2017;2017;06;20;Keskiviikko;53;32;85
623;28.06.2017;2017;06;21;Keskiviikko;35;23;58
623;28.06.2017;2017;06;22;Keskiviikko;23;17;40
623;28.06.2017;2017;06;23;Keskiviikko;12;10;22
623;29.06.2017;2017;06;00;Torstai;11;7;18
623;29.06.2017;2017;06;01;Torstai;18;5;23
623;29.06.2017;2017;06;02;Torstai;5;2;7
623;29.06.2017;2017;06;03;Torstai;2;0;2
623;29.06.2017;2017;06;04;Torstai;1;2;3
623;29.06.2017;2017;06;05;Torstai;2;0;2
623;29.06.2017;2017;06;06;Torstai;8;5;13
623;29.06.2017;2017;06;07;Torstai;13;52;65
623;29.06.2017;2017;06;08;Torstai;30;93;123
623;29.06.2017;2017;06;09;Torstai;32;70;102
623;29.06.2017;2017;06;10;Torstai;29;56;85
623;29.06.2017;2017;06;11;Torstai;21;36;57
623;29.06.2017;2017;06;12;Torstai;34;51;85
623;29.06.2017;2017;06;13;Torstai;66;63;129
623;29.06.2017;2017;06;14;Torstai;58;59;117
623;29.06.2017;2017;06;15;Torstai;57;45;102
623;29.06.2017;2017;06;16;Torstai;118;66;184
623;29.06.2017;2017;06;17;Torstai;100;62;162
623;29.06.2017;2017;06;18;Torstai;66;50;116
623;29.06.2017;2017;06;19;Torstai;59;56;115
623;29.06.2017;2017;06;20;Torstai;64;41;105
623;29.06.2017;2017;06;21;Torstai;59;26;85
623;29.06.2017;2017;06;22;Torstai;27;7;34
623;29.06.2017;2017;06;23;Torstai;20;12;32
623;30.06.2017;2017;06;00;Perjantai;13;8;21
623;30.06.2017;2017;06;01;Perjantai;9;3;12
623;30.06.2017;2017;06;02;Perjantai;10;3;13
623;30.06.2017;2017;06;03;Perjantai;3;3;6
623;30.06.2017;2017;06;04;Perjantai;2;3;5
623;30.06.2017;2017;06;05;Perjantai;2;4;6
623;30.06.2017;2017;06;06;Perjantai;5;7;12
623;30.06.2017;2017;06;07;Perjantai;16;34;50
623;30.06.2017;2017;06;08;Perjantai;16;81;97
623;30.06.2017;2017;06;09;Perjantai;33;69;102
623;30.06.2017;2017;06;10;Perjantai;24;54;78
623;30.06.2017;2017;06;11;Perjantai;20;51;71
623;30.06.2017;2017;06;12;Perjantai;33;60;93
623;30.06.2017;2017;06;13;Perjantai;59;48;107
623;30.06.2017;2017;06;14;Perjantai;64;71;135
623;30.06.2017;2017;06;15;Perjantai;80;51;131
623;30.06.2017;2017;06;16;Perjantai;97;55;152
623;30.06.2017;2017;06;17;Perjantai;82;58;140
623;30.06.2017;2017;06;18;Perjantai;51;41;92
623;30.06.2017;2017;06;19;Perjantai;50;48;98
623;30.06.2017;2017;06;20;Perjantai;32;39;71
623;30.06.2017;2017;06;21;Perjantai;57;48;105
623;30.06.2017;2017;06;22;Perjantai;38;30;68
623;30.06.2017;2017;06;23;Perjantai;29;19;48
623;01.07.2017;2017;07;00;Lauantai;25;12;37
623;01.07.2017;2017;07;01;Lauantai;12;5;17
623;01.07.2017;2017;07;02;Lauantai;14;6;20
623;01.07.2017;2017;07;03;Lauantai;17;6;23
623;01.07.2017;2017;07;04;Lauantai;18;2;20
623;01.07.2017;2017;07;05;Lauantai;12;3;15
623;01.07.2017;2017;07;06;Lauantai;3;10;13
623;01.07.2017;2017;07;07;Lauantai;7;7;14
623;01.07.2017;2017;07;08;Lauantai;3;5;8
623;01.07.2017;2017;07;09;Lauantai;6;18;24
623;01.07.2017;2017;07;10;Lauantai;13;39;52
623;01.07.2017;2017;07;11;Lauantai;27;43;70
623;01.07.2017;2017;07;12;Lauantai;29;62;91
623;01.07.2017;2017;07;13;Lauantai;41;75;116
623;01.07.2017;2017;07;14;Lauantai;43;56;99
623;01.07.2017;2017;07;15;Lauantai;77;73;150
623;01.07.2017;2017;07;16;Lauantai;67;64;131
623;01.07.2017;2017;07;17;Lauantai;56;58;114
623;01.07.2017;2017;07;18;Lauantai;61;44;105
623;01.07.2017;2017;07;19;Lauantai;51;47;98
623;01.07.2017;2017;07;20;Lauantai;33;38;71
623;01.07.2017;2017;07;21;Lauantai;37;52;89
623;01.07.2017;2017;07;22;Lauantai;42;25;67
623;01.07.2017;2017;07;23;Lauantai;26;10;36
623;02.07.2017;2017;07;00;Sunnuntai;28;13;41
623;02.07.2017;2017;07;01;Sunnuntai;24;7;31
623;02.07.2017;2017;07;02;Sunnuntai;25;10;35
623;02.07.2017;2017;07;03;Sunnuntai;24;5;29
623;02.07.2017;2017;07;04;Sunnuntai;11;3;14
623;02.07.2017;2017;07;05;Sunnuntai;12;4;16
623;02.07.2017;2017;07;06;Sunnuntai;3;4;7
623;02.07.2017;2017;07;07;Sunnuntai;2;12;14
623;02.07.2017;2017;07;08;Sunnuntai;3;4;7
623;02.07.2017;2017;07;09;Sunnuntai;5;5;10
623;02.07.2017;2017;07;10;Sunnuntai;4;18;22
623;02.07.2017;2017;07;11;Sunnuntai;25;24;49
623;02.07.2017;2017;07;12;Sunnuntai;22;51;73
623;02.07.2017;2017;07;13;Sunnuntai;34;56;90
623;02.07.2017;2017;07;14;Sunnuntai;41;62;103
623;02.07.2017;2017;07;15;Sunnuntai;57;60;117
623;02.07.2017;2017;07;16;Sunnuntai;54;51;105
623;02.07.2017;2017;07;17;Sunnuntai;68;64;132
623;02.07.2017;2017;07;18;Sunnuntai;64;62;126
623;02.07.2017;2017;07;19;Sunnuntai;60;54;114
623;02.07.2017;2017;07;20;Sunnuntai;55;39;94
623;02.07.2017;2017;07;21;Sunnuntai;44;38;82
623;02.07.2017;2017;07;22;Sunnuntai;43;22;65
623;02.07.2017;2017;07;23;Sunnuntai;12;7;19
623;03.07.2017;2017;07;00;Maanantai;7;8;15
623;03.07.2017;2017;07;01;Maanantai;7;4;11
623;03.07.2017;2017;07;02;Maanantai;4;0;4
623;03.07.2017;2017;07;03;Maanantai;6;2;8
623;03.07.2017;2017;07;04;Maanantai;1;1;2
623;03.07.2017;2017;07;05;Maanantai;2;2;4
623;03.07.2017;2017;07;06;Maanantai;2;6;8
623;03.07.2017;2017;07;07;Maanantai;12;33;45
623;03.07.2017;2017;07;08;Maanantai;25;81;106
623;03.07.2017;2017;07;09;Maanantai;27;68;95
623;03.07.2017;2017;07;10;Maanantai;22;53;75
623;03.07.2017;2017;07;11;Maanantai;25;49;74
623;03.07.2017;2017;07;12;Maanantai;37;61;98
623;03.07.2017;2017;07;13;Maanantai;44;64;108
623;03.07.2017;2017;07;14;Maanantai;65;56;121
623;03.07.2017;2017;07;15;Maanantai;55;58;113
623;03.07.2017;2017;07;16;Maanantai;89;59;148
623;03.07.2017;2017;07;17;Maanantai;117;57;174
623;03.07.2017;2017;07;18;Maanantai;73;71;144
623;03.07.2017;2017;07;19;Maanantai;59;41;100
623;03.07.2017;2017;07;20;Maanantai;60;37;97
623;03.07.2017;2017;07;21;Maanantai;39;25;64
623;03.07.2017;2017;07;22;Maanantai;35;12;47
623;03.07.2017;2017;07;23;Maanantai;13;11;24
623;04.07.2017;2017;07;00;Tiistai;15;3;18
623;04.07.2017;2017;07;01;Tiistai;12;1;13
623;04.07.2017;2017;07;02;Tiistai;7;5;12
623;04.07.2017;2017;07;03;Tiistai;6;2;8
623;04.07.2017;2017;07;04;Tiistai;2;2;4
623;04.07.2017;2017;07;05;Tiistai;0;1;1
623;04.07.2017;2017;07;06;Tiistai;3;12;15
623;04.07.2017;2017;07;07;Tiistai;11;36;47
623;04.07.2017;2017;07;08;Tiistai;17;50;67
623;04.07.2017;2017;07;09;Tiistai;24;62;86
623;04.07.2017;2017;07;10;Tiistai;14;50;64
623;04.07.2017;2017;07;11;Tiistai;29;37;66
623;04.07.2017;2017;07;12;Tiistai;42;54;96
623;04.07.2017;2017;07;13;Tiistai;40;39;79
623;04.07.2017;2017;07;14;Tiistai;38;19;57
623;04.07.2017;2017;07;15;Tiistai;41;27;68
623;04.07.2017;2017;07;16;Tiistai;71;41;112
623;04.07.2017;2017;07;17;Tiistai;76;57;133
623;04.07.2017;2017;07;18;Tiistai;65;55;120
623;04.07.2017;2017;07;19;Tiistai;39;30;69
623;04.07.2017;2017;07;20;Tiistai;46;23;69
623;04.07.2017;2017;07;21;Tiistai;36;25;61
623;04.07.2017;2017;07;22;Tiistai;27;18;45
623;04.07.2017;2017;07;23;Tiistai;14;10;24
623;05.07.2017;2017;07;00;Keskiviikko;8;6;14
623;05.07.2017;2017;07;01;Keskiviikko;11;3;14
623;05.07.2017;2017;07;02;Keskiviikko;3;1;4
623;05.07.2017;2017;07;03;Keskiviikko;6;2;8
623;05.07.2017;2017;07;04;Keskiviikko;3;1;4
623;05.07.2017;2017;07;05;Keskiviikko;1;1;2
623;05.07.2017;2017;07;06;Keskiviikko;4;9;13
623;05.07.2017;2017;07;07;Keskiviikko;7;38;45
623;05.07.2017;2017;07;08;Keskiviikko;20;54;74
623;05.07.2017;2017;07;09;Keskiviikko;11;55;66
623;05.07.2017;2017;07;10;Keskiviikko;17;44;61
623;05.07.2017;2017;07;11;Keskiviikko;17;30;47
623;05.07.2017;2017;07;12;Keskiviikko;26;41;67
623;05.07.2017;2017;07;13;Keskiviikko;28;33;61
623;05.07.2017;2017;07;14;Keskiviikko;44;41;85
623;05.07.2017;2017;07;15;Keskiviikko;49;41;90
623;05.07.2017;2017;07;16;Keskiviikko;70;58;128
623;05.07.2017;2017;07;17;Keskiviikko;84;51;135
623;05.07.2017;2017;07;18;Keskiviikko;48;39;87
623;05.07.2017;2017;07;19;Keskiviikko;38;25;63
623;05.07.2017;2017;07;20;Keskiviikko;42;21;63
623;05.07.2017;2017;07;21;Keskiviikko;30;21;51
623;05.07.2017;2017;07;22;Keskiviikko;33;16;49
623;05.07.2017;2017;07;23;Keskiviikko;17;8;25
623;06.07.2017;2017;07;00;Torstai;14;7;21
623;06.07.2017;2017;07;01;Torstai;4;2;6
623;06.07.2017;2017;07;02;Torstai;8;0;8
623;06.07.2017;2017;07;03;Torstai;7;6;13
623;06.07.2017;2017;07;04;Torstai;2;2;4
623;06.07.2017;2017;07;05;Torstai;1;3;4
623;06.07.2017;2017;07;06;Torstai;3;7;10
623;06.07.2017;2017;07;07;Torstai;8;37;45
623;06.07.2017;2017;07;08;Torstai;8;54;62
623;06.07.2017;2017;07;09;Torstai;12;45;57
623;06.07.2017;2017;07;10;Torstai;3;24;27
623;06.07.2017;2017;07;11;Torstai;12;15;27
623;06.07.2017;2017;07;12;Torstai;16;23;39
623;06.07.2017;2017;07;13;Torstai;24;33;57
623;06.07.2017;2017;07;14;Torstai;33;26;59
623;06.07.2017;2017;07;15;Torstai;32;37;69
623;06.07.2017;2017;07;16;Torstai;55;30;85
623;06.07.2017;2017;07;17;Torstai;64;40;104
623;06.07.2017;2017;07;18;Torstai;51;29;80
623;06.07.2017;2017;07;19;Torstai;46;31;77
623;06.07.2017;2017;07;20;Torstai;28;22;50
623;06.07.2017;2017;07;21;Torstai;34;15;49
623;06.07.2017;2017;07;22;Torstai;20;17;37
623;06.07.2017;2017;07;23;Torstai;14;9;23
623;07.07.2017;2017;07;00;Perjantai;15;4;19
623;07.07.2017;2017;07;01;Perjantai;7;3;10
623;07.07.2017;2017;07;02;Perjantai;6;5;11
623;07.07.2017;2017;07;03;Perjantai;4;4;8
623;07.07.2017;2017;07;04;Perjantai;1;1;2
623;07.07.2017;2017;07;05;Perjantai;2;0;2
623;07.07.2017;2017;07;06;Perjantai;3;9;12
623;07.07.2017;2017;07;07;Perjantai;4;29;33
623;07.07.2017;2017;07;08;Perjantai;13;57;70
623;07.07.2017;2017;07;09;Perjantai;16;53;69
623;07.07.2017;2017;07;10;Perjantai;13;44;57
623;07.07.2017;2017;07;11;Perjantai;24;51;75
623;07.07.2017;2017;07;12;Perjantai;36;55;91
623;07.07.2017;2017;07;13;Perjantai;36;47;83
623;07.07.2017;2017;07;14;Perjantai;45;48;93
623;07.07.2017;2017;07;15;Perjantai;80;60;140
623;07.07.2017;2017;07;16;Perjantai;89;65;154
623;07.07.2017;2017;07;17;Perjantai;96;65;161
623;07.07.2017;2017;07;18;Perjantai;59;48;107
623;07.07.2017;2017;07;19;Perjantai;53;60;113
623;07.07.2017;2017;07;20;Perjantai;41;39;80
623;07.07.2017;2017;07;21;Perjantai;46;55;101
623;07.07.2017;2017;07;22;Perjantai;28;30;58
623;07.07.2017;2017;07;23;Perjantai;25;19;44
623;08.07.2017;2017;07;00;Lauantai;33;13;46
623;08.07.2017;2017;07;01;Lauantai;31;6;37
623;08.07.2017;2017;07;02;Lauantai;19;10;29
623;08.07.2017;2017;07;03;Lauantai;29;2;31
623;08.07.2017;2017;07;04;Lauantai;13;3;16
623;08.07.2017;2017;07;05;Lauantai;10;1;11
623;08.07.2017;2017;07;06;Lauantai;7;8;15
623;08.07.2017;2017;07;07;Lauantai;4;9;13
623;08.07.2017;2017;07;08;Lauantai;6;8;14
623;08.07.2017;2017;07;09;Lauantai;5;11;16
623;08.07.2017;2017;07;10;Lauantai;9;26;35
623;08.07.2017;2017;07;11;Lauantai;19;36;55
623;08.07.2017;2017;07;12;Lauantai;29;62;91
623;08.07.2017;2017;07;13;Lauantai;42;78;120
623;08.07.2017;2017;07;14;Lauantai;42;74;116
623;08.07.2017;2017;07;15;Lauantai;65;54;119
623;08.07.2017;2017;07;16;Lauantai;60;58;118
623;08.07.2017;2017;07;17;Lauantai;60;56;116
623;08.07.2017;2017;07;18;Lauantai;62;40;102
623;08.07.2017;2017;07;19;Lauantai;41;60;101
623;08.07.2017;2017;07;20;Lauantai;45;51;96
623;08.07.2017;2017;07;21;Lauantai;47;43;90
623;08.07.2017;2017;07;22;Lauantai;39;25;64
623;08.07.2017;2017;07;23;Lauantai;17;17;34
623;09.07.2017;2017;07;00;Sunnuntai;19;5;24
623;09.07.2017;2017;07;01;Sunnuntai;27;20;47
623;09.07.2017;2017;07;02;Sunnuntai;16;5;21
623;09.07.2017;2017;07;03;Sunnuntai;20;4;24
623;09.07.2017;2017;07;04;Sunnuntai;12;2;14
623;09.07.2017;2017;07;05;Sunnuntai;8;2;10
623;09.07.2017;2017;07;06;Sunnuntai;8;3;11
623;09.07.2017;2017;07;07;Sunnuntai;6;10;16
623;09.07.2017;2017;07;08;Sunnuntai;1;8;9
623;09.07.2017;2017;07;09;Sunnuntai;5;6;11
623;09.07.2017;2017;07;10;Sunnuntai;6;13;19
623;09.07.2017;2017;07;11;Sunnuntai;10;27;37
623;09.07.2017;2017;07;12;Sunnuntai;20;23;43
623;09.07.2017;2017;07;13;Sunnuntai;34;57;91
623;09.07.2017;2017;07;14;Sunnuntai;43;50;93
623;09.07.2017;2017;07;15;Sunnuntai;45;60;105
623;09.07.2017;2017;07;16;Sunnuntai;53;59;112
623;09.07.2017;2017;07;17;Sunnuntai;54;53;107
623;09.07.2017;2017;07;18;Sunnuntai;56;49;105
623;09.07.2017;2017;07;19;Sunnuntai;41;36;77
623;09.07.2017;2017;07;20;Sunnuntai;52;30;82
623;09.07.2017;2017;07;21;Sunnuntai;49;33;82
623;09.07.2017;2017;07;22;Sunnuntai;31;26;57
623;09.07.2017;2017;07;23;Sunnuntai;20;11;31
623;10.07.2017;2017;07;00;Maanantai;6;8;14
623;10.07.2017;2017;07;01;Maanantai;13;4;17
623;10.07.2017;2017;07;02;Maanantai;9;7;16
623;10.07.2017;2017;07;03;Maanantai;6;2;8
623;10.07.2017;2017;07;04;Maanantai;5;1;6
623;10.07.2017;2017;07;05;Maanantai;4;3;7
623;10.07.2017;2017;07;06;Maanantai;3;8;11
623;10.07.2017;2017;07;07;Maanantai;8;43;51
623;10.07.2017;2017;07;08;Maanantai;9;54;63
623;10.07.2017;2017;07;09;Maanantai;17;67;84
623;10.07.2017;2017;07;10;Maanantai;20;77;97
623;10.07.2017;2017;07;11;Maanantai;30;58;88
623;10.07.2017;2017;07;12;Maanantai;50;78;128
623;10.07.2017;2017;07;13;Maanantai;57;63;120
623;10.07.2017;2017;07;14;Maanantai;81;63;144
623;10.07.2017;2017;07;15;Maanantai;69;61;130
623;10.07.2017;2017;07;16;Maanantai;87;50;137
623;10.07.2017;2017;07;17;Maanantai;100;58;158
623;10.07.2017;2017;07;18;Maanantai;88;51;139
623;10.07.2017;2017;07;19;Maanantai;51;39;90
623;10.07.2017;2017;07;20;Maanantai;50;26;76
623;10.07.2017;2017;07;21;Maanantai;33;30;63
623;10.07.2017;2017;07;22;Maanantai;42;15;57
623;10.07.2017;2017;07;23;Maanantai;17;9;26
623;11.07.2017;2017;07;00;Tiistai;7;8;15
623;11.07.2017;2017;07;01;Tiistai;5;1;6
623;11.07.2017;2017;07;02;Tiistai;3;1;4
623;11.07.2017;2017;07;03;Tiistai;4;1;5
623;11.07.2017;2017;07;04;Tiistai;2;1;3
623;11.07.2017;2017;07;05;Tiistai;2;2;4
623;11.07.2017;2017;07;06;Tiistai;3;11;14
623;11.07.2017;2017;07;07;Tiistai;12;36;48
623;11.07.2017;2017;07;08;Tiistai;12;64;76
623;11.07.2017;2017;07;09;Tiistai;15;58;73
623;11.07.2017;2017;07;10;Tiistai;22;56;78
623;11.07.2017;2017;07;11;Tiistai;32;46;78
623;11.07.2017;2017;07;12;Tiistai;37;63;100
623;11.07.2017;2017;07;13;Tiistai;44;72;116
623;11.07.2017;2017;07;14;Tiistai;56;56;112
623;11.07.2017;2017;07;15;Tiistai;67;54;121
623;11.07.2017;2017;07;16;Tiistai;97;63;160
623;11.07.2017;2017;07;17;Tiistai;100;50;150
623;11.07.2017;2017;07;18;Tiistai;83;60;143
623;11.07.2017;2017;07;19;Tiistai;49;56;105
623;11.07.2017;2017;07;20;Tiistai;54;41;95
623;11.07.2017;2017;07;21;Tiistai;40;25;65
623;11.07.2017;2017;07;22;Tiistai;40;20;60
623;11.07.2017;2017;07;23;Tiistai;15;9;24
623;12.07.2017;2017;07;00;Keskiviikko;11;4;15
623;12.07.2017;2017;07;01;Keskiviikko;2;1;3
623;12.07.2017;2017;07;02;Keskiviikko;5;4;9
623;12.07.2017;2017;07;03;Keskiviikko;4;2;6
623;12.07.2017;2017;07;04;Keskiviikko;0;1;1
623;12.07.2017;2017;07;05;Keskiviikko;1;0;1
623;12.07.2017;2017;07;06;Keskiviikko;3;6;9
623;12.07.2017;2017;07;07;Keskiviikko;9;39;48
623;12.07.2017;2017;07;08;Keskiviikko;9;41;50
623;12.07.2017;2017;07;09;Keskiviikko;14;42;56
623;12.07.2017;2017;07;10;Keskiviikko;8;25;33
623;12.07.2017;2017;07;11;Keskiviikko;10;21;31
623;12.07.2017;2017;07;12;Keskiviikko;21;27;48
623;12.07.2017;2017;07;13;Keskiviikko;28;26;54
623;12.07.2017;2017;07;14;Keskiviikko;24;34;58
623;12.07.2017;2017;07;15;Keskiviikko;35;19;54
623;12.07.2017;2017;07;16;Keskiviikko;56;25;81
623;12.07.2017;2017;07;17;Keskiviikko;36;21;57
623;12.07.2017;2017;07;18;Keskiviikko;29;24;53
623;12.07.2017;2017;07;19;Keskiviikko;30;30;60
623;12.07.2017;2017;07;20;Keskiviikko;26;11;37
623;12.07.2017;2017;07;21;Keskiviikko;19;8;27
623;12.07.2017;2017;07;22;Keskiviikko;16;10;26
623;12.07.2017;2017;07;23;Keskiviikko;5;11;16
623;13.07.2017;2017;07;00;Torstai;8;3;11
623;13.07.2017;2017;07;01;Torstai;6;1;7
623;13.07.2017;2017;07;02;Torstai;6;2;8
623;13.07.2017;2017;07;03;Torstai;3;5;8
623;13.07.2017;2017;07;04;Torstai;3;1;4
623;13.07.2017;2017;07;05;Torstai;2;2;4
623;13.07.2017;2017;07;06;Torstai;4;5;9
623;13.07.2017;2017;07;07;Torstai;9;35;44
623;13.07.2017;2017;07;08;Torstai;11;38;49
623;13.07.2017;2017;07;09;Torstai;10;53;63
623;13.07.2017;2017;07;10;Torstai;12;34;46
623;13.07.2017;2017;07;11;Torstai;19;33;52
623;13.07.2017;2017;07;12;Torstai;26;46;72
623;13.07.2017;2017;07;13;Torstai;25;45;70
623;13.07.2017;2017;07;14;Torstai;52;40;92
623;13.07.2017;2017;07;15;Torstai;56;59;115
623;13.07.2017;2017;07;16;Torstai;74;47;121
623;13.07.2017;2017;07;17;Torstai;74;52;126
623;13.07.2017;2017;07;18;Torstai;37;23;60
623;13.07.2017;2017;07;19;Torstai;42;31;73
623;13.07.2017;2017;07;20;Torstai;19;17;36
623;13.07.2017;2017;07;21;Torstai;30;27;57
623;13.07.2017;2017;07;22;Torstai;22;22;44
623;13.07.2017;2017;07;23;Torstai;18;11;29
623;14.07.2017;2017;07;00;Perjantai;15;11;26
623;14.07.2017;2017;07;01;Perjantai;14;5;19
623;14.07.2017;2017;07;02;Perjantai;9;3;12
623;14.07.2017;2017;07;03;Perjantai;4;2;6
623;14.07.2017;2017;07;04;Perjantai;1;2;3
623;14.07.2017;2017;07;05;Perjantai;4;0;4
623;14.07.2017;2017;07;06;Perjantai;3;6;9
623;14.07.2017;2017;07;07;Perjantai;9;30;39
623;14.07.2017;2017;07;08;Perjantai;13;33;46
623;14.07.2017;2017;07;09;Perjantai;11;27;38
623;14.07.2017;2017;07;10;Perjantai;6;18;24
623;14.07.2017;2017;07;11;Perjantai;6;6;12
623;14.07.2017;2017;07;12;Perjantai;7;9;16
623;14.07.2017;2017;07;13;Perjantai;10;11;21
623;14.07.2017;2017;07;14;Perjantai;1;2;3
623;14.07.2017;2017;07;15;Perjantai;10;15;25
623;14.07.2017;2017;07;16;Perjantai;51;35;86
623;14.07.2017;2017;07;17;Perjantai;41;37;78
623;14.07.2017;2017;07;18;Perjantai;36;39;75
623;14.07.2017;2017;07;19;Perjantai;34;39;73
623;14.07.2017;2017;07;20;Perjantai;23;45;68
623;14.07.2017;2017;07;21;Perjantai;34;34;68
623;14.07.2017;2017;07;22;Perjantai;24;21;45
623;14.07.2017;2017;07;23;Perjantai;11;22;33
623;15.07.2017;2017;07;00;Lauantai;24;10;34
623;15.07.2017;2017;07;01;Lauantai;28;9;37
623;15.07.2017;2017;07;02;Lauantai;21;12;33
623;15.07.2017;2017;07;03;Lauantai;14;3;17
623;15.07.2017;2017;07;04;Lauantai;17;4;21
623;15.07.2017;2017;07;05;Lauantai;8;3;11
623;15.07.2017;2017;07;06;Lauantai;6;3;9
623;15.07.2017;2017;07;07;Lauantai;9;7;16
623;15.07.2017;2017;07;08;Lauantai;3;12;15
623;15.07.2017;2017;07;09;Lauantai;5;13;18
623;15.07.2017;2017;07;10;Lauantai;7;21;28
623;15.07.2017;2017;07;11;Lauantai;12;32;44
623;15.07.2017;2017;07;12;Lauantai;25;43;68
623;15.07.2017;2017;07;13;Lauantai;34;62;96
623;15.07.2017;2017;07;14;Lauantai;37;53;90
623;15.07.2017;2017;07;15;Lauantai;53;58;111
623;15.07.2017;2017;07;16;Lauantai;57;66;123
623;15.07.2017;2017;07;17;Lauantai;41;65;106
623;15.07.2017;2017;07;18;Lauantai;50;43;93
623;15.07.2017;2017;07;19;Lauantai;44;47;91
623;15.07.2017;2017;07;20;Lauantai;48;34;82
623;15.07.2017;2017;07;21;Lauantai;34;35;69
623;15.07.2017;2017;07;22;Lauantai;30;25;55
623;15.07.2017;2017;07;23;Lauantai;28;22;50
623;16.07.2017;2017;07;00;Sunnuntai;28;14;42
623;16.07.2017;2017;07;01;Sunnuntai;38;13;51
623;16.07.2017;2017;07;02;Sunnuntai;28;10;38
623;16.07.2017;2017;07;03;Sunnuntai;19;3;22
623;16.07.2017;2017;07;04;Sunnuntai;18;3;21
623;16.07.2017;2017;07;05;Sunnuntai;9;0;9
623;16.07.2017;2017;07;06;Sunnuntai;3;1;4
623;16.07.2017;2017;07;07;Sunnuntai;4;7;11
623;16.07.2017;2017;07;08;Sunnuntai;2;4;6
623;16.07.2017;2017;07;09;Sunnuntai;5;7;12
623;16.07.2017;2017;07;10;Sunnuntai;13;15;28
623;16.07.2017;2017;07;11;Sunnuntai;10;26;36
623;16.07.2017;2017;07;12;Sunnuntai;29;37;66
623;16.07.2017;2017;07;13;Sunnuntai;32;70;102
623;16.07.2017;2017;07;14;Sunnuntai;40;58;98
623;16.07.2017;2017;07;15;Sunnuntai;51;64;115
623;16.07.2017;2017;07;16;Sunnuntai;53;58;111
623;16.07.2017;2017;07;17;Sunnuntai;49;58;107
623;16.07.2017;2017;07;18;Sunnuntai;59;61;120
623;16.07.2017;2017;07;19;Sunnuntai;68;47;115
623;16.07.2017;2017;07;20;Sunnuntai;48;40;88
623;16.07.2017;2017;07;21;Sunnuntai;37;29;66
623;16.07.2017;2017;07;22;Sunnuntai;32;13;45
623;16.07.2017;2017;07;23;Sunnuntai;15;7;22
623;17.07.2017;2017;07;00;Maanantai;8;7;15
623;17.07.2017;2017;07;01;Maanantai;11;7;18
623;17.07.2017;2017;07;02;Maanantai;4;1;5
623;17.07.2017;2017;07;03;Maanantai;3;3;6
623;17.07.2017;2017;07;04;Maanantai;4;1;5
623;17.07.2017;2017;07;05;Maanantai;1;2;3
623;17.07.2017;2017;07;06;Maanantai;5;13;18
623;17.07.2017;2017;07;07;Maanantai;7;28;35
623;17.07.2017;2017;07;08;Maanantai;10;50;60
623;17.07.2017;2017;07;09;Maanantai;15;50;65
623;17.07.2017;2017;07;10;Maanantai;12;45;57
623;17.07.2017;2017;07;11;Maanantai;21;51;72
623;17.07.2017;2017;07;12;Maanantai;41;52;93
623;17.07.2017;2017;07;13;Maanantai;32;49;81
623;17.07.2017;2017;07;14;Maanantai;54;42;96
623;17.07.2017;2017;07;15;Maanantai;68;36;104
623;17.07.2017;2017;07;16;Maanantai;90;40;130
623;17.07.2017;2017;07;17;Maanantai;72;48;120
623;17.07.2017;2017;07;18;Maanantai;65;71;136
623;17.07.2017;2017;07;19;Maanantai;48;34;82
623;17.07.2017;2017;07;20;Maanantai;73;51;124
623;17.07.2017;2017;07;21;Maanantai;39;18;57
623;17.07.2017;2017;07;22;Maanantai;25;16;41
623;17.07.2017;2017;07;23;Maanantai;19;11;30
623;18.07.2017;2017;07;00;Tiistai;11;10;21
623;18.07.2017;2017;07;01;Tiistai;9;4;13
623;18.07.2017;2017;07;02;Tiistai;4;3;7
623;18.07.2017;2017;07;03;Tiistai;2;3;5
623;18.07.2017;2017;07;04;Tiistai;2;3;5
623;18.07.2017;2017;07;05;Tiistai;0;2;2
623;18.07.2017;2017;07;06;Tiistai;1;6;7
623;18.07.2017;2017;07;07;Tiistai;5;28;33
623;18.07.2017;2017;07;08;Tiistai;9;22;31
623;18.07.2017;2017;07;09;Tiistai;7;30;37
623;18.07.2017;2017;07;10;Tiistai;7;10;17
623;18.07.2017;2017;07;11;Tiistai;7;9;16
623;18.07.2017;2017;07;12;Tiistai;11;21;32
623;18.07.2017;2017;07;13;Tiistai;11;16;27
623;18.07.2017;2017;07;14;Tiistai;21;19;40
623;18.07.2017;2017;07;15;Tiistai;25;31;56
623;18.07.2017;2017;07;16;Tiistai;35;25;60
623;18.07.2017;2017;07;17;Tiistai;33;29;62
623;18.07.2017;2017;07;18;Tiistai;31;21;52
623;18.07.2017;2017;07;19;Tiistai;22;22;44
623;18.07.2017;2017;07;20;Tiistai;25;12;37
623;18.07.2017;2017;07;21;Tiistai;11;15;26
623;18.07.2017;2017;07;22;Tiistai;21;9;30
623;18.07.2017;2017;07;23;Tiistai;7;2;9
623;19.07.2017;2017;07;00;Keskiviikko;5;2;7
623;19.07.2017;2017;07;01;Keskiviikko;5;0;5
623;19.07.2017;2017;07;02;Keskiviikko;1;0;1
623;19.07.2017;2017;07;03;Keskiviikko;2;3;5
623;19.07.2017;2017;07;04;Keskiviikko;2;1;3
623;19.07.2017;2017;07;05;Keskiviikko;2;3;5
623;19.07.2017;2017;07;06;Keskiviikko;2;10;12
623;19.07.2017;2017;07;07;Keskiviikko;8;31;39
623;19.07.2017;2017;07;08;Keskiviikko;11;39;50
623;19.07.2017;2017;07;09;Keskiviikko;12;52;64
623;19.07.2017;2017;07;10;Keskiviikko;13;24;37
623;19.07.2017;2017;07;11;Keskiviikko;14;27;41
623;19.07.2017;2017;07;12;Keskiviikko;31;35;66
623;19.07.2017;2017;07;13;Keskiviikko;46;56;102
623;19.07.2017;2017;07;14;Keskiviikko;50;43;93
623;19.07.2017;2017;07;15;Keskiviikko;48;27;75
623;19.07.2017;2017;07;16;Keskiviikko;60;41;101
623;19.07.2017;2017;07;17;Keskiviikko;51;44;95
623;19.07.2017;2017;07;18;Keskiviikko;44;45;89
623;19.07.2017;2017;07;19;Keskiviikko;46;53;99
623;19.07.2017;2017;07;20;Keskiviikko;39;34;73
623;19.07.2017;2017;07;21;Keskiviikko;56;25;81
623;19.07.2017;2017;07;22;Keskiviikko;47;19;66
623;19.07.2017;2017;07;23;Keskiviikko;27;12;39
623;20.07.2017;2017;07;00;Torstai;14;5;19
623;20.07.2017;2017;07;01;Torstai;4;4;8
623;20.07.2017;2017;07;02;Torstai;5;2;7
623;20.07.2017;2017;07;03;Torstai;4;1;5
623;20.07.2017;2017;07;04;Torstai;0;1;1
623;20.07.2017;2017;07;05;Torstai;1;8;9
623;20.07.2017;2017;07;06;Torstai;4;8;12
623;20.07.2017;2017;07;07;Torstai;12;41;53
623;20.07.2017;2017;07;08;Torstai;6;40;46
623;20.07.2017;2017;07;09;Torstai;12;47;59
623;20.07.2017;2017;07;10;Torstai;18;47;65
623;20.07.2017;2017;07;11;Torstai;18;33;51
623;20.07.2017;2017;07;12;Torstai;26;43;69
623;20.07.2017;2017;07;13;Torstai;31;37;68
623;20.07.2017;2017;07;14;Torstai;42;39;81
623;20.07.2017;2017;07;15;Torstai;50;36;86
623;20.07.2017;2017;07;16;Torstai;76;51;127
623;20.07.2017;2017;07;17;Torstai;79;52;131
623;20.07.2017;2017;07;18;Torstai;46;40;86
623;20.07.2017;2017;07;19;Torstai;56;36;92
623;20.07.2017;2017;07;20;Torstai;55;41;96
623;20.07.2017;2017;07;21;Torstai;44;24;68
623;20.07.2017;2017;07;22;Torstai;23;9;32
623;20.07.2017;2017;07;23;Torstai;20;17;37
623;21.07.2017;2017;07;00;Perjantai;12;5;17
623;21.07.2017;2017;07;01;Perjantai;8;1;9
623;21.07.2017;2017;07;02;Perjantai;6;2;8
623;21.07.2017;2017;07;03;Perjantai;3;1;4
623;21.07.2017;2017;07;04;Perjantai;4;4;8
623;21.07.2017;2017;07;05;Perjantai;2;3;5
623;21.07.2017;2017;07;06;Perjantai;3;11;14
623;21.07.2017;2017;07;07;Perjantai;11;32;43
623;21.07.2017;2017;07;08;Perjantai;11;34;45
623;21.07.2017;2017;07;09;Perjantai;16;37;53
623;21.07.2017;2017;07;10;Perjantai;11;37;48
623;21.07.2017;2017;07;11;Perjantai;26;35;61
623;21.07.2017;2017;07;12;Perjantai;27;33;60
623;21.07.2017;2017;07;13;Perjantai;42;41;83
623;21.07.2017;2017;07;14;Perjantai;50;47;97
623;21.07.2017;2017;07;15;Perjantai;68;52;120
623;21.07.2017;2017;07;16;Perjantai;61;31;92
623;21.07.2017;2017;07;17;Perjantai;53;40;93
623;21.07.2017;2017;07;18;Perjantai;41;40;81
623;21.07.2017;2017;07;19;Perjantai;44;33;77
623;21.07.2017;2017;07;20;Perjantai;32;37;69
623;21.07.2017;2017;07;21;Perjantai;38;23;61
623;21.07.2017;2017;07;22;Perjantai;30;18;48
623;21.07.2017;2017;07;23;Perjantai;19;4;23
623;22.07.2017;2017;07;00;Lauantai;13;17;30
623;22.07.2017;2017;07;01;Lauantai;12;6;18
623;22.07.2017;2017;07;02;Lauantai;7;2;9
623;22.07.2017;2017;07;03;Lauantai;14;3;17
623;22.07.2017;2017;07;04;Lauantai;9;5;14
623;22.07.2017;2017;07;05;Lauantai;13;1;14
623;22.07.2017;2017;07;06;Lauantai;3;3;6
623;22.07.2017;2017;07;07;Lauantai;5;17;22
623;22.07.2017;2017;07;08;Lauantai;3;7;10
623;22.07.2017;2017;07;09;Lauantai;1;12;13
623;22.07.2017;2017;07;10;Lauantai;8;21;29
623;22.07.2017;2017;07;11;Lauantai;10;31;41
623;22.07.2017;2017;07;12;Lauantai;31;35;66
623;22.07.2017;2017;07;13;Lauantai;21;44;65
623;22.07.2017;2017;07;14;Lauantai;30;35;65
623;22.07.2017;2017;07;15;Lauantai;37;29;66
623;22.07.2017;2017;07;16;Lauantai;44;38;82
623;22.07.2017;2017;07;17;Lauantai;29;39;68
623;22.07.2017;2017;07;18;Lauantai;41;40;81
623;22.07.2017;2017;07;19;Lauantai;35;39;74
623;22.07.2017;2017;07;20;Lauantai;32;31;63
623;22.07.2017;2017;07;21;Lauantai;20;30;50
623;22.07.2017;2017;07;22;Lauantai;25;25;50
623;22.07.2017;2017;07;23;Lauantai;22;18;40
623;23.07.2017;2017;07;00;Sunnuntai;16;21;37
623;23.07.2017;2017;07;01;Sunnuntai;19;9;28
623;23.07.2017;2017;07;02;Sunnuntai;15;1;16
623;23.07.2017;2017;07;03;Sunnuntai;20;5;25
623;23.07.2017;2017;07;04;Sunnuntai;9;2;11
623;23.07.2017;2017;07;05;Sunnuntai;8;3;11
623;23.07.2017;2017;07;06;Sunnuntai;2;3;5
623;23.07.2017;2017;07;07;Sunnuntai;3;12;15
623;23.07.2017;2017;07;08;Sunnuntai;4;6;10
623;23.07.2017;2017;07;09;Sunnuntai;9;12;21
623;23.07.2017;2017;07;10;Sunnuntai;13;15;28
623;23.07.2017;2017;07;11;Sunnuntai;12;20;32
623;23.07.2017;2017;07;12;Sunnuntai;16;39;55
623;23.07.2017;2017;07;13;Sunnuntai;24;30;54
623;23.07.2017;2017;07;14;Sunnuntai;36;36;72
623;23.07.2017;2017;07;15;Sunnuntai;45;33;78
623;23.07.2017;2017;07;16;Sunnuntai;35;30;65
623;23.07.2017;2017;07;17;Sunnuntai;25;15;40
623;23.07.2017;2017;07;18;Sunnuntai;27;21;48
623;23.07.2017;2017;07;19;Sunnuntai;25;19;44
623;23.07.2017;2017;07;20;Sunnuntai;23;16;39
623;23.07.2017;2017;07;21;Sunnuntai;11;13;24
623;23.07.2017;2017;07;22;Sunnuntai;18;17;35
623;23.07.2017;2017;07;23;Sunnuntai;9;14;23
623;24.07.2017;2017;07;00;Maanantai;6;5;11
623;24.07.2017;2017;07;01;Maanantai;3;5;8
623;24.07.2017;2017;07;02;Maanantai;6;4;10
623;24.07.2017;2017;07;03;Maanantai;2;3;5
623;24.07.2017;2017;07;04;Maanantai;0;3;3
623;24.07.2017;2017;07;05;Maanantai;1;4;5
623;24.07.2017;2017;07;06;Maanantai;5;10;15
623;24.07.2017;2017;07;07;Maanantai;12;41;53
623;24.07.2017;2017;07;08;Maanantai;9;48;57
623;24.07.2017;2017;07;09;Maanantai;20;54;74
623;24.07.2017;2017;07;10;Maanantai;20;41;61
623;24.07.2017;2017;07;11;Maanantai;19;45;64
623;24.07.2017;2017;07;12;Maanantai;33;52;85
623;24.07.2017;2017;07;13;Maanantai;45;68;113
623;24.07.2017;2017;07;14;Maanantai;45;43;88
623;24.07.2017;2017;07;15;Maanantai;79;46;125
623;24.07.2017;2017;07;16;Maanantai;95;68;163
623;24.07.2017;2017;07;17;Maanantai;105;52;157
623;24.07.2017;2017;07;18;Maanantai;61;44;105
623;24.07.2017;2017;07;19;Maanantai;56;44;100
623;24.07.2017;2017;07;20;Maanantai;46;39;85
623;24.07.2017;2017;07;21;Maanantai;48;34;82
623;24.07.2017;2017;07;22;Maanantai;42;18;60
623;24.07.2017;2017;07;23;Maanantai;20;9;29
623;25.07.2017;2017;07;00;Tiistai;10;6;16
623;25.07.2017;2017;07;01;Tiistai;13;2;15
623;25.07.2017;2017;07;02;Tiistai;0;2;2
623;25.07.2017;2017;07;03;Tiistai;4;3;7
623;25.07.2017;2017;07;04;Tiistai;1;1;2
623;25.07.2017;2017;07;05;Tiistai;4;2;6
623;25.07.2017;2017;07;06;Tiistai;5;6;11
623;25.07.2017;2017;07;07;Tiistai;15;43;58
623;25.07.2017;2017;07;08;Tiistai;14;60;74
623;25.07.2017;2017;07;09;Tiistai;27;65;92
623;25.07.2017;2017;07;10;Tiistai;27;54;81
623;25.07.2017;2017;07;11;Tiistai;19;40;59
623;25.07.2017;2017;07;12;Tiistai;44;70;114
623;25.07.2017;2017;07;13;Tiistai;40;69;109
623;25.07.2017;2017;07;14;Tiistai;67;59;126
623;25.07.2017;2017;07;15;Tiistai;73;52;125
623;25.07.2017;2017;07;16;Tiistai;105;78;183
623;25.07.2017;2017;07;17;Tiistai;111;68;179
623;25.07.2017;2017;07;18;Tiistai;89;73;162
623;25.07.2017;2017;07;19;Tiistai;57;48;105
623;25.07.2017;2017;07;20;Tiistai;64;47;111
623;25.07.2017;2017;07;21;Tiistai;64;44;108
623;25.07.2017;2017;07;22;Tiistai;44;23;67
623;25.07.2017;2017;07;23;Tiistai;26;13;39
623;26.07.2017;2017;07;00;Keskiviikko;19;7;26
623;26.07.2017;2017;07;01;Keskiviikko;15;5;20
623;26.07.2017;2017;07;02;Keskiviikko;11;4;15
623;26.07.2017;2017;07;03;Keskiviikko;5;1;6
623;26.07.2017;2017;07;04;Keskiviikko;3;1;4
623;26.07.2017;2017;07;05;Keskiviikko;4;2;6
623;26.07.2017;2017;07;06;Keskiviikko;3;6;9
623;26.07.2017;2017;07;07;Keskiviikko;16;42;58
623;26.07.2017;2017;07;08;Keskiviikko;10;58;68
623;26.07.2017;2017;07;09;Keskiviikko;20;50;70
623;26.07.2017;2017;07;10;Keskiviikko;12;48;60
623;26.07.2017;2017;07;11;Keskiviikko;24;38;62
623;26.07.2017;2017;07;12;Keskiviikko;37;66;103
623;26.07.2017;2017;07;13;Keskiviikko;52;74;126
623;26.07.2017;2017;07;14;Keskiviikko;58;75;133
623;26.07.2017;2017;07;15;Keskiviikko;78;64;142
623;26.07.2017;2017;07;16;Keskiviikko;121;95;216
623;26.07.2017;2017;07;17;Keskiviikko;116;71;187
623;26.07.2017;2017;07;18;Keskiviikko;106;110;216
623;26.07.2017;2017;07;19;Keskiviikko;69;64;133
623;26.07.2017;2017;07;20;Keskiviikko;83;67;150
623;26.07.2017;2017;07;21;Keskiviikko;68;43;111
623;26.07.2017;2017;07;22;Keskiviikko;65;37;102
623;26.07.2017;2017;07;23;Keskiviikko;41;13;54
623;27.07.2017;2017;07;00;Torstai;26;7;33
623;27.07.2017;2017;07;01;Torstai;23;1;24
623;27.07.2017;2017;07;02;Torstai;14;7;21
623;27.07.2017;2017;07;03;Torstai;8;3;11
623;27.07.2017;2017;07;04;Torstai;6;1;7
623;27.07.2017;2017;07;05;Torstai;7;3;10
623;27.07.2017;2017;07;06;Torstai;4;10;14
623;27.07.2017;2017;07;07;Torstai;14;51;65
623;27.07.2017;2017;07;08;Torstai;14;74;88
623;27.07.2017;2017;07;09;Torstai;22;62;84
623;27.07.2017;2017;07;10;Torstai;13;44;57
623;27.07.2017;2017;07;11;Torstai;25;49;74
623;27.07.2017;2017;07;12;Torstai;40;62;102
623;27.07.2017;2017;07;13;Torstai;56;72;128
623;27.07.2017;2017;07;14;Torstai;62;68;130
623;27.07.2017;2017;07;15;Torstai;94;84;178
623;27.07.2017;2017;07;16;Torstai;117;90;207
623;27.07.2017;2017;07;17;Torstai;141;98;239
623;27.07.2017;2017;07;18;Torstai;81;82;163
623;27.07.2017;2017;07;19;Torstai;79;56;135
623;27.07.2017;2017;07;20;Torstai;75;42;117
623;27.07.2017;2017;07;21;Torstai;61;37;98
623;27.07.2017;2017;07;22;Torstai;63;38;101
623;27.07.2017;2017;07;23;Torstai;31;16;47
623;28.07.2017;2017;07;00;Perjantai;26;8;34
623;28.07.2017;2017;07;01;Perjantai;18;4;22
623;28.07.2017;2017;07;02;Perjantai;12;8;20
623;28.07.2017;2017;07;03;Perjantai;6;4;10
623;28.07.2017;2017;07;04;Perjantai;2;2;4
623;28.07.2017;2017;07;05;Perjantai;2;2;4
623;28.07.2017;2017;07;06;Perjantai;2;10;12
623;28.07.2017;2017;07;07;Perjantai;8;38;46
623;28.07.2017;2017;07;08;Perjantai;15;60;75
623;28.07.2017;2017;07;09;Perjantai;22;43;65
623;28.07.2017;2017;07;10;Perjantai;19;55;74
623;28.07.2017;2017;07;11;Perjantai;34;59;93
623;28.07.2017;2017;07;12;Perjantai;65;80;145
623;28.07.2017;2017;07;13;Perjantai;68;76;144
623;28.07.2017;2017;07;14;Perjantai;70;78;148
623;28.07.2017;2017;07;15;Perjantai;95;94;189
623;28.07.2017;2017;07;16;Perjantai;100;92;192
623;28.07.2017;2017;07;17;Perjantai;95;103;198
623;28.07.2017;2017;07;18;Perjantai;72;86;158
623;28.07.2017;2017;07;19;Perjantai;51;67;118
623;28.07.2017;2017;07;20;Perjantai;51;77;128
623;28.07.2017;2017;07;21;Perjantai;51;56;107
623;28.07.2017;2017;07;22;Perjantai;40;34;74
623;28.07.2017;2017;07;23;Perjantai;55;33;88
623;29.07.2017;2017;07;00;Lauantai;48;13;61
623;29.07.2017;2017;07;01;Lauantai;85;9;94
623;29.07.2017;2017;07;02;Lauantai;105;22;127
623;29.07.2017;2017;07;03;Lauantai;52;3;55
623;29.07.2017;2017;07;04;Lauantai;37;3;40
623;29.07.2017;2017;07;05;Lauantai;22;6;28
623;29.07.2017;2017;07;06;Lauantai;9;4;13
623;29.07.2017;2017;07;07;Lauantai;4;7;11
623;29.07.2017;2017;07;08;Lauantai;6;8;14
623;29.07.2017;2017;07;09;Lauantai;3;11;14
623;29.07.2017;2017;07;10;Lauantai;13;22;35
623;29.07.2017;2017;07;11;Lauantai;25;36;61
623;29.07.2017;2017;07;12;Lauantai;26;32;58
623;29.07.2017;2017;07;13;Lauantai;29;45;74
623;29.07.2017;2017;07;14;Lauantai;32;66;98
623;29.07.2017;2017;07;15;Lauantai;31;76;107
623;29.07.2017;2017;07;16;Lauantai;26;33;59
623;29.07.2017;2017;07;17;Lauantai;34;63;97
623;29.07.2017;2017;07;18;Lauantai;44;56;100
623;29.07.2017;2017;07;19;Lauantai;48;60;108
623;29.07.2017;2017;07;20;Lauantai;36;48;84
623;29.07.2017;2017;07;21;Lauantai;43;60;103
623;29.07.2017;2017;07;22;Lauantai;27;31;58
623;29.07.2017;2017;07;23;Lauantai;36;40;76
623;30.07.2017;2017;07;00;Sunnuntai;33;21;54
623;30.07.2017;2017;07;01;Sunnuntai;56;13;69
623;30.07.2017;2017;07;02;Sunnuntai;104;14;118
623;30.07.2017;2017;07;03;Sunnuntai;47;3;50
623;30.07.2017;2017;07;04;Sunnuntai;30;1;31
623;30.07.2017;2017;07;05;Sunnuntai;35;1;36
623;30.07.2017;2017;07;06;Sunnuntai;11;4;15
623;30.07.2017;2017;07;07;Sunnuntai;6;7;13
623;30.07.2017;2017;07;08;Sunnuntai;6;7;13
623;30.07.2017;2017;07;09;Sunnuntai;5;6;11
623;30.07.2017;2017;07;10;Sunnuntai;13;19;32
623;30.07.2017;2017;07;11;Sunnuntai;13;21;34
623;30.07.2017;2017;07;12;Sunnuntai;40;58;98
623;30.07.2017;2017;07;13;Sunnuntai;42;69;111
623;30.07.2017;2017;07;14;Sunnuntai;40;72;112
623;30.07.2017;2017;07;15;Sunnuntai;62;52;114
623;30.07.2017;2017;07;16;Sunnuntai;61;51;112
623;30.07.2017;2017;07;17;Sunnuntai;73;58;131
623;30.07.2017;2017;07;18;Sunnuntai;64;80;144
623;30.07.2017;2017;07;19;Sunnuntai;67;73;140
623;30.07.2017;2017;07;20;Sunnuntai;42;31;73
623;30.07.2017;2017;07;21;Sunnuntai;50;33;83
623;30.07.2017;2017;07;22;Sunnuntai;39;19;58
623;30.07.2017;2017;07;23;Sunnuntai;11;14;25
623;31.07.2017;2017;07;00;Maanantai;11;11;22
623;31.07.2017;2017;07;01;Maanantai;10;4;14
623;31.07.2017;2017;07;02;Maanantai;9;2;11
623;31.07.2017;2017;07;03;Maanantai;5;3;8
623;31.07.2017;2017;07;04;Maanantai;1;2;3
623;31.07.2017;2017;07;05;Maanantai;2;0;2
623;31.07.2017;2017;07;06;Maanantai;5;12;17
623;31.07.2017;2017;07;07;Maanantai;14;51;65
623;31.07.2017;2017;07;08;Maanantai;26;80;106
623;31.07.2017;2017;07;09;Maanantai;22;52;74
623;31.07.2017;2017;07;10;Maanantai;17;51;68
623;31.07.2017;2017;07;11;Maanantai;21;35;56
623;31.07.2017;2017;07;12;Maanantai;32;46;78
623;31.07.2017;2017;07;13;Maanantai;43;56;99
623;31.07.2017;2017;07;14;Maanantai;42;59;101
623;31.07.2017;2017;07;15;Maanantai;66;64;130
623;31.07.2017;2017;07;16;Maanantai;90;77;167
623;31.07.2017;2017;07;17;Maanantai;123;91;214
623;31.07.2017;2017;07;18;Maanantai;102;89;191
623;31.07.2017;2017;07;19;Maanantai;68;57;125
623;31.07.2017;2017;07;20;Maanantai;65;37;102
623;31.07.2017;2017;07;21;Maanantai;46;26;72
623;31.07.2017;2017;07;22;Maanantai;37;23;60
623;31.07.2017;2017;07;23;Maanantai;18;7;25
623;01.08.2017;2017;08;00;Tiistai;18;7;25
623;01.08.2017;2017;08;01;Tiistai;7;2;9
623;01.08.2017;2017;08;02;Tiistai;6;1;7
623;01.08.2017;2017;08;03;Tiistai;4;2;6
623;01.08.2017;2017;08;04;Tiistai;1;1;2
623;01.08.2017;2017;08;05;Tiistai;2;1;3
623;01.08.2017;2017;08;06;Tiistai;5;13;18
623;01.08.2017;2017;08;07;Tiistai;12;43;55
623;01.08.2017;2017;08;08;Tiistai;22;80;102
623;01.08.2017;2017;08;09;Tiistai;28;64;92
623;01.08.2017;2017;08;10;Tiistai;23;51;74
623;01.08.2017;2017;08;11;Tiistai;27;52;79
623;01.08.2017;2017;08;12;Tiistai;40;59;99
623;01.08.2017;2017;08;13;Tiistai;41;56;97
623;01.08.2017;2017;08;14;Tiistai;57;67;124
623;01.08.2017;2017;08;15;Tiistai;50;45;95
623;01.08.2017;2017;08;16;Tiistai;106;74;180
623;01.08.2017;2017;08;17;Tiistai;154;84;238
623;01.08.2017;2017;08;18;Tiistai;92;72;164
623;01.08.2017;2017;08;19;Tiistai;88;91;179
623;01.08.2017;2017;08;20;Tiistai;76;52;128
623;01.08.2017;2017;08;21;Tiistai;70;40;110
623;01.08.2017;2017;08;22;Tiistai;47;22;69
623;01.08.2017;2017;08;23;Tiistai;15;11;26
623;02.08.2017;2017;08;00;Keskiviikko;15;3;18
623;02.08.2017;2017;08;01;Keskiviikko;4;2;6
623;02.08.2017;2017;08;02;Keskiviikko;7;3;10
623;02.08.2017;2017;08;03;Keskiviikko;7;3;10
623;02.08.2017;2017;08;04;Keskiviikko;2;0;2
623;02.08.2017;2017;08;05;Keskiviikko;3;3;6
623;02.08.2017;2017;08;06;Keskiviikko;4;12;16
623;02.08.2017;2017;08;07;Keskiviikko;14;60;74
623;02.08.2017;2017;08;08;Keskiviikko;33;106;139
623;02.08.2017;2017;08;09;Keskiviikko;30;70;100
623;02.08.2017;2017;08;10;Keskiviikko;29;58;87
623;02.08.2017;2017;08;11;Keskiviikko;25;46;71
623;02.08.2017;2017;08;12;Keskiviikko;34;42;76
623;02.08.2017;2017;08;13;Keskiviikko;34;62;96
623;02.08.2017;2017;08;14;Keskiviikko;57;79;136
623;02.08.2017;2017;08;15;Keskiviikko;69;47;116
623;02.08.2017;2017;08;16;Keskiviikko;111;66;177
623;02.08.2017;2017;08;17;Keskiviikko;135;88;223
623;02.08.2017;2017;08;18;Keskiviikko;94;69;163
623;02.08.2017;2017;08;19;Keskiviikko;72;52;124
623;02.08.2017;2017;08;20;Keskiviikko;54;40;94
623;02.08.2017;2017;08;21;Keskiviikko;42;29;71
623;02.08.2017;2017;08;22;Keskiviikko;46;18;64
623;02.08.2017;2017;08;23;Keskiviikko;21;8;29
623;03.08.2017;2017;08;00;Torstai;20;8;28
623;03.08.2017;2017;08;01;Torstai;6;1;7
623;03.08.2017;2017;08;02;Torstai;1;4;5
623;03.08.2017;2017;08;03;Torstai;6;1;7
623;03.08.2017;2017;08;04;Torstai;4;3;7
623;03.08.2017;2017;08;05;Torstai;0;3;3
623;03.08.2017;2017;08;06;Torstai;2;8;10
623;03.08.2017;2017;08;07;Torstai;15;41;56
623;03.08.2017;2017;08;08;Torstai;20;83;103
623;03.08.2017;2017;08;09;Torstai;18;57;75
623;03.08.2017;2017;08;10;Torstai;27;59;86
623;03.08.2017;2017;08;11;Torstai;19;41;60
623;03.08.2017;2017;08;12;Torstai;33;50;83
623;03.08.2017;2017;08;13;Torstai;33;47;80
623;03.08.2017;2017;08;14;Torstai;46;47;93
623;03.08.2017;2017;08;15;Torstai;60;43;103
623;03.08.2017;2017;08;16;Torstai;98;57;155
623;03.08.2017;2017;08;17;Torstai;115;67;182
623;03.08.2017;2017;08;18;Torstai;89;69;158
623;03.08.2017;2017;08;19;Torstai;66;54;120
623;03.08.2017;2017;08;20;Torstai;69;50;119
623;03.08.2017;2017;08;21;Torstai;64;34;98
623;03.08.2017;2017;08;22;Torstai;30;30;60
623;03.08.2017;2017;08;23;Torstai;22;12;34
623;04.08.2017;2017;08;00;Perjantai;17;9;26
623;04.08.2017;2017;08;01;Perjantai;10;3;13
623;04.08.2017;2017;08;02;Perjantai;6;0;6
623;04.08.2017;2017;08;03;Perjantai;4;5;9
623;04.08.2017;2017;08;04;Perjantai;4;1;5
623;04.08.2017;2017;08;05;Perjantai;0;2;2
623;04.08.2017;2017;08;06;Perjantai;2;14;16
623;04.08.2017;2017;08;07;Perjantai;13;38;51
623;04.08.2017;2017;08;08;Perjantai;27;91;118
623;04.08.2017;2017;08;09;Perjantai;26;65;91
623;04.08.2017;2017;08;10;Perjantai;21;64;85
623;04.08.2017;2017;08;11;Perjantai;23;45;68
623;04.08.2017;2017;08;12;Perjantai;46;47;93
623;04.08.2017;2017;08;13;Perjantai;44;56;100
623;04.08.2017;2017;08;14;Perjantai;60;56;116
623;04.08.2017;2017;08;15;Perjantai;81;59;140
623;04.08.2017;2017;08;16;Perjantai;94;79;173
623;04.08.2017;2017;08;17;Perjantai;105;82;187
623;04.08.2017;2017;08;18;Perjantai;74;67;141
623;04.08.2017;2017;08;19;Perjantai;52;51;103
623;04.08.2017;2017;08;20;Perjantai;48;52;100
623;04.08.2017;2017;08;21;Perjantai;40;39;79
623;04.08.2017;2017;08;22;Perjantai;33;24;57
623;04.08.2017;2017;08;23;Perjantai;27;23;50
623;05.08.2017;2017;08;00;Lauantai;49;17;66
623;05.08.2017;2017;08;01;Lauantai;31;11;42
623;05.08.2017;2017;08;02;Lauantai;26;10;36
623;05.08.2017;2017;08;03;Lauantai;13;3;16
623;05.08.2017;2017;08;04;Lauantai;13;2;15
623;05.08.2017;2017;08;05;Lauantai;13;3;16
623;05.08.2017;2017;08;06;Lauantai;5;3;8
623;05.08.2017;2017;08;07;Lauantai;3;8;11
623;05.08.2017;2017;08;08;Lauantai;7;13;20
623;05.08.2017;2017;08;09;Lauantai;2;14;16
623;05.08.2017;2017;08;10;Lauantai;7;20;27
623;05.08.2017;2017;08;11;Lauantai;13;25;38
623;05.08.2017;2017;08;12;Lauantai;23;29;52
623;05.08.2017;2017;08;13;Lauantai;22;31;53
623;05.08.2017;2017;08;14;Lauantai;22;43;65
623;05.08.2017;2017;08;15;Lauantai;24;40;64
623;05.08.2017;2017;08;16;Lauantai;41;37;78
623;05.08.2017;2017;08;17;Lauantai;28;48;76
623;05.08.2017;2017;08;18;Lauantai;41;34;75
623;05.08.2017;2017;08;19;Lauantai;40;43;83
623;05.08.2017;2017;08;20;Lauantai;35;32;67
623;05.08.2017;2017;08;21;Lauantai;24;27;51
623;05.08.2017;2017;08;22;Lauantai;22;30;52
623;05.08.2017;2017;08;23;Lauantai;25;20;45
623;06.08.2017;2017;08;00;Sunnuntai;17;9;26
623;06.08.2017;2017;08;01;Sunnuntai;45;21;66
623;06.08.2017;2017;08;02;Sunnuntai;13;12;25
623;06.08.2017;2017;08;03;Sunnuntai;13;3;16
623;06.08.2017;2017;08;04;Sunnuntai;12;7;19
623;06.08.2017;2017;08;05;Sunnuntai;15;3;18
623;06.08.2017;2017;08;06;Sunnuntai;6;3;9
623;06.08.2017;2017;08;07;Sunnuntai;5;9;14
623;06.08.2017;2017;08;08;Sunnuntai;2;3;5
623;06.08.2017;2017;08;09;Sunnuntai;3;5;8
623;06.08.2017;2017;08;10;Sunnuntai;10;11;21
623;06.08.2017;2017;08;11;Sunnuntai;14;29;43
623;06.08.2017;2017;08;12;Sunnuntai;17;26;43
623;06.08.2017;2017;08;13;Sunnuntai;18;24;42
623;06.08.2017;2017;08;14;Sunnuntai;35;44;79
623;06.08.2017;2017;08;15;Sunnuntai;24;28;52
623;06.08.2017;2017;08;16;Sunnuntai;41;29;70
623;06.08.2017;2017;08;17;Sunnuntai;46;30;76
623;06.08.2017;2017;08;18;Sunnuntai;24;36;60
623;06.08.2017;2017;08;19;Sunnuntai;39;38;77
623;06.08.2017;2017;08;20;Sunnuntai;30;20;50
623;06.08.2017;2017;08;21;Sunnuntai;21;20;41
623;06.08.2017;2017;08;22;Sunnuntai;20;11;31
623;06.08.2017;2017;08;23;Sunnuntai;7;5;12
623;07.08.2017;2017;08;00;Maanantai;8;5;13
623;07.08.2017;2017;08;01;Maanantai;5;1;6
623;07.08.2017;2017;08;02;Maanantai;1;2;3
623;07.08.2017;2017;08;03;Maanantai;1;4;5
623;07.08.2017;2017;08;04;Maanantai;1;1;2
623;07.08.2017;2017;08;05;Maanantai;5;4;9
623;07.08.2017;2017;08;06;Maanantai;2;9;11
623;07.08.2017;2017;08;07;Maanantai;17;48;65
623;07.08.2017;2017;08;08;Maanantai;45;129;174
623;07.08.2017;2017;08;09;Maanantai;55;99;154
623;07.08.2017;2017;08;10;Maanantai;25;56;81
623;07.08.2017;2017;08;11;Maanantai;30;40;70
623;07.08.2017;2017;08;12;Maanantai;32;54;86
623;07.08.2017;2017;08;13;Maanantai;46;58;104
623;07.08.2017;2017;08;14;Maanantai;46;51;97
623;07.08.2017;2017;08;15;Maanantai;70;36;106
623;07.08.2017;2017;08;16;Maanantai;99;65;164
623;07.08.2017;2017;08;17;Maanantai;116;64;180
623;07.08.2017;2017;08;18;Maanantai;85;62;147
623;07.08.2017;2017;08;19;Maanantai;64;37;101
623;07.08.2017;2017;08;20;Maanantai;51;35;86
623;07.08.2017;2017;08;21;Maanantai;37;33;70
623;07.08.2017;2017;08;22;Maanantai;26;13;39
623;07.08.2017;2017;08;23;Maanantai;19;7;26
623;08.08.2017;2017;08;00;Tiistai;14;6;20
623;08.08.2017;2017;08;01;Tiistai;10;2;12
623;08.08.2017;2017;08;02;Tiistai;5;2;7
623;08.08.2017;2017;08;03;Tiistai;5;2;7
623;08.08.2017;2017;08;04;Tiistai;0;1;1
623;08.08.2017;2017;08;05;Tiistai;3;6;9
623;08.08.2017;2017;08;06;Tiistai;3;12;15
623;08.08.2017;2017;08;07;Tiistai;14;51;65
623;08.08.2017;2017;08;08;Tiistai;36;120;156
623;08.08.2017;2017;08;09;Tiistai;45;103;148
623;08.08.2017;2017;08;10;Tiistai;30;61;91
623;08.08.2017;2017;08;11;Tiistai;26;54;80
623;08.08.2017;2017;08;12;Tiistai;30;45;75
623;08.08.2017;2017;08;13;Tiistai;41;50;91
623;08.08.2017;2017;08;14;Tiistai;47;73;120
623;08.08.2017;2017;08;15;Tiistai;86;48;134
623;08.08.2017;2017;08;16;Tiistai;122;61;183
623;08.08.2017;2017;08;17;Tiistai;155;94;249
623;08.08.2017;2017;08;18;Tiistai;106;65;171
623;08.08.2017;2017;08;19;Tiistai;59;40;99
623;08.08.2017;2017;08;20;Tiistai;50;33;83
623;08.08.2017;2017;08;21;Tiistai;45;25;70
623;08.08.2017;2017;08;22;Tiistai;33;16;49
623;08.08.2017;2017;08;23;Tiistai;21;7;28
623;09.08.2017;2017;08;00;Keskiviikko;11;5;16
623;09.08.2017;2017;08;01;Keskiviikko;3;3;6
623;09.08.2017;2017;08;02;Keskiviikko;2;1;3
623;09.08.2017;2017;08;03;Keskiviikko;3;2;5
623;09.08.2017;2017;08;04;Keskiviikko;1;4;5
623;09.08.2017;2017;08;05;Keskiviikko;2;4;6
623;09.08.2017;2017;08;06;Keskiviikko;3;9;12
623;09.08.2017;2017;08;07;Keskiviikko;11;53;64
623;09.08.2017;2017;08;08;Keskiviikko;47;113;160
623;09.08.2017;2017;08;09;Keskiviikko;57;101;158
623;09.08.2017;2017;08;10;Keskiviikko;29;55;84
623;09.08.2017;2017;08;11;Keskiviikko;24;36;60
623;09.08.2017;2017;08;12;Keskiviikko;40;51;91
623;09.08.2017;2017;08;13;Keskiviikko;42;48;90
623;09.08.2017;2017;08;14;Keskiviikko;58;61;119
623;09.08.2017;2017;08;15;Keskiviikko;83;57;140
623;09.08.2017;2017;08;16;Keskiviikko;94;84;178
623;09.08.2017;2017;08;17;Keskiviikko;174;101;275
623;09.08.2017;2017;08;18;Keskiviikko;87;72;159
623;09.08.2017;2017;08;19;Keskiviikko;76;64;140
623;09.08.2017;2017;08;20;Keskiviikko;63;39;102
623;09.08.2017;2017;08;21;Keskiviikko;57;47;104
623;09.08.2017;2017;08;22;Keskiviikko;47;21;68
623;09.08.2017;2017;08;23;Keskiviikko;24;9;33
623;10.08.2017;2017;08;00;Torstai;13;7;20
623;10.08.2017;2017;08;01;Torstai;7;2;9
623;10.08.2017;2017;08;02;Torstai;5;3;8
623;10.08.2017;2017;08;03;Torstai;4;2;6
623;10.08.2017;2017;08;04;Torstai;2;4;6
623;10.08.2017;2017;08;05;Torstai;3;3;6
623;10.08.2017;2017;08;06;Torstai;3;14;17
623;10.08.2017;2017;08;07;Torstai;9;46;55
623;10.08.2017;2017;08;08;Torstai;42;92;134
623;10.08.2017;2017;08;09;Torstai;55;116;171
623;10.08.2017;2017;08;10;Torstai;39;80;119
623;10.08.2017;2017;08;11;Torstai;36;51;87
623;10.08.2017;2017;08;12;Torstai;51;32;83
623;10.08.2017;2017;08;13;Torstai;43;17;60
623;10.08.2017;2017;08;14;Torstai;31;14;45
623;10.08.2017;2017;08;15;Torstai;51;32;83
623;10.08.2017;2017;08;16;Torstai;62;28;90
623;10.08.2017;2017;08;17;Torstai;89;54;143
623;10.08.2017;2017;08;18;Torstai;40;30;70
623;10.08.2017;2017;08;19;Torstai;47;28;75
623;10.08.2017;2017;08;20;Torstai;35;24;59
623;10.08.2017;2017;08;21;Torstai;40;17;57
623;10.08.2017;2017;08;22;Torstai;23;13;36
623;10.08.2017;2017;08;23;Torstai;11;3;14
623;11.08.2017;2017;08;00;Perjantai;7;2;9
623;11.08.2017;2017;08;01;Perjantai;2;4;6
623;11.08.2017;2017;08;02;Perjantai;3;2;5
623;11.08.2017;2017;08;03;Perjantai;3;2;5
623;11.08.2017;2017;08;04;Perjantai;2;2;4
623;11.08.2017;2017;08;05;Perjantai;2;3;5
623;11.08.2017;2017;08;06;Perjantai;3;10;13
623;11.08.2017;2017;08;07;Perjantai;9;43;52
623;11.08.2017;2017;08;08;Perjantai;40;103;143
623;11.08.2017;2017;08;09;Perjantai;68;159;227
623;11.08.2017;2017;08;10;Perjantai;52;100;152
623;11.08.2017;2017;08;11;Perjantai;39;40;79
623;11.08.2017;2017;08;12;Perjantai;53;54;107
623;11.08.2017;2017;08;13;Perjantai;60;54;114
623;11.08.2017;2017;08;14;Perjantai;67;47;114
623;11.08.2017;2017;08;15;Perjantai;95;49;144
623;11.08.2017;2017;08;16;Perjantai;108;53;161
623;11.08.2017;2017;08;17;Perjantai;117;77;194
623;11.08.2017;2017;08;18;Perjantai;71;64;135
623;11.08.2017;2017;08;19;Perjantai;50;47;97
623;11.08.2017;2017;08;20;Perjantai;46;33;79
623;11.08.2017;2017;08;21;Perjantai;32;25;57
623;11.08.2017;2017;08;22;Perjantai;44;24;68
623;11.08.2017;2017;08;23;Perjantai;29;18;47
623;12.08.2017;2017;08;00;Lauantai;13;12;25
623;12.08.2017;2017;08;01;Lauantai;14;8;22
623;12.08.2017;2017;08;02;Lauantai;11;5;16
623;12.08.2017;2017;08;03;Lauantai;9;2;11
623;12.08.2017;2017;08;04;Lauantai;14;1;15
623;12.08.2017;2017;08;05;Lauantai;9;1;10
623;12.08.2017;2017;08;06;Lauantai;1;4;5
623;12.08.2017;2017;08;07;Lauantai;9;12;21
623;12.08.2017;2017;08;08;Lauantai;3;5;8
623;12.08.2017;2017;08;09;Lauantai;8;21;29
623;12.08.2017;2017;08;10;Lauantai;15;32;47
623;12.08.2017;2017;08;11;Lauantai;21;39;60
623;12.08.2017;2017;08;12;Lauantai;28;59;87
623;12.08.2017;2017;08;13;Lauantai;54;74;128
623;12.08.2017;2017;08;14;Lauantai;52;63;115
623;12.08.2017;2017;08;15;Lauantai;52;52;104
623;12.08.2017;2017;08;16;Lauantai;67;57;124
623;12.08.2017;2017;08;17;Lauantai;71;47;118
623;12.08.2017;2017;08;18;Lauantai;54;43;97
623;12.08.2017;2017;08;19;Lauantai;36;33;69
623;12.08.2017;2017;08;20;Lauantai;38;24;62
623;12.08.2017;2017;08;21;Lauantai;23;30;53
623;12.08.2017;2017;08;22;Lauantai;43;17;60
623;12.08.2017;2017;08;23;Lauantai;17;11;28
623;13.08.2017;2017;08;00;Sunnuntai;12;8;20
623;13.08.2017;2017;08;01;Sunnuntai;10;7;17
623;13.08.2017;2017;08;02;Sunnuntai;15;4;19
623;13.08.2017;2017;08;03;Sunnuntai;15;5;20
623;13.08.2017;2017;08;04;Sunnuntai;13;3;16
623;13.08.2017;2017;08;05;Sunnuntai;9;3;12
623;13.08.2017;2017;08;06;Sunnuntai;5;1;6
623;13.08.2017;2017;08;07;Sunnuntai;2;11;13
623;13.08.2017;2017;08;08;Sunnuntai;1;3;4
623;13.08.2017;2017;08;09;Sunnuntai;2;5;7
623;13.08.2017;2017;08;10;Sunnuntai;3;9;12
623;13.08.2017;2017;08;11;Sunnuntai;10;20;30
623;13.08.2017;2017;08;12;Sunnuntai;15;20;35
623;13.08.2017;2017;08;13;Sunnuntai;16;14;30
623;13.08.2017;2017;08;14;Sunnuntai;14;12;26
623;13.08.2017;2017;08;15;Sunnuntai;14;30;44
623;13.08.2017;2017;08;16;Sunnuntai;25;28;53
623;13.08.2017;2017;08;17;Sunnuntai;17;15;32
623;13.08.2017;2017;08;18;Sunnuntai;14;9;23
623;13.08.2017;2017;08;19;Sunnuntai;20;26;46
623;13.08.2017;2017;08;20;Sunnuntai;27;18;45
623;13.08.2017;2017;08;21;Sunnuntai;21;15;36
623;13.08.2017;2017;08;22;Sunnuntai;20;14;34
623;13.08.2017;2017;08;23;Sunnuntai;8;5;13
623;14.08.2017;2017;08;00;Maanantai;9;4;13
623;14.08.2017;2017;08;01;Maanantai;3;2;5
623;14.08.2017;2017;08;02;Maanantai;0;1;1
623;14.08.2017;2017;08;03;Maanantai;1;1;2
623;14.08.2017;2017;08;04;Maanantai;0;2;2
623;14.08.2017;2017;08;05;Maanantai;3;6;9
623;14.08.2017;2017;08;06;Maanantai;2;10;12
623;14.08.2017;2017;08;07;Maanantai;8;62;70
623;14.08.2017;2017;08;08;Maanantai;51;136;187
623;14.08.2017;2017;08;09;Maanantai;63;140;203
623;14.08.2017;2017;08;10;Maanantai;46;111;157
623;14.08.2017;2017;08;11;Maanantai;28;35;63
623;14.08.2017;2017;08;12;Maanantai;38;41;79
623;14.08.2017;2017;08;13;Maanantai;56;58;114
623;14.08.2017;2017;08;14;Maanantai;48;49;97
623;14.08.2017;2017;08;15;Maanantai;109;47;156
623;14.08.2017;2017;08;16;Maanantai;131;53;184
623;14.08.2017;2017;08;17;Maanantai;143;68;211
623;14.08.2017;2017;08;18;Maanantai;75;61;136
623;14.08.2017;2017;08;19;Maanantai;81;43;124
623;14.08.2017;2017;08;20;Maanantai;50;40;90
623;14.08.2017;2017;08;21;Maanantai;41;22;63
623;14.08.2017;2017;08;22;Maanantai;39;12;51
623;14.08.2017;2017;08;23;Maanantai;13;10;23
623;15.08.2017;2017;08;00;Tiistai;8;7;15
623;15.08.2017;2017;08;01;Tiistai;3;0;3
623;15.08.2017;2017;08;02;Tiistai;4;1;5
623;15.08.2017;2017;08;03;Tiistai;3;1;4
623;15.08.2017;2017;08;04;Tiistai;1;3;4
623;15.08.2017;2017;08;05;Tiistai;1;6;7
623;15.08.2017;2017;08;06;Tiistai;4;12;16
623;15.08.2017;2017;08;07;Tiistai;11;52;63
623;15.08.2017;2017;08;08;Tiistai;57;156;213
623;15.08.2017;2017;08;09;Tiistai;68;151;219
623;15.08.2017;2017;08;10;Tiistai;47;87;134
623;15.08.2017;2017;08;11;Tiistai;24;51;75
623;15.08.2017;2017;08;12;Tiistai;39;38;77
623;15.08.2017;2017;08;13;Tiistai;57;52;109
623;15.08.2017;2017;08;14;Tiistai;64;43;107
623;15.08.2017;2017;08;15;Tiistai;84;46;130
623;15.08.2017;2017;08;16;Tiistai;132;59;191
623;15.08.2017;2017;08;17;Tiistai;206;93;299
623;15.08.2017;2017;08;18;Tiistai;117;64;181
623;15.08.2017;2017;08;19;Tiistai;60;33;93
623;15.08.2017;2017;08;20;Tiistai;61;34;95
623;15.08.2017;2017;08;21;Tiistai;50;33;83
623;15.08.2017;2017;08;22;Tiistai;32;15;47
623;15.08.2017;2017;08;23;Tiistai;12;11;23
623;16.08.2017;2017;08;00;Keskiviikko;12;9;21
623;16.08.2017;2017;08;01;Keskiviikko;3;1;4
623;16.08.2017;2017;08;02;Keskiviikko;6;0;6
623;16.08.2017;2017;08;03;Keskiviikko;2;3;5
623;16.08.2017;2017;08;04;Keskiviikko;2;3;5
623;16.08.2017;2017;08;05;Keskiviikko;2;4;6
623;16.08.2017;2017;08;06;Keskiviikko;2;8;10
623;16.08.2017;2017;08;07;Keskiviikko;12;65;77
623;16.08.2017;2017;08;08;Keskiviikko;56;140;196
623;16.08.2017;2017;08;09;Keskiviikko;101;170;271
623;16.08.2017;2017;08;10;Keskiviikko;38;80;118
623;16.08.2017;2017;08;11;Keskiviikko;20;41;61
623;16.08.2017;2017;08;12;Keskiviikko;52;72;124
623;16.08.2017;2017;08;13;Keskiviikko;39;47;86
623;16.08.2017;2017;08;14;Keskiviikko;60;55;115
623;16.08.2017;2017;08;15;Keskiviikko;124;55;179
623;16.08.2017;2017;08;16;Keskiviikko;118;57;175
623;16.08.2017;2017;08;17;Keskiviikko;168;83;251
623;16.08.2017;2017;08;18;Keskiviikko;76;63;139
623;16.08.2017;2017;08;19;Keskiviikko;68;41;109
623;16.08.2017;2017;08;20;Keskiviikko;65;32;97
623;16.08.2017;2017;08;21;Keskiviikko;48;36;84
623;16.08.2017;2017;08;22;Keskiviikko;33;28;61
623;16.08.2017;2017;08;23;Keskiviikko;20;13;33
623;17.08.2017;2017;08;00;Torstai;14;9;23
623;17.08.2017;2017;08;01;Torstai;5;3;8
623;17.08.2017;2017;08;02;Torstai;3;0;3
623;17.08.2017;2017;08;03;Torstai;0;1;1
623;17.08.2017;2017;08;04;Torstai;0;2;2
623;17.08.2017;2017;08;05;Torstai;0;8;8
623;17.08.2017;2017;08;06;Torstai;4;10;14
623;17.08.2017;2017;08;07;Torstai;10;51;61
623;17.08.2017;2017;08;08;Torstai;58;137;195
623;17.08.2017;2017;08;09;Torstai;73;152;225
623;17.08.2017;2017;08;10;Torstai;32;62;94
623;17.08.2017;2017;08;11;Torstai;37;52;89
623;17.08.2017;2017;08;12;Torstai;45;49;94
623;17.08.2017;2017;08;13;Torstai;56;56;112
623;17.08.2017;2017;08;14;Torstai;65;48;113
623;17.08.2017;2017;08;15;Torstai;114;71;185
623;17.08.2017;2017;08;16;Torstai;124;60;184
623;17.08.2017;2017;08;17;Torstai;163;107;270
623;17.08.2017;2017;08;18;Torstai;88;94;182
623;17.08.2017;2017;08;19;Torstai;58;88;146
623;17.08.2017;2017;08;20;Torstai;66;65;131
623;17.08.2017;2017;08;21;Torstai;81;47;128
623;17.08.2017;2017;08;22;Torstai;74;26;100
623;17.08.2017;2017;08;23;Torstai;46;13;59
623;18.08.2017;2017;08;00;Perjantai;32;5;37
623;18.08.2017;2017;08;01;Perjantai;32;1;33
623;18.08.2017;2017;08;02;Perjantai;8;0;8
623;18.08.2017;2017;08;03;Perjantai;7;3;10
623;18.08.2017;2017;08;04;Perjantai;4;4;8
623;18.08.2017;2017;08;05;Perjantai;1;3;4
623;18.08.2017;2017;08;06;Perjantai;3;9;12
623;18.08.2017;2017;08;07;Perjantai;14;41;55
623;18.08.2017;2017;08;08;Perjantai;45;116;161
623;18.08.2017;2017;08;09;Perjantai;58;126;184
623;18.08.2017;2017;08;10;Perjantai;48;97;145
623;18.08.2017;2017;08;11;Perjantai;28;40;68
623;18.08.2017;2017;08;12;Perjantai;46;55;101
623;18.08.2017;2017;08;13;Perjantai;53;53;106
623;18.08.2017;2017;08;14;Perjantai;66;50;116
623;18.08.2017;2017;08;15;Perjantai;136;52;188
623;18.08.2017;2017;08;16;Perjantai;108;44;152
623;18.08.2017;2017;08;17;Perjantai;93;52;145
623;18.08.2017;2017;08;18;Perjantai;66;60;126
623;18.08.2017;2017;08;19;Perjantai;34;43;77
623;18.08.2017;2017;08;20;Perjantai;36;26;62
623;18.08.2017;2017;08;21;Perjantai;28;33;61
623;18.08.2017;2017;08;22;Perjantai;43;23;66
623;18.08.2017;2017;08;23;Perjantai;13;6;19
623;19.08.2017;2017;08;00;Lauantai;8;3;11
623;19.08.2017;2017;08;01;Lauantai;11;4;15
623;19.08.2017;2017;08;02;Lauantai;9;5;14
623;19.08.2017;2017;08;03;Lauantai;11;3;14
623;19.08.2017;2017;08;04;Lauantai;6;0;6
623;19.08.2017;2017;08;05;Lauantai;8;2;10
623;19.08.2017;2017;08;06;Lauantai;1;7;8
623;19.08.2017;2017;08;07;Lauantai;4;8;12
623;19.08.2017;2017;08;08;Lauantai;5;7;12
623;19.08.2017;2017;08;09;Lauantai;7;12;19
623;19.08.2017;2017;08;10;Lauantai;10;32;42
623;19.08.2017;2017;08;11;Lauantai;15;35;50
623;19.08.2017;2017;08;12;Lauantai;19;50;69
623;19.08.2017;2017;08;13;Lauantai;38;54;92
623;19.08.2017;2017;08;14;Lauantai;32;56;88
623;19.08.2017;2017;08;15;Lauantai;52;40;92
623;19.08.2017;2017;08;16;Lauantai;37;49;86
623;19.08.2017;2017;08;17;Lauantai;57;42;99
623;19.08.2017;2017;08;18;Lauantai;42;32;74
623;19.08.2017;2017;08;19;Lauantai;35;29;64
623;19.08.2017;2017;08;20;Lauantai;31;16;47
623;19.08.2017;2017;08;21;Lauantai;15;11;26
623;19.08.2017;2017;08;22;Lauantai;21;17;38
623;19.08.2017;2017;08;23;Lauantai;13;17;30
623;20.08.2017;2017;08;00;Sunnuntai;17;4;21
623;20.08.2017;2017;08;01;Sunnuntai;12;4;16
623;20.08.2017;2017;08;02;Sunnuntai;7;13;20
623;20.08.2017;2017;08;03;Sunnuntai;11;4;15
623;20.08.2017;2017;08;04;Sunnuntai;11;3;14
623;20.08.2017;2017;08;05;Sunnuntai;2;0;2
623;20.08.2017;2017;08;06;Sunnuntai;4;2;6
623;20.08.2017;2017;08;07;Sunnuntai;3;8;11
623;20.08.2017;2017;08;08;Sunnuntai;5;5;10
623;20.08.2017;2017;08;09;Sunnuntai;6;5;11
623;20.08.2017;2017;08;10;Sunnuntai;16;14;30
623;20.08.2017;2017;08;11;Sunnuntai;13;24;37
623;20.08.2017;2017;08;12;Sunnuntai;23;33;56
623;20.08.2017;2017;08;13;Sunnuntai;27;40;67
623;20.08.2017;2017;08;14;Sunnuntai;48;56;104
623;20.08.2017;2017;08;15;Sunnuntai;31;30;61
623;20.08.2017;2017;08;16;Sunnuntai;44;31;75
623;20.08.2017;2017;08;17;Sunnuntai;40;40;80
623;20.08.2017;2017;08;18;Sunnuntai;33;27;60
623;20.08.2017;2017;08;19;Sunnuntai;28;25;53
623;20.08.2017;2017;08;20;Sunnuntai;37;31;68
623;20.08.2017;2017;08;21;Sunnuntai;33;21;54
623;20.08.2017;2017;08;22;Sunnuntai;35;11;46
623;20.08.2017;2017;08;23;Sunnuntai;13;10;23
623;21.08.2017;2017;08;00;Maanantai;6;4;10
623;21.08.2017;2017;08;01;Maanantai;10;7;17
623;21.08.2017;2017;08;02;Maanantai;2;0;2
623;21.08.2017;2017;08;03;Maanantai;2;1;3
623;21.08.2017;2017;08;04;Maanantai;2;3;5
623;21.08.2017;2017;08;05;Maanantai;4;1;5
623;21.08.2017;2017;08;06;Maanantai;1;11;12
623;21.08.2017;2017;08;07;Maanantai;11;50;61
623;21.08.2017;2017;08;08;Maanantai;54;139;193
623;21.08.2017;2017;08;09;Maanantai;78;161;239
623;21.08.2017;2017;08;10;Maanantai;50;77;127
623;21.08.2017;2017;08;11;Maanantai;32;41;73
623;21.08.2017;2017;08;12;Maanantai;49;51;100
623;21.08.2017;2017;08;13;Maanantai;47;35;82
623;21.08.2017;2017;08;14;Maanantai;42;40;82
623;21.08.2017;2017;08;15;Maanantai;99;41;140
623;21.08.2017;2017;08;16;Maanantai;120;44;164
623;21.08.2017;2017;08;17;Maanantai;169;99;268
623;21.08.2017;2017;08;18;Maanantai;79;59;138
623;21.08.2017;2017;08;19;Maanantai;53;38;91
623;21.08.2017;2017;08;20;Maanantai;40;34;74
623;21.08.2017;2017;08;21;Maanantai;44;17;61
623;21.08.2017;2017;08;22;Maanantai;27;9;36
623;21.08.2017;2017;08;23;Maanantai;17;5;22
623;22.08.2017;2017;08;00;Tiistai;7;1;8
623;22.08.2017;2017;08;01;Tiistai;6;1;7
623;22.08.2017;2017;08;02;Tiistai;1;2;3
623;22.08.2017;2017;08;03;Tiistai;2;0;2
623;22.08.2017;2017;08;04;Tiistai;2;3;5
623;22.08.2017;2017;08;05;Tiistai;2;1;3
623;22.08.2017;2017;08;06;Tiistai;4;11;15
623;22.08.2017;2017;08;07;Tiistai;13;47;60
623;22.08.2017;2017;08;08;Tiistai;47;126;173
623;22.08.2017;2017;08;09;Tiistai;91;146;237
623;22.08.2017;2017;08;10;Tiistai;45;86;131
623;22.08.2017;2017;08;11;Tiistai;30;58;88
623;22.08.2017;2017;08;12;Tiistai;35;44;79
623;22.08.2017;2017;08;13;Tiistai;47;58;105
623;22.08.2017;2017;08;14;Tiistai;51;34;85
623;22.08.2017;2017;08;15;Tiistai;90;45;135
623;22.08.2017;2017;08;16;Tiistai;110;46;156
623;22.08.2017;2017;08;17;Tiistai;173;85;258
623;22.08.2017;2017;08;18;Tiistai;73;61;134
623;22.08.2017;2017;08;19;Tiistai;66;39;105
623;22.08.2017;2017;08;20;Tiistai;45;26;71
623;22.08.2017;2017;08;21;Tiistai;46;22;68
623;22.08.2017;2017;08;22;Tiistai;30;12;42
623;22.08.2017;2017;08;23;Tiistai;13;6;19
623;23.08.2017;2017;08;00;Keskiviikko;4;7;11
623;23.08.2017;2017;08;01;Keskiviikko;11;0;11
623;23.08.2017;2017;08;02;Keskiviikko;5;0;5
623;23.08.2017;2017;08;03;Keskiviikko;2;1;3
623;23.08.2017;2017;08;04;Keskiviikko;1;3;4
623;23.08.2017;2017;08;05;Keskiviikko;0;1;1
623;23.08.2017;2017;08;06;Keskiviikko;2;10;12
623;23.08.2017;2017;08;07;Keskiviikko;8;45;53
623;23.08.2017;2017;08;08;Keskiviikko;48;134;182
623;23.08.2017;2017;08;09;Keskiviikko;53;140;193
623;23.08.2017;2017;08;10;Keskiviikko;48;69;117
623;23.08.2017;2017;08;11;Keskiviikko;18;38;56
623;23.08.2017;2017;08;12;Keskiviikko;62;59;121
623;23.08.2017;2017;08;13;Keskiviikko;46;54;100
623;23.08.2017;2017;08;14;Keskiviikko;58;41;99
623;23.08.2017;2017;08;15;Keskiviikko;105;45;150
623;23.08.2017;2017;08;16;Keskiviikko;103;60;163
623;23.08.2017;2017;08;17;Keskiviikko;143;70;213
623;23.08.2017;2017;08;18;Keskiviikko;81;68;149
623;23.08.2017;2017;08;19;Keskiviikko;52;50;102
623;23.08.2017;2017;08;20;Keskiviikko;50;25;75
623;23.08.2017;2017;08;21;Keskiviikko;57;27;84
623;23.08.2017;2017;08;22;Keskiviikko;31;23;54
623;23.08.2017;2017;08;23;Keskiviikko;13;5;18
623;24.08.2017;2017;08;00;Torstai;9;4;13
623;24.08.2017;2017;08;01;Torstai;8;3;11
623;24.08.2017;2017;08;02;Torstai;2;1;3
623;24.08.2017;2017;08;03;Torstai;0;1;1
623;24.08.2017;2017;08;04;Torstai;0;3;3
623;24.08.2017;2017;08;05;Torstai;2;3;5
623;24.08.2017;2017;08;06;Torstai;3;15;18
623;24.08.2017;2017;08;07;Torstai;10;37;47
623;24.08.2017;2017;08;08;Torstai;48;127;175
623;24.08.2017;2017;08;09;Torstai;76;153;229
623;24.08.2017;2017;08;10;Torstai;33;69;102
623;24.08.2017;2017;08;11;Torstai;35;49;84
623;24.08.2017;2017;08;12;Torstai;45;40;85
623;24.08.2017;2017;08;13;Torstai;46;46;92
623;24.08.2017;2017;08;14;Torstai;63;44;107
623;24.08.2017;2017;08;15;Torstai;84;38;122
623;24.08.2017;2017;08;16;Torstai;112;40;152
623;24.08.2017;2017;08;17;Torstai;133;62;195
623;24.08.2017;2017;08;18;Torstai;75;71;146
623;24.08.2017;2017;08;19;Torstai;60;49;109
623;24.08.2017;2017;08;20;Torstai;41;23;64
623;24.08.2017;2017;08;21;Torstai;52;30;82
623;24.08.2017;2017;08;22;Torstai;38;16;54
623;24.08.2017;2017;08;23;Torstai;17;9;26
623;25.08.2017;2017;08;00;Perjantai;9;2;11
623;25.08.2017;2017;08;01;Perjantai;3;1;4
623;25.08.2017;2017;08;02;Perjantai;1;3;4
623;25.08.2017;2017;08;03;Perjantai;3;1;4
623;25.08.2017;2017;08;04;Perjantai;3;3;6
623;25.08.2017;2017;08;05;Perjantai;1;3;4
623;25.08.2017;2017;08;06;Perjantai;3;6;9
623;25.08.2017;2017;08;07;Perjantai;8;35;43
623;25.08.2017;2017;08;08;Perjantai;28;106;134
623;25.08.2017;2017;08;09;Perjantai;44;102;146
623;25.08.2017;2017;08;10;Perjantai;21;59;80
623;25.08.2017;2017;08;11;Perjantai;17;27;44
623;25.08.2017;2017;08;12;Perjantai;25;25;50
623;25.08.2017;2017;08;13;Perjantai;28;16;44
623;25.08.2017;2017;08;14;Perjantai;39;14;53
623;25.08.2017;2017;08;15;Perjantai;74;34;108
623;25.08.2017;2017;08;16;Perjantai;55;26;81
623;25.08.2017;2017;08;17;Perjantai;79;38;117
623;25.08.2017;2017;08;18;Perjantai;27;39;66
623;25.08.2017;2017;08;19;Perjantai;26;24;50
623;25.08.2017;2017;08;20;Perjantai;19;21;40
623;25.08.2017;2017;08;21;Perjantai;23;20;43
623;25.08.2017;2017;08;22;Perjantai;23;13;36
623;25.08.2017;2017;08;23;Perjantai;7;8;15
623;26.08.2017;2017;08;00;Lauantai;5;4;9
623;26.08.2017;2017;08;01;Lauantai;11;5;16
623;26.08.2017;2017;08;02;Lauantai;8;1;9
623;26.08.2017;2017;08;03;Lauantai;6;1;7
623;26.08.2017;2017;08;04;Lauantai;6;0;6
623;26.08.2017;2017;08;05;Lauantai;2;2;4
623;26.08.2017;2017;08;06;Lauantai;2;2;4
623;26.08.2017;2017;08;07;Lauantai;4;3;7
623;26.08.2017;2017;08;08;Lauantai;1;5;6
623;26.08.2017;2017;08;09;Lauantai;2;5;7
623;26.08.2017;2017;08;10;Lauantai;6;23;29
623;26.08.2017;2017;08;11;Lauantai;9;28;37
623;26.08.2017;2017;08;12;Lauantai;26;29;55
623;26.08.2017;2017;08;13;Lauantai;24;41;65
623;26.08.2017;2017;08;14;Lauantai;26;36;62
623;26.08.2017;2017;08;15;Lauantai;41;31;72
623;26.08.2017;2017;08;16;Lauantai;36;31;67
623;26.08.2017;2017;08;17;Lauantai;29;27;56
623;26.08.2017;2017;08;18;Lauantai;43;47;90
623;26.08.2017;2017;08;19;Lauantai;28;38;66
623;26.08.2017;2017;08;20;Lauantai;33;24;57
623;26.08.2017;2017;08;21;Lauantai;21;28;49
623;26.08.2017;2017;08;22;Lauantai;24;18;42
623;26.08.2017;2017;08;23;Lauantai;20;5;25
623;27.08.2017;2017;08;00;Sunnuntai;15;2;17
623;27.08.2017;2017;08;01;Sunnuntai;42;11;53
623;27.08.2017;2017;08;02;Sunnuntai;9;7;16
623;27.08.2017;2017;08;03;Sunnuntai;18;2;20
623;27.08.2017;2017;08;04;Sunnuntai;11;1;12
623;27.08.2017;2017;08;05;Sunnuntai;7;2;9
623;27.08.2017;2017;08;06;Sunnuntai;0;5;5
623;27.08.2017;2017;08;07;Sunnuntai;2;3;5
623;27.08.2017;2017;08;08;Sunnuntai;7;3;10
623;27.08.2017;2017;08;09;Sunnuntai;2;12;14
623;27.08.2017;2017;08;10;Sunnuntai;10;8;18
623;27.08.2017;2017;08;11;Sunnuntai;12;25;37
623;27.08.2017;2017;08;12;Sunnuntai;18;28;46
623;27.08.2017;2017;08;13;Sunnuntai;12;33;45
623;27.08.2017;2017;08;14;Sunnuntai;29;30;59
623;27.08.2017;2017;08;15;Sunnuntai;27;29;56
623;27.08.2017;2017;08;16;Sunnuntai;40;26;66
623;27.08.2017;2017;08;17;Sunnuntai;43;37;80
623;27.08.2017;2017;08;18;Sunnuntai;39;39;78
623;27.08.2017;2017;08;19;Sunnuntai;42;38;80
623;27.08.2017;2017;08;20;Sunnuntai;21;23;44
623;27.08.2017;2017;08;21;Sunnuntai;27;13;40
623;27.08.2017;2017;08;22;Sunnuntai;19;11;30
623;27.08.2017;2017;08;23;Sunnuntai;9;11;20
623;28.08.2017;2017;08;00;Maanantai;4;9;13
623;28.08.2017;2017;08;01;Maanantai;3;1;4
623;28.08.2017;2017;08;02;Maanantai;2;5;7
623;28.08.2017;2017;08;03;Maanantai;2;2;4
623;28.08.2017;2017;08;04;Maanantai;0;0;0
623;28.08.2017;2017;08;05;Maanantai;0;2;2
623;28.08.2017;2017;08;06;Maanantai;2;13;15
623;28.08.2017;2017;08;07;Maanantai;12;49;61
623;28.08.2017;2017;08;08;Maanantai;49;149;198
623;28.08.2017;2017;08;09;Maanantai;83;191;274
623;28.08.2017;2017;08;10;Maanantai;65;97;162
623;28.08.2017;2017;08;11;Maanantai;34;40;74
623;28.08.2017;2017;08;12;Maanantai;42;50;92
623;28.08.2017;2017;08;13;Maanantai;52;44;96
623;28.08.2017;2017;08;14;Maanantai;57;43;100
623;28.08.2017;2017;08;15;Maanantai;98;46;144
623;28.08.2017;2017;08;16;Maanantai;112;54;166
623;28.08.2017;2017;08;17;Maanantai;155;76;231
623;28.08.2017;2017;08;18;Maanantai;91;66;157
623;28.08.2017;2017;08;19;Maanantai;50;43;93
623;28.08.2017;2017;08;20;Maanantai;50;52;102
623;28.08.2017;2017;08;21;Maanantai;54;29;83
623;28.08.2017;2017;08;22;Maanantai;25;22;47
623;28.08.2017;2017;08;23;Maanantai;12;4;16
623;29.08.2017;2017;08;00;Tiistai;1;2;3
623;29.08.2017;2017;08;01;Tiistai;2;2;4
623;29.08.2017;2017;08;02;Tiistai;6;2;8
623;29.08.2017;2017;08;03;Tiistai;2;1;3
623;29.08.2017;2017;08;04;Tiistai;0;3;3
623;29.08.2017;2017;08;05;Tiistai;2;1;3
623;29.08.2017;2017;08;06;Tiistai;2;10;12
623;29.08.2017;2017;08;07;Tiistai;13;48;61
623;29.08.2017;2017;08;08;Tiistai;52;135;187
623;29.08.2017;2017;08;09;Tiistai;64;145;209
623;29.08.2017;2017;08;10;Tiistai;49;69;118
623;29.08.2017;2017;08;11;Tiistai;33;53;86
623;29.08.2017;2017;08;12;Tiistai;32;36;68
623;29.08.2017;2017;08;13;Tiistai;61;53;114
623;29.08.2017;2017;08;14;Tiistai;59;37;96
623;29.08.2017;2017;08;15;Tiistai;85;36;121
623;29.08.2017;2017;08;16;Tiistai;101;40;141
623;29.08.2017;2017;08;17;Tiistai;115;45;160
623;29.08.2017;2017;08;18;Tiistai;54;32;86
623;29.08.2017;2017;08;19;Tiistai;43;17;60
623;29.08.2017;2017;08;20;Tiistai;23;14;37
623;29.08.2017;2017;08;21;Tiistai;23;16;39
623;29.08.2017;2017;08;22;Tiistai;18;12;30
623;29.08.2017;2017;08;23;Tiistai;11;6;17
623;30.08.2017;2017;08;00;Keskiviikko;5;5;10
623;30.08.2017;2017;08;01;Keskiviikko;4;2;6
623;30.08.2017;2017;08;02;Keskiviikko;2;0;2
623;30.08.2017;2017;08;03;Keskiviikko;3;0;3
623;30.08.2017;2017;08;04;Keskiviikko;1;3;4
623;30.08.2017;2017;08;05;Keskiviikko;0;5;5
623;30.08.2017;2017;08;06;Keskiviikko;1;8;9
623;30.08.2017;2017;08;07;Keskiviikko;4;36;40
623;30.08.2017;2017;08;08;Keskiviikko;18;89;107
623;30.08.2017;2017;08;09;Keskiviikko;38;130;168
623;30.08.2017;2017;08;10;Keskiviikko;24;49;73
623;30.08.2017;2017;08;11;Keskiviikko;7;13;20
623;30.08.2017;2017;08;12;Keskiviikko;22;15;37
623;30.08.2017;2017;08;13;Keskiviikko;21;31;52
623;30.08.2017;2017;08;14;Keskiviikko;27;31;58
623;30.08.2017;2017;08;15;Keskiviikko;84;33;117
623;30.08.2017;2017;08;16;Keskiviikko;80;45;125
623;30.08.2017;2017;08;17;Keskiviikko;113;68;181
623;30.08.2017;2017;08;18;Keskiviikko;72;53;125
623;30.08.2017;2017;08;19;Keskiviikko;53;37;90
623;30.08.2017;2017;08;20;Keskiviikko;52;33;85
623;30.08.2017;2017;08;21;Keskiviikko;33;17;50
623;30.08.2017;2017;08;22;Keskiviikko;33;25;58
623;30.08.2017;2017;08;23;Keskiviikko;10;14;24
623;31.08.2017;2017;08;00;Torstai;6;3;9
623;31.08.2017;2017;08;01;Torstai;8;7;15
623;31.08.2017;2017;08;02;Torstai;2;0;2
623;31.08.2017;2017;08;03;Torstai;2;1;3
623;31.08.2017;2017;08;04;Torstai;1;1;2
623;31.08.2017;2017;08;05;Torstai;0;5;5
623;31.08.2017;2017;08;06;Torstai;2;11;13
623;31.08.2017;2017;08;07;Torstai;15;49;64
623;31.08.2017;2017;08;08;Torstai;46;144;190
623;31.08.2017;2017;08;09;Torstai;76;149;225
623;31.08.2017;2017;08;10;Torstai;44;81;125
623;31.08.2017;2017;08;11;Torstai;40;49;89
623;31.08.2017;2017;08;12;Torstai;43;44;87
623;31.08.2017;2017;08;13;Torstai;47;45;92
623;31.08.2017;2017;08;14;Torstai;75;65;140
623;31.08.2017;2017;08;15;Torstai;86;49;135
623;31.08.2017;2017;08;16;Torstai;131;53;184
623;31.08.2017;2017;08;17;Torstai;150;89;239
623;31.08.2017;2017;08;18;Torstai;83;56;139
623;31.08.2017;2017;08;19;Torstai;49;49;98
623;31.08.2017;2017;08;20;Torstai;63;36;99
623;31.08.2017;2017;08;21;Torstai;48;25;73
623;31.08.2017;2017;08;22;Torstai;33;19;52
623;31.08.2017;2017;08;23;Torstai;16;6;22
623;01.09.2017;2017;09;00;Perjantai;8;4;12
623;01.09.2017;2017;09;01;Perjantai;6;1;7
623;01.09.2017;2017;09;02;Perjantai;2;0;2
623;01.09.2017;2017;09;03;Perjantai;4;3;7
623;01.09.2017;2017;09;04;Perjantai;3;2;5
623;01.09.2017;2017;09;05;Perjantai;1;3;4
623;01.09.2017;2017;09;06;Perjantai;1;6;7
623;01.09.2017;2017;09;07;Perjantai;8;31;39
623;01.09.2017;2017;09;08;Perjantai;23;67;90
623;01.09.2017;2017;09;09;Perjantai;29;77;106
623;01.09.2017;2017;09;10;Perjantai;10;29;39
623;01.09.2017;2017;09;11;Perjantai;11;14;25
623;01.09.2017;2017;09;12;Perjantai;20;19;39
623;01.09.2017;2017;09;13;Perjantai;26;18;44
623;01.09.2017;2017;09;14;Perjantai;32;16;48
623;01.09.2017;2017;09;15;Perjantai;40;25;65
623;01.09.2017;2017;09;16;Perjantai;36;21;57
623;01.09.2017;2017;09;17;Perjantai;39;26;65
623;01.09.2017;2017;09;18;Perjantai;29;23;52
623;01.09.2017;2017;09;19;Perjantai;22;22;44
623;01.09.2017;2017;09;20;Perjantai;25;15;40
623;01.09.2017;2017;09;21;Perjantai;17;24;41
623;01.09.2017;2017;09;22;Perjantai;15;16;31
623;01.09.2017;2017;09;23;Perjantai;11;9;20
623;02.09.2017;2017;09;00;Lauantai;10;6;16
623;02.09.2017;2017;09;01;Lauantai;13;2;15
623;02.09.2017;2017;09;02;Lauantai;4;1;5
623;02.09.2017;2017;09;03;Lauantai;5;1;6
623;02.09.2017;2017;09;04;Lauantai;7;2;9
623;02.09.2017;2017;09;05;Lauantai;9;3;12
623;02.09.2017;2017;09;06;Lauantai;1;2;3
623;02.09.2017;2017;09;07;Lauantai;3;8;11
623;02.09.2017;2017;09;08;Lauantai;4;7;11
623;02.09.2017;2017;09;09;Lauantai;6;18;24
623;02.09.2017;2017;09;10;Lauantai;13;20;33
623;02.09.2017;2017;09;11;Lauantai;18;27;45
623;02.09.2017;2017;09;12;Lauantai;17;28;45
623;02.09.2017;2017;09;13;Lauantai;24;42;66
623;02.09.2017;2017;09;14;Lauantai;21;40;61
623;02.09.2017;2017;09;15;Lauantai;42;56;98
623;02.09.2017;2017;09;16;Lauantai;54;52;106
623;02.09.2017;2017;09;17;Lauantai;42;35;77
623;02.09.2017;2017;09;18;Lauantai;36;36;72
623;02.09.2017;2017;09;19;Lauantai;39;40;79
623;02.09.2017;2017;09;20;Lauantai;42;37;79
623;02.09.2017;2017;09;21;Lauantai;25;22;47
623;02.09.2017;2017;09;22;Lauantai;29;17;46
623;02.09.2017;2017;09;23;Lauantai;24;13;37
623;03.09.2017;2017;09;00;Sunnuntai;20;5;25
623;03.09.2017;2017;09;01;Sunnuntai;13;7;20
623;03.09.2017;2017;09;02;Sunnuntai;11;2;13
623;03.09.2017;2017;09;03;Sunnuntai;9;8;17
623;03.09.2017;2017;09;04;Sunnuntai;11;6;17
623;03.09.2017;2017;09;05;Sunnuntai;10;7;17
623;03.09.2017;2017;09;06;Sunnuntai;4;2;6
623;03.09.2017;2017;09;07;Sunnuntai;3;8;11
623;03.09.2017;2017;09;08;Sunnuntai;3;3;6
623;03.09.2017;2017;09;09;Sunnuntai;1;6;7
623;03.09.2017;2017;09;10;Sunnuntai;15;15;30
623;03.09.2017;2017;09;11;Sunnuntai;23;35;58
623;03.09.2017;2017;09;12;Sunnuntai;7;21;28
623;03.09.2017;2017;09;13;Sunnuntai;29;34;63
623;03.09.2017;2017;09;14;Sunnuntai;41;40;81
623;03.09.2017;2017;09;15;Sunnuntai;41;48;89
623;03.09.2017;2017;09;16;Sunnuntai;49;33;82
623;03.09.2017;2017;09;17;Sunnuntai;40;54;94
623;03.09.2017;2017;09;18;Sunnuntai;40;38;78
623;03.09.2017;2017;09;19;Sunnuntai;44;38;82
623;03.09.2017;2017;09;20;Sunnuntai;30;34;64
623;03.09.2017;2017;09;21;Sunnuntai;30;28;58
623;03.09.2017;2017;09;22;Sunnuntai;23;9;32
623;03.09.2017;2017;09;23;Sunnuntai;10;3;13
623;04.09.2017;2017;09;00;Maanantai;5;1;6
623;04.09.2017;2017;09;01;Maanantai;4;1;5
623;04.09.2017;2017;09;02;Maanantai;1;2;3
623;04.09.2017;2017;09;03;Maanantai;2;3;5
623;04.09.2017;2017;09;04;Maanantai;2;1;3
623;04.09.2017;2017;09;05;Maanantai;0;1;1
623;04.09.2017;2017;09;06;Maanantai;6;14;20
623;04.09.2017;2017;09;07;Maanantai;15;53;68
623;04.09.2017;2017;09;08;Maanantai;65;136;201
623;04.09.2017;2017;09;09;Maanantai;96;144;240
623;04.09.2017;2017;09;10;Maanantai;62;83;145
623;04.09.2017;2017;09;11;Maanantai;31;24;55
623;04.09.2017;2017;09;12;Maanantai;50;53;103
623;04.09.2017;2017;09;13;Maanantai;56;48;104
623;04.09.2017;2017;09;14;Maanantai;66;64;130
623;04.09.2017;2017;09;15;Maanantai;88;50;138
623;04.09.2017;2017;09;16;Maanantai;135;75;210
623;04.09.2017;2017;09;17;Maanantai;177;103;280
623;04.09.2017;2017;09;18;Maanantai;103;82;185
623;04.09.2017;2017;09;19;Maanantai;75;64;139
623;04.09.2017;2017;09;20;Maanantai;59;36;95
623;04.09.2017;2017;09;21;Maanantai;53;39;92
623;04.09.2017;2017;09;22;Maanantai;31;26;57
623;04.09.2017;2017;09;23;Maanantai;12;14;26
623;05.09.2017;2017;09;00;Tiistai;2;0;2
623;05.09.2017;2017;09;01;Tiistai;6;2;8
623;05.09.2017;2017;09;02;Tiistai;5;3;8
623;05.09.2017;2017;09;03;Tiistai;6;2;8
623;05.09.2017;2017;09;04;Tiistai;3;1;4
623;05.09.2017;2017;09;05;Tiistai;1;5;6
623;05.09.2017;2017;09;06;Tiistai;2;12;14
623;05.09.2017;2017;09;07;Tiistai;10;55;65
623;05.09.2017;2017;09;08;Tiistai;72;135;207
623;05.09.2017;2017;09;09;Tiistai;85;159;244
623;05.09.2017;2017;09;10;Tiistai;60;74;134
623;05.09.2017;2017;09;11;Tiistai;34;41;75
623;05.09.2017;2017;09;12;Tiistai;47;54;101
623;05.09.2017;2017;09;13;Tiistai;55;63;118
623;05.09.2017;2017;09;14;Tiistai;51;59;110
623;05.09.2017;2017;09;15;Tiistai;81;52;133
623;05.09.2017;2017;09;16;Tiistai;112;65;177
623;05.09.2017;2017;09;17;Tiistai;159;107;266
623;05.09.2017;2017;09;18;Tiistai;117;90;207
623;05.09.2017;2017;09;19;Tiistai;72;55;127
623;05.09.2017;2017;09;20;Tiistai;53;38;91
623;05.09.2017;2017;09;21;Tiistai;64;29;93
623;05.09.2017;2017;09;22;Tiistai;29;21;50
623;05.09.2017;2017;09;23;Tiistai;13;13;26
623;06.09.2017;2017;09;00;Keskiviikko;17;3;20
623;06.09.2017;2017;09;01;Keskiviikko;8;3;11
623;06.09.2017;2017;09;02;Keskiviikko;4;1;5
623;06.09.2017;2017;09;03;Keskiviikko;4;0;4
623;06.09.2017;2017;09;04;Keskiviikko;2;2;4
623;06.09.2017;2017;09;05;Keskiviikko;0;2;2
623;06.09.2017;2017;09;06;Keskiviikko;2;12;14
623;06.09.2017;2017;09;07;Keskiviikko;14;47;61
623;06.09.2017;2017;09;08;Keskiviikko;61;146;207
623;06.09.2017;2017;09;09;Keskiviikko;61;128;189
623;06.09.2017;2017;09;10;Keskiviikko;60;67;127
623;06.09.2017;2017;09;11;Keskiviikko;28;36;64
623;06.09.2017;2017;09;12;Keskiviikko;51;40;91
623;06.09.2017;2017;09;13;Keskiviikko;54;61;115
623;06.09.2017;2017;09;14;Keskiviikko;47;58;105
623;06.09.2017;2017;09;15;Keskiviikko;98;59;157
623;06.09.2017;2017;09;16;Keskiviikko;121;83;204
623;06.09.2017;2017;09;17;Keskiviikko;142;84;226
623;06.09.2017;2017;09;18;Keskiviikko;108;76;184
623;06.09.2017;2017;09;19;Keskiviikko;75;52;127
623;06.09.2017;2017;09;20;Keskiviikko;79;46;125
623;06.09.2017;2017;09;21;Keskiviikko;60;32;92
623;06.09.2017;2017;09;22;Keskiviikko;46;22;68
623;06.09.2017;2017;09;23;Keskiviikko;9;18;27
623;07.09.2017;2017;09;00;Torstai;11;33;44
623;07.09.2017;2017;09;01;Torstai;7;8;15
623;07.09.2017;2017;09;02;Torstai;7;9;16
623;07.09.2017;2017;09;03;Torstai;4;2;6
623;07.09.2017;2017;09;04;Torstai;5;4;9
623;07.09.2017;2017;09;05;Torstai;3;3;6
623;07.09.2017;2017;09;06;Torstai;5;6;11
623;07.09.2017;2017;09;07;Torstai;16;50;66
623;07.09.2017;2017;09;08;Torstai;58;137;195
623;07.09.2017;2017;09;09;Torstai;79;146;225
623;07.09.2017;2017;09;10;Torstai;56;72;128
623;07.09.2017;2017;09;11;Torstai;30;35;65
623;07.09.2017;2017;09;12;Torstai;47;50;97
623;07.09.2017;2017;09;13;Torstai;36;42;78
623;07.09.2017;2017;09;14;Torstai;50;48;98
623;07.09.2017;2017;09;15;Torstai;89;55;144
623;07.09.2017;2017;09;16;Torstai;121;71;192
623;07.09.2017;2017;09;17;Torstai;137;89;226
623;07.09.2017;2017;09;18;Torstai;81;64;145
623;07.09.2017;2017;09;19;Torstai;52;55;107
623;07.09.2017;2017;09;20;Torstai;52;45;97
623;07.09.2017;2017;09;21;Torstai;44;26;70
623;07.09.2017;2017;09;22;Torstai;30;15;45
623;07.09.2017;2017;09;23;Torstai;14;7;21
623;08.09.2017;2017;09;00;Perjantai;8;4;12
623;08.09.2017;2017;09;01;Perjantai;8;4;12
623;08.09.2017;2017;09;02;Perjantai;8;1;9
623;08.09.2017;2017;09;03;Perjantai;8;1;9
623;08.09.2017;2017;09;04;Perjantai;5;1;6
623;08.09.2017;2017;09;05;Perjantai;1;3;4
623;08.09.2017;2017;09;06;Perjantai;3;9;12
623;08.09.2017;2017;09;07;Perjantai;7;42;49
623;08.09.2017;2017;09;08;Perjantai;30;84;114
623;08.09.2017;2017;09;09;Perjantai;69;98;167
623;08.09.2017;2017;09;10;Perjantai;41;72;113
623;08.09.2017;2017;09;11;Perjantai;17;30;47
623;08.09.2017;2017;09;12;Perjantai;33;29;62
623;08.09.2017;2017;09;13;Perjantai;51;37;88
623;08.09.2017;2017;09;14;Perjantai;44;29;73
623;08.09.2017;2017;09;15;Perjantai;73;47;120
623;08.09.2017;2017;09;16;Perjantai;71;44;115
623;08.09.2017;2017;09;17;Perjantai;83;47;130
623;08.09.2017;2017;09;18;Perjantai;56;46;102
623;08.09.2017;2017;09;19;Perjantai;29;36;65
623;08.09.2017;2017;09;20;Perjantai;26;32;58
623;08.09.2017;2017;09;21;Perjantai;25;30;55
623;08.09.2017;2017;09;22;Perjantai;32;17;49
623;08.09.2017;2017;09;23;Perjantai;25;9;34
623;09.09.2017;2017;09;00;Lauantai;12;3;15
623;09.09.2017;2017;09;01;Lauantai;7;3;10
623;09.09.2017;2017;09;02;Lauantai;9;4;13
623;09.09.2017;2017;09;03;Lauantai;4;1;5
623;09.09.2017;2017;09;04;Lauantai;3;2;5
623;09.09.2017;2017;09;05;Lauantai;2;4;6
623;09.09.2017;2017;09;06;Lauantai;2;2;4
623;09.09.2017;2017;09;07;Lauantai;2;8;10
623;09.09.2017;2017;09;08;Lauantai;1;3;4
623;09.09.2017;2017;09;09;Lauantai;1;10;11
623;09.09.2017;2017;09;10;Lauantai;6;28;34
623;09.09.2017;2017;09;11;Lauantai;16;26;42
623;09.09.2017;2017;09;12;Lauantai;17;21;38
623;09.09.2017;2017;09;13;Lauantai;18;25;43
623;09.09.2017;2017;09;14;Lauantai;27;25;52
623;09.09.2017;2017;09;15;Lauantai;36;37;73
623;09.09.2017;2017;09;16;Lauantai;31;33;64
623;09.09.2017;2017;09;17;Lauantai;26;26;52
623;09.09.2017;2017;09;18;Lauantai;31;26;57
623;09.09.2017;2017;09;19;Lauantai;31;37;68
623;09.09.2017;2017;09;20;Lauantai;21;18;39
623;09.09.2017;2017;09;21;Lauantai;21;27;48
623;09.09.2017;2017;09;22;Lauantai;26;20;46
623;09.09.2017;2017;09;23;Lauantai;15;6;21
623;10.09.2017;2017;09;00;Sunnuntai;13;6;19
623;10.09.2017;2017;09;01;Sunnuntai;14;5;19
623;10.09.2017;2017;09;02;Sunnuntai;11;8;19
623;10.09.2017;2017;09;03;Sunnuntai;10;6;16
623;10.09.2017;2017;09;04;Sunnuntai;14;2;16
623;10.09.2017;2017;09;05;Sunnuntai;8;3;11
623;10.09.2017;2017;09;06;Sunnuntai;1;3;4
623;10.09.2017;2017;09;07;Sunnuntai;2;2;4
623;10.09.2017;2017;09;08;Sunnuntai;1;4;5
623;10.09.2017;2017;09;09;Sunnuntai;2;4;6
623;10.09.2017;2017;09;10;Sunnuntai;4;2;6
623;10.09.2017;2017;09;11;Sunnuntai;1;4;5
623;10.09.2017;2017;09;12;Sunnuntai;3;8;11
623;10.09.2017;2017;09;13;Sunnuntai;3;7;10
623;10.09.2017;2017;09;14;Sunnuntai;9;10;19
623;10.09.2017;2017;09;15;Sunnuntai;12;11;23
623;10.09.2017;2017;09;16;Sunnuntai;9;5;14
623;10.09.2017;2017;09;17;Sunnuntai;9;6;15
623;10.09.2017;2017;09;18;Sunnuntai;10;15;25
623;10.09.2017;2017;09;19;Sunnuntai;13;10;23
623;10.09.2017;2017;09;20;Sunnuntai;21;13;34
623;10.09.2017;2017;09;21;Sunnuntai;10;10;20
623;10.09.2017;2017;09;22;Sunnuntai;10;4;14
623;10.09.2017;2017;09;23;Sunnuntai;6;5;11
623;11.09.2017;2017;09;00;Maanantai;6;0;6
623;11.09.2017;2017;09;01;Maanantai;4;2;6
623;11.09.2017;2017;09;02;Maanantai;2;0;2
623;11.09.2017;2017;09;03;Maanantai;0;1;1
623;11.09.2017;2017;09;04;Maanantai;1;4;5
623;11.09.2017;2017;09;05;Maanantai;0;5;5
623;11.09.2017;2017;09;06;Maanantai;3;12;15
623;11.09.2017;2017;09;07;Maanantai;11;46;57
623;11.09.2017;2017;09;08;Maanantai;59;114;173
623;11.09.2017;2017;09;09;Maanantai;69;116;185
623;11.09.2017;2017;09;10;Maanantai;59;106;165
623;11.09.2017;2017;09;11;Maanantai;31;44;75
623;11.09.2017;2017;09;12;Maanantai;48;52;100
623;11.09.2017;2017;09;13;Maanantai;62;58;120
623;11.09.2017;2017;09;14;Maanantai;66;39;105
623;11.09.2017;2017;09;15;Maanantai;94;65;159
623;11.09.2017;2017;09;16;Maanantai;116;59;175
623;11.09.2017;2017;09;17;Maanantai;137;97;234
623;11.09.2017;2017;09;18;Maanantai;88;70;158
623;11.09.2017;2017;09;19;Maanantai;63;49;112
623;11.09.2017;2017;09;20;Maanantai;57;29;86
623;11.09.2017;2017;09;21;Maanantai;33;26;59
623;11.09.2017;2017;09;22;Maanantai;32;16;48
623;11.09.2017;2017;09;23;Maanantai;8;7;15
623;12.09.2017;2017;09;00;Tiistai;4;0;4
623;12.09.2017;2017;09;01;Tiistai;3;1;4
623;12.09.2017;2017;09;02;Tiistai;2;1;3
623;12.09.2017;2017;09;03;Tiistai;3;1;4
623;12.09.2017;2017;09;04;Tiistai;3;1;4
623;12.09.2017;2017;09;05;Tiistai;2;4;6
623;12.09.2017;2017;09;06;Tiistai;4;12;16
623;12.09.2017;2017;09;07;Tiistai;12;45;57
623;12.09.2017;2017;09;08;Tiistai;76;138;214
623;12.09.2017;2017;09;09;Tiistai;73;143;216
623;12.09.2017;2017;09;10;Tiistai;51;76;127
623;12.09.2017;2017;09;11;Tiistai;25;56;81
623;12.09.2017;2017;09;12;Tiistai;48;53;101
623;12.09.2017;2017;09;13;Tiistai;58;55;113
623;12.09.2017;2017;09;14;Tiistai;53;46;99
623;12.09.2017;2017;09;15;Tiistai;87;47;134
623;12.09.2017;2017;09;16;Tiistai;79;45;124
623;12.09.2017;2017;09;17;Tiistai;105;56;161
623;12.09.2017;2017;09;18;Tiistai;49;38;87
623;12.09.2017;2017;09;19;Tiistai;26;28;54
623;12.09.2017;2017;09;20;Tiistai;20;12;32
623;12.09.2017;2017;09;21;Tiistai;29;20;49
623;12.09.2017;2017;09;22;Tiistai;21;9;30
623;12.09.2017;2017;09;23;Tiistai;8;3;11
623;13.09.2017;2017;09;00;Keskiviikko;7;2;9
623;13.09.2017;2017;09;01;Keskiviikko;5;2;7
623;13.09.2017;2017;09;02;Keskiviikko;1;0;1
623;13.09.2017;2017;09;03;Keskiviikko;1;2;3
623;13.09.2017;2017;09;04;Keskiviikko;2;3;5
623;13.09.2017;2017;09;05;Keskiviikko;0;1;1
623;13.09.2017;2017;09;06;Keskiviikko;1;6;7
623;13.09.2017;2017;09;07;Keskiviikko;9;42;51
623;13.09.2017;2017;09;08;Keskiviikko;67;104;171
623;13.09.2017;2017;09;09;Keskiviikko;73;131;204
623;13.09.2017;2017;09;10;Keskiviikko;50;81;131
623;13.09.2017;2017;09;11;Keskiviikko;29;39;68
623;13.09.2017;2017;09;12;Keskiviikko;55;64;119
623;13.09.2017;2017;09;13;Keskiviikko;44;57;101
623;13.09.2017;2017;09;14;Keskiviikko;74;42;116
623;13.09.2017;2017;09;15;Keskiviikko;96;69;165
623;13.09.2017;2017;09;16;Keskiviikko;95;57;152
623;13.09.2017;2017;09;17;Keskiviikko;109;65;174
623;13.09.2017;2017;09;18;Keskiviikko;80;69;149
623;13.09.2017;2017;09;19;Keskiviikko;51;41;92
623;13.09.2017;2017;09;20;Keskiviikko;45;37;82
623;13.09.2017;2017;09;21;Keskiviikko;37;21;58
623;13.09.2017;2017;09;22;Keskiviikko;40;22;62
623;13.09.2017;2017;09;23;Keskiviikko;7;8;15
623;14.09.2017;2017;09;00;Torstai;10;1;11
623;14.09.2017;2017;09;01;Torstai;5;2;7
623;14.09.2017;2017;09;02;Torstai;1;0;1
623;14.09.2017;2017;09;03;Torstai;1;1;2
623;14.09.2017;2017;09;04;Torstai;2;5;7
623;14.09.2017;2017;09;05;Torstai;2;2;4
623;14.09.2017;2017;09;06;Torstai;3;6;9
623;14.09.2017;2017;09;07;Torstai;9;38;47
623;14.09.2017;2017;09;08;Torstai;58;115;173
623;14.09.2017;2017;09;09;Torstai;76;152;228
623;14.09.2017;2017;09;10;Torstai;51;60;111
623;14.09.2017;2017;09;11;Torstai;30;35;65
623;14.09.2017;2017;09;12;Torstai;50;32;82
623;14.09.2017;2017;09;13;Torstai;38;40;78
623;14.09.2017;2017;09;14;Torstai;45;44;89
623;14.09.2017;2017;09;15;Torstai;92;63;155
623;14.09.2017;2017;09;16;Torstai;97;72;169
623;14.09.2017;2017;09;17;Torstai;125;92;217
623;14.09.2017;2017;09;18;Torstai;78;56;134
623;14.09.2017;2017;09;19;Torstai;56;48;104
623;14.09.2017;2017;09;20;Torstai;75;34;109
623;14.09.2017;2017;09;21;Torstai;39;28;67
623;14.09.2017;2017;09;22;Torstai;26;14;40
623;14.09.2017;2017;09;23;Torstai;8;7;15
623;15.09.2017;2017;09;00;Perjantai;15;2;17
623;15.09.2017;2017;09;01;Perjantai;5;0;5
623;15.09.2017;2017;09;02;Perjantai;7;1;8
623;15.09.2017;2017;09;03;Perjantai;3;0;3
623;15.09.2017;2017;09;04;Perjantai;5;3;8
623;15.09.2017;2017;09;05;Perjantai;4;3;7
623;15.09.2017;2017;09;06;Perjantai;0;6;6
623;15.09.2017;2017;09;07;Perjantai;5;30;35
623;15.09.2017;2017;09;08;Perjantai;46;96;142
623;15.09.2017;2017;09;09;Perjantai;64;111;175
623;15.09.2017;2017;09;10;Perjantai;37;62;99
623;15.09.2017;2017;09;11;Perjantai;23;31;54
623;15.09.2017;2017;09;12;Perjantai;45;39;84
623;15.09.2017;2017;09;13;Perjantai;58;43;101
623;15.09.2017;2017;09;14;Perjantai;48;30;78
623;15.09.2017;2017;09;15;Perjantai;95;39;134
623;15.09.2017;2017;09;16;Perjantai;79;48;127
623;15.09.2017;2017;09;17;Perjantai;69;40;109
623;15.09.2017;2017;09;18;Perjantai;37;46;83
623;15.09.2017;2017;09;19;Perjantai;22;24;46
623;15.09.2017;2017;09;20;Perjantai;22;20;42
623;15.09.2017;2017;09;21;Perjantai;16;18;34
623;15.09.2017;2017;09;22;Perjantai;13;14;27
623;15.09.2017;2017;09;23;Perjantai;13;11;24
623;16.09.2017;2017;09;00;Lauantai;9;8;17
623;16.09.2017;2017;09;01;Lauantai;11;4;15
623;16.09.2017;2017;09;02;Lauantai;6;3;9
623;16.09.2017;2017;09;03;Lauantai;9;4;13
623;16.09.2017;2017;09;04;Lauantai;6;1;7
623;16.09.2017;2017;09;05;Lauantai;1;3;4
623;16.09.2017;2017;09;06;Lauantai;2;2;4
623;16.09.2017;2017;09;07;Lauantai;1;7;8
623;16.09.2017;2017;09;08;Lauantai;2;7;9
623;16.09.2017;2017;09;09;Lauantai;3;8;11
623;16.09.2017;2017;09;10;Lauantai;9;25;34
623;16.09.2017;2017;09;11;Lauantai;11;27;38
623;16.09.2017;2017;09;12;Lauantai;17;19;36
623;16.09.2017;2017;09;13;Lauantai;31;29;60
623;16.09.2017;2017;09;14;Lauantai;18;26;44
623;16.09.2017;2017;09;15;Lauantai;34;36;70
623;16.09.2017;2017;09;16;Lauantai;26;32;58
623;16.09.2017;2017;09;17;Lauantai;27;32;59
623;16.09.2017;2017;09;18;Lauantai;19;29;48
623;16.09.2017;2017;09;19;Lauantai;29;26;55
623;16.09.2017;2017;09;20;Lauantai;21;30;51
623;16.09.2017;2017;09;21;Lauantai;28;17;45
623;16.09.2017;2017;09;22;Lauantai;18;14;32
623;16.09.2017;2017;09;23;Lauantai;15;10;25
623;17.09.2017;2017;09;00;Sunnuntai;11;6;17
623;17.09.2017;2017;09;01;Sunnuntai;12;8;20
623;17.09.2017;2017;09;02;Sunnuntai;7;7;14
623;17.09.2017;2017;09;03;Sunnuntai;6;0;6
623;17.09.2017;2017;09;04;Sunnuntai;2;0;2
623;17.09.2017;2017;09;05;Sunnuntai;4;2;6
623;17.09.2017;2017;09;06;Sunnuntai;2;1;3
623;17.09.2017;2017;09;07;Sunnuntai;1;9;10
623;17.09.2017;2017;09;08;Sunnuntai;3;1;4
623;17.09.2017;2017;09;09;Sunnuntai;3;3;6
623;17.09.2017;2017;09;10;Sunnuntai;7;12;19
623;17.09.2017;2017;09;11;Sunnuntai;12;23;35
623;17.09.2017;2017;09;12;Sunnuntai;19;28;47
623;17.09.2017;2017;09;13;Sunnuntai;26;34;60
623;17.09.2017;2017;09;14;Sunnuntai;38;28;66
623;17.09.2017;2017;09;15;Sunnuntai;29;30;59
623;17.09.2017;2017;09;16;Sunnuntai;29;30;59
623;17.09.2017;2017;09;17;Sunnuntai;41;36;77
623;17.09.2017;2017;09;18;Sunnuntai;37;28;65
623;17.09.2017;2017;09;19;Sunnuntai;48;40;88
623;17.09.2017;2017;09;20;Sunnuntai;25;26;51
623;17.09.2017;2017;09;21;Sunnuntai;20;12;32
623;17.09.2017;2017;09;22;Sunnuntai;15;7;22
623;17.09.2017;2017;09;23;Sunnuntai;7;6;13
623;18.09.2017;2017;09;00;Maanantai;2;2;4
623;18.09.2017;2017;09;01;Maanantai;5;2;7
623;18.09.2017;2017;09;02;Maanantai;2;1;3
623;18.09.2017;2017;09;03;Maanantai;3;1;4
623;18.09.2017;2017;09;04;Maanantai;1;2;3
623;18.09.2017;2017;09;05;Maanantai;0;2;2
623;18.09.2017;2017;09;06;Maanantai;3;12;15
623;18.09.2017;2017;09;07;Maanantai;6;43;49
623;18.09.2017;2017;09;08;Maanantai;51;113;164
623;18.09.2017;2017;09;09;Maanantai;66;142;208
623;18.09.2017;2017;09;10;Maanantai;32;47;79
623;18.09.2017;2017;09;11;Maanantai;24;32;56
623;18.09.2017;2017;09;12;Maanantai;30;34;64
623;18.09.2017;2017;09;13;Maanantai;41;44;85
623;18.09.2017;2017;09;14;Maanantai;50;30;80
623;18.09.2017;2017;09;15;Maanantai;81;48;129
623;18.09.2017;2017;09;16;Maanantai;92;39;131
623;18.09.2017;2017;09;17;Maanantai;130;63;193
623;18.09.2017;2017;09;18;Maanantai;82;56;138
623;18.09.2017;2017;09;19;Maanantai;56;37;93
623;18.09.2017;2017;09;20;Maanantai;39;23;62
623;18.09.2017;2017;09;21;Maanantai;31;31;62
623;18.09.2017;2017;09;22;Maanantai;22;14;36
623;18.09.2017;2017;09;23;Maanantai;14;4;18
623;19.09.2017;2017;09;00;Tiistai;7;3;10
623;19.09.2017;2017;09;01;Tiistai;1;5;6
623;19.09.2017;2017;09;02;Tiistai;5;1;6
623;19.09.2017;2017;09;03;Tiistai;1;0;1
623;19.09.2017;2017;09;04;Tiistai;1;4;5
623;19.09.2017;2017;09;05;Tiistai;1;1;2
623;19.09.2017;2017;09;06;Tiistai;3;7;10
623;19.09.2017;2017;09;07;Tiistai;6;41;47
623;19.09.2017;2017;09;08;Tiistai;53;106;159
623;19.09.2017;2017;09;09;Tiistai;80;133;213
623;19.09.2017;2017;09;10;Tiistai;38;51;89
623;19.09.2017;2017;09;11;Tiistai;22;24;46
623;19.09.2017;2017;09;12;Tiistai;20;13;33
623;19.09.2017;2017;09;13;Tiistai;40;36;76
623;19.09.2017;2017;09;14;Tiistai;37;23;60
623;19.09.2017;2017;09;15;Tiistai;79;35;114
623;19.09.2017;2017;09;16;Tiistai;75;37;112
623;19.09.2017;2017;09;17;Tiistai;118;75;193
623;19.09.2017;2017;09;18;Tiistai;50;51;101
623;19.09.2017;2017;09;19;Tiistai;43;41;84
623;19.09.2017;2017;09;20;Tiistai;35;18;53
623;19.09.2017;2017;09;21;Tiistai;41;15;56
623;19.09.2017;2017;09;22;Tiistai;21;6;27
623;19.09.2017;2017;09;23;Tiistai;15;8;23
623;20.09.2017;2017;09;00;Keskiviikko;7;0;7
623;20.09.2017;2017;09;01;Keskiviikko;4;1;5
623;20.09.2017;2017;09;02;Keskiviikko;3;0;3
623;20.09.2017;2017;09;03;Keskiviikko;0;0;0
623;20.09.2017;2017;09;04;Keskiviikko;0;2;2
623;20.09.2017;2017;09;05;Keskiviikko;0;2;2
623;20.09.2017;2017;09;06;Keskiviikko;2;14;16
623;20.09.2017;2017;09;07;Keskiviikko;11;37;48
623;20.09.2017;2017;09;08;Keskiviikko;40;107;147
623;20.09.2017;2017;09;09;Keskiviikko;67;134;201
623;20.09.2017;2017;09;10;Keskiviikko;58;60;118
623;20.09.2017;2017;09;11;Keskiviikko;24;33;57
623;20.09.2017;2017;09;12;Keskiviikko;37;51;88
623;20.09.2017;2017;09;13;Keskiviikko;39;40;79
623;20.09.2017;2017;09;14;Keskiviikko;56;32;88
623;20.09.2017;2017;09;15;Keskiviikko;85;50;135
623;20.09.2017;2017;09;16;Keskiviikko;90;40;130
623;20.09.2017;2017;09;17;Keskiviikko;101;63;164
623;20.09.2017;2017;09;18;Keskiviikko;60;60;120
623;20.09.2017;2017;09;19;Keskiviikko;62;39;101
623;20.09.2017;2017;09;20;Keskiviikko;45;28;73
623;20.09.2017;2017;09;21;Keskiviikko;25;24;49
623;20.09.2017;2017;09;22;Keskiviikko;20;13;33
623;20.09.2017;2017;09;23;Keskiviikko;15;4;19
623;21.09.2017;2017;09;00;Torstai;1;3;4
623;21.09.2017;2017;09;01;Torstai;5;1;6
623;21.09.2017;2017;09;02;Torstai;3;0;3
623;21.09.2017;2017;09;03;Torstai;1;0;1
623;21.09.2017;2017;09;04;Torstai;3;1;4
623;21.09.2017;2017;09;05;Torstai;0;1;1
623;21.09.2017;2017;09;06;Torstai;4;5;9
623;21.09.2017;2017;09;07;Torstai;8;35;43
623;21.09.2017;2017;09;08;Torstai;42;105;147
623;21.09.2017;2017;09;09;Torstai;63;119;182
623;21.09.2017;2017;09;10;Torstai;29;38;67
623;21.09.2017;2017;09;11;Torstai;29;35;64
623;21.09.2017;2017;09;12;Torstai;39;32;71
623;21.09.2017;2017;09;13;Torstai;43;35;78
623;21.09.2017;2017;09;14;Torstai;53;31;84
623;21.09.2017;2017;09;15;Torstai;78;41;119
623;21.09.2017;2017;09;16;Torstai;81;57;138
623;21.09.2017;2017;09;17;Torstai;102;78;180
623;21.09.2017;2017;09;18;Torstai;76;53;129
623;21.09.2017;2017;09;19;Torstai;54;37;91
623;21.09.2017;2017;09;20;Torstai;35;22;57
623;21.09.2017;2017;09;21;Torstai;26;14;40
623;21.09.2017;2017;09;22;Torstai;11;6;17
623;21.09.2017;2017;09;23;Torstai;10;7;17
623;22.09.2017;2017;09;00;Perjantai;3;3;6
623;22.09.2017;2017;09;01;Perjantai;4;0;4
623;22.09.2017;2017;09;02;Perjantai;2;1;3
623;22.09.2017;2017;09;03;Perjantai;1;2;3
623;22.09.2017;2017;09;04;Perjantai;1;0;1
623;22.09.2017;2017;09;05;Perjantai;1;2;3
623;22.09.2017;2017;09;06;Perjantai;2;10;12
623;22.09.2017;2017;09;07;Perjantai;6;29;35
623;22.09.2017;2017;09;08;Perjantai;42;93;135
623;22.09.2017;2017;09;09;Perjantai;50;115;165
623;22.09.2017;2017;09;10;Perjantai;44;52;96
623;22.09.2017;2017;09;11;Perjantai;40;42;82
623;22.09.2017;2017;09;12;Perjantai;38;43;81
623;22.09.2017;2017;09;13;Perjantai;54;39;93
623;22.09.2017;2017;09;14;Perjantai;68;43;111
623;22.09.2017;2017;09;15;Perjantai;74;48;122
623;22.09.2017;2017;09;16;Perjantai;80;63;143
623;22.09.2017;2017;09;17;Perjantai;88;70;158
623;22.09.2017;2017;09;18;Perjantai;49;50;99
623;22.09.2017;2017;09;19;Perjantai;56;52;108
623;22.09.2017;2017;09;20;Perjantai;40;41;81
623;22.09.2017;2017;09;21;Perjantai;28;21;49
623;22.09.2017;2017;09;22;Perjantai;19;21;40
623;22.09.2017;2017;09;23;Perjantai;18;15;33
623;23.09.2017;2017;09;00;Lauantai;9;5;14
623;23.09.2017;2017;09;01;Lauantai;22;4;26
623;23.09.2017;2017;09;02;Lauantai;10;1;11
623;23.09.2017;2017;09;03;Lauantai;17;5;22
623;23.09.2017;2017;09;04;Lauantai;3;2;5
623;23.09.2017;2017;09;05;Lauantai;3;1;4
623;23.09.2017;2017;09;06;Lauantai;1;4;5
623;23.09.2017;2017;09;07;Lauantai;5;4;9
623;23.09.2017;2017;09;08;Lauantai;5;6;11
623;23.09.2017;2017;09;09;Lauantai;2;10;12
623;23.09.2017;2017;09;10;Lauantai;5;29;34
623;23.09.2017;2017;09;11;Lauantai;16;29;45
623;23.09.2017;2017;09;12;Lauantai;24;30;54
623;23.09.2017;2017;09;13;Lauantai;30;41;71
623;23.09.2017;2017;09;14;Lauantai;20;16;36
623;23.09.2017;2017;09;15;Lauantai;26;24;50
623;23.09.2017;2017;09;16;Lauantai;40;27;67
623;23.09.2017;2017;09;17;Lauantai;16;21;37
623;23.09.2017;2017;09;18;Lauantai;32;40;72
623;23.09.2017;2017;09;19;Lauantai;23;16;39
623;23.09.2017;2017;09;20;Lauantai;24;19;43
623;23.09.2017;2017;09;21;Lauantai;22;25;47
623;23.09.2017;2017;09;22;Lauantai;16;10;26
623;23.09.2017;2017;09;23;Lauantai;11;8;19
623;24.09.2017;2017;09;00;Sunnuntai;8;9;17
623;24.09.2017;2017;09;01;Sunnuntai;10;4;14
623;24.09.2017;2017;09;02;Sunnuntai;11;3;14
623;24.09.2017;2017;09;03;Sunnuntai;8;1;9
623;24.09.2017;2017;09;04;Sunnuntai;5;2;7
623;24.09.2017;2017;09;05;Sunnuntai;4;3;7
623;24.09.2017;2017;09;06;Sunnuntai;1;1;2
623;24.09.2017;2017;09;07;Sunnuntai;2;7;9
623;24.09.2017;2017;09;08;Sunnuntai;1;0;1
623;24.09.2017;2017;09;09;Sunnuntai;4;8;12
623;24.09.2017;2017;09;10;Sunnuntai;8;12;20
623;24.09.2017;2017;09;11;Sunnuntai;11;15;26
623;24.09.2017;2017;09;12;Sunnuntai;20;20;40
623;24.09.2017;2017;09;13;Sunnuntai;22;28;50
623;24.09.2017;2017;09;14;Sunnuntai;24;24;48
623;24.09.2017;2017;09;15;Sunnuntai;23;25;48
623;24.09.2017;2017;09;16;Sunnuntai;24;31;55
623;24.09.2017;2017;09;17;Sunnuntai;31;34;65
623;24.09.2017;2017;09;18;Sunnuntai;38;34;72
623;24.09.2017;2017;09;19;Sunnuntai;26;15;41
623;24.09.2017;2017;09;20;Sunnuntai;18;20;38
623;24.09.2017;2017;09;21;Sunnuntai;17;16;33
623;24.09.2017;2017;09;22;Sunnuntai;13;7;20
623;24.09.2017;2017;09;23;Sunnuntai;3;4;7
623;25.09.2017;2017;09;00;Maanantai;6;1;7
623;25.09.2017;2017;09;01;Maanantai;4;0;4
623;25.09.2017;2017;09;02;Maanantai;0;0;0
623;25.09.2017;2017;09;03;Maanantai;0;1;1
623;25.09.2017;2017;09;04;Maanantai;1;0;1
623;25.09.2017;2017;09;05;Maanantai;0;1;1
623;25.09.2017;2017;09;06;Maanantai;3;11;14
623;25.09.2017;2017;09;07;Maanantai;12;37;49
623;25.09.2017;2017;09;08;Maanantai;60;113;173
623;25.09.2017;2017;09;09;Maanantai;76;141;217
623;25.09.2017;2017;09;10;Maanantai;41;59;100
623;25.09.2017;2017;09;11;Maanantai;30;33;63
623;25.09.2017;2017;09;12;Maanantai;34;38;72
623;25.09.2017;2017;09;13;Maanantai;48;35;83
623;25.09.2017;2017;09;14;Maanantai;56;34;90
623;25.09.2017;2017;09;15;Maanantai;64;36;100
623;25.09.2017;2017;09;16;Maanantai;112;58;170
623;25.09.2017;2017;09;17;Maanantai;144;88;232
623;25.09.2017;2017;09;18;Maanantai;64;60;124
623;25.09.2017;2017;09;19;Maanantai;46;54;100
623;25.09.2017;2017;09;20;Maanantai;40;22;62
623;25.09.2017;2017;09;21;Maanantai;34;24;58
623;25.09.2017;2017;09;22;Maanantai;18;15;33
623;25.09.2017;2017;09;23;Maanantai;6;2;8
623;26.09.2017;2017;09;00;Tiistai;3;1;4
623;26.09.2017;2017;09;01;Tiistai;2;2;4
623;26.09.2017;2017;09;02;Tiistai;1;0;1
623;26.09.2017;2017;09;03;Tiistai;3;1;4
623;26.09.2017;2017;09;04;Tiistai;2;0;2
623;26.09.2017;2017;09;05;Tiistai;1;6;7
623;26.09.2017;2017;09;06;Tiistai;2;6;8
623;26.09.2017;2017;09;07;Tiistai;7;45;52
623;26.09.2017;2017;09;08;Tiistai;64;125;189
623;26.09.2017;2017;09;09;Tiistai;65;127;192
623;26.09.2017;2017;09;10;Tiistai;42;75;117
623;26.09.2017;2017;09;11;Tiistai;33;36;69
623;26.09.2017;2017;09;12;Tiistai;35;40;75
623;26.09.2017;2017;09;13;Tiistai;38;60;98
623;26.09.2017;2017;09;14;Tiistai;66;32;98
623;26.09.2017;2017;09;15;Tiistai;81;45;126
623;26.09.2017;2017;09;16;Tiistai;92;48;140
623;26.09.2017;2017;09;17;Tiistai;107;68;175
623;26.09.2017;2017;09;18;Tiistai;66;78;144
623;26.09.2017;2017;09;19;Tiistai;59;48;107
623;26.09.2017;2017;09;20;Tiistai;47;27;74
623;26.09.2017;2017;09;21;Tiistai;29;16;45
623;26.09.2017;2017;09;22;Tiistai;33;13;46
623;26.09.2017;2017;09;23;Tiistai;8;3;11
623;27.09.2017;2017;09;00;Keskiviikko;12;2;14
623;27.09.2017;2017;09;01;Keskiviikko;1;2;3
623;27.09.2017;2017;09;02;Keskiviikko;2;0;2
623;27.09.2017;2017;09;03;Keskiviikko;1;2;3
623;27.09.2017;2017;09;04;Keskiviikko;3;2;5
623;27.09.2017;2017;09;05;Keskiviikko;1;3;4
623;27.09.2017;2017;09;06;Keskiviikko;2;8;10
623;27.09.2017;2017;09;07;Keskiviikko;8;30;38
623;27.09.2017;2017;09;08;Keskiviikko;54;120;174
623;27.09.2017;2017;09;09;Keskiviikko;76;117;193
623;27.09.2017;2017;09;10;Keskiviikko;39;70;109
623;27.09.2017;2017;09;11;Keskiviikko;38;44;82
623;27.09.2017;2017;09;12;Keskiviikko;34;36;70
623;27.09.2017;2017;09;13;Keskiviikko;37;49;86
623;27.09.2017;2017;09;14;Keskiviikko;57;35;92
623;27.09.2017;2017;09;15;Keskiviikko;80;46;126
623;27.09.2017;2017;09;16;Keskiviikko;108;52;160
623;27.09.2017;2017;09;17;Keskiviikko;113;84;197
623;27.09.2017;2017;09;18;Keskiviikko;61;66;127
623;27.09.2017;2017;09;19;Keskiviikko;39;35;74
623;27.09.2017;2017;09;20;Keskiviikko;39;24;63
623;27.09.2017;2017;09;21;Keskiviikko;40;19;59
623;27.09.2017;2017;09;22;Keskiviikko;25;14;39
623;27.09.2017;2017;09;23;Keskiviikko;9;10;19
623;28.09.2017;2017;09;00;Torstai;9;10;19
623;28.09.2017;2017;09;01;Torstai;2;2;4
623;28.09.2017;2017;09;02;Torstai;3;2;5
623;28.09.2017;2017;09;03;Torstai;2;2;4
623;28.09.2017;2017;09;04;Torstai;0;1;1
623;28.09.2017;2017;09;05;Torstai;3;2;5
623;28.09.2017;2017;09;06;Torstai;3;11;14
623;28.09.2017;2017;09;07;Torstai;5;37;42
623;28.09.2017;2017;09;08;Torstai;34;91;125
623;28.09.2017;2017;09;09;Torstai;60;125;185
623;28.09.2017;2017;09;10;Torstai;40;56;96
623;28.09.2017;2017;09;11;Torstai;21;29;50
623;28.09.2017;2017;09;12;Torstai;41;37;78
623;28.09.2017;2017;09;13;Torstai;47;40;87
623;28.09.2017;2017;09;14;Torstai;41;25;66
623;28.09.2017;2017;09;15;Torstai;79;42;121
623;28.09.2017;2017;09;16;Torstai;103;59;162
623;28.09.2017;2017;09;17;Torstai;108;78;186
623;28.09.2017;2017;09;18;Torstai;71;69;140
623;28.09.2017;2017;09;19;Torstai;44;55;99
623;28.09.2017;2017;09;20;Torstai;41;21;62
623;28.09.2017;2017;09;21;Torstai;36;17;53
623;28.09.2017;2017;09;22;Torstai;29;11;40
623;28.09.2017;2017;09;23;Torstai;12;3;15
623;29.09.2017;2017;09;00;Perjantai;5;2;7
623;29.09.2017;2017;09;01;Perjantai;5;0;5
623;29.09.2017;2017;09;02;Perjantai;4;1;5
623;29.09.2017;2017;09;03;Perjantai;2;1;3
623;29.09.2017;2017;09;04;Perjantai;0;2;2
623;29.09.2017;2017;09;05;Perjantai;2;2;4
623;29.09.2017;2017;09;06;Perjantai;1;5;6
623;29.09.2017;2017;09;07;Perjantai;6;34;40
623;29.09.2017;2017;09;08;Perjantai;44;103;147
623;29.09.2017;2017;09;09;Perjantai;57;110;167
623;29.09.2017;2017;09;10;Perjantai;41;52;93
623;29.09.2017;2017;09;11;Perjantai;19;36;55
623;29.09.2017;2017;09;12;Perjantai;40;43;83
623;29.09.2017;2017;09;13;Perjantai;47;57;104
623;29.09.2017;2017;09;14;Perjantai;48;51;99
623;29.09.2017;2017;09;15;Perjantai;106;56;162
623;29.09.2017;2017;09;16;Perjantai;99;55;154
623;29.09.2017;2017;09;17;Perjantai;89;60;149
623;29.09.2017;2017;09;18;Perjantai;50;38;88
623;29.09.2017;2017;09;19;Perjantai;34;38;72
623;29.09.2017;2017;09;20;Perjantai;27;28;55
623;29.09.2017;2017;09;21;Perjantai;25;30;55
623;29.09.2017;2017;09;22;Perjantai;12;15;27
623;29.09.2017;2017;09;23;Perjantai;22;17;39
623;30.09.2017;2017;09;00;Lauantai;7;5;12
623;30.09.2017;2017;09;01;Lauantai;10;6;16
623;30.09.2017;2017;09;02;Lauantai;16;4;20
623;30.09.2017;2017;09;03;Lauantai;6;3;9
623;30.09.2017;2017;09;04;Lauantai;6;2;8
623;30.09.2017;2017;09;05;Lauantai;5;5;10
623;30.09.2017;2017;09;06;Lauantai;2;4;6
623;30.09.2017;2017;09;07;Lauantai;3;5;8
623;30.09.2017;2017;09;08;Lauantai;2;5;7
623;30.09.2017;2017;09;09;Lauantai;8;18;26
623;30.09.2017;2017;09;10;Lauantai;9;25;34
623;30.09.2017;2017;09;11;Lauantai;9;28;37
623;30.09.2017;2017;09;12;Lauantai;17;35;52
623;30.09.2017;2017;09;13;Lauantai;28;29;57
623;30.09.2017;2017;09;14;Lauantai;21;31;52
623;30.09.2017;2017;09;15;Lauantai;34;37;71
623;30.09.2017;2017;09;16;Lauantai;34;27;61
623;30.09.2017;2017;09;17;Lauantai;29;38;67
623;30.09.2017;2017;09;18;Lauantai;30;32;62
623;30.09.2017;2017;09;19;Lauantai;24;38;62
623;30.09.2017;2017;09;20;Lauantai;29;32;61
623;30.09.2017;2017;09;21;Lauantai;18;17;35
623;30.09.2017;2017;09;22;Lauantai;18;18;36
623;30.09.2017;2017;09;23;Lauantai;24;14;38
623;01.10.2017;2017;10;00;Sunnuntai;10;4;14
623;01.10.2017;2017;10;01;Sunnuntai;11;11;22
623;01.10.2017;2017;10;02;Sunnuntai;18;1;19
623;01.10.2017;2017;10;03;Sunnuntai;3;1;4
623;01.10.2017;2017;10;04;Sunnuntai;8;1;9
623;01.10.2017;2017;10;05;Sunnuntai;8;4;12
623;01.10.2017;2017;10;06;Sunnuntai;2;1;3
623;01.10.2017;2017;10;07;Sunnuntai;2;2;4
623;01.10.2017;2017;10;08;Sunnuntai;4;7;11
623;01.10.2017;2017;10;09;Sunnuntai;5;7;12
623;01.10.2017;2017;10;10;Sunnuntai;4;15;19
623;01.10.2017;2017;10;11;Sunnuntai;4;21;25
623;01.10.2017;2017;10;12;Sunnuntai;17;25;42
623;01.10.2017;2017;10;13;Sunnuntai;24;20;44
623;01.10.2017;2017;10;14;Sunnuntai;20;28;48
623;01.10.2017;2017;10;15;Sunnuntai;18;15;33
623;01.10.2017;2017;10;16;Sunnuntai;27;17;44
623;01.10.2017;2017;10;17;Sunnuntai;34;18;52
623;01.10.2017;2017;10;18;Sunnuntai;28;25;53
623;01.10.2017;2017;10;19;Sunnuntai;35;14;49
623;01.10.2017;2017;10;20;Sunnuntai;27;12;39
623;01.10.2017;2017;10;21;Sunnuntai;13;11;24
623;01.10.2017;2017;10;22;Sunnuntai;11;9;20
623;01.10.2017;2017;10;23;Sunnuntai;6;4;10
623;02.10.2017;2017;10;00;Maanantai;6;3;9
623;02.10.2017;2017;10;01;Maanantai;3;0;3
623;02.10.2017;2017;10;02;Maanantai;3;1;4
623;02.10.2017;2017;10;03;Maanantai;1;2;3
623;02.10.2017;2017;10;04;Maanantai;0;0;0
623;02.10.2017;2017;10;05;Maanantai;2;3;5
623;02.10.2017;2017;10;06;Maanantai;3;11;14
623;02.10.2017;2017;10;07;Maanantai;8;37;45
623;02.10.2017;2017;10;08;Maanantai;49;121;170
623;02.10.2017;2017;10;09;Maanantai;75;128;203
623;02.10.2017;2017;10;10;Maanantai;49;62;111
623;02.10.2017;2017;10;11;Maanantai;30;31;61
623;02.10.2017;2017;10;12;Maanantai;36;49;85
623;02.10.2017;2017;10;13;Maanantai;54;35;89
623;02.10.2017;2017;10;14;Maanantai;50;45;95
623;02.10.2017;2017;10;15;Maanantai;66;48;114
623;02.10.2017;2017;10;16;Maanantai;99;47;146
623;02.10.2017;2017;10;17;Maanantai;132;81;213
623;02.10.2017;2017;10;18;Maanantai;81;52;133
623;02.10.2017;2017;10;19;Maanantai;37;30;67
623;02.10.2017;2017;10;20;Maanantai;46;27;73
623;02.10.2017;2017;10;21;Maanantai;32;19;51
623;02.10.2017;2017;10;22;Maanantai;28;15;43
623;02.10.2017;2017;10;23;Maanantai;4;6;10
623;03.10.2017;2017;10;00;Tiistai;3;1;4
623;03.10.2017;2017;10;01;Tiistai;0;0;0
623;03.10.2017;2017;10;02;Tiistai;0;0;0
623;03.10.2017;2017;10;03;Tiistai;5;2;7
623;03.10.2017;2017;10;04;Tiistai;0;1;1
623;03.10.2017;2017;10;05;Tiistai;1;1;2
623;03.10.2017;2017;10;06;Tiistai;3;10;13
623;03.10.2017;2017;10;07;Tiistai;3;34;37
623;03.10.2017;2017;10;08;Tiistai;46;111;157
623;03.10.2017;2017;10;09;Tiistai;54;116;170
623;03.10.2017;2017;10;10;Tiistai;53;65;118
623;03.10.2017;2017;10;11;Tiistai;20;22;42
623;03.10.2017;2017;10;12;Tiistai;33;23;56
623;03.10.2017;2017;10;13;Tiistai;41;23;64
623;03.10.2017;2017;10;14;Tiistai;37;31;68
623;03.10.2017;2017;10;15;Tiistai;73;44;117
623;03.10.2017;2017;10;16;Tiistai;81;32;113
623;03.10.2017;2017;10;17;Tiistai;104;56;160
623;03.10.2017;2017;10;18;Tiistai;49;36;85
623;03.10.2017;2017;10;19;Tiistai;30;34;64
623;03.10.2017;2017;10;20;Tiistai;29;13;42
623;03.10.2017;2017;10;21;Tiistai;26;18;44
623;03.10.2017;2017;10;22;Tiistai;21;8;29
623;03.10.2017;2017;10;23;Tiistai;11;7;18
623;04.10.2017;2017;10;00;Keskiviikko;2;3;5
623;04.10.2017;2017;10;01;Keskiviikko;5;0;5
623;04.10.2017;2017;10;02;Keskiviikko;1;0;1
623;04.10.2017;2017;10;03;Keskiviikko;1;1;2
623;04.10.2017;2017;10;04;Keskiviikko;0;1;1
623;04.10.2017;2017;10;05;Keskiviikko;0;2;2
623;04.10.2017;2017;10;06;Keskiviikko;3;8;11
623;04.10.2017;2017;10;07;Keskiviikko;7;28;35
623;04.10.2017;2017;10;08;Keskiviikko;46;97;143
623;04.10.2017;2017;10;09;Keskiviikko;60;120;180
623;04.10.2017;2017;10;10;Keskiviikko;26;62;88
623;04.10.2017;2017;10;11;Keskiviikko;18;23;41
623;04.10.2017;2017;10;12;Keskiviikko;35;29;64
623;04.10.2017;2017;10;13;Keskiviikko;35;37;72
623;04.10.2017;2017;10;14;Keskiviikko;43;30;73
623;04.10.2017;2017;10;15;Keskiviikko;72;32;104
623;04.10.2017;2017;10;16;Keskiviikko;88;38;126
623;04.10.2017;2017;10;17;Keskiviikko;108;64;172
623;04.10.2017;2017;10;18;Keskiviikko;58;45;103
623;04.10.2017;2017;10;19;Keskiviikko;40;32;72
623;04.10.2017;2017;10;20;Keskiviikko;35;19;54
623;04.10.2017;2017;10;21;Keskiviikko;22;16;38
623;04.10.2017;2017;10;22;Keskiviikko;18;6;24
623;04.10.2017;2017;10;23;Keskiviikko;4;3;7
623;05.10.2017;2017;10;00;Torstai;1;3;4
623;05.10.2017;2017;10;01;Torstai;5;3;8
623;05.10.2017;2017;10;02;Torstai;1;2;3
623;05.10.2017;2017;10;03;Torstai;1;1;2
623;05.10.2017;2017;10;04;Torstai;1;1;2
623;05.10.2017;2017;10;05;Torstai;1;2;3
623;05.10.2017;2017;10;06;Torstai;3;7;10
623;05.10.2017;2017;10;07;Torstai;7;36;43
623;05.10.2017;2017;10;08;Torstai;49;98;147
623;05.10.2017;2017;10;09;Torstai;54;131;185
623;05.10.2017;2017;10;10;Torstai;33;41;74
623;05.10.2017;2017;10;11;Torstai;20;39;59
623;05.10.2017;2017;10;12;Torstai;37;36;73
623;05.10.2017;2017;10;13;Torstai;37;33;70
623;05.10.2017;2017;10;14;Torstai;26;29;55
623;05.10.2017;2017;10;15;Torstai;73;58;131
623;05.10.2017;2017;10;16;Torstai;92;48;140
623;05.10.2017;2017;10;17;Torstai;115;70;185
623;05.10.2017;2017;10;18;Torstai;63;58;121
623;05.10.2017;2017;10;19;Torstai;51;39;90
623;05.10.2017;2017;10;20;Torstai;26;27;53
623;05.10.2017;2017;10;21;Torstai;33;20;53
623;05.10.2017;2017;10;22;Torstai;25;15;40
623;05.10.2017;2017;10;23;Torstai;7;10;17
623;06.10.2017;2017;10;00;Perjantai;4;0;4
623;06.10.2017;2017;10;01;Perjantai;0;1;1
623;06.10.2017;2017;10;02;Perjantai;2;1;3
623;06.10.2017;2017;10;03;Perjantai;0;0;0
623;06.10.2017;2017;10;04;Perjantai;1;0;1
623;06.10.2017;2017;10;05;Perjantai;2;5;7
623;06.10.2017;2017;10;06;Perjantai;1;5;6
623;06.10.2017;2017;10;07;Perjantai;6;35;41
623;06.10.2017;2017;10;08;Perjantai;30;97;127
623;06.10.2017;2017;10;09;Perjantai;55;118;173
623;06.10.2017;2017;10;10;Perjantai;40;47;87
623;06.10.2017;2017;10;11;Perjantai;17;28;45
623;06.10.2017;2017;10;12;Perjantai;50;38;88
623;06.10.2017;2017;10;13;Perjantai;50;44;94
623;06.10.2017;2017;10;14;Perjantai;47;34;81
623;06.10.2017;2017;10;15;Perjantai;87;52;139
623;06.10.2017;2017;10;16;Perjantai;84;36;120
623;06.10.2017;2017;10;17;Perjantai;69;47;116
623;06.10.2017;2017;10;18;Perjantai;41;35;76
623;06.10.2017;2017;10;19;Perjantai;29;36;65
623;06.10.2017;2017;10;20;Perjantai;27;29;56
623;06.10.2017;2017;10;21;Perjantai;29;26;55
623;06.10.2017;2017;10;22;Perjantai;19;11;30
623;06.10.2017;2017;10;23;Perjantai;7;5;12
623;07.10.2017;2017;10;00;Lauantai;15;6;21
623;07.10.2017;2017;10;01;Lauantai;6;4;10
623;07.10.2017;2017;10;02;Lauantai;8;2;10
623;07.10.2017;2017;10;03;Lauantai;4;4;8
623;07.10.2017;2017;10;04;Lauantai;2;3;5
623;07.10.2017;2017;10;05;Lauantai;1;1;2
623;07.10.2017;2017;10;06;Lauantai;1;3;4
623;07.10.2017;2017;10;07;Lauantai;1;4;5
623;07.10.2017;2017;10;08;Lauantai;3;13;16
623;07.10.2017;2017;10;09;Lauantai;6;16;22
623;07.10.2017;2017;10;10;Lauantai;9;22;31
623;07.10.2017;2017;10;11;Lauantai;9;18;27
623;07.10.2017;2017;10;12;Lauantai;25;23;48
623;07.10.2017;2017;10;13;Lauantai;6;25;31
623;07.10.2017;2017;10;14;Lauantai;21;25;46
623;07.10.2017;2017;10;15;Lauantai;34;31;65
623;07.10.2017;2017;10;16;Lauantai;30;29;59
623;07.10.2017;2017;10;17;Lauantai;31;34;65
623;07.10.2017;2017;10;18;Lauantai;20;18;38
623;07.10.2017;2017;10;19;Lauantai;25;22;47
623;07.10.2017;2017;10;20;Lauantai;31;16;47
623;07.10.2017;2017;10;21;Lauantai;28;25;53
623;07.10.2017;2017;10;22;Lauantai;12;8;20
623;07.10.2017;2017;10;23;Lauantai;10;7;17
623;08.10.2017;2017;10;00;Sunnuntai;10;3;13
623;08.10.2017;2017;10;01;Sunnuntai;12;10;22
623;08.10.2017;2017;10;02;Sunnuntai;11;2;13
623;08.10.2017;2017;10;03;Sunnuntai;6;2;8
623;08.10.2017;2017;10;04;Sunnuntai;8;2;10
623;08.10.2017;2017;10;05;Sunnuntai;2;3;5
623;08.10.2017;2017;10;06;Sunnuntai;3;2;5
623;08.10.2017;2017;10;07;Sunnuntai;1;6;7
623;08.10.2017;2017;10;08;Sunnuntai;2;4;6
623;08.10.2017;2017;10;09;Sunnuntai;3;3;6
623;08.10.2017;2017;10;10;Sunnuntai;8;15;23
623;08.10.2017;2017;10;11;Sunnuntai;9;12;21
623;08.10.2017;2017;10;12;Sunnuntai;16;24;40
623;08.10.2017;2017;10;13;Sunnuntai;21;33;54
623;08.10.2017;2017;10;14;Sunnuntai;22;31;53
623;08.10.2017;2017;10;15;Sunnuntai;31;22;53
623;08.10.2017;2017;10;16;Sunnuntai;26;27;53
623;08.10.2017;2017;10;17;Sunnuntai;22;17;39
623;08.10.2017;2017;10;18;Sunnuntai;27;32;59
623;08.10.2017;2017;10;19;Sunnuntai;31;27;58
623;08.10.2017;2017;10;20;Sunnuntai;22;18;40
623;08.10.2017;2017;10;21;Sunnuntai;16;14;30
623;08.10.2017;2017;10;22;Sunnuntai;15;6;21
623;08.10.2017;2017;10;23;Sunnuntai;7;2;9
623;09.10.2017;2017;10;00;Maanantai;4;0;4
623;09.10.2017;2017;10;01;Maanantai;1;2;3
623;09.10.2017;2017;10;02;Maanantai;1;1;2
623;09.10.2017;2017;10;03;Maanantai;0;1;1
623;09.10.2017;2017;10;04;Maanantai;1;2;3
623;09.10.2017;2017;10;05;Maanantai;0;2;2
623;09.10.2017;2017;10;06;Maanantai;2;7;9
623;09.10.2017;2017;10;07;Maanantai;10;43;53
623;09.10.2017;2017;10;08;Maanantai;41;95;136
623;09.10.2017;2017;10;09;Maanantai;66;128;194
623;09.10.2017;2017;10;10;Maanantai;40;71;111
623;09.10.2017;2017;10;11;Maanantai;37;31;68
623;09.10.2017;2017;10;12;Maanantai;33;39;72
623;09.10.2017;2017;10;13;Maanantai;54;44;98
623;09.10.2017;2017;10;14;Maanantai;51;43;94
623;09.10.2017;2017;10;15;Maanantai;82;41;123
623;09.10.2017;2017;10;16;Maanantai;92;48;140
623;09.10.2017;2017;10;17;Maanantai;129;80;209
623;09.10.2017;2017;10;18;Maanantai;58;52;110
623;09.10.2017;2017;10;19;Maanantai;49;34;83
623;09.10.2017;2017;10;20;Maanantai;35;37;72
623;09.10.2017;2017;10;21;Maanantai;31;25;56
623;09.10.2017;2017;10;22;Maanantai;25;14;39
623;09.10.2017;2017;10;23;Maanantai;8;6;14
623;10.10.2017;2017;10;00;Tiistai;5;3;8
623;10.10.2017;2017;10;01;Tiistai;2;0;2
623;10.10.2017;2017;10;02;Tiistai;2;0;2
623;10.10.2017;2017;10;03;Tiistai;1;1;2
623;10.10.2017;2017;10;04;Tiistai;0;2;2
623;10.10.2017;2017;10;05;Tiistai;0;3;3
623;10.10.2017;2017;10;06;Tiistai;2;7;9
623;10.10.2017;2017;10;07;Tiistai;7;35;42
623;10.10.2017;2017;10;08;Tiistai;31;104;135
623;10.10.2017;2017;10;09;Tiistai;47;91;138
623;10.10.2017;2017;10;10;Tiistai;26;43;69
623;10.10.2017;2017;10;11;Tiistai;17;22;39
623;10.10.2017;2017;10;12;Tiistai;26;23;49
623;10.10.2017;2017;10;13;Tiistai;28;28;56
623;10.10.2017;2017;10;14;Tiistai;19;28;47
623;10.10.2017;2017;10;15;Tiistai;52;27;79
623;10.10.2017;2017;10;16;Tiistai;74;29;103
623;10.10.2017;2017;10;17;Tiistai;85;69;154
623;10.10.2017;2017;10;18;Tiistai;35;42;77
623;10.10.2017;2017;10;19;Tiistai;41;29;70
623;10.10.2017;2017;10;20;Tiistai;27;16;43
623;10.10.2017;2017;10;21;Tiistai;23;17;40
623;10.10.2017;2017;10;22;Tiistai;20;5;25
623;10.10.2017;2017;10;23;Tiistai;7;3;10
623;11.10.2017;2017;10;00;Keskiviikko;5;4;9
623;11.10.2017;2017;10;01;Keskiviikko;3;2;5
623;11.10.2017;2017;10;02;Keskiviikko;1;0;1
623;11.10.2017;2017;10;03;Keskiviikko;3;1;4
623;11.10.2017;2017;10;04;Keskiviikko;0;1;1
623;11.10.2017;2017;10;05;Keskiviikko;0;1;1
623;11.10.2017;2017;10;06;Keskiviikko;4;14;18
623;11.10.2017;2017;10;07;Keskiviikko;8;41;49
623;11.10.2017;2017;10;08;Keskiviikko;52;109;161
623;11.10.2017;2017;10;09;Keskiviikko;79;133;212
623;11.10.2017;2017;10;10;Keskiviikko;39;75;114
623;11.10.2017;2017;10;11;Keskiviikko;24;25;49
623;11.10.2017;2017;10;12;Keskiviikko;38;35;73
623;11.10.2017;2017;10;13;Keskiviikko;46;46;92
623;11.10.2017;2017;10;14;Keskiviikko;60;28;88
623;11.10.2017;2017;10;15;Keskiviikko;75;51;126
623;11.10.2017;2017;10;16;Keskiviikko;81;35;116
623;11.10.2017;2017;10;17;Keskiviikko;124;82;206
623;11.10.2017;2017;10;18;Keskiviikko;57;58;115
623;11.10.2017;2017;10;19;Keskiviikko;21;15;36
623;11.10.2017;2017;10;20;Keskiviikko;39;22;61
623;11.10.2017;2017;10;21;Keskiviikko;30;21;51
623;11.10.2017;2017;10;22;Keskiviikko;29;14;43
623;11.10.2017;2017;10;23;Keskiviikko;6;9;15
623;12.10.2017;2017;10;00;Torstai;5;1;6
623;12.10.2017;2017;10;01;Torstai;3;1;4
623;12.10.2017;2017;10;02;Torstai;0;0;0
623;12.10.2017;2017;10;03;Torstai;1;0;1
623;12.10.2017;2017;10;04;Torstai;2;3;5
623;12.10.2017;2017;10;05;Torstai;1;0;1
623;12.10.2017;2017;10;06;Torstai;4;8;12
623;12.10.2017;2017;10;07;Torstai;5;43;48
623;12.10.2017;2017;10;08;Torstai;57;116;173
623;12.10.2017;2017;10;09;Torstai;65;118;183
623;12.10.2017;2017;10;10;Torstai;31;64;95
623;12.10.2017;2017;10;11;Torstai;26;30;56
623;12.10.2017;2017;10;12;Torstai;44;30;74
623;12.10.2017;2017;10;13;Torstai;60;41;101
623;12.10.2017;2017;10;14;Torstai;39;37;76
623;12.10.2017;2017;10;15;Torstai;79;49;128
623;12.10.2017;2017;10;16;Torstai;94;46;140
623;12.10.2017;2017;10;17;Torstai;118;72;190
623;12.10.2017;2017;10;18;Torstai;82;74;156
623;12.10.2017;2017;10;19;Torstai;49;51;100
623;12.10.2017;2017;10;20;Torstai;35;28;63
623;12.10.2017;2017;10;21;Torstai;34;21;55
623;12.10.2017;2017;10;22;Torstai;22;11;33
623;12.10.2017;2017;10;23;Torstai;13;6;19
623;13.10.2017;2017;10;00;Perjantai;3;1;4
623;13.10.2017;2017;10;01;Perjantai;6;2;8
623;13.10.2017;2017;10;02;Perjantai;1;0;1
623;13.10.2017;2017;10;03;Perjantai;0;2;2
623;13.10.2017;2017;10;04;Perjantai;3;1;4
623;13.10.2017;2017;10;05;Perjantai;0;1;1
623;13.10.2017;2017;10;06;Perjantai;2;10;12
623;13.10.2017;2017;10;07;Perjantai;8;41;49
623;13.10.2017;2017;10;08;Perjantai;40;111;151
623;13.10.2017;2017;10;09;Perjantai;55;107;162
623;13.10.2017;2017;10;10;Perjantai;39;72;111
623;13.10.2017;2017;10;11;Perjantai;20;32;52
623;13.10.2017;2017;10;12;Perjantai;32;39;71
623;13.10.2017;2017;10;13;Perjantai;43;38;81
623;13.10.2017;2017;10;14;Perjantai;45;41;86
623;13.10.2017;2017;10;15;Perjantai;99;54;153
623;13.10.2017;2017;10;16;Perjantai;106;41;147
623;13.10.2017;2017;10;17;Perjantai;84;55;139
623;13.10.2017;2017;10;18;Perjantai;48;44;92
623;13.10.2017;2017;10;19;Perjantai;41;29;70
623;13.10.2017;2017;10;20;Perjantai;32;30;62
623;13.10.2017;2017;10;21;Perjantai;27;41;68
623;13.10.2017;2017;10;22;Perjantai;20;13;33
623;13.10.2017;2017;10;23;Perjantai;11;11;22
623;14.10.2017;2017;10;00;Lauantai;13;7;20
623;14.10.2017;2017;10;01;Lauantai;11;2;13
623;14.10.2017;2017;10;02;Lauantai;9;4;13
623;14.10.2017;2017;10;03;Lauantai;11;4;15
623;14.10.2017;2017;10;04;Lauantai;7;1;8
623;14.10.2017;2017;10;05;Lauantai;4;1;5
623;14.10.2017;2017;10;06;Lauantai;3;2;5
623;14.10.2017;2017;10;07;Lauantai;2;6;8
623;14.10.2017;2017;10;08;Lauantai;2;10;12
623;14.10.2017;2017;10;09;Lauantai;2;6;8
623;14.10.2017;2017;10;10;Lauantai;8;32;40
623;14.10.2017;2017;10;11;Lauantai;12;21;33
623;14.10.2017;2017;10;12;Lauantai;26;21;47
623;14.10.2017;2017;10;13;Lauantai;24;31;55
623;14.10.2017;2017;10;14;Lauantai;37;24;61
623;14.10.2017;2017;10;15;Lauantai;29;23;52
623;14.10.2017;2017;10;16;Lauantai;38;28;66
623;14.10.2017;2017;10;17;Lauantai;26;18;44
623;14.10.2017;2017;10;18;Lauantai;17;7;24
623;14.10.2017;2017;10;19;Lauantai;10;11;21
623;14.10.2017;2017;10;20;Lauantai;14;15;29
623;14.10.2017;2017;10;21;Lauantai;9;10;19
623;14.10.2017;2017;10;22;Lauantai;14;6;20
623;14.10.2017;2017;10;23;Lauantai;3;2;5
623;15.10.2017;2017;10;00;Sunnuntai;6;4;10
623;15.10.2017;2017;10;01;Sunnuntai;5;5;10
623;15.10.2017;2017;10;02;Sunnuntai;6;0;6
623;15.10.2017;2017;10;03;Sunnuntai;3;5;8
623;15.10.2017;2017;10;04;Sunnuntai;7;0;7
623;15.10.2017;2017;10;05;Sunnuntai;3;1;4
623;15.10.2017;2017;10;06;Sunnuntai;1;0;1
623;15.10.2017;2017;10;07;Sunnuntai;2;3;5
623;15.10.2017;2017;10;08;Sunnuntai;1;2;3
623;15.10.2017;2017;10;09;Sunnuntai;3;8;11
623;15.10.2017;2017;10;10;Sunnuntai;8;6;14
623;15.10.2017;2017;10;11;Sunnuntai;3;10;13
623;15.10.2017;2017;10;12;Sunnuntai;16;28;44
623;15.10.2017;2017;10;13;Sunnuntai;18;24;42
623;15.10.2017;2017;10;14;Sunnuntai;25;34;59
623;15.10.2017;2017;10;15;Sunnuntai;25;20;45
623;15.10.2017;2017;10;16;Sunnuntai;42;33;75
623;15.10.2017;2017;10;17;Sunnuntai;30;32;62
623;15.10.2017;2017;10;18;Sunnuntai;27;21;48
623;15.10.2017;2017;10;19;Sunnuntai;15;20;35
623;15.10.2017;2017;10;20;Sunnuntai;17;14;31
623;15.10.2017;2017;10;21;Sunnuntai;22;10;32
623;15.10.2017;2017;10;22;Sunnuntai;15;14;29
623;15.10.2017;2017;10;23;Sunnuntai;6;2;8
623;16.10.2017;2017;10;00;Maanantai;2;5;7
623;16.10.2017;2017;10;01;Maanantai;3;1;4
623;16.10.2017;2017;10;02;Maanantai;1;0;1
623;16.10.2017;2017;10;03;Maanantai;3;1;4
623;16.10.2017;2017;10;04;Maanantai;1;0;1
623;16.10.2017;2017;10;05;Maanantai;0;1;1
623;16.10.2017;2017;10;06;Maanantai;2;9;11
623;16.10.2017;2017;10;07;Maanantai;10;38;48
623;16.10.2017;2017;10;08;Maanantai;41;94;135
623;16.10.2017;2017;10;09;Maanantai;57;119;176
623;16.10.2017;2017;10;10;Maanantai;23;49;72
623;16.10.2017;2017;10;11;Maanantai;20;15;35
623;16.10.2017;2017;10;12;Maanantai;23;20;43
623;16.10.2017;2017;10;13;Maanantai;34;29;63
623;16.10.2017;2017;10;14;Maanantai;29;19;48
623;16.10.2017;2017;10;15;Maanantai;54;26;80
623;16.10.2017;2017;10;16;Maanantai;69;31;100
623;16.10.2017;2017;10;17;Maanantai;95;46;141
623;16.10.2017;2017;10;18;Maanantai;54;50;104
623;16.10.2017;2017;10;19;Maanantai;30;29;59
623;16.10.2017;2017;10;20;Maanantai;27;19;46
623;16.10.2017;2017;10;21;Maanantai;30;13;43
623;16.10.2017;2017;10;22;Maanantai;16;8;24
623;16.10.2017;2017;10;23;Maanantai;7;3;10
623;17.10.2017;2017;10;00;Tiistai;4;1;5
623;17.10.2017;2017;10;01;Tiistai;0;2;2
623;17.10.2017;2017;10;02;Tiistai;1;2;3
623;17.10.2017;2017;10;03;Tiistai;0;0;0
623;17.10.2017;2017;10;04;Tiistai;0;0;0
623;17.10.2017;2017;10;05;Tiistai;0;3;3
623;17.10.2017;2017;10;06;Tiistai;1;11;12
623;17.10.2017;2017;10;07;Tiistai;7;33;40
623;17.10.2017;2017;10;08;Tiistai;40;114;154
623;17.10.2017;2017;10;09;Tiistai;63;116;179
623;17.10.2017;2017;10;10;Tiistai;36;69;105
623;17.10.2017;2017;10;11;Tiistai;25;37;62
623;17.10.2017;2017;10;12;Tiistai;36;33;69
623;17.10.2017;2017;10;13;Tiistai;39;31;70
623;17.10.2017;2017;10;14;Tiistai;38;34;72
623;17.10.2017;2017;10;15;Tiistai;84;45;129
623;17.10.2017;2017;10;16;Tiistai;95;55;150
623;17.10.2017;2017;10;17;Tiistai;123;76;199
623;17.10.2017;2017;10;18;Tiistai;74;65;139
623;17.10.2017;2017;10;19;Tiistai;36;31;67
623;17.10.2017;2017;10;20;Tiistai;33;18;51
623;17.10.2017;2017;10;21;Tiistai;27;28;55
623;17.10.2017;2017;10;22;Tiistai;24;6;30
623;17.10.2017;2017;10;23;Tiistai;9;3;12
623;18.10.2017;2017;10;00;Keskiviikko;4;2;6
623;18.10.2017;2017;10;01;Keskiviikko;9;6;15
623;18.10.2017;2017;10;02;Keskiviikko;3;2;5
623;18.10.2017;2017;10;03;Keskiviikko;8;1;9
623;18.10.2017;2017;10;04;Keskiviikko;3;1;4
623;18.10.2017;2017;10;05;Keskiviikko;2;3;5
623;18.10.2017;2017;10;06;Keskiviikko;3;8;11
623;18.10.2017;2017;10;07;Keskiviikko;5;35;40
623;18.10.2017;2017;10;08;Keskiviikko;41;107;148
623;18.10.2017;2017;10;09;Keskiviikko;56;109;165
623;18.10.2017;2017;10;10;Keskiviikko;31;57;88
623;18.10.2017;2017;10;11;Keskiviikko;16;27;43
623;18.10.2017;2017;10;12;Keskiviikko;25;32;57
623;18.10.2017;2017;10;13;Keskiviikko;39;43;82
623;18.10.2017;2017;10;14;Keskiviikko;48;33;81
623;18.10.2017;2017;10;15;Keskiviikko;82;44;126
623;18.10.2017;2017;10;16;Keskiviikko;80;53;133
623;18.10.2017;2017;10;17;Keskiviikko;89;77;166
623;18.10.2017;2017;10;18;Keskiviikko;63;62;125
623;18.10.2017;2017;10;19;Keskiviikko;38;37;75
623;18.10.2017;2017;10;20;Keskiviikko;33;17;50
623;18.10.2017;2017;10;21;Keskiviikko;25;17;42
623;18.10.2017;2017;10;22;Keskiviikko;26;18;44
623;18.10.2017;2017;10;23;Keskiviikko;8;6;14
623;19.10.2017;2017;10;00;Torstai;6;5;11
623;19.10.2017;2017;10;01;Torstai;5;3;8
623;19.10.2017;2017;10;02;Torstai;3;0;3
623;19.10.2017;2017;10;03;Torstai;2;0;2
623;19.10.2017;2017;10;04;Torstai;0;2;2
623;19.10.2017;2017;10;05;Torstai;1;3;4
623;19.10.2017;2017;10;06;Torstai;2;6;8
623;19.10.2017;2017;10;07;Torstai;6;35;41
623;19.10.2017;2017;10;08;Torstai;42;110;152
623;19.10.2017;2017;10;09;Torstai;58;121;179
623;19.10.2017;2017;10;10;Torstai;28;66;94
623;19.10.2017;2017;10;11;Torstai;17;29;46
623;19.10.2017;2017;10;12;Torstai;35;36;71
623;19.10.2017;2017;10;13;Torstai;34;23;57
623;19.10.2017;2017;10;14;Torstai;42;31;73
623;19.10.2017;2017;10;15;Torstai;62;33;95
623;19.10.2017;2017;10;16;Torstai;100;45;145
623;19.10.2017;2017;10;17;Torstai;109;57;166
623;19.10.2017;2017;10;18;Torstai;61;41;102
623;19.10.2017;2017;10;19;Torstai;37;32;69
623;19.10.2017;2017;10;20;Torstai;31;25;56
623;19.10.2017;2017;10;21;Torstai;22;15;37
623;19.10.2017;2017;10;22;Torstai;13;8;21
623;19.10.2017;2017;10;23;Torstai;9;3;12
623;20.10.2017;2017;10;00;Perjantai;11;1;12
623;20.10.2017;2017;10;01;Perjantai;2;2;4
623;20.10.2017;2017;10;02;Perjantai;4;0;4
623;20.10.2017;2017;10;03;Perjantai;2;1;3
623;20.10.2017;2017;10;04;Perjantai;1;0;1
623;20.10.2017;2017;10;05;Perjantai;2;1;3
623;20.10.2017;2017;10;06;Perjantai;3;10;13
623;20.10.2017;2017;10;07;Perjantai;4;31;35
623;20.10.2017;2017;10;08;Perjantai;30;84;114
623;20.10.2017;2017;10;09;Perjantai;47;103;150
623;20.10.2017;2017;10;10;Perjantai;26;55;81
623;20.10.2017;2017;10;11;Perjantai;20;20;40
623;20.10.2017;2017;10;12;Perjantai;15;28;43
623;20.10.2017;2017;10;13;Perjantai;27;41;68
623;20.10.2017;2017;10;14;Perjantai;36;29;65
623;20.10.2017;2017;10;15;Perjantai;64;32;96
623;20.10.2017;2017;10;16;Perjantai;63;42;105
623;20.10.2017;2017;10;17;Perjantai;52;42;94
623;20.10.2017;2017;10;18;Perjantai;43;30;73
623;20.10.2017;2017;10;19;Perjantai;28;19;47
623;20.10.2017;2017;10;20;Perjantai;14;11;25
623;20.10.2017;2017;10;21;Perjantai;11;12;23
623;20.10.2017;2017;10;22;Perjantai;9;5;14
623;20.10.2017;2017;10;23;Perjantai;7;7;14
623;21.10.2017;2017;10;00;Lauantai;4;0;4
623;21.10.2017;2017;10;01;Lauantai;8;1;9
623;21.10.2017;2017;10;02;Lauantai;3;4;7
623;21.10.2017;2017;10;03;Lauantai;2;1;3
623;21.10.2017;2017;10;04;Lauantai;2;0;2
623;21.10.2017;2017;10;05;Lauantai;1;2;3
623;21.10.2017;2017;10;06;Lauantai;2;2;4
623;21.10.2017;2017;10;07;Lauantai;0;5;5
623;21.10.2017;2017;10;08;Lauantai;1;4;5
623;21.10.2017;2017;10;09;Lauantai;2;5;7
623;21.10.2017;2017;10;10;Lauantai;7;19;26
623;21.10.2017;2017;10;11;Lauantai;7;18;25
623;21.10.2017;2017;10;12;Lauantai;12;17;29
623;21.10.2017;2017;10;13;Lauantai;13;18;31
623;21.10.2017;2017;10;14;Lauantai;24;32;56
623;21.10.2017;2017;10;15;Lauantai;19;23;42
623;21.10.2017;2017;10;16;Lauantai;24;12;36
623;21.10.2017;2017;10;17;Lauantai;7;11;18
623;21.10.2017;2017;10;18;Lauantai;21;23;44
623;21.10.2017;2017;10;19;Lauantai;16;17;33
623;21.10.2017;2017;10;20;Lauantai;17;9;26
623;21.10.2017;2017;10;21;Lauantai;8;8;16
623;21.10.2017;2017;10;22;Lauantai;10;6;16
623;21.10.2017;2017;10;23;Lauantai;16;10;26
623;22.10.2017;2017;10;00;Sunnuntai;6;1;7
623;22.10.2017;2017;10;01;Sunnuntai;2;3;5
623;22.10.2017;2017;10;02;Sunnuntai;3;3;6
623;22.10.2017;2017;10;03;Sunnuntai;2;2;4
623;22.10.2017;2017;10;04;Sunnuntai;5;0;5
623;22.10.2017;2017;10;05;Sunnuntai;2;1;3
623;22.10.2017;2017;10;06;Sunnuntai;3;2;5
623;22.10.2017;2017;10;07;Sunnuntai;1;2;3
623;22.10.2017;2017;10;08;Sunnuntai;1;2;3
623;22.10.2017;2017;10;09;Sunnuntai;2;3;5
623;22.10.2017;2017;10;10;Sunnuntai;6;5;11
623;22.10.2017;2017;10;11;Sunnuntai;10;10;20
623;22.10.2017;2017;10;12;Sunnuntai;8;19;27
623;22.10.2017;2017;10;13;Sunnuntai;19;24;43
623;22.10.2017;2017;10;14;Sunnuntai;12;18;30
623;22.10.2017;2017;10;15;Sunnuntai;25;10;35
623;22.10.2017;2017;10;16;Sunnuntai;18;12;30
623;22.10.2017;2017;10;17;Sunnuntai;20;15;35
623;22.10.2017;2017;10;18;Sunnuntai;12;19;31
623;22.10.2017;2017;10;19;Sunnuntai;17;16;33
623;22.10.2017;2017;10;20;Sunnuntai;12;6;18
623;22.10.2017;2017;10;21;Sunnuntai;13;10;23
623;22.10.2017;2017;10;22;Sunnuntai;7;9;16
623;22.10.2017;2017;10;23;Sunnuntai;4;7;11
623;23.10.2017;2017;10;00;Maanantai;2;1;3
623;23.10.2017;2017;10;01;Maanantai;2;0;2
623;23.10.2017;2017;10;02;Maanantai;2;0;2
623;23.10.2017;2017;10;03;Maanantai;0;1;1
623;23.10.2017;2017;10;04;Maanantai;0;0;0
623;23.10.2017;2017;10;05;Maanantai;0;1;1
623;23.10.2017;2017;10;06;Maanantai;1;4;5
623;23.10.2017;2017;10;07;Maanantai;5;29;34
623;23.10.2017;2017;10;08;Maanantai;17;55;72
623;23.10.2017;2017;10;09;Maanantai;22;40;62
623;23.10.2017;2017;10;10;Maanantai;13;19;32
623;23.10.2017;2017;10;11;Maanantai;22;17;39
623;23.10.2017;2017;10;12;Maanantai;17;23;40
623;23.10.2017;2017;10;13;Maanantai;25;19;44
623;23.10.2017;2017;10;14;Maanantai;20;21;41
623;23.10.2017;2017;10;15;Maanantai;28;28;56
623;23.10.2017;2017;10;16;Maanantai;30;31;61
623;23.10.2017;2017;10;17;Maanantai;71;43;114
623;23.10.2017;2017;10;18;Maanantai;30;20;50
623;23.10.2017;2017;10;19;Maanantai;23;19;42
623;23.10.2017;2017;10;20;Maanantai;10;16;26
623;23.10.2017;2017;10;21;Maanantai;12;5;17
623;23.10.2017;2017;10;22;Maanantai;11;7;18
623;23.10.2017;2017;10;23;Maanantai;7;5;12
623;24.10.2017;2017;10;00;Tiistai;1;5;6
623;24.10.2017;2017;10;01;Tiistai;4;0;4
623;24.10.2017;2017;10;02;Tiistai;0;1;1
623;24.10.2017;2017;10;03;Tiistai;2;0;2
623;24.10.2017;2017;10;04;Tiistai;0;1;1
623;24.10.2017;2017;10;05;Tiistai;0;2;2
623;24.10.2017;2017;10;06;Tiistai;1;3;4
623;24.10.2017;2017;10;07;Tiistai;5;37;42
623;24.10.2017;2017;10;08;Tiistai;30;74;104
623;24.10.2017;2017;10;09;Tiistai;28;51;79
623;24.10.2017;2017;10;10;Tiistai;19;21;40
623;24.10.2017;2017;10;11;Tiistai;18;22;40
623;24.10.2017;2017;10;12;Tiistai;25;27;52
623;24.10.2017;2017;10;13;Tiistai;31;33;64
623;24.10.2017;2017;10;14;Tiistai;27;26;53
623;24.10.2017;2017;10;15;Tiistai;37;25;62
623;24.10.2017;2017;10;16;Tiistai;53;25;78
623;24.10.2017;2017;10;17;Tiistai;54;37;91
623;24.10.2017;2017;10;18;Tiistai;51;39;90
623;24.10.2017;2017;10;19;Tiistai;22;20;42
623;24.10.2017;2017;10;20;Tiistai;22;12;34
623;24.10.2017;2017;10;21;Tiistai;18;15;33
623;24.10.2017;2017;10;22;Tiistai;12;10;22
623;24.10.2017;2017;10;23;Tiistai;7;4;11
623;25.10.2017;2017;10;00;Keskiviikko;2;0;2
623;25.10.2017;2017;10;01;Keskiviikko;5;3;8
623;25.10.2017;2017;10;02;Keskiviikko;3;0;3
623;25.10.2017;2017;10;03;Keskiviikko;1;1;2
623;25.10.2017;2017;10;04;Keskiviikko;0;1;1
623;25.10.2017;2017;10;05;Keskiviikko;0;1;1
623;25.10.2017;2017;10;06;Keskiviikko;2;7;9
623;25.10.2017;2017;10;07;Keskiviikko;6;38;44
623;25.10.2017;2017;10;08;Keskiviikko;20;54;74
623;25.10.2017;2017;10;09;Keskiviikko;22;55;77
623;25.10.2017;2017;10;10;Keskiviikko;11;24;35
623;25.10.2017;2017;10;11;Keskiviikko;22;22;44
623;25.10.2017;2017;10;12;Keskiviikko;20;25;45
623;25.10.2017;2017;10;13;Keskiviikko;23;27;50
623;25.10.2017;2017;10;14;Keskiviikko;32;31;63
623;25.10.2017;2017;10;15;Keskiviikko;36;26;62
623;25.10.2017;2017;10;16;Keskiviikko;56;28;84
623;25.10.2017;2017;10;17;Keskiviikko;40;20;60
623;25.10.2017;2017;10;18;Keskiviikko;30;20;50
623;25.10.2017;2017;10;19;Keskiviikko;11;9;20
623;25.10.2017;2017;10;20;Keskiviikko;14;10;24
623;25.10.2017;2017;10;21;Keskiviikko;19;10;29
623;25.10.2017;2017;10;22;Keskiviikko;16;5;21
623;25.10.2017;2017;10;23;Keskiviikko;7;7;14
623;26.10.2017;2017;10;00;Torstai;5;2;7
623;26.10.2017;2017;10;01;Torstai;7;4;11
623;26.10.2017;2017;10;02;Torstai;0;0;0
623;26.10.2017;2017;10;03;Torstai;0;1;1
623;26.10.2017;2017;10;04;Torstai;2;0;2
623;26.10.2017;2017;10;05;Torstai;0;1;1
623;26.10.2017;2017;10;06;Torstai;2;2;4
623;26.10.2017;2017;10;07;Torstai;3;32;35
623;26.10.2017;2017;10;08;Torstai;22;62;84
623;26.10.2017;2017;10;09;Torstai;19;38;57
623;26.10.2017;2017;10;10;Torstai;12;17;29
623;26.10.2017;2017;10;11;Torstai;12;19;31
623;26.10.2017;2017;10;12;Torstai;20;23;43
623;26.10.2017;2017;10;13;Torstai;21;22;43
623;26.10.2017;2017;10;14;Torstai;27;26;53
623;26.10.2017;2017;10;15;Torstai;37;25;62
623;26.10.2017;2017;10;16;Torstai;53;25;78
623;26.10.2017;2017;10;17;Torstai;54;37;91
623;26.10.2017;2017;10;18;Torstai;51;39;90
623;26.10.2017;2017;10;19;Torstai;22;20;42
623;26.10.2017;2017;10;20;Torstai;22;12;34
623;26.10.2017;2017;10;21;Torstai;18;15;33
623;26.10.2017;2017;10;22;Torstai;12;10;22
623;26.10.2017;2017;10;23;Torstai;7;4;11
623;27.10.2017;2017;10;00;Perjantai;11;1;12
623;27.10.2017;2017;10;01;Perjantai;2;2;4
623;27.10.2017;2017;10;02;Perjantai;4;0;4
623;27.10.2017;2017;10;03;Perjantai;2;1;3
623;27.10.2017;2017;10;04;Perjantai;1;0;1
623;27.10.2017;2017;10;05;Perjantai;2;1;3
623;27.10.2017;2017;10;06;Perjantai;3;10;13
623;27.10.2017;2017;10;07;Perjantai;4;31;35
623;27.10.2017;2017;10;08;Perjantai;30;84;114
623;27.10.2017;2017;10;09;Perjantai;47;103;150
623;27.10.2017;2017;10;10;Perjantai;26;55;81
623;27.10.2017;2017;10;11;Perjantai;20;20;40
623;27.10.2017;2017;10;12;Perjantai;15;28;43
623;27.10.2017;2017;10;13;Perjantai;27;41;68
623;27.10.2017;2017;10;14;Perjantai;36;29;65
623;27.10.2017;2017;10;15;Perjantai;64;32;96
623;27.10.2017;2017;10;16;Perjantai;63;42;105
623;27.10.2017;2017;10;17;Perjantai;52;42;94
623;27.10.2017;2017;10;18;Perjantai;25;22;47
623;27.10.2017;2017;10;19;Perjantai;16;18;34
623;27.10.2017;2017;10;20;Perjantai;16;11;27
623;27.10.2017;2017;10;21;Perjantai;12;20;32
623;27.10.2017;2017;10;22;Perjantai;20;7;27
623;27.10.2017;2017;10;23;Perjantai;9;9;18
623;28.10.2017;2017;10;00;Lauantai;4;5;9
623;28.10.2017;2017;10;01;Lauantai;5;3;8
623;28.10.2017;2017;10;02;Lauantai;8;1;9
623;28.10.2017;2017;10;03;Lauantai;4;0;4
623;28.10.2017;2017;10;04;Lauantai;2;1;3
623;28.10.2017;2017;10;05;Lauantai;2;2;4
623;28.10.2017;2017;10;06;Lauantai;5;2;7
623;28.10.2017;2017;10;07;Lauantai;1;1;2
623;28.10.2017;2017;10;08;Lauantai;2;1;3
623;28.10.2017;2017;10;09;Lauantai;1;5;6
623;28.10.2017;2017;10;10;Lauantai;5;17;22
623;28.10.2017;2017;10;11;Lauantai;10;13;23
623;28.10.2017;2017;10;12;Lauantai;5;13;18
623;28.10.2017;2017;10;13;Lauantai;16;17;33
623;28.10.2017;2017;10;14;Lauantai;16;12;28
623;28.10.2017;2017;10;15;Lauantai;18;7;25
623;28.10.2017;2017;10;16;Lauantai;9;9;18
623;28.10.2017;2017;10;17;Lauantai;15;15;30
623;28.10.2017;2017;10;18;Lauantai;11;5;16
623;28.10.2017;2017;10;19;Lauantai;15;16;31
623;28.10.2017;2017;10;20;Lauantai;10;8;18
623;28.10.2017;2017;10;21;Lauantai;4;4;8
623;28.10.2017;2017;10;22;Lauantai;10;5;15
623;28.10.2017;2017;10;23;Lauantai;3;5;8
623;29.10.2017;2017;10;00;Sunnuntai;5;2;7
623;29.10.2017;2017;10;01;Sunnuntai;4;0;4
623;29.10.2017;2017;10;02;Sunnuntai;3;3;6
623;29.10.2017;2017;10;03;Sunnuntai;0;0;0
623;29.10.2017;2017;10;04;Sunnuntai;6;1;7
623;29.10.2017;2017;10;05;Sunnuntai;4;1;5
623;29.10.2017;2017;10;06;Sunnuntai;0;1;1
623;29.10.2017;2017;10;07;Sunnuntai;1;5;6
623;29.10.2017;2017;10;08;Sunnuntai;0;1;1
623;29.10.2017;2017;10;09;Sunnuntai;2;1;3
623;29.10.2017;2017;10;10;Sunnuntai;4;6;10
623;29.10.2017;2017;10;11;Sunnuntai;2;7;9
623;29.10.2017;2017;10;12;Sunnuntai;9;13;22
623;29.10.2017;2017;10;13;Sunnuntai;10;8;18
623;29.10.2017;2017;10;14;Sunnuntai;8;15;23
623;29.10.2017;2017;10;15;Sunnuntai;5;9;14
623;29.10.2017;2017;10;16;Sunnuntai;16;8;24
623;29.10.2017;2017;10;17;Sunnuntai;7;10;17
623;29.10.2017;2017;10;18;Sunnuntai;7;8;15
623;29.10.2017;2017;10;19;Sunnuntai;14;4;18
623;29.10.2017;2017;10;20;Sunnuntai;7;6;13
623;29.10.2017;2017;10;21;Sunnuntai;5;3;8
623;29.10.2017;2017;10;22;Sunnuntai;12;4;16
623;29.10.2017;2017;10;23;Sunnuntai;3;3;6
623;30.10.2017;2017;10;00;Maanantai;4;0;4
623;30.10.2017;2017;10;01;Maanantai;2;0;2
623;30.10.2017;2017;10;02;Maanantai;0;0;0
623;30.10.2017;2017;10;03;Maanantai;1;1;2
623;30.10.2017;2017;10;04;Maanantai;1;3;4
623;30.10.2017;2017;10;05;Maanantai;0;1;1
623;30.10.2017;2017;10;06;Maanantai;1;7;8
623;30.10.2017;2017;10;07;Maanantai;5;26;31
623;30.10.2017;2017;10;08;Maanantai;37;66;103
623;30.10.2017;2017;10;09;Maanantai;35;70;105
623;30.10.2017;2017;10;10;Maanantai;12;16;28
623;30.10.2017;2017;10;11;Maanantai;3;3;6
623;30.10.2017;2017;10;12;Maanantai;31;23;54
623;30.10.2017;2017;10;13;Maanantai;21;24;45
623;30.10.2017;2017;10;14;Maanantai;0;0;0
623;30.10.2017;2017;10;15;Maanantai;35;29;64
623;30.10.2017;2017;10;16;Maanantai;64;37;101
623;30.10.2017;2017;10;17;Maanantai;76;45;121
623;30.10.2017;2017;10;18;Maanantai;41;42;83
623;30.10.2017;2017;10;19;Maanantai;23;26;49
623;30.10.2017;2017;10;20;Maanantai;23;16;39
623;30.10.2017;2017;10;21;Maanantai;14;14;28
623;30.10.2017;2017;10;22;Maanantai;11;10;21
623;30.10.2017;2017;10;23;Maanantai;3;2;5
623;31.10.2017;2017;10;00;Tiistai;6;0;6
623;31.10.2017;2017;10;01;Tiistai;3;0;3
623;31.10.2017;2017;10;02;Tiistai;1;0;1
623;31.10.2017;2017;10;03;Tiistai;1;2;3
623;31.10.2017;2017;10;04;Tiistai;1;2;3
623;31.10.2017;2017;10;05;Tiistai;1;2;3
623;31.10.2017;2017;10;06;Tiistai;1;4;5
623;31.10.2017;2017;10;07;Tiistai;5;30;35
623;31.10.2017;2017;10;08;Tiistai;26;75;101
623;31.10.2017;2017;10;09;Tiistai;47;75;122
623;31.10.2017;2017;10;10;Tiistai;28;34;62
623;31.10.2017;2017;10;11;Tiistai;24;26;50
623;31.10.2017;2017;10;12;Tiistai;34;18;52
623;31.10.2017;2017;10;13;Tiistai;19;23;42
623;31.10.2017;2017;10;14;Tiistai;33;23;56
623;31.10.2017;2017;10;15;Tiistai;48;45;93
623;31.10.2017;2017;10;16;Tiistai;68;27;95
623;31.10.2017;2017;10;17;Tiistai;80;57;137
623;31.10.2017;2017;10;18;Tiistai;39;33;72
623;31.10.2017;2017;10;19;Tiistai;25;24;49
623;31.10.2017;2017;10;20;Tiistai;15;17;32
623;31.10.2017;2017;10;21;Tiistai;16;11;27
623;31.10.2017;2017;10;22;Tiistai;24;10;34
623;31.10.2017;2017;10;23;Tiistai;8;3;11
623;01.11.2017;2017;11;00;Keskiviikko;1;5;6
623;01.11.2017;2017;11;01;Keskiviikko;2;1;3
623;01.11.2017;2017;11;02;Keskiviikko;1;1;2
623;01.11.2017;2017;11;03;Keskiviikko;0;1;1
623;01.11.2017;2017;11;04;Keskiviikko;0;4;4
623;01.11.2017;2017;11;05;Keskiviikko;1;3;4
623;01.11.2017;2017;11;06;Keskiviikko;1;6;7
623;01.11.2017;2017;11;07;Keskiviikko;3;33;36
623;01.11.2017;2017;11;08;Keskiviikko;31;67;98
623;01.11.2017;2017;11;09;Keskiviikko;36;81;117
623;01.11.2017;2017;11;10;Keskiviikko;22;23;45
623;01.11.2017;2017;11;11;Keskiviikko;20;23;43
623;01.11.2017;2017;11;12;Keskiviikko;28;14;42
623;01.11.2017;2017;11;13;Keskiviikko;14;20;34
623;01.11.2017;2017;11;14;Keskiviikko;26;21;47
623;01.11.2017;2017;11;15;Keskiviikko;44;26;70
623;01.11.2017;2017;11;16;Keskiviikko;50;33;83
623;01.11.2017;2017;11;17;Keskiviikko;74;52;126
623;01.11.2017;2017;11;18;Keskiviikko;34;27;61
623;01.11.2017;2017;11;19;Keskiviikko;13;21;34
623;01.11.2017;2017;11;20;Keskiviikko;27;14;41
623;01.11.2017;2017;11;21;Keskiviikko;17;10;27
623;01.11.2017;2017;11;22;Keskiviikko;7;1;8
623;01.11.2017;2017;11;23;Keskiviikko;6;4;10
623;02.11.2017;2017;11;00;Torstai;4;1;5
623;02.11.2017;2017;11;01;Torstai;1;1;2
623;02.11.2017;2017;11;02;Torstai;1;1;2
623;02.11.2017;2017;11;03;Torstai;1;1;2
623;02.11.2017;2017;11;04;Torstai;2;2;4
623;02.11.2017;2017;11;05;Torstai;0;4;4
623;02.11.2017;2017;11;06;Torstai;1;4;5
623;02.11.2017;2017;11;07;Torstai;5;23;28
623;02.11.2017;2017;11;08;Torstai;28;73;101
623;02.11.2017;2017;11;09;Torstai;42;71;113
623;02.11.2017;2017;11;10;Torstai;21;31;52
623;02.11.2017;2017;11;11;Torstai;8;19;27
623;02.11.2017;2017;11;12;Torstai;14;28;42
623;02.11.2017;2017;11;13;Torstai;31;31;62
623;02.11.2017;2017;11;14;Torstai;34;17;51
623;02.11.2017;2017;11;15;Torstai;36;36;72
623;02.11.2017;2017;11;16;Torstai;53;16;69
623;02.11.2017;2017;11;17;Torstai;75;42;117
623;02.11.2017;2017;11;18;Torstai;37;28;65
623;02.11.2017;2017;11;19;Torstai;36;28;64
623;02.11.2017;2017;11;20;Torstai;15;11;26
623;02.11.2017;2017;11;21;Torstai;26;10;36
623;02.11.2017;2017;11;22;Torstai;14;8;22
623;02.11.2017;2017;11;23;Torstai;5;9;14
623;03.11.2017;2017;11;00;Perjantai;3;0;3
623;03.11.2017;2017;11;01;Perjantai;2;3;5
623;03.11.2017;2017;11;02;Perjantai;2;2;4
623;03.11.2017;2017;11;03;Perjantai;1;0;1
623;03.11.2017;2017;11;04;Perjantai;1;2;3
623;03.11.2017;2017;11;05;Perjantai;2;4;6
623;03.11.2017;2017;11;06;Perjantai;2;8;10
623;03.11.2017;2017;11;07;Perjantai;4;23;27
623;03.11.2017;2017;11;08;Perjantai;28;76;104
623;03.11.2017;2017;11;09;Perjantai;32;71;103
623;03.11.2017;2017;11;10;Perjantai;16;33;49
623;03.11.2017;2017;11;11;Perjantai;18;16;34
623;03.11.2017;2017;11;12;Perjantai;2;9;11
623;03.11.2017;2017;11;13;Perjantai;0;0;0
623;03.11.2017;2017;11;14;Perjantai;0;0;0
623;03.11.2017;2017;11;15;Perjantai;24;25;49
623;03.11.2017;2017;11;16;Perjantai;51;27;78
623;03.11.2017;2017;11;17;Perjantai;55;31;86
623;03.11.2017;2017;11;18;Perjantai;28;28;56
623;03.11.2017;2017;11;19;Perjantai;23;25;48
623;03.11.2017;2017;11;20;Perjantai;19;11;30
623;03.11.2017;2017;11;21;Perjantai;13;16;29
623;03.11.2017;2017;11;22;Perjantai;9;4;13
623;03.11.2017;2017;11;23;Perjantai;13;8;21
623;04.11.2017;2017;11;00;Lauantai;10;3;13
623;04.11.2017;2017;11;01;Lauantai;8;8;16
623;04.11.2017;2017;11;02;Lauantai;7;2;9
623;04.11.2017;2017;11;03;Lauantai;4;2;6
623;04.11.2017;2017;11;04;Lauantai;2;0;2
623;04.11.2017;2017;11;05;Lauantai;0;1;1
623;04.11.2017;2017;11;06;Lauantai;0;0;0
623;04.11.2017;2017;11;07;Lauantai;2;3;5
623;04.11.2017;2017;11;08;Lauantai;1;4;5
623;04.11.2017;2017;11;09;Lauantai;2;6;8
623;04.11.2017;2017;11;10;Lauantai;6;14;20
623;04.11.2017;2017;11;11;Lauantai;9;8;17
623;04.11.2017;2017;11;12;Lauantai;16;14;30
623;04.11.2017;2017;11;13;Lauantai;10;17;27
623;04.11.2017;2017;11;14;Lauantai;18;20;38
623;04.11.2017;2017;11;15;Lauantai;9;15;24
623;04.11.2017;2017;11;16;Lauantai;11;25;36
623;04.11.2017;2017;11;17;Lauantai;14;23;37
623;04.11.2017;2017;11;18;Lauantai;17;12;29
623;04.11.2017;2017;11;19;Lauantai;13;10;23
623;04.11.2017;2017;11;20;Lauantai;13;11;24
623;04.11.2017;2017;11;21;Lauantai;11;14;25
623;04.11.2017;2017;11;22;Lauantai;14;8;22
623;04.11.2017;2017;11;23;Lauantai;10;8;18
623;05.11.2017;2017;11;00;Sunnuntai;8;7;15
623;05.11.2017;2017;11;01;Sunnuntai;3;4;7
623;05.11.2017;2017;11;02;Sunnuntai;4;3;7
623;05.11.2017;2017;11;03;Sunnuntai;5;0;5
623;05.11.2017;2017;11;04;Sunnuntai;2;0;2
623;05.11.2017;2017;11;05;Sunnuntai;7;0;7
623;05.11.2017;2017;11;06;Sunnuntai;1;0;1
623;05.11.2017;2017;11;07;Sunnuntai;0;2;2
623;05.11.2017;2017;11;08;Sunnuntai;1;1;2
623;05.11.2017;2017;11;09;Sunnuntai;2;3;5
623;05.11.2017;2017;11;10;Sunnuntai;3;11;14
623;05.11.2017;2017;11;11;Sunnuntai;5;9;14
623;05.11.2017;2017;11;12;Sunnuntai;3;22;25
623;05.11.2017;2017;11;13;Sunnuntai;11;16;27
623;05.11.2017;2017;11;14;Sunnuntai;13;18;31
623;05.11.2017;2017;11;15;Sunnuntai;17;17;34
623;05.11.2017;2017;11;16;Sunnuntai;18;16;34
623;05.11.2017;2017;11;17;Sunnuntai;17;12;29
623;05.11.2017;2017;11;18;Sunnuntai;20;17;37
623;05.11.2017;2017;11;19;Sunnuntai;11;7;18
623;05.11.2017;2017;11;20;Sunnuntai;12;6;18
623;05.11.2017;2017;11;21;Sunnuntai;3;5;8
623;05.11.2017;2017;11;22;Sunnuntai;6;2;8
623;05.11.2017;2017;11;23;Sunnuntai;5;1;6
623;06.11.2017;2017;11;00;Maanantai;3;1;4
623;06.11.2017;2017;11;01;Maanantai;1;0;1
623;06.11.2017;2017;11;02;Maanantai;2;0;2
623;06.11.2017;2017;11;03;Maanantai;2;1;3
623;06.11.2017;2017;11;04;Maanantai;0;0;0
623;06.11.2017;2017;11;05;Maanantai;0;1;1
623;06.11.2017;2017;11;06;Maanantai;0;5;5
623;06.11.2017;2017;11;07;Maanantai;5;32;37
623;06.11.2017;2017;11;08;Maanantai;33;79;112
623;06.11.2017;2017;11;09;Maanantai;27;85;112
623;06.11.2017;2017;11;10;Maanantai;23;50;73
623;06.11.2017;2017;11;11;Maanantai;16;24;40
623;06.11.2017;2017;11;12;Maanantai;38;29;67
623;06.11.2017;2017;11;13;Maanantai;36;30;66
623;06.11.2017;2017;11;14;Maanantai;35;28;63
623;06.11.2017;2017;11;15;Maanantai;48;32;80
623;06.11.2017;2017;11;16;Maanantai;60;21;81
623;06.11.2017;2017;11;17;Maanantai;87;47;134
623;06.11.2017;2017;11;18;Maanantai;51;38;89
623;06.11.2017;2017;11;19;Maanantai;30;21;51
623;06.11.2017;2017;11;20;Maanantai;24;17;41
623;06.11.2017;2017;11;21;Maanantai;21;10;31
623;06.11.2017;2017;11;22;Maanantai;21;7;28
623;06.11.2017;2017;11;23;Maanantai;7;1;8
623;07.11.2017;2017;11;00;Tiistai;6;2;8
623;07.11.2017;2017;11;01;Tiistai;3;1;4
623;07.11.2017;2017;11;02;Tiistai;0;0;0
623;07.11.2017;2017;11;03;Tiistai;2;1;3
623;07.11.2017;2017;11;04;Tiistai;0;2;2
623;07.11.2017;2017;11;05;Tiistai;2;3;5
623;07.11.2017;2017;11;06;Tiistai;0;6;6
623;07.11.2017;2017;11;07;Tiistai;6;46;52
623;07.11.2017;2017;11;08;Tiistai;43;77;120
623;07.11.2017;2017;11;09;Tiistai;44;102;146
623;07.11.2017;2017;11;10;Tiistai;26;44;70
623;07.11.2017;2017;11;11;Tiistai;17;15;32
623;07.11.2017;2017;11;12;Tiistai;40;35;75
623;07.11.2017;2017;11;13;Tiistai;28;35;63
623;07.11.2017;2017;11;14;Tiistai;43;24;67
623;07.11.2017;2017;11;15;Tiistai;60;68;128
623;07.11.2017;2017;11;16;Tiistai;72;34;106
623;07.11.2017;2017;11;17;Tiistai;84;53;137
623;07.11.2017;2017;11;18;Tiistai;50;43;93
623;07.11.2017;2017;11;19;Tiistai;34;27;61
623;07.11.2017;2017;11;20;Tiistai;35;12;47
623;07.11.2017;2017;11;21;Tiistai;22;11;33
623;07.11.2017;2017;11;22;Tiistai;24;15;39
623;07.11.2017;2017;11;23;Tiistai;5;0;5
623;08.11.2017;2017;11;00;Keskiviikko;6;5;11
623;08.11.2017;2017;11;01;Keskiviikko;3;1;4
623;08.11.2017;2017;11;02;Keskiviikko;1;0;1
623;08.11.2017;2017;11;03;Keskiviikko;1;1;2
623;08.11.2017;2017;11;04;Keskiviikko;1;1;2
623;08.11.2017;2017;11;05;Keskiviikko;0;4;4
623;08.11.2017;2017;11;06;Keskiviikko;0;7;7
623;08.11.2017;2017;11;07;Keskiviikko;14;38;52
623;08.11.2017;2017;11;08;Keskiviikko;34;80;114
623;08.11.2017;2017;11;09;Keskiviikko;60;90;150
623;08.11.2017;2017;11;10;Keskiviikko;25;56;81
623;08.11.2017;2017;11;11;Keskiviikko;21;28;49
623;08.11.2017;2017;11;12;Keskiviikko;26;34;60
623;08.11.2017;2017;11;13;Keskiviikko;31;36;67
623;08.11.2017;2017;11;14;Keskiviikko;26;25;51
623;08.11.2017;2017;11;15;Keskiviikko;67;37;104
623;08.11.2017;2017;11;16;Keskiviikko;51;37;88
623;08.11.2017;2017;11;17;Keskiviikko;72;46;118
623;08.11.2017;2017;11;18;Keskiviikko;44;45;89
623;08.11.2017;2017;11;19;Keskiviikko;31;25;56
623;08.11.2017;2017;11;20;Keskiviikko;39;26;65
623;08.11.2017;2017;11;21;Keskiviikko;14;17;31
623;08.11.2017;2017;11;22;Keskiviikko;26;8;34
623;08.11.2017;2017;11;23;Keskiviikko;5;7;12
623;09.11.2017;2017;11;00;Torstai;3;3;6
623;09.11.2017;2017;11;01;Torstai;4;0;4
623;09.11.2017;2017;11;02;Torstai;5;0;5
623;09.11.2017;2017;11;03;Torstai;1;1;2
623;09.11.2017;2017;11;04;Torstai;2;2;4
623;09.11.2017;2017;11;05;Torstai;1;2;3
623;09.11.2017;2017;11;06;Torstai;0;5;5
623;09.11.2017;2017;11;07;Torstai;12;36;48
623;09.11.2017;2017;11;08;Torstai;49;85;134
623;09.11.2017;2017;11;09;Torstai;46;93;139
623;09.11.2017;2017;11;10;Torstai;29;46;75
623;09.11.2017;2017;11;11;Torstai;24;28;52
623;09.11.2017;2017;11;12;Torstai;22;26;48
623;09.11.2017;2017;11;13;Torstai;26;33;59
623;09.11.2017;2017;11;14;Torstai;30;25;55
623;09.11.2017;2017;11;15;Torstai;51;42;93
623;09.11.2017;2017;11;16;Torstai;85;38;123
623;09.11.2017;2017;11;17;Torstai;93;42;135
623;09.11.2017;2017;11;18;Torstai;48;47;95
623;09.11.2017;2017;11;19;Torstai;36;23;59
623;09.11.2017;2017;11;20;Torstai;22;14;36
623;09.11.2017;2017;11;21;Torstai;29;10;39
623;09.11.2017;2017;11;22;Torstai;19;3;22
623;09.11.2017;2017;11;23;Torstai;9;10;19
623;10.11.2017;2017;11;00;Perjantai;4;1;5
623;10.11.2017;2017;11;01;Perjantai;2;2;4
623;10.11.2017;2017;11;02;Perjantai;0;0;0
623;10.11.2017;2017;11;03;Perjantai;2;2;4
623;10.11.2017;2017;11;04;Perjantai;5;1;6
623;10.11.2017;2017;11;05;Perjantai;0;5;5
623;10.11.2017;2017;11;06;Perjantai;3;7;10
623;10.11.2017;2017;11;07;Perjantai;6;39;45
623;10.11.2017;2017;11;08;Perjantai;37;82;119
623;10.11.2017;2017;11;09;Perjantai;40;88;128
623;10.11.2017;2017;11;10;Perjantai;27;50;77
623;10.11.2017;2017;11;11;Perjantai;21;26;47
623;10.11.2017;2017;11;12;Perjantai;34;20;54
623;10.11.2017;2017;11;13;Perjantai;32;35;67
623;10.11.2017;2017;11;14;Perjantai;34;34;68
623;10.11.2017;2017;11;15;Perjantai;70;33;103
623;10.11.2017;2017;11;16;Perjantai;70;47;117
623;10.11.2017;2017;11;17;Perjantai;62;45;107
623;10.11.2017;2017;11;18;Perjantai;39;44;83
623;10.11.2017;2017;11;19;Perjantai;27;20;47
623;10.11.2017;2017;11;20;Perjantai;18;16;34
623;10.11.2017;2017;11;21;Perjantai;18;14;32
623;10.11.2017;2017;11;22;Perjantai;15;5;20
623;10.11.2017;2017;11;23;Perjantai;9;7;16
623;11.11.2017;2017;11;00;Lauantai;16;10;26
623;11.11.2017;2017;11;01;Lauantai;7;5;12
623;11.11.2017;2017;11;02;Lauantai;7;3;10
623;11.11.2017;2017;11;03;Lauantai;9;3;12
623;11.11.2017;2017;11;04;Lauantai;4;2;6
623;11.11.2017;2017;11;05;Lauantai;8;3;11
623;11.11.2017;2017;11;06;Lauantai;4;1;5
623;11.11.2017;2017;11;07;Lauantai;1;9;10
623;11.11.2017;2017;11;08;Lauantai;4;9;13
623;11.11.2017;2017;11;09;Lauantai;2;8;10
623;11.11.2017;2017;11;10;Lauantai;1;23;24
623;11.11.2017;2017;11;11;Lauantai;11;25;36
623;11.11.2017;2017;11;12;Lauantai;16;27;43
623;11.11.2017;2017;11;13;Lauantai;29;33;62
623;11.11.2017;2017;11;14;Lauantai;26;27;53
623;11.11.2017;2017;11;15;Lauantai;22;19;41
623;11.11.2017;2017;11;16;Lauantai;25;17;42
623;11.11.2017;2017;11;17;Lauantai;23;24;47
623;11.11.2017;2017;11;18;Lauantai;22;19;41
623;11.11.2017;2017;11;19;Lauantai;18;13;31
623;11.11.2017;2017;11;20;Lauantai;16;17;33
623;11.11.2017;2017;11;21;Lauantai;20;17;37
623;11.11.2017;2017;11;22;Lauantai;10;5;15
623;11.11.2017;2017;11;23;Lauantai;19;5;24
623;12.11.2017;2017;11;00;Sunnuntai;12;2;14
623;12.11.2017;2017;11;01;Sunnuntai;5;5;10
623;12.11.2017;2017;11;02;Sunnuntai;5;0;5
623;12.11.2017;2017;11;03;Sunnuntai;1;2;3
623;12.11.2017;2017;11;04;Sunnuntai;2;1;3
623;12.11.2017;2017;11;05;Sunnuntai;7;0;7
623;12.11.2017;2017;11;06;Sunnuntai;2;1;3
623;12.11.2017;2017;11;07;Sunnuntai;1;3;4
623;12.11.2017;2017;11;08;Sunnuntai;4;3;7
623;12.11.2017;2017;11;09;Sunnuntai;1;5;6
623;12.11.2017;2017;11;10;Sunnuntai;7;17;24
623;12.11.2017;2017;11;11;Sunnuntai;5;13;18
623;12.11.2017;2017;11;12;Sunnuntai;14;22;36
623;12.11.2017;2017;11;13;Sunnuntai;15;11;26
623;12.11.2017;2017;11;14;Sunnuntai;15;15;30
623;12.11.2017;2017;11;15;Sunnuntai;23;17;40
623;12.11.2017;2017;11;16;Sunnuntai;24;13;37
623;12.11.2017;2017;11;17;Sunnuntai;16;18;34
623;12.11.2017;2017;11;18;Sunnuntai;9;12;21
623;12.11.2017;2017;11;19;Sunnuntai;13;12;25
623;12.11.2017;2017;11;20;Sunnuntai;10;9;19
623;12.11.2017;2017;11;21;Sunnuntai;9;4;13
623;12.11.2017;2017;11;22;Sunnuntai;12;8;20
623;12.11.2017;2017;11;23;Sunnuntai;5;3;8
623;13.11.2017;2017;11;00;Maanantai;0;3;3
623;13.11.2017;2017;11;01;Maanantai;0;0;0
623;13.11.2017;2017;11;02;Maanantai;0;0;0
623;13.11.2017;2017;11;03;Maanantai;2;1;3
623;13.11.2017;2017;11;04;Maanantai;3;1;4
623;13.11.2017;2017;11;05;Maanantai;2;3;5
623;13.11.2017;2017;11;06;Maanantai;0;7;7
623;13.11.2017;2017;11;07;Maanantai;8;37;45
623;13.11.2017;2017;11;08;Maanantai;38;89;127
623;13.11.2017;2017;11;09;Maanantai;39;81;120
623;13.11.2017;2017;11;10;Maanantai;36;52;88
623;13.11.2017;2017;11;11;Maanantai;27;24;51
623;13.11.2017;2017;11;12;Maanantai;26;20;46
623;13.11.2017;2017;11;13;Maanantai;38;26;64
623;13.11.2017;2017;11;14;Maanantai;45;27;72
623;13.11.2017;2017;11;15;Maanantai;54;23;77
623;13.11.2017;2017;11;16;Maanantai;70;30;100
623;13.11.2017;2017;11;17;Maanantai;89;61;150
623;13.11.2017;2017;11;18;Maanantai;44;44;88
623;13.11.2017;2017;11;19;Maanantai;32;25;57
623;13.11.2017;2017;11;20;Maanantai;22;14;36
623;13.11.2017;2017;11;21;Maanantai;18;15;33
623;13.11.2017;2017;11;22;Maanantai;8;11;19
623;13.11.2017;2017;11;23;Maanantai;5;4;9
623;14.11.2017;2017;11;00;Tiistai;1;2;3
623;14.11.2017;2017;11;01;Tiistai;1;0;1
623;14.11.2017;2017;11;02;Tiistai;0;0;0
623;14.11.2017;2017;11;03;Tiistai;1;1;2
623;14.11.2017;2017;11;04;Tiistai;1;2;3
623;14.11.2017;2017;11;05;Tiistai;1;3;4
623;14.11.2017;2017;11;06;Tiistai;2;7;9
623;14.11.2017;2017;11;07;Tiistai;4;37;41
623;14.11.2017;2017;11;08;Tiistai;46;92;138
623;14.11.2017;2017;11;09;Tiistai;55;106;161
623;14.11.2017;2017;11;10;Tiistai;36;40;76
623;14.11.2017;2017;11;11;Tiistai;19;26;45
623;14.11.2017;2017;11;12;Tiistai;34;22;56
623;14.11.2017;2017;11;13;Tiistai;40;29;69
623;14.11.2017;2017;11;14;Tiistai;38;28;66
623;14.11.2017;2017;11;15;Tiistai;49;36;85
623;14.11.2017;2017;11;16;Tiistai;63;35;98
623;14.11.2017;2017;11;17;Tiistai;95;57;152
623;14.11.2017;2017;11;18;Tiistai;51;47;98
623;14.11.2017;2017;11;19;Tiistai;34;28;62
623;14.11.2017;2017;11;20;Tiistai;24;16;40
623;14.11.2017;2017;11;21;Tiistai;21;15;36
623;14.11.2017;2017;11;22;Tiistai;18;6;24
623;14.11.2017;2017;11;23;Tiistai;7;4;11
623;15.11.2017;2017;11;00;Keskiviikko;5;2;7
623;15.11.2017;2017;11;01;Keskiviikko;1;0;1
623;15.11.2017;2017;11;02;Keskiviikko;2;0;2
623;15.11.2017;2017;11;03;Keskiviikko;2;3;5
623;15.11.2017;2017;11;04;Keskiviikko;2;1;3
623;15.11.2017;2017;11;05;Keskiviikko;0;5;5
623;15.11.2017;2017;11;06;Keskiviikko;1;6;7
623;15.11.2017;2017;11;07;Keskiviikko;9;37;46
623;15.11.2017;2017;11;08;Keskiviikko;39;80;119
623;15.11.2017;2017;11;09;Keskiviikko;52;94;146
623;15.11.2017;2017;11;10;Keskiviikko;34;44;78
623;15.11.2017;2017;11;11;Keskiviikko;18;25;43
623;15.11.2017;2017;11;12;Keskiviikko;32;32;64
623;15.11.2017;2017;11;13;Keskiviikko;24;32;56
623;15.11.2017;2017;11;14;Keskiviikko;38;26;64
623;15.11.2017;2017;11;15;Keskiviikko;69;43;112
623;15.11.2017;2017;11;16;Keskiviikko;64;48;112
623;15.11.2017;2017;11;17;Keskiviikko;76;59;135
623;15.11.2017;2017;11;18;Keskiviikko;43;42;85
623;15.11.2017;2017;11;19;Keskiviikko;35;25;60
623;15.11.2017;2017;11;20;Keskiviikko;35;17;52
623;15.11.2017;2017;11;21;Keskiviikko;17;15;32
623;15.11.2017;2017;11;22;Keskiviikko;15;9;24
623;15.11.2017;2017;11;23;Keskiviikko;12;10;22
623;16.11.2017;2017;11;00;Torstai;4;3;7
623;16.11.2017;2017;11;01;Torstai;1;1;2
623;16.11.2017;2017;11;02;Torstai;1;2;3
623;16.11.2017;2017;11;03;Torstai;0;2;2
623;16.11.2017;2017;11;04;Torstai;0;1;1
623;16.11.2017;2017;11;05;Torstai;0;1;1
623;16.11.2017;2017;11;06;Torstai;2;8;10
623;16.11.2017;2017;11;07;Torstai;6;40;46
623;16.11.2017;2017;11;08;Torstai;34;74;108
623;16.11.2017;2017;11;09;Torstai;41;102;143
623;16.11.2017;2017;11;10;Torstai;35;29;64
623;16.11.2017;2017;11;11;Torstai;19;21;40
623;16.11.2017;2017;11;12;Torstai;26;23;49
623;16.11.2017;2017;11;13;Torstai;40;24;64
623;16.11.2017;2017;11;14;Torstai;31;31;62
623;16.11.2017;2017;11;15;Torstai;41;39;80
623;16.11.2017;2017;11;16;Torstai;83;42;125
623;16.11.2017;2017;11;17;Torstai;85;46;131
623;16.11.2017;2017;11;18;Torstai;50;27;77
623;16.11.2017;2017;11;19;Torstai;32;30;62
623;16.11.2017;2017;11;20;Torstai;24;18;42
623;16.11.2017;2017;11;21;Torstai;24;11;35
623;16.11.2017;2017;11;22;Torstai;13;4;17
623;16.11.2017;2017;11;23;Torstai;6;4;10
623;17.11.2017;2017;11;00;Perjantai;3;5;8
623;17.11.2017;2017;11;01;Perjantai;3;2;5
623;17.11.2017;2017;11;02;Perjantai;3;1;4
623;17.11.2017;2017;11;03;Perjantai;3;2;5
623;17.11.2017;2017;11;04;Perjantai;0;2;2
623;17.11.2017;2017;11;05;Perjantai;2;4;6
623;17.11.2017;2017;11;06;Perjantai;0;8;8
623;17.11.2017;2017;11;07;Perjantai;4;28;32
623;17.11.2017;2017;11;08;Perjantai;24;71;95
623;17.11.2017;2017;11;09;Perjantai;42;86;128
623;17.11.2017;2017;11;10;Perjantai;20;31;51
623;17.11.2017;2017;11;11;Perjantai;18;18;36
623;17.11.2017;2017;11;12;Perjantai;23;16;39
623;17.11.2017;2017;11;13;Perjantai;33;32;65
623;17.11.2017;2017;11;14;Perjantai;29;12;41
623;17.11.2017;2017;11;15;Perjantai;53;29;82
623;17.11.2017;2017;11;16;Perjantai;50;36;86
623;17.11.2017;2017;11;17;Perjantai;51;39;90
623;17.11.2017;2017;11;18;Perjantai;30;24;54
623;17.11.2017;2017;11;19;Perjantai;13;16;29
623;17.11.2017;2017;11;20;Perjantai;20;10;30
623;17.11.2017;2017;11;21;Perjantai;12;15;27
623;17.11.2017;2017;11;22;Perjantai;11;8;19
623;17.11.2017;2017;11;23;Perjantai;7;6;13
623;18.11.2017;2017;11;00;Lauantai;2;4;6
623;18.11.2017;2017;11;01;Lauantai;8;1;9
623;18.11.2017;2017;11;02;Lauantai;2;1;3
623;18.11.2017;2017;11;03;Lauantai;2;1;3
623;18.11.2017;2017;11;04;Lauantai;4;0;4
623;18.11.2017;2017;11;05;Lauantai;5;2;7
623;18.11.2017;2017;11;06;Lauantai;1;1;2
623;18.11.2017;2017;11;07;Lauantai;2;5;7
623;18.11.2017;2017;11;08;Lauantai;2;7;9
623;18.11.2017;2017;11;09;Lauantai;2;5;7
623;18.11.2017;2017;11;10;Lauantai;5;4;9
623;18.11.2017;2017;11;11;Lauantai;9;17;26
623;18.11.2017;2017;11;12;Lauantai;6;21;27
623;18.11.2017;2017;11;13;Lauantai;14;23;37
623;18.11.2017;2017;11;14;Lauantai;14;18;32
623;18.11.2017;2017;11;15;Lauantai;16;10;26
623;18.11.2017;2017;11;16;Lauantai;16;14;30
623;18.11.2017;2017;11;17;Lauantai;9;11;20
623;18.11.2017;2017;11;18;Lauantai;19;17;36
623;18.11.2017;2017;11;19;Lauantai;17;16;33
623;18.11.2017;2017;11;20;Lauantai;10;8;18
623;18.11.2017;2017;11;21;Lauantai;11;10;21
623;18.11.2017;2017;11;22;Lauantai;13;6;19
623;18.11.2017;2017;11;23;Lauantai;8;11;19
623;19.11.2017;2017;11;00;Sunnuntai;7;8;15
623;19.11.2017;2017;11;01;Sunnuntai;6;2;8
623;19.11.2017;2017;11;02;Sunnuntai;9;3;12
623;19.11.2017;2017;11;03;Sunnuntai;5;3;8
623;19.11.2017;2017;11;04;Sunnuntai;8;1;9
623;19.11.2017;2017;11;05;Sunnuntai;6;1;7
623;19.11.2017;2017;11;06;Sunnuntai;1;1;2
623;19.11.2017;2017;11;07;Sunnuntai;2;4;6
623;19.11.2017;2017;11;08;Sunnuntai;0;5;5
623;19.11.2017;2017;11;09;Sunnuntai;2;4;6
623;19.11.2017;2017;11;10;Sunnuntai;2;4;6
623;19.11.2017;2017;11;11;Sunnuntai;9;12;21
623;19.11.2017;2017;11;12;Sunnuntai;9;14;23
623;19.11.2017;2017;11;13;Sunnuntai;12;13;25
623;19.11.2017;2017;11;14;Sunnuntai;10;16;26
623;19.11.2017;2017;11;15;Sunnuntai;16;15;31
623;19.11.2017;2017;11;16;Sunnuntai;22;12;34
623;19.11.2017;2017;11;17;Sunnuntai;16;15;31
623;19.11.2017;2017;11;18;Sunnuntai;19;21;40
623;19.11.2017;2017;11;19;Sunnuntai;17;11;28
623;19.11.2017;2017;11;20;Sunnuntai;7;4;11
623;19.11.2017;2017;11;21;Sunnuntai;15;5;20
623;19.11.2017;2017;11;22;Sunnuntai;13;6;19
623;19.11.2017;2017;11;23;Sunnuntai;4;2;6
623;20.11.2017;2017;11;00;Maanantai;3;1;4
623;20.11.2017;2017;11;01;Maanantai;2;2;4
623;20.11.2017;2017;11;02;Maanantai;0;0;0
623;20.11.2017;2017;11;03;Maanantai;0;2;2
623;20.11.2017;2017;11;04;Maanantai;0;3;3
623;20.11.2017;2017;11;05;Maanantai;0;1;1
623;20.11.2017;2017;11;06;Maanantai;2;9;11
623;20.11.2017;2017;11;07;Maanantai;2;30;32
623;20.11.2017;2017;11;08;Maanantai;38;67;105
623;20.11.2017;2017;11;09;Maanantai;44;84;128
623;20.11.2017;2017;11;10;Maanantai;33;50;83
623;20.11.2017;2017;11;11;Maanantai;16;21;37
623;20.11.2017;2017;11;12;Maanantai;24;31;55
623;20.11.2017;2017;11;13;Maanantai;32;23;55
623;20.11.2017;2017;11;14;Maanantai;39;30;69
623;20.11.2017;2017;11;15;Maanantai;54;34;88
623;20.11.2017;2017;11;16;Maanantai;70;33;103
623;20.11.2017;2017;11;17;Maanantai;78;51;129
623;20.11.2017;2017;11;18;Maanantai;45;38;83
623;20.11.2017;2017;11;19;Maanantai;27;30;57
623;20.11.2017;2017;11;20;Maanantai;19;18;37
623;20.11.2017;2017;11;21;Maanantai;20;10;30
623;20.11.2017;2017;11;22;Maanantai;13;12;25
623;20.11.2017;2017;11;23;Maanantai;6;5;11
623;21.11.2017;2017;11;00;Tiistai;1;3;4
623;21.11.2017;2017;11;01;Tiistai;1;0;1
623;21.11.2017;2017;11;02;Tiistai;2;0;2
623;21.11.2017;2017;11;03;Tiistai;1;0;1
623;21.11.2017;2017;11;04;Tiistai;0;3;3
623;21.11.2017;2017;11;05;Tiistai;1;2;3
623;21.11.2017;2017;11;06;Tiistai;2;10;12
623;21.11.2017;2017;11;07;Tiistai;3;32;35
623;21.11.2017;2017;11;08;Tiistai;45;71;116
623;21.11.2017;2017;11;09;Tiistai;38;81;119
623;21.11.2017;2017;11;10;Tiistai;29;39;68
623;21.11.2017;2017;11;11;Tiistai;19;19;38
623;21.11.2017;2017;11;12;Tiistai;23;22;45
623;21.11.2017;2017;11;13;Tiistai;29;25;54
623;21.11.2017;2017;11;14;Tiistai;41;27;68
623;21.11.2017;2017;11;15;Tiistai;41;25;66
623;21.11.2017;2017;11;16;Tiistai;57;25;82
623;21.11.2017;2017;11;17;Tiistai;74;63;137
623;21.11.2017;2017;11;18;Tiistai;49;37;86
623;21.11.2017;2017;11;19;Tiistai;33;28;61
623;21.11.2017;2017;11;20;Tiistai;24;21;45
623;21.11.2017;2017;11;21;Tiistai;23;11;34
623;21.11.2017;2017;11;22;Tiistai;20;7;27
623;21.11.2017;2017;11;23;Tiistai;4;6;10
623;22.11.2017;2017;11;00;Keskiviikko;1;0;1
623;22.11.2017;2017;11;01;Keskiviikko;3;1;4
623;22.11.2017;2017;11;02;Keskiviikko;1;0;1
623;22.11.2017;2017;11;03;Keskiviikko;1;1;2
623;22.11.2017;2017;11;04;Keskiviikko;0;2;2
623;22.11.2017;2017;11;05;Keskiviikko;0;4;4
623;22.11.2017;2017;11;06;Keskiviikko;1;8;9
623;22.11.2017;2017;11;07;Keskiviikko;4;32;36
623;22.11.2017;2017;11;08;Keskiviikko;35;72;107
623;22.11.2017;2017;11;09;Keskiviikko;50;81;131
623;22.11.2017;2017;11;10;Keskiviikko;21;42;63
623;22.11.2017;2017;11;11;Keskiviikko;18;19;37
623;22.11.2017;2017;11;12;Keskiviikko;28;19;47
623;22.11.2017;2017;11;13;Keskiviikko;23;25;48
623;22.11.2017;2017;11;14;Keskiviikko;35;16;51
623;22.11.2017;2017;11;15;Keskiviikko;51;34;85
623;22.11.2017;2017;11;16;Keskiviikko;41;27;68
623;22.11.2017;2017;11;17;Keskiviikko;77;50;127
623;22.11.2017;2017;11;18;Keskiviikko;41;49;90
623;22.11.2017;2017;11;19;Keskiviikko;37;15;52
623;22.11.2017;2017;11;20;Keskiviikko;18;18;36
623;22.11.2017;2017;11;21;Keskiviikko;13;10;23
623;22.11.2017;2017;11;22;Keskiviikko;20;8;28
623;22.11.2017;2017;11;23;Keskiviikko;4;7;11
623;23.11.2017;2017;11;00;Torstai;6;2;8
623;23.11.2017;2017;11;01;Torstai;2;2;4
623;23.11.2017;2017;11;02;Torstai;0;0;0
623;23.11.2017;2017;11;03;Torstai;1;0;1
623;23.11.2017;2017;11;04;Torstai;3;2;5
623;23.11.2017;2017;11;05;Torstai;0;4;4
623;23.11.2017;2017;11;06;Torstai;1;6;7
623;23.11.2017;2017;11;07;Torstai;2;30;32
623;23.11.2017;2017;11;08;Torstai;24;70;94
623;23.11.2017;2017;11;09;Torstai;37;71;108
623;23.11.2017;2017;11;10;Torstai;23;29;52
623;23.11.2017;2017;11;11;Torstai;15;21;36
623;23.11.2017;2017;11;12;Torstai;20;9;29
623;23.11.2017;2017;11;13;Torstai;23;17;40
623;23.11.2017;2017;11;14;Torstai;31;14;45
623;23.11.2017;2017;11;15;Torstai;36;25;61
623;23.11.2017;2017;11;16;Torstai;48;23;71
623;23.11.2017;2017;11;17;Torstai;58;44;102
623;23.11.2017;2017;11;18;Torstai;26;28;54
623;23.11.2017;2017;11;19;Torstai;25;13;38
623;23.11.2017;2017;11;20;Torstai;15;10;25
623;23.11.2017;2017;11;21;Torstai;11;6;17
623;23.11.2017;2017;11;22;Torstai;5;6;11
623;23.11.2017;2017;11;23;Torstai;5;3;8
623;24.11.2017;2017;11;00;Perjantai;1;2;3
623;24.11.2017;2017;11;01;Perjantai;4;0;4
623;24.11.2017;2017;11;02;Perjantai;2;0;2
623;24.11.2017;2017;11;03;Perjantai;0;1;1
623;24.11.2017;2017;11;04;Perjantai;1;1;2
623;24.11.2017;2017;11;05;Perjantai;0;1;1
623;24.11.2017;2017;11;06;Perjantai;2;6;8
623;24.11.2017;2017;11;07;Perjantai;3;21;24
623;24.11.2017;2017;11;08;Perjantai;14;40;54
623;24.11.2017;2017;11;09;Perjantai;17;51;68
623;24.11.2017;2017;11;10;Perjantai;15;27;42
623;24.11.2017;2017;11;11;Perjantai;6;17;23
623;24.11.2017;2017;11;12;Perjantai;22;16;38
623;24.11.2017;2017;11;13;Perjantai;24;21;45
623;24.11.2017;2017;11;14;Perjantai;35;16;51
623;24.11.2017;2017;11;15;Perjantai;30;28;58
623;24.11.2017;2017;11;16;Perjantai;41;16;57
623;24.11.2017;2017;11;17;Perjantai;34;27;61
623;24.11.2017;2017;11;18;Perjantai;22;27;49
623;24.11.2017;2017;11;19;Perjantai;15;10;25
623;24.11.2017;2017;11;20;Perjantai;13;7;20
623;24.11.2017;2017;11;21;Perjantai;16;17;33
623;24.11.2017;2017;11;22;Perjantai;7;5;12
623;24.11.2017;2017;11;23;Perjantai;5;5;10
623;25.11.2017;2017;11;00;Lauantai;6;2;8
623;25.11.2017;2017;11;01;Lauantai;7;3;10
623;25.11.2017;2017;11;02;Lauantai;5;1;6
623;25.11.2017;2017;11;03;Lauantai;5;1;6
623;25.11.2017;2017;11;04;Lauantai;1;0;1
623;25.11.2017;2017;11;05;Lauantai;0;4;4
623;25.11.2017;2017;11;06;Lauantai;2;1;3
623;25.11.2017;2017;11;07;Lauantai;3;2;5
623;25.11.2017;2017;11;08;Lauantai;0;3;3
623;25.11.2017;2017;11;09;Lauantai;2;3;5
623;25.11.2017;2017;11;10;Lauantai;4;10;14
623;25.11.2017;2017;11;11;Lauantai;10;13;23
623;25.11.2017;2017;11;12;Lauantai;17;20;37
623;25.11.2017;2017;11;13;Lauantai;20;31;51
623;25.11.2017;2017;11;14;Lauantai;21;17;38
623;25.11.2017;2017;11;15;Lauantai;19;13;32
623;25.11.2017;2017;11;16;Lauantai;9;17;26
623;25.11.2017;2017;11;17;Lauantai;20;13;33
623;25.11.2017;2017;11;18;Lauantai;14;9;23
623;25.11.2017;2017;11;19;Lauantai;9;11;20
623;25.11.2017;2017;11;20;Lauantai;13;10;23
623;25.11.2017;2017;11;21;Lauantai;1;8;9
623;25.11.2017;2017;11;22;Lauantai;5;6;11
623;25.11.2017;2017;11;23;Lauantai;6;6;12
623;26.11.2017;2017;11;00;Sunnuntai;6;2;8
623;26.11.2017;2017;11;01;Sunnuntai;8;1;9
623;26.11.2017;2017;11;02;Sunnuntai;4;1;5
623;26.11.2017;2017;11;03;Sunnuntai;4;1;5
623;26.11.2017;2017;11;04;Sunnuntai;4;2;6
623;26.11.2017;2017;11;05;Sunnuntai;2;1;3
623;26.11.2017;2017;11;06;Sunnuntai;1;2;3
623;26.11.2017;2017;11;07;Sunnuntai;2;5;7
623;26.11.2017;2017;11;08;Sunnuntai;3;4;7
623;26.11.2017;2017;11;09;Sunnuntai;3;2;5
623;26.11.2017;2017;11;10;Sunnuntai;3;8;11
623;26.11.2017;2017;11;11;Sunnuntai;8;8;16
623;26.11.2017;2017;11;12;Sunnuntai;7;16;23
623;26.11.2017;2017;11;13;Sunnuntai;7;16;23
623;26.11.2017;2017;11;14;Sunnuntai;19;18;37
623;26.11.2017;2017;11;15;Sunnuntai;15;10;25
623;26.11.2017;2017;11;16;Sunnuntai;15;12;27
623;26.11.2017;2017;11;17;Sunnuntai;20;10;30
623;26.11.2017;2017;11;18;Sunnuntai;10;14;24
623;26.11.2017;2017;11;19;Sunnuntai;17;15;32
623;26.11.2017;2017;11;20;Sunnuntai;10;11;21
623;26.11.2017;2017;11;21;Sunnuntai;10;3;13
623;26.11.2017;2017;11;22;Sunnuntai;7;2;9
623;26.11.2017;2017;11;23;Sunnuntai;3;6;9
623;27.11.2017;2017;11;00;Maanantai;3;1;4
623;27.11.2017;2017;11;01;Maanantai;0;0;0
623;27.11.2017;2017;11;02;Maanantai;0;0;0
623;27.11.2017;2017;11;03;Maanantai;1;1;2
623;27.11.2017;2017;11;04;Maanantai;0;2;2
623;27.11.2017;2017;11;05;Maanantai;1;4;5
623;27.11.2017;2017;11;06;Maanantai;1;10;11
623;27.11.2017;2017;11;07;Maanantai;1;24;25
623;27.11.2017;2017;11;08;Maanantai;25;67;92
623;27.11.2017;2017;11;09;Maanantai;41;79;120
623;27.11.2017;2017;11;10;Maanantai;19;31;50
623;27.11.2017;2017;11;11;Maanantai;22;18;40
623;27.11.2017;2017;11;12;Maanantai;18;23;41
623;27.11.2017;2017;11;13;Maanantai;23;29;52
623;27.11.2017;2017;11;14;Maanantai;41;16;57
623;27.11.2017;2017;11;15;Maanantai;44;24;68
623;27.11.2017;2017;11;16;Maanantai;63;20;83
623;27.11.2017;2017;11;17;Maanantai;67;50;117
623;27.11.2017;2017;11;18;Maanantai;34;34;68
623;27.11.2017;2017;11;19;Maanantai;22;14;36
623;27.11.2017;2017;11;20;Maanantai;17;9;26
623;27.11.2017;2017;11;21;Maanantai;17;13;30
623;27.11.2017;2017;11;22;Maanantai;11;6;17
623;27.11.2017;2017;11;23;Maanantai;7;2;9
623;28.11.2017;2017;11;00;Tiistai;2;0;2
623;28.11.2017;2017;11;01;Tiistai;3;5;8
623;28.11.2017;2017;11;02;Tiistai;1;0;1
623;28.11.2017;2017;11;03;Tiistai;0;1;1
623;28.11.2017;2017;11;04;Tiistai;0;1;1
623;28.11.2017;2017;11;05;Tiistai;0;5;5
623;28.11.2017;2017;11;06;Tiistai;2;10;12
623;28.11.2017;2017;11;07;Tiistai;5;32;37
623;28.11.2017;2017;11;08;Tiistai;28;57;85
623;28.11.2017;2017;11;09;Tiistai;44;74;118
623;28.11.2017;2017;11;10;Tiistai;16;44;60
623;28.11.2017;2017;11;11;Tiistai;14;11;25
623;28.11.2017;2017;11;12;Tiistai;20;24;44
623;28.11.2017;2017;11;13;Tiistai;27;21;48
623;28.11.2017;2017;11;14;Tiistai;28;30;58
623;28.11.2017;2017;11;15;Tiistai;42;24;66
623;28.11.2017;2017;11;16;Tiistai;56;20;76
623;28.11.2017;2017;11;17;Tiistai;58;45;103
623;28.11.2017;2017;11;18;Tiistai;38;35;73
623;28.11.2017;2017;11;19;Tiistai;28;24;52
623;28.11.2017;2017;11;20;Tiistai;28;20;48
623;28.11.2017;2017;11;21;Tiistai;14;12;26
623;28.11.2017;2017;11;22;Tiistai;19;7;26
623;28.11.2017;2017;11;23;Tiistai;4;7;11
623;29.11.2017;2017;11;00;Keskiviikko;4;0;4
623;29.11.2017;2017;11;01;Keskiviikko;1;0;1
623;29.11.2017;2017;11;02;Keskiviikko;2;0;2
623;29.11.2017;2017;11;03;Keskiviikko;2;2;4
623;29.11.2017;2017;11;04;Keskiviikko;1;1;2
623;29.11.2017;2017;11;05;Keskiviikko;0;3;3
623;29.11.2017;2017;11;06;Keskiviikko;1;7;8
623;29.11.2017;2017;11;07;Keskiviikko;5;36;41
623;29.11.2017;2017;11;08;Keskiviikko;32;68;100
623;29.11.2017;2017;11;09;Keskiviikko;45;88;133
623;29.11.2017;2017;11;10;Keskiviikko;26;35;61
623;29.11.2017;2017;11;11;Keskiviikko;17;22;39
623;29.11.2017;2017;11;12;Keskiviikko;27;29;56
623;29.11.2017;2017;11;13;Keskiviikko;27;27;54
623;29.11.2017;2017;11;14;Keskiviikko;40;25;65
623;29.11.2017;2017;11;15;Keskiviikko;52;26;78
623;29.11.2017;2017;11;16;Keskiviikko;62;26;88
623;29.11.2017;2017;11;17;Keskiviikko;81;43;124
623;29.11.2017;2017;11;18;Keskiviikko;40;39;79
623;29.11.2017;2017;11;19;Keskiviikko;27;27;54
623;29.11.2017;2017;11;20;Keskiviikko;34;12;46
623;29.11.2017;2017;11;21;Keskiviikko;14;16;30
623;29.11.2017;2017;11;22;Keskiviikko;20;13;33
623;29.11.2017;2017;11;23;Keskiviikko;8;7;15
623;30.11.2017;2017;11;00;Torstai;2;2;4
623;30.11.2017;2017;11;01;Torstai;2;0;2
623;30.11.2017;2017;11;02;Torstai;2;2;4
623;30.11.2017;2017;11;03;Torstai;0;2;2
623;30.11.2017;2017;11;04;Torstai;0;1;1
623;30.11.2017;2017;11;05;Torstai;2;3;5
623;30.11.2017;2017;11;06;Torstai;1;5;6
623;30.11.2017;2017;11;07;Torstai;3;33;36
623;30.11.2017;2017;11;08;Torstai;26;68;94
623;30.11.2017;2017;11;09;Torstai;41;85;126
623;30.11.2017;2017;11;10;Torstai;27;38;65
623;30.11.2017;2017;11;11;Torstai;15;24;39
623;30.11.2017;2017;11;12;Torstai;25;24;49
623;30.11.2017;2017;11;13;Torstai;31;21;52
623;30.11.2017;2017;11;14;Torstai;23;33;56
623;30.11.2017;2017;11;15;Torstai;42;33;75
623;30.11.2017;2017;11;16;Torstai;56;30;86
623;30.11.2017;2017;11;17;Torstai;68;45;113
623;30.11.2017;2017;11;18;Torstai;41;30;71
623;30.11.2017;2017;11;19;Torstai;39;23;62
623;30.11.2017;2017;11;20;Torstai;24;16;40
623;30.11.2017;2017;11;21;Torstai;18;9;27
623;30.11.2017;2017;11;22;Torstai;15;5;20
623;30.11.2017;2017;11;23;Torstai;5;4;9
623;01.12.2017;2017;12;00;Perjantai;3;2;5
623;01.12.2017;2017;12;01;Perjantai;4;0;4
623;01.12.2017;2017;12;02;Perjantai;5;0;5
623;01.12.2017;2017;12;03;Perjantai;1;2;3
623;01.12.2017;2017;12;04;Perjantai;1;1;2
623;01.12.2017;2017;12;05;Perjantai;0;3;3
623;01.12.2017;2017;12;06;Perjantai;1;6;7
623;01.12.2017;2017;12;07;Perjantai;6;32;38
623;01.12.2017;2017;12;08;Perjantai;26;64;90
623;01.12.2017;2017;12;09;Perjantai;41;82;123
623;01.12.2017;2017;12;10;Perjantai;28;29;57
623;01.12.2017;2017;12;11;Perjantai;16;25;41
623;01.12.2017;2017;12;12;Perjantai;30;20;50
623;01.12.2017;2017;12;13;Perjantai;34;26;60
623;01.12.2017;2017;12;14;Perjantai;26;36;62
623;01.12.2017;2017;12;15;Perjantai;54;25;79
623;01.12.2017;2017;12;16;Perjantai;69;42;111
623;01.12.2017;2017;12;17;Perjantai;47;32;79
623;01.12.2017;2017;12;18;Perjantai;24;29;53
623;01.12.2017;2017;12;19;Perjantai;32;15;47
623;01.12.2017;2017;12;20;Perjantai;13;12;25
623;01.12.2017;2017;12;21;Perjantai;10;12;22
623;01.12.2017;2017;12;22;Perjantai;15;12;27
623;01.12.2017;2017;12;23;Perjantai;13;7;20
623;02.12.2017;2017;12;00;Lauantai;5;5;10
623;02.12.2017;2017;12;01;Lauantai;7;2;9
623;02.12.2017;2017;12;02;Lauantai;7;1;8
623;02.12.2017;2017;12;03;Lauantai;4;1;5
623;02.12.2017;2017;12;04;Lauantai;3;2;5
623;02.12.2017;2017;12;05;Lauantai;2;3;5
623;02.12.2017;2017;12;06;Lauantai;1;1;2
623;02.12.2017;2017;12;07;Lauantai;2;9;11
623;02.12.2017;2017;12;08;Lauantai;3;6;9
623;02.12.2017;2017;12;09;Lauantai;7;25;32
623;02.12.2017;2017;12;10;Lauantai;2;11;13
623;02.12.2017;2017;12;11;Lauantai;8;25;33
623;02.12.2017;2017;12;12;Lauantai;17;20;37
623;02.12.2017;2017;12;13;Lauantai;17;21;38
623;02.12.2017;2017;12;14;Lauantai;22;18;40
623;02.12.2017;2017;12;15;Lauantai;13;19;32
623;02.12.2017;2017;12;16;Lauantai;23;27;50
623;02.12.2017;2017;12;17;Lauantai;12;13;25
623;02.12.2017;2017;12;18;Lauantai;18;17;35
623;02.12.2017;2017;12;19;Lauantai;15;11;26
623;02.12.2017;2017;12;20;Lauantai;20;7;27
623;02.12.2017;2017;12;21;Lauantai;8;10;18
623;02.12.2017;2017;12;22;Lauantai;8;8;16
623;02.12.2017;2017;12;23;Lauantai;6;3;9
623;03.12.2017;2017;12;00;Sunnuntai;9;5;14
623;03.12.2017;2017;12;01;Sunnuntai;7;3;10
623;03.12.2017;2017;12;02;Sunnuntai;11;2;13
623;03.12.2017;2017;12;03;Sunnuntai;6;0;6
623;03.12.2017;2017;12;04;Sunnuntai;4;0;4
623;03.12.2017;2017;12;05;Sunnuntai;6;1;7
623;03.12.2017;2017;12;06;Sunnuntai;4;2;6
623;03.12.2017;2017;12;07;Sunnuntai;1;4;5
623;03.12.2017;2017;12;08;Sunnuntai;4;3;7
623;03.12.2017;2017;12;09;Sunnuntai;3;4;7
623;03.12.2017;2017;12;10;Sunnuntai;3;7;10
623;03.12.2017;2017;12;11;Sunnuntai;3;8;11
623;03.12.2017;2017;12;12;Sunnuntai;5;7;12
623;03.12.2017;2017;12;13;Sunnuntai;10;17;27
623;03.12.2017;2017;12;14;Sunnuntai;15;24;39
623;03.12.2017;2017;12;15;Sunnuntai;9;9;18
623;03.12.2017;2017;12;16;Sunnuntai;12;14;26
623;03.12.2017;2017;12;17;Sunnuntai;16;15;31
623;03.12.2017;2017;12;18;Sunnuntai;14;10;24
623;03.12.2017;2017;12;19;Sunnuntai;17;8;25
623;03.12.2017;2017;12;20;Sunnuntai;10;9;19
623;03.12.2017;2017;12;21;Sunnuntai;4;7;11
623;03.12.2017;2017;12;22;Sunnuntai;10;5;15
623;03.12.2017;2017;12;23;Sunnuntai;3;6;9
623;04.12.2017;2017;12;00;Maanantai;8;2;10
623;04.12.2017;2017;12;01;Maanantai;5;2;7
623;04.12.2017;2017;12;02;Maanantai;1;0;1
623;04.12.2017;2017;12;03;Maanantai;2;1;3
623;04.12.2017;2017;12;04;Maanantai;2;1;3
623;04.12.2017;2017;12;05;Maanantai;1;2;3
623;04.12.2017;2017;12;06;Maanantai;0;6;6
623;04.12.2017;2017;12;07;Maanantai;3;35;38
623;04.12.2017;2017;12;08;Maanantai;23;60;83
623;04.12.2017;2017;12;09;Maanantai;34;68;102
623;04.12.2017;2017;12;10;Maanantai;29;40;69
623;04.12.2017;2017;12;11;Maanantai;16;21;37
623;04.12.2017;2017;12;12;Maanantai;27;20;47
623;04.12.2017;2017;12;13;Maanantai;34;22;56
623;04.12.2017;2017;12;14;Maanantai;31;32;63
623;04.12.2017;2017;12;15;Maanantai;42;29;71
623;04.12.2017;2017;12;16;Maanantai;53;27;80
623;04.12.2017;2017;12;17;Maanantai;67;44;111
623;04.12.2017;2017;12;18;Maanantai;44;24;68
623;04.12.2017;2017;12;19;Maanantai;13;20;33
623;04.12.2017;2017;12;20;Maanantai;11;13;24
623;04.12.2017;2017;12;21;Maanantai;13;4;17
623;04.12.2017;2017;12;22;Maanantai;20;3;23
623;04.12.2017;2017;12;23;Maanantai;6;4;10
623;05.12.2017;2017;12;00;Tiistai;3;0;3
623;05.12.2017;2017;12;01;Tiistai;3;1;4
623;05.12.2017;2017;12;02;Tiistai;1;0;1
623;05.12.2017;2017;12;03;Tiistai;0;5;5
623;05.12.2017;2017;12;04;Tiistai;2;0;2
623;05.12.2017;2017;12;05;Tiistai;0;2;2
623;05.12.2017;2017;12;06;Tiistai;1;8;9
623;05.12.2017;2017;12;07;Tiistai;9;24;33
623;05.12.2017;2017;12;08;Tiistai;32;62;94
623;05.12.2017;2017;12;09;Tiistai;32;61;93
623;05.12.2017;2017;12;10;Tiistai;23;33;56
623;05.12.2017;2017;12;11;Tiistai;10;21;31
623;05.12.2017;2017;12;12;Tiistai;23;29;52
623;05.12.2017;2017;12;13;Tiistai;21;20;41
623;05.12.2017;2017;12;14;Tiistai;20;17;37
623;05.12.2017;2017;12;15;Tiistai;47;19;66
623;05.12.2017;2017;12;16;Tiistai;49;28;77
623;05.12.2017;2017;12;17;Tiistai;59;41;100
623;05.12.2017;2017;12;18;Tiistai;20;33;53
623;05.12.2017;2017;12;19;Tiistai;25;13;38
623;05.12.2017;2017;12;20;Tiistai;15;9;24
623;05.12.2017;2017;12;21;Tiistai;14;10;24
623;05.12.2017;2017;12;22;Tiistai;16;6;22
623;05.12.2017;2017;12;23;Tiistai;4;3;7
623;06.12.2017;2017;12;00;Keskiviikko;5;4;9
623;06.12.2017;2017;12;01;Keskiviikko;7;3;10
623;06.12.2017;2017;12;02;Keskiviikko;3;1;4
623;06.12.2017;2017;12;03;Keskiviikko;0;1;1
623;06.12.2017;2017;12;04;Keskiviikko;4;1;5
623;06.12.2017;2017;12;05;Keskiviikko;3;1;4
623;06.12.2017;2017;12;06;Keskiviikko;1;1;2
623;06.12.2017;2017;12;07;Keskiviikko;1;3;4
623;06.12.2017;2017;12;08;Keskiviikko;3;3;6
623;06.12.2017;2017;12;09;Keskiviikko;3;4;7
623;06.12.2017;2017;12;10;Keskiviikko;5;3;8
623;06.12.2017;2017;12;11;Keskiviikko;6;6;12
623;06.12.2017;2017;12;12;Keskiviikko;7;24;31
623;06.12.2017;2017;12;13;Keskiviikko;16;12;28
623;06.12.2017;2017;12;14;Keskiviikko;12;20;32
623;06.12.2017;2017;12;15;Keskiviikko;12;18;30
623;06.12.2017;2017;12;16;Keskiviikko;32;12;44
623;06.12.2017;2017;12;17;Keskiviikko;18;10;28
623;06.12.2017;2017;12;18;Keskiviikko;18;18;36
623;06.12.2017;2017;12;19;Keskiviikko;10;8;18
623;06.12.2017;2017;12;20;Keskiviikko;5;9;14
623;06.12.2017;2017;12;21;Keskiviikko;2;3;5
623;06.12.2017;2017;12;22;Keskiviikko;5;5;10
623;06.12.2017;2017;12;23;Keskiviikko;3;5;8
623;07.12.2017;2017;12;00;Torstai;5;3;8
623;07.12.2017;2017;12;01;Torstai;4;2;6
623;07.12.2017;2017;12;02;Torstai;0;0;0
623;07.12.2017;2017;12;03;Torstai;4;1;5
623;07.12.2017;2017;12;04;Torstai;0;1;1
623;07.12.2017;2017;12;05;Torstai;0;5;5
623;07.12.2017;2017;12;06;Torstai;1;8;9
623;07.12.2017;2017;12;07;Torstai;5;23;28
623;07.12.2017;2017;12;08;Torstai;25;50;75
623;07.12.2017;2017;12;09;Torstai;28;86;114
623;07.12.2017;2017;12;10;Torstai;30;37;67
623;07.12.2017;2017;12;11;Torstai;18;29;47
623;07.12.2017;2017;12;12;Torstai;33;18;51
623;07.12.2017;2017;12;13;Torstai;28;41;69
623;07.12.2017;2017;12;14;Torstai;31;18;49
623;07.12.2017;2017;12;15;Torstai;33;34;67
623;07.12.2017;2017;12;16;Torstai;52;12;64
623;07.12.2017;2017;12;17;Torstai;60;33;93
623;07.12.2017;2017;12;18;Torstai;35;25;60
623;07.12.2017;2017;12;19;Torstai;36;15;51
623;07.12.2017;2017;12;20;Torstai;18;11;29
623;07.12.2017;2017;12;21;Torstai;11;14;25
623;07.12.2017;2017;12;22;Torstai;13;8;21
623;07.12.2017;2017;12;23;Torstai;2;7;9
623;08.12.2017;2017;12;00;Perjantai;5;1;6
623;08.12.2017;2017;12;01;Perjantai;3;1;4
623;08.12.2017;2017;12;02;Perjantai;3;0;3
623;08.12.2017;2017;12;03;Perjantai;1;1;2
623;08.12.2017;2017;12;04;Perjantai;1;2;3
623;08.12.2017;2017;12;05;Perjantai;0;2;2
623;08.12.2017;2017;12;06;Perjantai;0;7;7
623;08.12.2017;2017;12;07;Perjantai;3;17;20
623;08.12.2017;2017;12;08;Perjantai;18;43;61
623;08.12.2017;2017;12;09;Perjantai;20;50;70
623;08.12.2017;2017;12;10;Perjantai;13;23;36
623;08.12.2017;2017;12;11;Perjantai;10;13;23
623;08.12.2017;2017;12;12;Perjantai;14;13;27
623;08.12.2017;2017;12;13;Perjantai;15;13;28
623;08.12.2017;2017;12;14;Perjantai;15;13;28
623;08.12.2017;2017;12;15;Perjantai;31;13;44
623;08.12.2017;2017;12;16;Perjantai;39;21;60
623;08.12.2017;2017;12;17;Perjantai;29;23;52
623;08.12.2017;2017;12;18;Perjantai;20;19;39
623;08.12.2017;2017;12;19;Perjantai;21;9;30
623;08.12.2017;2017;12;20;Perjantai;16;16;32
623;08.12.2017;2017;12;21;Perjantai;5;9;14
623;08.12.2017;2017;12;22;Perjantai;13;10;23
623;08.12.2017;2017;12;23;Perjantai;15;6;21
623;09.12.2017;2017;12;00;Lauantai;2;2;4
623;09.12.2017;2017;12;01;Lauantai;4;3;7
623;09.12.2017;2017;12;02;Lauantai;5;1;6
623;09.12.2017;2017;12;03;Lauantai;5;6;11
623;09.12.2017;2017;12;04;Lauantai;3;1;4
623;09.12.2017;2017;12;05;Lauantai;5;2;7
623;09.12.2017;2017;12;06;Lauantai;2;1;3
623;09.12.2017;2017;12;07;Lauantai;2;4;6
623;09.12.2017;2017;12;08;Lauantai;1;3;4
623;09.12.2017;2017;12;09;Lauantai;5;9;14
623;09.12.2017;2017;12;10;Lauantai;5;12;17
623;09.12.2017;2017;12;11;Lauantai;6;9;15
623;09.12.2017;2017;12;12;Lauantai;8;17;25
623;09.12.2017;2017;12;13;Lauantai;16;20;36
623;09.12.2017;2017;12;14;Lauantai;13;9;22
623;09.12.2017;2017;12;15;Lauantai;11;11;22
623;09.12.2017;2017;12;16;Lauantai;18;13;31
623;09.12.2017;2017;12;17;Lauantai;10;6;16
623;09.12.2017;2017;12;18;Lauantai;14;10;24
623;09.12.2017;2017;12;19;Lauantai;6;6;12
623;09.12.2017;2017;12;20;Lauantai;8;9;17
623;09.12.2017;2017;12;21;Lauantai;6;4;10
623;09.12.2017;2017;12;22;Lauantai;10;7;17
623;09.12.2017;2017;12;23;Lauantai;7;5;12
623;10.12.2017;2017;12;00;Sunnuntai;1;2;3
623;10.12.2017;2017;12;01;Sunnuntai;2;7;9
623;10.12.2017;2017;12;02;Sunnuntai;7;2;9
623;10.12.2017;2017;12;03;Sunnuntai;3;0;3
623;10.12.2017;2017;12;04;Sunnuntai;3;2;5
623;10.12.2017;2017;12;05;Sunnuntai;5;1;6
623;10.12.2017;2017;12;06;Sunnuntai;2;3;5
623;10.12.2017;2017;12;07;Sunnuntai;1;4;5
623;10.12.2017;2017;12;08;Sunnuntai;2;2;4
623;10.12.2017;2017;12;09;Sunnuntai;3;1;4
623;10.12.2017;2017;12;10;Sunnuntai;2;5;7
623;10.12.2017;2017;12;11;Sunnuntai;3;7;10
623;10.12.2017;2017;12;12;Sunnuntai;7;12;19
623;10.12.2017;2017;12;13;Sunnuntai;5;8;13
623;10.12.2017;2017;12;14;Sunnuntai;14;16;30
623;10.12.2017;2017;12;15;Sunnuntai;17;8;25
623;10.12.2017;2017;12;16;Sunnuntai;13;17;30
623;10.12.2017;2017;12;17;Sunnuntai;15;8;23
623;10.12.2017;2017;12;18;Sunnuntai;12;7;19
623;10.12.2017;2017;12;19;Sunnuntai;9;8;17
623;10.12.2017;2017;12;20;Sunnuntai;7;5;12
623;10.12.2017;2017;12;21;Sunnuntai;7;2;9
623;10.12.2017;2017;12;22;Sunnuntai;6;3;9
623;10.12.2017;2017;12;23;Sunnuntai;3;2;5
623;11.12.2017;2017;12;00;Maanantai;1;1;2
623;11.12.2017;2017;12;01;Maanantai;2;1;3
623;11.12.2017;2017;12;02;Maanantai;0;0;0
623;11.12.2017;2017;12;03;Maanantai;0;0;0
623;11.12.2017;2017;12;04;Maanantai;1;1;2
623;11.12.2017;2017;12;05;Maanantai;0;3;3
623;11.12.2017;2017;12;06;Maanantai;2;5;7
623;11.12.2017;2017;12;07;Maanantai;6;18;24
623;11.12.2017;2017;12;08;Maanantai;22;66;88
623;11.12.2017;2017;12;09;Maanantai;30;70;100
623;11.12.2017;2017;12;10;Maanantai;33;43;76
623;11.12.2017;2017;12;11;Maanantai;16;16;32
623;11.12.2017;2017;12;12;Maanantai;22;18;40
623;11.12.2017;2017;12;13;Maanantai;24;24;48
623;11.12.2017;2017;12;14;Maanantai;28;28;56
623;11.12.2017;2017;12;15;Maanantai;53;38;91
623;11.12.2017;2017;12;16;Maanantai;58;29;87
623;11.12.2017;2017;12;17;Maanantai;64;39;103
623;11.12.2017;2017;12;18;Maanantai;27;18;45
623;11.12.2017;2017;12;19;Maanantai;17;18;35
623;11.12.2017;2017;12;20;Maanantai;16;7;23
623;11.12.2017;2017;12;21;Maanantai;8;6;14
623;11.12.2017;2017;12;22;Maanantai;8;6;14
623;11.12.2017;2017;12;23;Maanantai;3;2;5
623;12.12.2017;2017;12;00;Tiistai;0;0;0
623;12.12.2017;2017;12;01;Tiistai;3;0;3
623;12.12.2017;2017;12;02;Tiistai;0;0;0
623;12.12.2017;2017;12;03;Tiistai;0;1;1
623;12.12.2017;2017;12;04;Tiistai;0;0;0
623;12.12.2017;2017;12;05;Tiistai;0;1;1
623;12.12.2017;2017;12;06;Tiistai;0;8;8
623;12.12.2017;2017;12;07;Tiistai;4;23;27
623;12.12.2017;2017;12;08;Tiistai;20;60;80
623;12.12.2017;2017;12;09;Tiistai;39;86;125
623;12.12.2017;2017;12;10;Tiistai;24;31;55
623;12.12.2017;2017;12;11;Tiistai;15;22;37
623;12.12.2017;2017;12;12;Tiistai;18;16;34
623;12.12.2017;2017;12;13;Tiistai;25;16;41
623;12.12.2017;2017;12;14;Tiistai;21;13;34
623;12.12.2017;2017;12;15;Tiistai;38;35;73
623;12.12.2017;2017;12;16;Tiistai;41;16;57
623;12.12.2017;2017;12;17;Tiistai;63;35;98
623;12.12.2017;2017;12;18;Tiistai;37;29;66
623;12.12.2017;2017;12;19;Tiistai;19;15;34
623;12.12.2017;2017;12;20;Tiistai;12;7;19
623;12.12.2017;2017;12;21;Tiistai;15;8;23
623;12.12.2017;2017;12;22;Tiistai;10;8;18
623;12.12.2017;2017;12;23;Tiistai;2;3;5
623;13.12.2017;2017;12;00;Keskiviikko;2;0;2
623;13.12.2017;2017;12;01;Keskiviikko;1;1;2
623;13.12.2017;2017;12;02;Keskiviikko;1;0;1
623;13.12.2017;2017;12;03;Keskiviikko;0;1;1
623;13.12.2017;2017;12;04;Keskiviikko;0;0;0
623;13.12.2017;2017;12;05;Keskiviikko;0;3;3
623;13.12.2017;2017;12;06;Keskiviikko;1;3;4
623;13.12.2017;2017;12;07;Keskiviikko;3;10;13
623;13.12.2017;2017;12;08;Keskiviikko;3;3;6
623;13.12.2017;2017;12;09;Keskiviikko;3;4;7
623;13.12.2017;2017;12;10;Keskiviikko;5;3;8
623;13.12.2017;2017;12;11;Keskiviikko;6;6;12
623;13.12.2017;2017;12;12;Keskiviikko;7;24;31
623;13.12.2017;2017;12;13;Keskiviikko;16;12;28
623;13.12.2017;2017;12;14;Keskiviikko;12;20;32
623;13.12.2017;2017;12;15;Keskiviikko;12;18;30
623;13.12.2017;2017;12;16;Keskiviikko;32;12;44
623;13.12.2017;2017;12;17;Keskiviikko;18;10;28
623;13.12.2017;2017;12;18;Keskiviikko;18;18;36
623;13.12.2017;2017;12;19;Keskiviikko;10;8;18
623;13.12.2017;2017;12;20;Keskiviikko;5;9;14
623;13.12.2017;2017;12;21;Keskiviikko;2;3;5
623;13.12.2017;2017;12;22;Keskiviikko;5;5;10
623;13.12.2017;2017;12;23;Keskiviikko;3;5;8
623;14.12.2017;2017;12;00;Torstai;2;0;2
623;14.12.2017;2017;12;01;Torstai;1;1;2
623;14.12.2017;2017;12;02;Torstai;1;0;1
623;14.12.2017;2017;12;03;Torstai;0;1;1
623;14.12.2017;2017;12;04;Torstai;0;0;0
623;14.12.2017;2017;12;05;Torstai;0;3;3
623;14.12.2017;2017;12;06;Torstai;1;3;4
623;14.12.2017;2017;12;07;Torstai;3;25;28
623;14.12.2017;2017;12;08;Torstai;20;40;60
623;14.12.2017;2017;12;09;Torstai;40;70;110
623;14.12.2017;2017;12;10;Torstai;18;33;51
623;14.12.2017;2017;12;11;Torstai;12;14;26
623;14.12.2017;2017;12;12;Torstai;20;17;37
623;14.12.2017;2017;12;13;Torstai;19;24;43
623;14.12.2017;2017;12;14;Torstai;14;17;31
623;14.12.2017;2017;12;15;Torstai;35;22;57
623;14.12.2017;2017;12;16;Torstai;40;25;65
623;14.12.2017;2017;12;17;Torstai;60;30;90
623;14.12.2017;2017;12;18;Torstai;32;25;57
623;14.12.2017;2017;12;19;Torstai;18;15;33
623;14.12.2017;2017;12;20;Torstai;16;13;29
623;14.12.2017;2017;12;21;Torstai;6;9;15
623;14.12.2017;2017;12;22;Torstai;13;6;19
623;14.12.2017;2017;12;23;Torstai;1;4;5
623;15.12.2017;2017;12;00;Perjantai;4;2;6
623;15.12.2017;2017;12;01;Perjantai;4;1;5
623;15.12.2017;2017;12;02;Perjantai;0;0;0
623;15.12.2017;2017;12;03;Perjantai;2;0;2
623;15.12.2017;2017;12;04;Perjantai;2;1;3
623;15.12.2017;2017;12;05;Perjantai;2;3;5
623;15.12.2017;2017;12;06;Perjantai;1;3;4
623;15.12.2017;2017;12;07;Perjantai;4;23;27
623;15.12.2017;2017;12;08;Perjantai;19;47;66
623;15.12.2017;2017;12;09;Perjantai;36;77;113
623;15.12.2017;2017;12;10;Perjantai;21;19;40
623;15.12.2017;2017;12;11;Perjantai;17;20;37
623;15.12.2017;2017;12;12;Perjantai;26;18;44
623;15.12.2017;2017;12;13;Perjantai;19;22;41
623;15.12.2017;2017;12;14;Perjantai;36;17;53
623;15.12.2017;2017;12;15;Perjantai;40;20;60
623;15.12.2017;2017;12;16;Perjantai;37;25;62
623;15.12.2017;2017;12;17;Perjantai;37;22;59
623;15.12.2017;2017;12;18;Perjantai;31;44;75
623;15.12.2017;2017;12;19;Perjantai;23;16;39
623;15.12.2017;2017;12;20;Perjantai;20;13;33
623;15.12.2017;2017;12;21;Perjantai;10;12;22
623;15.12.2017;2017;12;22;Perjantai;14;5;19
623;15.12.2017;2017;12;23;Perjantai;8;3;11
623;16.12.2017;2017;12;00;Lauantai;11;2;13
623;16.12.2017;2017;12;01;Lauantai;8;2;10
623;16.12.2017;2017;12;02;Lauantai;8;2;10
623;16.12.2017;2017;12;03;Lauantai;5;0;5
623;16.12.2017;2017;12;04;Lauantai;1;0;1
623;16.12.2017;2017;12;05;Lauantai;1;3;4
623;16.12.2017;2017;12;06;Lauantai;1;1;2
623;16.12.2017;2017;12;07;Lauantai;1;4;5
623;16.12.2017;2017;12;08;Lauantai;1;3;4
623;16.12.2017;2017;12;09;Lauantai;4;8;12
623;16.12.2017;2017;12;10;Lauantai;3;13;16
623;16.12.2017;2017;12;11;Lauantai;7;10;17
623;16.12.2017;2017;12;12;Lauantai;10;20;30
623;16.12.2017;2017;12;13;Lauantai;13;23;36
623;16.12.2017;2017;12;14;Lauantai;16;18;34
623;16.12.2017;2017;12;15;Lauantai;17;22;39
623;16.12.2017;2017;12;16;Lauantai;16;7;23
623;16.12.2017;2017;12;17;Lauantai;12;13;25
623;16.12.2017;2017;12;18;Lauantai;14;12;26
623;16.12.2017;2017;12;19;Lauantai;9;10;19
623;16.12.2017;2017;12;20;Lauantai;9;14;23
623;16.12.2017;2017;12;21;Lauantai;5;6;11
623;16.12.2017;2017;12;22;Lauantai;7;4;11
623;16.12.2017;2017;12;23;Lauantai;3;4;7
623;17.12.2017;2017;12;00;Sunnuntai;2;2;4
623;17.12.2017;2017;12;01;Sunnuntai;6;1;7
623;17.12.2017;2017;12;02;Sunnuntai;1;2;3
623;17.12.2017;2017;12;03;Sunnuntai;2;2;4
623;17.12.2017;2017;12;04;Sunnuntai;2;3;5
623;17.12.2017;2017;12;05;Sunnuntai;5;5;10
623;17.12.2017;2017;12;06;Sunnuntai;2;1;3
623;17.12.2017;2017;12;07;Sunnuntai;1;2;3
623;17.12.2017;2017;12;08;Sunnuntai;1;2;3
623;17.12.2017;2017;12;09;Sunnuntai;1;3;4
623;17.12.2017;2017;12;10;Sunnuntai;0;6;6
623;17.12.2017;2017;12;11;Sunnuntai;7;9;16
623;17.12.2017;2017;12;12;Sunnuntai;13;16;29
623;17.12.2017;2017;12;13;Sunnuntai;6;14;20
623;17.12.2017;2017;12;14;Sunnuntai;6;8;14
623;17.12.2017;2017;12;15;Sunnuntai;14;14;28
623;17.12.2017;2017;12;16;Sunnuntai;18;12;30
623;17.12.2017;2017;12;17;Sunnuntai;14;7;21
623;17.12.2017;2017;12;18;Sunnuntai;14;9;23
623;17.12.2017;2017;12;19;Sunnuntai;11;11;22
623;17.12.2017;2017;12;20;Sunnuntai;11;10;21
623;17.12.2017;2017;12;21;Sunnuntai;8;10;18
623;17.12.2017;2017;12;22;Sunnuntai;10;6;16
623;17.12.2017;2017;12;23;Sunnuntai;2;1;3
623;18.12.2017;2017;12;00;Maanantai;3;2;5
623;18.12.2017;2017;12;01;Maanantai;5;2;7
623;18.12.2017;2017;12;02;Maanantai;1;0;1
623;18.12.2017;2017;12;03;Maanantai;0;1;1
623;18.12.2017;2017;12;04;Maanantai;2;3;5
623;18.12.2017;2017;12;05;Maanantai;1;2;3
623;18.12.2017;2017;12;06;Maanantai;0;7;7
623;18.12.2017;2017;12;07;Maanantai;5;21;26
623;18.12.2017;2017;12;08;Maanantai;21;69;90
623;18.12.2017;2017;12;09;Maanantai;31;73;104
623;18.12.2017;2017;12;10;Maanantai;17;47;64
623;18.12.2017;2017;12;11;Maanantai;16;20;36
623;18.12.2017;2017;12;12;Maanantai;20;21;41
623;18.12.2017;2017;12;13;Maanantai;29;25;54
623;18.12.2017;2017;12;14;Maanantai;37;29;66
623;18.12.2017;2017;12;15;Maanantai;39;24;63
623;18.12.2017;2017;12;16;Maanantai;49;22;71
623;18.12.2017;2017;12;17;Maanantai;59;47;106
623;18.12.2017;2017;12;18;Maanantai;44;23;67
623;18.12.2017;2017;12;19;Maanantai;27;23;50
623;18.12.2017;2017;12;20;Maanantai;19;11;30
623;18.12.2017;2017;12;21;Maanantai;8;9;17
623;18.12.2017;2017;12;22;Maanantai;14;3;17
623;18.12.2017;2017;12;23;Maanantai;6;6;12
623;19.12.2017;2017;12;00;Tiistai;4;0;4
623;19.12.2017;2017;12;01;Tiistai;4;1;5
623;19.12.2017;2017;12;02;Tiistai;1;0;1
623;19.12.2017;2017;12;03;Tiistai;1;2;3
623;19.12.2017;2017;12;04;Tiistai;1;1;2
623;19.12.2017;2017;12;05;Tiistai;1;4;5
623;19.12.2017;2017;12;06;Tiistai;0;4;4
623;19.12.2017;2017;12;07;Tiistai;5;28;33
623;19.12.2017;2017;12;08;Tiistai;28;64;92
623;19.12.2017;2017;12;09;Tiistai;29;79;108
623;19.12.2017;2017;12;10;Tiistai;21;29;50
623;19.12.2017;2017;12;11;Tiistai;21;23;44
623;19.12.2017;2017;12;12;Tiistai;16;21;37
623;19.12.2017;2017;12;13;Tiistai;22;26;48
623;19.12.2017;2017;12;14;Tiistai;25;23;48
623;19.12.2017;2017;12;15;Tiistai;42;28;70
623;19.12.2017;2017;12;16;Tiistai;52;25;77
623;19.12.2017;2017;12;17;Tiistai;60;38;98
623;19.12.2017;2017;12;18;Tiistai;35;29;64
623;19.12.2017;2017;12;19;Tiistai;17;24;41
623;19.12.2017;2017;12;20;Tiistai;18;15;33
623;19.12.2017;2017;12;21;Tiistai;13;12;25
623;19.12.2017;2017;12;22;Tiistai;22;7;29
623;19.12.2017;2017;12;23;Tiistai;7;4;11
623;20.12.2017;2017;12;00;Keskiviikko;5;2;7
623;20.12.2017;2017;12;01;Keskiviikko;2;3;5
623;20.12.2017;2017;12;02;Keskiviikko;0;0;0
623;20.12.2017;2017;12;03;Keskiviikko;2;1;3
623;20.12.2017;2017;12;04;Keskiviikko;0;2;2
623;20.12.2017;2017;12;05;Keskiviikko;0;2;2
623;20.12.2017;2017;12;06;Keskiviikko;1;10;11
623;20.12.2017;2017;12;07;Keskiviikko;2;23;25
623;20.12.2017;2017;12;08;Keskiviikko;15;63;78
623;20.12.2017;2017;12;09;Keskiviikko;26;65;91
623;20.12.2017;2017;12;10;Keskiviikko;21;31;52
623;20.12.2017;2017;12;11;Keskiviikko;8;8;16
623;20.12.2017;2017;12;12;Keskiviikko;15;16;31
623;20.12.2017;2017;12;13;Keskiviikko;17;4;21
623;20.12.2017;2017;12;14;Keskiviikko;21;16;37
623;20.12.2017;2017;12;15;Keskiviikko;23;23;46
623;20.12.2017;2017;12;16;Keskiviikko;8;5;13
623;20.12.2017;2017;12;17;Keskiviikko;43;24;67
623;20.12.2017;2017;12;18;Keskiviikko;30;25;55
623;20.12.2017;2017;12;19;Keskiviikko;13;8;21
623;20.12.2017;2017;12;20;Keskiviikko;8;2;10
623;20.12.2017;2017;12;21;Keskiviikko;11;8;19
623;20.12.2017;2017;12;22;Keskiviikko;5;2;7
623;20.12.2017;2017;12;23;Keskiviikko;5;7;12
623;21.12.2017;2017;12;00;Torstai;3;2;5
623;21.12.2017;2017;12;01;Torstai;3;1;4
623;21.12.2017;2017;12;02;Torstai;1;0;1
623;21.12.2017;2017;12;03;Torstai;0;1;1
623;21.12.2017;2017;12;04;Torstai;0;2;2
623;21.12.2017;2017;12;05;Torstai;0;3;3
623;21.12.2017;2017;12;06;Torstai;0;3;3
623;21.12.2017;2017;12;07;Torstai;3;24;27
623;21.12.2017;2017;12;08;Torstai;9;47;56
623;21.12.2017;2017;12;09;Torstai;19;58;77
623;21.12.2017;2017;12;10;Torstai;16;29;45
623;21.12.2017;2017;12;11;Torstai;9;17;26
623;21.12.2017;2017;12;12;Torstai;29;23;52
623;21.12.2017;2017;12;13;Torstai;18;22;40
623;21.12.2017;2017;12;14;Torstai;22;20;42
623;21.12.2017;2017;12;15;Torstai;27;19;46
623;21.12.2017;2017;12;16;Torstai;26;16;42
623;21.12.2017;2017;12;17;Torstai;33;21;54
623;21.12.2017;2017;12;18;Torstai;28;16;44
623;21.12.2017;2017;12;19;Torstai;16;18;34
623;21.12.2017;2017;12;20;Torstai;9;10;19
623;21.12.2017;2017;12;21;Torstai;17;5;22
623;21.12.2017;2017;12;22;Torstai;10;9;19
623;21.12.2017;2017;12;23;Torstai;6;8;14
623;22.12.2017;2017;12;00;Perjantai;9;4;13
623;22.12.2017;2017;12;01;Perjantai;2;1;3
623;22.12.2017;2017;12;02;Perjantai;0;0;0
623;22.12.2017;2017;12;03;Perjantai;0;0;0
623;22.12.2017;2017;12;04;Perjantai;1;1;2
623;22.12.2017;2017;12;05;Perjantai;3;2;5
623;22.12.2017;2017;12;06;Perjantai;1;1;2
623;22.12.2017;2017;12;07;Perjantai;5;26;31
623;22.12.2017;2017;12;08;Perjantai;11;31;42
623;22.12.2017;2017;12;09;Perjantai;11;43;54
623;22.12.2017;2017;12;10;Perjantai;23;27;50
623;22.12.2017;2017;12;11;Perjantai;12;13;25
623;22.12.2017;2017;12;12;Perjantai;22;20;42
623;22.12.2017;2017;12;13;Perjantai;12;20;32
623;22.12.2017;2017;12;14;Perjantai;17;13;30
623;22.12.2017;2017;12;15;Perjantai;27;15;42
623;22.12.2017;2017;12;16;Perjantai;25;21;46
623;22.12.2017;2017;12;17;Perjantai;28;10;38
623;22.12.2017;2017;12;18;Perjantai;20;12;32
623;22.12.2017;2017;12;19;Perjantai;10;10;20
623;22.12.2017;2017;12;20;Perjantai;11;9;20
623;22.12.2017;2017;12;21;Perjantai;6;5;11
623;22.12.2017;2017;12;22;Perjantai;11;5;16
623;22.12.2017;2017;12;23;Perjantai;1;2;3
623;23.12.2017;2017;12;00;Lauantai;1;3;4
623;23.12.2017;2017;12;01;Lauantai;1;2;3
623;23.12.2017;2017;12;02;Lauantai;0;1;1
623;23.12.2017;2017;12;03;Lauantai;2;0;2
623;23.12.2017;2017;12;04;Lauantai;1;1;2
623;23.12.2017;2017;12;05;Lauantai;1;4;5
623;23.12.2017;2017;12;06;Lauantai;2;2;4
623;23.12.2017;2017;12;07;Lauantai;2;5;7
623;23.12.2017;2017;12;08;Lauantai;0;4;4
623;23.12.2017;2017;12;09;Lauantai;1;3;4
623;23.12.2017;2017;12;10;Lauantai;4;5;9
623;23.12.2017;2017;12;11;Lauantai;3;8;11
623;23.12.2017;2017;12;12;Lauantai;2;4;6
623;23.12.2017;2017;12;13;Lauantai;5;6;11
623;23.12.2017;2017;12;14;Lauantai;5;5;10
623;23.12.2017;2017;12;15;Lauantai;3;7;10
623;23.12.2017;2017;12;16;Lauantai;3;4;7
623;23.12.2017;2017;12;17;Lauantai;1;4;5
623;23.12.2017;2017;12;18;Lauantai;3;4;7
623;23.12.2017;2017;12;19;Lauantai;7;2;9
623;23.12.2017;2017;12;20;Lauantai;3;2;5
623;23.12.2017;2017;12;21;Lauantai;2;3;5
623;23.12.2017;2017;12;22;Lauantai;2;0;2
623;23.12.2017;2017;12;23;Lauantai;1;0;1
623;24.12.2017;2017;12;00;Sunnuntai;2;3;5
623;24.12.2017;2017;12;01;Sunnuntai;1;2;3
623;24.12.2017;2017;12;02;Sunnuntai;0;0;0
623;24.12.2017;2017;12;03;Sunnuntai;0;0;0
623;24.12.2017;2017;12;04;Sunnuntai;2;1;3
623;24.12.2017;2017;12;05;Sunnuntai;0;0;0
623;24.12.2017;2017;12;06;Sunnuntai;2;3;5
623;24.12.2017;2017;12;07;Sunnuntai;1;3;4
623;24.12.2017;2017;12;08;Sunnuntai;0;3;3
623;24.12.2017;2017;12;09;Sunnuntai;3;6;9
623;24.12.2017;2017;12;10;Sunnuntai;9;5;14
623;24.12.2017;2017;12;11;Sunnuntai;4;7;11
623;24.12.2017;2017;12;12;Sunnuntai;4;8;12
623;24.12.2017;2017;12;13;Sunnuntai;6;6;12
623;24.12.2017;2017;12;14;Sunnuntai;8;5;13
623;24.12.2017;2017;12;15;Sunnuntai;8;5;13
623;24.12.2017;2017;12;16;Sunnuntai;2;4;6
623;24.12.2017;2017;12;17;Sunnuntai;4;1;5
623;24.12.2017;2017;12;18;Sunnuntai;4;6;10
623;24.12.2017;2017;12;19;Sunnuntai;1;1;2
623;24.12.2017;2017;12;20;Sunnuntai;4;3;7
623;24.12.2017;2017;12;21;Sunnuntai;2;1;3
623;24.12.2017;2017;12;22;Sunnuntai;2;1;3
623;24.12.2017;2017;12;23;Sunnuntai;4;5;9
623;25.12.2017;2017;12;00;Maanantai;2;0;2
623;25.12.2017;2017;12;01;Maanantai;1;1;2
623;25.12.2017;2017;12;02;Maanantai;2;1;3
623;25.12.2017;2017;12;03;Maanantai;0;0;0
623;25.12.2017;2017;12;04;Maanantai;0;0;0
623;25.12.2017;2017;12;05;Maanantai;0;1;1
623;25.12.2017;2017;12;06;Maanantai;0;0;0
623;25.12.2017;2017;12;07;Maanantai;0;4;4
623;25.12.2017;2017;12;08;Maanantai;0;1;1
623;25.12.2017;2017;12;09;Maanantai;2;2;4
623;25.12.2017;2017;12;10;Maanantai;2;4;6
623;25.12.2017;2017;12;11;Maanantai;1;2;3
623;25.12.2017;2017;12;12;Maanantai;4;3;7
623;25.12.2017;2017;12;13;Maanantai;1;6;7
623;25.12.2017;2017;12;14;Maanantai;2;10;12
623;25.12.2017;2017;12;15;Maanantai;3;9;12
623;25.12.2017;2017;12;16;Maanantai;11;7;18
623;25.12.2017;2017;12;17;Maanantai;5;7;12
623;25.12.2017;2017;12;18;Maanantai;4;4;8
623;25.12.2017;2017;12;19;Maanantai;5;9;14
623;25.12.2017;2017;12;20;Maanantai;8;4;12
623;25.12.2017;2017;12;21;Maanantai;4;1;5
623;25.12.2017;2017;12;22;Maanantai;7;4;11
623;25.12.2017;2017;12;23;Maanantai;1;2;3
623;26.12.2017;2017;12;00;Tiistai;0;2;2
623;26.12.2017;2017;12;01;Tiistai;1;3;4
623;26.12.2017;2017;12;02;Tiistai;0;1;1
623;26.12.2017;2017;12;03;Tiistai;1;1;2
623;26.12.2017;2017;12;04;Tiistai;0;0;0
623;26.12.2017;2017;12;05;Tiistai;1;1;2
623;26.12.2017;2017;12;06;Tiistai;0;0;0
623;26.12.2017;2017;12;07;Tiistai;0;3;3
623;26.12.2017;2017;12;08;Tiistai;0;3;3
623;26.12.2017;2017;12;09;Tiistai;2;1;3
623;26.12.2017;2017;12;10;Tiistai;2;3;5
623;26.12.2017;2017;12;11;Tiistai;2;8;10
623;26.12.2017;2017;12;12;Tiistai;5;9;14
623;26.12.2017;2017;12;13;Tiistai;3;10;13
623;26.12.2017;2017;12;14;Tiistai;7;8;15
623;26.12.2017;2017;12;15;Tiistai;7;5;12
623;26.12.2017;2017;12;16;Tiistai;6;3;9
623;26.12.2017;2017;12;17;Tiistai;5;8;13
623;26.12.2017;2017;12;18;Tiistai;1;4;5
623;26.12.2017;2017;12;19;Tiistai;5;5;10
623;26.12.2017;2017;12;20;Tiistai;4;3;7
623;26.12.2017;2017;12;21;Tiistai;2;4;6
623;26.12.2017;2017;12;22;Tiistai;7;5;12
623;26.12.2017;2017;12;23;Tiistai;2;3;5
623;27.12.2017;2017;12;00;Keskiviikko;1;4;5
623;27.12.2017;2017;12;01;Keskiviikko;3;2;5
623;27.12.2017;2017;12;02;Keskiviikko;1;0;1
623;27.12.2017;2017;12;03;Keskiviikko;2;1;3
623;27.12.2017;2017;12;04;Keskiviikko;3;2;5
623;27.12.2017;2017;12;05;Keskiviikko;1;3;4
623;27.12.2017;2017;12;06;Keskiviikko;1;6;7
623;27.12.2017;2017;12;07;Keskiviikko;1;6;7
623;27.12.2017;2017;12;08;Keskiviikko;4;16;20
623;27.12.2017;2017;12;09;Keskiviikko;7;25;32
623;27.12.2017;2017;12;10;Keskiviikko;6;6;12
623;27.12.2017;2017;12;11;Keskiviikko;3;9;12
623;27.12.2017;2017;12;12;Keskiviikko;5;13;18
623;27.12.2017;2017;12;13;Keskiviikko;9;13;22
623;27.12.2017;2017;12;14;Keskiviikko;13;6;19
623;27.12.2017;2017;12;15;Keskiviikko;17;16;33
623;27.12.2017;2017;12;16;Keskiviikko;17;11;28
623;27.12.2017;2017;12;17;Keskiviikko;20;12;32
623;27.12.2017;2017;12;18;Keskiviikko;17;13;30
623;27.12.2017;2017;12;19;Keskiviikko;7;5;12
623;27.12.2017;2017;12;20;Keskiviikko;10;4;14
623;27.12.2017;2017;12;21;Keskiviikko;7;10;17
623;27.12.2017;2017;12;22;Keskiviikko;6;5;11
623;27.12.2017;2017;12;23;Keskiviikko;4;1;5
623;28.12.2017;2017;12;00;Torstai;6;2;8
623;28.12.2017;2017;12;01;Torstai;1;0;1
623;28.12.2017;2017;12;02;Torstai;0;1;1
623;28.12.2017;2017;12;03;Torstai;1;2;3
623;28.12.2017;2017;12;04;Torstai;0;3;3
623;28.12.2017;2017;12;05;Torstai;1;2;3
623;28.12.2017;2017;12;06;Torstai;1;1;2
623;28.12.2017;2017;12;07;Torstai;3;11;14
623;28.12.2017;2017;12;08;Torstai;8;15;23
623;28.12.2017;2017;12;09;Torstai;6;22;28
623;28.12.2017;2017;12;10;Torstai;7;13;20
623;28.12.2017;2017;12;11;Torstai;2;10;12
623;28.12.2017;2017;12;12;Torstai;10;15;25
623;28.12.2017;2017;12;13;Torstai;8;15;23
623;28.12.2017;2017;12;14;Torstai;11;12;23
623;28.12.2017;2017;12;15;Torstai;16;21;37
623;28.12.2017;2017;12;16;Torstai;19;12;31
623;28.12.2017;2017;12;17;Torstai;17;23;40
623;28.12.2017;2017;12;18;Torstai;22;10;32
623;28.12.2017;2017;12;19;Torstai;10;9;19
623;28.12.2017;2017;12;20;Torstai;4;9;13
623;28.12.2017;2017;12;21;Torstai;7;3;10
623;28.12.2017;2017;12;22;Torstai;10;5;15
623;28.12.2017;2017;12;23;Torstai;4;1;5
623;29.12.2017;2017;12;00;Perjantai;4;2;6
623;29.12.2017;2017;12;01;Perjantai;3;0;3
623;29.12.2017;2017;12;02;Perjantai;1;0;1
623;29.12.2017;2017;12;03;Perjantai;4;3;7
623;29.12.2017;2017;12;04;Perjantai;0;2;2
623;29.12.2017;2017;12;05;Perjantai;1;3;4
623;29.12.2017;2017;12;06;Perjantai;2;3;5
623;29.12.2017;2017;12;07;Perjantai;5;12;17
623;29.12.2017;2017;12;08;Perjantai;6;11;17
623;29.12.2017;2017;12;09;Perjantai;9;19;28
623;29.12.2017;2017;12;10;Perjantai;7;11;18
623;29.12.2017;2017;12;11;Perjantai;11;6;17
623;29.12.2017;2017;12;12;Perjantai;3;9;12
623;29.12.2017;2017;12;13;Perjantai;6;16;22
623;29.12.2017;2017;12;14;Perjantai;6;8;14
623;29.12.2017;2017;12;15;Perjantai;9;12;21
623;29.12.2017;2017;12;16;Perjantai;23;15;38
623;29.12.2017;2017;12;17;Perjantai;17;14;31
623;29.12.2017;2017;12;18;Perjantai;18;15;33
623;29.12.2017;2017;12;19;Perjantai;10;5;15
623;29.12.2017;2017;12;20;Perjantai;12;5;17
623;29.12.2017;2017;12;21;Perjantai;8;5;13
623;29.12.2017;2017;12;22;Perjantai;6;5;11
623;29.12.2017;2017;12;23;Perjantai;4;7;11
623;30.12.2017;2017;12;00;Lauantai;3;1;4
623;30.12.2017;2017;12;01;Lauantai;5;2;7
623;30.12.2017;2017;12;02;Lauantai;2;0;2
623;30.12.2017;2017;12;03;Lauantai;1;1;2
623;30.12.2017;2017;12;04;Lauantai;1;0;1
623;30.12.2017;2017;12;05;Lauantai;2;5;7
623;30.12.2017;2017;12;06;Lauantai;3;2;5
623;30.12.2017;2017;12;07;Lauantai;0;3;3
623;30.12.2017;2017;12;08;Lauantai;2;5;7
623;30.12.2017;2017;12;09;Lauantai;2;4;6
623;30.12.2017;2017;12;10;Lauantai;4;8;12
623;30.12.2017;2017;12;11;Lauantai;3;8;11
623;30.12.2017;2017;12;12;Lauantai;5;7;12
623;30.12.2017;2017;12;13;Lauantai;8;14;22
623;30.12.2017;2017;12;14;Lauantai;10;14;24
623;30.12.2017;2017;12;15;Lauantai;10;11;21
623;30.12.2017;2017;12;16;Lauantai;16;5;21
623;30.12.2017;2017;12;17;Lauantai;7;7;14
623;30.12.2017;2017;12;18;Lauantai;8;11;19
623;30.12.2017;2017;12;19;Lauantai;5;8;13
623;30.12.2017;2017;12;20;Lauantai;11;7;18
623;30.12.2017;2017;12;21;Lauantai;1;9;10
623;30.12.2017;2017;12;22;Lauantai;5;2;7
623;30.12.2017;2017;12;23;Lauantai;2;3;5
623;31.12.2017;2017;12;00;Sunnuntai;4;2;6
623;31.12.2017;2017;12;01;Sunnuntai;3;0;3
623;31.12.2017;2017;12;02;Sunnuntai;1;0;1
623;31.12.2017;2017;12;03;Sunnuntai;2;0;2
623;31.12.2017;2017;12;04;Sunnuntai;3;0;3
623;31.12.2017;2017;12;05;Sunnuntai;1;1;2
623;31.12.2017;2017;12;06;Sunnuntai;1;2;3
623;31.12.2017;2017;12;07;Sunnuntai;1;4;5
623;31.12.2017;2017;12;08;Sunnuntai;1;1;2
623;31.12.2017;2017;12;09;Sunnuntai;0;1;1
623;31.12.2017;2017;12;10;Sunnuntai;3;4;7
623;31.12.2017;2017;12;11;Sunnuntai;2;8;10
623;31.12.2017;2017;12;12;Sunnuntai;6;9;15
623;31.12.2017;2017;12;13;Sunnuntai;8;12;20
623;31.12.2017;2017;12;14;Sunnuntai;10;17;27
623;31.12.2017;2017;12;15;Sunnuntai;9;12;21
623;31.12.2017;2017;12;16;Sunnuntai;9;8;17
623;31.12.2017;2017;12;17;Sunnuntai;14;6;20
623;31.12.2017;2017;12;18;Sunnuntai;9;9;18
623;31.12.2017;2017;12;19;Sunnuntai;6;11;17
623;31.12.2017;2017;12;20;Sunnuntai;7;22;29
623;31.12.2017;2017;12;21;Sunnuntai;20;11;31
623;31.12.2017;2017;12;22;Sunnuntai;11;11;22
623;31.12.2017;2017;12;23;Sunnuntai;5;5;10
623;01.01.2018;2018;01;00;Maanantai;7;3;10
623;01.01.2018;2018;01;01;Maanantai;5;3;8
623;01.01.2018;2018;01;02;Maanantai;9;4;13
623;01.01.2018;2018;01;03;Maanantai;6;3;9
623;01.01.2018;2018;01;04;Maanantai;5;0;5
623;01.01.2018;2018;01;05;Maanantai;8;2;10
623;01.01.2018;2018;01;06;Maanantai;4;3;7
623;01.01.2018;2018;01;07;Maanantai;0;2;2
623;01.01.2018;2018;01;08;Maanantai;0;0;0
623;01.01.2018;2018;01;09;Maanantai;2;4;6
623;01.01.2018;2018;01;10;Maanantai;0;2;2
623;01.01.2018;2018;01;11;Maanantai;0;5;5
623;01.01.2018;2018;01;12;Maanantai;6;8;14
623;01.01.2018;2018;01;13;Maanantai;9;5;14
623;01.01.2018;2018;01;14;Maanantai;8;11;19
623;01.01.2018;2018;01;15;Maanantai;8;8;16
623;01.01.2018;2018;01;16;Maanantai;7;12;19
623;01.01.2018;2018;01;17;Maanantai;5;6;11
623;01.01.2018;2018;01;18;Maanantai;11;7;18
623;01.01.2018;2018;01;19;Maanantai;9;9;18
623;01.01.2018;2018;01;20;Maanantai;7;5;12
623;01.01.2018;2018;01;21;Maanantai;3;3;6
623;01.01.2018;2018;01;22;Maanantai;6;7;13
623;01.01.2018;2018;01;23;Maanantai;3;2;5
623;02.01.2018;2018;01;00;Tiistai;2;0;2
623;02.01.2018;2018;01;01;Tiistai;0;2;2
623;02.01.2018;2018;01;02;Tiistai;3;2;5
623;02.01.2018;2018;01;03;Tiistai;3;1;4
623;02.01.2018;2018;01;04;Tiistai;0;1;1
623;02.01.2018;2018;01;05;Tiistai;0;2;2
623;02.01.2018;2018;01;06;Tiistai;1;3;4
623;02.01.2018;2018;01;07;Tiistai;9;25;34
623;02.01.2018;2018;01;08;Tiistai;12;46;58
623;02.01.2018;2018;01;09;Tiistai;10;36;46
623;02.01.2018;2018;01;10;Tiistai;11;16;27
623;02.01.2018;2018;01;11;Tiistai;9;11;20
623;02.01.2018;2018;01;12;Tiistai;10;14;24
623;02.01.2018;2018;01;13;Tiistai;15;20;35
623;02.01.2018;2018;01;14;Tiistai;16;23;39
623;02.01.2018;2018;01;15;Tiistai;26;25;51
623;02.01.2018;2018;01;16;Tiistai;35;18;53
623;02.01.2018;2018;01;17;Tiistai;54;23;77
623;02.01.2018;2018;01;18;Tiistai;32;20;52
623;02.01.2018;2018;01;19;Tiistai;17;8;25
623;02.01.2018;2018;01;20;Tiistai;13;10;23
623;02.01.2018;2018;01;21;Tiistai;6;2;8
623;02.01.2018;2018;01;22;Tiistai;9;3;12
623;02.01.2018;2018;01;23;Tiistai;5;3;8
623;03.01.2018;2018;01;00;Keskiviikko;5;2;7
623;03.01.2018;2018;01;01;Keskiviikko;2;0;2
623;03.01.2018;2018;01;02;Keskiviikko;0;0;0
623;03.01.2018;2018;01;03;Keskiviikko;0;1;1
623;03.01.2018;2018;01;04;Keskiviikko;0;1;1
623;03.01.2018;2018;01;05;Keskiviikko;2;3;5
623;03.01.2018;2018;01;06;Keskiviikko;3;6;9
623;03.01.2018;2018;01;07;Keskiviikko;9;25;34
623;03.01.2018;2018;01;08;Keskiviikko;22;48;70
623;03.01.2018;2018;01;09;Keskiviikko;17;37;54
623;03.01.2018;2018;01;10;Keskiviikko;11;8;19
623;03.01.2018;2018;01;11;Keskiviikko;10;19;29
623;03.01.2018;2018;01;12;Keskiviikko;12;20;32
623;03.01.2018;2018;01;13;Keskiviikko;12;24;36
623;03.01.2018;2018;01;14;Keskiviikko;19;17;36
623;03.01.2018;2018;01;15;Keskiviikko;18;14;32
623;03.01.2018;2018;01;16;Keskiviikko;36;21;57
623;03.01.2018;2018;01;17;Keskiviikko;61;38;99
623;03.01.2018;2018;01;18;Keskiviikko;28;21;49
623;03.01.2018;2018;01;19;Keskiviikko;18;9;27
623;03.01.2018;2018;01;20;Keskiviikko;15;4;19
623;03.01.2018;2018;01;21;Keskiviikko;9;4;13
623;03.01.2018;2018;01;22;Keskiviikko;8;2;10
623;03.01.2018;2018;01;23;Keskiviikko;3;5;8
623;04.01.2018;2018;01;00;Torstai;3;0;3
623;04.01.2018;2018;01;01;Torstai;1;0;1
623;04.01.2018;2018;01;02;Torstai;1;0;1
623;04.01.2018;2018;01;03;Torstai;0;0;0
623;04.01.2018;2018;01;04;Torstai;1;2;3
623;04.01.2018;2018;01;05;Torstai;1;6;7
623;04.01.2018;2018;01;06;Torstai;3;6;9
623;04.01.2018;2018;01;07;Torstai;2;24;26
623;04.01.2018;2018;01;08;Torstai;19;46;65
623;04.01.2018;2018;01;09;Torstai;16;41;57
623;04.01.2018;2018;01;10;Torstai;11;16;27
623;04.01.2018;2018;01;11;Torstai;11;18;29
623;04.01.2018;2018;01;12;Torstai;13;18;31
623;04.01.2018;2018;01;13;Torstai;11;18;29
623;04.01.2018;2018;01;14;Torstai;12;21;33
623;04.01.2018;2018;01;15;Torstai;17;16;33
623;04.01.2018;2018;01;16;Torstai;39;13;52
623;04.01.2018;2018;01;17;Torstai;45;37;82
623;04.01.2018;2018;01;18;Torstai;25;15;40
623;04.01.2018;2018;01;19;Torstai;17;12;29
623;04.01.2018;2018;01;20;Torstai;15;4;19
623;04.01.2018;2018;01;21;Torstai;7;3;10
623;04.01.2018;2018;01;22;Torstai;19;5;24
623;04.01.2018;2018;01;23;Torstai;6;5;11
623;05.01.2018;2018;01;00;Perjantai;1;1;2
623;05.01.2018;2018;01;01;Perjantai;2;0;2
623;05.01.2018;2018;01;02;Perjantai;1;0;1
623;05.01.2018;2018;01;03;Perjantai;0;2;2
623;05.01.2018;2018;01;04;Perjantai;0;2;2
623;05.01.2018;2018;01;05;Perjantai;1;3;4
623;05.01.2018;2018;01;06;Perjantai;5;4;9
623;05.01.2018;2018;01;07;Perjantai;2;16;18
623;05.01.2018;2018;01;08;Perjantai;16;43;59
623;05.01.2018;2018;01;09;Perjantai;11;39;50
623;05.01.2018;2018;01;10;Perjantai;12;15;27
623;05.01.2018;2018;01;11;Perjantai;8;12;20
623;05.01.2018;2018;01;12;Perjantai;9;13;22
623;05.01.2018;2018;01;13;Perjantai;8;13;21
623;05.01.2018;2018;01;14;Perjantai;11;14;25
623;05.01.2018;2018;01;15;Perjantai;15;11;26
623;05.01.2018;2018;01;16;Perjantai;18;8;26
623;05.01.2018;2018;01;17;Perjantai;39;30;69
623;05.01.2018;2018;01;18;Perjantai;20;14;34
623;05.01.2018;2018;01;19;Perjantai;14;7;21
623;05.01.2018;2018;01;20;Perjantai;9;9;18
623;05.01.2018;2018;01;21;Perjantai;9;3;12
623;05.01.2018;2018;01;22;Perjantai;9;7;16
623;05.01.2018;2018;01;23;Perjantai;1;1;2
623;06.01.2018;2018;01;00;Lauantai;3;6;9
623;06.01.2018;2018;01;01;Lauantai;2;1;3
623;06.01.2018;2018;01;02;Lauantai;3;1;4
623;06.01.2018;2018;01;03;Lauantai;2;1;3
623;06.01.2018;2018;01;04;Lauantai;1;1;2
623;06.01.2018;2018;01;05;Lauantai;0;0;0
623;06.01.2018;2018;01;06;Lauantai;0;0;0
623;06.01.2018;2018;01;07;Lauantai;1;2;3
623;06.01.2018;2018;01;08;Lauantai;2;3;5
623;06.01.2018;2018;01;09;Lauantai;1;3;4
623;06.01.2018;2018;01;10;Lauantai;4;4;8
623;06.01.2018;2018;01;11;Lauantai;4;9;13
623;06.01.2018;2018;01;12;Lauantai;8;10;18
623;06.01.2018;2018;01;13;Lauantai;8;12;20
623;06.01.2018;2018;01;14;Lauantai;7;13;20
623;06.01.2018;2018;01;15;Lauantai;8;12;20
623;06.01.2018;2018;01;16;Lauantai;9;14;23
623;06.01.2018;2018;01;17;Lauantai;10;11;21
623;06.01.2018;2018;01;18;Lauantai;10;7;17
623;06.01.2018;2018;01;19;Lauantai;6;7;13
623;06.01.2018;2018;01;20;Lauantai;3;3;6
623;06.01.2018;2018;01;21;Lauantai;7;5;12
623;06.01.2018;2018;01;22;Lauantai;5;4;9
623;06.01.2018;2018;01;23;Lauantai;6;3;9
623;07.01.2018;2018;01;00;Sunnuntai;2;2;4
623;07.01.2018;2018;01;01;Sunnuntai;4;1;5
623;07.01.2018;2018;01;02;Sunnuntai;1;2;3
623;07.01.2018;2018;01;03;Sunnuntai;0;1;1
623;07.01.2018;2018;01;04;Sunnuntai;1;0;1
623;07.01.2018;2018;01;05;Sunnuntai;0;1;1
623;07.01.2018;2018;01;06;Sunnuntai;1;1;2
623;07.01.2018;2018;01;07;Sunnuntai;1;4;5
623;07.01.2018;2018;01;08;Sunnuntai;1;1;2
623;07.01.2018;2018;01;09;Sunnuntai;2;1;3
623;07.01.2018;2018;01;10;Sunnuntai;6;1;7
623;07.01.2018;2018;01;11;Sunnuntai;2;10;12
623;07.01.2018;2018;01;12;Sunnuntai;6;15;21
623;07.01.2018;2018;01;13;Sunnuntai;10;9;19
623;07.01.2018;2018;01;14;Sunnuntai;14;14;28
623;07.01.2018;2018;01;15;Sunnuntai;13;8;21
623;07.01.2018;2018;01;16;Sunnuntai;6;8;14
623;07.01.2018;2018;01;17;Sunnuntai;6;5;11
623;07.01.2018;2018;01;18;Sunnuntai;5;7;12
623;07.01.2018;2018;01;19;Sunnuntai;6;14;20
623;07.01.2018;2018;01;20;Sunnuntai;5;6;11
623;07.01.2018;2018;01;21;Sunnuntai;12;3;15
623;07.01.2018;2018;01;22;Sunnuntai;7;2;9
623;07.01.2018;2018;01;23;Sunnuntai;6;1;7
623;08.01.2018;2018;01;00;Maanantai;1;0;1
623;08.01.2018;2018;01;01;Maanantai;0;0;0
623;08.01.2018;2018;01;02;Maanantai;1;1;2
623;08.01.2018;2018;01;03;Maanantai;0;2;2
623;08.01.2018;2018;01;04;Maanantai;0;2;2
623;08.01.2018;2018;01;05;Maanantai;0;0;0
623;08.01.2018;2018;01;06;Maanantai;1;8;9
623;08.01.2018;2018;01;07;Maanantai;4;27;31
623;08.01.2018;2018;01;08;Maanantai;25;69;94
623;08.01.2018;2018;01;09;Maanantai;23;66;89
623;08.01.2018;2018;01;10;Maanantai;25;30;55
623;08.01.2018;2018;01;11;Maanantai;16;13;29
623;08.01.2018;2018;01;12;Maanantai;16;18;34
623;08.01.2018;2018;01;13;Maanantai;17;18;35
623;08.01.2018;2018;01;14;Maanantai;18;13;31
623;08.01.2018;2018;01;15;Maanantai;35;20;55
623;08.01.2018;2018;01;16;Maanantai;44;25;69
623;08.01.2018;2018;01;17;Maanantai;61;43;104
623;08.01.2018;2018;01;18;Maanantai;40;21;61
623;08.01.2018;2018;01;19;Maanantai;17;18;35
623;08.01.2018;2018;01;20;Maanantai;20;15;35
623;08.01.2018;2018;01;21;Maanantai;10;8;18
623;08.01.2018;2018;01;22;Maanantai;9;9;18
623;08.01.2018;2018;01;23;Maanantai;6;3;9
623;09.01.2018;2018;01;00;Tiistai;1;1;2
623;09.01.2018;2018;01;01;Tiistai;3;0;3
623;09.01.2018;2018;01;02;Tiistai;1;1;2
623;09.01.2018;2018;01;03;Tiistai;0;1;1
623;09.01.2018;2018;01;04;Tiistai;0;3;3
623;09.01.2018;2018;01;05;Tiistai;0;4;4
623;09.01.2018;2018;01;06;Tiistai;0;2;2
623;09.01.2018;2018;01;07;Tiistai;4;36;40
623;09.01.2018;2018;01;08;Tiistai;32;78;110
623;09.01.2018;2018;01;09;Tiistai;41;78;119
623;09.01.2018;2018;01;10;Tiistai;29;32;61
623;09.01.2018;2018;01;11;Tiistai;18;24;42
623;09.01.2018;2018;01;12;Tiistai;17;28;45
623;09.01.2018;2018;01;13;Tiistai;15;27;42
623;09.01.2018;2018;01;14;Tiistai;26;33;59
623;09.01.2018;2018;01;15;Tiistai;32;28;60
623;09.01.2018;2018;01;16;Tiistai;45;23;68
623;09.01.2018;2018;01;17;Tiistai;68;48;116
623;09.01.2018;2018;01;18;Tiistai;40;33;73
623;09.01.2018;2018;01;19;Tiistai;18;16;34
623;09.01.2018;2018;01;20;Tiistai;23;4;27
623;09.01.2018;2018;01;21;Tiistai;7;11;18
623;09.01.2018;2018;01;22;Tiistai;9;4;13
623;09.01.2018;2018;01;23;Tiistai;8;4;12
623;10.01.2018;2018;01;00;Keskiviikko;3;0;3
623;10.01.2018;2018;01;01;Keskiviikko;1;1;2
623;10.01.2018;2018;01;02;Keskiviikko;0;0;0
623;10.01.2018;2018;01;03;Keskiviikko;0;1;1
623;10.01.2018;2018;01;04;Keskiviikko;0;2;2
623;10.01.2018;2018;01;05;Keskiviikko;0;3;3
623;10.01.2018;2018;01;06;Keskiviikko;0;5;5
623;10.01.2018;2018;01;07;Keskiviikko;5;33;38
623;10.01.2018;2018;01;08;Keskiviikko;23;67;90
623;10.01.2018;2018;01;09;Keskiviikko;29;75;104
623;10.01.2018;2018;01;10;Keskiviikko;19;34;53
623;10.01.2018;2018;01;11;Keskiviikko;7;17;24
623;10.01.2018;2018;01;12;Keskiviikko;21;11;32
623;10.01.2018;2018;01;13;Keskiviikko;18;26;44
623;10.01.2018;2018;01;14;Keskiviikko;14;25;39
623;10.01.2018;2018;01;15;Keskiviikko;33;27;60
623;10.01.2018;2018;01;16;Keskiviikko;39;25;64
623;10.01.2018;2018;01;17;Keskiviikko;55;41;96
623;10.01.2018;2018;01;18;Keskiviikko;39;33;72
623;10.01.2018;2018;01;19;Keskiviikko;25;23;48
623;10.01.2018;2018;01;20;Keskiviikko;23;10;33
623;10.01.2018;2018;01;21;Keskiviikko;12;7;19
623;10.01.2018;2018;01;22;Keskiviikko;9;7;16
623;10.01.2018;2018;01;23;Keskiviikko;5;4;9
623;11.01.2018;2018;01;00;Torstai;3;3;6
623;11.01.2018;2018;01;01;Torstai;1;3;4
623;11.01.2018;2018;01;02;Torstai;2;0;2
623;11.01.2018;2018;01;03;Torstai;1;1;2
623;11.01.2018;2018;01;04;Torstai;0;2;2
623;11.01.2018;2018;01;05;Torstai;0;3;3
623;11.01.2018;2018;01;06;Torstai;1;5;6
623;11.01.2018;2018;01;07;Torstai;2;30;32
623;11.01.2018;2018;01;08;Torstai;27;63;90
623;11.01.2018;2018;01;09;Torstai;32;72;104
623;11.01.2018;2018;01;10;Torstai;26;30;56
623;11.01.2018;2018;01;11;Torstai;12;20;32
623;11.01.2018;2018;01;12;Torstai;19;24;43
623;11.01.2018;2018;01;13;Torstai;20;22;42
623;11.01.2018;2018;01;14;Torstai;18;14;32
623;11.01.2018;2018;01;15;Torstai;26;28;54
623;11.01.2018;2018;01;16;Torstai;39;17;56
623;11.01.2018;2018;01;17;Torstai;58;34;92
623;11.01.2018;2018;01;18;Torstai;30;23;53
623;11.01.2018;2018;01;19;Torstai;18;14;32
623;11.01.2018;2018;01;20;Torstai;19;10;29
623;11.01.2018;2018;01;21;Torstai;11;10;21
623;11.01.2018;2018;01;22;Torstai;6;2;8
623;11.01.2018;2018;01;23;Torstai;7;5;12
623;12.01.2018;2018;01;00;Perjantai;1;1;2
623;12.01.2018;2018;01;01;Perjantai;1;0;1
623;12.01.2018;2018;01;02;Perjantai;1;1;2
623;12.01.2018;2018;01;03;Perjantai;0;2;2
623;12.01.2018;2018;01;04;Perjantai;0;2;2
623;12.01.2018;2018;01;05;Perjantai;0;2;2
623;12.01.2018;2018;01;06;Perjantai;0;6;6
623;12.01.2018;2018;01;07;Perjantai;3;29;32
623;12.01.2018;2018;01;08;Perjantai;27;60;87
623;12.01.2018;2018;01;09;Perjantai;17;73;90
623;12.01.2018;2018;01;10;Perjantai;18;29;47
623;12.01.2018;2018;01;11;Perjantai;11;22;33
623;12.01.2018;2018;01;12;Perjantai;15;16;31
623;12.01.2018;2018;01;13;Perjantai;19;16;35
623;12.01.2018;2018;01;14;Perjantai;14;24;38
623;12.01.2018;2018;01;15;Perjantai;36;23;59
623;12.01.2018;2018;01;16;Perjantai;37;23;60
623;12.01.2018;2018;01;17;Perjantai;38;25;63
623;12.01.2018;2018;01;18;Perjantai;27;17;44
623;12.01.2018;2018;01;19;Perjantai;19;13;32
623;12.01.2018;2018;01;20;Perjantai;11;9;20
623;12.01.2018;2018;01;21;Perjantai;3;7;10
623;12.01.2018;2018;01;22;Perjantai;8;6;14
623;12.01.2018;2018;01;23;Perjantai;6;6;12
623;13.01.2018;2018;01;00;Lauantai;5;7;12
623;13.01.2018;2018;01;01;Lauantai;1;2;3
623;13.01.2018;2018;01;02;Lauantai;2;1;3
623;13.01.2018;2018;01;03;Lauantai;3;3;6
623;13.01.2018;2018;01;04;Lauantai;3;0;3
623;13.01.2018;2018;01;05;Lauantai;3;0;3
623;13.01.2018;2018;01;06;Lauantai;1;4;5
623;13.01.2018;2018;01;07;Lauantai;1;3;4
623;13.01.2018;2018;01;08;Lauantai;1;6;7
623;13.01.2018;2018;01;09;Lauantai;1;4;5
623;13.01.2018;2018;01;10;Lauantai;4;10;14
623;13.01.2018;2018;01;11;Lauantai;1;13;14
623;13.01.2018;2018;01;12;Lauantai;11;15;26
623;13.01.2018;2018;01;13;Lauantai;16;18;34
623;13.01.2018;2018;01;14;Lauantai;7;14;21
623;13.01.2018;2018;01;15;Lauantai;17;8;25
623;13.01.2018;2018;01;16;Lauantai;9;5;14
623;13.01.2018;2018;01;17;Lauantai;14;9;23
623;13.01.2018;2018;01;18;Lauantai;10;13;23
623;13.01.2018;2018;01;19;Lauantai;8;10;18
623;13.01.2018;2018;01;20;Lauantai;8;9;17
623;13.01.2018;2018;01;21;Lauantai;6;1;7
623;13.01.2018;2018;01;22;Lauantai;5;7;12
623;13.01.2018;2018;01;23;Lauantai;4;5;9
623;14.01.2018;2018;01;00;Sunnuntai;1;0;1
623;14.01.2018;2018;01;01;Sunnuntai;2;0;2
623;14.01.2018;2018;01;02;Sunnuntai;2;1;3
623;14.01.2018;2018;01;03;Sunnuntai;2;0;2
623;14.01.2018;2018;01;04;Sunnuntai;2;0;2
623;14.01.2018;2018;01;05;Sunnuntai;1;0;1
623;14.01.2018;2018;01;06;Sunnuntai;0;3;3
623;14.01.2018;2018;01;07;Sunnuntai;1;4;5
623;14.01.2018;2018;01;08;Sunnuntai;1;1;2
623;14.01.2018;2018;01;09;Sunnuntai;1;3;4
623;14.01.2018;2018;01;10;Sunnuntai;3;5;8
623;14.01.2018;2018;01;11;Sunnuntai;9;12;21
623;14.01.2018;2018;01;12;Sunnuntai;8;14;22
623;14.01.2018;2018;01;13;Sunnuntai;11;9;20
623;14.01.2018;2018;01;14;Sunnuntai;6;19;25
623;14.01.2018;2018;01;15;Sunnuntai;17;23;40
623;14.01.2018;2018;01;16;Sunnuntai;15;13;28
623;14.01.2018;2018;01;17;Sunnuntai;6;9;15
623;14.01.2018;2018;01;18;Sunnuntai;12;12;24
623;14.01.2018;2018;01;19;Sunnuntai;7;9;16
623;14.01.2018;2018;01;20;Sunnuntai;6;5;11
623;14.01.2018;2018;01;21;Sunnuntai;6;2;8
623;14.01.2018;2018;01;22;Sunnuntai;6;5;11
623;14.01.2018;2018;01;23;Sunnuntai;2;5;7
623;15.01.2018;2018;01;00;Maanantai;0;0;0
623;15.01.2018;2018;01;01;Maanantai;2;1;3
623;15.01.2018;2018;01;02;Maanantai;0;0;0
623;15.01.2018;2018;01;03;Maanantai;0;1;1
623;15.01.2018;2018;01;04;Maanantai;0;1;1
623;15.01.2018;2018;01;05;Maanantai;0;1;1
623;15.01.2018;2018;01;06;Maanantai;1;4;5
623;15.01.2018;2018;01;07;Maanantai;2;21;23
623;15.01.2018;2018;01;08;Maanantai;25;68;93
623;15.01.2018;2018;01;09;Maanantai;29;59;88
623;15.01.2018;2018;01;10;Maanantai;24;30;54
623;15.01.2018;2018;01;11;Maanantai;4;19;23
623;15.01.2018;2018;01;12;Maanantai;20;29;49
623;15.01.2018;2018;01;13;Maanantai;18;23;41
623;15.01.2018;2018;01;14;Maanantai;20;21;41
623;15.01.2018;2018;01;15;Maanantai;37;26;63
623;15.01.2018;2018;01;16;Maanantai;32;22;54
623;15.01.2018;2018;01;17;Maanantai;56;50;106
623;15.01.2018;2018;01;18;Maanantai;28;30;58
623;15.01.2018;2018;01;19;Maanantai;15;11;26
623;15.01.2018;2018;01;20;Maanantai;18;6;24
623;15.01.2018;2018;01;21;Maanantai;12;4;16
623;15.01.2018;2018;01;22;Maanantai;5;7;12
623;15.01.2018;2018;01;23;Maanantai;5;2;7
623;16.01.2018;2018;01;00;Tiistai;1;1;2
623;16.01.2018;2018;01;01;Tiistai;2;0;2
623;16.01.2018;2018;01;02;Tiistai;2;0;2
623;16.01.2018;2018;01;03;Tiistai;0;2;2
623;16.01.2018;2018;01;04;Tiistai;1;1;2
623;16.01.2018;2018;01;05;Tiistai;1;1;2
623;16.01.2018;2018;01;06;Tiistai;0;4;4
623;16.01.2018;2018;01;07;Tiistai;4;35;39
623;16.01.2018;2018;01;08;Tiistai;37;50;87
623;16.01.2018;2018;01;09;Tiistai;24;74;98
623;16.01.2018;2018;01;10;Tiistai;19;27;46
623;16.01.2018;2018;01;11;Tiistai;8;16;24
623;16.01.2018;2018;01;12;Tiistai;18;17;35
623;16.01.2018;2018;01;13;Tiistai;21;23;44
623;16.01.2018;2018;01;14;Tiistai;21;25;46
623;16.01.2018;2018;01;15;Tiistai;26;28;54
623;16.01.2018;2018;01;16;Tiistai;39;30;69
623;16.01.2018;2018;01;17;Tiistai;42;38;80
623;16.01.2018;2018;01;18;Tiistai;30;28;58
623;16.01.2018;2018;01;19;Tiistai;12;11;23
623;16.01.2018;2018;01;20;Tiistai;19;12;31
623;16.01.2018;2018;01;21;Tiistai;16;12;28
623;16.01.2018;2018;01;22;Tiistai;20;8;28
623;16.01.2018;2018;01;23;Tiistai;3;3;6
623;17.01.2018;2018;01;00;Keskiviikko;1;1;2
623;17.01.2018;2018;01;01;Keskiviikko;2;1;3
623;17.01.2018;2018;01;02;Keskiviikko;0;0;0
623;17.01.2018;2018;01;03;Keskiviikko;0;1;1
623;17.01.2018;2018;01;04;Keskiviikko;0;2;2
623;17.01.2018;2018;01;05;Keskiviikko;0;1;1
623;17.01.2018;2018;01;06;Keskiviikko;0;8;8
623;17.01.2018;2018;01;07;Keskiviikko;6;29;35
623;17.01.2018;2018;01;08;Keskiviikko;29;58;87
623;17.01.2018;2018;01;09;Keskiviikko;25;59;84
623;17.01.2018;2018;01;10;Keskiviikko;16;29;45
623;17.01.2018;2018;01;11;Keskiviikko;9;18;27
623;17.01.2018;2018;01;12;Keskiviikko;17;28;45
623;17.01.2018;2018;01;13;Keskiviikko;16;32;48
623;17.01.2018;2018;01;14;Keskiviikko;22;21;43
623;17.01.2018;2018;01;15;Keskiviikko;34;32;66
623;17.01.2018;2018;01;16;Keskiviikko;32;20;52
623;17.01.2018;2018;01;17;Keskiviikko;59;46;105
623;17.01.2018;2018;01;18;Keskiviikko;33;28;61
623;17.01.2018;2018;01;19;Keskiviikko;17;13;30
623;17.01.2018;2018;01;20;Keskiviikko;21;14;35
623;17.01.2018;2018;01;21;Keskiviikko;16;11;27
623;17.01.2018;2018;01;22;Keskiviikko;13;8;21
623;17.01.2018;2018;01;23;Keskiviikko;3;5;8
623;18.01.2018;2018;01;00;Torstai;1;1;2
623;18.01.2018;2018;01;01;Torstai;1;1;2
623;18.01.2018;2018;01;02;Torstai;0;1;1
623;18.01.2018;2018;01;03;Torstai;1;1;2
623;18.01.2018;2018;01;04;Torstai;0;1;1
623;18.01.2018;2018;01;05;Torstai;1;2;3
623;18.01.2018;2018;01;06;Torstai;0;5;5
623;18.01.2018;2018;01;07;Torstai;3;26;29
623;18.01.2018;2018;01;08;Torstai;28;63;91
623;18.01.2018;2018;01;09;Torstai;28;66;94
623;18.01.2018;2018;01;10;Torstai;23;32;55
623;18.01.2018;2018;01;11;Torstai;10;17;27
623;18.01.2018;2018;01;12;Torstai;24;19;43
623;18.01.2018;2018;01;13;Torstai;22;25;47
623;18.01.2018;2018;01;14;Torstai;18;20;38
623;18.01.2018;2018;01;15;Torstai;21;31;52
623;18.01.2018;2018;01;16;Torstai;40;25;65
623;18.01.2018;2018;01;17;Torstai;56;31;87
623;18.01.2018;2018;01;18;Torstai;39;34;73
623;18.01.2018;2018;01;19;Torstai;13;22;35
623;18.01.2018;2018;01;20;Torstai;14;14;28
623;18.01.2018;2018;01;21;Torstai;11;5;16
623;18.01.2018;2018;01;22;Torstai;16;3;19
623;18.01.2018;2018;01;23;Torstai;5;5;10
623;19.01.2018;2018;01;00;Perjantai;2;4;6
623;19.01.2018;2018;01;01;Perjantai;0;0;0
623;19.01.2018;2018;01;02;Perjantai;3;0;3
623;19.01.2018;2018;01;03;Perjantai;0;2;2
623;19.01.2018;2018;01;04;Perjantai;0;1;1
623;19.01.2018;2018;01;05;Perjantai;1;1;2
623;19.01.2018;2018;01;06;Perjantai;0;6;6
623;19.01.2018;2018;01;07;Perjantai;8;24;32
623;19.01.2018;2018;01;08;Perjantai;27;55;82
623;19.01.2018;2018;01;09;Perjantai;22;60;82
623;19.01.2018;2018;01;10;Perjantai;17;28;45
623;19.01.2018;2018;01;11;Perjantai;10;25;35
623;19.01.2018;2018;01;12;Perjantai;21;14;35
623;19.01.2018;2018;01;13;Perjantai;18;32;50
623;19.01.2018;2018;01;14;Perjantai;17;21;38
623;19.01.2018;2018;01;15;Perjantai;41;27;68
623;19.01.2018;2018;01;16;Perjantai;29;20;49
623;19.01.2018;2018;01;17;Perjantai;40;24;64
623;19.01.2018;2018;01;18;Perjantai;22;14;36
623;19.01.2018;2018;01;19;Perjantai;18;12;30
623;19.01.2018;2018;01;20;Perjantai;13;8;21
623;19.01.2018;2018;01;21;Perjantai;6;11;17
623;19.01.2018;2018;01;22;Perjantai;10;5;15
623;19.01.2018;2018;01;23;Perjantai;5;5;10
623;20.01.2018;2018;01;00;Lauantai;2;0;2
623;20.01.2018;2018;01;01;Lauantai;3;3;6
623;20.01.2018;2018;01;02;Lauantai;2;2;4
623;20.01.2018;2018;01;03;Lauantai;2;0;2
623;20.01.2018;2018;01;04;Lauantai;3;0;3
623;20.01.2018;2018;01;05;Lauantai;0;1;1
623;20.01.2018;2018;01;06;Lauantai;1;3;4
623;20.01.2018;2018;01;07;Lauantai;1;1;2
623;20.01.2018;2018;01;08;Lauantai;1;1;2
623;20.01.2018;2018;01;09;Lauantai;2;4;6
623;20.01.2018;2018;01;10;Lauantai;3;6;9
623;20.01.2018;2018;01;11;Lauantai;5;17;22
623;20.01.2018;2018;01;12;Lauantai;12;21;33
623;20.01.2018;2018;01;13;Lauantai;14;15;29
623;20.01.2018;2018;01;14;Lauantai;12;18;30
623;20.01.2018;2018;01;15;Lauantai;10;12;22
623;20.01.2018;2018;01;16;Lauantai;15;16;31
623;20.01.2018;2018;01;17;Lauantai;11;8;19
623;20.01.2018;2018;01;18;Lauantai;6;9;15
623;20.01.2018;2018;01;19;Lauantai;6;14;20
623;20.01.2018;2018;01;20;Lauantai;4;6;10
623;20.01.2018;2018;01;21;Lauantai;3;6;9
623;20.01.2018;2018;01;22;Lauantai;8;6;14
623;20.01.2018;2018;01;23;Lauantai;5;3;8
623;21.01.2018;2018;01;00;Sunnuntai;5;4;9
623;21.01.2018;2018;01;01;Sunnuntai;2;1;3
623;21.01.2018;2018;01;02;Sunnuntai;3;0;3
623;21.01.2018;2018;01;03;Sunnuntai;1;1;2
623;21.01.2018;2018;01;04;Sunnuntai;1;1;2
623;21.01.2018;2018;01;05;Sunnuntai;1;0;1
623;21.01.2018;2018;01;06;Sunnuntai;2;3;5
623;21.01.2018;2018;01;07;Sunnuntai;1;0;1
623;21.01.2018;2018;01;08;Sunnuntai;0;4;4
623;21.01.2018;2018;01;09;Sunnuntai;2;2;4
623;21.01.2018;2018;01;10;Sunnuntai;3;5;8
623;21.01.2018;2018;01;11;Sunnuntai;6;7;13
623;21.01.2018;2018;01;12;Sunnuntai;5;8;13
623;21.01.2018;2018;01;13;Sunnuntai;5;9;14
623;21.01.2018;2018;01;14;Sunnuntai;4;14;18
623;21.01.2018;2018;01;15;Sunnuntai;10;20;30
623;21.01.2018;2018;01;16;Sunnuntai;12;8;20
623;21.01.2018;2018;01;17;Sunnuntai;14;10;24
623;21.01.2018;2018;01;18;Sunnuntai;12;8;20
623;21.01.2018;2018;01;19;Sunnuntai;9;9;18
623;21.01.2018;2018;01;20;Sunnuntai;5;7;12
623;21.01.2018;2018;01;21;Sunnuntai;5;6;11
623;21.01.2018;2018;01;22;Sunnuntai;5;2;7
623;21.01.2018;2018;01;23;Sunnuntai;1;1;2
623;22.01.2018;2018;01;00;Maanantai;1;1;2
623;22.01.2018;2018;01;01;Maanantai;1;1;2
623;22.01.2018;2018;01;02;Maanantai;0;0;0
623;22.01.2018;2018;01;03;Maanantai;1;1;2
623;22.01.2018;2018;01;04;Maanantai;0;1;1
623;22.01.2018;2018;01;05;Maanantai;0;3;3
623;22.01.2018;2018;01;06;Maanantai;2;4;6
623;22.01.2018;2018;01;07;Maanantai;3;23;26
623;22.01.2018;2018;01;08;Maanantai;17;50;67
623;22.01.2018;2018;01;09;Maanantai;18;51;69
623;22.01.2018;2018;01;10;Maanantai;14;32;46
623;22.01.2018;2018;01;11;Maanantai;7;14;21
623;22.01.2018;2018;01;12;Maanantai;13;10;23
623;22.01.2018;2018;01;13;Maanantai;13;22;35
623;22.01.2018;2018;01;14;Maanantai;9;7;16
623;22.01.2018;2018;01;15;Maanantai;23;18;41
623;22.01.2018;2018;01;16;Maanantai;33;22;55
623;22.01.2018;2018;01;17;Maanantai;48;38;86
623;22.01.2018;2018;01;18;Maanantai;24;18;42
623;22.01.2018;2018;01;19;Maanantai;12;13;25
623;22.01.2018;2018;01;20;Maanantai;11;8;19
623;22.01.2018;2018;01;21;Maanantai;13;8;21
623;22.01.2018;2018;01;22;Maanantai;4;4;8
623;22.01.2018;2018;01;23;Maanantai;4;5;9
623;23.01.2018;2018;01;00;Tiistai;2;0;2
623;23.01.2018;2018;01;01;Tiistai;0;1;1
623;23.01.2018;2018;01;02;Tiistai;4;0;4
623;23.01.2018;2018;01;03;Tiistai;0;0;0
623;23.01.2018;2018;01;04;Tiistai;1;1;2
623;23.01.2018;2018;01;05;Tiistai;0;1;1
623;23.01.2018;2018;01;06;Tiistai;1;4;5
623;23.01.2018;2018;01;07;Tiistai;1;16;17
623;23.01.2018;2018;01;08;Tiistai;11;43;54
623;23.01.2018;2018;01;09;Tiistai;30;50;80
623;23.01.2018;2018;01;10;Tiistai;8;18;26
623;23.01.2018;2018;01;11;Tiistai;7;8;15
623;23.01.2018;2018;01;12;Tiistai;11;15;26
623;23.01.2018;2018;01;13;Tiistai;14;8;22
623;23.01.2018;2018;01;14;Tiistai;14;13;27
623;23.01.2018;2018;01;15;Tiistai;17;14;31
623;23.01.2018;2018;01;16;Tiistai;21;18;39
623;23.01.2018;2018;01;17;Tiistai;30;26;56
623;23.01.2018;2018;01;18;Tiistai;18;26;44
623;23.01.2018;2018;01;19;Tiistai;10;10;20
623;23.01.2018;2018;01;20;Tiistai;9;8;17
623;23.01.2018;2018;01;21;Tiistai;13;8;21
623;23.01.2018;2018;01;22;Tiistai;8;2;10
623;23.01.2018;2018;01;23;Tiistai;7;3;10
623;24.01.2018;2018;01;00;Keskiviikko;1;3;4
623;24.01.2018;2018;01;01;Keskiviikko;0;0;0
623;24.01.2018;2018;01;02;Keskiviikko;1;1;2
623;24.01.2018;2018;01;03;Keskiviikko;0;0;0
623;24.01.2018;2018;01;04;Keskiviikko;0;3;3
623;24.01.2018;2018;01;05;Keskiviikko;0;1;1
623;24.01.2018;2018;01;06;Keskiviikko;2;8;10
623;24.01.2018;2018;01;07;Keskiviikko;6;32;38
623;24.01.2018;2018;01;08;Keskiviikko;16;61;77
623;24.01.2018;2018;01;09;Keskiviikko;22;65;87
623;24.01.2018;2018;01;10;Keskiviikko;12;25;37
623;24.01.2018;2018;01;11;Keskiviikko;9;10;19
623;24.01.2018;2018;01;12;Keskiviikko;18;9;27
623;24.01.2018;2018;01;13;Keskiviikko;15;21;36
623;24.01.2018;2018;01;14;Keskiviikko;10;21;31
623;24.01.2018;2018;01;15;Keskiviikko;39;25;64
623;24.01.2018;2018;01;16;Keskiviikko;20;13;33
623;24.01.2018;2018;01;17;Keskiviikko;39;26;65
623;24.01.2018;2018;01;18;Keskiviikko;13;22;35
623;24.01.2018;2018;01;19;Keskiviikko;14;8;22
623;24.01.2018;2018;01;20;Keskiviikko;6;7;13
623;24.01.2018;2018;01;21;Keskiviikko;10;6;16
623;24.01.2018;2018;01;22;Keskiviikko;6;6;12
623;24.01.2018;2018;01;23;Keskiviikko;4;2;6
623;25.01.2018;2018;01;00;Torstai;3;9;12
623;25.01.2018;2018;01;01;Torstai;4;1;5
623;25.01.2018;2018;01;02;Torstai;2;1;3
623;25.01.2018;2018;01;03;Torstai;1;1;2
623;25.01.2018;2018;01;04;Torstai;0;3;3
623;25.01.2018;2018;01;05;Torstai;1;2;3
623;25.01.2018;2018;01;06;Torstai;1;2;3
623;25.01.2018;2018;01;07;Torstai;2;21;23
623;25.01.2018;2018;01;08;Torstai;20;41;61
623;25.01.2018;2018;01;09;Torstai;24;51;75
623;25.01.2018;2018;01;10;Torstai;10;25;35
623;25.01.2018;2018;01;11;Torstai;11;18;29
623;25.01.2018;2018;01;12;Torstai;10;15;25
623;25.01.2018;2018;01;13;Torstai;13;22;35
623;25.01.2018;2018;01;14;Torstai;20;16;36
623;25.01.2018;2018;01;15;Torstai;19;20;39
623;25.01.2018;2018;01;16;Torstai;22;22;44
623;25.01.2018;2018;01;17;Torstai;36;35;71
623;25.01.2018;2018;01;18;Torstai;22;20;42
623;25.01.2018;2018;01;19;Torstai;13;9;22
623;25.01.2018;2018;01;20;Torstai;10;5;15
623;25.01.2018;2018;01;21;Torstai;6;7;13
623;25.01.2018;2018;01;22;Torstai;4;4;8
623;25.01.2018;2018;01;23;Torstai;4;5;9
623;26.01.2018;2018;01;00;Perjantai;1;1;2
623;26.01.2018;2018;01;01;Perjantai;3;0;3
623;26.01.2018;2018;01;02;Perjantai;0;1;1
623;26.01.2018;2018;01;03;Perjantai;1;1;2
623;26.01.2018;2018;01;04;Perjantai;1;1;2
623;26.01.2018;2018;01;05;Perjantai;0;2;2
623;26.01.2018;2018;01;06;Perjantai;2;5;7
623;26.01.2018;2018;01;07;Perjantai;2;15;17
623;26.01.2018;2018;01;08;Perjantai;11;38;49
623;26.01.2018;2018;01;09;Perjantai;21;59;80
623;26.01.2018;2018;01;10;Perjantai;13;25;38
623;26.01.2018;2018;01;11;Perjantai;12;17;29
623;26.01.2018;2018;01;12;Perjantai;16;13;29
623;26.01.2018;2018;01;13;Perjantai;23;20;43
623;26.01.2018;2018;01;14;Perjantai;17;22;39
623;26.01.2018;2018;01;15;Perjantai;26;28;54
623;26.01.2018;2018;01;16;Perjantai;37;16;53
623;26.01.2018;2018;01;17;Perjantai;33;26;59
623;26.01.2018;2018;01;18;Perjantai;19;21;40
623;26.01.2018;2018;01;19;Perjantai;19;9;28
623;26.01.2018;2018;01;20;Perjantai;10;9;19
623;26.01.2018;2018;01;21;Perjantai;7;5;12
623;26.01.2018;2018;01;22;Perjantai;6;4;10
623;26.01.2018;2018;01;23;Perjantai;5;5;10
623;27.01.2018;2018;01;00;Lauantai;4;1;5
623;27.01.2018;2018;01;01;Lauantai;6;0;6
623;27.01.2018;2018;01;02;Lauantai;3;0;3
623;27.01.2018;2018;01;03;Lauantai;1;1;2
623;27.01.2018;2018;01;04;Lauantai;1;0;1
623;27.01.2018;2018;01;05;Lauantai;0;4;4
623;27.01.2018;2018;01;06;Lauantai;0;3;3
623;27.01.2018;2018;01;07;Lauantai;1;8;9
623;27.01.2018;2018;01;08;Lauantai;2;3;5
623;27.01.2018;2018;01;09;Lauantai;3;2;5
623;27.01.2018;2018;01;10;Lauantai;2;7;9
623;27.01.2018;2018;01;11;Lauantai;8;9;17
623;27.01.2018;2018;01;12;Lauantai;15;10;25
623;27.01.2018;2018;01;13;Lauantai;13;15;28
623;27.01.2018;2018;01;14;Lauantai;4;18;22
623;27.01.2018;2018;01;15;Lauantai;15;14;29
623;27.01.2018;2018;01;16;Lauantai;16;6;22
623;27.01.2018;2018;01;17;Lauantai;5;7;12
623;27.01.2018;2018;01;18;Lauantai;17;5;22
623;27.01.2018;2018;01;19;Lauantai;6;10;16
623;27.01.2018;2018;01;20;Lauantai;5;14;19
623;27.01.2018;2018;01;21;Lauantai;4;9;13
623;27.01.2018;2018;01;22;Lauantai;7;3;10
623;27.01.2018;2018;01;23;Lauantai;5;3;8
623;28.01.2018;2018;01;00;Sunnuntai;4;3;7
623;28.01.2018;2018;01;01;Sunnuntai;7;3;10
623;28.01.2018;2018;01;02;Sunnuntai;1;4;5
623;28.01.2018;2018;01;03;Sunnuntai;4;2;6
623;28.01.2018;2018;01;04;Sunnuntai;0;0;0
623;28.01.2018;2018;01;05;Sunnuntai;1;3;4
623;28.01.2018;2018;01;06;Sunnuntai;2;2;4
623;28.01.2018;2018;01;07;Sunnuntai;2;5;7
623;28.01.2018;2018;01;08;Sunnuntai;1;0;1
623;28.01.2018;2018;01;09;Sunnuntai;3;5;8
623;28.01.2018;2018;01;10;Sunnuntai;3;12;15
623;28.01.2018;2018;01;11;Sunnuntai;4;9;13
623;28.01.2018;2018;01;12;Sunnuntai;12;15;27
623;28.01.2018;2018;01;13;Sunnuntai;7;17;24
623;28.01.2018;2018;01;14;Sunnuntai;11;17;28
623;28.01.2018;2018;01;15;Sunnuntai;21;24;45
623;28.01.2018;2018;01;16;Sunnuntai;18;18;36
623;28.01.2018;2018;01;17;Sunnuntai;15;12;27
623;28.01.2018;2018;01;18;Sunnuntai;14;13;27
623;28.01.2018;2018;01;19;Sunnuntai;10;11;21
623;28.01.2018;2018;01;20;Sunnuntai;14;9;23
623;28.01.2018;2018;01;21;Sunnuntai;6;5;11
623;28.01.2018;2018;01;22;Sunnuntai;8;2;10
623;28.01.2018;2018;01;23;Sunnuntai;3;3;6
623;29.01.2018;2018;01;00;Maanantai;1;1;2
623;29.01.2018;2018;01;01;Maanantai;3;1;4
623;29.01.2018;2018;01;02;Maanantai;0;0;0
623;29.01.2018;2018;01;03;Maanantai;0;1;1
623;29.01.2018;2018;01;04;Maanantai;0;2;2
623;29.01.2018;2018;01;05;Maanantai;2;2;4
623;29.01.2018;2018;01;06;Maanantai;0;6;6
623;29.01.2018;2018;01;07;Maanantai;5;28;33
623;29.01.2018;2018;01;08;Maanantai;15;58;73
623;29.01.2018;2018;01;09;Maanantai;25;65;90
623;29.01.2018;2018;01;10;Maanantai;19;35;54
623;29.01.2018;2018;01;11;Maanantai;15;12;27
623;29.01.2018;2018;01;12;Maanantai;11;16;27
623;29.01.2018;2018;01;13;Maanantai;18;23;41
623;29.01.2018;2018;01;14;Maanantai;17;18;35
623;29.01.2018;2018;01;15;Maanantai;23;21;44
623;29.01.2018;2018;01;16;Maanantai;29;21;50
623;29.01.2018;2018;01;17;Maanantai;44;42;86
623;29.01.2018;2018;01;18;Maanantai;36;31;67
623;29.01.2018;2018;01;19;Maanantai;18;20;38
623;29.01.2018;2018;01;20;Maanantai;14;10;24
623;29.01.2018;2018;01;21;Maanantai;12;12;24
623;29.01.2018;2018;01;22;Maanantai;5;4;9
623;29.01.2018;2018;01;23;Maanantai;6;8;14
623;30.01.2018;2018;01;00;Tiistai;2;2;4
623;30.01.2018;2018;01;01;Tiistai;0;0;0
623;30.01.2018;2018;01;02;Tiistai;0;0;0
623;30.01.2018;2018;01;03;Tiistai;1;0;1
623;30.01.2018;2018;01;04;Tiistai;0;3;3
623;30.01.2018;2018;01;05;Tiistai;1;1;2
623;30.01.2018;2018;01;06;Tiistai;0;4;4
623;30.01.2018;2018;01;07;Tiistai;5;29;34
623;30.01.2018;2018;01;08;Tiistai;19;65;84
623;30.01.2018;2018;01;09;Tiistai;29;64;93
623;30.01.2018;2018;01;10;Tiistai;13;29;42
623;30.01.2018;2018;01;11;Tiistai;11;18;29
623;30.01.2018;2018;01;12;Tiistai;15;24;39
623;30.01.2018;2018;01;13;Tiistai;11;17;28
623;30.01.2018;2018;01;14;Tiistai;14;14;28
623;30.01.2018;2018;01;15;Tiistai;26;21;47
623;30.01.2018;2018;01;16;Tiistai;33;22;55
623;30.01.2018;2018;01;17;Tiistai;46;42;88
623;30.01.2018;2018;01;18;Tiistai;35;33;68
623;30.01.2018;2018;01;19;Tiistai;17;15;32
623;30.01.2018;2018;01;20;Tiistai;13;9;22
623;30.01.2018;2018;01;21;Tiistai;16;11;27
623;30.01.2018;2018;01;22;Tiistai;13;4;17
623;30.01.2018;2018;01;23;Tiistai;5;4;9
623;31.01.2018;2018;01;00;Keskiviikko;3;1;4
623;31.01.2018;2018;01;01;Keskiviikko;3;1;4
623;31.01.2018;2018;01;02;Keskiviikko;0;0;0
623;31.01.2018;2018;01;03;Keskiviikko;0;2;2
623;31.01.2018;2018;01;04;Keskiviikko;0;1;1
623;31.01.2018;2018;01;05;Keskiviikko;0;3;3
623;31.01.2018;2018;01;06;Keskiviikko;0;6;6
623;31.01.2018;2018;01;07;Keskiviikko;1;23;24
623;31.01.2018;2018;01;08;Keskiviikko;27;71;98
623;31.01.2018;2018;01;09;Keskiviikko;22;57;79
623;31.01.2018;2018;01;10;Keskiviikko;14;30;44
623;31.01.2018;2018;01;11;Keskiviikko;13;18;31
623;31.01.2018;2018;01;12;Keskiviikko;17;19;36
623;31.01.2018;2018;01;13;Keskiviikko;16;24;40
623;31.01.2018;2018;01;14;Keskiviikko;17;20;37
623;31.01.2018;2018;01;15;Keskiviikko;32;34;66
623;31.01.2018;2018;01;16;Keskiviikko;35;27;62
623;31.01.2018;2018;01;17;Keskiviikko;33;47;80
623;31.01.2018;2018;01;18;Keskiviikko;28;33;61
623;31.01.2018;2018;01;19;Keskiviikko;17;15;32
623;31.01.2018;2018;01;20;Keskiviikko;16;8;24
623;31.01.2018;2018;01;21;Keskiviikko;15;10;25
623;31.01.2018;2018;01;22;Keskiviikko;11;1;12
623;31.01.2018;2018;01;23;Keskiviikko;5;7;12
623;01.02.2018;2018;02;00;Torstai;1;3;4
623;01.02.2018;2018;02;01;Torstai;3;2;5
623;01.02.2018;2018;02;02;Torstai;2;2;4
623;01.02.2018;2018;02;03;Torstai;1;4;5
623;01.02.2018;2018;02;04;Torstai;0;2;2
623;01.02.2018;2018;02;05;Torstai;0;0;0
623;01.02.2018;2018;02;06;Torstai;1;6;7
623;01.02.2018;2018;02;07;Torstai;0;23;23
623;01.02.2018;2018;02;08;Torstai;20;48;68
623;01.02.2018;2018;02;09;Torstai;20;49;69
623;01.02.2018;2018;02;10;Torstai;11;23;34
623;01.02.2018;2018;02;11;Torstai;6;13;19
623;01.02.2018;2018;02;12;Torstai;10;13;23
623;01.02.2018;2018;02;13;Torstai;12;18;30
623;01.02.2018;2018;02;14;Torstai;14;14;28
623;01.02.2018;2018;02;15;Torstai;22;17;39
623;01.02.2018;2018;02;16;Torstai;22;22;44
623;01.02.2018;2018;02;17;Torstai;22;32;54
623;01.02.2018;2018;02;18;Torstai;22;24;46
623;01.02.2018;2018;02;19;Torstai;15;15;30
623;01.02.2018;2018;02;20;Torstai;12;7;19
623;01.02.2018;2018;02;21;Torstai;12;7;19
623;01.02.2018;2018;02;22;Torstai;7;2;9
623;01.02.2018;2018;02;23;Torstai;3;3;6
623;02.02.2018;2018;02;00;Perjantai;1;3;4
623;02.02.2018;2018;02;01;Perjantai;3;2;5
623;02.02.2018;2018;02;02;Perjantai;2;2;4
623;02.02.2018;2018;02;03;Perjantai;1;4;5
623;02.02.2018;2018;02;04;Perjantai;0;2;2
623;02.02.2018;2018;02;05;Perjantai;0;0;0
623;02.02.2018;2018;02;06;Perjantai;1;6;7
623;02.02.2018;2018;02;07;Perjantai;0;23;23
623;02.02.2018;2018;02;08;Perjantai;20;48;68
623;02.02.2018;2018;02;09;Perjantai;20;49;69
623;02.02.2018;2018;02;10;Perjantai;11;23;34
623;02.02.2018;2018;02;11;Perjantai;6;13;19
623;02.02.2018;2018;02;12;Perjantai;10;13;23
623;02.02.2018;2018;02;13;Perjantai;12;18;30
623;02.02.2018;2018;02;14;Perjantai;14;14;28
623;02.02.2018;2018;02;15;Perjantai;22;17;39
623;02.02.2018;2018;02;16;Perjantai;21;21;42
623;02.02.2018;2018;02;17;Perjantai;20;20;40
623;02.02.2018;2018;02;18;Perjantai;22;19;41
623;02.02.2018;2018;02;19;Perjantai;15;5;20
623;02.02.2018;2018;02;20;Perjantai;9;11;20
623;02.02.2018;2018;02;21;Perjantai;7;10;17
623;02.02.2018;2018;02;22;Perjantai;4;8;12
623;02.02.2018;2018;02;23;Perjantai;5;5;10
623;03.02.2018;2018;02;00;Lauantai;1;1;2
623;03.02.2018;2018;02;01;Lauantai;1;1;2
623;03.02.2018;2018;02;02;Lauantai;1;1;2
623;03.02.2018;2018;02;03;Lauantai;1;0;1
623;03.02.2018;2018;02;04;Lauantai;1;0;1
623;03.02.2018;2018;02;05;Lauantai;1;0;1
623;03.02.2018;2018;02;06;Lauantai;1;3;4
623;03.02.2018;2018;02;07;Lauantai;0;2;2
623;03.02.2018;2018;02;08;Lauantai;1;3;4
623;03.02.2018;2018;02;09;Lauantai;2;3;5
623;03.02.2018;2018;02;10;Lauantai;2;7;9
623;03.02.2018;2018;02;11;Lauantai;1;6;7
623;03.02.2018;2018;02;12;Lauantai;7;10;17
623;03.02.2018;2018;02;13;Lauantai;4;13;17
623;03.02.2018;2018;02;14;Lauantai;9;12;21
623;03.02.2018;2018;02;15;Lauantai;12;10;22
623;03.02.2018;2018;02;16;Lauantai;13;7;20
623;03.02.2018;2018;02;17;Lauantai;5;6;11
623;03.02.2018;2018;02;18;Lauantai;6;10;16
623;03.02.2018;2018;02;19;Lauantai;5;7;12
623;03.02.2018;2018;02;20;Lauantai;3;4;7
623;03.02.2018;2018;02;21;Lauantai;1;4;5
623;03.02.2018;2018;02;22;Lauantai;4;6;10
623;03.02.2018;2018;02;23;Lauantai;3;5;8
623;04.02.2018;2018;02;00;Sunnuntai;3;1;4
623;04.02.2018;2018;02;01;Sunnuntai;3;2;5
623;04.02.2018;2018;02;02;Sunnuntai;0;0;0
623;04.02.2018;2018;02;03;Sunnuntai;1;1;2
623;04.02.2018;2018;02;04;Sunnuntai;2;0;2
623;04.02.2018;2018;02;05;Sunnuntai;0;3;3
623;04.02.2018;2018;02;06;Sunnuntai;0;0;0
623;04.02.2018;2018;02;07;Sunnuntai;2;4;6
623;04.02.2018;2018;02;08;Sunnuntai;0;1;1
623;04.02.2018;2018;02;09;Sunnuntai;0;1;1
623;04.02.2018;2018;02;10;Sunnuntai;1;2;3
623;04.02.2018;2018;02;11;Sunnuntai;1;6;7
623;04.02.2018;2018;02;12;Sunnuntai;4;9;13
623;04.02.2018;2018;02;13;Sunnuntai;3;4;7
623;04.02.2018;2018;02;14;Sunnuntai;5;3;8
623;04.02.2018;2018;02;15;Sunnuntai;4;8;12
623;04.02.2018;2018;02;16;Sunnuntai;1;6;7
623;04.02.2018;2018;02;17;Sunnuntai;3;3;6
623;04.02.2018;2018;02;18;Sunnuntai;1;5;6
623;04.02.2018;2018;02;19;Sunnuntai;5;4;9
623;04.02.2018;2018;02;20;Sunnuntai;6;5;11
623;04.02.2018;2018;02;21;Sunnuntai;2;3;5
623;04.02.2018;2018;02;22;Sunnuntai;6;3;9
623;04.02.2018;2018;02;23;Sunnuntai;3;2;5
623;05.02.2018;2018;02;00;Maanantai;1;0;1
623;05.02.2018;2018;02;01;Maanantai;0;0;0
623;05.02.2018;2018;02;02;Maanantai;0;0;0
623;05.02.2018;2018;02;03;Maanantai;1;1;2
623;05.02.2018;2018;02;04;Maanantai;0;0;0
623;05.02.2018;2018;02;05;Maanantai;1;1;2
623;05.02.2018;2018;02;06;Maanantai;0;6;6
623;05.02.2018;2018;02;07;Maanantai;2;16;18
623;05.02.2018;2018;02;08;Maanantai;16;43;59
623;05.02.2018;2018;02;09;Maanantai;21;37;58
623;05.02.2018;2018;02;10;Maanantai;9;21;30
623;05.02.2018;2018;02;11;Maanantai;4;16;20
623;05.02.2018;2018;02;12;Maanantai;7;3;10
623;05.02.2018;2018;02;13;Maanantai;7;7;14
623;05.02.2018;2018;02;14;Maanantai;12;12;24
623;05.02.2018;2018;02;15;Maanantai;18;16;34
623;05.02.2018;2018;02;16;Maanantai;19;13;32
623;05.02.2018;2018;02;17;Maanantai;31;28;59
623;05.02.2018;2018;02;18;Maanantai;15;14;29
623;05.02.2018;2018;02;19;Maanantai;10;17;27
623;05.02.2018;2018;02;20;Maanantai;5;9;14
623;05.02.2018;2018;02;21;Maanantai;12;2;14
623;05.02.2018;2018;02;22;Maanantai;6;2;8
623;05.02.2018;2018;02;23;Maanantai;1;0;1
623;06.02.2018;2018;02;00;Tiistai;1;1;2
623;06.02.2018;2018;02;01;Tiistai;2;1;3
623;06.02.2018;2018;02;02;Tiistai;1;0;1
623;06.02.2018;2018;02;03;Tiistai;0;0;0
623;06.02.2018;2018;02;04;Tiistai;0;1;1
623;06.02.2018;2018;02;05;Tiistai;0;2;2
623;06.02.2018;2018;02;06;Tiistai;0;8;8
623;06.02.2018;2018;02;07;Tiistai;4;18;22
623;06.02.2018;2018;02;08;Tiistai;9;37;46
623;06.02.2018;2018;02;09;Tiistai;21;57;78
623;06.02.2018;2018;02;10;Tiistai;7;24;31
623;06.02.2018;2018;02;11;Tiistai;9;11;20
623;06.02.2018;2018;02;12;Tiistai;6;14;20
623;06.02.2018;2018;02;13;Tiistai;13;11;24
623;06.02.2018;2018;02;14;Tiistai;12;18;30
623;06.02.2018;2018;02;15;Tiistai;17;19;36
623;06.02.2018;2018;02;16;Tiistai;22;19;41
623;06.02.2018;2018;02;17;Tiistai;34;35;69
623;06.02.2018;2018;02;18;Tiistai;14;17;31
623;06.02.2018;2018;02;19;Tiistai;13;16;29
623;06.02.2018;2018;02;20;Tiistai;13;12;25
623;06.02.2018;2018;02;21;Tiistai;5;7;12
623;06.02.2018;2018;02;22;Tiistai;10;4;14
623;06.02.2018;2018;02;23;Tiistai;2;4;6
623;07.02.2018;2018;02;00;Keskiviikko;2;1;3
623;07.02.2018;2018;02;01;Keskiviikko;2;0;2
623;07.02.2018;2018;02;02;Keskiviikko;0;1;1
623;07.02.2018;2018;02;03;Keskiviikko;0;1;1
623;07.02.2018;2018;02;04;Keskiviikko;0;1;1
623;07.02.2018;2018;02;05;Keskiviikko;0;1;1
623;07.02.2018;2018;02;06;Keskiviikko;1;8;9
623;07.02.2018;2018;02;07;Keskiviikko;6;25;31
623;07.02.2018;2018;02;08;Keskiviikko;23;62;85
623;07.02.2018;2018;02;09;Keskiviikko;19;66;85
623;07.02.2018;2018;02;10;Keskiviikko;12;21;33
623;07.02.2018;2018;02;11;Keskiviikko;6;14;20
623;07.02.2018;2018;02;12;Keskiviikko;14;21;35
623;07.02.2018;2018;02;13;Keskiviikko;14;21;35
623;07.02.2018;2018;02;14;Keskiviikko;24;17;41
623;07.02.2018;2018;02;15;Keskiviikko;17;23;40
623;07.02.2018;2018;02;16;Keskiviikko;29;21;50
623;07.02.2018;2018;02;17;Keskiviikko;53;35;88
623;07.02.2018;2018;02;18;Keskiviikko;27;21;48
623;07.02.2018;2018;02;19;Keskiviikko;15;16;31
623;07.02.2018;2018;02;20;Keskiviikko;12;12;24
623;07.02.2018;2018;02;21;Keskiviikko;7;9;16
623;07.02.2018;2018;02;22;Keskiviikko;6;8;14
623;07.02.2018;2018;02;23;Keskiviikko;1;4;5
623;08.02.2018;2018;02;00;Torstai;4;2;6
623;08.02.2018;2018;02;01;Torstai;1;0;1
623;08.02.2018;2018;02;02;Torstai;0;0;0
623;08.02.2018;2018;02;03;Torstai;2;1;3
623;08.02.2018;2018;02;04;Torstai;0;2;2
623;08.02.2018;2018;02;05;Torstai;0;3;3
623;08.02.2018;2018;02;06;Torstai;0;5;5
623;08.02.2018;2018;02;07;Torstai;3;20;23
623;08.02.2018;2018;02;08;Torstai;14;47;61
623;08.02.2018;2018;02;09;Torstai;24;66;90
623;08.02.2018;2018;02;10;Torstai;11;36;47
623;08.02.2018;2018;02;11;Torstai;10;17;27
623;08.02.2018;2018;02;12;Torstai;7;17;24
623;08.02.2018;2018;02;13;Torstai;8;13;21
623;08.02.2018;2018;02;14;Torstai;10;17;27
623;08.02.2018;2018;02;15;Torstai;22;23;45
623;08.02.2018;2018;02;16;Torstai;23;14;37
623;08.02.2018;2018;02;17;Torstai;34;41;75
623;08.02.2018;2018;02;18;Torstai;23;20;43
623;08.02.2018;2018;02;19;Torstai;14;18;32
623;08.02.2018;2018;02;20;Torstai;5;10;15
623;08.02.2018;2018;02;21;Torstai;9;10;19
623;08.02.2018;2018;02;22;Torstai;10;6;16
623;08.02.2018;2018;02;23;Torstai;3;9;12
623;09.02.2018;2018;02;00;Perjantai;0;3;3
623;09.02.2018;2018;02;01;Perjantai;0;2;2
623;09.02.2018;2018;02;02;Perjantai;1;1;2
623;09.02.2018;2018;02;03;Perjantai;2;1;3
623;09.02.2018;2018;02;04;Perjantai;2;0;2
623;09.02.2018;2018;02;05;Perjantai;0;2;2
623;09.02.2018;2018;02;06;Perjantai;0;5;5
623;09.02.2018;2018;02;07;Perjantai;6;24;30
623;09.02.2018;2018;02;08;Perjantai;16;50;66
623;09.02.2018;2018;02;09;Perjantai;19;50;69
623;09.02.2018;2018;02;10;Perjantai;10;31;41
623;09.02.2018;2018;02;11;Perjantai;11;17;28
623;09.02.2018;2018;02;12;Perjantai;18;24;42
623;09.02.2018;2018;02;13;Perjantai;12;24;36
623;09.02.2018;2018;02;14;Perjantai;20;18;38
623;09.02.2018;2018;02;15;Perjantai;21;20;41
623;09.02.2018;2018;02;16;Perjantai;27;23;50
623;09.02.2018;2018;02;17;Perjantai;23;37;60
623;09.02.2018;2018;02;18;Perjantai;15;11;26
623;09.02.2018;2018;02;19;Perjantai;10;18;28
623;09.02.2018;2018;02;20;Perjantai;3;11;14
623;09.02.2018;2018;02;21;Perjantai;8;8;16
623;09.02.2018;2018;02;22;Perjantai;4;10;14
623;09.02.2018;2018;02;23;Perjantai;5;5;10
623;10.02.2018;2018;02;00;Lauantai;4;1;5
623;10.02.2018;2018;02;01;Lauantai;1;1;2
623;10.02.2018;2018;02;02;Lauantai;2;0;2
623;10.02.2018;2018;02;03;Lauantai;2;0;2
623;10.02.2018;2018;02;04;Lauantai;2;1;3
623;10.02.2018;2018;02;05;Lauantai;3;1;4
623;10.02.2018;2018;02;06;Lauantai;0;1;1
623;10.02.2018;2018;02;07;Lauantai;1;3;4
623;10.02.2018;2018;02;08;Lauantai;0;5;5
623;10.02.2018;2018;02;09;Lauantai;1;7;8
623;10.02.2018;2018;02;10;Lauantai;4;7;11
623;10.02.2018;2018;02;11;Lauantai;5;6;11
623;10.02.2018;2018;02;12;Lauantai;2;15;17
623;10.02.2018;2018;02;13;Lauantai;10;18;28
623;10.02.2018;2018;02;14;Lauantai;13;18;31
623;10.02.2018;2018;02;15;Lauantai;11;10;21
623;10.02.2018;2018;02;16;Lauantai;11;8;19
623;10.02.2018;2018;02;17;Lauantai;11;11;22
623;10.02.2018;2018;02;18;Lauantai;3;10;13
623;10.02.2018;2018;02;19;Lauantai;7;5;12
623;10.02.2018;2018;02;20;Lauantai;2;5;7
623;10.02.2018;2018;02;21;Lauantai;5;6;11
623;10.02.2018;2018;02;22;Lauantai;8;6;14
623;10.02.2018;2018;02;23;Lauantai;1;5;6
623;11.02.2018;2018;02;00;Sunnuntai;5;3;8
623;11.02.2018;2018;02;01;Sunnuntai;2;2;4
623;11.02.2018;2018;02;02;Sunnuntai;5;0;5
623;11.02.2018;2018;02;03;Sunnuntai;1;0;1
623;11.02.2018;2018;02;04;Sunnuntai;1;0;1
623;11.02.2018;2018;02;05;Sunnuntai;0;1;1
623;11.02.2018;2018;02;06;Sunnuntai;2;0;2
623;11.02.2018;2018;02;07;Sunnuntai;0;3;3
623;11.02.2018;2018;02;08;Sunnuntai;1;4;5
623;11.02.2018;2018;02;09;Sunnuntai;2;1;3
623;11.02.2018;2018;02;10;Sunnuntai;3;4;7
623;11.02.2018;2018;02;11;Sunnuntai;1;11;12
623;11.02.2018;2018;02;12;Sunnuntai;2;9;11
623;11.02.2018;2018;02;13;Sunnuntai;6;14;20
623;11.02.2018;2018;02;14;Sunnuntai;6;7;13
623;11.02.2018;2018;02;15;Sunnuntai;7;15;22
623;11.02.2018;2018;02;16;Sunnuntai;7;10;17
623;11.02.2018;2018;02;17;Sunnuntai;6;8;14
623;11.02.2018;2018;02;18;Sunnuntai;6;6;12
623;11.02.2018;2018;02;19;Sunnuntai;6;7;13
623;11.02.2018;2018;02;20;Sunnuntai;5;7;12
623;11.02.2018;2018;02;21;Sunnuntai;2;10;12
623;11.02.2018;2018;02;22;Sunnuntai;7;2;9
623;11.02.2018;2018;02;23;Sunnuntai;0;2;2
623;12.02.2018;2018;02;00;Maanantai;1;1;2
623;12.02.2018;2018;02;01;Maanantai;1;0;1
623;12.02.2018;2018;02;02;Maanantai;0;0;0
623;12.02.2018;2018;02;03;Maanantai;1;1;2
623;12.02.2018;2018;02;04;Maanantai;0;2;2
623;12.02.2018;2018;02;05;Maanantai;0;0;0
623;12.02.2018;2018;02;06;Maanantai;0;7;7
623;12.02.2018;2018;02;07;Maanantai;6;26;32
623;12.02.2018;2018;02;08;Maanantai;14;56;70
623;12.02.2018;2018;02;09;Maanantai;32;67;99
623;12.02.2018;2018;02;10;Maanantai;16;35;51
623;12.02.2018;2018;02;11;Maanantai;9;19;28
623;12.02.2018;2018;02;12;Maanantai;14;17;31
623;12.02.2018;2018;02;13;Maanantai;7;21;28
623;12.02.2018;2018;02;14;Maanantai;7;13;20
623;12.02.2018;2018;02;15;Maanantai;23;17;40
623;12.02.2018;2018;02;16;Maanantai;24;14;38
623;12.02.2018;2018;02;17;Maanantai;44;31;75
623;12.02.2018;2018;02;18;Maanantai;15;25;40
623;12.02.2018;2018;02;19;Maanantai;11;15;26
623;12.02.2018;2018;02;20;Maanantai;18;11;29
623;12.02.2018;2018;02;21;Maanantai;13;6;19
623;12.02.2018;2018;02;22;Maanantai;6;3;9
623;12.02.2018;2018;02;23;Maanantai;4;7;11
623;13.02.2018;2018;02;00;Tiistai;2;3;5
623;13.02.2018;2018;02;01;Tiistai;1;0;1
623;13.02.2018;2018;02;02;Tiistai;0;0;0
623;13.02.2018;2018;02;03;Tiistai;0;1;1
623;13.02.2018;2018;02;04;Tiistai;0;2;2
623;13.02.2018;2018;02;05;Tiistai;0;1;1
623;13.02.2018;2018;02;06;Tiistai;1;3;4
623;13.02.2018;2018;02;07;Tiistai;1;25;26
623;13.02.2018;2018;02;08;Tiistai;15;58;73
623;13.02.2018;2018;02;09;Tiistai;14;66;80
623;13.02.2018;2018;02;10;Tiistai;11;29;40
623;13.02.2018;2018;02;11;Tiistai;7;13;20
623;13.02.2018;2018;02;12;Tiistai;12;18;30
623;13.02.2018;2018;02;13;Tiistai;7;21;28
623;13.02.2018;2018;02;14;Tiistai;11;21;32
623;13.02.2018;2018;02;15;Tiistai;14;23;37
623;13.02.2018;2018;02;16;Tiistai;27;26;53
623;13.02.2018;2018;02;17;Tiistai;46;35;81
623;13.02.2018;2018;02;18;Tiistai;26;24;50
623;13.02.2018;2018;02;19;Tiistai;19;23;42
623;13.02.2018;2018;02;20;Tiistai;9;8;17
623;13.02.2018;2018;02;21;Tiistai;10;12;22
623;13.02.2018;2018;02;22;Tiistai;6;5;11
623;13.02.2018;2018;02;23;Tiistai;3;8;11
623;14.02.2018;2018;02;00;Keskiviikko;3;1;4
623;14.02.2018;2018;02;01;Keskiviikko;0;1;1
623;14.02.2018;2018;02;02;Keskiviikko;0;1;1
623;14.02.2018;2018;02;03;Keskiviikko;1;2;3
623;14.02.2018;2018;02;04;Keskiviikko;1;2;3
623;14.02.2018;2018;02;05;Keskiviikko;0;1;1
623;14.02.2018;2018;02;06;Keskiviikko;1;6;7
623;14.02.2018;2018;02;07;Keskiviikko;3;23;26
623;14.02.2018;2018;02;08;Keskiviikko;16;53;69
623;14.02.2018;2018;02;09;Keskiviikko;21;61;82
623;14.02.2018;2018;02;10;Keskiviikko;6;26;32
623;14.02.2018;2018;02;11;Keskiviikko;5;16;21
623;14.02.2018;2018;02;12;Keskiviikko;17;17;34
623;14.02.2018;2018;02;13;Keskiviikko;13;24;37
623;14.02.2018;2018;02;14;Keskiviikko;22;25;47
623;14.02.2018;2018;02;15;Keskiviikko;21;41;62
623;14.02.2018;2018;02;16;Keskiviikko;29;23;52
623;14.02.2018;2018;02;17;Keskiviikko;44;33;77
623;14.02.2018;2018;02;18;Keskiviikko;36;31;67
623;14.02.2018;2018;02;19;Keskiviikko;19;16;35
623;14.02.2018;2018;02;20;Keskiviikko;16;4;20
623;14.02.2018;2018;02;21;Keskiviikko;13;12;25
623;14.02.2018;2018;02;22;Keskiviikko;6;5;11
623;14.02.2018;2018;02;23;Keskiviikko;5;10;15
623;15.02.2018;2018;02;00;Torstai;1;1;2
623;15.02.2018;2018;02;01;Torstai;1;0;1
623;15.02.2018;2018;02;02;Torstai;0;0;0
623;15.02.2018;2018;02;03;Torstai;1;2;3
623;15.02.2018;2018;02;04;Torstai;1;1;2
623;15.02.2018;2018;02;05;Torstai;0;1;1
623;15.02.2018;2018;02;06;Torstai;2;2;4
623;15.02.2018;2018;02;07;Torstai;3;28;31
623;15.02.2018;2018;02;08;Torstai;18;58;76
623;15.02.2018;2018;02;09;Torstai;18;58;76
623;15.02.2018;2018;02;10;Torstai;16;30;46
623;15.02.2018;2018;02;11;Torstai;9;6;15
623;15.02.2018;2018;02;12;Torstai;12;22;34
623;15.02.2018;2018;02;13;Torstai;20;32;52
623;15.02.2018;2018;02;14;Torstai;7;19;26
623;15.02.2018;2018;02;15;Torstai;26;18;44
623;15.02.2018;2018;02;16;Torstai;26;17;43
623;15.02.2018;2018;02;17;Torstai;42;38;80
623;15.02.2018;2018;02;18;Torstai;20;26;46
623;15.02.2018;2018;02;19;Torstai;26;13;39
623;15.02.2018;2018;02;20;Torstai;14;10;24
623;15.02.2018;2018;02;21;Torstai;14;9;23
623;15.02.2018;2018;02;22;Torstai;2;6;8
623;15.02.2018;2018;02;23;Torstai;2;4;6
623;16.02.2018;2018;02;00;Perjantai;1;2;3
623;16.02.2018;2018;02;01;Perjantai;1;1;2
623;16.02.2018;2018;02;02;Perjantai;0;0;0
623;16.02.2018;2018;02;03;Perjantai;0;2;2
623;16.02.2018;2018;02;04;Perjantai;1;1;2
623;16.02.2018;2018;02;05;Perjantai;1;0;1
623;16.02.2018;2018;02;06;Perjantai;0;4;4
623;16.02.2018;2018;02;07;Perjantai;3;27;30
623;16.02.2018;2018;02;08;Perjantai;15;52;67
623;16.02.2018;2018;02;09;Perjantai;18;50;68
623;16.02.2018;2018;02;10;Perjantai;16;22;38
623;16.02.2018;2018;02;11;Perjantai;6;20;26
623;16.02.2018;2018;02;12;Perjantai;20;17;37
623;16.02.2018;2018;02;13;Perjantai;16;29;45
623;16.02.2018;2018;02;14;Perjantai;17;21;38
623;16.02.2018;2018;02;15;Perjantai;27;29;56
623;16.02.2018;2018;02;16;Perjantai;27;23;50
623;16.02.2018;2018;02;17;Perjantai;27;27;54
623;16.02.2018;2018;02;18;Perjantai;18;24;42
623;16.02.2018;2018;02;19;Perjantai;16;13;29
623;16.02.2018;2018;02;20;Perjantai;12;12;24
623;16.02.2018;2018;02;21;Perjantai;6;7;13
623;16.02.2018;2018;02;22;Perjantai;8;3;11
623;16.02.2018;2018;02;23;Perjantai;6;3;9
623;17.02.2018;2018;02;00;Lauantai;1;2;3
623;17.02.2018;2018;02;01;Lauantai;1;4;5
623;17.02.2018;2018;02;02;Lauantai;4;2;6
623;17.02.2018;2018;02;03;Lauantai;5;0;5
623;17.02.2018;2018;02;04;Lauantai;0;0;0
623;17.02.2018;2018;02;05;Lauantai;0;1;1
623;17.02.2018;2018;02;06;Lauantai;0;3;3
623;17.02.2018;2018;02;07;Lauantai;0;4;4
623;17.02.2018;2018;02;08;Lauantai;0;1;1
623;17.02.2018;2018;02;09;Lauantai;1;6;7
623;17.02.2018;2018;02;10;Lauantai;0;7;7
623;17.02.2018;2018;02;11;Lauantai;6;11;17
623;17.02.2018;2018;02;12;Lauantai;2;11;13
623;17.02.2018;2018;02;13;Lauantai;5;9;14
623;17.02.2018;2018;02;14;Lauantai;5;15;20
623;17.02.2018;2018;02;15;Lauantai;6;15;21
623;17.02.2018;2018;02;16;Lauantai;13;7;20
623;17.02.2018;2018;02;17;Lauantai;11;7;18
623;17.02.2018;2018;02;18;Lauantai;5;9;14
623;17.02.2018;2018;02;19;Lauantai;6;9;15
623;17.02.2018;2018;02;20;Lauantai;1;4;5
623;17.02.2018;2018;02;21;Lauantai;5;6;11
623;17.02.2018;2018;02;22;Lauantai;3;8;11
623;17.02.2018;2018;02;23;Lauantai;4;2;6
623;18.02.2018;2018;02;00;Sunnuntai;1;1;2
623;18.02.2018;2018;02;01;Sunnuntai;2;3;5
623;18.02.2018;2018;02;02;Sunnuntai;4;1;5
623;18.02.2018;2018;02;03;Sunnuntai;1;1;2
623;18.02.2018;2018;02;04;Sunnuntai;1;1;2
623;18.02.2018;2018;02;05;Sunnuntai;1;0;1
623;18.02.2018;2018;02;06;Sunnuntai;0;2;2
623;18.02.2018;2018;02;07;Sunnuntai;0;1;1
623;18.02.2018;2018;02;08;Sunnuntai;2;0;2
623;18.02.2018;2018;02;09;Sunnuntai;3;1;4
623;18.02.2018;2018;02;10;Sunnuntai;1;3;4
623;18.02.2018;2018;02;11;Sunnuntai;4;9;13
623;18.02.2018;2018;02;12;Sunnuntai;2;9;11
623;18.02.2018;2018;02;13;Sunnuntai;8;12;20
623;18.02.2018;2018;02;14;Sunnuntai;5;9;14
623;18.02.2018;2018;02;15;Sunnuntai;8;7;15
623;18.02.2018;2018;02;16;Sunnuntai;5;3;8
623;18.02.2018;2018;02;17;Sunnuntai;3;9;12
623;18.02.2018;2018;02;18;Sunnuntai;6;13;19
623;18.02.2018;2018;02;19;Sunnuntai;5;10;15
623;18.02.2018;2018;02;20;Sunnuntai;2;5;7
623;18.02.2018;2018;02;21;Sunnuntai;2;6;8
623;18.02.2018;2018;02;22;Sunnuntai;5;3;8
623;18.02.2018;2018;02;23;Sunnuntai;1;2;3
623;19.02.2018;2018;02;00;Maanantai;1;1;2
623;19.02.2018;2018;02;01;Maanantai;1;1;2
623;19.02.2018;2018;02;02;Maanantai;1;0;1
623;19.02.2018;2018;02;03;Maanantai;0;2;2
623;19.02.2018;2018;02;04;Maanantai;1;2;3
623;19.02.2018;2018;02;05;Maanantai;1;3;4
623;19.02.2018;2018;02;06;Maanantai;1;3;4
623;19.02.2018;2018;02;07;Maanantai;1;24;25
623;19.02.2018;2018;02;08;Maanantai;17;57;74
623;19.02.2018;2018;02;09;Maanantai;23;42;65
623;19.02.2018;2018;02;10;Maanantai;14;25;39
623;19.02.2018;2018;02;11;Maanantai;4;12;16
623;19.02.2018;2018;02;12;Maanantai;6;14;20
623;19.02.2018;2018;02;13;Maanantai;14;12;26
623;19.02.2018;2018;02;14;Maanantai;12;9;21
623;19.02.2018;2018;02;15;Maanantai;21;18;39
623;19.02.2018;2018;02;16;Maanantai;21;17;38
623;19.02.2018;2018;02;17;Maanantai;42;25;67
623;19.02.2018;2018;02;18;Maanantai;18;16;34
623;19.02.2018;2018;02;19;Maanantai;15;12;27
623;19.02.2018;2018;02;20;Maanantai;12;7;19
623;19.02.2018;2018;02;21;Maanantai;3;1;4
623;19.02.2018;2018;02;22;Maanantai;3;6;9
623;19.02.2018;2018;02;23;Maanantai;0;3;3
623;20.02.2018;2018;02;00;Tiistai;1;1;2
623;20.02.2018;2018;02;01;Tiistai;1;0;1
623;20.02.2018;2018;02;02;Tiistai;0;0;0
623;20.02.2018;2018;02;03;Tiistai;1;1;2
623;20.02.2018;2018;02;04;Tiistai;0;1;1
623;20.02.2018;2018;02;05;Tiistai;0;2;2
623;20.02.2018;2018;02;06;Tiistai;0;6;6
623;20.02.2018;2018;02;07;Tiistai;1;15;16
623;20.02.2018;2018;02;08;Tiistai;12;43;55
623;20.02.2018;2018;02;09;Tiistai;17;38;55
623;20.02.2018;2018;02;10;Tiistai;12;23;35
623;20.02.2018;2018;02;11;Tiistai;4;7;11
623;20.02.2018;2018;02;12;Tiistai;9;12;21
623;20.02.2018;2018;02;13;Tiistai;9;12;21
623;20.02.2018;2018;02;14;Tiistai;15;16;31
623;20.02.2018;2018;02;15;Tiistai;13;13;26
623;20.02.2018;2018;02;16;Tiistai;30;12;42
623;20.02.2018;2018;02;17;Tiistai;28;31;59
623;20.02.2018;2018;02;18;Tiistai;22;19;41
623;20.02.2018;2018;02;19;Tiistai;6;11;17
623;20.02.2018;2018;02;20;Tiistai;9;6;15
623;20.02.2018;2018;02;21;Tiistai;5;8;13
623;20.02.2018;2018;02;22;Tiistai;7;5;12
623;20.02.2018;2018;02;23;Tiistai;5;6;11
623;21.02.2018;2018;02;00;Keskiviikko;0;0;0
623;21.02.2018;2018;02;01;Keskiviikko;1;1;2
623;21.02.2018;2018;02;02;Keskiviikko;1;0;1
623;21.02.2018;2018;02;03;Keskiviikko;0;2;2
623;21.02.2018;2018;02;04;Keskiviikko;0;0;0
623;21.02.2018;2018;02;05;Keskiviikko;1;2;3
623;21.02.2018;2018;02;06;Keskiviikko;2;6;8
623;21.02.2018;2018;02;07;Keskiviikko;1;22;23
623;21.02.2018;2018;02;08;Keskiviikko;18;52;70
623;21.02.2018;2018;02;09;Keskiviikko;12;48;60
623;21.02.2018;2018;02;10;Keskiviikko;12;18;30
623;21.02.2018;2018;02;11;Keskiviikko;6;13;19
623;21.02.2018;2018;02;12;Keskiviikko;3;9;12
623;21.02.2018;2018;02;13;Keskiviikko;11;24;35
623;21.02.2018;2018;02;14;Keskiviikko;12;9;21
623;21.02.2018;2018;02;15;Keskiviikko;22;21;43
623;21.02.2018;2018;02;16;Keskiviikko;27;21;48
623;21.02.2018;2018;02;17;Keskiviikko;33;27;60
623;21.02.2018;2018;02;18;Keskiviikko;23;22;45
623;21.02.2018;2018;02;19;Keskiviikko;16;16;32
623;21.02.2018;2018;02;20;Keskiviikko;19;7;26
623;21.02.2018;2018;02;21;Keskiviikko;8;9;17
623;21.02.2018;2018;02;22;Keskiviikko;8;4;12
623;21.02.2018;2018;02;23;Keskiviikko;2;2;4
623;22.02.2018;2018;02;00;Torstai;2;1;3
623;22.02.2018;2018;02;01;Torstai;2;0;2
623;22.02.2018;2018;02;02;Torstai;2;0;2
623;22.02.2018;2018;02;03;Torstai;1;1;2
623;22.02.2018;2018;02;04;Torstai;0;1;1
623;22.02.2018;2018;02;05;Torstai;0;3;3
623;22.02.2018;2018;02;06;Torstai;1;0;1
623;22.02.2018;2018;02;07;Torstai;2;23;25
623;22.02.2018;2018;02;08;Torstai;20;48;68
623;22.02.2018;2018;02;09;Torstai;19;45;64
623;22.02.2018;2018;02;10;Torstai;12;22;34
623;22.02.2018;2018;02;11;Torstai;9;7;16
623;22.02.2018;2018;02;12;Torstai;5;18;23
623;22.02.2018;2018;02;13;Torstai;4;25;29
623;22.02.2018;2018;02;14;Torstai;14;14;28
623;22.02.2018;2018;02;15;Torstai;18;12;30
623;22.02.2018;2018;02;16;Torstai;30;23;53
623;22.02.2018;2018;02;17;Torstai;37;37;74
623;22.02.2018;2018;02;18;Torstai;18;24;42
623;22.02.2018;2018;02;19;Torstai;8;17;25
623;22.02.2018;2018;02;20;Torstai;10;3;13
623;22.02.2018;2018;02;21;Torstai;4;5;9
623;22.02.2018;2018;02;22;Torstai;10;8;18
623;22.02.2018;2018;02;23;Torstai;1;0;1
623;23.02.2018;2018;02;00;Perjantai;0;2;2
623;23.02.2018;2018;02;01;Perjantai;2;1;3
623;23.02.2018;2018;02;02;Perjantai;0;1;1
623;23.02.2018;2018;02;03;Perjantai;0;2;2
623;23.02.2018;2018;02;04;Perjantai;0;1;1
623;23.02.2018;2018;02;05;Perjantai;1;1;2
623;23.02.2018;2018;02;06;Perjantai;1;3;4
623;23.02.2018;2018;02;07;Perjantai;1;22;23
623;23.02.2018;2018;02;08;Perjantai;18;45;63
623;23.02.2018;2018;02;09;Perjantai;11;42;53
623;23.02.2018;2018;02;10;Perjantai;15;15;30
623;23.02.2018;2018;02;11;Perjantai;6;14;20
623;23.02.2018;2018;02;12;Perjantai;6;21;27
623;23.02.2018;2018;02;13;Perjantai;9;10;19
623;23.02.2018;2018;02;14;Perjantai;14;17;31
623;23.02.2018;2018;02;15;Perjantai;21;17;38
623;23.02.2018;2018;02;16;Perjantai;26;17;43
623;23.02.2018;2018;02;17;Perjantai;18;16;34
623;23.02.2018;2018;02;18;Perjantai;10;21;31
623;23.02.2018;2018;02;19;Perjantai;19;15;34
623;23.02.2018;2018;02;20;Perjantai;5;6;11
623;23.02.2018;2018;02;21;Perjantai;7;10;17
623;23.02.2018;2018;02;22;Perjantai;6;4;10
623;23.02.2018;2018;02;23;Perjantai;5;4;9
623;24.02.2018;2018;02;00;Lauantai;2;1;3
623;24.02.2018;2018;02;01;Lauantai;2;2;4
623;24.02.2018;2018;02;02;Lauantai;1;1;2
623;24.02.2018;2018;02;03;Lauantai;0;1;1
623;24.02.2018;2018;02;04;Lauantai;0;0;0
623;24.02.2018;2018;02;05;Lauantai;0;2;2
623;24.02.2018;2018;02;06;Lauantai;1;5;6
623;24.02.2018;2018;02;07;Lauantai;0;3;3
623;24.02.2018;2018;02;08;Lauantai;3;3;6
623;24.02.2018;2018;02;09;Lauantai;1;6;7
623;24.02.2018;2018;02;10;Lauantai;0;4;4
623;24.02.2018;2018;02;11;Lauantai;3;6;9
623;24.02.2018;2018;02;12;Lauantai;6;7;13
623;24.02.2018;2018;02;13;Lauantai;3;9;12
623;24.02.2018;2018;02;14;Lauantai;4;9;13
623;24.02.2018;2018;02;15;Lauantai;11;15;26
623;24.02.2018;2018;02;16;Lauantai;12;6;18
623;24.02.2018;2018;02;17;Lauantai;9;7;16
623;24.02.2018;2018;02;18;Lauantai;6;5;11
623;24.02.2018;2018;02;19;Lauantai;5;7;12
623;24.02.2018;2018;02;20;Lauantai;5;2;7
623;24.02.2018;2018;02;21;Lauantai;2;6;8
623;24.02.2018;2018;02;22;Lauantai;1;2;3
623;24.02.2018;2018;02;23;Lauantai;2;5;7
623;25.02.2018;2018;02;00;Sunnuntai;3;5;8
623;25.02.2018;2018;02;01;Sunnuntai;1;0;1
623;25.02.2018;2018;02;02;Sunnuntai;0;0;0
623;25.02.2018;2018;02;03;Sunnuntai;0;0;0
623;25.02.2018;2018;02;04;Sunnuntai;2;0;2
623;25.02.2018;2018;02;05;Sunnuntai;2;3;5
623;25.02.2018;2018;02;06;Sunnuntai;0;2;2
623;25.02.2018;2018;02;07;Sunnuntai;0;2;2
623;25.02.2018;2018;02;08;Sunnuntai;0;3;3
623;25.02.2018;2018;02;09;Sunnuntai;1;1;2
623;25.02.2018;2018;02;10;Sunnuntai;1;4;5
623;25.02.2018;2018;02;11;Sunnuntai;2;4;6
623;25.02.2018;2018;02;12;Sunnuntai;3;12;15
623;25.02.2018;2018;02;13;Sunnuntai;5;12;17
623;25.02.2018;2018;02;14;Sunnuntai;5;11;16
623;25.02.2018;2018;02;15;Sunnuntai;8;8;16
623;25.02.2018;2018;02;16;Sunnuntai;13;11;24
623;25.02.2018;2018;02;17;Sunnuntai;10;6;16
623;25.02.2018;2018;02;18;Sunnuntai;7;9;16
623;25.02.2018;2018;02;19;Sunnuntai;10;10;20
623;25.02.2018;2018;02;20;Sunnuntai;5;3;8
623;25.02.2018;2018;02;21;Sunnuntai;0;0;0
623;25.02.2018;2018;02;22;Sunnuntai;7;5;12
623;25.02.2018;2018;02;23;Sunnuntai;1;0;1
623;26.02.2018;2018;02;00;Maanantai;1;1;2
623;26.02.2018;2018;02;01;Maanantai;0;0;0
623;26.02.2018;2018;02;02;Maanantai;0;0;0
623;26.02.2018;2018;02;03;Maanantai;1;1;2
623;26.02.2018;2018;02;04;Maanantai;0;1;1
623;26.02.2018;2018;02;05;Maanantai;0;2;2
623;26.02.2018;2018;02;06;Maanantai;0;2;2
623;26.02.2018;2018;02;07;Maanantai;2;23;25
623;26.02.2018;2018;02;08;Maanantai;19;57;76
623;26.02.2018;2018;02;09;Maanantai;22;53;75
623;26.02.2018;2018;02;10;Maanantai;9;29;38
623;26.02.2018;2018;02;11;Maanantai;7;14;21
623;26.02.2018;2018;02;12;Maanantai;10;17;27
623;26.02.2018;2018;02;13;Maanantai;6;14;20
623;26.02.2018;2018;02;14;Maanantai;10;23;33
623;26.02.2018;2018;02;15;Maanantai;11;26;37
623;26.02.2018;2018;02;16;Maanantai;32;18;50
623;26.02.2018;2018;02;17;Maanantai;43;37;80
623;26.02.2018;2018;02;18;Maanantai;22;30;52
623;26.02.2018;2018;02;19;Maanantai;19;19;38
623;26.02.2018;2018;02;20;Maanantai;13;10;23
623;26.02.2018;2018;02;21;Maanantai;8;9;17
623;26.02.2018;2018;02;22;Maanantai;7;8;15
623;26.02.2018;2018;02;23;Maanantai;3;1;4
623;27.02.2018;2018;02;00;Tiistai;1;0;1
623;27.02.2018;2018;02;01;Tiistai;1;1;2
623;27.02.2018;2018;02;02;Tiistai;0;1;1
623;27.02.2018;2018;02;03;Tiistai;0;1;1
623;27.02.2018;2018;02;04;Tiistai;1;2;3
623;27.02.2018;2018;02;05;Tiistai;1;4;5
623;27.02.2018;2018;02;06;Tiistai;0;2;2
623;27.02.2018;2018;02;07;Tiistai;3;20;23
623;27.02.2018;2018;02;08;Tiistai;16;45;61
623;27.02.2018;2018;02;09;Tiistai;23;56;79
623;27.02.2018;2018;02;10;Tiistai;9;17;26
623;27.02.2018;2018;02;11;Tiistai;10;7;17
623;27.02.2018;2018;02;12;Tiistai;10;12;22
623;27.02.2018;2018;02;13;Tiistai;11;19;30
623;27.02.2018;2018;02;14;Tiistai;15;17;32
623;27.02.2018;2018;02;15;Tiistai;18;15;33
623;27.02.2018;2018;02;16;Tiistai;25;20;45
623;27.02.2018;2018;02;17;Tiistai;30;35;65
623;27.02.2018;2018;02;18;Tiistai;15;28;43
623;27.02.2018;2018;02;19;Tiistai;13;19;32
623;27.02.2018;2018;02;20;Tiistai;21;11;32
623;27.02.2018;2018;02;21;Tiistai;7;6;13
623;27.02.2018;2018;02;22;Tiistai;7;0;7
623;27.02.2018;2018;02;23;Tiistai;1;2;3
623;28.02.2018;2018;02;00;Keskiviikko;1;2;3
623;28.02.2018;2018;02;01;Keskiviikko;1;1;2
623;28.02.2018;2018;02;02;Keskiviikko;0;1;1
623;28.02.2018;2018;02;03;Keskiviikko;0;1;1
623;28.02.2018;2018;02;04;Keskiviikko;0;1;1
623;28.02.2018;2018;02;05;Keskiviikko;0;2;2
623;28.02.2018;2018;02;06;Keskiviikko;0;4;4
623;28.02.2018;2018;02;07;Keskiviikko;1;16;17
623;28.02.2018;2018;02;08;Keskiviikko;10;35;45
623;28.02.2018;2018;02;09;Keskiviikko;13;41;54
623;28.02.2018;2018;02;10;Keskiviikko;6;15;21
623;28.02.2018;2018;02;11;Keskiviikko;2;8;10
623;28.02.2018;2018;02;12;Keskiviikko;9;7;16
623;28.02.2018;2018;02;13;Keskiviikko;8;13;21
623;28.02.2018;2018;02;14;Keskiviikko;7;12;19
623;28.02.2018;2018;02;15;Keskiviikko;16;22;38
623;28.02.2018;2018;02;16;Keskiviikko;21;20;41
623;28.02.2018;2018;02;17;Keskiviikko;21;23;44
623;28.02.2018;2018;02;18;Keskiviikko;14;17;31
623;28.02.2018;2018;02;19;Keskiviikko;13;15;28
623;28.02.2018;2018;02;20;Keskiviikko;15;7;22
623;28.02.2018;2018;02;21;Keskiviikko;5;4;9
623;28.02.2018;2018;02;22;Keskiviikko;7;7;14
623;28.02.2018;2018;02;23;Keskiviikko;2;4;6
623;01.03.2018;2018;03;00;Torstai;0;0;0
623;01.03.2018;2018;03;01;Torstai;0;1;1
623;01.03.2018;2018;03;02;Torstai;1;1;2
623;01.03.2018;2018;03;03;Torstai;0;2;2
623;01.03.2018;2018;03;04;Torstai;1;1;2
623;01.03.2018;2018;03;05;Torstai;0;3;3
623;01.03.2018;2018;03;06;Torstai;0;3;3
623;01.03.2018;2018;03;07;Torstai;0;14;14
623;01.03.2018;2018;03;08;Torstai;18;45;63
623;01.03.2018;2018;03;09;Torstai;19;38;57
623;01.03.2018;2018;03;10;Torstai;13;30;43
623;01.03.2018;2018;03;11;Torstai;5;10;15
623;01.03.2018;2018;03;12;Torstai;8;21;29
623;01.03.2018;2018;03;13;Torstai;2;6;8
623;01.03.2018;2018;03;14;Torstai;9;14;23
623;01.03.2018;2018;03;15;Torstai;15;19;34
623;01.03.2018;2018;03;16;Torstai;26;22;48
623;01.03.2018;2018;03;17;Torstai;30;32;62
623;01.03.2018;2018;03;18;Torstai;25;23;48
623;01.03.2018;2018;03;19;Torstai;14;14;28
623;01.03.2018;2018;03;20;Torstai;8;10;18
623;01.03.2018;2018;03;21;Torstai;9;9;18
623;01.03.2018;2018;03;22;Torstai;5;0;5
623;01.03.2018;2018;03;23;Torstai;3;5;8
623;02.03.2018;2018;03;00;Perjantai;0;1;1
623;02.03.2018;2018;03;01;Perjantai;0;2;2
623;02.03.2018;2018;03;02;Perjantai;0;0;0
623;02.03.2018;2018;03;03;Perjantai;0;3;3
623;02.03.2018;2018;03;04;Perjantai;1;1;2
623;02.03.2018;2018;03;05;Perjantai;1;3;4
623;02.03.2018;2018;03;06;Perjantai;0;4;4
623;02.03.2018;2018;03;07;Perjantai;1;21;22
623;02.03.2018;2018;03;08;Perjantai;15;48;63
623;02.03.2018;2018;03;09;Perjantai;13;51;64
623;02.03.2018;2018;03;10;Perjantai;15;28;43
623;02.03.2018;2018;03;11;Perjantai;10;16;26
623;02.03.2018;2018;03;12;Perjantai;11;16;27
623;02.03.2018;2018;03;13;Perjantai;12;14;26
623;02.03.2018;2018;03;14;Perjantai;12;19;31
623;02.03.2018;2018;03;15;Perjantai;17;17;34
623;02.03.2018;2018;03;16;Perjantai;19;23;42
623;02.03.2018;2018;03;17;Perjantai;18;27;45
623;02.03.2018;2018;03;18;Perjantai;18;28;46
623;02.03.2018;2018;03;19;Perjantai;10;11;21
623;02.03.2018;2018;03;20;Perjantai;7;5;12
623;02.03.2018;2018;03;21;Perjantai;6;7;13
623;02.03.2018;2018;03;22;Perjantai;7;5;12
623;02.03.2018;2018;03;23;Perjantai;9;2;11
623;03.03.2018;2018;03;00;Lauantai;1;1;2
623;03.03.2018;2018;03;01;Lauantai;3;3;6
623;03.03.2018;2018;03;02;Lauantai;1;1;2
623;03.03.2018;2018;03;03;Lauantai;2;3;5
623;03.03.2018;2018;03;04;Lauantai;0;1;1
623;03.03.2018;2018;03;05;Lauantai;1;2;3
623;03.03.2018;2018;03;06;Lauantai;0;0;0
623;03.03.2018;2018;03;07;Lauantai;0;3;3
623;03.03.2018;2018;03;08;Lauantai;1;6;7
623;03.03.2018;2018;03;09;Lauantai;2;4;6
623;03.03.2018;2018;03;10;Lauantai;4;9;13
623;03.03.2018;2018;03;11;Lauantai;4;8;12
623;03.03.2018;2018;03;12;Lauantai;10;9;19
623;03.03.2018;2018;03;13;Lauantai;4;10;14
623;03.03.2018;2018;03;14;Lauantai;5;15;20
623;03.03.2018;2018;03;15;Lauantai;11;11;22
623;03.03.2018;2018;03;16;Lauantai;12;10;22
623;03.03.2018;2018;03;17;Lauantai;11;11;22
623;03.03.2018;2018;03;18;Lauantai;6;10;16
623;03.03.2018;2018;03;19;Lauantai;4;6;10
623;03.03.2018;2018;03;20;Lauantai;3;7;10
623;03.03.2018;2018;03;21;Lauantai;7;6;13
623;03.03.2018;2018;03;22;Lauantai;5;3;8
623;03.03.2018;2018;03;23;Lauantai;1;2;3
623;04.03.2018;2018;03;00;Sunnuntai;4;2;6
623;04.03.2018;2018;03;01;Sunnuntai;2;2;4
623;04.03.2018;2018;03;02;Sunnuntai;3;1;4
623;04.03.2018;2018;03;03;Sunnuntai;4;2;6
623;04.03.2018;2018;03;04;Sunnuntai;2;0;2
623;04.03.2018;2018;03;05;Sunnuntai;3;3;6
623;04.03.2018;2018;03;06;Sunnuntai;1;0;1
623;04.03.2018;2018;03;07;Sunnuntai;1;4;5
623;04.03.2018;2018;03;08;Sunnuntai;1;2;3
623;04.03.2018;2018;03;09;Sunnuntai;2;2;4
623;04.03.2018;2018;03;10;Sunnuntai;1;4;5
623;04.03.2018;2018;03;11;Sunnuntai;2;6;8
623;04.03.2018;2018;03;12;Sunnuntai;8;15;23
623;04.03.2018;2018;03;13;Sunnuntai;3;6;9
623;04.03.2018;2018;03;14;Sunnuntai;6;14;20
623;04.03.2018;2018;03;15;Sunnuntai;5;10;15
623;04.03.2018;2018;03;16;Sunnuntai;4;9;13
623;04.03.2018;2018;03;17;Sunnuntai;5;5;10
623;04.03.2018;2018;03;18;Sunnuntai;10;9;19
623;04.03.2018;2018;03;19;Sunnuntai;4;5;9
623;04.03.2018;2018;03;20;Sunnuntai;6;6;12
623;04.03.2018;2018;03;21;Sunnuntai;7;1;8
623;04.03.2018;2018;03;22;Sunnuntai;6;5;11
623;04.03.2018;2018;03;23;Sunnuntai;0;4;4
623;05.03.2018;2018;03;00;Maanantai;1;3;4
623;05.03.2018;2018;03;01;Maanantai;2;2;4
623;05.03.2018;2018;03;02;Maanantai;0;0;0
623;05.03.2018;2018;03;03;Maanantai;1;1;2
623;05.03.2018;2018;03;04;Maanantai;1;1;2
623;05.03.2018;2018;03;05;Maanantai;0;2;2
623;05.03.2018;2018;03;06;Maanantai;0;4;4
623;05.03.2018;2018;03;07;Maanantai;3;21;24
623;05.03.2018;2018;03;08;Maanantai;12;36;48
623;05.03.2018;2018;03;09;Maanantai;9;26;35
623;05.03.2018;2018;03;10;Maanantai;8;17;25
623;05.03.2018;2018;03;11;Maanantai;5;7;12
623;05.03.2018;2018;03;12;Maanantai;4;14;18
623;05.03.2018;2018;03;13;Maanantai;8;14;22
623;05.03.2018;2018;03;14;Maanantai;13;10;23
623;05.03.2018;2018;03;15;Maanantai;10;14;24
623;05.03.2018;2018;03;16;Maanantai;17;10;27
623;05.03.2018;2018;03;17;Maanantai;30;24;54
623;05.03.2018;2018;03;18;Maanantai;11;12;23
623;05.03.2018;2018;03;19;Maanantai;12;7;19
623;05.03.2018;2018;03;20;Maanantai;8;10;18
623;05.03.2018;2018;03;21;Maanantai;5;7;12
623;05.03.2018;2018;03;22;Maanantai;5;1;6
623;05.03.2018;2018;03;23;Maanantai;3;3;6
623;06.03.2018;2018;03;00;Tiistai;1;0;1
623;06.03.2018;2018;03;01;Tiistai;1;0;1
623;06.03.2018;2018;03;02;Tiistai;0;0;0
623;06.03.2018;2018;03;03;Tiistai;0;0;0
623;06.03.2018;2018;03;04;Tiistai;1;3;4
623;06.03.2018;2018;03;05;Tiistai;0;2;2
623;06.03.2018;2018;03;06;Tiistai;0;6;6
623;06.03.2018;2018;03;07;Tiistai;1;24;25
623;06.03.2018;2018;03;08;Tiistai;12;32;44
623;06.03.2018;2018;03;09;Tiistai;9;20;29
623;06.03.2018;2018;03;10;Tiistai;6;8;14
623;06.03.2018;2018;03;11;Tiistai;3;11;14
623;06.03.2018;2018;03;12;Tiistai;2;15;17
623;06.03.2018;2018;03;13;Tiistai;4;13;17
623;06.03.2018;2018;03;14;Tiistai;6;11;17
623;06.03.2018;2018;03;15;Tiistai;13;22;35
623;06.03.2018;2018;03;16;Tiistai;19;6;25
623;06.03.2018;2018;03;17;Tiistai;15;17;32
623;06.03.2018;2018;03;18;Tiistai;17;18;35
623;06.03.2018;2018;03;19;Tiistai;10;9;19
623;06.03.2018;2018;03;20;Tiistai;11;5;16
623;06.03.2018;2018;03;21;Tiistai;3;6;9
623;06.03.2018;2018;03;22;Tiistai;7;3;10
623;06.03.2018;2018;03;23;Tiistai;3;0;3
623;07.03.2018;2018;03;00;Keskiviikko;1;0;1
623;07.03.2018;2018;03;01;Keskiviikko;1;1;2
623;07.03.2018;2018;03;02;Keskiviikko;0;0;0
623;07.03.2018;2018;03;03;Keskiviikko;1;1;2
623;07.03.2018;2018;03;04;Keskiviikko;0;1;1
623;07.03.2018;2018;03;05;Keskiviikko;1;1;2
623;07.03.2018;2018;03;06;Keskiviikko;1;3;4
623;07.03.2018;2018;03;07;Keskiviikko;4;22;26
623;07.03.2018;2018;03;08;Keskiviikko;6;24;30
623;07.03.2018;2018;03;09;Keskiviikko;7;22;29
623;07.03.2018;2018;03;10;Keskiviikko;7;10;17
623;07.03.2018;2018;03;11;Keskiviikko;2;16;18
623;07.03.2018;2018;03;12;Keskiviikko;4;14;18
623;07.03.2018;2018;03;13;Keskiviikko;8;18;26
623;07.03.2018;2018;03;14;Keskiviikko;15;10;25
623;07.03.2018;2018;03;15;Keskiviikko;8;20;28
623;07.03.2018;2018;03;16;Keskiviikko;22;7;29
623;07.03.2018;2018;03;17;Keskiviikko;21;22;43
623;07.03.2018;2018;03;18;Keskiviikko;11;14;25
623;07.03.2018;2018;03;19;Keskiviikko;12;8;20
623;07.03.2018;2018;03;20;Keskiviikko;14;11;25
623;07.03.2018;2018;03;21;Keskiviikko;7;5;12
623;07.03.2018;2018;03;22;Keskiviikko;4;8;12
623;07.03.2018;2018;03;23;Keskiviikko;1;2;3
623;08.03.2018;2018;03;00;Torstai;1;1;2
623;08.03.2018;2018;03;01;Torstai;0;0;0
623;08.03.2018;2018;03;02;Torstai;0;1;1
623;08.03.2018;2018;03;03;Torstai;1;2;3
623;08.03.2018;2018;03;04;Torstai;0;3;3
623;08.03.2018;2018;03;05;Torstai;0;0;0
623;08.03.2018;2018;03;06;Torstai;0;3;3
623;08.03.2018;2018;03;07;Torstai;2;21;23
623;08.03.2018;2018;03;08;Torstai;7;37;44
623;08.03.2018;2018;03;09;Torstai;8;26;34
623;08.03.2018;2018;03;10;Torstai;7;16;23
623;08.03.2018;2018;03;11;Torstai;5;15;20
623;08.03.2018;2018;03;12;Torstai;13;16;29
623;08.03.2018;2018;03;13;Torstai;5;14;19
623;08.03.2018;2018;03;14;Torstai;11;16;27
623;08.03.2018;2018;03;15;Torstai;11;16;27
623;08.03.2018;2018;03;16;Torstai;21;8;29
623;08.03.2018;2018;03;17;Torstai;18;25;43
623;08.03.2018;2018;03;18;Torstai;8;18;26
623;08.03.2018;2018;03;19;Torstai;14;10;24
623;08.03.2018;2018;03;20;Torstai;7;7;14
623;08.03.2018;2018;03;21;Torstai;13;4;17
623;08.03.2018;2018;03;22;Torstai;6;3;9
623;08.03.2018;2018;03;23;Torstai;2;3;5
623;09.03.2018;2018;03;00;Perjantai;2;4;6
623;09.03.2018;2018;03;01;Perjantai;1;1;2
623;09.03.2018;2018;03;02;Perjantai;1;0;1
623;09.03.2018;2018;03;03;Perjantai;0;1;1
623;09.03.2018;2018;03;04;Perjantai;1;2;3
623;09.03.2018;2018;03;05;Perjantai;1;1;2
623;09.03.2018;2018;03;06;Perjantai;0;8;8
623;09.03.2018;2018;03;07;Perjantai;3;15;18
623;09.03.2018;2018;03;08;Perjantai;8;30;38
623;09.03.2018;2018;03;09;Perjantai;10;21;31
623;09.03.2018;2018;03;10;Perjantai;6;19;25
623;09.03.2018;2018;03;11;Perjantai;8;12;20
623;09.03.2018;2018;03;12;Perjantai;7;11;18
623;09.03.2018;2018;03;13;Perjantai;15;16;31
623;09.03.2018;2018;03;14;Perjantai;10;14;24
623;09.03.2018;2018;03;15;Perjantai;9;9;18
623;09.03.2018;2018;03;16;Perjantai;18;12;30
623;09.03.2018;2018;03;17;Perjantai;18;24;42
623;09.03.2018;2018;03;18;Perjantai;7;9;16
623;09.03.2018;2018;03;19;Perjantai;12;5;17
623;09.03.2018;2018;03;20;Perjantai;8;10;18
623;09.03.2018;2018;03;21;Perjantai;5;6;11
623;09.03.2018;2018;03;22;Perjantai;6;5;11
623;09.03.2018;2018;03;23;Perjantai;2;4;6
623;10.03.2018;2018;03;00;Lauantai;3;2;5
623;10.03.2018;2018;03;01;Lauantai;2;1;3
623;10.03.2018;2018;03;02;Lauantai;0;2;2
623;10.03.2018;2018;03;03;Lauantai;3;1;4
623;10.03.2018;2018;03;04;Lauantai;0;0;0
623;10.03.2018;2018;03;05;Lauantai;1;2;3
623;10.03.2018;2018;03;06;Lauantai;1;2;3
623;10.03.2018;2018;03;07;Lauantai;1;4;5
623;10.03.2018;2018;03;08;Lauantai;0;3;3
623;10.03.2018;2018;03;09;Lauantai;0;4;4
623;10.03.2018;2018;03;10;Lauantai;2;10;12
623;10.03.2018;2018;03;11;Lauantai;4;4;8
623;10.03.2018;2018;03;12;Lauantai;3;9;12
623;10.03.2018;2018;03;13;Lauantai;6;9;15
623;10.03.2018;2018;03;14;Lauantai;7;10;17
623;10.03.2018;2018;03;15;Lauantai;8;11;19
623;10.03.2018;2018;03;16;Lauantai;9;12;21
623;10.03.2018;2018;03;17;Lauantai;5;10;15
623;10.03.2018;2018;03;18;Lauantai;10;11;21
623;10.03.2018;2018;03;19;Lauantai;9;12;21
623;10.03.2018;2018;03;20;Lauantai;8;5;13
623;10.03.2018;2018;03;21;Lauantai;0;8;8
623;10.03.2018;2018;03;22;Lauantai;6;6;12
623;10.03.2018;2018;03;23;Lauantai;5;5;10
623;11.03.2018;2018;03;00;Sunnuntai;2;5;7
623;11.03.2018;2018;03;01;Sunnuntai;3;2;5
623;11.03.2018;2018;03;02;Sunnuntai;1;2;3
623;11.03.2018;2018;03;03;Sunnuntai;0;0;0
623;11.03.2018;2018;03;04;Sunnuntai;4;1;5
623;11.03.2018;2018;03;05;Sunnuntai;0;2;2
623;11.03.2018;2018;03;06;Sunnuntai;0;0;0
623;11.03.2018;2018;03;07;Sunnuntai;1;4;5
623;11.03.2018;2018;03;08;Sunnuntai;1;1;2
623;11.03.2018;2018;03;09;Sunnuntai;0;0;0
623;11.03.2018;2018;03;10;Sunnuntai;3;5;8
623;11.03.2018;2018;03;11;Sunnuntai;0;8;8
623;11.03.2018;2018;03;12;Sunnuntai;2;7;9
623;11.03.2018;2018;03;13;Sunnuntai;1;9;10
623;11.03.2018;2018;03;14;Sunnuntai;5;6;11
623;11.03.2018;2018;03;15;Sunnuntai;6;3;9
623;11.03.2018;2018;03;16;Sunnuntai;8;10;18
623;11.03.2018;2018;03;17;Sunnuntai;8;15;23
623;11.03.2018;2018;03;18;Sunnuntai;7;6;13
623;11.03.2018;2018;03;19;Sunnuntai;5;4;9
623;11.03.2018;2018;03;20;Sunnuntai;4;2;6
623;11.03.2018;2018;03;21;Sunnuntai;3;4;7
623;11.03.2018;2018;03;22;Sunnuntai;3;1;4
623;11.03.2018;2018;03;23;Sunnuntai;0;1;1
623;12.03.2018;2018;03;00;Maanantai;2;1;3
623;12.03.2018;2018;03;01;Maanantai;1;0;1
623;12.03.2018;2018;03;02;Maanantai;0;0;0
623;12.03.2018;2018;03;03;Maanantai;0;5;5
623;12.03.2018;2018;03;04;Maanantai;1;1;2
623;12.03.2018;2018;03;05;Maanantai;0;0;0
623;12.03.2018;2018;03;06;Maanantai;0;4;4
623;12.03.2018;2018;03;07;Maanantai;5;23;28
623;12.03.2018;2018;03;08;Maanantai;15;64;79
623;12.03.2018;2018;03;09;Maanantai;16;47;63
623;12.03.2018;2018;03;10;Maanantai;13;19;32
623;12.03.2018;2018;03;11;Maanantai;7;13;20
623;12.03.2018;2018;03;12;Maanantai;8;18;26
623;12.03.2018;2018;03;13;Maanantai;8;19;27
623;12.03.2018;2018;03;14;Maanantai;10;16;26
623;12.03.2018;2018;03;15;Maanantai;11;23;34
623;12.03.2018;2018;03;16;Maanantai;32;15;47
623;12.03.2018;2018;03;17;Maanantai;36;39;75
623;12.03.2018;2018;03;18;Maanantai;19;33;52
623;12.03.2018;2018;03;19;Maanantai;11;12;23
623;12.03.2018;2018;03;20;Maanantai;5;9;14
623;12.03.2018;2018;03;21;Maanantai;13;6;19
623;12.03.2018;2018;03;22;Maanantai;7;4;11
623;12.03.2018;2018;03;23;Maanantai;2;3;5
623;13.03.2018;2018;03;00;Tiistai;0;1;1
623;13.03.2018;2018;03;01;Tiistai;1;0;1
623;13.03.2018;2018;03;02;Tiistai;0;0;0
623;13.03.2018;2018;03;03;Tiistai;1;2;3
623;13.03.2018;2018;03;04;Tiistai;0;1;1
623;13.03.2018;2018;03;05;Tiistai;0;1;1
623;13.03.2018;2018;03;06;Tiistai;0;2;2
623;13.03.2018;2018;03;07;Tiistai;5;25;30
623;13.03.2018;2018;03;08;Tiistai;16;55;71
623;13.03.2018;2018;03;09;Tiistai;13;46;59
623;13.03.2018;2018;03;10;Tiistai;11;28;39
623;13.03.2018;2018;03;11;Tiistai;6;10;16
623;13.03.2018;2018;03;12;Tiistai;5;8;13
623;13.03.2018;2018;03;13;Tiistai;14;20;34
623;13.03.2018;2018;03;14;Tiistai;10;14;24
623;13.03.2018;2018;03;15;Tiistai;14;30;44
623;13.03.2018;2018;03;16;Tiistai;35;20;55
623;13.03.2018;2018;03;17;Tiistai;34;30;64
623;13.03.2018;2018;03;18;Tiistai;24;28;52
623;13.03.2018;2018;03;19;Tiistai;21;16;37
623;13.03.2018;2018;03;20;Tiistai;9;14;23
623;13.03.2018;2018;03;21;Tiistai;9;9;18
623;13.03.2018;2018;03;22;Tiistai;10;4;14
623;13.03.2018;2018;03;23;Tiistai;3;2;5
623;14.03.2018;2018;03;00;Keskiviikko;4;1;5
623;14.03.2018;2018;03;01;Keskiviikko;0;0;0
623;14.03.2018;2018;03;02;Keskiviikko;0;1;1
623;14.03.2018;2018;03;03;Keskiviikko;0;2;2
623;14.03.2018;2018;03;04;Keskiviikko;0;1;1
623;14.03.2018;2018;03;05;Keskiviikko;0;4;4
623;14.03.2018;2018;03;06;Keskiviikko;1;2;3
623;14.03.2018;2018;03;07;Keskiviikko;5;20;25
623;14.03.2018;2018;03;08;Keskiviikko;11;48;59
623;14.03.2018;2018;03;09;Keskiviikko;15;57;72
623;14.03.2018;2018;03;10;Keskiviikko;14;21;35
623;14.03.2018;2018;03;11;Keskiviikko;9;16;25
623;14.03.2018;2018;03;12;Keskiviikko;9;18;27
623;14.03.2018;2018;03;13;Keskiviikko;7;20;27
623;14.03.2018;2018;03;14;Keskiviikko;15;12;27
623;14.03.2018;2018;03;15;Keskiviikko;24;17;41
623;14.03.2018;2018;03;16;Keskiviikko;25;19;44
623;14.03.2018;2018;03;17;Keskiviikko;28;28;56
623;14.03.2018;2018;03;18;Keskiviikko;17;24;41
623;14.03.2018;2018;03;19;Keskiviikko;8;19;27
623;14.03.2018;2018;03;20;Keskiviikko;12;6;18
623;14.03.2018;2018;03;21;Keskiviikko;7;6;13
623;14.03.2018;2018;03;22;Keskiviikko;5;5;10
623;14.03.2018;2018;03;23;Keskiviikko;1;3;4
623;15.03.2018;2018;03;00;Torstai;1;1;2
623;15.03.2018;2018;03;01;Torstai;1;0;1
623;15.03.2018;2018;03;02;Torstai;0;0;0
623;15.03.2018;2018;03;03;Torstai;0;2;2
623;15.03.2018;2018;03;04;Torstai;0;2;2
623;15.03.2018;2018;03;05;Torstai;0;3;3
623;15.03.2018;2018;03;06;Torstai;0;3;3
623;15.03.2018;2018;03;07;Torstai;7;16;23
623;15.03.2018;2018;03;08;Torstai;14;53;67
623;15.03.2018;2018;03;09;Torstai;20;42;62
623;15.03.2018;2018;03;10;Torstai;9;33;42
623;15.03.2018;2018;03;11;Torstai;8;13;21
623;15.03.2018;2018;03;12;Torstai;12;15;27
623;15.03.2018;2018;03;13;Torstai;8;22;30
623;15.03.2018;2018;03;14;Torstai;16;17;33
623;15.03.2018;2018;03;15;Torstai;13;26;39
623;15.03.2018;2018;03;16;Torstai;26;30;56
623;15.03.2018;2018;03;17;Torstai;24;37;61
623;15.03.2018;2018;03;18;Torstai;24;32;56
623;15.03.2018;2018;03;19;Torstai;14;21;35
623;15.03.2018;2018;03;20;Torstai;6;9;15
623;15.03.2018;2018;03;21;Torstai;6;6;12
623;15.03.2018;2018;03;22;Torstai;8;5;13
623;15.03.2018;2018;03;23;Torstai;4;4;8
623;16.03.2018;2018;03;00;Perjantai;5;3;8
623;16.03.2018;2018;03;01;Perjantai;0;1;1
623;16.03.2018;2018;03;02;Perjantai;1;0;1
623;16.03.2018;2018;03;03;Perjantai;1;1;2
623;16.03.2018;2018;03;04;Perjantai;0;2;2
623;16.03.2018;2018;03;05;Perjantai;0;2;2
623;16.03.2018;2018;03;06;Perjantai;0;4;4
623;16.03.2018;2018;03;07;Perjantai;7;17;24
623;16.03.2018;2018;03;08;Perjantai;9;43;52
623;16.03.2018;2018;03;09;Perjantai;11;37;48
623;16.03.2018;2018;03;10;Perjantai;6;27;33
623;16.03.2018;2018;03;11;Perjantai;7;20;27
623;16.03.2018;2018;03;12;Perjantai;15;15;30
623;16.03.2018;2018;03;13;Perjantai;10;13;23
623;16.03.2018;2018;03;14;Perjantai;12;20;32
623;16.03.2018;2018;03;15;Perjantai;14;24;38
623;16.03.2018;2018;03;16;Perjantai;20;13;33
623;16.03.2018;2018;03;17;Perjantai;15;29;44
623;16.03.2018;2018;03;18;Perjantai;14;22;36
623;16.03.2018;2018;03;19;Perjantai;7;15;22
623;16.03.2018;2018;03;20;Perjantai;11;11;22
623;16.03.2018;2018;03;21;Perjantai;8;11;19
623;16.03.2018;2018;03;22;Perjantai;4;2;6
623;16.03.2018;2018;03;23;Perjantai;4;5;9
623;17.03.2018;2018;03;00;Lauantai;3;5;8
623;17.03.2018;2018;03;01;Lauantai;2;3;5
623;17.03.2018;2018;03;02;Lauantai;2;0;2
623;17.03.2018;2018;03;03;Lauantai;3;3;6
623;17.03.2018;2018;03;04;Lauantai;0;1;1
623;17.03.2018;2018;03;05;Lauantai;0;1;1
623;17.03.2018;2018;03;06;Lauantai;1;2;3
623;17.03.2018;2018;03;07;Lauantai;0;6;6
623;17.03.2018;2018;03;08;Lauantai;1;3;4
623;17.03.2018;2018;03;09;Lauantai;4;4;8
623;17.03.2018;2018;03;10;Lauantai;1;8;9
623;17.03.2018;2018;03;11;Lauantai;4;7;11
623;17.03.2018;2018;03;12;Lauantai;6;15;21
623;17.03.2018;2018;03;13;Lauantai;4;6;10
623;17.03.2018;2018;03;14;Lauantai;3;7;10
623;17.03.2018;2018;03;15;Lauantai;15;16;31
623;17.03.2018;2018;03;16;Lauantai;6;9;15
623;17.03.2018;2018;03;17;Lauantai;3;5;8
623;17.03.2018;2018;03;18;Lauantai;4;7;11
623;17.03.2018;2018;03;19;Lauantai;2;2;4
623;17.03.2018;2018;03;20;Lauantai;2;2;4
623;17.03.2018;2018;03;21;Lauantai;1;1;2
623;17.03.2018;2018;03;22;Lauantai;1;1;2
623;17.03.2018;2018;03;23;Lauantai;1;1;2
623;18.03.2018;2018;03;00;Sunnuntai;2;5;7
623;18.03.2018;2018;03;01;Sunnuntai;3;2;5
623;18.03.2018;2018;03;02;Sunnuntai;1;2;3
623;18.03.2018;2018;03;03;Sunnuntai;0;0;0
623;18.03.2018;2018;03;04;Sunnuntai;4;1;5
623;18.03.2018;2018;03;05;Sunnuntai;0;2;2
623;18.03.2018;2018;03;06;Sunnuntai;0;0;0
623;18.03.2018;2018;03;07;Sunnuntai;1;4;5
623;18.03.2018;2018;03;08;Sunnuntai;1;1;2
623;18.03.2018;2018;03;09;Sunnuntai;0;0;0
623;18.03.2018;2018;03;10;Sunnuntai;3;5;8
623;18.03.2018;2018;03;11;Sunnuntai;0;8;8
623;18.03.2018;2018;03;12;Sunnuntai;2;7;9
623;18.03.2018;2018;03;13;Sunnuntai;1;9;10
623;18.03.2018;2018;03;14;Sunnuntai;5;6;11
623;18.03.2018;2018;03;15;Sunnuntai;6;3;9
623;18.03.2018;2018;03;16;Sunnuntai;8;10;18
623;18.03.2018;2018;03;17;Sunnuntai;8;15;23
623;18.03.2018;2018;03;18;Sunnuntai;7;6;13
623;18.03.2018;2018;03;19;Sunnuntai;5;4;9
623;18.03.2018;2018;03;20;Sunnuntai;4;2;6
623;18.03.2018;2018;03;21;Sunnuntai;3;4;7
623;18.03.2018;2018;03;22;Sunnuntai;3;1;4
623;18.03.2018;2018;03;23;Sunnuntai;0;1;1
623;19.03.2018;2018;03;00;Maanantai;3;4;7
623;19.03.2018;2018;03;01;Maanantai;1;1;2
623;19.03.2018;2018;03;02;Maanantai;2;0;2
623;19.03.2018;2018;03;03;Maanantai;0;1;1
623;19.03.2018;2018;03;04;Maanantai;0;2;2
623;19.03.2018;2018;03;05;Maanantai;0;3;3
623;19.03.2018;2018;03;06;Maanantai;0;5;5
623;19.03.2018;2018;03;07;Maanantai;5;24;29
623;19.03.2018;2018;03;08;Maanantai;19;70;89
623;19.03.2018;2018;03;09;Maanantai;25;61;86
623;19.03.2018;2018;03;10;Maanantai;12;32;44
623;19.03.2018;2018;03;11;Maanantai;10;22;32
623;19.03.2018;2018;03;12;Maanantai;11;19;30
623;19.03.2018;2018;03;13;Maanantai;12;18;30
623;19.03.2018;2018;03;14;Maanantai;18;19;37
623;19.03.2018;2018;03;15;Maanantai;21;21;42
623;19.03.2018;2018;03;16;Maanantai;34;23;57
623;19.03.2018;2018;03;17;Maanantai;45;47;92
623;19.03.2018;2018;03;18;Maanantai;21;27;48
623;19.03.2018;2018;03;19;Maanantai;13;16;29
623;19.03.2018;2018;03;20;Maanantai;12;7;19
623;19.03.2018;2018;03;21;Maanantai;10;10;20
623;19.03.2018;2018;03;22;Maanantai;5;6;11
623;19.03.2018;2018;03;23;Maanantai;2;1;3
623;20.03.2018;2018;03;00;Tiistai;3;4;7
623;20.03.2018;2018;03;01;Tiistai;1;1;2
623;20.03.2018;2018;03;02;Tiistai;2;0;2
623;20.03.2018;2018;03;03;Tiistai;0;1;1
623;20.03.2018;2018;03;04;Tiistai;0;3;3
623;20.03.2018;2018;03;05;Tiistai;0;2;2
623;20.03.2018;2018;03;06;Tiistai;0;5;5
623;20.03.2018;2018;03;07;Tiistai;5;24;29
623;20.03.2018;2018;03;08;Tiistai;19;70;89
623;20.03.2018;2018;03;09;Tiistai;25;61;86
623;20.03.2018;2018;03;10;Tiistai;20;23;43
623;20.03.2018;2018;03;11;Tiistai;4;13;17
623;20.03.2018;2018;03;12;Tiistai;13;17;30
623;20.03.2018;2018;03;13;Tiistai;15;16;31
623;20.03.2018;2018;03;14;Tiistai;8;26;34
623;20.03.2018;2018;03;15;Tiistai;14;20;34
623;20.03.2018;2018;03;16;Tiistai;29;31;60
623;20.03.2018;2018;03;17;Tiistai;36;41;77
623;20.03.2018;2018;03;18;Tiistai;19;40;59
623;20.03.2018;2018;03;19;Tiistai;17;19;36
623;20.03.2018;2018;03;20;Tiistai;10;8;18
623;20.03.2018;2018;03;21;Tiistai;5;13;18
623;20.03.2018;2018;03;22;Tiistai;7;3;10
623;20.03.2018;2018;03;23;Tiistai;4;0;4
623;21.03.2018;2018;03;00;Keskiviikko;0;1;1
623;21.03.2018;2018;03;01;Keskiviikko;2;0;2
623;21.03.2018;2018;03;02;Keskiviikko;0;0;0
623;21.03.2018;2018;03;03;Keskiviikko;0;1;1
623;21.03.2018;2018;03;04;Keskiviikko;0;1;1
623;21.03.2018;2018;03;05;Keskiviikko;0;2;2
623;21.03.2018;2018;03;06;Keskiviikko;0;8;8
623;21.03.2018;2018;03;07;Keskiviikko;5;20;25
623;21.03.2018;2018;03;08;Keskiviikko;23;54;77
623;21.03.2018;2018;03;09;Keskiviikko;20;53;73
623;21.03.2018;2018;03;10;Keskiviikko;14;24;38
623;21.03.2018;2018;03;11;Keskiviikko;6;20;26
623;21.03.2018;2018;03;12;Keskiviikko;16;11;27
623;21.03.2018;2018;03;13;Keskiviikko;7;16;23
623;21.03.2018;2018;03;14;Keskiviikko;16;13;29
623;21.03.2018;2018;03;15;Keskiviikko;23;19;42
623;21.03.2018;2018;03;16;Keskiviikko;25;26;51
623;21.03.2018;2018;03;17;Keskiviikko;34;32;66
623;21.03.2018;2018;03;18;Keskiviikko;31;27;58
623;21.03.2018;2018;03;19;Keskiviikko;24;15;39
623;21.03.2018;2018;03;20;Keskiviikko;12;10;22
623;21.03.2018;2018;03;21;Keskiviikko;9;12;21
623;21.03.2018;2018;03;22;Keskiviikko;10;12;22
623;21.03.2018;2018;03;23;Keskiviikko;6;6;12
623;22.03.2018;2018;03;00;Torstai;1;4;5
623;22.03.2018;2018;03;01;Torstai;1;2;3
623;22.03.2018;2018;03;02;Torstai;1;0;1
623;22.03.2018;2018;03;03;Torstai;0;2;2
623;22.03.2018;2018;03;04;Torstai;1;1;2
623;22.03.2018;2018;03;05;Torstai;1;2;3
623;22.03.2018;2018;03;06;Torstai;0;6;6
623;22.03.2018;2018;03;07;Torstai;3;24;27
623;22.03.2018;2018;03;08;Torstai;17;60;77
623;22.03.2018;2018;03;09;Torstai;22;47;69
623;22.03.2018;2018;03;10;Torstai;10;27;37
623;22.03.2018;2018;03;11;Torstai;7;22;29
623;22.03.2018;2018;03;12;Torstai;12;29;41
623;22.03.2018;2018;03;13;Torstai;12;13;25
623;22.03.2018;2018;03;14;Torstai;18;24;42
623;22.03.2018;2018;03;15;Torstai;15;32;47
623;22.03.2018;2018;03;16;Torstai;23;27;50
623;22.03.2018;2018;03;17;Torstai;39;34;73
623;22.03.2018;2018;03;18;Torstai;22;37;59
623;22.03.2018;2018;03;19;Torstai;18;9;27
623;22.03.2018;2018;03;20;Torstai;9;6;15
623;22.03.2018;2018;03;21;Torstai;10;11;21
623;22.03.2018;2018;03;22;Torstai;6;5;11
623;22.03.2018;2018;03;23;Torstai;4;1;5
623;23.03.2018;2018;03;00;Perjantai;2;3;5
623;23.03.2018;2018;03;01;Perjantai;1;0;1
623;23.03.2018;2018;03;02;Perjantai;0;0;0
623;23.03.2018;2018;03;03;Perjantai;2;2;4
623;23.03.2018;2018;03;04;Perjantai;1;1;2
623;23.03.2018;2018;03;05;Perjantai;0;3;3
623;23.03.2018;2018;03;06;Perjantai;1;4;5
623;23.03.2018;2018;03;07;Perjantai;3;21;24
623;23.03.2018;2018;03;08;Perjantai;17;57;74
623;23.03.2018;2018;03;09;Perjantai;20;56;76
623;23.03.2018;2018;03;10;Perjantai;15;29;44
623;23.03.2018;2018;03;11;Perjantai;4;13;17
623;23.03.2018;2018;03;12;Perjantai;7;13;20
623;23.03.2018;2018;03;13;Perjantai;15;23;38
623;23.03.2018;2018;03;14;Perjantai;15;25;40
623;23.03.2018;2018;03;15;Perjantai;21;21;42
623;23.03.2018;2018;03;16;Perjantai;23;25;48
623;23.03.2018;2018;03;17;Perjantai;20;29;49
623;23.03.2018;2018;03;18;Perjantai;13;20;33
623;23.03.2018;2018;03;19;Perjantai;8;13;21
623;23.03.2018;2018;03;20;Perjantai;9;7;16
623;23.03.2018;2018;03;21;Perjantai;9;7;16
623;23.03.2018;2018;03;22;Perjantai;5;4;9
623;23.03.2018;2018;03;23;Perjantai;8;5;13
623;24.03.2018;2018;03;00;Lauantai;1;2;3
623;24.03.2018;2018;03;01;Lauantai;1;1;2
623;24.03.2018;2018;03;02;Lauantai;4;1;5
623;24.03.2018;2018;03;03;Lauantai;0;0;0
623;24.03.2018;2018;03;04;Lauantai;2;0;2
623;24.03.2018;2018;03;05;Lauantai;2;4;6
623;24.03.2018;2018;03;06;Lauantai;0;0;0
623;24.03.2018;2018;03;07;Lauantai;1;1;2
623;24.03.2018;2018;03;08;Lauantai;1;3;4
623;24.03.2018;2018;03;09;Lauantai;1;8;9
623;24.03.2018;2018;03;10;Lauantai;7;13;20
623;24.03.2018;2018;03;11;Lauantai;4;9;13
623;24.03.2018;2018;03;12;Lauantai;7;6;13
623;24.03.2018;2018;03;13;Lauantai;4;14;18
623;24.03.2018;2018;03;14;Lauantai;11;5;16
623;24.03.2018;2018;03;15;Lauantai;8;7;15
623;24.03.2018;2018;03;16;Lauantai;12;3;15
623;24.03.2018;2018;03;17;Lauantai;3;5;8
623;24.03.2018;2018;03;18;Lauantai;6;11;17
623;24.03.2018;2018;03;19;Lauantai;3;8;11
623;24.03.2018;2018;03;20;Lauantai;3;6;9
623;24.03.2018;2018;03;21;Lauantai;0;4;4
623;24.03.2018;2018;03;22;Lauantai;6;1;7
623;24.03.2018;2018;03;23;Lauantai;1;2;3
623;25.03.2018;2018;03;00;Sunnuntai;0;2;2
623;25.03.2018;2018;03;01;Sunnuntai;2;3;5
623;25.03.2018;2018;03;02;Sunnuntai;0;2;2
623;25.03.2018;2018;03;03;Sunnuntai;0;0;0
623;25.03.2018;2018;03;04;Sunnuntai;4;1;5
623;25.03.2018;2018;03;05;Sunnuntai;3;2;5
623;25.03.2018;2018;03;06;Sunnuntai;1;1;2
623;25.03.2018;2018;03;07;Sunnuntai;2;1;3
623;25.03.2018;2018;03;08;Sunnuntai;0;1;1
623;25.03.2018;2018;03;09;Sunnuntai;1;2;3
623;25.03.2018;2018;03;10;Sunnuntai;0;1;1
623;25.03.2018;2018;03;11;Sunnuntai;2;11;13
623;25.03.2018;2018;03;12;Sunnuntai;7;10;17
623;25.03.2018;2018;03;13;Sunnuntai;0;8;8
623;25.03.2018;2018;03;14;Sunnuntai;8;7;15
623;25.03.2018;2018;03;15;Sunnuntai;9;13;22
623;25.03.2018;2018;03;16;Sunnuntai;12;15;27
623;25.03.2018;2018;03;17;Sunnuntai;14;9;23
623;25.03.2018;2018;03;18;Sunnuntai;5;9;14
623;25.03.2018;2018;03;19;Sunnuntai;11;5;16
623;25.03.2018;2018;03;20;Sunnuntai;12;6;18
623;25.03.2018;2018;03;21;Sunnuntai;1;4;5
623;25.03.2018;2018;03;22;Sunnuntai;8;6;14
623;25.03.2018;2018;03;23;Sunnuntai;2;1;3
623;26.03.2018;2018;03;00;Maanantai;2;1;3
623;26.03.2018;2018;03;01;Maanantai;1;0;1
623;26.03.2018;2018;03;02;Maanantai;1;0;1
623;26.03.2018;2018;03;03;Maanantai;0;1;1
623;26.03.2018;2018;03;04;Maanantai;0;0;0
623;26.03.2018;2018;03;05;Maanantai;1;5;6
623;26.03.2018;2018;03;06;Maanantai;0;2;2
623;26.03.2018;2018;03;07;Maanantai;4;20;24
623;26.03.2018;2018;03;08;Maanantai;17;53;70
623;26.03.2018;2018;03;09;Maanantai;21;63;84
623;26.03.2018;2018;03;10;Maanantai;9;30;39
623;26.03.2018;2018;03;11;Maanantai;4;12;16
623;26.03.2018;2018;03;12;Maanantai;10;17;27
623;26.03.2018;2018;03;13;Maanantai;14;22;36
623;26.03.2018;2018;03;14;Maanantai;9;17;26
623;26.03.2018;2018;03;15;Maanantai;18;33;51
623;26.03.2018;2018;03;16;Maanantai;35;20;55
623;26.03.2018;2018;03;17;Maanantai;30;27;57
623;26.03.2018;2018;03;18;Maanantai;25;36;61
623;26.03.2018;2018;03;19;Maanantai;12;18;30
623;26.03.2018;2018;03;20;Maanantai;7;10;17
623;26.03.2018;2018;03;21;Maanantai;5;4;9
623;26.03.2018;2018;03;22;Maanantai;4;6;10
623;26.03.2018;2018;03;23;Maanantai;4;3;7
623;27.03.2018;2018;03;00;Tiistai;2;0;2
623;27.03.2018;2018;03;01;Tiistai;1;0;1
623;27.03.2018;2018;03;02;Tiistai;1;0;1
623;27.03.2018;2018;03;03;Tiistai;0;1;1
623;27.03.2018;2018;03;04;Tiistai;0;0;0
623;27.03.2018;2018;03;05;Tiistai;0;1;1
623;27.03.2018;2018;03;06;Tiistai;0;2;2
623;27.03.2018;2018;03;07;Tiistai;7;28;35
623;27.03.2018;2018;03;08;Tiistai;20;58;78
623;27.03.2018;2018;03;09;Tiistai;14;47;61
623;27.03.2018;2018;03;10;Tiistai;8;20;28
623;27.03.2018;2018;03;11;Tiistai;3;6;9
623;27.03.2018;2018;03;12;Tiistai;11;18;29
623;27.03.2018;2018;03;13;Tiistai;15;19;34
623;27.03.2018;2018;03;14;Tiistai;11;20;31
623;27.03.2018;2018;03;15;Tiistai;15;20;35
623;27.03.2018;2018;03;16;Tiistai;24;22;46
623;27.03.2018;2018;03;17;Tiistai;30;36;66
623;27.03.2018;2018;03;18;Tiistai;23;32;55
623;27.03.2018;2018;03;19;Tiistai;15;19;34
623;27.03.2018;2018;03;20;Tiistai;13;10;23
623;27.03.2018;2018;03;21;Tiistai;7;15;22
623;27.03.2018;2018;03;22;Tiistai;5;7;12
623;27.03.2018;2018;03;23;Tiistai;3;2;5
623;28.03.2018;2018;03;00;Keskiviikko;3;5;8
623;28.03.2018;2018;03;01;Keskiviikko;1;2;3
623;28.03.2018;2018;03;02;Keskiviikko;0;1;1
623;28.03.2018;2018;03;03;Keskiviikko;1;2;3
623;28.03.2018;2018;03;04;Keskiviikko;2;0;2
623;28.03.2018;2018;03;05;Keskiviikko;1;2;3
623;28.03.2018;2018;03;06;Keskiviikko;0;4;4
623;28.03.2018;2018;03;07;Keskiviikko;8;26;34
623;28.03.2018;2018;03;08;Keskiviikko;14;53;67
623;28.03.2018;2018;03;09;Keskiviikko;19;59;78
623;28.03.2018;2018;03;10;Keskiviikko;16;24;40
623;28.03.2018;2018;03;11;Keskiviikko;11;21;32
623;28.03.2018;2018;03;12;Keskiviikko;9;7;16
623;28.03.2018;2018;03;13;Keskiviikko;8;20;28
623;28.03.2018;2018;03;14;Keskiviikko;21;22;43
623;28.03.2018;2018;03;15;Keskiviikko;16;26;42
623;28.03.2018;2018;03;16;Keskiviikko;31;20;51
623;28.03.2018;2018;03;17;Keskiviikko;27;36;63
623;28.03.2018;2018;03;18;Keskiviikko;39;40;79
623;28.03.2018;2018;03;19;Keskiviikko;22;14;36
623;28.03.2018;2018;03;20;Keskiviikko;15;8;23
623;28.03.2018;2018;03;21;Keskiviikko;7;8;15
623;28.03.2018;2018;03;22;Keskiviikko;8;8;16
623;28.03.2018;2018;03;23;Keskiviikko;1;4;5
623;29.03.2018;2018;03;00;Torstai;4;2;6
623;29.03.2018;2018;03;01;Torstai;1;0;1
623;29.03.2018;2018;03;02;Torstai;0;0;0
623;29.03.2018;2018;03;03;Torstai;2;1;3
623;29.03.2018;2018;03;04;Torstai;1;0;1
623;29.03.2018;2018;03;05;Torstai;0;1;1
623;29.03.2018;2018;03;06;Torstai;2;4;6
623;29.03.2018;2018;03;07;Torstai;1;23;24
623;29.03.2018;2018;03;08;Torstai;23;53;76
623;29.03.2018;2018;03;09;Torstai;21;60;81
623;29.03.2018;2018;03;10;Torstai;14;21;35
623;29.03.2018;2018;03;11;Torstai;9;16;25
623;29.03.2018;2018;03;12;Torstai;13;11;24
623;29.03.2018;2018;03;13;Torstai;14;14;28
623;29.03.2018;2018;03;14;Torstai;6;19;25
623;29.03.2018;2018;03;15;Torstai;12;24;36
623;29.03.2018;2018;03;16;Torstai;23;24;47
623;29.03.2018;2018;03;17;Torstai;20;30;50
623;29.03.2018;2018;03;18;Torstai;20;21;41
623;29.03.2018;2018;03;19;Torstai;10;14;24
623;29.03.2018;2018;03;20;Torstai;15;6;21
623;29.03.2018;2018;03;21;Torstai;3;9;12
623;29.03.2018;2018;03;22;Torstai;8;8;16
623;29.03.2018;2018;03;23;Torstai;1;6;7
623;30.03.2018;2018;03;00;Perjantai;1;4;5
623;30.03.2018;2018;03;01;Perjantai;4;3;7
623;30.03.2018;2018;03;02;Perjantai;1;0;1
623;30.03.2018;2018;03;03;Perjantai;3;1;4
623;30.03.2018;2018;03;04;Perjantai;1;1;2
623;30.03.2018;2018;03;05;Perjantai;1;1;2
623;30.03.2018;2018;03;06;Perjantai;0;2;2
623;30.03.2018;2018;03;07;Perjantai;1;6;7
623;30.03.2018;2018;03;08;Perjantai;1;1;2
623;30.03.2018;2018;03;09;Perjantai;0;5;5
623;30.03.2018;2018;03;10;Perjantai;3;5;8
623;30.03.2018;2018;03;11;Perjantai;3;4;7
623;30.03.2018;2018;03;12;Perjantai;6;9;15
623;30.03.2018;2018;03;13;Perjantai;10;18;28
623;30.03.2018;2018;03;14;Perjantai;4;14;18
623;30.03.2018;2018;03;15;Perjantai;8;12;20
623;30.03.2018;2018;03;16;Perjantai;5;10;15
623;30.03.2018;2018;03;17;Perjantai;11;17;28
623;30.03.2018;2018;03;18;Perjantai;3;7;10
623;30.03.2018;2018;03;19;Perjantai;5;4;9
623;30.03.2018;2018;03;20;Perjantai;2;1;3
623;30.03.2018;2018;03;21;Perjantai;7;1;8
623;30.03.2018;2018;03;22;Perjantai;3;4;7
623;30.03.2018;2018;03;23;Perjantai;1;0;1
623;31.03.2018;2018;03;00;Lauantai;4;4;8
623;31.03.2018;2018;03;01;Lauantai;2;1;3
623;31.03.2018;2018;03;02;Lauantai;1;1;2
623;31.03.2018;2018;03;03;Lauantai;0;1;1
623;31.03.2018;2018;03;04;Lauantai;0;0;0
623;31.03.2018;2018;03;05;Lauantai;1;2;3
623;31.03.2018;2018;03;06;Lauantai;1;0;1
623;31.03.2018;2018;03;07;Lauantai;1;3;4
623;31.03.2018;2018;03;08;Lauantai;0;4;4
623;31.03.2018;2018;03;09;Lauantai;0;2;2
623;31.03.2018;2018;03;10;Lauantai;1;7;8
623;31.03.2018;2018;03;11;Lauantai;3;9;12
623;31.03.2018;2018;03;12;Lauantai;4;11;15
623;31.03.2018;2018;03;13;Lauantai;4;14;18
623;31.03.2018;2018;03;14;Lauantai;7;17;24
623;31.03.2018;2018;03;15;Lauantai;9;15;24
623;31.03.2018;2018;03;16;Lauantai;11;17;28
623;31.03.2018;2018;03;17;Lauantai;6;8;14
623;31.03.2018;2018;03;18;Lauantai;4;5;9
623;31.03.2018;2018;03;19;Lauantai;4;8;12
623;31.03.2018;2018;03;20;Lauantai;4;7;11
623;31.03.2018;2018;03;21;Lauantai;3;10;13
623;31.03.2018;2018;03;22;Lauantai;4;3;7
623;31.03.2018;2018;03;23;Lauantai;1;4;5
623;01.04.2018;2018;04;00;Sunnuntai;4;4;8
623;01.04.2018;2018;04;01;Sunnuntai;1;0;1
623;01.04.2018;2018;04;02;Sunnuntai;1;3;4
623;01.04.2018;2018;04;03;Sunnuntai;3;3;6
623;01.04.2018;2018;04;04;Sunnuntai;1;0;1
623;01.04.2018;2018;04;05;Sunnuntai;1;2;3
623;01.04.2018;2018;04;06;Sunnuntai;2;0;2
623;01.04.2018;2018;04;07;Sunnuntai;0;3;3
623;01.04.2018;2018;04;08;Sunnuntai;0;0;0
623;01.04.2018;2018;04;09;Sunnuntai;2;5;7
623;01.04.2018;2018;04;10;Sunnuntai;1;4;5
623;01.04.2018;2018;04;11;Sunnuntai;1;11;12
623;01.04.2018;2018;04;12;Sunnuntai;3;14;17
623;01.04.2018;2018;04;13;Sunnuntai;2;9;11
623;01.04.2018;2018;04;14;Sunnuntai;7;8;15
623;01.04.2018;2018;04;15;Sunnuntai;9;11;20
623;01.04.2018;2018;04;16;Sunnuntai;4;6;10
623;01.04.2018;2018;04;17;Sunnuntai;5;7;12
623;01.04.2018;2018;04;18;Sunnuntai;6;6;12
623;01.04.2018;2018;04;19;Sunnuntai;8;2;10
623;01.04.2018;2018;04;20;Sunnuntai;7;5;12
623;01.04.2018;2018;04;21;Sunnuntai;6;5;11
623;01.04.2018;2018;04;22;Sunnuntai;3;1;4
623;01.04.2018;2018;04;23;Sunnuntai;2;1;3
623;02.04.2018;2018;04;00;Maanantai;1;0;1
623;02.04.2018;2018;04;01;Maanantai;0;0;0
623;02.04.2018;2018;04;02;Maanantai;1;0;1
623;02.04.2018;2018;04;03;Maanantai;0;0;0
623;02.04.2018;2018;04;04;Maanantai;2;0;2
623;02.04.2018;2018;04;05;Maanantai;0;1;1
623;02.04.2018;2018;04;06;Maanantai;0;0;0
623;02.04.2018;2018;04;07;Maanantai;0;3;3
623;02.04.2018;2018;04;08;Maanantai;0;6;6
623;02.04.2018;2018;04;09;Maanantai;1;3;4
623;02.04.2018;2018;04;10;Maanantai;6;5;11
623;02.04.2018;2018;04;11;Maanantai;2;7;9
623;02.04.2018;2018;04;12;Maanantai;2;6;8
623;02.04.2018;2018;04;13;Maanantai;4;19;23
623;02.04.2018;2018;04;14;Maanantai;7;9;16
623;02.04.2018;2018;04;15;Maanantai;9;6;15
623;02.04.2018;2018;04;16;Maanantai;7;6;13
623;02.04.2018;2018;04;17;Maanantai;5;8;13
623;02.04.2018;2018;04;18;Maanantai;7;11;18
623;02.04.2018;2018;04;19;Maanantai;5;4;9
623;02.04.2018;2018;04;20;Maanantai;5;5;10
623;02.04.2018;2018;04;21;Maanantai;3;3;6
623;02.04.2018;2018;04;22;Maanantai;4;3;7
623;02.04.2018;2018;04;23;Maanantai;2;0;2
623;03.04.2018;2018;04;00;Tiistai;0;1;1
623;03.04.2018;2018;04;01;Tiistai;3;0;3
623;03.04.2018;2018;04;02;Tiistai;0;0;0
623;03.04.2018;2018;04;03;Tiistai;0;2;2
623;03.04.2018;2018;04;04;Tiistai;1;0;1
623;03.04.2018;2018;04;05;Tiistai;0;4;4
623;03.04.2018;2018;04;06;Tiistai;1;4;5
623;03.04.2018;2018;04;07;Tiistai;5;20;25
623;03.04.2018;2018;04;08;Tiistai;13;50;63
623;03.04.2018;2018;04;09;Tiistai;20;53;73
623;03.04.2018;2018;04;10;Tiistai;19;28;47
623;03.04.2018;2018;04;11;Tiistai;10;11;21
623;03.04.2018;2018;04;12;Tiistai;12;8;20
623;03.04.2018;2018;04;13;Tiistai;6;12;18
623;03.04.2018;2018;04;14;Tiistai;12;15;27
623;03.04.2018;2018;04;15;Tiistai;11;16;27
623;03.04.2018;2018;04;16;Tiistai;20;22;42
623;03.04.2018;2018;04;17;Tiistai;24;29;53
623;03.04.2018;2018;04;18;Tiistai;22;19;41
623;03.04.2018;2018;04;19;Tiistai;17;12;29
623;03.04.2018;2018;04;20;Tiistai;9;11;20
623;03.04.2018;2018;04;21;Tiistai;10;10;20
623;03.04.2018;2018;04;22;Tiistai;11;1;12
623;03.04.2018;2018;04;23;Tiistai;4;1;5
623;04.04.2018;2018;04;00;Keskiviikko;2;1;3
623;04.04.2018;2018;04;01;Keskiviikko;0;1;1
623;04.04.2018;2018;04;02;Keskiviikko;0;0;0
623;04.04.2018;2018;04;03;Keskiviikko;0;2;2
623;04.04.2018;2018;04;04;Keskiviikko;1;2;3
623;04.04.2018;2018;04;05;Keskiviikko;1;3;4
623;04.04.2018;2018;04;06;Keskiviikko;0;7;7
623;04.04.2018;2018;04;07;Keskiviikko;2;23;25
623;04.04.2018;2018;04;08;Keskiviikko;25;60;85
623;04.04.2018;2018;04;09;Keskiviikko;25;56;81
623;04.04.2018;2018;04;10;Keskiviikko;15;33;48
623;04.04.2018;2018;04;11;Keskiviikko;5;11;16
623;04.04.2018;2018;04;12;Keskiviikko;11;15;26
623;04.04.2018;2018;04;13;Keskiviikko;15;14;29
623;04.04.2018;2018;04;14;Keskiviikko;14;19;33
623;04.04.2018;2018;04;15;Keskiviikko;16;27;43
623;04.04.2018;2018;04;16;Keskiviikko;26;27;53
623;04.04.2018;2018;04;17;Keskiviikko;35;42;77
623;04.04.2018;2018;04;18;Keskiviikko;28;27;55
623;04.04.2018;2018;04;19;Keskiviikko;29;17;46
623;04.04.2018;2018;04;20;Keskiviikko;13;14;27
623;04.04.2018;2018;04;21;Keskiviikko;13;11;24
623;04.04.2018;2018;04;22;Keskiviikko;12;8;20
623;04.04.2018;2018;04;23;Keskiviikko;3;1;4
623;05.04.2018;2018;04;00;Torstai;1;3;4
623;05.04.2018;2018;04;01;Torstai;0;1;1
623;05.04.2018;2018;04;02;Torstai;1;1;2
623;05.04.2018;2018;04;03;Torstai;0;1;1
623;05.04.2018;2018;04;04;Torstai;0;1;1
623;05.04.2018;2018;04;05;Torstai;0;3;3
623;05.04.2018;2018;04;06;Torstai;0;6;6
623;05.04.2018;2018;04;07;Torstai;3;23;26
623;05.04.2018;2018;04;08;Torstai;11;48;59
623;05.04.2018;2018;04;09;Torstai;20;53;73
623;05.04.2018;2018;04;10;Torstai;12;20;32
623;05.04.2018;2018;04;11;Torstai;14;16;30
623;05.04.2018;2018;04;12;Torstai;14;22;36
623;05.04.2018;2018;04;13;Torstai;7;21;28
623;05.04.2018;2018;04;14;Torstai;15;18;33
623;05.04.2018;2018;04;15;Torstai;21;19;40
623;05.04.2018;2018;04;16;Torstai;33;15;48
623;05.04.2018;2018;04;17;Torstai;43;42;85
623;05.04.2018;2018;04;18;Torstai;31;26;57
623;05.04.2018;2018;04;19;Torstai;17;21;38
623;05.04.2018;2018;04;20;Torstai;22;4;26
623;05.04.2018;2018;04;21;Torstai;10;7;17
623;05.04.2018;2018;04;22;Torstai;10;6;16
623;05.04.2018;2018;04;23;Torstai;8;2;10
623;06.04.2018;2018;04;00;Perjantai;2;0;2
623;06.04.2018;2018;04;01;Perjantai;2;0;2
623;06.04.2018;2018;04;02;Perjantai;1;0;1
623;06.04.2018;2018;04;03;Perjantai;0;2;2
623;06.04.2018;2018;04;04;Perjantai;2;0;2
623;06.04.2018;2018;04;05;Perjantai;1;3;4
623;06.04.2018;2018;04;06;Perjantai;0;4;4
623;06.04.2018;2018;04;07;Perjantai;0;16;16
623;06.04.2018;2018;04;08;Perjantai;8;25;33
623;06.04.2018;2018;04;09;Perjantai;15;33;48
623;06.04.2018;2018;04;10;Perjantai;9;16;25
623;06.04.2018;2018;04;11;Perjantai;11;11;22
623;06.04.2018;2018;04;12;Perjantai;11;17;28
623;06.04.2018;2018;04;13;Perjantai;8;15;23
623;06.04.2018;2018;04;14;Perjantai;15;13;28
623;06.04.2018;2018;04;15;Perjantai;14;12;26
623;06.04.2018;2018;04;16;Perjantai;29;17;46
623;06.04.2018;2018;04;17;Perjantai;21;18;39
623;06.04.2018;2018;04;18;Perjantai;8;10;18
623;06.04.2018;2018;04;19;Perjantai;8;4;12
623;06.04.2018;2018;04;20;Perjantai;9;9;18
623;06.04.2018;2018;04;21;Perjantai;1;4;5
623;06.04.2018;2018;04;22;Perjantai;6;2;8
623;06.04.2018;2018;04;23;Perjantai;2;2;4
623;07.04.2018;2018;04;00;Lauantai;4;3;7
623;07.04.2018;2018;04;01;Lauantai;2;0;2
623;07.04.2018;2018;04;02;Lauantai;1;1;2
623;07.04.2018;2018;04;03;Lauantai;1;1;2
623;07.04.2018;2018;04;04;Lauantai;2;0;2
623;07.04.2018;2018;04;05;Lauantai;1;0;1
623;07.04.2018;2018;04;06;Lauantai;1;0;1
623;07.04.2018;2018;04;07;Lauantai;1;5;6
623;07.04.2018;2018;04;08;Lauantai;1;3;4
623;07.04.2018;2018;04;09;Lauantai;0;6;6
623;07.04.2018;2018;04;10;Lauantai;2;14;16
623;07.04.2018;2018;04;11;Lauantai;12;15;27
623;07.04.2018;2018;04;12;Lauantai;7;11;18
623;07.04.2018;2018;04;13;Lauantai;10;12;22
623;07.04.2018;2018;04;14;Lauantai;11;13;24
623;07.04.2018;2018;04;15;Lauantai;14;16;30
623;07.04.2018;2018;04;16;Lauantai;4;7;11
623;07.04.2018;2018;04;17;Lauantai;7;9;16
623;07.04.2018;2018;04;18;Lauantai;7;3;10
623;07.04.2018;2018;04;19;Lauantai;2;1;3
623;07.04.2018;2018;04;20;Lauantai;2;2;4
623;07.04.2018;2018;04;21;Lauantai;3;0;3
623;07.04.2018;2018;04;22;Lauantai;3;3;6
623;07.04.2018;2018;04;23;Lauantai;3;2;5
623;08.04.2018;2018;04;00;Sunnuntai;3;2;5
623;08.04.2018;2018;04;01;Sunnuntai;0;0;0
623;08.04.2018;2018;04;02;Sunnuntai;1;1;2
623;08.04.2018;2018;04;03;Sunnuntai;2;2;4
623;08.04.2018;2018;04;04;Sunnuntai;1;0;1
623;08.04.2018;2018;04;05;Sunnuntai;1;0;1
623;08.04.2018;2018;04;06;Sunnuntai;0;1;1
623;08.04.2018;2018;04;07;Sunnuntai;1;4;5
623;08.04.2018;2018;04;08;Sunnuntai;2;1;3
623;08.04.2018;2018;04;09;Sunnuntai;4;2;6
623;08.04.2018;2018;04;10;Sunnuntai;4;6;10
623;08.04.2018;2018;04;11;Sunnuntai;6;0;6
623;08.04.2018;2018;04;12;Sunnuntai;4;7;11
623;08.04.2018;2018;04;13;Sunnuntai;3;10;13
623;08.04.2018;2018;04;14;Sunnuntai;2;9;11
623;08.04.2018;2018;04;15;Sunnuntai;9;6;15
623;08.04.2018;2018;04;16;Sunnuntai;9;10;19
623;08.04.2018;2018;04;17;Sunnuntai;7;6;13
623;08.04.2018;2018;04;18;Sunnuntai;8;6;14
623;08.04.2018;2018;04;19;Sunnuntai;10;7;17
623;08.04.2018;2018;04;20;Sunnuntai;9;3;12
623;08.04.2018;2018;04;21;Sunnuntai;8;6;14
623;08.04.2018;2018;04;22;Sunnuntai;3;2;5
623;08.04.2018;2018;04;23;Sunnuntai;2;2;4
623;09.04.2018;2018;04;00;Maanantai;2;0;2
623;09.04.2018;2018;04;01;Maanantai;0;0;0
623;09.04.2018;2018;04;02;Maanantai;0;0;0
623;09.04.2018;2018;04;03;Maanantai;0;2;2
623;09.04.2018;2018;04;04;Maanantai;0;1;1
623;09.04.2018;2018;04;05;Maanantai;0;1;1
623;09.04.2018;2018;04;06;Maanantai;0;2;2
623;09.04.2018;2018;04;07;Maanantai;6;23;29
623;09.04.2018;2018;04;08;Maanantai;19;43;62
623;09.04.2018;2018;04;09;Maanantai;24;46;70
623;09.04.2018;2018;04;10;Maanantai;13;28;41
623;09.04.2018;2018;04;11;Maanantai;11;11;22
623;09.04.2018;2018;04;12;Maanantai;15;11;26
623;09.04.2018;2018;04;13;Maanantai;12;19;31
623;09.04.2018;2018;04;14;Maanantai;20;16;36
623;09.04.2018;2018;04;15;Maanantai;29;21;50
623;09.04.2018;2018;04;16;Maanantai;45;13;58
623;09.04.2018;2018;04;17;Maanantai;33;26;59
623;09.04.2018;2018;04;18;Maanantai;15;16;31
623;09.04.2018;2018;04;19;Maanantai;13;17;30
623;09.04.2018;2018;04;20;Maanantai;10;6;16
623;09.04.2018;2018;04;21;Maanantai;8;6;14
623;09.04.2018;2018;04;22;Maanantai;9;5;14
623;09.04.2018;2018;04;23;Maanantai;2;3;5
623;10.04.2018;2018;04;00;Tiistai;3;0;3
623;10.04.2018;2018;04;01;Tiistai;1;2;3
623;10.04.2018;2018;04;02;Tiistai;1;0;1
623;10.04.2018;2018;04;03;Tiistai;2;1;3
623;10.04.2018;2018;04;04;Tiistai;0;2;2
623;10.04.2018;2018;04;05;Tiistai;1;2;3
623;10.04.2018;2018;04;06;Tiistai;2;4;6
623;10.04.2018;2018;04;07;Tiistai;4;20;24
623;10.04.2018;2018;04;08;Tiistai;17;46;63
623;10.04.2018;2018;04;09;Tiistai;28;70;98
623;10.04.2018;2018;04;10;Tiistai;23;30;53
623;10.04.2018;2018;04;11;Tiistai;5;14;19
623;10.04.2018;2018;04;12;Tiistai;15;16;31
623;10.04.2018;2018;04;13;Tiistai;25;26;51
623;10.04.2018;2018;04;14;Tiistai;21;19;40
623;10.04.2018;2018;04;15;Tiistai;12;21;33
623;10.04.2018;2018;04;16;Tiistai;25;11;36
623;10.04.2018;2018;04;17;Tiistai;37;29;66
623;10.04.2018;2018;04;18;Tiistai;16;15;31
623;10.04.2018;2018;04;19;Tiistai;24;9;33
623;10.04.2018;2018;04;20;Tiistai;20;9;29
623;10.04.2018;2018;04;21;Tiistai;9;7;16
623;10.04.2018;2018;04;22;Tiistai;12;3;15
623;10.04.2018;2018;04;23;Tiistai;3;5;8
623;11.04.2018;2018;04;00;Keskiviikko;2;0;2
623;11.04.2018;2018;04;01;Keskiviikko;3;2;5
623;11.04.2018;2018;04;02;Keskiviikko;0;1;1
623;11.04.2018;2018;04;03;Keskiviikko;2;1;3
623;11.04.2018;2018;04;04;Keskiviikko;0;1;1
623;11.04.2018;2018;04;05;Keskiviikko;1;3;4
623;11.04.2018;2018;04;06;Keskiviikko;2;3;5
623;11.04.2018;2018;04;07;Keskiviikko;2;17;19
623;11.04.2018;2018;04;08;Keskiviikko;18;68;86
623;11.04.2018;2018;04;09;Keskiviikko;26;55;81
623;11.04.2018;2018;04;10;Keskiviikko;14;28;42
623;11.04.2018;2018;04;11;Keskiviikko;11;12;23
623;11.04.2018;2018;04;12;Keskiviikko;19;18;37
623;11.04.2018;2018;04;13;Keskiviikko;22;19;41
623;11.04.2018;2018;04;14;Keskiviikko;16;20;36
623;11.04.2018;2018;04;15;Keskiviikko;26;20;46
623;11.04.2018;2018;04;16;Keskiviikko;32;17;49
623;11.04.2018;2018;04;17;Keskiviikko;46;26;72
623;11.04.2018;2018;04;18;Keskiviikko;43;29;72
623;11.04.2018;2018;04;19;Keskiviikko;16;16;32
623;11.04.2018;2018;04;20;Keskiviikko;21;3;24
623;11.04.2018;2018;04;21;Keskiviikko;17;5;22
623;11.04.2018;2018;04;22;Keskiviikko;20;7;27
623;11.04.2018;2018;04;23;Keskiviikko;3;7;10
623;12.04.2018;2018;04;00;Torstai;0;1;1
623;12.04.2018;2018;04;01;Torstai;3;1;4
623;12.04.2018;2018;04;02;Torstai;0;0;0
623;12.04.2018;2018;04;03;Torstai;1;0;1
623;12.04.2018;2018;04;04;Torstai;0;1;1
623;12.04.2018;2018;04;05;Torstai;1;2;3
623;12.04.2018;2018;04;06;Torstai;0;4;4
623;12.04.2018;2018;04;07;Torstai;4;18;22
623;12.04.2018;2018;04;08;Torstai;28;62;90
623;12.04.2018;2018;04;09;Torstai;16;57;73
623;12.04.2018;2018;04;10;Torstai;15;30;45
623;12.04.2018;2018;04;11;Torstai;13;16;29
623;12.04.2018;2018;04;12;Torstai;21;18;39
623;12.04.2018;2018;04;13;Torstai;19;26;45
623;12.04.2018;2018;04;14;Torstai;26;22;48
623;12.04.2018;2018;04;15;Torstai;31;30;61
623;12.04.2018;2018;04;16;Torstai;49;27;76
623;12.04.2018;2018;04;17;Torstai;62;37;99
623;12.04.2018;2018;04;18;Torstai;37;23;60
623;12.04.2018;2018;04;19;Torstai;37;21;58
623;12.04.2018;2018;04;20;Torstai;13;7;20
623;12.04.2018;2018;04;21;Torstai;11;9;20
623;12.04.2018;2018;04;22;Torstai;11;4;15
623;12.04.2018;2018;04;23;Torstai;3;3;6
623;13.04.2018;2018;04;00;Perjantai;0;1;1
623;13.04.2018;2018;04;01;Perjantai;2;2;4
623;13.04.2018;2018;04;02;Perjantai;3;2;5
623;13.04.2018;2018;04;03;Perjantai;3;3;6
623;13.04.2018;2018;04;04;Perjantai;1;1;2
623;13.04.2018;2018;04;05;Perjantai;1;2;3
623;13.04.2018;2018;04;06;Perjantai;1;6;7
623;13.04.2018;2018;04;07;Perjantai;2;19;21
623;13.04.2018;2018;04;08;Perjantai;19;52;71
623;13.04.2018;2018;04;09;Perjantai;33;64;97
623;13.04.2018;2018;04;10;Perjantai;16;33;49
623;13.04.2018;2018;04;11;Perjantai;16;22;38
623;13.04.2018;2018;04;12;Perjantai;18;26;44
623;13.04.2018;2018;04;13;Perjantai;23;23;46
623;13.04.2018;2018;04;14;Perjantai;24;25;49
623;13.04.2018;2018;04;15;Perjantai;42;29;71
623;13.04.2018;2018;04;16;Perjantai;48;30;78
623;13.04.2018;2018;04;17;Perjantai;35;22;57
623;13.04.2018;2018;04;18;Perjantai;27;17;44
623;13.04.2018;2018;04;19;Perjantai;16;12;28
623;13.04.2018;2018;04;20;Perjantai;21;12;33
623;13.04.2018;2018;04;21;Perjantai;14;11;25
623;13.04.2018;2018;04;22;Perjantai;23;9;32
623;13.04.2018;2018;04;23;Perjantai;6;6;12
623;14.04.2018;2018;04;00;Lauantai;5;5;10
623;14.04.2018;2018;04;01;Lauantai;5;3;8
623;14.04.2018;2018;04;02;Lauantai;2;0;2
623;14.04.2018;2018;04;03;Lauantai;2;1;3
623;14.04.2018;2018;04;04;Lauantai;2;2;4
623;14.04.2018;2018;04;05;Lauantai;1;0;1
623;14.04.2018;2018;04;06;Lauantai;3;4;7
623;14.04.2018;2018;04;07;Lauantai;0;5;5
623;14.04.2018;2018;04;08;Lauantai;0;4;4
623;14.04.2018;2018;04;09;Lauantai;3;7;10
623;14.04.2018;2018;04;10;Lauantai;5;14;19
623;14.04.2018;2018;04;11;Lauantai;9;11;20
623;14.04.2018;2018;04;12;Lauantai;19;27;46
623;14.04.2018;2018;04;13;Lauantai;12;30;42
623;14.04.2018;2018;04;14;Lauantai;23;20;43
623;14.04.2018;2018;04;15;Lauantai;19;19;38
623;14.04.2018;2018;04;16;Lauantai;26;20;46
623;14.04.2018;2018;04;17;Lauantai;30;20;50
623;14.04.2018;2018;04;18;Lauantai;14;11;25
623;14.04.2018;2018;04;19;Lauantai;15;9;24
623;14.04.2018;2018;04;20;Lauantai;15;12;27
623;14.04.2018;2018;04;21;Lauantai;11;10;21
623;14.04.2018;2018;04;22;Lauantai;13;5;18
623;14.04.2018;2018;04;23;Lauantai;7;6;13
623;15.04.2018;2018;04;00;Sunnuntai;7;0;7
623;15.04.2018;2018;04;01;Sunnuntai;6;1;7
623;15.04.2018;2018;04;02;Sunnuntai;4;1;5
623;15.04.2018;2018;04;03;Sunnuntai;5;0;5
623;15.04.2018;2018;04;04;Sunnuntai;4;0;4
623;15.04.2018;2018;04;05;Sunnuntai;0;2;2
623;15.04.2018;2018;04;06;Sunnuntai;2;1;3
623;15.04.2018;2018;04;07;Sunnuntai;2;3;5
623;15.04.2018;2018;04;08;Sunnuntai;5;3;8
623;15.04.2018;2018;04;09;Sunnuntai;1;7;8
623;15.04.2018;2018;04;10;Sunnuntai;6;8;14
623;15.04.2018;2018;04;11;Sunnuntai;11;13;24
623;15.04.2018;2018;04;12;Sunnuntai;6;25;31
623;15.04.2018;2018;04;13;Sunnuntai;27;27;54
623;15.04.2018;2018;04;14;Sunnuntai;36;33;69
623;15.04.2018;2018;04;15;Sunnuntai;24;24;48
623;15.04.2018;2018;04;16;Sunnuntai;32;32;64
623;15.04.2018;2018;04;17;Sunnuntai;28;22;50
623;15.04.2018;2018;04;18;Sunnuntai;21;22;43
623;15.04.2018;2018;04;19;Sunnuntai;28;23;51
623;15.04.2018;2018;04;20;Sunnuntai;17;16;33
623;15.04.2018;2018;04;21;Sunnuntai;21;7;28
623;15.04.2018;2018;04;22;Sunnuntai;12;7;19
623;15.04.2018;2018;04;23;Sunnuntai;2;4;6
623;16.04.2018;2018;04;00;Maanantai;4;0;4
623;16.04.2018;2018;04;01;Maanantai;4;1;5
623;16.04.2018;2018;04;02;Maanantai;1;0;1
623;16.04.2018;2018;04;03;Maanantai;1;1;2
623;16.04.2018;2018;04;04;Maanantai;1;1;2
623;16.04.2018;2018;04;05;Maanantai;1;2;3
623;16.04.2018;2018;04;06;Maanantai;3;8;11
623;16.04.2018;2018;04;07;Maanantai;8;22;30
623;16.04.2018;2018;04;08;Maanantai;35;88;123
623;16.04.2018;2018;04;09;Maanantai;36;79;115
623;16.04.2018;2018;04;10;Maanantai;18;39;57
623;16.04.2018;2018;04;11;Maanantai;21;25;46
623;16.04.2018;2018;04;12;Maanantai;30;22;52
623;16.04.2018;2018;04;13;Maanantai;35;35;70
623;16.04.2018;2018;04;14;Maanantai;34;26;60
623;16.04.2018;2018;04;15;Maanantai;62;35;97
623;16.04.2018;2018;04;16;Maanantai;57;32;89
623;16.04.2018;2018;04;17;Maanantai;71;48;119
623;16.04.2018;2018;04;18;Maanantai;42;34;76
623;16.04.2018;2018;04;19;Maanantai;31;19;50
623;16.04.2018;2018;04;20;Maanantai;31;10;41
623;16.04.2018;2018;04;21;Maanantai;21;12;33
623;16.04.2018;2018;04;22;Maanantai;18;2;20
623;16.04.2018;2018;04;23;Maanantai;5;5;10
623;17.04.2018;2018;04;00;Tiistai;1;1;2
623;17.04.2018;2018;04;01;Tiistai;0;2;2
623;17.04.2018;2018;04;02;Tiistai;0;0;0
623;17.04.2018;2018;04;03;Tiistai;0;1;1
623;17.04.2018;2018;04;04;Tiistai;0;3;3
623;17.04.2018;2018;04;05;Tiistai;0;2;2
623;17.04.2018;2018;04;06;Tiistai;2;7;9
623;17.04.2018;2018;04;07;Tiistai;7;34;41
623;17.04.2018;2018;04;08;Tiistai;24;77;101
623;17.04.2018;2018;04;09;Tiistai;44;92;136
623;17.04.2018;2018;04;10;Tiistai;25;38;63
623;17.04.2018;2018;04;11;Tiistai;20;23;43
623;17.04.2018;2018;04;12;Tiistai;28;22;50
623;17.04.2018;2018;04;13;Tiistai;34;34;68
623;17.04.2018;2018;04;14;Tiistai;26;30;56
623;17.04.2018;2018;04;15;Tiistai;46;33;79
623;17.04.2018;2018;04;16;Tiistai;91;35;126
623;17.04.2018;2018;04;17;Tiistai;89;67;156
623;17.04.2018;2018;04;18;Tiistai;47;53;100
623;17.04.2018;2018;04;19;Tiistai;39;28;67
623;17.04.2018;2018;04;20;Tiistai;43;11;54
623;17.04.2018;2018;04;21;Tiistai;18;11;29
623;17.04.2018;2018;04;22;Tiistai;20;6;26
623;17.04.2018;2018;04;23;Tiistai;6;6;12
623;18.04.2018;2018;04;00;Keskiviikko;3;4;7
623;18.04.2018;2018;04;01;Keskiviikko;0;1;1
623;18.04.2018;2018;04;02;Keskiviikko;0;2;2
623;18.04.2018;2018;04;03;Keskiviikko;1;1;2
623;18.04.2018;2018;04;04;Keskiviikko;0;2;2
623;18.04.2018;2018;04;05;Keskiviikko;1;1;2
623;18.04.2018;2018;04;06;Keskiviikko;1;5;6
623;18.04.2018;2018;04;07;Keskiviikko;7;26;33
623;18.04.2018;2018;04;08;Keskiviikko;28;72;100
623;18.04.2018;2018;04;09;Keskiviikko;48;97;145
623;18.04.2018;2018;04;10;Keskiviikko;29;39;68
623;18.04.2018;2018;04;11;Keskiviikko;24;33;57
623;18.04.2018;2018;04;12;Keskiviikko;26;31;57
623;18.04.2018;2018;04;13;Keskiviikko;23;48;71
623;18.04.2018;2018;04;14;Keskiviikko;40;28;68
623;18.04.2018;2018;04;15;Keskiviikko;66;29;95
623;18.04.2018;2018;04;16;Keskiviikko;84;50;134
623;18.04.2018;2018;04;17;Keskiviikko;80;59;139
623;18.04.2018;2018;04;18;Keskiviikko;46;42;88
623;18.04.2018;2018;04;19;Keskiviikko;47;26;73
623;18.04.2018;2018;04;20;Keskiviikko;36;15;51
623;18.04.2018;2018;04;21;Keskiviikko;29;21;50
623;18.04.2018;2018;04;22;Keskiviikko;17;15;32
623;18.04.2018;2018;04;23;Keskiviikko;8;5;13
623;19.04.2018;2018;04;00;Torstai;2;2;4
623;19.04.2018;2018;04;01;Torstai;2;1;3
623;19.04.2018;2018;04;02;Torstai;2;1;3
623;19.04.2018;2018;04;03;Torstai;1;1;2
623;19.04.2018;2018;04;04;Torstai;1;1;2
623;19.04.2018;2018;04;05;Torstai;2;3;5
623;19.04.2018;2018;04;06;Torstai;3;4;7
623;19.04.2018;2018;04;07;Torstai;5;33;38
623;19.04.2018;2018;04;08;Torstai;32;80;112
623;19.04.2018;2018;04;09;Torstai;50;95;145
623;19.04.2018;2018;04;10;Torstai;30;62;92
623;19.04.2018;2018;04;11;Torstai;19;27;46
623;19.04.2018;2018;04;12;Torstai;38;35;73
623;19.04.2018;2018;04;13;Torstai;41;46;87
623;19.04.2018;2018;04;14;Torstai;33;31;64
623;19.04.2018;2018;04;15;Torstai;53;27;80
623;19.04.2018;2018;04;16;Torstai;59;45;104
623;19.04.2018;2018;04;17;Torstai;100;78;178
623;19.04.2018;2018;04;18;Torstai;51;56;107
623;19.04.2018;2018;04;19;Torstai;46;45;91
623;19.04.2018;2018;04;20;Torstai;27;15;42
623;19.04.2018;2018;04;21;Torstai;32;9;41
623;19.04.2018;2018;04;22;Torstai;35;14;49
623;19.04.2018;2018;04;23;Torstai;5;5;10
623;20.04.2018;2018;04;00;Perjantai;3;3;6
623;20.04.2018;2018;04;01;Perjantai;7;2;9
623;20.04.2018;2018;04;02;Perjantai;5;0;5
623;20.04.2018;2018;04;03;Perjantai;3;2;5
623;20.04.2018;2018;04;04;Perjantai;2;0;2
623;20.04.2018;2018;04;05;Perjantai;1;3;4
623;20.04.2018;2018;04;06;Perjantai;2;7;9
623;20.04.2018;2018;04;07;Perjantai;7;21;28
623;20.04.2018;2018;04;08;Perjantai;20;59;79
623;20.04.2018;2018;04;09;Perjantai;28;71;99
623;20.04.2018;2018;04;10;Perjantai;19;31;50
623;20.04.2018;2018;04;11;Perjantai;7;8;15
623;20.04.2018;2018;04;12;Perjantai;11;14;25
623;20.04.2018;2018;04;13;Perjantai;21;27;48
623;20.04.2018;2018;04;14;Perjantai;28;18;46
623;20.04.2018;2018;04;15;Perjantai;47;22;69
623;20.04.2018;2018;04;16;Perjantai;49;38;87
623;20.04.2018;2018;04;17;Perjantai;47;35;82
623;20.04.2018;2018;04;18;Perjantai;35;37;72
623;20.04.2018;2018;04;19;Perjantai;29;16;45
623;20.04.2018;2018;04;20;Perjantai;23;13;36
623;20.04.2018;2018;04;21;Perjantai;12;9;21
623;20.04.2018;2018;04;22;Perjantai;13;2;15
623;20.04.2018;2018;04;23;Perjantai;12;5;17
623;21.04.2018;2018;04;00;Lauantai;9;1;10
623;21.04.2018;2018;04;01;Lauantai;3;4;7
623;21.04.2018;2018;04;02;Lauantai;6;3;9
623;21.04.2018;2018;04;03;Lauantai;2;1;3
623;21.04.2018;2018;04;04;Lauantai;4;0;4
623;21.04.2018;2018;04;05;Lauantai;8;3;11
623;21.04.2018;2018;04;06;Lauantai;5;4;9
623;21.04.2018;2018;04;07;Lauantai;5;3;8
623;21.04.2018;2018;04;08;Lauantai;1;4;5
623;21.04.2018;2018;04;09;Lauantai;6;8;14
623;21.04.2018;2018;04;10;Lauantai;5;20;25
623;21.04.2018;2018;04;11;Lauantai;17;17;34
623;21.04.2018;2018;04;12;Lauantai;20;38;58
623;21.04.2018;2018;04;13;Lauantai;13;24;37
623;21.04.2018;2018;04;14;Lauantai;23;19;42
623;21.04.2018;2018;04;15;Lauantai;33;17;50
623;21.04.2018;2018;04;16;Lauantai;30;22;52
623;21.04.2018;2018;04;17;Lauantai;28;18;46
623;21.04.2018;2018;04;18;Lauantai;15;15;30
623;21.04.2018;2018;04;19;Lauantai;16;15;31
623;21.04.2018;2018;04;20;Lauantai;11;12;23
623;21.04.2018;2018;04;21;Lauantai;17;15;32
623;21.04.2018;2018;04;22;Lauantai;13;8;21
623;21.04.2018;2018;04;23;Lauantai;5;3;8
623;22.04.2018;2018;04;00;Sunnuntai;7;8;15
623;22.04.2018;2018;04;01;Sunnuntai;3;1;4
623;22.04.2018;2018;04;02;Sunnuntai;9;2;11
623;22.04.2018;2018;04;03;Sunnuntai;5;4;9
623;22.04.2018;2018;04;04;Sunnuntai;0;3;3
623;22.04.2018;2018;04;05;Sunnuntai;3;1;4
623;22.04.2018;2018;04;06;Sunnuntai;3;2;5
623;22.04.2018;2018;04;07;Sunnuntai;3;6;9
623;22.04.2018;2018;04;08;Sunnuntai;2;6;8
623;22.04.2018;2018;04;09;Sunnuntai;1;6;7
623;22.04.2018;2018;04;10;Sunnuntai;7;7;14
623;22.04.2018;2018;04;11;Sunnuntai;14;25;39
623;22.04.2018;2018;04;12;Sunnuntai;25;55;80
623;22.04.2018;2018;04;13;Sunnuntai;27;55;82
623;22.04.2018;2018;04;14;Sunnuntai;39;50;89
623;22.04.2018;2018;04;15;Sunnuntai;28;20;48
623;22.04.2018;2018;04;16;Sunnuntai;58;28;86
623;22.04.2018;2018;04;17;Sunnuntai;39;20;59
623;22.04.2018;2018;04;18;Sunnuntai;17;21;38
623;22.04.2018;2018;04;19;Sunnuntai;25;33;58
623;22.04.2018;2018;04;20;Sunnuntai;26;24;50
623;22.04.2018;2018;04;21;Sunnuntai;21;14;35
623;22.04.2018;2018;04;22;Sunnuntai;14;18;32
623;22.04.2018;2018;04;23;Sunnuntai;6;5;11
623;23.04.2018;2018;04;00;Maanantai;3;3;6
623;23.04.2018;2018;04;01;Maanantai;3;1;4
623;23.04.2018;2018;04;02;Maanantai;1;0;1
623;23.04.2018;2018;04;03;Maanantai;1;1;2
623;23.04.2018;2018;04;04;Maanantai;1;1;2
623;23.04.2018;2018;04;05;Maanantai;2;2;4
623;23.04.2018;2018;04;06;Maanantai;0;12;12
623;23.04.2018;2018;04;07;Maanantai;4;34;38
623;23.04.2018;2018;04;08;Maanantai;38;92;130
623;23.04.2018;2018;04;09;Maanantai;39;90;129
623;23.04.2018;2018;04;10;Maanantai;42;59;101
623;23.04.2018;2018;04;11;Maanantai;20;25;45
623;23.04.2018;2018;04;12;Maanantai;30;31;61
623;23.04.2018;2018;04;13;Maanantai;24;36;60
623;23.04.2018;2018;04;14;Maanantai;44;27;71
623;23.04.2018;2018;04;15;Maanantai;60;41;101
623;23.04.2018;2018;04;16;Maanantai;89;47;136
623;23.04.2018;2018;04;17;Maanantai;100;59;159
623;23.04.2018;2018;04;18;Maanantai;55;50;105
623;23.04.2018;2018;04;19;Maanantai;35;32;67
623;23.04.2018;2018;04;20;Maanantai;28;22;50
623;23.04.2018;2018;04;21;Maanantai;26;7;33
623;23.04.2018;2018;04;22;Maanantai;30;9;39
623;23.04.2018;2018;04;23;Maanantai;13;9;22
623;24.04.2018;2018;04;00;Tiistai;2;2;4
623;24.04.2018;2018;04;01;Tiistai;2;2;4
623;24.04.2018;2018;04;02;Tiistai;3;4;7
623;24.04.2018;2018;04;03;Tiistai;7;2;9
623;24.04.2018;2018;04;04;Tiistai;1;0;1
623;24.04.2018;2018;04;05;Tiistai;1;3;4
623;24.04.2018;2018;04;06;Tiistai;2;10;12
623;24.04.2018;2018;04;07;Tiistai;7;39;46
623;24.04.2018;2018;04;08;Tiistai;31;93;124
623;24.04.2018;2018;04;09;Tiistai;34;108;142
623;24.04.2018;2018;04;10;Tiistai;32;45;77
623;24.04.2018;2018;04;11;Tiistai;22;36;58
623;24.04.2018;2018;04;12;Tiistai;24;16;40
623;24.04.2018;2018;04;13;Tiistai;20;19;39
623;24.04.2018;2018;04;14;Tiistai;38;31;69
623;24.04.2018;2018;04;15;Tiistai;44;25;69
623;24.04.2018;2018;04;16;Tiistai;70;19;89
623;24.04.2018;2018;04;17;Tiistai;80;45;125
623;24.04.2018;2018;04;18;Tiistai;51;51;102
623;24.04.2018;2018;04;19;Tiistai;37;27;64
623;24.04.2018;2018;04;20;Tiistai;23;13;36
623;24.04.2018;2018;04;21;Tiistai;14;14;28
623;24.04.2018;2018;04;22;Tiistai;23;6;29
623;24.04.2018;2018;04;23;Tiistai;9;4;13
623;25.04.2018;2018;04;00;Keskiviikko;6;1;7
623;25.04.2018;2018;04;01;Keskiviikko;2;3;5
623;25.04.2018;2018;04;02;Keskiviikko;1;2;3
623;25.04.2018;2018;04;03;Keskiviikko;1;1;2
623;25.04.2018;2018;04;04;Keskiviikko;0;1;1
623;25.04.2018;2018;04;05;Keskiviikko;0;4;4
623;25.04.2018;2018;04;06;Keskiviikko;1;6;7
623;25.04.2018;2018;04;07;Keskiviikko;5;35;40
623;25.04.2018;2018;04;08;Keskiviikko;35;84;119
623;25.04.2018;2018;04;09;Keskiviikko;52;96;148
623;25.04.2018;2018;04;10;Keskiviikko;17;48;65
623;25.04.2018;2018;04;11;Keskiviikko;26;39;65
623;25.04.2018;2018;04;12;Keskiviikko;34;34;68
623;25.04.2018;2018;04;13;Keskiviikko;40;32;72
623;25.04.2018;2018;04;14;Keskiviikko;33;22;55
623;25.04.2018;2018;04;15;Keskiviikko;72;40;112
623;25.04.2018;2018;04;16;Keskiviikko;57;45;102
623;25.04.2018;2018;04;17;Keskiviikko;94;61;155
623;25.04.2018;2018;04;18;Keskiviikko;43;47;90
623;25.04.2018;2018;04;19;Keskiviikko;42;39;81
623;25.04.2018;2018;04;20;Keskiviikko;30;26;56
623;25.04.2018;2018;04;21;Keskiviikko;28;16;44
623;25.04.2018;2018;04;22;Keskiviikko;17;14;31
623;25.04.2018;2018;04;23;Keskiviikko;4;7;11
623;26.04.2018;2018;04;00;Torstai;9;4;13
623;26.04.2018;2018;04;01;Torstai;7;2;9
623;26.04.2018;2018;04;02;Torstai;1;0;1
623;26.04.2018;2018;04;03;Torstai;4;2;6
623;26.04.2018;2018;04;04;Torstai;2;2;4
623;26.04.2018;2018;04;05;Torstai;1;3;4
623;26.04.2018;2018;04;06;Torstai;2;3;5
623;26.04.2018;2018;04;07;Torstai;5;42;47
623;26.04.2018;2018;04;08;Torstai;32;74;106
623;26.04.2018;2018;04;09;Torstai;41;94;135
623;26.04.2018;2018;04;10;Torstai;26;57;83
623;26.04.2018;2018;04;11;Torstai;24;31;55
623;26.04.2018;2018;04;12;Torstai;31;28;59
623;26.04.2018;2018;04;13;Torstai;33;39;72
623;26.04.2018;2018;04;14;Torstai;49;31;80
623;26.04.2018;2018;04;15;Torstai;56;44;100
623;26.04.2018;2018;04;16;Torstai;71;45;116
623;26.04.2018;2018;04;17;Torstai;98;73;171
623;26.04.2018;2018;04;18;Torstai;51;44;95
623;26.04.2018;2018;04;19;Torstai;44;33;77
623;26.04.2018;2018;04;20;Torstai;24;20;44
623;26.04.2018;2018;04;21;Torstai;14;16;30
623;26.04.2018;2018;04;22;Torstai;25;9;34
623;26.04.2018;2018;04;23;Torstai;15;14;29
623;27.04.2018;2018;04;00;Perjantai;10;4;14
623;27.04.2018;2018;04;01;Perjantai;5;5;10
623;27.04.2018;2018;04;02;Perjantai;8;1;9
623;27.04.2018;2018;04;03;Perjantai;5;2;7
623;27.04.2018;2018;04;04;Perjantai;8;2;10
623;27.04.2018;2018;04;05;Perjantai;6;3;9
623;27.04.2018;2018;04;06;Perjantai;2;9;11
623;27.04.2018;2018;04;07;Perjantai;5;39;44
623;27.04.2018;2018;04;08;Perjantai;37;76;113
623;27.04.2018;2018;04;09;Perjantai;43;97;140
623;27.04.2018;2018;04;10;Perjantai;33;53;86
623;27.04.2018;2018;04;11;Perjantai;25;30;55
623;27.04.2018;2018;04;12;Perjantai;43;46;89
623;27.04.2018;2018;04;13;Perjantai;33;42;75
623;27.04.2018;2018;04;14;Perjantai;53;31;84
623;27.04.2018;2018;04;15;Perjantai;65;34;99
623;27.04.2018;2018;04;16;Perjantai;68;43;111
623;27.04.2018;2018;04;17;Perjantai;62;37;99
623;27.04.2018;2018;04;18;Perjantai;38;39;77
623;27.04.2018;2018;04;19;Perjantai;30;28;58
623;27.04.2018;2018;04;20;Perjantai;38;21;59
623;27.04.2018;2018;04;21;Perjantai;18;18;36
623;27.04.2018;2018;04;22;Perjantai;20;9;29
623;27.04.2018;2018;04;23;Perjantai;10;7;17
623;28.04.2018;2018;04;00;Lauantai;14;5;19
623;28.04.2018;2018;04;01;Lauantai;8;4;12
623;28.04.2018;2018;04;02;Lauantai;7;3;10
623;28.04.2018;2018;04;03;Lauantai;6;2;8
623;28.04.2018;2018;04;04;Lauantai;5;1;6
623;28.04.2018;2018;04;05;Lauantai;6;4;10
623;28.04.2018;2018;04;06;Lauantai;4;3;7
623;28.04.2018;2018;04;07;Lauantai;0;5;5
623;28.04.2018;2018;04;08;Lauantai;3;9;12
623;28.04.2018;2018;04;09;Lauantai;9;8;17
623;28.04.2018;2018;04;10;Lauantai;8;22;30
623;28.04.2018;2018;04;11;Lauantai;19;25;44
623;28.04.2018;2018;04;12;Lauantai;17;29;46
623;28.04.2018;2018;04;13;Lauantai;34;46;80
623;28.04.2018;2018;04;14;Lauantai;30;39;69
623;28.04.2018;2018;04;15;Lauantai;34;45;79
623;28.04.2018;2018;04;16;Lauantai;32;30;62
623;28.04.2018;2018;04;17;Lauantai;35;32;67
623;28.04.2018;2018;04;18;Lauantai;29;18;47
623;28.04.2018;2018;04;19;Lauantai;19;25;44
623;28.04.2018;2018;04;20;Lauantai;18;25;43
623;28.04.2018;2018;04;21;Lauantai;19;18;37
623;28.04.2018;2018;04;22;Lauantai;24;7;31
623;28.04.2018;2018;04;23;Lauantai;5;8;13
623;29.04.2018;2018;04;00;Sunnuntai;12;4;16
623;29.04.2018;2018;04;01;Sunnuntai;8;4;12
623;29.04.2018;2018;04;02;Sunnuntai;11;5;16
623;29.04.2018;2018;04;03;Sunnuntai;10;1;11
623;29.04.2018;2018;04;04;Sunnuntai;5;0;5
623;29.04.2018;2018;04;05;Sunnuntai;4;3;7
623;29.04.2018;2018;04;06;Sunnuntai;1;2;3
623;29.04.2018;2018;04;07;Sunnuntai;5;10;15
623;29.04.2018;2018;04;08;Sunnuntai;0;4;4
623;29.04.2018;2018;04;09;Sunnuntai;1;3;4
623;29.04.2018;2018;04;10;Sunnuntai;11;12;23
623;29.04.2018;2018;04;11;Sunnuntai;8;18;26
623;29.04.2018;2018;04;12;Sunnuntai;18;18;36
623;29.04.2018;2018;04;13;Sunnuntai;17;39;56
623;29.04.2018;2018;04;14;Sunnuntai;22;30;52
623;29.04.2018;2018;04;15;Sunnuntai;23;32;55
623;29.04.2018;2018;04;16;Sunnuntai;30;14;44
623;29.04.2018;2018;04;17;Sunnuntai;31;33;64
623;29.04.2018;2018;04;18;Sunnuntai;21;20;41
623;29.04.2018;2018;04;19;Sunnuntai;27;32;59
623;29.04.2018;2018;04;20;Sunnuntai;24;14;38
623;29.04.2018;2018;04;21;Sunnuntai;29;16;45
623;29.04.2018;2018;04;22;Sunnuntai;10;9;19
623;29.04.2018;2018;04;23;Sunnuntai;7;8;15
623;30.04.2018;2018;04;00;Maanantai;8;4;12
623;30.04.2018;2018;04;01;Maanantai;9;4;13
623;30.04.2018;2018;04;02;Maanantai;4;1;5
623;30.04.2018;2018;04;03;Maanantai;7;1;8
623;30.04.2018;2018;04;04;Maanantai;3;1;4
623;30.04.2018;2018;04;05;Maanantai;3;4;7
623;30.04.2018;2018;04;06;Maanantai;1;7;8
623;30.04.2018;2018;04;07;Maanantai;4;30;34
623;30.04.2018;2018;04;08;Maanantai;14;54;68
623;30.04.2018;2018;04;09;Maanantai;10;45;55
623;30.04.2018;2018;04;10;Maanantai;15;29;44
623;30.04.2018;2018;04;11;Maanantai;23;32;55
623;30.04.2018;2018;04;12;Maanantai;25;54;79
623;30.04.2018;2018;04;13;Maanantai;29;52;81
623;30.04.2018;2018;04;14;Maanantai;40;74;114
623;30.04.2018;2018;04;15;Maanantai;50;66;116
623;30.04.2018;2018;04;16;Maanantai;78;35;113
623;30.04.2018;2018;04;17;Maanantai;78;48;126
623;30.04.2018;2018;04;18;Maanantai;62;44;106
623;30.04.2018;2018;04;19;Maanantai;48;32;80
623;30.04.2018;2018;04;20;Maanantai;17;14;31
623;30.04.2018;2018;04;21;Maanantai;20;12;32
623;30.04.2018;2018;04;22;Maanantai;20;13;33
623;30.04.2018;2018;04;23;Maanantai;12;13;25
623;01.05.2018;2018;05;00;Tiistai;16;6;22
623;01.05.2018;2018;05;01;Tiistai;18;10;28
623;01.05.2018;2018;05;02;Tiistai;13;2;15
623;01.05.2018;2018;05;03;Tiistai;17;4;21
623;01.05.2018;2018;05;04;Tiistai;10;5;15
623;01.05.2018;2018;05;05;Tiistai;18;6;24
623;01.05.2018;2018;05;06;Tiistai;19;6;25
623;01.05.2018;2018;05;07;Tiistai;11;8;19
623;01.05.2018;2018;05;08;Tiistai;3;7;10
623;01.05.2018;2018;05;09;Tiistai;9;13;22
623;01.05.2018;2018;05;10;Tiistai;11;14;25
623;01.05.2018;2018;05;11;Tiistai;18;41;59
623;01.05.2018;2018;05;12;Tiistai;19;55;74
623;01.05.2018;2018;05;13;Tiistai;39;74;113
623;01.05.2018;2018;05;14;Tiistai;42;52;94
623;01.05.2018;2018;05;15;Tiistai;37;44;81
623;01.05.2018;2018;05;16;Tiistai;49;66;115
623;01.05.2018;2018;05;17;Tiistai;40;24;64
623;01.05.2018;2018;05;18;Tiistai;76;27;103
623;01.05.2018;2018;05;19;Tiistai;52;12;64
623;01.05.2018;2018;05;20;Tiistai;16;15;31
623;01.05.2018;2018;05;21;Tiistai;14;12;26
623;01.05.2018;2018;05;22;Tiistai;22;8;30
623;01.05.2018;2018;05;23;Tiistai;4;1;5
623;02.05.2018;2018;05;00;Keskiviikko;7;3;10
623;02.05.2018;2018;05;01;Keskiviikko;1;2;3
623;02.05.2018;2018;05;02;Keskiviikko;0;0;0
623;02.05.2018;2018;05;03;Keskiviikko;0;1;1
623;02.05.2018;2018;05;04;Keskiviikko;0;1;1
623;02.05.2018;2018;05;05;Keskiviikko;0;2;2
623;02.05.2018;2018;05;06;Keskiviikko;3;12;15
623;02.05.2018;2018;05;07;Keskiviikko;8;35;43
623;02.05.2018;2018;05;08;Keskiviikko;26;73;99
623;02.05.2018;2018;05;09;Keskiviikko;40;108;148
623;02.05.2018;2018;05;10;Keskiviikko;30;37;67
623;02.05.2018;2018;05;11;Keskiviikko;15;17;32
623;02.05.2018;2018;05;12;Keskiviikko;25;26;51
623;02.05.2018;2018;05;13;Keskiviikko;22;42;64
623;02.05.2018;2018;05;14;Keskiviikko;36;21;57
623;02.05.2018;2018;05;15;Keskiviikko;59;22;81
623;02.05.2018;2018;05;16;Keskiviikko;62;22;84
623;02.05.2018;2018;05;17;Keskiviikko;95;48;143
623;02.05.2018;2018;05;18;Keskiviikko;51;40;91
623;02.05.2018;2018;05;19;Keskiviikko;37;22;59
623;02.05.2018;2018;05;20;Keskiviikko;27;8;35
623;02.05.2018;2018;05;21;Keskiviikko;25;11;36
623;02.05.2018;2018;05;22;Keskiviikko;19;11;30
623;02.05.2018;2018;05;23;Keskiviikko;7;2;9
623;03.05.2018;2018;05;00;Torstai;5;0;5
623;03.05.2018;2018;05;01;Torstai;4;1;5
623;03.05.2018;2018;05;02;Torstai;0;0;0
623;03.05.2018;2018;05;03;Torstai;0;1;1
623;03.05.2018;2018;05;04;Torstai;0;3;3
623;03.05.2018;2018;05;05;Torstai;0;3;3
623;03.05.2018;2018;05;06;Torstai;1;5;6
623;03.05.2018;2018;05;07;Torstai;8;45;53
623;03.05.2018;2018;05;08;Torstai;46;106;152
623;03.05.2018;2018;05;09;Torstai;36;89;125
623;03.05.2018;2018;05;10;Torstai;28;41;69
623;03.05.2018;2018;05;11;Torstai;15;28;43
623;03.05.2018;2018;05;12;Torstai;33;40;73
623;03.05.2018;2018;05;13;Torstai;26;34;60
623;03.05.2018;2018;05;14;Torstai;43;46;89
623;03.05.2018;2018;05;15;Torstai;56;38;94
623;03.05.2018;2018;05;16;Torstai;95;36;131
623;03.05.2018;2018;05;17;Torstai;94;54;148
623;03.05.2018;2018;05;18;Torstai;60;43;103
623;03.05.2018;2018;05;19;Torstai;39;35;74
623;03.05.2018;2018;05;20;Torstai;39;26;65
623;03.05.2018;2018;05;21;Torstai;33;17;50
623;03.05.2018;2018;05;22;Torstai;29;7;36
623;03.05.2018;2018;05;23;Torstai;8;5;13
623;04.05.2018;2018;05;00;Perjantai;4;0;4
623;04.05.2018;2018;05;01;Perjantai;1;4;5
623;04.05.2018;2018;05;02;Perjantai;0;1;1
623;04.05.2018;2018;05;03;Perjantai;0;2;2
623;04.05.2018;2018;05;04;Perjantai;0;0;0
623;04.05.2018;2018;05;05;Perjantai;0;2;2
623;04.05.2018;2018;05;06;Perjantai;0;9;9
623;04.05.2018;2018;05;07;Perjantai;7;25;32
623;04.05.2018;2018;05;08;Perjantai;24;70;94
623;04.05.2018;2018;05;09;Perjantai;22;64;86
623;04.05.2018;2018;05;10;Perjantai;11;30;41
623;04.05.2018;2018;05;11;Perjantai;7;19;26
623;04.05.2018;2018;05;12;Perjantai;10;21;31
623;04.05.2018;2018;05;13;Perjantai;19;13;32
623;04.05.2018;2018;05;14;Perjantai;22;13;35
623;04.05.2018;2018;05;15;Perjantai;33;14;47
623;04.05.2018;2018;05;16;Perjantai;31;19;50
623;04.05.2018;2018;05;17;Perjantai;45;14;59
623;04.05.2018;2018;05;18;Perjantai;26;20;46
623;04.05.2018;2018;05;19;Perjantai;18;9;27
623;04.05.2018;2018;05;20;Perjantai;16;18;34
623;04.05.2018;2018;05;21;Perjantai;12;9;21
623;04.05.2018;2018;05;22;Perjantai;21;5;26
623;04.05.2018;2018;05;23;Perjantai;7;6;13
623;05.05.2018;2018;05;00;Lauantai;2;4;6
623;05.05.2018;2018;05;01;Lauantai;6;0;6
623;05.05.2018;2018;05;02;Lauantai;3;1;4
623;05.05.2018;2018;05;03;Lauantai;6;0;6
623;05.05.2018;2018;05;04;Lauantai;3;2;5
623;05.05.2018;2018;05;05;Lauantai;1;2;3
623;05.05.2018;2018;05;06;Lauantai;3;1;4
623;05.05.2018;2018;05;07;Lauantai;3;7;10
623;05.05.2018;2018;05;08;Lauantai;5;2;7
623;05.05.2018;2018;05;09;Lauantai;5;9;14
623;05.05.2018;2018;05;10;Lauantai;5;26;31
623;05.05.2018;2018;05;11;Lauantai;22;18;40
623;05.05.2018;2018;05;12;Lauantai;20;34;54
623;05.05.2018;2018;05;13;Lauantai;31;43;74
623;05.05.2018;2018;05;14;Lauantai;24;24;48
623;05.05.2018;2018;05;15;Lauantai;33;40;73
623;05.05.2018;2018;05;16;Lauantai;42;28;70
623;05.05.2018;2018;05;17;Lauantai;27;26;53
623;05.05.2018;2018;05;18;Lauantai;21;28;49
623;05.05.2018;2018;05;19;Lauantai;25;23;48
623;05.05.2018;2018;05;20;Lauantai;33;20;53
623;05.05.2018;2018;05;21;Lauantai;14;19;33
623;05.05.2018;2018;05;22;Lauantai;17;12;29
623;05.05.2018;2018;05;23;Lauantai;11;5;16
623;06.05.2018;2018;05;00;Sunnuntai;10;3;13
623;06.05.2018;2018;05;01;Sunnuntai;15;4;19
623;06.05.2018;2018;05;02;Sunnuntai;6;1;7
623;06.05.2018;2018;05;03;Sunnuntai;4;2;6
623;06.05.2018;2018;05;04;Sunnuntai;3;0;3
623;06.05.2018;2018;05;05;Sunnuntai;2;4;6
623;06.05.2018;2018;05;06;Sunnuntai;2;1;3
623;06.05.2018;2018;05;07;Sunnuntai;5;9;14
623;06.05.2018;2018;05;08;Sunnuntai;3;5;8
623;06.05.2018;2018;05;09;Sunnuntai;3;8;11
623;06.05.2018;2018;05;10;Sunnuntai;8;18;26
623;06.05.2018;2018;05;11;Sunnuntai;15;28;43
623;06.05.2018;2018;05;12;Sunnuntai;31;41;72
623;06.05.2018;2018;05;13;Sunnuntai;35;41;76
623;06.05.2018;2018;05;14;Sunnuntai;45;44;89
623;06.05.2018;2018;05;15;Sunnuntai;28;27;55
623;06.05.2018;2018;05;16;Sunnuntai;25;38;63
623;06.05.2018;2018;05;17;Sunnuntai;46;43;89
623;06.05.2018;2018;05;18;Sunnuntai;36;20;56
623;06.05.2018;2018;05;19;Sunnuntai;44;34;78
623;06.05.2018;2018;05;20;Sunnuntai;26;19;45
623;06.05.2018;2018;05;21;Sunnuntai;19;8;27
623;06.05.2018;2018;05;22;Sunnuntai;11;6;17
623;06.05.2018;2018;05;23;Sunnuntai;6;7;13
623;07.05.2018;2018;05;00;Maanantai;4;2;6
623;07.05.2018;2018;05;01;Maanantai;5;0;5
623;07.05.2018;2018;05;02;Maanantai;2;1;3
623;07.05.2018;2018;05;03;Maanantai;0;1;1
623;07.05.2018;2018;05;04;Maanantai;0;2;2
623;07.05.2018;2018;05;05;Maanantai;1;2;3
623;07.05.2018;2018;05;06;Maanantai;1;10;11
623;07.05.2018;2018;05;07;Maanantai;7;41;48
623;07.05.2018;2018;05;08;Maanantai;36;98;134
623;07.05.2018;2018;05;09;Maanantai;46;124;170
623;07.05.2018;2018;05;10;Maanantai;43;66;109
623;07.05.2018;2018;05;11;Maanantai;34;36;70
623;07.05.2018;2018;05;12;Maanantai;35;30;65
623;07.05.2018;2018;05;13;Maanantai;33;27;60
623;07.05.2018;2018;05;14;Maanantai;46;34;80
623;07.05.2018;2018;05;15;Maanantai;71;25;96
623;07.05.2018;2018;05;16;Maanantai;62;36;98
623;07.05.2018;2018;05;17;Maanantai;106;48;154
623;07.05.2018;2018;05;18;Maanantai;52;42;94
623;07.05.2018;2018;05;19;Maanantai;30;20;50
623;07.05.2018;2018;05;20;Maanantai;31;23;54
623;07.05.2018;2018;05;21;Maanantai;19;9;28
623;07.05.2018;2018;05;22;Maanantai;21;11;32
623;07.05.2018;2018;05;23;Maanantai;6;6;12
623;08.05.2018;2018;05;00;Tiistai;1;0;1
623;08.05.2018;2018;05;01;Tiistai;1;1;2
623;08.05.2018;2018;05;02;Tiistai;0;0;0
623;08.05.2018;2018;05;03;Tiistai;1;1;2
623;08.05.2018;2018;05;04;Tiistai;0;2;2
623;08.05.2018;2018;05;05;Tiistai;0;2;2
623;08.05.2018;2018;05;06;Tiistai;2;12;14
623;08.05.2018;2018;05;07;Tiistai;11;47;58
623;08.05.2018;2018;05;08;Tiistai;54;121;175
623;08.05.2018;2018;05;09;Tiistai;56;137;193
623;08.05.2018;2018;05;10;Tiistai;32;63;95
623;08.05.2018;2018;05;11;Tiistai;38;52;90
623;08.05.2018;2018;05;12;Tiistai;30;31;61
623;08.05.2018;2018;05;13;Tiistai;51;48;99
623;08.05.2018;2018;05;14;Tiistai;45;39;84
623;08.05.2018;2018;05;15;Tiistai;48;49;97
623;08.05.2018;2018;05;16;Tiistai;104;47;151
623;08.05.2018;2018;05;17;Tiistai;116;65;181
623;08.05.2018;2018;05;18;Tiistai;84;65;149
623;08.05.2018;2018;05;19;Tiistai;76;44;120
623;08.05.2018;2018;05;20;Tiistai;45;31;76
623;08.05.2018;2018;05;21;Tiistai;31;29;60
623;08.05.2018;2018;05;22;Tiistai;32;10;42
623;08.05.2018;2018;05;23;Tiistai;10;5;15
623;09.05.2018;2018;05;00;Keskiviikko;7;2;9
623;09.05.2018;2018;05;01;Keskiviikko;4;2;6
623;09.05.2018;2018;05;02;Keskiviikko;2;0;2
623;09.05.2018;2018;05;03;Keskiviikko;2;0;2
623;09.05.2018;2018;05;04;Keskiviikko;1;2;3
623;09.05.2018;2018;05;05;Keskiviikko;1;4;5
623;09.05.2018;2018;05;06;Keskiviikko;2;8;10
623;09.05.2018;2018;05;07;Keskiviikko;16;50;66
623;09.05.2018;2018;05;08;Keskiviikko;50;122;172
623;09.05.2018;2018;05;09;Keskiviikko;56;128;184
623;09.05.2018;2018;05;10;Keskiviikko;32;55;87
623;09.05.2018;2018;05;11;Keskiviikko;20;42;62
623;09.05.2018;2018;05;12;Keskiviikko;40;56;96
623;09.05.2018;2018;05;13;Keskiviikko;60;64;124
623;09.05.2018;2018;05;14;Keskiviikko;57;43;100
623;09.05.2018;2018;05;15;Keskiviikko;77;46;123
623;09.05.2018;2018;05;16;Keskiviikko;86;60;146
623;09.05.2018;2018;05;17;Keskiviikko;121;71;192
623;09.05.2018;2018;05;18;Keskiviikko;64;67;131
623;09.05.2018;2018;05;19;Keskiviikko;53;64;117
623;09.05.2018;2018;05;20;Keskiviikko;49;35;84
623;09.05.2018;2018;05;21;Keskiviikko;34;28;62
623;09.05.2018;2018;05;22;Keskiviikko;31;18;49
623;09.05.2018;2018;05;23;Keskiviikko;19;11;30
623;10.05.2018;2018;05;00;Torstai;10;7;17
623;10.05.2018;2018;05;01;Torstai;6;8;14
623;10.05.2018;2018;05;02;Torstai;7;3;10
623;10.05.2018;2018;05;03;Torstai;3;3;6
623;10.05.2018;2018;05;04;Torstai;5;3;8
623;10.05.2018;2018;05;05;Torstai;6;8;14
623;10.05.2018;2018;05;06;Torstai;4;5;9
623;10.05.2018;2018;05;07;Torstai;5;17;22
623;10.05.2018;2018;05;08;Torstai;3;14;17
623;10.05.2018;2018;05;09;Torstai;8;14;22
623;10.05.2018;2018;05;10;Torstai;21;17;38
623;10.05.2018;2018;05;11;Torstai;13;29;42
623;10.05.2018;2018;05;12;Torstai;28;46;74
623;10.05.2018;2018;05;13;Torstai;45;57;102
623;10.05.2018;2018;05;14;Torstai;37;62;99
623;10.05.2018;2018;05;15;Torstai;49;70;119
623;10.05.2018;2018;05;16;Torstai;71;67;138
623;10.05.2018;2018;05;17;Torstai;65;67;132
623;10.05.2018;2018;05;18;Torstai;67;60;127
623;10.05.2018;2018;05;19;Torstai;49;37;86
623;10.05.2018;2018;05;20;Torstai;59;38;97
623;10.05.2018;2018;05;21;Torstai;34;15;49
623;10.05.2018;2018;05;22;Torstai;23;9;32
623;10.05.2018;2018;05;23;Torstai;14;7;21
623;11.05.2018;2018;05;00;Perjantai;11;4;15
623;11.05.2018;2018;05;01;Perjantai;9;1;10
623;11.05.2018;2018;05;02;Perjantai;6;1;7
623;11.05.2018;2018;05;03;Perjantai;2;1;3
623;11.05.2018;2018;05;04;Perjantai;0;3;3
623;11.05.2018;2018;05;05;Perjantai;0;3;3
623;11.05.2018;2018;05;06;Perjantai;2;6;8
623;11.05.2018;2018;05;07;Perjantai;5;44;49
623;11.05.2018;2018;05;08;Perjantai;30;77;107
623;11.05.2018;2018;05;09;Perjantai;41;104;145
623;11.05.2018;2018;05;10;Perjantai;20;55;75
623;11.05.2018;2018;05;11;Perjantai;24;50;74
623;11.05.2018;2018;05;12;Perjantai;43;51;94
623;11.05.2018;2018;05;13;Perjantai;54;77;131
623;11.05.2018;2018;05;14;Perjantai;54;35;89
623;11.05.2018;2018;05;15;Perjantai;86;55;141
623;11.05.2018;2018;05;16;Perjantai;95;73;168
623;11.05.2018;2018;05;17;Perjantai;86;59;145
623;11.05.2018;2018;05;18;Perjantai;58;49;107
623;11.05.2018;2018;05;19;Perjantai;39;45;84
623;11.05.2018;2018;05;20;Perjantai;42;35;77
623;11.05.2018;2018;05;21;Perjantai;31;36;67
623;11.05.2018;2018;05;22;Perjantai;30;16;46
623;11.05.2018;2018;05;23;Perjantai;14;22;36
623;12.05.2018;2018;05;00;Lauantai;15;5;20
623;12.05.2018;2018;05;01;Lauantai;17;11;28
623;12.05.2018;2018;05;02;Lauantai;7;1;8
623;12.05.2018;2018;05;03;Lauantai;13;2;15
623;12.05.2018;2018;05;04;Lauantai;7;3;10
623;12.05.2018;2018;05;05;Lauantai;3;2;5
623;12.05.2018;2018;05;06;Lauantai;3;1;4
623;12.05.2018;2018;05;07;Lauantai;5;9;14
623;12.05.2018;2018;05;08;Lauantai;1;5;6
623;12.05.2018;2018;05;09;Lauantai;9;12;21
623;12.05.2018;2018;05;10;Lauantai;10;31;41
623;12.05.2018;2018;05;11;Lauantai;24;28;52
623;12.05.2018;2018;05;12;Lauantai;24;56;80
623;12.05.2018;2018;05;13;Lauantai;28;66;94
623;12.05.2018;2018;05;14;Lauantai;58;63;121
623;12.05.2018;2018;05;15;Lauantai;67;59;126
623;12.05.2018;2018;05;16;Lauantai;59;57;116
623;12.05.2018;2018;05;17;Lauantai;59;50;109
623;12.05.2018;2018;05;18;Lauantai;39;48;87
623;12.05.2018;2018;05;19;Lauantai;54;39;93
623;12.05.2018;2018;05;20;Lauantai;36;32;68
623;12.05.2018;2018;05;21;Lauantai;39;25;64
623;12.05.2018;2018;05;22;Lauantai;26;12;38
623;12.05.2018;2018;05;23;Lauantai;19;8;27
623;13.05.2018;2018;05;00;Sunnuntai;12;4;16
623;13.05.2018;2018;05;01;Sunnuntai;9;7;16
623;13.05.2018;2018;05;02;Sunnuntai;10;2;12
623;13.05.2018;2018;05;03;Sunnuntai;10;7;17
623;13.05.2018;2018;05;04;Sunnuntai;9;0;9
623;13.05.2018;2018;05;05;Sunnuntai;5;1;6
623;13.05.2018;2018;05;06;Sunnuntai;5;1;6
623;13.05.2018;2018;05;07;Sunnuntai;2;10;12
623;13.05.2018;2018;05;08;Sunnuntai;4;5;9
623;13.05.2018;2018;05;09;Sunnuntai;4;6;10
623;13.05.2018;2018;05;10;Sunnuntai;9;22;31
623;13.05.2018;2018;05;11;Sunnuntai;29;38;67
623;13.05.2018;2018;05;12;Sunnuntai;32;49;81
623;13.05.2018;2018;05;13;Sunnuntai;35;46;81
623;13.05.2018;2018;05;14;Sunnuntai;45;64;109
623;13.05.2018;2018;05;15;Sunnuntai;57;57;114
623;13.05.2018;2018;05;16;Sunnuntai;55;55;110
623;13.05.2018;2018;05;17;Sunnuntai;73;47;120
623;13.05.2018;2018;05;18;Sunnuntai;57;49;106
623;13.05.2018;2018;05;19;Sunnuntai;47;39;86
623;13.05.2018;2018;05;20;Sunnuntai;37;35;72
623;13.05.2018;2018;05;21;Sunnuntai;32;20;52
623;13.05.2018;2018;05;22;Sunnuntai;24;15;39
623;13.05.2018;2018;05;23;Sunnuntai;9;4;13
623;14.05.2018;2018;05;00;Maanantai;5;3;8
623;14.05.2018;2018;05;01;Maanantai;2;1;3
623;14.05.2018;2018;05;02;Maanantai;0;1;1
623;14.05.2018;2018;05;03;Maanantai;3;1;4
623;14.05.2018;2018;05;04;Maanantai;0;1;1
623;14.05.2018;2018;05;05;Maanantai;1;8;9
623;14.05.2018;2018;05;06;Maanantai;1;15;16
623;14.05.2018;2018;05;07;Maanantai;13;55;68
623;14.05.2018;2018;05;08;Maanantai;63;140;203
623;14.05.2018;2018;05;09;Maanantai;90;167;257
623;14.05.2018;2018;05;10;Maanantai;47;84;131
623;14.05.2018;2018;05;11;Maanantai;37;38;75
623;14.05.2018;2018;05;12;Maanantai;47;69;116
623;14.05.2018;2018;05;13;Maanantai;59;79;138
623;14.05.2018;2018;05;14;Maanantai;64;50;114
623;14.05.2018;2018;05;15;Maanantai;104;58;162
623;14.05.2018;2018;05;16;Maanantai;135;80;215
623;14.05.2018;2018;05;17;Maanantai;191;114;305
623;14.05.2018;2018;05;18;Maanantai;97;76;173
623;14.05.2018;2018;05;19;Maanantai;65;54;119
623;14.05.2018;2018;05;20;Maanantai;59;30;89
623;14.05.2018;2018;05;21;Maanantai;52;24;76
623;14.05.2018;2018;05;22;Maanantai;43;17;60
623;14.05.2018;2018;05;23;Maanantai;12;5;17
623;15.05.2018;2018;05;00;Tiistai;8;5;13
623;15.05.2018;2018;05;01;Tiistai;5;3;8
623;15.05.2018;2018;05;02;Tiistai;4;2;6
623;15.05.2018;2018;05;03;Tiistai;0;0;0
623;15.05.2018;2018;05;04;Tiistai;1;2;3
623;15.05.2018;2018;05;05;Tiistai;1;5;6
623;15.05.2018;2018;05;06;Tiistai;2;14;16
623;15.05.2018;2018;05;07;Tiistai;10;63;73
623;15.05.2018;2018;05;08;Tiistai;68;154;222
623;15.05.2018;2018;05;09;Tiistai;56;153;209
623;15.05.2018;2018;05;10;Tiistai;41;86;127
623;15.05.2018;2018;05;11;Tiistai;27;47;74
623;15.05.2018;2018;05;12;Tiistai;49;42;91
623;15.05.2018;2018;05;13;Tiistai;67;51;118
623;15.05.2018;2018;05;14;Tiistai;70;42;112
623;15.05.2018;2018;05;15;Tiistai;68;61;129
623;15.05.2018;2018;05;16;Tiistai;132;74;206
623;15.05.2018;2018;05;17;Tiistai;162;89;251
623;15.05.2018;2018;05;18;Tiistai;106;80;186
623;15.05.2018;2018;05;19;Tiistai;63;54;117
623;15.05.2018;2018;05;20;Tiistai;62;46;108
623;15.05.2018;2018;05;21;Tiistai;62;29;91
623;15.05.2018;2018;05;22;Tiistai;42;18;60
623;15.05.2018;2018;05;23;Tiistai;18;12;30
623;16.05.2018;2018;05;00;Keskiviikko;10;2;12
623;16.05.2018;2018;05;01;Keskiviikko;5;0;5
623;16.05.2018;2018;05;02;Keskiviikko;0;2;2
623;16.05.2018;2018;05;03;Keskiviikko;0;1;1
623;16.05.2018;2018;05;04;Keskiviikko;1;3;4
623;16.05.2018;2018;05;05;Keskiviikko;4;6;10
623;16.05.2018;2018;05;06;Keskiviikko;2;12;14
623;16.05.2018;2018;05;07;Keskiviikko;14;58;72
623;16.05.2018;2018;05;08;Keskiviikko;74;141;215
623;16.05.2018;2018;05;09;Keskiviikko;71;160;231
623;16.05.2018;2018;05;10;Keskiviikko;40;84;124
623;16.05.2018;2018;05;11;Keskiviikko;45;61;106
623;16.05.2018;2018;05;12;Keskiviikko;47;62;109
623;16.05.2018;2018;05;13;Keskiviikko;27;30;57
623;16.05.2018;2018;05;14;Keskiviikko;89;99;188
623;16.05.2018;2018;05;15;Keskiviikko;18;15;33
623;16.05.2018;2018;05;16;Keskiviikko;216;140;356
623;16.05.2018;2018;05;17;Keskiviikko;164;92;256
623;16.05.2018;2018;05;18;Keskiviikko;121;84;205
623;16.05.2018;2018;05;19;Keskiviikko;69;68;137
623;16.05.2018;2018;05;20;Keskiviikko;89;44;133
623;16.05.2018;2018;05;21;Keskiviikko;53;30;83
623;16.05.2018;2018;05;22;Keskiviikko;44;28;72
623;16.05.2018;2018;05;23;Keskiviikko;18;9;27
623;17.05.2018;2018;05;00;Torstai;15;5;20
623;17.05.2018;2018;05;01;Torstai;4;3;7
623;17.05.2018;2018;05;02;Torstai;4;2;6
623;17.05.2018;2018;05;03;Torstai;2;2;4
623;17.05.2018;2018;05;04;Torstai;3;2;5
623;17.05.2018;2018;05;05;Torstai;2;5;7
623;17.05.2018;2018;05;06;Torstai;1;13;14
623;17.05.2018;2018;05;07;Torstai;16;57;73
623;17.05.2018;2018;05;08;Torstai;60;140;200
623;17.05.2018;2018;05;09;Torstai;69;152;221
623;17.05.2018;2018;05;10;Torstai;47;81;128
623;17.05.2018;2018;05;11;Torstai;34;39;73
623;17.05.2018;2018;05;12;Torstai;51;52;103
623;17.05.2018;2018;05;13;Torstai;50;47;97
623;17.05.2018;2018;05;14;Torstai;51;42;93
623;17.05.2018;2018;05;15;Torstai;82;54;136
623;17.05.2018;2018;05;16;Torstai;128;60;188
623;17.05.2018;2018;05;17;Torstai;155;87;242
623;17.05.2018;2018;05;18;Torstai;94;62;156
623;17.05.2018;2018;05;19;Torstai;60;52;112
623;17.05.2018;2018;05;20;Torstai;64;31;95
623;17.05.2018;2018;05;21;Torstai;33;23;56
623;17.05.2018;2018;05;22;Torstai;33;15;48
623;17.05.2018;2018;05;23;Torstai;13;9;22
623;18.05.2018;2018;05;00;Perjantai;9;5;14
623;18.05.2018;2018;05;01;Perjantai;9;6;15
623;18.05.2018;2018;05;02;Perjantai;4;1;5
623;18.05.2018;2018;05;03;Perjantai;1;1;2
623;18.05.2018;2018;05;04;Perjantai;1;3;4
623;18.05.2018;2018;05;05;Perjantai;0;4;4
623;18.05.2018;2018;05;06;Perjantai;2;10;12
623;18.05.2018;2018;05;07;Perjantai;10;49;59
623;18.05.2018;2018;05;08;Perjantai;51;111;162
623;18.05.2018;2018;05;09;Perjantai;72;139;211
623;18.05.2018;2018;05;10;Perjantai;41;86;127
623;18.05.2018;2018;05;11;Perjantai;34;34;68
623;18.05.2018;2018;05;12;Perjantai;41;52;93
623;18.05.2018;2018;05;13;Perjantai;39;30;69
623;18.05.2018;2018;05;14;Perjantai;63;32;95
623;18.05.2018;2018;05;15;Perjantai;78;46;124
623;18.05.2018;2018;05;16;Perjantai;107;50;157
623;18.05.2018;2018;05;17;Perjantai;105;51;156
623;18.05.2018;2018;05;18;Perjantai;70;67;137
623;18.05.2018;2018;05;19;Perjantai;50;33;83
623;18.05.2018;2018;05;20;Perjantai;37;28;65
623;18.05.2018;2018;05;21;Perjantai;33;21;54
623;18.05.2018;2018;05;22;Perjantai;23;19;42
623;18.05.2018;2018;05;23;Perjantai;21;13;34
623;19.05.2018;2018;05;00;Lauantai;9;5;14
623;19.05.2018;2018;05;01;Lauantai;13;4;17
623;19.05.2018;2018;05;02;Lauantai;13;8;21
623;19.05.2018;2018;05;03;Lauantai;7;3;10
623;19.05.2018;2018;05;04;Lauantai;10;3;13
623;19.05.2018;2018;05;05;Lauantai;1;4;5
623;19.05.2018;2018;05;06;Lauantai;3;7;10
623;19.05.2018;2018;05;07;Lauantai;4;11;15
623;19.05.2018;2018;05;08;Lauantai;7;9;16
623;19.05.2018;2018;05;09;Lauantai;6;19;25
623;19.05.2018;2018;05;10;Lauantai;13;33;46
623;19.05.2018;2018;05;11;Lauantai;22;31;53
623;19.05.2018;2018;05;12;Lauantai;21;33;54
623;19.05.2018;2018;05;13;Lauantai;29;49;78
623;19.05.2018;2018;05;14;Lauantai;52;44;96
623;19.05.2018;2018;05;15;Lauantai;54;44;98
623;19.05.2018;2018;05;16;Lauantai;51;42;93
623;19.05.2018;2018;05;17;Lauantai;46;35;81
623;19.05.2018;2018;05;18;Lauantai;42;30;72
623;19.05.2018;2018;05;19;Lauantai;38;33;71
623;19.05.2018;2018;05;20;Lauantai;27;29;56
623;19.05.2018;2018;05;21;Lauantai;22;25;47
623;19.05.2018;2018;05;22;Lauantai;31;21;52
623;19.05.2018;2018;05;23;Lauantai;22;10;32
623;20.05.2018;2018;05;00;Sunnuntai;18;11;29
623;20.05.2018;2018;05;01;Sunnuntai;11;13;24
623;20.05.2018;2018;05;02;Sunnuntai;15;5;20
623;20.05.2018;2018;05;03;Sunnuntai;15;1;16
623;20.05.2018;2018;05;04;Sunnuntai;8;1;9
623;20.05.2018;2018;05;05;Sunnuntai;4;1;5
623;20.05.2018;2018;05;06;Sunnuntai;4;2;6
623;20.05.2018;2018;05;07;Sunnuntai;2;9;11
623;20.05.2018;2018;05;08;Sunnuntai;4;11;15
623;20.05.2018;2018;05;09;Sunnuntai;1;3;4
623;20.05.2018;2018;05;10;Sunnuntai;17;20;37
623;20.05.2018;2018;05;11;Sunnuntai;15;18;33
623;20.05.2018;2018;05;12;Sunnuntai;32;47;79
623;20.05.2018;2018;05;13;Sunnuntai;31;63;94
623;20.05.2018;2018;05;14;Sunnuntai;36;40;76
623;20.05.2018;2018;05;15;Sunnuntai;50;48;98
623;20.05.2018;2018;05;16;Sunnuntai;40;50;90
623;20.05.2018;2018;05;17;Sunnuntai;54;28;82
623;20.05.2018;2018;05;18;Sunnuntai;48;39;87
623;20.05.2018;2018;05;19;Sunnuntai;38;29;67
623;20.05.2018;2018;05;20;Sunnuntai;35;33;68
623;20.05.2018;2018;05;21;Sunnuntai;24;22;46
623;20.05.2018;2018;05;22;Sunnuntai;24;8;32
623;20.05.2018;2018;05;23;Sunnuntai;13;5;18
623;21.05.2018;2018;05;00;Maanantai;4;3;7
623;21.05.2018;2018;05;01;Maanantai;6;4;10
623;21.05.2018;2018;05;02;Maanantai;3;1;4
623;21.05.2018;2018;05;03;Maanantai;2;2;4
623;21.05.2018;2018;05;04;Maanantai;1;2;3
623;21.05.2018;2018;05;05;Maanantai;1;5;6
623;21.05.2018;2018;05;06;Maanantai;1;17;18
623;21.05.2018;2018;05;07;Maanantai;7;49;56
623;21.05.2018;2018;05;08;Maanantai;58;149;207
623;21.05.2018;2018;05;09;Maanantai;68;164;232
623;21.05.2018;2018;05;10;Maanantai;44;93;137
623;21.05.2018;2018;05;11;Maanantai;33;48;81
623;21.05.2018;2018;05;12;Maanantai;38;53;91
623;21.05.2018;2018;05;13;Maanantai;41;59;100
623;21.05.2018;2018;05;14;Maanantai;68;51;119
623;21.05.2018;2018;05;15;Maanantai;105;45;150
623;21.05.2018;2018;05;16;Maanantai;116;66;182
623;21.05.2018;2018;05;17;Maanantai;191;99;290
623;21.05.2018;2018;05;18;Maanantai;92;73;165
623;21.05.2018;2018;05;19;Maanantai;58;62;120
623;21.05.2018;2018;05;20;Maanantai;63;37;100
623;21.05.2018;2018;05;21;Maanantai;59;30;89
623;21.05.2018;2018;05;22;Maanantai;38;13;51
623;21.05.2018;2018;05;23;Maanantai;20;11;31
623;22.05.2018;2018;05;00;Tiistai;11;3;14
623;22.05.2018;2018;05;01;Tiistai;6;4;10
623;22.05.2018;2018;05;02;Tiistai;2;1;3
623;22.05.2018;2018;05;03;Tiistai;2;2;4
623;22.05.2018;2018;05;04;Tiistai;0;1;1
623;22.05.2018;2018;05;05;Tiistai;0;7;7
623;22.05.2018;2018;05;06;Tiistai;1;13;14
623;22.05.2018;2018;05;07;Tiistai;15;58;73
623;22.05.2018;2018;05;08;Tiistai;72;157;229
623;22.05.2018;2018;05;09;Tiistai;76;157;233
623;22.05.2018;2018;05;10;Tiistai;30;78;108
623;22.05.2018;2018;05;11;Tiistai;37;57;94
623;22.05.2018;2018;05;12;Tiistai;42;56;98
623;22.05.2018;2018;05;13;Tiistai;51;57;108
623;22.05.2018;2018;05;14;Tiistai;55;56;111
623;22.05.2018;2018;05;15;Tiistai;93;75;168
623;22.05.2018;2018;05;16;Tiistai;161;67;228
623;22.05.2018;2018;05;17;Tiistai;171;105;276
623;22.05.2018;2018;05;18;Tiistai;91;70;161
623;22.05.2018;2018;05;19;Tiistai;65;43;108
623;22.05.2018;2018;05;20;Tiistai;67;51;118
623;22.05.2018;2018;05;21;Tiistai;62;38;100
623;22.05.2018;2018;05;22;Tiistai;27;16;43
623;22.05.2018;2018;05;23;Tiistai;15;12;27
623;23.05.2018;2018;05;00;Keskiviikko;15;1;16
623;23.05.2018;2018;05;01;Keskiviikko;8;7;15
623;23.05.2018;2018;05;02;Keskiviikko;3;1;4
623;23.05.2018;2018;05;03;Keskiviikko;0;2;2
623;23.05.2018;2018;05;04;Keskiviikko;2;0;2
623;23.05.2018;2018;05;05;Keskiviikko;0;6;6
623;23.05.2018;2018;05;06;Keskiviikko;3;13;16
623;23.05.2018;2018;05;07;Keskiviikko;11;52;63
623;23.05.2018;2018;05;08;Keskiviikko;55;147;202
623;23.05.2018;2018;05;09;Keskiviikko;70;156;226
623;23.05.2018;2018;05;10;Keskiviikko;33;64;97
623;23.05.2018;2018;05;11;Keskiviikko;25;37;62
623;23.05.2018;2018;05;12;Keskiviikko;40;49;89
623;23.05.2018;2018;05;13;Keskiviikko;55;52;107
623;23.05.2018;2018;05;14;Keskiviikko;76;53;129
623;23.05.2018;2018;05;15;Keskiviikko;77;53;130
623;23.05.2018;2018;05;16;Keskiviikko;115;57;172
623;23.05.2018;2018;05;17;Keskiviikko;140;75;215
623;23.05.2018;2018;05;18;Keskiviikko;103;72;175
623;23.05.2018;2018;05;19;Keskiviikko;73;39;112
623;23.05.2018;2018;05;20;Keskiviikko;53;31;84
623;23.05.2018;2018;05;21;Keskiviikko;41;25;66
623;23.05.2018;2018;05;22;Keskiviikko;34;16;50
623;23.05.2018;2018;05;23;Keskiviikko;33;10;43
623;24.05.2018;2018;05;00;Torstai;7;3;10
623;24.05.2018;2018;05;01;Torstai;9;2;11
623;24.05.2018;2018;05;02;Torstai;3;2;5
623;24.05.2018;2018;05;03;Torstai;3;1;4
623;24.05.2018;2018;05;04;Torstai;2;2;4
623;24.05.2018;2018;05;05;Torstai;0;5;5
623;24.05.2018;2018;05;06;Torstai;0;9;9
623;24.05.2018;2018;05;07;Torstai;15;51;66
623;24.05.2018;2018;05;08;Torstai;54;116;170
623;24.05.2018;2018;05;09;Torstai;72;146;218
623;24.05.2018;2018;05;10;Torstai;29;79;108
623;24.05.2018;2018;05;11;Torstai;37;48;85
623;24.05.2018;2018;05;12;Torstai;35;38;73
623;24.05.2018;2018;05;13;Torstai;54;53;107
623;24.05.2018;2018;05;14;Torstai;67;50;117
623;24.05.2018;2018;05;15;Torstai;95;38;133
623;24.05.2018;2018;05;16;Torstai;124;59;183
623;24.05.2018;2018;05;17;Torstai;140;82;222
623;24.05.2018;2018;05;18;Torstai;85;66;151
623;24.05.2018;2018;05;19;Torstai;58;43;101
623;24.05.2018;2018;05;20;Torstai;45;41;86
623;24.05.2018;2018;05;21;Torstai;47;28;75
623;24.05.2018;2018;05;22;Torstai;27;12;39
623;24.05.2018;2018;05;23;Torstai;11;12;23
623;25.05.2018;2018;05;00;Perjantai;10;1;11
623;25.05.2018;2018;05;01;Perjantai;10;6;16
623;25.05.2018;2018;05;02;Perjantai;2;1;3
623;25.05.2018;2018;05;03;Perjantai;2;1;3
623;25.05.2018;2018;05;04;Perjantai;0;2;2
623;25.05.2018;2018;05;05;Perjantai;1;3;4
623;25.05.2018;2018;05;06;Perjantai;0;11;11
623;25.05.2018;2018;05;07;Perjantai;16;44;60
623;25.05.2018;2018;05;08;Perjantai;42;105;147
623;25.05.2018;2018;05;09;Perjantai;61;131;192
623;25.05.2018;2018;05;10;Perjantai;32;74;106
623;25.05.2018;2018;05;11;Perjantai;26;32;58
623;25.05.2018;2018;05;12;Perjantai;32;42;74
623;25.05.2018;2018;05;13;Perjantai;61;53;114
623;25.05.2018;2018;05;14;Perjantai;67;46;113
623;25.05.2018;2018;05;15;Perjantai;91;56;147
623;25.05.2018;2018;05;16;Perjantai;101;57;158
623;25.05.2018;2018;05;17;Perjantai;115;86;201
623;25.05.2018;2018;05;18;Perjantai;75;61;136
623;25.05.2018;2018;05;19;Perjantai;43;44;87
623;25.05.2018;2018;05;20;Perjantai;40;36;76
623;25.05.2018;2018;05;21;Perjantai;38;29;67
623;25.05.2018;2018;05;22;Perjantai;30;22;52
623;25.05.2018;2018;05;23;Perjantai;23;8;31
623;26.05.2018;2018;05;00;Lauantai;23;8;31
623;26.05.2018;2018;05;01;Lauantai;20;5;25
623;26.05.2018;2018;05;02;Lauantai;20;12;32
623;26.05.2018;2018;05;03;Lauantai;9;2;11
623;26.05.2018;2018;05;04;Lauantai;7;0;7
623;26.05.2018;2018;05;05;Lauantai;6;1;7
623;26.05.2018;2018;05;06;Lauantai;4;2;6
623;26.05.2018;2018;05;07;Lauantai;2;8;10
623;26.05.2018;2018;05;08;Lauantai;1;14;15
623;26.05.2018;2018;05;09;Lauantai;4;16;20
623;26.05.2018;2018;05;10;Lauantai;6;30;36
623;26.05.2018;2018;05;11;Lauantai;30;57;87
623;26.05.2018;2018;05;12;Lauantai;26;56;82
623;26.05.2018;2018;05;13;Lauantai;43;60;103
623;26.05.2018;2018;05;14;Lauantai;41;50;91
623;26.05.2018;2018;05;15;Lauantai;41;29;70
623;26.05.2018;2018;05;16;Lauantai;56;38;94
623;26.05.2018;2018;05;17;Lauantai;44;20;64
623;26.05.2018;2018;05;18;Lauantai;33;31;64
623;26.05.2018;2018;05;19;Lauantai;18;32;50
623;26.05.2018;2018;05;20;Lauantai;14;30;44
623;26.05.2018;2018;05;21;Lauantai;14;17;31
623;26.05.2018;2018;05;22;Lauantai;16;9;25
623;26.05.2018;2018;05;23;Lauantai;12;5;17
623;27.05.2018;2018;05;00;Sunnuntai;13;0;13
623;27.05.2018;2018;05;01;Sunnuntai;8;0;8
623;27.05.2018;2018;05;02;Sunnuntai;12;0;12
623;27.05.2018;2018;05;03;Sunnuntai;9;0;9
623;27.05.2018;2018;05;04;Sunnuntai;5;0;5
623;27.05.2018;2018;05;05;Sunnuntai;3;0;3
623;27.05.2018;2018;05;06;Sunnuntai;1;0;1
623;27.05.2018;2018;05;07;Sunnuntai;4;0;4
623;27.05.2018;2018;05;08;Sunnuntai;4;0;4
623;27.05.2018;2018;05;09;Sunnuntai;9;0;9
623;27.05.2018;2018;05;10;Sunnuntai;28;0;28
623;27.05.2018;2018;05;11;Sunnuntai;34;0;34
623;27.05.2018;2018;05;12;Sunnuntai;32;0;32
623;27.05.2018;2018;05;13;Sunnuntai;94;0;94
623;27.05.2018;2018;05;14;Sunnuntai;76;0;76
623;27.05.2018;2018;05;15;Sunnuntai;98;0;98
623;27.05.2018;2018;05;16;Sunnuntai;90;0;90
623;27.05.2018;2018;05;17;Sunnuntai;82;0;82
623;27.05.2018;2018;05;18;Sunnuntai;87;0;87
623;27.05.2018;2018;05;19;Sunnuntai;67;0;67
623;27.05.2018;2018;05;20;Sunnuntai;68;0;68
623;27.05.2018;2018;05;21;Sunnuntai;46;0;46
623;27.05.2018;2018;05;22;Sunnuntai;32;0;32
623;27.05.2018;2018;05;23;Sunnuntai;18;0;18
623;28.05.2018;2018;05;00;Maanantai;7;0;7
623;28.05.2018;2018;05;01;Maanantai;10;0;10
623;28.05.2018;2018;05;02;Maanantai;4;0;4
623;28.05.2018;2018;05;03;Maanantai;4;0;4
623;28.05.2018;2018;05;04;Maanantai;3;0;3
623;28.05.2018;2018;05;05;Maanantai;6;0;6
623;28.05.2018;2018;05;06;Maanantai;18;0;18
623;28.05.2018;2018;05;07;Maanantai;56;0;56
623;28.05.2018;2018;05;08;Maanantai;207;0;207
623;28.05.2018;2018;05;09;Maanantai;232;0;232
623;28.05.2018;2018;05;10;Maanantai;137;0;137
623;28.05.2018;2018;05;11;Maanantai;81;0;81
623;28.05.2018;2018;05;12;Maanantai;101;0;101
623;28.05.2018;2018;05;13;Maanantai;114;0;114
623;28.05.2018;2018;05;14;Maanantai;114;0;114
623;28.05.2018;2018;05;15;Maanantai;130;0;130
623;28.05.2018;2018;05;16;Maanantai;194;0;194
623;28.05.2018;2018;05;17;Maanantai;258;0;258
623;28.05.2018;2018;05;18;Maanantai;177;0;177
623;28.05.2018;2018;05;19;Maanantai;97;0;97
623;28.05.2018;2018;05;20;Maanantai;70;0;70
623;28.05.2018;2018;05;21;Maanantai;79;0;79
623;28.05.2018;2018;05;22;Maanantai;45;0;45
623;28.05.2018;2018;05;23;Maanantai;36;0;36
623;29.05.2018;2018;05;00;Tiistai;3;2;5
623;29.05.2018;2018;05;01;Tiistai;6;0;6
623;29.05.2018;2018;05;02;Tiistai;1;3;4
623;29.05.2018;2018;05;03;Tiistai;0;4;4
623;29.05.2018;2018;05;04;Tiistai;3;2;5
623;29.05.2018;2018;05;05;Tiistai;0;4;4
623;29.05.2018;2018;05;06;Tiistai;3;15;18
623;29.05.2018;2018;05;07;Tiistai;13;61;74
623;29.05.2018;2018;05;08;Tiistai;51;137;188
623;29.05.2018;2018;05;09;Tiistai;56;146;202
623;29.05.2018;2018;05;10;Tiistai;35;83;118
623;29.05.2018;2018;05;11;Tiistai;35;38;73
623;29.05.2018;2018;05;12;Tiistai;31;51;82
623;29.05.2018;2018;05;13;Tiistai;83;58;141
623;29.05.2018;2018;05;14;Tiistai;74;45;119
623;29.05.2018;2018;05;15;Tiistai;89;59;148
623;29.05.2018;2018;05;16;Tiistai;123;51;174
623;29.05.2018;2018;05;17;Tiistai;170;90;260
623;29.05.2018;2018;05;18;Tiistai;91;70;161
623;29.05.2018;2018;05;19;Tiistai;71;63;134
623;29.05.2018;2018;05;20;Tiistai;67;45;112
623;29.05.2018;2018;05;21;Tiistai;46;27;73
623;29.05.2018;2018;05;22;Tiistai;34;19;53
623;29.05.2018;2018;05;23;Tiistai;25;13;38
623;30.05.2018;2018;05;00;Keskiviikko;6;1;7
623;30.05.2018;2018;05;01;Keskiviikko;3;4;7
623;30.05.2018;2018;05;02;Keskiviikko;5;3;8
623;30.05.2018;2018;05;03;Keskiviikko;2;4;6
623;30.05.2018;2018;05;04;Keskiviikko;1;1;2
623;30.05.2018;2018;05;05;Keskiviikko;0;7;7
623;30.05.2018;2018;05;06;Keskiviikko;2;15;17
623;30.05.2018;2018;05;07;Keskiviikko;9;56;65
623;30.05.2018;2018;05;08;Keskiviikko;47;124;171
623;30.05.2018;2018;05;09;Keskiviikko;76;154;230
623;30.05.2018;2018;05;10;Keskiviikko;34;62;96
623;30.05.2018;2018;05;11;Keskiviikko;34;41;75
623;30.05.2018;2018;05;12;Keskiviikko;55;43;98
623;30.05.2018;2018;05;13;Keskiviikko;63;67;130
623;30.05.2018;2018;05;14;Keskiviikko;52;34;86
623;30.05.2018;2018;05;15;Keskiviikko;59;36;95
623;30.05.2018;2018;05;16;Keskiviikko;109;56;165
623;30.05.2018;2018;05;17;Keskiviikko;148;89;237
623;30.05.2018;2018;05;18;Keskiviikko;106;66;172
623;30.05.2018;2018;05;19;Keskiviikko;57;43;100
623;30.05.2018;2018;05;20;Keskiviikko;45;26;71
623;30.05.2018;2018;05;21;Keskiviikko;34;20;54
623;30.05.2018;2018;05;22;Keskiviikko;31;16;47
623;30.05.2018;2018;05;23;Keskiviikko;25;15;40
623;31.05.2018;2018;05;00;Torstai;14;6;20
623;31.05.2018;2018;05;01;Torstai;5;3;8
623;31.05.2018;2018;05;02;Torstai;4;1;5
623;31.05.2018;2018;05;03;Torstai;2;3;5
623;31.05.2018;2018;05;04;Torstai;0;2;2
623;31.05.2018;2018;05;05;Torstai;1;3;4
623;31.05.2018;2018;05;06;Torstai;1;12;13
623;31.05.2018;2018;05;07;Torstai;15;62;77
623;31.05.2018;2018;05;08;Torstai;49;127;176
623;31.05.2018;2018;05;09;Torstai;77;154;231
623;31.05.2018;2018;05;10;Torstai;40;93;133
623;31.05.2018;2018;05;11;Torstai;27;58;85
623;31.05.2018;2018;05;12;Torstai;42;46;88
623;31.05.2018;2018;05;13;Torstai;56;56;112
623;31.05.2018;2018;05;14;Torstai;72;50;122
623;31.05.2018;2018;05;15;Torstai;75;41;116
623;31.05.2018;2018;05;16;Torstai;104;52;156
623;31.05.2018;2018;05;17;Torstai;150;72;222
623;31.05.2018;2018;05;18;Torstai;83;61;144
623;31.05.2018;2018;05;19;Torstai;62;39;101
623;31.05.2018;2018;05;20;Torstai;53;35;88
623;31.05.2018;2018;05;21;Torstai;43;25;68
623;31.05.2018;2018;05;22;Torstai;31;22;53
623;31.05.2018;2018;05;23;Torstai;13;12;25
623;01.06.2018;2018;06;00;Perjantai;6;4;10
623;01.06.2018;2018;06;01;Perjantai;7;2;9
623;01.06.2018;2018;06;02;Perjantai;7;3;10
623;01.06.2018;2018;06;03;Perjantai;3;3;6
623;01.06.2018;2018;06;04;Perjantai;3;1;4
623;01.06.2018;2018;06;05;Perjantai;3;3;6
623;01.06.2018;2018;06;06;Perjantai;0;15;15
623;01.06.2018;2018;06;07;Perjantai;10;57;67
623;01.06.2018;2018;06;08;Perjantai;48;91;139
623;01.06.2018;2018;06;09;Perjantai;70;149;219
623;01.06.2018;2018;06;10;Perjantai;36;69;105
623;01.06.2018;2018;06;11;Perjantai;40;42;82
623;01.06.2018;2018;06;12;Perjantai;59;48;107
623;01.06.2018;2018;06;13;Perjantai;51;62;113
623;01.06.2018;2018;06;14;Perjantai;73;51;124
623;01.06.2018;2018;06;15;Perjantai;83;51;134
623;01.06.2018;2018;06;16;Perjantai;104;61;165
623;01.06.2018;2018;06;17;Perjantai;111;79;190
623;01.06.2018;2018;06;18;Perjantai;75;51;126
623;01.06.2018;2018;06;19;Perjantai;60;57;117
623;01.06.2018;2018;06;20;Perjantai;33;31;64
623;01.06.2018;2018;06;21;Perjantai;36;31;67
623;01.06.2018;2018;06;22;Perjantai;30;25;55
623;01.06.2018;2018;06;23;Perjantai;16;14;30
623;02.06.2018;2018;06;00;Lauantai;19;6;25
623;02.06.2018;2018;06;01;Lauantai;18;3;21
623;02.06.2018;2018;06;02;Lauantai;6;1;7
623;02.06.2018;2018;06;03;Lauantai;11;2;13
623;02.06.2018;2018;06;04;Lauantai;7;4;11
623;02.06.2018;2018;06;05;Lauantai;4;1;5
623;02.06.2018;2018;06;06;Lauantai;5;3;8
623;02.06.2018;2018;06;07;Lauantai;3;9;12
623;02.06.2018;2018;06;08;Lauantai;7;12;19
623;02.06.2018;2018;06;09;Lauantai;25;59;84
623;02.06.2018;2018;06;10;Lauantai;14;30;44
623;02.06.2018;2018;06;11;Lauantai;42;33;75
623;02.06.2018;2018;06;12;Lauantai;35;55;90
623;02.06.2018;2018;06;13;Lauantai;38;37;75
623;02.06.2018;2018;06;14;Lauantai;41;49;90
623;02.06.2018;2018;06;15;Lauantai;45;57;102
623;02.06.2018;2018;06;16;Lauantai;48;46;94
623;02.06.2018;2018;06;17;Lauantai;37;37;74
623;02.06.2018;2018;06;18;Lauantai;63;37;100
623;02.06.2018;2018;06;19;Lauantai;48;39;87
623;02.06.2018;2018;06;20;Lauantai;34;47;81
623;02.06.2018;2018;06;21;Lauantai;21;37;58
623;02.06.2018;2018;06;22;Lauantai;28;23;51
623;02.06.2018;2018;06;23;Lauantai;20;22;42
623;03.06.2018;2018;06;00;Sunnuntai;13;11;24
623;03.06.2018;2018;06;01;Sunnuntai;13;7;20
623;03.06.2018;2018;06;02;Sunnuntai;15;10;25
623;03.06.2018;2018;06;03;Sunnuntai;22;3;25
623;03.06.2018;2018;06;04;Sunnuntai;18;3;21
623;03.06.2018;2018;06;05;Sunnuntai;16;5;21
623;03.06.2018;2018;06;06;Sunnuntai;7;5;12
623;03.06.2018;2018;06;07;Sunnuntai;5;13;18
623;03.06.2018;2018;06;08;Sunnuntai;0;3;3
623;03.06.2018;2018;06;09;Sunnuntai;2;12;14
623;03.06.2018;2018;06;10;Sunnuntai;7;17;24
623;03.06.2018;2018;06;11;Sunnuntai;21;31;52
623;03.06.2018;2018;06;12;Sunnuntai;22;28;50
623;03.06.2018;2018;06;13;Sunnuntai;35;37;72
623;03.06.2018;2018;06;14;Sunnuntai;35;48;83
623;03.06.2018;2018;06;15;Sunnuntai;43;39;82
623;03.06.2018;2018;06;16;Sunnuntai;42;38;80
623;03.06.2018;2018;06;17;Sunnuntai;40;35;75
623;03.06.2018;2018;06;18;Sunnuntai;26;30;56
623;03.06.2018;2018;06;19;Sunnuntai;42;25;67
623;03.06.2018;2018;06;20;Sunnuntai;23;24;47
623;03.06.2018;2018;06;21;Sunnuntai;23;6;29
623;03.06.2018;2018;06;22;Sunnuntai;17;7;24
623;03.06.2018;2018;06;23;Sunnuntai;13;3;16
623;04.06.2018;2018;06;00;Maanantai;6;5;11
623;04.06.2018;2018;06;01;Maanantai;1;2;3
623;04.06.2018;2018;06;02;Maanantai;1;2;3
623;04.06.2018;2018;06;03;Maanantai;2;2;4
623;04.06.2018;2018;06;04;Maanantai;1;1;2
623;04.06.2018;2018;06;05;Maanantai;0;3;3
623;04.06.2018;2018;06;06;Maanantai;1;10;11
623;04.06.2018;2018;06;07;Maanantai;12;50;62
623;04.06.2018;2018;06;08;Maanantai;26;71;97
623;04.06.2018;2018;06;09;Maanantai;34;96;130
623;04.06.2018;2018;06;10;Maanantai;16;37;53
623;04.06.2018;2018;06;11;Maanantai;21;30;51
623;04.06.2018;2018;06;12;Maanantai;25;30;55
623;04.06.2018;2018;06;13;Maanantai;27;19;46
623;04.06.2018;2018;06;14;Maanantai;31;23;54
623;04.06.2018;2018;06;15;Maanantai;33;34;67
623;04.06.2018;2018;06;16;Maanantai;55;36;91
623;04.06.2018;2018;06;17;Maanantai;98;47;145
623;04.06.2018;2018;06;18;Maanantai;49;24;73
623;04.06.2018;2018;06;19;Maanantai;32;16;48
623;04.06.2018;2018;06;20;Maanantai;32;14;46
623;04.06.2018;2018;06;21;Maanantai;20;10;30
623;04.06.2018;2018;06;22;Maanantai;13;6;19
623;04.06.2018;2018;06;23;Maanantai;7;4;11
623;05.06.2018;2018;06;00;Tiistai;6;3;9
623;05.06.2018;2018;06;01;Tiistai;3;1;4
623;05.06.2018;2018;06;02;Tiistai;2;1;3
623;05.06.2018;2018;06;03;Tiistai;0;3;3
623;05.06.2018;2018;06;04;Tiistai;1;2;3
623;05.06.2018;2018;06;05;Tiistai;2;4;6
623;05.06.2018;2018;06;06;Tiistai;2;10;12
623;05.06.2018;2018;06;07;Tiistai;7;47;54
623;05.06.2018;2018;06;08;Tiistai;37;91;128
623;05.06.2018;2018;06;09;Tiistai;36;71;107
623;05.06.2018;2018;06;10;Tiistai;26;50;76
623;05.06.2018;2018;06;11;Tiistai;27;35;62
623;05.06.2018;2018;06;12;Tiistai;29;28;57
623;05.06.2018;2018;06;13;Tiistai;41;38;79
623;05.06.2018;2018;06;14;Tiistai;31;29;60
623;05.06.2018;2018;06;15;Tiistai;39;31;70
623;05.06.2018;2018;06;16;Tiistai;80;40;120
623;05.06.2018;2018;06;17;Tiistai;107;50;157
623;05.06.2018;2018;06;18;Tiistai;53;33;86
623;05.06.2018;2018;06;19;Tiistai;35;25;60
623;05.06.2018;2018;06;20;Tiistai;23;23;46
623;05.06.2018;2018;06;21;Tiistai;23;13;36
623;05.06.2018;2018;06;22;Tiistai;23;8;31
623;05.06.2018;2018;06;23;Tiistai;13;9;22
623;06.06.2018;2018;06;00;Keskiviikko;5;4;9
623;06.06.2018;2018;06;01;Keskiviikko;3;1;4
623;06.06.2018;2018;06;02;Keskiviikko;0;0;0
623;06.06.2018;2018;06;03;Keskiviikko;1;3;4
623;06.06.2018;2018;06;04;Keskiviikko;1;1;2
623;06.06.2018;2018;06;05;Keskiviikko;0;3;3
623;06.06.2018;2018;06;06;Keskiviikko;1;12;13
623;06.06.2018;2018;06;07;Keskiviikko;8;45;53
623;06.06.2018;2018;06;08;Keskiviikko;32;97;129
623;06.06.2018;2018;06;09;Keskiviikko;45;104;149
623;06.06.2018;2018;06;10;Keskiviikko;26;39;65
623;06.06.2018;2018;06;11;Keskiviikko;23;28;51
623;06.06.2018;2018;06;12;Keskiviikko;31;36;67
623;06.06.2018;2018;06;13;Keskiviikko;40;40;80
623;06.06.2018;2018;06;14;Keskiviikko;33;28;61
623;06.06.2018;2018;06;15;Keskiviikko;34;37;71
623;06.06.2018;2018;06;16;Keskiviikko;88;46;134
623;06.06.2018;2018;06;17;Keskiviikko;122;74;196
623;06.06.2018;2018;06;18;Keskiviikko;67;42;109
623;06.06.2018;2018;06;19;Keskiviikko;43;22;65
623;06.06.2018;2018;06;20;Keskiviikko;38;36;74
623;06.06.2018;2018;06;21;Keskiviikko;33;24;57
623;06.06.2018;2018;06;22;Keskiviikko;22;11;33
623;06.06.2018;2018;06;23;Keskiviikko;14;5;19
623;07.06.2018;2018;06;00;Torstai;8;1;9
623;07.06.2018;2018;06;01;Torstai;1;0;1
623;07.06.2018;2018;06;02;Torstai;0;4;4
623;07.06.2018;2018;06;03;Torstai;2;1;3
623;07.06.2018;2018;06;04;Torstai;1;2;3
623;07.06.2018;2018;06;05;Torstai;1;6;7
623;07.06.2018;2018;06;06;Torstai;1;8;9
623;07.06.2018;2018;06;07;Torstai;4;42;46
623;07.06.2018;2018;06;08;Torstai;22;65;87
623;07.06.2018;2018;06;09;Torstai;22;57;79
623;07.06.2018;2018;06;10;Torstai;11;26;37
623;07.06.2018;2018;06;11;Torstai;7;11;18
623;07.06.2018;2018;06;12;Torstai;13;14;27
623;07.06.2018;2018;06;13;Torstai;9;22;31
623;07.06.2018;2018;06;14;Torstai;27;22;49
623;07.06.2018;2018;06;15;Torstai;39;30;69
623;07.06.2018;2018;06;16;Torstai;54;31;85
623;07.06.2018;2018;06;17;Torstai;68;34;102
623;07.06.2018;2018;06;18;Torstai;33;29;62
623;07.06.2018;2018;06;19;Torstai;27;18;45
623;07.06.2018;2018;06;20;Torstai;24;23;47
623;07.06.2018;2018;06;21;Torstai;23;18;41
623;07.06.2018;2018;06;22;Torstai;25;16;41
623;07.06.2018;2018;06;23;Torstai;14;5;19
623;08.06.2018;2018;06;00;Perjantai;4;3;7
623;08.06.2018;2018;06;01;Perjantai;4;2;6
623;08.06.2018;2018;06;02;Perjantai;1;0;1
623;08.06.2018;2018;06;03;Perjantai;2;2;4
623;08.06.2018;2018;06;04;Perjantai;0;3;3
623;08.06.2018;2018;06;05;Perjantai;1;4;5
623;08.06.2018;2018;06;06;Perjantai;1;9;10
623;08.06.2018;2018;06;07;Perjantai;8;54;62
623;08.06.2018;2018;06;08;Perjantai;44;92;136
623;08.06.2018;2018;06;09;Perjantai;32;85;117
623;08.06.2018;2018;06;10;Perjantai;27;52;79
623;08.06.2018;2018;06;11;Perjantai;25;35;60
623;08.06.2018;2018;06;12;Perjantai;17;29;46
623;08.06.2018;2018;06;13;Perjantai;31;42;73
623;08.06.2018;2018;06;14;Perjantai;42;30;72
623;08.06.2018;2018;06;15;Perjantai;49;42;91
623;08.06.2018;2018;06;16;Perjantai;88;52;140
623;08.06.2018;2018;06;17;Perjantai;86;56;142
623;08.06.2018;2018;06;18;Perjantai;41;40;81
623;08.06.2018;2018;06;19;Perjantai;40;26;66
623;08.06.2018;2018;06;20;Perjantai;34;26;60
623;08.06.2018;2018;06;21;Perjantai;29;16;45
623;08.06.2018;2018;06;22;Perjantai;25;15;40
623;08.06.2018;2018;06;23;Perjantai;17;11;28
623;09.06.2018;2018;06;00;Lauantai;15;12;27
623;09.06.2018;2018;06;01;Lauantai;17;5;22
623;09.06.2018;2018;06;02;Lauantai;5;2;7
623;09.06.2018;2018;06;03;Lauantai;9;4;13
623;09.06.2018;2018;06;04;Lauantai;7;4;11
623;09.06.2018;2018;06;05;Lauantai;4;3;7
623;09.06.2018;2018;06;06;Lauantai;8;1;9
623;09.06.2018;2018;06;07;Lauantai;12;0;12
623;09.06.2018;2018;06;08;Lauantai;19;0;19
623;09.06.2018;2018;06;09;Lauantai;84;0;84
623;09.06.2018;2018;06;10;Lauantai;44;0;44
623;09.06.2018;2018;06;11;Lauantai;75;0;75
623;09.06.2018;2018;06;12;Lauantai;90;0;90
623;09.06.2018;2018;06;13;Lauantai;75;0;75
623;09.06.2018;2018;06;14;Lauantai;90;0;90
623;09.06.2018;2018;06;15;Lauantai;102;0;102
623;09.06.2018;2018;06;16;Lauantai;94;0;94
623;09.06.2018;2018;06;17;Lauantai;74;0;74
623;09.06.2018;2018;06;18;Lauantai;100;0;100
623;09.06.2018;2018;06;19;Lauantai;87;0;87
623;09.06.2018;2018;06;20;Lauantai;81;0;81
623;09.06.2018;2018;06;21;Lauantai;58;0;58
623;09.06.2018;2018;06;22;Lauantai;51;0;51
623;09.06.2018;2018;06;23;Lauantai;42;0;42
623;10.06.2018;2018;06;00;Sunnuntai;24;0;24
623;10.06.2018;2018;06;01;Sunnuntai;20;0;20
623;10.06.2018;2018;06;02;Sunnuntai;25;0;25
623;10.06.2018;2018;06;03;Sunnuntai;25;0;25
623;10.06.2018;2018;06;04;Sunnuntai;21;0;21
623;10.06.2018;2018;06;05;Sunnuntai;21;0;21
623;10.06.2018;2018;06;06;Sunnuntai;12;0;12
623;10.06.2018;2018;06;07;Sunnuntai;18;0;18
623;10.06.2018;2018;06;08;Sunnuntai;3;0;3
623;10.06.2018;2018;06;09;Sunnuntai;14;0;14
623;10.06.2018;2018;06;10;Sunnuntai;24;0;24
623;10.06.2018;2018;06;11;Sunnuntai;52;0;52
623;10.06.2018;2018;06;12;Sunnuntai;50;0;50
623;10.06.2018;2018;06;13;Sunnuntai;72;0;72
623;10.06.2018;2018;06;14;Sunnuntai;83;0;83
623;10.06.2018;2018;06;15;Sunnuntai;82;0;82
623;10.06.2018;2018;06;16;Sunnuntai;80;0;80
623;10.06.2018;2018;06;17;Sunnuntai;75;0;75
623;10.06.2018;2018;06;18;Sunnuntai;56;0;56
623;10.06.2018;2018;06;19;Sunnuntai;67;0;67
623;10.06.2018;2018;06;20;Sunnuntai;47;0;47
623;10.06.2018;2018;06;21;Sunnuntai;29;0;29
623;10.06.2018;2018;06;22;Sunnuntai;24;0;24
623;10.06.2018;2018;06;23;Sunnuntai;16;0;16
623;11.06.2018;2018;06;00;Maanantai;10;8;18
623;11.06.2018;2018;06;01;Maanantai;2;1;3
623;11.06.2018;2018;06;02;Maanantai;0;3;3
623;11.06.2018;2018;06;03;Maanantai;1;5;6
623;11.06.2018;2018;06;04;Maanantai;2;0;2
623;11.06.2018;2018;06;05;Maanantai;2;6;8
623;11.06.2018;2018;06;06;Maanantai;1;8;9
623;11.06.2018;2018;06;07;Maanantai;9;58;67
623;11.06.2018;2018;06;08;Maanantai;40;110;150
623;11.06.2018;2018;06;09;Maanantai;55;108;163
623;11.06.2018;2018;06;10;Maanantai;22;48;70
623;11.06.2018;2018;06;11;Maanantai;30;34;64
623;11.06.2018;2018;06;12;Maanantai;37;39;76
623;11.06.2018;2018;06;13;Maanantai;43;54;97
623;11.06.2018;2018;06;14;Maanantai;32;51;83
623;11.06.2018;2018;06;15;Maanantai;55;42;97
623;11.06.2018;2018;06;16;Maanantai;88;60;148
623;11.06.2018;2018;06;17;Maanantai;138;83;221
623;11.06.2018;2018;06;18;Maanantai;90;59;149
623;11.06.2018;2018;06;19;Maanantai;59;49;108
623;11.06.2018;2018;06;20;Maanantai;50;35;85
623;11.06.2018;2018;06;21;Maanantai;35;32;67
623;11.06.2018;2018;06;22;Maanantai;31;7;38
623;11.06.2018;2018;06;23;Maanantai;18;9;27
623;12.06.2018;2018;06;00;Tiistai;10;8;18
623;12.06.2018;2018;06;01;Tiistai;2;1;3
623;12.06.2018;2018;06;02;Tiistai;0;3;3
623;12.06.2018;2018;06;03;Tiistai;1;5;6
623;12.06.2018;2018;06;04;Tiistai;2;0;2
623;12.06.2018;2018;06;05;Tiistai;2;6;8
623;12.06.2018;2018;06;06;Tiistai;1;8;9
623;12.06.2018;2018;06;07;Tiistai;9;58;67
623;12.06.2018;2018;06;08;Tiistai;40;110;150
623;12.06.2018;2018;06;09;Tiistai;55;108;163
623;12.06.2018;2018;06;10;Tiistai;22;48;70
623;12.06.2018;2018;06;11;Tiistai;30;34;64
623;12.06.2018;2018;06;12;Tiistai;37;39;76
623;12.06.2018;2018;06;13;Tiistai;25;55;80
623;12.06.2018;2018;06;14;Tiistai;59;48;107
623;12.06.2018;2018;06;15;Tiistai;43;49;92
623;12.06.2018;2018;06;16;Tiistai;87;58;145
623;12.06.2018;2018;06;17;Tiistai;148;80;228
623;12.06.2018;2018;06;18;Tiistai;79;73;152
623;12.06.2018;2018;06;19;Tiistai;55;37;92
623;12.06.2018;2018;06;20;Tiistai;54;45;99
623;12.06.2018;2018;06;21;Tiistai;48;28;76
623;12.06.2018;2018;06;22;Tiistai;35;17;52
623;12.06.2018;2018;06;23;Tiistai;17;8;25
623;13.06.2018;2018;06;00;Keskiviikko;4;7;11
623;13.06.2018;2018;06;01;Keskiviikko;4;6;10
623;13.06.2018;2018;06;02;Keskiviikko;2;2;4
623;13.06.2018;2018;06;03;Keskiviikko;2;3;5
623;13.06.2018;2018;06;04;Keskiviikko;2;0;2
623;13.06.2018;2018;06;05;Keskiviikko;0;5;5
623;13.06.2018;2018;06;06;Keskiviikko;1;12;13
623;13.06.2018;2018;06;07;Keskiviikko;6;50;56
623;13.06.2018;2018;06;08;Keskiviikko;46;108;154
623;13.06.2018;2018;06;09;Keskiviikko;44;98;142
623;13.06.2018;2018;06;10;Keskiviikko;23;52;75
623;13.06.2018;2018;06;11;Keskiviikko;25;34;59
623;13.06.2018;2018;06;12;Keskiviikko;22;58;80
623;13.06.2018;2018;06;13;Keskiviikko;35;44;79
623;13.06.2018;2018;06;14;Keskiviikko;49;50;99
623;13.06.2018;2018;06;15;Keskiviikko;67;64;131
623;13.06.2018;2018;06;16;Keskiviikko;94;69;163
623;13.06.2018;2018;06;17;Keskiviikko;105;85;190
623;13.06.2018;2018;06;18;Keskiviikko;62;62;124
623;13.06.2018;2018;06;19;Keskiviikko;65;50;115
623;13.06.2018;2018;06;20;Keskiviikko;34;40;74
623;13.06.2018;2018;06;21;Keskiviikko;35;23;58
623;13.06.2018;2018;06;22;Keskiviikko;35;18;53
623;13.06.2018;2018;06;23;Keskiviikko;18;8;26
623;14.06.2018;2018;06;00;Torstai;11;4;15
623;14.06.2018;2018;06;01;Torstai;5;4;9
623;14.06.2018;2018;06;02;Torstai;6;1;7
623;14.06.2018;2018;06;03;Torstai;1;2;3
623;14.06.2018;2018;06;04;Torstai;1;1;2
623;14.06.2018;2018;06;05;Torstai;2;2;4
623;14.06.2018;2018;06;06;Torstai;0;7;7
623;14.06.2018;2018;06;07;Torstai;15;61;76
623;14.06.2018;2018;06;08;Torstai;41;114;155
623;14.06.2018;2018;06;09;Torstai;46;112;158
623;14.06.2018;2018;06;10;Torstai;27;73;100
623;14.06.2018;2018;06;11;Torstai;29;55;84
623;14.06.2018;2018;06;12;Torstai;38;51;89
623;14.06.2018;2018;06;13;Torstai;45;67;112
623;14.06.2018;2018;06;14;Torstai;46;57;103
623;14.06.2018;2018;06;15;Torstai;64;68;132
623;14.06.2018;2018;06;16;Torstai;109;86;195
623;14.06.2018;2018;06;17;Torstai;121;77;198
623;14.06.2018;2018;06;18;Torstai;74;75;149
623;14.06.2018;2018;06;19;Torstai;77;61;138
623;14.06.2018;2018;06;20;Torstai;41;39;80
623;14.06.2018;2018;06;21;Torstai;45;32;77
623;14.06.2018;2018;06;22;Torstai;36;24;60
623;14.06.2018;2018;06;23;Torstai;31;13;44
623;15.06.2018;2018;06;00;Perjantai;7;2;9
623;15.06.2018;2018;06;01;Perjantai;8;3;11
623;15.06.2018;2018;06;02;Perjantai;5;3;8
623;15.06.2018;2018;06;03;Perjantai;7;2;9
623;15.06.2018;2018;06;04;Perjantai;1;2;3
623;15.06.2018;2018;06;05;Perjantai;0;4;4
623;15.06.2018;2018;06;06;Perjantai;1;8;9
623;15.06.2018;2018;06;07;Perjantai;9;50;59
623;15.06.2018;2018;06;08;Perjantai;44;99;143
623;15.06.2018;2018;06;09;Perjantai;48;104;152
623;15.06.2018;2018;06;10;Perjantai;26;54;80
623;15.06.2018;2018;06;11;Perjantai;23;47;70
623;15.06.2018;2018;06;12;Perjantai;28;53;81
623;15.06.2018;2018;06;13;Perjantai;38;55;93
623;15.06.2018;2018;06;14;Perjantai;50;59;109
623;15.06.2018;2018;06;15;Perjantai;77;53;130
623;15.06.2018;2018;06;16;Perjantai;88;70;158
623;15.06.2018;2018;06;17;Perjantai;76;75;151
623;15.06.2018;2018;06;18;Perjantai;61;74;135
623;15.06.2018;2018;06;19;Perjantai;44;60;104
623;15.06.2018;2018;06;20;Perjantai;43;39;82
623;15.06.2018;2018;06;21;Perjantai;47;34;81
623;15.06.2018;2018;06;22;Perjantai;37;21;58
623;15.06.2018;2018;06;23;Perjantai;23;13;36
623;16.06.2018;2018;06;00;Lauantai;24;30;54
623;16.06.2018;2018;06;01;Lauantai;12;4;16
623;16.06.2018;2018;06;02;Lauantai;12;8;20
623;16.06.2018;2018;06;03;Lauantai;9;7;16
623;16.06.2018;2018;06;04;Lauantai;6;1;7
623;16.06.2018;2018;06;05;Lauantai;8;5;13
623;16.06.2018;2018;06;06;Lauantai;8;5;13
623;16.06.2018;2018;06;07;Lauantai;5;10;15
623;16.06.2018;2018;06;08;Lauantai;2;5;7
623;16.06.2018;2018;06;09;Lauantai;6;20;26
623;16.06.2018;2018;06;10;Lauantai;13;38;51
623;16.06.2018;2018;06;11;Lauantai;18;42;60
623;16.06.2018;2018;06;12;Lauantai;32;69;101
623;16.06.2018;2018;06;13;Lauantai;48;81;129
623;16.06.2018;2018;06;14;Lauantai;55;95;150
623;16.06.2018;2018;06;15;Lauantai;69;85;154
623;16.06.2018;2018;06;16;Lauantai;79;97;176
623;16.06.2018;2018;06;17;Lauantai;60;50;110
623;16.06.2018;2018;06;18;Lauantai;53;54;107
623;16.06.2018;2018;06;19;Lauantai;52;57;109
623;16.06.2018;2018;06;20;Lauantai;32;39;71
623;16.06.2018;2018;06;21;Lauantai;32;28;60
623;16.06.2018;2018;06;22;Lauantai;32;19;51
623;16.06.2018;2018;06;23;Lauantai;17;15;32
623;17.06.2018;2018;06;00;Sunnuntai;13;11;24
623;17.06.2018;2018;06;01;Sunnuntai;31;9;40
623;17.06.2018;2018;06;02;Sunnuntai;16;11;27
623;17.06.2018;2018;06;03;Sunnuntai;22;5;27
623;17.06.2018;2018;06;04;Sunnuntai;11;5;16
623;17.06.2018;2018;06;05;Sunnuntai;9;1;10
623;17.06.2018;2018;06;06;Sunnuntai;2;2;4
623;17.06.2018;2018;06;07;Sunnuntai;6;7;13
623;17.06.2018;2018;06;08;Sunnuntai;6;6;12
623;17.06.2018;2018;06;09;Sunnuntai;5;7;12
623;17.06.2018;2018;06;10;Sunnuntai;14;23;37
623;17.06.2018;2018;06;11;Sunnuntai;24;33;57
623;17.06.2018;2018;06;12;Sunnuntai;49;53;102
623;17.06.2018;2018;06;13;Sunnuntai;63;80;143
623;17.06.2018;2018;06;14;Sunnuntai;59;101;160
623;17.06.2018;2018;06;15;Sunnuntai;61;99;160
623;17.06.2018;2018;06;16;Sunnuntai;62;84;146
623;17.06.2018;2018;06;17;Sunnuntai;63;88;151
623;17.06.2018;2018;06;18;Sunnuntai;61;62;123
623;17.06.2018;2018;06;19;Sunnuntai;63;61;124
623;17.06.2018;2018;06;20;Sunnuntai;45;39;84
623;17.06.2018;2018;06;21;Sunnuntai;31;21;52
623;17.06.2018;2018;06;22;Sunnuntai;18;19;37
623;17.06.2018;2018;06;23;Sunnuntai;14;6;20
623;18.06.2018;2018;06;00;Maanantai;8;5;13
623;18.06.2018;2018;06;01;Maanantai;6;5;11
623;18.06.2018;2018;06;02;Maanantai;0;2;2
623;18.06.2018;2018;06;03;Maanantai;4;1;5
623;18.06.2018;2018;06;04;Maanantai;0;3;3
623;18.06.2018;2018;06;05;Maanantai;3;5;8
623;18.06.2018;2018;06;06;Maanantai;3;7;10
623;18.06.2018;2018;06;07;Maanantai;12;52;64
623;18.06.2018;2018;06;08;Maanantai;37;115;152
623;18.06.2018;2018;06;09;Maanantai;36;89;125
623;18.06.2018;2018;06;10;Maanantai;22;35;57
623;18.06.2018;2018;06;11;Maanantai;16;38;54
623;18.06.2018;2018;06;12;Maanantai;32;29;61
623;18.06.2018;2018;06;13;Maanantai;29;41;70
623;18.06.2018;2018;06;14;Maanantai;32;41;73
623;18.06.2018;2018;06;15;Maanantai;48;62;110
623;18.06.2018;2018;06;16;Maanantai;92;59;151
623;18.06.2018;2018;06;17;Maanantai;119;66;185
623;18.06.2018;2018;06;18;Maanantai;69;47;116
623;18.06.2018;2018;06;19;Maanantai;56;34;90
623;18.06.2018;2018;06;20;Maanantai;33;31;64
623;18.06.2018;2018;06;21;Maanantai;20;29;49
623;18.06.2018;2018;06;22;Maanantai;20;8;28
623;18.06.2018;2018;06;23;Maanantai;13;10;23
623;19.06.2018;2018;06;00;Tiistai;9;6;15
623;19.06.2018;2018;06;01;Tiistai;3;1;4
623;19.06.2018;2018;06;02;Tiistai;1;4;5
623;19.06.2018;2018;06;03;Tiistai;4;1;5
623;19.06.2018;2018;06;04;Tiistai;0;1;1
623;19.06.2018;2018;06;05;Tiistai;1;2;3
623;19.06.2018;2018;06;06;Tiistai;1;8;9
623;19.06.2018;2018;06;07;Tiistai;8;51;59
623;19.06.2018;2018;06;08;Tiistai;39;100;139
623;19.06.2018;2018;06;09;Tiistai;47;96;143
623;19.06.2018;2018;06;10;Tiistai;26;63;89
623;19.06.2018;2018;06;11;Tiistai;28;42;70
623;19.06.2018;2018;06;12;Tiistai;36;33;69
623;19.06.2018;2018;06;13;Tiistai;27;9;36
623;19.06.2018;2018;06;14;Tiistai;13;14;27
623;19.06.2018;2018;06;15;Tiistai;35;32;67
623;19.06.2018;2018;06;16;Tiistai;57;20;77
623;19.06.2018;2018;06;17;Tiistai;79;42;121
623;19.06.2018;2018;06;18;Tiistai;62;37;99
623;19.06.2018;2018;06;19;Tiistai;30;35;65
623;19.06.2018;2018;06;20;Tiistai;31;24;55
623;19.06.2018;2018;06;21;Tiistai;22;17;39
623;19.06.2018;2018;06;22;Tiistai;12;5;17
623;19.06.2018;2018;06;23;Tiistai;12;4;16
623;20.06.2018;2018;06;00;Keskiviikko;4;5;9
623;20.06.2018;2018;06;01;Keskiviikko;6;1;7
623;20.06.2018;2018;06;02;Keskiviikko;4;2;6
623;20.06.2018;2018;06;03;Keskiviikko;4;3;7
623;20.06.2018;2018;06;04;Keskiviikko;0;0;0
623;20.06.2018;2018;06;05;Keskiviikko;2;5;7
623;20.06.2018;2018;06;06;Keskiviikko;1;8;9
623;20.06.2018;2018;06;07;Keskiviikko;12;42;54
623;20.06.2018;2018;06;08;Keskiviikko;30;95;125
623;20.06.2018;2018;06;09;Keskiviikko;50;122;172
623;20.06.2018;2018;06;10;Keskiviikko;31;42;73
623;20.06.2018;2018;06;11;Keskiviikko;29;46;75
623;20.06.2018;2018;06;12;Keskiviikko;42;47;89
623;20.06.2018;2018;06;13;Keskiviikko;33;31;64
623;20.06.2018;2018;06;14;Keskiviikko;34;55;89
623;20.06.2018;2018;06;15;Keskiviikko;54;65;119
623;20.06.2018;2018;06;16;Keskiviikko;90;59;149
623;20.06.2018;2018;06;17;Keskiviikko;113;69;182
623;20.06.2018;2018;06;18;Keskiviikko;72;53;125
623;20.06.2018;2018;06;19;Keskiviikko;52;52;104
623;20.06.2018;2018;06;20;Keskiviikko;51;43;94
623;20.06.2018;2018;06;21;Keskiviikko;62;34;96
623;20.06.2018;2018;06;22;Keskiviikko;36;21;57
623;20.06.2018;2018;06;23;Keskiviikko;28;12;40
623;21.06.2018;2018;06;00;Torstai;11;8;19
623;21.06.2018;2018;06;01;Torstai;7;4;11
623;21.06.2018;2018;06;02;Torstai;7;8;15
623;21.06.2018;2018;06;03;Torstai;1;3;4
623;21.06.2018;2018;06;04;Torstai;2;1;3
623;21.06.2018;2018;06;05;Torstai;1;5;6
623;21.06.2018;2018;06;06;Torstai;2;13;15
623;21.06.2018;2018;06;07;Torstai;10;54;64
623;21.06.2018;2018;06;08;Torstai;42;92;134
623;21.06.2018;2018;06;09;Torstai;46;88;134
623;21.06.2018;2018;06;10;Torstai;24;56;80
623;21.06.2018;2018;06;11;Torstai;27;34;61
623;21.06.2018;2018;06;12;Torstai;33;48;81
623;21.06.2018;2018;06;13;Torstai;46;67;113
623;21.06.2018;2018;06;14;Torstai;60;63;123
623;21.06.2018;2018;06;15;Torstai;83;48;131
623;21.06.2018;2018;06;16;Torstai;114;48;162
623;21.06.2018;2018;06;17;Torstai;89;62;151
623;21.06.2018;2018;06;18;Torstai;50;59;109
623;21.06.2018;2018;06;19;Torstai;59;36;95
623;21.06.2018;2018;06;20;Torstai;36;44;80
623;21.06.2018;2018;06;21;Torstai;25;21;46
623;21.06.2018;2018;06;22;Torstai;27;15;42
623;21.06.2018;2018;06;23;Torstai;21;9;30
623;22.06.2018;2018;06;00;Perjantai;11;6;17
623;22.06.2018;2018;06;01;Perjantai;12;8;20
623;22.06.2018;2018;06;02;Perjantai;8;7;15
623;22.06.2018;2018;06;03;Perjantai;4;3;7
623;22.06.2018;2018;06;04;Perjantai;2;2;4
623;22.06.2018;2018;06;05;Perjantai;1;2;3
623;22.06.2018;2018;06;06;Perjantai;3;7;10
623;22.06.2018;2018;06;07;Perjantai;5;13;18
623;22.06.2018;2018;06;08;Perjantai;4;7;11
623;22.06.2018;2018;06;09;Perjantai;1;5;6
623;22.06.2018;2018;06;10;Perjantai;3;4;7
623;22.06.2018;2018;06;11;Perjantai;6;8;14
623;22.06.2018;2018;06;12;Perjantai;5;5;10
623;22.06.2018;2018;06;13;Perjantai;8;9;17
623;22.06.2018;2018;06;14;Perjantai;12;10;22
623;22.06.2018;2018;06;15;Perjantai;9;12;21
623;22.06.2018;2018;06;16;Perjantai;7;7;14
623;22.06.2018;2018;06;17;Perjantai;5;12;17
623;22.06.2018;2018;06;18;Perjantai;11;12;23
623;22.06.2018;2018;06;19;Perjantai;7;10;17
623;22.06.2018;2018;06;20;Perjantai;11;12;23
623;22.06.2018;2018;06;21;Perjantai;4;7;11
623;22.06.2018;2018;06;22;Perjantai;5;6;11
623;22.06.2018;2018;06;23;Perjantai;6;7;13
623;23.06.2018;2018;06;00;Lauantai;8;10;18
623;23.06.2018;2018;06;01;Lauantai;5;5;10
623;23.06.2018;2018;06;02;Lauantai;5;6;11
623;23.06.2018;2018;06;03;Lauantai;12;7;19
623;23.06.2018;2018;06;04;Lauantai;4;1;5
623;23.06.2018;2018;06;05;Lauantai;6;2;8
623;23.06.2018;2018;06;06;Lauantai;2;2;4
623;23.06.2018;2018;06;07;Lauantai;5;18;23
623;23.06.2018;2018;06;08;Lauantai;1;6;7
623;23.06.2018;2018;06;09;Lauantai;5;1;6
623;23.06.2018;2018;06;10;Lauantai;3;5;8
623;23.06.2018;2018;06;11;Lauantai;6;8;14
623;23.06.2018;2018;06;12;Lauantai;8;6;14
623;23.06.2018;2018;06;13;Lauantai;14;12;26
623;23.06.2018;2018;06;14;Lauantai;11;18;29
623;23.06.2018;2018;06;15;Lauantai;17;10;27
623;23.06.2018;2018;06;16;Lauantai;12;20;32
623;23.06.2018;2018;06;17;Lauantai;14;13;27
623;23.06.2018;2018;06;18;Lauantai;20;12;32
623;23.06.2018;2018;06;19;Lauantai;10;14;24
623;23.06.2018;2018;06;20;Lauantai;15;15;30
623;23.06.2018;2018;06;21;Lauantai;10;13;23
623;23.06.2018;2018;06;22;Lauantai;6;9;15
623;23.06.2018;2018;06;23;Lauantai;1;3;4
623;24.06.2018;2018;06;00;Sunnuntai;5;11;16
623;24.06.2018;2018;06;01;Sunnuntai;6;6;12
623;24.06.2018;2018;06;02;Sunnuntai;4;1;5
623;24.06.2018;2018;06;03;Sunnuntai;4;3;7
623;24.06.2018;2018;06;04;Sunnuntai;8;5;13
623;24.06.2018;2018;06;05;Sunnuntai;5;1;6
623;24.06.2018;2018;06;06;Sunnuntai;3;2;5
623;24.06.2018;2018;06;07;Sunnuntai;6;13;19
623;24.06.2018;2018;06;08;Sunnuntai;5;5;10
623;24.06.2018;2018;06;09;Sunnuntai;2;4;6
623;24.06.2018;2018;06;10;Sunnuntai;6;13;19
623;24.06.2018;2018;06;11;Sunnuntai;12;20;32
623;24.06.2018;2018;06;12;Sunnuntai;23;39;62
623;24.06.2018;2018;06;13;Sunnuntai;37;47;84
623;24.06.2018;2018;06;14;Sunnuntai;29;56;85
623;24.06.2018;2018;06;15;Sunnuntai;45;62;107
623;24.06.2018;2018;06;16;Sunnuntai;36;45;81
623;24.06.2018;2018;06;17;Sunnuntai;52;35;87
623;24.06.2018;2018;06;18;Sunnuntai;36;39;75
623;24.06.2018;2018;06;19;Sunnuntai;47;46;93
623;24.06.2018;2018;06;20;Sunnuntai;41;26;67
623;24.06.2018;2018;06;21;Sunnuntai;30;21;51
623;24.06.2018;2018;06;22;Sunnuntai;16;9;25
623;24.06.2018;2018;06;23;Sunnuntai;8;8;16
623;25.06.2018;2018;06;00;Maanantai;6;7;13
623;25.06.2018;2018;06;01;Maanantai;3;4;7
623;25.06.2018;2018;06;02;Maanantai;4;3;7
623;25.06.2018;2018;06;03;Maanantai;1;3;4
623;25.06.2018;2018;06;04;Maanantai;1;1;2
623;25.06.2018;2018;06;05;Maanantai;3;4;7
623;25.06.2018;2018;06;06;Maanantai;2;13;15
623;25.06.2018;2018;06;07;Maanantai;12;55;67
623;25.06.2018;2018;06;08;Maanantai;42;110;152
623;25.06.2018;2018;06;09;Maanantai;40;88;128
623;25.06.2018;2018;06;10;Maanantai;24;57;81
623;25.06.2018;2018;06;11;Maanantai;29;50;79
623;25.06.2018;2018;06;12;Maanantai;56;60;116
623;25.06.2018;2018;06;13;Maanantai;45;66;111
623;25.06.2018;2018;06;14;Maanantai;62;68;130
623;25.06.2018;2018;06;15;Maanantai;60;49;109
623;25.06.2018;2018;06;16;Maanantai;123;81;204
623;25.06.2018;2018;06;17;Maanantai;113;74;187
623;25.06.2018;2018;06;18;Maanantai;94;72;166
623;25.06.2018;2018;06;19;Maanantai;47;49;96
623;25.06.2018;2018;06;20;Maanantai;59;54;113
623;25.06.2018;2018;06;21;Maanantai;56;41;97
623;25.06.2018;2018;06;22;Maanantai;32;25;57
623;25.06.2018;2018;06;23;Maanantai;19;8;27
623;26.06.2018;2018;06;00;Tiistai;16;6;22
623;26.06.2018;2018;06;01;Tiistai;7;3;10
623;26.06.2018;2018;06;02;Tiistai;2;3;5
623;26.06.2018;2018;06;03;Tiistai;2;2;4
623;26.06.2018;2018;06;04;Tiistai;2;1;3
623;26.06.2018;2018;06;05;Tiistai;2;3;5
623;26.06.2018;2018;06;06;Tiistai;1;12;13
623;26.06.2018;2018;06;07;Tiistai;10;57;67
623;26.06.2018;2018;06;08;Tiistai;48;107;155
623;26.06.2018;2018;06;09;Tiistai;33;113;146
623;26.06.2018;2018;06;10;Tiistai;44;65;109
623;26.06.2018;2018;06;11;Tiistai;19;45;64
623;26.06.2018;2018;06;12;Tiistai;42;51;93
623;26.06.2018;2018;06;13;Tiistai;37;66;103
623;26.06.2018;2018;06;14;Tiistai;55;55;110
623;26.06.2018;2018;06;15;Tiistai;61;58;119
623;26.06.2018;2018;06;16;Tiistai;100;55;155
623;26.06.2018;2018;06;17;Tiistai;144;80;224
623;26.06.2018;2018;06;18;Tiistai;96;66;162
623;26.06.2018;2018;06;19;Tiistai;65;53;118
623;26.06.2018;2018;06;20;Tiistai;52;33;85
623;26.06.2018;2018;06;21;Tiistai;70;39;109
623;26.06.2018;2018;06;22;Tiistai;34;18;52
623;26.06.2018;2018;06;23;Tiistai;26;14;40
623;27.06.2018;2018;06;00;Keskiviikko;17;10;27
623;27.06.2018;2018;06;01;Keskiviikko;9;5;14
623;27.06.2018;2018;06;02;Keskiviikko;5;5;10
623;27.06.2018;2018;06;03;Keskiviikko;3;2;5
623;27.06.2018;2018;06;04;Keskiviikko;2;1;3
623;27.06.2018;2018;06;05;Keskiviikko;1;4;5
623;27.06.2018;2018;06;06;Keskiviikko;2;10;12
623;27.06.2018;2018;06;07;Keskiviikko;10;51;61
623;27.06.2018;2018;06;08;Keskiviikko;39;112;151
623;27.06.2018;2018;06;09;Keskiviikko;48;109;157
623;27.06.2018;2018;06;10;Keskiviikko;33;76;109
623;27.06.2018;2018;06;11;Keskiviikko;29;48;77
623;27.06.2018;2018;06;12;Keskiviikko;38;60;98
623;27.06.2018;2018;06;13;Keskiviikko;48;70;118
623;27.06.2018;2018;06;14;Keskiviikko;51;57;108
623;27.06.2018;2018;06;15;Keskiviikko;69;50;119
623;27.06.2018;2018;06;16;Keskiviikko;111;68;179
623;27.06.2018;2018;06;17;Keskiviikko;123;79;202
623;27.06.2018;2018;06;18;Keskiviikko;91;64;155
623;27.06.2018;2018;06;19;Keskiviikko;65;43;108
623;27.06.2018;2018;06;20;Keskiviikko;51;40;91
623;27.06.2018;2018;06;21;Keskiviikko;46;32;78
623;27.06.2018;2018;06;22;Keskiviikko;35;16;51
623;27.06.2018;2018;06;23;Keskiviikko;22;14;36
623;28.06.2018;2018;06;00;Torstai;16;1;17
623;28.06.2018;2018;06;01;Torstai;6;2;8
623;28.06.2018;2018;06;02;Torstai;4;4;8
623;28.06.2018;2018;06;03;Torstai;6;4;10
623;28.06.2018;2018;06;04;Torstai;2;5;7
623;28.06.2018;2018;06;05;Torstai;7;2;9
623;28.06.2018;2018;06;06;Torstai;2;10;12
623;28.06.2018;2018;06;07;Torstai;11;42;53
623;28.06.2018;2018;06;08;Torstai;22;67;89
623;28.06.2018;2018;06;09;Torstai;25;58;83
623;28.06.2018;2018;06;10;Torstai;13;32;45
623;28.06.2018;2018;06;11;Torstai;13;18;31
623;28.06.2018;2018;06;12;Torstai;7;13;20
623;28.06.2018;2018;06;13;Torstai;13;20;33
623;28.06.2018;2018;06;14;Torstai;16;19;35
623;28.06.2018;2018;06;15;Torstai;16;16;32
623;28.06.2018;2018;06;16;Torstai;42;26;68
623;28.06.2018;2018;06;17;Torstai;58;28;86
623;28.06.2018;2018;06;18;Torstai;43;23;66
623;28.06.2018;2018;06;19;Torstai;33;15;48
623;28.06.2018;2018;06;20;Torstai;21;14;35
623;28.06.2018;2018;06;21;Torstai;21;13;34
623;28.06.2018;2018;06;22;Torstai;15;9;24
623;28.06.2018;2018;06;23;Torstai;9;7;16
623;29.06.2018;2018;06;00;Perjantai;6;5;11
623;29.06.2018;2018;06;01;Perjantai;2;4;6
623;29.06.2018;2018;06;02;Perjantai;4;3;7
623;29.06.2018;2018;06;03;Perjantai;1;2;3
623;29.06.2018;2018;06;04;Perjantai;1;1;2
623;29.06.2018;2018;06;05;Perjantai;4;2;6
623;29.06.2018;2018;06;06;Perjantai;1;9;10
623;29.06.2018;2018;06;07;Perjantai;11;39;50
623;29.06.2018;2018;06;08;Perjantai;25;69;94
623;29.06.2018;2018;06;09;Perjantai;20;69;89
623;29.06.2018;2018;06;10;Perjantai;20;53;73
623;29.06.2018;2018;06;11;Perjantai;21;46;67
623;29.06.2018;2018;06;12;Perjantai;31;40;71
623;29.06.2018;2018;06;13;Perjantai;31;34;65
623;29.06.2018;2018;06;14;Perjantai;40;51;91
623;29.06.2018;2018;06;15;Perjantai;57;29;86
623;29.06.2018;2018;06;16;Perjantai;83;57;140
623;29.06.2018;2018;06;17;Perjantai;69;55;124
623;29.06.2018;2018;06;18;Perjantai;48;38;86
623;29.06.2018;2018;06;19;Perjantai;49;30;79
623;29.06.2018;2018;06;20;Perjantai;25;27;52
623;29.06.2018;2018;06;21;Perjantai;36;36;72
623;29.06.2018;2018;06;22;Perjantai;24;20;44
623;29.06.2018;2018;06;23;Perjantai;23;20;43
623;30.06.2018;2018;06;00;Lauantai;24;13;37
623;30.06.2018;2018;06;01;Lauantai;18;14;32
623;30.06.2018;2018;06;02;Lauantai;13;7;20
623;30.06.2018;2018;06;03;Lauantai;8;1;9
623;30.06.2018;2018;06;04;Lauantai;3;3;6
623;30.06.2018;2018;06;05;Lauantai;9;4;13
623;30.06.2018;2018;06;06;Lauantai;4;8;12
623;30.06.2018;2018;06;07;Lauantai;3;9;12
623;30.06.2018;2018;06;08;Lauantai;0;14;14
623;30.06.2018;2018;06;09;Lauantai;4;18;22
623;30.06.2018;2018;06;10;Lauantai;8;33;41
623;30.06.2018;2018;06;11;Lauantai;20;31;51
623;30.06.2018;2018;06;12;Lauantai;18;37;55
623;30.06.2018;2018;06;13;Lauantai;38;54;92
623;30.06.2018;2018;06;14;Lauantai;35;61;96
623;30.06.2018;2018;06;15;Lauantai;46;52;98
623;30.06.2018;2018;06;16;Lauantai;36;36;72
623;30.06.2018;2018;06;17;Lauantai;46;31;77
623;30.06.2018;2018;06;18;Lauantai;34;29;63
623;30.06.2018;2018;06;19;Lauantai;30;27;57
623;30.06.2018;2018;06;20;Lauantai;37;32;69
623;30.06.2018;2018;06;21;Lauantai;21;24;45
623;30.06.2018;2018;06;22;Lauantai;26;16;42
623;30.06.2018;2018;06;23;Lauantai;16;11;27
623;01.07.2018;2018;07;00;Sunnuntai;11;12;23
623;01.07.2018;2018;07;01;Sunnuntai;12;8;20
623;01.07.2018;2018;07;02;Sunnuntai;16;6;22
623;01.07.2018;2018;07;03;Sunnuntai;11;2;13
623;01.07.2018;2018;07;04;Sunnuntai;6;4;10
623;01.07.2018;2018;07;05;Sunnuntai;5;4;9
623;01.07.2018;2018;07;06;Sunnuntai;3;5;8
623;01.07.2018;2018;07;07;Sunnuntai;2;10;12
623;01.07.2018;2018;07;08;Sunnuntai;1;5;6
623;01.07.2018;2018;07;09;Sunnuntai;5;3;8
623;01.07.2018;2018;07;10;Sunnuntai;14;27;41
623;01.07.2018;2018;07;11;Sunnuntai;14;31;45
623;01.07.2018;2018;07;12;Sunnuntai;28;38;66
623;01.07.2018;2018;07;13;Sunnuntai;27;60;87
623;01.07.2018;2018;07;14;Sunnuntai;47;48;95
623;01.07.2018;2018;07;15;Sunnuntai;52;53;105
623;01.07.2018;2018;07;16;Sunnuntai;58;67;125
623;01.07.2018;2018;07;17;Sunnuntai;48;46;94
623;01.07.2018;2018;07;18;Sunnuntai;41;42;83
623;01.07.2018;2018;07;19;Sunnuntai;53;33;86
623;01.07.2018;2018;07;20;Sunnuntai;29;26;55
623;01.07.2018;2018;07;21;Sunnuntai;30;25;55
623;01.07.2018;2018;07;22;Sunnuntai;18;11;29
623;01.07.2018;2018;07;23;Sunnuntai;19;13;32
623;02.07.2018;2018;07;00;Maanantai;8;10;18
623;02.07.2018;2018;07;01;Maanantai;5;7;12
623;02.07.2018;2018;07;02;Maanantai;4;3;7
623;02.07.2018;2018;07;03;Maanantai;5;2;7
623;02.07.2018;2018;07;04;Maanantai;4;5;9
623;02.07.2018;2018;07;05;Maanantai;3;6;9
623;02.07.2018;2018;07;06;Maanantai;6;16;22
623;02.07.2018;2018;07;07;Maanantai;16;35;51
623;02.07.2018;2018;07;08;Maanantai;26;87;113
623;02.07.2018;2018;07;09;Maanantai;29;89;118
623;02.07.2018;2018;07;10;Maanantai;22;62;84
623;02.07.2018;2018;07;11;Maanantai;26;53;79
623;02.07.2018;2018;07;12;Maanantai;38;61;99
623;02.07.2018;2018;07;13;Maanantai;42;67;109
623;02.07.2018;2018;07;14;Maanantai;66;83;149
623;02.07.2018;2018;07;15;Maanantai;66;61;127
623;02.07.2018;2018;07;16;Maanantai;115;70;185
623;02.07.2018;2018;07;17;Maanantai;121;73;194
623;02.07.2018;2018;07;18;Maanantai;81;71;152
623;02.07.2018;2018;07;19;Maanantai;53;49;102
623;02.07.2018;2018;07;20;Maanantai;67;57;124
623;02.07.2018;2018;07;21;Maanantai;71;43;114
623;02.07.2018;2018;07;22;Maanantai;35;19;54
623;02.07.2018;2018;07;23;Maanantai;33;10;43
623;03.07.2018;2018;07;00;Tiistai;10;6;16
623;03.07.2018;2018;07;01;Tiistai;5;5;10
623;03.07.2018;2018;07;02;Tiistai;9;0;9
623;03.07.2018;2018;07;03;Tiistai;6;6;12
623;03.07.2018;2018;07;04;Tiistai;3;4;7
623;03.07.2018;2018;07;05;Tiistai;4;3;7
623;03.07.2018;2018;07;06;Tiistai;4;19;23
623;03.07.2018;2018;07;07;Tiistai;14;38;52
623;03.07.2018;2018;07;08;Tiistai;19;84;103
623;03.07.2018;2018;07;09;Tiistai;30;89;119
623;03.07.2018;2018;07;10;Tiistai;21;57;78
623;03.07.2018;2018;07;11;Tiistai;19;46;65
623;03.07.2018;2018;07;12;Tiistai;39;35;74
623;03.07.2018;2018;07;13;Tiistai;34;50;84
623;03.07.2018;2018;07;14;Tiistai;45;56;101
623;03.07.2018;2018;07;15;Tiistai;69;41;110
623;03.07.2018;2018;07;16;Tiistai;85;70;155
623;03.07.2018;2018;07;17;Tiistai;108;58;166
623;03.07.2018;2018;07;18;Tiistai;74;54;128
623;03.07.2018;2018;07;19;Tiistai;57;44;101
623;03.07.2018;2018;07;20;Tiistai;60;43;103
623;03.07.2018;2018;07;21;Tiistai;45;28;73
623;03.07.2018;2018;07;22;Tiistai;35;25;60
623;03.07.2018;2018;07;23;Tiistai;11;7;18
623;04.07.2018;2018;07;00;Keskiviikko;9;2;11
623;04.07.2018;2018;07;01;Keskiviikko;6;2;8
623;04.07.2018;2018;07;02;Keskiviikko;0;0;0
623;04.07.2018;2018;07;03;Keskiviikko;0;0;0
623;04.07.2018;2018;07;04;Keskiviikko;0;0;0
623;04.07.2018;2018;07;05;Keskiviikko;0;0;0
623;04.07.2018;2018;07;06;Keskiviikko;0;0;0
623;04.07.2018;2018;07;07;Keskiviikko;0;0;0
623;04.07.2018;2018;07;08;Keskiviikko;0;0;0
623;04.07.2018;2018;07;09;Keskiviikko;45;136;181
623;04.07.2018;2018;07;10;Keskiviikko;9;29;38
623;04.07.2018;2018;07;11;Keskiviikko;9;15;24
623;04.07.2018;2018;07;12;Keskiviikko;12;21;33
623;04.07.2018;2018;07;13;Keskiviikko;19;17;36
623;04.07.2018;2018;07;14;Keskiviikko;21;20;41
623;04.07.2018;2018;07;15;Keskiviikko;29;31;60
623;04.07.2018;2018;07;16;Keskiviikko;46;31;77
623;04.07.2018;2018;07;17;Keskiviikko;62;49;111
623;04.07.2018;2018;07;18;Keskiviikko;51;44;95
623;04.07.2018;2018;07;19;Keskiviikko;46;35;81
623;04.07.2018;2018;07;20;Keskiviikko;33;27;60
623;04.07.2018;2018;07;21;Keskiviikko;31;31;62
623;04.07.2018;2018;07;22;Keskiviikko;37;21;58
623;04.07.2018;2018;07;23;Keskiviikko;13;17;30
623;05.07.2018;2018;07;00;Torstai;9;6;15
623;05.07.2018;2018;07;01;Torstai;8;8;16
623;05.07.2018;2018;07;02;Torstai;10;3;13
623;05.07.2018;2018;07;03;Torstai;7;4;11
623;05.07.2018;2018;07;04;Torstai;0;0;0
623;05.07.2018;2018;07;05;Torstai;1;5;6
623;05.07.2018;2018;07;06;Torstai;2;10;12
623;05.07.2018;2018;07;07;Torstai;11;44;55
623;05.07.2018;2018;07;08;Torstai;25;85;110
623;05.07.2018;2018;07;09;Torstai;29;71;100
623;05.07.2018;2018;07;10;Torstai;19;39;58
623;05.07.2018;2018;07;11;Torstai;27;48;75
623;05.07.2018;2018;07;12;Torstai;24;71;95
623;05.07.2018;2018;07;13;Torstai;46;69;115
623;05.07.2018;2018;07;14;Torstai;70;76;146
623;05.07.2018;2018;07;15;Torstai;74;49;123
623;05.07.2018;2018;07;16;Torstai;121;61;182
623;05.07.2018;2018;07;17;Torstai;86;44;130
623;05.07.2018;2018;07;18;Torstai;72;51;123
623;05.07.2018;2018;07;19;Torstai;51;39;90
623;05.07.2018;2018;07;20;Torstai;39;30;69
623;05.07.2018;2018;07;21;Torstai;27;15;42
623;05.07.2018;2018;07;22;Torstai;27;14;41
623;05.07.2018;2018;07;23;Torstai;16;8;24
623;06.07.2018;2018;07;00;Perjantai;10;3;13
623;06.07.2018;2018;07;01;Perjantai;8;3;11
623;06.07.2018;2018;07;02;Perjantai;2;4;6
623;06.07.2018;2018;07;03;Perjantai;7;6;13
623;06.07.2018;2018;07;04;Perjantai;3;1;4
623;06.07.2018;2018;07;05;Perjantai;4;4;8
623;06.07.2018;2018;07;06;Perjantai;6;9;15
623;06.07.2018;2018;07;07;Perjantai;7;41;48
623;06.07.2018;2018;07;08;Perjantai;19;64;83
623;06.07.2018;2018;07;09;Perjantai;30;67;97
623;06.07.2018;2018;07;10;Perjantai;16;46;62
623;06.07.2018;2018;07;11;Perjantai;29;44;73
623;06.07.2018;2018;07;12;Perjantai;30;65;95
623;06.07.2018;2018;07;13;Perjantai;39;64;103
623;06.07.2018;2018;07;14;Perjantai;59;63;122
623;06.07.2018;2018;07;15;Perjantai;78;51;129
623;06.07.2018;2018;07;16;Perjantai;87;79;166
623;06.07.2018;2018;07;17;Perjantai;100;63;163
623;06.07.2018;2018;07;18;Perjantai;71;69;140
623;06.07.2018;2018;07;19;Perjantai;54;53;107
623;06.07.2018;2018;07;20;Perjantai;52;60;112
623;06.07.2018;2018;07;21;Perjantai;49;64;113
623;06.07.2018;2018;07;22;Perjantai;35;21;56
623;06.07.2018;2018;07;23;Perjantai;20;23;43
623;07.07.2018;2018;07;00;Lauantai;33;19;52
623;07.07.2018;2018;07;01;Lauantai;32;18;50
623;07.07.2018;2018;07;02;Lauantai;32;13;45
623;07.07.2018;2018;07;03;Lauantai;24;5;29
623;07.07.2018;2018;07;04;Lauantai;17;1;18
623;07.07.2018;2018;07;05;Lauantai;13;5;18
623;07.07.2018;2018;07;06;Lauantai;9;10;19
623;07.07.2018;2018;07;07;Lauantai;4;10;14
623;07.07.2018;2018;07;08;Lauantai;7;13;20
623;07.07.2018;2018;07;09;Lauantai;9;17;26
623;07.07.2018;2018;07;10;Lauantai;12;38;50
623;07.07.2018;2018;07;11;Lauantai;24;56;80
623;07.07.2018;2018;07;12;Lauantai;31;67;98
623;07.07.2018;2018;07;13;Lauantai;47;106;153
623;07.07.2018;2018;07;14;Lauantai;51;92;143
623;07.07.2018;2018;07;15;Lauantai;86;81;167
623;07.07.2018;2018;07;16;Lauantai;79;66;145
623;07.07.2018;2018;07;17;Lauantai;56;46;102
623;07.07.2018;2018;07;18;Lauantai;62;29;91
623;07.07.2018;2018;07;19;Lauantai;42;30;72
623;07.07.2018;2018;07;20;Lauantai;46;49;95
623;07.07.2018;2018;07;21;Lauantai;39;36;75
623;07.07.2018;2018;07;22;Lauantai;17;17;34
623;07.07.2018;2018;07;23;Lauantai;30;20;50
623;08.07.2018;2018;07;00;Sunnuntai;16;6;22
623;08.07.2018;2018;07;01;Sunnuntai;24;9;33
623;08.07.2018;2018;07;02;Sunnuntai;17;7;24
623;08.07.2018;2018;07;03;Sunnuntai;11;3;14
623;08.07.2018;2018;07;04;Sunnuntai;12;5;17
623;08.07.2018;2018;07;05;Sunnuntai;11;3;14
623;08.07.2018;2018;07;06;Sunnuntai;2;4;6
623;08.07.2018;2018;07;07;Sunnuntai;3;9;12
623;08.07.2018;2018;07;08;Sunnuntai;2;9;11
623;08.07.2018;2018;07;09;Sunnuntai;4;7;11
623;08.07.2018;2018;07;10;Sunnuntai;14;22;36
623;08.07.2018;2018;07;11;Sunnuntai;9;31;40
623;08.07.2018;2018;07;12;Sunnuntai;31;43;74
623;08.07.2018;2018;07;13;Sunnuntai;34;66;100
623;08.07.2018;2018;07;14;Sunnuntai;44;69;113
623;08.07.2018;2018;07;15;Sunnuntai;56;61;117
623;08.07.2018;2018;07;16;Sunnuntai;44;60;104
623;08.07.2018;2018;07;17;Sunnuntai;56;46;102
623;08.07.2018;2018;07;18;Sunnuntai;55;48;103
623;08.07.2018;2018;07;19;Sunnuntai;50;43;93
623;08.07.2018;2018;07;20;Sunnuntai;50;31;81
623;08.07.2018;2018;07;21;Sunnuntai;33;33;66
623;08.07.2018;2018;07;22;Sunnuntai;20;17;37
623;08.07.2018;2018;07;23;Sunnuntai;17;19;36
623;09.07.2018;2018;07;00;Maanantai;10;4;14
623;09.07.2018;2018;07;01;Maanantai;11;2;13
623;09.07.2018;2018;07;02;Maanantai;6;2;8
623;09.07.2018;2018;07;03;Maanantai;4;3;7
623;09.07.2018;2018;07;04;Maanantai;1;0;1
623;09.07.2018;2018;07;05;Maanantai;2;6;8
623;09.07.2018;2018;07;06;Maanantai;2;13;15
623;09.07.2018;2018;07;07;Maanantai;7;42;49
623;09.07.2018;2018;07;08;Maanantai;20;77;97
623;09.07.2018;2018;07;09;Maanantai;27;71;98
623;09.07.2018;2018;07;10;Maanantai;25;53;78
623;09.07.2018;2018;07;11;Maanantai;31;59;90
623;09.07.2018;2018;07;12;Maanantai;45;73;118
623;09.07.2018;2018;07;13;Maanantai;43;76;119
623;09.07.2018;2018;07;14;Maanantai;61;80;141
623;09.07.2018;2018;07;15;Maanantai;87;77;164
623;09.07.2018;2018;07;16;Maanantai;98;78;176
623;09.07.2018;2018;07;17;Maanantai;103;69;172
623;09.07.2018;2018;07;18;Maanantai;81;81;162
623;09.07.2018;2018;07;19;Maanantai;65;56;121
623;09.07.2018;2018;07;20;Maanantai;55;47;102
623;09.07.2018;2018;07;21;Maanantai;61;34;95
623;09.07.2018;2018;07;22;Maanantai;47;32;79
623;09.07.2018;2018;07;23;Maanantai;22;12;34
623;10.07.2018;2018;07;00;Tiistai;11;7;18
623;10.07.2018;2018;07;01;Tiistai;9;4;13
623;10.07.2018;2018;07;02;Tiistai;5;8;13
623;10.07.2018;2018;07;03;Tiistai;0;3;3
623;10.07.2018;2018;07;04;Tiistai;2;0;2
623;10.07.2018;2018;07;05;Tiistai;5;2;7
623;10.07.2018;2018;07;06;Tiistai;3;13;16
623;10.07.2018;2018;07;07;Tiistai;7;52;59
623;10.07.2018;2018;07;08;Tiistai;20;69;89
623;10.07.2018;2018;07;09;Tiistai;29;78;107
623;10.07.2018;2018;07;10;Tiistai;20;50;70
623;10.07.2018;2018;07;11;Tiistai;38;83;121
623;10.07.2018;2018;07;12;Tiistai;42;62;104
623;10.07.2018;2018;07;13;Tiistai;65;107;172
623;10.07.2018;2018;07;14;Tiistai;53;68;121
623;10.07.2018;2018;07;15;Tiistai;82;61;143
623;10.07.2018;2018;07;16;Tiistai;101;77;178
623;10.07.2018;2018;07;17;Tiistai;111;83;194
623;10.07.2018;2018;07;18;Tiistai;108;79;187
623;10.07.2018;2018;07;19;Tiistai;74;59;133
623;10.07.2018;2018;07;20;Tiistai;82;56;138
623;10.07.2018;2018;07;21;Tiistai;59;38;97
623;10.07.2018;2018;07;22;Tiistai;38;17;55
623;10.07.2018;2018;07;23;Tiistai;32;16;48
623;11.07.2018;2018;07;00;Keskiviikko;17;7;24
623;11.07.2018;2018;07;01;Keskiviikko;11;4;15
623;11.07.2018;2018;07;02;Keskiviikko;11;7;18
623;11.07.2018;2018;07;03;Keskiviikko;7;5;12
623;11.07.2018;2018;07;04;Keskiviikko;5;4;9
623;11.07.2018;2018;07;05;Keskiviikko;3;2;5
623;11.07.2018;2018;07;06;Keskiviikko;3;18;21
623;11.07.2018;2018;07;07;Keskiviikko;5;45;50
623;11.07.2018;2018;07;08;Keskiviikko;18;68;86
623;11.07.2018;2018;07;09;Keskiviikko;43;74;117
623;11.07.2018;2018;07;10;Keskiviikko;16;63;79
623;11.07.2018;2018;07;11;Keskiviikko;30;49;79
623;11.07.2018;2018;07;12;Keskiviikko;35;70;105
623;11.07.2018;2018;07;13;Keskiviikko;36;75;111
623;11.07.2018;2018;07;14;Keskiviikko;80;97;177
623;11.07.2018;2018;07;15;Keskiviikko;77;69;146
623;11.07.2018;2018;07;16;Keskiviikko;100;67;167
623;11.07.2018;2018;07;17;Keskiviikko;118;69;187
623;11.07.2018;2018;07;18;Keskiviikko;78;96;174
623;11.07.2018;2018;07;19;Keskiviikko;66;68;134
623;11.07.2018;2018;07;20;Keskiviikko;73;49;122
623;11.07.2018;2018;07;21;Keskiviikko;67;54;121
623;11.07.2018;2018;07;22;Keskiviikko;49;28;77
623;11.07.2018;2018;07;23;Keskiviikko;28;21;49
623;12.07.2018;2018;07;00;Torstai;19;12;31
623;12.07.2018;2018;07;01;Torstai;12;8;20
623;12.07.2018;2018;07;02;Torstai;10;4;14
623;12.07.2018;2018;07;03;Torstai;6;7;13
623;12.07.2018;2018;07;04;Torstai;3;3;6
623;12.07.2018;2018;07;05;Torstai;3;2;5
623;12.07.2018;2018;07;06;Torstai;4;12;16
623;12.07.2018;2018;07;07;Torstai;6;37;43
623;12.07.2018;2018;07;08;Torstai;21;67;88
623;12.07.2018;2018;07;09;Torstai;25;74;99
623;12.07.2018;2018;07;10;Torstai;25;42;67
623;12.07.2018;2018;07;11;Torstai;38;68;106
623;12.07.2018;2018;07;12;Torstai;44;59;103
623;12.07.2018;2018;07;13;Torstai;66;78;144
623;12.07.2018;2018;07;14;Torstai;64;79;143
623;12.07.2018;2018;07;15;Torstai;84;85;169
623;12.07.2018;2018;07;16;Torstai;115;85;200
623;12.07.2018;2018;07;17;Torstai;113;104;217
623;12.07.2018;2018;07;18;Torstai;73;64;137
623;12.07.2018;2018;07;19;Torstai;66;61;127
623;12.07.2018;2018;07;20;Torstai;77;74;151
623;12.07.2018;2018;07;21;Torstai;59;50;109
623;12.07.2018;2018;07;22;Torstai;54;34;88
623;12.07.2018;2018;07;23;Torstai;60;16;76
623;13.07.2018;2018;07;00;Perjantai;43;12;55
623;13.07.2018;2018;07;01;Perjantai;28;12;40
623;13.07.2018;2018;07;02;Perjantai;10;3;13
623;13.07.2018;2018;07;03;Perjantai;5;6;11
623;13.07.2018;2018;07;04;Perjantai;6;1;7
623;13.07.2018;2018;07;05;Perjantai;7;3;10
623;13.07.2018;2018;07;06;Perjantai;3;13;16
623;13.07.2018;2018;07;07;Perjantai;10;33;43
623;13.07.2018;2018;07;08;Perjantai;16;42;58
623;13.07.2018;2018;07;09;Perjantai;25;81;106
623;13.07.2018;2018;07;10;Perjantai;22;49;71
623;13.07.2018;2018;07;11;Perjantai;43;80;123
623;13.07.2018;2018;07;12;Perjantai;37;59;96
623;13.07.2018;2018;07;13;Perjantai;58;78;136
623;13.07.2018;2018;07;14;Perjantai;61;97;158
623;13.07.2018;2018;07;15;Perjantai;74;70;144
623;13.07.2018;2018;07;16;Perjantai;98;84;182
623;13.07.2018;2018;07;17;Perjantai;94;81;175
623;13.07.2018;2018;07;18;Perjantai;72;92;164
623;13.07.2018;2018;07;19;Perjantai;70;83;153
623;13.07.2018;2018;07;20;Perjantai;73;91;164
623;13.07.2018;2018;07;21;Perjantai;50;55;105
623;13.07.2018;2018;07;22;Perjantai;38;41;79
623;13.07.2018;2018;07;23;Perjantai;47;18;65
623;14.07.2018;2018;07;00;Lauantai;39;20;59
623;14.07.2018;2018;07;01;Lauantai;83;12;95
623;14.07.2018;2018;07;02;Lauantai;38;11;49
623;14.07.2018;2018;07;03;Lauantai;21;2;23
623;14.07.2018;2018;07;04;Lauantai;21;2;23
623;14.07.2018;2018;07;05;Lauantai;25;3;28
623;14.07.2018;2018;07;06;Lauantai;7;7;14
623;14.07.2018;2018;07;07;Lauantai;7;10;17
623;14.07.2018;2018;07;08;Lauantai;3;8;11
623;14.07.2018;2018;07;09;Lauantai;3;14;17
623;14.07.2018;2018;07;10;Lauantai;7;31;38
623;14.07.2018;2018;07;11;Lauantai;29;46;75
623;14.07.2018;2018;07;12;Lauantai;38;38;76
623;14.07.2018;2018;07;13;Lauantai;24;42;66
623;14.07.2018;2018;07;14;Lauantai;47;85;132
623;14.07.2018;2018;07;15;Lauantai;65;74;139
623;14.07.2018;2018;07;16;Lauantai;57;70;127
623;14.07.2018;2018;07;17;Lauantai;69;63;132
623;14.07.2018;2018;07;18;Lauantai;48;63;111
623;14.07.2018;2018;07;19;Lauantai;60;70;130
623;14.07.2018;2018;07;20;Lauantai;50;62;112
623;14.07.2018;2018;07;21;Lauantai;49;53;102
623;14.07.2018;2018;07;22;Lauantai;49;47;96
623;14.07.2018;2018;07;23;Lauantai;30;23;53
623;15.07.2018;2018;07;00;Sunnuntai;55;23;78
623;15.07.2018;2018;07;01;Sunnuntai;53;19;72
623;15.07.2018;2018;07;02;Sunnuntai;30;12;42
623;15.07.2018;2018;07;03;Sunnuntai;18;6;24
623;15.07.2018;2018;07;04;Sunnuntai;19;1;20
623;15.07.2018;2018;07;05;Sunnuntai;22;2;24
623;15.07.2018;2018;07;06;Sunnuntai;8;6;14
623;15.07.2018;2018;07;07;Sunnuntai;4;7;11
623;15.07.2018;2018;07;08;Sunnuntai;2;5;7
623;15.07.2018;2018;07;09;Sunnuntai;9;12;21
623;15.07.2018;2018;07;10;Sunnuntai;17;23;40
623;15.07.2018;2018;07;11;Sunnuntai;20;39;59
623;15.07.2018;2018;07;12;Sunnuntai;43;70;113
623;15.07.2018;2018;07;13;Sunnuntai;43;65;108
623;15.07.2018;2018;07;14;Sunnuntai;44;74;118
623;15.07.2018;2018;07;15;Sunnuntai;63;79;142
623;15.07.2018;2018;07;16;Sunnuntai;54;74;128
623;15.07.2018;2018;07;17;Sunnuntai;58;53;111
623;15.07.2018;2018;07;18;Sunnuntai;65;56;121
623;15.07.2018;2018;07;19;Sunnuntai;49;39;88
623;15.07.2018;2018;07;20;Sunnuntai;33;24;57
623;15.07.2018;2018;07;21;Sunnuntai;37;37;74
623;15.07.2018;2018;07;22;Sunnuntai;49;32;81
623;15.07.2018;2018;07;23;Sunnuntai;32;21;53
623;16.07.2018;2018;07;00;Maanantai;20;12;32
623;16.07.2018;2018;07;01;Maanantai;15;12;27
623;16.07.2018;2018;07;02;Maanantai;6;4;10
623;16.07.2018;2018;07;03;Maanantai;6;4;10
623;16.07.2018;2018;07;04;Maanantai;7;3;10
623;16.07.2018;2018;07;05;Maanantai;8;6;14
623;16.07.2018;2018;07;06;Maanantai;2;13;15
623;16.07.2018;2018;07;07;Maanantai;8;44;52
623;16.07.2018;2018;07;08;Maanantai;21;62;83
623;16.07.2018;2018;07;09;Maanantai;32;72;104
623;16.07.2018;2018;07;10;Maanantai;29;59;88
623;16.07.2018;2018;07;11;Maanantai;41;75;116
623;16.07.2018;2018;07;12;Maanantai;48;65;113
623;16.07.2018;2018;07;13;Maanantai;54;69;123
623;16.07.2018;2018;07;14;Maanantai;47;70;117
623;16.07.2018;2018;07;15;Maanantai;92;77;169
623;16.07.2018;2018;07;16;Maanantai;93;69;162
623;16.07.2018;2018;07;17;Maanantai;118;73;191
623;16.07.2018;2018;07;18;Maanantai;88;67;155
623;16.07.2018;2018;07;19;Maanantai;73;59;132
623;16.07.2018;2018;07;20;Maanantai;70;56;126
623;16.07.2018;2018;07;21;Maanantai;67;34;101
623;16.07.2018;2018;07;22;Maanantai;45;20;65
623;16.07.2018;2018;07;23;Maanantai;23;12;35
623;17.07.2018;2018;07;00;Tiistai;11;5;16
623;17.07.2018;2018;07;01;Tiistai;12;5;17
623;17.07.2018;2018;07;02;Tiistai;9;8;17
623;17.07.2018;2018;07;03;Tiistai;3;5;8
623;17.07.2018;2018;07;04;Tiistai;2;3;5
623;17.07.2018;2018;07;05;Tiistai;0;4;4
623;17.07.2018;2018;07;06;Tiistai;6;14;20
623;17.07.2018;2018;07;07;Tiistai;10;46;56
623;17.07.2018;2018;07;08;Tiistai;21;67;88
623;17.07.2018;2018;07;09;Tiistai;27;69;96
623;17.07.2018;2018;07;10;Tiistai;20;61;81
623;17.07.2018;2018;07;11;Tiistai;34;55;89
623;17.07.2018;2018;07;12;Tiistai;35;52;87
623;17.07.2018;2018;07;13;Tiistai;51;74;125
623;17.07.2018;2018;07;14;Tiistai;59;75;134
623;17.07.2018;2018;07;15;Tiistai;63;62;125
623;17.07.2018;2018;07;16;Tiistai;98;82;180
623;17.07.2018;2018;07;17;Tiistai;117;88;205
623;17.07.2018;2018;07;18;Tiistai;81;80;161
623;17.07.2018;2018;07;19;Tiistai;83;77;160
623;17.07.2018;2018;07;20;Tiistai;72;57;129
623;17.07.2018;2018;07;21;Tiistai;58;46;104
623;17.07.2018;2018;07;22;Tiistai;62;38;100
623;17.07.2018;2018;07;23;Tiistai;28;15;43
623;18.07.2018;2018;07;00;Keskiviikko;20;7;27
623;18.07.2018;2018;07;01;Keskiviikko;17;9;26
623;18.07.2018;2018;07;02;Keskiviikko;11;5;16
623;18.07.2018;2018;07;03;Keskiviikko;6;6;12
623;18.07.2018;2018;07;04;Keskiviikko;6;3;9
623;18.07.2018;2018;07;05;Keskiviikko;3;3;6
623;18.07.2018;2018;07;06;Keskiviikko;0;12;12
623;18.07.2018;2018;07;07;Keskiviikko;9;45;54
623;18.07.2018;2018;07;08;Keskiviikko;25;64;89
623;18.07.2018;2018;07;09;Keskiviikko;29;73;102
623;18.07.2018;2018;07;10;Keskiviikko;23;55;78
623;18.07.2018;2018;07;11;Keskiviikko;34;62;96
623;18.07.2018;2018;07;12;Keskiviikko;39;65;104
623;18.07.2018;2018;07;13;Keskiviikko;37;65;102
623;18.07.2018;2018;07;14;Keskiviikko;65;61;126
623;18.07.2018;2018;07;15;Keskiviikko;70;69;139
623;18.07.2018;2018;07;16;Keskiviikko;96;66;162
623;18.07.2018;2018;07;17;Keskiviikko;101;87;188
623;18.07.2018;2018;07;18;Keskiviikko;83;81;164
623;18.07.2018;2018;07;19;Keskiviikko;60;55;115
623;18.07.2018;2018;07;20;Keskiviikko;58;43;101
623;18.07.2018;2018;07;21;Keskiviikko;64;55;119
623;18.07.2018;2018;07;22;Keskiviikko;66;33;99
623;18.07.2018;2018;07;23;Keskiviikko;34;17;51
623;19.07.2018;2018;07;00;Torstai;21;6;27
623;19.07.2018;2018;07;01;Torstai;11;6;17
623;19.07.2018;2018;07;02;Torstai;10;4;14
623;19.07.2018;2018;07;03;Torstai;8;4;12
623;19.07.2018;2018;07;04;Torstai;3;3;6
623;19.07.2018;2018;07;05;Torstai;3;4;7
623;19.07.2018;2018;07;06;Torstai;4;10;14
623;19.07.2018;2018;07;07;Torstai;9;45;54
623;19.07.2018;2018;07;08;Torstai;22;63;85
623;19.07.2018;2018;07;09;Torstai;21;73;94
623;19.07.2018;2018;07;10;Torstai;21;53;74
623;19.07.2018;2018;07;11;Torstai;27;60;87
623;19.07.2018;2018;07;12;Torstai;33;50;83
623;19.07.2018;2018;07;13;Torstai;40;69;109
623;19.07.2018;2018;07;14;Torstai;62;85;147
623;19.07.2018;2018;07;15;Torstai;68;62;130
623;19.07.2018;2018;07;16;Torstai;95;70;165
623;19.07.2018;2018;07;17;Torstai;118;86;204
623;19.07.2018;2018;07;18;Torstai;73;68;141
623;19.07.2018;2018;07;19;Torstai;70;41;111
623;19.07.2018;2018;07;20;Torstai;63;56;119
623;19.07.2018;2018;07;21;Torstai;48;29;77
623;19.07.2018;2018;07;22;Torstai;63;33;96
623;19.07.2018;2018;07;23;Torstai;31;25;56
623;20.07.2018;2018;07;00;Perjantai;22;10;32
623;20.07.2018;2018;07;01;Perjantai;7;7;14
623;20.07.2018;2018;07;02;Perjantai;7;4;11
623;20.07.2018;2018;07;03;Perjantai;5;2;7
623;20.07.2018;2018;07;04;Perjantai;4;2;6
623;20.07.2018;2018;07;05;Perjantai;4;3;7
623;20.07.2018;2018;07;06;Perjantai;2;16;18
623;20.07.2018;2018;07;07;Perjantai;12;42;54
623;20.07.2018;2018;07;08;Perjantai;24;67;91
623;20.07.2018;2018;07;09;Perjantai;23;57;80
623;20.07.2018;2018;07;10;Perjantai;25;60;85
623;20.07.2018;2018;07;11;Perjantai;32;47;79
623;20.07.2018;2018;07;12;Perjantai;30;53;83
623;20.07.2018;2018;07;13;Perjantai;29;52;81
623;20.07.2018;2018;07;14;Perjantai;48;74;122
623;20.07.2018;2018;07;15;Perjantai;69;75;144
623;20.07.2018;2018;07;16;Perjantai;93;75;168
623;20.07.2018;2018;07;17;Perjantai;91;54;145
623;20.07.2018;2018;07;18;Perjantai;61;70;131
623;20.07.2018;2018;07;19;Perjantai;67;59;126
623;20.07.2018;2018;07;20;Perjantai;68;52;120
623;20.07.2018;2018;07;21;Perjantai;55;56;111
623;20.07.2018;2018;07;22;Perjantai;46;42;88
623;20.07.2018;2018;07;23;Perjantai;27;39;66
623;21.07.2018;2018;07;00;Lauantai;20;14;34
623;21.07.2018;2018;07;01;Lauantai;25;7;32
623;21.07.2018;2018;07;02;Lauantai;26;6;32
623;21.07.2018;2018;07;03;Lauantai;12;5;17
623;21.07.2018;2018;07;04;Lauantai;16;3;19
623;21.07.2018;2018;07;05;Lauantai;11;4;15
623;21.07.2018;2018;07;06;Lauantai;10;3;13
623;21.07.2018;2018;07;07;Lauantai;9;6;15
623;21.07.2018;2018;07;08;Lauantai;4;16;20
623;21.07.2018;2018;07;09;Lauantai;7;23;30
623;21.07.2018;2018;07;10;Lauantai;11;26;37
623;21.07.2018;2018;07;11;Lauantai;27;40;67
623;21.07.2018;2018;07;12;Lauantai;20;41;61
623;21.07.2018;2018;07;13;Lauantai;25;56;81
623;21.07.2018;2018;07;14;Lauantai;31;43;74
623;21.07.2018;2018;07;15;Lauantai;33;37;70
623;21.07.2018;2018;07;16;Lauantai;38;30;68
623;21.07.2018;2018;07;17;Lauantai;31;32;63
623;21.07.2018;2018;07;18;Lauantai;28;33;61
623;21.07.2018;2018;07;19;Lauantai;49;33;82
623;21.07.2018;2018;07;20;Lauantai;35;39;74
623;21.07.2018;2018;07;21;Lauantai;24;30;54
623;21.07.2018;2018;07;22;Lauantai;36;35;71
623;21.07.2018;2018;07;23;Lauantai;17;16;33
623;22.07.2018;2018;07;00;Sunnuntai;15;8;23
623;22.07.2018;2018;07;01;Sunnuntai;15;10;25
623;22.07.2018;2018;07;02;Sunnuntai;15;10;25
623;22.07.2018;2018;07;03;Sunnuntai;29;3;32
623;22.07.2018;2018;07;04;Sunnuntai;17;2;19
623;22.07.2018;2018;07;05;Sunnuntai;12;1;13
623;22.07.2018;2018;07;06;Sunnuntai;4;1;5
623;22.07.2018;2018;07;07;Sunnuntai;7;5;12
623;22.07.2018;2018;07;08;Sunnuntai;3;11;14
623;22.07.2018;2018;07;09;Sunnuntai;4;12;16
623;22.07.2018;2018;07;10;Sunnuntai;14;24;38
623;22.07.2018;2018;07;11;Sunnuntai;6;19;25
623;22.07.2018;2018;07;12;Sunnuntai;25;33;58
623;22.07.2018;2018;07;13;Sunnuntai;23;41;64
623;22.07.2018;2018;07;14;Sunnuntai;26;32;58
623;22.07.2018;2018;07;15;Sunnuntai;31;34;65
623;22.07.2018;2018;07;16;Sunnuntai;33;32;65
623;22.07.2018;2018;07;17;Sunnuntai;28;25;53
623;22.07.2018;2018;07;18;Sunnuntai;21;20;41
623;22.07.2018;2018;07;19;Sunnuntai;34;25;59
623;22.07.2018;2018;07;20;Sunnuntai;25;17;42
623;22.07.2018;2018;07;21;Sunnuntai;9;13;22
623;22.07.2018;2018;07;22;Sunnuntai;26;17;43
623;22.07.2018;2018;07;23;Sunnuntai;18;15;33
623;23.07.2018;2018;07;00;Maanantai;7;4;11
623;23.07.2018;2018;07;01;Maanantai;8;6;14
623;23.07.2018;2018;07;02;Maanantai;6;2;8
623;23.07.2018;2018;07;03;Maanantai;4;2;6
623;23.07.2018;2018;07;04;Maanantai;2;3;5
623;23.07.2018;2018;07;05;Maanantai;3;2;5
623;23.07.2018;2018;07;06;Maanantai;1;10;11
623;23.07.2018;2018;07;07;Maanantai;8;47;55
623;23.07.2018;2018;07;08;Maanantai;20;59;79
623;23.07.2018;2018;07;09;Maanantai;34;68;102
623;23.07.2018;2018;07;10;Maanantai;26;47;73
623;23.07.2018;2018;07;11;Maanantai;31;56;87
623;23.07.2018;2018;07;12;Maanantai;32;60;92
623;23.07.2018;2018;07;13;Maanantai;42;72;114
623;23.07.2018;2018;07;14;Maanantai;49;71;120
623;23.07.2018;2018;07;15;Maanantai;74;75;149
623;23.07.2018;2018;07;16;Maanantai;91;65;156
623;23.07.2018;2018;07;17;Maanantai;111;88;199
623;23.07.2018;2018;07;18;Maanantai;100;73;173
623;23.07.2018;2018;07;19;Maanantai;64;55;119
623;23.07.2018;2018;07;20;Maanantai;70;58;128
623;23.07.2018;2018;07;21;Maanantai;73;37;110
623;23.07.2018;2018;07;22;Maanantai;45;26;71
623;23.07.2018;2018;07;23;Maanantai;31;15;46
623;24.07.2018;2018;07;00;Tiistai;22;11;33
623;24.07.2018;2018;07;01;Tiistai;11;4;15
623;24.07.2018;2018;07;02;Tiistai;10;4;14
623;24.07.2018;2018;07;03;Tiistai;4;4;8
623;24.07.2018;2018;07;04;Tiistai;4;2;6
623;24.07.2018;2018;07;05;Tiistai;3;3;6
623;24.07.2018;2018;07;06;Tiistai;3;14;17
623;24.07.2018;2018;07;07;Tiistai;9;40;49
623;24.07.2018;2018;07;08;Tiistai;19;71;90
623;24.07.2018;2018;07;09;Tiistai;28;78;106
623;24.07.2018;2018;07;10;Tiistai;30;71;101
623;24.07.2018;2018;07;11;Tiistai;27;59;86
623;24.07.2018;2018;07;12;Tiistai;50;69;119
623;24.07.2018;2018;07;13;Tiistai;71;85;156
623;24.07.2018;2018;07;14;Tiistai;73;78;151
623;24.07.2018;2018;07;15;Tiistai;75;65;140
623;24.07.2018;2018;07;16;Tiistai;105;87;192
623;24.07.2018;2018;07;17;Tiistai;124;81;205
623;24.07.2018;2018;07;18;Tiistai;107;89;196
623;24.07.2018;2018;07;19;Tiistai;71;65;136
623;24.07.2018;2018;07;20;Tiistai;85;51;136
623;24.07.2018;2018;07;21;Tiistai;61;46;107
623;24.07.2018;2018;07;22;Tiistai;55;38;93
623;24.07.2018;2018;07;23;Tiistai;35;21;56
623;25.07.2018;2018;07;00;Keskiviikko;23;5;28
623;25.07.2018;2018;07;01;Keskiviikko;8;6;14
623;25.07.2018;2018;07;02;Keskiviikko;8;5;13
623;25.07.2018;2018;07;03;Keskiviikko;9;2;11
623;25.07.2018;2018;07;04;Keskiviikko;1;1;2
623;25.07.2018;2018;07;05;Keskiviikko;4;5;9
623;25.07.2018;2018;07;06;Keskiviikko;2;10;12
623;25.07.2018;2018;07;07;Keskiviikko;11;46;57
623;25.07.2018;2018;07;08;Keskiviikko;19;71;90
623;25.07.2018;2018;07;09;Keskiviikko;30;65;95
623;25.07.2018;2018;07;10;Keskiviikko;26;62;88
623;25.07.2018;2018;07;11;Keskiviikko;30;69;99
623;25.07.2018;2018;07;12;Keskiviikko;33;64;97
623;25.07.2018;2018;07;13;Keskiviikko;65;82;147
623;25.07.2018;2018;07;14;Keskiviikko;72;73;145
623;25.07.2018;2018;07;15;Keskiviikko;93;71;164
623;25.07.2018;2018;07;16;Keskiviikko;96;73;169
623;25.07.2018;2018;07;17;Keskiviikko;130;102;232
623;25.07.2018;2018;07;18;Keskiviikko;82;92;174
623;25.07.2018;2018;07;19;Keskiviikko;77;72;149
623;25.07.2018;2018;07;20;Keskiviikko;55;58;113
623;25.07.2018;2018;07;21;Keskiviikko;57;48;105
623;25.07.2018;2018;07;22;Keskiviikko;70;25;95
623;25.07.2018;2018;07;23;Keskiviikko;42;15;57
623;26.07.2018;2018;07;00;Torstai;31;12;43
623;26.07.2018;2018;07;01;Torstai;11;5;16
623;26.07.2018;2018;07;02;Torstai;6;6;12
623;26.07.2018;2018;07;03;Torstai;10;2;12
623;26.07.2018;2018;07;04;Torstai;8;0;8
623;26.07.2018;2018;07;05;Torstai;2;1;3
623;26.07.2018;2018;07;06;Torstai;3;13;16
623;26.07.2018;2018;07;07;Torstai;12;51;63
623;26.07.2018;2018;07;08;Torstai;15;66;81
623;26.07.2018;2018;07;09;Torstai;28;67;95
623;26.07.2018;2018;07;10;Torstai;26;58;84
623;26.07.2018;2018;07;11;Torstai;26;45;71
623;26.07.2018;2018;07;12;Torstai;26;66;92
623;26.07.2018;2018;07;13;Torstai;36;72;108
623;26.07.2018;2018;07;14;Torstai;59;61;120
623;26.07.2018;2018;07;15;Torstai;77;71;148
623;26.07.2018;2018;07;16;Torstai;111;80;191
623;26.07.2018;2018;07;17;Torstai;122;94;216
623;26.07.2018;2018;07;18;Torstai;77;73;150
623;26.07.2018;2018;07;19;Torstai;70;82;152
623;26.07.2018;2018;07;20;Torstai;58;57;115
623;26.07.2018;2018;07;21;Torstai;68;61;129
623;26.07.2018;2018;07;22;Torstai;53;30;83
623;26.07.2018;2018;07;23;Torstai;44;28;72
623;27.07.2018;2018;07;00;Perjantai;20;10;30
623;27.07.2018;2018;07;01;Perjantai;21;8;29
623;27.07.2018;2018;07;02;Perjantai;3;2;5
623;27.07.2018;2018;07;03;Perjantai;7;3;10
623;27.07.2018;2018;07;04;Perjantai;7;4;11
623;27.07.2018;2018;07;05;Perjantai;4;2;6
623;27.07.2018;2018;07;06;Perjantai;3;14;17
623;27.07.2018;2018;07;07;Perjantai;10;31;41
623;27.07.2018;2018;07;08;Perjantai;14;67;81
623;27.07.2018;2018;07;09;Perjantai;27;54;81
623;27.07.2018;2018;07;10;Perjantai;18;68;86
623;27.07.2018;2018;07;11;Perjantai;29;60;89
623;27.07.2018;2018;07;12;Perjantai;41;68;109
623;27.07.2018;2018;07;13;Perjantai;52;84;136
623;27.07.2018;2018;07;14;Perjantai;69;102;171
623;27.07.2018;2018;07;15;Perjantai;98;109;207
623;27.07.2018;2018;07;16;Perjantai;108;110;218
623;27.07.2018;2018;07;17;Perjantai;103;124;227
623;27.07.2018;2018;07;18;Perjantai;87;109;196
623;27.07.2018;2018;07;19;Perjantai;67;92;159
623;27.07.2018;2018;07;20;Perjantai;55;87;142
623;27.07.2018;2018;07;21;Perjantai;73;83;156
623;27.07.2018;2018;07;22;Perjantai;68;36;104
623;27.07.2018;2018;07;23;Perjantai;58;39;97
623;28.07.2018;2018;07;00;Lauantai;72;28;100
623;28.07.2018;2018;07;01;Lauantai;107;22;129
623;28.07.2018;2018;07;02;Lauantai;125;20;145
623;28.07.2018;2018;07;03;Lauantai;70;6;76
623;28.07.2018;2018;07;04;Lauantai;29;3;32
623;28.07.2018;2018;07;05;Lauantai;23;2;25
623;28.07.2018;2018;07;06;Lauantai;9;4;13
623;28.07.2018;2018;07;07;Lauantai;4;9;13
623;28.07.2018;2018;07;08;Lauantai;2;8;10
623;28.07.2018;2018;07;09;Lauantai;8;11;19
623;28.07.2018;2018;07;10;Lauantai;7;41;48
623;28.07.2018;2018;07;11;Lauantai;18;42;60
623;28.07.2018;2018;07;12;Lauantai;26;62;88
623;28.07.2018;2018;07;13;Lauantai;36;106;142
623;28.07.2018;2018;07;14;Lauantai;42;96;138
623;28.07.2018;2018;07;15;Lauantai;55;94;149
623;28.07.2018;2018;07;16;Lauantai;64;74;138
623;28.07.2018;2018;07;17;Lauantai;52;77;129
623;28.07.2018;2018;07;18;Lauantai;65;92;157
623;28.07.2018;2018;07;19;Lauantai;65;88;153
623;28.07.2018;2018;07;20;Lauantai;57;89;146
623;28.07.2018;2018;07;21;Lauantai;47;53;100
623;28.07.2018;2018;07;22;Lauantai;51;50;101
623;28.07.2018;2018;07;23;Lauantai;43;28;71
623;29.07.2018;2018;07;00;Sunnuntai;47;25;72
623;29.07.2018;2018;07;01;Sunnuntai;91;14;105
623;29.07.2018;2018;07;02;Sunnuntai;126;25;151
623;29.07.2018;2018;07;03;Sunnuntai;61;5;66
623;29.07.2018;2018;07;04;Sunnuntai;52;6;58
623;29.07.2018;2018;07;05;Sunnuntai;35;3;38
623;29.07.2018;2018;07;06;Sunnuntai;16;2;18
623;29.07.2018;2018;07;07;Sunnuntai;6;5;11
623;29.07.2018;2018;07;08;Sunnuntai;4;7;11
623;29.07.2018;2018;07;09;Sunnuntai;12;9;21
623;29.07.2018;2018;07;10;Sunnuntai;12;33;45
623;29.07.2018;2018;07;11;Sunnuntai;22;35;57
623;29.07.2018;2018;07;12;Sunnuntai;25;48;73
623;29.07.2018;2018;07;13;Sunnuntai;45;68;113
623;29.07.2018;2018;07;14;Sunnuntai;51;78;129
623;29.07.2018;2018;07;15;Sunnuntai;59;60;119
623;29.07.2018;2018;07;16;Sunnuntai;52;52;104
623;29.07.2018;2018;07;17;Sunnuntai;59;59;118
623;29.07.2018;2018;07;18;Sunnuntai;66;60;126
623;29.07.2018;2018;07;19;Sunnuntai;66;55;121
623;29.07.2018;2018;07;20;Sunnuntai;56;41;97
623;29.07.2018;2018;07;21;Sunnuntai;51;43;94
623;29.07.2018;2018;07;22;Sunnuntai;51;31;82
623;29.07.2018;2018;07;23;Sunnuntai;18;15;33
623;30.07.2018;2018;07;00;Maanantai;17;9;26
623;30.07.2018;2018;07;01;Maanantai;11;2;13
623;30.07.2018;2018;07;02;Maanantai;8;4;12
623;30.07.2018;2018;07;03;Maanantai;1;1;2
623;30.07.2018;2018;07;04;Maanantai;2;2;4
623;30.07.2018;2018;07;05;Maanantai;3;4;7
623;30.07.2018;2018;07;06;Maanantai;7;13;20
623;30.07.2018;2018;07;07;Maanantai;10;64;74
623;30.07.2018;2018;07;08;Maanantai;35;93;128
623;30.07.2018;2018;07;09;Maanantai;35;87;122
623;30.07.2018;2018;07;10;Maanantai;26;76;102
623;30.07.2018;2018;07;11;Maanantai;37;51;88
623;30.07.2018;2018;07;12;Maanantai;41;53;94
623;30.07.2018;2018;07;13;Maanantai;48;57;105
623;30.07.2018;2018;07;14;Maanantai;61;69;130
623;30.07.2018;2018;07;15;Maanantai;77;61;138
623;30.07.2018;2018;07;16;Maanantai;109;71;180
623;30.07.2018;2018;07;17;Maanantai;130;84;214
623;30.07.2018;2018;07;18;Maanantai;68;52;120
623;30.07.2018;2018;07;19;Maanantai;79;52;131
623;30.07.2018;2018;07;20;Maanantai;64;57;121
623;30.07.2018;2018;07;21;Maanantai;37;39;76
623;30.07.2018;2018;07;22;Maanantai;51;23;74
623;30.07.2018;2018;07;23;Maanantai;30;17;47
623;31.07.2018;2018;07;00;Tiistai;25;4;29
623;31.07.2018;2018;07;01;Tiistai;10;5;15
623;31.07.2018;2018;07;02;Tiistai;3;5;8
623;31.07.2018;2018;07;03;Tiistai;5;1;6
623;31.07.2018;2018;07;04;Tiistai;0;2;2
623;31.07.2018;2018;07;05;Tiistai;1;5;6
623;31.07.2018;2018;07;06;Tiistai;2;4;6
623;31.07.2018;2018;07;07;Tiistai;7;47;54
623;31.07.2018;2018;07;08;Tiistai;26;91;117
623;31.07.2018;2018;07;09;Tiistai;40;99;139
623;31.07.2018;2018;07;10;Tiistai;24;44;68
623;31.07.2018;2018;07;11;Tiistai;37;59;96
623;31.07.2018;2018;07;12;Tiistai;35;48;83
623;31.07.2018;2018;07;13;Tiistai;40;75;115
623;31.07.2018;2018;07;14;Tiistai;52;64;116
623;31.07.2018;2018;07;15;Tiistai;73;63;136
623;31.07.2018;2018;07;16;Tiistai;126;63;189
623;31.07.2018;2018;07;17;Tiistai;135;92;227
623;31.07.2018;2018;07;18;Tiistai;81;65;146
623;31.07.2018;2018;07;19;Tiistai;73;68;141
623;31.07.2018;2018;07;20;Tiistai;59;48;107
623;31.07.2018;2018;07;21;Tiistai;57;41;98
623;31.07.2018;2018;07;22;Tiistai;63;24;87
623;31.07.2018;2018;07;23;Tiistai;27;11;38
623;01.08.2018;2018;08;00;Keskiviikko;20;10;30
623;01.08.2018;2018;08;01;Keskiviikko;13;5;18
623;01.08.2018;2018;08;02;Keskiviikko;6;3;9
623;01.08.2018;2018;08;03;Keskiviikko;3;1;4
623;01.08.2018;2018;08;04;Keskiviikko;2;1;3
623;01.08.2018;2018;08;05;Keskiviikko;6;4;10
623;01.08.2018;2018;08;06;Keskiviikko;1;9;10
623;01.08.2018;2018;08;07;Keskiviikko;9;47;56
623;01.08.2018;2018;08;08;Keskiviikko;36;86;122
623;01.08.2018;2018;08;09;Keskiviikko;36;97;133
623;01.08.2018;2018;08;10;Keskiviikko;20;71;91
623;01.08.2018;2018;08;11;Keskiviikko;24;36;60
623;01.08.2018;2018;08;12;Keskiviikko;35;56;91
623;01.08.2018;2018;08;13;Keskiviikko;61;72;133
623;01.08.2018;2018;08;14;Keskiviikko;47;61;108
623;01.08.2018;2018;08;15;Keskiviikko;48;60;108
623;01.08.2018;2018;08;16;Keskiviikko;110;76;186
623;01.08.2018;2018;08;17;Keskiviikko;142;68;210
623;01.08.2018;2018;08;18;Keskiviikko;60;50;110
623;01.08.2018;2018;08;19;Keskiviikko;58;60;118
623;01.08.2018;2018;08;20;Keskiviikko;54;59;113
623;01.08.2018;2018;08;21;Keskiviikko;40;27;67
623;01.08.2018;2018;08;22;Keskiviikko;57;36;93
623;01.08.2018;2018;08;23;Keskiviikko;29;26;55
623;02.08.2018;2018;08;00;Torstai;27;11;38
623;02.08.2018;2018;08;01;Torstai;17;3;20
623;02.08.2018;2018;08;02;Torstai;14;0;14
623;02.08.2018;2018;08;03;Torstai;12;0;12
623;02.08.2018;2018;08;04;Torstai;6;0;6
623;02.08.2018;2018;08;05;Torstai;7;0;7
623;02.08.2018;2018;08;06;Torstai;14;0;14
623;02.08.2018;2018;08;07;Torstai;54;0;54
623;02.08.2018;2018;08;08;Torstai;85;0;85
623;02.08.2018;2018;08;09;Torstai;94;0;94
623;02.08.2018;2018;08;10;Torstai;74;0;74
623;02.08.2018;2018;08;11;Torstai;87;0;87
623;02.08.2018;2018;08;12;Torstai;83;0;83
623;02.08.2018;2018;08;13;Torstai;109;0;109
623;02.08.2018;2018;08;14;Torstai;147;0;147
623;02.08.2018;2018;08;15;Torstai;130;0;130
623;02.08.2018;2018;08;16;Torstai;165;0;165
623;02.08.2018;2018;08;17;Torstai;204;0;204
623;02.08.2018;2018;08;18;Torstai;141;0;141
623;02.08.2018;2018;08;19;Torstai;111;0;111
623;02.08.2018;2018;08;20;Torstai;119;0;119
623;02.08.2018;2018;08;21;Torstai;77;0;77
623;02.08.2018;2018;08;22;Torstai;96;0;96
623;02.08.2018;2018;08;23;Torstai;56;0;56
623;03.08.2018;2018;08;00;Perjantai;32;0;32
623;03.08.2018;2018;08;01;Perjantai;14;0;14
623;03.08.2018;2018;08;02;Perjantai;11;0;11
623;03.08.2018;2018;08;03;Perjantai;7;0;7
623;03.08.2018;2018;08;04;Perjantai;6;0;6
623;03.08.2018;2018;08;05;Perjantai;7;0;7
623;03.08.2018;2018;08;06;Perjantai;18;0;18
623;03.08.2018;2018;08;07;Perjantai;54;0;54
623;03.08.2018;2018;08;08;Perjantai;91;0;91
623;03.08.2018;2018;08;09;Perjantai;80;0;80
623;03.08.2018;2018;08;10;Perjantai;85;0;85
623;03.08.2018;2018;08;11;Perjantai;79;0;79
623;03.08.2018;2018;08;12;Perjantai;83;0;83
623;03.08.2018;2018;08;13;Perjantai;81;0;81
623;03.08.2018;2018;08;14;Perjantai;122;0;122
623;03.08.2018;2018;08;15;Perjantai;144;0;144
623;03.08.2018;2018;08;16;Perjantai;168;0;168
623;03.08.2018;2018;08;17;Perjantai;145;0;145
623;03.08.2018;2018;08;18;Perjantai;131;0;131
623;03.08.2018;2018;08;19;Perjantai;126;0;126
623;03.08.2018;2018;08;20;Perjantai;120;0;120
623;03.08.2018;2018;08;21;Perjantai;111;0;111
623;03.08.2018;2018;08;22;Perjantai;88;0;88
623;03.08.2018;2018;08;23;Perjantai;66;0;66
623;04.08.2018;2018;08;00;Lauantai;34;0;34
623;04.08.2018;2018;08;01;Lauantai;32;0;32
623;04.08.2018;2018;08;02;Lauantai;32;0;32
623;04.08.2018;2018;08;03;Lauantai;17;0;17
623;04.08.2018;2018;08;04;Lauantai;19;0;19
623;04.08.2018;2018;08;05;Lauantai;15;0;15
623;04.08.2018;2018;08;06;Lauantai;13;0;13
623;04.08.2018;2018;08;07;Lauantai;15;0;15
623;04.08.2018;2018;08;08;Lauantai;20;0;20
623;04.08.2018;2018;08;09;Lauantai;30;0;30
623;04.08.2018;2018;08;10;Lauantai;37;0;37
623;04.08.2018;2018;08;11;Lauantai;67;0;67
623;04.08.2018;2018;08;12;Lauantai;61;0;61
623;04.08.2018;2018;08;13;Lauantai;81;0;81
623;04.08.2018;2018;08;14;Lauantai;74;0;74
623;04.08.2018;2018;08;15;Lauantai;70;0;70
623;04.08.2018;2018;08;16;Lauantai;68;0;68
623;04.08.2018;2018;08;17;Lauantai;63;0;63
623;04.08.2018;2018;08;18;Lauantai;61;0;61
623;04.08.2018;2018;08;19;Lauantai;82;0;82
623;04.08.2018;2018;08;20;Lauantai;74;0;74
623;04.08.2018;2018;08;21;Lauantai;54;0;54
623;04.08.2018;2018;08;22;Lauantai;71;0;71
623;04.08.2018;2018;08;23;Lauantai;33;0;33
623;05.08.2018;2018;08;00;Sunnuntai;23;0;23
623;05.08.2018;2018;08;01;Sunnuntai;25;0;25
623;05.08.2018;2018;08;02;Sunnuntai;25;0;25
623;05.08.2018;2018;08;03;Sunnuntai;32;0;32
623;05.08.2018;2018;08;04;Sunnuntai;19;0;19
623;05.08.2018;2018;08;05;Sunnuntai;13;0;13
623;05.08.2018;2018;08;06;Sunnuntai;5;0;5
623;05.08.2018;2018;08;07;Sunnuntai;12;0;12
623;05.08.2018;2018;08;08;Sunnuntai;14;0;14
623;05.08.2018;2018;08;09;Sunnuntai;16;0;16
623;05.08.2018;2018;08;10;Sunnuntai;38;0;38
623;05.08.2018;2018;08;11;Sunnuntai;25;0;25
623;05.08.2018;2018;08;12;Sunnuntai;58;0;58
623;05.08.2018;2018;08;13;Sunnuntai;64;0;64
623;05.08.2018;2018;08;14;Sunnuntai;58;0;58
623;05.08.2018;2018;08;15;Sunnuntai;65;0;65
623;05.08.2018;2018;08;16;Sunnuntai;65;0;65
623;05.08.2018;2018;08;17;Sunnuntai;53;0;53
623;05.08.2018;2018;08;18;Sunnuntai;41;0;41
623;05.08.2018;2018;08;19;Sunnuntai;59;0;59
623;05.08.2018;2018;08;20;Sunnuntai;42;0;42
623;05.08.2018;2018;08;21;Sunnuntai;22;0;22
623;05.08.2018;2018;08;22;Sunnuntai;43;0;43
623;05.08.2018;2018;08;23;Sunnuntai;33;0;33
623;06.08.2018;2018;08;00;Maanantai;0;0;0
623;06.08.2018;2018;08;01;Maanantai;0;0;0
623;06.08.2018;2018;08;02;Maanantai;0;0;0
623;06.08.2018;2018;08;03;Maanantai;0;0;0
623;06.08.2018;2018;08;04;Maanantai;0;0;0
623;06.08.2018;2018;08;05;Maanantai;5;5;10
623;06.08.2018;2018;08;06;Maanantai;10;10;20
623;06.08.2018;2018;08;07;Maanantai;20;20;40
623;06.08.2018;2018;08;08;Maanantai;25;40;65
623;06.08.2018;2018;08;09;Maanantai;26;51;77
623;06.08.2018;2018;08;10;Maanantai;30;40;70
623;06.08.2018;2018;08;11;Maanantai;24;33;57
623;06.08.2018;2018;08;12;Maanantai;24;21;45
623;06.08.2018;2018;08;13;Maanantai;8;9;17
623;06.08.2018;2018;08;14;Maanantai;19;20;39
623;06.08.2018;2018;08;15;Maanantai;40;29;69
623;06.08.2018;2018;08;16;Maanantai;61;46;107
623;06.08.2018;2018;08;17;Maanantai;92;75;167
623;06.08.2018;2018;08;18;Maanantai;56;48;104
623;06.08.2018;2018;08;19;Maanantai;50;32;82
623;06.08.2018;2018;08;20;Maanantai;43;41;84
623;06.08.2018;2018;08;21;Maanantai;36;34;70
623;06.08.2018;2018;08;22;Maanantai;34;18;52
623;06.08.2018;2018;08;23;Maanantai;17;6;23
623;07.08.2018;2018;08;00;Tiistai;12;2;14
623;07.08.2018;2018;08;01;Tiistai;4;3;7
623;07.08.2018;2018;08;02;Tiistai;2;3;5
623;07.08.2018;2018;08;03;Tiistai;2;5;7
623;07.08.2018;2018;08;04;Tiistai;2;2;4
623;07.08.2018;2018;08;05;Tiistai;2;6;8
623;07.08.2018;2018;08;06;Tiistai;3;11;14
623;07.08.2018;2018;08;07;Tiistai;11;66;77
623;07.08.2018;2018;08;08;Tiistai;60;137;197
623;07.08.2018;2018;08;09;Tiistai;66;129;195
623;07.08.2018;2018;08;10;Tiistai;37;56;93
623;07.08.2018;2018;08;11;Tiistai;35;60;95
623;07.08.2018;2018;08;12;Tiistai;42;47;89
623;07.08.2018;2018;08;13;Tiistai;43;70;113
623;07.08.2018;2018;08;14;Tiistai;61;46;107
623;07.08.2018;2018;08;15;Tiistai;80;73;153
623;07.08.2018;2018;08;16;Tiistai;115;69;184
623;07.08.2018;2018;08;17;Tiistai;169;124;293
623;07.08.2018;2018;08;18;Tiistai;87;69;156
623;07.08.2018;2018;08;19;Tiistai;87;68;155
623;07.08.2018;2018;08;20;Tiistai;74;56;130
623;07.08.2018;2018;08;21;Tiistai;64;40;104
623;07.08.2018;2018;08;22;Tiistai;50;30;80
623;07.08.2018;2018;08;23;Tiistai;27;12;39
623;08.08.2018;2018;08;00;Keskiviikko;17;9;26
623;08.08.2018;2018;08;01;Keskiviikko;10;5;15
623;08.08.2018;2018;08;02;Keskiviikko;7;4;11
623;08.08.2018;2018;08;03;Keskiviikko;3;3;6
623;08.08.2018;2018;08;04;Keskiviikko;0;1;1
623;08.08.2018;2018;08;05;Keskiviikko;5;6;11
623;08.08.2018;2018;08;06;Keskiviikko;1;11;12
623;08.08.2018;2018;08;07;Keskiviikko;13;64;77
623;08.08.2018;2018;08;08;Keskiviikko;65;129;194
623;08.08.2018;2018;08;09;Keskiviikko;75;117;192
623;08.08.2018;2018;08;10;Keskiviikko;29;66;95
623;08.08.2018;2018;08;11;Keskiviikko;43;60;103
623;08.08.2018;2018;08;12;Keskiviikko;42;62;104
623;08.08.2018;2018;08;13;Keskiviikko;45;59;104
623;08.08.2018;2018;08;14;Keskiviikko;57;59;116
623;08.08.2018;2018;08;15;Keskiviikko;87;83;170
623;08.08.2018;2018;08;16;Keskiviikko;136;77;213
623;08.08.2018;2018;08;17;Keskiviikko;174;124;298
623;08.08.2018;2018;08;18;Keskiviikko;111;106;217
623;08.08.2018;2018;08;19;Keskiviikko;69;78;147
623;08.08.2018;2018;08;20;Keskiviikko;49;42;91
623;08.08.2018;2018;08;21;Keskiviikko;68;36;104
623;08.08.2018;2018;08;22;Keskiviikko;63;26;89
623;08.08.2018;2018;08;23;Keskiviikko;27;18;45
623;09.08.2018;2018;08;00;Torstai;10;9;19
623;09.08.2018;2018;08;01;Torstai;13;1;14
623;09.08.2018;2018;08;02;Torstai;3;4;7
623;09.08.2018;2018;08;03;Torstai;5;1;6
623;09.08.2018;2018;08;04;Torstai;2;2;4
623;09.08.2018;2018;08;05;Torstai;6;4;10
623;09.08.2018;2018;08;06;Torstai;3;11;14
623;09.08.2018;2018;08;07;Torstai;13;54;67
623;09.08.2018;2018;08;08;Torstai;58;117;175
623;09.08.2018;2018;08;09;Torstai;57;111;168
623;09.08.2018;2018;08;10;Torstai;38;75;113
623;09.08.2018;2018;08;11;Torstai;30;67;97
623;09.08.2018;2018;08;12;Torstai;60;54;114
623;09.08.2018;2018;08;13;Torstai;75;43;118
623;09.08.2018;2018;08;14;Torstai;60;43;103
623;09.08.2018;2018;08;15;Torstai;59;48;107
623;09.08.2018;2018;08;16;Torstai;129;79;208
623;09.08.2018;2018;08;17;Torstai;118;73;191
623;09.08.2018;2018;08;18;Torstai;84;71;155
623;09.08.2018;2018;08;19;Torstai;70;52;122
623;09.08.2018;2018;08;20;Torstai;59;42;101
623;09.08.2018;2018;08;21;Torstai;38;27;65
623;09.08.2018;2018;08;22;Torstai;29;15;44
623;09.08.2018;2018;08;23;Torstai;25;8;33
623;10.08.2018;2018;08;00;Perjantai;17;7;24
623;10.08.2018;2018;08;01;Perjantai;8;11;19
623;10.08.2018;2018;08;02;Perjantai;2;2;4
623;10.08.2018;2018;08;03;Perjantai;3;3;6
623;10.08.2018;2018;08;04;Perjantai;3;3;6
623;10.08.2018;2018;08;05;Perjantai;1;5;6
623;10.08.2018;2018;08;06;Perjantai;1;9;10
623;10.08.2018;2018;08;07;Perjantai;15;63;78
623;10.08.2018;2018;08;08;Perjantai;47;130;177
623;10.08.2018;2018;08;09;Perjantai;82;177;259
623;10.08.2018;2018;08;10;Perjantai;40;58;98
623;10.08.2018;2018;08;11;Perjantai;46;56;102
623;10.08.2018;2018;08;12;Perjantai;53;56;109
623;10.08.2018;2018;08;13;Perjantai;73;70;143
623;10.08.2018;2018;08;14;Perjantai;79;57;136
623;10.08.2018;2018;08;15;Perjantai;103;59;162
623;10.08.2018;2018;08;16;Perjantai;97;89;186
623;10.08.2018;2018;08;17;Perjantai;120;85;205
623;10.08.2018;2018;08;18;Perjantai;87;74;161
623;10.08.2018;2018;08;19;Perjantai;71;52;123
623;10.08.2018;2018;08;20;Perjantai;47;16;63
623;10.08.2018;2018;08;21;Perjantai;23;19;42
623;10.08.2018;2018;08;22;Perjantai;16;10;26
623;10.08.2018;2018;08;23;Perjantai;12;10;22
623;11.08.2018;2018;08;00;Lauantai;8;13;21
623;11.08.2018;2018;08;01;Lauantai;10;3;13
623;11.08.2018;2018;08;02;Lauantai;6;6;12
623;11.08.2018;2018;08;03;Lauantai;6;1;7
623;11.08.2018;2018;08;04;Lauantai;8;2;10
623;11.08.2018;2018;08;05;Lauantai;7;3;10
623;11.08.2018;2018;08;06;Lauantai;2;2;4
623;11.08.2018;2018;08;07;Lauantai;4;9;13
623;11.08.2018;2018;08;08;Lauantai;3;7;10
623;11.08.2018;2018;08;09;Lauantai;10;16;26
623;11.08.2018;2018;08;10;Lauantai;10;31;41
623;11.08.2018;2018;08;11;Lauantai;16;28;44
623;11.08.2018;2018;08;12;Lauantai;32;52;84
623;11.08.2018;2018;08;13;Lauantai;35;37;72
623;11.08.2018;2018;08;14;Lauantai;37;44;81
623;11.08.2018;2018;08;15;Lauantai;32;37;69
623;11.08.2018;2018;08;16;Lauantai;45;26;71
623;11.08.2018;2018;08;17;Lauantai;50;34;84
623;11.08.2018;2018;08;18;Lauantai;31;23;54
623;11.08.2018;2018;08;19;Lauantai;43;39;82
623;11.08.2018;2018;08;20;Lauantai;24;31;55
623;11.08.2018;2018;08;21;Lauantai;25;23;48
623;11.08.2018;2018;08;22;Lauantai;24;16;40
623;11.08.2018;2018;08;23;Lauantai;12;19;31
623;12.08.2018;2018;08;00;Sunnuntai;11;9;20
623;12.08.2018;2018;08;01;Sunnuntai;16;9;25
623;12.08.2018;2018;08;02;Sunnuntai;21;15;36
623;12.08.2018;2018;08;03;Sunnuntai;11;1;12
623;12.08.2018;2018;08;04;Sunnuntai;9;1;10
623;12.08.2018;2018;08;05;Sunnuntai;10;2;12
623;12.08.2018;2018;08;06;Sunnuntai;4;3;7
623;12.08.2018;2018;08;07;Sunnuntai;3;5;8
623;12.08.2018;2018;08;08;Sunnuntai;6;4;10
623;12.08.2018;2018;08;09;Sunnuntai;3;8;11
623;12.08.2018;2018;08;10;Sunnuntai;18;22;40
623;12.08.2018;2018;08;11;Sunnuntai;17;30;47
623;12.08.2018;2018;08;12;Sunnuntai;26;46;72
623;12.08.2018;2018;08;13;Sunnuntai;34;53;87
623;12.08.2018;2018;08;14;Sunnuntai;41;59;100
623;12.08.2018;2018;08;15;Sunnuntai;47;39;86
623;12.08.2018;2018;08;16;Sunnuntai;42;51;93
623;12.08.2018;2018;08;17;Sunnuntai;40;52;92
623;12.08.2018;2018;08;18;Sunnuntai;34;34;68
623;12.08.2018;2018;08;19;Sunnuntai;42;36;78
623;12.08.2018;2018;08;20;Sunnuntai;49;24;73
623;12.08.2018;2018;08;21;Sunnuntai;38;17;55
623;12.08.2018;2018;08;22;Sunnuntai;24;18;42
623;12.08.2018;2018;08;23;Sunnuntai;9;9;18
623;13.08.2018;2018;08;00;Maanantai;10;8;18
623;13.08.2018;2018;08;01;Maanantai;6;0;6
623;13.08.2018;2018;08;02;Maanantai;1;1;2
623;13.08.2018;2018;08;03;Maanantai;0;1;1
623;13.08.2018;2018;08;04;Maanantai;0;4;4
623;13.08.2018;2018;08;05;Maanantai;3;8;11
623;13.08.2018;2018;08;06;Maanantai;1;14;15
623;13.08.2018;2018;08;07;Maanantai;18;40;58
623;13.08.2018;2018;08;08;Maanantai;52;126;178
623;13.08.2018;2018;08;09;Maanantai;75;175;250
623;13.08.2018;2018;08;10;Maanantai;39;69;108
623;13.08.2018;2018;08;11;Maanantai;16;51;67
623;13.08.2018;2018;08;12;Maanantai;54;40;94
623;13.08.2018;2018;08;13;Maanantai;48;46;94
623;13.08.2018;2018;08;14;Maanantai;41;37;78
623;13.08.2018;2018;08;15;Maanantai;92;49;141
623;13.08.2018;2018;08;16;Maanantai;104;51;155
623;13.08.2018;2018;08;17;Maanantai;128;70;198
623;13.08.2018;2018;08;18;Maanantai;70;56;126
623;13.08.2018;2018;08;19;Maanantai;45;39;84
623;13.08.2018;2018;08;20;Maanantai;38;28;66
623;13.08.2018;2018;08;21;Maanantai;53;17;70
623;13.08.2018;2018;08;22;Maanantai;28;12;40
623;13.08.2018;2018;08;23;Maanantai;9;8;17
623;14.08.2018;2018;08;00;Tiistai;6;4;10
623;14.08.2018;2018;08;01;Tiistai;4;3;7
623;14.08.2018;2018;08;02;Tiistai;3;2;5
623;14.08.2018;2018;08;03;Tiistai;1;3;4
623;14.08.2018;2018;08;04;Tiistai;1;3;4
623;14.08.2018;2018;08;05;Tiistai;0;7;7
623;14.08.2018;2018;08;06;Tiistai;1;12;13
623;14.08.2018;2018;08;07;Tiistai;13;53;66
623;14.08.2018;2018;08;08;Tiistai;76;160;236
623;14.08.2018;2018;08;09;Tiistai;104;184;288
623;14.08.2018;2018;08;10;Tiistai;34;88;122
623;14.08.2018;2018;08;11;Tiistai;34;53;87
623;14.08.2018;2018;08;12;Tiistai;55;56;111
623;14.08.2018;2018;08;13;Tiistai;53;51;104
623;14.08.2018;2018;08;14;Tiistai;70;45;115
623;14.08.2018;2018;08;15;Tiistai;104;54;158
623;14.08.2018;2018;08;16;Tiistai;111;65;176
623;14.08.2018;2018;08;17;Tiistai;185;97;282
623;14.08.2018;2018;08;18;Tiistai;85;68;153
623;14.08.2018;2018;08;19;Tiistai;60;49;109
623;14.08.2018;2018;08;20;Tiistai;61;46;107
623;14.08.2018;2018;08;21;Tiistai;59;33;92
623;14.08.2018;2018;08;22;Tiistai;35;14;49
623;14.08.2018;2018;08;23;Tiistai;23;14;37
623;15.08.2018;2018;08;00;Keskiviikko;7;5;12
623;15.08.2018;2018;08;01;Keskiviikko;7;4;11
623;15.08.2018;2018;08;02;Keskiviikko;7;6;13
623;15.08.2018;2018;08;03;Keskiviikko;2;5;7
623;15.08.2018;2018;08;04;Keskiviikko;2;4;6
623;15.08.2018;2018;08;05;Keskiviikko;0;8;8
623;15.08.2018;2018;08;06;Keskiviikko;2;18;20
623;15.08.2018;2018;08;07;Keskiviikko;9;53;62
623;15.08.2018;2018;08;08;Keskiviikko;65;146;211
623;15.08.2018;2018;08;09;Keskiviikko;86;188;274
623;15.08.2018;2018;08;10;Keskiviikko;47;92;139
623;15.08.2018;2018;08;11;Keskiviikko;41;53;94
623;15.08.2018;2018;08;12;Keskiviikko;42;50;92
623;15.08.2018;2018;08;13;Keskiviikko;52;61;113
623;15.08.2018;2018;08;14;Keskiviikko;76;84;160
623;15.08.2018;2018;08;15;Keskiviikko;116;51;167
623;15.08.2018;2018;08;16;Keskiviikko;119;65;184
623;15.08.2018;2018;08;17;Keskiviikko;183;101;284
623;15.08.2018;2018;08;18;Keskiviikko;117;76;193
623;15.08.2018;2018;08;19;Keskiviikko;69;51;120
623;15.08.2018;2018;08;20;Keskiviikko;67;41;108
623;15.08.2018;2018;08;21;Keskiviikko;48;29;77
623;15.08.2018;2018;08;22;Keskiviikko;36;19;55
623;15.08.2018;2018;08;23;Keskiviikko;17;11;28
623;16.08.2018;2018;08;00;Torstai;8;5;13
623;16.08.2018;2018;08;01;Torstai;6;4;10
623;16.08.2018;2018;08;02;Torstai;2;2;4
623;16.08.2018;2018;08;03;Torstai;2;4;6
623;16.08.2018;2018;08;04;Torstai;3;2;5
623;16.08.2018;2018;08;05;Torstai;4;5;9
623;16.08.2018;2018;08;06;Torstai;3;10;13
623;16.08.2018;2018;08;07;Torstai;18;57;75
623;16.08.2018;2018;08;08;Torstai;65;137;202
623;16.08.2018;2018;08;09;Torstai;85;174;259
623;16.08.2018;2018;08;10;Torstai;46;75;121
623;16.08.2018;2018;08;11;Torstai;37;49;86
623;16.08.2018;2018;08;12;Torstai;53;47;100
623;16.08.2018;2018;08;13;Torstai;52;72;124
623;16.08.2018;2018;08;14;Torstai;87;63;150
623;16.08.2018;2018;08;15;Torstai;113;75;188
623;16.08.2018;2018;08;16;Torstai;167;80;247
623;16.08.2018;2018;08;17;Torstai;156;94;250
623;16.08.2018;2018;08;18;Torstai;77;91;168
623;16.08.2018;2018;08;19;Torstai;77;73;150
623;16.08.2018;2018;08;20;Torstai;57;61;118
623;16.08.2018;2018;08;21;Torstai;80;32;112
623;16.08.2018;2018;08;22;Torstai;54;31;85
623;16.08.2018;2018;08;23;Torstai;63;16;79
623;17.08.2018;2018;08;00;Perjantai;33;7;40
623;17.08.2018;2018;08;01;Perjantai;19;3;22
623;17.08.2018;2018;08;02;Perjantai;12;3;15
623;17.08.2018;2018;08;03;Perjantai;10;2;12
623;17.08.2018;2018;08;04;Perjantai;9;1;10
623;17.08.2018;2018;08;05;Perjantai;2;6;8
623;17.08.2018;2018;08;06;Perjantai;3;12;15
623;17.08.2018;2018;08;07;Perjantai;15;37;52
623;17.08.2018;2018;08;08;Perjantai;55;128;183
623;17.08.2018;2018;08;09;Perjantai;76;123;199
623;17.08.2018;2018;08;10;Perjantai;43;102;145
623;17.08.2018;2018;08;11;Perjantai;18;48;66
623;17.08.2018;2018;08;12;Perjantai;33;32;65
623;17.08.2018;2018;08;13;Perjantai;70;44;114
623;17.08.2018;2018;08;14;Perjantai;58;38;96
623;17.08.2018;2018;08;15;Perjantai;101;65;166
623;17.08.2018;2018;08;16;Perjantai;94;60;154
623;17.08.2018;2018;08;17;Perjantai;115;69;184
623;17.08.2018;2018;08;18;Perjantai;52;38;90
623;17.08.2018;2018;08;19;Perjantai;40;37;77
623;17.08.2018;2018;08;20;Perjantai;40;35;75
623;17.08.2018;2018;08;21;Perjantai;41;22;63
623;17.08.2018;2018;08;22;Perjantai;33;14;47
623;17.08.2018;2018;08;23;Perjantai;16;10;26
623;18.08.2018;2018;08;00;Lauantai;15;3;18
623;18.08.2018;2018;08;01;Lauantai;7;3;10
623;18.08.2018;2018;08;02;Lauantai;5;3;8
623;18.08.2018;2018;08;03;Lauantai;3;2;5
623;18.08.2018;2018;08;04;Lauantai;6;2;8
623;18.08.2018;2018;08;05;Lauantai;4;3;7
623;18.08.2018;2018;08;06;Lauantai;3;4;7
623;18.08.2018;2018;08;07;Lauantai;2;5;7
623;18.08.2018;2018;08;08;Lauantai;4;11;15
623;18.08.2018;2018;08;09;Lauantai;4;20;24
623;18.08.2018;2018;08;10;Lauantai;11;30;41
623;18.08.2018;2018;08;11;Lauantai;9;22;31
623;18.08.2018;2018;08;12;Lauantai;28;32;60
623;18.08.2018;2018;08;13;Lauantai;23;41;64
623;18.08.2018;2018;08;14;Lauantai;26;45;71
623;18.08.2018;2018;08;15;Lauantai;49;30;79
623;18.08.2018;2018;08;16;Lauantai;45;50;95
623;18.08.2018;2018;08;17;Lauantai;50;55;105
623;18.08.2018;2018;08;18;Lauantai;50;40;90
623;18.08.2018;2018;08;19;Lauantai;47;37;84
623;18.08.2018;2018;08;20;Lauantai;26;46;72
623;18.08.2018;2018;08;21;Lauantai;22;30;52
623;18.08.2018;2018;08;22;Lauantai;36;17;53
623;18.08.2018;2018;08;23;Lauantai;34;18;52
623;19.08.2018;2018;08;00;Sunnuntai;25;12;37
623;19.08.2018;2018;08;01;Sunnuntai;39;11;50
623;19.08.2018;2018;08;02;Sunnuntai;17;4;21
623;19.08.2018;2018;08;03;Sunnuntai;0;0;0
623;19.08.2018;2018;08;04;Sunnuntai;26;6;32
623;19.08.2018;2018;08;05;Sunnuntai;3;1;4
623;19.08.2018;2018;08;06;Sunnuntai;4;1;5
623;19.08.2018;2018;08;07;Sunnuntai;2;3;5
623;19.08.2018;2018;08;08;Sunnuntai;4;3;7
623;19.08.2018;2018;08;09;Sunnuntai;3;7;10
623;19.08.2018;2018;08;10;Sunnuntai;8;20;28
623;19.08.2018;2018;08;11;Sunnuntai;15;22;37
623;19.08.2018;2018;08;12;Sunnuntai;22;35;57
623;19.08.2018;2018;08;13;Sunnuntai;18;32;50
623;19.08.2018;2018;08;14;Sunnuntai;30;46;76
623;19.08.2018;2018;08;15;Sunnuntai;32;42;74
623;19.08.2018;2018;08;16;Sunnuntai;47;45;92
623;19.08.2018;2018;08;17;Sunnuntai;43;29;72
623;19.08.2018;2018;08;18;Sunnuntai;36;30;66
623;19.08.2018;2018;08;19;Sunnuntai;43;23;66
623;19.08.2018;2018;08;20;Sunnuntai;24;23;47
623;19.08.2018;2018;08;21;Sunnuntai;30;16;46
623;19.08.2018;2018;08;22;Sunnuntai;26;7;33
623;19.08.2018;2018;08;23;Sunnuntai;10;6;16
623;20.08.2018;2018;08;00;Maanantai;3;3;6
623;20.08.2018;2018;08;01;Maanantai;4;0;4
623;20.08.2018;2018;08;02;Maanantai;0;0;0
623;20.08.2018;2018;08;03;Maanantai;0;2;2
623;20.08.2018;2018;08;04;Maanantai;1;0;1
623;20.08.2018;2018;08;05;Maanantai;4;6;10
623;20.08.2018;2018;08;06;Maanantai;2;8;10
623;20.08.2018;2018;08;07;Maanantai;7;38;45
623;20.08.2018;2018;08;08;Maanantai;47;139;186
623;20.08.2018;2018;08;09;Maanantai;79;165;244
623;20.08.2018;2018;08;10;Maanantai;46;54;100
623;20.08.2018;2018;08;11;Maanantai;35;43;78
623;20.08.2018;2018;08;12;Maanantai;39;48;87
623;20.08.2018;2018;08;13;Maanantai;51;61;112
623;20.08.2018;2018;08;14;Maanantai;65;27;92
623;20.08.2018;2018;08;15;Maanantai;91;38;129
623;20.08.2018;2018;08;16;Maanantai;121;55;176
623;20.08.2018;2018;08;17;Maanantai;153;70;223
623;20.08.2018;2018;08;18;Maanantai;84;59;143
623;20.08.2018;2018;08;19;Maanantai;51;44;95
623;20.08.2018;2018;08;20;Maanantai;54;32;86
623;20.08.2018;2018;08;21;Maanantai;40;16;56
623;20.08.2018;2018;08;22;Maanantai;39;16;55
623;20.08.2018;2018;08;23;Maanantai;12;10;22
623;21.08.2018;2018;08;00;Tiistai;6;5;11
623;21.08.2018;2018;08;01;Tiistai;1;2;3
623;21.08.2018;2018;08;02;Tiistai;2;0;2
623;21.08.2018;2018;08;03;Tiistai;3;2;5
623;21.08.2018;2018;08;04;Tiistai;2;1;3
623;21.08.2018;2018;08;05;Tiistai;0;6;6
623;21.08.2018;2018;08;06;Tiistai;5;13;18
623;21.08.2018;2018;08;07;Tiistai;15;59;74
623;21.08.2018;2018;08;08;Tiistai;67;147;214
623;21.08.2018;2018;08;09;Tiistai;63;166;229
623;21.08.2018;2018;08;10;Tiistai;47;71;118
623;21.08.2018;2018;08;11;Tiistai;42;45;87
623;21.08.2018;2018;08;12;Tiistai;53;35;88
623;21.08.2018;2018;08;13;Tiistai;40;43;83
623;21.08.2018;2018;08;14;Tiistai;56;42;98
623;21.08.2018;2018;08;15;Tiistai;96;43;139
623;21.08.2018;2018;08;16;Tiistai;109;52;161
623;21.08.2018;2018;08;17;Tiistai;156;72;228
623;21.08.2018;2018;08;18;Tiistai;90;62;152
623;21.08.2018;2018;08;19;Tiistai;62;47;109
623;21.08.2018;2018;08;20;Tiistai;48;32;80
623;21.08.2018;2018;08;21;Tiistai;39;20;59
623;21.08.2018;2018;08;22;Tiistai;26;19;45
623;21.08.2018;2018;08;23;Tiistai;11;9;20
623;22.08.2018;2018;08;00;Keskiviikko;7;3;10
623;22.08.2018;2018;08;01;Keskiviikko;2;2;4
623;22.08.2018;2018;08;02;Keskiviikko;3;1;4
623;22.08.2018;2018;08;03;Keskiviikko;3;3;6
623;22.08.2018;2018;08;04;Keskiviikko;0;2;2
623;22.08.2018;2018;08;05;Keskiviikko;1;4;5
623;22.08.2018;2018;08;06;Keskiviikko;5;15;20
623;22.08.2018;2018;08;07;Keskiviikko;13;56;69
623;22.08.2018;2018;08;08;Keskiviikko;69;144;213
623;22.08.2018;2018;08;09;Keskiviikko;74;159;233
623;22.08.2018;2018;08;10;Keskiviikko;36;69;105
623;22.08.2018;2018;08;11;Keskiviikko;30;49;79
623;22.08.2018;2018;08;12;Keskiviikko;36;35;71
623;22.08.2018;2018;08;13;Keskiviikko;43;53;96
623;22.08.2018;2018;08;14;Keskiviikko;55;46;101
623;22.08.2018;2018;08;15;Keskiviikko;101;43;144
623;22.08.2018;2018;08;16;Keskiviikko;128;61;189
623;22.08.2018;2018;08;17;Keskiviikko;152;58;210
623;22.08.2018;2018;08;18;Keskiviikko;70;52;122
623;22.08.2018;2018;08;19;Keskiviikko;56;38;94
623;22.08.2018;2018;08;20;Keskiviikko;39;27;66
623;22.08.2018;2018;08;21;Keskiviikko;24;14;38
623;22.08.2018;2018;08;22;Keskiviikko;15;15;30
623;22.08.2018;2018;08;23;Keskiviikko;13;12;25
623;23.08.2018;2018;08;00;Torstai;5;2;7
623;23.08.2018;2018;08;01;Torstai;3;6;9
623;23.08.2018;2018;08;02;Torstai;1;1;2
623;23.08.2018;2018;08;03;Torstai;1;3;4
623;23.08.2018;2018;08;04;Torstai;0;1;1
623;23.08.2018;2018;08;05;Torstai;0;4;4
623;23.08.2018;2018;08;06;Torstai;4;14;18
623;23.08.2018;2018;08;07;Torstai;10;38;48
623;23.08.2018;2018;08;08;Torstai;38;99;137
623;23.08.2018;2018;08;09;Torstai;50;118;168
623;23.08.2018;2018;08;10;Torstai;18;31;49
623;23.08.2018;2018;08;11;Torstai;7;13;20
623;23.08.2018;2018;08;12;Torstai;14;16;30
623;23.08.2018;2018;08;13;Torstai;20;29;49
623;23.08.2018;2018;08;14;Torstai;33;38;71
623;23.08.2018;2018;08;15;Torstai;82;32;114
623;23.08.2018;2018;08;16;Torstai;85;34;119
623;23.08.2018;2018;08;17;Torstai;87;63;150
623;23.08.2018;2018;08;18;Torstai;60;44;104
623;23.08.2018;2018;08;19;Torstai;38;46;84
623;23.08.2018;2018;08;20;Torstai;49;22;71
623;23.08.2018;2018;08;21;Torstai;26;12;38
623;23.08.2018;2018;08;22;Torstai;20;12;32
623;23.08.2018;2018;08;23;Torstai;13;11;24
623;24.08.2018;2018;08;00;Perjantai;5;2;7
623;24.08.2018;2018;08;01;Perjantai;3;0;3
623;24.08.2018;2018;08;02;Perjantai;2;3;5
623;24.08.2018;2018;08;03;Perjantai;1;2;3
623;24.08.2018;2018;08;04;Perjantai;0;0;0
623;24.08.2018;2018;08;05;Perjantai;1;3;4
623;24.08.2018;2018;08;06;Perjantai;1;7;8
623;24.08.2018;2018;08;07;Perjantai;11;34;45
623;24.08.2018;2018;08;08;Perjantai;28;83;111
623;24.08.2018;2018;08;09;Perjantai;51;96;147
623;24.08.2018;2018;08;10;Perjantai;17;57;74
623;24.08.2018;2018;08;11;Perjantai;7;10;17
623;24.08.2018;2018;08;12;Perjantai;14;21;35
623;24.08.2018;2018;08;13;Perjantai;38;12;50
623;24.08.2018;2018;08;14;Perjantai;29;15;44
623;24.08.2018;2018;08;15;Perjantai;75;26;101
623;24.08.2018;2018;08;16;Perjantai;50;40;90
623;24.08.2018;2018;08;17;Perjantai;57;36;93
623;24.08.2018;2018;08;18;Perjantai;38;34;72
623;24.08.2018;2018;08;19;Perjantai;32;28;60
623;24.08.2018;2018;08;20;Perjantai;28;26;54
623;24.08.2018;2018;08;21;Perjantai;16;14;30
623;24.08.2018;2018;08;22;Perjantai;19;8;27
623;24.08.2018;2018;08;23;Perjantai;13;3;16
623;25.08.2018;2018;08;00;Lauantai;2;4;6
623;25.08.2018;2018;08;01;Lauantai;2;1;3
623;25.08.2018;2018;08;02;Lauantai;4;1;5
623;25.08.2018;2018;08;03;Lauantai;6;2;8
623;25.08.2018;2018;08;04;Lauantai;2;2;4
623;25.08.2018;2018;08;05;Lauantai;1;0;1
623;25.08.2018;2018;08;06;Lauantai;4;2;6
623;25.08.2018;2018;08;07;Lauantai;4;4;8
623;25.08.2018;2018;08;08;Lauantai;1;7;8
623;25.08.2018;2018;08;09;Lauantai;6;5;11
623;25.08.2018;2018;08;10;Lauantai;3;12;15
623;25.08.2018;2018;08;11;Lauantai;5;14;19
623;25.08.2018;2018;08;12;Lauantai;19;40;59
623;25.08.2018;2018;08;13;Lauantai;23;42;65
623;25.08.2018;2018;08;14;Lauantai;26;44;70
623;25.08.2018;2018;08;15;Lauantai;36;37;73
623;25.08.2018;2018;08;16;Lauantai;47;48;95
623;25.08.2018;2018;08;17;Lauantai;35;26;61
623;25.08.2018;2018;08;18;Lauantai;44;26;70
623;25.08.2018;2018;08;19;Lauantai;34;32;66
623;25.08.2018;2018;08;20;Lauantai;24;13;37
623;25.08.2018;2018;08;21;Lauantai;22;23;45
623;25.08.2018;2018;08;22;Lauantai;12;10;22
623;25.08.2018;2018;08;23;Lauantai;15;10;25
623;26.08.2018;2018;08;00;Sunnuntai;11;12;23
623;26.08.2018;2018;08;01;Sunnuntai;10;5;15
623;26.08.2018;2018;08;02;Sunnuntai;4;2;6
623;26.08.2018;2018;08;03;Sunnuntai;5;0;5
623;26.08.2018;2018;08;04;Sunnuntai;5;1;6
623;26.08.2018;2018;08;05;Sunnuntai;8;0;8
623;26.08.2018;2018;08;06;Sunnuntai;4;1;5
623;26.08.2018;2018;08;07;Sunnuntai;2;5;7
623;26.08.2018;2018;08;08;Sunnuntai;1;5;6
623;26.08.2018;2018;08;09;Sunnuntai;7;7;14
623;26.08.2018;2018;08;10;Sunnuntai;8;14;22
623;26.08.2018;2018;08;11;Sunnuntai;17;24;41
623;26.08.2018;2018;08;12;Sunnuntai;20;35;55
623;26.08.2018;2018;08;13;Sunnuntai;21;40;61
623;26.08.2018;2018;08;14;Sunnuntai;48;44;92
623;26.08.2018;2018;08;15;Sunnuntai;48;35;83
623;26.08.2018;2018;08;16;Sunnuntai;33;24;57
623;26.08.2018;2018;08;17;Sunnuntai;24;9;33
623;26.08.2018;2018;08;18;Sunnuntai;21;19;40
623;26.08.2018;2018;08;19;Sunnuntai;18;11;29
623;26.08.2018;2018;08;20;Sunnuntai;17;13;30
623;26.08.2018;2018;08;21;Sunnuntai;4;4;8
623;26.08.2018;2018;08;22;Sunnuntai;12;8;20
623;26.08.2018;2018;08;23;Sunnuntai;5;5;10
623;27.08.2018;2018;08;00;Maanantai;2;2;4
623;27.08.2018;2018;08;01;Maanantai;2;2;4
623;27.08.2018;2018;08;02;Maanantai;0;1;1
623;27.08.2018;2018;08;03;Maanantai;0;0;0
623;27.08.2018;2018;08;04;Maanantai;0;1;1
623;27.08.2018;2018;08;05;Maanantai;1;5;6
623;27.08.2018;2018;08;06;Maanantai;5;9;14
623;27.08.2018;2018;08;07;Maanantai;7;36;43
623;27.08.2018;2018;08;08;Maanantai;42;100;142
623;27.08.2018;2018;08;09;Maanantai;61;126;187
623;27.08.2018;2018;08;10;Maanantai;33;49;82
623;27.08.2018;2018;08;11;Maanantai;18;24;42
623;27.08.2018;2018;08;12;Maanantai;23;33;56
623;27.08.2018;2018;08;13;Maanantai;36;33;69
623;27.08.2018;2018;08;14;Maanantai;34;27;61
623;27.08.2018;2018;08;15;Maanantai;79;27;106
623;27.08.2018;2018;08;16;Maanantai;84;43;127
623;27.08.2018;2018;08;17;Maanantai;113;66;179
623;27.08.2018;2018;08;18;Maanantai;74;50;124
623;27.08.2018;2018;08;19;Maanantai;44;45;89
623;27.08.2018;2018;08;20;Maanantai;37;27;64
623;27.08.2018;2018;08;21;Maanantai;23;13;36
623;27.08.2018;2018;08;22;Maanantai;25;10;35
623;27.08.2018;2018;08;23;Maanantai;18;4;22
623;28.08.2018;2018;08;00;Tiistai;3;2;5
623;28.08.2018;2018;08;01;Tiistai;2;2;4
623;28.08.2018;2018;08;02;Tiistai;1;0;1
623;28.08.2018;2018;08;03;Tiistai;2;3;5
623;28.08.2018;2018;08;04;Tiistai;1;2;3
623;28.08.2018;2018;08;05;Tiistai;0;6;6
623;28.08.2018;2018;08;06;Tiistai;2;7;9
623;28.08.2018;2018;08;07;Tiistai;8;53;61
623;28.08.2018;2018;08;08;Tiistai;66;126;192
623;28.08.2018;2018;08;09;Tiistai;70;148;218
623;28.08.2018;2018;08;10;Tiistai;33;63;96
623;28.08.2018;2018;08;11;Tiistai;19;36;55
623;28.08.2018;2018;08;12;Tiistai;42;40;82
623;28.08.2018;2018;08;13;Tiistai;48;25;73
623;28.08.2018;2018;08;14;Tiistai;41;31;72
623;28.08.2018;2018;08;15;Tiistai;85;37;122
623;28.08.2018;2018;08;16;Tiistai;106;50;156
623;28.08.2018;2018;08;17;Tiistai;149;67;216
623;28.08.2018;2018;08;18;Tiistai;79;54;133
623;28.08.2018;2018;08;19;Tiistai;49;38;87
623;28.08.2018;2018;08;20;Tiistai;55;35;90
623;28.08.2018;2018;08;21;Tiistai;41;25;66
623;28.08.2018;2018;08;22;Tiistai;25;13;38
623;28.08.2018;2018;08;23;Tiistai;13;8;21
623;29.08.2018;2018;08;00;Keskiviikko;3;2;5
623;29.08.2018;2018;08;01;Keskiviikko;3;0;3
623;29.08.2018;2018;08;02;Keskiviikko;3;1;4
623;29.08.2018;2018;08;03;Keskiviikko;2;3;5
623;29.08.2018;2018;08;04;Keskiviikko;1;2;3
623;29.08.2018;2018;08;05;Keskiviikko;1;5;6
623;29.08.2018;2018;08;06;Keskiviikko;1;14;15
623;29.08.2018;2018;08;07;Keskiviikko;13;62;75
623;29.08.2018;2018;08;08;Keskiviikko;64;135;199
623;29.08.2018;2018;08;09;Keskiviikko;49;129;178
623;29.08.2018;2018;08;10;Keskiviikko;19;20;39
623;29.08.2018;2018;08;11;Keskiviikko;44;72;116
623;29.08.2018;2018;08;12;Keskiviikko;46;43;89
623;29.08.2018;2018;08;13;Keskiviikko;43;45;88
623;29.08.2018;2018;08;14;Keskiviikko;50;36;86
623;29.08.2018;2018;08;15;Keskiviikko;110;41;151
623;29.08.2018;2018;08;16;Keskiviikko;112;78;190
623;29.08.2018;2018;08;17;Keskiviikko;134;64;198
623;29.08.2018;2018;08;18;Keskiviikko;83;65;148
623;29.08.2018;2018;08;19;Keskiviikko;51;53;104
623;29.08.2018;2018;08;20;Keskiviikko;53;41;94
623;29.08.2018;2018;08;21;Keskiviikko;45;20;65
623;29.08.2018;2018;08;22;Keskiviikko;28;12;40
623;29.08.2018;2018;08;23;Keskiviikko;10;7;17
623;30.08.2018;2018;08;00;Torstai;10;3;13
623;30.08.2018;2018;08;01;Torstai;6;3;9
623;30.08.2018;2018;08;02;Torstai;5;1;6
623;30.08.2018;2018;08;03;Torstai;4;2;6
623;30.08.2018;2018;08;04;Torstai;1;1;2
623;30.08.2018;2018;08;05;Torstai;1;4;5
623;30.08.2018;2018;08;06;Torstai;2;14;16
623;30.08.2018;2018;08;07;Torstai;8;53;61
623;30.08.2018;2018;08;08;Torstai;49;121;170
623;30.08.2018;2018;08;09;Torstai;87;132;219
623;30.08.2018;2018;08;10;Torstai;36;54;90
623;30.08.2018;2018;08;11;Torstai;21;33;54
623;30.08.2018;2018;08;12;Torstai;39;44;83
623;30.08.2018;2018;08;13;Torstai;54;55;109
623;30.08.2018;2018;08;14;Torstai;65;61;126
623;30.08.2018;2018;08;15;Torstai;87;47;134
623;30.08.2018;2018;08;16;Torstai;120;55;175
623;30.08.2018;2018;08;17;Torstai;122;61;183
623;30.08.2018;2018;08;18;Torstai;76;54;130
623;30.08.2018;2018;08;19;Torstai;55;43;98
623;30.08.2018;2018;08;20;Torstai;50;29;79
623;30.08.2018;2018;08;21;Torstai;30;16;46
623;30.08.2018;2018;08;22;Torstai;31;10;41
623;30.08.2018;2018;08;23;Torstai;14;10;24
623;31.08.2018;2018;08;00;Perjantai;5;3;8
623;31.08.2018;2018;08;01;Perjantai;3;1;4
623;31.08.2018;2018;08;02;Perjantai;0;2;2
623;31.08.2018;2018;08;03;Perjantai;2;2;4
623;31.08.2018;2018;08;04;Perjantai;2;3;5
623;31.08.2018;2018;08;05;Perjantai;0;5;5
623;31.08.2018;2018;08;06;Perjantai;2;8;10
623;31.08.2018;2018;08;07;Perjantai;10;44;54
623;31.08.2018;2018;08;08;Perjantai;32;96;128
623;31.08.2018;2018;08;09;Perjantai;57;105;162
623;31.08.2018;2018;08;10;Perjantai;30;69;99
623;31.08.2018;2018;08;11;Perjantai;20;28;48
623;31.08.2018;2018;08;12;Perjantai;26;38;64
623;31.08.2018;2018;08;13;Perjantai;68;56;124
623;31.08.2018;2018;08;14;Perjantai;56;41;97
623;31.08.2018;2018;08;15;Perjantai;102;45;147
623;31.08.2018;2018;08;16;Perjantai;85;41;126
623;31.08.2018;2018;08;17;Perjantai;95;49;144
623;31.08.2018;2018;08;18;Perjantai;39;37;76
623;31.08.2018;2018;08;19;Perjantai;41;38;79
623;31.08.2018;2018;08;20;Perjantai;37;32;69
623;31.08.2018;2018;08;21;Perjantai;25;19;44
623;31.08.2018;2018;08;22;Perjantai;31;26;57
623;31.08.2018;2018;08;23;Perjantai;17;3;20
623;01.09.2018;2018;09;00;Lauantai;13;7;20
623;01.09.2018;2018;09;01;Lauantai;9;5;14
623;01.09.2018;2018;09;02;Lauantai;8;2;10
623;01.09.2018;2018;09;03;Lauantai;8;0;8
623;01.09.2018;2018;09;04;Lauantai;4;0;4
623;01.09.2018;2018;09;05;Lauantai;3;1;4
623;01.09.2018;2018;09;06;Lauantai;2;0;2
623;01.09.2018;2018;09;07;Lauantai;3;11;14
623;01.09.2018;2018;09;08;Lauantai;1;4;5
623;01.09.2018;2018;09;09;Lauantai;5;9;14
623;01.09.2018;2018;09;10;Lauantai;12;11;23
623;01.09.2018;2018;09;11;Lauantai;12;29;41
623;01.09.2018;2018;09;12;Lauantai;30;37;67
623;01.09.2018;2018;09;13;Lauantai;34;47;81
623;01.09.2018;2018;09;14;Lauantai;33;34;67
623;01.09.2018;2018;09;15;Lauantai;37;39;76
623;01.09.2018;2018;09;16;Lauantai;41;33;74
623;01.09.2018;2018;09;17;Lauantai;34;46;80
623;01.09.2018;2018;09;18;Lauantai;34;40;74
623;01.09.2018;2018;09;19;Lauantai;35;20;55
623;01.09.2018;2018;09;20;Lauantai;35;27;62
623;01.09.2018;2018;09;21;Lauantai;26;26;52
623;01.09.2018;2018;09;22;Lauantai;18;7;25
623;01.09.2018;2018;09;23;Lauantai;16;9;25
623;02.09.2018;2018;09;00;Sunnuntai;12;6;18
623;02.09.2018;2018;09;01;Sunnuntai;16;2;18
623;02.09.2018;2018;09;02;Sunnuntai;14;8;22
623;02.09.2018;2018;09;03;Sunnuntai;10;6;16
623;02.09.2018;2018;09;04;Sunnuntai;8;2;10
623;02.09.2018;2018;09;05;Sunnuntai;5;2;7
623;02.09.2018;2018;09;06;Sunnuntai;5;0;5
623;02.09.2018;2018;09;07;Sunnuntai;2;6;8
623;02.09.2018;2018;09;08;Sunnuntai;2;2;4
623;02.09.2018;2018;09;09;Sunnuntai;2;9;11
623;02.09.2018;2018;09;10;Sunnuntai;13;26;39
623;02.09.2018;2018;09;11;Sunnuntai;20;26;46
623;02.09.2018;2018;09;12;Sunnuntai;18;40;58
623;02.09.2018;2018;09;13;Sunnuntai;19;36;55
623;02.09.2018;2018;09;14;Sunnuntai;28;44;72
623;02.09.2018;2018;09;15;Sunnuntai;48;35;83
623;02.09.2018;2018;09;16;Sunnuntai;41;37;78
623;02.09.2018;2018;09;17;Sunnuntai;41;29;70
623;02.09.2018;2018;09;18;Sunnuntai;52;39;91
623;02.09.2018;2018;09;19;Sunnuntai;39;35;74
623;02.09.2018;2018;09;20;Sunnuntai;32;27;59
623;02.09.2018;2018;09;21;Sunnuntai;27;9;36
623;02.09.2018;2018;09;22;Sunnuntai;7;1;8
623;02.09.2018;2018;09;23;Sunnuntai;0;0;0
623;03.09.2018;2018;09;00;Maanantai;4;4;8
623;03.09.2018;2018;09;01;Maanantai;8;2;10
623;03.09.2018;2018;09;02;Maanantai;8;0;8
623;03.09.2018;2018;09;03;Maanantai;7;2;9
623;03.09.2018;2018;09;04;Maanantai;2;0;2
623;03.09.2018;2018;09;05;Maanantai;1;5;6
623;03.09.2018;2018;09;06;Maanantai;1;10;11
623;03.09.2018;2018;09;07;Maanantai;7;54;61
623;03.09.2018;2018;09;08;Maanantai;71;145;216
623;03.09.2018;2018;09;09;Maanantai;75;149;224
623;03.09.2018;2018;09;10;Maanantai;45;70;115
623;03.09.2018;2018;09;11;Maanantai;28;43;71
623;03.09.2018;2018;09;12;Maanantai;56;52;108
623;03.09.2018;2018;09;13;Maanantai;45;58;103
623;03.09.2018;2018;09;14;Maanantai;56;40;96
623;03.09.2018;2018;09;15;Maanantai;125;57;182
623;03.09.2018;2018;09;16;Maanantai;117;58;175
623;03.09.2018;2018;09;17;Maanantai;135;72;207
623;03.09.2018;2018;09;18;Maanantai;81;71;152
623;03.09.2018;2018;09;19;Maanantai;56;46;102
623;03.09.2018;2018;09;20;Maanantai;55;41;96
623;03.09.2018;2018;09;21;Maanantai;46;22;68
623;03.09.2018;2018;09;22;Maanantai;33;14;47
623;03.09.2018;2018;09;23;Maanantai;14;10;24
623;04.09.2018;2018;09;00;Tiistai;4;4;8
623;04.09.2018;2018;09;01;Tiistai;8;2;10
623;04.09.2018;2018;09;02;Tiistai;8;0;8
623;04.09.2018;2018;09;03;Tiistai;7;2;9
623;04.09.2018;2018;09;04;Tiistai;2;0;2
623;04.09.2018;2018;09;05;Tiistai;1;5;6
623;04.09.2018;2018;09;06;Tiistai;1;10;11
623;04.09.2018;2018;09;07;Tiistai;7;54;61
623;04.09.2018;2018;09;08;Tiistai;71;145;216
623;04.09.2018;2018;09;09;Tiistai;75;149;224
623;04.09.2018;2018;09;10;Tiistai;45;70;115
623;04.09.2018;2018;09;11;Tiistai;25;43;68
623;04.09.2018;2018;09;12;Tiistai;65;50;115
623;04.09.2018;2018;09;13;Tiistai;63;63;126
623;04.09.2018;2018;09;14;Tiistai;66;36;102
623;04.09.2018;2018;09;15;Tiistai;117;64;181
623;04.09.2018;2018;09;16;Tiistai;114;72;186
623;04.09.2018;2018;09;17;Tiistai;158;106;264
623;04.09.2018;2018;09;18;Tiistai;81;69;150
623;04.09.2018;2018;09;19;Tiistai;58;39;97
623;04.09.2018;2018;09;20;Tiistai;58;44;102
623;04.09.2018;2018;09;21;Tiistai;37;24;61
623;04.09.2018;2018;09;22;Tiistai;49;18;67
623;04.09.2018;2018;09;23;Tiistai;11;8;19
623;05.09.2018;2018;09;00;Keskiviikko;8;6;14
623;05.09.2018;2018;09;01;Keskiviikko;5;4;9
623;05.09.2018;2018;09;02;Keskiviikko;1;1;2
623;05.09.2018;2018;09;03;Keskiviikko;2;3;5
623;05.09.2018;2018;09;04;Keskiviikko;1;2;3
623;05.09.2018;2018;09;05;Keskiviikko;0;10;10
623;05.09.2018;2018;09;06;Keskiviikko;0;9;9
623;05.09.2018;2018;09;07;Keskiviikko;8;56;64
623;05.09.2018;2018;09;08;Keskiviikko;86;122;208
623;05.09.2018;2018;09;09;Keskiviikko;67;142;209
623;05.09.2018;2018;09;10;Keskiviikko;44;70;114
623;05.09.2018;2018;09;11;Keskiviikko;31;28;59
623;05.09.2018;2018;09;12;Keskiviikko;30;37;67
623;05.09.2018;2018;09;13;Keskiviikko;47;51;98
623;05.09.2018;2018;09;14;Keskiviikko;63;52;115
623;05.09.2018;2018;09;15;Keskiviikko;110;57;167
623;05.09.2018;2018;09;16;Keskiviikko;124;76;200
623;05.09.2018;2018;09;17;Keskiviikko;145;97;242
623;05.09.2018;2018;09;18;Keskiviikko;71;61;132
623;05.09.2018;2018;09;19;Keskiviikko;60;33;93
623;05.09.2018;2018;09;20;Keskiviikko;55;36;91
623;05.09.2018;2018;09;21;Keskiviikko;40;26;66
623;05.09.2018;2018;09;22;Keskiviikko;28;19;47
623;05.09.2018;2018;09;23;Keskiviikko;19;2;21
623;06.09.2018;2018;09;00;Torstai;6;4;10
623;06.09.2018;2018;09;01;Torstai;8;4;12
623;06.09.2018;2018;09;02;Torstai;1;2;3
623;06.09.2018;2018;09;03;Torstai;4;3;7
623;06.09.2018;2018;09;04;Torstai;0;3;3
623;06.09.2018;2018;09;05;Torstai;1;5;6
623;06.09.2018;2018;09;06;Torstai;1;7;8
623;06.09.2018;2018;09;07;Torstai;12;58;70
623;06.09.2018;2018;09;08;Torstai;62;112;174
623;06.09.2018;2018;09;09;Torstai;71;140;211
623;06.09.2018;2018;09;10;Torstai;45;65;110
623;06.09.2018;2018;09;11;Torstai;22;39;61
623;06.09.2018;2018;09;12;Torstai;49;28;77
623;06.09.2018;2018;09;13;Torstai;53;43;96
623;06.09.2018;2018;09;14;Torstai;60;39;99
623;06.09.2018;2018;09;15;Torstai;85;54;139
623;06.09.2018;2018;09;16;Torstai;113;56;169
623;06.09.2018;2018;09;17;Torstai;148;78;226
623;06.09.2018;2018;09;18;Torstai;82;73;155
623;06.09.2018;2018;09;19;Torstai;54;65;119
623;06.09.2018;2018;09;20;Torstai;61;40;101
623;06.09.2018;2018;09;21;Torstai;41;20;61
623;06.09.2018;2018;09;22;Torstai;33;19;52
623;06.09.2018;2018;09;23;Torstai;14;15;29
623;07.09.2018;2018;09;00;Perjantai;7;1;8
623;07.09.2018;2018;09;01;Perjantai;8;8;16
623;07.09.2018;2018;09;02;Perjantai;3;3;6
623;07.09.2018;2018;09;03;Perjantai;5;2;7
623;07.09.2018;2018;09;04;Perjantai;7;2;9
623;07.09.2018;2018;09;05;Perjantai;5;6;11
623;07.09.2018;2018;09;06;Perjantai;3;11;14
623;07.09.2018;2018;09;07;Perjantai;13;51;64
623;07.09.2018;2018;09;08;Perjantai;69;101;170
623;07.09.2018;2018;09;09;Perjantai;70;125;195
623;07.09.2018;2018;09;10;Perjantai;40;68;108
623;07.09.2018;2018;09;11;Perjantai;29;36;65
623;07.09.2018;2018;09;12;Perjantai;28;31;59
623;07.09.2018;2018;09;13;Perjantai;52;47;99
623;07.09.2018;2018;09;14;Perjantai;55;57;112
623;07.09.2018;2018;09;15;Perjantai;110;52;162
623;07.09.2018;2018;09;16;Perjantai;96;44;140
623;07.09.2018;2018;09;17;Perjantai;75;57;132
623;07.09.2018;2018;09;18;Perjantai;59;44;103
623;07.09.2018;2018;09;19;Perjantai;48;24;72
623;07.09.2018;2018;09;20;Perjantai;45;30;75
623;07.09.2018;2018;09;21;Perjantai;22;34;56
623;07.09.2018;2018;09;22;Perjantai;31;18;49
623;07.09.2018;2018;09;23;Perjantai;22;16;38
623;08.09.2018;2018;09;00;Lauantai;8;3;11
623;08.09.2018;2018;09;01;Lauantai;17;4;21
623;08.09.2018;2018;09;02;Lauantai;8;1;9
623;08.09.2018;2018;09;03;Lauantai;5;4;9
623;08.09.2018;2018;09;04;Lauantai;12;4;16
623;08.09.2018;2018;09;05;Lauantai;5;4;9
623;08.09.2018;2018;09;06;Lauantai;2;5;7
623;08.09.2018;2018;09;07;Lauantai;4;11;15
623;08.09.2018;2018;09;08;Lauantai;2;4;6
623;08.09.2018;2018;09;09;Lauantai;4;13;17
623;08.09.2018;2018;09;10;Lauantai;4;23;27
623;08.09.2018;2018;09;11;Lauantai;11;22;33
623;08.09.2018;2018;09;12;Lauantai;15;27;42
623;08.09.2018;2018;09;13;Lauantai;34;55;89
623;08.09.2018;2018;09;14;Lauantai;33;44;77
623;08.09.2018;2018;09;15;Lauantai;48;39;87
623;08.09.2018;2018;09;16;Lauantai;44;36;80
623;08.09.2018;2018;09;17;Lauantai;37;37;74
623;08.09.2018;2018;09;18;Lauantai;47;39;86
623;08.09.2018;2018;09;19;Lauantai;37;34;71
623;08.09.2018;2018;09;20;Lauantai;27;31;58
623;08.09.2018;2018;09;21;Lauantai;23;27;50
623;08.09.2018;2018;09;22;Lauantai;27;22;49
623;08.09.2018;2018;09;23;Lauantai;27;14;41
623;09.09.2018;2018;09;00;Sunnuntai;11;6;17
623;09.09.2018;2018;09;01;Sunnuntai;17;5;22
623;09.09.2018;2018;09;02;Sunnuntai;7;4;11
623;09.09.2018;2018;09;03;Sunnuntai;10;1;11
623;09.09.2018;2018;09;04;Sunnuntai;9;5;14
623;09.09.2018;2018;09;05;Sunnuntai;6;3;9
623;09.09.2018;2018;09;06;Sunnuntai;1;3;4
623;09.09.2018;2018;09;07;Sunnuntai;5;9;14
623;09.09.2018;2018;09;08;Sunnuntai;1;6;7
623;09.09.2018;2018;09;09;Sunnuntai;4;6;10
623;09.09.2018;2018;09;10;Sunnuntai;11;19;30
623;09.09.2018;2018;09;11;Sunnuntai;13;26;39
623;09.09.2018;2018;09;12;Sunnuntai;26;38;64
623;09.09.2018;2018;09;13;Sunnuntai;25;38;63
623;09.09.2018;2018;09;14;Sunnuntai;39;39;78
623;09.09.2018;2018;09;15;Sunnuntai;40;26;66
623;09.09.2018;2018;09;16;Sunnuntai;43;40;83
623;09.09.2018;2018;09;17;Sunnuntai;42;22;64
623;09.09.2018;2018;09;18;Sunnuntai;46;41;87
623;09.09.2018;2018;09;19;Sunnuntai;39;28;67
623;09.09.2018;2018;09;20;Sunnuntai;33;17;50
623;09.09.2018;2018;09;21;Sunnuntai;15;12;27
623;09.09.2018;2018;09;22;Sunnuntai;24;5;29
623;09.09.2018;2018;09;23;Sunnuntai;8;4;12
623;10.09.2018;2018;09;00;Maanantai;6;5;11
623;10.09.2018;2018;09;01;Maanantai;4;3;7
623;10.09.2018;2018;09;02;Maanantai;0;4;4
623;10.09.2018;2018;09;03;Maanantai;3;2;5
623;10.09.2018;2018;09;04;Maanantai;2;2;4
623;10.09.2018;2018;09;05;Maanantai;0;4;4
623;10.09.2018;2018;09;06;Maanantai;2;11;13
623;10.09.2018;2018;09;07;Maanantai;10;49;59
623;10.09.2018;2018;09;08;Maanantai;68;120;188
623;10.09.2018;2018;09;09;Maanantai;54;122;176
623;10.09.2018;2018;09;10;Maanantai;58;108;166
623;10.09.2018;2018;09;11;Maanantai;26;36;62
623;10.09.2018;2018;09;12;Maanantai;45;42;87
623;10.09.2018;2018;09;13;Maanantai;63;34;97
623;10.09.2018;2018;09;14;Maanantai;72;45;117
623;10.09.2018;2018;09;15;Maanantai;95;54;149
623;10.09.2018;2018;09;16;Maanantai;116;61;177
623;10.09.2018;2018;09;17;Maanantai;142;73;215
623;10.09.2018;2018;09;18;Maanantai;85;58;143
623;10.09.2018;2018;09;19;Maanantai;66;46;112
623;10.09.2018;2018;09;20;Maanantai;50;32;82
623;10.09.2018;2018;09;21;Maanantai;56;28;84
623;10.09.2018;2018;09;22;Maanantai;24;15;39
623;10.09.2018;2018;09;23;Maanantai;13;7;20
623;11.09.2018;2018;09;00;Tiistai;7;5;12
623;11.09.2018;2018;09;01;Tiistai;1;0;1
623;11.09.2018;2018;09;02;Tiistai;0;1;1
623;11.09.2018;2018;09;03;Tiistai;0;2;2
623;11.09.2018;2018;09;04;Tiistai;1;1;2
623;11.09.2018;2018;09;05;Tiistai;1;5;6
623;11.09.2018;2018;09;06;Tiistai;3;9;12
623;11.09.2018;2018;09;07;Tiistai;11;42;53
623;11.09.2018;2018;09;08;Tiistai;66;118;184
623;11.09.2018;2018;09;09;Tiistai;65;124;189
623;11.09.2018;2018;09;10;Tiistai;41;55;96
623;11.09.2018;2018;09;11;Tiistai;30;48;78
623;11.09.2018;2018;09;12;Tiistai;43;24;67
623;11.09.2018;2018;09;13;Tiistai;44;34;78
623;11.09.2018;2018;09;14;Tiistai;51;37;88
623;11.09.2018;2018;09;15;Tiistai;85;39;124
623;11.09.2018;2018;09;16;Tiistai;92;49;141
623;11.09.2018;2018;09;17;Tiistai;118;61;179
623;11.09.2018;2018;09;18;Tiistai;36;25;61
623;11.09.2018;2018;09;19;Tiistai;31;24;55
623;11.09.2018;2018;09;20;Tiistai;22;13;35
623;11.09.2018;2018;09;21;Tiistai;19;9;28
623;11.09.2018;2018;09;22;Tiistai;15;4;19
623;11.09.2018;2018;09;23;Tiistai;9;6;15
623;12.09.2018;2018;09;00;Keskiviikko;5;0;5
623;12.09.2018;2018;09;01;Keskiviikko;3;3;6
623;12.09.2018;2018;09;02;Keskiviikko;0;0;0
623;12.09.2018;2018;09;03;Keskiviikko;2;2;4
623;12.09.2018;2018;09;04;Keskiviikko;0;1;1
623;12.09.2018;2018;09;05;Keskiviikko;2;4;6
623;12.09.2018;2018;09;06;Keskiviikko;1;6;7
623;12.09.2018;2018;09;07;Keskiviikko;5;39;44
623;12.09.2018;2018;09;08;Keskiviikko;43;82;125
623;12.09.2018;2018;09;09;Keskiviikko;61;112;173
623;12.09.2018;2018;09;10;Keskiviikko;37;51;88
623;12.09.2018;2018;09;11;Keskiviikko;28;36;64
623;12.09.2018;2018;09;12;Keskiviikko;37;25;62
623;12.09.2018;2018;09;13;Keskiviikko;32;44;76
623;12.09.2018;2018;09;14;Keskiviikko;46;19;65
623;12.09.2018;2018;09;15;Keskiviikko;87;39;126
623;12.09.2018;2018;09;16;Keskiviikko;55;43;98
623;12.09.2018;2018;09;17;Keskiviikko;75;48;123
623;12.09.2018;2018;09;18;Keskiviikko;43;40;83
623;12.09.2018;2018;09;19;Keskiviikko;35;32;67
623;12.09.2018;2018;09;20;Keskiviikko;39;22;61
623;12.09.2018;2018;09;21;Keskiviikko;16;19;35
623;12.09.2018;2018;09;22;Keskiviikko;30;17;47
623;12.09.2018;2018;09;23;Keskiviikko;9;4;13
623;13.09.2018;2018;09;00;Torstai;2;4;6
623;13.09.2018;2018;09;01;Torstai;4;4;8
623;13.09.2018;2018;09;02;Torstai;6;0;6
623;13.09.2018;2018;09;03;Torstai;4;1;5
623;13.09.2018;2018;09;04;Torstai;4;2;6
623;13.09.2018;2018;09;05;Torstai;5;6;11
623;13.09.2018;2018;09;06;Torstai;4;11;15
623;13.09.2018;2018;09;07;Torstai;8;52;60
623;13.09.2018;2018;09;08;Torstai;61;116;177
623;13.09.2018;2018;09;09;Torstai;66;130;196
623;13.09.2018;2018;09;10;Torstai;45;61;106
623;13.09.2018;2018;09;11;Torstai;31;33;64
623;13.09.2018;2018;09;12;Torstai;50;35;85
623;13.09.2018;2018;09;13;Torstai;61;37;98
623;13.09.2018;2018;09;14;Torstai;52;35;87
623;13.09.2018;2018;09;15;Torstai;84;57;141
623;13.09.2018;2018;09;16;Torstai;91;50;141
623;13.09.2018;2018;09;17;Torstai;118;74;192
623;13.09.2018;2018;09;18;Torstai;75;69;144
623;13.09.2018;2018;09;19;Torstai;44;52;96
623;13.09.2018;2018;09;20;Torstai;63;42;105
623;13.09.2018;2018;09;21;Torstai;38;27;65
623;13.09.2018;2018;09;22;Torstai;27;17;44
623;13.09.2018;2018;09;23;Torstai;15;11;26
623;14.09.2018;2018;09;00;Perjantai;10;3;13
623;14.09.2018;2018;09;01;Perjantai;7;3;10
623;14.09.2018;2018;09;02;Perjantai;6;1;7
623;14.09.2018;2018;09;03;Perjantai;8;3;11
623;14.09.2018;2018;09;04;Perjantai;3;1;4
623;14.09.2018;2018;09;05;Perjantai;2;5;7
623;14.09.2018;2018;09;06;Perjantai;1;7;8
623;14.09.2018;2018;09;07;Perjantai;5;36;41
623;14.09.2018;2018;09;08;Perjantai;58;97;155
623;14.09.2018;2018;09;09;Perjantai;56;116;172
623;14.09.2018;2018;09;10;Perjantai;34;53;87
623;14.09.2018;2018;09;11;Perjantai;24;32;56
623;14.09.2018;2018;09;12;Perjantai;28;25;53
623;14.09.2018;2018;09;13;Perjantai;55;49;104
623;14.09.2018;2018;09;14;Perjantai;51;41;92
623;14.09.2018;2018;09;15;Perjantai;88;44;132
623;14.09.2018;2018;09;16;Perjantai;88;45;133
623;14.09.2018;2018;09;17;Perjantai;93;54;147
623;14.09.2018;2018;09;18;Perjantai;49;42;91
623;14.09.2018;2018;09;19;Perjantai;33;32;65
623;14.09.2018;2018;09;20;Perjantai;22;26;48
623;14.09.2018;2018;09;21;Perjantai;18;15;33
623;14.09.2018;2018;09;22;Perjantai;24;10;34
623;14.09.2018;2018;09;23;Perjantai;9;6;15
623;15.09.2018;2018;09;00;Lauantai;15;7;22
623;15.09.2018;2018;09;01;Lauantai;4;2;6
623;15.09.2018;2018;09;02;Lauantai;7;2;9
623;15.09.2018;2018;09;03;Lauantai;2;1;3
623;15.09.2018;2018;09;04;Lauantai;1;2;3
623;15.09.2018;2018;09;05;Lauantai;8;3;11
623;15.09.2018;2018;09;06;Lauantai;3;2;5
623;15.09.2018;2018;09;07;Lauantai;0;2;2
623;15.09.2018;2018;09;08;Lauantai;1;7;8
623;15.09.2018;2018;09;09;Lauantai;7;37;44
623;15.09.2018;2018;09;10;Lauantai;11;18;29
623;15.09.2018;2018;09;11;Lauantai;9;19;28
623;15.09.2018;2018;09;12;Lauantai;18;25;43
623;15.09.2018;2018;09;13;Lauantai;42;29;71
623;15.09.2018;2018;09;14;Lauantai;22;16;38
623;15.09.2018;2018;09;15;Lauantai;12;6;18
623;15.09.2018;2018;09;16;Lauantai;13;21;34
623;15.09.2018;2018;09;17;Lauantai;10;7;17
623;15.09.2018;2018;09;18;Lauantai;18;15;33
623;15.09.2018;2018;09;19;Lauantai;16;23;39
623;15.09.2018;2018;09;20;Lauantai;16;15;31
623;15.09.2018;2018;09;21;Lauantai;13;12;25
623;15.09.2018;2018;09;22;Lauantai;6;2;8
623;15.09.2018;2018;09;23;Lauantai;5;6;11
623;16.09.2018;2018;09;00;Sunnuntai;8;10;18
623;16.09.2018;2018;09;01;Sunnuntai;5;3;8
623;16.09.2018;2018;09;02;Sunnuntai;6;2;8
623;16.09.2018;2018;09;03;Sunnuntai;4;1;5
623;16.09.2018;2018;09;04;Sunnuntai;5;2;7
623;16.09.2018;2018;09;05;Sunnuntai;5;1;6
623;16.09.2018;2018;09;06;Sunnuntai;5;5;10
623;16.09.2018;2018;09;07;Sunnuntai;2;3;5
623;16.09.2018;2018;09;08;Sunnuntai;2;4;6
623;16.09.2018;2018;09;09;Sunnuntai;2;5;7
623;16.09.2018;2018;09;10;Sunnuntai;11;11;22
623;16.09.2018;2018;09;11;Sunnuntai;15;20;35
623;16.09.2018;2018;09;12;Sunnuntai;17;28;45
623;16.09.2018;2018;09;13;Sunnuntai;25;31;56
623;16.09.2018;2018;09;14;Sunnuntai;25;29;54
623;16.09.2018;2018;09;15;Sunnuntai;30;27;57
623;16.09.2018;2018;09;16;Sunnuntai;28;23;51
623;16.09.2018;2018;09;17;Sunnuntai;33;18;51
623;16.09.2018;2018;09;18;Sunnuntai;26;23;49
623;16.09.2018;2018;09;19;Sunnuntai;25;20;45
623;16.09.2018;2018;09;20;Sunnuntai;21;17;38
623;16.09.2018;2018;09;21;Sunnuntai;12;9;21
623;16.09.2018;2018;09;22;Sunnuntai;12;3;15
623;16.09.2018;2018;09;23;Sunnuntai;9;3;12
623;17.09.2018;2018;09;00;Maanantai;3;0;3
623;17.09.2018;2018;09;01;Maanantai;2;3;5
623;17.09.2018;2018;09;02;Maanantai;2;0;2
623;17.09.2018;2018;09;03;Maanantai;0;1;1
623;17.09.2018;2018;09;04;Maanantai;0;0;0
623;17.09.2018;2018;09;05;Maanantai;0;4;4
623;17.09.2018;2018;09;06;Maanantai;0;11;11
623;17.09.2018;2018;09;07;Maanantai;4;34;38
623;17.09.2018;2018;09;08;Maanantai;57;111;168
623;17.09.2018;2018;09;09;Maanantai;73;141;214
623;17.09.2018;2018;09;10;Maanantai;43;46;89
623;17.09.2018;2018;09;11;Maanantai;29;32;61
623;17.09.2018;2018;09;12;Maanantai;36;37;73
623;17.09.2018;2018;09;13;Maanantai;53;55;108
623;17.09.2018;2018;09;14;Maanantai;50;32;82
623;17.09.2018;2018;09;15;Maanantai;112;40;152
623;17.09.2018;2018;09;16;Maanantai;81;48;129
623;17.09.2018;2018;09;17;Maanantai;128;60;188
623;17.09.2018;2018;09;18;Maanantai;63;41;104
623;17.09.2018;2018;09;19;Maanantai;43;37;80
623;17.09.2018;2018;09;20;Maanantai;42;19;61
623;17.09.2018;2018;09;21;Maanantai;29;17;46
623;17.09.2018;2018;09;22;Maanantai;19;10;29
623;17.09.2018;2018;09;23;Maanantai;8;6;14
623;18.09.2018;2018;09;00;Tiistai;2;2;4
623;18.09.2018;2018;09;01;Tiistai;0;1;1
623;18.09.2018;2018;09;02;Tiistai;1;2;3
623;18.09.2018;2018;09;03;Tiistai;2;1;3
623;18.09.2018;2018;09;04;Tiistai;0;0;0
623;18.09.2018;2018;09;05;Tiistai;1;6;7
623;18.09.2018;2018;09;06;Tiistai;0;7;7
623;18.09.2018;2018;09;07;Tiistai;11;45;56
623;18.09.2018;2018;09;08;Tiistai;56;111;167
623;18.09.2018;2018;09;09;Tiistai;66;129;195
623;18.09.2018;2018;09;10;Tiistai;48;57;105
623;18.09.2018;2018;09;11;Tiistai;36;38;74
623;18.09.2018;2018;09;12;Tiistai;44;33;77
623;18.09.2018;2018;09;13;Tiistai;45;40;85
623;18.09.2018;2018;09;14;Tiistai;54;33;87
623;18.09.2018;2018;09;15;Tiistai;78;48;126
623;18.09.2018;2018;09;16;Tiistai;93;44;137
623;18.09.2018;2018;09;17;Tiistai;122;77;199
623;18.09.2018;2018;09;18;Tiistai;74;52;126
623;18.09.2018;2018;09;19;Tiistai;55;38;93
623;18.09.2018;2018;09;20;Tiistai;40;22;62
623;18.09.2018;2018;09;21;Tiistai;27;13;40
623;18.09.2018;2018;09;22;Tiistai;29;10;39
623;18.09.2018;2018;09;23;Tiistai;9;5;14
623;19.09.2018;2018;09;00;Keskiviikko;6;2;8
623;19.09.2018;2018;09;01;Keskiviikko;2;4;6
623;19.09.2018;2018;09;02;Keskiviikko;1;1;2
623;19.09.2018;2018;09;03;Keskiviikko;1;0;1
623;19.09.2018;2018;09;04;Keskiviikko;2;2;4
623;19.09.2018;2018;09;05;Keskiviikko;1;6;7
623;19.09.2018;2018;09;06;Keskiviikko;2;11;13
623;19.09.2018;2018;09;07;Keskiviikko;6;41;47
623;19.09.2018;2018;09;08;Keskiviikko;50;102;152
623;19.09.2018;2018;09;09;Keskiviikko;71;112;183
623;19.09.2018;2018;09;10;Keskiviikko;35;55;90
623;19.09.2018;2018;09;11;Keskiviikko;27;27;54
623;19.09.2018;2018;09;12;Keskiviikko;25;22;47
623;19.09.2018;2018;09;13;Keskiviikko;38;27;65
623;19.09.2018;2018;09;14;Keskiviikko;43;24;67
623;19.09.2018;2018;09;15;Keskiviikko;93;38;131
623;19.09.2018;2018;09;16;Keskiviikko;76;40;116
623;19.09.2018;2018;09;17;Keskiviikko;83;55;138
623;19.09.2018;2018;09;18;Keskiviikko;56;44;100
623;19.09.2018;2018;09;19;Keskiviikko;36;27;63
623;19.09.2018;2018;09;20;Keskiviikko;30;21;51
623;19.09.2018;2018;09;21;Keskiviikko;23;9;32
623;19.09.2018;2018;09;22;Keskiviikko;19;10;29
623;19.09.2018;2018;09;23;Keskiviikko;11;7;18
623;20.09.2018;2018;09;00;Torstai;5;3;8
623;20.09.2018;2018;09;01;Torstai;3;2;5
623;20.09.2018;2018;09;02;Torstai;5;1;6
623;20.09.2018;2018;09;03;Torstai;2;0;2
623;20.09.2018;2018;09;04;Torstai;1;2;3
623;20.09.2018;2018;09;05;Torstai;1;5;6
623;20.09.2018;2018;09;06;Torstai;2;8;10
623;20.09.2018;2018;09;07;Torstai;7;53;60
623;20.09.2018;2018;09;08;Torstai;47;111;158
623;20.09.2018;2018;09;09;Torstai;62;119;181
623;20.09.2018;2018;09;10;Torstai;29;62;91
623;20.09.2018;2018;09;11;Torstai;28;37;65
623;20.09.2018;2018;09;12;Torstai;43;36;79
623;20.09.2018;2018;09;13;Torstai;36;44;80
623;20.09.2018;2018;09;14;Torstai;31;17;48
623;20.09.2018;2018;09;15;Torstai;99;50;149
623;20.09.2018;2018;09;16;Torstai;98;45;143
623;20.09.2018;2018;09;17;Torstai;103;49;152
623;20.09.2018;2018;09;18;Torstai;48;46;94
623;20.09.2018;2018;09;19;Torstai;36;30;66
623;20.09.2018;2018;09;20;Torstai;50;32;82
623;20.09.2018;2018;09;21;Torstai;19;10;29
623;20.09.2018;2018;09;22;Torstai;31;10;41
623;20.09.2018;2018;09;23;Torstai;10;6;16
623;21.09.2018;2018;09;00;Perjantai;7;2;9
623;21.09.2018;2018;09;01;Perjantai;1;0;1
623;21.09.2018;2018;09;02;Perjantai;2;4;6
623;21.09.2018;2018;09;03;Perjantai;2;1;3
623;21.09.2018;2018;09;04;Perjantai;1;2;3
623;21.09.2018;2018;09;05;Perjantai;2;5;7
623;21.09.2018;2018;09;06;Perjantai;2;6;8
623;21.09.2018;2018;09;07;Perjantai;7;46;53
623;21.09.2018;2018;09;08;Perjantai;33;74;107
623;21.09.2018;2018;09;09;Perjantai;52;107;159
623;21.09.2018;2018;09;10;Perjantai;17;62;79
623;21.09.2018;2018;09;11;Perjantai;25;31;56
623;21.09.2018;2018;09;12;Perjantai;37;40;77
623;21.09.2018;2018;09;13;Perjantai;42;41;83
623;21.09.2018;2018;09;14;Perjantai;60;37;97
623;21.09.2018;2018;09;15;Perjantai;88;45;133
623;21.09.2018;2018;09;16;Perjantai;74;47;121
623;21.09.2018;2018;09;17;Perjantai;74;53;127
623;21.09.2018;2018;09;18;Perjantai;38;36;74
623;21.09.2018;2018;09;19;Perjantai;27;26;53
623;21.09.2018;2018;09;20;Perjantai;30;15;45
623;21.09.2018;2018;09;21;Perjantai;13;10;23
623;21.09.2018;2018;09;22;Perjantai;11;11;22
623;21.09.2018;2018;09;23;Perjantai;11;5;16
623;22.09.2018;2018;09;00;Lauantai;10;6;16
623;22.09.2018;2018;09;01;Lauantai;8;6;14
623;22.09.2018;2018;09;02;Lauantai;2;8;10
623;22.09.2018;2018;09;03;Lauantai;3;1;4
623;22.09.2018;2018;09;04;Lauantai;4;0;4
623;22.09.2018;2018;09;05;Lauantai;3;3;6
623;22.09.2018;2018;09;06;Lauantai;5;4;9
623;22.09.2018;2018;09;07;Lauantai;1;7;8
623;22.09.2018;2018;09;08;Lauantai;2;4;6
623;22.09.2018;2018;09;09;Lauantai;2;10;12
623;22.09.2018;2018;09;10;Lauantai;3;7;10
623;22.09.2018;2018;09;11;Lauantai;6;7;13
623;22.09.2018;2018;09;12;Lauantai;7;13;20
623;22.09.2018;2018;09;13;Lauantai;14;14;28
623;22.09.2018;2018;09;14;Lauantai;18;27;45
623;22.09.2018;2018;09;15;Lauantai;22;8;30
623;22.09.2018;2018;09;16;Lauantai;22;13;35
623;22.09.2018;2018;09;17;Lauantai;12;13;25
623;22.09.2018;2018;09;18;Lauantai;23;20;43
623;22.09.2018;2018;09;19;Lauantai;9;14;23
623;22.09.2018;2018;09;20;Lauantai;25;14;39
623;22.09.2018;2018;09;21;Lauantai;12;10;22
623;22.09.2018;2018;09;22;Lauantai;10;10;20
623;22.09.2018;2018;09;23;Lauantai;7;5;12
623;23.09.2018;2018;09;00;Sunnuntai;11;4;15
623;23.09.2018;2018;09;01;Sunnuntai;2;5;7
623;23.09.2018;2018;09;02;Sunnuntai;7;2;9
623;23.09.2018;2018;09;03;Sunnuntai;2;0;2
623;23.09.2018;2018;09;04;Sunnuntai;2;1;3
623;23.09.2018;2018;09;05;Sunnuntai;3;1;4
623;23.09.2018;2018;09;06;Sunnuntai;5;1;6
623;23.09.2018;2018;09;07;Sunnuntai;0;9;9
623;23.09.2018;2018;09;08;Sunnuntai;0;1;1
623;23.09.2018;2018;09;09;Sunnuntai;0;7;7
623;23.09.2018;2018;09;10;Sunnuntai;12;15;27
623;23.09.2018;2018;09;11;Sunnuntai;13;13;26
623;23.09.2018;2018;09;12;Sunnuntai;12;24;36
623;23.09.2018;2018;09;13;Sunnuntai;17;30;47
623;23.09.2018;2018;09;14;Sunnuntai;25;31;56
623;23.09.2018;2018;09;15;Sunnuntai;43;33;76
623;23.09.2018;2018;09;16;Sunnuntai;30;24;54
623;23.09.2018;2018;09;17;Sunnuntai;30;24;54
623;23.09.2018;2018;09;18;Sunnuntai;12;14;26
623;23.09.2018;2018;09;19;Sunnuntai;24;19;43
623;23.09.2018;2018;09;20;Sunnuntai;12;12;24
623;23.09.2018;2018;09;21;Sunnuntai;14;9;23
623;23.09.2018;2018;09;22;Sunnuntai;14;4;18
623;23.09.2018;2018;09;23;Sunnuntai;4;2;6
623;24.09.2018;2018;09;00;Maanantai;2;2;4
623;24.09.2018;2018;09;01;Maanantai;1;1;2
623;24.09.2018;2018;09;02;Maanantai;1;0;1
623;24.09.2018;2018;09;03;Maanantai;0;0;0
623;24.09.2018;2018;09;04;Maanantai;0;2;2
623;24.09.2018;2018;09;05;Maanantai;4;3;7
623;24.09.2018;2018;09;06;Maanantai;1;10;11
623;24.09.2018;2018;09;07;Maanantai;4;33;37
623;24.09.2018;2018;09;08;Maanantai;46;91;137
623;24.09.2018;2018;09;09;Maanantai;66;137;203
623;24.09.2018;2018;09;10;Maanantai;36;62;98
623;24.09.2018;2018;09;11;Maanantai;19;47;66
623;24.09.2018;2018;09;12;Maanantai;34;33;67
623;24.09.2018;2018;09;13;Maanantai;46;38;84
623;24.09.2018;2018;09;14;Maanantai;59;25;84
623;24.09.2018;2018;09;15;Maanantai;77;48;125
623;24.09.2018;2018;09;16;Maanantai;97;57;154
623;24.09.2018;2018;09;17;Maanantai;113;72;185
623;24.09.2018;2018;09;18;Maanantai;60;49;109
623;24.09.2018;2018;09;19;Maanantai;38;31;69
623;24.09.2018;2018;09;20;Maanantai;38;18;56
623;24.09.2018;2018;09;21;Maanantai;25;11;36
623;24.09.2018;2018;09;22;Maanantai;19;9;28
623;24.09.2018;2018;09;23;Maanantai;10;4;14
623;25.09.2018;2018;09;00;Tiistai;2;2;4
623;25.09.2018;2018;09;01;Tiistai;3;3;6
623;25.09.2018;2018;09;02;Tiistai;1;1;2
623;25.09.2018;2018;09;03;Tiistai;2;2;4
623;25.09.2018;2018;09;04;Tiistai;2;1;3
623;25.09.2018;2018;09;05;Tiistai;0;4;4
623;25.09.2018;2018;09;06;Tiistai;2;12;14
623;25.09.2018;2018;09;07;Tiistai;6;52;58
623;25.09.2018;2018;09;08;Tiistai;64;114;178
623;25.09.2018;2018;09;09;Tiistai;65;125;190
623;25.09.2018;2018;09;10;Tiistai;36;51;87
623;25.09.2018;2018;09;11;Tiistai;15;34;49
623;25.09.2018;2018;09;12;Tiistai;33;36;69
623;25.09.2018;2018;09;13;Tiistai;47;40;87
623;25.09.2018;2018;09;14;Tiistai;51;27;78
623;25.09.2018;2018;09;15;Tiistai;97;57;154
623;25.09.2018;2018;09;16;Tiistai;95;47;142
623;25.09.2018;2018;09;17;Tiistai;119;70;189
623;25.09.2018;2018;09;18;Tiistai;53;48;101
623;25.09.2018;2018;09;19;Tiistai;38;33;71
623;25.09.2018;2018;09;20;Tiistai;47;19;66
623;25.09.2018;2018;09;21;Tiistai;21;13;34
623;25.09.2018;2018;09;22;Tiistai;31;7;38
623;25.09.2018;2018;09;23;Tiistai;18;3;21
623;26.09.2018;2018;09;00;Keskiviikko;2;4;6
623;26.09.2018;2018;09;01;Keskiviikko;2;3;5
623;26.09.2018;2018;09;02;Keskiviikko;1;1;2
623;26.09.2018;2018;09;03;Keskiviikko;0;2;2
623;26.09.2018;2018;09;04;Keskiviikko;3;0;3
623;26.09.2018;2018;09;05;Keskiviikko;1;6;7
623;26.09.2018;2018;09;06;Keskiviikko;1;6;7
623;26.09.2018;2018;09;07;Keskiviikko;7;35;42
623;26.09.2018;2018;09;08;Keskiviikko;35;72;107
623;26.09.2018;2018;09;09;Keskiviikko;42;85;127
623;26.09.2018;2018;09;10;Keskiviikko;31;60;91
623;26.09.2018;2018;09;11;Keskiviikko;22;18;40
623;26.09.2018;2018;09;12;Keskiviikko;29;19;48
623;26.09.2018;2018;09;13;Keskiviikko;22;22;44
623;26.09.2018;2018;09;14;Keskiviikko;36;16;52
623;26.09.2018;2018;09;15;Keskiviikko;62;24;86
623;26.09.2018;2018;09;16;Keskiviikko;46;26;72
623;26.09.2018;2018;09;17;Keskiviikko;61;49;110
623;26.09.2018;2018;09;18;Keskiviikko;41;29;70
623;26.09.2018;2018;09;19;Keskiviikko;34;29;63
623;26.09.2018;2018;09;20;Keskiviikko;28;25;53
623;26.09.2018;2018;09;21;Keskiviikko;24;6;30
623;26.09.2018;2018;09;22;Keskiviikko;17;9;26
623;26.09.2018;2018;09;23;Keskiviikko;6;7;13
623;27.09.2018;2018;09;00;Torstai;3;0;3
623;27.09.2018;2018;09;01;Torstai;7;1;8
623;27.09.2018;2018;09;02;Torstai;0;2;2
623;27.09.2018;2018;09;03;Torstai;2;2;4
623;27.09.2018;2018;09;04;Torstai;0;1;1
623;27.09.2018;2018;09;05;Torstai;0;6;6
623;27.09.2018;2018;09;06;Torstai;4;5;9
623;27.09.2018;2018;09;07;Torstai;5;30;35
623;27.09.2018;2018;09;08;Torstai;30;69;99
623;27.09.2018;2018;09;09;Torstai;34;93;127
623;27.09.2018;2018;09;10;Torstai;23;40;63
623;27.09.2018;2018;09;11;Torstai;29;19;48
623;27.09.2018;2018;09;12;Torstai;31;33;64
623;27.09.2018;2018;09;13;Torstai;27;18;45
623;27.09.2018;2018;09;14;Torstai;31;28;59
623;27.09.2018;2018;09;15;Torstai;53;40;93
623;27.09.2018;2018;09;16;Torstai;55;35;90
623;27.09.2018;2018;09;17;Torstai;79;49;128
623;27.09.2018;2018;09;18;Torstai;40;46;86
623;27.09.2018;2018;09;19;Torstai;32;33;65
623;27.09.2018;2018;09;20;Torstai;49;28;77
623;27.09.2018;2018;09;21;Torstai;32;12;44
623;27.09.2018;2018;09;22;Torstai;15;7;22
623;27.09.2018;2018;09;23;Torstai;14;1;15
623;28.09.2018;2018;09;00;Perjantai;9;1;10
623;28.09.2018;2018;09;01;Perjantai;2;1;3
623;28.09.2018;2018;09;02;Perjantai;3;1;4
623;28.09.2018;2018;09;03;Perjantai;2;2;4
623;28.09.2018;2018;09;04;Perjantai;2;0;2
623;28.09.2018;2018;09;05;Perjantai;0;2;2
623;28.09.2018;2018;09;06;Perjantai;3;8;11
623;28.09.2018;2018;09;07;Perjantai;5;39;44
623;28.09.2018;2018;09;08;Perjantai;46;97;143
623;28.09.2018;2018;09;09;Perjantai;43;88;131
623;28.09.2018;2018;09;10;Perjantai;43;56;99
623;28.09.2018;2018;09;11;Perjantai;24;35;59
623;28.09.2018;2018;09;12;Perjantai;47;34;81
623;28.09.2018;2018;09;13;Perjantai;58;36;94
623;28.09.2018;2018;09;14;Perjantai;66;41;107
623;28.09.2018;2018;09;15;Perjantai;81;54;135
623;28.09.2018;2018;09;16;Perjantai;62;45;107
623;28.09.2018;2018;09;17;Perjantai;81;47;128
623;28.09.2018;2018;09;18;Perjantai;59;33;92
623;28.09.2018;2018;09;19;Perjantai;38;33;71
623;28.09.2018;2018;09;20;Perjantai;31;32;63
623;28.09.2018;2018;09;21;Perjantai;21;14;35
623;28.09.2018;2018;09;22;Perjantai;14;13;27
623;28.09.2018;2018;09;23;Perjantai;16;6;22
623;29.09.2018;2018;09;00;Lauantai;14;12;26
623;29.09.2018;2018;09;01;Lauantai;7;5;12
623;29.09.2018;2018;09;02;Lauantai;4;0;4
623;29.09.2018;2018;09;03;Lauantai;1;1;2
623;29.09.2018;2018;09;04;Lauantai;6;2;8
623;29.09.2018;2018;09;05;Lauantai;6;1;7
623;29.09.2018;2018;09;06;Lauantai;0;3;3
623;29.09.2018;2018;09;07;Lauantai;2;5;7
623;29.09.2018;2018;09;08;Lauantai;3;3;6
623;29.09.2018;2018;09;09;Lauantai;3;10;13
623;29.09.2018;2018;09;10;Lauantai;8;18;26
623;29.09.2018;2018;09;11;Lauantai;17;25;42
623;29.09.2018;2018;09;12;Lauantai;16;25;41
623;29.09.2018;2018;09;13;Lauantai;20;28;48
623;29.09.2018;2018;09;14;Lauantai;32;23;55
623;29.09.2018;2018;09;15;Lauantai;30;18;48
623;29.09.2018;2018;09;16;Lauantai;35;24;59
623;29.09.2018;2018;09;17;Lauantai;26;29;55
623;29.09.2018;2018;09;18;Lauantai;31;24;55
623;29.09.2018;2018;09;19;Lauantai;17;23;40
623;29.09.2018;2018;09;20;Lauantai;33;19;52
623;29.09.2018;2018;09;21;Lauantai;17;16;33
623;29.09.2018;2018;09;22;Lauantai;16;3;19
623;29.09.2018;2018;09;23;Lauantai;15;10;25
623;30.09.2018;2018;09;00;Sunnuntai;9;11;20
623;30.09.2018;2018;09;01;Sunnuntai;8;7;15
623;30.09.2018;2018;09;02;Sunnuntai;2;5;7
623;30.09.2018;2018;09;03;Sunnuntai;8;2;10
623;30.09.2018;2018;09;04;Sunnuntai;13;1;14
623;30.09.2018;2018;09;05;Sunnuntai;5;2;7
623;30.09.2018;2018;09;06;Sunnuntai;4;0;4
623;30.09.2018;2018;09;07;Sunnuntai;0;6;6
623;30.09.2018;2018;09;08;Sunnuntai;2;3;5
623;30.09.2018;2018;09;09;Sunnuntai;3;8;11
623;30.09.2018;2018;09;10;Sunnuntai;7;17;24
623;30.09.2018;2018;09;11;Sunnuntai;5;13;18
623;30.09.2018;2018;09;12;Sunnuntai;17;40;57
623;30.09.2018;2018;09;13;Sunnuntai;23;40;63
623;30.09.2018;2018;09;14;Sunnuntai;33;24;57
623;30.09.2018;2018;09;15;Sunnuntai;30;26;56
623;30.09.2018;2018;09;16;Sunnuntai;44;31;75
623;30.09.2018;2018;09;17;Sunnuntai;27;19;46
623;30.09.2018;2018;09;18;Sunnuntai;18;24;42
623;30.09.2018;2018;09;19;Sunnuntai;26;30;56
623;30.09.2018;2018;09;20;Sunnuntai;22;21;43
623;30.09.2018;2018;09;21;Sunnuntai;19;16;35
623;30.09.2018;2018;09;22;Sunnuntai;14;9;23
623;30.09.2018;2018;09;23;Sunnuntai;7;5;12