MittausID;Pvm;Vuosi;Kuukausi;Tunti;Viikonpäivä;PP_1;PP_2;PP_YHT
622;06.02.2017;2017;02;00;Maanantai;0;2;2
622;06.02.2017;2017;02;01;Maanantai;1;0;1
622;06.02.2017;2017;02;02;Maanantai;0;0;0
622;06.02.2017;2017;02;03;Maanantai;0;0;0
622;06.02.2017;2017;02;04;Maanantai;1;0;1
622;06.02.2017;2017;02;05;Maanantai;0;0;0
622;06.02.2017;2017;02;06;Maanantai;2;5;7
622;06.02.2017;2017;02;07;Maanantai;8;20;28
622;06.02.2017;2017;02;08;Maanantai;20;24;44
622;06.02.2017;2017;02;09;Maanantai;28;28;56
622;06.02.2017;2017;02;10;Maanantai;23;15;38
622;06.02.2017;2017;02;11;Maanantai;8;14;22
622;06.02.2017;2017;02;12;Maanantai;10;16;26
622;06.02.2017;2017;02;13;Maanantai;19;20;39
622;06.02.2017;2017;02;14;Maanantai;16;12;28
622;06.02.2017;2017;02;15;Maanantai;29;26;55
622;06.02.2017;2017;02;16;Maanantai;37;15;52
622;06.02.2017;2017;02;17;Maanantai;51;26;77
622;06.02.2017;2017;02;18;Maanantai;13;22;35
622;06.02.2017;2017;02;19;Maanantai;26;15;41
622;06.02.2017;2017;02;20;Maanantai;13;5;18
622;06.02.2017;2017;02;21;Maanantai;13;7;20
622;06.02.2017;2017;02;22;Maanantai;7;5;12
622;06.02.2017;2017;02;23;Maanantai;3;3;6
622;07.02.2017;2017;02;00;Tiistai;0;1;1
622;07.02.2017;2017;02;01;Tiistai;0;1;1
622;07.02.2017;2017;02;02;Tiistai;0;0;0
622;07.02.2017;2017;02;03;Tiistai;0;0;0
622;07.02.2017;2017;02;04;Tiistai;0;0;0
622;07.02.2017;2017;02;05;Tiistai;0;1;1
622;07.02.2017;2017;02;06;Tiistai;4;6;10
622;07.02.2017;2017;02;07;Tiistai;7;19;26
622;07.02.2017;2017;02;08;Tiistai;26;29;55
622;07.02.2017;2017;02;09;Tiistai;25;19;44
622;07.02.2017;2017;02;10;Tiistai;15;17;32
622;07.02.2017;2017;02;11;Tiistai;7;8;15
622;07.02.2017;2017;02;12;Tiistai;9;16;25
622;07.02.2017;2017;02;13;Tiistai;16;9;25
622;07.02.2017;2017;02;14;Tiistai;13;15;28
622;07.02.2017;2017;02;15;Tiistai;22;20;42
622;07.02.2017;2017;02;16;Tiistai;20;16;36
622;07.02.2017;2017;02;17;Tiistai;36;21;57
622;07.02.2017;2017;02;18;Tiistai;23;15;38
622;07.02.2017;2017;02;19;Tiistai;23;11;34
622;07.02.2017;2017;02;20;Tiistai;16;5;21
622;07.02.2017;2017;02;21;Tiistai;12;5;17
622;07.02.2017;2017;02;22;Tiistai;9;8;17
622;07.02.2017;2017;02;23;Tiistai;2;4;6
622;08.02.2017;2017;02;00;Keskiviikko;1;2;3
622;08.02.2017;2017;02;01;Keskiviikko;0;2;2
622;08.02.2017;2017;02;02;Keskiviikko;2;2;4
622;08.02.2017;2017;02;03;Keskiviikko;1;1;2
622;08.02.2017;2017;02;04;Keskiviikko;0;0;0
622;08.02.2017;2017;02;05;Keskiviikko;2;2;4
622;08.02.2017;2017;02;06;Keskiviikko;6;2;8
622;08.02.2017;2017;02;07;Keskiviikko;20;5;25
622;08.02.2017;2017;02;08;Keskiviikko;29;17;46
622;08.02.2017;2017;02;09;Keskiviikko;22;26;48
622;08.02.2017;2017;02;10;Keskiviikko;14;14;28
622;08.02.2017;2017;02;11;Keskiviikko;12;4;16
622;08.02.2017;2017;02;12;Keskiviikko;13;7;20
622;08.02.2017;2017;02;13;Keskiviikko;9;14;23
622;08.02.2017;2017;02;14;Keskiviikko;19;9;28
622;08.02.2017;2017;02;15;Keskiviikko;15;22;37
622;08.02.2017;2017;02;16;Keskiviikko;19;37;56
622;08.02.2017;2017;02;17;Keskiviikko;16;39;55
622;08.02.2017;2017;02;18;Keskiviikko;19;21;40
622;08.02.2017;2017;02;19;Keskiviikko;10;16;26
622;08.02.2017;2017;02;20;Keskiviikko;10;19;29
622;08.02.2017;2017;02;21;Keskiviikko;13;14;27
622;08.02.2017;2017;02;22;Keskiviikko;4;8;12
622;08.02.2017;2017;02;23;Keskiviikko;6;2;8
622;09.02.2017;2017;02;00;Torstai;0;0;0
622;09.02.2017;2017;02;01;Torstai;0;0;0
622;09.02.2017;2017;02;02;Torstai;1;2;3
622;09.02.2017;2017;02;03;Torstai;0;0;0
622;09.02.2017;2017;02;04;Torstai;0;0;0
622;09.02.2017;2017;02;05;Torstai;0;2;2
622;09.02.2017;2017;02;06;Torstai;1;1;2
622;09.02.2017;2017;02;07;Torstai;5;9;14
622;09.02.2017;2017;02;08;Torstai;11;13;24
622;09.02.2017;2017;02;09;Torstai;23;14;37
622;09.02.2017;2017;02;10;Torstai;4;13;17
622;09.02.2017;2017;02;11;Torstai;8;6;14
622;09.02.2017;2017;02;12;Torstai;10;9;19
622;09.02.2017;2017;02;13;Torstai;7;4;11
622;09.02.2017;2017;02;14;Torstai;10;8;18
622;09.02.2017;2017;02;15;Torstai;13;8;21
622;09.02.2017;2017;02;16;Torstai;18;15;33
622;09.02.2017;2017;02;17;Torstai;25;18;43
622;09.02.2017;2017;02;18;Torstai;15;17;32
622;09.02.2017;2017;02;19;Torstai;21;11;32
622;09.02.2017;2017;02;20;Torstai;10;10;20
622;09.02.2017;2017;02;21;Torstai;9;5;14
622;09.02.2017;2017;02;22;Torstai;8;0;8
622;09.02.2017;2017;02;23;Torstai;2;1;3
622;10.02.2017;2017;02;00;Perjantai;1;1;2
622;10.02.2017;2017;02;01;Perjantai;2;1;3
622;10.02.2017;2017;02;02;Perjantai;0;1;1
622;10.02.2017;2017;02;03;Perjantai;1;1;2
622;10.02.2017;2017;02;04;Perjantai;0;0;0
622;10.02.2017;2017;02;05;Perjantai;0;2;2
622;10.02.2017;2017;02;06;Perjantai;2;0;2
622;10.02.2017;2017;02;07;Perjantai;3;20;23
622;10.02.2017;2017;02;08;Perjantai;20;28;48
622;10.02.2017;2017;02;09;Perjantai;14;20;34
622;10.02.2017;2017;02;10;Perjantai;12;17;29
622;10.02.2017;2017;02;11;Perjantai;8;6;14
622;10.02.2017;2017;02;12;Perjantai;10;13;23
622;10.02.2017;2017;02;13;Perjantai;20;16;36
622;10.02.2017;2017;02;14;Perjantai;22;17;39
622;10.02.2017;2017;02;15;Perjantai;28;10;38
622;10.02.2017;2017;02;16;Perjantai;30;17;47
622;10.02.2017;2017;02;17;Perjantai;41;22;63
622;10.02.2017;2017;02;18;Perjantai;19;22;41
622;10.02.2017;2017;02;19;Perjantai;16;11;27
622;10.02.2017;2017;02;20;Perjantai;9;6;15
622;10.02.2017;2017;02;21;Perjantai;13;7;20
622;10.02.2017;2017;02;22;Perjantai;4;3;7
622;10.02.2017;2017;02;23;Perjantai;4;4;8
622;11.02.2017;2017;02;00;Lauantai;2;1;3
622;11.02.2017;2017;02;01;Lauantai;2;0;2
622;11.02.2017;2017;02;02;Lauantai;2;0;2
622;11.02.2017;2017;02;03;Lauantai;1;1;2
622;11.02.2017;2017;02;04;Lauantai;2;1;3
622;11.02.2017;2017;02;05;Lauantai;0;2;2
622;11.02.2017;2017;02;06;Lauantai;1;2;3
622;11.02.2017;2017;02;07;Lauantai;1;2;3
622;11.02.2017;2017;02;08;Lauantai;2;4;6
622;11.02.2017;2017;02;09;Lauantai;3;1;4
622;11.02.2017;2017;02;10;Lauantai;5;10;15
622;11.02.2017;2017;02;11;Lauantai;10;10;20
622;11.02.2017;2017;02;12;Lauantai;13;10;23
622;11.02.2017;2017;02;13;Lauantai;9;10;19
622;11.02.2017;2017;02;14;Lauantai;9;9;18
622;11.02.2017;2017;02;15;Lauantai;10;14;24
622;11.02.2017;2017;02;16;Lauantai;6;13;19
622;11.02.2017;2017;02;17;Lauantai;22;11;33
622;11.02.2017;2017;02;18;Lauantai;11;3;14
622;11.02.2017;2017;02;19;Lauantai;6;5;11
622;11.02.2017;2017;02;20;Lauantai;7;5;12
622;11.02.2017;2017;02;21;Lauantai;9;5;14
622;11.02.2017;2017;02;22;Lauantai;4;0;4
622;11.02.2017;2017;02;23;Lauantai;3;1;4
622;12.02.2017;2017;02;00;Sunnuntai;2;2;4
622;12.02.2017;2017;02;01;Sunnuntai;4;1;5
622;12.02.2017;2017;02;02;Sunnuntai;3;1;4
622;12.02.2017;2017;02;03;Sunnuntai;1;1;2
622;12.02.2017;2017;02;04;Sunnuntai;3;2;5
622;12.02.2017;2017;02;05;Sunnuntai;2;2;4
622;12.02.2017;2017;02;06;Sunnuntai;0;1;1
622;12.02.2017;2017;02;07;Sunnuntai;1;3;4
622;12.02.2017;2017;02;08;Sunnuntai;0;3;3
622;12.02.2017;2017;02;09;Sunnuntai;0;2;2
622;12.02.2017;2017;02;10;Sunnuntai;1;3;4
622;12.02.2017;2017;02;11;Sunnuntai;8;5;13
622;12.02.2017;2017;02;12;Sunnuntai;5;5;10
622;12.02.2017;2017;02;13;Sunnuntai;9;10;19
622;12.02.2017;2017;02;14;Sunnuntai;12;10;22
622;12.02.2017;2017;02;15;Sunnuntai;18;5;23
622;12.02.2017;2017;02;16;Sunnuntai;6;10;16
622;12.02.2017;2017;02;17;Sunnuntai;12;10;22
622;12.02.2017;2017;02;18;Sunnuntai;10;6;16
622;12.02.2017;2017;02;19;Sunnuntai;8;6;14
622;12.02.2017;2017;02;20;Sunnuntai;6;9;15
622;12.02.2017;2017;02;21;Sunnuntai;8;3;11
622;12.02.2017;2017;02;22;Sunnuntai;2;2;4
622;12.02.2017;2017;02;23;Sunnuntai;5;0;5
622;13.02.2017;2017;02;00;Maanantai;0;2;2
622;13.02.2017;2017;02;01;Maanantai;1;0;1
622;13.02.2017;2017;02;02;Maanantai;0;0;0
622;13.02.2017;2017;02;03;Maanantai;0;0;0
622;13.02.2017;2017;02;04;Maanantai;1;0;1
622;13.02.2017;2017;02;05;Maanantai;0;0;0
622;13.02.2017;2017;02;06;Maanantai;2;5;7
622;13.02.2017;2017;02;07;Maanantai;8;20;28
622;13.02.2017;2017;02;08;Maanantai;20;24;44
622;13.02.2017;2017;02;09;Maanantai;28;28;56
622;13.02.2017;2017;02;10;Maanantai;23;15;38
622;13.02.2017;2017;02;11;Maanantai;8;14;22
622;13.02.2017;2017;02;12;Maanantai;10;16;26
622;13.02.2017;2017;02;13;Maanantai;19;20;39
622;13.02.2017;2017;02;14;Maanantai;16;12;28
622;13.02.2017;2017;02;15;Maanantai;29;26;55
622;13.02.2017;2017;02;16;Maanantai;37;15;52
622;13.02.2017;2017;02;17;Maanantai;51;26;77
622;13.02.2017;2017;02;18;Maanantai;13;22;35
622;13.02.2017;2017;02;19;Maanantai;26;15;41
622;13.02.2017;2017;02;20;Maanantai;13;5;18
622;13.02.2017;2017;02;21;Maanantai;13;7;20
622;13.02.2017;2017;02;22;Maanantai;7;5;12
622;13.02.2017;2017;02;23;Maanantai;3;3;6
622;14.02.2017;2017;02;00;Tiistai;0;1;1
622;14.02.2017;2017;02;01;Tiistai;0;1;1
622;14.02.2017;2017;02;02;Tiistai;0;0;0
622;14.02.2017;2017;02;03;Tiistai;0;0;0
622;14.02.2017;2017;02;04;Tiistai;0;0;0
622;14.02.2017;2017;02;05;Tiistai;0;1;1
622;14.02.2017;2017;02;06;Tiistai;4;6;10
622;14.02.2017;2017;02;07;Tiistai;7;19;26
622;14.02.2017;2017;02;08;Tiistai;26;29;55
622;14.02.2017;2017;02;09;Tiistai;25;19;44
622;14.02.2017;2017;02;10;Tiistai;15;17;32
622;14.02.2017;2017;02;11;Tiistai;7;8;15
622;14.02.2017;2017;02;12;Tiistai;9;16;25
622;14.02.2017;2017;02;13;Tiistai;16;9;25
622;14.02.2017;2017;02;14;Tiistai;13;15;28
622;14.02.2017;2017;02;15;Tiistai;22;20;42
622;14.02.2017;2017;02;16;Tiistai;20;16;36
622;14.02.2017;2017;02;17;Tiistai;36;21;57
622;14.02.2017;2017;02;18;Tiistai;23;15;38
622;14.02.2017;2017;02;19;Tiistai;23;11;34
622;14.02.2017;2017;02;20;Tiistai;16;5;21
622;14.02.2017;2017;02;21;Tiistai;12;5;17
622;14.02.2017;2017;02;22;Tiistai;9;8;17
622;14.02.2017;2017;02;23;Tiistai;2;4;6
622;15.02.2017;2017;02;00;Keskiviikko;2;1;3
622;15.02.2017;2017;02;01;Keskiviikko;2;0;2
622;15.02.2017;2017;02;02;Keskiviikko;2;2;4
622;15.02.2017;2017;02;03;Keskiviikko;1;1;2
622;15.02.2017;2017;02;04;Keskiviikko;0;0;0
622;15.02.2017;2017;02;05;Keskiviikko;2;2;4
622;15.02.2017;2017;02;06;Keskiviikko;2;6;8
622;15.02.2017;2017;02;07;Keskiviikko;5;20;25
622;15.02.2017;2017;02;08;Keskiviikko;17;29;46
622;15.02.2017;2017;02;09;Keskiviikko;26;22;48
622;15.02.2017;2017;02;10;Keskiviikko;14;14;28
622;15.02.2017;2017;02;11;Keskiviikko;4;12;16
622;15.02.2017;2017;02;12;Keskiviikko;7;13;20
622;15.02.2017;2017;02;13;Keskiviikko;14;9;23
622;15.02.2017;2017;02;14;Keskiviikko;9;19;28
622;15.02.2017;2017;02;15;Keskiviikko;22;15;37
622;15.02.2017;2017;02;16;Keskiviikko;37;19;56
622;15.02.2017;2017;02;17;Keskiviikko;39;16;55
622;15.02.2017;2017;02;18;Keskiviikko;21;19;40
622;15.02.2017;2017;02;19;Keskiviikko;16;10;26
622;15.02.2017;2017;02;20;Keskiviikko;19;10;29
622;15.02.2017;2017;02;21;Keskiviikko;14;13;27
622;15.02.2017;2017;02;22;Keskiviikko;8;4;12
622;15.02.2017;2017;02;23;Keskiviikko;2;6;8
622;16.02.2017;2017;02;00;Torstai;3;2;5
622;16.02.2017;2017;02;01;Torstai;1;1;2
622;16.02.2017;2017;02;02;Torstai;1;1;2
622;16.02.2017;2017;02;03;Torstai;2;0;2
622;16.02.2017;2017;02;04;Torstai;0;0;0
622;16.02.2017;2017;02;05;Torstai;0;2;2
622;16.02.2017;2017;02;06;Torstai;2;4;6
622;16.02.2017;2017;02;07;Torstai;5;20;25
622;16.02.2017;2017;02;08;Torstai;20;36;56
622;16.02.2017;2017;02;09;Torstai;21;25;46
622;16.02.2017;2017;02;10;Torstai;10;12;22
622;16.02.2017;2017;02;11;Torstai;9;17;26
622;16.02.2017;2017;02;12;Torstai;12;16;28
622;16.02.2017;2017;02;13;Torstai;9;12;21
622;16.02.2017;2017;02;14;Torstai;9;16;25
622;16.02.2017;2017;02;15;Torstai;25;17;42
622;16.02.2017;2017;02;16;Torstai;31;24;55
622;16.02.2017;2017;02;17;Torstai;45;20;65
622;16.02.2017;2017;02;18;Torstai;23;17;40
622;16.02.2017;2017;02;19;Torstai;16;17;33
622;16.02.2017;2017;02;20;Torstai;12;13;25
622;16.02.2017;2017;02;21;Torstai;15;3;18
622;16.02.2017;2017;02;22;Torstai;9;5;14
622;16.02.2017;2017;02;23;Torstai;2;2;4
622;17.02.2017;2017;02;00;Perjantai;1;0;1
622;17.02.2017;2017;02;01;Perjantai;1;1;2
622;17.02.2017;2017;02;02;Perjantai;2;2;4
622;17.02.2017;2017;02;03;Perjantai;0;0;0
622;17.02.2017;2017;02;04;Perjantai;0;2;2
622;17.02.2017;2017;02;05;Perjantai;2;2;4
622;17.02.2017;2017;02;06;Perjantai;3;4;7
622;17.02.2017;2017;02;07;Perjantai;2;17;19
622;17.02.2017;2017;02;08;Perjantai;21;31;52
622;17.02.2017;2017;02;09;Perjantai;21;24;45
622;17.02.2017;2017;02;10;Perjantai;14;15;29
622;17.02.2017;2017;02;11;Perjantai;11;10;21
622;17.02.2017;2017;02;12;Perjantai;13;20;33
622;17.02.2017;2017;02;13;Perjantai;20;20;40
622;17.02.2017;2017;02;14;Perjantai;20;9;29
622;17.02.2017;2017;02;15;Perjantai;27;20;47
622;17.02.2017;2017;02;16;Perjantai;26;5;31
622;17.02.2017;2017;02;17;Perjantai;37;22;59
622;17.02.2017;2017;02;18;Perjantai;17;20;37
622;17.02.2017;2017;02;19;Perjantai;22;15;37
622;17.02.2017;2017;02;20;Perjantai;15;11;26
622;17.02.2017;2017;02;21;Perjantai;7;12;19
622;17.02.2017;2017;02;22;Perjantai;8;8;16
622;17.02.2017;2017;02;23;Perjantai;11;3;14
622;18.02.2017;2017;02;00;Lauantai;1;3;4
622;18.02.2017;2017;02;01;Lauantai;0;3;3
622;18.02.2017;2017;02;02;Lauantai;5;3;8
622;18.02.2017;2017;02;03;Lauantai;5;2;7
622;18.02.2017;2017;02;04;Lauantai;1;0;1
622;18.02.2017;2017;02;05;Lauantai;3;0;3
622;18.02.2017;2017;02;06;Lauantai;0;2;2
622;18.02.2017;2017;02;07;Lauantai;1;1;2
622;18.02.2017;2017;02;08;Lauantai;2;3;5
622;18.02.2017;2017;02;09;Lauantai;2;3;5
622;18.02.2017;2017;02;10;Lauantai;5;5;10
622;18.02.2017;2017;02;11;Lauantai;4;12;16
622;18.02.2017;2017;02;12;Lauantai;8;12;20
622;18.02.2017;2017;02;13;Lauantai;10;9;19
622;18.02.2017;2017;02;14;Lauantai;17;9;26
622;18.02.2017;2017;02;15;Lauantai;17;20;37
622;18.02.2017;2017;02;16;Lauantai;20;13;33
622;18.02.2017;2017;02;17;Lauantai;11;10;21
622;18.02.2017;2017;02;18;Lauantai;14;10;24
622;18.02.2017;2017;02;19;Lauantai;10;8;18
622;18.02.2017;2017;02;20;Lauantai;8;7;15
622;18.02.2017;2017;02;21;Lauantai;7;4;11
622;18.02.2017;2017;02;22;Lauantai;2;4;6
622;18.02.2017;2017;02;23;Lauantai;3;3;6
622;19.02.2017;2017;02;00;Sunnuntai;4;1;5
622;19.02.2017;2017;02;01;Sunnuntai;0;1;1
622;19.02.2017;2017;02;02;Sunnuntai;2;1;3
622;19.02.2017;2017;02;03;Sunnuntai;2;2;4
622;19.02.2017;2017;02;04;Sunnuntai;0;1;1
622;19.02.2017;2017;02;05;Sunnuntai;0;1;1
622;19.02.2017;2017;02;06;Sunnuntai;2;0;2
622;19.02.2017;2017;02;07;Sunnuntai;1;1;2
622;19.02.2017;2017;02;08;Sunnuntai;1;1;2
622;19.02.2017;2017;02;09;Sunnuntai;1;5;6
622;19.02.2017;2017;02;10;Sunnuntai;0;4;4
622;19.02.2017;2017;02;11;Sunnuntai;7;6;13
622;19.02.2017;2017;02;12;Sunnuntai;8;4;12
622;19.02.2017;2017;02;13;Sunnuntai;17;11;28
622;19.02.2017;2017;02;14;Sunnuntai;14;23;37
622;19.02.2017;2017;02;15;Sunnuntai;17;14;31
622;19.02.2017;2017;02;16;Sunnuntai;9;7;16
622;19.02.2017;2017;02;17;Sunnuntai;9;9;18
622;19.02.2017;2017;02;18;Sunnuntai;10;11;21
622;19.02.2017;2017;02;19;Sunnuntai;10;16;26
622;19.02.2017;2017;02;20;Sunnuntai;10;5;15
622;19.02.2017;2017;02;21;Sunnuntai;9;5;14
622;19.02.2017;2017;02;22;Sunnuntai;4;3;7
622;19.02.2017;2017;02;23;Sunnuntai;1;2;3
622;20.02.2017;2017;02;00;Maanantai;0;0;0
622;20.02.2017;2017;02;01;Maanantai;1;0;1
622;20.02.2017;2017;02;02;Maanantai;0;0;0
622;20.02.2017;2017;02;03;Maanantai;0;1;1
622;20.02.2017;2017;02;04;Maanantai;0;0;0
622;20.02.2017;2017;02;05;Maanantai;2;1;3
622;20.02.2017;2017;02;06;Maanantai;4;15;19
622;20.02.2017;2017;02;07;Maanantai;6;18;24
622;20.02.2017;2017;02;08;Maanantai;21;25;46
622;20.02.2017;2017;02;09;Maanantai;24;23;47
622;20.02.2017;2017;02;10;Maanantai;9;16;25
622;20.02.2017;2017;02;11;Maanantai;9;10;19
622;20.02.2017;2017;02;12;Maanantai;8;14;22
622;20.02.2017;2017;02;13;Maanantai;9;13;22
622;20.02.2017;2017;02;14;Maanantai;14;12;26
622;20.02.2017;2017;02;15;Maanantai;18;17;35
622;20.02.2017;2017;02;16;Maanantai;32;15;47
622;20.02.2017;2017;02;17;Maanantai;41;28;69
622;20.02.2017;2017;02;18;Maanantai;19;15;34
622;20.02.2017;2017;02;19;Maanantai;19;11;30
622;20.02.2017;2017;02;20;Maanantai;14;11;25
622;20.02.2017;2017;02;21;Maanantai;15;7;22
622;20.02.2017;2017;02;22;Maanantai;10;2;12
622;20.02.2017;2017;02;23;Maanantai;5;1;6
622;21.02.2017;2017;02;00;Tiistai;3;1;4
622;21.02.2017;2017;02;01;Tiistai;1;1;2
622;21.02.2017;2017;02;02;Tiistai;0;0;0
622;21.02.2017;2017;02;03;Tiistai;0;1;1
622;21.02.2017;2017;02;04;Tiistai;0;0;0
622;21.02.2017;2017;02;05;Tiistai;0;3;3
622;21.02.2017;2017;02;06;Tiistai;3;6;9
622;21.02.2017;2017;02;07;Tiistai;7;17;24
622;21.02.2017;2017;02;08;Tiistai;27;28;55
622;21.02.2017;2017;02;09;Tiistai;16;19;35
622;21.02.2017;2017;02;10;Tiistai;16;12;28
622;21.02.2017;2017;02;11;Tiistai;7;7;14
622;21.02.2017;2017;02;12;Tiistai;9;7;16
622;21.02.2017;2017;02;13;Tiistai;8;7;15
622;21.02.2017;2017;02;14;Tiistai;9;9;18
622;21.02.2017;2017;02;15;Tiistai;20;24;44
622;21.02.2017;2017;02;16;Tiistai;33;16;49
622;21.02.2017;2017;02;17;Tiistai;31;18;49
622;21.02.2017;2017;02;18;Tiistai;19;10;29
622;21.02.2017;2017;02;19;Tiistai;22;11;33
622;21.02.2017;2017;02;20;Tiistai;4;5;9
622;21.02.2017;2017;02;21;Tiistai;7;8;15
622;21.02.2017;2017;02;22;Tiistai;6;8;14
622;21.02.2017;2017;02;23;Tiistai;1;2;3
622;22.02.2017;2017;02;00;Keskiviikko;1;0;1
622;22.02.2017;2017;02;01;Keskiviikko;1;0;1
622;22.02.2017;2017;02;02;Keskiviikko;2;2;4
622;22.02.2017;2017;02;03;Keskiviikko;0;0;0
622;22.02.2017;2017;02;04;Keskiviikko;0;0;0
622;22.02.2017;2017;02;05;Keskiviikko;0;0;0
622;22.02.2017;2017;02;06;Keskiviikko;2;5;7
622;22.02.2017;2017;02;07;Keskiviikko;6;11;17
622;22.02.2017;2017;02;08;Keskiviikko;13;28;41
622;22.02.2017;2017;02;09;Keskiviikko;12;17;29
622;22.02.2017;2017;02;10;Keskiviikko;11;15;26
622;22.02.2017;2017;02;11;Keskiviikko;12;10;22
622;22.02.2017;2017;02;12;Keskiviikko;9;8;17
622;22.02.2017;2017;02;13;Keskiviikko;15;9;24
622;22.02.2017;2017;02;14;Keskiviikko;6;14;20
622;22.02.2017;2017;02;15;Keskiviikko;25;11;36
622;22.02.2017;2017;02;16;Keskiviikko;21;11;32
622;22.02.2017;2017;02;17;Keskiviikko;31;14;45
622;22.02.2017;2017;02;18;Keskiviikko;20;16;36
622;22.02.2017;2017;02;19;Keskiviikko;19;11;30
622;22.02.2017;2017;02;20;Keskiviikko;13;10;23
622;22.02.2017;2017;02;21;Keskiviikko;17;3;20
622;22.02.2017;2017;02;22;Keskiviikko;6;5;11
622;22.02.2017;2017;02;23;Keskiviikko;5;2;7
622;23.02.2017;2017;02;00;Torstai;4;2;6
622;23.02.2017;2017;02;01;Torstai;1;0;1
622;23.02.2017;2017;02;02;Torstai;0;2;2
622;23.02.2017;2017;02;03;Torstai;0;0;0
622;23.02.2017;2017;02;04;Torstai;1;0;1
622;23.02.2017;2017;02;05;Torstai;1;2;3
622;23.02.2017;2017;02;06;Torstai;1;3;4
622;23.02.2017;2017;02;07;Torstai;2;19;21
622;23.02.2017;2017;02;08;Torstai;15;19;34
622;23.02.2017;2017;02;09;Torstai;18;24;42
622;23.02.2017;2017;02;10;Torstai;7;16;23
622;23.02.2017;2017;02;11;Torstai;4;9;13
622;23.02.2017;2017;02;12;Torstai;6;16;22
622;23.02.2017;2017;02;13;Torstai;11;8;19
622;23.02.2017;2017;02;14;Torstai;11;11;22
622;23.02.2017;2017;02;15;Torstai;15;18;33
622;23.02.2017;2017;02;16;Torstai;21;14;35
622;23.02.2017;2017;02;17;Torstai;20;14;34
622;23.02.2017;2017;02;18;Torstai;15;11;26
622;23.02.2017;2017;02;19;Torstai;11;10;21
622;23.02.2017;2017;02;20;Torstai;8;9;17
622;23.02.2017;2017;02;21;Torstai;7;3;10
622;23.02.2017;2017;02;22;Torstai;7;6;13
622;23.02.2017;2017;02;23;Torstai;2;2;4
622;24.02.2017;2017;02;00;Perjantai;3;3;6
622;24.02.2017;2017;02;01;Perjantai;1;0;1
622;24.02.2017;2017;02;02;Perjantai;1;0;1
622;24.02.2017;2017;02;03;Perjantai;1;0;1
622;24.02.2017;2017;02;04;Perjantai;1;1;2
622;24.02.2017;2017;02;05;Perjantai;4;1;5
622;24.02.2017;2017;02;06;Perjantai;1;5;6
622;24.02.2017;2017;02;07;Perjantai;2;10;12
622;24.02.2017;2017;02;08;Perjantai;13;18;31
622;24.02.2017;2017;02;09;Perjantai;12;16;28
622;24.02.2017;2017;02;10;Perjantai;6;13;19
622;24.02.2017;2017;02;11;Perjantai;10;7;17
622;24.02.2017;2017;02;12;Perjantai;4;7;11
622;24.02.2017;2017;02;13;Perjantai;10;12;22
622;24.02.2017;2017;02;14;Perjantai;8;10;18
622;24.02.2017;2017;02;15;Perjantai;15;13;28
622;24.02.2017;2017;02;16;Perjantai;25;14;39
622;24.02.2017;2017;02;17;Perjantai;24;11;35
622;24.02.2017;2017;02;18;Perjantai;15;10;25
622;24.02.2017;2017;02;19;Perjantai;18;8;26
622;24.02.2017;2017;02;20;Perjantai;8;7;15
622;24.02.2017;2017;02;21;Perjantai;8;3;11
622;24.02.2017;2017;02;22;Perjantai;5;4;9
622;24.02.2017;2017;02;23;Perjantai;1;3;4
622;25.02.2017;2017;02;00;Lauantai;0;1;1
622;25.02.2017;2017;02;01;Lauantai;1;0;1
622;25.02.2017;2017;02;02;Lauantai;2;0;2
622;25.02.2017;2017;02;03;Lauantai;0;0;0
622;25.02.2017;2017;02;04;Lauantai;2;0;2
622;25.02.2017;2017;02;05;Lauantai;2;0;2
622;25.02.2017;2017;02;06;Lauantai;1;1;2
622;25.02.2017;2017;02;07;Lauantai;1;0;1
622;25.02.2017;2017;02;08;Lauantai;2;1;3
622;25.02.2017;2017;02;09;Lauantai;3;2;5
622;25.02.2017;2017;02;10;Lauantai;4;7;11
622;25.02.2017;2017;02;11;Lauantai;1;9;10
622;25.02.2017;2017;02;12;Lauantai;13;4;17
622;25.02.2017;2017;02;13;Lauantai;7;16;23
622;25.02.2017;2017;02;14;Lauantai;11;13;24
622;25.02.2017;2017;02;15;Lauantai;3;7;10
622;25.02.2017;2017;02;16;Lauantai;15;3;18
622;25.02.2017;2017;02;17;Lauantai;14;8;22
622;25.02.2017;2017;02;18;Lauantai;11;5;16
622;25.02.2017;2017;02;19;Lauantai;11;5;16
622;25.02.2017;2017;02;20;Lauantai;10;5;15
622;25.02.2017;2017;02;21;Lauantai;2;2;4
622;25.02.2017;2017;02;22;Lauantai;3;0;3
622;25.02.2017;2017;02;23;Lauantai;1;0;1
622;26.02.2017;2017;02;00;Sunnuntai;2;1;3
622;26.02.2017;2017;02;01;Sunnuntai;3;3;6
622;26.02.2017;2017;02;02;Sunnuntai;0;2;2
622;26.02.2017;2017;02;03;Sunnuntai;1;1;2
622;26.02.2017;2017;02;04;Sunnuntai;2;2;4
622;26.02.2017;2017;02;05;Sunnuntai;0;0;0
622;26.02.2017;2017;02;06;Sunnuntai;1;0;1
622;26.02.2017;2017;02;07;Sunnuntai;1;3;4
622;26.02.2017;2017;02;08;Sunnuntai;1;1;2
622;26.02.2017;2017;02;09;Sunnuntai;2;3;5
622;26.02.2017;2017;02;10;Sunnuntai;3;2;5
622;26.02.2017;2017;02;11;Sunnuntai;4;3;7
622;26.02.2017;2017;02;12;Sunnuntai;4;13;17
622;26.02.2017;2017;02;13;Sunnuntai;5;10;15
622;26.02.2017;2017;02;14;Sunnuntai;8;11;19
622;26.02.2017;2017;02;15;Sunnuntai;9;4;13
622;26.02.2017;2017;02;16;Sunnuntai;14;3;17
622;26.02.2017;2017;02;17;Sunnuntai;14;6;20
622;26.02.2017;2017;02;18;Sunnuntai;10;11;21
622;26.02.2017;2017;02;19;Sunnuntai;5;2;7
622;26.02.2017;2017;02;20;Sunnuntai;7;10;17
622;26.02.2017;2017;02;21;Sunnuntai;6;4;10
622;26.02.2017;2017;02;22;Sunnuntai;2;1;3
622;26.02.2017;2017;02;23;Sunnuntai;1;0;1
622;27.02.2017;2017;02;00;Maanantai;2;1;3
622;27.02.2017;2017;02;01;Maanantai;0;0;0
622;27.02.2017;2017;02;02;Maanantai;0;0;0
622;27.02.2017;2017;02;03;Maanantai;0;0;0
622;27.02.2017;2017;02;04;Maanantai;0;0;0
622;27.02.2017;2017;02;05;Maanantai;0;1;1
622;27.02.2017;2017;02;06;Maanantai;1;3;4
622;27.02.2017;2017;02;07;Maanantai;2;11;13
622;27.02.2017;2017;02;08;Maanantai;13;19;32
622;27.02.2017;2017;02;09;Maanantai;9;19;28
622;27.02.2017;2017;02;10;Maanantai;8;21;29
622;27.02.2017;2017;02;11;Maanantai;13;10;23
622;27.02.2017;2017;02;12;Maanantai;11;12;23
622;27.02.2017;2017;02;13;Maanantai;13;15;28
622;27.02.2017;2017;02;14;Maanantai;12;13;25
622;27.02.2017;2017;02;15;Maanantai;20;17;37
622;27.02.2017;2017;02;16;Maanantai;39;22;61
622;27.02.2017;2017;02;17;Maanantai;35;20;55
622;27.02.2017;2017;02;18;Maanantai;24;15;39
622;27.02.2017;2017;02;19;Maanantai;25;13;38
622;27.02.2017;2017;02;20;Maanantai;12;8;20
622;27.02.2017;2017;02;21;Maanantai;17;10;27
622;27.02.2017;2017;02;22;Maanantai;10;2;12
622;27.02.2017;2017;02;23;Maanantai;8;2;10
622;28.02.2017;2017;02;00;Tiistai;1;1;2
622;28.02.2017;2017;02;01;Tiistai;2;1;3
622;28.02.2017;2017;02;02;Tiistai;0;0;0
622;28.02.2017;2017;02;03;Tiistai;0;0;0
622;28.02.2017;2017;02;04;Tiistai;0;0;0
622;28.02.2017;2017;02;05;Tiistai;0;1;1
622;28.02.2017;2017;02;06;Tiistai;1;3;4
622;28.02.2017;2017;02;07;Tiistai;2;17;19
622;28.02.2017;2017;02;08;Tiistai;16;18;34
622;28.02.2017;2017;02;09;Tiistai;20;15;35
622;28.02.2017;2017;02;10;Tiistai;8;20;28
622;28.02.2017;2017;02;11;Tiistai;9;14;23
622;28.02.2017;2017;02;12;Tiistai;13;13;26
622;28.02.2017;2017;02;13;Tiistai;18;11;29
622;28.02.2017;2017;02;14;Tiistai;5;10;15
622;28.02.2017;2017;02;15;Tiistai;14;7;21
622;28.02.2017;2017;02;16;Tiistai;27;13;40
622;28.02.2017;2017;02;17;Tiistai;51;22;73
622;28.02.2017;2017;02;18;Tiistai;25;19;44
622;28.02.2017;2017;02;19;Tiistai;15;12;27
622;28.02.2017;2017;02;20;Tiistai;9;5;14
622;28.02.2017;2017;02;21;Tiistai;8;9;17
622;28.02.2017;2017;02;22;Tiistai;11;7;18
622;28.02.2017;2017;02;23;Tiistai;3;4;7
622;01.03.2017;2017;03;00;Keskiviikko;1;0;1
622;01.03.2017;2017;03;01;Keskiviikko;3;0;3
622;01.03.2017;2017;03;02;Keskiviikko;0;1;1
622;01.03.2017;2017;03;03;Keskiviikko;1;0;1
622;01.03.2017;2017;03;04;Keskiviikko;2;0;2
622;01.03.2017;2017;03;05;Keskiviikko;2;1;3
622;01.03.2017;2017;03;06;Keskiviikko;2;6;8
622;01.03.2017;2017;03;07;Keskiviikko;2;14;16
622;01.03.2017;2017;03;08;Keskiviikko;21;21;42
622;01.03.2017;2017;03;09;Keskiviikko;13;13;26
622;01.03.2017;2017;03;10;Keskiviikko;5;10;15
622;01.03.2017;2017;03;11;Keskiviikko;12;12;24
622;01.03.2017;2017;03;12;Keskiviikko;8;5;13
622;01.03.2017;2017;03;13;Keskiviikko;10;8;18
622;01.03.2017;2017;03;14;Keskiviikko;5;10;15
622;01.03.2017;2017;03;15;Keskiviikko;10;14;24
622;01.03.2017;2017;03;16;Keskiviikko;26;14;40
622;01.03.2017;2017;03;17;Keskiviikko;30;14;44
622;01.03.2017;2017;03;18;Keskiviikko;21;7;28
622;01.03.2017;2017;03;19;Keskiviikko;11;7;18
622;01.03.2017;2017;03;20;Keskiviikko;4;5;9
622;01.03.2017;2017;03;21;Keskiviikko;7;4;11
622;01.03.2017;2017;03;22;Keskiviikko;4;3;7
622;01.03.2017;2017;03;23;Keskiviikko;1;0;1
622;02.03.2017;2017;03;00;Torstai;1;0;1
622;02.03.2017;2017;03;01;Torstai;0;1;1
622;02.03.2017;2017;03;02;Torstai;1;1;2
622;02.03.2017;2017;03;03;Torstai;0;1;1
622;02.03.2017;2017;03;04;Torstai;0;0;0
622;02.03.2017;2017;03;05;Torstai;2;7;9
622;02.03.2017;2017;03;06;Torstai;2;7;9
622;02.03.2017;2017;03;07;Torstai;3;15;18
622;02.03.2017;2017;03;08;Torstai;16;26;42
622;02.03.2017;2017;03;09;Torstai;14;17;31
622;02.03.2017;2017;03;10;Torstai;6;16;22
622;02.03.2017;2017;03;11;Torstai;8;8;16
622;02.03.2017;2017;03;12;Torstai;5;8;13
622;02.03.2017;2017;03;13;Torstai;8;9;17
622;02.03.2017;2017;03;14;Torstai;8;12;20
622;02.03.2017;2017;03;15;Torstai;11;19;30
622;02.03.2017;2017;03;16;Torstai;20;12;32
622;02.03.2017;2017;03;17;Torstai;25;16;41
622;02.03.2017;2017;03;18;Torstai;7;11;18
622;02.03.2017;2017;03;19;Torstai;11;5;16
622;02.03.2017;2017;03;20;Torstai;6;7;13
622;02.03.2017;2017;03;21;Torstai;9;6;15
622;02.03.2017;2017;03;22;Torstai;3;2;5
622;02.03.2017;2017;03;23;Torstai;2;2;4
622;03.03.2017;2017;03;00;Perjantai;0;0;0
622;03.03.2017;2017;03;01;Perjantai;1;0;1
622;03.03.2017;2017;03;02;Perjantai;1;1;2
622;03.03.2017;2017;03;03;Perjantai;0;0;0
622;03.03.2017;2017;03;04;Perjantai;1;0;1
622;03.03.2017;2017;03;05;Perjantai;2;1;3
622;03.03.2017;2017;03;06;Perjantai;1;1;2
622;03.03.2017;2017;03;07;Perjantai;8;17;25
622;03.03.2017;2017;03;08;Perjantai;19;18;37
622;03.03.2017;2017;03;09;Perjantai;3;16;19
622;03.03.2017;2017;03;10;Perjantai;7;9;16
622;03.03.2017;2017;03;11;Perjantai;3;5;8
622;03.03.2017;2017;03;12;Perjantai;4;11;15
622;03.03.2017;2017;03;13;Perjantai;5;12;17
622;03.03.2017;2017;03;14;Perjantai;6;7;13
622;03.03.2017;2017;03;15;Perjantai;13;8;21
622;03.03.2017;2017;03;16;Perjantai;20;11;31
622;03.03.2017;2017;03;17;Perjantai;17;13;30
622;03.03.2017;2017;03;18;Perjantai;9;12;21
622;03.03.2017;2017;03;19;Perjantai;12;8;20
622;03.03.2017;2017;03;20;Perjantai;8;1;9
622;03.03.2017;2017;03;21;Perjantai;5;1;6
622;03.03.2017;2017;03;22;Perjantai;3;1;4
622;03.03.2017;2017;03;23;Perjantai;4;1;5
622;04.03.2017;2017;03;00;Lauantai;2;2;4
622;04.03.2017;2017;03;01;Lauantai;3;0;3
622;04.03.2017;2017;03;02;Lauantai;1;0;1
622;04.03.2017;2017;03;03;Lauantai;1;0;1
622;04.03.2017;2017;03;04;Lauantai;0;1;1
622;04.03.2017;2017;03;05;Lauantai;0;1;1
622;04.03.2017;2017;03;06;Lauantai;1;3;4
622;04.03.2017;2017;03;07;Lauantai;1;3;4
622;04.03.2017;2017;03;08;Lauantai;2;1;3
622;04.03.2017;2017;03;09;Lauantai;2;4;6
622;04.03.2017;2017;03;10;Lauantai;1;5;6
622;04.03.2017;2017;03;11;Lauantai;8;9;17
622;04.03.2017;2017;03;12;Lauantai;8;6;14
622;04.03.2017;2017;03;13;Lauantai;8;6;14
622;04.03.2017;2017;03;14;Lauantai;11;7;18
622;04.03.2017;2017;03;15;Lauantai;6;6;12
622;04.03.2017;2017;03;16;Lauantai;7;8;15
622;04.03.2017;2017;03;17;Lauantai;4;8;12
622;04.03.2017;2017;03;18;Lauantai;3;5;8
622;04.03.2017;2017;03;19;Lauantai;2;3;5
622;04.03.2017;2017;03;20;Lauantai;6;4;10
622;04.03.2017;2017;03;21;Lauantai;4;2;6
622;04.03.2017;2017;03;22;Lauantai;2;0;2
622;04.03.2017;2017;03;23;Lauantai;1;2;3
622;05.03.2017;2017;03;00;Sunnuntai;1;2;3
622;05.03.2017;2017;03;01;Sunnuntai;0;0;0
622;05.03.2017;2017;03;02;Sunnuntai;2;0;2
622;05.03.2017;2017;03;03;Sunnuntai;1;1;2
622;05.03.2017;2017;03;04;Sunnuntai;0;0;0
622;05.03.2017;2017;03;05;Sunnuntai;2;1;3
622;05.03.2017;2017;03;06;Sunnuntai;1;1;2
622;05.03.2017;2017;03;07;Sunnuntai;0;1;1
622;05.03.2017;2017;03;08;Sunnuntai;0;2;2
622;05.03.2017;2017;03;09;Sunnuntai;0;1;1
622;05.03.2017;2017;03;10;Sunnuntai;1;2;3
622;05.03.2017;2017;03;11;Sunnuntai;0;2;2
622;05.03.2017;2017;03;12;Sunnuntai;1;9;10
622;05.03.2017;2017;03;13;Sunnuntai;8;6;14
622;05.03.2017;2017;03;14;Sunnuntai;5;8;13
622;05.03.2017;2017;03;15;Sunnuntai;12;10;22
622;05.03.2017;2017;03;16;Sunnuntai;5;5;10
622;05.03.2017;2017;03;17;Sunnuntai;6;2;8
622;05.03.2017;2017;03;18;Sunnuntai;9;2;11
622;05.03.2017;2017;03;19;Sunnuntai;3;2;5
622;05.03.2017;2017;03;20;Sunnuntai;1;3;4
622;05.03.2017;2017;03;21;Sunnuntai;4;0;4
622;05.03.2017;2017;03;22;Sunnuntai;3;0;3
622;05.03.2017;2017;03;23;Sunnuntai;0;1;1
622;06.03.2017;2017;03;00;Maanantai;0;0;0
622;06.03.2017;2017;03;01;Maanantai;1;0;1
622;06.03.2017;2017;03;02;Maanantai;0;0;0
622;06.03.2017;2017;03;03;Maanantai;0;0;0
622;06.03.2017;2017;03;04;Maanantai;6;4;10
622;06.03.2017;2017;03;05;Maanantai;0;0;0
622;06.03.2017;2017;03;06;Maanantai;1;2;3
622;06.03.2017;2017;03;07;Maanantai;2;5;7
622;06.03.2017;2017;03;08;Maanantai;6;7;13
622;06.03.2017;2017;03;09;Maanantai;8;10;18
622;06.03.2017;2017;03;10;Maanantai;7;7;14
622;06.03.2017;2017;03;11;Maanantai;3;4;7
622;06.03.2017;2017;03;12;Maanantai;2;8;10
622;06.03.2017;2017;03;13;Maanantai;12;14;26
622;06.03.2017;2017;03;14;Maanantai;14;10;24
622;06.03.2017;2017;03;15;Maanantai;8;6;14
622;06.03.2017;2017;03;16;Maanantai;14;6;20
622;06.03.2017;2017;03;17;Maanantai;11;9;20
622;06.03.2017;2017;03;18;Maanantai;11;12;23
622;06.03.2017;2017;03;19;Maanantai;11;16;27
622;06.03.2017;2017;03;20;Maanantai;5;1;6
622;06.03.2017;2017;03;21;Maanantai;9;1;10
622;06.03.2017;2017;03;22;Maanantai;2;2;4
622;06.03.2017;2017;03;23;Maanantai;2;0;2
622;07.03.2017;2017;03;00;Tiistai;2;3;5
622;07.03.2017;2017;03;01;Tiistai;1;0;1
622;07.03.2017;2017;03;02;Tiistai;0;0;0
622;07.03.2017;2017;03;03;Tiistai;1;0;1
622;07.03.2017;2017;03;04;Tiistai;0;0;0
622;07.03.2017;2017;03;05;Tiistai;1;1;2
622;07.03.2017;2017;03;06;Tiistai;1;2;3
622;07.03.2017;2017;03;07;Tiistai;4;10;14
622;07.03.2017;2017;03;08;Tiistai;5;6;11
622;07.03.2017;2017;03;09;Tiistai;2;8;10
622;07.03.2017;2017;03;10;Tiistai;4;5;9
622;07.03.2017;2017;03;11;Tiistai;2;2;4
622;07.03.2017;2017;03;12;Tiistai;1;9;10
622;07.03.2017;2017;03;13;Tiistai;4;11;15
622;07.03.2017;2017;03;14;Tiistai;3;7;10
622;07.03.2017;2017;03;15;Tiistai;13;7;20
622;07.03.2017;2017;03;16;Tiistai;9;7;16
622;07.03.2017;2017;03;17;Tiistai;12;10;22
622;07.03.2017;2017;03;18;Tiistai;21;7;28
622;07.03.2017;2017;03;19;Tiistai;7;6;13
622;07.03.2017;2017;03;20;Tiistai;3;3;6
622;07.03.2017;2017;03;21;Tiistai;10;5;15
622;07.03.2017;2017;03;22;Tiistai;2;1;3
622;07.03.2017;2017;03;23;Tiistai;5;1;6
622;08.03.2017;2017;03;00;Keskiviikko;2;0;2
622;08.03.2017;2017;03;01;Keskiviikko;0;1;1
622;08.03.2017;2017;03;02;Keskiviikko;0;0;0
622;08.03.2017;2017;03;03;Keskiviikko;0;0;0
622;08.03.2017;2017;03;04;Keskiviikko;0;0;0
622;08.03.2017;2017;03;05;Keskiviikko;0;0;0
622;08.03.2017;2017;03;06;Keskiviikko;0;2;2
622;08.03.2017;2017;03;07;Keskiviikko;6;14;20
622;08.03.2017;2017;03;08;Keskiviikko;8;11;19
622;08.03.2017;2017;03;09;Keskiviikko;7;8;15
622;08.03.2017;2017;03;10;Keskiviikko;7;9;16
622;08.03.2017;2017;03;11;Keskiviikko;5;7;12
622;08.03.2017;2017;03;12;Keskiviikko;6;11;17
622;08.03.2017;2017;03;13;Keskiviikko;10;11;21
622;08.03.2017;2017;03;14;Keskiviikko;3;4;7
622;08.03.2017;2017;03;15;Keskiviikko;2;5;7
622;08.03.2017;2017;03;16;Keskiviikko;6;14;20
622;08.03.2017;2017;03;17;Keskiviikko;16;10;26
622;08.03.2017;2017;03;18;Keskiviikko;5;6;11
622;08.03.2017;2017;03;19;Keskiviikko;7;4;11
622;08.03.2017;2017;03;20;Keskiviikko;3;1;4
622;08.03.2017;2017;03;21;Keskiviikko;8;0;8
622;08.03.2017;2017;03;22;Keskiviikko;4;4;8
622;08.03.2017;2017;03;23;Keskiviikko;2;1;3
622;09.03.2017;2017;03;00;Torstai;2;1;3
622;09.03.2017;2017;03;01;Torstai;2;2;4
622;09.03.2017;2017;03;02;Torstai;0;0;0
622;09.03.2017;2017;03;03;Torstai;0;0;0
622;09.03.2017;2017;03;04;Torstai;0;0;0
622;09.03.2017;2017;03;05;Torstai;1;0;1
622;09.03.2017;2017;03;06;Torstai;0;1;1
622;09.03.2017;2017;03;07;Torstai;1;4;5
622;09.03.2017;2017;03;08;Torstai;5;4;9
622;09.03.2017;2017;03;09;Torstai;6;13;19
622;09.03.2017;2017;03;10;Torstai;8;10;18
622;09.03.2017;2017;03;11;Torstai;2;6;8
622;09.03.2017;2017;03;12;Torstai;4;7;11
622;09.03.2017;2017;03;13;Torstai;4;10;14
622;09.03.2017;2017;03;14;Torstai;6;12;18
622;09.03.2017;2017;03;15;Torstai;2;7;9
622;09.03.2017;2017;03;16;Torstai;4;9;13
622;09.03.2017;2017;03;17;Torstai;5;14;19
622;09.03.2017;2017;03;18;Torstai;6;9;15
622;09.03.2017;2017;03;19;Torstai;3;9;12
622;09.03.2017;2017;03;20;Torstai;2;1;3
622;09.03.2017;2017;03;21;Torstai;4;5;9
622;09.03.2017;2017;03;22;Torstai;1;5;6
622;09.03.2017;2017;03;23;Torstai;4;0;4
622;10.03.2017;2017;03;00;Perjantai;0;3;3
622;10.03.2017;2017;03;01;Perjantai;1;0;1
622;10.03.2017;2017;03;02;Perjantai;0;0;0
622;10.03.2017;2017;03;03;Perjantai;0;0;0
622;10.03.2017;2017;03;04;Perjantai;0;0;0
622;10.03.2017;2017;03;05;Perjantai;1;2;3
622;10.03.2017;2017;03;06;Perjantai;1;1;2
622;10.03.2017;2017;03;07;Perjantai;0;6;6
622;10.03.2017;2017;03;08;Perjantai;3;13;16
622;10.03.2017;2017;03;09;Perjantai;2;11;13
622;10.03.2017;2017;03;10;Perjantai;3;10;13
622;10.03.2017;2017;03;11;Perjantai;8;9;17
622;10.03.2017;2017;03;12;Perjantai;5;14;19
622;10.03.2017;2017;03;13;Perjantai;10;18;28
622;10.03.2017;2017;03;14;Perjantai;8;13;21
622;10.03.2017;2017;03;15;Perjantai;10;13;23
622;10.03.2017;2017;03;16;Perjantai;13;10;23
622;10.03.2017;2017;03;17;Perjantai;19;12;31
622;10.03.2017;2017;03;18;Perjantai;16;7;23
622;10.03.2017;2017;03;19;Perjantai;15;8;23
622;10.03.2017;2017;03;20;Perjantai;6;6;12
622;10.03.2017;2017;03;21;Perjantai;4;2;6
622;10.03.2017;2017;03;22;Perjantai;4;4;8
622;10.03.2017;2017;03;23;Perjantai;3;3;6
622;11.03.2017;2017;03;00;Lauantai;1;2;3
622;11.03.2017;2017;03;01;Lauantai;1;0;1
622;11.03.2017;2017;03;02;Lauantai;0;1;1
622;11.03.2017;2017;03;03;Lauantai;0;1;1
622;11.03.2017;2017;03;04;Lauantai;0;0;0
622;11.03.2017;2017;03;05;Lauantai;0;1;1
622;11.03.2017;2017;03;06;Lauantai;0;1;1
622;11.03.2017;2017;03;07;Lauantai;0;1;1
622;11.03.2017;2017;03;08;Lauantai;1;2;3
622;11.03.2017;2017;03;09;Lauantai;2;3;5
622;11.03.2017;2017;03;10;Lauantai;6;6;12
622;11.03.2017;2017;03;11;Lauantai;3;6;9
622;11.03.2017;2017;03;12;Lauantai;8;8;16
622;11.03.2017;2017;03;13;Lauantai;8;5;13
622;11.03.2017;2017;03;14;Lauantai;7;9;16
622;11.03.2017;2017;03;15;Lauantai;11;5;16
622;11.03.2017;2017;03;16;Lauantai;7;4;11
622;11.03.2017;2017;03;17;Lauantai;16;4;20
622;11.03.2017;2017;03;18;Lauantai;6;6;12
622;11.03.2017;2017;03;19;Lauantai;4;4;8
622;11.03.2017;2017;03;20;Lauantai;2;4;6
622;11.03.2017;2017;03;21;Lauantai;3;3;6
622;11.03.2017;2017;03;22;Lauantai;6;3;9
622;11.03.2017;2017;03;23;Lauantai;2;2;4
622;12.03.2017;2017;03;00;Sunnuntai;1;5;6
622;12.03.2017;2017;03;01;Sunnuntai;3;0;3
622;12.03.2017;2017;03;02;Sunnuntai;1;1;2
622;12.03.2017;2017;03;03;Sunnuntai;2;0;2
622;12.03.2017;2017;03;04;Sunnuntai;0;1;1
622;12.03.2017;2017;03;05;Sunnuntai;2;0;2
622;12.03.2017;2017;03;06;Sunnuntai;1;0;1
622;12.03.2017;2017;03;07;Sunnuntai;0;0;0
622;12.03.2017;2017;03;08;Sunnuntai;2;2;4
622;12.03.2017;2017;03;09;Sunnuntai;0;2;2
622;12.03.2017;2017;03;10;Sunnuntai;0;4;4
622;12.03.2017;2017;03;11;Sunnuntai;4;3;7
622;12.03.2017;2017;03;12;Sunnuntai;7;9;16
622;12.03.2017;2017;03;13;Sunnuntai;12;8;20
622;12.03.2017;2017;03;14;Sunnuntai;18;16;34
622;12.03.2017;2017;03;15;Sunnuntai;13;10;23
622;12.03.2017;2017;03;16;Sunnuntai;3;4;7
622;12.03.2017;2017;03;17;Sunnuntai;7;8;15
622;12.03.2017;2017;03;18;Sunnuntai;2;2;4
622;12.03.2017;2017;03;19;Sunnuntai;10;5;15
622;12.03.2017;2017;03;20;Sunnuntai;3;5;8
622;12.03.2017;2017;03;21;Sunnuntai;1;4;5
622;12.03.2017;2017;03;22;Sunnuntai;2;2;4
622;12.03.2017;2017;03;23;Sunnuntai;5;1;6
622;13.03.2017;2017;03;00;Maanantai;1;1;2
622;13.03.2017;2017;03;01;Maanantai;1;0;1
622;13.03.2017;2017;03;02;Maanantai;1;0;1
622;13.03.2017;2017;03;03;Maanantai;0;0;0
622;13.03.2017;2017;03;04;Maanantai;0;0;0
622;13.03.2017;2017;03;05;Maanantai;0;1;1
622;13.03.2017;2017;03;06;Maanantai;2;5;7
622;13.03.2017;2017;03;07;Maanantai;4;12;16
622;13.03.2017;2017;03;08;Maanantai;23;24;47
622;13.03.2017;2017;03;09;Maanantai;16;18;34
622;13.03.2017;2017;03;10;Maanantai;5;14;19
622;13.03.2017;2017;03;11;Maanantai;4;6;10
622;13.03.2017;2017;03;12;Maanantai;8;4;12
622;13.03.2017;2017;03;13;Maanantai;4;12;16
622;13.03.2017;2017;03;14;Maanantai;8;16;24
622;13.03.2017;2017;03;15;Maanantai;15;14;29
622;13.03.2017;2017;03;16;Maanantai;30;22;52
622;13.03.2017;2017;03;17;Maanantai;35;28;63
622;13.03.2017;2017;03;18;Maanantai;23;24;47
622;13.03.2017;2017;03;19;Maanantai;16;6;22
622;13.03.2017;2017;03;20;Maanantai;6;9;15
622;13.03.2017;2017;03;21;Maanantai;7;3;10
622;13.03.2017;2017;03;22;Maanantai;3;2;5
622;13.03.2017;2017;03;23;Maanantai;6;3;9
622;14.03.2017;2017;03;00;Tiistai;0;0;0
622;14.03.2017;2017;03;01;Tiistai;0;1;1
622;14.03.2017;2017;03;02;Tiistai;0;0;0
622;14.03.2017;2017;03;03;Tiistai;0;0;0
622;14.03.2017;2017;03;04;Tiistai;0;0;0
622;14.03.2017;2017;03;05;Tiistai;4;1;5
622;14.03.2017;2017;03;06;Tiistai;2;5;7
622;14.03.2017;2017;03;07;Tiistai;6;20;26
622;14.03.2017;2017;03;08;Tiistai;14;21;35
622;14.03.2017;2017;03;09;Tiistai;7;14;21
622;14.03.2017;2017;03;10;Tiistai;4;7;11
622;14.03.2017;2017;03;11;Tiistai;1;7;8
622;14.03.2017;2017;03;12;Tiistai;10;9;19
622;14.03.2017;2017;03;13;Tiistai;4;11;15
622;14.03.2017;2017;03;14;Tiistai;10;14;24
622;14.03.2017;2017;03;15;Tiistai;13;9;22
622;14.03.2017;2017;03;16;Tiistai;14;14;28
622;14.03.2017;2017;03;17;Tiistai;21;24;45
622;14.03.2017;2017;03;18;Tiistai;14;17;31
622;14.03.2017;2017;03;19;Tiistai;12;7;19
622;14.03.2017;2017;03;20;Tiistai;7;4;11
622;14.03.2017;2017;03;21;Tiistai;9;6;15
622;14.03.2017;2017;03;22;Tiistai;3;4;7
622;14.03.2017;2017;03;23;Tiistai;2;1;3
622;15.03.2017;2017;03;00;Keskiviikko;1;1;2
622;15.03.2017;2017;03;01;Keskiviikko;0;0;0
622;15.03.2017;2017;03;02;Keskiviikko;1;0;1
622;15.03.2017;2017;03;03;Keskiviikko;0;0;0
622;15.03.2017;2017;03;04;Keskiviikko;1;0;1
622;15.03.2017;2017;03;05;Keskiviikko;1;1;2
622;15.03.2017;2017;03;06;Keskiviikko;5;2;7
622;15.03.2017;2017;03;07;Keskiviikko;2;19;21
622;15.03.2017;2017;03;08;Keskiviikko;20;24;44
622;15.03.2017;2017;03;09;Keskiviikko;19;23;42
622;15.03.2017;2017;03;10;Keskiviikko;12;6;18
622;15.03.2017;2017;03;11;Keskiviikko;8;12;20
622;15.03.2017;2017;03;12;Keskiviikko;9;4;13
622;15.03.2017;2017;03;13;Keskiviikko;4;6;10
622;15.03.2017;2017;03;14;Keskiviikko;7;13;20
622;15.03.2017;2017;03;15;Keskiviikko;19;13;32
622;15.03.2017;2017;03;16;Keskiviikko;15;14;29
622;15.03.2017;2017;03;17;Keskiviikko;22;19;41
622;15.03.2017;2017;03;18;Keskiviikko;9;8;17
622;15.03.2017;2017;03;19;Keskiviikko;10;5;15
622;15.03.2017;2017;03;20;Keskiviikko;4;6;10
622;15.03.2017;2017;03;21;Keskiviikko;7;3;10
622;15.03.2017;2017;03;22;Keskiviikko;8;1;9
622;15.03.2017;2017;03;23;Keskiviikko;0;1;1
622;16.03.2017;2017;03;00;Torstai;1;1;2
622;16.03.2017;2017;03;01;Torstai;0;0;0
622;16.03.2017;2017;03;02;Torstai;0;0;0
622;16.03.2017;2017;03;03;Torstai;0;0;0
622;16.03.2017;2017;03;04;Torstai;0;0;0
622;16.03.2017;2017;03;05;Torstai;1;0;1
622;16.03.2017;2017;03;06;Torstai;1;2;3
622;16.03.2017;2017;03;07;Torstai;1;15;16
622;16.03.2017;2017;03;08;Torstai;15;17;32
622;16.03.2017;2017;03;09;Torstai;13;18;31
622;16.03.2017;2017;03;10;Torstai;12;8;20
622;16.03.2017;2017;03;11;Torstai;8;7;15
622;16.03.2017;2017;03;12;Torstai;11;9;20
622;16.03.2017;2017;03;13;Torstai;4;8;12
622;16.03.2017;2017;03;14;Torstai;15;21;36
622;16.03.2017;2017;03;15;Torstai;15;14;29
622;16.03.2017;2017;03;16;Torstai;28;17;45
622;16.03.2017;2017;03;17;Torstai;32;18;50
622;16.03.2017;2017;03;18;Torstai;13;9;22
622;16.03.2017;2017;03;19;Torstai;11;9;20
622;16.03.2017;2017;03;20;Torstai;9;4;13
622;16.03.2017;2017;03;21;Torstai;4;2;6
622;16.03.2017;2017;03;22;Torstai;2;3;5
622;16.03.2017;2017;03;23;Torstai;3;0;3
622;17.03.2017;2017;03;00;Perjantai;4;1;5
622;17.03.2017;2017;03;01;Perjantai;0;0;0
622;17.03.2017;2017;03;02;Perjantai;1;1;2
622;17.03.2017;2017;03;03;Perjantai;1;0;1
622;17.03.2017;2017;03;04;Perjantai;0;0;0
622;17.03.2017;2017;03;05;Perjantai;1;0;1
622;17.03.2017;2017;03;06;Perjantai;2;0;2
622;17.03.2017;2017;03;07;Perjantai;2;7;9
622;17.03.2017;2017;03;08;Perjantai;9;4;13
622;17.03.2017;2017;03;09;Perjantai;16;11;27
622;17.03.2017;2017;03;10;Perjantai;5;16;21
622;17.03.2017;2017;03;11;Perjantai;5;7;12
622;17.03.2017;2017;03;12;Perjantai;6;12;18
622;17.03.2017;2017;03;13;Perjantai;5;8;13
622;17.03.2017;2017;03;14;Perjantai;10;15;25
622;17.03.2017;2017;03;15;Perjantai;9;16;25
622;17.03.2017;2017;03;16;Perjantai;5;15;20
622;17.03.2017;2017;03;17;Perjantai;7;14;21
622;17.03.2017;2017;03;18;Perjantai;11;6;17
622;17.03.2017;2017;03;19;Perjantai;10;8;18
622;17.03.2017;2017;03;20;Perjantai;8;4;12
622;17.03.2017;2017;03;21;Perjantai;6;3;9
622;17.03.2017;2017;03;22;Perjantai;4;1;5
622;17.03.2017;2017;03;23;Perjantai;0;0;0
622;18.03.2017;2017;03;00;Lauantai;3;1;4
622;18.03.2017;2017;03;01;Lauantai;0;0;0
622;18.03.2017;2017;03;02;Lauantai;1;2;3
622;18.03.2017;2017;03;03;Lauantai;2;1;3
622;18.03.2017;2017;03;04;Lauantai;0;0;0
622;18.03.2017;2017;03;05;Lauantai;0;1;1
622;18.03.2017;2017;03;06;Lauantai;1;0;1
622;18.03.2017;2017;03;07;Lauantai;0;1;1
622;18.03.2017;2017;03;08;Lauantai;2;2;4
622;18.03.2017;2017;03;09;Lauantai;2;4;6
622;18.03.2017;2017;03;10;Lauantai;2;7;9
622;18.03.2017;2017;03;11;Lauantai;4;3;7
622;18.03.2017;2017;03;12;Lauantai;10;5;15
622;18.03.2017;2017;03;13;Lauantai;7;11;18
622;18.03.2017;2017;03;14;Lauantai;4;3;7
622;18.03.2017;2017;03;15;Lauantai;7;7;14
622;18.03.2017;2017;03;16;Lauantai;9;7;16
622;18.03.2017;2017;03;17;Lauantai;4;2;6
622;18.03.2017;2017;03;18;Lauantai;4;11;15
622;18.03.2017;2017;03;19;Lauantai;6;4;10
622;18.03.2017;2017;03;20;Lauantai;7;5;12
622;18.03.2017;2017;03;21;Lauantai;4;5;9
622;18.03.2017;2017;03;22;Lauantai;5;0;5
622;18.03.2017;2017;03;23;Lauantai;2;3;5
622;19.03.2017;2017;03;00;Sunnuntai;0;2;2
622;19.03.2017;2017;03;01;Sunnuntai;2;2;4
622;19.03.2017;2017;03;02;Sunnuntai;0;1;1
622;19.03.2017;2017;03;03;Sunnuntai;1;0;1
622;19.03.2017;2017;03;04;Sunnuntai;1;2;3
622;19.03.2017;2017;03;05;Sunnuntai;2;1;3
622;19.03.2017;2017;03;06;Sunnuntai;1;0;1
622;19.03.2017;2017;03;07;Sunnuntai;0;2;2
622;19.03.2017;2017;03;08;Sunnuntai;1;1;2
622;19.03.2017;2017;03;09;Sunnuntai;0;2;2
622;19.03.2017;2017;03;10;Sunnuntai;2;3;5
622;19.03.2017;2017;03;11;Sunnuntai;6;5;11
622;19.03.2017;2017;03;12;Sunnuntai;5;9;14
622;19.03.2017;2017;03;13;Sunnuntai;3;7;10
622;19.03.2017;2017;03;14;Sunnuntai;1;16;17
622;19.03.2017;2017;03;15;Sunnuntai;7;6;13
622;19.03.2017;2017;03;16;Sunnuntai;8;16;24
622;19.03.2017;2017;03;17;Sunnuntai;13;9;22
622;19.03.2017;2017;03;18;Sunnuntai;10;6;16
622;19.03.2017;2017;03;19;Sunnuntai;6;8;14
622;19.03.2017;2017;03;20;Sunnuntai;6;4;10
622;19.03.2017;2017;03;21;Sunnuntai;5;5;10
622;19.03.2017;2017;03;22;Sunnuntai;5;3;8
622;19.03.2017;2017;03;23;Sunnuntai;2;0;2
622;20.03.2017;2017;03;00;Maanantai;0;0;0
622;20.03.2017;2017;03;01;Maanantai;0;1;1
622;20.03.2017;2017;03;02;Maanantai;0;0;0
622;20.03.2017;2017;03;03;Maanantai;0;0;0
622;20.03.2017;2017;03;04;Maanantai;0;0;0
622;20.03.2017;2017;03;05;Maanantai;1;1;2
622;20.03.2017;2017;03;06;Maanantai;0;6;6
622;20.03.2017;2017;03;07;Maanantai;5;13;18
622;20.03.2017;2017;03;08;Maanantai;13;27;40
622;20.03.2017;2017;03;09;Maanantai;19;22;41
622;20.03.2017;2017;03;10;Maanantai;4;7;11
622;20.03.2017;2017;03;11;Maanantai;5;12;17
622;20.03.2017;2017;03;12;Maanantai;5;8;13
622;20.03.2017;2017;03;13;Maanantai;4;13;17
622;20.03.2017;2017;03;14;Maanantai;14;11;25
622;20.03.2017;2017;03;15;Maanantai;14;20;34
622;20.03.2017;2017;03;16;Maanantai;22;24;46
622;20.03.2017;2017;03;17;Maanantai;36;40;76
622;20.03.2017;2017;03;18;Maanantai;16;23;39
622;20.03.2017;2017;03;19;Maanantai;21;16;37
622;20.03.2017;2017;03;20;Maanantai;16;13;29
622;20.03.2017;2017;03;21;Maanantai;9;4;13
622;20.03.2017;2017;03;22;Maanantai;6;1;7
622;20.03.2017;2017;03;23;Maanantai;3;2;5
622;21.03.2017;2017;03;00;Tiistai;0;2;2
622;21.03.2017;2017;03;01;Tiistai;3;1;4
622;21.03.2017;2017;03;02;Tiistai;0;0;0
622;21.03.2017;2017;03;03;Tiistai;0;1;1
622;21.03.2017;2017;03;04;Tiistai;0;0;0
622;21.03.2017;2017;03;05;Tiistai;0;1;1
622;21.03.2017;2017;03;06;Tiistai;3;3;6
622;21.03.2017;2017;03;07;Tiistai;3;17;20
622;21.03.2017;2017;03;08;Tiistai;22;47;69
622;21.03.2017;2017;03;09;Tiistai;20;19;39
622;21.03.2017;2017;03;10;Tiistai;10;20;30
622;21.03.2017;2017;03;11;Tiistai;7;10;17
622;21.03.2017;2017;03;12;Tiistai;4;9;13
622;21.03.2017;2017;03;13;Tiistai;16;10;26
622;21.03.2017;2017;03;14;Tiistai;11;18;29
622;21.03.2017;2017;03;15;Tiistai;17;19;36
622;21.03.2017;2017;03;16;Tiistai;23;18;41
622;21.03.2017;2017;03;17;Tiistai;29;23;52
622;21.03.2017;2017;03;18;Tiistai;17;17;34
622;21.03.2017;2017;03;19;Tiistai;16;12;28
622;21.03.2017;2017;03;20;Tiistai;12;4;16
622;21.03.2017;2017;03;21;Tiistai;11;10;21
622;21.03.2017;2017;03;22;Tiistai;6;9;15
622;21.03.2017;2017;03;23;Tiistai;3;6;9
622;22.03.2017;2017;03;00;Keskiviikko;2;1;3
622;22.03.2017;2017;03;01;Keskiviikko;1;0;1
622;22.03.2017;2017;03;02;Keskiviikko;0;1;1
622;22.03.2017;2017;03;03;Keskiviikko;0;0;0
622;22.03.2017;2017;03;04;Keskiviikko;0;2;2
622;22.03.2017;2017;03;05;Keskiviikko;1;1;2
622;22.03.2017;2017;03;06;Keskiviikko;3;4;7
622;22.03.2017;2017;03;07;Keskiviikko;9;10;19
622;22.03.2017;2017;03;08;Keskiviikko;17;29;46
622;22.03.2017;2017;03;09;Keskiviikko;15;18;33
622;22.03.2017;2017;03;10;Keskiviikko;7;15;22
622;22.03.2017;2017;03;11;Keskiviikko;9;13;22
622;22.03.2017;2017;03;12;Keskiviikko;11;14;25
622;22.03.2017;2017;03;13;Keskiviikko;8;9;17
622;22.03.2017;2017;03;14;Keskiviikko;11;12;23
622;22.03.2017;2017;03;15;Keskiviikko;26;20;46
622;22.03.2017;2017;03;16;Keskiviikko;23;25;48
622;22.03.2017;2017;03;17;Keskiviikko;26;32;58
622;22.03.2017;2017;03;18;Keskiviikko;27;14;41
622;22.03.2017;2017;03;19;Keskiviikko;24;11;35
622;22.03.2017;2017;03;20;Keskiviikko;13;6;19
622;22.03.2017;2017;03;21;Keskiviikko;18;7;25
622;22.03.2017;2017;03;22;Keskiviikko;2;1;3
622;22.03.2017;2017;03;23;Keskiviikko;2;1;3
622;23.03.2017;2017;03;00;Torstai;2;1;3
622;23.03.2017;2017;03;01;Torstai;0;1;1
622;23.03.2017;2017;03;02;Torstai;1;1;2
622;23.03.2017;2017;03;03;Torstai;1;0;1
622;23.03.2017;2017;03;04;Torstai;0;0;0
622;23.03.2017;2017;03;05;Torstai;0;1;1
622;23.03.2017;2017;03;06;Torstai;6;6;12
622;23.03.2017;2017;03;07;Torstai;6;13;19
622;23.03.2017;2017;03;08;Torstai;18;25;43
622;23.03.2017;2017;03;09;Torstai;32;26;58
622;23.03.2017;2017;03;10;Torstai;19;18;37
622;23.03.2017;2017;03;11;Torstai;8;15;23
622;23.03.2017;2017;03;12;Torstai;7;9;16
622;23.03.2017;2017;03;13;Torstai;9;17;26
622;23.03.2017;2017;03;14;Torstai;11;17;28
622;23.03.2017;2017;03;15;Torstai;28;16;44
622;23.03.2017;2017;03;16;Torstai;42;29;71
622;23.03.2017;2017;03;17;Torstai;35;44;79
622;23.03.2017;2017;03;18;Torstai;26;31;57
622;23.03.2017;2017;03;19;Torstai;24;16;40
622;23.03.2017;2017;03;20;Torstai;14;15;29
622;23.03.2017;2017;03;21;Torstai;16;9;25
622;23.03.2017;2017;03;22;Torstai;3;3;6
622;23.03.2017;2017;03;23;Torstai;4;1;5
622;24.03.2017;2017;03;00;Perjantai;5;0;5
622;24.03.2017;2017;03;01;Perjantai;1;0;1
622;24.03.2017;2017;03;02;Perjantai;0;1;1
622;24.03.2017;2017;03;03;Perjantai;1;0;1
622;24.03.2017;2017;03;04;Perjantai;2;1;3
622;24.03.2017;2017;03;05;Perjantai;7;1;8
622;24.03.2017;2017;03;06;Perjantai;4;8;12
622;24.03.2017;2017;03;07;Perjantai;6;19;25
622;24.03.2017;2017;03;08;Perjantai;28;31;59
622;24.03.2017;2017;03;09;Perjantai;32;32;64
622;24.03.2017;2017;03;10;Perjantai;13;15;28
622;24.03.2017;2017;03;11;Perjantai;10;26;36
622;24.03.2017;2017;03;12;Perjantai;10;17;27
622;24.03.2017;2017;03;13;Perjantai;19;25;44
622;24.03.2017;2017;03;14;Perjantai;13;34;47
622;24.03.2017;2017;03;15;Perjantai;23;30;53
622;24.03.2017;2017;03;16;Perjantai;37;26;63
622;24.03.2017;2017;03;17;Perjantai;34;30;64
622;24.03.2017;2017;03;18;Perjantai;18;18;36
622;24.03.2017;2017;03;19;Perjantai;24;19;43
622;24.03.2017;2017;03;20;Perjantai;12;5;17
622;24.03.2017;2017;03;21;Perjantai;9;9;18
622;24.03.2017;2017;03;22;Perjantai;3;1;4
622;24.03.2017;2017;03;23;Perjantai;4;4;8
622;25.03.2017;2017;03;00;Lauantai;6;3;9
622;25.03.2017;2017;03;01;Lauantai;8;1;9
622;25.03.2017;2017;03;02;Lauantai;1;1;2
622;25.03.2017;2017;03;03;Lauantai;4;5;9
622;25.03.2017;2017;03;04;Lauantai;1;1;2
622;25.03.2017;2017;03;05;Lauantai;3;0;3
622;25.03.2017;2017;03;06;Lauantai;2;9;11
622;25.03.2017;2017;03;07;Lauantai;0;3;3
622;25.03.2017;2017;03;08;Lauantai;0;3;3
622;25.03.2017;2017;03;09;Lauantai;4;6;10
622;25.03.2017;2017;03;10;Lauantai;5;13;18
622;25.03.2017;2017;03;11;Lauantai;10;14;24
622;25.03.2017;2017;03;12;Lauantai;25;33;58
622;25.03.2017;2017;03;13;Lauantai;10;15;25
622;25.03.2017;2017;03;14;Lauantai;21;16;37
622;25.03.2017;2017;03;15;Lauantai;20;14;34
622;25.03.2017;2017;03;16;Lauantai;19;20;39
622;25.03.2017;2017;03;17;Lauantai;18;11;29
622;25.03.2017;2017;03;18;Lauantai;15;7;22
622;25.03.2017;2017;03;19;Lauantai;9;5;14
622;25.03.2017;2017;03;20;Lauantai;7;13;20
622;25.03.2017;2017;03;21;Lauantai;16;6;22
622;25.03.2017;2017;03;22;Lauantai;5;6;11
622;25.03.2017;2017;03;23;Lauantai;6;4;10
622;26.03.2017;2017;03;00;Sunnuntai;6;9;15
622;26.03.2017;2017;03;01;Sunnuntai;5;4;9
622;26.03.2017;2017;03;02;Sunnuntai;1;3;4
622;26.03.2017;2017;03;03;Sunnuntai;0;0;0
622;26.03.2017;2017;03;04;Sunnuntai;4;2;6
622;26.03.2017;2017;03;05;Sunnuntai;4;0;4
622;26.03.2017;2017;03;06;Sunnuntai;3;4;7
622;26.03.2017;2017;03;07;Sunnuntai;1;2;3
622;26.03.2017;2017;03;08;Sunnuntai;0;3;3
622;26.03.2017;2017;03;09;Sunnuntai;1;1;2
622;26.03.2017;2017;03;10;Sunnuntai;2;5;7
622;26.03.2017;2017;03;11;Sunnuntai;3;5;8
622;26.03.2017;2017;03;12;Sunnuntai;6;9;15
622;26.03.2017;2017;03;13;Sunnuntai;10;22;32
622;26.03.2017;2017;03;14;Sunnuntai;16;22;38
622;26.03.2017;2017;03;15;Sunnuntai;11;12;23
622;26.03.2017;2017;03;16;Sunnuntai;19;15;34
622;26.03.2017;2017;03;17;Sunnuntai;20;20;40
622;26.03.2017;2017;03;18;Sunnuntai;17;21;38
622;26.03.2017;2017;03;19;Sunnuntai;12;7;19
622;26.03.2017;2017;03;20;Sunnuntai;17;10;27
622;26.03.2017;2017;03;21;Sunnuntai;11;9;20
622;26.03.2017;2017;03;22;Sunnuntai;4;2;6
622;26.03.2017;2017;03;23;Sunnuntai;4;3;7
622;27.03.2017;2017;03;00;Maanantai;3;1;4
622;27.03.2017;2017;03;01;Maanantai;0;0;0
622;27.03.2017;2017;03;02;Maanantai;0;0;0
622;27.03.2017;2017;03;03;Maanantai;0;2;2
622;27.03.2017;2017;03;04;Maanantai;0;0;0
622;27.03.2017;2017;03;05;Maanantai;0;1;1
622;27.03.2017;2017;03;06;Maanantai;2;9;11
622;27.03.2017;2017;03;07;Maanantai;8;25;33
622;27.03.2017;2017;03;08;Maanantai;24;32;56
622;27.03.2017;2017;03;09;Maanantai;26;28;54
622;27.03.2017;2017;03;10;Maanantai;21;36;57
622;27.03.2017;2017;03;11;Maanantai;11;11;22
622;27.03.2017;2017;03;12;Maanantai;9;13;22
622;27.03.2017;2017;03;13;Maanantai;18;27;45
622;27.03.2017;2017;03;14;Maanantai;12;28;40
622;27.03.2017;2017;03;15;Maanantai;25;18;43
622;27.03.2017;2017;03;16;Maanantai;48;21;69
622;27.03.2017;2017;03;17;Maanantai;57;28;85
622;27.03.2017;2017;03;18;Maanantai;18;24;42
622;27.03.2017;2017;03;19;Maanantai;22;20;42
622;27.03.2017;2017;03;20;Maanantai;13;11;24
622;27.03.2017;2017;03;21;Maanantai;14;13;27
622;27.03.2017;2017;03;22;Maanantai;9;4;13
622;27.03.2017;2017;03;23;Maanantai;2;3;5
622;28.03.2017;2017;03;00;Tiistai;2;0;2
622;28.03.2017;2017;03;01;Tiistai;1;1;2
622;28.03.2017;2017;03;02;Tiistai;0;2;2
622;28.03.2017;2017;03;03;Tiistai;0;0;0
622;28.03.2017;2017;03;04;Tiistai;0;0;0
622;28.03.2017;2017;03;05;Tiistai;2;0;2
622;28.03.2017;2017;03;06;Tiistai;6;8;14
622;28.03.2017;2017;03;07;Tiistai;6;23;29
622;28.03.2017;2017;03;08;Tiistai;21;44;65
622;28.03.2017;2017;03;09;Tiistai;29;35;64
622;28.03.2017;2017;03;10;Tiistai;17;25;42
622;28.03.2017;2017;03;11;Tiistai;11;17;28
622;28.03.2017;2017;03;12;Tiistai;19;22;41
622;28.03.2017;2017;03;13;Tiistai;18;19;37
622;28.03.2017;2017;03;14;Tiistai;20;32;52
622;28.03.2017;2017;03;15;Tiistai;30;34;64
622;28.03.2017;2017;03;16;Tiistai;33;30;63
622;28.03.2017;2017;03;17;Tiistai;35;33;68
622;28.03.2017;2017;03;18;Tiistai;29;23;52
622;28.03.2017;2017;03;19;Tiistai;28;14;42
622;28.03.2017;2017;03;20;Tiistai;24;18;42
622;28.03.2017;2017;03;21;Tiistai;13;12;25
622;28.03.2017;2017;03;22;Tiistai;9;15;24
622;28.03.2017;2017;03;23;Tiistai;4;2;6
622;29.03.2017;2017;03;00;Keskiviikko;2;0;2
622;29.03.2017;2017;03;01;Keskiviikko;1;0;1
622;29.03.2017;2017;03;02;Keskiviikko;3;2;5
622;29.03.2017;2017;03;03;Keskiviikko;1;1;2
622;29.03.2017;2017;03;04;Keskiviikko;0;1;1
622;29.03.2017;2017;03;05;Keskiviikko;1;3;4
622;29.03.2017;2017;03;06;Keskiviikko;0;10;10
622;29.03.2017;2017;03;07;Keskiviikko;4;21;25
622;29.03.2017;2017;03;08;Keskiviikko;16;39;55
622;29.03.2017;2017;03;09;Keskiviikko;34;37;71
622;29.03.2017;2017;03;10;Keskiviikko;16;31;47
622;29.03.2017;2017;03;11;Keskiviikko;9;13;22
622;29.03.2017;2017;03;12;Keskiviikko;13;17;30
622;29.03.2017;2017;03;13;Keskiviikko;19;20;39
622;29.03.2017;2017;03;14;Keskiviikko;13;19;32
622;29.03.2017;2017;03;15;Keskiviikko;38;33;71
622;29.03.2017;2017;03;16;Keskiviikko;34;33;67
622;29.03.2017;2017;03;17;Keskiviikko;44;27;71
622;29.03.2017;2017;03;18;Keskiviikko;34;20;54
622;29.03.2017;2017;03;19;Keskiviikko;24;13;37
622;29.03.2017;2017;03;20;Keskiviikko;18;10;28
622;29.03.2017;2017;03;21;Keskiviikko;17;11;28
622;29.03.2017;2017;03;22;Keskiviikko;11;11;22
622;29.03.2017;2017;03;23;Keskiviikko;9;4;13
622;30.03.2017;2017;03;00;Torstai;2;0;2
622;30.03.2017;2017;03;01;Torstai;2;0;2
622;30.03.2017;2017;03;02;Torstai;1;0;1
622;30.03.2017;2017;03;03;Torstai;2;1;3
622;30.03.2017;2017;03;04;Torstai;0;0;0
622;30.03.2017;2017;03;05;Torstai;0;1;1
622;30.03.2017;2017;03;06;Torstai;0;6;6
622;30.03.2017;2017;03;07;Torstai;7;19;26
622;30.03.2017;2017;03;08;Torstai;22;43;65
622;30.03.2017;2017;03;09;Torstai;21;37;58
622;30.03.2017;2017;03;10;Torstai;9;16;25
622;30.03.2017;2017;03;11;Torstai;11;10;21
622;30.03.2017;2017;03;12;Torstai;15;11;26
622;30.03.2017;2017;03;13;Torstai;15;28;43
622;30.03.2017;2017;03;14;Torstai;14;20;34
622;30.03.2017;2017;03;15;Torstai;25;35;60
622;30.03.2017;2017;03;16;Torstai;30;19;49
622;30.03.2017;2017;03;17;Torstai;43;33;76
622;30.03.2017;2017;03;18;Torstai;22;23;45
622;30.03.2017;2017;03;19;Torstai;31;18;49
622;30.03.2017;2017;03;20;Torstai;18;15;33
622;30.03.2017;2017;03;21;Torstai;9;13;22
622;30.03.2017;2017;03;22;Torstai;11;6;17
622;30.03.2017;2017;03;23;Torstai;4;1;5
622;31.03.2017;2017;03;00;Perjantai;3;2;5
622;31.03.2017;2017;03;01;Perjantai;2;0;2
622;31.03.2017;2017;03;02;Perjantai;0;1;1
622;31.03.2017;2017;03;03;Perjantai;2;0;2
622;31.03.2017;2017;03;04;Perjantai;1;0;1
622;31.03.2017;2017;03;05;Perjantai;0;1;1
622;31.03.2017;2017;03;06;Perjantai;1;6;7
622;31.03.2017;2017;03;07;Perjantai;3;15;18
622;31.03.2017;2017;03;08;Perjantai;20;35;55
622;31.03.2017;2017;03;09;Perjantai;29;33;62
622;31.03.2017;2017;03;10;Perjantai;21;20;41
622;31.03.2017;2017;03;11;Perjantai;5;10;15
622;31.03.2017;2017;03;12;Perjantai;13;14;27
622;31.03.2017;2017;03;13;Perjantai;14;24;38
622;31.03.2017;2017;03;14;Perjantai;23;29;52
622;31.03.2017;2017;03;15;Perjantai;34;27;61
622;31.03.2017;2017;03;16;Perjantai;25;15;40
622;31.03.2017;2017;03;17;Perjantai;35;27;62
622;31.03.2017;2017;03;18;Perjantai;23;28;51
622;31.03.2017;2017;03;19;Perjantai;23;17;40
622;31.03.2017;2017;03;20;Perjantai;16;13;29
622;31.03.2017;2017;03;21;Perjantai;15;17;32
622;31.03.2017;2017;03;22;Perjantai;11;4;15
622;31.03.2017;2017;03;23;Perjantai;2;2;4
622;01.04.2017;2017;04;00;Lauantai;5;4;9
622;01.04.2017;2017;04;01;Lauantai;3;0;3
622;01.04.2017;2017;04;02;Lauantai;7;0;7
622;01.04.2017;2017;04;03;Lauantai;3;0;3
622;01.04.2017;2017;04;04;Lauantai;1;0;1
622;01.04.2017;2017;04;05;Lauantai;0;1;1
622;01.04.2017;2017;04;06;Lauantai;1;1;2
622;01.04.2017;2017;04;07;Lauantai;1;6;7
622;01.04.2017;2017;04;08;Lauantai;3;0;3
622;01.04.2017;2017;04;09;Lauantai;3;6;9
622;01.04.2017;2017;04;10;Lauantai;6;9;15
622;01.04.2017;2017;04;11;Lauantai;6;9;15
622;01.04.2017;2017;04;12;Lauantai;9;11;20
622;01.04.2017;2017;04;13;Lauantai;13;22;35
622;01.04.2017;2017;04;14;Lauantai;11;21;32
622;01.04.2017;2017;04;15;Lauantai;10;7;17
622;01.04.2017;2017;04;16;Lauantai;19;14;33
622;01.04.2017;2017;04;17;Lauantai;14;12;26
622;01.04.2017;2017;04;18;Lauantai;11;10;21
622;01.04.2017;2017;04;19;Lauantai;5;10;15
622;01.04.2017;2017;04;20;Lauantai;7;7;14
622;01.04.2017;2017;04;21;Lauantai;6;9;15
622;01.04.2017;2017;04;22;Lauantai;4;6;10
622;01.04.2017;2017;04;23;Lauantai;2;0;2
622;02.04.2017;2017;04;00;Sunnuntai;7;6;13
622;02.04.2017;2017;04;01;Sunnuntai;3;0;3
622;02.04.2017;2017;04;02;Sunnuntai;2;0;2
622;02.04.2017;2017;04;03;Sunnuntai;4;1;5
622;02.04.2017;2017;04;04;Sunnuntai;1;0;1
622;02.04.2017;2017;04;05;Sunnuntai;0;1;1
622;02.04.2017;2017;04;06;Sunnuntai;2;1;3
622;02.04.2017;2017;04;07;Sunnuntai;3;4;7
622;02.04.2017;2017;04;08;Sunnuntai;5;3;8
622;02.04.2017;2017;04;09;Sunnuntai;0;3;3
622;02.04.2017;2017;04;10;Sunnuntai;3;7;10
622;02.04.2017;2017;04;11;Sunnuntai;9;11;20
622;02.04.2017;2017;04;12;Sunnuntai;13;20;33
622;02.04.2017;2017;04;13;Sunnuntai;22;20;42
622;02.04.2017;2017;04;14;Sunnuntai;10;17;27
622;02.04.2017;2017;04;15;Sunnuntai;24;21;45
622;02.04.2017;2017;04;16;Sunnuntai;8;18;26
622;02.04.2017;2017;04;17;Sunnuntai;16;17;33
622;02.04.2017;2017;04;18;Sunnuntai;11;8;19
622;02.04.2017;2017;04;19;Sunnuntai;8;12;20
622;02.04.2017;2017;04;20;Sunnuntai;12;7;19
622;02.04.2017;2017;04;21;Sunnuntai;8;9;17
622;02.04.2017;2017;04;22;Sunnuntai;6;7;13
622;02.04.2017;2017;04;23;Sunnuntai;3;0;3
622;03.04.2017;2017;04;00;Maanantai;3;2;5
622;03.04.2017;2017;04;01;Maanantai;1;3;4
622;03.04.2017;2017;04;02;Maanantai;2;1;3
622;03.04.2017;2017;04;03;Maanantai;0;1;1
622;03.04.2017;2017;04;04;Maanantai;1;0;1
622;03.04.2017;2017;04;05;Maanantai;1;0;1
622;03.04.2017;2017;04;06;Maanantai;4;7;11
622;03.04.2017;2017;04;07;Maanantai;3;28;31
622;03.04.2017;2017;04;08;Maanantai;33;46;79
622;03.04.2017;2017;04;09;Maanantai;26;33;59
622;03.04.2017;2017;04;10;Maanantai;19;31;50
622;03.04.2017;2017;04;11;Maanantai;16;21;37
622;03.04.2017;2017;04;12;Maanantai;18;23;41
622;03.04.2017;2017;04;13;Maanantai;8;22;30
622;03.04.2017;2017;04;14;Maanantai;19;18;37
622;03.04.2017;2017;04;15;Maanantai;27;29;56
622;03.04.2017;2017;04;16;Maanantai;37;17;54
622;03.04.2017;2017;04;17;Maanantai;58;36;94
622;03.04.2017;2017;04;18;Maanantai;28;23;51
622;03.04.2017;2017;04;19;Maanantai;25;25;50
622;03.04.2017;2017;04;20;Maanantai;21;13;34
622;03.04.2017;2017;04;21;Maanantai;10;10;20
622;03.04.2017;2017;04;22;Maanantai;9;2;11
622;03.04.2017;2017;04;23;Maanantai;6;2;8
622;04.04.2017;2017;04;00;Tiistai;1;1;2
622;04.04.2017;2017;04;01;Tiistai;2;1;3
622;04.04.2017;2017;04;02;Tiistai;0;0;0
622;04.04.2017;2017;04;03;Tiistai;0;0;0
622;04.04.2017;2017;04;04;Tiistai;0;1;1
622;04.04.2017;2017;04;05;Tiistai;0;0;0
622;04.04.2017;2017;04;06;Tiistai;3;7;10
622;04.04.2017;2017;04;07;Tiistai;7;28;35
622;04.04.2017;2017;04;08;Tiistai;26;40;66
622;04.04.2017;2017;04;09;Tiistai;26;25;51
622;04.04.2017;2017;04;10;Tiistai;16;34;50
622;04.04.2017;2017;04;11;Tiistai;15;18;33
622;04.04.2017;2017;04;12;Tiistai;15;15;30
622;04.04.2017;2017;04;13;Tiistai;9;21;30
622;04.04.2017;2017;04;14;Tiistai;18;22;40
622;04.04.2017;2017;04;15;Tiistai;24;40;64
622;04.04.2017;2017;04;16;Tiistai;42;31;73
622;04.04.2017;2017;04;17;Tiistai;50;42;92
622;04.04.2017;2017;04;18;Tiistai;30;30;60
622;04.04.2017;2017;04;19;Tiistai;25;10;35
622;04.04.2017;2017;04;20;Tiistai;20;16;36
622;04.04.2017;2017;04;21;Tiistai;20;10;30
622;04.04.2017;2017;04;22;Tiistai;10;6;16
622;04.04.2017;2017;04;23;Tiistai;6;7;13
622;05.04.2017;2017;04;00;Keskiviikko;5;1;6
622;05.04.2017;2017;04;01;Keskiviikko;0;4;4
622;05.04.2017;2017;04;02;Keskiviikko;2;1;3
622;05.04.2017;2017;04;03;Keskiviikko;1;0;1
622;05.04.2017;2017;04;04;Keskiviikko;0;1;1
622;05.04.2017;2017;04;05;Keskiviikko;1;1;2
622;05.04.2017;2017;04;06;Keskiviikko;5;6;11
622;05.04.2017;2017;04;07;Keskiviikko;5;24;29
622;05.04.2017;2017;04;08;Keskiviikko;25;46;71
622;05.04.2017;2017;04;09;Keskiviikko;27;37;64
622;05.04.2017;2017;04;10;Keskiviikko;13;25;38
622;05.04.2017;2017;04;11;Keskiviikko;16;16;32
622;05.04.2017;2017;04;12;Keskiviikko;19;23;42
622;05.04.2017;2017;04;13;Keskiviikko;22;32;54
622;05.04.2017;2017;04;14;Keskiviikko;28;30;58
622;05.04.2017;2017;04;15;Keskiviikko;23;33;56
622;05.04.2017;2017;04;16;Keskiviikko;32;36;68
622;05.04.2017;2017;04;17;Keskiviikko;56;41;97
622;05.04.2017;2017;04;18;Keskiviikko;35;40;75
622;05.04.2017;2017;04;19;Keskiviikko;33;26;59
622;05.04.2017;2017;04;20;Keskiviikko;30;17;47
622;05.04.2017;2017;04;21;Keskiviikko;18;10;28
622;05.04.2017;2017;04;22;Keskiviikko;18;11;29
622;05.04.2017;2017;04;23;Keskiviikko;7;4;11
622;06.04.2017;2017;04;00;Torstai;3;2;5
622;06.04.2017;2017;04;01;Torstai;2;0;2
622;06.04.2017;2017;04;02;Torstai;2;1;3
622;06.04.2017;2017;04;03;Torstai;0;0;0
622;06.04.2017;2017;04;04;Torstai;0;0;0
622;06.04.2017;2017;04;05;Torstai;2;2;4
622;06.04.2017;2017;04;06;Torstai;3;10;13
622;06.04.2017;2017;04;07;Torstai;8;18;26
622;06.04.2017;2017;04;08;Torstai;23;41;64
622;06.04.2017;2017;04;09;Torstai;25;26;51
622;06.04.2017;2017;04;10;Torstai;9;21;30
622;06.04.2017;2017;04;11;Torstai;7;24;31
622;06.04.2017;2017;04;12;Torstai;16;28;44
622;06.04.2017;2017;04;13;Torstai;21;30;51
622;06.04.2017;2017;04;14;Torstai;22;26;48
622;06.04.2017;2017;04;15;Torstai;30;30;60
622;06.04.2017;2017;04;16;Torstai;20;15;35
622;06.04.2017;2017;04;17;Torstai;55;37;92
622;06.04.2017;2017;04;18;Torstai;30;28;58
622;06.04.2017;2017;04;19;Torstai;31;22;53
622;06.04.2017;2017;04;20;Torstai;28;17;45
622;06.04.2017;2017;04;21;Torstai;16;15;31
622;06.04.2017;2017;04;22;Torstai;17;6;23
622;06.04.2017;2017;04;23;Torstai;3;6;9
622;07.04.2017;2017;04;00;Perjantai;2;2;4
622;07.04.2017;2017;04;01;Perjantai;3;0;3
622;07.04.2017;2017;04;02;Perjantai;1;0;1
622;07.04.2017;2017;04;03;Perjantai;0;1;1
622;07.04.2017;2017;04;04;Perjantai;1;0;1
622;07.04.2017;2017;04;05;Perjantai;3;1;4
622;07.04.2017;2017;04;06;Perjantai;3;7;10
622;07.04.2017;2017;04;07;Perjantai;2;27;29
622;07.04.2017;2017;04;08;Perjantai;22;43;65
622;07.04.2017;2017;04;09;Perjantai;22;31;53
622;07.04.2017;2017;04;10;Perjantai;26;32;58
622;07.04.2017;2017;04;11;Perjantai;14;16;30
622;07.04.2017;2017;04;12;Perjantai;18;25;43
622;07.04.2017;2017;04;13;Perjantai;18;33;51
622;07.04.2017;2017;04;14;Perjantai;29;26;55
622;07.04.2017;2017;04;15;Perjantai;33;33;66
622;07.04.2017;2017;04;16;Perjantai;37;25;62
622;07.04.2017;2017;04;17;Perjantai;45;24;69
622;07.04.2017;2017;04;18;Perjantai;27;13;40
622;07.04.2017;2017;04;19;Perjantai;26;19;45
622;07.04.2017;2017;04;20;Perjantai;23;17;40
622;07.04.2017;2017;04;21;Perjantai;21;18;39
622;07.04.2017;2017;04;22;Perjantai;15;6;21
622;07.04.2017;2017;04;23;Perjantai;7;2;9
622;08.04.2017;2017;04;00;Lauantai;4;4;8
622;08.04.2017;2017;04;01;Lauantai;4;2;6
622;08.04.2017;2017;04;02;Lauantai;1;2;3
622;08.04.2017;2017;04;03;Lauantai;0;0;0
622;08.04.2017;2017;04;04;Lauantai;2;1;3
622;08.04.2017;2017;04;05;Lauantai;1;2;3
622;08.04.2017;2017;04;06;Lauantai;2;4;6
622;08.04.2017;2017;04;07;Lauantai;0;6;6
622;08.04.2017;2017;04;08;Lauantai;0;3;3
622;08.04.2017;2017;04;09;Lauantai;4;8;12
622;08.04.2017;2017;04;10;Lauantai;8;15;23
622;08.04.2017;2017;04;11;Lauantai;15;19;34
622;08.04.2017;2017;04;12;Lauantai;13;30;43
622;08.04.2017;2017;04;13;Lauantai;18;18;36
622;08.04.2017;2017;04;14;Lauantai;25;24;49
622;08.04.2017;2017;04;15;Lauantai;29;23;52
622;08.04.2017;2017;04;16;Lauantai;22;18;40
622;08.04.2017;2017;04;17;Lauantai;23;18;41
622;08.04.2017;2017;04;18;Lauantai;17;11;28
622;08.04.2017;2017;04;19;Lauantai;18;10;28
622;08.04.2017;2017;04;20;Lauantai;14;20;34
622;08.04.2017;2017;04;21;Lauantai;17;13;30
622;08.04.2017;2017;04;22;Lauantai;12;6;18
622;08.04.2017;2017;04;23;Lauantai;9;2;11
622;09.04.2017;2017;04;00;Sunnuntai;4;2;6
622;09.04.2017;2017;04;01;Sunnuntai;4;7;11
622;09.04.2017;2017;04;02;Sunnuntai;2;3;5
622;09.04.2017;2017;04;03;Sunnuntai;0;1;1
622;09.04.2017;2017;04;04;Sunnuntai;5;1;6
622;09.04.2017;2017;04;05;Sunnuntai;1;2;3
622;09.04.2017;2017;04;06;Sunnuntai;1;2;3
622;09.04.2017;2017;04;07;Sunnuntai;1;2;3
622;09.04.2017;2017;04;08;Sunnuntai;0;3;3
622;09.04.2017;2017;04;09;Sunnuntai;2;4;6
622;09.04.2017;2017;04;10;Sunnuntai;9;5;14
622;09.04.2017;2017;04;11;Sunnuntai;7;8;15
622;09.04.2017;2017;04;12;Sunnuntai;14;19;33
622;09.04.2017;2017;04;13;Sunnuntai;17;26;43
622;09.04.2017;2017;04;14;Sunnuntai;14;24;38
622;09.04.2017;2017;04;15;Sunnuntai;17;22;39
622;09.04.2017;2017;04;16;Sunnuntai;21;8;29
622;09.04.2017;2017;04;17;Sunnuntai;16;23;39
622;09.04.2017;2017;04;18;Sunnuntai;22;25;47
622;09.04.2017;2017;04;19;Sunnuntai;26;12;38
622;09.04.2017;2017;04;20;Sunnuntai;10;25;35
622;09.04.2017;2017;04;21;Sunnuntai;16;10;26
622;09.04.2017;2017;04;22;Sunnuntai;5;2;7
622;09.04.2017;2017;04;23;Sunnuntai;1;3;4
622;10.04.2017;2017;04;00;Maanantai;3;3;6
622;10.04.2017;2017;04;01;Maanantai;1;1;2
622;10.04.2017;2017;04;02;Maanantai;0;1;1
622;10.04.2017;2017;04;03;Maanantai;2;0;2
622;10.04.2017;2017;04;04;Maanantai;0;0;0
622;10.04.2017;2017;04;05;Maanantai;0;3;3
622;10.04.2017;2017;04;06;Maanantai;1;10;11
622;10.04.2017;2017;04;07;Maanantai;2;18;20
622;10.04.2017;2017;04;08;Maanantai;15;47;62
622;10.04.2017;2017;04;09;Maanantai;38;30;68
622;10.04.2017;2017;04;10;Maanantai;12;30;42
622;10.04.2017;2017;04;11;Maanantai;11;23;34
622;10.04.2017;2017;04;12;Maanantai;18;20;38
622;10.04.2017;2017;04;13;Maanantai;14;15;29
622;10.04.2017;2017;04;14;Maanantai;15;11;26
622;10.04.2017;2017;04;15;Maanantai;32;26;58
622;10.04.2017;2017;04;16;Maanantai;38;33;71
622;10.04.2017;2017;04;17;Maanantai;44;27;71
622;10.04.2017;2017;04;18;Maanantai;18;20;38
622;10.04.2017;2017;04;19;Maanantai;25;6;31
622;10.04.2017;2017;04;20;Maanantai;14;8;22
622;10.04.2017;2017;04;21;Maanantai;9;5;14
622;10.04.2017;2017;04;22;Maanantai;13;7;20
622;10.04.2017;2017;04;23;Maanantai;3;2;5
622;11.04.2017;2017;04;00;Tiistai;2;0;2
622;11.04.2017;2017;04;01;Tiistai;3;1;4
622;11.04.2017;2017;04;02;Tiistai;2;0;2
622;11.04.2017;2017;04;03;Tiistai;1;0;1
622;11.04.2017;2017;04;04;Tiistai;1;0;1
622;11.04.2017;2017;04;05;Tiistai;1;2;3
622;11.04.2017;2017;04;06;Tiistai;2;6;8
622;11.04.2017;2017;04;07;Tiistai;8;17;25
622;11.04.2017;2017;04;08;Tiistai;15;20;35
622;11.04.2017;2017;04;09;Tiistai;15;15;30
622;11.04.2017;2017;04;10;Tiistai;8;11;19
622;11.04.2017;2017;04;11;Tiistai;5;10;15
622;11.04.2017;2017;04;12;Tiistai;8;5;13
622;11.04.2017;2017;04;13;Tiistai;13;16;29
622;11.04.2017;2017;04;14;Tiistai;9;17;26
622;11.04.2017;2017;04;15;Tiistai;16;26;42
622;11.04.2017;2017;04;16;Tiistai;29;19;48
622;11.04.2017;2017;04;17;Tiistai;31;27;58
622;11.04.2017;2017;04;18;Tiistai;22;17;39
622;11.04.2017;2017;04;19;Tiistai;17;12;29
622;11.04.2017;2017;04;20;Tiistai;17;16;33
622;11.04.2017;2017;04;21;Tiistai;16;12;28
622;11.04.2017;2017;04;22;Tiistai;10;9;19
622;11.04.2017;2017;04;23;Tiistai;6;2;8
622;12.04.2017;2017;04;00;Keskiviikko;4;0;4
622;12.04.2017;2017;04;01;Keskiviikko;3;0;3
622;12.04.2017;2017;04;02;Keskiviikko;1;1;2
622;12.04.2017;2017;04;03;Keskiviikko;0;1;1
622;12.04.2017;2017;04;04;Keskiviikko;0;0;0
622;12.04.2017;2017;04;05;Keskiviikko;0;1;1
622;12.04.2017;2017;04;06;Keskiviikko;1;6;7
622;12.04.2017;2017;04;07;Keskiviikko;4;16;20
622;12.04.2017;2017;04;08;Keskiviikko;20;42;62
622;12.04.2017;2017;04;09;Keskiviikko;24;23;47
622;12.04.2017;2017;04;10;Keskiviikko;16;21;37
622;12.04.2017;2017;04;11;Keskiviikko;9;17;26
622;12.04.2017;2017;04;12;Keskiviikko;13;22;35
622;12.04.2017;2017;04;13;Keskiviikko;15;18;33
622;12.04.2017;2017;04;14;Keskiviikko;24;24;48
622;12.04.2017;2017;04;15;Keskiviikko;28;23;51
622;12.04.2017;2017;04;16;Keskiviikko;32;23;55
622;12.04.2017;2017;04;17;Keskiviikko;52;33;85
622;12.04.2017;2017;04;18;Keskiviikko;23;30;53
622;12.04.2017;2017;04;19;Keskiviikko;10;16;26
622;12.04.2017;2017;04;20;Keskiviikko;23;13;36
622;12.04.2017;2017;04;21;Keskiviikko;17;9;26
622;12.04.2017;2017;04;22;Keskiviikko;9;4;13
622;12.04.2017;2017;04;23;Keskiviikko;4;4;8
622;13.04.2017;2017;04;00;Torstai;2;0;2
622;13.04.2017;2017;04;01;Torstai;0;0;0
622;13.04.2017;2017;04;02;Torstai;0;1;1
622;13.04.2017;2017;04;03;Torstai;1;0;1
622;13.04.2017;2017;04;04;Torstai;1;1;2
622;13.04.2017;2017;04;05;Torstai;3;1;4
622;13.04.2017;2017;04;06;Torstai;1;8;9
622;13.04.2017;2017;04;07;Torstai;2;20;22
622;13.04.2017;2017;04;08;Torstai;15;27;42
622;13.04.2017;2017;04;09;Torstai;27;28;55
622;13.04.2017;2017;04;10;Torstai;10;18;28
622;13.04.2017;2017;04;11;Torstai;7;20;27
622;13.04.2017;2017;04;12;Torstai;18;21;39
622;13.04.2017;2017;04;13;Torstai;14;20;34
622;13.04.2017;2017;04;14;Torstai;25;24;49
622;13.04.2017;2017;04;15;Torstai;22;20;42
622;13.04.2017;2017;04;16;Torstai;35;22;57
622;13.04.2017;2017;04;17;Torstai;41;24;65
622;13.04.2017;2017;04;18;Torstai;22;17;39
622;13.04.2017;2017;04;19;Torstai;24;17;41
622;13.04.2017;2017;04;20;Torstai;10;10;20
622;13.04.2017;2017;04;21;Torstai;11;7;18
622;13.04.2017;2017;04;22;Torstai;8;6;14
622;13.04.2017;2017;04;23;Torstai;3;6;9
622;14.04.2017;2017;04;00;Perjantai;3;2;5
622;14.04.2017;2017;04;01;Perjantai;1;3;4
622;14.04.2017;2017;04;02;Perjantai;3;0;3
622;14.04.2017;2017;04;03;Perjantai;0;0;0
622;14.04.2017;2017;04;04;Perjantai;2;2;4
622;14.04.2017;2017;04;05;Perjantai;2;1;3
622;14.04.2017;2017;04;06;Perjantai;2;3;5
622;14.04.2017;2017;04;07;Perjantai;0;6;6
622;14.04.2017;2017;04;08;Perjantai;2;3;5
622;14.04.2017;2017;04;09;Perjantai;2;3;5
622;14.04.2017;2017;04;10;Perjantai;3;3;6
622;14.04.2017;2017;04;11;Perjantai;6;10;16
622;14.04.2017;2017;04;12;Perjantai;11;16;27
622;14.04.2017;2017;04;13;Perjantai;19;20;39
622;14.04.2017;2017;04;14;Perjantai;10;16;26
622;14.04.2017;2017;04;15;Perjantai;13;8;21
622;14.04.2017;2017;04;16;Perjantai;8;13;21
622;14.04.2017;2017;04;17;Perjantai;13;14;27
622;14.04.2017;2017;04;18;Perjantai;9;13;22
622;14.04.2017;2017;04;19;Perjantai;10;9;19
622;14.04.2017;2017;04;20;Perjantai;14;9;23
622;14.04.2017;2017;04;21;Perjantai;8;5;13
622;14.04.2017;2017;04;22;Perjantai;3;5;8
622;14.04.2017;2017;04;23;Perjantai;3;2;5
622;15.04.2017;2017;04;00;Lauantai;4;6;10
622;15.04.2017;2017;04;01;Lauantai;2;4;6
622;15.04.2017;2017;04;02;Lauantai;1;1;2
622;15.04.2017;2017;04;03;Lauantai;1;3;4
622;15.04.2017;2017;04;04;Lauantai;1;1;2
622;15.04.2017;2017;04;05;Lauantai;5;0;5
622;15.04.2017;2017;04;06;Lauantai;1;2;3
622;15.04.2017;2017;04;07;Lauantai;2;4;6
622;15.04.2017;2017;04;08;Lauantai;1;1;2
622;15.04.2017;2017;04;09;Lauantai;2;2;4
622;15.04.2017;2017;04;10;Lauantai;3;10;13
622;15.04.2017;2017;04;11;Lauantai;6;7;13
622;15.04.2017;2017;04;12;Lauantai;6;8;14
622;15.04.2017;2017;04;13;Lauantai;9;17;26
622;15.04.2017;2017;04;14;Lauantai;13;12;25
622;15.04.2017;2017;04;15;Lauantai;8;11;19
622;15.04.2017;2017;04;16;Lauantai;13;10;23
622;15.04.2017;2017;04;17;Lauantai;17;18;35
622;15.04.2017;2017;04;18;Lauantai;4;9;13
622;15.04.2017;2017;04;19;Lauantai;16;15;31
622;15.04.2017;2017;04;20;Lauantai;11;7;18
622;15.04.2017;2017;04;21;Lauantai;9;10;19
622;15.04.2017;2017;04;22;Lauantai;5;6;11
622;15.04.2017;2017;04;23;Lauantai;7;2;9
622;16.04.2017;2017;04;00;Sunnuntai;2;3;5
622;16.04.2017;2017;04;01;Sunnuntai;1;1;2
622;16.04.2017;2017;04;02;Sunnuntai;1;1;2
622;16.04.2017;2017;04;03;Sunnuntai;1;1;2
622;16.04.2017;2017;04;04;Sunnuntai;1;3;4
622;16.04.2017;2017;04;05;Sunnuntai;1;1;2
622;16.04.2017;2017;04;06;Sunnuntai;0;3;3
622;16.04.2017;2017;04;07;Sunnuntai;0;3;3
622;16.04.2017;2017;04;08;Sunnuntai;2;6;8
622;16.04.2017;2017;04;09;Sunnuntai;1;2;3
622;16.04.2017;2017;04;10;Sunnuntai;3;2;5
622;16.04.2017;2017;04;11;Sunnuntai;6;5;11
622;16.04.2017;2017;04;12;Sunnuntai;12;15;27
622;16.04.2017;2017;04;13;Sunnuntai;15;19;34
622;16.04.2017;2017;04;14;Sunnuntai;18;25;43
622;16.04.2017;2017;04;15;Sunnuntai;21;21;42
622;16.04.2017;2017;04;16;Sunnuntai;22;17;39
622;16.04.2017;2017;04;17;Sunnuntai;24;24;48
622;16.04.2017;2017;04;18;Sunnuntai;15;11;26
622;16.04.2017;2017;04;19;Sunnuntai;17;11;28
622;16.04.2017;2017;04;20;Sunnuntai;6;7;13
622;16.04.2017;2017;04;21;Sunnuntai;8;4;12
622;16.04.2017;2017;04;22;Sunnuntai;8;5;13
622;16.04.2017;2017;04;23;Sunnuntai;2;3;5
622;17.04.2017;2017;04;00;Maanantai;3;2;5
622;17.04.2017;2017;04;01;Maanantai;3;5;8
622;17.04.2017;2017;04;02;Maanantai;4;0;4
622;17.04.2017;2017;04;03;Maanantai;1;1;2
622;17.04.2017;2017;04;04;Maanantai;0;1;1
622;17.04.2017;2017;04;05;Maanantai;2;1;3
622;17.04.2017;2017;04;06;Maanantai;2;1;3
622;17.04.2017;2017;04;07;Maanantai;0;2;2
622;17.04.2017;2017;04;08;Maanantai;3;1;4
622;17.04.2017;2017;04;09;Maanantai;0;3;3
622;17.04.2017;2017;04;10;Maanantai;6;8;14
622;17.04.2017;2017;04;11;Maanantai;8;6;14
622;17.04.2017;2017;04;12;Maanantai;8;17;25
622;17.04.2017;2017;04;13;Maanantai;19;19;38
622;17.04.2017;2017;04;14;Maanantai;18;24;42
622;17.04.2017;2017;04;15;Maanantai;10;12;22
622;17.04.2017;2017;04;16;Maanantai;16;14;30
622;17.04.2017;2017;04;17;Maanantai;23;25;48
622;17.04.2017;2017;04;18;Maanantai;16;14;30
622;17.04.2017;2017;04;19;Maanantai;12;12;24
622;17.04.2017;2017;04;20;Maanantai;10;9;19
622;17.04.2017;2017;04;21;Maanantai;14;6;20
622;17.04.2017;2017;04;22;Maanantai;5;7;12
622;17.04.2017;2017;04;23;Maanantai;6;1;7
622;18.04.2017;2017;04;00;Tiistai;4;2;6
622;18.04.2017;2017;04;01;Tiistai;0;2;2
622;18.04.2017;2017;04;02;Tiistai;1;0;1
622;18.04.2017;2017;04;03;Tiistai;0;0;0
622;18.04.2017;2017;04;04;Tiistai;1;0;1
622;18.04.2017;2017;04;05;Tiistai;1;1;2
622;18.04.2017;2017;04;06;Tiistai;2;9;11
622;18.04.2017;2017;04;07;Tiistai;5;26;31
622;18.04.2017;2017;04;08;Tiistai;23;36;59
622;18.04.2017;2017;04;09;Tiistai;30;36;66
622;18.04.2017;2017;04;10;Tiistai;13;23;36
622;18.04.2017;2017;04;11;Tiistai;5;23;28
622;18.04.2017;2017;04;12;Tiistai;9;25;34
622;18.04.2017;2017;04;13;Tiistai;22;28;50
622;18.04.2017;2017;04;14;Tiistai;31;22;53
622;18.04.2017;2017;04;15;Tiistai;29;31;60
622;18.04.2017;2017;04;16;Tiistai;54;37;91
622;18.04.2017;2017;04;17;Tiistai;58;34;92
622;18.04.2017;2017;04;18;Tiistai;41;31;72
622;18.04.2017;2017;04;19;Tiistai;29;26;55
622;18.04.2017;2017;04;20;Tiistai;24;14;38
622;18.04.2017;2017;04;21;Tiistai;31;14;45
622;18.04.2017;2017;04;22;Tiistai;19;17;36
622;18.04.2017;2017;04;23;Tiistai;3;4;7
622;19.04.2017;2017;04;00;Keskiviikko;4;1;5
622;19.04.2017;2017;04;01;Keskiviikko;4;0;4
622;19.04.2017;2017;04;02;Keskiviikko;5;2;7
622;19.04.2017;2017;04;03;Keskiviikko;0;0;0
622;19.04.2017;2017;04;04;Keskiviikko;0;1;1
622;19.04.2017;2017;04;05;Keskiviikko;2;0;2
622;19.04.2017;2017;04;06;Keskiviikko;2;8;10
622;19.04.2017;2017;04;07;Keskiviikko;9;25;34
622;19.04.2017;2017;04;08;Keskiviikko;27;48;75
622;19.04.2017;2017;04;09;Keskiviikko;32;43;75
622;19.04.2017;2017;04;10;Keskiviikko;12;27;39
622;19.04.2017;2017;04;11;Keskiviikko;10;20;30
622;19.04.2017;2017;04;12;Keskiviikko;23;21;44
622;19.04.2017;2017;04;13;Keskiviikko;15;20;35
622;19.04.2017;2017;04;14;Keskiviikko;24;37;61
622;19.04.2017;2017;04;15;Keskiviikko;48;30;78
622;19.04.2017;2017;04;16;Keskiviikko;42;28;70
622;19.04.2017;2017;04;17;Keskiviikko;54;37;91
622;19.04.2017;2017;04;18;Keskiviikko;25;26;51
622;19.04.2017;2017;04;19;Keskiviikko;38;25;63
622;19.04.2017;2017;04;20;Keskiviikko;19;10;29
622;19.04.2017;2017;04;21;Keskiviikko;20;9;29
622;19.04.2017;2017;04;22;Keskiviikko;15;8;23
622;19.04.2017;2017;04;23;Keskiviikko;4;4;8
622;20.04.2017;2017;04;00;Torstai;3;1;4
622;20.04.2017;2017;04;01;Torstai;5;0;5
622;20.04.2017;2017;04;02;Torstai;2;1;3
622;20.04.2017;2017;04;03;Torstai;2;0;2
622;20.04.2017;2017;04;04;Torstai;0;2;2
622;20.04.2017;2017;04;05;Torstai;4;1;5
622;20.04.2017;2017;04;06;Torstai;2;6;8
622;20.04.2017;2017;04;07;Torstai;12;23;35
622;20.04.2017;2017;04;08;Torstai;21;37;58
622;20.04.2017;2017;04;09;Torstai;26;36;62
622;20.04.2017;2017;04;10;Torstai;10;22;32
622;20.04.2017;2017;04;11;Torstai;12;16;28
622;20.04.2017;2017;04;12;Torstai;9;14;23
622;20.04.2017;2017;04;13;Torstai;18;18;36
622;20.04.2017;2017;04;14;Torstai;24;21;45
622;20.04.2017;2017;04;15;Torstai;40;31;71
622;20.04.2017;2017;04;16;Torstai;41;19;60
622;20.04.2017;2017;04;17;Torstai;22;17;39
622;20.04.2017;2017;04;18;Torstai;24;11;35
622;20.04.2017;2017;04;19;Torstai;23;3;26
622;20.04.2017;2017;04;20;Torstai;15;7;22
622;20.04.2017;2017;04;21;Torstai;9;6;15
622;20.04.2017;2017;04;22;Torstai;7;7;14
622;20.04.2017;2017;04;23;Torstai;3;3;6
622;21.04.2017;2017;04;00;Perjantai;2;1;3
622;21.04.2017;2017;04;01;Perjantai;3;1;4
622;21.04.2017;2017;04;02;Perjantai;0;0;0
622;21.04.2017;2017;04;03;Perjantai;2;0;2
622;21.04.2017;2017;04;04;Perjantai;2;1;3
622;21.04.2017;2017;04;05;Perjantai;2;0;2
622;21.04.2017;2017;04;06;Perjantai;0;3;3
622;21.04.2017;2017;04;07;Perjantai;7;19;26
622;21.04.2017;2017;04;08;Perjantai;25;38;63
622;21.04.2017;2017;04;09;Perjantai;27;33;60
622;21.04.2017;2017;04;10;Perjantai;14;23;37
622;21.04.2017;2017;04;11;Perjantai;13;22;35
622;21.04.2017;2017;04;12;Perjantai;13;22;35
622;21.04.2017;2017;04;13;Perjantai;20;32;52
622;21.04.2017;2017;04;14;Perjantai;20;32;52
622;21.04.2017;2017;04;15;Perjantai;41;40;81
622;21.04.2017;2017;04;16;Perjantai;40;39;79
622;21.04.2017;2017;04;17;Perjantai;47;38;85
622;21.04.2017;2017;04;18;Perjantai;33;27;60
622;21.04.2017;2017;04;19;Perjantai;41;18;59
622;21.04.2017;2017;04;20;Perjantai;20;18;38
622;21.04.2017;2017;04;21;Perjantai;16;9;25
622;21.04.2017;2017;04;22;Perjantai;13;5;18
622;21.04.2017;2017;04;23;Perjantai;8;3;11
622;22.04.2017;2017;04;00;Lauantai;8;3;11
622;22.04.2017;2017;04;01;Lauantai;3;1;4
622;22.04.2017;2017;04;02;Lauantai;2;0;2
622;22.04.2017;2017;04;03;Lauantai;0;2;2
622;22.04.2017;2017;04;04;Lauantai;2;2;4
622;22.04.2017;2017;04;05;Lauantai;0;2;2
622;22.04.2017;2017;04;06;Lauantai;1;3;4
622;22.04.2017;2017;04;07;Lauantai;2;2;4
622;22.04.2017;2017;04;08;Lauantai;3;2;5
622;22.04.2017;2017;04;09;Lauantai;3;4;7
622;22.04.2017;2017;04;10;Lauantai;3;15;18
622;22.04.2017;2017;04;11;Lauantai;11;23;34
622;22.04.2017;2017;04;12;Lauantai;20;25;45
622;22.04.2017;2017;04;13;Lauantai;31;34;65
622;22.04.2017;2017;04;14;Lauantai;31;28;59
622;22.04.2017;2017;04;15;Lauantai;16;27;43
622;22.04.2017;2017;04;16;Lauantai;35;23;58
622;22.04.2017;2017;04;17;Lauantai;28;23;51
622;22.04.2017;2017;04;18;Lauantai;21;19;40
622;22.04.2017;2017;04;19;Lauantai;18;16;34
622;22.04.2017;2017;04;20;Lauantai;12;14;26
622;22.04.2017;2017;04;21;Lauantai;13;9;22
622;22.04.2017;2017;04;22;Lauantai;5;8;13
622;22.04.2017;2017;04;23;Lauantai;13;4;17
622;23.04.2017;2017;04;00;Sunnuntai;9;6;15
622;23.04.2017;2017;04;01;Sunnuntai;3;3;6
622;23.04.2017;2017;04;02;Sunnuntai;5;0;5
622;23.04.2017;2017;04;03;Sunnuntai;4;1;5
622;23.04.2017;2017;04;04;Sunnuntai;2;2;4
622;23.04.2017;2017;04;05;Sunnuntai;2;0;2
622;23.04.2017;2017;04;06;Sunnuntai;0;1;1
622;23.04.2017;2017;04;07;Sunnuntai;1;2;3
622;23.04.2017;2017;04;08;Sunnuntai;2;0;2
622;23.04.2017;2017;04;09;Sunnuntai;1;4;5
622;23.04.2017;2017;04;10;Sunnuntai;4;6;10
622;23.04.2017;2017;04;11;Sunnuntai;5;8;13
622;23.04.2017;2017;04;12;Sunnuntai;11;27;38
622;23.04.2017;2017;04;13;Sunnuntai;19;28;47
622;23.04.2017;2017;04;14;Sunnuntai;19;22;41
622;23.04.2017;2017;04;15;Sunnuntai;19;17;36
622;23.04.2017;2017;04;16;Sunnuntai;21;22;43
622;23.04.2017;2017;04;17;Sunnuntai;29;18;47
622;23.04.2017;2017;04;18;Sunnuntai;11;2;13
622;23.04.2017;2017;04;19;Sunnuntai;7;8;15
622;23.04.2017;2017;04;20;Sunnuntai;11;9;20
622;23.04.2017;2017;04;21;Sunnuntai;8;7;15
622;23.04.2017;2017;04;22;Sunnuntai;7;3;10
622;23.04.2017;2017;04;23;Sunnuntai;4;0;4
622;24.04.2017;2017;04;00;Maanantai;3;1;4
622;24.04.2017;2017;04;01;Maanantai;3;1;4
622;24.04.2017;2017;04;02;Maanantai;1;2;3
622;24.04.2017;2017;04;03;Maanantai;2;1;3
622;24.04.2017;2017;04;04;Maanantai;3;0;3
622;24.04.2017;2017;04;05;Maanantai;2;1;3
622;24.04.2017;2017;04;06;Maanantai;4;8;12
622;24.04.2017;2017;04;07;Maanantai;10;33;43
622;24.04.2017;2017;04;08;Maanantai;26;41;67
622;24.04.2017;2017;04;09;Maanantai;28;38;66
622;24.04.2017;2017;04;10;Maanantai;12;22;34
622;24.04.2017;2017;04;11;Maanantai;11;16;27
622;24.04.2017;2017;04;12;Maanantai;13;35;48
622;24.04.2017;2017;04;13;Maanantai;21;29;50
622;24.04.2017;2017;04;14;Maanantai;29;21;50
622;24.04.2017;2017;04;15;Maanantai;42;38;80
622;24.04.2017;2017;04;16;Maanantai;60;34;94
622;24.04.2017;2017;04;17;Maanantai;55;42;97
622;24.04.2017;2017;04;18;Maanantai;34;30;64
622;24.04.2017;2017;04;19;Maanantai;34;29;63
622;24.04.2017;2017;04;20;Maanantai;26;20;46
622;24.04.2017;2017;04;21;Maanantai;25;20;45
622;24.04.2017;2017;04;22;Maanantai;13;8;21
622;24.04.2017;2017;04;23;Maanantai;11;7;18
622;25.04.2017;2017;04;00;Tiistai;3;3;6
622;25.04.2017;2017;04;01;Tiistai;1;0;1
622;25.04.2017;2017;04;02;Tiistai;2;1;3
622;25.04.2017;2017;04;03;Tiistai;3;0;3
622;25.04.2017;2017;04;04;Tiistai;0;0;0
622;25.04.2017;2017;04;05;Tiistai;4;1;5
622;25.04.2017;2017;04;06;Tiistai;2;7;9
622;25.04.2017;2017;04;07;Tiistai;15;43;58
622;25.04.2017;2017;04;08;Tiistai;30;59;89
622;25.04.2017;2017;04;09;Tiistai;32;51;83
622;25.04.2017;2017;04;10;Tiistai;23;33;56
622;25.04.2017;2017;04;11;Tiistai;8;20;28
622;25.04.2017;2017;04;12;Tiistai;16;26;42
622;25.04.2017;2017;04;13;Tiistai;20;31;51
622;25.04.2017;2017;04;14;Tiistai;34;34;68
622;25.04.2017;2017;04;15;Tiistai;47;37;84
622;25.04.2017;2017;04;16;Tiistai;51;47;98
622;25.04.2017;2017;04;17;Tiistai;71;40;111
622;25.04.2017;2017;04;18;Tiistai;44;33;77
622;25.04.2017;2017;04;19;Tiistai;33;27;60
622;25.04.2017;2017;04;20;Tiistai;26;24;50
622;25.04.2017;2017;04;21;Tiistai;31;9;40
622;25.04.2017;2017;04;22;Tiistai;19;8;27
622;25.04.2017;2017;04;23;Tiistai;6;3;9
622;26.04.2017;2017;04;00;Keskiviikko;4;2;6
622;26.04.2017;2017;04;01;Keskiviikko;2;0;2
622;26.04.2017;2017;04;02;Keskiviikko;1;2;3
622;26.04.2017;2017;04;03;Keskiviikko;1;0;1
622;26.04.2017;2017;04;04;Keskiviikko;1;1;2
622;26.04.2017;2017;04;05;Keskiviikko;0;1;1
622;26.04.2017;2017;04;06;Keskiviikko;1;5;6
622;26.04.2017;2017;04;07;Keskiviikko;10;25;35
622;26.04.2017;2017;04;08;Keskiviikko;18;41;59
622;26.04.2017;2017;04;09;Keskiviikko;29;39;68
622;26.04.2017;2017;04;10;Keskiviikko;16;12;28
622;26.04.2017;2017;04;11;Keskiviikko;4;8;12
622;26.04.2017;2017;04;12;Keskiviikko;5;3;8
622;26.04.2017;2017;04;13;Keskiviikko;7;11;18
622;26.04.2017;2017;04;14;Keskiviikko;11;20;31
622;26.04.2017;2017;04;15;Keskiviikko;14;24;38
622;26.04.2017;2017;04;16;Keskiviikko;28;20;48
622;26.04.2017;2017;04;17;Keskiviikko;45;27;72
622;26.04.2017;2017;04;18;Keskiviikko;19;18;37
622;26.04.2017;2017;04;19;Keskiviikko;16;7;23
622;26.04.2017;2017;04;20;Keskiviikko;12;7;19
622;26.04.2017;2017;04;21;Keskiviikko;7;8;15
622;26.04.2017;2017;04;22;Keskiviikko;10;5;15
622;26.04.2017;2017;04;23;Keskiviikko;3;4;7
622;27.04.2017;2017;04;00;Torstai;7;0;7
622;27.04.2017;2017;04;01;Torstai;2;0;2
622;27.04.2017;2017;04;02;Torstai;3;2;5
622;27.04.2017;2017;04;03;Torstai;3;1;4
622;27.04.2017;2017;04;04;Torstai;0;0;0
622;27.04.2017;2017;04;05;Torstai;0;0;0
622;27.04.2017;2017;04;06;Torstai;0;3;3
622;27.04.2017;2017;04;07;Torstai;9;15;24
622;27.04.2017;2017;04;08;Torstai;13;34;47
622;27.04.2017;2017;04;09;Torstai;23;41;64
622;27.04.2017;2017;04;10;Torstai;9;23;32
622;27.04.2017;2017;04;11;Torstai;10;15;25
622;27.04.2017;2017;04;12;Torstai;19;15;34
622;27.04.2017;2017;04;13;Torstai;16;23;39
622;27.04.2017;2017;04;14;Torstai;23;32;55
622;27.04.2017;2017;04;15;Torstai;30;29;59
622;27.04.2017;2017;04;16;Torstai;43;31;74
622;27.04.2017;2017;04;17;Torstai;51;33;84
622;27.04.2017;2017;04;18;Torstai;40;32;72
622;27.04.2017;2017;04;19;Torstai;24;17;41
622;27.04.2017;2017;04;20;Torstai;26;13;39
622;27.04.2017;2017;04;21;Torstai;18;19;37
622;27.04.2017;2017;04;22;Torstai;16;7;23
622;27.04.2017;2017;04;23;Torstai;6;7;13
622;28.04.2017;2017;04;00;Perjantai;5;7;12
622;28.04.2017;2017;04;01;Perjantai;1;0;1
622;28.04.2017;2017;04;02;Perjantai;1;0;1
622;28.04.2017;2017;04;03;Perjantai;0;1;1
622;28.04.2017;2017;04;04;Perjantai;2;3;5
622;28.04.2017;2017;04;05;Perjantai;5;1;6
622;28.04.2017;2017;04;06;Perjantai;2;6;8
622;28.04.2017;2017;04;07;Perjantai;12;30;42
622;28.04.2017;2017;04;08;Perjantai;25;42;67
622;28.04.2017;2017;04;09;Perjantai;20;42;62
622;28.04.2017;2017;04;10;Perjantai;20;34;54
622;28.04.2017;2017;04;11;Perjantai;9;14;23
622;28.04.2017;2017;04;12;Perjantai;22;31;53
622;28.04.2017;2017;04;13;Perjantai;28;35;63
622;28.04.2017;2017;04;14;Perjantai;29;31;60
622;28.04.2017;2017;04;15;Perjantai;47;47;94
622;28.04.2017;2017;04;16;Perjantai;44;32;76
622;28.04.2017;2017;04;17;Perjantai;47;36;83
622;28.04.2017;2017;04;18;Perjantai;36;25;61
622;28.04.2017;2017;04;19;Perjantai;31;36;67
622;28.04.2017;2017;04;20;Perjantai;19;20;39
622;28.04.2017;2017;04;21;Perjantai;28;24;52
622;28.04.2017;2017;04;22;Perjantai;18;12;30
622;28.04.2017;2017;04;23;Perjantai;13;7;20
622;29.04.2017;2017;04;00;Lauantai;3;5;8
622;29.04.2017;2017;04;01;Lauantai;7;3;10
622;29.04.2017;2017;04;02;Lauantai;12;2;14
622;29.04.2017;2017;04;03;Lauantai;3;1;4
622;29.04.2017;2017;04;04;Lauantai;11;0;11
622;29.04.2017;2017;04;05;Lauantai;3;1;4
622;29.04.2017;2017;04;06;Lauantai;0;0;0
622;29.04.2017;2017;04;07;Lauantai;6;4;10
622;29.04.2017;2017;04;08;Lauantai;3;2;5
622;29.04.2017;2017;04;09;Lauantai;3;8;11
622;29.04.2017;2017;04;10;Lauantai;3;15;18
622;29.04.2017;2017;04;11;Lauantai;11;23;34
622;29.04.2017;2017;04;12;Lauantai;20;25;45
622;29.04.2017;2017;04;13;Lauantai;31;34;65
622;29.04.2017;2017;04;14;Lauantai;31;28;59
622;29.04.2017;2017;04;15;Lauantai;16;27;43
622;29.04.2017;2017;04;16;Lauantai;35;23;58
622;29.04.2017;2017;04;17;Lauantai;28;23;51
622;29.04.2017;2017;04;18;Lauantai;21;19;40
622;29.04.2017;2017;04;19;Lauantai;18;16;34
622;29.04.2017;2017;04;20;Lauantai;12;14;26
622;29.04.2017;2017;04;21;Lauantai;13;9;22
622;29.04.2017;2017;04;22;Lauantai;5;8;13
622;29.04.2017;2017;04;23;Lauantai;13;4;17
622;30.04.2017;2017;04;00;Sunnuntai;9;6;15
622;30.04.2017;2017;04;01;Sunnuntai;3;3;6
622;30.04.2017;2017;04;02;Sunnuntai;5;0;5
622;30.04.2017;2017;04;03;Sunnuntai;4;1;5
622;30.04.2017;2017;04;04;Sunnuntai;2;2;4
622;30.04.2017;2017;04;05;Sunnuntai;2;0;2
622;30.04.2017;2017;04;06;Sunnuntai;0;1;1
622;30.04.2017;2017;04;07;Sunnuntai;1;2;3
622;30.04.2017;2017;04;08;Sunnuntai;2;0;2
622;30.04.2017;2017;04;09;Sunnuntai;1;4;5
622;30.04.2017;2017;04;10;Sunnuntai;4;6;10
622;30.04.2017;2017;04;11;Sunnuntai;5;8;13
622;30.04.2017;2017;04;12;Sunnuntai;11;27;38
622;30.04.2017;2017;04;13;Sunnuntai;19;28;47
622;30.04.2017;2017;04;14;Sunnuntai;19;22;41
622;30.04.2017;2017;04;15;Sunnuntai;19;17;36
622;30.04.2017;2017;04;16;Sunnuntai;21;22;43
622;30.04.2017;2017;04;17;Sunnuntai;29;18;47
622;30.04.2017;2017;04;18;Sunnuntai;11;2;13
622;30.04.2017;2017;04;19;Sunnuntai;7;8;15
622;30.04.2017;2017;04;20;Sunnuntai;11;9;20
622;30.04.2017;2017;04;21;Sunnuntai;8;7;15
622;30.04.2017;2017;04;22;Sunnuntai;7;3;10
622;30.04.2017;2017;04;23;Sunnuntai;4;0;4
622;01.05.2017;2017;05;00;Maanantai;9;6;15
622;01.05.2017;2017;05;01;Maanantai;3;3;6
622;01.05.2017;2017;05;02;Maanantai;5;0;5
622;01.05.2017;2017;05;03;Maanantai;4;1;5
622;01.05.2017;2017;05;04;Maanantai;2;2;4
622;01.05.2017;2017;05;05;Maanantai;2;0;2
622;01.05.2017;2017;05;06;Maanantai;0;1;1
622;01.05.2017;2017;05;07;Maanantai;1;2;3
622;01.05.2017;2017;05;08;Maanantai;2;0;2
622;01.05.2017;2017;05;09;Maanantai;1;4;5
622;01.05.2017;2017;05;10;Maanantai;4;6;10
622;01.05.2017;2017;05;11;Maanantai;5;8;13
622;01.05.2017;2017;05;12;Maanantai;11;27;38
622;01.05.2017;2017;05;13;Maanantai;19;28;47
622;01.05.2017;2017;05;14;Maanantai;19;22;41
622;01.05.2017;2017;05;15;Maanantai;19;17;36
622;01.05.2017;2017;05;16;Maanantai;21;22;43
622;01.05.2017;2017;05;17;Maanantai;29;18;47
622;01.05.2017;2017;05;18;Maanantai;11;2;13
622;01.05.2017;2017;05;19;Maanantai;7;8;15
622;01.05.2017;2017;05;20;Maanantai;11;9;20
622;01.05.2017;2017;05;21;Maanantai;8;7;15
622;01.05.2017;2017;05;22;Maanantai;7;3;10
622;01.05.2017;2017;05;23;Maanantai;4;0;4
622;02.05.2017;2017;05;00;Tiistai;3;3;6
622;02.05.2017;2017;05;01;Tiistai;1;0;1
622;02.05.2017;2017;05;02;Tiistai;2;1;3
622;02.05.2017;2017;05;03;Tiistai;3;0;3
622;02.05.2017;2017;05;04;Tiistai;0;0;0
622;02.05.2017;2017;05;05;Tiistai;4;1;5
622;02.05.2017;2017;05;06;Tiistai;2;7;9
622;02.05.2017;2017;05;07;Tiistai;15;43;58
622;02.05.2017;2017;05;08;Tiistai;30;59;89
622;02.05.2017;2017;05;09;Tiistai;32;51;83
622;02.05.2017;2017;05;10;Tiistai;23;33;56
622;02.05.2017;2017;05;11;Tiistai;8;20;28
622;02.05.2017;2017;05;12;Tiistai;16;26;42
622;02.05.2017;2017;05;13;Tiistai;20;31;51
622;02.05.2017;2017;05;14;Tiistai;34;34;68
622;02.05.2017;2017;05;15;Tiistai;47;37;84
622;02.05.2017;2017;05;16;Tiistai;51;47;98
622;02.05.2017;2017;05;17;Tiistai;71;40;111
622;02.05.2017;2017;05;18;Tiistai;44;33;77
622;02.05.2017;2017;05;19;Tiistai;33;27;60
622;02.05.2017;2017;05;20;Tiistai;26;24;50
622;02.05.2017;2017;05;21;Tiistai;31;9;40
622;02.05.2017;2017;05;22;Tiistai;19;8;27
622;02.05.2017;2017;05;23;Tiistai;6;3;9
622;03.05.2017;2017;05;00;Keskiviikko;4;2;6
622;03.05.2017;2017;05;01;Keskiviikko;2;0;2
622;03.05.2017;2017;05;02;Keskiviikko;1;2;3
622;03.05.2017;2017;05;03;Keskiviikko;1;0;1
622;03.05.2017;2017;05;04;Keskiviikko;1;1;2
622;03.05.2017;2017;05;05;Keskiviikko;0;1;1
622;03.05.2017;2017;05;06;Keskiviikko;1;5;6
622;03.05.2017;2017;05;07;Keskiviikko;10;25;35
622;03.05.2017;2017;05;08;Keskiviikko;18;41;59
622;03.05.2017;2017;05;09;Keskiviikko;29;39;68
622;03.05.2017;2017;05;10;Keskiviikko;16;12;28
622;03.05.2017;2017;05;11;Keskiviikko;4;8;12
622;03.05.2017;2017;05;12;Keskiviikko;5;3;8
622;03.05.2017;2017;05;13;Keskiviikko;7;11;18
622;03.05.2017;2017;05;14;Keskiviikko;11;20;31
622;03.05.2017;2017;05;15;Keskiviikko;14;24;38
622;03.05.2017;2017;05;16;Keskiviikko;28;20;48
622;03.05.2017;2017;05;17;Keskiviikko;45;27;72
622;03.05.2017;2017;05;18;Keskiviikko;19;18;37
622;03.05.2017;2017;05;19;Keskiviikko;16;7;23
622;03.05.2017;2017;05;20;Keskiviikko;12;7;19
622;03.05.2017;2017;05;21;Keskiviikko;7;8;15
622;03.05.2017;2017;05;22;Keskiviikko;10;5;15
622;03.05.2017;2017;05;23;Keskiviikko;3;4;7
622;04.05.2017;2017;05;00;Torstai;11;1;12
622;04.05.2017;2017;05;01;Torstai;0;4;4
622;04.05.2017;2017;05;02;Torstai;3;2;5
622;04.05.2017;2017;05;03;Torstai;0;0;0
622;04.05.2017;2017;05;04;Torstai;0;0;0
622;04.05.2017;2017;05;05;Torstai;2;2;4
622;04.05.2017;2017;05;06;Torstai;3;13;16
622;04.05.2017;2017;05;07;Torstai;11;40;51
622;04.05.2017;2017;05;08;Torstai;33;73;106
622;04.05.2017;2017;05;09;Torstai;23;58;81
622;04.05.2017;2017;05;10;Torstai;26;39;65
622;04.05.2017;2017;05;11;Torstai;21;30;51
622;04.05.2017;2017;05;12;Torstai;29;25;54
622;04.05.2017;2017;05;13;Torstai;32;40;72
622;04.05.2017;2017;05;14;Torstai;28;40;68
622;04.05.2017;2017;05;15;Torstai;51;36;87
622;04.05.2017;2017;05;16;Torstai;73;43;116
622;04.05.2017;2017;05;17;Torstai;75;50;125
622;04.05.2017;2017;05;18;Torstai;64;28;92
622;04.05.2017;2017;05;19;Torstai;47;40;87
622;04.05.2017;2017;05;20;Torstai;28;13;41
622;04.05.2017;2017;05;21;Torstai;39;17;56
622;04.05.2017;2017;05;22;Torstai;23;5;28
622;04.05.2017;2017;05;23;Torstai;17;2;19
622;05.05.2017;2017;05;00;Perjantai;11;1;12
622;05.05.2017;2017;05;01;Perjantai;0;4;4
622;05.05.2017;2017;05;02;Perjantai;3;2;5
622;05.05.2017;2017;05;03;Perjantai;0;0;0
622;05.05.2017;2017;05;04;Perjantai;0;0;0
622;05.05.2017;2017;05;05;Perjantai;2;2;4
622;05.05.2017;2017;05;06;Perjantai;3;13;16
622;05.05.2017;2017;05;07;Perjantai;11;40;51
622;05.05.2017;2017;05;08;Perjantai;33;63;96
622;05.05.2017;2017;05;09;Perjantai;23;38;61
622;05.05.2017;2017;05;10;Perjantai;26;39;65
622;05.05.2017;2017;05;11;Perjantai;12;24;36
622;05.05.2017;2017;05;12;Perjantai;30;49;79
622;05.05.2017;2017;05;13;Perjantai;28;36;64
622;05.05.2017;2017;05;14;Perjantai;37;63;100
622;05.05.2017;2017;05;15;Perjantai;84;64;148
622;05.05.2017;2017;05;16;Perjantai;76;48;124
622;05.05.2017;2017;05;17;Perjantai;85;54;139
622;05.05.2017;2017;05;18;Perjantai;44;51;95
622;05.05.2017;2017;05;19;Perjantai;43;27;70
622;05.05.2017;2017;05;20;Perjantai;41;28;69
622;05.05.2017;2017;05;21;Perjantai;31;19;50
622;05.05.2017;2017;05;22;Perjantai;16;10;26
622;05.05.2017;2017;05;23;Perjantai;17;9;26
622;06.05.2017;2017;05;00;Lauantai;12;3;15
622;06.05.2017;2017;05;01;Lauantai;11;6;17
622;06.05.2017;2017;05;02;Lauantai;7;1;8
622;06.05.2017;2017;05;03;Lauantai;3;4;7
622;06.05.2017;2017;05;04;Lauantai;2;1;3
622;06.05.2017;2017;05;05;Lauantai;2;1;3
622;06.05.2017;2017;05;06;Lauantai;4;6;10
622;06.05.2017;2017;05;07;Lauantai;2;1;3
622;06.05.2017;2017;05;08;Lauantai;3;7;10
622;06.05.2017;2017;05;09;Lauantai;4;7;11
622;06.05.2017;2017;05;10;Lauantai;9;25;34
622;06.05.2017;2017;05;11;Lauantai;18;25;43
622;06.05.2017;2017;05;12;Lauantai;25;25;50
622;06.05.2017;2017;05;13;Lauantai;29;37;66
622;06.05.2017;2017;05;14;Lauantai;30;39;69
622;06.05.2017;2017;05;15;Lauantai;27;39;66
622;06.05.2017;2017;05;16;Lauantai;31;25;56
622;06.05.2017;2017;05;17;Lauantai;30;20;50
622;06.05.2017;2017;05;18;Lauantai;28;24;52
622;06.05.2017;2017;05;19;Lauantai;37;27;64
622;06.05.2017;2017;05;20;Lauantai;34;22;56
622;06.05.2017;2017;05;21;Lauantai;15;12;27
622;06.05.2017;2017;05;22;Lauantai;16;9;25
622;06.05.2017;2017;05;23;Lauantai;8;5;13
622;07.05.2017;2017;05;00;Sunnuntai;8;6;14
622;07.05.2017;2017;05;01;Sunnuntai;3;1;4
622;07.05.2017;2017;05;02;Sunnuntai;4;3;7
622;07.05.2017;2017;05;03;Sunnuntai;3;1;4
622;07.05.2017;2017;05;04;Sunnuntai;3;2;5
622;07.05.2017;2017;05;05;Sunnuntai;2;1;3
622;07.05.2017;2017;05;06;Sunnuntai;2;3;5
622;07.05.2017;2017;05;07;Sunnuntai;0;4;4
622;07.05.2017;2017;05;08;Sunnuntai;4;4;8
622;07.05.2017;2017;05;09;Sunnuntai;6;10;16
622;07.05.2017;2017;05;10;Sunnuntai;8;8;16
622;07.05.2017;2017;05;11;Sunnuntai;13;22;35
622;07.05.2017;2017;05;12;Sunnuntai;24;19;43
622;07.05.2017;2017;05;13;Sunnuntai;28;50;78
622;07.05.2017;2017;05;14;Sunnuntai;39;59;98
622;07.05.2017;2017;05;15;Sunnuntai;50;54;104
622;07.05.2017;2017;05;16;Sunnuntai;39;40;79
622;07.05.2017;2017;05;17;Sunnuntai;50;28;78
622;07.05.2017;2017;05;18;Sunnuntai;35;31;66
622;07.05.2017;2017;05;19;Sunnuntai;37;23;60
622;07.05.2017;2017;05;20;Sunnuntai;17;19;36
622;07.05.2017;2017;05;21;Sunnuntai;14;11;25
622;07.05.2017;2017;05;22;Sunnuntai;14;8;22
622;07.05.2017;2017;05;23;Sunnuntai;6;5;11
622;08.05.2017;2017;05;00;Maanantai;4;2;6
622;08.05.2017;2017;05;01;Maanantai;0;0;0
622;08.05.2017;2017;05;02;Maanantai;0;0;0
622;08.05.2017;2017;05;03;Maanantai;0;1;1
622;08.05.2017;2017;05;04;Maanantai;0;2;2
622;08.05.2017;2017;05;05;Maanantai;2;3;5
622;08.05.2017;2017;05;06;Maanantai;2;10;12
622;08.05.2017;2017;05;07;Maanantai;11;47;58
622;08.05.2017;2017;05;08;Maanantai;37;56;93
622;08.05.2017;2017;05;09;Maanantai;36;45;81
622;08.05.2017;2017;05;10;Maanantai;8;31;39
622;08.05.2017;2017;05;11;Maanantai;8;16;24
622;08.05.2017;2017;05;12;Maanantai;13;23;36
622;08.05.2017;2017;05;13;Maanantai;20;23;43
622;08.05.2017;2017;05;14;Maanantai;20;34;54
622;08.05.2017;2017;05;15;Maanantai;23;50;73
622;08.05.2017;2017;05;16;Maanantai;74;45;119
622;08.05.2017;2017;05;17;Maanantai;72;34;106
622;08.05.2017;2017;05;18;Maanantai;47;39;86
622;08.05.2017;2017;05;19;Maanantai;33;32;65
622;08.05.2017;2017;05;20;Maanantai;33;18;51
622;08.05.2017;2017;05;21;Maanantai;19;14;33
622;08.05.2017;2017;05;22;Maanantai;15;13;28
622;08.05.2017;2017;05;23;Maanantai;14;3;17
622;09.05.2017;2017;05;00;Tiistai;5;1;6
622;09.05.2017;2017;05;01;Tiistai;3;1;4
622;09.05.2017;2017;05;02;Tiistai;1;0;1
622;09.05.2017;2017;05;03;Tiistai;0;0;0
622;09.05.2017;2017;05;04;Tiistai;0;0;0
622;09.05.2017;2017;05;05;Tiistai;1;0;1
622;09.05.2017;2017;05;06;Tiistai;5;10;15
622;09.05.2017;2017;05;07;Tiistai;19;45;64
622;09.05.2017;2017;05;08;Tiistai;32;65;97
622;09.05.2017;2017;05;09;Tiistai;37;37;74
622;09.05.2017;2017;05;10;Tiistai;19;33;52
622;09.05.2017;2017;05;11;Tiistai;14;19;33
622;09.05.2017;2017;05;12;Tiistai;22;25;47
622;09.05.2017;2017;05;13;Tiistai;19;27;46
622;09.05.2017;2017;05;14;Tiistai;24;25;49
622;09.05.2017;2017;05;15;Tiistai;45;40;85
622;09.05.2017;2017;05;16;Tiistai;51;51;102
622;09.05.2017;2017;05;17;Tiistai;80;46;126
622;09.05.2017;2017;05;18;Tiistai;43;36;79
622;09.05.2017;2017;05;19;Tiistai;36;16;52
622;09.05.2017;2017;05;20;Tiistai;34;19;53
622;09.05.2017;2017;05;21;Tiistai;23;22;45
622;09.05.2017;2017;05;22;Tiistai;16;17;33
622;09.05.2017;2017;05;23;Tiistai;10;3;13
622;10.05.2017;2017;05;00;Keskiviikko;7;2;9
622;10.05.2017;2017;05;01;Keskiviikko;2;1;3
622;10.05.2017;2017;05;02;Keskiviikko;2;0;2
622;10.05.2017;2017;05;03;Keskiviikko;0;2;2
622;10.05.2017;2017;05;04;Keskiviikko;0;1;1
622;10.05.2017;2017;05;05;Keskiviikko;1;0;1
622;10.05.2017;2017;05;06;Keskiviikko;3;11;14
622;10.05.2017;2017;05;07;Keskiviikko;15;48;63
622;10.05.2017;2017;05;08;Keskiviikko;27;57;84
622;10.05.2017;2017;05;09;Keskiviikko;39;55;94
622;10.05.2017;2017;05;10;Keskiviikko;27;41;68
622;10.05.2017;2017;05;11;Keskiviikko;25;32;57
622;10.05.2017;2017;05;12;Keskiviikko;25;22;47
622;10.05.2017;2017;05;13;Keskiviikko;27;33;60
622;10.05.2017;2017;05;14;Keskiviikko;32;39;71
622;10.05.2017;2017;05;15;Keskiviikko;37;29;66
622;10.05.2017;2017;05;16;Keskiviikko;80;58;138
622;10.05.2017;2017;05;17;Keskiviikko;76;31;107
622;10.05.2017;2017;05;18;Keskiviikko;45;27;72
622;10.05.2017;2017;05;19;Keskiviikko;35;14;49
622;10.05.2017;2017;05;20;Keskiviikko;18;14;32
622;10.05.2017;2017;05;21;Keskiviikko;19;11;30
622;10.05.2017;2017;05;22;Keskiviikko;11;8;19
622;10.05.2017;2017;05;23;Keskiviikko;6;5;11
622;11.05.2017;2017;05;00;Torstai;8;2;10
622;11.05.2017;2017;05;01;Torstai;2;0;2
622;11.05.2017;2017;05;02;Torstai;1;2;3
622;11.05.2017;2017;05;03;Torstai;2;0;2
622;11.05.2017;2017;05;04;Torstai;0;2;2
622;11.05.2017;2017;05;05;Torstai;4;0;4
622;11.05.2017;2017;05;06;Torstai;2;11;13
622;11.05.2017;2017;05;07;Torstai;16;38;54
622;11.05.2017;2017;05;08;Torstai;27;56;83
622;11.05.2017;2017;05;09;Torstai;32;44;76
622;11.05.2017;2017;05;10;Torstai;16;33;49
622;11.05.2017;2017;05;11;Torstai;18;22;40
622;11.05.2017;2017;05;12;Torstai;16;17;33
622;11.05.2017;2017;05;13;Torstai;17;39;56
622;11.05.2017;2017;05;14;Torstai;34;28;62
622;11.05.2017;2017;05;15;Torstai;36;37;73
622;11.05.2017;2017;05;16;Torstai;39;34;73
622;11.05.2017;2017;05;17;Torstai;67;45;112
622;11.05.2017;2017;05;18;Torstai;44;34;78
622;11.05.2017;2017;05;19;Torstai;40;19;59
622;11.05.2017;2017;05;20;Torstai;19;21;40
622;11.05.2017;2017;05;21;Torstai;23;19;42
622;11.05.2017;2017;05;22;Torstai;22;6;28
622;11.05.2017;2017;05;23;Torstai;10;8;18
622;12.05.2017;2017;05;00;Perjantai;5;2;7
622;12.05.2017;2017;05;01;Perjantai;4;1;5
622;12.05.2017;2017;05;02;Perjantai;0;2;2
622;12.05.2017;2017;05;03;Perjantai;0;0;0
622;12.05.2017;2017;05;04;Perjantai;0;1;1
622;12.05.2017;2017;05;05;Perjantai;2;1;3
622;12.05.2017;2017;05;06;Perjantai;3;9;12
622;12.05.2017;2017;05;07;Perjantai;10;40;50
622;12.05.2017;2017;05;08;Perjantai;41;61;102
622;12.05.2017;2017;05;09;Perjantai;34;37;71
622;12.05.2017;2017;05;10;Perjantai;16;36;52
622;12.05.2017;2017;05;11;Perjantai;20;34;54
622;12.05.2017;2017;05;12;Perjantai;29;36;65
622;12.05.2017;2017;05;13;Perjantai;31;26;57
622;12.05.2017;2017;05;14;Perjantai;26;41;67
622;12.05.2017;2017;05;15;Perjantai;59;34;93
622;12.05.2017;2017;05;16;Perjantai;57;53;110
622;12.05.2017;2017;05;17;Perjantai;51;39;90
622;12.05.2017;2017;05;18;Perjantai;44;33;77
622;12.05.2017;2017;05;19;Perjantai;34;22;56
622;12.05.2017;2017;05;20;Perjantai;25;22;47
622;12.05.2017;2017;05;21;Perjantai;21;12;33
622;12.05.2017;2017;05;22;Perjantai;21;14;35
622;12.05.2017;2017;05;23;Perjantai;9;4;13
622;13.05.2017;2017;05;00;Lauantai;13;5;18
622;13.05.2017;2017;05;01;Lauantai;10;5;15
622;13.05.2017;2017;05;02;Lauantai;4;1;5
622;13.05.2017;2017;05;03;Lauantai;3;1;4
622;13.05.2017;2017;05;04;Lauantai;0;4;4
622;13.05.2017;2017;05;05;Lauantai;3;3;6
622;13.05.2017;2017;05;06;Lauantai;3;2;5
622;13.05.2017;2017;05;07;Lauantai;4;9;13
622;13.05.2017;2017;05;08;Lauantai;3;2;5
622;13.05.2017;2017;05;09;Lauantai;3;5;8
622;13.05.2017;2017;05;10;Lauantai;13;24;37
622;13.05.2017;2017;05;11;Lauantai;19;25;44
622;13.05.2017;2017;05;12;Lauantai;20;33;53
622;13.05.2017;2017;05;13;Lauantai;29;40;69
622;13.05.2017;2017;05;14;Lauantai;35;32;67
622;13.05.2017;2017;05;15;Lauantai;38;32;70
622;13.05.2017;2017;05;16;Lauantai;21;23;44
622;13.05.2017;2017;05;17;Lauantai;35;28;63
622;13.05.2017;2017;05;18;Lauantai;26;41;67
622;13.05.2017;2017;05;19;Lauantai;18;23;41
622;13.05.2017;2017;05;20;Lauantai;40;23;63
622;13.05.2017;2017;05;21;Lauantai;24;23;47
622;13.05.2017;2017;05;22;Lauantai;17;11;28
622;13.05.2017;2017;05;23;Lauantai;12;5;17
622;14.05.2017;2017;05;00;Sunnuntai;11;4;15
622;14.05.2017;2017;05;01;Sunnuntai;4;3;7
622;14.05.2017;2017;05;02;Sunnuntai;6;3;9
622;14.05.2017;2017;05;03;Sunnuntai;2;0;2
622;14.05.2017;2017;05;04;Sunnuntai;3;2;5
622;14.05.2017;2017;05;05;Sunnuntai;1;2;3
622;14.05.2017;2017;05;06;Sunnuntai;2;2;4
622;14.05.2017;2017;05;07;Sunnuntai;4;3;7
622;14.05.2017;2017;05;08;Sunnuntai;1;4;5
622;14.05.2017;2017;05;09;Sunnuntai;1;2;3
622;14.05.2017;2017;05;10;Sunnuntai;3;5;8
622;14.05.2017;2017;05;11;Sunnuntai;3;6;9
622;14.05.2017;2017;05;12;Sunnuntai;5;11;16
622;14.05.2017;2017;05;13;Sunnuntai;6;12;18
622;14.05.2017;2017;05;14;Sunnuntai;5;3;8
622;14.05.2017;2017;05;15;Sunnuntai;10;8;18
622;14.05.2017;2017;05;16;Sunnuntai;10;7;17
622;14.05.2017;2017;05;17;Sunnuntai;9;13;22
622;14.05.2017;2017;05;18;Sunnuntai;6;8;14
622;14.05.2017;2017;05;19;Sunnuntai;11;9;20
622;14.05.2017;2017;05;20;Sunnuntai;8;9;17
622;14.05.2017;2017;05;21;Sunnuntai;9;8;17
622;14.05.2017;2017;05;22;Sunnuntai;7;4;11
622;14.05.2017;2017;05;23;Sunnuntai;0;4;4
622;15.05.2017;2017;05;00;Maanantai;2;0;2
622;15.05.2017;2017;05;01;Maanantai;0;1;1
622;15.05.2017;2017;05;02;Maanantai;1;0;1
622;15.05.2017;2017;05;03;Maanantai;0;1;1
622;15.05.2017;2017;05;04;Maanantai;0;2;2
622;15.05.2017;2017;05;05;Maanantai;1;1;2
622;15.05.2017;2017;05;06;Maanantai;4;11;15
622;15.05.2017;2017;05;07;Maanantai;18;43;61
622;15.05.2017;2017;05;08;Maanantai;26;60;86
622;15.05.2017;2017;05;09;Maanantai;36;55;91
622;15.05.2017;2017;05;10;Maanantai;20;36;56
622;15.05.2017;2017;05;11;Maanantai;18;24;42
622;15.05.2017;2017;05;12;Maanantai;18;21;39
622;15.05.2017;2017;05;13;Maanantai;22;30;52
622;15.05.2017;2017;05;14;Maanantai;29;45;74
622;15.05.2017;2017;05;15;Maanantai;49;49;98
622;15.05.2017;2017;05;16;Maanantai;70;44;114
622;15.05.2017;2017;05;17;Maanantai;95;59;154
622;15.05.2017;2017;05;18;Maanantai;51;57;108
622;15.05.2017;2017;05;19;Maanantai;36;35;71
622;15.05.2017;2017;05;20;Maanantai;40;22;62
622;15.05.2017;2017;05;21;Maanantai;32;14;46
622;15.05.2017;2017;05;22;Maanantai;19;5;24
622;15.05.2017;2017;05;23;Maanantai;8;2;10
622;16.05.2017;2017;05;00;Tiistai;9;1;10
622;16.05.2017;2017;05;01;Tiistai;3;1;4
622;16.05.2017;2017;05;02;Tiistai;1;0;1
622;16.05.2017;2017;05;03;Tiistai;0;2;2
622;16.05.2017;2017;05;04;Tiistai;0;0;0
622;16.05.2017;2017;05;05;Tiistai;1;2;3
622;16.05.2017;2017;05;06;Tiistai;3;11;14
622;16.05.2017;2017;05;07;Tiistai;15;55;70
622;16.05.2017;2017;05;08;Tiistai;47;79;126
622;16.05.2017;2017;05;09;Tiistai;31;56;87
622;16.05.2017;2017;05;10;Tiistai;15;37;52
622;16.05.2017;2017;05;11;Tiistai;13;26;39
622;16.05.2017;2017;05;12;Tiistai;24;28;52
622;16.05.2017;2017;05;13;Tiistai;26;44;70
622;16.05.2017;2017;05;14;Tiistai;34;33;67
622;16.05.2017;2017;05;15;Tiistai;52;40;92
622;16.05.2017;2017;05;16;Tiistai;79;43;122
622;16.05.2017;2017;05;17;Tiistai;83;47;130
622;16.05.2017;2017;05;18;Tiistai;61;56;117
622;16.05.2017;2017;05;19;Tiistai;46;27;73
622;16.05.2017;2017;05;20;Tiistai;52;21;73
622;16.05.2017;2017;05;21;Tiistai;28;25;53
622;16.05.2017;2017;05;22;Tiistai;26;10;36
622;16.05.2017;2017;05;23;Tiistai;7;3;10
622;17.05.2017;2017;05;00;Keskiviikko;3;0;3
622;17.05.2017;2017;05;01;Keskiviikko;3;1;4
622;17.05.2017;2017;05;02;Keskiviikko;1;0;1
622;17.05.2017;2017;05;03;Keskiviikko;1;1;2
622;17.05.2017;2017;05;04;Keskiviikko;1;0;1
622;17.05.2017;2017;05;05;Keskiviikko;0;0;0
622;17.05.2017;2017;05;06;Keskiviikko;4;12;16
622;17.05.2017;2017;05;07;Keskiviikko;13;38;51
622;17.05.2017;2017;05;08;Keskiviikko;23;51;74
622;17.05.2017;2017;05;09;Keskiviikko;32;37;69
622;17.05.2017;2017;05;10;Keskiviikko;15;35;50
622;17.05.2017;2017;05;11;Keskiviikko;7;17;24
622;17.05.2017;2017;05;12;Keskiviikko;13;12;25
622;17.05.2017;2017;05;13;Keskiviikko;15;16;31
622;17.05.2017;2017;05;14;Keskiviikko;15;24;39
622;17.05.2017;2017;05;15;Keskiviikko;35;28;63
622;17.05.2017;2017;05;16;Keskiviikko;44;19;63
622;17.05.2017;2017;05;17;Keskiviikko;48;23;71
622;17.05.2017;2017;05;18;Keskiviikko;28;25;53
622;17.05.2017;2017;05;19;Keskiviikko;29;21;50
622;17.05.2017;2017;05;20;Keskiviikko;16;7;23
622;17.05.2017;2017;05;21;Keskiviikko;14;7;21
622;17.05.2017;2017;05;22;Keskiviikko;7;6;13
622;17.05.2017;2017;05;23;Keskiviikko;5;3;8
622;18.05.2017;2017;05;00;Torstai;2;1;3
622;18.05.2017;2017;05;01;Torstai;0;0;0
622;18.05.2017;2017;05;02;Torstai;0;0;0
622;18.05.2017;2017;05;03;Torstai;1;0;1
622;18.05.2017;2017;05;04;Torstai;0;1;1
622;18.05.2017;2017;05;05;Torstai;2;2;4
622;18.05.2017;2017;05;06;Torstai;4;9;13
622;18.05.2017;2017;05;07;Torstai;6;42;48
622;18.05.2017;2017;05;08;Torstai;35;51;86
622;18.05.2017;2017;05;09;Torstai;29;53;82
622;18.05.2017;2017;05;10;Torstai;12;28;40
622;18.05.2017;2017;05;11;Torstai;12;23;35
622;18.05.2017;2017;05;12;Torstai;24;21;45
622;18.05.2017;2017;05;13;Torstai;19;27;46
622;18.05.2017;2017;05;14;Torstai;22;30;52
622;18.05.2017;2017;05;15;Torstai;42;23;65
622;18.05.2017;2017;05;16;Torstai;63;38;101
622;18.05.2017;2017;05;17;Torstai;87;45;132
622;18.05.2017;2017;05;18;Torstai;58;40;98
622;18.05.2017;2017;05;19;Torstai;24;29;53
622;18.05.2017;2017;05;20;Torstai;24;13;37
622;18.05.2017;2017;05;21;Torstai;25;14;39
622;18.05.2017;2017;05;22;Torstai;16;9;25
622;18.05.2017;2017;05;23;Torstai;7;5;12
622;19.05.2017;2017;05;00;Perjantai;3;2;5
622;19.05.2017;2017;05;01;Perjantai;1;1;2
622;19.05.2017;2017;05;02;Perjantai;1;1;2
622;19.05.2017;2017;05;03;Perjantai;1;2;3
622;19.05.2017;2017;05;04;Perjantai;0;0;0
622;19.05.2017;2017;05;05;Perjantai;1;0;1
622;19.05.2017;2017;05;06;Perjantai;1;6;7
622;19.05.2017;2017;05;07;Perjantai;7;16;23
622;19.05.2017;2017;05;08;Perjantai;11;26;37
622;19.05.2017;2017;05;09;Perjantai;12;14;26
622;19.05.2017;2017;05;10;Perjantai;11;16;27
622;19.05.2017;2017;05;11;Perjantai;5;12;17
622;19.05.2017;2017;05;12;Perjantai;19;18;37
622;19.05.2017;2017;05;13;Perjantai;12;14;26
622;19.05.2017;2017;05;14;Perjantai;23;24;47
622;19.05.2017;2017;05;15;Perjantai;31;22;53
622;19.05.2017;2017;05;16;Perjantai;35;27;62
622;19.05.2017;2017;05;17;Perjantai;27;24;51
622;19.05.2017;2017;05;18;Perjantai;26;25;51
622;19.05.2017;2017;05;19;Perjantai;23;18;41
622;19.05.2017;2017;05;20;Perjantai;22;11;33
622;19.05.2017;2017;05;21;Perjantai;12;9;21
622;19.05.2017;2017;05;22;Perjantai;20;4;24
622;19.05.2017;2017;05;23;Perjantai;8;2;10
622;20.05.2017;2017;05;00;Lauantai;3;3;6
622;20.05.2017;2017;05;01;Lauantai;5;2;7
622;20.05.2017;2017;05;02;Lauantai;2;2;4
622;20.05.2017;2017;05;03;Lauantai;2;2;4
622;20.05.2017;2017;05;04;Lauantai;1;0;1
622;20.05.2017;2017;05;05;Lauantai;4;3;7
622;20.05.2017;2017;05;06;Lauantai;2;0;2
622;20.05.2017;2017;05;07;Lauantai;8;11;19
622;20.05.2017;2017;05;08;Lauantai;3;2;5
622;20.05.2017;2017;05;09;Lauantai;3;15;18
622;20.05.2017;2017;05;10;Lauantai;12;34;46
622;20.05.2017;2017;05;11;Lauantai;16;40;56
622;20.05.2017;2017;05;12;Lauantai;29;57;86
622;20.05.2017;2017;05;13;Lauantai;32;50;82
622;20.05.2017;2017;05;14;Lauantai;51;64;115
622;20.05.2017;2017;05;15;Lauantai;67;52;119
622;20.05.2017;2017;05;16;Lauantai;47;41;88
622;20.05.2017;2017;05;17;Lauantai;45;33;78
622;20.05.2017;2017;05;18;Lauantai;43;48;91
622;20.05.2017;2017;05;19;Lauantai;36;14;50
622;20.05.2017;2017;05;20;Lauantai;22;31;53
622;20.05.2017;2017;05;21;Lauantai;30;18;48
622;20.05.2017;2017;05;22;Lauantai;13;9;22
622;20.05.2017;2017;05;23;Lauantai;12;6;18
622;21.05.2017;2017;05;00;Sunnuntai;4;12;16
622;21.05.2017;2017;05;01;Sunnuntai;8;6;14
622;21.05.2017;2017;05;02;Sunnuntai;13;4;17
622;21.05.2017;2017;05;03;Sunnuntai;2;0;2
622;21.05.2017;2017;05;04;Sunnuntai;4;1;5
622;21.05.2017;2017;05;05;Sunnuntai;1;0;1
622;21.05.2017;2017;05;06;Sunnuntai;2;1;3
622;21.05.2017;2017;05;07;Sunnuntai;1;3;4
622;21.05.2017;2017;05;08;Sunnuntai;4;2;6
622;21.05.2017;2017;05;09;Sunnuntai;2;5;7
622;21.05.2017;2017;05;10;Sunnuntai;12;10;22
622;21.05.2017;2017;05;11;Sunnuntai;5;9;14
622;21.05.2017;2017;05;12;Sunnuntai;21;28;49
622;21.05.2017;2017;05;13;Sunnuntai;29;42;71
622;21.05.2017;2017;05;14;Sunnuntai;34;32;66
622;21.05.2017;2017;05;15;Sunnuntai;62;56;118
622;21.05.2017;2017;05;16;Sunnuntai;52;52;104
622;21.05.2017;2017;05;17;Sunnuntai;32;40;72
622;21.05.2017;2017;05;18;Sunnuntai;44;41;85
622;21.05.2017;2017;05;19;Sunnuntai;43;30;73
622;21.05.2017;2017;05;20;Sunnuntai;35;22;57
622;21.05.2017;2017;05;21;Sunnuntai;24;20;44
622;21.05.2017;2017;05;22;Sunnuntai;14;13;27
622;21.05.2017;2017;05;23;Sunnuntai;9;5;14
622;22.05.2017;2017;05;00;Maanantai;1;3;4
622;22.05.2017;2017;05;01;Maanantai;3;2;5
622;22.05.2017;2017;05;02;Maanantai;2;2;4
622;22.05.2017;2017;05;03;Maanantai;0;1;1
622;22.05.2017;2017;05;04;Maanantai;1;0;1
622;22.05.2017;2017;05;05;Maanantai;0;2;2
622;22.05.2017;2017;05;06;Maanantai;1;8;9
622;22.05.2017;2017;05;07;Maanantai;18;58;76
622;22.05.2017;2017;05;08;Maanantai;43;73;116
622;22.05.2017;2017;05;09;Maanantai;35;74;109
622;22.05.2017;2017;05;10;Maanantai;28;47;75
622;22.05.2017;2017;05;11;Maanantai;12;31;43
622;22.05.2017;2017;05;12;Maanantai;29;28;57
622;22.05.2017;2017;05;13;Maanantai;28;48;76
622;22.05.2017;2017;05;14;Maanantai;33;31;64
622;22.05.2017;2017;05;15;Maanantai;56;45;101
622;22.05.2017;2017;05;16;Maanantai;99;58;157
622;22.05.2017;2017;05;17;Maanantai;131;61;192
622;22.05.2017;2017;05;18;Maanantai;66;53;119
622;22.05.2017;2017;05;19;Maanantai;74;68;142
622;22.05.2017;2017;05;20;Maanantai;44;31;75
622;22.05.2017;2017;05;21;Maanantai;32;22;54
622;22.05.2017;2017;05;22;Maanantai;25;7;32
622;22.05.2017;2017;05;23;Maanantai;15;12;27
622;23.05.2017;2017;05;00;Tiistai;4;2;6
622;23.05.2017;2017;05;01;Tiistai;1;1;2
622;23.05.2017;2017;05;02;Tiistai;2;1;3
622;23.05.2017;2017;05;03;Tiistai;0;0;0
622;23.05.2017;2017;05;04;Tiistai;0;0;0
622;23.05.2017;2017;05;05;Tiistai;1;1;2
622;23.05.2017;2017;05;06;Tiistai;2;11;13
622;23.05.2017;2017;05;07;Tiistai;13;61;74
622;23.05.2017;2017;05;08;Tiistai;44;82;126
622;23.05.2017;2017;05;09;Tiistai;34;72;106
622;23.05.2017;2017;05;10;Tiistai;18;49;67
622;23.05.2017;2017;05;11;Tiistai;18;20;38
622;23.05.2017;2017;05;12;Tiistai;34;22;56
622;23.05.2017;2017;05;13;Tiistai;34;35;69
622;23.05.2017;2017;05;14;Tiistai;29;31;60
622;23.05.2017;2017;05;15;Tiistai;72;29;101
622;23.05.2017;2017;05;16;Tiistai;77;51;128
622;23.05.2017;2017;05;17;Tiistai;99;81;180
622;23.05.2017;2017;05;18;Tiistai;70;55;125
622;23.05.2017;2017;05;19;Tiistai;58;39;97
622;23.05.2017;2017;05;20;Tiistai;53;31;84
622;23.05.2017;2017;05;21;Tiistai;39;23;62
622;23.05.2017;2017;05;22;Tiistai;18;9;27
622;23.05.2017;2017;05;23;Tiistai;16;11;27
622;24.05.2017;2017;05;00;Keskiviikko;7;2;9
622;24.05.2017;2017;05;01;Keskiviikko;6;1;7
622;24.05.2017;2017;05;02;Keskiviikko;1;1;2
622;24.05.2017;2017;05;03;Keskiviikko;0;0;0
622;24.05.2017;2017;05;04;Keskiviikko;1;1;2
622;24.05.2017;2017;05;05;Keskiviikko;0;2;2
622;24.05.2017;2017;05;06;Keskiviikko;4;11;15
622;24.05.2017;2017;05;07;Keskiviikko;10;51;61
622;24.05.2017;2017;05;08;Keskiviikko;36;72;108
622;24.05.2017;2017;05;09;Keskiviikko;44;46;90
622;24.05.2017;2017;05;10;Keskiviikko;18;45;63
622;24.05.2017;2017;05;11;Keskiviikko;27;38;65
622;24.05.2017;2017;05;12;Keskiviikko;20;20;40
622;24.05.2017;2017;05;13;Keskiviikko;24;32;56
622;24.05.2017;2017;05;14;Keskiviikko;48;64;112
622;24.05.2017;2017;05;15;Keskiviikko;58;79;137
622;24.05.2017;2017;05;16;Keskiviikko;87;61;148
622;24.05.2017;2017;05;17;Keskiviikko;93;56;149
622;24.05.2017;2017;05;18;Keskiviikko;69;74;143
622;24.05.2017;2017;05;19;Keskiviikko;64;49;113
622;24.05.2017;2017;05;20;Keskiviikko;40;40;80
622;24.05.2017;2017;05;21;Keskiviikko;50;26;76
622;24.05.2017;2017;05;22;Keskiviikko;34;13;47
622;24.05.2017;2017;05;23;Keskiviikko;30;12;42
622;25.05.2017;2017;05;00;Torstai;16;5;21
622;25.05.2017;2017;05;01;Torstai;11;4;15
622;25.05.2017;2017;05;02;Torstai;3;2;5
622;25.05.2017;2017;05;03;Torstai;3;1;4
622;25.05.2017;2017;05;04;Torstai;5;3;8
622;25.05.2017;2017;05;05;Torstai;2;1;3
622;25.05.2017;2017;05;06;Torstai;5;2;7
622;25.05.2017;2017;05;07;Torstai;1;10;11
622;25.05.2017;2017;05;08;Torstai;6;15;21
622;25.05.2017;2017;05;09;Torstai;6;10;16
622;25.05.2017;2017;05;10;Torstai;5;15;20
622;25.05.2017;2017;05;11;Torstai;20;25;45
622;25.05.2017;2017;05;12;Torstai;23;26;49
622;25.05.2017;2017;05;13;Torstai;25;43;68
622;25.05.2017;2017;05;14;Torstai;29;31;60
622;25.05.2017;2017;05;15;Torstai;46;24;70
622;25.05.2017;2017;05;16;Torstai;37;44;81
622;25.05.2017;2017;05;17;Torstai;56;52;108
622;25.05.2017;2017;05;18;Torstai;60;27;87
622;25.05.2017;2017;05;19;Torstai;41;43;84
622;25.05.2017;2017;05;20;Torstai;47;33;80
622;25.05.2017;2017;05;21;Torstai;35;20;55
622;25.05.2017;2017;05;22;Torstai;23;11;34
622;25.05.2017;2017;05;23;Torstai;6;2;8
622;26.05.2017;2017;05;00;Perjantai;7;3;10
622;26.05.2017;2017;05;01;Perjantai;3;2;5
622;26.05.2017;2017;05;02;Perjantai;0;0;0
622;26.05.2017;2017;05;03;Perjantai;4;1;5
622;26.05.2017;2017;05;04;Perjantai;0;1;1
622;26.05.2017;2017;05;05;Perjantai;1;1;2
622;26.05.2017;2017;05;06;Perjantai;4;13;17
622;26.05.2017;2017;05;07;Perjantai;6;34;40
622;26.05.2017;2017;05;08;Perjantai;26;39;65
622;26.05.2017;2017;05;09;Perjantai;16;50;66
622;26.05.2017;2017;05;10;Perjantai;12;29;41
622;26.05.2017;2017;05;11;Perjantai;17;31;48
622;26.05.2017;2017;05;12;Perjantai;16;32;48
622;26.05.2017;2017;05;13;Perjantai;28;30;58
622;26.05.2017;2017;05;14;Perjantai;31;40;71
622;26.05.2017;2017;05;15;Perjantai;50;28;78
622;26.05.2017;2017;05;16;Perjantai;53;35;88
622;26.05.2017;2017;05;17;Perjantai;57;43;100
622;26.05.2017;2017;05;18;Perjantai;39;33;72
622;26.05.2017;2017;05;19;Perjantai;40;24;64
622;26.05.2017;2017;05;20;Perjantai;42;33;75
622;26.05.2017;2017;05;21;Perjantai;22;14;36
622;26.05.2017;2017;05;22;Perjantai;28;18;46
622;26.05.2017;2017;05;23;Perjantai;12;13;25
622;27.05.2017;2017;05;00;Lauantai;7;8;15
622;27.05.2017;2017;05;01;Lauantai;3;8;11
622;27.05.2017;2017;05;02;Lauantai;11;2;13
622;27.05.2017;2017;05;03;Lauantai;3;2;5
622;27.05.2017;2017;05;04;Lauantai;7;1;8
622;27.05.2017;2017;05;05;Lauantai;2;1;3
622;27.05.2017;2017;05;06;Lauantai;2;6;8
622;27.05.2017;2017;05;07;Lauantai;0;7;7
622;27.05.2017;2017;05;08;Lauantai;8;6;14
622;27.05.2017;2017;05;09;Lauantai;7;7;14
622;27.05.2017;2017;05;10;Lauantai;11;18;29
622;27.05.2017;2017;05;11;Lauantai;10;26;36
622;27.05.2017;2017;05;12;Lauantai;17;31;48
622;27.05.2017;2017;05;13;Lauantai;31;34;65
622;27.05.2017;2017;05;14;Lauantai;40;26;66
622;27.05.2017;2017;05;15;Lauantai;39;27;66
622;27.05.2017;2017;05;16;Lauantai;25;16;41
622;27.05.2017;2017;05;17;Lauantai;29;19;48
622;27.05.2017;2017;05;18;Lauantai;26;30;56
622;27.05.2017;2017;05;19;Lauantai;29;19;48
622;27.05.2017;2017;05;20;Lauantai;16;25;41
622;27.05.2017;2017;05;21;Lauantai;18;15;33
622;27.05.2017;2017;05;22;Lauantai;12;8;20
622;27.05.2017;2017;05;23;Lauantai;10;9;19
622;28.05.2017;2017;05;00;Sunnuntai;6;8;14
622;28.05.2017;2017;05;01;Sunnuntai;8;7;15
622;28.05.2017;2017;05;02;Sunnuntai;5;0;5
622;28.05.2017;2017;05;03;Sunnuntai;6;3;9
622;28.05.2017;2017;05;04;Sunnuntai;7;6;13
622;28.05.2017;2017;05;05;Sunnuntai;6;2;8
622;28.05.2017;2017;05;06;Sunnuntai;3;1;4
622;28.05.2017;2017;05;07;Sunnuntai;2;1;3
622;28.05.2017;2017;05;08;Sunnuntai;8;4;12
622;28.05.2017;2017;05;09;Sunnuntai;6;3;9
622;28.05.2017;2017;05;10;Sunnuntai;7;13;20
622;28.05.2017;2017;05;11;Sunnuntai;10;8;18
622;28.05.2017;2017;05;12;Sunnuntai;4;5;9
622;28.05.2017;2017;05;13;Sunnuntai;8;3;11
622;28.05.2017;2017;05;14;Sunnuntai;6;9;15
622;28.05.2017;2017;05;15;Sunnuntai;9;7;16
622;28.05.2017;2017;05;16;Sunnuntai;5;9;14
622;28.05.2017;2017;05;17;Sunnuntai;14;15;29
622;28.05.2017;2017;05;18;Sunnuntai;15;18;33
622;28.05.2017;2017;05;19;Sunnuntai;19;15;34
622;28.05.2017;2017;05;20;Sunnuntai;13;10;23
622;28.05.2017;2017;05;21;Sunnuntai;11;14;25
622;28.05.2017;2017;05;22;Sunnuntai;3;8;11
622;28.05.2017;2017;05;23;Sunnuntai;3;5;8
622;29.05.2017;2017;05;00;Maanantai;3;4;7
622;29.05.2017;2017;05;01;Maanantai;1;3;4
622;29.05.2017;2017;05;02;Maanantai;0;1;1
622;29.05.2017;2017;05;03;Maanantai;1;0;1
622;29.05.2017;2017;05;04;Maanantai;1;0;1
622;29.05.2017;2017;05;05;Maanantai;0;3;3
622;29.05.2017;2017;05;06;Maanantai;4;7;11
622;29.05.2017;2017;05;07;Maanantai;10;39;49
622;29.05.2017;2017;05;08;Maanantai;26;65;91
622;29.05.2017;2017;05;09;Maanantai;28;60;88
622;29.05.2017;2017;05;10;Maanantai;20;25;45
622;29.05.2017;2017;05;11;Maanantai;15;34;49
622;29.05.2017;2017;05;12;Maanantai;42;67;109
622;29.05.2017;2017;05;13;Maanantai;29;35;64
622;29.05.2017;2017;05;14;Maanantai;49;39;88
622;29.05.2017;2017;05;15;Maanantai;53;28;81
622;29.05.2017;2017;05;16;Maanantai;75;47;122
622;29.05.2017;2017;05;17;Maanantai;77;46;123
622;29.05.2017;2017;05;18;Maanantai;51;46;97
622;29.05.2017;2017;05;19;Maanantai;51;32;83
622;29.05.2017;2017;05;20;Maanantai;42;42;84
622;29.05.2017;2017;05;21;Maanantai;51;20;71
622;29.05.2017;2017;05;22;Maanantai;21;12;33
622;29.05.2017;2017;05;23;Maanantai;15;3;18
622;30.05.2017;2017;05;00;Tiistai;6;4;10
622;30.05.2017;2017;05;01;Tiistai;2;1;3
622;30.05.2017;2017;05;02;Tiistai;2;2;4
622;30.05.2017;2017;05;03;Tiistai;0;1;1
622;30.05.2017;2017;05;04;Tiistai;1;2;3
622;30.05.2017;2017;05;05;Tiistai;2;2;4
622;30.05.2017;2017;05;06;Tiistai;4;10;14
622;30.05.2017;2017;05;07;Tiistai;20;52;72
622;30.05.2017;2017;05;08;Tiistai;26;67;93
622;30.05.2017;2017;05;09;Tiistai;45;72;117
622;30.05.2017;2017;05;10;Tiistai;28;69;97
622;30.05.2017;2017;05;11;Tiistai;22;45;67
622;30.05.2017;2017;05;12;Tiistai;21;41;62
622;30.05.2017;2017;05;13;Tiistai;54;41;95
622;30.05.2017;2017;05;14;Tiistai;50;51;101
622;30.05.2017;2017;05;15;Tiistai;62;44;106
622;30.05.2017;2017;05;16;Tiistai;80;63;143
622;30.05.2017;2017;05;17;Tiistai;101;69;170
622;30.05.2017;2017;05;18;Tiistai;66;47;113
622;30.05.2017;2017;05;19;Tiistai;52;26;78
622;30.05.2017;2017;05;20;Tiistai;53;34;87
622;30.05.2017;2017;05;21;Tiistai;36;18;54
622;30.05.2017;2017;05;22;Tiistai;26;19;45
622;30.05.2017;2017;05;23;Tiistai;10;6;16
622;31.05.2017;2017;05;00;Keskiviikko;11;0;11
622;31.05.2017;2017;05;01;Keskiviikko;5;4;9
622;31.05.2017;2017;05;02;Keskiviikko;2;2;4
622;31.05.2017;2017;05;03;Keskiviikko;0;0;0
622;31.05.2017;2017;05;04;Keskiviikko;0;1;1
622;31.05.2017;2017;05;05;Keskiviikko;1;1;2
622;31.05.2017;2017;05;06;Keskiviikko;3;9;12
622;31.05.2017;2017;05;07;Keskiviikko;15;53;68
622;31.05.2017;2017;05;08;Keskiviikko;27;56;83
622;31.05.2017;2017;05;09;Keskiviikko;42;57;99
622;31.05.2017;2017;05;10;Keskiviikko;12;21;33
622;31.05.2017;2017;05;11;Keskiviikko;13;13;26
622;31.05.2017;2017;05;12;Keskiviikko;23;29;52
622;31.05.2017;2017;05;13;Keskiviikko;19;38;57
622;31.05.2017;2017;05;14;Keskiviikko;24;24;48
622;31.05.2017;2017;05;15;Keskiviikko;49;39;88
622;31.05.2017;2017;05;16;Keskiviikko;55;38;93
622;31.05.2017;2017;05;17;Keskiviikko;67;38;105
622;31.05.2017;2017;05;18;Keskiviikko;40;42;82
622;31.05.2017;2017;05;19;Keskiviikko;39;25;64
622;31.05.2017;2017;05;20;Keskiviikko;28;17;45
622;31.05.2017;2017;05;21;Keskiviikko;24;12;36
622;31.05.2017;2017;05;22;Keskiviikko;16;5;21
622;31.05.2017;2017;05;23;Keskiviikko;11;3;14
622;01.06.2017;2017;06;00;Torstai;8;4;12
622;01.06.2017;2017;06;01;Torstai;3;1;4
622;01.06.2017;2017;06;02;Torstai;4;1;5
622;01.06.2017;2017;06;03;Torstai;1;0;1
622;01.06.2017;2017;06;04;Torstai;0;2;2
622;01.06.2017;2017;06;05;Torstai;3;3;6
622;01.06.2017;2017;06;06;Torstai;3;9;12
622;01.06.2017;2017;06;07;Torstai;9;37;46
622;01.06.2017;2017;06;08;Torstai;27;58;85
622;01.06.2017;2017;06;09;Torstai;37;69;106
622;01.06.2017;2017;06;10;Torstai;17;48;65
622;01.06.2017;2017;06;11;Torstai;24;22;46
622;01.06.2017;2017;06;12;Torstai;31;41;72
622;01.06.2017;2017;06;13;Torstai;20;29;49
622;01.06.2017;2017;06;14;Torstai;24;24;48
622;01.06.2017;2017;06;15;Torstai;32;19;51
622;01.06.2017;2017;06;16;Torstai;50;40;90
622;01.06.2017;2017;06;17;Torstai;60;40;100
622;01.06.2017;2017;06;18;Torstai;40;40;80
622;01.06.2017;2017;06;19;Torstai;39;25;64
622;01.06.2017;2017;06;20;Torstai;28;17;45
622;01.06.2017;2017;06;21;Torstai;24;12;36
622;01.06.2017;2017;06;22;Torstai;16;5;21
622;01.06.2017;2017;06;23;Torstai;11;3;14
622;02.06.2017;2017;06;00;Perjantai;7;3;10
622;02.06.2017;2017;06;01;Perjantai;3;2;5
622;02.06.2017;2017;06;02;Perjantai;0;0;0
622;02.06.2017;2017;06;03;Perjantai;4;1;5
622;02.06.2017;2017;06;04;Perjantai;0;1;1
622;02.06.2017;2017;06;05;Perjantai;1;1;2
622;02.06.2017;2017;06;06;Perjantai;4;13;17
622;02.06.2017;2017;06;07;Perjantai;6;34;40
622;02.06.2017;2017;06;08;Perjantai;26;39;65
622;02.06.2017;2017;06;09;Perjantai;16;50;66
622;02.06.2017;2017;06;10;Perjantai;12;29;41
622;02.06.2017;2017;06;11;Perjantai;17;31;48
622;02.06.2017;2017;06;12;Perjantai;16;32;48
622;02.06.2017;2017;06;13;Perjantai;28;30;58
622;02.06.2017;2017;06;14;Perjantai;31;40;71
622;02.06.2017;2017;06;15;Perjantai;50;28;78
622;02.06.2017;2017;06;16;Perjantai;53;35;88
622;02.06.2017;2017;06;17;Perjantai;57;43;100
622;02.06.2017;2017;06;18;Perjantai;26;19;45
622;02.06.2017;2017;06;19;Perjantai;28;15;43
622;02.06.2017;2017;06;20;Perjantai;27;13;40
622;02.06.2017;2017;06;21;Perjantai;27;14;41
622;02.06.2017;2017;06;22;Perjantai;25;14;39
622;02.06.2017;2017;06;23;Perjantai;8;11;19
622;03.06.2017;2017;06;00;Lauantai;16;2;18
622;03.06.2017;2017;06;01;Lauantai;9;0;9
622;03.06.2017;2017;06;02;Lauantai;3;1;4
622;03.06.2017;2017;06;03;Lauantai;0;0;0
622;03.06.2017;2017;06;04;Lauantai;0;1;1
622;03.06.2017;2017;06;05;Lauantai;1;1;2
622;03.06.2017;2017;06;06;Lauantai;3;6;9
622;03.06.2017;2017;06;07;Lauantai;3;10;13
622;03.06.2017;2017;06;08;Lauantai;4;6;10
622;03.06.2017;2017;06;09;Lauantai;13;12;25
622;03.06.2017;2017;06;10;Lauantai;16;18;34
622;03.06.2017;2017;06;11;Lauantai;17;28;45
622;03.06.2017;2017;06;12;Lauantai;14;16;30
622;03.06.2017;2017;06;13;Lauantai;21;31;52
622;03.06.2017;2017;06;14;Lauantai;29;29;58
622;03.06.2017;2017;06;15;Lauantai;28;31;59
622;03.06.2017;2017;06;16;Lauantai;26;26;52
622;03.06.2017;2017;06;17;Lauantai;25;20;45
622;03.06.2017;2017;06;18;Lauantai;19;29;48
622;03.06.2017;2017;06;19;Lauantai;21;15;36
622;03.06.2017;2017;06;20;Lauantai;18;28;46
622;03.06.2017;2017;06;21;Lauantai;18;19;37
622;03.06.2017;2017;06;22;Lauantai;9;15;24
622;03.06.2017;2017;06;23;Lauantai;17;7;24
622;04.06.2017;2017;06;00;Sunnuntai;13;11;24
622;04.06.2017;2017;06;01;Sunnuntai;15;10;25
622;04.06.2017;2017;06;02;Sunnuntai;11;3;14
622;04.06.2017;2017;06;03;Sunnuntai;11;3;14
622;04.06.2017;2017;06;04;Sunnuntai;3;2;5
622;04.06.2017;2017;06;05;Sunnuntai;1;3;4
622;04.06.2017;2017;06;06;Sunnuntai;4;1;5
622;04.06.2017;2017;06;07;Sunnuntai;2;9;11
622;04.06.2017;2017;06;08;Sunnuntai;2;6;8
622;04.06.2017;2017;06;09;Sunnuntai;7;5;12
622;04.06.2017;2017;06;10;Sunnuntai;9;12;21
622;04.06.2017;2017;06;11;Sunnuntai;13;34;47
622;04.06.2017;2017;06;12;Sunnuntai;20;32;52
622;04.06.2017;2017;06;13;Sunnuntai;42;36;78
622;04.06.2017;2017;06;14;Sunnuntai;24;40;64
622;04.06.2017;2017;06;15;Sunnuntai;39;48;87
622;04.06.2017;2017;06;16;Sunnuntai;36;25;61
622;04.06.2017;2017;06;17;Sunnuntai;43;34;77
622;04.06.2017;2017;06;18;Sunnuntai;24;18;42
622;04.06.2017;2017;06;19;Sunnuntai;24;28;52
622;04.06.2017;2017;06;20;Sunnuntai;25;14;39
622;04.06.2017;2017;06;21;Sunnuntai;18;23;41
622;04.06.2017;2017;06;22;Sunnuntai;20;6;26
622;04.06.2017;2017;06;23;Sunnuntai;12;10;22
622;05.06.2017;2017;06;00;Maanantai;7;4;11
622;05.06.2017;2017;06;01;Maanantai;2;0;2
622;05.06.2017;2017;06;02;Maanantai;0;1;1
622;05.06.2017;2017;06;03;Maanantai;1;1;2
622;05.06.2017;2017;06;04;Maanantai;0;0;0
622;05.06.2017;2017;06;05;Maanantai;1;4;5
622;05.06.2017;2017;06;06;Maanantai;4;13;17
622;05.06.2017;2017;06;07;Maanantai;14;61;75
622;05.06.2017;2017;06;08;Maanantai;31;81;112
622;05.06.2017;2017;06;09;Maanantai;25;68;93
622;05.06.2017;2017;06;10;Maanantai;18;40;58
622;05.06.2017;2017;06;11;Maanantai;17;34;51
622;05.06.2017;2017;06;12;Maanantai;28;35;63
622;05.06.2017;2017;06;13;Maanantai;43;50;93
622;05.06.2017;2017;06;14;Maanantai;41;47;88
622;05.06.2017;2017;06;15;Maanantai;67;46;113
622;05.06.2017;2017;06;16;Maanantai;109;66;175
622;05.06.2017;2017;06;17;Maanantai;110;64;174
622;05.06.2017;2017;06;18;Maanantai;70;66;136
622;05.06.2017;2017;06;19;Maanantai;58;40;98
622;05.06.2017;2017;06;20;Maanantai;43;27;70
622;05.06.2017;2017;06;21;Maanantai;42;21;63
622;05.06.2017;2017;06;22;Maanantai;21;14;35
622;05.06.2017;2017;06;23;Maanantai;10;6;16
622;06.06.2017;2017;06;00;Tiistai;8;2;10
622;06.06.2017;2017;06;01;Tiistai;6;2;8
622;06.06.2017;2017;06;02;Tiistai;0;1;1
622;06.06.2017;2017;06;03;Tiistai;0;1;1
622;06.06.2017;2017;06;04;Tiistai;1;1;2
622;06.06.2017;2017;06;05;Tiistai;0;3;3
622;06.06.2017;2017;06;06;Tiistai;3;14;17
622;06.06.2017;2017;06;07;Tiistai;11;47;58
622;06.06.2017;2017;06;08;Tiistai;28;44;72
622;06.06.2017;2017;06;09;Tiistai;31;51;82
622;06.06.2017;2017;06;10;Tiistai;17;18;35
622;06.06.2017;2017;06;11;Tiistai;21;22;43
622;06.06.2017;2017;06;12;Tiistai;16;19;35
622;06.06.2017;2017;06;13;Tiistai;25;29;54
622;06.06.2017;2017;06;14;Tiistai;33;32;65
622;06.06.2017;2017;06;15;Tiistai;43;35;78
622;06.06.2017;2017;06;16;Tiistai;78;59;137
622;06.06.2017;2017;06;17;Tiistai;83;64;147
622;06.06.2017;2017;06;18;Tiistai;58;51;109
622;06.06.2017;2017;06;19;Tiistai;50;41;91
622;06.06.2017;2017;06;20;Tiistai;61;27;88
622;06.06.2017;2017;06;21;Tiistai;49;38;87
622;06.06.2017;2017;06;22;Tiistai;29;18;47
622;06.06.2017;2017;06;23;Tiistai;17;13;30
622;07.06.2017;2017;06;00;Keskiviikko;12;4;16
622;07.06.2017;2017;06;01;Keskiviikko;3;3;6
622;07.06.2017;2017;06;02;Keskiviikko;3;1;4
622;07.06.2017;2017;06;03;Keskiviikko;1;0;1
622;07.06.2017;2017;06;04;Keskiviikko;2;1;3
622;07.06.2017;2017;06;05;Keskiviikko;0;3;3
622;07.06.2017;2017;06;06;Keskiviikko;2;15;17
622;07.06.2017;2017;06;07;Keskiviikko;18;86;104
622;07.06.2017;2017;06;08;Keskiviikko;33;93;126
622;07.06.2017;2017;06;09;Keskiviikko;50;57;107
622;07.06.2017;2017;06;10;Keskiviikko;37;53;90
622;07.06.2017;2017;06;11;Keskiviikko;31;50;81
622;07.06.2017;2017;06;12;Keskiviikko;51;68;119
622;07.06.2017;2017;06;13;Keskiviikko;46;35;81
622;07.06.2017;2017;06;14;Keskiviikko;56;54;110
622;07.06.2017;2017;06;15;Keskiviikko;57;66;123
622;07.06.2017;2017;06;16;Keskiviikko;118;105;223
622;07.06.2017;2017;06;17;Keskiviikko;154;90;244
622;07.06.2017;2017;06;18;Keskiviikko;117;105;222
622;07.06.2017;2017;06;19;Keskiviikko;81;77;158
622;07.06.2017;2017;06;20;Keskiviikko;76;64;140
622;07.06.2017;2017;06;21;Keskiviikko;82;47;129
622;07.06.2017;2017;06;22;Keskiviikko;70;30;100
622;07.06.2017;2017;06;23;Keskiviikko;36;17;53
622;08.06.2017;2017;06;00;Torstai;12;3;15
622;08.06.2017;2017;06;01;Torstai;8;1;9
622;08.06.2017;2017;06;02;Torstai;9;6;15
622;08.06.2017;2017;06;03;Torstai;4;2;6
622;08.06.2017;2017;06;04;Torstai;2;1;3
622;08.06.2017;2017;06;05;Torstai;3;3;6
622;08.06.2017;2017;06;06;Torstai;1;13;14
622;08.06.2017;2017;06;07;Torstai;26;74;100
622;08.06.2017;2017;06;08;Torstai;31;87;118
622;08.06.2017;2017;06;09;Torstai;50;52;102
622;08.06.2017;2017;06;10;Torstai;22;49;71
622;08.06.2017;2017;06;11;Torstai;19;52;71
622;08.06.2017;2017;06;12;Torstai;41;39;80
622;08.06.2017;2017;06;13;Torstai;51;42;93
622;08.06.2017;2017;06;14;Torstai;57;53;110
622;08.06.2017;2017;06;15;Torstai;83;64;147
622;08.06.2017;2017;06;16;Torstai;108;93;201
622;08.06.2017;2017;06;17;Torstai;125;86;211
622;08.06.2017;2017;06;18;Torstai;109;85;194
622;08.06.2017;2017;06;19;Torstai;87;61;148
622;08.06.2017;2017;06;20;Torstai;77;44;121
622;08.06.2017;2017;06;21;Torstai;83;56;139
622;08.06.2017;2017;06;22;Torstai;54;19;73
622;08.06.2017;2017;06;23;Torstai;27;11;38
622;09.06.2017;2017;06;00;Perjantai;24;8;32
622;09.06.2017;2017;06;01;Perjantai;12;4;16
622;09.06.2017;2017;06;02;Perjantai;5;2;7
622;09.06.2017;2017;06;03;Perjantai;1;1;2
622;09.06.2017;2017;06;04;Perjantai;4;1;5
622;09.06.2017;2017;06;05;Perjantai;1;2;3
622;09.06.2017;2017;06;06;Perjantai;4;13;17
622;09.06.2017;2017;06;07;Perjantai;21;68;89
622;09.06.2017;2017;06;08;Perjantai;19;66;85
622;09.06.2017;2017;06;09;Perjantai;18;64;82
622;09.06.2017;2017;06;10;Perjantai;25;51;76
622;09.06.2017;2017;06;11;Perjantai;20;38;58
622;09.06.2017;2017;06;12;Perjantai;44;54;98
622;09.06.2017;2017;06;13;Perjantai;62;70;132
622;09.06.2017;2017;06;14;Perjantai;83;80;163
622;09.06.2017;2017;06;15;Perjantai;94;83;177
622;09.06.2017;2017;06;16;Perjantai;117;94;211
622;09.06.2017;2017;06;17;Perjantai;96;79;175
622;09.06.2017;2017;06;18;Perjantai;70;86;156
622;09.06.2017;2017;06;19;Perjantai;64;64;128
622;09.06.2017;2017;06;20;Perjantai;73;78;151
622;09.06.2017;2017;06;21;Perjantai;58;41;99
622;09.06.2017;2017;06;22;Perjantai;54;22;76
622;09.06.2017;2017;06;23;Perjantai;25;19;44
622;10.06.2017;2017;06;00;Lauantai;31;16;47
622;10.06.2017;2017;06;01;Lauantai;13;17;30
622;10.06.2017;2017;06;02;Lauantai;19;1;20
622;10.06.2017;2017;06;03;Lauantai;9;4;13
622;10.06.2017;2017;06;04;Lauantai;9;2;11
622;10.06.2017;2017;06;05;Lauantai;9;0;9
622;10.06.2017;2017;06;06;Lauantai;12;4;16
622;10.06.2017;2017;06;07;Lauantai;6;5;11
622;10.06.2017;2017;06;08;Lauantai;11;6;17
622;10.06.2017;2017;06;09;Lauantai;13;19;32
622;10.06.2017;2017;06;10;Lauantai;15;33;48
622;10.06.2017;2017;06;11;Lauantai;33;37;70
622;10.06.2017;2017;06;12;Lauantai;44;39;83
622;10.06.2017;2017;06;13;Lauantai;47;57;104
622;10.06.2017;2017;06;14;Lauantai;52;82;134
622;10.06.2017;2017;06;15;Lauantai;66;91;157
622;10.06.2017;2017;06;16;Lauantai;69;53;122
622;10.06.2017;2017;06;17;Lauantai;65;60;125
622;10.06.2017;2017;06;18;Lauantai;57;54;111
622;10.06.2017;2017;06;19;Lauantai;68;52;120
622;10.06.2017;2017;06;20;Lauantai;36;27;63
622;10.06.2017;2017;06;21;Lauantai;39;27;66
622;10.06.2017;2017;06;22;Lauantai;28;16;44
622;10.06.2017;2017;06;23;Lauantai;10;8;18
622;11.06.2017;2017;06;00;Sunnuntai;21;9;30
622;11.06.2017;2017;06;01;Sunnuntai;15;7;22
622;11.06.2017;2017;06;02;Sunnuntai;10;6;16
622;11.06.2017;2017;06;03;Sunnuntai;5;3;8
622;11.06.2017;2017;06;04;Sunnuntai;7;3;10
622;11.06.2017;2017;06;05;Sunnuntai;6;1;7
622;11.06.2017;2017;06;06;Sunnuntai;5;3;8
622;11.06.2017;2017;06;07;Sunnuntai;3;8;11
622;11.06.2017;2017;06;08;Sunnuntai;3;4;7
622;11.06.2017;2017;06;09;Sunnuntai;4;7;11
622;11.06.2017;2017;06;10;Sunnuntai;5;14;19
622;11.06.2017;2017;06;11;Sunnuntai;20;27;47
622;11.06.2017;2017;06;12;Sunnuntai;20;43;63
622;11.06.2017;2017;06;13;Sunnuntai;40;62;102
622;11.06.2017;2017;06;14;Sunnuntai;48;53;101
622;11.06.2017;2017;06;15;Sunnuntai;58;61;119
622;11.06.2017;2017;06;16;Sunnuntai;47;49;96
622;11.06.2017;2017;06;17;Sunnuntai;49;46;95
622;11.06.2017;2017;06;18;Sunnuntai;56;41;97
622;11.06.2017;2017;06;19;Sunnuntai;71;39;110
622;11.06.2017;2017;06;20;Sunnuntai;39;36;75
622;11.06.2017;2017;06;21;Sunnuntai;33;25;58
622;11.06.2017;2017;06;22;Sunnuntai;27;13;40
622;11.06.2017;2017;06;23;Sunnuntai;8;4;12
622;12.06.2017;2017;06;00;Maanantai;4;3;7
622;12.06.2017;2017;06;01;Maanantai;4;2;6
622;12.06.2017;2017;06;02;Maanantai;0;1;1
622;12.06.2017;2017;06;03;Maanantai;1;1;2
622;12.06.2017;2017;06;04;Maanantai;1;1;2
622;12.06.2017;2017;06;05;Maanantai;1;2;3
622;12.06.2017;2017;06;06;Maanantai;3;7;10
622;12.06.2017;2017;06;07;Maanantai;16;56;72
622;12.06.2017;2017;06;08;Maanantai;32;53;85
622;12.06.2017;2017;06;09;Maanantai;15;53;68
622;12.06.2017;2017;06;10;Maanantai;7;20;27
622;12.06.2017;2017;06;11;Maanantai;5;10;15
622;12.06.2017;2017;06;12;Maanantai;6;12;18
622;12.06.2017;2017;06;13;Maanantai;11;21;32
622;12.06.2017;2017;06;14;Maanantai;37;38;75
622;12.06.2017;2017;06;15;Maanantai;31;36;67
622;12.06.2017;2017;06;16;Maanantai;70;49;119
622;12.06.2017;2017;06;17;Maanantai;91;43;134
622;12.06.2017;2017;06;18;Maanantai;64;39;103
622;12.06.2017;2017;06;19;Maanantai;38;36;74
622;12.06.2017;2017;06;20;Maanantai;28;31;59
622;12.06.2017;2017;06;21;Maanantai;37;20;57
622;12.06.2017;2017;06;22;Maanantai;22;13;35
622;12.06.2017;2017;06;23;Maanantai;21;1;22
622;13.06.2017;2017;06;00;Tiistai;4;2;6
622;13.06.2017;2017;06;01;Tiistai;4;1;5
622;13.06.2017;2017;06;02;Tiistai;2;2;4
622;13.06.2017;2017;06;03;Tiistai;1;0;1
622;13.06.2017;2017;06;04;Tiistai;4;0;4
622;13.06.2017;2017;06;05;Tiistai;1;2;3
622;13.06.2017;2017;06;06;Tiistai;1;7;8
622;13.06.2017;2017;06;07;Tiistai;15;77;92
622;13.06.2017;2017;06;08;Tiistai;28;81;109
622;13.06.2017;2017;06;09;Tiistai;16;58;74
622;13.06.2017;2017;06;10;Tiistai;15;28;43
622;13.06.2017;2017;06;11;Tiistai;12;33;45
622;13.06.2017;2017;06;12;Tiistai;34;35;69
622;13.06.2017;2017;06;13;Tiistai;33;38;71
622;13.06.2017;2017;06;14;Tiistai;45;49;94
622;13.06.2017;2017;06;15;Tiistai;72;47;119
622;13.06.2017;2017;06;16;Tiistai;95;60;155
622;13.06.2017;2017;06;17;Tiistai;103;79;182
622;13.06.2017;2017;06;18;Tiistai;78;64;142
622;13.06.2017;2017;06;19;Tiistai;68;53;121
622;13.06.2017;2017;06;20;Tiistai;62;39;101
622;13.06.2017;2017;06;21;Tiistai;66;50;116
622;13.06.2017;2017;06;22;Tiistai;40;14;54
622;13.06.2017;2017;06;23;Tiistai;12;3;15
622;14.06.2017;2017;06;00;Keskiviikko;10;4;14
622;14.06.2017;2017;06;01;Keskiviikko;10;3;13
622;14.06.2017;2017;06;02;Keskiviikko;5;2;7
622;14.06.2017;2017;06;03;Keskiviikko;1;2;3
622;14.06.2017;2017;06;04;Keskiviikko;4;1;5
622;14.06.2017;2017;06;05;Keskiviikko;1;2;3
622;14.06.2017;2017;06;06;Keskiviikko;3;10;13
622;14.06.2017;2017;06;07;Keskiviikko;19;64;83
622;14.06.2017;2017;06;08;Keskiviikko;26;86;112
622;14.06.2017;2017;06;09;Keskiviikko;24;65;89
622;14.06.2017;2017;06;10;Keskiviikko;13;40;53
622;14.06.2017;2017;06;11;Keskiviikko;22;31;53
622;14.06.2017;2017;06;12;Keskiviikko;24;31;55
622;14.06.2017;2017;06;13;Keskiviikko;35;40;75
622;14.06.2017;2017;06;14;Keskiviikko;37;34;71
622;14.06.2017;2017;06;15;Keskiviikko;48;62;110
622;14.06.2017;2017;06;16;Keskiviikko;106;70;176
622;14.06.2017;2017;06;17;Keskiviikko;116;74;190
622;14.06.2017;2017;06;18;Keskiviikko;77;50;127
622;14.06.2017;2017;06;19;Keskiviikko;69;46;115
622;14.06.2017;2017;06;20;Keskiviikko;58;29;87
622;14.06.2017;2017;06;21;Keskiviikko;49;21;70
622;14.06.2017;2017;06;22;Keskiviikko;24;22;46
622;14.06.2017;2017;06;23;Keskiviikko;11;6;17
622;15.06.2017;2017;06;00;Torstai;6;3;9
622;15.06.2017;2017;06;01;Torstai;7;2;9
622;15.06.2017;2017;06;02;Torstai;4;1;5
622;15.06.2017;2017;06;03;Torstai;2;2;4
622;15.06.2017;2017;06;04;Torstai;2;1;3
622;15.06.2017;2017;06;05;Torstai;0;4;4
622;15.06.2017;2017;06;06;Torstai;2;5;7
622;15.06.2017;2017;06;07;Torstai;15;54;69
622;15.06.2017;2017;06;08;Torstai;33;71;104
622;15.06.2017;2017;06;09;Torstai;23;55;78
622;15.06.2017;2017;06;10;Torstai;22;33;55
622;15.06.2017;2017;06;11;Torstai;24;29;53
622;15.06.2017;2017;06;12;Torstai;38;62;100
622;15.06.2017;2017;06;13;Torstai;25;68;93
622;15.06.2017;2017;06;14;Torstai;58;68;126
622;15.06.2017;2017;06;15;Torstai;68;56;124
622;15.06.2017;2017;06;16;Torstai;123;92;215
622;15.06.2017;2017;06;17;Torstai;128;98;226
622;15.06.2017;2017;06;18;Torstai;78;67;145
622;15.06.2017;2017;06;19;Torstai;73;59;132
622;15.06.2017;2017;06;20;Torstai;77;49;126
622;15.06.2017;2017;06;21;Torstai;81;31;112
622;15.06.2017;2017;06;22;Torstai;56;17;73
622;15.06.2017;2017;06;23;Torstai;14;10;24
622;16.06.2017;2017;06;00;Perjantai;8;7;15
622;16.06.2017;2017;06;01;Perjantai;9;3;12
622;16.06.2017;2017;06;02;Perjantai;6;4;10
622;16.06.2017;2017;06;03;Perjantai;2;5;7
622;16.06.2017;2017;06;04;Perjantai;3;0;3
622;16.06.2017;2017;06;05;Perjantai;5;2;7
622;16.06.2017;2017;06;06;Perjantai;2;9;11
622;16.06.2017;2017;06;07;Perjantai;12;50;62
622;16.06.2017;2017;06;08;Perjantai;27;74;101
622;16.06.2017;2017;06;09;Perjantai;21;53;74
622;16.06.2017;2017;06;10;Perjantai;37;27;64
622;16.06.2017;2017;06;11;Perjantai;14;29;43
622;16.06.2017;2017;06;12;Perjantai;29;27;56
622;16.06.2017;2017;06;13;Perjantai;39;62;101
622;16.06.2017;2017;06;14;Perjantai;58;48;106
622;16.06.2017;2017;06;15;Perjantai;73;69;142
622;16.06.2017;2017;06;16;Perjantai;100;68;168
622;16.06.2017;2017;06;17;Perjantai;110;94;204
622;16.06.2017;2017;06;18;Perjantai;91;55;146
622;16.06.2017;2017;06;19;Perjantai;64;58;122
622;16.06.2017;2017;06;20;Perjantai;54;44;98
622;16.06.2017;2017;06;21;Perjantai;47;39;86
622;16.06.2017;2017;06;22;Perjantai;40;20;60
622;16.06.2017;2017;06;23;Perjantai;21;15;36
622;17.06.2017;2017;06;00;Lauantai;26;9;35
622;17.06.2017;2017;06;01;Lauantai;21;6;27
622;17.06.2017;2017;06;02;Lauantai;7;3;10
622;17.06.2017;2017;06;03;Lauantai;8;2;10
622;17.06.2017;2017;06;04;Lauantai;7;2;9
622;17.06.2017;2017;06;05;Lauantai;3;0;3
622;17.06.2017;2017;06;06;Lauantai;4;5;9
622;17.06.2017;2017;06;07;Lauantai;2;3;5
622;17.06.2017;2017;06;08;Lauantai;5;5;10
622;17.06.2017;2017;06;09;Lauantai;8;8;16
622;17.06.2017;2017;06;10;Lauantai;15;30;45
622;17.06.2017;2017;06;11;Lauantai;19;46;65
622;17.06.2017;2017;06;12;Lauantai;38;64;102
622;17.06.2017;2017;06;13;Lauantai;39;56;95
622;17.06.2017;2017;06;14;Lauantai;70;80;150
622;17.06.2017;2017;06;15;Lauantai;62;41;103
622;17.06.2017;2017;06;16;Lauantai;53;55;108
622;17.06.2017;2017;06;17;Lauantai;84;41;125
622;17.06.2017;2017;06;18;Lauantai;49;38;87
622;17.06.2017;2017;06;19;Lauantai;43;48;91
622;17.06.2017;2017;06;20;Lauantai;39;30;69
622;17.06.2017;2017;06;21;Lauantai;29;22;51
622;17.06.2017;2017;06;22;Lauantai;21;21;42
622;17.06.2017;2017;06;23;Lauantai;19;9;28
622;18.06.2017;2017;06;00;Sunnuntai;10;6;16
622;18.06.2017;2017;06;01;Sunnuntai;12;5;17
622;18.06.2017;2017;06;02;Sunnuntai;4;5;9
622;18.06.2017;2017;06;03;Sunnuntai;4;3;7
622;18.06.2017;2017;06;04;Sunnuntai;16;1;17
622;18.06.2017;2017;06;05;Sunnuntai;2;2;4
622;18.06.2017;2017;06;06;Sunnuntai;3;3;6
622;18.06.2017;2017;06;07;Sunnuntai;2;7;9
622;18.06.2017;2017;06;08;Sunnuntai;1;2;3
622;18.06.2017;2017;06;09;Sunnuntai;0;2;2
622;18.06.2017;2017;06;10;Sunnuntai;1;2;3
622;18.06.2017;2017;06;11;Sunnuntai;5;1;6
622;18.06.2017;2017;06;12;Sunnuntai;7;6;13
622;18.06.2017;2017;06;13;Sunnuntai;8;18;26
622;18.06.2017;2017;06;14;Sunnuntai;13;31;44
622;18.06.2017;2017;06;15;Sunnuntai;22;27;49
622;18.06.2017;2017;06;16;Sunnuntai;33;33;66
622;18.06.2017;2017;06;17;Sunnuntai;34;18;52
622;18.06.2017;2017;06;18;Sunnuntai;42;36;78
622;18.06.2017;2017;06;19;Sunnuntai;34;32;66
622;18.06.2017;2017;06;20;Sunnuntai;36;25;61
622;18.06.2017;2017;06;21;Sunnuntai;12;7;19
622;18.06.2017;2017;06;22;Sunnuntai;20;9;29
622;18.06.2017;2017;06;23;Sunnuntai;8;4;12
622;19.06.2017;2017;06;00;Maanantai;7;2;9
622;19.06.2017;2017;06;01;Maanantai;5;0;5
622;19.06.2017;2017;06;02;Maanantai;1;1;2
622;19.06.2017;2017;06;03;Maanantai;2;3;5
622;19.06.2017;2017;06;04;Maanantai;2;1;3
622;19.06.2017;2017;06;05;Maanantai;4;5;9
622;19.06.2017;2017;06;06;Maanantai;2;10;12
622;19.06.2017;2017;06;07;Maanantai;13;45;58
622;19.06.2017;2017;06;08;Maanantai;29;72;101
622;19.06.2017;2017;06;09;Maanantai;18;45;63
622;19.06.2017;2017;06;10;Maanantai;17;45;62
622;19.06.2017;2017;06;11;Maanantai;17;30;47
622;19.06.2017;2017;06;12;Maanantai;18;40;58
622;19.06.2017;2017;06;13;Maanantai;34;45;79
622;19.06.2017;2017;06;14;Maanantai;29;41;70
622;19.06.2017;2017;06;15;Maanantai;51;50;101
622;19.06.2017;2017;06;16;Maanantai;83;63;146
622;19.06.2017;2017;06;17;Maanantai;116;72;188
622;19.06.2017;2017;06;18;Maanantai;66;48;114
622;19.06.2017;2017;06;19;Maanantai;50;42;92
622;19.06.2017;2017;06;20;Maanantai;62;15;77
622;19.06.2017;2017;06;21;Maanantai;61;36;97
622;19.06.2017;2017;06;22;Maanantai;28;17;45
622;19.06.2017;2017;06;23;Maanantai;15;1;16
622;20.06.2017;2017;06;00;Tiistai;1;3;4
622;20.06.2017;2017;06;01;Tiistai;0;0;0
622;20.06.2017;2017;06;02;Tiistai;0;0;0
622;20.06.2017;2017;06;03;Tiistai;0;0;0
622;20.06.2017;2017;06;04;Tiistai;0;0;0
622;20.06.2017;2017;06;05;Tiistai;0;0;0
622;20.06.2017;2017;06;06;Tiistai;0;0;0
622;20.06.2017;2017;06;07;Tiistai;0;0;0
622;20.06.2017;2017;06;08;Tiistai;0;0;0
622;20.06.2017;2017;06;09;Tiistai;0;0;0
622;20.06.2017;2017;06;10;Tiistai;1;5;6
622;20.06.2017;2017;06;11;Tiistai;40;55;95
622;20.06.2017;2017;06;12;Tiistai;31;56;87
622;20.06.2017;2017;06;13;Tiistai;33;41;74
622;20.06.2017;2017;06;14;Tiistai;41;46;87
622;20.06.2017;2017;06;15;Tiistai;50;39;89
622;20.06.2017;2017;06;16;Tiistai;90;56;146
622;20.06.2017;2017;06;17;Tiistai;110;66;176
622;20.06.2017;2017;06;18;Tiistai;53;56;109
622;20.06.2017;2017;06;19;Tiistai;41;27;68
622;20.06.2017;2017;06;20;Tiistai;54;30;84
622;20.06.2017;2017;06;21;Tiistai;52;32;84
622;20.06.2017;2017;06;22;Tiistai;30;17;47
622;20.06.2017;2017;06;23;Tiistai;21;10;31
622;21.06.2017;2017;06;00;Keskiviikko;9;8;17
622;21.06.2017;2017;06;01;Keskiviikko;6;2;8
622;21.06.2017;2017;06;02;Keskiviikko;1;1;2
622;21.06.2017;2017;06;03;Keskiviikko;3;1;4
622;21.06.2017;2017;06;04;Keskiviikko;0;1;1
622;21.06.2017;2017;06;05;Keskiviikko;2;1;3
622;21.06.2017;2017;06;06;Keskiviikko;4;8;12
622;21.06.2017;2017;06;07;Keskiviikko;20;54;74
622;21.06.2017;2017;06;08;Keskiviikko;25;68;93
622;21.06.2017;2017;06;09;Keskiviikko;16;49;65
622;21.06.2017;2017;06;10;Keskiviikko;26;46;72
622;21.06.2017;2017;06;11;Keskiviikko;23;37;60
622;21.06.2017;2017;06;12;Keskiviikko;21;39;60
622;21.06.2017;2017;06;13;Keskiviikko;21;24;45
622;21.06.2017;2017;06;14;Keskiviikko;37;41;78
622;21.06.2017;2017;06;15;Keskiviikko;50;35;85
622;21.06.2017;2017;06;16;Keskiviikko;61;36;97
622;21.06.2017;2017;06;17;Keskiviikko;76;36;112
622;21.06.2017;2017;06;18;Keskiviikko;46;26;72
622;21.06.2017;2017;06;19;Keskiviikko;27;25;52
622;21.06.2017;2017;06;20;Keskiviikko;33;22;55
622;21.06.2017;2017;06;21;Keskiviikko;29;16;45
622;21.06.2017;2017;06;22;Keskiviikko;23;16;39
622;21.06.2017;2017;06;23;Keskiviikko;23;10;33
622;22.06.2017;2017;06;00;Torstai;7;3;10
622;22.06.2017;2017;06;01;Torstai;4;3;7
622;22.06.2017;2017;06;02;Torstai;4;7;11
622;22.06.2017;2017;06;03;Torstai;0;2;2
622;22.06.2017;2017;06;04;Torstai;1;0;1
622;22.06.2017;2017;06;05;Torstai;1;5;6
622;22.06.2017;2017;06;06;Torstai;4;8;12
622;22.06.2017;2017;06;07;Torstai;12;37;49
622;22.06.2017;2017;06;08;Torstai;16;28;44
622;22.06.2017;2017;06;09;Torstai;15;39;54
622;22.06.2017;2017;06;10;Torstai;17;25;42
622;22.06.2017;2017;06;11;Torstai;22;33;55
622;22.06.2017;2017;06;12;Torstai;25;28;53
622;22.06.2017;2017;06;13;Torstai;26;37;63
622;22.06.2017;2017;06;14;Torstai;33;29;62
622;22.06.2017;2017;06;15;Torstai;50;33;83
622;22.06.2017;2017;06;16;Torstai;43;38;81
622;22.06.2017;2017;06;17;Torstai;40;35;75
622;22.06.2017;2017;06;18;Torstai;43;25;68
622;22.06.2017;2017;06;19;Torstai;26;28;54
622;22.06.2017;2017;06;20;Torstai;25;14;39
622;22.06.2017;2017;06;21;Torstai;14;14;28
622;22.06.2017;2017;06;22;Torstai;9;11;20
622;22.06.2017;2017;06;23;Torstai;10;3;13
622;23.06.2017;2017;06;00;Perjantai;2;4;6
622;23.06.2017;2017;06;01;Perjantai;6;3;9
622;23.06.2017;2017;06;02;Perjantai;1;5;6
622;23.06.2017;2017;06;03;Perjantai;2;2;4
622;23.06.2017;2017;06;04;Perjantai;5;0;5
622;23.06.2017;2017;06;05;Perjantai;3;4;7
622;23.06.2017;2017;06;06;Perjantai;3;4;7
622;23.06.2017;2017;06;07;Perjantai;3;5;8
622;23.06.2017;2017;06;08;Perjantai;6;4;10
622;23.06.2017;2017;06;09;Perjantai;0;9;9
622;23.06.2017;2017;06;10;Perjantai;9;12;21
622;23.06.2017;2017;06;11;Perjantai;14;21;35
622;23.06.2017;2017;06;12;Perjantai;20;23;43
622;23.06.2017;2017;06;13;Perjantai;26;19;45
622;23.06.2017;2017;06;14;Perjantai;33;30;63
622;23.06.2017;2017;06;15;Perjantai;27;27;54
622;23.06.2017;2017;06;16;Perjantai;24;39;63
622;23.06.2017;2017;06;17;Perjantai;31;32;63
622;23.06.2017;2017;06;18;Perjantai;27;23;50
622;23.06.2017;2017;06;19;Perjantai;39;24;63
622;23.06.2017;2017;06;20;Perjantai;25;71;96
622;23.06.2017;2017;06;21;Perjantai;58;63;121
622;23.06.2017;2017;06;22;Perjantai;44;22;66
622;23.06.2017;2017;06;23;Perjantai;24;11;35
622;24.06.2017;2017;06;00;Lauantai;12;8;20
622;24.06.2017;2017;06;01;Lauantai;11;3;14
622;24.06.2017;2017;06;02;Lauantai;8;7;15
622;24.06.2017;2017;06;03;Lauantai;3;5;8
622;24.06.2017;2017;06;04;Lauantai;4;3;7
622;24.06.2017;2017;06;05;Lauantai;6;4;10
622;24.06.2017;2017;06;06;Lauantai;7;3;10
622;24.06.2017;2017;06;07;Lauantai;5;10;15
622;24.06.2017;2017;06;08;Lauantai;9;2;11
622;24.06.2017;2017;06;09;Lauantai;2;4;6
622;24.06.2017;2017;06;10;Lauantai;6;6;12
622;24.06.2017;2017;06;11;Lauantai;13;19;32
622;24.06.2017;2017;06;12;Lauantai;14;15;29
622;24.06.2017;2017;06;13;Lauantai;25;40;65
622;24.06.2017;2017;06;14;Lauantai;34;35;69
622;24.06.2017;2017;06;15;Lauantai;43;59;102
622;24.06.2017;2017;06;16;Lauantai;48;44;92
622;24.06.2017;2017;06;17;Lauantai;42;42;84
622;24.06.2017;2017;06;18;Lauantai;36;35;71
622;24.06.2017;2017;06;19;Lauantai;35;38;73
622;24.06.2017;2017;06;20;Lauantai;42;23;65
622;24.06.2017;2017;06;21;Lauantai;21;27;48
622;24.06.2017;2017;06;22;Lauantai;21;18;39
622;24.06.2017;2017;06;23;Lauantai;18;12;30
622;25.06.2017;2017;06;00;Sunnuntai;5;7;12
622;25.06.2017;2017;06;01;Sunnuntai;9;9;18
622;25.06.2017;2017;06;02;Sunnuntai;4;0;4
622;25.06.2017;2017;06;03;Sunnuntai;5;6;11
622;25.06.2017;2017;06;04;Sunnuntai;5;4;9
622;25.06.2017;2017;06;05;Sunnuntai;3;3;6
622;25.06.2017;2017;06;06;Sunnuntai;4;4;8
622;25.06.2017;2017;06;07;Sunnuntai;4;6;10
622;25.06.2017;2017;06;08;Sunnuntai;6;2;8
622;25.06.2017;2017;06;09;Sunnuntai;5;6;11
622;25.06.2017;2017;06;10;Sunnuntai;4;8;12
622;25.06.2017;2017;06;11;Sunnuntai;7;28;35
622;25.06.2017;2017;06;12;Sunnuntai;11;11;22
622;25.06.2017;2017;06;13;Sunnuntai;19;23;42
622;25.06.2017;2017;06;14;Sunnuntai;9;5;14
622;25.06.2017;2017;06;15;Sunnuntai;13;10;23
622;25.06.2017;2017;06;16;Sunnuntai;7;15;22
622;25.06.2017;2017;06;17;Sunnuntai;12;10;22
622;25.06.2017;2017;06;18;Sunnuntai;10;20;30
622;25.06.2017;2017;06;19;Sunnuntai;14;19;33
622;25.06.2017;2017;06;20;Sunnuntai;22;23;45
622;25.06.2017;2017;06;21;Sunnuntai;22;19;41
622;25.06.2017;2017;06;22;Sunnuntai;4;6;10
622;25.06.2017;2017;06;23;Sunnuntai;10;4;14
622;26.06.2017;2017;06;00;Maanantai;0;2;2
622;26.06.2017;2017;06;01;Maanantai;3;5;8
622;26.06.2017;2017;06;02;Maanantai;1;0;1
622;26.06.2017;2017;06;03;Maanantai;3;0;3
622;26.06.2017;2017;06;04;Maanantai;1;2;3
622;26.06.2017;2017;06;05;Maanantai;1;5;6
622;26.06.2017;2017;06;06;Maanantai;1;12;13
622;26.06.2017;2017;06;07;Maanantai;7;25;32
622;26.06.2017;2017;06;08;Maanantai;12;31;43
622;26.06.2017;2017;06;09;Maanantai;17;37;54
622;26.06.2017;2017;06;10;Maanantai;6;14;20
622;26.06.2017;2017;06;11;Maanantai;11;15;26
622;26.06.2017;2017;06;12;Maanantai;15;16;31
622;26.06.2017;2017;06;13;Maanantai;12;12;24
622;26.06.2017;2017;06;14;Maanantai;23;18;41
622;26.06.2017;2017;06;15;Maanantai;35;26;61
622;26.06.2017;2017;06;16;Maanantai;57;39;96
622;26.06.2017;2017;06;17;Maanantai;62;57;119
622;26.06.2017;2017;06;18;Maanantai;59;41;100
622;26.06.2017;2017;06;19;Maanantai;52;40;92
622;26.06.2017;2017;06;20;Maanantai;42;39;81
622;26.06.2017;2017;06;21;Maanantai;36;30;66
622;26.06.2017;2017;06;22;Maanantai;33;13;46
622;26.06.2017;2017;06;23;Maanantai;16;8;24
622;27.06.2017;2017;06;00;Tiistai;10;1;11
622;27.06.2017;2017;06;01;Tiistai;11;3;14
622;27.06.2017;2017;06;02;Tiistai;2;0;2
622;27.06.2017;2017;06;03;Tiistai;2;0;2
622;27.06.2017;2017;06;04;Tiistai;3;5;8
622;27.06.2017;2017;06;05;Tiistai;2;4;6
622;27.06.2017;2017;06;06;Tiistai;1;12;13
622;27.06.2017;2017;06;07;Tiistai;14;49;63
622;27.06.2017;2017;06;08;Tiistai;25;64;89
622;27.06.2017;2017;06;09;Tiistai;15;49;64
622;27.06.2017;2017;06;10;Tiistai;26;32;58
622;27.06.2017;2017;06;11;Tiistai;26;36;62
622;27.06.2017;2017;06;12;Tiistai;35;42;77
622;27.06.2017;2017;06;13;Tiistai;25;41;66
622;27.06.2017;2017;06;14;Tiistai;36;52;88
622;27.06.2017;2017;06;15;Tiistai;55;38;93
622;27.06.2017;2017;06;16;Tiistai;67;59;126
622;27.06.2017;2017;06;17;Tiistai;77;48;125
622;27.06.2017;2017;06;18;Tiistai;84;65;149
622;27.06.2017;2017;06;19;Tiistai;49;45;94
622;27.06.2017;2017;06;20;Tiistai;69;28;97
622;27.06.2017;2017;06;21;Tiistai;44;32;76
622;27.06.2017;2017;06;22;Tiistai;30;19;49
622;27.06.2017;2017;06;23;Tiistai;13;4;17
622;28.06.2017;2017;06;00;Keskiviikko;13;7;20
622;28.06.2017;2017;06;01;Keskiviikko;7;5;12
622;28.06.2017;2017;06;02;Keskiviikko;3;5;8
622;28.06.2017;2017;06;03;Keskiviikko;4;5;9
622;28.06.2017;2017;06;04;Keskiviikko;4;7;11
622;28.06.2017;2017;06;05;Keskiviikko;1;4;5
622;28.06.2017;2017;06;06;Keskiviikko;3;9;12
622;28.06.2017;2017;06;07;Keskiviikko;17;53;70
622;28.06.2017;2017;06;08;Keskiviikko;25;52;77
622;28.06.2017;2017;06;09;Keskiviikko;18;52;70
622;28.06.2017;2017;06;10;Keskiviikko;8;17;25
622;28.06.2017;2017;06;11;Keskiviikko;15;26;41
622;28.06.2017;2017;06;12;Keskiviikko;10;30;40
622;28.06.2017;2017;06;13;Keskiviikko;19;35;54
622;28.06.2017;2017;06;14;Keskiviikko;27;24;51
622;28.06.2017;2017;06;15;Keskiviikko;43;22;65
622;28.06.2017;2017;06;16;Keskiviikko;54;40;94
622;28.06.2017;2017;06;17;Keskiviikko;71;47;118
622;28.06.2017;2017;06;18;Keskiviikko;40;49;89
622;28.06.2017;2017;06;19;Keskiviikko;39;37;76
622;28.06.2017;2017;06;20;Keskiviikko;47;20;67
622;28.06.2017;2017;06;21;Keskiviikko;51;17;68
622;28.06.2017;2017;06;22;Keskiviikko;31;14;45
622;28.06.2017;2017;06;23;Keskiviikko;12;11;23
622;29.06.2017;2017;06;00;Torstai;6;4;10
622;29.06.2017;2017;06;01;Torstai;8;1;9
622;29.06.2017;2017;06;02;Torstai;1;0;1
622;29.06.2017;2017;06;03;Torstai;0;2;2
622;29.06.2017;2017;06;04;Torstai;1;2;3
622;29.06.2017;2017;06;05;Torstai;3;5;8
622;29.06.2017;2017;06;06;Torstai;4;9;13
622;29.06.2017;2017;06;07;Torstai;13;47;60
622;29.06.2017;2017;06;08;Torstai;26;50;76
622;29.06.2017;2017;06;09;Torstai;26;51;77
622;29.06.2017;2017;06;10;Torstai;15;34;49
622;29.06.2017;2017;06;11;Torstai;26;46;72
622;29.06.2017;2017;06;12;Torstai;36;59;95
622;29.06.2017;2017;06;13;Torstai;39;58;97
622;29.06.2017;2017;06;14;Torstai;55;50;105
622;29.06.2017;2017;06;15;Torstai;51;77;128
622;29.06.2017;2017;06;16;Torstai;103;63;166
622;29.06.2017;2017;06;17;Torstai;114;65;179
622;29.06.2017;2017;06;18;Torstai;100;70;170
622;29.06.2017;2017;06;19;Torstai;67;55;122
622;29.06.2017;2017;06;20;Torstai;56;35;91
622;29.06.2017;2017;06;21;Torstai;55;35;90
622;29.06.2017;2017;06;22;Torstai;38;25;63
622;29.06.2017;2017;06;23;Torstai;29;3;32
622;30.06.2017;2017;06;00;Perjantai;15;3;18
622;30.06.2017;2017;06;01;Perjantai;12;3;15
622;30.06.2017;2017;06;02;Perjantai;2;2;4
622;30.06.2017;2017;06;03;Perjantai;0;1;1
622;30.06.2017;2017;06;04;Perjantai;2;1;3
622;30.06.2017;2017;06;05;Perjantai;1;3;4
622;30.06.2017;2017;06;06;Perjantai;3;15;18
622;30.06.2017;2017;06;07;Perjantai;15;52;67
622;30.06.2017;2017;06;08;Perjantai;23;57;80
622;30.06.2017;2017;06;09;Perjantai;26;48;74
622;30.06.2017;2017;06;10;Perjantai;23;42;65
622;30.06.2017;2017;06;11;Perjantai;22;45;67
622;30.06.2017;2017;06;12;Perjantai;47;63;110
622;30.06.2017;2017;06;13;Perjantai;59;70;129
622;30.06.2017;2017;06;14;Perjantai;68;69;137
622;30.06.2017;2017;06;15;Perjantai;80;68;148
622;30.06.2017;2017;06;16;Perjantai;78;67;145
622;30.06.2017;2017;06;17;Perjantai;90;62;152
622;30.06.2017;2017;06;18;Perjantai;51;58;109
622;30.06.2017;2017;06;19;Perjantai;48;42;90
622;30.06.2017;2017;06;20;Perjantai;59;56;115
622;30.06.2017;2017;06;21;Perjantai;57;47;104
622;30.06.2017;2017;06;22;Perjantai;47;40;87
622;30.06.2017;2017;06;23;Perjantai;29;16;45
622;01.07.2017;2017;07;00;Lauantai;27;14;41
622;01.07.2017;2017;07;01;Lauantai;21;9;30
622;01.07.2017;2017;07;02;Lauantai;15;7;22
622;01.07.2017;2017;07;03;Lauantai;10;1;11
622;01.07.2017;2017;07;04;Lauantai;9;4;13
622;01.07.2017;2017;07;05;Lauantai;13;2;15
622;01.07.2017;2017;07;06;Lauantai;7;2;9
622;01.07.2017;2017;07;07;Lauantai;5;9;14
622;01.07.2017;2017;07;08;Lauantai;8;8;16
622;01.07.2017;2017;07;09;Lauantai;8;12;20
622;01.07.2017;2017;07;10;Lauantai;14;32;46
622;01.07.2017;2017;07;11;Lauantai;26;44;70
622;01.07.2017;2017;07;12;Lauantai;37;77;114
622;01.07.2017;2017;07;13;Lauantai;54;95;149
622;01.07.2017;2017;07;14;Lauantai;74;88;162
622;01.07.2017;2017;07;15;Lauantai;60;103;163
622;01.07.2017;2017;07;16;Lauantai;87;84;171
622;01.07.2017;2017;07;17;Lauantai;111;107;218
622;01.07.2017;2017;07;18;Lauantai;82;86;168
622;01.07.2017;2017;07;19;Lauantai;80;63;143
622;01.07.2017;2017;07;20;Lauantai;77;70;147
622;01.07.2017;2017;07;21;Lauantai;72;61;133
622;01.07.2017;2017;07;22;Lauantai;54;41;95
622;01.07.2017;2017;07;23;Lauantai;41;19;60
622;02.07.2017;2017;07;00;Sunnuntai;27;13;40
622;02.07.2017;2017;07;01;Sunnuntai;20;6;26
622;02.07.2017;2017;07;02;Sunnuntai;15;5;20
622;02.07.2017;2017;07;03;Sunnuntai;22;6;28
622;02.07.2017;2017;07;04;Sunnuntai;10;4;14
622;02.07.2017;2017;07;05;Sunnuntai;6;1;7
622;02.07.2017;2017;07;06;Sunnuntai;6;4;10
622;02.07.2017;2017;07;07;Sunnuntai;1;5;6
622;02.07.2017;2017;07;08;Sunnuntai;4;5;9
622;02.07.2017;2017;07;09;Sunnuntai;4;5;9
622;02.07.2017;2017;07;10;Sunnuntai;10;22;32
622;02.07.2017;2017;07;11;Sunnuntai;22;30;52
622;02.07.2017;2017;07;12;Sunnuntai;30;57;87
622;02.07.2017;2017;07;13;Sunnuntai;43;63;106
622;02.07.2017;2017;07;14;Sunnuntai;50;92;142
622;02.07.2017;2017;07;15;Sunnuntai;62;92;154
622;02.07.2017;2017;07;16;Sunnuntai;92;94;186
622;02.07.2017;2017;07;17;Sunnuntai;78;84;162
622;02.07.2017;2017;07;18;Sunnuntai;115;113;228
622;02.07.2017;2017;07;19;Sunnuntai;69;74;143
622;02.07.2017;2017;07;20;Sunnuntai;80;56;136
622;02.07.2017;2017;07;21;Sunnuntai;89;28;117
622;02.07.2017;2017;07;22;Sunnuntai;52;25;77
622;02.07.2017;2017;07;23;Sunnuntai;22;13;35
622;03.07.2017;2017;07;00;Maanantai;14;6;20
622;03.07.2017;2017;07;01;Maanantai;5;2;7
622;03.07.2017;2017;07;02;Maanantai;4;4;8
622;03.07.2017;2017;07;03;Maanantai;3;0;3
622;03.07.2017;2017;07;04;Maanantai;2;3;5
622;03.07.2017;2017;07;05;Maanantai;3;2;5
622;03.07.2017;2017;07;06;Maanantai;6;14;20
622;03.07.2017;2017;07;07;Maanantai;15;45;60
622;03.07.2017;2017;07;08;Maanantai;32;65;97
622;03.07.2017;2017;07;09;Maanantai;19;50;69
622;03.07.2017;2017;07;10;Maanantai;24;38;62
622;03.07.2017;2017;07;11;Maanantai;33;66;99
622;03.07.2017;2017;07;12;Maanantai;35;55;90
622;03.07.2017;2017;07;13;Maanantai;69;98;167
622;03.07.2017;2017;07;14;Maanantai;60;67;127
622;03.07.2017;2017;07;15;Maanantai;78;67;145
622;03.07.2017;2017;07;16;Maanantai;106;77;183
622;03.07.2017;2017;07;17;Maanantai;126;92;218
622;03.07.2017;2017;07;18;Maanantai;86;74;160
622;03.07.2017;2017;07;19;Maanantai;114;70;184
622;03.07.2017;2017;07;20;Maanantai;68;41;109
622;03.07.2017;2017;07;21;Maanantai;56;38;94
622;03.07.2017;2017;07;22;Maanantai;42;17;59
622;03.07.2017;2017;07;23;Maanantai;22;11;33
622;04.07.2017;2017;07;00;Tiistai;9;4;13
622;04.07.2017;2017;07;01;Tiistai;9;2;11
622;04.07.2017;2017;07;02;Tiistai;1;7;8
622;04.07.2017;2017;07;03;Tiistai;6;2;8
622;04.07.2017;2017;07;04;Tiistai;3;2;5
622;04.07.2017;2017;07;05;Tiistai;3;2;5
622;04.07.2017;2017;07;06;Tiistai;2;12;14
622;04.07.2017;2017;07;07;Tiistai;13;37;50
622;04.07.2017;2017;07;08;Tiistai;8;51;59
622;04.07.2017;2017;07;09;Tiistai;19;51;70
622;04.07.2017;2017;07;10;Tiistai;16;34;50
622;04.07.2017;2017;07;11;Tiistai;30;57;87
622;04.07.2017;2017;07;12;Tiistai;34;40;74
622;04.07.2017;2017;07;13;Tiistai;43;37;80
622;04.07.2017;2017;07;14;Tiistai;36;21;57
622;04.07.2017;2017;07;15;Tiistai;28;37;65
622;04.07.2017;2017;07;16;Tiistai;63;49;112
622;04.07.2017;2017;07;17;Tiistai;79;50;129
622;04.07.2017;2017;07;18;Tiistai;83;64;147
622;04.07.2017;2017;07;19;Tiistai;52;48;100
622;04.07.2017;2017;07;20;Tiistai;41;21;62
622;04.07.2017;2017;07;21;Tiistai;32;38;70
622;04.07.2017;2017;07;22;Tiistai;23;15;38
622;04.07.2017;2017;07;23;Tiistai;9;4;13
622;05.07.2017;2017;07;00;Keskiviikko;10;4;14
622;05.07.2017;2017;07;01;Keskiviikko;4;1;5
622;05.07.2017;2017;07;02;Keskiviikko;5;2;7
622;05.07.2017;2017;07;03;Keskiviikko;1;1;2
622;05.07.2017;2017;07;04;Keskiviikko;1;2;3
622;05.07.2017;2017;07;05;Keskiviikko;4;1;5
622;05.07.2017;2017;07;06;Keskiviikko;3;6;9
622;05.07.2017;2017;07;07;Keskiviikko;10;33;43
622;05.07.2017;2017;07;08;Keskiviikko;11;44;55
622;05.07.2017;2017;07;09;Keskiviikko;17;32;49
622;05.07.2017;2017;07;10;Keskiviikko;19;34;53
622;05.07.2017;2017;07;11;Keskiviikko;22;25;47
622;05.07.2017;2017;07;12;Keskiviikko;28;35;63
622;05.07.2017;2017;07;13;Keskiviikko;33;32;65
622;05.07.2017;2017;07;14;Keskiviikko;36;45;81
622;05.07.2017;2017;07;15;Keskiviikko;49;51;100
622;05.07.2017;2017;07;16;Keskiviikko;56;60;116
622;05.07.2017;2017;07;17;Keskiviikko;79;34;113
622;05.07.2017;2017;07;18;Keskiviikko;58;47;105
622;05.07.2017;2017;07;19;Keskiviikko;46;25;71
622;05.07.2017;2017;07;20;Keskiviikko;34;14;48
622;05.07.2017;2017;07;21;Keskiviikko;32;16;48
622;05.07.2017;2017;07;22;Keskiviikko;18;14;32
622;05.07.2017;2017;07;23;Keskiviikko;7;6;13
622;06.07.2017;2017;07;00;Torstai;7;6;13
622;06.07.2017;2017;07;01;Torstai;7;1;8
622;06.07.2017;2017;07;02;Torstai;1;1;2
622;06.07.2017;2017;07;03;Torstai;1;1;2
622;06.07.2017;2017;07;04;Torstai;6;3;9
622;06.07.2017;2017;07;05;Torstai;2;1;3
622;06.07.2017;2017;07;06;Torstai;6;7;13
622;06.07.2017;2017;07;07;Torstai;13;32;45
622;06.07.2017;2017;07;08;Torstai;12;30;42
622;06.07.2017;2017;07;09;Torstai;8;31;39
622;06.07.2017;2017;07;10;Torstai;8;17;25
622;06.07.2017;2017;07;11;Torstai;8;11;19
622;06.07.2017;2017;07;12;Torstai;9;13;22
622;06.07.2017;2017;07;13;Torstai;15;27;42
622;06.07.2017;2017;07;14;Torstai;21;37;58
622;06.07.2017;2017;07;15;Torstai;22;27;49
622;06.07.2017;2017;07;16;Torstai;40;35;75
622;06.07.2017;2017;07;17;Torstai;62;25;87
622;06.07.2017;2017;07;18;Torstai;45;36;81
622;06.07.2017;2017;07;19;Torstai;42;24;66
622;06.07.2017;2017;07;20;Torstai;31;31;62
622;06.07.2017;2017;07;21;Torstai;25;11;36
622;06.07.2017;2017;07;22;Torstai;32;17;49
622;06.07.2017;2017;07;23;Torstai;10;5;15
622;07.07.2017;2017;07;00;Perjantai;9;5;14
622;07.07.2017;2017;07;01;Perjantai;4;3;7
622;07.07.2017;2017;07;02;Perjantai;2;3;5
622;07.07.2017;2017;07;03;Perjantai;1;0;1
622;07.07.2017;2017;07;04;Perjantai;0;4;4
622;07.07.2017;2017;07;05;Perjantai;2;1;3
622;07.07.2017;2017;07;06;Perjantai;6;10;16
622;07.07.2017;2017;07;07;Perjantai;12;33;45
622;07.07.2017;2017;07;08;Perjantai;15;45;60
622;07.07.2017;2017;07;09;Perjantai;16;41;57
622;07.07.2017;2017;07;10;Perjantai;21;31;52
622;07.07.2017;2017;07;11;Perjantai;29;49;78
622;07.07.2017;2017;07;12;Perjantai;34;64;98
622;07.07.2017;2017;07;13;Perjantai;51;54;105
622;07.07.2017;2017;07;14;Perjantai;58;71;129
622;07.07.2017;2017;07;15;Perjantai;66;78;144
622;07.07.2017;2017;07;16;Perjantai;70;55;125
622;07.07.2017;2017;07;17;Perjantai;63;46;109
622;07.07.2017;2017;07;18;Perjantai;74;67;141
622;07.07.2017;2017;07;19;Perjantai;65;105;170
622;07.07.2017;2017;07;20;Perjantai;49;62;111
622;07.07.2017;2017;07;21;Perjantai;37;54;91
622;07.07.2017;2017;07;22;Perjantai;71;33;104
622;07.07.2017;2017;07;23;Perjantai;43;17;60
622;08.07.2017;2017;07;00;Lauantai;22;20;42
622;08.07.2017;2017;07;01;Lauantai;24;8;32
622;08.07.2017;2017;07;02;Lauantai;25;3;28
622;08.07.2017;2017;07;03;Lauantai;19;3;22
622;08.07.2017;2017;07;04;Lauantai;6;1;7
622;08.07.2017;2017;07;05;Lauantai;4;0;4
622;08.07.2017;2017;07;06;Lauantai;5;9;14
622;08.07.2017;2017;07;07;Lauantai;7;9;16
622;08.07.2017;2017;07;08;Lauantai;7;7;14
622;08.07.2017;2017;07;09;Lauantai;7;20;27
622;08.07.2017;2017;07;10;Lauantai;6;31;37
622;08.07.2017;2017;07;11;Lauantai;19;49;68
622;08.07.2017;2017;07;12;Lauantai;57;76;133
622;08.07.2017;2017;07;13;Lauantai;50;67;117
622;08.07.2017;2017;07;14;Lauantai;54;79;133
622;08.07.2017;2017;07;15;Lauantai;64;58;122
622;08.07.2017;2017;07;16;Lauantai;82;74;156
622;08.07.2017;2017;07;17;Lauantai;56;75;131
622;08.07.2017;2017;07;18;Lauantai;70;64;134
622;08.07.2017;2017;07;19;Lauantai;43;70;113
622;08.07.2017;2017;07;20;Lauantai;56;46;102
622;08.07.2017;2017;07;21;Lauantai;52;54;106
622;08.07.2017;2017;07;22;Lauantai;38;39;77
622;08.07.2017;2017;07;23;Lauantai;31;21;52
622;09.07.2017;2017;07;00;Sunnuntai;38;16;54
622;09.07.2017;2017;07;01;Sunnuntai;52;16;68
622;09.07.2017;2017;07;02;Sunnuntai;23;4;27
622;09.07.2017;2017;07;03;Sunnuntai;12;3;15
622;09.07.2017;2017;07;04;Sunnuntai;19;2;21
622;09.07.2017;2017;07;05;Sunnuntai;13;4;17
622;09.07.2017;2017;07;06;Sunnuntai;4;3;7
622;09.07.2017;2017;07;07;Sunnuntai;4;3;7
622;09.07.2017;2017;07;08;Sunnuntai;3;5;8
622;09.07.2017;2017;07;09;Sunnuntai;4;11;15
622;09.07.2017;2017;07;10;Sunnuntai;9;16;25
622;09.07.2017;2017;07;11;Sunnuntai;18;39;57
622;09.07.2017;2017;07;12;Sunnuntai;40;69;109
622;09.07.2017;2017;07;13;Sunnuntai;50;45;95
622;09.07.2017;2017;07;14;Sunnuntai;55;63;118
622;09.07.2017;2017;07;15;Sunnuntai;66;78;144
622;09.07.2017;2017;07;16;Sunnuntai;60;61;121
622;09.07.2017;2017;07;17;Sunnuntai;72;68;140
622;09.07.2017;2017;07;18;Sunnuntai;87;70;157
622;09.07.2017;2017;07;19;Sunnuntai;77;68;145
622;09.07.2017;2017;07;20;Sunnuntai;63;50;113
622;09.07.2017;2017;07;21;Sunnuntai;53;38;91
622;09.07.2017;2017;07;22;Sunnuntai;32;11;43
622;09.07.2017;2017;07;23;Sunnuntai;27;12;39
622;10.07.2017;2017;07;00;Maanantai;12;7;19
622;10.07.2017;2017;07;01;Maanantai;6;5;11
622;10.07.2017;2017;07;02;Maanantai;2;1;3
622;10.07.2017;2017;07;03;Maanantai;5;2;7
622;10.07.2017;2017;07;04;Maanantai;1;0;1
622;10.07.2017;2017;07;05;Maanantai;3;2;5
622;10.07.2017;2017;07;06;Maanantai;6;7;13
622;10.07.2017;2017;07;07;Maanantai;21;42;63
622;10.07.2017;2017;07;08;Maanantai;20;58;78
622;10.07.2017;2017;07;09;Maanantai;12;52;64
622;10.07.2017;2017;07;10;Maanantai;17;34;51
622;10.07.2017;2017;07;11;Maanantai;23;60;83
622;10.07.2017;2017;07;12;Maanantai;29;65;94
622;10.07.2017;2017;07;13;Maanantai;60;70;130
622;10.07.2017;2017;07;14;Maanantai;69;77;146
622;10.07.2017;2017;07;15;Maanantai;91;78;169
622;10.07.2017;2017;07;16;Maanantai;112;85;197
622;10.07.2017;2017;07;17;Maanantai;111;61;172
622;10.07.2017;2017;07;18;Maanantai;94;53;147
622;10.07.2017;2017;07;19;Maanantai;44;33;77
622;10.07.2017;2017;07;20;Maanantai;48;24;72
622;10.07.2017;2017;07;21;Maanantai;33;13;46
622;10.07.2017;2017;07;22;Maanantai;44;19;63
622;10.07.2017;2017;07;23;Maanantai;13;5;18
622;11.07.2017;2017;07;00;Tiistai;12;2;14
622;11.07.2017;2017;07;01;Tiistai;6;5;11
622;11.07.2017;2017;07;02;Tiistai;8;3;11
622;11.07.2017;2017;07;03;Tiistai;4;1;5
622;11.07.2017;2017;07;04;Tiistai;4;2;6
622;11.07.2017;2017;07;05;Tiistai;3;2;5
622;11.07.2017;2017;07;06;Tiistai;4;11;15
622;11.07.2017;2017;07;07;Tiistai;14;38;52
622;11.07.2017;2017;07;08;Tiistai;20;60;80
622;11.07.2017;2017;07;09;Tiistai;16;51;67
622;11.07.2017;2017;07;10;Tiistai;21;28;49
622;11.07.2017;2017;07;11;Tiistai;31;69;100
622;11.07.2017;2017;07;12;Tiistai;52;69;121
622;11.07.2017;2017;07;13;Tiistai;62;62;124
622;11.07.2017;2017;07;14;Tiistai;75;68;143
622;11.07.2017;2017;07;15;Tiistai;85;85;170
622;11.07.2017;2017;07;16;Tiistai;90;54;144
622;11.07.2017;2017;07;17;Tiistai;107;79;186
622;11.07.2017;2017;07;18;Tiistai;79;67;146
622;11.07.2017;2017;07;19;Tiistai;88;50;138
622;11.07.2017;2017;07;20;Tiistai;68;42;110
622;11.07.2017;2017;07;21;Tiistai;56;36;92
622;11.07.2017;2017;07;22;Tiistai;36;17;53
622;11.07.2017;2017;07;23;Tiistai;18;15;33
622;12.07.2017;2017;07;00;Keskiviikko;9;5;14
622;12.07.2017;2017;07;01;Keskiviikko;4;2;6
622;12.07.2017;2017;07;02;Keskiviikko;0;1;1
622;12.07.2017;2017;07;03;Keskiviikko;1;0;1
622;12.07.2017;2017;07;04;Keskiviikko;0;2;2
622;12.07.2017;2017;07;05;Keskiviikko;6;4;10
622;12.07.2017;2017;07;06;Keskiviikko;2;3;5
622;12.07.2017;2017;07;07;Keskiviikko;10;27;37
622;12.07.2017;2017;07;08;Keskiviikko;12;24;36
622;12.07.2017;2017;07;09;Keskiviikko;3;21;24
622;12.07.2017;2017;07;10;Keskiviikko;15;23;38
622;12.07.2017;2017;07;11;Keskiviikko;9;24;33
622;12.07.2017;2017;07;12;Keskiviikko;24;24;48
622;12.07.2017;2017;07;13;Keskiviikko;14;21;35
622;12.07.2017;2017;07;14;Keskiviikko;20;22;42
622;12.07.2017;2017;07;15;Keskiviikko;33;22;55
622;12.07.2017;2017;07;16;Keskiviikko;27;18;45
622;12.07.2017;2017;07;17;Keskiviikko;31;23;54
622;12.07.2017;2017;07;18;Keskiviikko;25;19;44
622;12.07.2017;2017;07;19;Keskiviikko;24;26;50
622;12.07.2017;2017;07;20;Keskiviikko;25;14;39
622;12.07.2017;2017;07;21;Keskiviikko;18;11;29
622;12.07.2017;2017;07;22;Keskiviikko;18;4;22
622;12.07.2017;2017;07;23;Keskiviikko;9;2;11
622;13.07.2017;2017;07;00;Torstai;4;4;8
622;13.07.2017;2017;07;01;Torstai;8;2;10
622;13.07.2017;2017;07;02;Torstai;2;2;4
622;13.07.2017;2017;07;03;Torstai;0;0;0
622;13.07.2017;2017;07;04;Torstai;3;2;5
622;13.07.2017;2017;07;05;Torstai;2;0;2
622;13.07.2017;2017;07;06;Torstai;2;11;13
622;13.07.2017;2017;07;07;Torstai;9;23;32
622;13.07.2017;2017;07;08;Torstai;6;33;39
622;13.07.2017;2017;07;09;Torstai;11;38;49
622;13.07.2017;2017;07;10;Torstai;8;26;34
622;13.07.2017;2017;07;11;Torstai;15;26;41
622;13.07.2017;2017;07;12;Torstai;20;39;59
622;13.07.2017;2017;07;13;Torstai;39;35;74
622;13.07.2017;2017;07;14;Torstai;48;44;92
622;13.07.2017;2017;07;15;Torstai;60;77;137
622;13.07.2017;2017;07;16;Torstai;70;40;110
622;13.07.2017;2017;07;17;Torstai;79;54;133
622;13.07.2017;2017;07;18;Torstai;56;36;92
622;13.07.2017;2017;07;19;Torstai;52;39;91
622;13.07.2017;2017;07;20;Torstai;23;17;40
622;13.07.2017;2017;07;21;Torstai;23;30;53
622;13.07.2017;2017;07;22;Torstai;33;21;54
622;13.07.2017;2017;07;23;Torstai;18;3;21
622;14.07.2017;2017;07;00;Perjantai;8;3;11
622;14.07.2017;2017;07;01;Perjantai;12;3;15
622;14.07.2017;2017;07;02;Perjantai;3;3;6
622;14.07.2017;2017;07;03;Perjantai;3;1;4
622;14.07.2017;2017;07;04;Perjantai;0;0;0
622;14.07.2017;2017;07;05;Perjantai;1;2;3
622;14.07.2017;2017;07;06;Perjantai;2;6;8
622;14.07.2017;2017;07;07;Perjantai;11;20;31
622;14.07.2017;2017;07;08;Perjantai;4;19;23
622;14.07.2017;2017;07;09;Perjantai;5;12;17
622;14.07.2017;2017;07;10;Perjantai;7;9;16
622;14.07.2017;2017;07;11;Perjantai;7;8;15
622;14.07.2017;2017;07;12;Perjantai;4;8;12
622;14.07.2017;2017;07;13;Perjantai;11;5;16
622;14.07.2017;2017;07;14;Perjantai;0;0;0
622;14.07.2017;2017;07;15;Perjantai;17;10;27
622;14.07.2017;2017;07;16;Perjantai;39;45;84
622;14.07.2017;2017;07;17;Perjantai;37;35;72
622;14.07.2017;2017;07;18;Perjantai;29;33;62
622;14.07.2017;2017;07;19;Perjantai;19;28;47
622;14.07.2017;2017;07;20;Perjantai;32;32;64
622;14.07.2017;2017;07;21;Perjantai;37;24;61
622;14.07.2017;2017;07;22;Perjantai;22;15;37
622;14.07.2017;2017;07;23;Perjantai;9;7;16
622;15.07.2017;2017;07;00;Lauantai;13;8;21
622;15.07.2017;2017;07;01;Lauantai;14;9;23
622;15.07.2017;2017;07;02;Lauantai;9;3;12
622;15.07.2017;2017;07;03;Lauantai;3;0;3
622;15.07.2017;2017;07;04;Lauantai;7;4;11
622;15.07.2017;2017;07;05;Lauantai;5;5;10
622;15.07.2017;2017;07;06;Lauantai;4;4;8
622;15.07.2017;2017;07;07;Lauantai;2;14;16
622;15.07.2017;2017;07;08;Lauantai;6;8;14
622;15.07.2017;2017;07;09;Lauantai;4;16;20
622;15.07.2017;2017;07;10;Lauantai;11;19;30
622;15.07.2017;2017;07;11;Lauantai;17;37;54
622;15.07.2017;2017;07;12;Lauantai;30;55;85
622;15.07.2017;2017;07;13;Lauantai;49;65;114
622;15.07.2017;2017;07;14;Lauantai;47;46;93
622;15.07.2017;2017;07;15;Lauantai;45;42;87
622;15.07.2017;2017;07;16;Lauantai;53;50;103
622;15.07.2017;2017;07;17;Lauantai;49;68;117
622;15.07.2017;2017;07;18;Lauantai;66;67;133
622;15.07.2017;2017;07;19;Lauantai;45;44;89
622;15.07.2017;2017;07;20;Lauantai;33;40;73
622;15.07.2017;2017;07;21;Lauantai;35;33;68
622;15.07.2017;2017;07;22;Lauantai;35;21;56
622;15.07.2017;2017;07;23;Lauantai;17;14;31
622;16.07.2017;2017;07;00;Sunnuntai;15;10;25
622;16.07.2017;2017;07;01;Sunnuntai;21;15;36
622;16.07.2017;2017;07;02;Sunnuntai;10;3;13
622;16.07.2017;2017;07;03;Sunnuntai;19;4;23
622;16.07.2017;2017;07;04;Sunnuntai;11;1;12
622;16.07.2017;2017;07;05;Sunnuntai;10;3;13
622;16.07.2017;2017;07;06;Sunnuntai;4;4;8
622;16.07.2017;2017;07;07;Sunnuntai;4;10;14
622;16.07.2017;2017;07;08;Sunnuntai;1;4;5
622;16.07.2017;2017;07;09;Sunnuntai;4;15;19
622;16.07.2017;2017;07;10;Sunnuntai;7;16;23
622;16.07.2017;2017;07;11;Sunnuntai;9;33;42
622;16.07.2017;2017;07;12;Sunnuntai;42;53;95
622;16.07.2017;2017;07;13;Sunnuntai;38;66;104
622;16.07.2017;2017;07;14;Sunnuntai;64;116;180
622;16.07.2017;2017;07;15;Sunnuntai;75;75;150
622;16.07.2017;2017;07;16;Sunnuntai;75;69;144
622;16.07.2017;2017;07;17;Sunnuntai;90;62;152
622;16.07.2017;2017;07;18;Sunnuntai;99;72;171
622;16.07.2017;2017;07;19;Sunnuntai;83;78;161
622;16.07.2017;2017;07;20;Sunnuntai;68;47;115
622;16.07.2017;2017;07;21;Sunnuntai;52;16;68
622;16.07.2017;2017;07;22;Sunnuntai;20;13;33
622;16.07.2017;2017;07;23;Sunnuntai;23;16;39
622;17.07.2017;2017;07;00;Maanantai;12;7;19
622;17.07.2017;2017;07;01;Maanantai;8;7;15
622;17.07.2017;2017;07;02;Maanantai;5;1;6
622;17.07.2017;2017;07;03;Maanantai;3;0;3
622;17.07.2017;2017;07;04;Maanantai;3;0;3
622;17.07.2017;2017;07;05;Maanantai;4;4;8
622;17.07.2017;2017;07;06;Maanantai;4;15;19
622;17.07.2017;2017;07;07;Maanantai;15;40;55
622;17.07.2017;2017;07;08;Maanantai;24;26;50
622;17.07.2017;2017;07;09;Maanantai;18;29;47
622;17.07.2017;2017;07;10;Maanantai;16;37;53
622;17.07.2017;2017;07;11;Maanantai;21;39;60
622;17.07.2017;2017;07;12;Maanantai;36;50;86
622;17.07.2017;2017;07;13;Maanantai;50;59;109
622;17.07.2017;2017;07;14;Maanantai;45;47;92
622;17.07.2017;2017;07;15;Maanantai;73;61;134
622;17.07.2017;2017;07;16;Maanantai;88;38;126
622;17.07.2017;2017;07;17;Maanantai;76;49;125
622;17.07.2017;2017;07;18;Maanantai;57;63;120
622;17.07.2017;2017;07;19;Maanantai;54;40;94
622;17.07.2017;2017;07;20;Maanantai;62;43;105
622;17.07.2017;2017;07;21;Maanantai;50;17;67
622;17.07.2017;2017;07;22;Maanantai;33;18;51
622;17.07.2017;2017;07;23;Maanantai;20;7;27
622;18.07.2017;2017;07;00;Tiistai;5;3;8
622;18.07.2017;2017;07;01;Tiistai;5;4;9
622;18.07.2017;2017;07;02;Tiistai;4;3;7
622;18.07.2017;2017;07;03;Tiistai;3;0;3
622;18.07.2017;2017;07;04;Tiistai;2;0;2
622;18.07.2017;2017;07;05;Tiistai;2;0;2
622;18.07.2017;2017;07;06;Tiistai;0;4;4
622;18.07.2017;2017;07;07;Tiistai;7;18;25
622;18.07.2017;2017;07;08;Tiistai;3;16;19
622;18.07.2017;2017;07;09;Tiistai;6;10;16
622;18.07.2017;2017;07;10;Tiistai;1;14;15
622;18.07.2017;2017;07;11;Tiistai;4;7;11
622;18.07.2017;2017;07;12;Tiistai;10;28;38
622;18.07.2017;2017;07;13;Tiistai;21;8;29
622;18.07.2017;2017;07;14;Tiistai;19;25;44
622;18.07.2017;2017;07;15;Tiistai;25;18;43
622;18.07.2017;2017;07;16;Tiistai;29;31;60
622;18.07.2017;2017;07;17;Tiistai;40;32;72
622;18.07.2017;2017;07;18;Tiistai;25;18;43
622;18.07.2017;2017;07;19;Tiistai;32;23;55
622;18.07.2017;2017;07;20;Tiistai;12;6;18
622;18.07.2017;2017;07;21;Tiistai;8;7;15
622;18.07.2017;2017;07;22;Tiistai;14;9;23
622;18.07.2017;2017;07;23;Tiistai;3;3;6
622;19.07.2017;2017;07;00;Keskiviikko;2;1;3
622;19.07.2017;2017;07;01;Keskiviikko;2;0;2
622;19.07.2017;2017;07;02;Keskiviikko;3;2;5
622;19.07.2017;2017;07;03;Keskiviikko;1;0;1
622;19.07.2017;2017;07;04;Keskiviikko;0;1;1
622;19.07.2017;2017;07;05;Keskiviikko;1;3;4
622;19.07.2017;2017;07;06;Keskiviikko;2;7;9
622;19.07.2017;2017;07;07;Keskiviikko;10;18;28
622;19.07.2017;2017;07;08;Keskiviikko;8;28;36
622;19.07.2017;2017;07;09;Keskiviikko;5;29;34
622;19.07.2017;2017;07;10;Keskiviikko;16;26;42
622;19.07.2017;2017;07;11;Keskiviikko;17;26;43
622;19.07.2017;2017;07;12;Keskiviikko;21;37;58
622;19.07.2017;2017;07;13;Keskiviikko;26;39;65
622;19.07.2017;2017;07;14;Keskiviikko;39;46;85
622;19.07.2017;2017;07;15;Keskiviikko;41;39;80
622;19.07.2017;2017;07;16;Keskiviikko;45;46;91
622;19.07.2017;2017;07;17;Keskiviikko;61;42;103
622;19.07.2017;2017;07;18;Keskiviikko;55;46;101
622;19.07.2017;2017;07;19;Keskiviikko;36;43;79
622;19.07.2017;2017;07;20;Keskiviikko;38;23;61
622;19.07.2017;2017;07;21;Keskiviikko;55;17;72
622;19.07.2017;2017;07;22;Keskiviikko;29;16;45
622;19.07.2017;2017;07;23;Keskiviikko;14;3;17
622;20.07.2017;2017;07;00;Torstai;10;6;16
622;20.07.2017;2017;07;01;Torstai;9;3;12
622;20.07.2017;2017;07;02;Torstai;3;4;7
622;20.07.2017;2017;07;03;Torstai;0;1;1
622;20.07.2017;2017;07;04;Torstai;3;1;4
622;20.07.2017;2017;07;05;Torstai;4;4;8
622;20.07.2017;2017;07;06;Torstai;3;8;11
622;20.07.2017;2017;07;07;Torstai;8;31;39
622;20.07.2017;2017;07;08;Torstai;12;44;56
622;20.07.2017;2017;07;09;Torstai;10;31;41
622;20.07.2017;2017;07;10;Torstai;21;34;55
622;20.07.2017;2017;07;11;Torstai;17;27;44
622;20.07.2017;2017;07;12;Torstai;22;43;65
622;20.07.2017;2017;07;13;Torstai;28;39;67
622;20.07.2017;2017;07;14;Torstai;48;50;98
622;20.07.2017;2017;07;15;Torstai;56;38;94
622;20.07.2017;2017;07;16;Torstai;64;52;116
622;20.07.2017;2017;07;17;Torstai;73;54;127
622;20.07.2017;2017;07;18;Torstai;57;43;100
622;20.07.2017;2017;07;19;Torstai;53;36;89
622;20.07.2017;2017;07;20;Torstai;33;27;60
622;20.07.2017;2017;07;21;Torstai;65;33;98
622;20.07.2017;2017;07;22;Torstai;24;14;38
622;20.07.2017;2017;07;23;Torstai;17;12;29
622;21.07.2017;2017;07;00;Perjantai;14;6;20
622;21.07.2017;2017;07;01;Perjantai;8;6;14
622;21.07.2017;2017;07;02;Perjantai;2;2;4
622;21.07.2017;2017;07;03;Perjantai;2;2;4
622;21.07.2017;2017;07;04;Perjantai;2;3;5
622;21.07.2017;2017;07;05;Perjantai;1;5;6
622;21.07.2017;2017;07;06;Perjantai;1;7;8
622;21.07.2017;2017;07;07;Perjantai;6;32;38
622;21.07.2017;2017;07;08;Perjantai;11;28;39
622;21.07.2017;2017;07;09;Perjantai;6;26;32
622;21.07.2017;2017;07;10;Perjantai;13;42;55
622;21.07.2017;2017;07;11;Perjantai;23;42;65
622;21.07.2017;2017;07;12;Perjantai;29;48;77
622;21.07.2017;2017;07;13;Perjantai;40;41;81
622;21.07.2017;2017;07;14;Perjantai;44;53;97
622;21.07.2017;2017;07;15;Perjantai;45;39;84
622;21.07.2017;2017;07;16;Perjantai;56;29;85
622;21.07.2017;2017;07;17;Perjantai;44;27;71
622;21.07.2017;2017;07;18;Perjantai;32;42;74
622;21.07.2017;2017;07;19;Perjantai;35;53;88
622;21.07.2017;2017;07;20;Perjantai;35;34;69
622;21.07.2017;2017;07;21;Perjantai;26;24;50
622;21.07.2017;2017;07;22;Perjantai;33;16;49
622;21.07.2017;2017;07;23;Perjantai;21;13;34
622;22.07.2017;2017;07;00;Lauantai;11;11;22
622;22.07.2017;2017;07;01;Lauantai;10;6;16
622;22.07.2017;2017;07;02;Lauantai;8;3;11
622;22.07.2017;2017;07;03;Lauantai;7;1;8
622;22.07.2017;2017;07;04;Lauantai;7;1;8
622;22.07.2017;2017;07;05;Lauantai;5;1;6
622;22.07.2017;2017;07;06;Lauantai;7;2;9
622;22.07.2017;2017;07;07;Lauantai;4;12;16
622;22.07.2017;2017;07;08;Lauantai;1;4;5
622;22.07.2017;2017;07;09;Lauantai;4;6;10
622;22.07.2017;2017;07;10;Lauantai;6;7;13
622;22.07.2017;2017;07;11;Lauantai;11;30;41
622;22.07.2017;2017;07;12;Lauantai;23;26;49
622;22.07.2017;2017;07;13;Lauantai;37;41;78
622;22.07.2017;2017;07;14;Lauantai;26;35;61
622;22.07.2017;2017;07;15;Lauantai;25;42;67
622;22.07.2017;2017;07;16;Lauantai;44;35;79
622;22.07.2017;2017;07;17;Lauantai;38;34;72
622;22.07.2017;2017;07;18;Lauantai;42;46;88
622;22.07.2017;2017;07;19;Lauantai;37;51;88
622;22.07.2017;2017;07;20;Lauantai;43;41;84
622;22.07.2017;2017;07;21;Lauantai;40;32;72
622;22.07.2017;2017;07;22;Lauantai;30;18;48
622;22.07.2017;2017;07;23;Lauantai;26;15;41
622;23.07.2017;2017;07;00;Sunnuntai;14;4;18
622;23.07.2017;2017;07;01;Sunnuntai;15;19;34
622;23.07.2017;2017;07;02;Sunnuntai;11;2;13
622;23.07.2017;2017;07;03;Sunnuntai;8;1;9
622;23.07.2017;2017;07;04;Sunnuntai;15;2;17
622;23.07.2017;2017;07;05;Sunnuntai;8;1;9
622;23.07.2017;2017;07;06;Sunnuntai;6;4;10
622;23.07.2017;2017;07;07;Sunnuntai;7;8;15
622;23.07.2017;2017;07;08;Sunnuntai;3;7;10
622;23.07.2017;2017;07;09;Sunnuntai;4;7;11
622;23.07.2017;2017;07;10;Sunnuntai;11;17;28
622;23.07.2017;2017;07;11;Sunnuntai;17;25;42
622;23.07.2017;2017;07;12;Sunnuntai;32;36;68
622;23.07.2017;2017;07;13;Sunnuntai;40;48;88
622;23.07.2017;2017;07;14;Sunnuntai;40;54;94
622;23.07.2017;2017;07;15;Sunnuntai;29;31;60
622;23.07.2017;2017;07;16;Sunnuntai;39;29;68
622;23.07.2017;2017;07;17;Sunnuntai;27;23;50
622;23.07.2017;2017;07;18;Sunnuntai;29;20;49
622;23.07.2017;2017;07;19;Sunnuntai;20;15;35
622;23.07.2017;2017;07;20;Sunnuntai;23;10;33
622;23.07.2017;2017;07;21;Sunnuntai;15;14;29
622;23.07.2017;2017;07;22;Sunnuntai;14;3;17
622;23.07.2017;2017;07;23;Sunnuntai;11;5;16
622;24.07.2017;2017;07;00;Maanantai;8;7;15
622;24.07.2017;2017;07;01;Maanantai;2;1;3
622;24.07.2017;2017;07;02;Maanantai;2;1;3
622;24.07.2017;2017;07;03;Maanantai;2;0;2
622;24.07.2017;2017;07;04;Maanantai;1;1;2
622;24.07.2017;2017;07;05;Maanantai;0;1;1
622;24.07.2017;2017;07;06;Maanantai;4;16;20
622;24.07.2017;2017;07;07;Maanantai;12;36;48
622;24.07.2017;2017;07;08;Maanantai;11;35;46
622;24.07.2017;2017;07;09;Maanantai;14;34;48
622;24.07.2017;2017;07;10;Maanantai;13;30;43
622;24.07.2017;2017;07;11;Maanantai;17;33;50
622;24.07.2017;2017;07;12;Maanantai;23;42;65
622;24.07.2017;2017;07;13;Maanantai;34;55;89
622;24.07.2017;2017;07;14;Maanantai;59;64;123
622;24.07.2017;2017;07;15;Maanantai;53;45;98
622;24.07.2017;2017;07;16;Maanantai;81;54;135
622;24.07.2017;2017;07;17;Maanantai;78;55;133
622;24.07.2017;2017;07;18;Maanantai;56;48;104
622;24.07.2017;2017;07;19;Maanantai;59;67;126
622;24.07.2017;2017;07;20;Maanantai;54;38;92
622;24.07.2017;2017;07;21;Maanantai;57;23;80
622;24.07.2017;2017;07;22;Maanantai;29;15;44
622;24.07.2017;2017;07;23;Maanantai;15;9;24
622;25.07.2017;2017;07;00;Tiistai;13;4;17
622;25.07.2017;2017;07;01;Tiistai;2;4;6
622;25.07.2017;2017;07;02;Tiistai;1;2;3
622;25.07.2017;2017;07;03;Tiistai;1;2;3
622;25.07.2017;2017;07;04;Tiistai;1;0;1
622;25.07.2017;2017;07;05;Tiistai;2;5;7
622;25.07.2017;2017;07;06;Tiistai;1;10;11
622;25.07.2017;2017;07;07;Tiistai;14;40;54
622;25.07.2017;2017;07;08;Tiistai;13;47;60
622;25.07.2017;2017;07;09;Tiistai;13;35;48
622;25.07.2017;2017;07;10;Tiistai;15;40;55
622;25.07.2017;2017;07;11;Tiistai;43;54;97
622;25.07.2017;2017;07;12;Tiistai;34;69;103
622;25.07.2017;2017;07;13;Tiistai;47;64;111
622;25.07.2017;2017;07;14;Tiistai;65;72;137
622;25.07.2017;2017;07;15;Tiistai;58;43;101
622;25.07.2017;2017;07;16;Tiistai;77;66;143
622;25.07.2017;2017;07;17;Tiistai;89;63;152
622;25.07.2017;2017;07;18;Tiistai;80;51;131
622;25.07.2017;2017;07;19;Tiistai;92;83;175
622;25.07.2017;2017;07;20;Tiistai;75;53;128
622;25.07.2017;2017;07;21;Tiistai;56;36;92
622;25.07.2017;2017;07;22;Tiistai;60;26;86
622;25.07.2017;2017;07;23;Tiistai;35;23;58
622;26.07.2017;2017;07;00;Keskiviikko;11;6;17
622;26.07.2017;2017;07;01;Keskiviikko;6;5;11
622;26.07.2017;2017;07;02;Keskiviikko;1;1;2
622;26.07.2017;2017;07;03;Keskiviikko;3;4;7
622;26.07.2017;2017;07;04;Keskiviikko;4;1;5
622;26.07.2017;2017;07;05;Keskiviikko;1;3;4
622;26.07.2017;2017;07;06;Keskiviikko;3;10;13
622;26.07.2017;2017;07;07;Keskiviikko;12;41;53
622;26.07.2017;2017;07;08;Keskiviikko;9;49;58
622;26.07.2017;2017;07;09;Keskiviikko;15;43;58
622;26.07.2017;2017;07;10;Keskiviikko;16;37;53
622;26.07.2017;2017;07;11;Keskiviikko;26;57;83
622;26.07.2017;2017;07;12;Keskiviikko;54;81;135
622;26.07.2017;2017;07;13;Keskiviikko;71;110;181
622;26.07.2017;2017;07;14;Keskiviikko;87;106;193
622;26.07.2017;2017;07;15;Keskiviikko;101;104;205
622;26.07.2017;2017;07;16;Keskiviikko;138;105;243
622;26.07.2017;2017;07;17;Keskiviikko;140;104;244
622;26.07.2017;2017;07;18;Keskiviikko;130;123;253
622;26.07.2017;2017;07;19;Keskiviikko;120;105;225
622;26.07.2017;2017;07;20;Keskiviikko;110;70;180
622;26.07.2017;2017;07;21;Keskiviikko;111;58;169
622;26.07.2017;2017;07;22;Keskiviikko;86;50;136
622;26.07.2017;2017;07;23;Keskiviikko;39;23;62
622;27.07.2017;2017;07;00;Torstai;21;14;35
622;27.07.2017;2017;07;01;Torstai;17;7;24
622;27.07.2017;2017;07;02;Torstai;10;4;14
622;27.07.2017;2017;07;03;Torstai;5;0;5
622;27.07.2017;2017;07;04;Torstai;2;1;3
622;27.07.2017;2017;07;05;Torstai;3;3;6
622;27.07.2017;2017;07;06;Torstai;4;14;18
622;27.07.2017;2017;07;07;Torstai;14;42;56
622;27.07.2017;2017;07;08;Torstai;20;49;69
622;27.07.2017;2017;07;09;Torstai;17;50;67
622;27.07.2017;2017;07;10;Torstai;19;53;72
622;27.07.2017;2017;07;11;Torstai;34;62;96
622;27.07.2017;2017;07;12;Torstai;37;70;107
622;27.07.2017;2017;07;13;Torstai;61;92;153
622;27.07.2017;2017;07;14;Torstai;86;93;179
622;27.07.2017;2017;07;15;Torstai;89;84;173
622;27.07.2017;2017;07;16;Torstai;122;77;199
622;27.07.2017;2017;07;17;Torstai;113;92;205
622;27.07.2017;2017;07;18;Torstai;100;101;201
622;27.07.2017;2017;07;19;Torstai;91;75;166
622;27.07.2017;2017;07;20;Torstai;92;64;156
622;27.07.2017;2017;07;21;Torstai;74;40;114
622;27.07.2017;2017;07;22;Torstai;53;32;85
622;27.07.2017;2017;07;23;Torstai;35;15;50
622;28.07.2017;2017;07;00;Perjantai;14;3;17
622;28.07.2017;2017;07;01;Perjantai;14;4;18
622;28.07.2017;2017;07;02;Perjantai;4;0;4
622;28.07.2017;2017;07;03;Perjantai;1;1;2
622;28.07.2017;2017;07;04;Perjantai;6;0;6
622;28.07.2017;2017;07;05;Perjantai;6;2;8
622;28.07.2017;2017;07;06;Perjantai;3;9;12
622;28.07.2017;2017;07;07;Perjantai;11;36;47
622;28.07.2017;2017;07;08;Perjantai;15;37;52
622;28.07.2017;2017;07;09;Perjantai;22;56;78
622;28.07.2017;2017;07;10;Perjantai;19;52;71
622;28.07.2017;2017;07;11;Perjantai;21;51;72
622;28.07.2017;2017;07;12;Perjantai;40;56;96
622;28.07.2017;2017;07;13;Perjantai;60;77;137
622;28.07.2017;2017;07;14;Perjantai;64;93;157
622;28.07.2017;2017;07;15;Perjantai;76;91;167
622;28.07.2017;2017;07;16;Perjantai;103;129;232
622;28.07.2017;2017;07;17;Perjantai;102;113;215
622;28.07.2017;2017;07;18;Perjantai;65;113;178
622;28.07.2017;2017;07;19;Perjantai;79;119;198
622;28.07.2017;2017;07;20;Perjantai;67;74;141
622;28.07.2017;2017;07;21;Perjantai;73;71;144
622;28.07.2017;2017;07;22;Perjantai;66;32;98
622;28.07.2017;2017;07;23;Perjantai;53;25;78
622;29.07.2017;2017;07;00;Lauantai;56;16;72
622;29.07.2017;2017;07;01;Lauantai;74;15;89
622;29.07.2017;2017;07;02;Lauantai;59;6;65
622;29.07.2017;2017;07;03;Lauantai;40;5;45
622;29.07.2017;2017;07;04;Lauantai;20;4;24
622;29.07.2017;2017;07;05;Lauantai;23;4;27
622;29.07.2017;2017;07;06;Lauantai;5;5;10
622;29.07.2017;2017;07;07;Lauantai;4;2;6
622;29.07.2017;2017;07;08;Lauantai;6;6;12
622;29.07.2017;2017;07;09;Lauantai;8;7;15
622;29.07.2017;2017;07;10;Lauantai;6;22;28
622;29.07.2017;2017;07;11;Lauantai;19;41;60
622;29.07.2017;2017;07;12;Lauantai;25;39;64
622;29.07.2017;2017;07;13;Lauantai;27;34;61
622;29.07.2017;2017;07;14;Lauantai;15;34;49
622;29.07.2017;2017;07;15;Lauantai;34;55;89
622;29.07.2017;2017;07;16;Lauantai;26;34;60
622;29.07.2017;2017;07;17;Lauantai;25;28;53
622;29.07.2017;2017;07;18;Lauantai;41;75;116
622;29.07.2017;2017;07;19;Lauantai;40;60;100
622;29.07.2017;2017;07;20;Lauantai;38;52;90
622;29.07.2017;2017;07;21;Lauantai;35;47;82
622;29.07.2017;2017;07;22;Lauantai;36;27;63
622;29.07.2017;2017;07;23;Lauantai;26;24;50
622;30.07.2017;2017;07;00;Sunnuntai;34;16;50
622;30.07.2017;2017;07;01;Sunnuntai;49;8;57
622;30.07.2017;2017;07;02;Sunnuntai;63;13;76
622;30.07.2017;2017;07;03;Sunnuntai;33;1;34
622;30.07.2017;2017;07;04;Sunnuntai;19;0;19
622;30.07.2017;2017;07;05;Sunnuntai;22;2;24
622;30.07.2017;2017;07;06;Sunnuntai;10;3;13
622;30.07.2017;2017;07;07;Sunnuntai;4;4;8
622;30.07.2017;2017;07;08;Sunnuntai;7;6;13
622;30.07.2017;2017;07;09;Sunnuntai;4;17;21
622;30.07.2017;2017;07;10;Sunnuntai;17;20;37
622;30.07.2017;2017;07;11;Sunnuntai;14;31;45
622;30.07.2017;2017;07;12;Sunnuntai;36;57;93
622;30.07.2017;2017;07;13;Sunnuntai;71;92;163
622;30.07.2017;2017;07;14;Sunnuntai;78;108;186
622;30.07.2017;2017;07;15;Sunnuntai;88;90;178
622;30.07.2017;2017;07;16;Sunnuntai;77;46;123
622;30.07.2017;2017;07;17;Sunnuntai;70;68;138
622;30.07.2017;2017;07;18;Sunnuntai;99;104;203
622;30.07.2017;2017;07;19;Sunnuntai;70;62;132
622;30.07.2017;2017;07;20;Sunnuntai;76;46;122
622;30.07.2017;2017;07;21;Sunnuntai;55;29;84
622;30.07.2017;2017;07;22;Sunnuntai;46;20;66
622;30.07.2017;2017;07;23;Sunnuntai;26;8;34
622;31.07.2017;2017;07;00;Maanantai;9;2;11
622;31.07.2017;2017;07;01;Maanantai;6;1;7
622;31.07.2017;2017;07;02;Maanantai;2;5;7
622;31.07.2017;2017;07;03;Maanantai;1;0;1
622;31.07.2017;2017;07;04;Maanantai;1;1;2
622;31.07.2017;2017;07;05;Maanantai;3;1;4
622;31.07.2017;2017;07;06;Maanantai;2;7;9
622;31.07.2017;2017;07;07;Maanantai;11;44;55
622;31.07.2017;2017;07;08;Maanantai;17;63;80
622;31.07.2017;2017;07;09;Maanantai;20;42;62
622;31.07.2017;2017;07;10;Maanantai;21;36;57
622;31.07.2017;2017;07;11;Maanantai;16;33;49
622;31.07.2017;2017;07;12;Maanantai;23;45;68
622;31.07.2017;2017;07;13;Maanantai;42;37;79
622;31.07.2017;2017;07;14;Maanantai;49;68;117
622;31.07.2017;2017;07;15;Maanantai;68;75;143
622;31.07.2017;2017;07;16;Maanantai;97;88;185
622;31.07.2017;2017;07;17;Maanantai;115;73;188
622;31.07.2017;2017;07;18;Maanantai;95;118;213
622;31.07.2017;2017;07;19;Maanantai;89;83;172
622;31.07.2017;2017;07;20;Maanantai;124;55;179
622;31.07.2017;2017;07;21;Maanantai;38;18;56
622;31.07.2017;2017;07;22;Maanantai;27;15;42
622;31.07.2017;2017;07;23;Maanantai;15;9;24
622;01.08.2017;2017;08;00;Tiistai;6;1;7
622;01.08.2017;2017;08;01;Tiistai;3;1;4
622;01.08.2017;2017;08;02;Tiistai;2;1;3
622;01.08.2017;2017;08;03;Tiistai;1;0;1
622;01.08.2017;2017;08;04;Tiistai;2;0;2
622;01.08.2017;2017;08;05;Tiistai;0;2;2
622;01.08.2017;2017;08;06;Tiistai;3;8;11
622;01.08.2017;2017;08;07;Tiistai;10;36;46
622;01.08.2017;2017;08;08;Tiistai;16;56;72
622;01.08.2017;2017;08;09;Tiistai;25;49;74
622;01.08.2017;2017;08;10;Tiistai;26;45;71
622;01.08.2017;2017;08;11;Tiistai;22;32;54
622;01.08.2017;2017;08;12;Tiistai;23;43;66
622;01.08.2017;2017;08;13;Tiistai;35;41;76
622;01.08.2017;2017;08;14;Tiistai;50;57;107
622;01.08.2017;2017;08;15;Tiistai;62;57;119
622;01.08.2017;2017;08;16;Tiistai;89;50;139
622;01.08.2017;2017;08;17;Tiistai;97;62;159
622;01.08.2017;2017;08;18;Tiistai;74;55;129
622;01.08.2017;2017;08;19;Tiistai;61;67;128
622;01.08.2017;2017;08;20;Tiistai;54;42;96
622;01.08.2017;2017;08;21;Tiistai;66;26;92
622;01.08.2017;2017;08;22;Tiistai;40;16;56
622;01.08.2017;2017;08;23;Tiistai;23;13;36
622;02.08.2017;2017;08;00;Keskiviikko;13;3;16
622;02.08.2017;2017;08;01;Keskiviikko;4;0;4
622;02.08.2017;2017;08;02;Keskiviikko;4;4;8
622;02.08.2017;2017;08;03;Keskiviikko;4;1;5
622;02.08.2017;2017;08;04;Keskiviikko;1;2;3
622;02.08.2017;2017;08;05;Keskiviikko;1;1;2
622;02.08.2017;2017;08;06;Keskiviikko;2;14;16
622;02.08.2017;2017;08;07;Keskiviikko;15;48;63
622;02.08.2017;2017;08;08;Keskiviikko;21;72;93
622;02.08.2017;2017;08;09;Keskiviikko;22;53;75
622;02.08.2017;2017;08;10;Keskiviikko;15;36;51
622;02.08.2017;2017;08;11;Keskiviikko;21;54;75
622;02.08.2017;2017;08;12;Keskiviikko;28;53;81
622;02.08.2017;2017;08;13;Keskiviikko;36;75;111
622;02.08.2017;2017;08;14;Keskiviikko;62;55;117
622;02.08.2017;2017;08;15;Keskiviikko;73;64;137
622;02.08.2017;2017;08;16;Keskiviikko;80;67;147
622;02.08.2017;2017;08;17;Keskiviikko;128;74;202
622;02.08.2017;2017;08;18;Keskiviikko;81;75;156
622;02.08.2017;2017;08;19;Keskiviikko;84;52;136
622;02.08.2017;2017;08;20;Keskiviikko;67;32;99
622;02.08.2017;2017;08;21;Keskiviikko;29;23;52
622;02.08.2017;2017;08;22;Keskiviikko;42;18;60
622;02.08.2017;2017;08;23;Keskiviikko;14;8;22
622;03.08.2017;2017;08;00;Torstai;8;7;15
622;03.08.2017;2017;08;01;Torstai;8;5;13
622;03.08.2017;2017;08;02;Torstai;7;0;7
622;03.08.2017;2017;08;03;Torstai;3;0;3
622;03.08.2017;2017;08;04;Torstai;0;0;0
622;03.08.2017;2017;08;05;Torstai;2;3;5
622;03.08.2017;2017;08;06;Torstai;0;13;13
622;03.08.2017;2017;08;07;Torstai;6;33;39
622;03.08.2017;2017;08;08;Torstai;19;52;71
622;03.08.2017;2017;08;09;Torstai;26;32;58
622;03.08.2017;2017;08;10;Torstai;19;33;52
622;03.08.2017;2017;08;11;Torstai;26;46;72
622;03.08.2017;2017;08;12;Torstai;20;31;51
622;03.08.2017;2017;08;13;Torstai;25;35;60
622;03.08.2017;2017;08;14;Torstai;35;50;85
622;03.08.2017;2017;08;15;Torstai;45;40;85
622;03.08.2017;2017;08;16;Torstai;93;72;165
622;03.08.2017;2017;08;17;Torstai;109;57;166
622;03.08.2017;2017;08;18;Torstai;69;72;141
622;03.08.2017;2017;08;19;Torstai;64;64;128
622;03.08.2017;2017;08;20;Torstai;79;41;120
622;03.08.2017;2017;08;21;Torstai;71;27;98
622;03.08.2017;2017;08;22;Torstai;52;18;70
622;03.08.2017;2017;08;23;Torstai;19;9;28
622;04.08.2017;2017;08;00;Perjantai;7;4;11
622;04.08.2017;2017;08;01;Perjantai;8;5;13
622;04.08.2017;2017;08;02;Perjantai;7;3;10
622;04.08.2017;2017;08;03;Perjantai;1;0;1
622;04.08.2017;2017;08;04;Perjantai;1;0;1
622;04.08.2017;2017;08;05;Perjantai;0;5;5
622;04.08.2017;2017;08;06;Perjantai;1;10;11
622;04.08.2017;2017;08;07;Perjantai;9;37;46
622;04.08.2017;2017;08;08;Perjantai;22;51;73
622;04.08.2017;2017;08;09;Perjantai;24;48;72
622;04.08.2017;2017;08;10;Perjantai;16;32;48
622;04.08.2017;2017;08;11;Perjantai;18;54;72
622;04.08.2017;2017;08;12;Perjantai;33;32;65
622;04.08.2017;2017;08;13;Perjantai;41;57;98
622;04.08.2017;2017;08;14;Perjantai;61;45;106
622;04.08.2017;2017;08;15;Perjantai;57;44;101
622;04.08.2017;2017;08;16;Perjantai;76;78;154
622;04.08.2017;2017;08;17;Perjantai;78;69;147
622;04.08.2017;2017;08;18;Perjantai;74;68;142
622;04.08.2017;2017;08;19;Perjantai;64;59;123
622;04.08.2017;2017;08;20;Perjantai;41;53;94
622;04.08.2017;2017;08;21;Perjantai;54;35;89
622;04.08.2017;2017;08;22;Perjantai;36;29;65
622;04.08.2017;2017;08;23;Perjantai;26;11;37
622;05.08.2017;2017;08;00;Lauantai;19;6;25
622;05.08.2017;2017;08;01;Lauantai;13;8;21
622;05.08.2017;2017;08;02;Lauantai;12;2;14
622;05.08.2017;2017;08;03;Lauantai;5;1;6
622;05.08.2017;2017;08;04;Lauantai;2;1;3
622;05.08.2017;2017;08;05;Lauantai;4;3;7
622;05.08.2017;2017;08;06;Lauantai;3;5;8
622;05.08.2017;2017;08;07;Lauantai;4;10;14
622;05.08.2017;2017;08;08;Lauantai;9;2;11
622;05.08.2017;2017;08;09;Lauantai;5;18;23
622;05.08.2017;2017;08;10;Lauantai;11;21;32
622;05.08.2017;2017;08;11;Lauantai;20;28;48
622;05.08.2017;2017;08;12;Lauantai;18;36;54
622;05.08.2017;2017;08;13;Lauantai;22;29;51
622;05.08.2017;2017;08;14;Lauantai;20;39;59
622;05.08.2017;2017;08;15;Lauantai;47;27;74
622;05.08.2017;2017;08;16;Lauantai;37;27;64
622;05.08.2017;2017;08;17;Lauantai;39;40;79
622;05.08.2017;2017;08;18;Lauantai;38;39;77
622;05.08.2017;2017;08;19;Lauantai;36;26;62
622;05.08.2017;2017;08;20;Lauantai;19;15;34
622;05.08.2017;2017;08;21;Lauantai;18;10;28
622;05.08.2017;2017;08;22;Lauantai;15;10;25
622;05.08.2017;2017;08;23;Lauantai;14;8;22
622;06.08.2017;2017;08;00;Sunnuntai;9;12;21
622;06.08.2017;2017;08;01;Sunnuntai;9;4;13
622;06.08.2017;2017;08;02;Sunnuntai;7;4;11
622;06.08.2017;2017;08;03;Sunnuntai;3;3;6
622;06.08.2017;2017;08;04;Sunnuntai;7;1;8
622;06.08.2017;2017;08;05;Sunnuntai;10;1;11
622;06.08.2017;2017;08;06;Sunnuntai;3;1;4
622;06.08.2017;2017;08;07;Sunnuntai;5;6;11
622;06.08.2017;2017;08;08;Sunnuntai;3;5;8
622;06.08.2017;2017;08;09;Sunnuntai;6;2;8
622;06.08.2017;2017;08;10;Sunnuntai;7;9;16
622;06.08.2017;2017;08;11;Sunnuntai;9;13;22
622;06.08.2017;2017;08;12;Sunnuntai;19;25;44
622;06.08.2017;2017;08;13;Sunnuntai;15;21;36
622;06.08.2017;2017;08;14;Sunnuntai;13;30;43
622;06.08.2017;2017;08;15;Sunnuntai;24;18;42
622;06.08.2017;2017;08;16;Sunnuntai;26;33;59
622;06.08.2017;2017;08;17;Sunnuntai;34;28;62
622;06.08.2017;2017;08;18;Sunnuntai;33;24;57
622;06.08.2017;2017;08;19;Sunnuntai;35;25;60
622;06.08.2017;2017;08;20;Sunnuntai;22;27;49
622;06.08.2017;2017;08;21;Sunnuntai;19;15;34
622;06.08.2017;2017;08;22;Sunnuntai;13;5;18
622;06.08.2017;2017;08;23;Sunnuntai;12;9;21
622;07.08.2017;2017;08;00;Maanantai;9;1;10
622;07.08.2017;2017;08;01;Maanantai;6;1;7
622;07.08.2017;2017;08;02;Maanantai;2;0;2
622;07.08.2017;2017;08;03;Maanantai;0;0;0
622;07.08.2017;2017;08;04;Maanantai;0;1;1
622;07.08.2017;2017;08;05;Maanantai;1;2;3
622;07.08.2017;2017;08;06;Maanantai;6;11;17
622;07.08.2017;2017;08;07;Maanantai;12;41;53
622;07.08.2017;2017;08;08;Maanantai;30;63;93
622;07.08.2017;2017;08;09;Maanantai;28;64;92
622;07.08.2017;2017;08;10;Maanantai;19;28;47
622;07.08.2017;2017;08;11;Maanantai;30;20;50
622;07.08.2017;2017;08;12;Maanantai;29;36;65
622;07.08.2017;2017;08;13;Maanantai;20;43;63
622;07.08.2017;2017;08;14;Maanantai;30;39;69
622;07.08.2017;2017;08;15;Maanantai;49;36;85
622;07.08.2017;2017;08;16;Maanantai;82;61;143
622;07.08.2017;2017;08;17;Maanantai;112;40;152
622;07.08.2017;2017;08;18;Maanantai;81;69;150
622;07.08.2017;2017;08;19;Maanantai;64;53;117
622;07.08.2017;2017;08;20;Maanantai;57;35;92
622;07.08.2017;2017;08;21;Maanantai;56;17;73
622;07.08.2017;2017;08;22;Maanantai;33;11;44
622;07.08.2017;2017;08;23;Maanantai;13;10;23
622;08.08.2017;2017;08;00;Tiistai;9;3;12
622;08.08.2017;2017;08;01;Tiistai;9;1;10
622;08.08.2017;2017;08;02;Tiistai;3;1;4
622;08.08.2017;2017;08;03;Tiistai;4;0;4
622;08.08.2017;2017;08;04;Tiistai;0;1;1
622;08.08.2017;2017;08;05;Tiistai;2;1;3
622;08.08.2017;2017;08;06;Tiistai;3;14;17
622;08.08.2017;2017;08;07;Tiistai;12;50;62
622;08.08.2017;2017;08;08;Tiistai;27;73;100
622;08.08.2017;2017;08;09;Tiistai;20;64;84
622;08.08.2017;2017;08;10;Tiistai;23;35;58
622;08.08.2017;2017;08;11;Tiistai;24;43;67
622;08.08.2017;2017;08;12;Tiistai;38;46;84
622;08.08.2017;2017;08;13;Tiistai;38;54;92
622;08.08.2017;2017;08;14;Tiistai;41;51;92
622;08.08.2017;2017;08;15;Tiistai;60;63;123
622;08.08.2017;2017;08;16;Tiistai;112;63;175
622;08.08.2017;2017;08;17;Tiistai;127;82;209
622;08.08.2017;2017;08;18;Tiistai;93;59;152
622;08.08.2017;2017;08;19;Tiistai;55;29;84
622;08.08.2017;2017;08;20;Tiistai;33;13;46
622;08.08.2017;2017;08;21;Tiistai;34;19;53
622;08.08.2017;2017;08;22;Tiistai;20;8;28
622;08.08.2017;2017;08;23;Tiistai;6;6;12
622;09.08.2017;2017;08;00;Keskiviikko;12;1;13
622;09.08.2017;2017;08;01;Keskiviikko;2;1;3
622;09.08.2017;2017;08;02;Keskiviikko;2;1;3
622;09.08.2017;2017;08;03;Keskiviikko;1;1;2
622;09.08.2017;2017;08;04;Keskiviikko;0;1;1
622;09.08.2017;2017;08;05;Keskiviikko;2;1;3
622;09.08.2017;2017;08;06;Keskiviikko;0;10;10
622;09.08.2017;2017;08;07;Keskiviikko;13;45;58
622;09.08.2017;2017;08;08;Keskiviikko;24;72;96
622;09.08.2017;2017;08;09;Keskiviikko;32;59;91
622;09.08.2017;2017;08;10;Keskiviikko;20;37;57
622;09.08.2017;2017;08;11;Keskiviikko;27;32;59
622;09.08.2017;2017;08;12;Keskiviikko;24;51;75
622;09.08.2017;2017;08;13;Keskiviikko;37;52;89
622;09.08.2017;2017;08;14;Keskiviikko;44;53;97
622;09.08.2017;2017;08;15;Keskiviikko;56;62;118
622;09.08.2017;2017;08;16;Keskiviikko;97;70;167
622;09.08.2017;2017;08;17;Keskiviikko;123;85;208
622;09.08.2017;2017;08;18;Keskiviikko;88;55;143
622;09.08.2017;2017;08;19;Keskiviikko;64;38;102
622;09.08.2017;2017;08;20;Keskiviikko;62;39;101
622;09.08.2017;2017;08;21;Keskiviikko;42;16;58
622;09.08.2017;2017;08;22;Keskiviikko;30;16;46
622;09.08.2017;2017;08;23;Keskiviikko;16;9;25
622;10.08.2017;2017;08;00;Torstai;13;6;19
622;10.08.2017;2017;08;01;Torstai;7;4;11
622;10.08.2017;2017;08;02;Torstai;1;0;1
622;10.08.2017;2017;08;03;Torstai;3;1;4
622;10.08.2017;2017;08;04;Torstai;1;1;2
622;10.08.2017;2017;08;05;Torstai;2;2;4
622;10.08.2017;2017;08;06;Torstai;4;7;11
622;10.08.2017;2017;08;07;Torstai;7;33;40
622;10.08.2017;2017;08;08;Torstai;13;52;65
622;10.08.2017;2017;08;09;Torstai;57;81;138
622;10.08.2017;2017;08;10;Torstai;16;48;64
622;10.08.2017;2017;08;11;Torstai;21;35;56
622;10.08.2017;2017;08;12;Torstai;27;17;44
622;10.08.2017;2017;08;13;Torstai;20;23;43
622;10.08.2017;2017;08;14;Torstai;16;12;28
622;10.08.2017;2017;08;15;Torstai;27;21;48
622;10.08.2017;2017;08;16;Torstai;52;30;82
622;10.08.2017;2017;08;17;Torstai;27;30;57
622;10.08.2017;2017;08;18;Torstai;32;27;59
622;10.08.2017;2017;08;19;Torstai;33;24;57
622;10.08.2017;2017;08;20;Torstai;35;15;50
622;10.08.2017;2017;08;21;Torstai;31;26;57
622;10.08.2017;2017;08;22;Torstai;24;3;27
622;10.08.2017;2017;08;23;Torstai;10;6;16
622;11.08.2017;2017;08;00;Perjantai;1;2;3
622;11.08.2017;2017;08;01;Perjantai;2;3;5
622;11.08.2017;2017;08;02;Perjantai;0;1;1
622;11.08.2017;2017;08;03;Perjantai;3;0;3
622;11.08.2017;2017;08;04;Perjantai;0;0;0
622;11.08.2017;2017;08;05;Perjantai;3;4;7
622;11.08.2017;2017;08;06;Perjantai;1;13;14
622;11.08.2017;2017;08;07;Perjantai;8;46;54
622;11.08.2017;2017;08;08;Perjantai;17;67;84
622;11.08.2017;2017;08;09;Perjantai;51;77;128
622;11.08.2017;2017;08;10;Perjantai;22;42;64
622;11.08.2017;2017;08;11;Perjantai;21;36;57
622;11.08.2017;2017;08;12;Perjantai;33;30;63
622;11.08.2017;2017;08;13;Perjantai;41;43;84
622;11.08.2017;2017;08;14;Perjantai;44;39;83
622;11.08.2017;2017;08;15;Perjantai;62;61;123
622;11.08.2017;2017;08;16;Perjantai;88;49;137
622;11.08.2017;2017;08;17;Perjantai;78;64;142
622;11.08.2017;2017;08;18;Perjantai;71;63;134
622;11.08.2017;2017;08;19;Perjantai;55;55;110
622;11.08.2017;2017;08;20;Perjantai;40;37;77
622;11.08.2017;2017;08;21;Perjantai;50;27;77
622;11.08.2017;2017;08;22;Perjantai;34;26;60
622;11.08.2017;2017;08;23;Perjantai;20;7;27
622;12.08.2017;2017;08;00;Lauantai;14;15;29
622;12.08.2017;2017;08;01;Lauantai;10;13;23
622;12.08.2017;2017;08;02;Lauantai;6;1;7
622;12.08.2017;2017;08;03;Lauantai;1;3;4
622;12.08.2017;2017;08;04;Lauantai;5;3;8
622;12.08.2017;2017;08;05;Lauantai;3;2;5
622;12.08.2017;2017;08;06;Lauantai;4;3;7
622;12.08.2017;2017;08;07;Lauantai;1;8;9
622;12.08.2017;2017;08;08;Lauantai;5;5;10
622;12.08.2017;2017;08;09;Lauantai;21;23;44
622;12.08.2017;2017;08;10;Lauantai;16;27;43
622;12.08.2017;2017;08;11;Lauantai;20;42;62
622;12.08.2017;2017;08;12;Lauantai;46;81;127
622;12.08.2017;2017;08;13;Lauantai;45;69;114
622;12.08.2017;2017;08;14;Lauantai;58;86;144
622;12.08.2017;2017;08;15;Lauantai;85;61;146
622;12.08.2017;2017;08;16;Lauantai;73;59;132
622;12.08.2017;2017;08;17;Lauantai;96;52;148
622;12.08.2017;2017;08;18;Lauantai;56;60;116
622;12.08.2017;2017;08;19;Lauantai;65;42;107
622;12.08.2017;2017;08;20;Lauantai;57;50;107
622;12.08.2017;2017;08;21;Lauantai;42;30;72
622;12.08.2017;2017;08;22;Lauantai;31;14;45
622;12.08.2017;2017;08;23;Lauantai;18;13;31
622;13.08.2017;2017;08;00;Sunnuntai;27;4;31
622;13.08.2017;2017;08;01;Sunnuntai;8;10;18
622;13.08.2017;2017;08;02;Sunnuntai;7;4;11
622;13.08.2017;2017;08;03;Sunnuntai;6;1;7
622;13.08.2017;2017;08;04;Sunnuntai;7;0;7
622;13.08.2017;2017;08;05;Sunnuntai;3;1;4
622;13.08.2017;2017;08;06;Sunnuntai;4;4;8
622;13.08.2017;2017;08;07;Sunnuntai;4;2;6
622;13.08.2017;2017;08;08;Sunnuntai;0;1;1
622;13.08.2017;2017;08;09;Sunnuntai;2;8;10
622;13.08.2017;2017;08;10;Sunnuntai;3;11;14
622;13.08.2017;2017;08;11;Sunnuntai;5;14;19
622;13.08.2017;2017;08;12;Sunnuntai;17;14;31
622;13.08.2017;2017;08;13;Sunnuntai;13;10;23
622;13.08.2017;2017;08;14;Sunnuntai;6;8;14
622;13.08.2017;2017;08;15;Sunnuntai;14;14;28
622;13.08.2017;2017;08;16;Sunnuntai;20;13;33
622;13.08.2017;2017;08;17;Sunnuntai;15;19;34
622;13.08.2017;2017;08;18;Sunnuntai;29;18;47
622;13.08.2017;2017;08;19;Sunnuntai;20;17;37
622;13.08.2017;2017;08;20;Sunnuntai;28;27;55
622;13.08.2017;2017;08;21;Sunnuntai;20;13;33
622;13.08.2017;2017;08;22;Sunnuntai;19;16;35
622;13.08.2017;2017;08;23;Sunnuntai;10;8;18
622;14.08.2017;2017;08;00;Maanantai;3;1;4
622;14.08.2017;2017;08;01;Maanantai;0;3;3
622;14.08.2017;2017;08;02;Maanantai;4;1;5
622;14.08.2017;2017;08;03;Maanantai;1;0;1
622;14.08.2017;2017;08;04;Maanantai;3;0;3
622;14.08.2017;2017;08;05;Maanantai;4;1;5
622;14.08.2017;2017;08;06;Maanantai;2;14;16
622;14.08.2017;2017;08;07;Maanantai;25;28;53
622;14.08.2017;2017;08;08;Maanantai;33;92;125
622;14.08.2017;2017;08;09;Maanantai;42;57;99
622;14.08.2017;2017;08;10;Maanantai;16;51;67
622;14.08.2017;2017;08;11;Maanantai;26;28;54
622;14.08.2017;2017;08;12;Maanantai;17;25;42
622;14.08.2017;2017;08;13;Maanantai;33;44;77
622;14.08.2017;2017;08;14;Maanantai;32;40;72
622;14.08.2017;2017;08;15;Maanantai;52;33;85
622;14.08.2017;2017;08;16;Maanantai;84;60;144
622;14.08.2017;2017;08;17;Maanantai;112;56;168
622;14.08.2017;2017;08;18;Maanantai;65;56;121
622;14.08.2017;2017;08;19;Maanantai;42;32;74
622;14.08.2017;2017;08;20;Maanantai;52;37;89
622;14.08.2017;2017;08;21;Maanantai;45;22;67
622;14.08.2017;2017;08;22;Maanantai;30;21;51
622;14.08.2017;2017;08;23;Maanantai;14;4;18
622;15.08.2017;2017;08;00;Tiistai;6;1;7
622;15.08.2017;2017;08;01;Tiistai;4;1;5
622;15.08.2017;2017;08;02;Tiistai;1;2;3
622;15.08.2017;2017;08;03;Tiistai;2;0;2
622;15.08.2017;2017;08;04;Tiistai;0;0;0
622;15.08.2017;2017;08;05;Tiistai;1;1;2
622;15.08.2017;2017;08;06;Tiistai;2;9;11
622;15.08.2017;2017;08;07;Tiistai;21;59;80
622;15.08.2017;2017;08;08;Tiistai;39;89;128
622;15.08.2017;2017;08;09;Tiistai;49;78;127
622;15.08.2017;2017;08;10;Tiistai;31;44;75
622;15.08.2017;2017;08;11;Tiistai;32;35;67
622;15.08.2017;2017;08;12;Tiistai;41;40;81
622;15.08.2017;2017;08;13;Tiistai;51;24;75
622;15.08.2017;2017;08;14;Tiistai;46;42;88
622;15.08.2017;2017;08;15;Tiistai;71;51;122
622;15.08.2017;2017;08;16;Tiistai;108;47;155
622;15.08.2017;2017;08;17;Tiistai;131;76;207
622;15.08.2017;2017;08;18;Tiistai;77;56;133
622;15.08.2017;2017;08;19;Tiistai;58;51;109
622;15.08.2017;2017;08;20;Tiistai;50;35;85
622;15.08.2017;2017;08;21;Tiistai;59;22;81
622;15.08.2017;2017;08;22;Tiistai;36;14;50
622;15.08.2017;2017;08;23;Tiistai;9;10;19
622;16.08.2017;2017;08;00;Keskiviikko;6;1;7
622;16.08.2017;2017;08;01;Keskiviikko;3;5;8
622;16.08.2017;2017;08;02;Keskiviikko;0;1;1
622;16.08.2017;2017;08;03;Keskiviikko;2;0;2
622;16.08.2017;2017;08;04;Keskiviikko;0;0;0
622;16.08.2017;2017;08;05;Keskiviikko;1;3;4
622;16.08.2017;2017;08;06;Keskiviikko;0;7;7
622;16.08.2017;2017;08;07;Keskiviikko;10;55;65
622;16.08.2017;2017;08;08;Keskiviikko;35;102;137
622;16.08.2017;2017;08;09;Keskiviikko;43;77;120
622;16.08.2017;2017;08;10;Keskiviikko;26;60;86
622;16.08.2017;2017;08;11;Keskiviikko;17;29;46
622;16.08.2017;2017;08;12;Keskiviikko;30;34;64
622;16.08.2017;2017;08;13;Keskiviikko;40;45;85
622;16.08.2017;2017;08;14;Keskiviikko;45;47;92
622;16.08.2017;2017;08;15;Keskiviikko;63;50;113
622;16.08.2017;2017;08;16;Keskiviikko;108;67;175
622;16.08.2017;2017;08;17;Keskiviikko;127;70;197
622;16.08.2017;2017;08;18;Keskiviikko;100;77;177
622;16.08.2017;2017;08;19;Keskiviikko;50;34;84
622;16.08.2017;2017;08;20;Keskiviikko;81;42;123
622;16.08.2017;2017;08;21;Keskiviikko;39;24;63
622;16.08.2017;2017;08;22;Keskiviikko;29;21;50
622;16.08.2017;2017;08;23;Keskiviikko;16;9;25
622;17.08.2017;2017;08;00;Torstai;10;1;11
622;17.08.2017;2017;08;01;Torstai;4;0;4
622;17.08.2017;2017;08;02;Torstai;3;0;3
622;17.08.2017;2017;08;03;Torstai;1;1;2
622;17.08.2017;2017;08;04;Torstai;1;0;1
622;17.08.2017;2017;08;05;Torstai;1;3;4
622;17.08.2017;2017;08;06;Torstai;2;7;9
622;17.08.2017;2017;08;07;Torstai;14;43;57
622;17.08.2017;2017;08;08;Torstai;50;84;134
622;17.08.2017;2017;08;09;Torstai;31;68;99
622;17.08.2017;2017;08;10;Torstai;23;46;69
622;17.08.2017;2017;08;11;Torstai;23;33;56
622;17.08.2017;2017;08;12;Torstai;29;35;64
622;17.08.2017;2017;08;13;Torstai;38;46;84
622;17.08.2017;2017;08;14;Torstai;41;45;86
622;17.08.2017;2017;08;15;Torstai;66;61;127
622;17.08.2017;2017;08;16;Torstai;92;60;152
622;17.08.2017;2017;08;17;Torstai;108;79;187
622;17.08.2017;2017;08;18;Torstai;80;83;163
622;17.08.2017;2017;08;19;Torstai;59;47;106
622;17.08.2017;2017;08;20;Torstai;63;46;109
622;17.08.2017;2017;08;21;Torstai;43;30;73
622;17.08.2017;2017;08;22;Torstai;52;15;67
622;17.08.2017;2017;08;23;Torstai;20;10;30
622;18.08.2017;2017;08;00;Perjantai;25;6;31
622;18.08.2017;2017;08;01;Perjantai;11;3;14
622;18.08.2017;2017;08;02;Perjantai;4;2;6
622;18.08.2017;2017;08;03;Perjantai;3;1;4
622;18.08.2017;2017;08;04;Perjantai;6;1;7
622;18.08.2017;2017;08;05;Perjantai;3;2;5
622;18.08.2017;2017;08;06;Perjantai;1;9;10
622;18.08.2017;2017;08;07;Perjantai;8;45;53
622;18.08.2017;2017;08;08;Perjantai;37;78;115
622;18.08.2017;2017;08;09;Perjantai;32;60;92
622;18.08.2017;2017;08;10;Perjantai;14;40;54
622;18.08.2017;2017;08;11;Perjantai;22;37;59
622;18.08.2017;2017;08;12;Perjantai;35;44;79
622;18.08.2017;2017;08;13;Perjantai;42;41;83
622;18.08.2017;2017;08;14;Perjantai;63;45;108
622;18.08.2017;2017;08;15;Perjantai;83;47;130
622;18.08.2017;2017;08;16;Perjantai;84;39;123
622;18.08.2017;2017;08;17;Perjantai;64;47;111
622;18.08.2017;2017;08;18;Perjantai;41;44;85
622;18.08.2017;2017;08;19;Perjantai;48;56;104
622;18.08.2017;2017;08;20;Perjantai;50;35;85
622;18.08.2017;2017;08;21;Perjantai;39;24;63
622;18.08.2017;2017;08;22;Perjantai;43;17;60
622;18.08.2017;2017;08;23;Perjantai;21;8;29
622;19.08.2017;2017;08;00;Lauantai;13;3;16
622;19.08.2017;2017;08;01;Lauantai;3;6;9
622;19.08.2017;2017;08;02;Lauantai;2;7;9
622;19.08.2017;2017;08;03;Lauantai;4;0;4
622;19.08.2017;2017;08;04;Lauantai;1;2;3
622;19.08.2017;2017;08;05;Lauantai;3;0;3
622;19.08.2017;2017;08;06;Lauantai;3;2;5
622;19.08.2017;2017;08;07;Lauantai;6;4;10
622;19.08.2017;2017;08;08;Lauantai;3;4;7
622;19.08.2017;2017;08;09;Lauantai;4;9;13
622;19.08.2017;2017;08;10;Lauantai;6;17;23
622;19.08.2017;2017;08;11;Lauantai;15;30;45
622;19.08.2017;2017;08;12;Lauantai;34;74;108
622;19.08.2017;2017;08;13;Lauantai;35;64;99
622;19.08.2017;2017;08;14;Lauantai;51;57;108
622;19.08.2017;2017;08;15;Lauantai;69;49;118
622;19.08.2017;2017;08;16;Lauantai;66;51;117
622;19.08.2017;2017;08;17;Lauantai;59;54;113
622;19.08.2017;2017;08;18;Lauantai;30;29;59
622;19.08.2017;2017;08;19;Lauantai;38;31;69
622;19.08.2017;2017;08;20;Lauantai;24;20;44
622;19.08.2017;2017;08;21;Lauantai;10;11;21
622;19.08.2017;2017;08;22;Lauantai;10;5;15
622;19.08.2017;2017;08;23;Lauantai;12;1;13
622;20.08.2017;2017;08;00;Sunnuntai;8;6;14
622;20.08.2017;2017;08;01;Sunnuntai;3;4;7
622;20.08.2017;2017;08;02;Sunnuntai;2;5;7
622;20.08.2017;2017;08;03;Sunnuntai;5;1;6
622;20.08.2017;2017;08;04;Sunnuntai;8;4;12
622;20.08.2017;2017;08;05;Sunnuntai;5;1;6
622;20.08.2017;2017;08;06;Sunnuntai;2;0;2
622;20.08.2017;2017;08;07;Sunnuntai;3;9;12
622;20.08.2017;2017;08;08;Sunnuntai;3;5;8
622;20.08.2017;2017;08;09;Sunnuntai;0;12;12
622;20.08.2017;2017;08;10;Sunnuntai;8;11;19
622;20.08.2017;2017;08;11;Sunnuntai;22;25;47
622;20.08.2017;2017;08;12;Sunnuntai;26;38;64
622;20.08.2017;2017;08;13;Sunnuntai;30;28;58
622;20.08.2017;2017;08;14;Sunnuntai;26;45;71
622;20.08.2017;2017;08;15;Sunnuntai;48;39;87
622;20.08.2017;2017;08;16;Sunnuntai;22;44;66
622;20.08.2017;2017;08;17;Sunnuntai;39;29;68
622;20.08.2017;2017;08;18;Sunnuntai;48;30;78
622;20.08.2017;2017;08;19;Sunnuntai;30;25;55
622;20.08.2017;2017;08;20;Sunnuntai;36;22;58
622;20.08.2017;2017;08;21;Sunnuntai;27;22;49
622;20.08.2017;2017;08;22;Sunnuntai;19;10;29
622;20.08.2017;2017;08;23;Sunnuntai;10;9;19
622;21.08.2017;2017;08;00;Maanantai;6;2;8
622;21.08.2017;2017;08;01;Maanantai;1;1;2
622;21.08.2017;2017;08;02;Maanantai;1;0;1
622;21.08.2017;2017;08;03;Maanantai;1;0;1
622;21.08.2017;2017;08;04;Maanantai;0;0;0
622;21.08.2017;2017;08;05;Maanantai;0;5;5
622;21.08.2017;2017;08;06;Maanantai;2;15;17
622;21.08.2017;2017;08;07;Maanantai;14;46;60
622;21.08.2017;2017;08;08;Maanantai;40;89;129
622;21.08.2017;2017;08;09;Maanantai;44;86;130
622;21.08.2017;2017;08;10;Maanantai;19;57;76
622;21.08.2017;2017;08;11;Maanantai;21;26;47
622;21.08.2017;2017;08;12;Maanantai;23;26;49
622;21.08.2017;2017;08;13;Maanantai;25;30;55
622;21.08.2017;2017;08;14;Maanantai;48;45;93
622;21.08.2017;2017;08;15;Maanantai;80;56;136
622;21.08.2017;2017;08;16;Maanantai;78;52;130
622;21.08.2017;2017;08;17;Maanantai;134;67;201
622;21.08.2017;2017;08;18;Maanantai;83;51;134
622;21.08.2017;2017;08;19;Maanantai;43;37;80
622;21.08.2017;2017;08;20;Maanantai;41;24;65
622;21.08.2017;2017;08;21;Maanantai;31;19;50
622;21.08.2017;2017;08;22;Maanantai;29;24;53
622;21.08.2017;2017;08;23;Maanantai;13;9;22
622;22.08.2017;2017;08;00;Tiistai;7;1;8
622;22.08.2017;2017;08;01;Tiistai;3;3;6
622;22.08.2017;2017;08;02;Tiistai;2;0;2
622;22.08.2017;2017;08;03;Tiistai;0;1;1
622;22.08.2017;2017;08;04;Tiistai;0;1;1
622;22.08.2017;2017;08;05;Tiistai;0;1;1
622;22.08.2017;2017;08;06;Tiistai;1;13;14
622;22.08.2017;2017;08;07;Tiistai;13;59;72
622;22.08.2017;2017;08;08;Tiistai;42;81;123
622;22.08.2017;2017;08;09;Tiistai;39;85;124
622;22.08.2017;2017;08;10;Tiistai;23;55;78
622;22.08.2017;2017;08;11;Tiistai;22;31;53
622;22.08.2017;2017;08;12;Tiistai;32;38;70
622;22.08.2017;2017;08;13;Tiistai;37;42;79
622;22.08.2017;2017;08;14;Tiistai;34;27;61
622;22.08.2017;2017;08;15;Tiistai;55;34;89
622;22.08.2017;2017;08;16;Tiistai;102;64;166
622;22.08.2017;2017;08;17;Tiistai;99;56;155
622;22.08.2017;2017;08;18;Tiistai;81;54;135
622;22.08.2017;2017;08;19;Tiistai;62;38;100
622;22.08.2017;2017;08;20;Tiistai;32;27;59
622;22.08.2017;2017;08;21;Tiistai;34;23;57
622;22.08.2017;2017;08;22;Tiistai;19;10;29
622;22.08.2017;2017;08;23;Tiistai;9;5;14
622;23.08.2017;2017;08;00;Keskiviikko;6;0;6
622;23.08.2017;2017;08;01;Keskiviikko;2;0;2
622;23.08.2017;2017;08;02;Keskiviikko;0;0;0
622;23.08.2017;2017;08;03;Keskiviikko;2;0;2
622;23.08.2017;2017;08;04;Keskiviikko;0;0;0
622;23.08.2017;2017;08;05;Keskiviikko;1;3;4
622;23.08.2017;2017;08;06;Keskiviikko;3;11;14
622;23.08.2017;2017;08;07;Keskiviikko;14;61;75
622;23.08.2017;2017;08;08;Keskiviikko;46;93;139
622;23.08.2017;2017;08;09;Keskiviikko;33;87;120
622;23.08.2017;2017;08;10;Keskiviikko;23;43;66
622;23.08.2017;2017;08;11;Keskiviikko;24;26;50
622;23.08.2017;2017;08;12;Keskiviikko;29;30;59
622;23.08.2017;2017;08;13;Keskiviikko;28;40;68
622;23.08.2017;2017;08;14;Keskiviikko;33;38;71
622;23.08.2017;2017;08;15;Keskiviikko;64;59;123
622;23.08.2017;2017;08;16;Keskiviikko;93;54;147
622;23.08.2017;2017;08;17;Keskiviikko;114;58;172
622;23.08.2017;2017;08;18;Keskiviikko;52;49;101
622;23.08.2017;2017;08;19;Keskiviikko;69;38;107
622;23.08.2017;2017;08;20;Keskiviikko;65;23;88
622;23.08.2017;2017;08;21;Keskiviikko;46;25;71
622;23.08.2017;2017;08;22;Keskiviikko;26;11;37
622;23.08.2017;2017;08;23;Keskiviikko;5;5;10
622;24.08.2017;2017;08;00;Torstai;3;2;5
622;24.08.2017;2017;08;01;Torstai;4;1;5
622;24.08.2017;2017;08;02;Torstai;0;0;0
622;24.08.2017;2017;08;03;Torstai;1;2;3
622;24.08.2017;2017;08;04;Torstai;0;1;1
622;24.08.2017;2017;08;05;Torstai;1;2;3
622;24.08.2017;2017;08;06;Torstai;1;9;10
622;24.08.2017;2017;08;07;Torstai;9;43;52
622;24.08.2017;2017;08;08;Torstai;32;77;109
622;24.08.2017;2017;08;09;Torstai;23;74;97
622;24.08.2017;2017;08;10;Torstai;18;34;52
622;24.08.2017;2017;08;11;Torstai;22;33;55
622;24.08.2017;2017;08;12;Torstai;27;38;65
622;24.08.2017;2017;08;13;Torstai;41;71;112
622;24.08.2017;2017;08;14;Torstai;30;44;74
622;24.08.2017;2017;08;15;Torstai;95;63;158
622;24.08.2017;2017;08;16;Torstai;94;49;143
622;24.08.2017;2017;08;17;Torstai;99;66;165
622;24.08.2017;2017;08;18;Torstai;60;38;98
622;24.08.2017;2017;08;19;Torstai;43;28;71
622;24.08.2017;2017;08;20;Torstai;47;33;80
622;24.08.2017;2017;08;21;Torstai;33;15;48
622;24.08.2017;2017;08;22;Torstai;20;8;28
622;24.08.2017;2017;08;23;Torstai;8;4;12
622;25.08.2017;2017;08;00;Perjantai;6;4;10
622;25.08.2017;2017;08;01;Perjantai;6;3;9
622;25.08.2017;2017;08;02;Perjantai;2;0;2
622;25.08.2017;2017;08;03;Perjantai;2;0;2
622;25.08.2017;2017;08;04;Perjantai;0;0;0
622;25.08.2017;2017;08;05;Perjantai;1;1;2
622;25.08.2017;2017;08;06;Perjantai;1;8;9
622;25.08.2017;2017;08;07;Perjantai;13;32;45
622;25.08.2017;2017;08;08;Perjantai;36;66;102
622;25.08.2017;2017;08;09;Perjantai;16;47;63
622;25.08.2017;2017;08;10;Perjantai;12;30;42
622;25.08.2017;2017;08;11;Perjantai;13;16;29
622;25.08.2017;2017;08;12;Perjantai;8;20;28
622;25.08.2017;2017;08;13;Perjantai;19;29;48
622;25.08.2017;2017;08;14;Perjantai;21;24;45
622;25.08.2017;2017;08;15;Perjantai;59;22;81
622;25.08.2017;2017;08;16;Perjantai;48;30;78
622;25.08.2017;2017;08;17;Perjantai;45;23;68
622;25.08.2017;2017;08;18;Perjantai;23;24;47
622;25.08.2017;2017;08;19;Perjantai;17;19;36
622;25.08.2017;2017;08;20;Perjantai;18;17;35
622;25.08.2017;2017;08;21;Perjantai;7;11;18
622;25.08.2017;2017;08;22;Perjantai;6;4;10
622;25.08.2017;2017;08;23;Perjantai;11;5;16
622;26.08.2017;2017;08;00;Lauantai;8;1;9
622;26.08.2017;2017;08;01;Lauantai;4;1;5
622;26.08.2017;2017;08;02;Lauantai;6;2;8
622;26.08.2017;2017;08;03;Lauantai;2;1;3
622;26.08.2017;2017;08;04;Lauantai;4;0;4
622;26.08.2017;2017;08;05;Lauantai;6;2;8
622;26.08.2017;2017;08;06;Lauantai;2;2;4
622;26.08.2017;2017;08;07;Lauantai;3;2;5
622;26.08.2017;2017;08;08;Lauantai;8;5;13
622;26.08.2017;2017;08;09;Lauantai;6;7;13
622;26.08.2017;2017;08;10;Lauantai;5;18;23
622;26.08.2017;2017;08;11;Lauantai;9;16;25
622;26.08.2017;2017;08;12;Lauantai;14;34;48
622;26.08.2017;2017;08;13;Lauantai;21;30;51
622;26.08.2017;2017;08;14;Lauantai;27;40;67
622;26.08.2017;2017;08;15;Lauantai;19;31;50
622;26.08.2017;2017;08;16;Lauantai;24;23;47
622;26.08.2017;2017;08;17;Lauantai;29;44;73
622;26.08.2017;2017;08;18;Lauantai;32;50;82
622;26.08.2017;2017;08;19;Lauantai;33;48;81
622;26.08.2017;2017;08;20;Lauantai;27;29;56
622;26.08.2017;2017;08;21;Lauantai;26;17;43
622;26.08.2017;2017;08;22;Lauantai;26;12;38
622;26.08.2017;2017;08;23;Lauantai;15;9;24
622;27.08.2017;2017;08;00;Sunnuntai;16;9;25
622;27.08.2017;2017;08;01;Sunnuntai;40;8;48
622;27.08.2017;2017;08;02;Sunnuntai;8;0;8
622;27.08.2017;2017;08;03;Sunnuntai;9;4;13
622;27.08.2017;2017;08;04;Sunnuntai;2;0;2
622;27.08.2017;2017;08;05;Sunnuntai;4;1;5
622;27.08.2017;2017;08;06;Sunnuntai;1;1;2
622;27.08.2017;2017;08;07;Sunnuntai;3;4;7
622;27.08.2017;2017;08;08;Sunnuntai;6;4;10
622;27.08.2017;2017;08;09;Sunnuntai;6;7;13
622;27.08.2017;2017;08;10;Sunnuntai;3;12;15
622;27.08.2017;2017;08;11;Sunnuntai;12;17;29
622;27.08.2017;2017;08;12;Sunnuntai;19;31;50
622;27.08.2017;2017;08;13;Sunnuntai;28;39;67
622;27.08.2017;2017;08;14;Sunnuntai;34;32;66
622;27.08.2017;2017;08;15;Sunnuntai;50;32;82
622;27.08.2017;2017;08;16;Sunnuntai;40;36;76
622;27.08.2017;2017;08;17;Sunnuntai;33;32;65
622;27.08.2017;2017;08;18;Sunnuntai;46;38;84
622;27.08.2017;2017;08;19;Sunnuntai;32;29;61
622;27.08.2017;2017;08;20;Sunnuntai;23;23;46
622;27.08.2017;2017;08;21;Sunnuntai;20;14;34
622;27.08.2017;2017;08;22;Sunnuntai;8;13;21
622;27.08.2017;2017;08;23;Sunnuntai;5;3;8
622;28.08.2017;2017;08;00;Maanantai;1;1;2
622;28.08.2017;2017;08;01;Maanantai;3;2;5
622;28.08.2017;2017;08;02;Maanantai;0;0;0
622;28.08.2017;2017;08;03;Maanantai;1;1;2
622;28.08.2017;2017;08;04;Maanantai;0;0;0
622;28.08.2017;2017;08;05;Maanantai;1;2;3
622;28.08.2017;2017;08;06;Maanantai;2;9;11
622;28.08.2017;2017;08;07;Maanantai;13;49;62
622;28.08.2017;2017;08;08;Maanantai;38;85;123
622;28.08.2017;2017;08;09;Maanantai;38;70;108
622;28.08.2017;2017;08;10;Maanantai;23;69;92
622;28.08.2017;2017;08;11;Maanantai;21;31;52
622;28.08.2017;2017;08;12;Maanantai;25;46;71
622;28.08.2017;2017;08;13;Maanantai;30;37;67
622;28.08.2017;2017;08;14;Maanantai;32;40;72
622;28.08.2017;2017;08;15;Maanantai;61;52;113
622;28.08.2017;2017;08;16;Maanantai;93;51;144
622;28.08.2017;2017;08;17;Maanantai;117;41;158
622;28.08.2017;2017;08;18;Maanantai;79;59;138
622;28.08.2017;2017;08;19;Maanantai;47;24;71
622;28.08.2017;2017;08;20;Maanantai;42;32;74
622;28.08.2017;2017;08;21;Maanantai;44;16;60
622;28.08.2017;2017;08;22;Maanantai;22;11;33
622;28.08.2017;2017;08;23;Maanantai;13;6;19
622;29.08.2017;2017;08;00;Tiistai;5;1;6
622;29.08.2017;2017;08;01;Tiistai;3;0;3
622;29.08.2017;2017;08;02;Tiistai;2;0;2
622;29.08.2017;2017;08;03;Tiistai;0;0;0
622;29.08.2017;2017;08;04;Tiistai;1;0;1
622;29.08.2017;2017;08;05;Tiistai;0;1;1
622;29.08.2017;2017;08;06;Tiistai;2;9;11
622;29.08.2017;2017;08;07;Tiistai;7;41;48
622;29.08.2017;2017;08;08;Tiistai;35;64;99
622;29.08.2017;2017;08;09;Tiistai;24;71;95
622;29.08.2017;2017;08;10;Tiistai;22;38;60
622;29.08.2017;2017;08;11;Tiistai;18;21;39
622;29.08.2017;2017;08;12;Tiistai;33;31;64
622;29.08.2017;2017;08;13;Tiistai;37;38;75
622;29.08.2017;2017;08;14;Tiistai;30;28;58
622;29.08.2017;2017;08;15;Tiistai;46;37;83
622;29.08.2017;2017;08;16;Tiistai;68;38;106
622;29.08.2017;2017;08;17;Tiistai;59;31;90
622;29.08.2017;2017;08;18;Tiistai;27;25;52
622;29.08.2017;2017;08;19;Tiistai;22;14;36
622;29.08.2017;2017;08;20;Tiistai;19;9;28
622;29.08.2017;2017;08;21;Tiistai;23;7;30
622;29.08.2017;2017;08;22;Tiistai;7;6;13
622;29.08.2017;2017;08;23;Tiistai;3;5;8
622;30.08.2017;2017;08;00;Keskiviikko;3;0;3
622;30.08.2017;2017;08;01;Keskiviikko;2;0;2
622;30.08.2017;2017;08;02;Keskiviikko;3;1;4
622;30.08.2017;2017;08;03;Keskiviikko;1;1;2
622;30.08.2017;2017;08;04;Keskiviikko;1;0;1
622;30.08.2017;2017;08;05;Keskiviikko;1;3;4
622;30.08.2017;2017;08;06;Keskiviikko;0;3;3
622;30.08.2017;2017;08;07;Keskiviikko;5;20;25
622;30.08.2017;2017;08;08;Keskiviikko;25;47;72
622;30.08.2017;2017;08;09;Keskiviikko;28;45;73
622;30.08.2017;2017;08;10;Keskiviikko;9;18;27
622;30.08.2017;2017;08;11;Keskiviikko;6;4;10
622;30.08.2017;2017;08;12;Keskiviikko;4;9;13
622;30.08.2017;2017;08;13;Keskiviikko;13;14;27
622;30.08.2017;2017;08;14;Keskiviikko;23;27;50
622;30.08.2017;2017;08;15;Keskiviikko;30;30;60
622;30.08.2017;2017;08;16;Keskiviikko;49;42;91
622;30.08.2017;2017;08;17;Keskiviikko;85;34;119
622;30.08.2017;2017;08;18;Keskiviikko;51;51;102
622;30.08.2017;2017;08;19;Keskiviikko;55;43;98
622;30.08.2017;2017;08;20;Keskiviikko;43;28;71
622;30.08.2017;2017;08;21;Keskiviikko;27;31;58
622;30.08.2017;2017;08;22;Keskiviikko;24;7;31
622;30.08.2017;2017;08;23;Keskiviikko;8;4;12
622;31.08.2017;2017;08;00;Torstai;4;1;5
622;31.08.2017;2017;08;01;Torstai;1;1;2
622;31.08.2017;2017;08;02;Torstai;2;0;2
622;31.08.2017;2017;08;03;Torstai;0;0;0
622;31.08.2017;2017;08;04;Torstai;1;0;1
622;31.08.2017;2017;08;05;Torstai;1;0;1
622;31.08.2017;2017;08;06;Torstai;1;14;15
622;31.08.2017;2017;08;07;Torstai;11;39;50
622;31.08.2017;2017;08;08;Torstai;41;95;136
622;31.08.2017;2017;08;09;Torstai;28;74;102
622;31.08.2017;2017;08;10;Torstai;21;49;70
622;31.08.2017;2017;08;11;Torstai;20;34;54
622;31.08.2017;2017;08;12;Torstai;39;48;87
622;31.08.2017;2017;08;13;Torstai;41;54;95
622;31.08.2017;2017;08;14;Torstai;53;58;111
622;31.08.2017;2017;08;15;Torstai;68;46;114
622;31.08.2017;2017;08;16;Torstai;94;60;154
622;31.08.2017;2017;08;17;Torstai;121;70;191
622;31.08.2017;2017;08;18;Torstai;79;54;133
622;31.08.2017;2017;08;19;Torstai;62;37;99
622;31.08.2017;2017;08;20;Torstai;39;32;71
622;31.08.2017;2017;08;21;Torstai;33;23;56
622;31.08.2017;2017;08;22;Torstai;33;13;46
622;31.08.2017;2017;08;23;Torstai;17;8;25
622;01.09.2017;2017;09;00;Perjantai;7;3;10
622;01.09.2017;2017;09;01;Perjantai;4;2;6
622;01.09.2017;2017;09;02;Perjantai;2;0;2
622;01.09.2017;2017;09;03;Perjantai;1;0;1
622;01.09.2017;2017;09;04;Perjantai;0;0;0
622;01.09.2017;2017;09;05;Perjantai;1;1;2
622;01.09.2017;2017;09;06;Perjantai;2;8;10
622;01.09.2017;2017;09;07;Perjantai;4;21;25
622;01.09.2017;2017;09;08;Perjantai;19;33;52
622;01.09.2017;2017;09;09;Perjantai;17;22;39
622;01.09.2017;2017;09;10;Perjantai;8;16;24
622;01.09.2017;2017;09;11;Perjantai;10;12;22
622;01.09.2017;2017;09;12;Perjantai;14;15;29
622;01.09.2017;2017;09;13;Perjantai;14;27;41
622;01.09.2017;2017;09;14;Perjantai;20;23;43
622;01.09.2017;2017;09;15;Perjantai;23;27;50
622;01.09.2017;2017;09;16;Perjantai;32;18;50
622;01.09.2017;2017;09;17;Perjantai;32;26;58
622;01.09.2017;2017;09;18;Perjantai;13;19;32
622;01.09.2017;2017;09;19;Perjantai;21;19;40
622;01.09.2017;2017;09;20;Perjantai;23;24;47
622;01.09.2017;2017;09;21;Perjantai;18;14;32
622;01.09.2017;2017;09;22;Perjantai;16;9;25
622;01.09.2017;2017;09;23;Perjantai;7;6;13
622;02.09.2017;2017;09;00;Lauantai;5;11;16
622;02.09.2017;2017;09;01;Lauantai;6;6;12
622;02.09.2017;2017;09;02;Lauantai;1;7;8
622;02.09.2017;2017;09;03;Lauantai;2;0;2
622;02.09.2017;2017;09;04;Lauantai;8;2;10
622;02.09.2017;2017;09;05;Lauantai;3;1;4
622;02.09.2017;2017;09;06;Lauantai;0;2;2
622;02.09.2017;2017;09;07;Lauantai;2;8;10
622;02.09.2017;2017;09;08;Lauantai;4;3;7
622;02.09.2017;2017;09;09;Lauantai;2;10;12
622;02.09.2017;2017;09;10;Lauantai;16;28;44
622;02.09.2017;2017;09;11;Lauantai;27;32;59
622;02.09.2017;2017;09;12;Lauantai;32;46;78
622;02.09.2017;2017;09;13;Lauantai;26;35;61
622;02.09.2017;2017;09;14;Lauantai;35;62;97
622;02.09.2017;2017;09;15;Lauantai;53;70;123
622;02.09.2017;2017;09;16;Lauantai;52;51;103
622;02.09.2017;2017;09;17;Lauantai;61;48;109
622;02.09.2017;2017;09;18;Lauantai;49;46;95
622;02.09.2017;2017;09;19;Lauantai;47;28;75
622;02.09.2017;2017;09;20;Lauantai;30;32;62
622;02.09.2017;2017;09;21;Lauantai;39;22;61
622;02.09.2017;2017;09;22;Lauantai;14;9;23
622;02.09.2017;2017;09;23;Lauantai;18;14;32
622;03.09.2017;2017;09;00;Sunnuntai;13;5;18
622;03.09.2017;2017;09;01;Sunnuntai;10;7;17
622;03.09.2017;2017;09;02;Sunnuntai;9;1;10
622;03.09.2017;2017;09;03;Sunnuntai;10;2;12
622;03.09.2017;2017;09;04;Sunnuntai;7;2;9
622;03.09.2017;2017;09;05;Sunnuntai;8;0;8
622;03.09.2017;2017;09;06;Sunnuntai;2;2;4
622;03.09.2017;2017;09;07;Sunnuntai;6;2;8
622;03.09.2017;2017;09;08;Sunnuntai;4;1;5
622;03.09.2017;2017;09;09;Sunnuntai;2;4;6
622;03.09.2017;2017;09;10;Sunnuntai;7;12;19
622;03.09.2017;2017;09;11;Sunnuntai;4;11;15
622;03.09.2017;2017;09;12;Sunnuntai;13;14;27
622;03.09.2017;2017;09;13;Sunnuntai;25;19;44
622;03.09.2017;2017;09;14;Sunnuntai;43;54;97
622;03.09.2017;2017;09;15;Sunnuntai;57;63;120
622;03.09.2017;2017;09;16;Sunnuntai;49;43;92
622;03.09.2017;2017;09;17;Sunnuntai;39;45;84
622;03.09.2017;2017;09;18;Sunnuntai;59;52;111
622;03.09.2017;2017;09;19;Sunnuntai;56;43;99
622;03.09.2017;2017;09;20;Sunnuntai;48;29;77
622;03.09.2017;2017;09;21;Sunnuntai;31;27;58
622;03.09.2017;2017;09;22;Sunnuntai;17;15;32
622;03.09.2017;2017;09;23;Sunnuntai;7;2;9
622;04.09.2017;2017;09;00;Maanantai;3;5;8
622;04.09.2017;2017;09;01;Maanantai;1;0;1
622;04.09.2017;2017;09;02;Maanantai;0;0;0
622;04.09.2017;2017;09;03;Maanantai;0;0;0
622;04.09.2017;2017;09;04;Maanantai;0;0;0
622;04.09.2017;2017;09;05;Maanantai;2;4;6
622;04.09.2017;2017;09;06;Maanantai;2;12;14
622;04.09.2017;2017;09;07;Maanantai;6;46;52
622;04.09.2017;2017;09;08;Maanantai;34;85;119
622;04.09.2017;2017;09;09;Maanantai;69;120;189
622;04.09.2017;2017;09;10;Maanantai;30;55;85
622;04.09.2017;2017;09;11;Maanantai;25;38;63
622;04.09.2017;2017;09;12;Maanantai;33;36;69
622;04.09.2017;2017;09;13;Maanantai;57;66;123
622;04.09.2017;2017;09;14;Maanantai;40;45;85
622;04.09.2017;2017;09;15;Maanantai;79;53;132
622;04.09.2017;2017;09;16;Maanantai;91;51;142
622;04.09.2017;2017;09;17;Maanantai;162;74;236
622;04.09.2017;2017;09;18;Maanantai;78;69;147
622;04.09.2017;2017;09;19;Maanantai;75;67;142
622;04.09.2017;2017;09;20;Maanantai;53;36;89
622;04.09.2017;2017;09;21;Maanantai;48;37;85
622;04.09.2017;2017;09;22;Maanantai;32;18;50
622;04.09.2017;2017;09;23;Maanantai;10;12;22
622;05.09.2017;2017;09;00;Tiistai;4;0;4
622;05.09.2017;2017;09;01;Tiistai;7;1;8
622;05.09.2017;2017;09;02;Tiistai;4;0;4
622;05.09.2017;2017;09;03;Tiistai;7;1;8
622;05.09.2017;2017;09;04;Tiistai;2;0;2
622;05.09.2017;2017;09;05;Tiistai;2;1;3
622;05.09.2017;2017;09;06;Tiistai;1;13;14
622;05.09.2017;2017;09;07;Tiistai;9;51;60
622;05.09.2017;2017;09;08;Tiistai;43;87;130
622;05.09.2017;2017;09;09;Tiistai;36;73;109
622;05.09.2017;2017;09;10;Tiistai;24;50;74
622;05.09.2017;2017;09;11;Tiistai;34;37;71
622;05.09.2017;2017;09;12;Tiistai;41;53;94
622;05.09.2017;2017;09;13;Tiistai;37;57;94
622;05.09.2017;2017;09;14;Tiistai;48;65;113
622;05.09.2017;2017;09;15;Tiistai;74;75;149
622;05.09.2017;2017;09;16;Tiistai;117;61;178
622;05.09.2017;2017;09;17;Tiistai;126;75;201
622;05.09.2017;2017;09;18;Tiistai;91;71;162
622;05.09.2017;2017;09;19;Tiistai;58;56;114
622;05.09.2017;2017;09;20;Tiistai;60;43;103
622;05.09.2017;2017;09;21;Tiistai;43;23;66
622;05.09.2017;2017;09;22;Tiistai;44;15;59
622;05.09.2017;2017;09;23;Tiistai;22;8;30
622;06.09.2017;2017;09;00;Keskiviikko;4;1;5
622;06.09.2017;2017;09;01;Keskiviikko;6;3;9
622;06.09.2017;2017;09;02;Keskiviikko;0;3;3
622;06.09.2017;2017;09;03;Keskiviikko;2;0;2
622;06.09.2017;2017;09;04;Keskiviikko;1;0;1
622;06.09.2017;2017;09;05;Keskiviikko;1;0;1
622;06.09.2017;2017;09;06;Keskiviikko;1;8;9
622;06.09.2017;2017;09;07;Keskiviikko;18;48;66
622;06.09.2017;2017;09;08;Keskiviikko;58;87;145
622;06.09.2017;2017;09;09;Keskiviikko;33;45;78
622;06.09.2017;2017;09;10;Keskiviikko;36;42;78
622;06.09.2017;2017;09;11;Keskiviikko;26;43;69
622;06.09.2017;2017;09;12;Keskiviikko;31;50;81
622;06.09.2017;2017;09;13;Keskiviikko;62;61;123
622;06.09.2017;2017;09;14;Keskiviikko;48;63;111
622;06.09.2017;2017;09;15;Keskiviikko;72;65;137
622;06.09.2017;2017;09;16;Keskiviikko;104;61;165
622;06.09.2017;2017;09;17;Keskiviikko;130;81;211
622;06.09.2017;2017;09;18;Keskiviikko;87;51;138
622;06.09.2017;2017;09;19;Keskiviikko;90;45;135
622;06.09.2017;2017;09;20;Keskiviikko;63;37;100
622;06.09.2017;2017;09;21;Keskiviikko;29;20;49
622;06.09.2017;2017;09;22;Keskiviikko;19;13;32
622;06.09.2017;2017;09;23;Keskiviikko;10;5;15
622;07.09.2017;2017;09;00;Torstai;5;4;9
622;07.09.2017;2017;09;01;Torstai;2;3;5
622;07.09.2017;2017;09;02;Torstai;1;1;2
622;07.09.2017;2017;09;03;Torstai;5;0;5
622;07.09.2017;2017;09;04;Torstai;7;1;8
622;07.09.2017;2017;09;05;Torstai;5;4;9
622;07.09.2017;2017;09;06;Torstai;2;15;17
622;07.09.2017;2017;09;07;Torstai;10;48;58
622;07.09.2017;2017;09;08;Torstai;52;91;143
622;07.09.2017;2017;09;09;Torstai;50;77;127
622;07.09.2017;2017;09;10;Torstai;26;45;71
622;07.09.2017;2017;09;11;Torstai;27;35;62
622;07.09.2017;2017;09;12;Torstai;27;41;68
622;07.09.2017;2017;09;13;Torstai;41;33;74
622;07.09.2017;2017;09;14;Torstai;36;40;76
622;07.09.2017;2017;09;15;Torstai;49;45;94
622;07.09.2017;2017;09;16;Torstai;97;63;160
622;07.09.2017;2017;09;17;Torstai;102;61;163
622;07.09.2017;2017;09;18;Torstai;72;51;123
622;07.09.2017;2017;09;19;Torstai;49;38;87
622;07.09.2017;2017;09;20;Torstai;52;35;87
622;07.09.2017;2017;09;21;Torstai;32;22;54
622;07.09.2017;2017;09;22;Torstai;32;15;47
622;07.09.2017;2017;09;23;Torstai;10;3;13
622;08.09.2017;2017;09;00;Perjantai;6;4;10
622;08.09.2017;2017;09;01;Perjantai;7;4;11
622;08.09.2017;2017;09;02;Perjantai;1;0;1
622;08.09.2017;2017;09;03;Perjantai;3;0;3
622;08.09.2017;2017;09;04;Perjantai;4;2;6
622;08.09.2017;2017;09;05;Perjantai;3;2;5
622;08.09.2017;2017;09;06;Perjantai;2;11;13
622;08.09.2017;2017;09;07;Perjantai;6;30;36
622;08.09.2017;2017;09;08;Perjantai;25;47;72
622;08.09.2017;2017;09;09;Perjantai;27;53;80
622;08.09.2017;2017;09;10;Perjantai;15;29;44
622;08.09.2017;2017;09;11;Perjantai;21;24;45
622;08.09.2017;2017;09;12;Perjantai;22;24;46
622;08.09.2017;2017;09;13;Perjantai;37;22;59
622;08.09.2017;2017;09;14;Perjantai;48;45;93
622;08.09.2017;2017;09;15;Perjantai;42;28;70
622;08.09.2017;2017;09;16;Perjantai;48;36;84
622;08.09.2017;2017;09;17;Perjantai;42;39;81
622;08.09.2017;2017;09;18;Perjantai;44;33;77
622;08.09.2017;2017;09;19;Perjantai;36;24;60
622;08.09.2017;2017;09;20;Perjantai;26;18;44
622;08.09.2017;2017;09;21;Perjantai;20;20;40
622;08.09.2017;2017;09;22;Perjantai;13;11;24
622;08.09.2017;2017;09;23;Perjantai;10;5;15
622;09.09.2017;2017;09;00;Lauantai;8;6;14
622;09.09.2017;2017;09;01;Lauantai;2;3;5
622;09.09.2017;2017;09;02;Lauantai;4;2;6
622;09.09.2017;2017;09;03;Lauantai;1;3;4
622;09.09.2017;2017;09;04;Lauantai;3;1;4
622;09.09.2017;2017;09;05;Lauantai;1;2;3
622;09.09.2017;2017;09;06;Lauantai;0;5;5
622;09.09.2017;2017;09;07;Lauantai;5;1;6
622;09.09.2017;2017;09;08;Lauantai;2;6;8
622;09.09.2017;2017;09;09;Lauantai;3;9;12
622;09.09.2017;2017;09;10;Lauantai;12;21;33
622;09.09.2017;2017;09;11;Lauantai;18;25;43
622;09.09.2017;2017;09;12;Lauantai;21;26;47
622;09.09.2017;2017;09;13;Lauantai;32;23;55
622;09.09.2017;2017;09;14;Lauantai;21;25;46
622;09.09.2017;2017;09;15;Lauantai;25;25;50
622;09.09.2017;2017;09;16;Lauantai;31;24;55
622;09.09.2017;2017;09;17;Lauantai;35;25;60
622;09.09.2017;2017;09;18;Lauantai;32;32;64
622;09.09.2017;2017;09;19;Lauantai;21;16;37
622;09.09.2017;2017;09;20;Lauantai;23;16;39
622;09.09.2017;2017;09;21;Lauantai;25;21;46
622;09.09.2017;2017;09;22;Lauantai;14;13;27
622;09.09.2017;2017;09;23;Lauantai;10;9;19
622;10.09.2017;2017;09;00;Sunnuntai;8;6;14
622;10.09.2017;2017;09;01;Sunnuntai;8;3;11
622;10.09.2017;2017;09;02;Sunnuntai;8;4;12
622;10.09.2017;2017;09;03;Sunnuntai;3;2;5
622;10.09.2017;2017;09;04;Sunnuntai;3;1;4
622;10.09.2017;2017;09;05;Sunnuntai;2;1;3
622;10.09.2017;2017;09;06;Sunnuntai;2;5;7
622;10.09.2017;2017;09;07;Sunnuntai;3;4;7
622;10.09.2017;2017;09;08;Sunnuntai;3;4;7
622;10.09.2017;2017;09;09;Sunnuntai;3;6;9
622;10.09.2017;2017;09;10;Sunnuntai;1;2;3
622;10.09.2017;2017;09;11;Sunnuntai;3;3;6
622;10.09.2017;2017;09;12;Sunnuntai;6;7;13
622;10.09.2017;2017;09;13;Sunnuntai;5;8;13
622;10.09.2017;2017;09;14;Sunnuntai;4;5;9
622;10.09.2017;2017;09;15;Sunnuntai;9;10;19
622;10.09.2017;2017;09;16;Sunnuntai;3;4;7
622;10.09.2017;2017;09;17;Sunnuntai;9;6;15
622;10.09.2017;2017;09;18;Sunnuntai;20;15;35
622;10.09.2017;2017;09;19;Sunnuntai;16;15;31
622;10.09.2017;2017;09;20;Sunnuntai;13;13;26
622;10.09.2017;2017;09;21;Sunnuntai;6;6;12
622;10.09.2017;2017;09;22;Sunnuntai;3;7;10
622;10.09.2017;2017;09;23;Sunnuntai;5;3;8
622;11.09.2017;2017;09;00;Maanantai;2;1;3
622;11.09.2017;2017;09;01;Maanantai;2;0;2
622;11.09.2017;2017;09;02;Maanantai;2;1;3
622;11.09.2017;2017;09;03;Maanantai;2;0;2
622;11.09.2017;2017;09;04;Maanantai;1;0;1
622;11.09.2017;2017;09;05;Maanantai;1;2;3
622;11.09.2017;2017;09;06;Maanantai;1;18;19
622;11.09.2017;2017;09;07;Maanantai;10;44;54
622;11.09.2017;2017;09;08;Maanantai;32;77;109
622;11.09.2017;2017;09;09;Maanantai;44;66;110
622;11.09.2017;2017;09;10;Maanantai;31;58;89
622;11.09.2017;2017;09;11;Maanantai;26;39;65
622;11.09.2017;2017;09;12;Maanantai;30;53;83
622;11.09.2017;2017;09;13;Maanantai;42;46;88
622;11.09.2017;2017;09;14;Maanantai;55;28;83
622;11.09.2017;2017;09;15;Maanantai;61;51;112
622;11.09.2017;2017;09;16;Maanantai;94;42;136
622;11.09.2017;2017;09;17;Maanantai;102;81;183
622;11.09.2017;2017;09;18;Maanantai;90;64;154
622;11.09.2017;2017;09;19;Maanantai;67;52;119
622;11.09.2017;2017;09;20;Maanantai;51;42;93
622;11.09.2017;2017;09;21;Maanantai;52;28;80
622;11.09.2017;2017;09;22;Maanantai;29;15;44
622;11.09.2017;2017;09;23;Maanantai;14;9;23
622;12.09.2017;2017;09;00;Tiistai;6;1;7
622;12.09.2017;2017;09;01;Tiistai;3;3;6
622;12.09.2017;2017;09;02;Tiistai;4;1;5
622;12.09.2017;2017;09;03;Tiistai;2;0;2
622;12.09.2017;2017;09;04;Tiistai;1;0;1
622;12.09.2017;2017;09;05;Tiistai;2;0;2
622;12.09.2017;2017;09;06;Tiistai;4;18;22
622;12.09.2017;2017;09;07;Tiistai;10;45;55
622;12.09.2017;2017;09;08;Tiistai;66;98;164
622;12.09.2017;2017;09;09;Tiistai;31;65;96
622;12.09.2017;2017;09;10;Tiistai;32;46;78
622;12.09.2017;2017;09;11;Tiistai;18;33;51
622;12.09.2017;2017;09;12;Tiistai;23;23;46
622;12.09.2017;2017;09;13;Tiistai;37;43;80
622;12.09.2017;2017;09;14;Tiistai;35;42;77
622;12.09.2017;2017;09;15;Tiistai;38;26;64
622;12.09.2017;2017;09;16;Tiistai;77;31;108
622;12.09.2017;2017;09;17;Tiistai;55;34;89
622;12.09.2017;2017;09;18;Tiistai;30;27;57
622;12.09.2017;2017;09;19;Tiistai;16;17;33
622;12.09.2017;2017;09;20;Tiistai;24;16;40
622;12.09.2017;2017;09;21;Tiistai;25;15;40
622;12.09.2017;2017;09;22;Tiistai;8;13;21
622;12.09.2017;2017;09;23;Tiistai;5;4;9
622;13.09.2017;2017;09;00;Keskiviikko;3;2;5
622;13.09.2017;2017;09;01;Keskiviikko;6;0;6
622;13.09.2017;2017;09;02;Keskiviikko;13;3;16
622;13.09.2017;2017;09;03;Keskiviikko;8;0;8
622;13.09.2017;2017;09;04;Keskiviikko;1;1;2
622;13.09.2017;2017;09;05;Keskiviikko;1;0;1
622;13.09.2017;2017;09;06;Keskiviikko;2;7;9
622;13.09.2017;2017;09;07;Keskiviikko;9;36;45
622;13.09.2017;2017;09;08;Keskiviikko;45;78;123
622;13.09.2017;2017;09;09;Keskiviikko;41;71;112
622;13.09.2017;2017;09;10;Keskiviikko;31;41;72
622;13.09.2017;2017;09;11;Keskiviikko;19;36;55
622;13.09.2017;2017;09;12;Keskiviikko;25;21;46
622;13.09.2017;2017;09;13;Keskiviikko;32;43;75
622;13.09.2017;2017;09;14;Keskiviikko;36;48;84
622;13.09.2017;2017;09;15;Keskiviikko;70;64;134
622;13.09.2017;2017;09;16;Keskiviikko;69;44;113
622;13.09.2017;2017;09;17;Keskiviikko;106;76;182
622;13.09.2017;2017;09;18;Keskiviikko;55;51;106
622;13.09.2017;2017;09;19;Keskiviikko;53;26;79
622;13.09.2017;2017;09;20;Keskiviikko;37;19;56
622;13.09.2017;2017;09;21;Keskiviikko;31;27;58
622;13.09.2017;2017;09;22;Keskiviikko;17;8;25
622;13.09.2017;2017;09;23;Keskiviikko;11;5;16
622;14.09.2017;2017;09;00;Torstai;6;1;7
622;14.09.2017;2017;09;01;Torstai;2;0;2
622;14.09.2017;2017;09;02;Torstai;3;0;3
622;14.09.2017;2017;09;03;Torstai;1;0;1
622;14.09.2017;2017;09;04;Torstai;1;0;1
622;14.09.2017;2017;09;05;Torstai;4;1;5
622;14.09.2017;2017;09;06;Torstai;2;17;19
622;14.09.2017;2017;09;07;Torstai;12;57;69
622;14.09.2017;2017;09;08;Torstai;45;74;119
622;14.09.2017;2017;09;09;Torstai;37;77;114
622;14.09.2017;2017;09;10;Torstai;23;42;65
622;14.09.2017;2017;09;11;Torstai;17;23;40
622;14.09.2017;2017;09;12;Torstai;25;32;57
622;14.09.2017;2017;09;13;Torstai;26;48;74
622;14.09.2017;2017;09;14;Torstai;33;29;62
622;14.09.2017;2017;09;15;Torstai;54;36;90
622;14.09.2017;2017;09;16;Torstai;86;37;123
622;14.09.2017;2017;09;17;Torstai;89;56;145
622;14.09.2017;2017;09;18;Torstai;53;48;101
622;14.09.2017;2017;09;19;Torstai;54;40;94
622;14.09.2017;2017;09;20;Torstai;46;24;70
622;14.09.2017;2017;09;21;Torstai;33;23;56
622;14.09.2017;2017;09;22;Torstai;24;13;37
622;14.09.2017;2017;09;23;Torstai;10;11;21
622;15.09.2017;2017;09;00;Perjantai;11;0;11
622;15.09.2017;2017;09;01;Perjantai;9;6;15
622;15.09.2017;2017;09;02;Perjantai;7;1;8
622;15.09.2017;2017;09;03;Perjantai;3;0;3
622;15.09.2017;2017;09;04;Perjantai;9;1;10
622;15.09.2017;2017;09;05;Perjantai;6;2;8
622;15.09.2017;2017;09;06;Perjantai;2;12;14
622;15.09.2017;2017;09;07;Perjantai;10;29;39
622;15.09.2017;2017;09;08;Perjantai;43;57;100
622;15.09.2017;2017;09;09;Perjantai;28;39;67
622;15.09.2017;2017;09;10;Perjantai;24;27;51
622;15.09.2017;2017;09;11;Perjantai;21;20;41
622;15.09.2017;2017;09;12;Perjantai;18;29;47
622;15.09.2017;2017;09;13;Perjantai;26;36;62
622;15.09.2017;2017;09;14;Perjantai;24;42;66
622;15.09.2017;2017;09;15;Perjantai;46;31;77
622;15.09.2017;2017;09;16;Perjantai;59;36;95
622;15.09.2017;2017;09;17;Perjantai;50;26;76
622;15.09.2017;2017;09;18;Perjantai;32;40;72
622;15.09.2017;2017;09;19;Perjantai;31;29;60
622;15.09.2017;2017;09;20;Perjantai;19;15;34
622;15.09.2017;2017;09;21;Perjantai;20;4;24
622;15.09.2017;2017;09;22;Perjantai;19;5;24
622;15.09.2017;2017;09;23;Perjantai;6;5;11
622;16.09.2017;2017;09;00;Lauantai;8;4;12
622;16.09.2017;2017;09;01;Lauantai;1;2;3
622;16.09.2017;2017;09;02;Lauantai;5;5;10
622;16.09.2017;2017;09;03;Lauantai;2;2;4
622;16.09.2017;2017;09;04;Lauantai;1;1;2
622;16.09.2017;2017;09;05;Lauantai;2;3;5
622;16.09.2017;2017;09;06;Lauantai;4;2;6
622;16.09.2017;2017;09;07;Lauantai;1;7;8
622;16.09.2017;2017;09;08;Lauantai;0;2;2
622;16.09.2017;2017;09;09;Lauantai;3;7;10
622;16.09.2017;2017;09;10;Lauantai;12;17;29
622;16.09.2017;2017;09;11;Lauantai;9;22;31
622;16.09.2017;2017;09;12;Lauantai;20;31;51
622;16.09.2017;2017;09;13;Lauantai;32;23;55
622;16.09.2017;2017;09;14;Lauantai;21;25;46
622;16.09.2017;2017;09;15;Lauantai;25;25;50
622;16.09.2017;2017;09;16;Lauantai;31;24;55
622;16.09.2017;2017;09;17;Lauantai;35;25;60
622;16.09.2017;2017;09;18;Lauantai;32;32;64
622;16.09.2017;2017;09;19;Lauantai;21;16;37
622;16.09.2017;2017;09;20;Lauantai;23;16;39
622;16.09.2017;2017;09;21;Lauantai;15;15;30
622;16.09.2017;2017;09;22;Lauantai;12;7;19
622;16.09.2017;2017;09;23;Lauantai;8;9;17
622;17.09.2017;2017;09;00;Sunnuntai;12;8;20
622;17.09.2017;2017;09;01;Sunnuntai;5;2;7
622;17.09.2017;2017;09;02;Sunnuntai;1;5;6
622;17.09.2017;2017;09;03;Sunnuntai;3;5;8
622;17.09.2017;2017;09;04;Sunnuntai;3;3;6
622;17.09.2017;2017;09;05;Sunnuntai;4;0;4
622;17.09.2017;2017;09;06;Sunnuntai;3;1;4
622;17.09.2017;2017;09;07;Sunnuntai;3;6;9
622;17.09.2017;2017;09;08;Sunnuntai;2;4;6
622;17.09.2017;2017;09;09;Sunnuntai;3;4;7
622;17.09.2017;2017;09;10;Sunnuntai;5;7;12
622;17.09.2017;2017;09;11;Sunnuntai;11;4;15
622;17.09.2017;2017;09;12;Sunnuntai;12;12;24
622;17.09.2017;2017;09;13;Sunnuntai;25;42;67
622;17.09.2017;2017;09;14;Sunnuntai;23;31;54
622;17.09.2017;2017;09;15;Sunnuntai;24;32;56
622;17.09.2017;2017;09;16;Sunnuntai;33;24;57
622;17.09.2017;2017;09;17;Sunnuntai;37;21;58
622;17.09.2017;2017;09;18;Sunnuntai;33;36;69
622;17.09.2017;2017;09;19;Sunnuntai;40;30;70
622;17.09.2017;2017;09;20;Sunnuntai;32;22;54
622;17.09.2017;2017;09;21;Sunnuntai;17;9;26
622;17.09.2017;2017;09;22;Sunnuntai;15;6;21
622;17.09.2017;2017;09;23;Sunnuntai;7;3;10
622;18.09.2017;2017;09;00;Maanantai;2;3;5
622;18.09.2017;2017;09;01;Maanantai;1;0;1
622;18.09.2017;2017;09;02;Maanantai;5;0;5
622;18.09.2017;2017;09;03;Maanantai;1;0;1
622;18.09.2017;2017;09;04;Maanantai;0;0;0
622;18.09.2017;2017;09;05;Maanantai;1;2;3
622;18.09.2017;2017;09;06;Maanantai;3;14;17
622;18.09.2017;2017;09;07;Maanantai;6;42;48
622;18.09.2017;2017;09;08;Maanantai;33;65;98
622;18.09.2017;2017;09;09;Maanantai;31;57;88
622;18.09.2017;2017;09;10;Maanantai;13;35;48
622;18.09.2017;2017;09;11;Maanantai;12;21;33
622;18.09.2017;2017;09;12;Maanantai;20;26;46
622;18.09.2017;2017;09;13;Maanantai;21;31;52
622;18.09.2017;2017;09;14;Maanantai;24;37;61
622;18.09.2017;2017;09;15;Maanantai;50;44;94
622;18.09.2017;2017;09;16;Maanantai;91;48;139
622;18.09.2017;2017;09;17;Maanantai;88;57;145
622;18.09.2017;2017;09;18;Maanantai;54;37;91
622;18.09.2017;2017;09;19;Maanantai;51;42;93
622;18.09.2017;2017;09;20;Maanantai;30;19;49
622;18.09.2017;2017;09;21;Maanantai;25;21;46
622;18.09.2017;2017;09;22;Maanantai;16;8;24
622;18.09.2017;2017;09;23;Maanantai;6;2;8
622;19.09.2017;2017;09;00;Tiistai;6;1;7
622;19.09.2017;2017;09;01;Tiistai;1;1;2
622;19.09.2017;2017;09;02;Tiistai;1;0;1
622;19.09.2017;2017;09;03;Tiistai;0;0;0
622;19.09.2017;2017;09;04;Tiistai;0;0;0
622;19.09.2017;2017;09;05;Tiistai;0;0;0
622;19.09.2017;2017;09;06;Tiistai;0;10;10
622;19.09.2017;2017;09;07;Tiistai;6;28;34
622;19.09.2017;2017;09;08;Tiistai;38;76;114
622;19.09.2017;2017;09;09;Tiistai;39;51;90
622;19.09.2017;2017;09;10;Tiistai;15;18;33
622;19.09.2017;2017;09;11;Tiistai;14;15;29
622;19.09.2017;2017;09;12;Tiistai;12;26;38
622;19.09.2017;2017;09;13;Tiistai;10;17;27
622;19.09.2017;2017;09;14;Tiistai;21;27;48
622;19.09.2017;2017;09;15;Tiistai;27;27;54
622;19.09.2017;2017;09;16;Tiistai;55;33;88
622;19.09.2017;2017;09;17;Tiistai;84;56;140
622;19.09.2017;2017;09;18;Tiistai;45;40;85
622;19.09.2017;2017;09;19;Tiistai;31;25;56
622;19.09.2017;2017;09;20;Tiistai;40;31;71
622;19.09.2017;2017;09;21;Tiistai;31;26;57
622;19.09.2017;2017;09;22;Tiistai;18;8;26
622;19.09.2017;2017;09;23;Tiistai;11;2;13
622;20.09.2017;2017;09;00;Keskiviikko;7;0;7
622;20.09.2017;2017;09;01;Keskiviikko;1;1;2
622;20.09.2017;2017;09;02;Keskiviikko;0;0;0
622;20.09.2017;2017;09;03;Keskiviikko;1;0;1
622;20.09.2017;2017;09;04;Keskiviikko;1;0;1
622;20.09.2017;2017;09;05;Keskiviikko;0;0;0
622;20.09.2017;2017;09;06;Keskiviikko;2;13;15
622;20.09.2017;2017;09;07;Keskiviikko;11;36;47
622;20.09.2017;2017;09;08;Keskiviikko;43;82;125
622;20.09.2017;2017;09;09;Keskiviikko;35;60;95
622;20.09.2017;2017;09;10;Keskiviikko;26;35;61
622;20.09.2017;2017;09;11;Keskiviikko;23;23;46
622;20.09.2017;2017;09;12;Keskiviikko;21;27;48
622;20.09.2017;2017;09;13;Keskiviikko;27;31;58
622;20.09.2017;2017;09;14;Keskiviikko;38;36;74
622;20.09.2017;2017;09;15;Keskiviikko;45;45;90
622;20.09.2017;2017;09;16;Keskiviikko;69;46;115
622;20.09.2017;2017;09;17;Keskiviikko;78;58;136
622;20.09.2017;2017;09;18;Keskiviikko;62;42;104
622;20.09.2017;2017;09;19;Keskiviikko;41;34;75
622;20.09.2017;2017;09;20;Keskiviikko;35;24;59
622;20.09.2017;2017;09;21;Keskiviikko;27;20;47
622;20.09.2017;2017;09;22;Keskiviikko;11;10;21
622;20.09.2017;2017;09;23;Keskiviikko;13;5;18
622;21.09.2017;2017;09;00;Torstai;3;2;5
622;21.09.2017;2017;09;01;Torstai;5;2;7
622;21.09.2017;2017;09;02;Torstai;8;1;9
622;21.09.2017;2017;09;03;Torstai;5;0;5
622;21.09.2017;2017;09;04;Torstai;1;1;2
622;21.09.2017;2017;09;05;Torstai;2;0;2
622;21.09.2017;2017;09;06;Torstai;0;10;10
622;21.09.2017;2017;09;07;Torstai;9;36;45
622;21.09.2017;2017;09;08;Torstai;50;80;130
622;21.09.2017;2017;09;09;Torstai;27;52;79
622;21.09.2017;2017;09;10;Torstai;18;22;40
622;21.09.2017;2017;09;11;Torstai;23;19;42
622;21.09.2017;2017;09;12;Torstai;27;34;61
622;21.09.2017;2017;09;13;Torstai;36;38;74
622;21.09.2017;2017;09;14;Torstai;32;32;64
622;21.09.2017;2017;09;15;Torstai;42;38;80
622;21.09.2017;2017;09;16;Torstai;78;31;109
622;21.09.2017;2017;09;17;Torstai;71;59;130
622;21.09.2017;2017;09;18;Torstai;53;46;99
622;21.09.2017;2017;09;19;Torstai;46;30;76
622;21.09.2017;2017;09;20;Torstai;32;26;58
622;21.09.2017;2017;09;21;Torstai;40;21;61
622;21.09.2017;2017;09;22;Torstai;16;8;24
622;21.09.2017;2017;09;23;Torstai;8;3;11
622;22.09.2017;2017;09;00;Perjantai;7;7;14
622;22.09.2017;2017;09;01;Perjantai;3;1;4
622;22.09.2017;2017;09;02;Perjantai;2;2;4
622;22.09.2017;2017;09;03;Perjantai;2;1;3
622;22.09.2017;2017;09;04;Perjantai;2;1;3
622;22.09.2017;2017;09;05;Perjantai;1;0;1
622;22.09.2017;2017;09;06;Perjantai;4;10;14
622;22.09.2017;2017;09;07;Perjantai;15;44;59
622;22.09.2017;2017;09;08;Perjantai;41;53;94
622;22.09.2017;2017;09;09;Perjantai;36;49;85
622;22.09.2017;2017;09;10;Perjantai;15;33;48
622;22.09.2017;2017;09;11;Perjantai;24;21;45
622;22.09.2017;2017;09;12;Perjantai;26;26;52
622;22.09.2017;2017;09;13;Perjantai;35;47;82
622;22.09.2017;2017;09;14;Perjantai;37;43;80
622;22.09.2017;2017;09;15;Perjantai;69;37;106
622;22.09.2017;2017;09;16;Perjantai;69;40;109
622;22.09.2017;2017;09;17;Perjantai;74;56;130
622;22.09.2017;2017;09;18;Perjantai;58;50;108
622;22.09.2017;2017;09;19;Perjantai;58;55;113
622;22.09.2017;2017;09;20;Perjantai;33;22;55
622;22.09.2017;2017;09;21;Perjantai;33;19;52
622;22.09.2017;2017;09;22;Perjantai;21;11;32
622;22.09.2017;2017;09;23;Perjantai;12;8;20
622;23.09.2017;2017;09;00;Lauantai;10;10;20
622;23.09.2017;2017;09;01;Lauantai;10;15;25
622;23.09.2017;2017;09;02;Lauantai;5;4;9
622;23.09.2017;2017;09;03;Lauantai;3;1;4
622;23.09.2017;2017;09;04;Lauantai;4;3;7
622;23.09.2017;2017;09;05;Lauantai;4;1;5
622;23.09.2017;2017;09;06;Lauantai;3;8;11
622;23.09.2017;2017;09;07;Lauantai;1;6;7
622;23.09.2017;2017;09;08;Lauantai;1;1;2
622;23.09.2017;2017;09;09;Lauantai;4;9;13
622;23.09.2017;2017;09;10;Lauantai;11;19;30
622;23.09.2017;2017;09;11;Lauantai;8;20;28
622;23.09.2017;2017;09;12;Lauantai;35;24;59
622;23.09.2017;2017;09;13;Lauantai;26;43;69
622;23.09.2017;2017;09;14;Lauantai;22;22;44
622;23.09.2017;2017;09;15;Lauantai;43;24;67
622;23.09.2017;2017;09;16;Lauantai;46;29;75
622;23.09.2017;2017;09;17;Lauantai;33;31;64
622;23.09.2017;2017;09;18;Lauantai;30;30;60
622;23.09.2017;2017;09;19;Lauantai;39;28;67
622;23.09.2017;2017;09;20;Lauantai;22;13;35
622;23.09.2017;2017;09;21;Lauantai;13;10;23
622;23.09.2017;2017;09;22;Lauantai;10;9;19
622;23.09.2017;2017;09;23;Lauantai;2;6;8
622;24.09.2017;2017;09;00;Sunnuntai;13;6;19
622;24.09.2017;2017;09;01;Sunnuntai;7;6;13
622;24.09.2017;2017;09;02;Sunnuntai;3;1;4
622;24.09.2017;2017;09;03;Sunnuntai;5;2;7
622;24.09.2017;2017;09;04;Sunnuntai;1;0;1
622;24.09.2017;2017;09;05;Sunnuntai;3;2;5
622;24.09.2017;2017;09;06;Sunnuntai;0;3;3
622;24.09.2017;2017;09;07;Sunnuntai;0;3;3
622;24.09.2017;2017;09;08;Sunnuntai;4;4;8
622;24.09.2017;2017;09;09;Sunnuntai;3;4;7
622;24.09.2017;2017;09;10;Sunnuntai;4;3;7
622;24.09.2017;2017;09;11;Sunnuntai;8;15;23
622;24.09.2017;2017;09;12;Sunnuntai;20;27;47
622;24.09.2017;2017;09;13;Sunnuntai;23;35;58
622;24.09.2017;2017;09;14;Sunnuntai;36;40;76
622;24.09.2017;2017;09;15;Sunnuntai;38;37;75
622;24.09.2017;2017;09;16;Sunnuntai;28;33;61
622;24.09.2017;2017;09;17;Sunnuntai;40;43;83
622;24.09.2017;2017;09;18;Sunnuntai;34;25;59
622;24.09.2017;2017;09;19;Sunnuntai;34;23;57
622;24.09.2017;2017;09;20;Sunnuntai;27;28;55
622;24.09.2017;2017;09;21;Sunnuntai;23;16;39
622;24.09.2017;2017;09;22;Sunnuntai;18;8;26
622;24.09.2017;2017;09;23;Sunnuntai;6;4;10
622;25.09.2017;2017;09;00;Maanantai;4;3;7
622;25.09.2017;2017;09;01;Maanantai;2;1;3
622;25.09.2017;2017;09;02;Maanantai;1;0;1
622;25.09.2017;2017;09;03;Maanantai;1;0;1
622;25.09.2017;2017;09;04;Maanantai;0;0;0
622;25.09.2017;2017;09;05;Maanantai;0;2;2
622;25.09.2017;2017;09;06;Maanantai;2;8;10
622;25.09.2017;2017;09;07;Maanantai;6;43;49
622;25.09.2017;2017;09;08;Maanantai;33;67;100
622;25.09.2017;2017;09;09;Maanantai;39;63;102
622;25.09.2017;2017;09;10;Maanantai;27;42;69
622;25.09.2017;2017;09;11;Maanantai;23;22;45
622;25.09.2017;2017;09;12;Maanantai;28;44;72
622;25.09.2017;2017;09;13;Maanantai;33;31;64
622;25.09.2017;2017;09;14;Maanantai;45;39;84
622;25.09.2017;2017;09;15;Maanantai;69;45;114
622;25.09.2017;2017;09;16;Maanantai;101;70;171
622;25.09.2017;2017;09;17;Maanantai;115;61;176
622;25.09.2017;2017;09;18;Maanantai;69;67;136
622;25.09.2017;2017;09;19;Maanantai;51;73;124
622;25.09.2017;2017;09;20;Maanantai;49;31;80
622;25.09.2017;2017;09;21;Maanantai;34;18;52
622;25.09.2017;2017;09;22;Maanantai;14;8;22
622;25.09.2017;2017;09;23;Maanantai;6;8;14
622;26.09.2017;2017;09;00;Tiistai;2;0;2
622;26.09.2017;2017;09;01;Tiistai;2;2;4
622;26.09.2017;2017;09;02;Tiistai;3;1;4
622;26.09.2017;2017;09;03;Tiistai;1;1;2
622;26.09.2017;2017;09;04;Tiistai;2;0;2
622;26.09.2017;2017;09;05;Tiistai;0;2;2
622;26.09.2017;2017;09;06;Tiistai;1;10;11
622;26.09.2017;2017;09;07;Tiistai;7;44;51
622;26.09.2017;2017;09;08;Tiistai;45;80;125
622;26.09.2017;2017;09;09;Tiistai;37;70;107
622;26.09.2017;2017;09;10;Tiistai;26;26;52
622;26.09.2017;2017;09;11;Tiistai;29;36;65
622;26.09.2017;2017;09;12;Tiistai;22;31;53
622;26.09.2017;2017;09;13;Tiistai;30;28;58
622;26.09.2017;2017;09;14;Tiistai;36;27;63
622;26.09.2017;2017;09;15;Tiistai;52;37;89
622;26.09.2017;2017;09;16;Tiistai;85;56;141
622;26.09.2017;2017;09;17;Tiistai;78;48;126
622;26.09.2017;2017;09;18;Tiistai;59;51;110
622;26.09.2017;2017;09;19;Tiistai;44;33;77
622;26.09.2017;2017;09;20;Tiistai;41;29;70
622;26.09.2017;2017;09;21;Tiistai;31;15;46
622;26.09.2017;2017;09;22;Tiistai;17;14;31
622;26.09.2017;2017;09;23;Tiistai;3;4;7
622;27.09.2017;2017;09;00;Keskiviikko;4;0;4
622;27.09.2017;2017;09;01;Keskiviikko;0;0;0
622;27.09.2017;2017;09;02;Keskiviikko;1;0;1
622;27.09.2017;2017;09;03;Keskiviikko;2;1;3
622;27.09.2017;2017;09;04;Keskiviikko;2;1;3
622;27.09.2017;2017;09;05;Keskiviikko;1;0;1
622;27.09.2017;2017;09;06;Keskiviikko;4;15;19
622;27.09.2017;2017;09;07;Keskiviikko;12;47;59
622;27.09.2017;2017;09;08;Keskiviikko;44;71;115
622;27.09.2017;2017;09;09;Keskiviikko;33;61;94
622;27.09.2017;2017;09;10;Keskiviikko;25;37;62
622;27.09.2017;2017;09;11;Keskiviikko;40;30;70
622;27.09.2017;2017;09;12;Keskiviikko;29;30;59
622;27.09.2017;2017;09;13;Keskiviikko;34;26;60
622;27.09.2017;2017;09;14;Keskiviikko;43;44;87
622;27.09.2017;2017;09;15;Keskiviikko;46;45;91
622;27.09.2017;2017;09;16;Keskiviikko;88;47;135
622;27.09.2017;2017;09;17;Keskiviikko;90;51;141
622;27.09.2017;2017;09;18;Keskiviikko;44;46;90
622;27.09.2017;2017;09;19;Keskiviikko;41;35;76
622;27.09.2017;2017;09;20;Keskiviikko;40;28;68
622;27.09.2017;2017;09;21;Keskiviikko;22;19;41
622;27.09.2017;2017;09;22;Keskiviikko;12;16;28
622;27.09.2017;2017;09;23;Keskiviikko;9;6;15
622;28.09.2017;2017;09;00;Torstai;3;9;12
622;28.09.2017;2017;09;01;Torstai;1;0;1
622;28.09.2017;2017;09;02;Torstai;0;2;2
622;28.09.2017;2017;09;03;Torstai;1;1;2
622;28.09.2017;2017;09;04;Torstai;8;2;10
622;28.09.2017;2017;09;05;Torstai;4;1;5
622;28.09.2017;2017;09;06;Torstai;2;14;16
622;28.09.2017;2017;09;07;Torstai;9;34;43
622;28.09.2017;2017;09;08;Torstai;44;72;116
622;28.09.2017;2017;09;09;Torstai;25;63;88
622;28.09.2017;2017;09;10;Torstai;14;22;36
622;28.09.2017;2017;09;11;Torstai;16;12;28
622;28.09.2017;2017;09;12;Torstai;17;24;41
622;28.09.2017;2017;09;13;Torstai;24;26;50
622;28.09.2017;2017;09;14;Torstai;44;41;85
622;28.09.2017;2017;09;15;Torstai;39;36;75
622;28.09.2017;2017;09;16;Torstai;65;44;109
622;28.09.2017;2017;09;17;Torstai;87;47;134
622;28.09.2017;2017;09;18;Torstai;55;45;100
622;28.09.2017;2017;09;19;Torstai;40;29;69
622;28.09.2017;2017;09;20;Torstai;32;28;60
622;28.09.2017;2017;09;21;Torstai;28;9;37
622;28.09.2017;2017;09;22;Torstai;11;8;19
622;28.09.2017;2017;09;23;Torstai;5;6;11
622;29.09.2017;2017;09;00;Perjantai;2;2;4
622;29.09.2017;2017;09;01;Perjantai;5;4;9
622;29.09.2017;2017;09;02;Perjantai;2;2;4
622;29.09.2017;2017;09;03;Perjantai;0;0;0
622;29.09.2017;2017;09;04;Perjantai;1;0;1
622;29.09.2017;2017;09;05;Perjantai;0;0;0
622;29.09.2017;2017;09;06;Perjantai;4;12;16
622;29.09.2017;2017;09;07;Perjantai;2;25;27
622;29.09.2017;2017;09;08;Perjantai;38;54;92
622;29.09.2017;2017;09;09;Perjantai;24;37;61
622;29.09.2017;2017;09;10;Perjantai;16;24;40
622;29.09.2017;2017;09;11;Perjantai;17;18;35
622;29.09.2017;2017;09;12;Perjantai;24;29;53
622;29.09.2017;2017;09;13;Perjantai;28;31;59
622;29.09.2017;2017;09;14;Perjantai;34;33;67
622;29.09.2017;2017;09;15;Perjantai;47;51;98
622;29.09.2017;2017;09;16;Perjantai;55;41;96
622;29.09.2017;2017;09;17;Perjantai;58;42;100
622;29.09.2017;2017;09;18;Perjantai;42;38;80
622;29.09.2017;2017;09;19;Perjantai;33;20;53
622;29.09.2017;2017;09;20;Perjantai;20;25;45
622;29.09.2017;2017;09;21;Perjantai;16;13;29
622;29.09.2017;2017;09;22;Perjantai;16;7;23
622;29.09.2017;2017;09;23;Perjantai;7;3;10
622;30.09.2017;2017;09;00;Lauantai;7;9;16
622;30.09.2017;2017;09;01;Lauantai;6;5;11
622;30.09.2017;2017;09;02;Lauantai;7;2;9
622;30.09.2017;2017;09;03;Lauantai;6;2;8
622;30.09.2017;2017;09;04;Lauantai;3;1;4
622;30.09.2017;2017;09;05;Lauantai;5;3;8
622;30.09.2017;2017;09;06;Lauantai;1;6;7
622;30.09.2017;2017;09;07;Lauantai;2;6;8
622;30.09.2017;2017;09;08;Lauantai;4;3;7
622;30.09.2017;2017;09;09;Lauantai;6;12;18
622;30.09.2017;2017;09;10;Lauantai;4;12;16
622;30.09.2017;2017;09;11;Lauantai;14;16;30
622;30.09.2017;2017;09;12;Lauantai;22;22;44
622;30.09.2017;2017;09;13;Lauantai;21;33;54
622;30.09.2017;2017;09;14;Lauantai;26;38;64
622;30.09.2017;2017;09;15;Lauantai;39;55;94
622;30.09.2017;2017;09;16;Lauantai;43;43;86
622;30.09.2017;2017;09;17;Lauantai;36;34;70
622;30.09.2017;2017;09;18;Lauantai;23;34;57
622;30.09.2017;2017;09;19;Lauantai;30;31;61
622;30.09.2017;2017;09;20;Lauantai;25;24;49
622;30.09.2017;2017;09;21;Lauantai;20;10;30
622;30.09.2017;2017;09;22;Lauantai;20;10;30
622;30.09.2017;2017;09;23;Lauantai;12;7;19
622;01.10.2017;2017;10;00;Sunnuntai;20;7;27
622;01.10.2017;2017;10;01;Sunnuntai;12;6;18
622;01.10.2017;2017;10;02;Sunnuntai;1;5;6
622;01.10.2017;2017;10;03;Sunnuntai;11;3;14
622;01.10.2017;2017;10;04;Sunnuntai;7;2;9
622;01.10.2017;2017;10;05;Sunnuntai;8;0;8
622;01.10.2017;2017;10;06;Sunnuntai;3;0;3
622;01.10.2017;2017;10;07;Sunnuntai;3;7;10
622;01.10.2017;2017;10;08;Sunnuntai;2;1;3
622;01.10.2017;2017;10;09;Sunnuntai;5;7;12
622;01.10.2017;2017;10;10;Sunnuntai;7;8;15
622;01.10.2017;2017;10;11;Sunnuntai;10;9;19
622;01.10.2017;2017;10;12;Sunnuntai;25;23;48
622;01.10.2017;2017;10;13;Sunnuntai;23;30;53
622;01.10.2017;2017;10;14;Sunnuntai;33;29;62
622;01.10.2017;2017;10;15;Sunnuntai;22;29;51
622;01.10.2017;2017;10;16;Sunnuntai;39;26;65
622;01.10.2017;2017;10;17;Sunnuntai;27;27;54
622;01.10.2017;2017;10;18;Sunnuntai;30;36;66
622;01.10.2017;2017;10;19;Sunnuntai;28;18;46
622;01.10.2017;2017;10;20;Sunnuntai;18;20;38
622;01.10.2017;2017;10;21;Sunnuntai;14;8;22
622;01.10.2017;2017;10;22;Sunnuntai;12;8;20
622;01.10.2017;2017;10;23;Sunnuntai;5;2;7
622;02.10.2017;2017;10;00;Maanantai;1;1;2
622;02.10.2017;2017;10;01;Maanantai;0;0;0
622;02.10.2017;2017;10;02;Maanantai;2;0;2
622;02.10.2017;2017;10;03;Maanantai;0;0;0
622;02.10.2017;2017;10;04;Maanantai;0;0;0
622;02.10.2017;2017;10;05;Maanantai;2;3;5
622;02.10.2017;2017;10;06;Maanantai;1;10;11
622;02.10.2017;2017;10;07;Maanantai;5;37;42
622;02.10.2017;2017;10;08;Maanantai;32;72;104
622;02.10.2017;2017;10;09;Maanantai;46;70;116
622;02.10.2017;2017;10;10;Maanantai;19;45;64
622;02.10.2017;2017;10;11;Maanantai;13;19;32
622;02.10.2017;2017;10;12;Maanantai;17;29;46
622;02.10.2017;2017;10;13;Maanantai;34;26;60
622;02.10.2017;2017;10;14;Maanantai;29;35;64
622;02.10.2017;2017;10;15;Maanantai;60;35;95
622;02.10.2017;2017;10;16;Maanantai;68;39;107
622;02.10.2017;2017;10;17;Maanantai;100;60;160
622;02.10.2017;2017;10;18;Maanantai;58;43;101
622;02.10.2017;2017;10;19;Maanantai;52;33;85
622;02.10.2017;2017;10;20;Maanantai;28;22;50
622;02.10.2017;2017;10;21;Maanantai;25;14;39
622;02.10.2017;2017;10;22;Maanantai;18;10;28
622;02.10.2017;2017;10;23;Maanantai;3;4;7
622;03.10.2017;2017;10;00;Tiistai;3;3;6
622;03.10.2017;2017;10;01;Tiistai;0;0;0
622;03.10.2017;2017;10;02;Tiistai;0;0;0
622;03.10.2017;2017;10;03;Tiistai;5;2;7
622;03.10.2017;2017;10;04;Tiistai;2;0;2
622;03.10.2017;2017;10;05;Tiistai;2;2;4
622;03.10.2017;2017;10;06;Tiistai;1;9;10
622;03.10.2017;2017;10;07;Tiistai;4;31;35
622;03.10.2017;2017;10;08;Tiistai;38;65;103
622;03.10.2017;2017;10;09;Tiistai;27;45;72
622;03.10.2017;2017;10;10;Tiistai;19;20;39
622;03.10.2017;2017;10;11;Tiistai;12;16;28
622;03.10.2017;2017;10;12;Tiistai;18;24;42
622;03.10.2017;2017;10;13;Tiistai;10;29;39
622;03.10.2017;2017;10;14;Tiistai;21;21;42
622;03.10.2017;2017;10;15;Tiistai;33;33;66
622;03.10.2017;2017;10;16;Tiistai;64;35;99
622;03.10.2017;2017;10;17;Tiistai;62;35;97
622;03.10.2017;2017;10;18;Tiistai;49;25;74
622;03.10.2017;2017;10;19;Tiistai;30;33;63
622;03.10.2017;2017;10;20;Tiistai;24;16;40
622;03.10.2017;2017;10;21;Tiistai;24;11;35
622;03.10.2017;2017;10;22;Tiistai;16;9;25
622;03.10.2017;2017;10;23;Tiistai;2;5;7
622;04.10.2017;2017;10;00;Keskiviikko;3;3;6
622;04.10.2017;2017;10;01;Keskiviikko;5;0;5
622;04.10.2017;2017;10;02;Keskiviikko;1;0;1
622;04.10.2017;2017;10;03;Keskiviikko;0;2;2
622;04.10.2017;2017;10;04;Keskiviikko;1;0;1
622;04.10.2017;2017;10;05;Keskiviikko;2;0;2
622;04.10.2017;2017;10;06;Keskiviikko;3;10;13
622;04.10.2017;2017;10;07;Keskiviikko;9;21;30
622;04.10.2017;2017;10;08;Keskiviikko;34;58;92
622;04.10.2017;2017;10;09;Keskiviikko;22;46;68
622;04.10.2017;2017;10;10;Keskiviikko;24;21;45
622;04.10.2017;2017;10;11;Keskiviikko;19;23;42
622;04.10.2017;2017;10;12;Keskiviikko;23;25;48
622;04.10.2017;2017;10;13;Keskiviikko;19;16;35
622;04.10.2017;2017;10;14;Keskiviikko;27;25;52
622;04.10.2017;2017;10;15;Keskiviikko;27;26;53
622;04.10.2017;2017;10;16;Keskiviikko;60;33;93
622;04.10.2017;2017;10;17;Keskiviikko;58;38;96
622;04.10.2017;2017;10;18;Keskiviikko;43;29;72
622;04.10.2017;2017;10;19;Keskiviikko;39;26;65
622;04.10.2017;2017;10;20;Keskiviikko;35;20;55
622;04.10.2017;2017;10;21;Keskiviikko;22;15;37
622;04.10.2017;2017;10;22;Keskiviikko;9;6;15
622;04.10.2017;2017;10;23;Keskiviikko;7;8;15
622;05.10.2017;2017;10;00;Torstai;3;3;6
622;05.10.2017;2017;10;01;Torstai;1;1;2
622;05.10.2017;2017;10;02;Torstai;2;0;2
622;05.10.2017;2017;10;03;Torstai;0;0;0
622;05.10.2017;2017;10;04;Torstai;2;0;2
622;05.10.2017;2017;10;05;Torstai;1;1;2
622;05.10.2017;2017;10;06;Torstai;1;15;16
622;05.10.2017;2017;10;07;Torstai;6;27;33
622;05.10.2017;2017;10;08;Torstai;37;61;98
622;05.10.2017;2017;10;09;Torstai;23;50;73
622;05.10.2017;2017;10;10;Torstai;18;22;40
622;05.10.2017;2017;10;11;Torstai;22;27;49
622;05.10.2017;2017;10;12;Torstai;18;24;42
622;05.10.2017;2017;10;13;Torstai;17;16;33
622;05.10.2017;2017;10;14;Torstai;16;18;34
622;05.10.2017;2017;10;15;Torstai;43;26;69
622;05.10.2017;2017;10;16;Torstai;51;43;94
622;05.10.2017;2017;10;17;Torstai;52;30;82
622;05.10.2017;2017;10;18;Torstai;36;54;90
622;05.10.2017;2017;10;19;Torstai;29;29;58
622;05.10.2017;2017;10;20;Torstai;25;22;47
622;05.10.2017;2017;10;21;Torstai;20;12;32
622;05.10.2017;2017;10;22;Torstai;10;2;12
622;05.10.2017;2017;10;23;Torstai;11;2;13
622;06.10.2017;2017;10;00;Perjantai;9;5;14
622;06.10.2017;2017;10;01;Perjantai;3;1;4
622;06.10.2017;2017;10;02;Perjantai;0;0;0
622;06.10.2017;2017;10;03;Perjantai;2;0;2
622;06.10.2017;2017;10;04;Perjantai;4;2;6
622;06.10.2017;2017;10;05;Perjantai;3;2;5
622;06.10.2017;2017;10;06;Perjantai;2;10;12
622;06.10.2017;2017;10;07;Perjantai;6;24;30
622;06.10.2017;2017;10;08;Perjantai;44;74;118
622;06.10.2017;2017;10;09;Perjantai;38;48;86
622;06.10.2017;2017;10;10;Perjantai;29;30;59
622;06.10.2017;2017;10;11;Perjantai;20;29;49
622;06.10.2017;2017;10;12;Perjantai;24;32;56
622;06.10.2017;2017;10;13;Perjantai;32;34;66
622;06.10.2017;2017;10;14;Perjantai;44;36;80
622;06.10.2017;2017;10;15;Perjantai;49;52;101
622;06.10.2017;2017;10;16;Perjantai;80;42;122
622;06.10.2017;2017;10;17;Perjantai;61;36;97
622;06.10.2017;2017;10;18;Perjantai;42;35;77
622;06.10.2017;2017;10;19;Perjantai;41;24;65
622;06.10.2017;2017;10;20;Perjantai;35;24;59
622;06.10.2017;2017;10;21;Perjantai;20;20;40
622;06.10.2017;2017;10;22;Perjantai;13;7;20
622;06.10.2017;2017;10;23;Perjantai;4;4;8
622;07.10.2017;2017;10;00;Lauantai;6;1;7
622;07.10.2017;2017;10;01;Lauantai;1;0;1
622;07.10.2017;2017;10;02;Lauantai;3;3;6
622;07.10.2017;2017;10;03;Lauantai;4;2;6
622;07.10.2017;2017;10;04;Lauantai;3;0;3
622;07.10.2017;2017;10;05;Lauantai;1;0;1
622;07.10.2017;2017;10;06;Lauantai;0;5;5
622;07.10.2017;2017;10;07;Lauantai;6;2;8
622;07.10.2017;2017;10;08;Lauantai;1;2;3
622;07.10.2017;2017;10;09;Lauantai;4;5;9
622;07.10.2017;2017;10;10;Lauantai;12;14;26
622;07.10.2017;2017;10;11;Lauantai;12;15;27
622;07.10.2017;2017;10;12;Lauantai;21;32;53
622;07.10.2017;2017;10;13;Lauantai;17;21;38
622;07.10.2017;2017;10;14;Lauantai;28;30;58
622;07.10.2017;2017;10;15;Lauantai;28;25;53
622;07.10.2017;2017;10;16;Lauantai;33;27;60
622;07.10.2017;2017;10;17;Lauantai;22;19;41
622;07.10.2017;2017;10;18;Lauantai;16;26;42
622;07.10.2017;2017;10;19;Lauantai;30;31;61
622;07.10.2017;2017;10;20;Lauantai;24;21;45
622;07.10.2017;2017;10;21;Lauantai;30;11;41
622;07.10.2017;2017;10;22;Lauantai;14;8;22
622;07.10.2017;2017;10;23;Lauantai;5;6;11
622;08.10.2017;2017;10;00;Sunnuntai;3;11;14
622;08.10.2017;2017;10;01;Sunnuntai;3;11;14
622;08.10.2017;2017;10;02;Sunnuntai;3;2;5
622;08.10.2017;2017;10;03;Sunnuntai;3;2;5
622;08.10.2017;2017;10;04;Sunnuntai;4;2;6
622;08.10.2017;2017;10;05;Sunnuntai;5;1;6
622;08.10.2017;2017;10;06;Sunnuntai;2;4;6
622;08.10.2017;2017;10;07;Sunnuntai;2;4;6
622;08.10.2017;2017;10;08;Sunnuntai;3;4;7
622;08.10.2017;2017;10;09;Sunnuntai;4;9;13
622;08.10.2017;2017;10;10;Sunnuntai;2;3;5
622;08.10.2017;2017;10;11;Sunnuntai;15;13;28
622;08.10.2017;2017;10;12;Sunnuntai;15;18;33
622;08.10.2017;2017;10;13;Sunnuntai;30;31;61
622;08.10.2017;2017;10;14;Sunnuntai;34;31;65
622;08.10.2017;2017;10;15;Sunnuntai;41;45;86
622;08.10.2017;2017;10;16;Sunnuntai;21;22;43
622;08.10.2017;2017;10;17;Sunnuntai;30;29;59
622;08.10.2017;2017;10;18;Sunnuntai;33;33;66
622;08.10.2017;2017;10;19;Sunnuntai;28;33;61
622;08.10.2017;2017;10;20;Sunnuntai;18;13;31
622;08.10.2017;2017;10;21;Sunnuntai;19;12;31
622;08.10.2017;2017;10;22;Sunnuntai;9;5;14
622;08.10.2017;2017;10;23;Sunnuntai;7;4;11
622;09.10.2017;2017;10;00;Maanantai;1;3;4
622;09.10.2017;2017;10;01;Maanantai;0;2;2
622;09.10.2017;2017;10;02;Maanantai;1;0;1
622;09.10.2017;2017;10;03;Maanantai;0;0;0
622;09.10.2017;2017;10;04;Maanantai;0;1;1
622;09.10.2017;2017;10;05;Maanantai;1;2;3
622;09.10.2017;2017;10;06;Maanantai;1;13;14
622;09.10.2017;2017;10;07;Maanantai;6;36;42
622;09.10.2017;2017;10;08;Maanantai;34;65;99
622;09.10.2017;2017;10;09;Maanantai;44;64;108
622;09.10.2017;2017;10;10;Maanantai;18;35;53
622;09.10.2017;2017;10;11;Maanantai;20;15;35
622;09.10.2017;2017;10;12;Maanantai;15;38;53
622;09.10.2017;2017;10;13;Maanantai;36;34;70
622;09.10.2017;2017;10;14;Maanantai;40;32;72
622;09.10.2017;2017;10;15;Maanantai;50;50;100
622;09.10.2017;2017;10;16;Maanantai;65;53;118
622;09.10.2017;2017;10;17;Maanantai;115;48;163
622;09.10.2017;2017;10;18;Maanantai;55;52;107
622;09.10.2017;2017;10;19;Maanantai;42;38;80
622;09.10.2017;2017;10;20;Maanantai;30;27;57
622;09.10.2017;2017;10;21;Maanantai;23;10;33
622;09.10.2017;2017;10;22;Maanantai;20;7;27
622;09.10.2017;2017;10;23;Maanantai;10;4;14
622;10.10.2017;2017;10;00;Tiistai;6;3;9
622;10.10.2017;2017;10;01;Tiistai;2;1;3
622;10.10.2017;2017;10;02;Tiistai;0;0;0
622;10.10.2017;2017;10;03;Tiistai;0;0;0
622;10.10.2017;2017;10;04;Tiistai;0;0;0
622;10.10.2017;2017;10;05;Tiistai;1;2;3
622;10.10.2017;2017;10;06;Tiistai;2;10;12
622;10.10.2017;2017;10;07;Tiistai;9;26;35
622;10.10.2017;2017;10;08;Tiistai;30;49;79
622;10.10.2017;2017;10;09;Tiistai;24;33;57
622;10.10.2017;2017;10;10;Tiistai;12;24;36
622;10.10.2017;2017;10;11;Tiistai;12;7;19
622;10.10.2017;2017;10;12;Tiistai;18;13;31
622;10.10.2017;2017;10;13;Tiistai;9;20;29
622;10.10.2017;2017;10;14;Tiistai;14;23;37
622;10.10.2017;2017;10;15;Tiistai;31;27;58
622;10.10.2017;2017;10;16;Tiistai;50;36;86
622;10.10.2017;2017;10;17;Tiistai;55;31;86
622;10.10.2017;2017;10;18;Tiistai;27;24;51
622;10.10.2017;2017;10;19;Tiistai;30;25;55
622;10.10.2017;2017;10;20;Tiistai;26;19;45
622;10.10.2017;2017;10;21;Tiistai;15;8;23
622;10.10.2017;2017;10;22;Tiistai;13;7;20
622;10.10.2017;2017;10;23;Tiistai;6;6;12
622;11.10.2017;2017;10;00;Keskiviikko;4;1;5
622;11.10.2017;2017;10;01;Keskiviikko;1;0;1
622;11.10.2017;2017;10;02;Keskiviikko;0;3;3
622;11.10.2017;2017;10;03;Keskiviikko;0;1;1
622;11.10.2017;2017;10;04;Keskiviikko;1;0;1
622;11.10.2017;2017;10;05;Keskiviikko;0;0;0
622;11.10.2017;2017;10;06;Keskiviikko;4;15;19
622;11.10.2017;2017;10;07;Keskiviikko;8;41;49
622;11.10.2017;2017;10;08;Keskiviikko;45;76;121
622;11.10.2017;2017;10;09;Keskiviikko;39;70;109
622;11.10.2017;2017;10;10;Keskiviikko;19;25;44
622;11.10.2017;2017;10;11;Keskiviikko;16;31;47
622;11.10.2017;2017;10;12;Keskiviikko;18;30;48
622;11.10.2017;2017;10;13;Keskiviikko;28;38;66
622;11.10.2017;2017;10;14;Keskiviikko;26;34;60
622;11.10.2017;2017;10;15;Keskiviikko;70;49;119
622;11.10.2017;2017;10;16;Keskiviikko;67;60;127
622;11.10.2017;2017;10;17;Keskiviikko;88;52;140
622;11.10.2017;2017;10;18;Keskiviikko;56;46;102
622;11.10.2017;2017;10;19;Keskiviikko;15;12;27
622;11.10.2017;2017;10;20;Keskiviikko;37;21;58
622;11.10.2017;2017;10;21;Keskiviikko;35;19;54
622;11.10.2017;2017;10;22;Keskiviikko;18;11;29
622;11.10.2017;2017;10;23;Keskiviikko;9;4;13
622;12.10.2017;2017;10;00;Torstai;3;2;5
622;12.10.2017;2017;10;01;Torstai;6;3;9
622;12.10.2017;2017;10;02;Torstai;2;1;3
622;12.10.2017;2017;10;03;Torstai;5;0;5
622;12.10.2017;2017;10;04;Torstai;3;0;3
622;12.10.2017;2017;10;05;Torstai;0;1;1
622;12.10.2017;2017;10;06;Torstai;0;19;19
622;12.10.2017;2017;10;07;Torstai;12;42;54
622;12.10.2017;2017;10;08;Torstai;46;84;130
622;12.10.2017;2017;10;09;Torstai;32;54;86
622;12.10.2017;2017;10;10;Torstai;23;40;63
622;12.10.2017;2017;10;11;Torstai;17;25;42
622;12.10.2017;2017;10;12;Torstai;26;31;57
622;12.10.2017;2017;10;13;Torstai;39;32;71
622;12.10.2017;2017;10;14;Torstai;42;38;80
622;12.10.2017;2017;10;15;Torstai;41;39;80
622;12.10.2017;2017;10;16;Torstai;92;52;144
622;12.10.2017;2017;10;17;Torstai;71;43;114
622;12.10.2017;2017;10;18;Torstai;57;43;100
622;12.10.2017;2017;10;19;Torstai;46;37;83
622;12.10.2017;2017;10;20;Torstai;27;19;46
622;12.10.2017;2017;10;21;Torstai;26;13;39
622;12.10.2017;2017;10;22;Torstai;19;9;28
622;12.10.2017;2017;10;23;Torstai;12;4;16
622;13.10.2017;2017;10;00;Perjantai;7;2;9
622;13.10.2017;2017;10;01;Perjantai;4;4;8
622;13.10.2017;2017;10;02;Perjantai;3;1;4
622;13.10.2017;2017;10;03;Perjantai;1;1;2
622;13.10.2017;2017;10;04;Perjantai;5;1;6
622;13.10.2017;2017;10;05;Perjantai;0;1;1
622;13.10.2017;2017;10;06;Perjantai;4;9;13
622;13.10.2017;2017;10;07;Perjantai;4;36;40
622;13.10.2017;2017;10;08;Perjantai;41;63;104
622;13.10.2017;2017;10;09;Perjantai;34;63;97
622;13.10.2017;2017;10;10;Perjantai;34;33;67
622;13.10.2017;2017;10;11;Perjantai;10;14;24
622;13.10.2017;2017;10;12;Perjantai;36;44;80
622;13.10.2017;2017;10;13;Perjantai;26;31;57
622;13.10.2017;2017;10;14;Perjantai;38;31;69
622;13.10.2017;2017;10;15;Perjantai;58;41;99
622;13.10.2017;2017;10;16;Perjantai;68;49;117
622;13.10.2017;2017;10;17;Perjantai;55;38;93
622;13.10.2017;2017;10;18;Perjantai;47;51;98
622;13.10.2017;2017;10;19;Perjantai;49;28;77
622;13.10.2017;2017;10;20;Perjantai;28;28;56
622;13.10.2017;2017;10;21;Perjantai;23;15;38
622;13.10.2017;2017;10;22;Perjantai;13;7;20
622;13.10.2017;2017;10;23;Perjantai;11;5;16
622;14.10.2017;2017;10;00;Lauantai;10;7;17
622;14.10.2017;2017;10;01;Lauantai;5;6;11
622;14.10.2017;2017;10;02;Lauantai;2;4;6
622;14.10.2017;2017;10;03;Lauantai;6;0;6
622;14.10.2017;2017;10;04;Lauantai;0;1;1
622;14.10.2017;2017;10;05;Lauantai;5;1;6
622;14.10.2017;2017;10;06;Lauantai;0;7;7
622;14.10.2017;2017;10;07;Lauantai;5;5;10
622;14.10.2017;2017;10;08;Lauantai;7;4;11
622;14.10.2017;2017;10;09;Lauantai;6;8;14
622;14.10.2017;2017;10;10;Lauantai;7;20;27
622;14.10.2017;2017;10;11;Lauantai;12;26;38
622;14.10.2017;2017;10;12;Lauantai;26;26;52
622;14.10.2017;2017;10;13;Lauantai;34;38;72
622;14.10.2017;2017;10;14;Lauantai;29;27;56
622;14.10.2017;2017;10;15;Lauantai;27;32;59
622;14.10.2017;2017;10;16;Lauantai;30;22;52
622;14.10.2017;2017;10;17;Lauantai;36;14;50
622;14.10.2017;2017;10;18;Lauantai;16;13;29
622;14.10.2017;2017;10;19;Lauantai;16;6;22
622;14.10.2017;2017;10;20;Lauantai;8;9;17
622;14.10.2017;2017;10;21;Lauantai;9;7;16
622;14.10.2017;2017;10;22;Lauantai;11;5;16
622;14.10.2017;2017;10;23;Lauantai;5;3;8
622;15.10.2017;2017;10;00;Sunnuntai;6;3;9
622;15.10.2017;2017;10;01;Sunnuntai;4;2;6
622;15.10.2017;2017;10;02;Sunnuntai;1;2;3
622;15.10.2017;2017;10;03;Sunnuntai;3;3;6
622;15.10.2017;2017;10;04;Sunnuntai;0;1;1
622;15.10.2017;2017;10;05;Sunnuntai;1;2;3
622;15.10.2017;2017;10;06;Sunnuntai;2;1;3
622;15.10.2017;2017;10;07;Sunnuntai;0;6;6
622;15.10.2017;2017;10;08;Sunnuntai;1;2;3
622;15.10.2017;2017;10;09;Sunnuntai;1;4;5
622;15.10.2017;2017;10;10;Sunnuntai;4;9;13
622;15.10.2017;2017;10;11;Sunnuntai;5;15;20
622;15.10.2017;2017;10;12;Sunnuntai;23;29;52
622;15.10.2017;2017;10;13;Sunnuntai;26;39;65
622;15.10.2017;2017;10;14;Sunnuntai;23;25;48
622;15.10.2017;2017;10;15;Sunnuntai;39;47;86
622;15.10.2017;2017;10;16;Sunnuntai;41;31;72
622;15.10.2017;2017;10;17;Sunnuntai;37;21;58
622;15.10.2017;2017;10;18;Sunnuntai;32;42;74
622;15.10.2017;2017;10;19;Sunnuntai;27;19;46
622;15.10.2017;2017;10;20;Sunnuntai;23;11;34
622;15.10.2017;2017;10;21;Sunnuntai;16;18;34
622;15.10.2017;2017;10;22;Sunnuntai;11;6;17
622;15.10.2017;2017;10;23;Sunnuntai;7;5;12
622;16.10.2017;2017;10;00;Maanantai;1;4;5
622;16.10.2017;2017;10;01;Maanantai;3;0;3
622;16.10.2017;2017;10;02;Maanantai;2;0;2
622;16.10.2017;2017;10;03;Maanantai;1;0;1
622;16.10.2017;2017;10;04;Maanantai;0;1;1
622;16.10.2017;2017;10;05;Maanantai;0;3;3
622;16.10.2017;2017;10;06;Maanantai;2;12;14
622;16.10.2017;2017;10;07;Maanantai;6;24;30
622;16.10.2017;2017;10;08;Maanantai;20;67;87
622;16.10.2017;2017;10;09;Maanantai;25;49;74
622;16.10.2017;2017;10;10;Maanantai;12;25;37
622;16.10.2017;2017;10;11;Maanantai;9;8;17
622;16.10.2017;2017;10;12;Maanantai;13;12;25
622;16.10.2017;2017;10;13;Maanantai;13;15;28
622;16.10.2017;2017;10;14;Maanantai;17;14;31
622;16.10.2017;2017;10;15;Maanantai;32;13;45
622;16.10.2017;2017;10;16;Maanantai;50;35;85
622;16.10.2017;2017;10;17;Maanantai;63;45;108
622;16.10.2017;2017;10;18;Maanantai;48;26;74
622;16.10.2017;2017;10;19;Maanantai;43;34;77
622;16.10.2017;2017;10;20;Maanantai;22;20;42
622;16.10.2017;2017;10;21;Maanantai;20;17;37
622;16.10.2017;2017;10;22;Maanantai;17;8;25
622;16.10.2017;2017;10;23;Maanantai;5;5;10
622;17.10.2017;2017;10;00;Tiistai;4;1;5
622;17.10.2017;2017;10;01;Tiistai;0;3;3
622;17.10.2017;2017;10;02;Tiistai;0;0;0
622;17.10.2017;2017;10;03;Tiistai;1;0;1
622;17.10.2017;2017;10;04;Tiistai;0;0;0
622;17.10.2017;2017;10;05;Tiistai;1;4;5
622;17.10.2017;2017;10;06;Tiistai;3;15;18
622;17.10.2017;2017;10;07;Tiistai;7;29;36
622;17.10.2017;2017;10;08;Tiistai;36;76;112
622;17.10.2017;2017;10;09;Tiistai;39;49;88
622;17.10.2017;2017;10;10;Tiistai;15;31;46
622;17.10.2017;2017;10;11;Tiistai;15;28;43
622;17.10.2017;2017;10;12;Tiistai;21;31;52
622;17.10.2017;2017;10;13;Tiistai;39;24;63
622;17.10.2017;2017;10;14;Tiistai;25;45;70
622;17.10.2017;2017;10;15;Tiistai;45;40;85
622;17.10.2017;2017;10;16;Tiistai;69;41;110
622;17.10.2017;2017;10;17;Tiistai;88;53;141
622;17.10.2017;2017;10;18;Tiistai;59;49;108
622;17.10.2017;2017;10;19;Tiistai;45;35;80
622;17.10.2017;2017;10;20;Tiistai;39;16;55
622;17.10.2017;2017;10;21;Tiistai;29;17;46
622;17.10.2017;2017;10;22;Tiistai;20;15;35
622;17.10.2017;2017;10;23;Tiistai;7;1;8
622;18.10.2017;2017;10;00;Keskiviikko;6;5;11
622;18.10.2017;2017;10;01;Keskiviikko;3;1;4
622;18.10.2017;2017;10;02;Keskiviikko;2;0;2
622;18.10.2017;2017;10;03;Keskiviikko;2;1;3
622;18.10.2017;2017;10;04;Keskiviikko;0;1;1
622;18.10.2017;2017;10;05;Keskiviikko;1;0;1
622;18.10.2017;2017;10;06;Keskiviikko;2;13;15
622;18.10.2017;2017;10;07;Keskiviikko;9;39;48
622;18.10.2017;2017;10;08;Keskiviikko;48;66;114
622;18.10.2017;2017;10;09;Keskiviikko;35;54;89
622;18.10.2017;2017;10;10;Keskiviikko;17;27;44
622;18.10.2017;2017;10;11;Keskiviikko;11;11;22
622;18.10.2017;2017;10;12;Keskiviikko;15;18;33
622;18.10.2017;2017;10;13;Keskiviikko;21;24;45
622;18.10.2017;2017;10;14;Keskiviikko;25;27;52
622;18.10.2017;2017;10;15;Keskiviikko;39;34;73
622;18.10.2017;2017;10;16;Keskiviikko;52;32;84
622;18.10.2017;2017;10;17;Keskiviikko;64;58;122
622;18.10.2017;2017;10;18;Keskiviikko;42;48;90
622;18.10.2017;2017;10;19;Keskiviikko;38;21;59
622;18.10.2017;2017;10;20;Keskiviikko;26;13;39
622;18.10.2017;2017;10;21;Keskiviikko;16;14;30
622;18.10.2017;2017;10;22;Keskiviikko;14;13;27
622;18.10.2017;2017;10;23;Keskiviikko;9;3;12
622;19.10.2017;2017;10;00;Torstai;6;6;12
622;19.10.2017;2017;10;01;Torstai;0;0;0
622;19.10.2017;2017;10;02;Torstai;5;1;6
622;19.10.2017;2017;10;03;Torstai;7;1;8
622;19.10.2017;2017;10;04;Torstai;1;1;2
622;19.10.2017;2017;10;05;Torstai;0;2;2
622;19.10.2017;2017;10;06;Torstai;1;12;13
622;19.10.2017;2017;10;07;Torstai;4;32;36
622;19.10.2017;2017;10;08;Torstai;40;53;93
622;19.10.2017;2017;10;09;Torstai;29;44;73
622;19.10.2017;2017;10;10;Torstai;12;30;42
622;19.10.2017;2017;10;11;Torstai;9;24;33
622;19.10.2017;2017;10;12;Torstai;27;24;51
622;19.10.2017;2017;10;13;Torstai;25;35;60
622;19.10.2017;2017;10;14;Torstai;34;42;76
622;19.10.2017;2017;10;15;Torstai;40;29;69
622;19.10.2017;2017;10;16;Torstai;45;47;92
622;19.10.2017;2017;10;17;Torstai;68;51;119
622;19.10.2017;2017;10;18;Torstai;50;42;92
622;19.10.2017;2017;10;19;Torstai;25;25;50
622;19.10.2017;2017;10;20;Torstai;24;14;38
622;19.10.2017;2017;10;21;Torstai;18;10;28
622;19.10.2017;2017;10;22;Torstai;14;7;21
622;19.10.2017;2017;10;23;Torstai;7;4;11
622;20.10.2017;2017;10;00;Perjantai;8;5;13
622;20.10.2017;2017;10;01;Perjantai;8;2;10
622;20.10.2017;2017;10;02;Perjantai;5;1;6
622;20.10.2017;2017;10;03;Perjantai;4;2;6
622;20.10.2017;2017;10;04;Perjantai;2;0;2
622;20.10.2017;2017;10;05;Perjantai;3;2;5
622;20.10.2017;2017;10;06;Perjantai;3;9;12
622;20.10.2017;2017;10;07;Perjantai;7;25;32
622;20.10.2017;2017;10;08;Perjantai;29;45;74
622;20.10.2017;2017;10;09;Perjantai;19;34;53
622;20.10.2017;2017;10;10;Perjantai;8;25;33
622;20.10.2017;2017;10;11;Perjantai;11;14;25
622;20.10.2017;2017;10;12;Perjantai;12;17;29
622;20.10.2017;2017;10;13;Perjantai;21;24;45
622;20.10.2017;2017;10;14;Perjantai;21;25;46
622;20.10.2017;2017;10;15;Perjantai;37;37;74
622;20.10.2017;2017;10;16;Perjantai;39;23;62
622;20.10.2017;2017;10;17;Perjantai;40;34;74
622;20.10.2017;2017;10;18;Perjantai;30;25;55
622;20.10.2017;2017;10;19;Perjantai;21;18;39
622;20.10.2017;2017;10;20;Perjantai;15;9;24
622;20.10.2017;2017;10;21;Perjantai;17;12;29
622;20.10.2017;2017;10;22;Perjantai;5;5;10
622;20.10.2017;2017;10;23;Perjantai;9;2;11
622;21.10.2017;2017;10;00;Lauantai;2;4;6
622;21.10.2017;2017;10;01;Lauantai;1;2;3
622;21.10.2017;2017;10;02;Lauantai;6;1;7
622;21.10.2017;2017;10;03;Lauantai;8;0;8
622;21.10.2017;2017;10;04;Lauantai;0;1;1
622;21.10.2017;2017;10;05;Lauantai;2;2;4
622;21.10.2017;2017;10;06;Lauantai;2;2;4
622;21.10.2017;2017;10;07;Lauantai;2;2;4
622;21.10.2017;2017;10;08;Lauantai;2;2;4
622;21.10.2017;2017;10;09;Lauantai;1;4;5
622;21.10.2017;2017;10;10;Lauantai;6;7;13
622;21.10.2017;2017;10;11;Lauantai;9;13;22
622;21.10.2017;2017;10;12;Lauantai;11;13;24
622;21.10.2017;2017;10;13;Lauantai;16;22;38
622;21.10.2017;2017;10;14;Lauantai;17;27;44
622;21.10.2017;2017;10;15;Lauantai;16;12;28
622;21.10.2017;2017;10;16;Lauantai;17;17;34
622;21.10.2017;2017;10;17;Lauantai;20;15;35
622;21.10.2017;2017;10;18;Lauantai;28;14;42
622;21.10.2017;2017;10;19;Lauantai;18;15;33
622;21.10.2017;2017;10;20;Lauantai;13;11;24
622;21.10.2017;2017;10;21;Lauantai;8;6;14
622;21.10.2017;2017;10;22;Lauantai;3;4;7
622;21.10.2017;2017;10;23;Lauantai;5;3;8
622;22.10.2017;2017;10;00;Sunnuntai;5;2;7
622;22.10.2017;2017;10;01;Sunnuntai;3;2;5
622;22.10.2017;2017;10;02;Sunnuntai;3;3;6
622;22.10.2017;2017;10;03;Sunnuntai;2;0;2
622;22.10.2017;2017;10;04;Sunnuntai;3;0;3
622;22.10.2017;2017;10;05;Sunnuntai;0;0;0
622;22.10.2017;2017;10;06;Sunnuntai;2;3;5
622;22.10.2017;2017;10;07;Sunnuntai;1;4;5
622;22.10.2017;2017;10;08;Sunnuntai;3;1;4
622;22.10.2017;2017;10;09;Sunnuntai;3;5;8
622;22.10.2017;2017;10;10;Sunnuntai;1;5;6
622;22.10.2017;2017;10;11;Sunnuntai;0;8;8
622;22.10.2017;2017;10;12;Sunnuntai;13;21;34
622;22.10.2017;2017;10;13;Sunnuntai;15;21;36
622;22.10.2017;2017;10;14;Sunnuntai;17;13;30
622;22.10.2017;2017;10;15;Sunnuntai;18;18;36
622;22.10.2017;2017;10;16;Sunnuntai;21;19;40
622;22.10.2017;2017;10;17;Sunnuntai;19;12;31
622;22.10.2017;2017;10;18;Sunnuntai;19;15;34
622;22.10.2017;2017;10;19;Sunnuntai;18;17;35
622;22.10.2017;2017;10;20;Sunnuntai;11;5;16
622;22.10.2017;2017;10;21;Sunnuntai;14;15;29
622;22.10.2017;2017;10;22;Sunnuntai;8;2;10
622;22.10.2017;2017;10;23;Sunnuntai;2;4;6
622;23.10.2017;2017;10;00;Maanantai;5;2;7
622;23.10.2017;2017;10;01;Maanantai;0;1;1
622;23.10.2017;2017;10;02;Maanantai;0;2;2
622;23.10.2017;2017;10;03;Maanantai;0;0;0
622;23.10.2017;2017;10;04;Maanantai;1;0;1
622;23.10.2017;2017;10;05;Maanantai;0;2;2
622;23.10.2017;2017;10;06;Maanantai;2;8;10
622;23.10.2017;2017;10;07;Maanantai;4;24;28
622;23.10.2017;2017;10;08;Maanantai;19;34;53
622;23.10.2017;2017;10;09;Maanantai;10;17;27
622;23.10.2017;2017;10;10;Maanantai;7;24;31
622;23.10.2017;2017;10;11;Maanantai;16;17;33
622;23.10.2017;2017;10;12;Maanantai;10;19;29
622;23.10.2017;2017;10;13;Maanantai;6;19;25
622;23.10.2017;2017;10;14;Maanantai;19;19;38
622;23.10.2017;2017;10;15;Maanantai;23;13;36
622;23.10.2017;2017;10;16;Maanantai;42;19;61
622;23.10.2017;2017;10;17;Maanantai;55;27;82
622;23.10.2017;2017;10;18;Maanantai;32;26;58
622;23.10.2017;2017;10;19;Maanantai;14;16;30
622;23.10.2017;2017;10;20;Maanantai;19;14;33
622;23.10.2017;2017;10;21;Maanantai;15;11;26
622;23.10.2017;2017;10;22;Maanantai;9;4;13
622;23.10.2017;2017;10;23;Maanantai;4;2;6
622;24.10.2017;2017;10;00;Tiistai;1;2;3
622;24.10.2017;2017;10;01;Tiistai;0;1;1
622;24.10.2017;2017;10;02;Tiistai;2;0;2
622;24.10.2017;2017;10;03;Tiistai;0;0;0
622;24.10.2017;2017;10;04;Tiistai;0;1;1
622;24.10.2017;2017;10;05;Tiistai;0;2;2
622;24.10.2017;2017;10;06;Tiistai;0;9;9
622;24.10.2017;2017;10;07;Tiistai;2;26;28
622;24.10.2017;2017;10;08;Tiistai;17;39;56
622;24.10.2017;2017;10;09;Tiistai;9;18;27
622;24.10.2017;2017;10;10;Tiistai;6;14;20
622;24.10.2017;2017;10;11;Tiistai;5;6;11
622;24.10.2017;2017;10;12;Tiistai;7;8;15
622;24.10.2017;2017;10;13;Tiistai;17;26;43
622;24.10.2017;2017;10;14;Tiistai;18;20;38
622;24.10.2017;2017;10;15;Tiistai;31;13;44
622;24.10.2017;2017;10;16;Tiistai;48;22;70
622;24.10.2017;2017;10;17;Tiistai;38;20;58
622;24.10.2017;2017;10;18;Tiistai;29;22;51
622;24.10.2017;2017;10;19;Tiistai;21;12;33
622;24.10.2017;2017;10;20;Tiistai;15;7;22
622;24.10.2017;2017;10;21;Tiistai;14;5;19
622;24.10.2017;2017;10;22;Tiistai;9;3;12
622;24.10.2017;2017;10;23;Tiistai;10;4;14
622;25.10.2017;2017;10;00;Keskiviikko;3;5;8
622;25.10.2017;2017;10;01;Keskiviikko;2;3;5
622;25.10.2017;2017;10;02;Keskiviikko;1;2;3
622;25.10.2017;2017;10;03;Keskiviikko;1;0;1
622;25.10.2017;2017;10;04;Keskiviikko;1;0;1
622;25.10.2017;2017;10;05;Keskiviikko;2;1;3
622;25.10.2017;2017;10;06;Keskiviikko;4;11;15
622;25.10.2017;2017;10;07;Keskiviikko;6;27;33
622;25.10.2017;2017;10;08;Keskiviikko;16;34;50
622;25.10.2017;2017;10;09;Keskiviikko;9;20;29
622;25.10.2017;2017;10;10;Keskiviikko;8;18;26
622;25.10.2017;2017;10;11;Keskiviikko;10;13;23
622;25.10.2017;2017;10;12;Keskiviikko;15;23;38
622;25.10.2017;2017;10;13;Keskiviikko;16;15;31
622;25.10.2017;2017;10;14;Keskiviikko;19;27;46
622;25.10.2017;2017;10;15;Keskiviikko;26;14;40
622;25.10.2017;2017;10;16;Keskiviikko;34;20;54
622;25.10.2017;2017;10;17;Keskiviikko;38;20;58
622;25.10.2017;2017;10;18;Keskiviikko;29;22;51
622;25.10.2017;2017;10;19;Keskiviikko;21;12;33
622;25.10.2017;2017;10;20;Keskiviikko;18;16;34
622;25.10.2017;2017;10;21;Keskiviikko;12;10;22
622;25.10.2017;2017;10;22;Keskiviikko;14;6;20
622;25.10.2017;2017;10;23;Keskiviikko;9;1;10
622;26.10.2017;2017;10;00;Torstai;2;1;3
622;26.10.2017;2017;10;01;Torstai;1;1;2
622;26.10.2017;2017;10;02;Torstai;2;2;4
622;26.10.2017;2017;10;03;Torstai;1;0;1
622;26.10.2017;2017;10;04;Torstai;0;0;0
622;26.10.2017;2017;10;05;Torstai;1;0;1
622;26.10.2017;2017;10;06;Torstai;1;6;7
622;26.10.2017;2017;10;07;Torstai;6;19;25
622;26.10.2017;2017;10;08;Torstai;12;34;46
622;26.10.2017;2017;10;09;Torstai;6;17;23
622;26.10.2017;2017;10;10;Torstai;6;14;20
622;26.10.2017;2017;10;11;Torstai;8;16;24
622;26.10.2017;2017;10;12;Torstai;19;13;32
622;26.10.2017;2017;10;13;Torstai;10;11;21
622;26.10.2017;2017;10;14;Torstai;18;20;38
622;26.10.2017;2017;10;15;Torstai;21;13;34
622;26.10.2017;2017;10;16;Torstai;48;22;70
622;26.10.2017;2017;10;17;Torstai;38;20;58
622;26.10.2017;2017;10;18;Torstai;29;22;51
622;26.10.2017;2017;10;19;Torstai;21;12;33
622;26.10.2017;2017;10;20;Torstai;15;7;22
622;26.10.2017;2017;10;21;Torstai;14;5;19
622;26.10.2017;2017;10;22;Torstai;9;3;12
622;26.10.2017;2017;10;23;Torstai;10;4;14
622;27.10.2017;2017;10;00;Perjantai;8;5;13
622;27.10.2017;2017;10;01;Perjantai;8;2;10
622;27.10.2017;2017;10;02;Perjantai;5;1;6
622;27.10.2017;2017;10;03;Perjantai;4;2;6
622;27.10.2017;2017;10;04;Perjantai;2;0;2
622;27.10.2017;2017;10;05;Perjantai;3;2;5
622;27.10.2017;2017;10;06;Perjantai;3;9;12
622;27.10.2017;2017;10;07;Perjantai;7;25;32
622;27.10.2017;2017;10;08;Perjantai;29;45;74
622;27.10.2017;2017;10;09;Perjantai;19;34;53
622;27.10.2017;2017;10;10;Perjantai;8;25;33
622;27.10.2017;2017;10;11;Perjantai;11;14;25
622;27.10.2017;2017;10;12;Perjantai;12;17;29
622;27.10.2017;2017;10;13;Perjantai;21;24;45
622;27.10.2017;2017;10;14;Perjantai;21;25;46
622;27.10.2017;2017;10;15;Perjantai;37;37;74
622;27.10.2017;2017;10;16;Perjantai;39;23;62
622;27.10.2017;2017;10;17;Perjantai;40;34;74
622;27.10.2017;2017;10;18;Perjantai;24;28;52
622;27.10.2017;2017;10;19;Perjantai;26;14;40
622;27.10.2017;2017;10;20;Perjantai;21;15;36
622;27.10.2017;2017;10;21;Perjantai;6;8;14
622;27.10.2017;2017;10;22;Perjantai;16;5;21
622;27.10.2017;2017;10;23;Perjantai;4;3;7
622;28.10.2017;2017;10;00;Lauantai;2;1;3
622;28.10.2017;2017;10;01;Lauantai;2;2;4
622;28.10.2017;2017;10;02;Lauantai;1;0;1
622;28.10.2017;2017;10;03;Lauantai;1;1;2
622;28.10.2017;2017;10;04;Lauantai;0;1;1
622;28.10.2017;2017;10;05;Lauantai;1;0;1
622;28.10.2017;2017;10;06;Lauantai;0;2;2
622;28.10.2017;2017;10;07;Lauantai;3;6;9
622;28.10.2017;2017;10;08;Lauantai;2;2;4
622;28.10.2017;2017;10;09;Lauantai;3;4;7
622;28.10.2017;2017;10;10;Lauantai;3;6;9
622;28.10.2017;2017;10;11;Lauantai;7;13;20
622;28.10.2017;2017;10;12;Lauantai;8;9;17
622;28.10.2017;2017;10;13;Lauantai;9;8;17
622;28.10.2017;2017;10;14;Lauantai;12;13;25
622;28.10.2017;2017;10;15;Lauantai;15;16;31
622;28.10.2017;2017;10;16;Lauantai;5;6;11
622;28.10.2017;2017;10;17;Lauantai;11;9;20
622;28.10.2017;2017;10;18;Lauantai;9;13;22
622;28.10.2017;2017;10;19;Lauantai;10;6;16
622;28.10.2017;2017;10;20;Lauantai;4;6;10
622;28.10.2017;2017;10;21;Lauantai;5;5;10
622;28.10.2017;2017;10;22;Lauantai;1;5;6
622;28.10.2017;2017;10;23;Lauantai;10;4;14
622;29.10.2017;2017;10;00;Sunnuntai;2;1;3
622;29.10.2017;2017;10;01;Sunnuntai;1;3;4
622;29.10.2017;2017;10;02;Sunnuntai;5;2;7
622;29.10.2017;2017;10;03;Sunnuntai;0;0;0
622;29.10.2017;2017;10;04;Sunnuntai;7;1;8
622;29.10.2017;2017;10;05;Sunnuntai;0;2;2
622;29.10.2017;2017;10;06;Sunnuntai;1;1;2
622;29.10.2017;2017;10;07;Sunnuntai;1;4;5
622;29.10.2017;2017;10;08;Sunnuntai;1;1;2
622;29.10.2017;2017;10;09;Sunnuntai;2;7;9
622;29.10.2017;2017;10;10;Sunnuntai;1;1;2
622;29.10.2017;2017;10;11;Sunnuntai;2;4;6
622;29.10.2017;2017;10;12;Sunnuntai;10;12;22
622;29.10.2017;2017;10;13;Sunnuntai;16;13;29
622;29.10.2017;2017;10;14;Sunnuntai;12;13;25
622;29.10.2017;2017;10;15;Sunnuntai;9;9;18
622;29.10.2017;2017;10;16;Sunnuntai;14;6;20
622;29.10.2017;2017;10;17;Sunnuntai;9;18;27
622;29.10.2017;2017;10;18;Sunnuntai;17;13;30
622;29.10.2017;2017;10;19;Sunnuntai;9;10;19
622;29.10.2017;2017;10;20;Sunnuntai;9;10;19
622;29.10.2017;2017;10;21;Sunnuntai;5;5;10
622;29.10.2017;2017;10;22;Sunnuntai;5;2;7
622;29.10.2017;2017;10;23;Sunnuntai;2;1;3
622;30.10.2017;2017;10;00;Maanantai;0;0;0
622;30.10.2017;2017;10;01;Maanantai;0;0;0
622;30.10.2017;2017;10;02;Maanantai;1;1;2
622;30.10.2017;2017;10;03;Maanantai;0;2;2
622;30.10.2017;2017;10;04;Maanantai;0;0;0
622;30.10.2017;2017;10;05;Maanantai;1;4;5
622;30.10.2017;2017;10;06;Maanantai;4;16;20
622;30.10.2017;2017;10;07;Maanantai;4;17;21
622;30.10.2017;2017;10;08;Maanantai;30;45;75
622;30.10.2017;2017;10;09;Maanantai;19;38;57
622;30.10.2017;2017;10;10;Maanantai;9;6;15
622;30.10.2017;2017;10;11;Maanantai;3;3;6
622;30.10.2017;2017;10;12;Maanantai;6;13;19
622;30.10.2017;2017;10;13;Maanantai;13;17;30
622;30.10.2017;2017;10;14;Maanantai;0;0;0
622;30.10.2017;2017;10;15;Maanantai;21;22;43
622;30.10.2017;2017;10;16;Maanantai;36;27;63
622;30.10.2017;2017;10;17;Maanantai;56;34;90
622;30.10.2017;2017;10;18;Maanantai;34;24;58
622;30.10.2017;2017;10;19;Maanantai;17;13;30
622;30.10.2017;2017;10;20;Maanantai;14;17;31
622;30.10.2017;2017;10;21;Maanantai;12;10;22
622;30.10.2017;2017;10;22;Maanantai;11;7;18
622;30.10.2017;2017;10;23;Maanantai;7;2;9
622;31.10.2017;2017;10;00;Tiistai;0;1;1
622;31.10.2017;2017;10;01;Tiistai;2;1;3
622;31.10.2017;2017;10;02;Tiistai;2;1;3
622;31.10.2017;2017;10;03;Tiistai;1;0;1
622;31.10.2017;2017;10;04;Tiistai;2;0;2
622;31.10.2017;2017;10;05;Tiistai;0;1;1
622;31.10.2017;2017;10;06;Tiistai;2;11;13
622;31.10.2017;2017;10;07;Tiistai;3;24;27
622;31.10.2017;2017;10;08;Tiistai;27;50;77
622;31.10.2017;2017;10;09;Tiistai;22;38;60
622;31.10.2017;2017;10;10;Tiistai;8;19;27
622;31.10.2017;2017;10;11;Tiistai;6;15;21
622;31.10.2017;2017;10;12;Tiistai;12;9;21
622;31.10.2017;2017;10;13;Tiistai;16;21;37
622;31.10.2017;2017;10;14;Tiistai;19;19;38
622;31.10.2017;2017;10;15;Tiistai;24;14;38
622;31.10.2017;2017;10;16;Tiistai;40;31;71
622;31.10.2017;2017;10;17;Tiistai;50;35;85
622;31.10.2017;2017;10;18;Tiistai;28;17;45
622;31.10.2017;2017;10;19;Tiistai;30;21;51
622;31.10.2017;2017;10;20;Tiistai;17;19;36
622;31.10.2017;2017;10;21;Tiistai;17;5;22
622;31.10.2017;2017;10;22;Tiistai;14;12;26
622;31.10.2017;2017;10;23;Tiistai;6;2;8
622;01.11.2017;2017;11;00;Keskiviikko;0;3;3
622;01.11.2017;2017;11;01;Keskiviikko;2;0;2
622;01.11.2017;2017;11;02;Keskiviikko;2;1;3
622;01.11.2017;2017;11;03;Keskiviikko;3;0;3
622;01.11.2017;2017;11;04;Keskiviikko;0;0;0
622;01.11.2017;2017;11;05;Keskiviikko;0;0;0
622;01.11.2017;2017;11;06;Keskiviikko;5;8;13
622;01.11.2017;2017;11;07;Keskiviikko;6;28;34
622;01.11.2017;2017;11;08;Keskiviikko;33;44;77
622;01.11.2017;2017;11;09;Keskiviikko;21;34;55
622;01.11.2017;2017;11;10;Keskiviikko;14;14;28
622;01.11.2017;2017;11;11;Keskiviikko;8;13;21
622;01.11.2017;2017;11;12;Keskiviikko;16;11;27
622;01.11.2017;2017;11;13;Keskiviikko;17;16;33
622;01.11.2017;2017;11;14;Keskiviikko;21;31;52
622;01.11.2017;2017;11;15;Keskiviikko;24;20;44
622;01.11.2017;2017;11;16;Keskiviikko;39;28;67
622;01.11.2017;2017;11;17;Keskiviikko;38;30;68
622;01.11.2017;2017;11;18;Keskiviikko;28;18;46
622;01.11.2017;2017;11;19;Keskiviikko;20;7;27
622;01.11.2017;2017;11;20;Keskiviikko;15;4;19
622;01.11.2017;2017;11;21;Keskiviikko;18;10;28
622;01.11.2017;2017;11;22;Keskiviikko;6;7;13
622;01.11.2017;2017;11;23;Keskiviikko;3;6;9
622;02.11.2017;2017;11;00;Torstai;4;3;7
622;02.11.2017;2017;11;01;Torstai;0;0;0
622;02.11.2017;2017;11;02;Torstai;2;0;2
622;02.11.2017;2017;11;03;Torstai;1;0;1
622;02.11.2017;2017;11;04;Torstai;0;0;0
622;02.11.2017;2017;11;05;Torstai;0;1;1
622;02.11.2017;2017;11;06;Torstai;3;9;12
622;02.11.2017;2017;11;07;Torstai;7;22;29
622;02.11.2017;2017;11;08;Torstai;27;47;74
622;02.11.2017;2017;11;09;Torstai;19;29;48
622;02.11.2017;2017;11;10;Torstai;12;18;30
622;02.11.2017;2017;11;11;Torstai;9;12;21
622;02.11.2017;2017;11;12;Torstai;16;23;39
622;02.11.2017;2017;11;13;Torstai;21;22;43
622;02.11.2017;2017;11;14;Torstai;14;14;28
622;02.11.2017;2017;11;15;Torstai;30;20;50
622;02.11.2017;2017;11;16;Torstai;37;19;56
622;02.11.2017;2017;11;17;Torstai;43;25;68
622;02.11.2017;2017;11;18;Torstai;23;23;46
622;02.11.2017;2017;11;19;Torstai;22;9;31
622;02.11.2017;2017;11;20;Torstai;14;17;31
622;02.11.2017;2017;11;21;Torstai;13;15;28
622;02.11.2017;2017;11;22;Torstai;12;5;17
622;02.11.2017;2017;11;23;Torstai;2;4;6
622;03.11.2017;2017;11;00;Perjantai;3;5;8
622;03.11.2017;2017;11;01;Perjantai;3;1;4
622;03.11.2017;2017;11;02;Perjantai;1;2;3
622;03.11.2017;2017;11;03;Perjantai;2;0;2
622;03.11.2017;2017;11;04;Perjantai;2;0;2
622;03.11.2017;2017;11;05;Perjantai;5;2;7
622;03.11.2017;2017;11;06;Perjantai;4;10;14
622;03.11.2017;2017;11;07;Perjantai;3;23;26
622;03.11.2017;2017;11;08;Perjantai;32;40;72
622;03.11.2017;2017;11;09;Perjantai;22;34;56
622;03.11.2017;2017;11;10;Perjantai;12;25;37
622;03.11.2017;2017;11;11;Perjantai;11;20;31
622;03.11.2017;2017;11;12;Perjantai;2;2;4
622;03.11.2017;2017;11;13;Perjantai;0;0;0
622;03.11.2017;2017;11;14;Perjantai;0;0;0
622;03.11.2017;2017;11;15;Perjantai;21;17;38
622;03.11.2017;2017;11;16;Perjantai;46;15;61
622;03.11.2017;2017;11;17;Perjantai;39;34;73
622;03.11.2017;2017;11;18;Perjantai;25;25;50
622;03.11.2017;2017;11;19;Perjantai;28;14;42
622;03.11.2017;2017;11;20;Perjantai;15;10;25
622;03.11.2017;2017;11;21;Perjantai;9;10;19
622;03.11.2017;2017;11;22;Perjantai;12;6;18
622;03.11.2017;2017;11;23;Perjantai;3;5;8
622;04.11.2017;2017;11;00;Lauantai;6;3;9
622;04.11.2017;2017;11;01;Lauantai;4;3;7
622;04.11.2017;2017;11;02;Lauantai;3;1;4
622;04.11.2017;2017;11;03;Lauantai;1;0;1
622;04.11.2017;2017;11;04;Lauantai;2;3;5
622;04.11.2017;2017;11;05;Lauantai;5;1;6
622;04.11.2017;2017;11;06;Lauantai;1;1;2
622;04.11.2017;2017;11;07;Lauantai;2;5;7
622;04.11.2017;2017;11;08;Lauantai;2;2;4
622;04.11.2017;2017;11;09;Lauantai;1;3;4
622;04.11.2017;2017;11;10;Lauantai;9;10;19
622;04.11.2017;2017;11;11;Lauantai;11;9;20
622;04.11.2017;2017;11;12;Lauantai;10;12;22
622;04.11.2017;2017;11;13;Lauantai;13;18;31
622;04.11.2017;2017;11;14;Lauantai;10;8;18
622;04.11.2017;2017;11;15;Lauantai;15;26;41
622;04.11.2017;2017;11;16;Lauantai;10;21;31
622;04.11.2017;2017;11;17;Lauantai;13;11;24
622;04.11.2017;2017;11;18;Lauantai;14;18;32
622;04.11.2017;2017;11;19;Lauantai;17;18;35
622;04.11.2017;2017;11;20;Lauantai;17;8;25
622;04.11.2017;2017;11;21;Lauantai;13;10;23
622;04.11.2017;2017;11;22;Lauantai;8;6;14
622;04.11.2017;2017;11;23;Lauantai;6;7;13
622;05.11.2017;2017;11;00;Sunnuntai;5;3;8
622;05.11.2017;2017;11;01;Sunnuntai;5;2;7
622;05.11.2017;2017;11;02;Sunnuntai;2;2;4
622;05.11.2017;2017;11;03;Sunnuntai;4;1;5
622;05.11.2017;2017;11;04;Sunnuntai;0;0;0
622;05.11.2017;2017;11;05;Sunnuntai;5;1;6
622;05.11.2017;2017;11;06;Sunnuntai;1;1;2
622;05.11.2017;2017;11;07;Sunnuntai;3;1;4
622;05.11.2017;2017;11;08;Sunnuntai;2;1;3
622;05.11.2017;2017;11;09;Sunnuntai;4;7;11
622;05.11.2017;2017;11;10;Sunnuntai;5;6;11
622;05.11.2017;2017;11;11;Sunnuntai;6;12;18
622;05.11.2017;2017;11;12;Sunnuntai;9;14;23
622;05.11.2017;2017;11;13;Sunnuntai;11;14;25
622;05.11.2017;2017;11;14;Sunnuntai;25;19;44
622;05.11.2017;2017;11;15;Sunnuntai;15;20;35
622;05.11.2017;2017;11;16;Sunnuntai;14;10;24
622;05.11.2017;2017;11;17;Sunnuntai;13;6;19
622;05.11.2017;2017;11;18;Sunnuntai;13;14;27
622;05.11.2017;2017;11;19;Sunnuntai;10;8;18
622;05.11.2017;2017;11;20;Sunnuntai;5;9;14
622;05.11.2017;2017;11;21;Sunnuntai;5;5;10
622;05.11.2017;2017;11;22;Sunnuntai;7;5;12
622;05.11.2017;2017;11;23;Sunnuntai;1;4;5
622;06.11.2017;2017;11;00;Maanantai;0;1;1
622;06.11.2017;2017;11;01;Maanantai;4;1;5
622;06.11.2017;2017;11;02;Maanantai;1;0;1
622;06.11.2017;2017;11;03;Maanantai;1;2;3
622;06.11.2017;2017;11;04;Maanantai;1;1;2
622;06.11.2017;2017;11;05;Maanantai;0;0;0
622;06.11.2017;2017;11;06;Maanantai;1;4;5
622;06.11.2017;2017;11;07;Maanantai;6;25;31
622;06.11.2017;2017;11;08;Maanantai;28;47;75
622;06.11.2017;2017;11;09;Maanantai;30;41;71
622;06.11.2017;2017;11;10;Maanantai;11;20;31
622;06.11.2017;2017;11;11;Maanantai;6;9;15
622;06.11.2017;2017;11;12;Maanantai;11;16;27
622;06.11.2017;2017;11;13;Maanantai;15;15;30
622;06.11.2017;2017;11;14;Maanantai;17;14;31
622;06.11.2017;2017;11;15;Maanantai;29;23;52
622;06.11.2017;2017;11;16;Maanantai;36;33;69
622;06.11.2017;2017;11;17;Maanantai;59;28;87
622;06.11.2017;2017;11;18;Maanantai;31;27;58
622;06.11.2017;2017;11;19;Maanantai;39;28;67
622;06.11.2017;2017;11;20;Maanantai;19;17;36
622;06.11.2017;2017;11;21;Maanantai;9;7;16
622;06.11.2017;2017;11;22;Maanantai;12;5;17
622;06.11.2017;2017;11;23;Maanantai;5;1;6
622;07.11.2017;2017;11;00;Tiistai;4;1;5
622;07.11.2017;2017;11;01;Tiistai;1;1;2
622;07.11.2017;2017;11;02;Tiistai;2;1;3
622;07.11.2017;2017;11;03;Tiistai;4;1;5
622;07.11.2017;2017;11;04;Tiistai;1;0;1
622;07.11.2017;2017;11;05;Tiistai;0;1;1
622;07.11.2017;2017;11;06;Tiistai;0;5;5
622;07.11.2017;2017;11;07;Tiistai;8;33;41
622;07.11.2017;2017;11;08;Tiistai;31;50;81
622;07.11.2017;2017;11;09;Tiistai;23;36;59
622;07.11.2017;2017;11;10;Tiistai;20;21;41
622;07.11.2017;2017;11;11;Tiistai;12;19;31
622;07.11.2017;2017;11;12;Tiistai;25;23;48
622;07.11.2017;2017;11;13;Tiistai;25;23;48
622;07.11.2017;2017;11;14;Tiistai;32;26;58
622;07.11.2017;2017;11;15;Tiistai;42;32;74
622;07.11.2017;2017;11;16;Tiistai;61;32;93
622;07.11.2017;2017;11;17;Tiistai;57;35;92
622;07.11.2017;2017;11;18;Tiistai;49;26;75
622;07.11.2017;2017;11;19;Tiistai;23;13;36
622;07.11.2017;2017;11;20;Tiistai;31;23;54
622;07.11.2017;2017;11;21;Tiistai;19;10;29
622;07.11.2017;2017;11;22;Tiistai;10;13;23
622;07.11.2017;2017;11;23;Tiistai;8;8;16
622;08.11.2017;2017;11;00;Keskiviikko;4;3;7
622;08.11.2017;2017;11;01;Keskiviikko;3;0;3
622;08.11.2017;2017;11;02;Keskiviikko;1;1;2
622;08.11.2017;2017;11;03;Keskiviikko;0;1;1
622;08.11.2017;2017;11;04;Keskiviikko;1;0;1
622;08.11.2017;2017;11;05;Keskiviikko;0;2;2
622;08.11.2017;2017;11;06;Keskiviikko;0;9;9
622;08.11.2017;2017;11;07;Keskiviikko;8;33;41
622;08.11.2017;2017;11;08;Keskiviikko;40;47;87
622;08.11.2017;2017;11;09;Keskiviikko;27;39;66
622;08.11.2017;2017;11;10;Keskiviikko;15;22;37
622;08.11.2017;2017;11;11;Keskiviikko;11;23;34
622;08.11.2017;2017;11;12;Keskiviikko;17;16;33
622;08.11.2017;2017;11;13;Keskiviikko;19;19;38
622;08.11.2017;2017;11;14;Keskiviikko;22;15;37
622;08.11.2017;2017;11;15;Keskiviikko;36;30;66
622;08.11.2017;2017;11;16;Keskiviikko;60;40;100
622;08.11.2017;2017;11;17;Keskiviikko;50;38;88
622;08.11.2017;2017;11;18;Keskiviikko;38;32;70
622;08.11.2017;2017;11;19;Keskiviikko;33;14;47
622;08.11.2017;2017;11;20;Keskiviikko;14;12;26
622;08.11.2017;2017;11;21;Keskiviikko;15;12;27
622;08.11.2017;2017;11;22;Keskiviikko;10;3;13
622;08.11.2017;2017;11;23;Keskiviikko;7;1;8
622;09.11.2017;2017;11;00;Torstai;2;3;5
622;09.11.2017;2017;11;01;Torstai;2;3;5
622;09.11.2017;2017;11;02;Torstai;1;2;3
622;09.11.2017;2017;11;03;Torstai;1;1;2
622;09.11.2017;2017;11;04;Torstai;3;2;5
622;09.11.2017;2017;11;05;Torstai;1;3;4
622;09.11.2017;2017;11;06;Torstai;2;10;12
622;09.11.2017;2017;11;07;Torstai;5;26;31
622;09.11.2017;2017;11;08;Torstai;36;51;87
622;09.11.2017;2017;11;09;Torstai;28;36;64
622;09.11.2017;2017;11;10;Torstai;17;20;37
622;09.11.2017;2017;11;11;Torstai;19;19;38
622;09.11.2017;2017;11;12;Torstai;21;20;41
622;09.11.2017;2017;11;13;Torstai;18;27;45
622;09.11.2017;2017;11;14;Torstai;32;22;54
622;09.11.2017;2017;11;15;Torstai;26;33;59
622;09.11.2017;2017;11;16;Torstai;49;29;78
622;09.11.2017;2017;11;17;Torstai;61;33;94
622;09.11.2017;2017;11;18;Torstai;37;24;61
622;09.11.2017;2017;11;19;Torstai;27;16;43
622;09.11.2017;2017;11;20;Torstai;20;16;36
622;09.11.2017;2017;11;21;Torstai;21;17;38
622;09.11.2017;2017;11;22;Torstai;11;7;18
622;09.11.2017;2017;11;23;Torstai;9;3;12
622;10.11.2017;2017;11;00;Perjantai;4;4;8
622;10.11.2017;2017;11;01;Perjantai;2;2;4
622;10.11.2017;2017;11;02;Perjantai;3;1;4
622;10.11.2017;2017;11;03;Perjantai;7;2;9
622;10.11.2017;2017;11;04;Perjantai;0;0;0
622;10.11.2017;2017;11;05;Perjantai;1;1;2
622;10.11.2017;2017;11;06;Perjantai;3;7;10
622;10.11.2017;2017;11;07;Perjantai;6;20;26
622;10.11.2017;2017;11;08;Perjantai;30;41;71
622;10.11.2017;2017;11;09;Perjantai;25;38;63
622;10.11.2017;2017;11;10;Perjantai;17;24;41
622;10.11.2017;2017;11;11;Perjantai;16;10;26
622;10.11.2017;2017;11;12;Perjantai;22;24;46
622;10.11.2017;2017;11;13;Perjantai;17;28;45
622;10.11.2017;2017;11;14;Perjantai;27;18;45
622;10.11.2017;2017;11;15;Perjantai;42;35;77
622;10.11.2017;2017;11;16;Perjantai;47;26;73
622;10.11.2017;2017;11;17;Perjantai;65;37;102
622;10.11.2017;2017;11;18;Perjantai;36;33;69
622;10.11.2017;2017;11;19;Perjantai;24;23;47
622;10.11.2017;2017;11;20;Perjantai;26;15;41
622;10.11.2017;2017;11;21;Perjantai;21;17;38
622;10.11.2017;2017;11;22;Perjantai;11;3;14
622;10.11.2017;2017;11;23;Perjantai;12;3;15
622;11.11.2017;2017;11;00;Lauantai;3;3;6
622;11.11.2017;2017;11;01;Lauantai;3;4;7
622;11.11.2017;2017;11;02;Lauantai;4;3;7
622;11.11.2017;2017;11;03;Lauantai;2;2;4
622;11.11.2017;2017;11;04;Lauantai;2;1;3
622;11.11.2017;2017;11;05;Lauantai;3;2;5
622;11.11.2017;2017;11;06;Lauantai;1;4;5
622;11.11.2017;2017;11;07;Lauantai;0;2;2
622;11.11.2017;2017;11;08;Lauantai;3;5;8
622;11.11.2017;2017;11;09;Lauantai;2;10;12
622;11.11.2017;2017;11;10;Lauantai;9;13;22
622;11.11.2017;2017;11;11;Lauantai;13;26;39
622;11.11.2017;2017;11;12;Lauantai;17;12;29
622;11.11.2017;2017;11;13;Lauantai;24;32;56
622;11.11.2017;2017;11;14;Lauantai;32;22;54
622;11.11.2017;2017;11;15;Lauantai;31;23;54
622;11.11.2017;2017;11;16;Lauantai;24;22;46
622;11.11.2017;2017;11;17;Lauantai;23;21;44
622;11.11.2017;2017;11;18;Lauantai;14;15;29
622;11.11.2017;2017;11;19;Lauantai;10;12;22
622;11.11.2017;2017;11;20;Lauantai;12;9;21
622;11.11.2017;2017;11;21;Lauantai;15;8;23
622;11.11.2017;2017;11;22;Lauantai;12;5;17
622;11.11.2017;2017;11;23;Lauantai;8;5;13
622;12.11.2017;2017;11;00;Sunnuntai;5;5;10
622;12.11.2017;2017;11;01;Sunnuntai;4;1;5
622;12.11.2017;2017;11;02;Sunnuntai;4;2;6
622;12.11.2017;2017;11;03;Sunnuntai;1;0;1
622;12.11.2017;2017;11;04;Sunnuntai;5;1;6
622;12.11.2017;2017;11;05;Sunnuntai;1;1;2
622;12.11.2017;2017;11;06;Sunnuntai;1;2;3
622;12.11.2017;2017;11;07;Sunnuntai;0;1;1
622;12.11.2017;2017;11;08;Sunnuntai;2;2;4
622;12.11.2017;2017;11;09;Sunnuntai;1;4;5
622;12.11.2017;2017;11;10;Sunnuntai;3;9;12
622;12.11.2017;2017;11;11;Sunnuntai;4;17;21
622;12.11.2017;2017;11;12;Sunnuntai;12;11;23
622;12.11.2017;2017;11;13;Sunnuntai;16;10;26
622;12.11.2017;2017;11;14;Sunnuntai;20;13;33
622;12.11.2017;2017;11;15;Sunnuntai;16;18;34
622;12.11.2017;2017;11;16;Sunnuntai;18;15;33
622;12.11.2017;2017;11;17;Sunnuntai;20;11;31
622;12.11.2017;2017;11;18;Sunnuntai;14;14;28
622;12.11.2017;2017;11;19;Sunnuntai;16;15;31
622;12.11.2017;2017;11;20;Sunnuntai;10;8;18
622;12.11.2017;2017;11;21;Sunnuntai;13;6;19
622;12.11.2017;2017;11;22;Sunnuntai;9;3;12
622;12.11.2017;2017;11;23;Sunnuntai;2;4;6
622;13.11.2017;2017;11;00;Maanantai;0;2;2
622;13.11.2017;2017;11;01;Maanantai;1;0;1
622;13.11.2017;2017;11;02;Maanantai;0;0;0
622;13.11.2017;2017;11;03;Maanantai;1;1;2
622;13.11.2017;2017;11;04;Maanantai;0;1;1
622;13.11.2017;2017;11;05;Maanantai;0;2;2
622;13.11.2017;2017;11;06;Maanantai;1;5;6
622;13.11.2017;2017;11;07;Maanantai;6;30;36
622;13.11.2017;2017;11;08;Maanantai;25;47;72
622;13.11.2017;2017;11;09;Maanantai;30;43;73
622;13.11.2017;2017;11;10;Maanantai;16;17;33
622;13.11.2017;2017;11;11;Maanantai;11;10;21
622;13.11.2017;2017;11;12;Maanantai;13;21;34
622;13.11.2017;2017;11;13;Maanantai;16;14;30
622;13.11.2017;2017;11;14;Maanantai;35;24;59
622;13.11.2017;2017;11;15;Maanantai;34;35;69
622;13.11.2017;2017;11;16;Maanantai;64;30;94
622;13.11.2017;2017;11;17;Maanantai;65;34;99
622;13.11.2017;2017;11;18;Maanantai;38;28;66
622;13.11.2017;2017;11;19;Maanantai;31;19;50
622;13.11.2017;2017;11;20;Maanantai;19;12;31
622;13.11.2017;2017;11;21;Maanantai;16;9;25
622;13.11.2017;2017;11;22;Maanantai;12;7;19
622;13.11.2017;2017;11;23;Maanantai;3;3;6
622;14.11.2017;2017;11;00;Tiistai;1;3;4
622;14.11.2017;2017;11;01;Tiistai;4;2;6
622;14.11.2017;2017;11;02;Tiistai;0;1;1
622;14.11.2017;2017;11;03;Tiistai;0;0;0
622;14.11.2017;2017;11;04;Tiistai;0;0;0
622;14.11.2017;2017;11;05;Tiistai;1;0;1
622;14.11.2017;2017;11;06;Tiistai;1;6;7
622;14.11.2017;2017;11;07;Tiistai;6;25;31
622;14.11.2017;2017;11;08;Tiistai;21;48;69
622;14.11.2017;2017;11;09;Tiistai;23;35;58
622;14.11.2017;2017;11;10;Tiistai;16;19;35
622;14.11.2017;2017;11;11;Tiistai;11;13;24
622;14.11.2017;2017;11;12;Tiistai;16;22;38
622;14.11.2017;2017;11;13;Tiistai;10;17;27
622;14.11.2017;2017;11;14;Tiistai;25;28;53
622;14.11.2017;2017;11;15;Tiistai;23;15;38
622;14.11.2017;2017;11;16;Tiistai;58;29;87
622;14.11.2017;2017;11;17;Tiistai;56;43;99
622;14.11.2017;2017;11;18;Tiistai;33;20;53
622;14.11.2017;2017;11;19;Tiistai;26;21;47
622;14.11.2017;2017;11;20;Tiistai;21;17;38
622;14.11.2017;2017;11;21;Tiistai;14;10;24
622;14.11.2017;2017;11;22;Tiistai;9;12;21
622;14.11.2017;2017;11;23;Tiistai;5;6;11
622;15.11.2017;2017;11;00;Keskiviikko;4;2;6
622;15.11.2017;2017;11;01;Keskiviikko;5;1;6
622;15.11.2017;2017;11;02;Keskiviikko;0;0;0
622;15.11.2017;2017;11;03;Keskiviikko;1;0;1
622;15.11.2017;2017;11;04;Keskiviikko;0;0;0
622;15.11.2017;2017;11;05;Keskiviikko;2;2;4
622;15.11.2017;2017;11;06;Keskiviikko;2;9;11
622;15.11.2017;2017;11;07;Keskiviikko;8;32;40
622;15.11.2017;2017;11;08;Keskiviikko;31;50;81
622;15.11.2017;2017;11;09;Keskiviikko;24;41;65
622;15.11.2017;2017;11;10;Keskiviikko;7;17;24
622;15.11.2017;2017;11;11;Keskiviikko;15;17;32
622;15.11.2017;2017;11;12;Keskiviikko;10;16;26
622;15.11.2017;2017;11;13;Keskiviikko;24;18;42
622;15.11.2017;2017;11;14;Keskiviikko;24;17;41
622;15.11.2017;2017;11;15;Keskiviikko;17;23;40
622;15.11.2017;2017;11;16;Keskiviikko;23;24;47
622;15.11.2017;2017;11;17;Keskiviikko;60;27;87
622;15.11.2017;2017;11;18;Keskiviikko;28;26;54
622;15.11.2017;2017;11;19;Keskiviikko;24;19;43
622;15.11.2017;2017;11;20;Keskiviikko;18;10;28
622;15.11.2017;2017;11;21;Keskiviikko;17;12;29
622;15.11.2017;2017;11;22;Keskiviikko;19;6;25
622;15.11.2017;2017;11;23;Keskiviikko;5;0;5
622;16.11.2017;2017;11;00;Torstai;3;3;6
622;16.11.2017;2017;11;01;Torstai;0;1;1
622;16.11.2017;2017;11;02;Torstai;0;0;0
622;16.11.2017;2017;11;03;Torstai;2;0;2
622;16.11.2017;2017;11;04;Torstai;0;0;0
622;16.11.2017;2017;11;05;Torstai;1;3;4
622;16.11.2017;2017;11;06;Torstai;2;5;7
622;16.11.2017;2017;11;07;Torstai;6;31;37
622;16.11.2017;2017;11;08;Torstai;27;49;76
622;16.11.2017;2017;11;09;Torstai;22;34;56
622;16.11.2017;2017;11;10;Torstai;14;19;33
622;16.11.2017;2017;11;11;Torstai;8;20;28
622;16.11.2017;2017;11;12;Torstai;17;26;43
622;16.11.2017;2017;11;13;Torstai;17;15;32
622;16.11.2017;2017;11;14;Torstai;19;16;35
622;16.11.2017;2017;11;15;Torstai;27;16;43
622;16.11.2017;2017;11;16;Torstai;38;26;64
622;16.11.2017;2017;11;17;Torstai;50;35;85
622;16.11.2017;2017;11;18;Torstai;37;28;65
622;16.11.2017;2017;11;19;Torstai;30;28;58
622;16.11.2017;2017;11;20;Torstai;23;9;32
622;16.11.2017;2017;11;21;Torstai;17;12;29
622;16.11.2017;2017;11;22;Torstai;8;7;15
622;16.11.2017;2017;11;23;Torstai;7;1;8
622;17.11.2017;2017;11;00;Perjantai;10;2;12
622;17.11.2017;2017;11;01;Perjantai;3;2;5
622;17.11.2017;2017;11;02;Perjantai;4;3;7
622;17.11.2017;2017;11;03;Perjantai;0;0;0
622;17.11.2017;2017;11;04;Perjantai;1;0;1
622;17.11.2017;2017;11;05;Perjantai;1;1;2
622;17.11.2017;2017;11;06;Perjantai;2;2;4
622;17.11.2017;2017;11;07;Perjantai;9;22;31
622;17.11.2017;2017;11;08;Perjantai;23;34;57
622;17.11.2017;2017;11;09;Perjantai;18;35;53
622;17.11.2017;2017;11;10;Perjantai;18;16;34
622;17.11.2017;2017;11;11;Perjantai;6;14;20
622;17.11.2017;2017;11;12;Perjantai;6;18;24
622;17.11.2017;2017;11;13;Perjantai;18;13;31
622;17.11.2017;2017;11;14;Perjantai;17;21;38
622;17.11.2017;2017;11;15;Perjantai;32;20;52
622;17.11.2017;2017;11;16;Perjantai;33;23;56
622;17.11.2017;2017;11;17;Perjantai;39;14;53
622;17.11.2017;2017;11;18;Perjantai;22;21;43
622;17.11.2017;2017;11;19;Perjantai;20;13;33
622;17.11.2017;2017;11;20;Perjantai;13;7;20
622;17.11.2017;2017;11;21;Perjantai;7;9;16
622;17.11.2017;2017;11;22;Perjantai;3;5;8
622;17.11.2017;2017;11;23;Perjantai;7;3;10
622;18.11.2017;2017;11;00;Lauantai;3;1;4
622;18.11.2017;2017;11;01;Lauantai;3;1;4
622;18.11.2017;2017;11;02;Lauantai;2;1;3
622;18.11.2017;2017;11;03;Lauantai;3;0;3
622;18.11.2017;2017;11;04;Lauantai;2;3;5
622;18.11.2017;2017;11;05;Lauantai;5;1;6
622;18.11.2017;2017;11;06;Lauantai;0;4;4
622;18.11.2017;2017;11;07;Lauantai;3;3;6
622;18.11.2017;2017;11;08;Lauantai;4;1;5
622;18.11.2017;2017;11;09;Lauantai;0;4;4
622;18.11.2017;2017;11;10;Lauantai;8;7;15
622;18.11.2017;2017;11;11;Lauantai;5;14;19
622;18.11.2017;2017;11;12;Lauantai;11;12;23
622;18.11.2017;2017;11;13;Lauantai;10;18;28
622;18.11.2017;2017;11;14;Lauantai;15;14;29
622;18.11.2017;2017;11;15;Lauantai;12;13;25
622;18.11.2017;2017;11;16;Lauantai;19;17;36
622;18.11.2017;2017;11;17;Lauantai;8;6;14
622;18.11.2017;2017;11;18;Lauantai;9;10;19
622;18.11.2017;2017;11;19;Lauantai;15;6;21
622;18.11.2017;2017;11;20;Lauantai;9;9;18
622;18.11.2017;2017;11;21;Lauantai;5;7;12
622;18.11.2017;2017;11;22;Lauantai;9;3;12
622;18.11.2017;2017;11;23;Lauantai;8;2;10
622;19.11.2017;2017;11;00;Sunnuntai;4;4;8
622;19.11.2017;2017;11;01;Sunnuntai;4;5;9
622;19.11.2017;2017;11;02;Sunnuntai;6;6;12
622;19.11.2017;2017;11;03;Sunnuntai;2;2;4
622;19.11.2017;2017;11;04;Sunnuntai;1;2;3
622;19.11.2017;2017;11;05;Sunnuntai;2;0;2
622;19.11.2017;2017;11;06;Sunnuntai;2;1;3
622;19.11.2017;2017;11;07;Sunnuntai;0;2;2
622;19.11.2017;2017;11;08;Sunnuntai;1;1;2
622;19.11.2017;2017;11;09;Sunnuntai;1;3;4
622;19.11.2017;2017;11;10;Sunnuntai;1;4;5
622;19.11.2017;2017;11;11;Sunnuntai;6;7;13
622;19.11.2017;2017;11;12;Sunnuntai;8;10;18
622;19.11.2017;2017;11;13;Sunnuntai;14;7;21
622;19.11.2017;2017;11;14;Sunnuntai;13;17;30
622;19.11.2017;2017;11;15;Sunnuntai;13;15;28
622;19.11.2017;2017;11;16;Sunnuntai;14;14;28
622;19.11.2017;2017;11;17;Sunnuntai;11;14;25
622;19.11.2017;2017;11;18;Sunnuntai;12;9;21
622;19.11.2017;2017;11;19;Sunnuntai;7;4;11
622;19.11.2017;2017;11;20;Sunnuntai;3;8;11
622;19.11.2017;2017;11;21;Sunnuntai;12;5;17
622;19.11.2017;2017;11;22;Sunnuntai;9;5;14
622;19.11.2017;2017;11;23;Sunnuntai;2;2;4
622;20.11.2017;2017;11;00;Maanantai;2;0;2
622;20.11.2017;2017;11;01;Maanantai;1;2;3
622;20.11.2017;2017;11;02;Maanantai;1;0;1
622;20.11.2017;2017;11;03;Maanantai;0;2;2
622;20.11.2017;2017;11;04;Maanantai;2;0;2
622;20.11.2017;2017;11;05;Maanantai;3;3;6
622;20.11.2017;2017;11;06;Maanantai;4;7;11
622;20.11.2017;2017;11;07;Maanantai;8;26;34
622;20.11.2017;2017;11;08;Maanantai;31;43;74
622;20.11.2017;2017;11;09;Maanantai;30;36;66
622;20.11.2017;2017;11;10;Maanantai;7;20;27
622;20.11.2017;2017;11;11;Maanantai;8;16;24
622;20.11.2017;2017;11;12;Maanantai;14;12;26
622;20.11.2017;2017;11;13;Maanantai;18;22;40
622;20.11.2017;2017;11;14;Maanantai;17;16;33
622;20.11.2017;2017;11;15;Maanantai;21;16;37
622;20.11.2017;2017;11;16;Maanantai;41;25;66
622;20.11.2017;2017;11;17;Maanantai;63;29;92
622;20.11.2017;2017;11;18;Maanantai;39;30;69
622;20.11.2017;2017;11;19;Maanantai;24;15;39
622;20.11.2017;2017;11;20;Maanantai;19;21;40
622;20.11.2017;2017;11;21;Maanantai;19;7;26
622;20.11.2017;2017;11;22;Maanantai;12;3;15
622;20.11.2017;2017;11;23;Maanantai;8;2;10
622;21.11.2017;2017;11;00;Tiistai;3;2;5
622;21.11.2017;2017;11;01;Tiistai;4;1;5
622;21.11.2017;2017;11;02;Tiistai;2;0;2
622;21.11.2017;2017;11;03;Tiistai;1;0;1
622;21.11.2017;2017;11;04;Tiistai;0;0;0
622;21.11.2017;2017;11;05;Tiistai;0;0;0
622;21.11.2017;2017;11;06;Tiistai;1;6;7
622;21.11.2017;2017;11;07;Tiistai;5;25;30
622;21.11.2017;2017;11;08;Tiistai;21;45;66
622;21.11.2017;2017;11;09;Tiistai;20;42;62
622;21.11.2017;2017;11;10;Tiistai;11;16;27
622;21.11.2017;2017;11;11;Tiistai;6;7;13
622;21.11.2017;2017;11;12;Tiistai;9;15;24
622;21.11.2017;2017;11;13;Tiistai;14;12;26
622;21.11.2017;2017;11;14;Tiistai;15;15;30
622;21.11.2017;2017;11;15;Tiistai;20;20;40
622;21.11.2017;2017;11;16;Tiistai;47;14;61
622;21.11.2017;2017;11;17;Tiistai;50;18;68
622;21.11.2017;2017;11;18;Tiistai;31;18;49
622;21.11.2017;2017;11;19;Tiistai;24;17;41
622;21.11.2017;2017;11;20;Tiistai;12;11;23
622;21.11.2017;2017;11;21;Tiistai;17;7;24
622;21.11.2017;2017;11;22;Tiistai;13;8;21
622;21.11.2017;2017;11;23;Tiistai;6;4;10
622;22.11.2017;2017;11;00;Keskiviikko;4;2;6
622;22.11.2017;2017;11;01;Keskiviikko;2;2;4
622;22.11.2017;2017;11;02;Keskiviikko;0;0;0
622;22.11.2017;2017;11;03;Keskiviikko;1;1;2
622;22.11.2017;2017;11;04;Keskiviikko;2;1;3
622;22.11.2017;2017;11;05;Keskiviikko;1;1;2
622;22.11.2017;2017;11;06;Keskiviikko;2;10;12
622;22.11.2017;2017;11;07;Keskiviikko;6;29;35
622;22.11.2017;2017;11;08;Keskiviikko;24;38;62
622;22.11.2017;2017;11;09;Keskiviikko;15;38;53
622;22.11.2017;2017;11;10;Keskiviikko;8;12;20
622;22.11.2017;2017;11;11;Keskiviikko;8;14;22
622;22.11.2017;2017;11;12;Keskiviikko;14;11;25
622;22.11.2017;2017;11;13;Keskiviikko;15;10;25
622;22.11.2017;2017;11;14;Keskiviikko;14;17;31
622;22.11.2017;2017;11;15;Keskiviikko;31;17;48
622;22.11.2017;2017;11;16;Keskiviikko;50;23;73
622;22.11.2017;2017;11;17;Keskiviikko;39;19;58
622;22.11.2017;2017;11;18;Keskiviikko;22;28;50
622;22.11.2017;2017;11;19;Keskiviikko;20;22;42
622;22.11.2017;2017;11;20;Keskiviikko;13;7;20
622;22.11.2017;2017;11;21;Keskiviikko;11;12;23
622;22.11.2017;2017;11;22;Keskiviikko;7;7;14
622;22.11.2017;2017;11;23;Keskiviikko;3;2;5
622;23.11.2017;2017;11;00;Torstai;4;2;6
622;23.11.2017;2017;11;01;Torstai;3;1;4
622;23.11.2017;2017;11;02;Torstai;3;1;4
622;23.11.2017;2017;11;03;Torstai;2;1;3
622;23.11.2017;2017;11;04;Torstai;1;0;1
622;23.11.2017;2017;11;05;Torstai;1;0;1
622;23.11.2017;2017;11;06;Torstai;1;4;5
622;23.11.2017;2017;11;07;Torstai;4;17;21
622;23.11.2017;2017;11;08;Torstai;20;32;52
622;23.11.2017;2017;11;09;Torstai;23;29;52
622;23.11.2017;2017;11;10;Torstai;8;14;22
622;23.11.2017;2017;11;11;Torstai;6;9;15
622;23.11.2017;2017;11;12;Torstai;12;9;21
622;23.11.2017;2017;11;13;Torstai;8;13;21
622;23.11.2017;2017;11;14;Torstai;14;15;29
622;23.11.2017;2017;11;15;Torstai;21;11;32
622;23.11.2017;2017;11;16;Torstai;30;16;46
622;23.11.2017;2017;11;17;Torstai;32;17;49
622;23.11.2017;2017;11;18;Torstai;14;13;27
622;23.11.2017;2017;11;19;Torstai;9;7;16
622;23.11.2017;2017;11;20;Torstai;10;7;17
622;23.11.2017;2017;11;21;Torstai;8;8;16
622;23.11.2017;2017;11;22;Torstai;5;1;6
622;23.11.2017;2017;11;23;Torstai;2;3;5
622;24.11.2017;2017;11;00;Perjantai;2;0;2
622;24.11.2017;2017;11;01;Perjantai;1;1;2
622;24.11.2017;2017;11;02;Perjantai;1;0;1
622;24.11.2017;2017;11;03;Perjantai;0;0;0
622;24.11.2017;2017;11;04;Perjantai;0;4;4
622;24.11.2017;2017;11;05;Perjantai;2;0;2
622;24.11.2017;2017;11;06;Perjantai;0;7;7
622;24.11.2017;2017;11;07;Perjantai;3;16;19
622;24.11.2017;2017;11;08;Perjantai;10;20;30
622;24.11.2017;2017;11;09;Perjantai;14;20;34
622;24.11.2017;2017;11;10;Perjantai;6;3;9
622;24.11.2017;2017;11;11;Perjantai;5;11;16
622;24.11.2017;2017;11;12;Perjantai;13;15;28
622;24.11.2017;2017;11;13;Perjantai;5;13;18
622;24.11.2017;2017;11;14;Perjantai;6;11;17
622;24.11.2017;2017;11;15;Perjantai;10;5;15
622;24.11.2017;2017;11;16;Perjantai;23;15;38
622;24.11.2017;2017;11;17;Perjantai;20;15;35
622;24.11.2017;2017;11;18;Perjantai;19;17;36
622;24.11.2017;2017;11;19;Perjantai;9;9;18
622;24.11.2017;2017;11;20;Perjantai;12;5;17
622;24.11.2017;2017;11;21;Perjantai;5;8;13
622;24.11.2017;2017;11;22;Perjantai;8;6;14
622;24.11.2017;2017;11;23;Perjantai;7;5;12
622;25.11.2017;2017;11;00;Lauantai;0;2;2
622;25.11.2017;2017;11;01;Lauantai;7;3;10
622;25.11.2017;2017;11;02;Lauantai;2;1;3
622;25.11.2017;2017;11;03;Lauantai;2;1;3
622;25.11.2017;2017;11;04;Lauantai;3;2;5
622;25.11.2017;2017;11;05;Lauantai;2;2;4
622;25.11.2017;2017;11;06;Lauantai;2;2;4
622;25.11.2017;2017;11;07;Lauantai;1;6;7
622;25.11.2017;2017;11;08;Lauantai;3;3;6
622;25.11.2017;2017;11;09;Lauantai;2;4;6
622;25.11.2017;2017;11;10;Lauantai;6;9;15
622;25.11.2017;2017;11;11;Lauantai;5;8;13
622;25.11.2017;2017;11;12;Lauantai;8;9;17
622;25.11.2017;2017;11;13;Lauantai;13;13;26
622;25.11.2017;2017;11;14;Lauantai;6;16;22
622;25.11.2017;2017;11;15;Lauantai;11;9;20
622;25.11.2017;2017;11;16;Lauantai;8;9;17
622;25.11.2017;2017;11;17;Lauantai;9;6;15
622;25.11.2017;2017;11;18;Lauantai;10;10;20
622;25.11.2017;2017;11;19;Lauantai;9;12;21
622;25.11.2017;2017;11;20;Lauantai;9;6;15
622;25.11.2017;2017;11;21;Lauantai;7;7;14
622;25.11.2017;2017;11;22;Lauantai;10;7;17
622;25.11.2017;2017;11;23;Lauantai;5;3;8
622;26.11.2017;2017;11;00;Sunnuntai;1;0;1
622;26.11.2017;2017;11;01;Sunnuntai;4;2;6
622;26.11.2017;2017;11;02;Sunnuntai;3;0;3
622;26.11.2017;2017;11;03;Sunnuntai;2;0;2
622;26.11.2017;2017;11;04;Sunnuntai;2;2;4
622;26.11.2017;2017;11;05;Sunnuntai;4;2;6
622;26.11.2017;2017;11;06;Sunnuntai;0;1;1
622;26.11.2017;2017;11;07;Sunnuntai;1;1;2
622;26.11.2017;2017;11;08;Sunnuntai;3;2;5
622;26.11.2017;2017;11;09;Sunnuntai;2;5;7
622;26.11.2017;2017;11;10;Sunnuntai;4;0;4
622;26.11.2017;2017;11;11;Sunnuntai;4;6;10
622;26.11.2017;2017;11;12;Sunnuntai;10;9;19
622;26.11.2017;2017;11;13;Sunnuntai;13;16;29
622;26.11.2017;2017;11;14;Sunnuntai;12;21;33
622;26.11.2017;2017;11;15;Sunnuntai;17;14;31
622;26.11.2017;2017;11;16;Sunnuntai;15;10;25
622;26.11.2017;2017;11;17;Sunnuntai;10;9;19
622;26.11.2017;2017;11;18;Sunnuntai;10;5;15
622;26.11.2017;2017;11;19;Sunnuntai;10;9;19
622;26.11.2017;2017;11;20;Sunnuntai;10;6;16
622;26.11.2017;2017;11;21;Sunnuntai;5;9;14
622;26.11.2017;2017;11;22;Sunnuntai;7;3;10
622;26.11.2017;2017;11;23;Sunnuntai;6;1;7
622;27.11.2017;2017;11;00;Maanantai;2;0;2
622;27.11.2017;2017;11;01;Maanantai;1;0;1
622;27.11.2017;2017;11;02;Maanantai;0;0;0
622;27.11.2017;2017;11;03;Maanantai;0;0;0
622;27.11.2017;2017;11;04;Maanantai;0;1;1
622;27.11.2017;2017;11;05;Maanantai;1;3;4
622;27.11.2017;2017;11;06;Maanantai;2;8;10
622;27.11.2017;2017;11;07;Maanantai;4;22;26
622;27.11.2017;2017;11;08;Maanantai;30;34;64
622;27.11.2017;2017;11;09;Maanantai;27;41;68
622;27.11.2017;2017;11;10;Maanantai;6;14;20
622;27.11.2017;2017;11;11;Maanantai;12;17;29
622;27.11.2017;2017;11;12;Maanantai;10;10;20
622;27.11.2017;2017;11;13;Maanantai;16;26;42
622;27.11.2017;2017;11;14;Maanantai;13;15;28
622;27.11.2017;2017;11;15;Maanantai;22;16;38
622;27.11.2017;2017;11;16;Maanantai;41;26;67
622;27.11.2017;2017;11;17;Maanantai;53;28;81
622;27.11.2017;2017;11;18;Maanantai;32;28;60
622;27.11.2017;2017;11;19;Maanantai;14;17;31
622;27.11.2017;2017;11;20;Maanantai;12;5;17
622;27.11.2017;2017;11;21;Maanantai;13;8;21
622;27.11.2017;2017;11;22;Maanantai;11;5;16
622;27.11.2017;2017;11;23;Maanantai;1;0;1
622;28.11.2017;2017;11;00;Tiistai;2;2;4
622;28.11.2017;2017;11;01;Tiistai;2;0;2
622;28.11.2017;2017;11;02;Tiistai;1;0;1
622;28.11.2017;2017;11;03;Tiistai;0;0;0
622;28.11.2017;2017;11;04;Tiistai;1;0;1
622;28.11.2017;2017;11;05;Tiistai;0;3;3
622;28.11.2017;2017;11;06;Tiistai;3;2;5
622;28.11.2017;2017;11;07;Tiistai;4;23;27
622;28.11.2017;2017;11;08;Tiistai;25;36;61
622;28.11.2017;2017;11;09;Tiistai;16;26;42
622;28.11.2017;2017;11;10;Tiistai;14;14;28
622;28.11.2017;2017;11;11;Tiistai;5;8;13
622;28.11.2017;2017;11;12;Tiistai;12;12;24
622;28.11.2017;2017;11;13;Tiistai;8;10;18
622;28.11.2017;2017;11;14;Tiistai;10;15;25
622;28.11.2017;2017;11;15;Tiistai;17;18;35
622;28.11.2017;2017;11;16;Tiistai;33;19;52
622;28.11.2017;2017;11;17;Tiistai;47;23;70
622;28.11.2017;2017;11;18;Tiistai;30;19;49
622;28.11.2017;2017;11;19;Tiistai;22;10;32
622;28.11.2017;2017;11;20;Tiistai;13;15;28
622;28.11.2017;2017;11;21;Tiistai;11;6;17
622;28.11.2017;2017;11;22;Tiistai;9;10;19
622;28.11.2017;2017;11;23;Tiistai;4;3;7
622;29.11.2017;2017;11;00;Keskiviikko;3;1;4
622;29.11.2017;2017;11;01;Keskiviikko;3;1;4
622;29.11.2017;2017;11;02;Keskiviikko;0;0;0
622;29.11.2017;2017;11;03;Keskiviikko;1;0;1
622;29.11.2017;2017;11;04;Keskiviikko;4;0;4
622;29.11.2017;2017;11;05;Keskiviikko;4;2;6
622;29.11.2017;2017;11;06;Keskiviikko;1;6;7
622;29.11.2017;2017;11;07;Keskiviikko;6;23;29
622;29.11.2017;2017;11;08;Keskiviikko;18;40;58
622;29.11.2017;2017;11;09;Keskiviikko;31;20;51
622;29.11.2017;2017;11;10;Keskiviikko;16;7;23
622;29.11.2017;2017;11;11;Keskiviikko;6;7;13
622;29.11.2017;2017;11;12;Keskiviikko;7;15;22
622;29.11.2017;2017;11;13;Keskiviikko;13;18;31
622;29.11.2017;2017;11;14;Keskiviikko;16;16;32
622;29.11.2017;2017;11;15;Keskiviikko;27;22;49
622;29.11.2017;2017;11;16;Keskiviikko;33;20;53
622;29.11.2017;2017;11;17;Keskiviikko;37;24;61
622;29.11.2017;2017;11;18;Keskiviikko;28;20;48
622;29.11.2017;2017;11;19;Keskiviikko;17;8;25
622;29.11.2017;2017;11;20;Keskiviikko;22;6;28
622;29.11.2017;2017;11;21;Keskiviikko;18;9;27
622;29.11.2017;2017;11;22;Keskiviikko;8;11;19
622;29.11.2017;2017;11;23;Keskiviikko;6;4;10
622;30.11.2017;2017;11;00;Torstai;0;1;1
622;30.11.2017;2017;11;01;Torstai;2;2;4
622;30.11.2017;2017;11;02;Torstai;1;2;3
622;30.11.2017;2017;11;03;Torstai;1;0;1
622;30.11.2017;2017;11;04;Torstai;0;1;1
622;30.11.2017;2017;11;05;Torstai;1;2;3
622;30.11.2017;2017;11;06;Torstai;2;8;10
622;30.11.2017;2017;11;07;Torstai;6;19;25
622;30.11.2017;2017;11;08;Torstai;32;34;66
622;30.11.2017;2017;11;09;Torstai;26;26;52
622;30.11.2017;2017;11;10;Torstai;12;15;27
622;30.11.2017;2017;11;11;Torstai;10;13;23
622;30.11.2017;2017;11;12;Torstai;13;13;26
622;30.11.2017;2017;11;13;Torstai;24;20;44
622;30.11.2017;2017;11;14;Torstai;17;16;33
622;30.11.2017;2017;11;15;Torstai;19;13;32
622;30.11.2017;2017;11;16;Torstai;35;24;59
622;30.11.2017;2017;11;17;Torstai;43;20;63
622;30.11.2017;2017;11;18;Torstai;30;24;54
622;30.11.2017;2017;11;19;Torstai;27;15;42
622;30.11.2017;2017;11;20;Torstai;21;11;32
622;30.11.2017;2017;11;21;Torstai;14;10;24
622;30.11.2017;2017;11;22;Torstai;7;9;16
622;30.11.2017;2017;11;23;Torstai;8;11;19
622;01.12.2017;2017;12;00;Perjantai;4;3;7
622;01.12.2017;2017;12;01;Perjantai;1;3;4
622;01.12.2017;2017;12;02;Perjantai;2;1;3
622;01.12.2017;2017;12;03;Perjantai;3;0;3
622;01.12.2017;2017;12;04;Perjantai;1;0;1
622;01.12.2017;2017;12;05;Perjantai;3;3;6
622;01.12.2017;2017;12;06;Perjantai;3;6;9
622;01.12.2017;2017;12;07;Perjantai;6;25;31
622;01.12.2017;2017;12;08;Perjantai;27;37;64
622;01.12.2017;2017;12;09;Perjantai;19;31;50
622;01.12.2017;2017;12;10;Perjantai;14;10;24
622;01.12.2017;2017;12;11;Perjantai;10;16;26
622;01.12.2017;2017;12;12;Perjantai;20;17;37
622;01.12.2017;2017;12;13;Perjantai;19;16;35
622;01.12.2017;2017;12;14;Perjantai;19;16;35
622;01.12.2017;2017;12;15;Perjantai;26;9;35
622;01.12.2017;2017;12;16;Perjantai;47;22;69
622;01.12.2017;2017;12;17;Perjantai;29;24;53
622;01.12.2017;2017;12;18;Perjantai;26;29;55
622;01.12.2017;2017;12;19;Perjantai;19;10;29
622;01.12.2017;2017;12;20;Perjantai;19;10;29
622;01.12.2017;2017;12;21;Perjantai;15;15;30
622;01.12.2017;2017;12;22;Perjantai;12;6;18
622;01.12.2017;2017;12;23;Perjantai;7;1;8
622;02.12.2017;2017;12;00;Lauantai;7;4;11
622;02.12.2017;2017;12;01;Lauantai;4;2;6
622;02.12.2017;2017;12;02;Lauantai;2;1;3
622;02.12.2017;2017;12;03;Lauantai;6;1;7
622;02.12.2017;2017;12;04;Lauantai;2;0;2
622;02.12.2017;2017;12;05;Lauantai;2;2;4
622;02.12.2017;2017;12;06;Lauantai;1;1;2
622;02.12.2017;2017;12;07;Lauantai;3;4;7
622;02.12.2017;2017;12;08;Lauantai;4;3;7
622;02.12.2017;2017;12;09;Lauantai;3;1;4
622;02.12.2017;2017;12;10;Lauantai;3;7;10
622;02.12.2017;2017;12;11;Lauantai;5;9;14
622;02.12.2017;2017;12;12;Lauantai;16;14;30
622;02.12.2017;2017;12;13;Lauantai;15;21;36
622;02.12.2017;2017;12;14;Lauantai;23;11;34
622;02.12.2017;2017;12;15;Lauantai;23;12;35
622;02.12.2017;2017;12;16;Lauantai;12;14;26
622;02.12.2017;2017;12;17;Lauantai;7;6;13
622;02.12.2017;2017;12;18;Lauantai;13;8;21
622;02.12.2017;2017;12;19;Lauantai;13;6;19
622;02.12.2017;2017;12;20;Lauantai;8;7;15
622;02.12.2017;2017;12;21;Lauantai;6;5;11
622;02.12.2017;2017;12;22;Lauantai;3;4;7
622;02.12.2017;2017;12;23;Lauantai;6;7;13
622;03.12.2017;2017;12;00;Sunnuntai;2;4;6
622;03.12.2017;2017;12;01;Sunnuntai;3;2;5
622;03.12.2017;2017;12;02;Sunnuntai;4;3;7
622;03.12.2017;2017;12;03;Sunnuntai;3;1;4
622;03.12.2017;2017;12;04;Sunnuntai;0;0;0
622;03.12.2017;2017;12;05;Sunnuntai;1;1;2
622;03.12.2017;2017;12;06;Sunnuntai;1;0;1
622;03.12.2017;2017;12;07;Sunnuntai;2;4;6
622;03.12.2017;2017;12;08;Sunnuntai;1;3;4
622;03.12.2017;2017;12;09;Sunnuntai;1;3;4
622;03.12.2017;2017;12;10;Sunnuntai;3;3;6
622;03.12.2017;2017;12;11;Sunnuntai;4;9;13
622;03.12.2017;2017;12;12;Sunnuntai;9;5;14
622;03.12.2017;2017;12;13;Sunnuntai;9;12;21
622;03.12.2017;2017;12;14;Sunnuntai;14;11;25
622;03.12.2017;2017;12;15;Sunnuntai;11;15;26
622;03.12.2017;2017;12;16;Sunnuntai;22;17;39
622;03.12.2017;2017;12;17;Sunnuntai;18;8;26
622;03.12.2017;2017;12;18;Sunnuntai;18;10;28
622;03.12.2017;2017;12;19;Sunnuntai;8;7;15
622;03.12.2017;2017;12;20;Sunnuntai;5;9;14
622;03.12.2017;2017;12;21;Sunnuntai;16;9;25
622;03.12.2017;2017;12;22;Sunnuntai;10;5;15
622;03.12.2017;2017;12;23;Sunnuntai;4;1;5
622;04.12.2017;2017;12;00;Maanantai;2;1;3
622;04.12.2017;2017;12;01;Maanantai;1;0;1
622;04.12.2017;2017;12;02;Maanantai;1;0;1
622;04.12.2017;2017;12;03;Maanantai;0;0;0
622;04.12.2017;2017;12;04;Maanantai;0;0;0
622;04.12.2017;2017;12;05;Maanantai;1;3;4
622;04.12.2017;2017;12;06;Maanantai;2;8;10
622;04.12.2017;2017;12;07;Maanantai;5;16;21
622;04.12.2017;2017;12;08;Maanantai;18;28;46
622;04.12.2017;2017;12;09;Maanantai;27;22;49
622;04.12.2017;2017;12;10;Maanantai;13;13;26
622;04.12.2017;2017;12;11;Maanantai;11;7;18
622;04.12.2017;2017;12;12;Maanantai;10;13;23
622;04.12.2017;2017;12;13;Maanantai;14;10;24
622;04.12.2017;2017;12;14;Maanantai;15;11;26
622;04.12.2017;2017;12;15;Maanantai;24;11;35
622;04.12.2017;2017;12;16;Maanantai;40;23;63
622;04.12.2017;2017;12;17;Maanantai;57;28;85
622;04.12.2017;2017;12;18;Maanantai;28;21;49
622;04.12.2017;2017;12;19;Maanantai;21;9;30
622;04.12.2017;2017;12;20;Maanantai;16;6;22
622;04.12.2017;2017;12;21;Maanantai;4;4;8
622;04.12.2017;2017;12;22;Maanantai;8;2;10
622;04.12.2017;2017;12;23;Maanantai;7;1;8
622;05.12.2017;2017;12;00;Tiistai;5;1;6
622;05.12.2017;2017;12;01;Tiistai;1;2;3
622;05.12.2017;2017;12;02;Tiistai;1;0;1
622;05.12.2017;2017;12;03;Tiistai;0;0;0
622;05.12.2017;2017;12;04;Tiistai;0;1;1
622;05.12.2017;2017;12;05;Tiistai;0;0;0
622;05.12.2017;2017;12;06;Tiistai;2;9;11
622;05.12.2017;2017;12;07;Tiistai;4;18;22
622;05.12.2017;2017;12;08;Tiistai;31;30;61
622;05.12.2017;2017;12;09;Tiistai;23;25;48
622;05.12.2017;2017;12;10;Tiistai;10;13;23
622;05.12.2017;2017;12;11;Tiistai;8;8;16
622;05.12.2017;2017;12;12;Tiistai;17;7;24
622;05.12.2017;2017;12;13;Tiistai;5;13;18
622;05.12.2017;2017;12;14;Tiistai;21;14;35
622;05.12.2017;2017;12;15;Tiistai;26;23;49
622;05.12.2017;2017;12;16;Tiistai;38;10;48
622;05.12.2017;2017;12;17;Tiistai;37;27;64
622;05.12.2017;2017;12;18;Tiistai;13;14;27
622;05.12.2017;2017;12;19;Tiistai;20;18;38
622;05.12.2017;2017;12;20;Tiistai;24;11;35
622;05.12.2017;2017;12;21;Tiistai;12;7;19
622;05.12.2017;2017;12;22;Tiistai;6;5;11
622;05.12.2017;2017;12;23;Tiistai;3;6;9
622;06.12.2017;2017;12;00;Keskiviikko;5;1;6
622;06.12.2017;2017;12;01;Keskiviikko;1;3;4
622;06.12.2017;2017;12;02;Keskiviikko;2;1;3
622;06.12.2017;2017;12;03;Keskiviikko;2;5;7
622;06.12.2017;2017;12;04;Keskiviikko;1;0;1
622;06.12.2017;2017;12;05;Keskiviikko;1;4;5
622;06.12.2017;2017;12;06;Keskiviikko;2;1;3
622;06.12.2017;2017;12;07;Keskiviikko;2;5;7
622;06.12.2017;2017;12;08;Keskiviikko;2;2;4
622;06.12.2017;2017;12;09;Keskiviikko;2;5;7
622;06.12.2017;2017;12;10;Keskiviikko;2;3;5
622;06.12.2017;2017;12;11;Keskiviikko;8;13;21
622;06.12.2017;2017;12;12;Keskiviikko;10;8;18
622;06.12.2017;2017;12;13;Keskiviikko;12;8;20
622;06.12.2017;2017;12;14;Keskiviikko;7;9;16
622;06.12.2017;2017;12;15;Keskiviikko;13;11;24
622;06.12.2017;2017;12;16;Keskiviikko;16;6;22
622;06.12.2017;2017;12;17;Keskiviikko;12;5;17
622;06.12.2017;2017;12;18;Keskiviikko;15;6;21
622;06.12.2017;2017;12;19;Keskiviikko;17;7;24
622;06.12.2017;2017;12;20;Keskiviikko;8;7;15
622;06.12.2017;2017;12;21;Keskiviikko;5;5;10
622;06.12.2017;2017;12;22;Keskiviikko;7;7;14
622;06.12.2017;2017;12;23;Keskiviikko;8;2;10
622;07.12.2017;2017;12;00;Torstai;3;4;7
622;07.12.2017;2017;12;01;Torstai;1;3;4
622;07.12.2017;2017;12;02;Torstai;0;2;2
622;07.12.2017;2017;12;03;Torstai;2;1;3
622;07.12.2017;2017;12;04;Torstai;1;0;1
622;07.12.2017;2017;12;05;Torstai;1;3;4
622;07.12.2017;2017;12;06;Torstai;1;6;7
622;07.12.2017;2017;12;07;Torstai;4;20;24
622;07.12.2017;2017;12;08;Torstai;22;32;54
622;07.12.2017;2017;12;09;Torstai;28;25;53
622;07.12.2017;2017;12;10;Torstai;7;3;10
622;07.12.2017;2017;12;11;Torstai;12;10;22
622;07.12.2017;2017;12;12;Torstai;7;16;23
622;07.12.2017;2017;12;13;Torstai;22;4;26
622;07.12.2017;2017;12;14;Torstai;7;17;24
622;07.12.2017;2017;12;15;Torstai;19;7;26
622;07.12.2017;2017;12;16;Torstai;41;16;57
622;07.12.2017;2017;12;17;Torstai;30;25;55
622;07.12.2017;2017;12;18;Torstai;27;17;44
622;07.12.2017;2017;12;19;Torstai;19;14;33
622;07.12.2017;2017;12;20;Torstai;13;10;23
622;07.12.2017;2017;12;21;Torstai;12;11;23
622;07.12.2017;2017;12;22;Torstai;11;6;17
622;07.12.2017;2017;12;23;Torstai;9;4;13
622;08.12.2017;2017;12;00;Perjantai;5;2;7
622;08.12.2017;2017;12;01;Perjantai;4;1;5
622;08.12.2017;2017;12;02;Perjantai;1;1;2
622;08.12.2017;2017;12;03;Perjantai;1;0;1
622;08.12.2017;2017;12;04;Perjantai;0;1;1
622;08.12.2017;2017;12;05;Perjantai;3;1;4
622;08.12.2017;2017;12;06;Perjantai;2;5;7
622;08.12.2017;2017;12;07;Perjantai;3;9;12
622;08.12.2017;2017;12;08;Perjantai;6;17;23
622;08.12.2017;2017;12;09;Perjantai;9;7;16
622;08.12.2017;2017;12;10;Perjantai;6;4;10
622;08.12.2017;2017;12;11;Perjantai;4;7;11
622;08.12.2017;2017;12;12;Perjantai;4;4;8
622;08.12.2017;2017;12;13;Perjantai;6;6;12
622;08.12.2017;2017;12;14;Perjantai;10;9;19
622;08.12.2017;2017;12;15;Perjantai;15;8;23
622;08.12.2017;2017;12;16;Perjantai;18;11;29
622;08.12.2017;2017;12;17;Perjantai;18;15;33
622;08.12.2017;2017;12;18;Perjantai;7;5;12
622;08.12.2017;2017;12;19;Perjantai;11;5;16
622;08.12.2017;2017;12;20;Perjantai;6;4;10
622;08.12.2017;2017;12;21;Perjantai;4;7;11
622;08.12.2017;2017;12;22;Perjantai;5;4;9
622;08.12.2017;2017;12;23;Perjantai;1;3;4
622;09.12.2017;2017;12;00;Lauantai;2;1;3
622;09.12.2017;2017;12;01;Lauantai;3;1;4
622;09.12.2017;2017;12;02;Lauantai;0;1;1
622;09.12.2017;2017;12;03;Lauantai;0;1;1
622;09.12.2017;2017;12;04;Lauantai;0;1;1
622;09.12.2017;2017;12;05;Lauantai;2;2;4
622;09.12.2017;2017;12;06;Lauantai;1;2;3
622;09.12.2017;2017;12;07;Lauantai;2;5;7
622;09.12.2017;2017;12;08;Lauantai;3;5;8
622;09.12.2017;2017;12;09;Lauantai;6;7;13
622;09.12.2017;2017;12;10;Lauantai;5;9;14
622;09.12.2017;2017;12;11;Lauantai;11;13;24
622;09.12.2017;2017;12;12;Lauantai;3;9;12
622;09.12.2017;2017;12;13;Lauantai;12;10;22
622;09.12.2017;2017;12;14;Lauantai;12;8;20
622;09.12.2017;2017;12;15;Lauantai;13;15;28
622;09.12.2017;2017;12;16;Lauantai;11;7;18
622;09.12.2017;2017;12;17;Lauantai;11;9;20
622;09.12.2017;2017;12;18;Lauantai;13;8;21
622;09.12.2017;2017;12;19;Lauantai;6;7;13
622;09.12.2017;2017;12;20;Lauantai;6;7;13
622;09.12.2017;2017;12;21;Lauantai;6;8;14
622;09.12.2017;2017;12;22;Lauantai;2;0;2
622;09.12.2017;2017;12;23;Lauantai;3;1;4
622;10.12.2017;2017;12;00;Sunnuntai;3;2;5
622;10.12.2017;2017;12;01;Sunnuntai;0;1;1
622;10.12.2017;2017;12;02;Sunnuntai;0;3;3
622;10.12.2017;2017;12;03;Sunnuntai;0;1;1
622;10.12.2017;2017;12;04;Sunnuntai;1;1;2
622;10.12.2017;2017;12;05;Sunnuntai;3;0;3
622;10.12.2017;2017;12;06;Sunnuntai;0;2;2
622;10.12.2017;2017;12;07;Sunnuntai;1;1;2
622;10.12.2017;2017;12;08;Sunnuntai;5;2;7
622;10.12.2017;2017;12;09;Sunnuntai;0;1;1
622;10.12.2017;2017;12;10;Sunnuntai;0;1;1
622;10.12.2017;2017;12;11;Sunnuntai;4;1;5
622;10.12.2017;2017;12;12;Sunnuntai;9;4;13
622;10.12.2017;2017;12;13;Sunnuntai;11;10;21
622;10.12.2017;2017;12;14;Sunnuntai;8;10;18
622;10.12.2017;2017;12;15;Sunnuntai;14;7;21
622;10.12.2017;2017;12;16;Sunnuntai;5;12;17
622;10.12.2017;2017;12;17;Sunnuntai;7;3;10
622;10.12.2017;2017;12;18;Sunnuntai;7;8;15
622;10.12.2017;2017;12;19;Sunnuntai;10;8;18
622;10.12.2017;2017;12;20;Sunnuntai;3;6;9
622;10.12.2017;2017;12;21;Sunnuntai;5;6;11
622;10.12.2017;2017;12;22;Sunnuntai;8;0;8
622;10.12.2017;2017;12;23;Sunnuntai;0;2;2
622;11.12.2017;2017;12;00;Maanantai;0;0;0
622;11.12.2017;2017;12;01;Maanantai;0;0;0
622;11.12.2017;2017;12;02;Maanantai;0;0;0
622;11.12.2017;2017;12;03;Maanantai;0;0;0
622;11.12.2017;2017;12;04;Maanantai;0;0;0
622;11.12.2017;2017;12;05;Maanantai;1;2;3
622;11.12.2017;2017;12;06;Maanantai;1;3;4
622;11.12.2017;2017;12;07;Maanantai;6;14;20
622;11.12.2017;2017;12;08;Maanantai;17;32;49
622;11.12.2017;2017;12;09;Maanantai;24;29;53
622;11.12.2017;2017;12;10;Maanantai;8;14;22
622;11.12.2017;2017;12;11;Maanantai;4;8;12
622;11.12.2017;2017;12;12;Maanantai;7;7;14
622;11.12.2017;2017;12;13;Maanantai;11;9;20
622;11.12.2017;2017;12;14;Maanantai;9;8;17
622;11.12.2017;2017;12;15;Maanantai;16;13;29
622;11.12.2017;2017;12;16;Maanantai;20;17;37
622;11.12.2017;2017;12;17;Maanantai;49;24;73
622;11.12.2017;2017;12;18;Maanantai;19;30;49
622;11.12.2017;2017;12;19;Maanantai;21;10;31
622;11.12.2017;2017;12;20;Maanantai;13;7;20
622;11.12.2017;2017;12;21;Maanantai;11;8;19
622;11.12.2017;2017;12;22;Maanantai;7;4;11
622;11.12.2017;2017;12;23;Maanantai;4;1;5
622;12.12.2017;2017;12;00;Tiistai;2;4;6
622;12.12.2017;2017;12;01;Tiistai;1;1;2
622;12.12.2017;2017;12;02;Tiistai;0;1;1
622;12.12.2017;2017;12;03;Tiistai;0;1;1
622;12.12.2017;2017;12;04;Tiistai;1;1;2
622;12.12.2017;2017;12;05;Tiistai;1;1;2
622;12.12.2017;2017;12;06;Tiistai;2;9;11
622;12.12.2017;2017;12;07;Tiistai;1;24;25
622;12.12.2017;2017;12;08;Tiistai;22;23;45
622;12.12.2017;2017;12;09;Tiistai;22;26;48
622;12.12.2017;2017;12;10;Tiistai;8;14;22
622;12.12.2017;2017;12;11;Tiistai;10;5;15
622;12.12.2017;2017;12;12;Tiistai;15;19;34
622;12.12.2017;2017;12;13;Tiistai;19;17;36
622;12.12.2017;2017;12;14;Tiistai;18;11;29
622;12.12.2017;2017;12;15;Tiistai;17;16;33
622;12.12.2017;2017;12;16;Tiistai;28;14;42
622;12.12.2017;2017;12;17;Tiistai;21;18;39
622;12.12.2017;2017;12;18;Tiistai;27;13;40
622;12.12.2017;2017;12;19;Tiistai;22;9;31
622;12.12.2017;2017;12;20;Tiistai;10;5;15
622;12.12.2017;2017;12;21;Tiistai;9;6;15
622;12.12.2017;2017;12;22;Tiistai;4;3;7
622;12.12.2017;2017;12;23;Tiistai;2;2;4
622;13.12.2017;2017;12;00;Keskiviikko;1;1;2
622;13.12.2017;2017;12;01;Keskiviikko;1;1;2
622;13.12.2017;2017;12;02;Keskiviikko;0;0;0
622;13.12.2017;2017;12;03;Keskiviikko;0;0;0
622;13.12.2017;2017;12;04;Keskiviikko;1;1;2
622;13.12.2017;2017;12;05;Keskiviikko;1;2;3
622;13.12.2017;2017;12;06;Keskiviikko;1;5;6
622;13.12.2017;2017;12;07;Keskiviikko;4;16;20
622;13.12.2017;2017;12;08;Keskiviikko;19;19;38
622;13.12.2017;2017;12;09;Keskiviikko;10;19;29
622;13.12.2017;2017;12;10;Keskiviikko;6;7;13
622;13.12.2017;2017;12;11;Keskiviikko;9;10;19
622;13.12.2017;2017;12;12;Keskiviikko;7;13;20
622;13.12.2017;2017;12;13;Keskiviikko;2;0;2
622;13.12.2017;2017;12;14;Keskiviikko;6;6;12
622;13.12.2017;2017;12;15;Keskiviikko;5;7;12
622;13.12.2017;2017;12;16;Keskiviikko;9;8;17
622;13.12.2017;2017;12;17;Keskiviikko;30;29;59
622;13.12.2017;2017;12;18;Keskiviikko;21;20;41
622;13.12.2017;2017;12;19;Keskiviikko;18;9;27
622;13.12.2017;2017;12;20;Keskiviikko;7;8;15
622;13.12.2017;2017;12;21;Keskiviikko;6;9;15
622;13.12.2017;2017;12;22;Keskiviikko;4;6;10
622;13.12.2017;2017;12;23;Keskiviikko;2;0;2
622;14.12.2017;2017;12;00;Torstai;2;2;4
622;14.12.2017;2017;12;01;Torstai;1;2;3
622;14.12.2017;2017;12;02;Torstai;0;0;0
622;14.12.2017;2017;12;03;Torstai;1;2;3
622;14.12.2017;2017;12;04;Torstai;0;0;0
622;14.12.2017;2017;12;05;Torstai;4;1;5
622;14.12.2017;2017;12;06;Torstai;1;11;12
622;14.12.2017;2017;12;07;Torstai;7;27;34
622;14.12.2017;2017;12;08;Torstai;17;24;41
622;14.12.2017;2017;12;09;Torstai;20;25;45
622;14.12.2017;2017;12;10;Torstai;11;16;27
622;14.12.2017;2017;12;11;Torstai;4;10;14
622;14.12.2017;2017;12;12;Torstai;5;8;13
622;14.12.2017;2017;12;13;Torstai;15;11;26
622;14.12.2017;2017;12;14;Torstai;8;6;14
622;14.12.2017;2017;12;15;Torstai;10;9;19
622;14.12.2017;2017;12;16;Torstai;24;6;30
622;14.12.2017;2017;12;17;Torstai;31;21;52
622;14.12.2017;2017;12;18;Torstai;13;12;25
622;14.12.2017;2017;12;19;Torstai;12;7;19
622;14.12.2017;2017;12;20;Torstai;11;5;16
622;14.12.2017;2017;12;21;Torstai;12;6;18
622;14.12.2017;2017;12;22;Torstai;7;6;13
622;14.12.2017;2017;12;23;Torstai;4;4;8
622;15.12.2017;2017;12;00;Perjantai;4;1;5
622;15.12.2017;2017;12;01;Perjantai;3;1;4
622;15.12.2017;2017;12;02;Perjantai;4;1;5
622;15.12.2017;2017;12;03;Perjantai;2;0;2
622;15.12.2017;2017;12;04;Perjantai;2;2;4
622;15.12.2017;2017;12;05;Perjantai;0;2;2
622;15.12.2017;2017;12;06;Perjantai;2;3;5
622;15.12.2017;2017;12;07;Perjantai;2;14;16
622;15.12.2017;2017;12;08;Perjantai;19;24;43
622;15.12.2017;2017;12;09;Perjantai;14;24;38
622;15.12.2017;2017;12;10;Perjantai;8;7;15
622;15.12.2017;2017;12;11;Perjantai;10;4;14
622;15.12.2017;2017;12;12;Perjantai;9;8;17
622;15.12.2017;2017;12;13;Perjantai;14;4;18
622;15.12.2017;2017;12;14;Perjantai;13;7;20
622;15.12.2017;2017;12;15;Perjantai;11;10;21
622;15.12.2017;2017;12;16;Perjantai;28;6;34
622;15.12.2017;2017;12;17;Perjantai;30;21;51
622;15.12.2017;2017;12;18;Perjantai;18;16;34
622;15.12.2017;2017;12;19;Perjantai;19;7;26
622;15.12.2017;2017;12;20;Perjantai;14;4;18
622;15.12.2017;2017;12;21;Perjantai;12;6;18
622;15.12.2017;2017;12;22;Perjantai;15;2;17
622;15.12.2017;2017;12;23;Perjantai;7;2;9
622;16.12.2017;2017;12;00;Lauantai;2;4;6
622;16.12.2017;2017;12;01;Lauantai;4;2;6
622;16.12.2017;2017;12;02;Lauantai;3;1;4
622;16.12.2017;2017;12;03;Lauantai;2;0;2
622;16.12.2017;2017;12;04;Lauantai;0;2;2
622;16.12.2017;2017;12;05;Lauantai;1;2;3
622;16.12.2017;2017;12;06;Lauantai;0;2;2
622;16.12.2017;2017;12;07;Lauantai;3;3;6
622;16.12.2017;2017;12;08;Lauantai;1;1;2
622;16.12.2017;2017;12;09;Lauantai;2;3;5
622;16.12.2017;2017;12;10;Lauantai;3;5;8
622;16.12.2017;2017;12;11;Lauantai;2;6;8
622;16.12.2017;2017;12;12;Lauantai;5;10;15
622;16.12.2017;2017;12;13;Lauantai;10;6;16
622;16.12.2017;2017;12;14;Lauantai;4;3;7
622;16.12.2017;2017;12;15;Lauantai;7;10;17
622;16.12.2017;2017;12;16;Lauantai;13;9;22
622;16.12.2017;2017;12;17;Lauantai;6;4;10
622;16.12.2017;2017;12;18;Lauantai;13;4;17
622;16.12.2017;2017;12;19;Lauantai;14;9;23
622;16.12.2017;2017;12;20;Lauantai;5;5;10
622;16.12.2017;2017;12;21;Lauantai;7;5;12
622;16.12.2017;2017;12;22;Lauantai;1;3;4
622;16.12.2017;2017;12;23;Lauantai;1;2;3
622;17.12.2017;2017;12;00;Sunnuntai;3;1;4
622;17.12.2017;2017;12;01;Sunnuntai;3;1;4
622;17.12.2017;2017;12;02;Sunnuntai;3;1;4
622;17.12.2017;2017;12;03;Sunnuntai;4;3;7
622;17.12.2017;2017;12;04;Sunnuntai;7;1;8
622;17.12.2017;2017;12;05;Sunnuntai;2;0;2
622;17.12.2017;2017;12;06;Sunnuntai;2;0;2
622;17.12.2017;2017;12;07;Sunnuntai;2;3;5
622;17.12.2017;2017;12;08;Sunnuntai;3;0;3
622;17.12.2017;2017;12;09;Sunnuntai;0;2;2
622;17.12.2017;2017;12;10;Sunnuntai;0;5;5
622;17.12.2017;2017;12;11;Sunnuntai;2;7;9
622;17.12.2017;2017;12;12;Sunnuntai;10;5;15
622;17.12.2017;2017;12;13;Sunnuntai;14;10;24
622;17.12.2017;2017;12;14;Sunnuntai;14;11;25
622;17.12.2017;2017;12;15;Sunnuntai;8;6;14
622;17.12.2017;2017;12;16;Sunnuntai;16;11;27
622;17.12.2017;2017;12;17;Sunnuntai;14;5;19
622;17.12.2017;2017;12;18;Sunnuntai;8;10;18
622;17.12.2017;2017;12;19;Sunnuntai;7;3;10
622;17.12.2017;2017;12;20;Sunnuntai;9;8;17
622;17.12.2017;2017;12;21;Sunnuntai;9;5;14
622;17.12.2017;2017;12;22;Sunnuntai;3;1;4
622;17.12.2017;2017;12;23;Sunnuntai;6;3;9
622;18.12.2017;2017;12;00;Maanantai;3;0;3
622;18.12.2017;2017;12;01;Maanantai;5;2;7
622;18.12.2017;2017;12;02;Maanantai;3;2;5
622;18.12.2017;2017;12;03;Maanantai;0;1;1
622;18.12.2017;2017;12;04;Maanantai;0;0;0
622;18.12.2017;2017;12;05;Maanantai;1;1;2
622;18.12.2017;2017;12;06;Maanantai;3;4;7
622;18.12.2017;2017;12;07;Maanantai;5;17;22
622;18.12.2017;2017;12;08;Maanantai;18;24;42
622;18.12.2017;2017;12;09;Maanantai;33;23;56
622;18.12.2017;2017;12;10;Maanantai;10;15;25
622;18.12.2017;2017;12;11;Maanantai;10;6;16
622;18.12.2017;2017;12;12;Maanantai;9;7;16
622;18.12.2017;2017;12;13;Maanantai;8;10;18
622;18.12.2017;2017;12;14;Maanantai;19;12;31
622;18.12.2017;2017;12;15;Maanantai;25;17;42
622;18.12.2017;2017;12;16;Maanantai;47;14;61
622;18.12.2017;2017;12;17;Maanantai;58;14;72
622;18.12.2017;2017;12;18;Maanantai;26;14;40
622;18.12.2017;2017;12;19;Maanantai;28;9;37
622;18.12.2017;2017;12;20;Maanantai;17;6;23
622;18.12.2017;2017;12;21;Maanantai;13;4;17
622;18.12.2017;2017;12;22;Maanantai;11;3;14
622;18.12.2017;2017;12;23;Maanantai;4;3;7
622;19.12.2017;2017;12;00;Tiistai;4;1;5
622;19.12.2017;2017;12;01;Tiistai;3;2;5
622;19.12.2017;2017;12;02;Tiistai;1;1;2
622;19.12.2017;2017;12;03;Tiistai;0;0;0
622;19.12.2017;2017;12;04;Tiistai;1;0;1
622;19.12.2017;2017;12;05;Tiistai;0;0;0
622;19.12.2017;2017;12;06;Tiistai;3;6;9
622;19.12.2017;2017;12;07;Tiistai;6;13;19
622;19.12.2017;2017;12;08;Tiistai;28;24;52
622;19.12.2017;2017;12;09;Tiistai;20;23;43
622;19.12.2017;2017;12;10;Tiistai;14;8;22
622;19.12.2017;2017;12;11;Tiistai;9;10;19
622;19.12.2017;2017;12;12;Tiistai;20;14;34
622;19.12.2017;2017;12;13;Tiistai;11;11;22
622;19.12.2017;2017;12;14;Tiistai;14;10;24
622;19.12.2017;2017;12;15;Tiistai;22;9;31
622;19.12.2017;2017;12;16;Tiistai;45;12;57
622;19.12.2017;2017;12;17;Tiistai;52;22;74
622;19.12.2017;2017;12;18;Tiistai;37;15;52
622;19.12.2017;2017;12;19;Tiistai;23;15;38
622;19.12.2017;2017;12;20;Tiistai;15;5;20
622;19.12.2017;2017;12;21;Tiistai;21;8;29
622;19.12.2017;2017;12;22;Tiistai;13;2;15
622;19.12.2017;2017;12;23;Tiistai;9;0;9
622;20.12.2017;2017;12;00;Keskiviikko;5;2;7
622;20.12.2017;2017;12;01;Keskiviikko;8;1;9
622;20.12.2017;2017;12;02;Keskiviikko;3;0;3
622;20.12.2017;2017;12;03;Keskiviikko;0;0;0
622;20.12.2017;2017;12;04;Keskiviikko;2;1;3
622;20.12.2017;2017;12;05;Keskiviikko;2;2;4
622;20.12.2017;2017;12;06;Keskiviikko;9;5;14
622;20.12.2017;2017;12;07;Keskiviikko;4;11;15
622;20.12.2017;2017;12;08;Keskiviikko;23;17;40
622;20.12.2017;2017;12;09;Keskiviikko;13;17;30
622;20.12.2017;2017;12;10;Keskiviikko;4;10;14
622;20.12.2017;2017;12;11;Keskiviikko;2;6;8
622;20.12.2017;2017;12;12;Keskiviikko;7;2;9
622;20.12.2017;2017;12;13;Keskiviikko;8;7;15
622;20.12.2017;2017;12;14;Keskiviikko;12;4;16
622;20.12.2017;2017;12;15;Keskiviikko;14;11;25
622;20.12.2017;2017;12;16;Keskiviikko;4;3;7
622;20.12.2017;2017;12;17;Keskiviikko;20;16;36
622;20.12.2017;2017;12;18;Keskiviikko;14;5;19
622;20.12.2017;2017;12;19;Keskiviikko;7;2;9
622;20.12.2017;2017;12;20;Keskiviikko;9;4;13
622;20.12.2017;2017;12;21;Keskiviikko;7;5;12
622;20.12.2017;2017;12;22;Keskiviikko;4;2;6
622;20.12.2017;2017;12;23;Keskiviikko;4;5;9
622;21.12.2017;2017;12;00;Torstai;3;1;4
622;21.12.2017;2017;12;01;Torstai;1;0;1
622;21.12.2017;2017;12;02;Torstai;0;0;0
622;21.12.2017;2017;12;03;Torstai;1;2;3
622;21.12.2017;2017;12;04;Torstai;0;0;0
622;21.12.2017;2017;12;05;Torstai;2;1;3
622;21.12.2017;2017;12;06;Torstai;3;4;7
622;21.12.2017;2017;12;07;Torstai;5;17;22
622;21.12.2017;2017;12;08;Torstai;20;19;39
622;21.12.2017;2017;12;09;Torstai;23;24;47
622;21.12.2017;2017;12;10;Torstai;15;9;24
622;21.12.2017;2017;12;11;Torstai;8;11;19
622;21.12.2017;2017;12;12;Torstai;15;9;24
622;21.12.2017;2017;12;13;Torstai;15;12;27
622;21.12.2017;2017;12;14;Torstai;18;8;26
622;21.12.2017;2017;12;15;Torstai;21;7;28
622;21.12.2017;2017;12;16;Torstai;26;9;35
622;21.12.2017;2017;12;17;Torstai;28;8;36
622;21.12.2017;2017;12;18;Torstai;22;12;34
622;21.12.2017;2017;12;19;Torstai;20;6;26
622;21.12.2017;2017;12;20;Torstai;11;6;17
622;21.12.2017;2017;12;21;Torstai;15;3;18
622;21.12.2017;2017;12;22;Torstai;2;5;7
622;21.12.2017;2017;12;23;Torstai;7;1;8
622;22.12.2017;2017;12;00;Perjantai;5;0;5
622;22.12.2017;2017;12;01;Perjantai;1;0;1
622;22.12.2017;2017;12;02;Perjantai;2;1;3
622;22.12.2017;2017;12;03;Perjantai;0;0;0
622;22.12.2017;2017;12;04;Perjantai;1;0;1
622;22.12.2017;2017;12;05;Perjantai;0;0;0
622;22.12.2017;2017;12;06;Perjantai;2;2;4
622;22.12.2017;2017;12;07;Perjantai;4;12;16
622;22.12.2017;2017;12;08;Perjantai;13;12;25
622;22.12.2017;2017;12;09;Perjantai;28;18;46
622;22.12.2017;2017;12;10;Perjantai;7;11;18
622;22.12.2017;2017;12;11;Perjantai;10;9;19
622;22.12.2017;2017;12;12;Perjantai;8;12;20
622;22.12.2017;2017;12;13;Perjantai;8;6;14
622;22.12.2017;2017;12;14;Perjantai;12;5;17
622;22.12.2017;2017;12;15;Perjantai;24;9;33
622;22.12.2017;2017;12;16;Perjantai;18;9;27
622;22.12.2017;2017;12;17;Perjantai;18;4;22
622;22.12.2017;2017;12;18;Perjantai;11;5;16
622;22.12.2017;2017;12;19;Perjantai;4;3;7
622;22.12.2017;2017;12;20;Perjantai;10;2;12
622;22.12.2017;2017;12;21;Perjantai;5;0;5
622;22.12.2017;2017;12;22;Perjantai;7;1;8
622;22.12.2017;2017;12;23;Perjantai;7;2;9
622;23.12.2017;2017;12;00;Lauantai;2;1;3
622;23.12.2017;2017;12;01;Lauantai;0;1;1
622;23.12.2017;2017;12;02;Lauantai;2;3;5
622;23.12.2017;2017;12;03;Lauantai;1;2;3
622;23.12.2017;2017;12;04;Lauantai;1;1;2
622;23.12.2017;2017;12;05;Lauantai;0;0;0
622;23.12.2017;2017;12;06;Lauantai;0;2;2
622;23.12.2017;2017;12;07;Lauantai;2;2;4
622;23.12.2017;2017;12;08;Lauantai;2;0;2
622;23.12.2017;2017;12;09;Lauantai;1;1;2
622;23.12.2017;2017;12;10;Lauantai;1;1;2
622;23.12.2017;2017;12;11;Lauantai;0;1;1
622;23.12.2017;2017;12;12;Lauantai;1;1;2
622;23.12.2017;2017;12;13;Lauantai;3;0;3
622;23.12.2017;2017;12;14;Lauantai;2;2;4
622;23.12.2017;2017;12;15;Lauantai;6;5;11
622;23.12.2017;2017;12;16;Lauantai;0;0;0
622;23.12.2017;2017;12;17;Lauantai;3;3;6
622;23.12.2017;2017;12;18;Lauantai;3;3;6
622;23.12.2017;2017;12;19;Lauantai;6;6;12
622;23.12.2017;2017;12;20;Lauantai;7;5;12
622;23.12.2017;2017;12;21;Lauantai;2;4;6
622;23.12.2017;2017;12;22;Lauantai;0;1;1
622;23.12.2017;2017;12;23;Lauantai;0;1;1
622;24.12.2017;2017;12;00;Sunnuntai;1;0;1
622;24.12.2017;2017;12;01;Sunnuntai;0;0;0
622;24.12.2017;2017;12;02;Sunnuntai;1;1;2
622;24.12.2017;2017;12;03;Sunnuntai;1;1;2
622;24.12.2017;2017;12;04;Sunnuntai;0;0;0
622;24.12.2017;2017;12;05;Sunnuntai;1;0;1
622;24.12.2017;2017;12;06;Sunnuntai;0;1;1
622;24.12.2017;2017;12;07;Sunnuntai;1;2;3
622;24.12.2017;2017;12;08;Sunnuntai;1;0;1
622;24.12.2017;2017;12;09;Sunnuntai;1;2;3
622;24.12.2017;2017;12;10;Sunnuntai;2;2;4
622;24.12.2017;2017;12;11;Sunnuntai;3;3;6
622;24.12.2017;2017;12;12;Sunnuntai;2;5;7
622;24.12.2017;2017;12;13;Sunnuntai;4;3;7
622;24.12.2017;2017;12;14;Sunnuntai;5;4;9
622;24.12.2017;2017;12;15;Sunnuntai;2;3;5
622;24.12.2017;2017;12;16;Sunnuntai;4;2;6
622;24.12.2017;2017;12;17;Sunnuntai;6;4;10
622;24.12.2017;2017;12;18;Sunnuntai;0;1;1
622;24.12.2017;2017;12;19;Sunnuntai;4;2;6
622;24.12.2017;2017;12;20;Sunnuntai;3;2;5
622;24.12.2017;2017;12;21;Sunnuntai;1;2;3
622;24.12.2017;2017;12;22;Sunnuntai;6;2;8
622;24.12.2017;2017;12;23;Sunnuntai;2;1;3
622;25.12.2017;2017;12;00;Maanantai;1;0;1
622;25.12.2017;2017;12;01;Maanantai;1;1;2
622;25.12.2017;2017;12;02;Maanantai;0;0;0
622;25.12.2017;2017;12;03;Maanantai;0;0;0
622;25.12.2017;2017;12;04;Maanantai;1;0;1
622;25.12.2017;2017;12;05;Maanantai;0;0;0
622;25.12.2017;2017;12;06;Maanantai;0;0;0
622;25.12.2017;2017;12;07;Maanantai;1;2;3
622;25.12.2017;2017;12;08;Maanantai;0;2;2
622;25.12.2017;2017;12;09;Maanantai;0;1;1
622;25.12.2017;2017;12;10;Maanantai;0;2;2
622;25.12.2017;2017;12;11;Maanantai;0;3;3
622;25.12.2017;2017;12;12;Maanantai;0;3;3
622;25.12.2017;2017;12;13;Maanantai;7;9;16
622;25.12.2017;2017;12;14;Maanantai;7;0;7
622;25.12.2017;2017;12;15;Maanantai;3;5;8
622;25.12.2017;2017;12;16;Maanantai;3;2;5
622;25.12.2017;2017;12;17;Maanantai;5;5;10
622;25.12.2017;2017;12;18;Maanantai;6;6;12
622;25.12.2017;2017;12;19;Maanantai;3;3;6
622;25.12.2017;2017;12;20;Maanantai;2;5;7
622;25.12.2017;2017;12;21;Maanantai;6;3;9
622;25.12.2017;2017;12;22;Maanantai;4;3;7
622;25.12.2017;2017;12;23;Maanantai;4;0;4
622;26.12.2017;2017;12;00;Tiistai;1;0;1
622;26.12.2017;2017;12;01;Tiistai;1;1;2
622;26.12.2017;2017;12;02;Tiistai;0;2;2
622;26.12.2017;2017;12;03;Tiistai;3;2;5
622;26.12.2017;2017;12;04;Tiistai;0;1;1
622;26.12.2017;2017;12;05;Tiistai;0;2;2
622;26.12.2017;2017;12;06;Tiistai;0;1;1
622;26.12.2017;2017;12;07;Tiistai;0;2;2
622;26.12.2017;2017;12;08;Tiistai;1;1;2
622;26.12.2017;2017;12;09;Tiistai;3;1;4
622;26.12.2017;2017;12;10;Tiistai;0;0;0
622;26.12.2017;2017;12;11;Tiistai;3;4;7
622;26.12.2017;2017;12;12;Tiistai;5;7;12
622;26.12.2017;2017;12;13;Tiistai;2;9;11
622;26.12.2017;2017;12;14;Tiistai;5;6;11
622;26.12.2017;2017;12;15;Tiistai;4;8;12
622;26.12.2017;2017;12;16;Tiistai;9;5;14
622;26.12.2017;2017;12;17;Tiistai;7;7;14
622;26.12.2017;2017;12;18;Tiistai;4;2;6
622;26.12.2017;2017;12;19;Tiistai;5;7;12
622;26.12.2017;2017;12;20;Tiistai;3;3;6
622;26.12.2017;2017;12;21;Tiistai;2;0;2
622;26.12.2017;2017;12;22;Tiistai;4;0;4
622;26.12.2017;2017;12;23;Tiistai;0;0;0
622;27.12.2017;2017;12;00;Keskiviikko;2;0;2
622;27.12.2017;2017;12;01;Keskiviikko;0;2;2
622;27.12.2017;2017;12;02;Keskiviikko;0;0;0
622;27.12.2017;2017;12;03;Keskiviikko;1;0;1
622;27.12.2017;2017;12;04;Keskiviikko;0;0;0
622;27.12.2017;2017;12;05;Keskiviikko;2;1;3
622;27.12.2017;2017;12;06;Keskiviikko;1;2;3
622;27.12.2017;2017;12;07;Keskiviikko;1;5;6
622;27.12.2017;2017;12;08;Keskiviikko;6;6;12
622;27.12.2017;2017;12;09;Keskiviikko;7;8;15
622;27.12.2017;2017;12;10;Keskiviikko;2;1;3
622;27.12.2017;2017;12;11;Keskiviikko;3;6;9
622;27.12.2017;2017;12;12;Keskiviikko;5;6;11
622;27.12.2017;2017;12;13;Keskiviikko;7;2;9
622;27.12.2017;2017;12;14;Keskiviikko;4;3;7
622;27.12.2017;2017;12;15;Keskiviikko;6;9;15
622;27.12.2017;2017;12;16;Keskiviikko;15;5;20
622;27.12.2017;2017;12;17;Keskiviikko;14;6;20
622;27.12.2017;2017;12;18;Keskiviikko;9;4;13
622;27.12.2017;2017;12;19;Keskiviikko;6;5;11
622;27.12.2017;2017;12;20;Keskiviikko;5;3;8
622;27.12.2017;2017;12;21;Keskiviikko;9;5;14
622;27.12.2017;2017;12;22;Keskiviikko;2;3;5
622;27.12.2017;2017;12;23;Keskiviikko;1;1;2
622;28.12.2017;2017;12;00;Torstai;0;0;0
622;28.12.2017;2017;12;01;Torstai;2;2;4
622;28.12.2017;2017;12;02;Torstai;1;0;1
622;28.12.2017;2017;12;03;Torstai;0;0;0
622;28.12.2017;2017;12;04;Torstai;1;1;2
622;28.12.2017;2017;12;05;Torstai;1;2;3
622;28.12.2017;2017;12;06;Torstai;2;3;5
622;28.12.2017;2017;12;07;Torstai;2;6;8
622;28.12.2017;2017;12;08;Torstai;4;6;10
622;28.12.2017;2017;12;09;Torstai;3;7;10
622;28.12.2017;2017;12;10;Torstai;1;3;4
622;28.12.2017;2017;12;11;Torstai;5;6;11
622;28.12.2017;2017;12;12;Torstai;9;9;18
622;28.12.2017;2017;12;13;Torstai;9;8;17
622;28.12.2017;2017;12;14;Torstai;8;10;18
622;28.12.2017;2017;12;15;Torstai;6;3;9
622;28.12.2017;2017;12;16;Torstai;24;11;35
622;28.12.2017;2017;12;17;Torstai;8;5;13
622;28.12.2017;2017;12;18;Torstai;14;11;25
622;28.12.2017;2017;12;19;Torstai;11;4;15
622;28.12.2017;2017;12;20;Torstai;4;2;6
622;28.12.2017;2017;12;21;Torstai;7;0;7
622;28.12.2017;2017;12;22;Torstai;12;1;13
622;28.12.2017;2017;12;23;Torstai;3;0;3
622;29.12.2017;2017;12;00;Perjantai;2;2;4
622;29.12.2017;2017;12;01;Perjantai;0;2;2
622;29.12.2017;2017;12;02;Perjantai;0;1;1
622;29.12.2017;2017;12;03;Perjantai;0;0;0
622;29.12.2017;2017;12;04;Perjantai;1;0;1
622;29.12.2017;2017;12;05;Perjantai;1;0;1
622;29.12.2017;2017;12;06;Perjantai;2;5;7
622;29.12.2017;2017;12;07;Perjantai;0;11;11
622;29.12.2017;2017;12;08;Perjantai;4;3;7
622;29.12.2017;2017;12;09;Perjantai;5;6;11
622;29.12.2017;2017;12;10;Perjantai;8;2;10
622;29.12.2017;2017;12;11;Perjantai;7;10;17
622;29.12.2017;2017;12;12;Perjantai;4;3;7
622;29.12.2017;2017;12;13;Perjantai;11;7;18
622;29.12.2017;2017;12;14;Perjantai;12;12;24
622;29.12.2017;2017;12;15;Perjantai;11;5;16
622;29.12.2017;2017;12;16;Perjantai;13;8;21
622;29.12.2017;2017;12;17;Perjantai;17;8;25
622;29.12.2017;2017;12;18;Perjantai;10;5;15
622;29.12.2017;2017;12;19;Perjantai;8;8;16
622;29.12.2017;2017;12;20;Perjantai;8;5;13
622;29.12.2017;2017;12;21;Perjantai;10;5;15
622;29.12.2017;2017;12;22;Perjantai;8;1;9
622;29.12.2017;2017;12;23;Perjantai;2;4;6
622;30.12.2017;2017;12;00;Lauantai;6;2;8
622;30.12.2017;2017;12;01;Lauantai;3;2;5
622;30.12.2017;2017;12;02;Lauantai;3;0;3
622;30.12.2017;2017;12;03;Lauantai;4;0;4
622;30.12.2017;2017;12;04;Lauantai;0;2;2
622;30.12.2017;2017;12;05;Lauantai;1;0;1
622;30.12.2017;2017;12;06;Lauantai;2;3;5
622;30.12.2017;2017;12;07;Lauantai;3;1;4
622;30.12.2017;2017;12;08;Lauantai;3;1;4
622;30.12.2017;2017;12;09;Lauantai;2;2;4
622;30.12.2017;2017;12;10;Lauantai;3;1;4
622;30.12.2017;2017;12;11;Lauantai;0;1;1
622;30.12.2017;2017;12;12;Lauantai;1;1;2
622;30.12.2017;2017;12;13;Lauantai;3;0;3
622;30.12.2017;2017;12;14;Lauantai;2;2;4
622;30.12.2017;2017;12;15;Lauantai;6;5;11
622;30.12.2017;2017;12;16;Lauantai;0;0;0
622;30.12.2017;2017;12;17;Lauantai;3;3;6
622;30.12.2017;2017;12;18;Lauantai;3;3;6
622;30.12.2017;2017;12;19;Lauantai;6;6;12
622;30.12.2017;2017;12;20;Lauantai;7;5;12
622;30.12.2017;2017;12;21;Lauantai;2;4;6
622;30.12.2017;2017;12;22;Lauantai;0;1;1
622;30.12.2017;2017;12;23;Lauantai;0;1;1
622;31.12.2017;2017;12;00;Sunnuntai;1;0;1
622;31.12.2017;2017;12;01;Sunnuntai;0;0;0
622;31.12.2017;2017;12;02;Sunnuntai;1;1;2
622;31.12.2017;2017;12;03;Sunnuntai;1;1;2
622;31.12.2017;2017;12;04;Sunnuntai;0;0;0
622;31.12.2017;2017;12;05;Sunnuntai;1;0;1
622;31.12.2017;2017;12;06;Sunnuntai;0;1;1
622;31.12.2017;2017;12;07;Sunnuntai;1;2;3
622;31.12.2017;2017;12;08;Sunnuntai;1;0;1
622;31.12.2017;2017;12;09;Sunnuntai;1;2;3
622;31.12.2017;2017;12;10;Sunnuntai;2;2;4
622;31.12.2017;2017;12;11;Sunnuntai;3;3;6
622;31.12.2017;2017;12;12;Sunnuntai;2;5;7
622;31.12.2017;2017;12;13;Sunnuntai;4;3;7
622;31.12.2017;2017;12;14;Sunnuntai;5;4;9
622;31.12.2017;2017;12;15;Sunnuntai;2;3;5
622;31.12.2017;2017;12;16;Sunnuntai;4;2;6
622;31.12.2017;2017;12;17;Sunnuntai;6;4;10
622;31.12.2017;2017;12;18;Sunnuntai;0;1;1
622;31.12.2017;2017;12;19;Sunnuntai;4;2;6
622;31.12.2017;2017;12;20;Sunnuntai;3;2;5
622;31.12.2017;2017;12;21;Sunnuntai;1;2;3
622;31.12.2017;2017;12;22;Sunnuntai;6;2;8
622;31.12.2017;2017;12;23;Sunnuntai;2;1;3
622;05.02.2018;2018;02;00;Maanantai;0;0;0
622;05.02.2018;2018;02;01;Maanantai;1;1;2
622;05.02.2018;2018;02;02;Maanantai;0;0;0
622;05.02.2018;2018;02;03;Maanantai;0;0;0
622;05.02.2018;2018;02;04;Maanantai;0;0;0
622;05.02.2018;2018;02;05;Maanantai;0;0;0
622;05.02.2018;2018;02;06;Maanantai;0;0;0
622;05.02.2018;2018;02;07;Maanantai;0;4;4
622;05.02.2018;2018;02;08;Maanantai;2;5;7
622;05.02.2018;2018;02;09;Maanantai;2;8;10
622;05.02.2018;2018;02;10;Maanantai;1;8;9
622;05.02.2018;2018;02;11;Maanantai;3;2;5
622;05.02.2018;2018;02;12;Maanantai;2;2;4
622;05.02.2018;2018;02;13;Maanantai;3;1;4
622;05.02.2018;2018;02;14;Maanantai;4;3;7
622;05.02.2018;2018;02;15;Maanantai;2;6;8
622;05.02.2018;2018;02;16;Maanantai;6;0;6
622;05.02.2018;2018;02;17;Maanantai;8;5;13
622;05.02.2018;2018;02;18;Maanantai;1;5;6
622;05.02.2018;2018;02;19;Maanantai;4;2;6
622;05.02.2018;2018;02;20;Maanantai;2;2;4
622;05.02.2018;2018;02;21;Maanantai;4;0;4
622;05.02.2018;2018;02;22;Maanantai;2;1;3
622;05.02.2018;2018;02;23;Maanantai;0;1;1
622;06.02.2018;2018;02;00;Tiistai;1;0;1
622;06.02.2018;2018;02;01;Tiistai;0;0;0
622;06.02.2018;2018;02;02;Tiistai;0;0;0
622;06.02.2018;2018;02;03;Tiistai;0;0;0
622;06.02.2018;2018;02;04;Tiistai;0;0;0
622;06.02.2018;2018;02;05;Tiistai;0;0;0
622;06.02.2018;2018;02;06;Tiistai;1;0;1
622;06.02.2018;2018;02;07;Tiistai;0;2;2
622;06.02.2018;2018;02;08;Tiistai;4;2;6
622;06.02.2018;2018;02;09;Tiistai;4;7;11
622;06.02.2018;2018;02;10;Tiistai;2;2;4
622;06.02.2018;2018;02;11;Tiistai;1;1;2
622;06.02.2018;2018;02;12;Tiistai;0;3;3
622;06.02.2018;2018;02;13;Tiistai;4;6;10
622;06.02.2018;2018;02;14;Tiistai;4;3;7
622;06.02.2018;2018;02;15;Tiistai;2;1;3
622;06.02.2018;2018;02;16;Tiistai;4;3;7
622;06.02.2018;2018;02;17;Tiistai;10;4;14
622;06.02.2018;2018;02;18;Tiistai;4;7;11
622;06.02.2018;2018;02;19;Tiistai;7;3;10
622;06.02.2018;2018;02;20;Tiistai;4;5;9
622;06.02.2018;2018;02;21;Tiistai;1;3;4
622;06.02.2018;2018;02;22;Tiistai;4;4;8
622;06.02.2018;2018;02;23;Tiistai;2;1;3
622;07.02.2018;2018;02;00;Keskiviikko;1;1;2
622;07.02.2018;2018;02;01;Keskiviikko;2;0;2
622;07.02.2018;2018;02;02;Keskiviikko;0;0;0
622;07.02.2018;2018;02;03;Keskiviikko;1;0;1
622;07.02.2018;2018;02;04;Keskiviikko;0;0;0
622;07.02.2018;2018;02;05;Keskiviikko;2;1;3
622;07.02.2018;2018;02;06;Keskiviikko;1;2;3
622;07.02.2018;2018;02;07;Keskiviikko;3;10;13
622;07.02.2018;2018;02;08;Keskiviikko;2;6;8
622;07.02.2018;2018;02;09;Keskiviikko;4;8;12
622;07.02.2018;2018;02;10;Keskiviikko;2;6;8
622;07.02.2018;2018;02;11;Keskiviikko;1;3;4
622;07.02.2018;2018;02;12;Keskiviikko;4;5;9
622;07.02.2018;2018;02;13;Keskiviikko;2;5;7
622;07.02.2018;2018;02;14;Keskiviikko;2;7;9
622;07.02.2018;2018;02;15;Keskiviikko;6;7;13
622;07.02.2018;2018;02;16;Keskiviikko;4;4;8
622;07.02.2018;2018;02;17;Keskiviikko;7;3;10
622;07.02.2018;2018;02;18;Keskiviikko;9;6;15
622;07.02.2018;2018;02;19;Keskiviikko;7;2;9
622;07.02.2018;2018;02;20;Keskiviikko;1;3;4
622;07.02.2018;2018;02;21;Keskiviikko;5;2;7
622;07.02.2018;2018;02;22;Keskiviikko;3;1;4
622;07.02.2018;2018;02;23;Keskiviikko;2;1;3
622;08.02.2018;2018;02;00;Torstai;1;0;1
622;08.02.2018;2018;02;01;Torstai;0;0;0
622;08.02.2018;2018;02;02;Torstai;0;0;0
622;08.02.2018;2018;02;03;Torstai;2;1;3
622;08.02.2018;2018;02;04;Torstai;0;1;1
622;08.02.2018;2018;02;05;Torstai;1;0;1
622;08.02.2018;2018;02;06;Torstai;2;2;4
622;08.02.2018;2018;02;07;Torstai;0;7;7
622;08.02.2018;2018;02;08;Torstai;9;9;18
622;08.02.2018;2018;02;09;Torstai;7;10;17
622;08.02.2018;2018;02;10;Torstai;5;5;10
622;08.02.2018;2018;02;11;Torstai;4;8;12
622;08.02.2018;2018;02;12;Torstai;5;3;8
622;08.02.2018;2018;02;13;Torstai;1;4;5
622;08.02.2018;2018;02;14;Torstai;5;1;6
622;08.02.2018;2018;02;15;Torstai;2;7;9
622;08.02.2018;2018;02;16;Torstai;10;6;16
622;08.02.2018;2018;02;17;Torstai;15;9;24
622;08.02.2018;2018;02;18;Torstai;5;1;6
622;08.02.2018;2018;02;19;Torstai;6;1;7
622;08.02.2018;2018;02;20;Torstai;3;2;5
622;08.02.2018;2018;02;21;Torstai;3;3;6
622;08.02.2018;2018;02;22;Torstai;6;2;8
622;08.02.2018;2018;02;23;Torstai;1;1;2
622;09.02.2018;2018;02;00;Perjantai;0;1;1
622;09.02.2018;2018;02;01;Perjantai;0;0;0
622;09.02.2018;2018;02;02;Perjantai;1;0;1
622;09.02.2018;2018;02;03;Perjantai;1;0;1
622;09.02.2018;2018;02;04;Perjantai;0;0;0
622;09.02.2018;2018;02;05;Perjantai;0;0;0
622;09.02.2018;2018;02;06;Perjantai;0;2;2
622;09.02.2018;2018;02;07;Perjantai;1;3;4
622;09.02.2018;2018;02;08;Perjantai;7;7;14
622;09.02.2018;2018;02;09;Perjantai;6;5;11
622;09.02.2018;2018;02;10;Perjantai;1;4;5
622;09.02.2018;2018;02;11;Perjantai;6;2;8
622;09.02.2018;2018;02;12;Perjantai;1;4;5
622;09.02.2018;2018;02;13;Perjantai;4;6;10
622;09.02.2018;2018;02;14;Perjantai;7;3;10
622;09.02.2018;2018;02;15;Perjantai;16;8;24
622;09.02.2018;2018;02;16;Perjantai;6;6;12
622;09.02.2018;2018;02;17;Perjantai;14;6;20
622;09.02.2018;2018;02;18;Perjantai;8;3;11
622;09.02.2018;2018;02;19;Perjantai;1;3;4
622;09.02.2018;2018;02;20;Perjantai;6;5;11
622;09.02.2018;2018;02;21;Perjantai;5;5;10
622;09.02.2018;2018;02;22;Perjantai;6;4;10
622;09.02.2018;2018;02;23;Perjantai;1;0;1
622;10.02.2018;2018;02;00;Lauantai;1;0;1
622;10.02.2018;2018;02;01;Lauantai;2;1;3
622;10.02.2018;2018;02;02;Lauantai;0;0;0
622;10.02.2018;2018;02;03;Lauantai;3;0;3
622;10.02.2018;2018;02;04;Lauantai;1;0;1
622;10.02.2018;2018;02;05;Lauantai;0;0;0
622;10.02.2018;2018;02;06;Lauantai;0;0;0
622;10.02.2018;2018;02;07;Lauantai;1;2;3
622;10.02.2018;2018;02;08;Lauantai;2;0;2
622;10.02.2018;2018;02;09;Lauantai;0;1;1
622;10.02.2018;2018;02;10;Lauantai;1;4;5
622;10.02.2018;2018;02;11;Lauantai;1;1;2
622;10.02.2018;2018;02;12;Lauantai;4;4;8
622;10.02.2018;2018;02;13;Lauantai;9;6;15
622;10.02.2018;2018;02;14;Lauantai;5;1;6
622;10.02.2018;2018;02;15;Lauantai;4;5;9
622;10.02.2018;2018;02;16;Lauantai;8;1;9
622;10.02.2018;2018;02;17;Lauantai;9;1;10
622;10.02.2018;2018;02;18;Lauantai;3;1;4
622;10.02.2018;2018;02;19;Lauantai;3;6;9
622;10.02.2018;2018;02;20;Lauantai;3;0;3
622;10.02.2018;2018;02;21;Lauantai;2;4;6
622;10.02.2018;2018;02;22;Lauantai;4;2;6
622;10.02.2018;2018;02;23;Lauantai;2;1;3
622;11.02.2018;2018;02;00;Sunnuntai;0;2;2
622;11.02.2018;2018;02;01;Sunnuntai;3;1;4
622;11.02.2018;2018;02;02;Sunnuntai;0;1;1
622;11.02.2018;2018;02;03;Sunnuntai;2;1;3
622;11.02.2018;2018;02;04;Sunnuntai;0;0;0
622;11.02.2018;2018;02;05;Sunnuntai;0;0;0
622;11.02.2018;2018;02;06;Sunnuntai;0;1;1
622;11.02.2018;2018;02;07;Sunnuntai;1;1;2
622;11.02.2018;2018;02;08;Sunnuntai;1;0;1
622;11.02.2018;2018;02;09;Sunnuntai;0;2;2
622;11.02.2018;2018;02;10;Sunnuntai;1;0;1
622;11.02.2018;2018;02;11;Sunnuntai;2;3;5
622;11.02.2018;2018;02;12;Sunnuntai;6;1;7
622;11.02.2018;2018;02;13;Sunnuntai;3;6;9
622;11.02.2018;2018;02;14;Sunnuntai;0;9;9
622;11.02.2018;2018;02;15;Sunnuntai;6;2;8
622;11.02.2018;2018;02;16;Sunnuntai;4;3;7
622;11.02.2018;2018;02;17;Sunnuntai;12;2;14
622;11.02.2018;2018;02;18;Sunnuntai;3;0;3
622;11.02.2018;2018;02;19;Sunnuntai;3;2;5
622;11.02.2018;2018;02;20;Sunnuntai;4;2;6
622;11.02.2018;2018;02;21;Sunnuntai;1;2;3
622;11.02.2018;2018;02;22;Sunnuntai;1;0;1
622;11.02.2018;2018;02;23;Sunnuntai;1;0;1
622;12.02.2018;2018;02;00;Maanantai;0;0;0
622;12.02.2018;2018;02;01;Maanantai;0;1;1
622;12.02.2018;2018;02;02;Maanantai;0;1;1
622;12.02.2018;2018;02;03;Maanantai;0;0;0
622;12.02.2018;2018;02;04;Maanantai;0;0;0
622;12.02.2018;2018;02;05;Maanantai;0;0;0
622;12.02.2018;2018;02;06;Maanantai;0;0;0
622;12.02.2018;2018;02;07;Maanantai;1;4;5
622;12.02.2018;2018;02;08;Maanantai;12;19;31
622;12.02.2018;2018;02;09;Maanantai;6;5;11
622;12.02.2018;2018;02;10;Maanantai;4;6;10
622;12.02.2018;2018;02;11;Maanantai;4;5;9
622;12.02.2018;2018;02;12;Maanantai;4;3;7
622;12.02.2018;2018;02;13;Maanantai;7;4;11
622;12.02.2018;2018;02;14;Maanantai;1;4;5
622;12.02.2018;2018;02;15;Maanantai;7;5;12
622;12.02.2018;2018;02;16;Maanantai;7;5;12
622;12.02.2018;2018;02;17;Maanantai;19;7;26
622;12.02.2018;2018;02;18;Maanantai;8;6;14
622;12.02.2018;2018;02;19;Maanantai;5;0;5
622;12.02.2018;2018;02;20;Maanantai;5;6;11
622;12.02.2018;2018;02;21;Maanantai;5;3;8
622;12.02.2018;2018;02;22;Maanantai;5;1;6
622;12.02.2018;2018;02;23;Maanantai;0;2;2
622;13.02.2018;2018;02;00;Tiistai;1;1;2
622;13.02.2018;2018;02;01;Tiistai;0;0;0
622;13.02.2018;2018;02;02;Tiistai;0;0;0
622;13.02.2018;2018;02;03;Tiistai;0;0;0
622;13.02.2018;2018;02;04;Tiistai;0;0;0
622;13.02.2018;2018;02;05;Tiistai;0;0;0
622;13.02.2018;2018;02;06;Tiistai;0;2;2
622;13.02.2018;2018;02;07;Tiistai;0;4;4
622;13.02.2018;2018;02;08;Tiistai;7;8;15
622;13.02.2018;2018;02;09;Tiistai;5;4;9
622;13.02.2018;2018;02;10;Tiistai;8;9;17
622;13.02.2018;2018;02;11;Tiistai;0;5;5
622;13.02.2018;2018;02;12;Tiistai;4;3;7
622;13.02.2018;2018;02;13;Tiistai;0;3;3
622;13.02.2018;2018;02;14;Tiistai;0;4;4
622;13.02.2018;2018;02;15;Tiistai;0;0;0
622;13.02.2018;2018;02;16;Tiistai;2;1;3
622;13.02.2018;2018;02;17;Tiistai;5;5;10
622;13.02.2018;2018;02;18;Tiistai;4;9;13
622;13.02.2018;2018;02;19;Tiistai;6;6;12
622;13.02.2018;2018;02;20;Tiistai;11;2;13
622;13.02.2018;2018;02;21;Tiistai;3;5;8
622;13.02.2018;2018;02;22;Tiistai;1;7;8
622;13.02.2018;2018;02;23;Tiistai;6;1;7
622;14.02.2018;2018;02;00;Keskiviikko;0;0;0
622;14.02.2018;2018;02;01;Keskiviikko;0;0;0
622;14.02.2018;2018;02;02;Keskiviikko;1;0;1
622;14.02.2018;2018;02;03;Keskiviikko;1;0;1
622;14.02.2018;2018;02;04;Keskiviikko;2;0;2
622;14.02.2018;2018;02;05;Keskiviikko;1;0;1
622;14.02.2018;2018;02;06;Keskiviikko;0;0;0
622;14.02.2018;2018;02;07;Keskiviikko;0;5;5
622;14.02.2018;2018;02;08;Keskiviikko;6;12;18
622;14.02.2018;2018;02;09;Keskiviikko;4;7;11
622;14.02.2018;2018;02;10;Keskiviikko;2;1;3
622;14.02.2018;2018;02;11;Keskiviikko;3;2;5
622;14.02.2018;2018;02;12;Keskiviikko;2;2;4
622;14.02.2018;2018;02;13;Keskiviikko;5;1;6
622;14.02.2018;2018;02;14;Keskiviikko;4;4;8
622;14.02.2018;2018;02;15;Keskiviikko;1;6;7
622;14.02.2018;2018;02;16;Keskiviikko;3;2;5
622;14.02.2018;2018;02;17;Keskiviikko;8;8;16
622;14.02.2018;2018;02;18;Keskiviikko;5;6;11
622;14.02.2018;2018;02;19;Keskiviikko;6;5;11
622;14.02.2018;2018;02;20;Keskiviikko;0;2;2
622;14.02.2018;2018;02;21;Keskiviikko;4;2;6
622;14.02.2018;2018;02;22;Keskiviikko;4;1;5
622;14.02.2018;2018;02;23;Keskiviikko;1;1;2
622;15.02.2018;2018;02;00;Torstai;0;1;1
622;15.02.2018;2018;02;01;Torstai;2;1;3
622;15.02.2018;2018;02;02;Torstai;0;0;0
622;15.02.2018;2018;02;03;Torstai;2;0;2
622;15.02.2018;2018;02;04;Torstai;1;0;1
622;15.02.2018;2018;02;05;Torstai;3;0;3
622;15.02.2018;2018;02;06;Torstai;1;5;6
622;15.02.2018;2018;02;07;Torstai;1;4;5
622;15.02.2018;2018;02;08;Torstai;5;18;23
622;15.02.2018;2018;02;09;Torstai;6;11;17
622;15.02.2018;2018;02;10;Torstai;6;3;9
622;15.02.2018;2018;02;11;Torstai;1;5;6
622;15.02.2018;2018;02;12;Torstai;2;12;14
622;15.02.2018;2018;02;13;Torstai;2;5;7
622;15.02.2018;2018;02;14;Torstai;5;7;12
622;15.02.2018;2018;02;15;Torstai;2;8;10
622;15.02.2018;2018;02;16;Torstai;9;3;12
622;15.02.2018;2018;02;17;Torstai;8;7;15
622;15.02.2018;2018;02;18;Torstai;5;8;13
622;15.02.2018;2018;02;19;Torstai;9;4;13
622;15.02.2018;2018;02;20;Torstai;5;5;10
622;15.02.2018;2018;02;21;Torstai;3;2;5
622;15.02.2018;2018;02;22;Torstai;1;1;2
622;15.02.2018;2018;02;23;Torstai;0;2;2
622;16.02.2018;2018;02;00;Perjantai;1;0;1
622;16.02.2018;2018;02;01;Perjantai;1;1;2
622;16.02.2018;2018;02;02;Perjantai;0;1;1
622;16.02.2018;2018;02;03;Perjantai;0;0;0
622;16.02.2018;2018;02;04;Perjantai;1;0;1
622;16.02.2018;2018;02;05;Perjantai;0;0;0
622;16.02.2018;2018;02;06;Perjantai;0;0;0
622;16.02.2018;2018;02;07;Perjantai;2;4;6
622;16.02.2018;2018;02;08;Perjantai;3;10;13
622;16.02.2018;2018;02;09;Perjantai;3;6;9
622;16.02.2018;2018;02;10;Perjantai;1;8;9
622;16.02.2018;2018;02;11;Perjantai;3;0;3
622;16.02.2018;2018;02;12;Perjantai;2;4;6
622;16.02.2018;2018;02;13;Perjantai;3;3;6
622;16.02.2018;2018;02;14;Perjantai;4;4;8
622;16.02.2018;2018;02;15;Perjantai;5;2;7
622;16.02.2018;2018;02;16;Perjantai;8;12;20
622;16.02.2018;2018;02;17;Perjantai;8;3;11
622;16.02.2018;2018;02;18;Perjantai;9;2;11
622;16.02.2018;2018;02;19;Perjantai;5;6;11
622;16.02.2018;2018;02;20;Perjantai;1;4;5
622;16.02.2018;2018;02;21;Perjantai;1;1;2
622;16.02.2018;2018;02;22;Perjantai;3;1;4
622;16.02.2018;2018;02;23;Perjantai;2;1;3
622;17.02.2018;2018;02;00;Lauantai;0;2;2
622;17.02.2018;2018;02;01;Lauantai;0;0;0
622;17.02.2018;2018;02;02;Lauantai;2;1;3
622;17.02.2018;2018;02;03;Lauantai;0;0;0
622;17.02.2018;2018;02;04;Lauantai;0;2;2
622;17.02.2018;2018;02;05;Lauantai;0;0;0
622;17.02.2018;2018;02;06;Lauantai;0;0;0
622;17.02.2018;2018;02;07;Lauantai;1;2;3
622;17.02.2018;2018;02;08;Lauantai;0;0;0
622;17.02.2018;2018;02;09;Lauantai;0;1;1
622;17.02.2018;2018;02;10;Lauantai;1;3;4
622;17.02.2018;2018;02;11;Lauantai;3;2;5
622;17.02.2018;2018;02;12;Lauantai;3;2;5
622;17.02.2018;2018;02;13;Lauantai;5;7;12
622;17.02.2018;2018;02;14;Lauantai;2;3;5
622;17.02.2018;2018;02;15;Lauantai;6;5;11
622;17.02.2018;2018;02;16;Lauantai;4;5;9
622;17.02.2018;2018;02;17;Lauantai;2;1;3
622;17.02.2018;2018;02;18;Lauantai;3;3;6
622;17.02.2018;2018;02;19;Lauantai;3;2;5
622;17.02.2018;2018;02;20;Lauantai;2;5;7
622;17.02.2018;2018;02;21;Lauantai;1;4;5
622;17.02.2018;2018;02;22;Lauantai;3;0;3
622;17.02.2018;2018;02;23;Lauantai;0;0;0
622;18.02.2018;2018;02;00;Sunnuntai;0;1;1
622;18.02.2018;2018;02;01;Sunnuntai;0;0;0
622;18.02.2018;2018;02;02;Sunnuntai;1;0;1
622;18.02.2018;2018;02;03;Sunnuntai;0;2;2
622;18.02.2018;2018;02;04;Sunnuntai;0;2;2
622;18.02.2018;2018;02;05;Sunnuntai;2;0;2
622;18.02.2018;2018;02;06;Sunnuntai;0;0;0
622;18.02.2018;2018;02;07;Sunnuntai;0;1;1
622;18.02.2018;2018;02;08;Sunnuntai;0;0;0
622;18.02.2018;2018;02;09;Sunnuntai;0;1;1
622;18.02.2018;2018;02;10;Sunnuntai;1;2;3
622;18.02.2018;2018;02;11;Sunnuntai;1;2;3
622;18.02.2018;2018;02;12;Sunnuntai;5;1;6
622;18.02.2018;2018;02;13;Sunnuntai;6;7;13
622;18.02.2018;2018;02;14;Sunnuntai;0;5;5
622;18.02.2018;2018;02;15;Sunnuntai;4;1;5
622;18.02.2018;2018;02;16;Sunnuntai;2;1;3
622;18.02.2018;2018;02;17;Sunnuntai;1;2;3
622;18.02.2018;2018;02;18;Sunnuntai;3;2;5
622;18.02.2018;2018;02;19;Sunnuntai;6;3;9
622;18.02.2018;2018;02;20;Sunnuntai;2;3;5
622;18.02.2018;2018;02;21;Sunnuntai;1;0;1
622;18.02.2018;2018;02;22;Sunnuntai;1;1;2
622;18.02.2018;2018;02;23;Sunnuntai;0;0;0
622;05.03.2018;2018;03;00;Maanantai;0;0;0
622;05.03.2018;2018;03;01;Maanantai;0;0;0
622;05.03.2018;2018;03;02;Maanantai;1;0;1
622;05.03.2018;2018;03;03;Maanantai;0;0;0
622;05.03.2018;2018;03;04;Maanantai;0;0;0
622;05.03.2018;2018;03;05;Maanantai;0;0;0
622;05.03.2018;2018;03;06;Maanantai;0;0;0
622;05.03.2018;2018;03;07;Maanantai;0;2;2
622;05.03.2018;2018;03;08;Maanantai;6;4;10
622;05.03.2018;2018;03;09;Maanantai;3;4;7
622;05.03.2018;2018;03;10;Maanantai;2;0;2
622;05.03.2018;2018;03;11;Maanantai;2;0;2
622;05.03.2018;2018;03;12;Maanantai;1;4;5
622;05.03.2018;2018;03;13;Maanantai;3;5;8
622;05.03.2018;2018;03;14;Maanantai;6;4;10
622;05.03.2018;2018;03;15;Maanantai;4;3;7
622;05.03.2018;2018;03;16;Maanantai;7;3;10
622;05.03.2018;2018;03;17;Maanantai;3;2;5
622;05.03.2018;2018;03;18;Maanantai;2;4;6
622;05.03.2018;2018;03;19;Maanantai;1;2;3
622;05.03.2018;2018;03;20;Maanantai;3;3;6
622;05.03.2018;2018;03;21;Maanantai;0;0;0
622;05.03.2018;2018;03;22;Maanantai;1;0;1
622;05.03.2018;2018;03;23;Maanantai;1;0;1
622;06.03.2018;2018;03;00;Tiistai;1;0;1
622;06.03.2018;2018;03;01;Tiistai;0;0;0
622;06.03.2018;2018;03;02;Tiistai;0;0;0
622;06.03.2018;2018;03;03;Tiistai;0;0;0
622;06.03.2018;2018;03;04;Tiistai;0;0;0
622;06.03.2018;2018;03;05;Tiistai;0;1;1
622;06.03.2018;2018;03;06;Tiistai;0;0;0
622;06.03.2018;2018;03;07;Tiistai;2;2;4
622;06.03.2018;2018;03;08;Tiistai;3;1;4
622;06.03.2018;2018;03;09;Tiistai;3;3;6
622;06.03.2018;2018;03;10;Tiistai;2;3;5
622;06.03.2018;2018;03;11;Tiistai;4;2;6
622;06.03.2018;2018;03;12;Tiistai;3;0;3
622;06.03.2018;2018;03;13;Tiistai;6;4;10
622;06.03.2018;2018;03;14;Tiistai;0;2;2
622;06.03.2018;2018;03;15;Tiistai;6;4;10
622;06.03.2018;2018;03;16;Tiistai;0;3;3
622;06.03.2018;2018;03;17;Tiistai;6;0;6
622;06.03.2018;2018;03;18;Tiistai;4;3;7
622;06.03.2018;2018;03;19;Tiistai;6;2;8
622;06.03.2018;2018;03;20;Tiistai;2;5;7
622;06.03.2018;2018;03;21;Tiistai;2;1;3
622;06.03.2018;2018;03;22;Tiistai;2;4;6
622;06.03.2018;2018;03;23;Tiistai;1;0;1
622;07.03.2018;2018;03;00;Keskiviikko;0;0;0
622;07.03.2018;2018;03;01;Keskiviikko;2;1;3
622;07.03.2018;2018;03;02;Keskiviikko;0;0;0
622;07.03.2018;2018;03;03;Keskiviikko;0;0;0
622;07.03.2018;2018;03;04;Keskiviikko;0;0;0
622;07.03.2018;2018;03;05;Keskiviikko;0;0;0
622;07.03.2018;2018;03;06;Keskiviikko;0;1;1
622;07.03.2018;2018;03;07;Keskiviikko;1;4;5
622;07.03.2018;2018;03;08;Keskiviikko;1;1;2
622;07.03.2018;2018;03;09;Keskiviikko;1;2;3
622;07.03.2018;2018;03;10;Keskiviikko;0;4;4
622;07.03.2018;2018;03;11;Keskiviikko;2;2;4
622;07.03.2018;2018;03;12;Keskiviikko;3;3;6
622;07.03.2018;2018;03;13;Keskiviikko;0;2;2
622;07.03.2018;2018;03;14;Keskiviikko;2;3;5
622;07.03.2018;2018;03;15;Keskiviikko;3;4;7
622;07.03.2018;2018;03;16;Keskiviikko;3;3;6
622;07.03.2018;2018;03;17;Keskiviikko;6;0;6
622;07.03.2018;2018;03;18;Keskiviikko;7;5;12
622;07.03.2018;2018;03;19;Keskiviikko;5;2;7
622;07.03.2018;2018;03;20;Keskiviikko;1;0;1
622;07.03.2018;2018;03;21;Keskiviikko;2;2;4
622;07.03.2018;2018;03;22;Keskiviikko;0;1;1
622;07.03.2018;2018;03;23;Keskiviikko;0;0;0
622;08.03.2018;2018;03;00;Torstai;0;0;0
622;08.03.2018;2018;03;01;Torstai;1;1;2
622;08.03.2018;2018;03;02;Torstai;0;1;1
622;08.03.2018;2018;03;03;Torstai;0;0;0
622;08.03.2018;2018;03;04;Torstai;0;0;0
622;08.03.2018;2018;03;05;Torstai;0;0;0
622;08.03.2018;2018;03;06;Torstai;0;1;1
622;08.03.2018;2018;03;07;Torstai;1;4;5
622;08.03.2018;2018;03;08;Torstai;2;0;2
622;08.03.2018;2018;03;09;Torstai;2;3;5
622;08.03.2018;2018;03;10;Torstai;0;3;3
622;08.03.2018;2018;03;11;Torstai;3;1;4
622;08.03.2018;2018;03;12;Torstai;1;0;1
622;08.03.2018;2018;03;13;Torstai;3;4;7
622;08.03.2018;2018;03;14;Torstai;0;8;8
622;08.03.2018;2018;03;15;Torstai;5;4;9
622;08.03.2018;2018;03;16;Torstai;8;7;15
622;08.03.2018;2018;03;17;Torstai;2;2;4
622;08.03.2018;2018;03;18;Torstai;3;4;7
622;08.03.2018;2018;03;19;Torstai;2;3;5
622;08.03.2018;2018;03;20;Torstai;2;2;4
622;08.03.2018;2018;03;21;Torstai;3;2;5
622;08.03.2018;2018;03;22;Torstai;2;3;5
622;08.03.2018;2018;03;23;Torstai;0;0;0
622;09.03.2018;2018;03;00;Perjantai;0;0;0
622;09.03.2018;2018;03;01;Perjantai;0;0;0
622;09.03.2018;2018;03;02;Perjantai;0;0;0
622;09.03.2018;2018;03;03;Perjantai;0;0;0
622;09.03.2018;2018;03;04;Perjantai;0;0;0
622;09.03.2018;2018;03;05;Perjantai;0;0;0
622;09.03.2018;2018;03;06;Perjantai;0;0;0
622;09.03.2018;2018;03;07;Perjantai;1;3;4
622;09.03.2018;2018;03;08;Perjantai;1;3;4
622;09.03.2018;2018;03;09;Perjantai;2;6;8
622;09.03.2018;2018;03;10;Perjantai;3;3;6
622;09.03.2018;2018;03;11;Perjantai;1;4;5
622;09.03.2018;2018;03;12;Perjantai;2;2;4
622;09.03.2018;2018;03;13;Perjantai;1;1;2
622;09.03.2018;2018;03;14;Perjantai;2;3;5
622;09.03.2018;2018;03;15;Perjantai;6;3;9
622;09.03.2018;2018;03;16;Perjantai;3;3;6
622;09.03.2018;2018;03;17;Perjantai;4;2;6
622;09.03.2018;2018;03;18;Perjantai;4;2;6
622;09.03.2018;2018;03;19;Perjantai;2;1;3
622;09.03.2018;2018;03;20;Perjantai;4;6;10
622;09.03.2018;2018;03;21;Perjantai;2;2;4
622;09.03.2018;2018;03;22;Perjantai;3;0;3
622;09.03.2018;2018;03;23;Perjantai;1;1;2
622;10.03.2018;2018;03;00;Lauantai;0;0;0
622;10.03.2018;2018;03;01;Lauantai;0;0;0
622;10.03.2018;2018;03;02;Lauantai;0;0;0
622;10.03.2018;2018;03;03;Lauantai;0;0;0
622;10.03.2018;2018;03;04;Lauantai;0;1;1
622;10.03.2018;2018;03;05;Lauantai;0;1;1
622;10.03.2018;2018;03;06;Lauantai;0;4;4
622;10.03.2018;2018;03;07;Lauantai;1;0;1
622;10.03.2018;2018;03;08;Lauantai;1;0;1
622;10.03.2018;2018;03;09;Lauantai;0;0;0
622;10.03.2018;2018;03;10;Lauantai;3;2;5
622;10.03.2018;2018;03;11;Lauantai;3;1;4
622;10.03.2018;2018;03;12;Lauantai;2;1;3
622;10.03.2018;2018;03;13;Lauantai;3;3;6
622;10.03.2018;2018;03;14;Lauantai;4;2;6
622;10.03.2018;2018;03;15;Lauantai;2;4;6
622;10.03.2018;2018;03;16;Lauantai;3;3;6
622;10.03.2018;2018;03;17;Lauantai;4;2;6
622;10.03.2018;2018;03;18;Lauantai;1;1;2
622;10.03.2018;2018;03;19;Lauantai;1;2;3
622;10.03.2018;2018;03;20;Lauantai;5;3;8
622;10.03.2018;2018;03;21;Lauantai;1;1;2
622;10.03.2018;2018;03;22;Lauantai;2;0;2
622;10.03.2018;2018;03;23;Lauantai;1;0;1
622;11.03.2018;2018;03;00;Sunnuntai;0;0;0
622;11.03.2018;2018;03;01;Sunnuntai;0;0;0
622;11.03.2018;2018;03;02;Sunnuntai;1;1;2
622;11.03.2018;2018;03;03;Sunnuntai;2;1;3
622;11.03.2018;2018;03;04;Sunnuntai;1;2;3
622;11.03.2018;2018;03;05;Sunnuntai;1;1;2
622;11.03.2018;2018;03;06;Sunnuntai;0;0;0
622;11.03.2018;2018;03;07;Sunnuntai;1;0;1
622;11.03.2018;2018;03;08;Sunnuntai;0;0;0
622;11.03.2018;2018;03;09;Sunnuntai;6;9;15
622;11.03.2018;2018;03;10;Sunnuntai;2;0;2
622;11.03.2018;2018;03;11;Sunnuntai;1;0;1
622;11.03.2018;2018;03;12;Sunnuntai;7;4;11
622;11.03.2018;2018;03;13;Sunnuntai;2;3;5
622;11.03.2018;2018;03;14;Sunnuntai;8;7;15
622;11.03.2018;2018;03;15;Sunnuntai;2;2;4
622;11.03.2018;2018;03;16;Sunnuntai;4;6;10
622;11.03.2018;2018;03;17;Sunnuntai;3;0;3
622;11.03.2018;2018;03;18;Sunnuntai;4;2;6
622;11.03.2018;2018;03;19;Sunnuntai;5;2;7
622;11.03.2018;2018;03;20;Sunnuntai;0;1;1
622;11.03.2018;2018;03;21;Sunnuntai;1;2;3
622;11.03.2018;2018;03;22;Sunnuntai;1;1;2
622;11.03.2018;2018;03;23;Sunnuntai;0;0;0
622;12.03.2018;2018;03;00;Maanantai;1;0;1
622;12.03.2018;2018;03;01;Maanantai;1;0;1
622;12.03.2018;2018;03;02;Maanantai;0;1;1
622;12.03.2018;2018;03;03;Maanantai;0;0;0
622;12.03.2018;2018;03;04;Maanantai;0;0;0
622;12.03.2018;2018;03;05;Maanantai;2;0;2
622;12.03.2018;2018;03;06;Maanantai;0;1;1
622;12.03.2018;2018;03;07;Maanantai;1;4;5
622;12.03.2018;2018;03;08;Maanantai;2;5;7
622;12.03.2018;2018;03;09;Maanantai;3;3;6
622;12.03.2018;2018;03;10;Maanantai;5;4;9
622;12.03.2018;2018;03;11;Maanantai;3;3;6
622;12.03.2018;2018;03;12;Maanantai;2;1;3
622;12.03.2018;2018;03;13;Maanantai;4;5;9
622;12.03.2018;2018;03;14;Maanantai;4;1;5
622;12.03.2018;2018;03;15;Maanantai;3;6;9
622;12.03.2018;2018;03;16;Maanantai;5;1;6
622;12.03.2018;2018;03;17;Maanantai;16;3;19
622;12.03.2018;2018;03;18;Maanantai;6;5;11
622;12.03.2018;2018;03;19;Maanantai;2;4;6
622;12.03.2018;2018;03;20;Maanantai;3;2;5
622;12.03.2018;2018;03;21;Maanantai;3;1;4
622;12.03.2018;2018;03;22;Maanantai;2;1;3
622;12.03.2018;2018;03;23;Maanantai;0;0;0
622;13.03.2018;2018;03;00;Tiistai;0;1;1
622;13.03.2018;2018;03;01;Tiistai;0;0;0
622;13.03.2018;2018;03;02;Tiistai;0;0;0
622;13.03.2018;2018;03;03;Tiistai;0;0;0
622;13.03.2018;2018;03;04;Tiistai;0;0;0
622;13.03.2018;2018;03;05;Tiistai;2;1;3
622;13.03.2018;2018;03;06;Tiistai;0;1;1
622;13.03.2018;2018;03;07;Tiistai;4;10;14
622;13.03.2018;2018;03;08;Tiistai;6;11;17
622;13.03.2018;2018;03;09;Tiistai;5;10;15
622;13.03.2018;2018;03;10;Tiistai;2;4;6
622;13.03.2018;2018;03;11;Tiistai;4;2;6
622;13.03.2018;2018;03;12;Tiistai;2;2;4
622;13.03.2018;2018;03;13;Tiistai;6;4;10
622;13.03.2018;2018;03;14;Tiistai;2;5;7
622;13.03.2018;2018;03;15;Tiistai;5;3;8
622;13.03.2018;2018;03;16;Tiistai;5;6;11
622;13.03.2018;2018;03;17;Tiistai;10;5;15
622;13.03.2018;2018;03;18;Tiistai;10;2;12
622;13.03.2018;2018;03;19;Tiistai;4;10;14
622;13.03.2018;2018;03;20;Tiistai;2;3;5
622;13.03.2018;2018;03;21;Tiistai;3;1;4
622;13.03.2018;2018;03;22;Tiistai;2;1;3
622;13.03.2018;2018;03;23;Tiistai;2;1;3
622;14.03.2018;2018;03;00;Keskiviikko;0;0;0
622;14.03.2018;2018;03;01;Keskiviikko;1;0;1
622;14.03.2018;2018;03;02;Keskiviikko;0;0;0
622;14.03.2018;2018;03;03;Keskiviikko;1;0;1
622;14.03.2018;2018;03;04;Keskiviikko;0;1;1
622;14.03.2018;2018;03;05;Keskiviikko;2;2;4
622;14.03.2018;2018;03;06;Keskiviikko;0;4;4
622;14.03.2018;2018;03;07;Keskiviikko;4;3;7
622;14.03.2018;2018;03;08;Keskiviikko;4;7;11
622;14.03.2018;2018;03;09;Keskiviikko;3;5;8
622;14.03.2018;2018;03;10;Keskiviikko;3;3;6
622;14.03.2018;2018;03;11;Keskiviikko;1;4;5
622;14.03.2018;2018;03;12;Keskiviikko;1;2;3
622;14.03.2018;2018;03;13;Keskiviikko;2;2;4
622;14.03.2018;2018;03;14;Keskiviikko;3;0;3
622;14.03.2018;2018;03;15;Keskiviikko;3;5;8
622;14.03.2018;2018;03;16;Keskiviikko;6;7;13
622;14.03.2018;2018;03;17;Keskiviikko;10;2;12
622;14.03.2018;2018;03;18;Keskiviikko;7;4;11
622;14.03.2018;2018;03;19;Keskiviikko;6;2;8
622;14.03.2018;2018;03;20;Keskiviikko;1;1;2
622;14.03.2018;2018;03;21;Keskiviikko;5;1;6
622;14.03.2018;2018;03;22;Keskiviikko;3;0;3
622;14.03.2018;2018;03;23;Keskiviikko;1;1;2
622;15.03.2018;2018;03;00;Torstai;0;0;0
622;15.03.2018;2018;03;01;Torstai;1;0;1
622;15.03.2018;2018;03;02;Torstai;0;0;0
622;15.03.2018;2018;03;03;Torstai;0;0;0
622;15.03.2018;2018;03;04;Torstai;0;1;1
622;15.03.2018;2018;03;05;Torstai;2;0;2
622;15.03.2018;2018;03;06;Torstai;0;1;1
622;15.03.2018;2018;03;07;Torstai;4;7;11
622;15.03.2018;2018;03;08;Torstai;4;7;11
622;15.03.2018;2018;03;09;Torstai;3;9;12
622;15.03.2018;2018;03;10;Torstai;2;4;6
622;15.03.2018;2018;03;11;Torstai;1;2;3
622;15.03.2018;2018;03;12;Torstai;2;5;7
622;15.03.2018;2018;03;13;Torstai;4;4;8
622;15.03.2018;2018;03;14;Torstai;0;2;2
622;15.03.2018;2018;03;15;Torstai;2;1;3
622;15.03.2018;2018;03;16;Torstai;6;3;9
622;15.03.2018;2018;03;17;Torstai;6;4;10
622;15.03.2018;2018;03;18;Torstai;5;4;9
622;15.03.2018;2018;03;19;Torstai;4;7;11
622;15.03.2018;2018;03;20;Torstai;2;2;4
622;15.03.2018;2018;03;21;Torstai;5;2;7
622;15.03.2018;2018;03;22;Torstai;2;0;2
622;15.03.2018;2018;03;23;Torstai;0;0;0
622;16.03.2018;2018;03;00;Perjantai;4;0;4
622;16.03.2018;2018;03;01;Perjantai;2;0;2
622;16.03.2018;2018;03;02;Perjantai;0;0;0
622;16.03.2018;2018;03;03;Perjantai;0;0;0
622;16.03.2018;2018;03;04;Perjantai;0;0;0
622;16.03.2018;2018;03;05;Perjantai;0;0;0
622;16.03.2018;2018;03;06;Perjantai;0;0;0
622;16.03.2018;2018;03;07;Perjantai;1;2;3
622;16.03.2018;2018;03;08;Perjantai;3;4;7
622;16.03.2018;2018;03;09;Perjantai;5;5;10
622;16.03.2018;2018;03;10;Perjantai;1;5;6
622;16.03.2018;2018;03;11;Perjantai;1;3;4
622;16.03.2018;2018;03;12;Perjantai;4;3;7
622;16.03.2018;2018;03;13;Perjantai;1;5;6
622;16.03.2018;2018;03;14;Perjantai;1;1;2
622;16.03.2018;2018;03;15;Perjantai;5;2;7
622;16.03.2018;2018;03;16;Perjantai;7;3;10
622;16.03.2018;2018;03;17;Perjantai;5;2;7
622;16.03.2018;2018;03;18;Perjantai;6;4;10
622;16.03.2018;2018;03;19;Perjantai;2;0;2
622;16.03.2018;2018;03;20;Perjantai;1;4;5
622;16.03.2018;2018;03;21;Perjantai;6;2;8
622;16.03.2018;2018;03;22;Perjantai;3;1;4
622;16.03.2018;2018;03;23;Perjantai;1;1;2
622;17.03.2018;2018;03;00;Lauantai;2;0;2
622;17.03.2018;2018;03;01;Lauantai;0;1;1
622;17.03.2018;2018;03;02;Lauantai;1;0;1
622;17.03.2018;2018;03;03;Lauantai;0;0;0
622;17.03.2018;2018;03;04;Lauantai;1;0;1
622;17.03.2018;2018;03;05;Lauantai;0;0;0
622;17.03.2018;2018;03;06;Lauantai;0;0;0
622;17.03.2018;2018;03;07;Lauantai;1;0;1
622;17.03.2018;2018;03;08;Lauantai;0;0;0
622;17.03.2018;2018;03;09;Lauantai;0;2;2
622;17.03.2018;2018;03;10;Lauantai;1;0;1
622;17.03.2018;2018;03;11;Lauantai;2;2;4
622;17.03.2018;2018;03;12;Lauantai;4;9;13
622;17.03.2018;2018;03;13;Lauantai;2;3;5
622;17.03.2018;2018;03;14;Lauantai;3;2;5
622;17.03.2018;2018;03;15;Lauantai;2;3;5
622;17.03.2018;2018;03;16;Lauantai;10;3;13
622;17.03.2018;2018;03;17;Lauantai;5;4;9
622;17.03.2018;2018;03;18;Lauantai;1;1;2
622;17.03.2018;2018;03;19;Lauantai;1;2;3
622;17.03.2018;2018;03;20;Lauantai;2;1;3
622;17.03.2018;2018;03;21;Lauantai;1;2;3
622;17.03.2018;2018;03;22;Lauantai;1;1;2
622;17.03.2018;2018;03;23;Lauantai;1;1;2
622;18.03.2018;2018;03;00;Sunnuntai;0;0;0
622;18.03.2018;2018;03;01;Sunnuntai;0;0;0
622;18.03.2018;2018;03;02;Sunnuntai;1;1;2
622;18.03.2018;2018;03;03;Sunnuntai;2;1;3
622;18.03.2018;2018;03;04;Sunnuntai;1;2;3
622;18.03.2018;2018;03;05;Sunnuntai;1;1;2
622;18.03.2018;2018;03;06;Sunnuntai;0;0;0
622;18.03.2018;2018;03;07;Sunnuntai;1;0;1
622;18.03.2018;2018;03;08;Sunnuntai;0;0;0
622;18.03.2018;2018;03;09;Sunnuntai;6;9;15
622;18.03.2018;2018;03;10;Sunnuntai;2;0;2
622;18.03.2018;2018;03;11;Sunnuntai;1;0;1
622;18.03.2018;2018;03;12;Sunnuntai;7;4;11
622;18.03.2018;2018;03;13;Sunnuntai;2;3;5
622;18.03.2018;2018;03;14;Sunnuntai;8;7;15
622;18.03.2018;2018;03;15;Sunnuntai;2;2;4
622;18.03.2018;2018;03;16;Sunnuntai;4;6;10
622;18.03.2018;2018;03;17;Sunnuntai;3;0;3
622;18.03.2018;2018;03;18;Sunnuntai;4;2;6
622;18.03.2018;2018;03;19;Sunnuntai;5;2;7
622;18.03.2018;2018;03;20;Sunnuntai;0;1;1
622;18.03.2018;2018;03;21;Sunnuntai;1;2;3
622;18.03.2018;2018;03;22;Sunnuntai;1;1;2
622;18.03.2018;2018;03;23;Sunnuntai;0;0;0
622;19.03.2018;2018;03;00;Maanantai;0;0;0
622;19.03.2018;2018;03;01;Maanantai;0;0;0
622;19.03.2018;2018;03;02;Maanantai;0;0;0
622;19.03.2018;2018;03;03;Maanantai;0;0;0
622;19.03.2018;2018;03;04;Maanantai;0;0;0
622;19.03.2018;2018;03;05;Maanantai;0;0;0
622;19.03.2018;2018;03;06;Maanantai;0;0;0
622;19.03.2018;2018;03;07;Maanantai;0;0;0
622;19.03.2018;2018;03;08;Maanantai;0;0;0
622;19.03.2018;2018;03;09;Maanantai;0;0;0
622;19.03.2018;2018;03;10;Maanantai;2;3;5
622;19.03.2018;2018;03;11;Maanantai;1;1;2
622;19.03.2018;2018;03;12;Maanantai;4;1;5
622;19.03.2018;2018;03;13;Maanantai;4;2;6
622;19.03.2018;2018;03;14;Maanantai;1;1;2
622;19.03.2018;2018;03;15;Maanantai;3;4;7
622;19.03.2018;2018;03;16;Maanantai;9;5;14
622;19.03.2018;2018;03;17;Maanantai;13;8;21
622;19.03.2018;2018;03;18;Maanantai;7;9;16
622;19.03.2018;2018;03;19;Maanantai;10;6;16
622;19.03.2018;2018;03;20;Maanantai;4;0;4
622;19.03.2018;2018;03;21;Maanantai;1;2;3
622;19.03.2018;2018;03;22;Maanantai;2;0;2
622;19.03.2018;2018;03;23;Maanantai;4;0;4
622;20.03.2018;2018;03;00;Tiistai;1;0;1
622;20.03.2018;2018;03;01;Tiistai;0;0;0
622;20.03.2018;2018;03;02;Tiistai;0;0;0
622;20.03.2018;2018;03;03;Tiistai;0;0;0
622;20.03.2018;2018;03;04;Tiistai;0;0;0
622;20.03.2018;2018;03;05;Tiistai;0;0;0
622;20.03.2018;2018;03;06;Tiistai;0;1;1
622;20.03.2018;2018;03;07;Tiistai;0;7;7
622;20.03.2018;2018;03;08;Tiistai;8;7;15
622;20.03.2018;2018;03;09;Tiistai;4;4;8
622;20.03.2018;2018;03;10;Tiistai;4;3;7
622;20.03.2018;2018;03;11;Tiistai;0;2;2
622;20.03.2018;2018;03;12;Tiistai;1;2;3
622;20.03.2018;2018;03;13;Tiistai;6;6;12
622;20.03.2018;2018;03;14;Tiistai;4;4;8
622;20.03.2018;2018;03;15;Tiistai;5;3;8
622;20.03.2018;2018;03;16;Tiistai;6;0;6
622;20.03.2018;2018;03;17;Tiistai;11;9;20
622;20.03.2018;2018;03;18;Tiistai;3;4;7
622;20.03.2018;2018;03;19;Tiistai;3;4;7
622;20.03.2018;2018;03;20;Tiistai;4;1;5
622;20.03.2018;2018;03;21;Tiistai;3;4;7
622;20.03.2018;2018;03;22;Tiistai;2;3;5
622;20.03.2018;2018;03;23;Tiistai;0;1;1
622;21.03.2018;2018;03;00;Keskiviikko;2;0;2
622;21.03.2018;2018;03;01;Keskiviikko;1;0;1
622;21.03.2018;2018;03;02;Keskiviikko;0;0;0
622;21.03.2018;2018;03;03;Keskiviikko;0;0;0
622;21.03.2018;2018;03;04;Keskiviikko;0;1;1
622;21.03.2018;2018;03;05;Keskiviikko;1;1;2
622;21.03.2018;2018;03;06;Keskiviikko;0;0;0
622;21.03.2018;2018;03;07;Keskiviikko;4;5;9
622;21.03.2018;2018;03;08;Keskiviikko;9;5;14
622;21.03.2018;2018;03;09;Keskiviikko;4;10;14
622;21.03.2018;2018;03;10;Keskiviikko;1;5;6
622;21.03.2018;2018;03;11;Keskiviikko;1;2;3
622;21.03.2018;2018;03;12;Keskiviikko;1;2;3
622;21.03.2018;2018;03;13;Keskiviikko;1;1;2
622;21.03.2018;2018;03;14;Keskiviikko;2;3;5
622;21.03.2018;2018;03;15;Keskiviikko;6;4;10
622;21.03.2018;2018;03;16;Keskiviikko;3;1;4
622;21.03.2018;2018;03;17;Keskiviikko;10;4;14
622;21.03.2018;2018;03;18;Keskiviikko;2;2;4
622;21.03.2018;2018;03;19;Keskiviikko;4;3;7
622;21.03.2018;2018;03;20;Keskiviikko;3;6;9
622;21.03.2018;2018;03;21;Keskiviikko;6;3;9
622;21.03.2018;2018;03;22;Keskiviikko;2;4;6
622;21.03.2018;2018;03;23;Keskiviikko;3;0;3
622;22.03.2018;2018;03;00;Torstai;0;0;0
622;22.03.2018;2018;03;01;Torstai;0;0;0
622;22.03.2018;2018;03;02;Torstai;0;0;0
622;22.03.2018;2018;03;03;Torstai;1;0;1
622;22.03.2018;2018;03;04;Torstai;1;0;1
622;22.03.2018;2018;03;05;Torstai;0;0;0
622;22.03.2018;2018;03;06;Torstai;0;2;2
622;22.03.2018;2018;03;07;Torstai;2;5;7
622;22.03.2018;2018;03;08;Torstai;9;8;17
622;22.03.2018;2018;03;09;Torstai;6;9;15
622;22.03.2018;2018;03;10;Torstai;5;4;9
622;22.03.2018;2018;03;11;Torstai;2;4;6
622;22.03.2018;2018;03;12;Torstai;4;1;5
622;22.03.2018;2018;03;13;Torstai;10;8;18
622;22.03.2018;2018;03;14;Torstai;4;6;10
622;22.03.2018;2018;03;15;Torstai;5;2;7
622;22.03.2018;2018;03;16;Torstai;7;6;13
622;22.03.2018;2018;03;17;Torstai;12;8;20
622;22.03.2018;2018;03;18;Torstai;4;4;8
622;22.03.2018;2018;03;19;Torstai;4;2;6
622;22.03.2018;2018;03;20;Torstai;3;1;4
622;22.03.2018;2018;03;21;Torstai;3;3;6
622;22.03.2018;2018;03;22;Torstai;2;1;3
622;22.03.2018;2018;03;23;Torstai;1;1;2
622;23.03.2018;2018;03;00;Perjantai;1;1;2
622;23.03.2018;2018;03;01;Perjantai;0;0;0
622;23.03.2018;2018;03;02;Perjantai;1;1;2
622;23.03.2018;2018;03;03;Perjantai;0;0;0
622;23.03.2018;2018;03;04;Perjantai;0;1;1
622;23.03.2018;2018;03;05;Perjantai;0;0;0
622;23.03.2018;2018;03;06;Perjantai;0;0;0
622;23.03.2018;2018;03;07;Perjantai;0;4;4
622;23.03.2018;2018;03;08;Perjantai;4;8;12
622;23.03.2018;2018;03;09;Perjantai;6;9;15
622;23.03.2018;2018;03;10;Perjantai;3;1;4
622;23.03.2018;2018;03;11;Perjantai;2;3;5
622;23.03.2018;2018;03;12;Perjantai;2;3;5
622;23.03.2018;2018;03;13;Perjantai;2;5;7
622;23.03.2018;2018;03;14;Perjantai;2;5;7
622;23.03.2018;2018;03;15;Perjantai;7;1;8
622;23.03.2018;2018;03;16;Perjantai;7;6;13
622;23.03.2018;2018;03;17;Perjantai;5;2;7
622;23.03.2018;2018;03;18;Perjantai;4;5;9
622;23.03.2018;2018;03;19;Perjantai;6;4;10
622;23.03.2018;2018;03;20;Perjantai;2;4;6
622;23.03.2018;2018;03;21;Perjantai;3;4;7
622;23.03.2018;2018;03;22;Perjantai;2;0;2
622;23.03.2018;2018;03;23;Perjantai;0;0;0
622;24.03.2018;2018;03;00;Lauantai;0;1;1
622;24.03.2018;2018;03;01;Lauantai;1;0;1
622;24.03.2018;2018;03;02;Lauantai;0;0;0
622;24.03.2018;2018;03;03;Lauantai;0;0;0
622;24.03.2018;2018;03;04;Lauantai;1;1;2
622;24.03.2018;2018;03;05;Lauantai;0;0;0
622;24.03.2018;2018;03;06;Lauantai;1;0;1
622;24.03.2018;2018;03;07;Lauantai;0;0;0
622;24.03.2018;2018;03;08;Lauantai;0;0;0
622;24.03.2018;2018;03;09;Lauantai;0;1;1
622;24.03.2018;2018;03;10;Lauantai;0;2;2
622;24.03.2018;2018;03;11;Lauantai;1;4;5
622;24.03.2018;2018;03;12;Lauantai;1;0;1
622;24.03.2018;2018;03;13;Lauantai;2;3;5
622;24.03.2018;2018;03;14;Lauantai;1;3;4
622;24.03.2018;2018;03;15;Lauantai;1;3;4
622;24.03.2018;2018;03;16;Lauantai;3;2;5
622;24.03.2018;2018;03;17;Lauantai;2;2;4
622;24.03.2018;2018;03;18;Lauantai;4;2;6
622;24.03.2018;2018;03;19;Lauantai;2;2;4
622;24.03.2018;2018;03;20;Lauantai;1;4;5
622;24.03.2018;2018;03;21;Lauantai;3;3;6
622;24.03.2018;2018;03;22;Lauantai;0;2;2
622;24.03.2018;2018;03;23;Lauantai;1;0;1
622;25.03.2018;2018;03;00;Sunnuntai;0;1;1
622;25.03.2018;2018;03;01;Sunnuntai;1;1;2
622;25.03.2018;2018;03;02;Sunnuntai;0;1;1
622;25.03.2018;2018;03;03;Sunnuntai;0;0;0
622;25.03.2018;2018;03;04;Sunnuntai;0;0;0
622;25.03.2018;2018;03;05;Sunnuntai;2;5;7
622;25.03.2018;2018;03;06;Sunnuntai;1;1;2
622;25.03.2018;2018;03;07;Sunnuntai;0;1;1
622;25.03.2018;2018;03;08;Sunnuntai;1;1;2
622;25.03.2018;2018;03;09;Sunnuntai;0;1;1
622;25.03.2018;2018;03;10;Sunnuntai;1;1;2
622;25.03.2018;2018;03;11;Sunnuntai;1;2;3
622;25.03.2018;2018;03;12;Sunnuntai;3;3;6
622;25.03.2018;2018;03;13;Sunnuntai;4;4;8
622;25.03.2018;2018;03;14;Sunnuntai;4;3;7
622;25.03.2018;2018;03;15;Sunnuntai;3;4;7
622;25.03.2018;2018;03;16;Sunnuntai;5;6;11
622;25.03.2018;2018;03;17;Sunnuntai;6;2;8
622;25.03.2018;2018;03;18;Sunnuntai;1;2;3
622;25.03.2018;2018;03;19;Sunnuntai;1;2;3
622;25.03.2018;2018;03;20;Sunnuntai;2;3;5
622;25.03.2018;2018;03;21;Sunnuntai;2;1;3
622;25.03.2018;2018;03;22;Sunnuntai;2;1;3
622;25.03.2018;2018;03;23;Sunnuntai;0;0;0
622;26.03.2018;2018;03;00;Maanantai;0;1;1
622;26.03.2018;2018;03;01;Maanantai;0;0;0
622;26.03.2018;2018;03;02;Maanantai;0;0;0
622;26.03.2018;2018;03;03;Maanantai;0;0;0
622;26.03.2018;2018;03;04;Maanantai;0;0;0
622;26.03.2018;2018;03;05;Maanantai;0;1;1
622;26.03.2018;2018;03;06;Maanantai;0;1;1
622;26.03.2018;2018;03;07;Maanantai;0;3;3
622;26.03.2018;2018;03;08;Maanantai;3;8;11
622;26.03.2018;2018;03;09;Maanantai;6;2;8
622;26.03.2018;2018;03;10;Maanantai;1;2;3
622;26.03.2018;2018;03;11;Maanantai;2;5;7
622;26.03.2018;2018;03;12;Maanantai;2;4;6
622;26.03.2018;2018;03;13;Maanantai;2;2;4
622;26.03.2018;2018;03;14;Maanantai;5;6;11
622;26.03.2018;2018;03;15;Maanantai;2;5;7
622;26.03.2018;2018;03;16;Maanantai;9;3;12
622;26.03.2018;2018;03;17;Maanantai;12;5;17
622;26.03.2018;2018;03;18;Maanantai;7;2;9
622;26.03.2018;2018;03;19;Maanantai;2;1;3
622;26.03.2018;2018;03;20;Maanantai;4;4;8
622;26.03.2018;2018;03;21;Maanantai;3;3;6
622;26.03.2018;2018;03;22;Maanantai;1;1;2
622;26.03.2018;2018;03;23;Maanantai;2;1;3
622;27.03.2018;2018;03;00;Tiistai;0;0;0
622;27.03.2018;2018;03;01;Tiistai;0;0;0
622;27.03.2018;2018;03;02;Tiistai;0;0;0
622;27.03.2018;2018;03;03;Tiistai;0;1;1
622;27.03.2018;2018;03;04;Tiistai;0;0;0
622;27.03.2018;2018;03;05;Tiistai;0;0;0
622;27.03.2018;2018;03;06;Tiistai;0;0;0
622;27.03.2018;2018;03;07;Tiistai;0;5;5
622;27.03.2018;2018;03;08;Tiistai;1;6;7
622;27.03.2018;2018;03;09;Tiistai;6;9;15
622;27.03.2018;2018;03;10;Tiistai;1;2;3
622;27.03.2018;2018;03;11;Tiistai;2;4;6
622;27.03.2018;2018;03;12;Tiistai;5;1;6
622;27.03.2018;2018;03;13;Tiistai;1;8;9
622;27.03.2018;2018;03;14;Tiistai;4;2;6
622;27.03.2018;2018;03;15;Tiistai;4;2;6
622;27.03.2018;2018;03;16;Tiistai;8;3;11
622;27.03.2018;2018;03;17;Tiistai;9;7;16
622;27.03.2018;2018;03;18;Tiistai;4;2;6
622;27.03.2018;2018;03;19;Tiistai;4;2;6
622;27.03.2018;2018;03;20;Tiistai;3;4;7
622;27.03.2018;2018;03;21;Tiistai;3;4;7
622;27.03.2018;2018;03;22;Tiistai;0;0;0
622;27.03.2018;2018;03;23;Tiistai;2;0;2
622;28.03.2018;2018;03;00;Keskiviikko;0;0;0
622;28.03.2018;2018;03;01;Keskiviikko;0;1;1
622;28.03.2018;2018;03;02;Keskiviikko;0;0;0
622;28.03.2018;2018;03;03;Keskiviikko;0;0;0
622;28.03.2018;2018;03;04;Keskiviikko;0;0;0
622;28.03.2018;2018;03;05;Keskiviikko;0;0;0
622;28.03.2018;2018;03;06;Keskiviikko;0;1;1
622;28.03.2018;2018;03;07;Keskiviikko;1;7;8
622;28.03.2018;2018;03;08;Keskiviikko;6;9;15
622;28.03.2018;2018;03;09;Keskiviikko;2;8;10
622;28.03.2018;2018;03;10;Keskiviikko;2;7;9
622;28.03.2018;2018;03;11;Keskiviikko;4;6;10
622;28.03.2018;2018;03;12;Keskiviikko;3;6;9
622;28.03.2018;2018;03;13;Keskiviikko;4;4;8
622;28.03.2018;2018;03;14;Keskiviikko;3;6;9
622;28.03.2018;2018;03;15;Keskiviikko;1;4;5
622;28.03.2018;2018;03;16;Keskiviikko;6;2;8
622;28.03.2018;2018;03;17;Keskiviikko;8;8;16
622;28.03.2018;2018;03;18;Keskiviikko;2;8;10
622;28.03.2018;2018;03;19;Keskiviikko;6;1;7
622;28.03.2018;2018;03;20;Keskiviikko;2;2;4
622;28.03.2018;2018;03;21;Keskiviikko;6;4;10
622;28.03.2018;2018;03;22;Keskiviikko;0;2;2
622;28.03.2018;2018;03;23;Keskiviikko;2;1;3
622;29.03.2018;2018;03;00;Torstai;0;0;0
622;29.03.2018;2018;03;01;Torstai;2;0;2
622;29.03.2018;2018;03;02;Torstai;1;0;1
622;29.03.2018;2018;03;03;Torstai;1;0;1
622;29.03.2018;2018;03;04;Torstai;0;0;0
622;29.03.2018;2018;03;05;Torstai;4;2;6
622;29.03.2018;2018;03;06;Torstai;0;0;0
622;29.03.2018;2018;03;07;Torstai;4;5;9
622;29.03.2018;2018;03;08;Torstai;2;3;5
622;29.03.2018;2018;03;09;Torstai;2;4;6
622;29.03.2018;2018;03;10;Torstai;1;0;1
622;29.03.2018;2018;03;11;Torstai;2;2;4
622;29.03.2018;2018;03;12;Torstai;3;5;8
622;29.03.2018;2018;03;13;Torstai;3;3;6
622;29.03.2018;2018;03;14;Torstai;3;2;5
622;29.03.2018;2018;03;15;Torstai;2;1;3
622;29.03.2018;2018;03;16;Torstai;2;4;6
622;29.03.2018;2018;03;17;Torstai;6;4;10
622;29.03.2018;2018;03;18;Torstai;5;1;6
622;29.03.2018;2018;03;19;Torstai;4;4;8
622;29.03.2018;2018;03;20;Torstai;2;4;6
622;29.03.2018;2018;03;21;Torstai;4;1;5
622;29.03.2018;2018;03;22;Torstai;1;2;3
622;29.03.2018;2018;03;23;Torstai;1;0;1
622;30.03.2018;2018;03;00;Perjantai;0;0;0
622;30.03.2018;2018;03;01;Perjantai;1;0;1
622;30.03.2018;2018;03;02;Perjantai;0;0;0
622;30.03.2018;2018;03;03;Perjantai;0;0;0
622;30.03.2018;2018;03;04;Perjantai;0;0;0
622;30.03.2018;2018;03;05;Perjantai;0;0;0
622;30.03.2018;2018;03;06;Perjantai;0;0;0
622;30.03.2018;2018;03;07;Perjantai;0;1;1
622;30.03.2018;2018;03;08;Perjantai;0;0;0
622;30.03.2018;2018;03;09;Perjantai;1;1;2
622;30.03.2018;2018;03;10;Perjantai;2;1;3
622;30.03.2018;2018;03;11;Perjantai;1;2;3
622;30.03.2018;2018;03;12;Perjantai;0;4;4
622;30.03.2018;2018;03;13;Perjantai;5;4;9
622;30.03.2018;2018;03;14;Perjantai;2;6;8
622;30.03.2018;2018;03;15;Perjantai;2;2;4
622;30.03.2018;2018;03;16;Perjantai;1;4;5
622;30.03.2018;2018;03;17;Perjantai;0;4;4
622;30.03.2018;2018;03;18;Perjantai;5;1;6
622;30.03.2018;2018;03;19;Perjantai;0;2;2
622;30.03.2018;2018;03;20;Perjantai;1;3;4
622;30.03.2018;2018;03;21;Perjantai;1;1;2
622;30.03.2018;2018;03;22;Perjantai;2;0;2
622;30.03.2018;2018;03;23;Perjantai;1;1;2
622;31.03.2018;2018;03;00;Lauantai;1;0;1
622;31.03.2018;2018;03;01;Lauantai;1;4;5
622;31.03.2018;2018;03;02;Lauantai;1;0;1
622;31.03.2018;2018;03;03;Lauantai;2;1;3
622;31.03.2018;2018;03;04;Lauantai;0;0;0
622;31.03.2018;2018;03;05;Lauantai;1;0;1
622;31.03.2018;2018;03;06;Lauantai;0;0;0
622;31.03.2018;2018;03;07;Lauantai;1;0;1
622;31.03.2018;2018;03;08;Lauantai;1;2;3
622;31.03.2018;2018;03;09;Lauantai;0;0;0
622;31.03.2018;2018;03;10;Lauantai;0;2;2
622;31.03.2018;2018;03;11;Lauantai;2;3;5
622;31.03.2018;2018;03;12;Lauantai;3;4;7
622;31.03.2018;2018;03;13;Lauantai;1;3;4
622;31.03.2018;2018;03;14;Lauantai;3;5;8
622;31.03.2018;2018;03;15;Lauantai;2;5;7
622;31.03.2018;2018;03;16;Lauantai;6;2;8
622;31.03.2018;2018;03;17;Lauantai;9;5;14
622;31.03.2018;2018;03;18;Lauantai;3;1;4
622;31.03.2018;2018;03;19;Lauantai;2;4;6
622;31.03.2018;2018;03;20;Lauantai;4;1;5
622;31.03.2018;2018;03;21;Lauantai;1;0;1
622;31.03.2018;2018;03;22;Lauantai;1;1;2
622;31.03.2018;2018;03;23;Lauantai;2;2;4
622;01.04.2018;2018;04;00;Sunnuntai;0;0;0
622;01.04.2018;2018;04;01;Sunnuntai;0;1;1
622;01.04.2018;2018;04;02;Sunnuntai;0;0;0
622;01.04.2018;2018;04;03;Sunnuntai;0;0;0
622;01.04.2018;2018;04;04;Sunnuntai;0;0;0
622;01.04.2018;2018;04;05;Sunnuntai;0;0;0
622;01.04.2018;2018;04;06;Sunnuntai;1;2;3
622;01.04.2018;2018;04;07;Sunnuntai;0;1;1
622;01.04.2018;2018;04;08;Sunnuntai;0;0;0
622;01.04.2018;2018;04;09;Sunnuntai;0;2;2
622;01.04.2018;2018;04;10;Sunnuntai;0;1;1
622;01.04.2018;2018;04;11;Sunnuntai;0;0;0
622;01.04.2018;2018;04;12;Sunnuntai;4;4;8
622;01.04.2018;2018;04;13;Sunnuntai;4;6;10
622;01.04.2018;2018;04;14;Sunnuntai;6;3;9
622;01.04.2018;2018;04;15;Sunnuntai;4;4;8
622;01.04.2018;2018;04;16;Sunnuntai;5;5;10
622;01.04.2018;2018;04;17;Sunnuntai;3;2;5
622;01.04.2018;2018;04;18;Sunnuntai;1;1;2
622;01.04.2018;2018;04;19;Sunnuntai;1;3;4
622;01.04.2018;2018;04;20;Sunnuntai;1;1;2
622;01.04.2018;2018;04;21;Sunnuntai;3;2;5
622;01.04.2018;2018;04;22;Sunnuntai;0;1;1
622;01.04.2018;2018;04;23;Sunnuntai;0;0;0
622;02.04.2018;2018;04;00;Maanantai;3;1;4
622;02.04.2018;2018;04;01;Maanantai;0;0;0
622;02.04.2018;2018;04;02;Maanantai;1;0;1
622;02.04.2018;2018;04;03;Maanantai;0;0;0
622;02.04.2018;2018;04;04;Maanantai;0;0;0
622;02.04.2018;2018;04;05;Maanantai;0;0;0
622;02.04.2018;2018;04;06;Maanantai;0;0;0
622;02.04.2018;2018;04;07;Maanantai;0;2;2
622;02.04.2018;2018;04;08;Maanantai;0;0;0
622;02.04.2018;2018;04;09;Maanantai;0;2;2
622;02.04.2018;2018;04;10;Maanantai;0;0;0
622;02.04.2018;2018;04;11;Maanantai;3;5;8
622;02.04.2018;2018;04;12;Maanantai;1;5;6
622;02.04.2018;2018;04;13;Maanantai;5;2;7
622;02.04.2018;2018;04;14;Maanantai;3;3;6
622;02.04.2018;2018;04;15;Maanantai;1;8;9
622;02.04.2018;2018;04;16;Maanantai;2;3;5
622;02.04.2018;2018;04;17;Maanantai;4;6;10
622;02.04.2018;2018;04;18;Maanantai;0;1;1
622;02.04.2018;2018;04;19;Maanantai;2;0;2
622;02.04.2018;2018;04;20;Maanantai;1;1;2
622;02.04.2018;2018;04;21;Maanantai;0;6;6
622;02.04.2018;2018;04;22;Maanantai;2;2;4
622;02.04.2018;2018;04;23;Maanantai;2;1;3
622;03.04.2018;2018;04;00;Tiistai;1;0;1
622;03.04.2018;2018;04;01;Tiistai;1;0;1
622;03.04.2018;2018;04;02;Tiistai;0;1;1
622;03.04.2018;2018;04;03;Tiistai;0;0;0
622;03.04.2018;2018;04;04;Tiistai;0;0;0
622;03.04.2018;2018;04;05;Tiistai;0;1;1
622;03.04.2018;2018;04;06;Tiistai;1;2;3
622;03.04.2018;2018;04;07;Tiistai;1;9;10
622;03.04.2018;2018;04;08;Tiistai;5;13;18
622;03.04.2018;2018;04;09;Tiistai;6;8;14
622;03.04.2018;2018;04;10;Tiistai;4;9;13
622;03.04.2018;2018;04;11;Tiistai;1;0;1
622;03.04.2018;2018;04;12;Tiistai;3;2;5
622;03.04.2018;2018;04;13;Tiistai;2;5;7
622;03.04.2018;2018;04;14;Tiistai;2;4;6
622;03.04.2018;2018;04;15;Tiistai;3;6;9
622;03.04.2018;2018;04;16;Tiistai;2;5;7
622;03.04.2018;2018;04;17;Tiistai;6;10;16
622;03.04.2018;2018;04;18;Tiistai;5;5;10
622;03.04.2018;2018;04;19;Tiistai;5;5;10
622;03.04.2018;2018;04;20;Tiistai;2;3;5
622;03.04.2018;2018;04;21;Tiistai;2;4;6
622;03.04.2018;2018;04;22;Tiistai;5;2;7
622;03.04.2018;2018;04;23;Tiistai;1;3;4
622;04.04.2018;2018;04;00;Keskiviikko;0;3;3
622;04.04.2018;2018;04;01;Keskiviikko;0;0;0
622;04.04.2018;2018;04;02;Keskiviikko;0;0;0
622;04.04.2018;2018;04;03;Keskiviikko;0;0;0
622;04.04.2018;2018;04;04;Keskiviikko;0;0;0
622;04.04.2018;2018;04;05;Keskiviikko;0;1;1
622;04.04.2018;2018;04;06;Keskiviikko;0;2;2
622;04.04.2018;2018;04;07;Keskiviikko;0;8;8
622;04.04.2018;2018;04;08;Keskiviikko;7;10;17
622;04.04.2018;2018;04;09;Keskiviikko;5;13;18
622;04.04.2018;2018;04;10;Keskiviikko;6;6;12
622;04.04.2018;2018;04;11;Keskiviikko;2;9;11
622;04.04.2018;2018;04;12;Keskiviikko;1;4;5
622;04.04.2018;2018;04;13;Keskiviikko;9;11;20
622;04.04.2018;2018;04;14;Keskiviikko;8;12;20
622;04.04.2018;2018;04;15;Keskiviikko;3;9;12
622;04.04.2018;2018;04;16;Keskiviikko;5;4;9
622;04.04.2018;2018;04;17;Keskiviikko;13;4;17
622;04.04.2018;2018;04;18;Keskiviikko;6;7;13
622;04.04.2018;2018;04;19;Keskiviikko;6;3;9
622;04.04.2018;2018;04;20;Keskiviikko;3;7;10
622;04.04.2018;2018;04;21;Keskiviikko;8;2;10
622;04.04.2018;2018;04;22;Keskiviikko;2;2;4
622;04.04.2018;2018;04;23;Keskiviikko;1;2;3
622;05.04.2018;2018;04;00;Torstai;1;0;1
622;05.04.2018;2018;04;01;Torstai;0;1;1
622;05.04.2018;2018;04;02;Torstai;0;0;0
622;05.04.2018;2018;04;03;Torstai;0;0;0
622;05.04.2018;2018;04;04;Torstai;1;0;1
622;05.04.2018;2018;04;05;Torstai;2;0;2
622;05.04.2018;2018;04;06;Torstai;2;5;7
622;05.04.2018;2018;04;07;Torstai;1;6;7
622;05.04.2018;2018;04;08;Torstai;2;15;17
622;05.04.2018;2018;04;09;Torstai;4;3;7
622;05.04.2018;2018;04;10;Torstai;3;6;9
622;05.04.2018;2018;04;11;Torstai;6;6;12
622;05.04.2018;2018;04;12;Torstai;4;3;7
622;05.04.2018;2018;04;13;Torstai;3;6;9
622;05.04.2018;2018;04;14;Torstai;4;6;10
622;05.04.2018;2018;04;15;Torstai;1;4;5
622;05.04.2018;2018;04;16;Torstai;4;9;13
622;05.04.2018;2018;04;17;Torstai;18;9;27
622;05.04.2018;2018;04;18;Torstai;11;5;16
622;05.04.2018;2018;04;19;Torstai;9;9;18
622;05.04.2018;2018;04;20;Torstai;2;3;5
622;05.04.2018;2018;04;21;Torstai;4;10;14
622;05.04.2018;2018;04;22;Torstai;1;2;3
622;05.04.2018;2018;04;23;Torstai;0;0;0
622;06.04.2018;2018;04;00;Perjantai;0;1;1
622;06.04.2018;2018;04;01;Perjantai;0;2;2
622;06.04.2018;2018;04;02;Perjantai;1;0;1
622;06.04.2018;2018;04;03;Perjantai;0;0;0
622;06.04.2018;2018;04;04;Perjantai;0;0;0
622;06.04.2018;2018;04;05;Perjantai;0;0;0
622;06.04.2018;2018;04;06;Perjantai;0;1;1
622;06.04.2018;2018;04;07;Perjantai;1;7;8
622;06.04.2018;2018;04;08;Perjantai;6;10;16
622;06.04.2018;2018;04;09;Perjantai;1;9;10
622;06.04.2018;2018;04;10;Perjantai;1;5;6
622;06.04.2018;2018;04;11;Perjantai;0;6;6
622;06.04.2018;2018;04;12;Perjantai;2;4;6
622;06.04.2018;2018;04;13;Perjantai;3;2;5
622;06.04.2018;2018;04;14;Perjantai;3;6;9
622;06.04.2018;2018;04;15;Perjantai;4;4;8
622;06.04.2018;2018;04;16;Perjantai;9;7;16
622;06.04.2018;2018;04;17;Perjantai;9;7;16
622;06.04.2018;2018;04;18;Perjantai;8;4;12
622;06.04.2018;2018;04;19;Perjantai;7;2;9
622;06.04.2018;2018;04;20;Perjantai;4;4;8
622;06.04.2018;2018;04;21;Perjantai;4;5;9
622;06.04.2018;2018;04;22;Perjantai;1;1;2
622;06.04.2018;2018;04;23;Perjantai;3;1;4
622;07.04.2018;2018;04;00;Lauantai;0;0;0
622;07.04.2018;2018;04;01;Lauantai;0;1;1
622;07.04.2018;2018;04;02;Lauantai;1;0;1
622;07.04.2018;2018;04;03;Lauantai;0;1;1
622;07.04.2018;2018;04;04;Lauantai;0;0;0
622;07.04.2018;2018;04;05;Lauantai;0;0;0
622;07.04.2018;2018;04;06;Lauantai;0;0;0
622;07.04.2018;2018;04;07;Lauantai;3;3;6
622;07.04.2018;2018;04;08;Lauantai;1;1;2
622;07.04.2018;2018;04;09;Lauantai;2;1;3
622;07.04.2018;2018;04;10;Lauantai;3;3;6
622;07.04.2018;2018;04;11;Lauantai;4;5;9
622;07.04.2018;2018;04;12;Lauantai;2;4;6
622;07.04.2018;2018;04;13;Lauantai;7;6;13
622;07.04.2018;2018;04;14;Lauantai;7;7;14
622;07.04.2018;2018;04;15;Lauantai;14;12;26
622;07.04.2018;2018;04;16;Lauantai;5;7;12
622;07.04.2018;2018;04;17;Lauantai;12;2;14
622;07.04.2018;2018;04;18;Lauantai;4;6;10
622;07.04.2018;2018;04;19;Lauantai;11;5;16
622;07.04.2018;2018;04;20;Lauantai;6;1;7
622;07.04.2018;2018;04;21;Lauantai;7;5;12
622;07.04.2018;2018;04;22;Lauantai;7;2;9
622;07.04.2018;2018;04;23;Lauantai;1;0;1
622;08.04.2018;2018;04;00;Sunnuntai;2;2;4
622;08.04.2018;2018;04;01;Sunnuntai;1;1;2
622;08.04.2018;2018;04;02;Sunnuntai;1;0;1
622;08.04.2018;2018;04;03;Sunnuntai;0;0;0
622;08.04.2018;2018;04;04;Sunnuntai;0;0;0
622;08.04.2018;2018;04;05;Sunnuntai;0;1;1
622;08.04.2018;2018;04;06;Sunnuntai;0;3;3
622;08.04.2018;2018;04;07;Sunnuntai;0;5;5
622;08.04.2018;2018;04;08;Sunnuntai;1;1;2
622;08.04.2018;2018;04;09;Sunnuntai;1;1;2
622;08.04.2018;2018;04;10;Sunnuntai;2;3;5
622;08.04.2018;2018;04;11;Sunnuntai;0;4;4
622;08.04.2018;2018;04;12;Sunnuntai;9;6;15
622;08.04.2018;2018;04;13;Sunnuntai;7;17;24
622;08.04.2018;2018;04;14;Sunnuntai;8;11;19
622;08.04.2018;2018;04;15;Sunnuntai;12;10;22
622;08.04.2018;2018;04;16;Sunnuntai;13;9;22
622;08.04.2018;2018;04;17;Sunnuntai;9;14;23
622;08.04.2018;2018;04;18;Sunnuntai;11;10;21
622;08.04.2018;2018;04;19;Sunnuntai;2;5;7
622;08.04.2018;2018;04;20;Sunnuntai;20;10;30
622;08.04.2018;2018;04;21;Sunnuntai;5;6;11
622;08.04.2018;2018;04;22;Sunnuntai;3;4;7
622;08.04.2018;2018;04;23;Sunnuntai;3;3;6
622;09.04.2018;2018;04;00;Maanantai;1;0;1
622;09.04.2018;2018;04;01;Maanantai;3;2;5
622;09.04.2018;2018;04;02;Maanantai;1;0;1
622;09.04.2018;2018;04;03;Maanantai;0;0;0
622;09.04.2018;2018;04;04;Maanantai;2;1;3
622;09.04.2018;2018;04;05;Maanantai;3;1;4
622;09.04.2018;2018;04;06;Maanantai;0;7;7
622;09.04.2018;2018;04;07;Maanantai;2;15;17
622;09.04.2018;2018;04;08;Maanantai;28;31;59
622;09.04.2018;2018;04;09;Maanantai;22;22;44
622;09.04.2018;2018;04;10;Maanantai;10;14;24
622;09.04.2018;2018;04;11;Maanantai;8;6;14
622;09.04.2018;2018;04;12;Maanantai;6;9;15
622;09.04.2018;2018;04;13;Maanantai;11;18;29
622;09.04.2018;2018;04;14;Maanantai;8;10;18
622;09.04.2018;2018;04;15;Maanantai;19;21;40
622;09.04.2018;2018;04;16;Maanantai;33;21;54
622;09.04.2018;2018;04;17;Maanantai;43;21;64
622;09.04.2018;2018;04;18;Maanantai;23;22;45
622;09.04.2018;2018;04;19;Maanantai;19;15;34
622;09.04.2018;2018;04;20;Maanantai;12;13;25
622;09.04.2018;2018;04;21;Maanantai;10;7;17
622;09.04.2018;2018;04;22;Maanantai;6;5;11
622;09.04.2018;2018;04;23;Maanantai;8;2;10
622;10.04.2018;2018;04;00;Tiistai;2;1;3
622;10.04.2018;2018;04;01;Tiistai;0;2;2
622;10.04.2018;2018;04;02;Tiistai;0;0;0
622;10.04.2018;2018;04;03;Tiistai;0;0;0
622;10.04.2018;2018;04;04;Tiistai;1;1;2
622;10.04.2018;2018;04;05;Tiistai;0;0;0
622;10.04.2018;2018;04;06;Tiistai;1;5;6
622;10.04.2018;2018;04;07;Tiistai;4;12;16
622;10.04.2018;2018;04;08;Tiistai;14;27;41
622;10.04.2018;2018;04;09;Tiistai;20;25;45
622;10.04.2018;2018;04;10;Tiistai;12;15;27
622;10.04.2018;2018;04;11;Tiistai;6;14;20
622;10.04.2018;2018;04;12;Tiistai;8;10;18
622;10.04.2018;2018;04;13;Tiistai;18;12;30
622;10.04.2018;2018;04;14;Tiistai;14;13;27
622;10.04.2018;2018;04;15;Tiistai;17;24;41
622;10.04.2018;2018;04;16;Tiistai;31;20;51
622;10.04.2018;2018;04;17;Tiistai;25;30;55
622;10.04.2018;2018;04;18;Tiistai;28;16;44
622;10.04.2018;2018;04;19;Tiistai;19;17;36
622;10.04.2018;2018;04;20;Tiistai;20;9;29
622;10.04.2018;2018;04;21;Tiistai;10;9;19
622;10.04.2018;2018;04;22;Tiistai;10;9;19
622;10.04.2018;2018;04;23;Tiistai;6;6;12
622;11.04.2018;2018;04;00;Keskiviikko;4;0;4
622;11.04.2018;2018;04;01;Keskiviikko;1;1;2
622;11.04.2018;2018;04;02;Keskiviikko;0;1;1
622;11.04.2018;2018;04;03;Keskiviikko;0;0;0
622;11.04.2018;2018;04;04;Keskiviikko;0;0;0
622;11.04.2018;2018;04;05;Keskiviikko;1;0;1
622;11.04.2018;2018;04;06;Keskiviikko;1;6;7
622;11.04.2018;2018;04;07;Keskiviikko;4;18;22
622;11.04.2018;2018;04;08;Keskiviikko;31;38;69
622;11.04.2018;2018;04;09;Keskiviikko;25;34;59
622;11.04.2018;2018;04;10;Keskiviikko;0;1;1
622;11.04.2018;2018;04;11;Keskiviikko;0;0;0
622;11.04.2018;2018;04;12;Keskiviikko;0;0;0
622;11.04.2018;2018;04;13;Keskiviikko;0;0;0
622;11.04.2018;2018;04;14;Keskiviikko;0;0;0
622;11.04.2018;2018;04;15;Keskiviikko;22;19;41
622;11.04.2018;2018;04;16;Keskiviikko;41;24;65
622;11.04.2018;2018;04;17;Keskiviikko;52;34;86
622;11.04.2018;2018;04;18;Keskiviikko;36;31;67
622;11.04.2018;2018;04;19;Keskiviikko;23;18;41
622;11.04.2018;2018;04;20;Keskiviikko;21;11;32
622;11.04.2018;2018;04;21;Keskiviikko;13;11;24
622;11.04.2018;2018;04;22;Keskiviikko;14;8;22
622;11.04.2018;2018;04;23;Keskiviikko;4;0;4
622;12.04.2018;2018;04;00;Torstai;6;8;14
622;12.04.2018;2018;04;01;Torstai;1;0;1
622;12.04.2018;2018;04;02;Torstai;1;2;3
622;12.04.2018;2018;04;03;Torstai;0;0;0
622;12.04.2018;2018;04;04;Torstai;1;0;1
622;12.04.2018;2018;04;05;Torstai;1;0;1
622;12.04.2018;2018;04;06;Torstai;4;4;8
622;12.04.2018;2018;04;07;Torstai;4;23;27
622;12.04.2018;2018;04;08;Torstai;34;33;67
622;12.04.2018;2018;04;09;Torstai;29;34;63
622;12.04.2018;2018;04;10;Torstai;9;17;26
622;12.04.2018;2018;04;11;Torstai;10;10;20
622;12.04.2018;2018;04;12;Torstai;20;25;45
622;12.04.2018;2018;04;13;Torstai;9;15;24
622;12.04.2018;2018;04;14;Torstai;12;21;33
622;12.04.2018;2018;04;15;Torstai;18;19;37
622;12.04.2018;2018;04;16;Torstai;45;12;57
622;12.04.2018;2018;04;17;Torstai;38;29;67
622;12.04.2018;2018;04;18;Torstai;31;27;58
622;12.04.2018;2018;04;19;Torstai;23;20;43
622;12.04.2018;2018;04;20;Torstai;16;13;29
622;12.04.2018;2018;04;21;Torstai;14;8;22
622;12.04.2018;2018;04;22;Torstai;14;8;22
622;12.04.2018;2018;04;23;Torstai;7;2;9
622;13.04.2018;2018;04;00;Perjantai;6;3;9
622;13.04.2018;2018;04;01;Perjantai;5;0;5
622;13.04.2018;2018;04;02;Perjantai;1;1;2
622;13.04.2018;2018;04;03;Perjantai;2;1;3
622;13.04.2018;2018;04;04;Perjantai;0;0;0
622;13.04.2018;2018;04;05;Perjantai;1;0;1
622;13.04.2018;2018;04;06;Perjantai;2;6;8
622;13.04.2018;2018;04;07;Perjantai;2;13;15
622;13.04.2018;2018;04;08;Perjantai;23;29;52
622;13.04.2018;2018;04;09;Perjantai;23;20;43
622;13.04.2018;2018;04;10;Perjantai;11;10;21
622;13.04.2018;2018;04;11;Perjantai;10;18;28
622;13.04.2018;2018;04;12;Perjantai;9;27;36
622;13.04.2018;2018;04;13;Perjantai;20;23;43
622;13.04.2018;2018;04;14;Perjantai;14;15;29
622;13.04.2018;2018;04;15;Perjantai;35;18;53
622;13.04.2018;2018;04;16;Perjantai;31;22;53
622;13.04.2018;2018;04;17;Perjantai;37;27;64
622;13.04.2018;2018;04;18;Perjantai;27;25;52
622;13.04.2018;2018;04;19;Perjantai;25;34;59
622;13.04.2018;2018;04;20;Perjantai;21;13;34
622;13.04.2018;2018;04;21;Perjantai;8;13;21
622;13.04.2018;2018;04;22;Perjantai;9;5;14
622;13.04.2018;2018;04;23;Perjantai;13;6;19
622;14.04.2018;2018;04;00;Lauantai;5;4;9
622;14.04.2018;2018;04;01;Lauantai;2;2;4
622;14.04.2018;2018;04;02;Lauantai;2;0;2
622;14.04.2018;2018;04;03;Lauantai;3;0;3
622;14.04.2018;2018;04;04;Lauantai;1;0;1
622;14.04.2018;2018;04;05;Lauantai;3;1;4
622;14.04.2018;2018;04;06;Lauantai;4;7;11
622;14.04.2018;2018;04;07;Lauantai;3;3;6
622;14.04.2018;2018;04;08;Lauantai;4;3;7
622;14.04.2018;2018;04;09;Lauantai;6;5;11
622;14.04.2018;2018;04;10;Lauantai;8;16;24
622;14.04.2018;2018;04;11;Lauantai;17;14;31
622;14.04.2018;2018;04;12;Lauantai;22;27;49
622;14.04.2018;2018;04;13;Lauantai;32;25;57
622;14.04.2018;2018;04;14;Lauantai;31;23;54
622;14.04.2018;2018;04;15;Lauantai;20;29;49
622;14.04.2018;2018;04;16;Lauantai;27;33;60
622;14.04.2018;2018;04;17;Lauantai;16;11;27
622;14.04.2018;2018;04;18;Lauantai;14;10;24
622;14.04.2018;2018;04;19;Lauantai;16;5;21
622;14.04.2018;2018;04;20;Lauantai;15;11;26
622;14.04.2018;2018;04;21;Lauantai;7;8;15
622;14.04.2018;2018;04;22;Lauantai;10;2;12
622;14.04.2018;2018;04;23;Lauantai;7;1;8
622;15.04.2018;2018;04;00;Sunnuntai;7;5;12
622;15.04.2018;2018;04;01;Sunnuntai;6;1;7
622;15.04.2018;2018;04;02;Sunnuntai;4;1;5
622;15.04.2018;2018;04;03;Sunnuntai;1;1;2
622;15.04.2018;2018;04;04;Sunnuntai;1;0;1
622;15.04.2018;2018;04;05;Sunnuntai;2;3;5
622;15.04.2018;2018;04;06;Sunnuntai;2;0;2
622;15.04.2018;2018;04;07;Sunnuntai;3;1;4
622;15.04.2018;2018;04;08;Sunnuntai;2;2;4
622;15.04.2018;2018;04;09;Sunnuntai;3;3;6
622;15.04.2018;2018;04;10;Sunnuntai;3;12;15
622;15.04.2018;2018;04;11;Sunnuntai;5;15;20
622;15.04.2018;2018;04;12;Sunnuntai;23;26;49
622;15.04.2018;2018;04;13;Sunnuntai;29;32;61
622;15.04.2018;2018;04;14;Sunnuntai;37;29;66
622;15.04.2018;2018;04;15;Sunnuntai;30;21;51
622;15.04.2018;2018;04;16;Sunnuntai;38;21;59
622;15.04.2018;2018;04;17;Sunnuntai;27;32;59
622;15.04.2018;2018;04;18;Sunnuntai;31;32;63
622;15.04.2018;2018;04;19;Sunnuntai;24;13;37
622;15.04.2018;2018;04;20;Sunnuntai;22;17;39
622;15.04.2018;2018;04;21;Sunnuntai;18;15;33
622;15.04.2018;2018;04;22;Sunnuntai;7;1;8
622;15.04.2018;2018;04;23;Sunnuntai;5;1;6
622;16.04.2018;2018;04;00;Maanantai;3;2;5
622;16.04.2018;2018;04;01;Maanantai;0;0;0
622;16.04.2018;2018;04;02;Maanantai;1;0;1
622;16.04.2018;2018;04;03;Maanantai;1;1;2
622;16.04.2018;2018;04;04;Maanantai;0;0;0
622;16.04.2018;2018;04;05;Maanantai;1;2;3
622;16.04.2018;2018;04;06;Maanantai;3;7;10
622;16.04.2018;2018;04;07;Maanantai;4;31;35
622;16.04.2018;2018;04;08;Maanantai;27;49;76
622;16.04.2018;2018;04;09;Maanantai;34;41;75
622;16.04.2018;2018;04;10;Maanantai;13;24;37
622;16.04.2018;2018;04;11;Maanantai;15;30;45
622;16.04.2018;2018;04;12;Maanantai;14;18;32
622;16.04.2018;2018;04;13;Maanantai;32;32;64
622;16.04.2018;2018;04;14;Maanantai;31;33;64
622;16.04.2018;2018;04;15;Maanantai;55;41;96
622;16.04.2018;2018;04;16;Maanantai;54;31;85
622;16.04.2018;2018;04;17;Maanantai;77;48;125
622;16.04.2018;2018;04;18;Maanantai;34;35;69
622;16.04.2018;2018;04;19;Maanantai;33;28;61
622;16.04.2018;2018;04;20;Maanantai;22;15;37
622;16.04.2018;2018;04;21;Maanantai;15;8;23
622;16.04.2018;2018;04;22;Maanantai;12;4;16
622;16.04.2018;2018;04;23;Maanantai;11;3;14
622;17.04.2018;2018;04;00;Tiistai;5;4;9
622;17.04.2018;2018;04;01;Tiistai;2;0;2
622;17.04.2018;2018;04;02;Tiistai;0;0;0
622;17.04.2018;2018;04;03;Tiistai;1;0;1
622;17.04.2018;2018;04;04;Tiistai;0;0;0
622;17.04.2018;2018;04;05;Tiistai;1;1;2
622;17.04.2018;2018;04;06;Tiistai;1;7;8
622;17.04.2018;2018;04;07;Tiistai;7;29;36
622;17.04.2018;2018;04;08;Tiistai;32;66;98
622;17.04.2018;2018;04;09;Tiistai;36;40;76
622;17.04.2018;2018;04;10;Tiistai;15;32;47
622;17.04.2018;2018;04;11;Tiistai;18;15;33
622;17.04.2018;2018;04;12;Tiistai;12;18;30
622;17.04.2018;2018;04;13;Tiistai;23;34;57
622;17.04.2018;2018;04;14;Tiistai;30;31;61
622;17.04.2018;2018;04;15;Tiistai;37;31;68
622;17.04.2018;2018;04;16;Tiistai;65;38;103
622;17.04.2018;2018;04;17;Tiistai;81;39;120
622;17.04.2018;2018;04;18;Tiistai;40;33;73
622;17.04.2018;2018;04;19;Tiistai;47;30;77
622;17.04.2018;2018;04;20;Tiistai;29;14;43
622;17.04.2018;2018;04;21;Tiistai;19;11;30
622;17.04.2018;2018;04;22;Tiistai;22;7;29
622;17.04.2018;2018;04;23;Tiistai;7;4;11
622;18.04.2018;2018;04;00;Keskiviikko;5;3;8
622;18.04.2018;2018;04;01;Keskiviikko;0;0;0
622;18.04.2018;2018;04;02;Keskiviikko;1;1;2
622;18.04.2018;2018;04;03;Keskiviikko;1;0;1
622;18.04.2018;2018;04;04;Keskiviikko;0;0;0
622;18.04.2018;2018;04;05;Keskiviikko;0;1;1
622;18.04.2018;2018;04;06;Keskiviikko;1;11;12
622;18.04.2018;2018;04;07;Keskiviikko;8;31;39
622;18.04.2018;2018;04;08;Keskiviikko;58;42;100
622;18.04.2018;2018;04;09;Keskiviikko;48;44;92
622;18.04.2018;2018;04;10;Keskiviikko;12;21;33
622;18.04.2018;2018;04;11;Keskiviikko;17;13;30
622;18.04.2018;2018;04;12;Keskiviikko;24;28;52
622;18.04.2018;2018;04;13;Keskiviikko;19;23;42
622;18.04.2018;2018;04;14;Keskiviikko;35;26;61
622;18.04.2018;2018;04;15;Keskiviikko;49;27;76
622;18.04.2018;2018;04;16;Keskiviikko;62;30;92
622;18.04.2018;2018;04;17;Keskiviikko;65;26;91
622;18.04.2018;2018;04;18;Keskiviikko;52;50;102
622;18.04.2018;2018;04;19;Keskiviikko;43;32;75
622;18.04.2018;2018;04;20;Keskiviikko;33;18;51
622;18.04.2018;2018;04;21;Keskiviikko;22;29;51
622;18.04.2018;2018;04;22;Keskiviikko;12;3;15
622;18.04.2018;2018;04;23;Keskiviikko;9;4;13
622;19.04.2018;2018;04;00;Torstai;3;2;5
622;19.04.2018;2018;04;01;Torstai;2;2;4
622;19.04.2018;2018;04;02;Torstai;1;2;3
622;19.04.2018;2018;04;03;Torstai;3;0;3
622;19.04.2018;2018;04;04;Torstai;0;0;0
622;19.04.2018;2018;04;05;Torstai;1;1;2
622;19.04.2018;2018;04;06;Torstai;3;14;17
622;19.04.2018;2018;04;07;Torstai;9;35;44
622;19.04.2018;2018;04;08;Torstai;33;56;89
622;19.04.2018;2018;04;09;Torstai;44;48;92
622;19.04.2018;2018;04;10;Torstai;25;18;43
622;19.04.2018;2018;04;11;Torstai;14;23;37
622;19.04.2018;2018;04;12;Torstai;23;26;49
622;19.04.2018;2018;04;13;Torstai;28;33;61
622;19.04.2018;2018;04;14;Torstai;29;36;65
622;19.04.2018;2018;04;15;Torstai;48;43;91
622;19.04.2018;2018;04;16;Torstai;66;35;101
622;19.04.2018;2018;04;17;Torstai;55;38;93
622;19.04.2018;2018;04;18;Torstai;50;40;90
622;19.04.2018;2018;04;19;Torstai;31;29;60
622;19.04.2018;2018;04;20;Torstai;34;25;59
622;19.04.2018;2018;04;21;Torstai;19;13;32
622;19.04.2018;2018;04;22;Torstai;23;5;28
622;19.04.2018;2018;04;23;Torstai;11;8;19
622;20.04.2018;2018;04;00;Perjantai;10;8;18
622;20.04.2018;2018;04;01;Perjantai;4;4;8
622;20.04.2018;2018;04;02;Perjantai;1;0;1
622;20.04.2018;2018;04;03;Perjantai;2;0;2
622;20.04.2018;2018;04;04;Perjantai;6;0;6
622;20.04.2018;2018;04;05;Perjantai;3;2;5
622;20.04.2018;2018;04;06;Perjantai;1;11;12
622;20.04.2018;2018;04;07;Perjantai;5;16;21
622;20.04.2018;2018;04;08;Perjantai;27;27;54
622;20.04.2018;2018;04;09;Perjantai;35;35;70
622;20.04.2018;2018;04;10;Perjantai;16;15;31
622;20.04.2018;2018;04;11;Perjantai;4;10;14
622;20.04.2018;2018;04;12;Perjantai;9;23;32
622;20.04.2018;2018;04;13;Perjantai;19;14;33
622;20.04.2018;2018;04;14;Perjantai;27;30;57
622;20.04.2018;2018;04;15;Perjantai;31;26;57
622;20.04.2018;2018;04;16;Perjantai;37;22;59
622;20.04.2018;2018;04;17;Perjantai;40;41;81
622;20.04.2018;2018;04;18;Perjantai;34;20;54
622;20.04.2018;2018;04;19;Perjantai;32;27;59
622;20.04.2018;2018;04;20;Perjantai;15;20;35
622;20.04.2018;2018;04;21;Perjantai;11;9;20
622;20.04.2018;2018;04;22;Perjantai;11;11;22
622;20.04.2018;2018;04;23;Perjantai;9;5;14
622;21.04.2018;2018;04;00;Lauantai;6;5;11
622;21.04.2018;2018;04;01;Lauantai;8;3;11
622;21.04.2018;2018;04;02;Lauantai;4;1;5
622;21.04.2018;2018;04;03;Lauantai;4;1;5
622;21.04.2018;2018;04;04;Lauantai;1;1;2
622;21.04.2018;2018;04;05;Lauantai;4;3;7
622;21.04.2018;2018;04;06;Lauantai;1;5;6
622;21.04.2018;2018;04;07;Lauantai;1;5;6
622;21.04.2018;2018;04;08;Lauantai;4;3;7
622;21.04.2018;2018;04;09;Lauantai;3;7;10
622;21.04.2018;2018;04;10;Lauantai;7;20;27
622;21.04.2018;2018;04;11;Lauantai;14;19;33
622;21.04.2018;2018;04;12;Lauantai;14;20;34
622;21.04.2018;2018;04;13;Lauantai;30;34;64
622;21.04.2018;2018;04;14;Lauantai;32;41;73
622;21.04.2018;2018;04;15;Lauantai;36;33;69
622;21.04.2018;2018;04;16;Lauantai;29;21;50
622;21.04.2018;2018;04;17;Lauantai;35;25;60
622;21.04.2018;2018;04;18;Lauantai;23;22;45
622;21.04.2018;2018;04;19;Lauantai;24;23;47
622;21.04.2018;2018;04;20;Lauantai;24;14;38
622;21.04.2018;2018;04;21;Lauantai;17;18;35
622;21.04.2018;2018;04;22;Lauantai;13;11;24
622;21.04.2018;2018;04;23;Lauantai;12;4;16
622;22.04.2018;2018;04;00;Sunnuntai;8;5;13
622;22.04.2018;2018;04;01;Sunnuntai;6;2;8
622;22.04.2018;2018;04;02;Sunnuntai;9;2;11
622;22.04.2018;2018;04;03;Sunnuntai;5;2;7
622;22.04.2018;2018;04;04;Sunnuntai;2;1;3
622;22.04.2018;2018;04;05;Sunnuntai;4;1;5
622;22.04.2018;2018;04;06;Sunnuntai;1;3;4
622;22.04.2018;2018;04;07;Sunnuntai;0;3;3
622;22.04.2018;2018;04;08;Sunnuntai;8;3;11
622;22.04.2018;2018;04;09;Sunnuntai;4;2;6
622;22.04.2018;2018;04;10;Sunnuntai;7;16;23
622;22.04.2018;2018;04;11;Sunnuntai;17;34;51
622;22.04.2018;2018;04;12;Sunnuntai;26;37;63
622;22.04.2018;2018;04;13;Sunnuntai;39;50;89
622;22.04.2018;2018;04;14;Sunnuntai;41;35;76
622;22.04.2018;2018;04;15;Sunnuntai;37;35;72
622;22.04.2018;2018;04;16;Sunnuntai;42;34;76
622;22.04.2018;2018;04;17;Sunnuntai;41;32;73
622;22.04.2018;2018;04;18;Sunnuntai;31;27;58
622;22.04.2018;2018;04;19;Sunnuntai;34;27;61
622;22.04.2018;2018;04;20;Sunnuntai;23;22;45
622;22.04.2018;2018;04;21;Sunnuntai;21;18;39
622;22.04.2018;2018;04;22;Sunnuntai;13;9;22
622;22.04.2018;2018;04;23;Sunnuntai;5;4;9
622;23.04.2018;2018;04;00;Maanantai;1;1;2
622;23.04.2018;2018;04;01;Maanantai;2;2;4
622;23.04.2018;2018;04;02;Maanantai;2;0;2
622;23.04.2018;2018;04;03;Maanantai;2;2;4
622;23.04.2018;2018;04;04;Maanantai;1;1;2
622;23.04.2018;2018;04;05;Maanantai;1;2;3
622;23.04.2018;2018;04;06;Maanantai;0;10;10
622;23.04.2018;2018;04;07;Maanantai;12;32;44
622;23.04.2018;2018;04;08;Maanantai;51;57;108
622;23.04.2018;2018;04;09;Maanantai;38;57;95
622;23.04.2018;2018;04;10;Maanantai;13;41;54
622;23.04.2018;2018;04;11;Maanantai;18;16;34
622;23.04.2018;2018;04;12;Maanantai;16;28;44
622;23.04.2018;2018;04;13;Maanantai;25;35;60
622;23.04.2018;2018;04;14;Maanantai;43;44;87
622;23.04.2018;2018;04;15;Maanantai;53;34;87
622;23.04.2018;2018;04;16;Maanantai;66;51;117
622;23.04.2018;2018;04;17;Maanantai;94;56;150
622;23.04.2018;2018;04;18;Maanantai;62;55;117
622;23.04.2018;2018;04;19;Maanantai;40;32;72
622;23.04.2018;2018;04;20;Maanantai;33;26;59
622;23.04.2018;2018;04;21;Maanantai;31;17;48
622;23.04.2018;2018;04;22;Maanantai;19;12;31
622;23.04.2018;2018;04;23;Maanantai;11;6;17
622;24.04.2018;2018;04;00;Tiistai;6;1;7
622;24.04.2018;2018;04;01;Tiistai;3;4;7
622;24.04.2018;2018;04;02;Tiistai;5;1;6
622;24.04.2018;2018;04;03;Tiistai;2;1;3
622;24.04.2018;2018;04;04;Tiistai;1;1;2
622;24.04.2018;2018;04;05;Tiistai;1;1;2
622;24.04.2018;2018;04;06;Tiistai;2;9;11
622;24.04.2018;2018;04;07;Tiistai;5;28;33
622;24.04.2018;2018;04;08;Tiistai;50;50;100
622;24.04.2018;2018;04;09;Tiistai;36;61;97
622;24.04.2018;2018;04;10;Tiistai;6;28;34
622;24.04.2018;2018;04;11;Tiistai;22;23;45
622;24.04.2018;2018;04;12;Tiistai;26;22;48
622;24.04.2018;2018;04;13;Tiistai;21;28;49
622;24.04.2018;2018;04;14;Tiistai;21;25;46
622;24.04.2018;2018;04;15;Tiistai;45;17;62
622;24.04.2018;2018;04;16;Tiistai;58;25;83
622;24.04.2018;2018;04;17;Tiistai;68;30;98
622;24.04.2018;2018;04;18;Tiistai;31;28;59
622;24.04.2018;2018;04;19;Tiistai;22;19;41
622;24.04.2018;2018;04;20;Tiistai;26;17;43
622;24.04.2018;2018;04;21;Tiistai;15;8;23
622;24.04.2018;2018;04;22;Tiistai;17;11;28
622;24.04.2018;2018;04;23;Tiistai;5;4;9
622;25.04.2018;2018;04;00;Keskiviikko;1;3;4
622;25.04.2018;2018;04;01;Keskiviikko;3;1;4
622;25.04.2018;2018;04;02;Keskiviikko;0;1;1
622;25.04.2018;2018;04;03;Keskiviikko;0;0;0
622;25.04.2018;2018;04;04;Keskiviikko;0;1;1
622;25.04.2018;2018;04;05;Keskiviikko;0;5;5
622;25.04.2018;2018;04;06;Keskiviikko;3;11;14
622;25.04.2018;2018;04;07;Keskiviikko;8;29;37
622;25.04.2018;2018;04;08;Keskiviikko;40;57;97
622;25.04.2018;2018;04;09;Keskiviikko;26;51;77
622;25.04.2018;2018;04;10;Keskiviikko;20;29;49
622;25.04.2018;2018;04;11;Keskiviikko;12;27;39
622;25.04.2018;2018;04;12;Keskiviikko;29;40;69
622;25.04.2018;2018;04;13;Keskiviikko;31;34;65
622;25.04.2018;2018;04;14;Keskiviikko;54;42;96
622;25.04.2018;2018;04;15;Keskiviikko;42;26;68
622;25.04.2018;2018;04;16;Keskiviikko;67;53;120
622;25.04.2018;2018;04;17;Keskiviikko;78;50;128
622;25.04.2018;2018;04;18;Keskiviikko;57;44;101
622;25.04.2018;2018;04;19;Keskiviikko;45;25;70
622;25.04.2018;2018;04;20;Keskiviikko;47;23;70
622;25.04.2018;2018;04;21;Keskiviikko;30;22;52
622;25.04.2018;2018;04;22;Keskiviikko;22;12;34
622;25.04.2018;2018;04;23;Keskiviikko;4;4;8
622;26.04.2018;2018;04;00;Torstai;7;1;8
622;26.04.2018;2018;04;01;Torstai;1;0;1
622;26.04.2018;2018;04;02;Torstai;4;2;6
622;26.04.2018;2018;04;03;Torstai;0;0;0
622;26.04.2018;2018;04;04;Torstai;0;0;0
622;26.04.2018;2018;04;05;Torstai;2;2;4
622;26.04.2018;2018;04;06;Torstai;6;12;18
622;26.04.2018;2018;04;07;Torstai;6;24;30
622;26.04.2018;2018;04;08;Torstai;47;72;119
622;26.04.2018;2018;04;09;Torstai;21;40;61
622;26.04.2018;2018;04;10;Torstai;15;39;54
622;26.04.2018;2018;04;11;Torstai;17;30;47
622;26.04.2018;2018;04;12;Torstai;33;20;53
622;26.04.2018;2018;04;13;Torstai;34;37;71
622;26.04.2018;2018;04;14;Torstai;34;46;80
622;26.04.2018;2018;04;15;Torstai;54;37;91
622;26.04.2018;2018;04;16;Torstai;78;47;125
622;26.04.2018;2018;04;17;Torstai;78;47;125
622;26.04.2018;2018;04;18;Torstai;46;37;83
622;26.04.2018;2018;04;19;Torstai;38;32;70
622;26.04.2018;2018;04;20;Torstai;31;23;54
622;26.04.2018;2018;04;21;Torstai;16;15;31
622;26.04.2018;2018;04;22;Torstai;20;15;35
622;26.04.2018;2018;04;23;Torstai;15;9;24
622;27.04.2018;2018;04;00;Perjantai;5;4;9
622;27.04.2018;2018;04;01;Perjantai;2;1;3
622;27.04.2018;2018;04;02;Perjantai;5;0;5
622;27.04.2018;2018;04;03;Perjantai;6;0;6
622;27.04.2018;2018;04;04;Perjantai;3;0;3
622;27.04.2018;2018;04;05;Perjantai;4;2;6
622;27.04.2018;2018;04;06;Perjantai;2;11;13
622;27.04.2018;2018;04;07;Perjantai;12;22;34
622;27.04.2018;2018;04;08;Perjantai;40;59;99
622;27.04.2018;2018;04;09;Perjantai;23;38;61
622;27.04.2018;2018;04;10;Perjantai;22;34;56
622;27.04.2018;2018;04;11;Perjantai;26;39;65
622;27.04.2018;2018;04;12;Perjantai;25;34;59
622;27.04.2018;2018;04;13;Perjantai;46;49;95
622;27.04.2018;2018;04;14;Perjantai;44;50;94
622;27.04.2018;2018;04;15;Perjantai;47;39;86
622;27.04.2018;2018;04;16;Perjantai;75;48;123
622;27.04.2018;2018;04;17;Perjantai;80;56;136
622;27.04.2018;2018;04;18;Perjantai;53;42;95
622;27.04.2018;2018;04;19;Perjantai;38;33;71
622;27.04.2018;2018;04;20;Perjantai;31;23;54
622;27.04.2018;2018;04;21;Perjantai;33;25;58
622;27.04.2018;2018;04;22;Perjantai;16;15;31
622;27.04.2018;2018;04;23;Perjantai;10;5;15
622;28.04.2018;2018;04;00;Lauantai;7;8;15
622;28.04.2018;2018;04;01;Lauantai;7;1;8
622;28.04.2018;2018;04;02;Lauantai;6;1;7
622;28.04.2018;2018;04;03;Lauantai;4;2;6
622;28.04.2018;2018;04;04;Lauantai;1;3;4
622;28.04.2018;2018;04;05;Lauantai;5;3;8
622;28.04.2018;2018;04;06;Lauantai;2;5;7
622;28.04.2018;2018;04;07;Lauantai;6;7;13
622;28.04.2018;2018;04;08;Lauantai;6;4;10
622;28.04.2018;2018;04;09;Lauantai;6;9;15
622;28.04.2018;2018;04;10;Lauantai;11;26;37
622;28.04.2018;2018;04;11;Lauantai;24;32;56
622;28.04.2018;2018;04;12;Lauantai;32;44;76
622;28.04.2018;2018;04;13;Lauantai;31;55;86
622;28.04.2018;2018;04;14;Lauantai;47;56;103
622;28.04.2018;2018;04;15;Lauantai;45;40;85
622;28.04.2018;2018;04;16;Lauantai;51;53;104
622;28.04.2018;2018;04;17;Lauantai;48;39;87
622;28.04.2018;2018;04;18;Lauantai;49;38;87
622;28.04.2018;2018;04;19;Lauantai;40;36;76
622;28.04.2018;2018;04;20;Lauantai;31;28;59
622;28.04.2018;2018;04;21;Lauantai;24;23;47
622;28.04.2018;2018;04;22;Lauantai;17;9;26
622;28.04.2018;2018;04;23;Lauantai;11;1;12
622;29.04.2018;2018;04;00;Sunnuntai;9;3;12
622;29.04.2018;2018;04;01;Sunnuntai;5;1;6
622;29.04.2018;2018;04;02;Sunnuntai;7;5;12
622;29.04.2018;2018;04;03;Sunnuntai;8;1;9
622;29.04.2018;2018;04;04;Sunnuntai;2;2;4
622;29.04.2018;2018;04;05;Sunnuntai;2;4;6
622;29.04.2018;2018;04;06;Sunnuntai;4;6;10
622;29.04.2018;2018;04;07;Sunnuntai;6;4;10
622;29.04.2018;2018;04;08;Sunnuntai;4;2;6
622;29.04.2018;2018;04;09;Sunnuntai;6;5;11
622;29.04.2018;2018;04;10;Sunnuntai;6;15;21
622;29.04.2018;2018;04;11;Sunnuntai;9;23;32
622;29.04.2018;2018;04;12;Sunnuntai;25;36;61
622;29.04.2018;2018;04;13;Sunnuntai;20;31;51
622;29.04.2018;2018;04;14;Sunnuntai;24;36;60
622;29.04.2018;2018;04;15;Sunnuntai;30;23;53
622;29.04.2018;2018;04;16;Sunnuntai;37;33;70
622;29.04.2018;2018;04;17;Sunnuntai;35;42;77
622;29.04.2018;2018;04;18;Sunnuntai;44;26;70
622;29.04.2018;2018;04;19;Sunnuntai;39;27;66
622;29.04.2018;2018;04;20;Sunnuntai;29;24;53
622;29.04.2018;2018;04;21;Sunnuntai;19;17;36
622;29.04.2018;2018;04;22;Sunnuntai;25;13;38
622;29.04.2018;2018;04;23;Sunnuntai;8;9;17
622;30.04.2018;2018;04;00;Maanantai;4;4;8
622;30.04.2018;2018;04;01;Maanantai;6;2;8
622;30.04.2018;2018;04;02;Maanantai;3;1;4
622;30.04.2018;2018;04;03;Maanantai;3;1;4
622;30.04.2018;2018;04;04;Maanantai;5;0;5
622;30.04.2018;2018;04;05;Maanantai;4;4;8
622;30.04.2018;2018;04;06;Maanantai;4;8;12
622;30.04.2018;2018;04;07;Maanantai;5;18;23
622;30.04.2018;2018;04;08;Maanantai;22;36;58
622;30.04.2018;2018;04;09;Maanantai;18;40;58
622;30.04.2018;2018;04;10;Maanantai;15;30;45
622;30.04.2018;2018;04;11;Maanantai;14;28;42
622;30.04.2018;2018;04;12;Maanantai;32;47;79
622;30.04.2018;2018;04;13;Maanantai;33;43;76
622;30.04.2018;2018;04;14;Maanantai;44;55;99
622;30.04.2018;2018;04;15;Maanantai;43;61;104
622;30.04.2018;2018;04;16;Maanantai;79;57;136
622;30.04.2018;2018;04;17;Maanantai;60;48;108
622;30.04.2018;2018;04;18;Maanantai;66;66;132
622;30.04.2018;2018;04;19;Maanantai;47;33;80
622;30.04.2018;2018;04;20;Maanantai;23;25;48
622;30.04.2018;2018;04;21;Maanantai;16;21;37
622;30.04.2018;2018;04;22;Maanantai;22;13;35
622;30.04.2018;2018;04;23;Maanantai;12;11;23
622;01.05.2018;2018;05;00;Tiistai;9;6;15
622;01.05.2018;2018;05;01;Tiistai;12;9;21
622;01.05.2018;2018;05;02;Tiistai;10;1;11
622;01.05.2018;2018;05;03;Tiistai;14;3;17
622;01.05.2018;2018;05;04;Tiistai;7;3;10
622;01.05.2018;2018;05;05;Tiistai;12;2;14
622;01.05.2018;2018;05;06;Tiistai;8;6;14
622;01.05.2018;2018;05;07;Tiistai;3;5;8
622;01.05.2018;2018;05;08;Tiistai;5;10;15
622;01.05.2018;2018;05;09;Tiistai;9;12;21
622;01.05.2018;2018;05;10;Tiistai;12;20;32
622;01.05.2018;2018;05;11;Tiistai;7;32;39
622;01.05.2018;2018;05;12;Tiistai;37;77;114
622;01.05.2018;2018;05;13;Tiistai;42;81;123
622;01.05.2018;2018;05;14;Tiistai;47;59;106
622;01.05.2018;2018;05;15;Tiistai;71;58;129
622;01.05.2018;2018;05;16;Tiistai;76;93;169
622;01.05.2018;2018;05;17;Tiistai;55;39;94
622;01.05.2018;2018;05;18;Tiistai;73;22;95
622;01.05.2018;2018;05;19;Tiistai;56;34;90
622;01.05.2018;2018;05;20;Tiistai;43;28;71
622;01.05.2018;2018;05;21;Tiistai;19;11;30
622;01.05.2018;2018;05;22;Tiistai;11;16;27
622;01.05.2018;2018;05;23;Tiistai;13;1;14
622;02.05.2018;2018;05;00;Keskiviikko;4;1;5
622;02.05.2018;2018;05;01;Keskiviikko;2;2;4
622;02.05.2018;2018;05;02;Keskiviikko;1;0;1
622;02.05.2018;2018;05;03;Keskiviikko;2;1;3
622;02.05.2018;2018;05;04;Keskiviikko;0;0;0
622;02.05.2018;2018;05;05;Keskiviikko;1;1;2
622;02.05.2018;2018;05;06;Keskiviikko;1;10;11
622;02.05.2018;2018;05;07;Keskiviikko;7;33;40
622;02.05.2018;2018;05;08;Keskiviikko;39;53;92
622;02.05.2018;2018;05;09;Keskiviikko;19;47;66
622;02.05.2018;2018;05;10;Keskiviikko;11;22;33
622;02.05.2018;2018;05;11;Keskiviikko;11;21;32
622;02.05.2018;2018;05;12;Keskiviikko;25;26;51
622;02.05.2018;2018;05;13;Keskiviikko;17;27;44
622;02.05.2018;2018;05;14;Keskiviikko;22;26;48
622;02.05.2018;2018;05;15;Keskiviikko;31;24;55
622;02.05.2018;2018;05;16;Keskiviikko;50;32;82
622;02.05.2018;2018;05;17;Keskiviikko;47;20;67
622;02.05.2018;2018;05;18;Keskiviikko;46;33;79
622;02.05.2018;2018;05;19;Keskiviikko;21;14;35
622;02.05.2018;2018;05;20;Keskiviikko;23;8;31
622;02.05.2018;2018;05;21;Keskiviikko;18;11;29
622;02.05.2018;2018;05;22;Keskiviikko;14;10;24
622;02.05.2018;2018;05;23;Keskiviikko;4;4;8
622;03.05.2018;2018;05;00;Torstai;5;2;7
622;03.05.2018;2018;05;01;Torstai;2;1;3
622;03.05.2018;2018;05;02;Torstai;1;0;1
622;03.05.2018;2018;05;03;Torstai;0;0;0
622;03.05.2018;2018;05;04;Torstai;0;0;0
622;03.05.2018;2018;05;05;Torstai;2;4;6
622;03.05.2018;2018;05;06;Torstai;4;13;17
622;03.05.2018;2018;05;07;Torstai;12;48;60
622;03.05.2018;2018;05;08;Torstai;43;72;115
622;03.05.2018;2018;05;09;Torstai;37;65;102
622;03.05.2018;2018;05;10;Torstai;12;34;46
622;03.05.2018;2018;05;11;Torstai;32;25;57
622;03.05.2018;2018;05;12;Torstai;21;36;57
622;03.05.2018;2018;05;13;Torstai;38;31;69
622;03.05.2018;2018;05;14;Torstai;30;31;61
622;03.05.2018;2018;05;15;Torstai;51;44;95
622;03.05.2018;2018;05;16;Torstai;74;39;113
622;03.05.2018;2018;05;17;Torstai;92;60;152
622;03.05.2018;2018;05;18;Torstai;57;43;100
622;03.05.2018;2018;05;19;Torstai;46;20;66
622;03.05.2018;2018;05;20;Torstai;46;28;74
622;03.05.2018;2018;05;21;Torstai;21;14;35
622;03.05.2018;2018;05;22;Torstai;16;10;26
622;03.05.2018;2018;05;23;Torstai;9;4;13
622;04.05.2018;2018;05;00;Perjantai;10;2;12
622;04.05.2018;2018;05;01;Perjantai;2;3;5
622;04.05.2018;2018;05;02;Perjantai;3;0;3
622;04.05.2018;2018;05;03;Perjantai;3;0;3
622;04.05.2018;2018;05;04;Perjantai;0;1;1
622;04.05.2018;2018;05;05;Perjantai;1;1;2
622;04.05.2018;2018;05;06;Perjantai;0;11;11
622;04.05.2018;2018;05;07;Perjantai;10;31;41
622;04.05.2018;2018;05;08;Perjantai;23;44;67
622;04.05.2018;2018;05;09;Perjantai;19;35;54
622;04.05.2018;2018;05;10;Perjantai;11;20;31
622;04.05.2018;2018;05;11;Perjantai;8;13;21
622;04.05.2018;2018;05;12;Perjantai;9;6;15
622;04.05.2018;2018;05;13;Perjantai;10;13;23
622;04.05.2018;2018;05;14;Perjantai;17;10;27
622;04.05.2018;2018;05;15;Perjantai;25;20;45
622;04.05.2018;2018;05;16;Perjantai;31;21;52
622;04.05.2018;2018;05;17;Perjantai;45;38;83
622;04.05.2018;2018;05;18;Perjantai;33;29;62
622;04.05.2018;2018;05;19;Perjantai;24;17;41
622;04.05.2018;2018;05;20;Perjantai;17;13;30
622;04.05.2018;2018;05;21;Perjantai;19;17;36
622;04.05.2018;2018;05;22;Perjantai;14;9;23
622;04.05.2018;2018;05;23;Perjantai;9;8;17
622;05.05.2018;2018;05;00;Lauantai;6;5;11
622;05.05.2018;2018;05;01;Lauantai;7;3;10
622;05.05.2018;2018;05;02;Lauantai;5;2;7
622;05.05.2018;2018;05;03;Lauantai;3;1;4
622;05.05.2018;2018;05;04;Lauantai;3;2;5
622;05.05.2018;2018;05;05;Lauantai;0;4;4
622;05.05.2018;2018;05;06;Lauantai;4;5;9
622;05.05.2018;2018;05;07;Lauantai;8;7;15
622;05.05.2018;2018;05;08;Lauantai;5;2;7
622;05.05.2018;2018;05;09;Lauantai;6;11;17
622;05.05.2018;2018;05;10;Lauantai;17;17;34
622;05.05.2018;2018;05;11;Lauantai;16;33;49
622;05.05.2018;2018;05;12;Lauantai;34;42;76
622;05.05.2018;2018;05;13;Lauantai;34;50;84
622;05.05.2018;2018;05;14;Lauantai;32;45;77
622;05.05.2018;2018;05;15;Lauantai;48;42;90
622;05.05.2018;2018;05;16;Lauantai;38;28;66
622;05.05.2018;2018;05;17;Lauantai;32;36;68
622;05.05.2018;2018;05;18;Lauantai;44;35;79
622;05.05.2018;2018;05;19;Lauantai;27;31;58
622;05.05.2018;2018;05;20;Lauantai;30;30;60
622;05.05.2018;2018;05;21;Lauantai;28;27;55
622;05.05.2018;2018;05;22;Lauantai;23;18;41
622;05.05.2018;2018;05;23;Lauantai;8;12;20
622;06.05.2018;2018;05;00;Sunnuntai;13;10;23
622;06.05.2018;2018;05;01;Sunnuntai;8;7;15
622;06.05.2018;2018;05;02;Sunnuntai;8;2;10
622;06.05.2018;2018;05;03;Sunnuntai;8;1;9
622;06.05.2018;2018;05;04;Sunnuntai;8;4;12
622;06.05.2018;2018;05;05;Sunnuntai;1;1;2
622;06.05.2018;2018;05;06;Sunnuntai;1;3;4
622;06.05.2018;2018;05;07;Sunnuntai;8;5;13
622;06.05.2018;2018;05;08;Sunnuntai;3;5;8
622;06.05.2018;2018;05;09;Sunnuntai;9;12;21
622;06.05.2018;2018;05;10;Sunnuntai;7;21;28
622;06.05.2018;2018;05;11;Sunnuntai;32;34;66
622;06.05.2018;2018;05;12;Sunnuntai;73;52;125
622;06.05.2018;2018;05;13;Sunnuntai;79;78;157
622;06.05.2018;2018;05;14;Sunnuntai;54;68;122
622;06.05.2018;2018;05;15;Sunnuntai;42;34;76
622;06.05.2018;2018;05;16;Sunnuntai;44;40;84
622;06.05.2018;2018;05;17;Sunnuntai;36;46;82
622;06.05.2018;2018;05;18;Sunnuntai;35;39;74
622;06.05.2018;2018;05;19;Sunnuntai;42;29;71
622;06.05.2018;2018;05;20;Sunnuntai;31;32;63
622;06.05.2018;2018;05;21;Sunnuntai;28;23;51
622;06.05.2018;2018;05;22;Sunnuntai;19;8;27
622;06.05.2018;2018;05;23;Sunnuntai;9;3;12
622;07.05.2018;2018;05;00;Maanantai;3;1;4
622;07.05.2018;2018;05;01;Maanantai;1;2;3
622;07.05.2018;2018;05;02;Maanantai;1;2;3
622;07.05.2018;2018;05;03;Maanantai;2;1;3
622;07.05.2018;2018;05;04;Maanantai;0;1;1
622;07.05.2018;2018;05;05;Maanantai;2;4;6
622;07.05.2018;2018;05;06;Maanantai;2;14;16
622;07.05.2018;2018;05;07;Maanantai;16;49;65
622;07.05.2018;2018;05;08;Maanantai;39;66;105
622;07.05.2018;2018;05;09;Maanantai;44;68;112
622;07.05.2018;2018;05;10;Maanantai;34;72;106
622;07.05.2018;2018;05;11;Maanantai;32;43;75
622;07.05.2018;2018;05;12;Maanantai;39;32;71
622;07.05.2018;2018;05;13;Maanantai;26;26;52
622;07.05.2018;2018;05;14;Maanantai;32;30;62
622;07.05.2018;2018;05;15;Maanantai;43;34;77
622;07.05.2018;2018;05;16;Maanantai;71;43;114
622;07.05.2018;2018;05;17;Maanantai;94;38;132
622;07.05.2018;2018;05;18;Maanantai;36;40;76
622;07.05.2018;2018;05;19;Maanantai;21;14;35
622;07.05.2018;2018;05;20;Maanantai;31;25;56
622;07.05.2018;2018;05;21;Maanantai;30;20;50
622;07.05.2018;2018;05;22;Maanantai;19;14;33
622;07.05.2018;2018;05;23;Maanantai;14;2;16
622;08.05.2018;2018;05;00;Tiistai;4;2;6
622;08.05.2018;2018;05;01;Tiistai;2;1;3
622;08.05.2018;2018;05;02;Tiistai;1;3;4
622;08.05.2018;2018;05;03;Tiistai;0;0;0
622;08.05.2018;2018;05;04;Tiistai;0;1;1
622;08.05.2018;2018;05;05;Tiistai;1;3;4
622;08.05.2018;2018;05;06;Tiistai;1;16;17
622;08.05.2018;2018;05;07;Tiistai;14;62;76
622;08.05.2018;2018;05;08;Tiistai;65;100;165
622;08.05.2018;2018;05;09;Tiistai;47;84;131
622;08.05.2018;2018;05;10;Tiistai;22;42;64
622;08.05.2018;2018;05;11;Tiistai;18;41;59
622;08.05.2018;2018;05;12;Tiistai;33;46;79
622;08.05.2018;2018;05;13;Tiistai;35;39;74
622;08.05.2018;2018;05;14;Tiistai;55;44;99
622;08.05.2018;2018;05;15;Tiistai;73;42;115
622;08.05.2018;2018;05;16;Tiistai;87;62;149
622;08.05.2018;2018;05;17;Tiistai;122;63;185
622;08.05.2018;2018;05;18;Tiistai;96;58;154
622;08.05.2018;2018;05;19;Tiistai;66;51;117
622;08.05.2018;2018;05;20;Tiistai;58;41;99
622;08.05.2018;2018;05;21;Tiistai;37;29;66
622;08.05.2018;2018;05;22;Tiistai;23;13;36
622;08.05.2018;2018;05;23;Tiistai;10;5;15
622;09.05.2018;2018;05;00;Keskiviikko;8;5;13
622;09.05.2018;2018;05;01;Keskiviikko;1;1;2
622;09.05.2018;2018;05;02;Keskiviikko;2;1;3
622;09.05.2018;2018;05;03;Keskiviikko;0;0;0
622;09.05.2018;2018;05;04;Keskiviikko;0;0;0
622;09.05.2018;2018;05;05;Keskiviikko;1;4;5
622;09.05.2018;2018;05;06;Keskiviikko;2;15;17
622;09.05.2018;2018;05;07;Keskiviikko;13;67;80
622;09.05.2018;2018;05;08;Keskiviikko;63;113;176
622;09.05.2018;2018;05;09;Keskiviikko;41;64;105
622;09.05.2018;2018;05;10;Keskiviikko;18;29;47
622;09.05.2018;2018;05;11;Keskiviikko;20;33;53
622;09.05.2018;2018;05;12;Keskiviikko;36;40;76
622;09.05.2018;2018;05;13;Keskiviikko;53;45;98
622;09.05.2018;2018;05;14;Keskiviikko;56;45;101
622;09.05.2018;2018;05;15;Keskiviikko;82;65;147
622;09.05.2018;2018;05;16;Keskiviikko;93;44;137
622;09.05.2018;2018;05;17;Keskiviikko;115;83;198
622;09.05.2018;2018;05;18;Keskiviikko;90;69;159
622;09.05.2018;2018;05;19;Keskiviikko;67;53;120
622;09.05.2018;2018;05;20;Keskiviikko;55;31;86
622;09.05.2018;2018;05;21;Keskiviikko;51;29;80
622;09.05.2018;2018;05;22;Keskiviikko;22;15;37
622;09.05.2018;2018;05;23;Keskiviikko;14;6;20
622;10.05.2018;2018;05;00;Torstai;10;5;15
622;10.05.2018;2018;05;01;Torstai;8;1;9
622;10.05.2018;2018;05;02;Torstai;7;1;8
622;10.05.2018;2018;05;03;Torstai;4;5;9
622;10.05.2018;2018;05;04;Torstai;5;2;7
622;10.05.2018;2018;05;05;Torstai;5;3;8
622;10.05.2018;2018;05;06;Torstai;1;7;8
622;10.05.2018;2018;05;07;Torstai;2;12;14
622;10.05.2018;2018;05;08;Torstai;13;7;20
622;10.05.2018;2018;05;09;Torstai;14;19;33
622;10.05.2018;2018;05;10;Torstai;16;22;38
622;10.05.2018;2018;05;11;Torstai;28;55;83
622;10.05.2018;2018;05;12;Torstai;52;74;126
622;10.05.2018;2018;05;13;Torstai;54;95;149
622;10.05.2018;2018;05;14;Torstai;95;124;219
622;10.05.2018;2018;05;15;Torstai;114;105;219
622;10.05.2018;2018;05;16;Torstai;109;98;207
622;10.05.2018;2018;05;17;Torstai;115;110;225
622;10.05.2018;2018;05;18;Torstai;85;67;152
622;10.05.2018;2018;05;19;Torstai;91;67;158
622;10.05.2018;2018;05;20;Torstai;68;51;119
622;10.05.2018;2018;05;21;Torstai;48;33;81
622;10.05.2018;2018;05;22;Torstai;36;20;56
622;10.05.2018;2018;05;23;Torstai;18;13;31
622;11.05.2018;2018;05;00;Perjantai;11;5;16
622;11.05.2018;2018;05;01;Perjantai;8;2;10
622;11.05.2018;2018;05;02;Perjantai;2;0;2
622;11.05.2018;2018;05;03;Perjantai;4;0;4
622;11.05.2018;2018;05;04;Perjantai;2;1;3
622;11.05.2018;2018;05;05;Perjantai;2;1;3
622;11.05.2018;2018;05;06;Perjantai;3;14;17
622;11.05.2018;2018;05;07;Perjantai;9;52;61
622;11.05.2018;2018;05;08;Perjantai;39;69;108
622;11.05.2018;2018;05;09;Perjantai;33;65;98
622;11.05.2018;2018;05;10;Perjantai;22;49;71
622;11.05.2018;2018;05;11;Perjantai;37;31;68
622;11.05.2018;2018;05;12;Perjantai;38;49;87
622;11.05.2018;2018;05;13;Perjantai;45;63;108
622;11.05.2018;2018;05;14;Perjantai;57;56;113
622;11.05.2018;2018;05;15;Perjantai;86;65;151
622;11.05.2018;2018;05;16;Perjantai;125;85;210
622;11.05.2018;2018;05;17;Perjantai;107;81;188
622;11.05.2018;2018;05;18;Perjantai;104;77;181
622;11.05.2018;2018;05;19;Perjantai;86;70;156
622;11.05.2018;2018;05;20;Perjantai;58;51;109
622;11.05.2018;2018;05;21;Perjantai;38;33;71
622;11.05.2018;2018;05;22;Perjantai;31;26;57
622;11.05.2018;2018;05;23;Perjantai;30;11;41
622;12.05.2018;2018;05;00;Lauantai;10;8;18
622;12.05.2018;2018;05;01;Lauantai;13;6;19
622;12.05.2018;2018;05;02;Lauantai;14;4;18
622;12.05.2018;2018;05;03;Lauantai;10;0;10
622;12.05.2018;2018;05;04;Lauantai;7;1;8
622;12.05.2018;2018;05;05;Lauantai;7;4;11
622;12.05.2018;2018;05;06;Lauantai;4;8;12
622;12.05.2018;2018;05;07;Lauantai;7;12;19
622;12.05.2018;2018;05;08;Lauantai;5;8;13
622;12.05.2018;2018;05;09;Lauantai;8;25;33
622;12.05.2018;2018;05;10;Lauantai;26;24;50
622;12.05.2018;2018;05;11;Lauantai;41;57;98
622;12.05.2018;2018;05;12;Lauantai;52;76;128
622;12.05.2018;2018;05;13;Lauantai;72;108;180
622;12.05.2018;2018;05;14;Lauantai;100;109;209
622;12.05.2018;2018;05;15;Lauantai;120;125;245
622;12.05.2018;2018;05;16;Lauantai;98;71;169
622;12.05.2018;2018;05;17;Lauantai;101;79;180
622;12.05.2018;2018;05;18;Lauantai;89;71;160
622;12.05.2018;2018;05;19;Lauantai;94;59;153
622;12.05.2018;2018;05;20;Lauantai;83;47;130
622;12.05.2018;2018;05;21;Lauantai;51;41;92
622;12.05.2018;2018;05;22;Lauantai;43;15;58
622;12.05.2018;2018;05;23;Lauantai;9;4;13
622;13.05.2018;2018;05;00;Sunnuntai;11;10;21
622;13.05.2018;2018;05;01;Sunnuntai;18;8;26
622;13.05.2018;2018;05;02;Sunnuntai;10;3;13
622;13.05.2018;2018;05;03;Sunnuntai;16;7;23
622;13.05.2018;2018;05;04;Sunnuntai;4;1;5
622;13.05.2018;2018;05;05;Sunnuntai;5;2;7
622;13.05.2018;2018;05;06;Sunnuntai;9;5;14
622;13.05.2018;2018;05;07;Sunnuntai;3;6;9
622;13.05.2018;2018;05;08;Sunnuntai;3;8;11
622;13.05.2018;2018;05;09;Sunnuntai;12;11;23
622;13.05.2018;2018;05;10;Sunnuntai;12;25;37
622;13.05.2018;2018;05;11;Sunnuntai;17;34;51
622;13.05.2018;2018;05;12;Sunnuntai;49;69;118
622;13.05.2018;2018;05;13;Sunnuntai;68;91;159
622;13.05.2018;2018;05;14;Sunnuntai;84;92;176
622;13.05.2018;2018;05;15;Sunnuntai;94;58;152
622;13.05.2018;2018;05;16;Sunnuntai;87;80;167
622;13.05.2018;2018;05;17;Sunnuntai;103;88;191
622;13.05.2018;2018;05;18;Sunnuntai;95;81;176
622;13.05.2018;2018;05;19;Sunnuntai;102;74;176
622;13.05.2018;2018;05;20;Sunnuntai;85;68;153
622;13.05.2018;2018;05;21;Sunnuntai;42;35;77
622;13.05.2018;2018;05;22;Sunnuntai;33;14;47
622;13.05.2018;2018;05;23;Sunnuntai;6;9;15
622;14.05.2018;2018;05;00;Maanantai;9;10;19
622;14.05.2018;2018;05;01;Maanantai;8;4;12
622;14.05.2018;2018;05;02;Maanantai;4;0;4
622;14.05.2018;2018;05;03;Maanantai;1;0;1
622;14.05.2018;2018;05;04;Maanantai;1;0;1
622;14.05.2018;2018;05;05;Maanantai;2;3;5
622;14.05.2018;2018;05;06;Maanantai;3;28;31
622;14.05.2018;2018;05;07;Maanantai;21;88;109
622;14.05.2018;2018;05;08;Maanantai;60;108;168
622;14.05.2018;2018;05;09;Maanantai;60;100;160
622;14.05.2018;2018;05;10;Maanantai;29;60;89
622;14.05.2018;2018;05;11;Maanantai;29;43;72
622;14.05.2018;2018;05;12;Maanantai;36;45;81
622;14.05.2018;2018;05;13;Maanantai;61;58;119
622;14.05.2018;2018;05;14;Maanantai;57;58;115
622;14.05.2018;2018;05;15;Maanantai;105;65;170
622;14.05.2018;2018;05;16;Maanantai;136;89;225
622;14.05.2018;2018;05;17;Maanantai;165;104;269
622;14.05.2018;2018;05;18;Maanantai;98;84;182
622;14.05.2018;2018;05;19;Maanantai;99;60;159
622;14.05.2018;2018;05;20;Maanantai;74;56;130
622;14.05.2018;2018;05;21;Maanantai;64;33;97
622;14.05.2018;2018;05;22;Maanantai;36;19;55
622;14.05.2018;2018;05;23;Maanantai;17;10;27
622;15.05.2018;2018;05;00;Tiistai;6;4;10
622;15.05.2018;2018;05;01;Tiistai;4;0;4
622;15.05.2018;2018;05;02;Tiistai;1;0;1
622;15.05.2018;2018;05;03;Tiistai;2;1;3
622;15.05.2018;2018;05;04;Tiistai;1;0;1
622;15.05.2018;2018;05;05;Tiistai;1;4;5
622;15.05.2018;2018;05;06;Tiistai;4;34;38
622;15.05.2018;2018;05;07;Tiistai;35;104;139
622;15.05.2018;2018;05;08;Tiistai;69;124;193
622;15.05.2018;2018;05;09;Tiistai;62;108;170
622;15.05.2018;2018;05;10;Tiistai;28;61;89
622;15.05.2018;2018;05;11;Tiistai;39;45;84
622;15.05.2018;2018;05;12;Tiistai;51;55;106
622;15.05.2018;2018;05;13;Tiistai;71;59;130
622;15.05.2018;2018;05;14;Tiistai;62;65;127
622;15.05.2018;2018;05;15;Tiistai;72;48;120
622;15.05.2018;2018;05;16;Tiistai;143;84;227
622;15.05.2018;2018;05;17;Tiistai;170;99;269
622;15.05.2018;2018;05;18;Tiistai;119;72;191
622;15.05.2018;2018;05;19;Tiistai;70;64;134
622;15.05.2018;2018;05;20;Tiistai;68;54;122
622;15.05.2018;2018;05;21;Tiistai;62;33;95
622;15.05.2018;2018;05;22;Tiistai;49;19;68
622;15.05.2018;2018;05;23;Tiistai;20;11;31
622;16.05.2018;2018;05;00;Keskiviikko;14;2;16
622;16.05.2018;2018;05;01;Keskiviikko;11;1;12
622;16.05.2018;2018;05;02;Keskiviikko;0;2;2
622;16.05.2018;2018;05;03;Keskiviikko;2;0;2
622;16.05.2018;2018;05;04;Keskiviikko;0;1;1
622;16.05.2018;2018;05;05;Keskiviikko;2;4;6
622;16.05.2018;2018;05;06;Keskiviikko;2;28;30
622;16.05.2018;2018;05;07;Keskiviikko;22;84;106
622;16.05.2018;2018;05;08;Keskiviikko;77;125;202
622;16.05.2018;2018;05;09;Keskiviikko;64;104;168
622;16.05.2018;2018;05;10;Keskiviikko;32;57;89
622;16.05.2018;2018;05;11;Keskiviikko;33;49;82
622;16.05.2018;2018;05;12;Keskiviikko;46;80;126
622;16.05.2018;2018;05;13;Keskiviikko;62;67;129
622;16.05.2018;2018;05;14;Keskiviikko;76;78;154
622;16.05.2018;2018;05;15;Keskiviikko;89;78;167
622;16.05.2018;2018;05;16;Keskiviikko;157;81;238
622;16.05.2018;2018;05;17;Keskiviikko;158;108;266
622;16.05.2018;2018;05;18;Keskiviikko;118;94;212
622;16.05.2018;2018;05;19;Keskiviikko;99;99;198
622;16.05.2018;2018;05;20;Keskiviikko;91;70;161
622;16.05.2018;2018;05;21;Keskiviikko;100;44;144
622;16.05.2018;2018;05;22;Keskiviikko;65;34;99
622;16.05.2018;2018;05;23;Keskiviikko;29;19;48
622;17.05.2018;2018;05;00;Torstai;23;5;28
622;17.05.2018;2018;05;01;Torstai;4;2;6
622;17.05.2018;2018;05;02;Torstai;6;3;9
622;17.05.2018;2018;05;03;Torstai;4;2;6
622;17.05.2018;2018;05;04;Torstai;2;1;3
622;17.05.2018;2018;05;05;Torstai;5;3;8
622;17.05.2018;2018;05;06;Torstai;2;28;30
622;17.05.2018;2018;05;07;Torstai;18;67;85
622;17.05.2018;2018;05;08;Torstai;76;110;186
622;17.05.2018;2018;05;09;Torstai;65;89;154
622;17.05.2018;2018;05;10;Torstai;27;52;79
622;17.05.2018;2018;05;11;Torstai;27;61;88
622;17.05.2018;2018;05;12;Torstai;29;53;82
622;17.05.2018;2018;05;13;Torstai;43;40;83
622;17.05.2018;2018;05;14;Torstai;60;67;127
622;17.05.2018;2018;05;15;Torstai;68;40;108
622;17.05.2018;2018;05;16;Torstai;116;48;164
622;17.05.2018;2018;05;17;Torstai;140;92;232
622;17.05.2018;2018;05;18;Torstai;81;49;130
622;17.05.2018;2018;05;19;Torstai;63;54;117
622;17.05.2018;2018;05;20;Torstai;64;29;93
622;17.05.2018;2018;05;21;Torstai;48;19;67
622;17.05.2018;2018;05;22;Torstai;35;15;50
622;17.05.2018;2018;05;23;Torstai;9;2;11
622;18.05.2018;2018;05;00;Perjantai;7;5;12
622;18.05.2018;2018;05;01;Perjantai;11;1;12
622;18.05.2018;2018;05;02;Perjantai;1;5;6
622;18.05.2018;2018;05;03;Perjantai;3;0;3
622;18.05.2018;2018;05;04;Perjantai;1;2;3
622;18.05.2018;2018;05;05;Perjantai;0;2;2
622;18.05.2018;2018;05;06;Perjantai;3;24;27
622;18.05.2018;2018;05;07;Perjantai;18;51;69
622;18.05.2018;2018;05;08;Perjantai;62;62;124
622;18.05.2018;2018;05;09;Perjantai;37;81;118
622;18.05.2018;2018;05;10;Perjantai;30;60;90
622;18.05.2018;2018;05;11;Perjantai;17;29;46
622;18.05.2018;2018;05;12;Perjantai;29;39;68
622;18.05.2018;2018;05;13;Perjantai;24;33;57
622;18.05.2018;2018;05;14;Perjantai;68;43;111
622;18.05.2018;2018;05;15;Perjantai;66;46;112
622;18.05.2018;2018;05;16;Perjantai;88;58;146
622;18.05.2018;2018;05;17;Perjantai;72;63;135
622;18.05.2018;2018;05;18;Perjantai;62;44;106
622;18.05.2018;2018;05;19;Perjantai;54;49;103
622;18.05.2018;2018;05;20;Perjantai;35;36;71
622;18.05.2018;2018;05;21;Perjantai;32;22;54
622;18.05.2018;2018;05;22;Perjantai;26;18;44
622;18.05.2018;2018;05;23;Perjantai;22;12;34
622;19.05.2018;2018;05;00;Lauantai;11;11;22
622;19.05.2018;2018;05;01;Lauantai;11;6;17
622;19.05.2018;2018;05;02;Lauantai;7;2;9
622;19.05.2018;2018;05;03;Lauantai;5;2;7
622;19.05.2018;2018;05;04;Lauantai;5;0;5
622;19.05.2018;2018;05;05;Lauantai;3;3;6
622;19.05.2018;2018;05;06;Lauantai;4;6;10
622;19.05.2018;2018;05;07;Lauantai;5;7;12
622;19.05.2018;2018;05;08;Lauantai;10;8;18
622;19.05.2018;2018;05;09;Lauantai;9;19;28
622;19.05.2018;2018;05;10;Lauantai;13;24;37
622;19.05.2018;2018;05;11;Lauantai;28;43;71
622;19.05.2018;2018;05;12;Lauantai;31;48;79
622;19.05.2018;2018;05;13;Lauantai;49;44;93
622;19.05.2018;2018;05;14;Lauantai;61;43;104
622;19.05.2018;2018;05;15;Lauantai;56;51;107
622;19.05.2018;2018;05;16;Lauantai;76;52;128
622;19.05.2018;2018;05;17;Lauantai;64;60;124
622;19.05.2018;2018;05;18;Lauantai;42;47;89
622;19.05.2018;2018;05;19;Lauantai;44;43;87
622;19.05.2018;2018;05;20;Lauantai;39;31;70
622;19.05.2018;2018;05;21;Lauantai;36;23;59
622;19.05.2018;2018;05;22;Lauantai;23;11;34
622;19.05.2018;2018;05;23;Lauantai;13;10;23
622;20.05.2018;2018;05;00;Sunnuntai;8;5;13
622;20.05.2018;2018;05;01;Sunnuntai;11;9;20
622;20.05.2018;2018;05;02;Sunnuntai;6;4;10
622;20.05.2018;2018;05;03;Sunnuntai;8;1;9
622;20.05.2018;2018;05;04;Sunnuntai;6;3;9
622;20.05.2018;2018;05;05;Sunnuntai;6;3;9
622;20.05.2018;2018;05;06;Sunnuntai;3;7;10
622;20.05.2018;2018;05;07;Sunnuntai;3;7;10
622;20.05.2018;2018;05;08;Sunnuntai;3;7;10
622;20.05.2018;2018;05;09;Sunnuntai;6;9;15
622;20.05.2018;2018;05;10;Sunnuntai;11;21;32
622;20.05.2018;2018;05;11;Sunnuntai;22;26;48
622;20.05.2018;2018;05;12;Sunnuntai;35;50;85
622;20.05.2018;2018;05;13;Sunnuntai;59;46;105
622;20.05.2018;2018;05;14;Sunnuntai;37;35;72
622;20.05.2018;2018;05;15;Sunnuntai;56;62;118
622;20.05.2018;2018;05;16;Sunnuntai;56;43;99
622;20.05.2018;2018;05;17;Sunnuntai;51;38;89
622;20.05.2018;2018;05;18;Sunnuntai;44;46;90
622;20.05.2018;2018;05;19;Sunnuntai;52;34;86
622;20.05.2018;2018;05;20;Sunnuntai;53;26;79
622;20.05.2018;2018;05;21;Sunnuntai;39;29;68
622;20.05.2018;2018;05;22;Sunnuntai;36;18;54
622;20.05.2018;2018;05;23;Sunnuntai;9;3;12
622;21.05.2018;2018;05;00;Maanantai;7;2;9
622;21.05.2018;2018;05;01;Maanantai;6;5;11
622;21.05.2018;2018;05;02;Maanantai;1;2;3
622;21.05.2018;2018;05;03;Maanantai;0;0;0
622;21.05.2018;2018;05;04;Maanantai;1;2;3
622;21.05.2018;2018;05;05;Maanantai;0;1;1
622;21.05.2018;2018;05;06;Maanantai;4;24;28
622;21.05.2018;2018;05;07;Maanantai;21;76;97
622;21.05.2018;2018;05;08;Maanantai;52;128;180
622;21.05.2018;2018;05;09;Maanantai;70;82;152
622;21.05.2018;2018;05;10;Maanantai;27;70;97
622;21.05.2018;2018;05;11;Maanantai;20;43;63
622;21.05.2018;2018;05;12;Maanantai;27;46;73
622;21.05.2018;2018;05;13;Maanantai;41;57;98
622;21.05.2018;2018;05;14;Maanantai;50;46;96
622;21.05.2018;2018;05;15;Maanantai;78;58;136
622;21.05.2018;2018;05;16;Maanantai;142;71;213
622;21.05.2018;2018;05;17;Maanantai;149;57;206
622;21.05.2018;2018;05;18;Maanantai;86;70;156
622;21.05.2018;2018;05;19;Maanantai;66;50;116
622;21.05.2018;2018;05;20;Maanantai;67;33;100
622;21.05.2018;2018;05;21;Maanantai;65;28;93
622;21.05.2018;2018;05;22;Maanantai;35;18;53
622;21.05.2018;2018;05;23;Maanantai;21;8;29
622;22.05.2018;2018;05;00;Tiistai;12;9;21
622;22.05.2018;2018;05;01;Tiistai;4;2;6
622;22.05.2018;2018;05;02;Tiistai;1;2;3
622;22.05.2018;2018;05;03;Tiistai;2;3;5
622;22.05.2018;2018;05;04;Tiistai;0;1;1
622;22.05.2018;2018;05;05;Tiistai;1;1;2
622;22.05.2018;2018;05;06;Tiistai;6;21;27
622;22.05.2018;2018;05;07;Tiistai;25;73;98
622;22.05.2018;2018;05;08;Tiistai;69;125;194
622;22.05.2018;2018;05;09;Tiistai;58;116;174
622;22.05.2018;2018;05;10;Tiistai;28;51;79
622;22.05.2018;2018;05;11;Tiistai;33;51;84
622;22.05.2018;2018;05;12;Tiistai;53;76;129
622;22.05.2018;2018;05;13;Tiistai;56;64;120
622;22.05.2018;2018;05;14;Tiistai;61;45;106
622;22.05.2018;2018;05;15;Tiistai;97;79;176
622;22.05.2018;2018;05;16;Tiistai;142;88;230
622;22.05.2018;2018;05;17;Tiistai;173;114;287
622;22.05.2018;2018;05;18;Tiistai;104;71;175
622;22.05.2018;2018;05;19;Tiistai;97;54;151
622;22.05.2018;2018;05;20;Tiistai;68;45;113
622;22.05.2018;2018;05;21;Tiistai;58;39;97
622;22.05.2018;2018;05;22;Tiistai;50;22;72
622;22.05.2018;2018;05;23;Tiistai;25;12;37
622;23.05.2018;2018;05;00;Keskiviikko;9;4;13
622;23.05.2018;2018;05;01;Keskiviikko;4;0;4
622;23.05.2018;2018;05;02;Keskiviikko;3;0;3
622;23.05.2018;2018;05;03;Keskiviikko;1;1;2
622;23.05.2018;2018;05;04;Keskiviikko;2;0;2
622;23.05.2018;2018;05;05;Keskiviikko;1;5;6
622;23.05.2018;2018;05;06;Keskiviikko;4;22;26
622;23.05.2018;2018;05;07;Keskiviikko;18;72;90
622;23.05.2018;2018;05;08;Keskiviikko;69;91;160
622;23.05.2018;2018;05;09;Keskiviikko;52;95;147
622;23.05.2018;2018;05;10;Keskiviikko;22;37;59
622;23.05.2018;2018;05;11;Keskiviikko;23;27;50
622;23.05.2018;2018;05;12;Keskiviikko;21;29;50
622;23.05.2018;2018;05;13;Keskiviikko;50;60;110
622;23.05.2018;2018;05;14;Keskiviikko;45;54;99
622;23.05.2018;2018;05;15;Keskiviikko;53;44;97
622;23.05.2018;2018;05;16;Keskiviikko;95;70;165
622;23.05.2018;2018;05;17;Keskiviikko;122;79;201
622;23.05.2018;2018;05;18;Keskiviikko;68;53;121
622;23.05.2018;2018;05;19;Keskiviikko;55;37;92
622;23.05.2018;2018;05;20;Keskiviikko;36;25;61
622;23.05.2018;2018;05;21;Keskiviikko;46;37;83
622;23.05.2018;2018;05;22;Keskiviikko;37;13;50
622;23.05.2018;2018;05;23;Keskiviikko;13;6;19
622;24.05.2018;2018;05;00;Torstai;4;6;10
622;24.05.2018;2018;05;01;Torstai;3;3;6
622;24.05.2018;2018;05;02;Torstai;2;2;4
622;24.05.2018;2018;05;03;Torstai;0;1;1
622;24.05.2018;2018;05;04;Torstai;2;0;2
622;24.05.2018;2018;05;05;Torstai;0;2;2
622;24.05.2018;2018;05;06;Torstai;11;22;33
622;24.05.2018;2018;05;07;Torstai;20;68;88
622;24.05.2018;2018;05;08;Torstai;64;111;175
622;24.05.2018;2018;05;09;Torstai;51;100;151
622;24.05.2018;2018;05;10;Torstai;28;53;81
622;24.05.2018;2018;05;11;Torstai;36;29;65
622;24.05.2018;2018;05;12;Torstai;28;47;75
622;24.05.2018;2018;05;13;Torstai;34;58;92
622;24.05.2018;2018;05;14;Torstai;56;35;91
622;24.05.2018;2018;05;15;Torstai;62;36;98
622;24.05.2018;2018;05;16;Torstai;95;70;165
622;24.05.2018;2018;05;17;Torstai;108;55;163
622;24.05.2018;2018;05;18;Torstai;85;53;138
622;24.05.2018;2018;05;19;Torstai;69;65;134
622;24.05.2018;2018;05;20;Torstai;60;30;90
622;24.05.2018;2018;05;21;Torstai;47;33;80
622;24.05.2018;2018;05;22;Torstai;27;11;38
622;24.05.2018;2018;05;23;Torstai;19;7;26
622;25.05.2018;2018;05;00;Perjantai;14;5;19
622;25.05.2018;2018;05;01;Perjantai;2;0;2
622;25.05.2018;2018;05;02;Perjantai;4;4;8
622;25.05.2018;2018;05;03;Perjantai;8;4;12
622;25.05.2018;2018;05;04;Perjantai;2;0;2
622;25.05.2018;2018;05;05;Perjantai;0;3;3
622;25.05.2018;2018;05;06;Perjantai;2;19;21
622;25.05.2018;2018;05;07;Perjantai;19;63;82
622;25.05.2018;2018;05;08;Perjantai;64;88;152
622;25.05.2018;2018;05;09;Perjantai;62;83;145
622;25.05.2018;2018;05;10;Perjantai;25;39;64
622;25.05.2018;2018;05;11;Perjantai;21;28;49
622;25.05.2018;2018;05;12;Perjantai;37;50;87
622;25.05.2018;2018;05;13;Perjantai;33;51;84
622;25.05.2018;2018;05;14;Perjantai;38;63;101
622;25.05.2018;2018;05;15;Perjantai;82;52;134
622;25.05.2018;2018;05;16;Perjantai;107;47;154
622;25.05.2018;2018;05;17;Perjantai;98;78;176
622;25.05.2018;2018;05;18;Perjantai;70;78;148
622;25.05.2018;2018;05;19;Perjantai;66;59;125
622;25.05.2018;2018;05;20;Perjantai;35;27;62
622;25.05.2018;2018;05;21;Perjantai;47;40;87
622;25.05.2018;2018;05;22;Perjantai;40;20;60
622;25.05.2018;2018;05;23;Perjantai;23;9;32
622;26.05.2018;2018;05;00;Lauantai;21;17;38
622;26.05.2018;2018;05;01;Lauantai;18;5;23
622;26.05.2018;2018;05;02;Lauantai;11;1;12
622;26.05.2018;2018;05;03;Lauantai;13;2;15
622;26.05.2018;2018;05;04;Lauantai;6;1;7
622;26.05.2018;2018;05;05;Lauantai;2;2;4
622;26.05.2018;2018;05;06;Lauantai;1;2;3
622;26.05.2018;2018;05;07;Lauantai;4;13;17
622;26.05.2018;2018;05;08;Lauantai;5;9;14
622;26.05.2018;2018;05;09;Lauantai;11;16;27
622;26.05.2018;2018;05;10;Lauantai;17;32;49
622;26.05.2018;2018;05;11;Lauantai;22;39;61
622;26.05.2018;2018;05;12;Lauantai;22;63;85
622;26.05.2018;2018;05;13;Lauantai;37;67;104
622;26.05.2018;2018;05;14;Lauantai;65;57;122
622;26.05.2018;2018;05;15;Lauantai;57;58;115
622;26.05.2018;2018;05;16;Lauantai;56;52;108
622;26.05.2018;2018;05;17;Lauantai;69;44;113
622;26.05.2018;2018;05;18;Lauantai;58;33;91
622;26.05.2018;2018;05;19;Lauantai;32;30;62
622;26.05.2018;2018;05;20;Lauantai;28;24;52
622;26.05.2018;2018;05;21;Lauantai;17;11;28
622;26.05.2018;2018;05;22;Lauantai;25;19;44
622;26.05.2018;2018;05;23;Lauantai;13;5;18
622;27.05.2018;2018;05;00;Sunnuntai;18;0;18
622;27.05.2018;2018;05;01;Sunnuntai;14;0;14
622;27.05.2018;2018;05;02;Sunnuntai;6;0;6
622;27.05.2018;2018;05;03;Sunnuntai;8;0;8
622;27.05.2018;2018;05;04;Sunnuntai;3;0;3
622;27.05.2018;2018;05;05;Sunnuntai;7;0;7
622;27.05.2018;2018;05;06;Sunnuntai;6;0;6
622;27.05.2018;2018;05;07;Sunnuntai;12;0;12
622;27.05.2018;2018;05;08;Sunnuntai;9;0;9
622;27.05.2018;2018;05;09;Sunnuntai;11;0;11
622;27.05.2018;2018;05;10;Sunnuntai;26;0;26
622;27.05.2018;2018;05;11;Sunnuntai;46;0;46
622;27.05.2018;2018;05;12;Sunnuntai;65;0;65
622;27.05.2018;2018;05;13;Sunnuntai;105;0;105
622;27.05.2018;2018;05;14;Sunnuntai;72;0;72
622;27.05.2018;2018;05;15;Sunnuntai;118;0;118
622;27.05.2018;2018;05;16;Sunnuntai;99;0;99
622;27.05.2018;2018;05;17;Sunnuntai;89;0;89
622;27.05.2018;2018;05;18;Sunnuntai;90;0;90
622;27.05.2018;2018;05;19;Sunnuntai;86;0;86
622;27.05.2018;2018;05;20;Sunnuntai;79;0;79
622;27.05.2018;2018;05;21;Sunnuntai;68;0;68
622;27.05.2018;2018;05;22;Sunnuntai;54;0;54
622;27.05.2018;2018;05;23;Sunnuntai;12;0;12
622;28.05.2018;2018;05;00;Maanantai;9;0;9
622;28.05.2018;2018;05;01;Maanantai;11;0;11
622;28.05.2018;2018;05;02;Maanantai;3;0;3
622;28.05.2018;2018;05;03;Maanantai;0;0;0
622;28.05.2018;2018;05;04;Maanantai;3;0;3
622;28.05.2018;2018;05;05;Maanantai;1;0;1
622;28.05.2018;2018;05;06;Maanantai;28;0;28
622;28.05.2018;2018;05;07;Maanantai;97;0;97
622;28.05.2018;2018;05;08;Maanantai;180;0;180
622;28.05.2018;2018;05;09;Maanantai;152;0;152
622;28.05.2018;2018;05;10;Maanantai;97;0;97
622;28.05.2018;2018;05;11;Maanantai;63;0;63
622;28.05.2018;2018;05;12;Maanantai;73;0;73
622;28.05.2018;2018;05;13;Maanantai;114;0;114
622;28.05.2018;2018;05;14;Maanantai;94;0;94
622;28.05.2018;2018;05;15;Maanantai;121;0;121
622;28.05.2018;2018;05;16;Maanantai;171;0;171
622;28.05.2018;2018;05;17;Maanantai;200;0;200
622;28.05.2018;2018;05;18;Maanantai;170;0;170
622;28.05.2018;2018;05;19;Maanantai;131;0;131
622;28.05.2018;2018;05;20;Maanantai;126;0;126
622;28.05.2018;2018;05;21;Maanantai;79;0;79
622;28.05.2018;2018;05;22;Maanantai;68;0;68
622;28.05.2018;2018;05;23;Maanantai;17;0;17
622;29.05.2018;2018;05;00;Tiistai;9;3;12
622;29.05.2018;2018;05;01;Tiistai;2;2;4
622;29.05.2018;2018;05;02;Tiistai;0;0;0
622;29.05.2018;2018;05;03;Tiistai;2;0;2
622;29.05.2018;2018;05;04;Tiistai;1;0;1
622;29.05.2018;2018;05;05;Tiistai;0;0;0
622;29.05.2018;2018;05;06;Tiistai;3;15;18
622;29.05.2018;2018;05;07;Tiistai;20;82;102
622;29.05.2018;2018;05;08;Tiistai;67;113;180
622;29.05.2018;2018;05;09;Tiistai;54;95;149
622;29.05.2018;2018;05;10;Tiistai;46;64;110
622;29.05.2018;2018;05;11;Tiistai;50;88;138
622;29.05.2018;2018;05;12;Tiistai;41;58;99
622;29.05.2018;2018;05;13;Tiistai;77;69;146
622;29.05.2018;2018;05;14;Tiistai;73;63;136
622;29.05.2018;2018;05;15;Tiistai;94;66;160
622;29.05.2018;2018;05;16;Tiistai;111;64;175
622;29.05.2018;2018;05;17;Tiistai;135;67;202
622;29.05.2018;2018;05;18;Tiistai;89;72;161
622;29.05.2018;2018;05;19;Tiistai;57;53;110
622;29.05.2018;2018;05;20;Tiistai;65;40;105
622;29.05.2018;2018;05;21;Tiistai;55;26;81
622;29.05.2018;2018;05;22;Tiistai;43;16;59
622;29.05.2018;2018;05;23;Tiistai;19;7;26
622;30.05.2018;2018;05;00;Keskiviikko;14;6;20
622;30.05.2018;2018;05;01;Keskiviikko;3;2;5
622;30.05.2018;2018;05;02;Keskiviikko;3;2;5
622;30.05.2018;2018;05;03;Keskiviikko;3;1;4
622;30.05.2018;2018;05;04;Keskiviikko;0;0;0
622;30.05.2018;2018;05;05;Keskiviikko;1;5;6
622;30.05.2018;2018;05;06;Keskiviikko;1;17;18
622;30.05.2018;2018;05;07;Keskiviikko;15;83;98
622;30.05.2018;2018;05;08;Keskiviikko;55;100;155
622;30.05.2018;2018;05;09;Keskiviikko;50;97;147
622;30.05.2018;2018;05;10;Keskiviikko;22;39;61
622;30.05.2018;2018;05;11;Keskiviikko;26;39;65
622;30.05.2018;2018;05;12;Keskiviikko;37;38;75
622;30.05.2018;2018;05;13;Keskiviikko;56;63;119
622;30.05.2018;2018;05;14;Keskiviikko;44;38;82
622;30.05.2018;2018;05;15;Keskiviikko;52;44;96
622;30.05.2018;2018;05;16;Keskiviikko;109;63;172
622;30.05.2018;2018;05;17;Keskiviikko;115;58;173
622;30.05.2018;2018;05;18;Keskiviikko;90;63;153
622;30.05.2018;2018;05;19;Keskiviikko;74;44;118
622;30.05.2018;2018;05;20;Keskiviikko;56;29;85
622;30.05.2018;2018;05;21;Keskiviikko;29;28;57
622;30.05.2018;2018;05;22;Keskiviikko;39;11;50
622;30.05.2018;2018;05;23;Keskiviikko;13;9;22
622;31.05.2018;2018;05;00;Torstai;9;7;16
622;31.05.2018;2018;05;01;Torstai;3;3;6
622;31.05.2018;2018;05;02;Torstai;2;2;4
622;31.05.2018;2018;05;03;Torstai;0;0;0
622;31.05.2018;2018;05;04;Torstai;3;2;5
622;31.05.2018;2018;05;05;Torstai;1;3;4
622;31.05.2018;2018;05;06;Torstai;2;20;22
622;31.05.2018;2018;05;07;Torstai;30;69;99
622;31.05.2018;2018;05;08;Torstai;69;73;142
622;31.05.2018;2018;05;09;Torstai;71;103;174
622;31.05.2018;2018;05;10;Torstai;49;102;151
622;31.05.2018;2018;05;11;Torstai;48;55;103
622;31.05.2018;2018;05;12;Torstai;56;53;109
622;31.05.2018;2018;05;13;Torstai;57;70;127
622;31.05.2018;2018;05;14;Torstai;73;48;121
622;31.05.2018;2018;05;15;Torstai;60;37;97
622;31.05.2018;2018;05;16;Torstai;108;62;170
622;31.05.2018;2018;05;17;Torstai;103;77;180
622;31.05.2018;2018;05;18;Torstai;90;58;148
622;31.05.2018;2018;05;19;Torstai;53;40;93
622;31.05.2018;2018;05;20;Torstai;60;28;88
622;31.05.2018;2018;05;21;Torstai;45;21;66
622;31.05.2018;2018;05;22;Torstai;39;24;63
622;31.05.2018;2018;05;23;Torstai;22;7;29
622;01.06.2018;2018;06;00;Perjantai;8;10;18
622;01.06.2018;2018;06;01;Perjantai;6;8;14
622;01.06.2018;2018;06;02;Perjantai;2;0;2
622;01.06.2018;2018;06;03;Perjantai;2;1;3
622;01.06.2018;2018;06;04;Perjantai;2;0;2
622;01.06.2018;2018;06;05;Perjantai;4;3;7
622;01.06.2018;2018;06;06;Perjantai;3;15;18
622;01.06.2018;2018;06;07;Perjantai;16;53;69
622;01.06.2018;2018;06;08;Perjantai;34;86;120
622;01.06.2018;2018;06;09;Perjantai;62;90;152
622;01.06.2018;2018;06;10;Perjantai;26;56;82
622;01.06.2018;2018;06;11;Perjantai;34;40;74
622;01.06.2018;2018;06;12;Perjantai;45;36;81
622;01.06.2018;2018;06;13;Perjantai;47;62;109
622;01.06.2018;2018;06;14;Perjantai;56;67;123
622;01.06.2018;2018;06;15;Perjantai;81;42;123
622;01.06.2018;2018;06;16;Perjantai;53;55;108
622;01.06.2018;2018;06;17;Perjantai;109;57;166
622;01.06.2018;2018;06;18;Perjantai;95;86;181
622;01.06.2018;2018;06;19;Perjantai;69;39;108
622;01.06.2018;2018;06;20;Perjantai;58;40;98
622;01.06.2018;2018;06;21;Perjantai;48;29;77
622;01.06.2018;2018;06;22;Perjantai;31;18;49
622;01.06.2018;2018;06;23;Perjantai;19;11;30
622;02.06.2018;2018;06;00;Lauantai;21;8;29
622;02.06.2018;2018;06;01;Lauantai;15;8;23
622;02.06.2018;2018;06;02;Lauantai;8;3;11
622;02.06.2018;2018;06;03;Lauantai;12;4;16
622;02.06.2018;2018;06;04;Lauantai;6;1;7
622;02.06.2018;2018;06;05;Lauantai;5;6;11
622;02.06.2018;2018;06;06;Lauantai;1;8;9
622;02.06.2018;2018;06;07;Lauantai;5;10;15
622;02.06.2018;2018;06;08;Lauantai;12;8;20
622;02.06.2018;2018;06;09;Lauantai;28;31;59
622;02.06.2018;2018;06;10;Lauantai;31;22;53
622;02.06.2018;2018;06;11;Lauantai;19;52;71
622;02.06.2018;2018;06;12;Lauantai;37;42;79
622;02.06.2018;2018;06;13;Lauantai;58;86;144
622;02.06.2018;2018;06;14;Lauantai;69;61;130
622;02.06.2018;2018;06;15;Lauantai;64;69;133
622;02.06.2018;2018;06;16;Lauantai;78;86;164
622;02.06.2018;2018;06;17;Lauantai;76;58;134
622;02.06.2018;2018;06;18;Lauantai;84;56;140
622;02.06.2018;2018;06;19;Lauantai;67;49;116
622;02.06.2018;2018;06;20;Lauantai;47;57;104
622;02.06.2018;2018;06;21;Lauantai;53;48;101
622;02.06.2018;2018;06;22;Lauantai;34;19;53
622;02.06.2018;2018;06;23;Lauantai;22;16;38
622;03.06.2018;2018;06;00;Sunnuntai;14;9;23
622;03.06.2018;2018;06;01;Sunnuntai;17;11;28
622;03.06.2018;2018;06;02;Sunnuntai;22;3;25
622;03.06.2018;2018;06;03;Sunnuntai;19;4;23
622;03.06.2018;2018;06;04;Sunnuntai;12;4;16
622;03.06.2018;2018;06;05;Sunnuntai;4;2;6
622;03.06.2018;2018;06;06;Sunnuntai;8;5;13
622;03.06.2018;2018;06;07;Sunnuntai;11;11;22
622;03.06.2018;2018;06;08;Sunnuntai;11;4;15
622;03.06.2018;2018;06;09;Sunnuntai;4;12;16
622;03.06.2018;2018;06;10;Sunnuntai;22;13;35
622;03.06.2018;2018;06;11;Sunnuntai;19;23;42
622;03.06.2018;2018;06;12;Sunnuntai;54;41;95
622;03.06.2018;2018;06;13;Sunnuntai;41;69;110
622;03.06.2018;2018;06;14;Sunnuntai;46;57;103
622;03.06.2018;2018;06;15;Sunnuntai;51;53;104
622;03.06.2018;2018;06;16;Sunnuntai;51;49;100
622;03.06.2018;2018;06;17;Sunnuntai;45;47;92
622;03.06.2018;2018;06;18;Sunnuntai;47;35;82
622;03.06.2018;2018;06;19;Sunnuntai;38;38;76
622;03.06.2018;2018;06;20;Sunnuntai;36;22;58
622;03.06.2018;2018;06;21;Sunnuntai;16;14;30
622;03.06.2018;2018;06;22;Sunnuntai;26;5;31
622;03.06.2018;2018;06;23;Sunnuntai;7;1;8
622;04.06.2018;2018;06;00;Maanantai;7;1;8
622;04.06.2018;2018;06;01;Maanantai;1;1;2
622;04.06.2018;2018;06;02;Maanantai;3;2;5
622;04.06.2018;2018;06;03;Maanantai;0;0;0
622;04.06.2018;2018;06;04;Maanantai;4;0;4
622;04.06.2018;2018;06;05;Maanantai;0;2;2
622;04.06.2018;2018;06;06;Maanantai;5;15;20
622;04.06.2018;2018;06;07;Maanantai;17;62;79
622;04.06.2018;2018;06;08;Maanantai;30;54;84
622;04.06.2018;2018;06;09;Maanantai;29;52;81
622;04.06.2018;2018;06;10;Maanantai;7;28;35
622;04.06.2018;2018;06;11;Maanantai;9;28;37
622;04.06.2018;2018;06;12;Maanantai;13;16;29
622;04.06.2018;2018;06;13;Maanantai;19;19;38
622;04.06.2018;2018;06;14;Maanantai;19;17;36
622;04.06.2018;2018;06;15;Maanantai;29;18;47
622;04.06.2018;2018;06;16;Maanantai;57;39;96
622;04.06.2018;2018;06;17;Maanantai;56;31;87
622;04.06.2018;2018;06;18;Maanantai;30;28;58
622;04.06.2018;2018;06;19;Maanantai;25;15;40
622;04.06.2018;2018;06;20;Maanantai;23;14;37
622;04.06.2018;2018;06;21;Maanantai;12;5;17
622;04.06.2018;2018;06;22;Maanantai;17;8;25
622;04.06.2018;2018;06;23;Maanantai;6;2;8
622;05.06.2018;2018;06;00;Tiistai;12;8;20
622;05.06.2018;2018;06;01;Tiistai;3;1;4
622;05.06.2018;2018;06;02;Tiistai;3;0;3
622;05.06.2018;2018;06;03;Tiistai;0;2;2
622;05.06.2018;2018;06;04;Tiistai;0;0;0
622;05.06.2018;2018;06;05;Tiistai;1;2;3
622;05.06.2018;2018;06;06;Tiistai;5;10;15
622;05.06.2018;2018;06;07;Tiistai;18;44;62
622;05.06.2018;2018;06;08;Tiistai;22;69;91
622;05.06.2018;2018;06;09;Tiistai;21;50;71
622;05.06.2018;2018;06;10;Tiistai;9;23;32
622;05.06.2018;2018;06;11;Tiistai;17;28;45
622;05.06.2018;2018;06;12;Tiistai;19;27;46
622;05.06.2018;2018;06;13;Tiistai;29;38;67
622;05.06.2018;2018;06;14;Tiistai;34;38;72
622;05.06.2018;2018;06;15;Tiistai;40;19;59
622;05.06.2018;2018;06;16;Tiistai;74;46;120
622;05.06.2018;2018;06;17;Tiistai;88;51;139
622;05.06.2018;2018;06;18;Tiistai;35;26;61
622;05.06.2018;2018;06;19;Tiistai;43;31;74
622;05.06.2018;2018;06;20;Tiistai;39;20;59
622;05.06.2018;2018;06;21;Tiistai;35;17;52
622;05.06.2018;2018;06;22;Tiistai;26;5;31
622;05.06.2018;2018;06;23;Tiistai;10;4;14
622;06.06.2018;2018;06;00;Keskiviikko;9;5;14
622;06.06.2018;2018;06;01;Keskiviikko;6;4;10
622;06.06.2018;2018;06;02;Keskiviikko;1;3;4
622;06.06.2018;2018;06;03;Keskiviikko;5;1;6
622;06.06.2018;2018;06;04;Keskiviikko;1;1;2
622;06.06.2018;2018;06;05;Keskiviikko;1;4;5
622;06.06.2018;2018;06;06;Keskiviikko;3;16;19
622;06.06.2018;2018;06;07;Keskiviikko;21;59;80
622;06.06.2018;2018;06;08;Keskiviikko;44;54;98
622;06.06.2018;2018;06;09;Keskiviikko;30;52;82
622;06.06.2018;2018;06;10;Keskiviikko;22;41;63
622;06.06.2018;2018;06;11;Keskiviikko;8;21;29
622;06.06.2018;2018;06;12;Keskiviikko;28;19;47
622;06.06.2018;2018;06;13;Keskiviikko;16;21;37
622;06.06.2018;2018;06;14;Keskiviikko;37;37;74
622;06.06.2018;2018;06;15;Keskiviikko;36;29;65
622;06.06.2018;2018;06;16;Keskiviikko;75;49;124
622;06.06.2018;2018;06;17;Keskiviikko;83;46;129
622;06.06.2018;2018;06;18;Keskiviikko;45;27;72
622;06.06.2018;2018;06;19;Keskiviikko;56;37;93
622;06.06.2018;2018;06;20;Keskiviikko;28;31;59
622;06.06.2018;2018;06;21;Keskiviikko;28;18;46
622;06.06.2018;2018;06;22;Keskiviikko;24;9;33
622;06.06.2018;2018;06;23;Keskiviikko;16;4;20
622;07.06.2018;2018;06;00;Torstai;3;3;6
622;07.06.2018;2018;06;01;Torstai;5;1;6
622;07.06.2018;2018;06;02;Torstai;1;2;3
622;07.06.2018;2018;06;03;Torstai;2;0;2
622;07.06.2018;2018;06;04;Torstai;1;2;3
622;07.06.2018;2018;06;05;Torstai;0;2;2
622;07.06.2018;2018;06;06;Torstai;4;21;25
622;07.06.2018;2018;06;07;Torstai;22;27;49
622;07.06.2018;2018;06;08;Torstai;18;38;56
622;07.06.2018;2018;06;09;Torstai;21;27;48
622;07.06.2018;2018;06;10;Torstai;13;10;23
622;07.06.2018;2018;06;11;Torstai;10;13;23
622;07.06.2018;2018;06;12;Torstai;6;12;18
622;07.06.2018;2018;06;13;Torstai;12;14;26
622;07.06.2018;2018;06;14;Torstai;14;18;32
622;07.06.2018;2018;06;15;Torstai;25;25;50
622;07.06.2018;2018;06;16;Torstai;57;33;90
622;07.06.2018;2018;06;17;Torstai;54;37;91
622;07.06.2018;2018;06;18;Torstai;38;30;68
622;07.06.2018;2018;06;19;Torstai;31;20;51
622;07.06.2018;2018;06;20;Torstai;23;21;44
622;07.06.2018;2018;06;21;Torstai;29;15;44
622;07.06.2018;2018;06;22;Torstai;16;5;21
622;07.06.2018;2018;06;23;Torstai;15;3;18
622;08.06.2018;2018;06;00;Perjantai;6;2;8
622;08.06.2018;2018;06;01;Perjantai;3;0;3
622;08.06.2018;2018;06;02;Perjantai;3;0;3
622;08.06.2018;2018;06;03;Perjantai;0;2;2
622;08.06.2018;2018;06;04;Perjantai;2;0;2
622;08.06.2018;2018;06;05;Perjantai;2;2;4
622;08.06.2018;2018;06;06;Perjantai;0;9;9
622;08.06.2018;2018;06;07;Perjantai;21;41;62
622;08.06.2018;2018;06;08;Perjantai;28;53;81
622;08.06.2018;2018;06;09;Perjantai;28;54;82
622;08.06.2018;2018;06;10;Perjantai;19;34;53
622;08.06.2018;2018;06;11;Perjantai;20;36;56
622;08.06.2018;2018;06;12;Perjantai;37;28;65
622;08.06.2018;2018;06;13;Perjantai;29;39;68
622;08.06.2018;2018;06;14;Perjantai;37;45;82
622;08.06.2018;2018;06;15;Perjantai;54;40;94
622;08.06.2018;2018;06;16;Perjantai;82;62;144
622;08.06.2018;2018;06;17;Perjantai;72;60;132
622;08.06.2018;2018;06;18;Perjantai;69;62;131
622;08.06.2018;2018;06;19;Perjantai;51;38;89
622;08.06.2018;2018;06;20;Perjantai;31;34;65
622;08.06.2018;2018;06;21;Perjantai;35;22;57
622;08.06.2018;2018;06;22;Perjantai;41;21;62
622;08.06.2018;2018;06;23;Perjantai;13;9;22
622;09.06.2018;2018;06;00;Lauantai;18;5;23
622;09.06.2018;2018;06;01;Lauantai;18;10;28
622;09.06.2018;2018;06;02;Lauantai;7;3;10
622;09.06.2018;2018;06;03;Lauantai;8;2;10
622;09.06.2018;2018;06;04;Lauantai;6;0;6
622;09.06.2018;2018;06;05;Lauantai;3;1;4
622;09.06.2018;2018;06;06;Lauantai;9;0;9
622;09.06.2018;2018;06;07;Lauantai;15;0;15
622;09.06.2018;2018;06;08;Lauantai;20;0;20
622;09.06.2018;2018;06;09;Lauantai;59;0;59
622;09.06.2018;2018;06;10;Lauantai;53;0;53
622;09.06.2018;2018;06;11;Lauantai;71;0;71
622;09.06.2018;2018;06;12;Lauantai;79;0;79
622;09.06.2018;2018;06;13;Lauantai;144;0;144
622;09.06.2018;2018;06;14;Lauantai;130;0;130
622;09.06.2018;2018;06;15;Lauantai;133;0;133
622;09.06.2018;2018;06;16;Lauantai;164;0;164
622;09.06.2018;2018;06;17;Lauantai;134;0;134
622;09.06.2018;2018;06;18;Lauantai;140;0;140
622;09.06.2018;2018;06;19;Lauantai;116;0;116
622;09.06.2018;2018;06;20;Lauantai;104;0;104
622;09.06.2018;2018;06;21;Lauantai;101;0;101
622;09.06.2018;2018;06;22;Lauantai;53;0;53
622;09.06.2018;2018;06;23;Lauantai;38;0;38
622;10.06.2018;2018;06;00;Sunnuntai;23;0;23
622;10.06.2018;2018;06;01;Sunnuntai;28;0;28
622;10.06.2018;2018;06;02;Sunnuntai;25;0;25
622;10.06.2018;2018;06;03;Sunnuntai;23;0;23
622;10.06.2018;2018;06;04;Sunnuntai;16;0;16
622;10.06.2018;2018;06;05;Sunnuntai;6;0;6
622;10.06.2018;2018;06;06;Sunnuntai;13;0;13
622;10.06.2018;2018;06;07;Sunnuntai;22;0;22
622;10.06.2018;2018;06;08;Sunnuntai;15;0;15
622;10.06.2018;2018;06;09;Sunnuntai;16;0;16
622;10.06.2018;2018;06;10;Sunnuntai;35;0;35
622;10.06.2018;2018;06;11;Sunnuntai;42;0;42
622;10.06.2018;2018;06;12;Sunnuntai;95;0;95
622;10.06.2018;2018;06;13;Sunnuntai;110;0;110
622;10.06.2018;2018;06;14;Sunnuntai;103;0;103
622;10.06.2018;2018;06;15;Sunnuntai;104;0;104
622;10.06.2018;2018;06;16;Sunnuntai;100;0;100
622;10.06.2018;2018;06;17;Sunnuntai;92;0;92
622;10.06.2018;2018;06;18;Sunnuntai;82;0;82
622;10.06.2018;2018;06;19;Sunnuntai;76;0;76
622;10.06.2018;2018;06;20;Sunnuntai;58;0;58
622;10.06.2018;2018;06;21;Sunnuntai;30;0;30
622;10.06.2018;2018;06;22;Sunnuntai;31;0;31
622;10.06.2018;2018;06;23;Sunnuntai;8;0;8
622;11.06.2018;2018;06;00;Maanantai;7;6;13
622;11.06.2018;2018;06;01;Maanantai;9;1;10
622;11.06.2018;2018;06;02;Maanantai;2;4;6
622;11.06.2018;2018;06;03;Maanantai;3;3;6
622;11.06.2018;2018;06;04;Maanantai;4;1;5
622;11.06.2018;2018;06;05;Maanantai;1;4;5
622;11.06.2018;2018;06;06;Maanantai;5;17;22
622;11.06.2018;2018;06;07;Maanantai;29;68;97
622;11.06.2018;2018;06;08;Maanantai;40;98;138
622;11.06.2018;2018;06;09;Maanantai;46;80;126
622;11.06.2018;2018;06;10;Maanantai;25;42;67
622;11.06.2018;2018;06;11;Maanantai;21;34;55
622;11.06.2018;2018;06;12;Maanantai;36;45;81
622;11.06.2018;2018;06;13;Maanantai;30;56;86
622;11.06.2018;2018;06;14;Maanantai;53;43;96
622;11.06.2018;2018;06;15;Maanantai;44;44;88
622;11.06.2018;2018;06;16;Maanantai;100;52;152
622;11.06.2018;2018;06;17;Maanantai;124;72;196
622;11.06.2018;2018;06;18;Maanantai;80;67;147
622;11.06.2018;2018;06;19;Maanantai;68;64;132
622;11.06.2018;2018;06;20;Maanantai;66;47;113
622;11.06.2018;2018;06;21;Maanantai;50;25;75
622;11.06.2018;2018;06;22;Maanantai;50;35;85
622;11.06.2018;2018;06;23;Maanantai;12;13;25
622;12.06.2018;2018;06;00;Tiistai;7;6;13
622;12.06.2018;2018;06;01;Tiistai;9;1;10
622;12.06.2018;2018;06;02;Tiistai;2;4;6
622;12.06.2018;2018;06;03;Tiistai;3;3;6
622;12.06.2018;2018;06;04;Tiistai;4;1;5
622;12.06.2018;2018;06;05;Tiistai;1;4;5
622;12.06.2018;2018;06;06;Tiistai;5;17;22
622;12.06.2018;2018;06;07;Tiistai;29;68;97
622;12.06.2018;2018;06;08;Tiistai;40;98;138
622;12.06.2018;2018;06;09;Tiistai;46;80;126
622;12.06.2018;2018;06;10;Tiistai;25;42;67
622;12.06.2018;2018;06;11;Tiistai;21;34;55
622;12.06.2018;2018;06;12;Tiistai;36;45;81
622;12.06.2018;2018;06;13;Tiistai;30;47;77
622;12.06.2018;2018;06;14;Tiistai;46;52;98
622;12.06.2018;2018;06;15;Tiistai;66;31;97
622;12.06.2018;2018;06;16;Tiistai;87;59;146
622;12.06.2018;2018;06;17;Tiistai;106;72;178
622;12.06.2018;2018;06;18;Tiistai;75;50;125
622;12.06.2018;2018;06;19;Tiistai;63;39;102
622;12.06.2018;2018;06;20;Tiistai;56;39;95
622;12.06.2018;2018;06;21;Tiistai;44;22;66
622;12.06.2018;2018;06;22;Tiistai;37;27;64
622;12.06.2018;2018;06;23;Tiistai;18;7;25
622;13.06.2018;2018;06;00;Keskiviikko;6;1;7
622;13.06.2018;2018;06;01;Keskiviikko;4;1;5
622;13.06.2018;2018;06;02;Keskiviikko;0;2;2
622;13.06.2018;2018;06;03;Keskiviikko;0;0;0
622;13.06.2018;2018;06;04;Keskiviikko;2;5;7
622;13.06.2018;2018;06;05;Keskiviikko;3;2;5
622;13.06.2018;2018;06;06;Keskiviikko;5;19;24
622;13.06.2018;2018;06;07;Keskiviikko;22;58;80
622;13.06.2018;2018;06;08;Keskiviikko;31;70;101
622;13.06.2018;2018;06;09;Keskiviikko;39;78;117
622;13.06.2018;2018;06;10;Keskiviikko;22;48;70
622;13.06.2018;2018;06;11;Keskiviikko;23;38;61
622;13.06.2018;2018;06;12;Keskiviikko;28;31;59
622;13.06.2018;2018;06;13;Keskiviikko;43;48;91
622;13.06.2018;2018;06;14;Keskiviikko;58;31;89
622;13.06.2018;2018;06;15;Keskiviikko;60;61;121
622;13.06.2018;2018;06;16;Keskiviikko;107;84;191
622;13.06.2018;2018;06;17;Keskiviikko;100;96;196
622;13.06.2018;2018;06;18;Keskiviikko;102;49;151
622;13.06.2018;2018;06;19;Keskiviikko;64;54;118
622;13.06.2018;2018;06;20;Keskiviikko;68;53;121
622;13.06.2018;2018;06;21;Keskiviikko;70;46;116
622;13.06.2018;2018;06;22;Keskiviikko;53;27;80
622;13.06.2018;2018;06;23;Keskiviikko;19;9;28
622;14.06.2018;2018;06;00;Torstai;14;10;24
622;14.06.2018;2018;06;01;Torstai;10;3;13
622;14.06.2018;2018;06;02;Torstai;5;4;9
622;14.06.2018;2018;06;03;Torstai;2;4;6
622;14.06.2018;2018;06;04;Torstai;3;0;3
622;14.06.2018;2018;06;05;Torstai;0;4;4
622;14.06.2018;2018;06;06;Torstai;2;18;20
622;14.06.2018;2018;06;07;Torstai;29;79;108
622;14.06.2018;2018;06;08;Torstai;43;103;146
622;14.06.2018;2018;06;09;Torstai;39;73;112
622;14.06.2018;2018;06;10;Torstai;27;59;86
622;14.06.2018;2018;06;11;Torstai;33;65;98
622;14.06.2018;2018;06;12;Torstai;31;62;93
622;14.06.2018;2018;06;13;Torstai;49;79;128
622;14.06.2018;2018;06;14;Torstai;53;56;109
622;14.06.2018;2018;06;15;Torstai;65;78;143
622;14.06.2018;2018;06;16;Torstai;117;95;212
622;14.06.2018;2018;06;17;Torstai;154;87;241
622;14.06.2018;2018;06;18;Torstai;83;62;145
622;14.06.2018;2018;06;19;Torstai;79;64;143
622;14.06.2018;2018;06;20;Torstai;68;53;121
622;14.06.2018;2018;06;21;Torstai;75;35;110
622;14.06.2018;2018;06;22;Torstai;51;19;70
622;14.06.2018;2018;06;23;Torstai;33;6;39
622;15.06.2018;2018;06;00;Perjantai;19;5;24
622;15.06.2018;2018;06;01;Perjantai;5;5;10
622;15.06.2018;2018;06;02;Perjantai;5;5;10
622;15.06.2018;2018;06;03;Perjantai;4;3;7
622;15.06.2018;2018;06;04;Perjantai;2;0;2
622;15.06.2018;2018;06;05;Perjantai;1;6;7
622;15.06.2018;2018;06;06;Perjantai;6;22;28
622;15.06.2018;2018;06;07;Perjantai;19;70;89
622;15.06.2018;2018;06;08;Perjantai;30;89;119
622;15.06.2018;2018;06;09;Perjantai;30;64;94
622;15.06.2018;2018;06;10;Perjantai;25;40;65
622;15.06.2018;2018;06;11;Perjantai;32;37;69
622;15.06.2018;2018;06;12;Perjantai;49;59;108
622;15.06.2018;2018;06;13;Perjantai;53;70;123
622;15.06.2018;2018;06;14;Perjantai;70;65;135
622;15.06.2018;2018;06;15;Perjantai;20;20;40
622;15.06.2018;2018;06;16;Perjantai;147;109;256
622;15.06.2018;2018;06;17;Perjantai;101;35;136
622;15.06.2018;2018;06;18;Perjantai;65;65;130
622;15.06.2018;2018;06;19;Perjantai;45;56;101
622;15.06.2018;2018;06;20;Perjantai;34;33;67
622;15.06.2018;2018;06;21;Perjantai;51;45;96
622;15.06.2018;2018;06;22;Perjantai;43;33;76
622;15.06.2018;2018;06;23;Perjantai;26;15;41
622;16.06.2018;2018;06;00;Lauantai;29;25;54
622;16.06.2018;2018;06;01;Lauantai;34;15;49
622;16.06.2018;2018;06;02;Lauantai;20;10;30
622;16.06.2018;2018;06;03;Lauantai;12;1;13
622;16.06.2018;2018;06;04;Lauantai;5;1;6
622;16.06.2018;2018;06;05;Lauantai;6;2;8
622;16.06.2018;2018;06;06;Lauantai;9;7;16
622;16.06.2018;2018;06;07;Lauantai;7;14;21
622;16.06.2018;2018;06;08;Lauantai;4;17;21
622;16.06.2018;2018;06;09;Lauantai;10;22;32
622;16.06.2018;2018;06;10;Lauantai;29;39;68
622;16.06.2018;2018;06;11;Lauantai;36;57;93
622;16.06.2018;2018;06;12;Lauantai;45;83;128
622;16.06.2018;2018;06;13;Lauantai;61;63;124
622;16.06.2018;2018;06;14;Lauantai;79;88;167
622;16.06.2018;2018;06;15;Lauantai;84;87;171
622;16.06.2018;2018;06;16;Lauantai;102;91;193
622;16.06.2018;2018;06;17;Lauantai;95;62;157
622;16.06.2018;2018;06;18;Lauantai;63;67;130
622;16.06.2018;2018;06;19;Lauantai;89;74;163
622;16.06.2018;2018;06;20;Lauantai;58;62;120
622;16.06.2018;2018;06;21;Lauantai;59;56;115
622;16.06.2018;2018;06;22;Lauantai;31;43;74
622;16.06.2018;2018;06;23;Lauantai;43;17;60
622;17.06.2018;2018;06;00;Sunnuntai;35;21;56
622;17.06.2018;2018;06;01;Sunnuntai;28;3;31
622;17.06.2018;2018;06;02;Sunnuntai;22;12;34
622;17.06.2018;2018;06;03;Sunnuntai;15;7;22
622;17.06.2018;2018;06;04;Sunnuntai;21;6;27
622;17.06.2018;2018;06;05;Sunnuntai;6;3;9
622;17.06.2018;2018;06;06;Sunnuntai;3;10;13
622;17.06.2018;2018;06;07;Sunnuntai;5;9;14
622;17.06.2018;2018;06;08;Sunnuntai;4;8;12
622;17.06.2018;2018;06;09;Sunnuntai;8;14;22
622;17.06.2018;2018;06;10;Sunnuntai;16;32;48
622;17.06.2018;2018;06;11;Sunnuntai;34;41;75
622;17.06.2018;2018;06;12;Sunnuntai;41;72;113
622;17.06.2018;2018;06;13;Sunnuntai;72;95;167
622;17.06.2018;2018;06;14;Sunnuntai;100;66;166
622;17.06.2018;2018;06;15;Sunnuntai;117;112;229
622;17.06.2018;2018;06;16;Sunnuntai;88;81;169
622;17.06.2018;2018;06;17;Sunnuntai;92;103;195
622;17.06.2018;2018;06;18;Sunnuntai;85;95;180
622;17.06.2018;2018;06;19;Sunnuntai;101;66;167
622;17.06.2018;2018;06;20;Sunnuntai;110;84;194
622;17.06.2018;2018;06;21;Sunnuntai;66;51;117
622;17.06.2018;2018;06;22;Sunnuntai;44;17;61
622;17.06.2018;2018;06;23;Sunnuntai;24;13;37
622;18.06.2018;2018;06;00;Maanantai;13;7;20
622;18.06.2018;2018;06;01;Maanantai;8;5;13
622;18.06.2018;2018;06;02;Maanantai;6;4;10
622;18.06.2018;2018;06;03;Maanantai;5;1;6
622;18.06.2018;2018;06;04;Maanantai;4;4;8
622;18.06.2018;2018;06;05;Maanantai;1;5;6
622;18.06.2018;2018;06;06;Maanantai;2;20;22
622;18.06.2018;2018;06;07;Maanantai;27;70;97
622;18.06.2018;2018;06;08;Maanantai;48;84;132
622;18.06.2018;2018;06;09;Maanantai;48;66;114
622;18.06.2018;2018;06;10;Maanantai;18;31;49
622;18.06.2018;2018;06;11;Maanantai;16;22;38
622;18.06.2018;2018;06;12;Maanantai;15;27;42
622;18.06.2018;2018;06;13;Maanantai;34;29;63
622;18.06.2018;2018;06;14;Maanantai;44;45;89
622;18.06.2018;2018;06;15;Maanantai;50;53;103
622;18.06.2018;2018;06;16;Maanantai;107;80;187
622;18.06.2018;2018;06;17;Maanantai;103;66;169
622;18.06.2018;2018;06;18;Maanantai;79;77;156
622;18.06.2018;2018;06;19;Maanantai;58;42;100
622;18.06.2018;2018;06;20;Maanantai;39;21;60
622;18.06.2018;2018;06;21;Maanantai;35;34;69
622;18.06.2018;2018;06;22;Maanantai;29;13;42
622;18.06.2018;2018;06;23;Maanantai;23;9;32
622;19.06.2018;2018;06;00;Tiistai;12;7;19
622;19.06.2018;2018;06;01;Tiistai;2;1;3
622;19.06.2018;2018;06;02;Tiistai;2;1;3
622;19.06.2018;2018;06;03;Tiistai;3;2;5
622;19.06.2018;2018;06;04;Tiistai;4;1;5
622;19.06.2018;2018;06;05;Tiistai;1;6;7
622;19.06.2018;2018;06;06;Tiistai;4;21;25
622;19.06.2018;2018;06;07;Tiistai;23;72;95
622;19.06.2018;2018;06;08;Tiistai;36;80;116
622;19.06.2018;2018;06;09;Tiistai;39;76;115
622;19.06.2018;2018;06;10;Tiistai;36;54;90
622;19.06.2018;2018;06;11;Tiistai;38;41;79
622;19.06.2018;2018;06;12;Tiistai;31;32;63
622;19.06.2018;2018;06;13;Tiistai;34;33;67
622;19.06.2018;2018;06;14;Tiistai;34;27;61
622;19.06.2018;2018;06;15;Tiistai;48;23;71
622;19.06.2018;2018;06;16;Tiistai;63;39;102
622;19.06.2018;2018;06;17;Tiistai;64;38;102
622;19.06.2018;2018;06;18;Tiistai;37;25;62
622;19.06.2018;2018;06;19;Tiistai;32;38;70
622;19.06.2018;2018;06;20;Tiistai;33;25;58
622;19.06.2018;2018;06;21;Tiistai;34;15;49
622;19.06.2018;2018;06;22;Tiistai;21;8;29
622;19.06.2018;2018;06;23;Tiistai;10;5;15
622;20.06.2018;2018;06;00;Keskiviikko;5;2;7
622;20.06.2018;2018;06;01;Keskiviikko;2;3;5
622;20.06.2018;2018;06;02;Keskiviikko;4;3;7
622;20.06.2018;2018;06;03;Keskiviikko;1;0;1
622;20.06.2018;2018;06;04;Keskiviikko;3;1;4
622;20.06.2018;2018;06;05;Keskiviikko;0;5;5
622;20.06.2018;2018;06;06;Keskiviikko;2;16;18
622;20.06.2018;2018;06;07;Keskiviikko;32;47;79
622;20.06.2018;2018;06;08;Keskiviikko;42;69;111
622;20.06.2018;2018;06;09;Keskiviikko;28;64;92
622;20.06.2018;2018;06;10;Keskiviikko;27;41;68
622;20.06.2018;2018;06;11;Keskiviikko;27;38;65
622;20.06.2018;2018;06;12;Keskiviikko;33;54;87
622;20.06.2018;2018;06;13;Keskiviikko;37;68;105
622;20.06.2018;2018;06;14;Keskiviikko;49;44;93
622;20.06.2018;2018;06;15;Keskiviikko;70;49;119
622;20.06.2018;2018;06;16;Keskiviikko;106;77;183
622;20.06.2018;2018;06;17;Keskiviikko;98;81;179
622;20.06.2018;2018;06;18;Keskiviikko;76;74;150
622;20.06.2018;2018;06;19;Keskiviikko;65;44;109
622;20.06.2018;2018;06;20;Keskiviikko;61;30;91
622;20.06.2018;2018;06;21;Keskiviikko;60;32;92
622;20.06.2018;2018;06;22;Keskiviikko;36;22;58
622;20.06.2018;2018;06;23;Keskiviikko;13;8;21
622;21.06.2018;2018;06;00;Torstai;15;11;26
622;21.06.2018;2018;06;01;Torstai;3;11;14
622;21.06.2018;2018;06;02;Torstai;10;2;12
622;21.06.2018;2018;06;03;Torstai;4;2;6
622;21.06.2018;2018;06;04;Torstai;3;0;3
622;21.06.2018;2018;06;05;Torstai;3;4;7
622;21.06.2018;2018;06;06;Torstai;3;13;16
622;21.06.2018;2018;06;07;Torstai;26;53;79
622;21.06.2018;2018;06;08;Torstai;36;78;114
622;21.06.2018;2018;06;09;Torstai;55;61;116
622;21.06.2018;2018;06;10;Torstai;22;62;84
622;21.06.2018;2018;06;11;Torstai;31;52;83
622;21.06.2018;2018;06;12;Torstai;37;53;90
622;21.06.2018;2018;06;13;Torstai;37;45;82
622;21.06.2018;2018;06;14;Torstai;39;49;88
622;21.06.2018;2018;06;15;Torstai;63;62;125
622;21.06.2018;2018;06;16;Torstai;73;53;126
622;21.06.2018;2018;06;17;Torstai;95;77;172
622;21.06.2018;2018;06;18;Torstai;65;65;130
622;21.06.2018;2018;06;19;Torstai;46;45;91
622;21.06.2018;2018;06;20;Torstai;71;44;115
622;21.06.2018;2018;06;21;Torstai;44;26;70
622;21.06.2018;2018;06;22;Torstai;43;15;58
622;21.06.2018;2018;06;23;Torstai;28;12;40
622;22.06.2018;2018;06;00;Perjantai;14;14;28
622;22.06.2018;2018;06;01;Perjantai;21;16;37
622;22.06.2018;2018;06;02;Perjantai;10;3;13
622;22.06.2018;2018;06;03;Perjantai;10;8;18
622;22.06.2018;2018;06;04;Perjantai;4;0;4
622;22.06.2018;2018;06;05;Perjantai;2;1;3
622;22.06.2018;2018;06;06;Perjantai;7;6;13
622;22.06.2018;2018;06;07;Perjantai;8;10;18
622;22.06.2018;2018;06;08;Perjantai;5;5;10
622;22.06.2018;2018;06;09;Perjantai;5;10;15
622;22.06.2018;2018;06;10;Perjantai;5;5;10
622;22.06.2018;2018;06;11;Perjantai;6;13;19
622;22.06.2018;2018;06;12;Perjantai;3;2;5
622;22.06.2018;2018;06;13;Perjantai;6;9;15
622;22.06.2018;2018;06;14;Perjantai;12;12;24
622;22.06.2018;2018;06;15;Perjantai;26;20;46
622;22.06.2018;2018;06;16;Perjantai;8;8;16
622;22.06.2018;2018;06;17;Perjantai;12;8;20
622;22.06.2018;2018;06;18;Perjantai;12;8;20
622;22.06.2018;2018;06;19;Perjantai;11;11;22
622;22.06.2018;2018;06;20;Perjantai;20;35;55
622;22.06.2018;2018;06;21;Perjantai;13;15;28
622;22.06.2018;2018;06;22;Perjantai;12;9;21
622;22.06.2018;2018;06;23;Perjantai;7;4;11
622;23.06.2018;2018;06;00;Lauantai;8;8;16
622;23.06.2018;2018;06;01;Lauantai;6;3;9
622;23.06.2018;2018;06;02;Lauantai;12;8;20
622;23.06.2018;2018;06;03;Lauantai;6;4;10
622;23.06.2018;2018;06;04;Lauantai;3;2;5
622;23.06.2018;2018;06;05;Lauantai;3;5;8
622;23.06.2018;2018;06;06;Lauantai;3;5;8
622;23.06.2018;2018;06;07;Lauantai;3;6;9
622;23.06.2018;2018;06;08;Lauantai;1;4;5
622;23.06.2018;2018;06;09;Lauantai;3;5;8
622;23.06.2018;2018;06;10;Lauantai;3;5;8
622;23.06.2018;2018;06;11;Lauantai;6;12;18
622;23.06.2018;2018;06;12;Lauantai;7;16;23
622;23.06.2018;2018;06;13;Lauantai;17;13;30
622;23.06.2018;2018;06;14;Lauantai;18;18;36
622;23.06.2018;2018;06;15;Lauantai;21;37;58
622;23.06.2018;2018;06;16;Lauantai;24;21;45
622;23.06.2018;2018;06;17;Lauantai;24;16;40
622;23.06.2018;2018;06;18;Lauantai;28;26;54
622;23.06.2018;2018;06;19;Lauantai;16;14;30
622;23.06.2018;2018;06;20;Lauantai;26;23;49
622;23.06.2018;2018;06;21;Lauantai;21;17;38
622;23.06.2018;2018;06;22;Lauantai;11;17;28
622;23.06.2018;2018;06;23;Lauantai;11;10;21
622;24.06.2018;2018;06;00;Sunnuntai;7;5;12
622;24.06.2018;2018;06;01;Sunnuntai;4;9;13
622;24.06.2018;2018;06;02;Sunnuntai;7;5;12
622;24.06.2018;2018;06;03;Sunnuntai;2;4;6
622;24.06.2018;2018;06;04;Sunnuntai;4;1;5
622;24.06.2018;2018;06;05;Sunnuntai;6;3;9
622;24.06.2018;2018;06;06;Sunnuntai;2;4;6
622;24.06.2018;2018;06;07;Sunnuntai;5;12;17
622;24.06.2018;2018;06;08;Sunnuntai;8;6;14
622;24.06.2018;2018;06;09;Sunnuntai;10;13;23
622;24.06.2018;2018;06;10;Sunnuntai;14;31;45
622;24.06.2018;2018;06;11;Sunnuntai;27;25;52
622;24.06.2018;2018;06;12;Sunnuntai;40;56;96
622;24.06.2018;2018;06;13;Sunnuntai;56;84;140
622;24.06.2018;2018;06;14;Sunnuntai;85;51;136
622;24.06.2018;2018;06;15;Sunnuntai;75;74;149
622;24.06.2018;2018;06;16;Sunnuntai;72;68;140
622;24.06.2018;2018;06;17;Sunnuntai;56;66;122
622;24.06.2018;2018;06;18;Sunnuntai;68;58;126
622;24.06.2018;2018;06;19;Sunnuntai;69;60;129
622;24.06.2018;2018;06;20;Sunnuntai;60;56;116
622;24.06.2018;2018;06;21;Sunnuntai;44;25;69
622;24.06.2018;2018;06;22;Sunnuntai;44;26;70
622;24.06.2018;2018;06;23;Sunnuntai;19;15;34
622;25.06.2018;2018;06;00;Maanantai;6;14;20
622;25.06.2018;2018;06;01;Maanantai;10;6;16
622;25.06.2018;2018;06;02;Maanantai;3;2;5
622;25.06.2018;2018;06;03;Maanantai;5;1;6
622;25.06.2018;2018;06;04;Maanantai;3;0;3
622;25.06.2018;2018;06;05;Maanantai;4;4;8
622;25.06.2018;2018;06;06;Maanantai;4;26;30
622;25.06.2018;2018;06;07;Maanantai;22;94;116
622;25.06.2018;2018;06;08;Maanantai;38;111;149
622;25.06.2018;2018;06;09;Maanantai;49;73;122
622;25.06.2018;2018;06;10;Maanantai;29;46;75
622;25.06.2018;2018;06;11;Maanantai;35;54;89
622;25.06.2018;2018;06;12;Maanantai;48;88;136
622;25.06.2018;2018;06;13;Maanantai;72;77;149
622;25.06.2018;2018;06;14;Maanantai;69;78;147
622;25.06.2018;2018;06;15;Maanantai;90;59;149
622;25.06.2018;2018;06;16;Maanantai;156;47;203
622;25.06.2018;2018;06;17;Maanantai;163;113;276
622;25.06.2018;2018;06;18;Maanantai;127;87;214
622;25.06.2018;2018;06;19;Maanantai;108;88;196
622;25.06.2018;2018;06;20;Maanantai;101;58;159
622;25.06.2018;2018;06;21;Maanantai;79;43;122
622;25.06.2018;2018;06;22;Maanantai;52;25;77
622;25.06.2018;2018;06;23;Maanantai;31;12;43
622;26.06.2018;2018;06;00;Tiistai;18;9;27
622;26.06.2018;2018;06;01;Tiistai;15;8;23
622;26.06.2018;2018;06;02;Tiistai;1;2;3
622;26.06.2018;2018;06;03;Tiistai;4;2;6
622;26.06.2018;2018;06;04;Tiistai;2;2;4
622;26.06.2018;2018;06;05;Tiistai;4;3;7
622;26.06.2018;2018;06;06;Tiistai;11;22;33
622;26.06.2018;2018;06;07;Tiistai;24;81;105
622;26.06.2018;2018;06;08;Tiistai;38;123;161
622;26.06.2018;2018;06;09;Tiistai;38;97;135
622;26.06.2018;2018;06;10;Tiistai;38;44;82
622;26.06.2018;2018;06;11;Tiistai;42;77;119
622;26.06.2018;2018;06;12;Tiistai;50;61;111
622;26.06.2018;2018;06;13;Tiistai;50;61;111
622;26.06.2018;2018;06;14;Tiistai;53;70;123
622;26.06.2018;2018;06;15;Tiistai;98;81;179
622;26.06.2018;2018;06;16;Tiistai;146;96;242
622;26.06.2018;2018;06;17;Tiistai;139;82;221
622;26.06.2018;2018;06;18;Tiistai;90;90;180
622;26.06.2018;2018;06;19;Tiistai;73;77;150
622;26.06.2018;2018;06;20;Tiistai;83;65;148
622;26.06.2018;2018;06;21;Tiistai;102;61;163
622;26.06.2018;2018;06;22;Tiistai;48;24;72
622;26.06.2018;2018;06;23;Tiistai;21;12;33
622;27.06.2018;2018;06;00;Keskiviikko;25;4;29
622;27.06.2018;2018;06;01;Keskiviikko;12;7;19
622;27.06.2018;2018;06;02;Keskiviikko;8;4;12
622;27.06.2018;2018;06;03;Keskiviikko;6;1;7
622;27.06.2018;2018;06;04;Keskiviikko;3;1;4
622;27.06.2018;2018;06;05;Keskiviikko;1;4;5
622;27.06.2018;2018;06;06;Keskiviikko;6;22;28
622;27.06.2018;2018;06;07;Keskiviikko;48;50;98
622;27.06.2018;2018;06;08;Keskiviikko;32;101;133
622;27.06.2018;2018;06;09;Keskiviikko;43;93;136
622;27.06.2018;2018;06;10;Keskiviikko;15;59;74
622;27.06.2018;2018;06;11;Keskiviikko;37;33;70
622;27.06.2018;2018;06;12;Keskiviikko;45;60;105
622;27.06.2018;2018;06;13;Keskiviikko;42;64;106
622;27.06.2018;2018;06;14;Keskiviikko;67;54;121
622;27.06.2018;2018;06;15;Keskiviikko;63;57;120
622;27.06.2018;2018;06;16;Keskiviikko;116;90;206
622;27.06.2018;2018;06;17;Keskiviikko;114;94;208
622;27.06.2018;2018;06;18;Keskiviikko;95;72;167
622;27.06.2018;2018;06;19;Keskiviikko;94;51;145
622;27.06.2018;2018;06;20;Keskiviikko;82;47;129
622;27.06.2018;2018;06;21;Keskiviikko;52;30;82
622;27.06.2018;2018;06;22;Keskiviikko;49;30;79
622;27.06.2018;2018;06;23;Keskiviikko;24;16;40
622;28.06.2018;2018;06;00;Torstai;19;10;29
622;28.06.2018;2018;06;01;Torstai;3;6;9
622;28.06.2018;2018;06;02;Torstai;6;6;12
622;28.06.2018;2018;06;03;Torstai;6;2;8
622;28.06.2018;2018;06;04;Torstai;2;4;6
622;28.06.2018;2018;06;05;Torstai;5;7;12
622;28.06.2018;2018;06;06;Torstai;6;16;22
622;28.06.2018;2018;06;07;Torstai;19;52;71
622;28.06.2018;2018;06;08;Torstai;32;30;62
622;28.06.2018;2018;06;09;Torstai;27;58;85
622;28.06.2018;2018;06;10;Torstai;16;21;37
622;28.06.2018;2018;06;11;Torstai;13;14;27
622;28.06.2018;2018;06;12;Torstai;11;18;29
622;28.06.2018;2018;06;13;Torstai;15;18;33
622;28.06.2018;2018;06;14;Torstai;18;17;35
622;28.06.2018;2018;06;15;Torstai;24;22;46
622;28.06.2018;2018;06;16;Torstai;43;33;76
622;28.06.2018;2018;06;17;Torstai;51;31;82
622;28.06.2018;2018;06;18;Torstai;26;24;50
622;28.06.2018;2018;06;19;Torstai;23;18;41
622;28.06.2018;2018;06;20;Torstai;39;24;63
622;28.06.2018;2018;06;21;Torstai;18;15;33
622;28.06.2018;2018;06;22;Torstai;19;7;26
622;28.06.2018;2018;06;23;Torstai;3;7;10
622;29.06.2018;2018;06;00;Perjantai;6;2;8
622;29.06.2018;2018;06;01;Perjantai;5;5;10
622;29.06.2018;2018;06;02;Perjantai;4;6;10
622;29.06.2018;2018;06;03;Perjantai;1;3;4
622;29.06.2018;2018;06;04;Perjantai;2;1;3
622;29.06.2018;2018;06;05;Perjantai;8;6;14
622;29.06.2018;2018;06;06;Perjantai;1;15;16
622;29.06.2018;2018;06;07;Perjantai;15;58;73
622;29.06.2018;2018;06;08;Perjantai;35;59;94
622;29.06.2018;2018;06;09;Perjantai;30;73;103
622;29.06.2018;2018;06;10;Perjantai;25;45;70
622;29.06.2018;2018;06;11;Perjantai;26;47;73
622;29.06.2018;2018;06;12;Perjantai;39;41;80
622;29.06.2018;2018;06;13;Perjantai;26;46;72
622;29.06.2018;2018;06;14;Perjantai;52;40;92
622;29.06.2018;2018;06;15;Perjantai;66;51;117
622;29.06.2018;2018;06;16;Perjantai;93;79;172
622;29.06.2018;2018;06;17;Perjantai;90;71;161
622;29.06.2018;2018;06;18;Perjantai;66;51;117
622;29.06.2018;2018;06;19;Perjantai;49;77;126
622;29.06.2018;2018;06;20;Perjantai;47;40;87
622;29.06.2018;2018;06;21;Perjantai;39;39;78
622;29.06.2018;2018;06;22;Perjantai;72;22;94
622;29.06.2018;2018;06;23;Perjantai;17;13;30
622;30.06.2018;2018;06;00;Lauantai;19;16;35
622;30.06.2018;2018;06;01;Lauantai;9;8;17
622;30.06.2018;2018;06;02;Lauantai;13;5;18
622;30.06.2018;2018;06;03;Lauantai;6;10;16
622;30.06.2018;2018;06;04;Lauantai;9;2;11
622;30.06.2018;2018;06;05;Lauantai;10;3;13
622;30.06.2018;2018;06;06;Lauantai;13;8;21
622;30.06.2018;2018;06;07;Lauantai;8;9;17
622;30.06.2018;2018;06;08;Lauantai;8;9;17
622;30.06.2018;2018;06;09;Lauantai;11;26;37
622;30.06.2018;2018;06;10;Lauantai;14;29;43
622;30.06.2018;2018;06;11;Lauantai;25;57;82
622;30.06.2018;2018;06;12;Lauantai;29;61;90
622;30.06.2018;2018;06;13;Lauantai;54;67;121
622;30.06.2018;2018;06;14;Lauantai;36;58;94
622;30.06.2018;2018;06;15;Lauantai;73;53;126
622;30.06.2018;2018;06;16;Lauantai;55;42;97
622;30.06.2018;2018;06;17;Lauantai;63;49;112
622;30.06.2018;2018;06;18;Lauantai;50;69;119
622;30.06.2018;2018;06;19;Lauantai;41;35;76
622;30.06.2018;2018;06;20;Lauantai;38;39;77
622;30.06.2018;2018;06;21;Lauantai;36;51;87
622;30.06.2018;2018;06;22;Lauantai;31;22;53
622;30.06.2018;2018;06;23;Lauantai;19;5;24
622;01.07.2018;2018;07;00;Sunnuntai;39;18;57
622;01.07.2018;2018;07;01;Sunnuntai;16;14;30
622;01.07.2018;2018;07;02;Sunnuntai;13;7;20
622;01.07.2018;2018;07;03;Sunnuntai;12;3;15
622;01.07.2018;2018;07;04;Sunnuntai;11;4;15
622;01.07.2018;2018;07;05;Sunnuntai;16;3;19
622;01.07.2018;2018;07;06;Sunnuntai;5;6;11
622;01.07.2018;2018;07;07;Sunnuntai;3;9;12
622;01.07.2018;2018;07;08;Sunnuntai;2;6;8
622;01.07.2018;2018;07;09;Sunnuntai;7;21;28
622;01.07.2018;2018;07;10;Sunnuntai;10;18;28
622;01.07.2018;2018;07;11;Sunnuntai;33;40;73
622;01.07.2018;2018;07;12;Sunnuntai;70;74;144
622;01.07.2018;2018;07;13;Sunnuntai;63;94;157
622;01.07.2018;2018;07;14;Sunnuntai;88;112;200
622;01.07.2018;2018;07;15;Sunnuntai;90;96;186
622;01.07.2018;2018;07;16;Sunnuntai;96;81;177
622;01.07.2018;2018;07;17;Sunnuntai;112;94;206
622;01.07.2018;2018;07;18;Sunnuntai;90;76;166
622;01.07.2018;2018;07;19;Sunnuntai;61;46;107
622;01.07.2018;2018;07;20;Sunnuntai;76;45;121
622;01.07.2018;2018;07;21;Sunnuntai;53;34;87
622;01.07.2018;2018;07;22;Sunnuntai;45;26;71
622;01.07.2018;2018;07;23;Sunnuntai;19;14;33
622;02.07.2018;2018;07;00;Maanantai;7;1;8
622;02.07.2018;2018;07;01;Maanantai;10;7;17
622;02.07.2018;2018;07;02;Maanantai;6;3;9
622;02.07.2018;2018;07;03;Maanantai;2;0;2
622;02.07.2018;2018;07;04;Maanantai;2;0;2
622;02.07.2018;2018;07;05;Maanantai;1;6;7
622;02.07.2018;2018;07;06;Maanantai;9;15;24
622;02.07.2018;2018;07;07;Maanantai;37;69;106
622;02.07.2018;2018;07;08;Maanantai;26;86;112
622;02.07.2018;2018;07;09;Maanantai;33;73;106
622;02.07.2018;2018;07;10;Maanantai;43;57;100
622;02.07.2018;2018;07;11;Maanantai;42;63;105
622;02.07.2018;2018;07;12;Maanantai;50;64;114
622;02.07.2018;2018;07;13;Maanantai;58;108;166
622;02.07.2018;2018;07;14;Maanantai;84;91;175
622;02.07.2018;2018;07;15;Maanantai;110;111;221
622;02.07.2018;2018;07;16;Maanantai;146;109;255
622;02.07.2018;2018;07;17;Maanantai;179;92;271
622;02.07.2018;2018;07;18;Maanantai;158;97;255
622;02.07.2018;2018;07;19;Maanantai;100;99;199
622;02.07.2018;2018;07;20;Maanantai;141;100;241
622;02.07.2018;2018;07;21;Maanantai;101;54;155
622;02.07.2018;2018;07;22;Maanantai;48;28;76
622;02.07.2018;2018;07;23;Maanantai;51;20;71
622;03.07.2018;2018;07;00;Tiistai;26;11;37
622;03.07.2018;2018;07;01;Tiistai;15;5;20
622;03.07.2018;2018;07;02;Tiistai;5;4;9
622;03.07.2018;2018;07;03;Tiistai;2;5;7
622;03.07.2018;2018;07;04;Tiistai;5;0;5
622;03.07.2018;2018;07;05;Tiistai;4;4;8
622;03.07.2018;2018;07;06;Tiistai;8;18;26
622;03.07.2018;2018;07;07;Tiistai;39;70;109
622;03.07.2018;2018;07;08;Tiistai;34;92;126
622;03.07.2018;2018;07;09;Tiistai;29;65;94
622;03.07.2018;2018;07;10;Tiistai;30;69;99
622;03.07.2018;2018;07;11;Tiistai;38;33;71
622;03.07.2018;2018;07;12;Tiistai;45;73;118
622;03.07.2018;2018;07;13;Tiistai;60;56;116
622;03.07.2018;2018;07;14;Tiistai;64;59;123
622;03.07.2018;2018;07;15;Tiistai;85;74;159
622;03.07.2018;2018;07;16;Tiistai;115;67;182
622;03.07.2018;2018;07;17;Tiistai;114;75;189
622;03.07.2018;2018;07;18;Tiistai;81;63;144
622;03.07.2018;2018;07;19;Tiistai;76;44;120
622;03.07.2018;2018;07;20;Tiistai;58;51;109
622;03.07.2018;2018;07;21;Tiistai;59;34;93
622;03.07.2018;2018;07;22;Tiistai;35;24;59
622;03.07.2018;2018;07;23;Tiistai;20;6;26
622;04.07.2018;2018;07;00;Keskiviikko;6;8;14
622;04.07.2018;2018;07;01;Keskiviikko;3;2;5
622;04.07.2018;2018;07;02;Keskiviikko;0;0;0
622;04.07.2018;2018;07;03;Keskiviikko;0;0;0
622;04.07.2018;2018;07;04;Keskiviikko;0;0;0
622;04.07.2018;2018;07;05;Keskiviikko;0;0;0
622;04.07.2018;2018;07;06;Keskiviikko;0;0;0
622;04.07.2018;2018;07;07;Keskiviikko;0;0;0
622;04.07.2018;2018;07;08;Keskiviikko;0;0;0
622;04.07.2018;2018;07;09;Keskiviikko;70;118;188
622;04.07.2018;2018;07;10;Keskiviikko;5;23;28
622;04.07.2018;2018;07;11;Keskiviikko;20;23;43
622;04.07.2018;2018;07;12;Keskiviikko;13;30;43
622;04.07.2018;2018;07;13;Keskiviikko;14;13;27
622;04.07.2018;2018;07;14;Keskiviikko;15;15;30
622;04.07.2018;2018;07;15;Keskiviikko;26;23;49
622;04.07.2018;2018;07;16;Keskiviikko;47;29;76
622;04.07.2018;2018;07;17;Keskiviikko;45;54;99
622;04.07.2018;2018;07;18;Keskiviikko;51;54;105
622;04.07.2018;2018;07;19;Keskiviikko;59;75;134
622;04.07.2018;2018;07;20;Keskiviikko;46;54;100
622;04.07.2018;2018;07;21;Keskiviikko;56;26;82
622;04.07.2018;2018;07;22;Keskiviikko;54;17;71
622;04.07.2018;2018;07;23;Keskiviikko;17;9;26
622;05.07.2018;2018;07;00;Torstai;12;5;17
622;05.07.2018;2018;07;01;Torstai;9;6;15
622;05.07.2018;2018;07;02;Torstai;11;2;13
622;05.07.2018;2018;07;03;Torstai;2;4;6
622;05.07.2018;2018;07;04;Torstai;1;0;1
622;05.07.2018;2018;07;05;Torstai;4;7;11
622;05.07.2018;2018;07;06;Torstai;4;14;18
622;05.07.2018;2018;07;07;Torstai;37;57;94
622;05.07.2018;2018;07;08;Torstai;25;82;107
622;05.07.2018;2018;07;09;Torstai;34;67;101
622;05.07.2018;2018;07;10;Torstai;25;59;84
622;05.07.2018;2018;07;11;Torstai;35;59;94
622;05.07.2018;2018;07;12;Torstai;52;50;102
622;05.07.2018;2018;07;13;Torstai;76;75;151
622;05.07.2018;2018;07;14;Torstai;96;64;160
622;05.07.2018;2018;07;15;Torstai;79;70;149
622;05.07.2018;2018;07;16;Torstai;119;78;197
622;05.07.2018;2018;07;17;Torstai;110;69;179
622;05.07.2018;2018;07;18;Torstai;96;54;150
622;05.07.2018;2018;07;19;Torstai;67;59;126
622;05.07.2018;2018;07;20;Torstai;64;32;96
622;05.07.2018;2018;07;21;Torstai;48;27;75
622;05.07.2018;2018;07;22;Torstai;31;22;53
622;05.07.2018;2018;07;23;Torstai;13;12;25
622;06.07.2018;2018;07;00;Perjantai;11;3;14
622;06.07.2018;2018;07;01;Perjantai;12;6;18
622;06.07.2018;2018;07;02;Perjantai;9;3;12
622;06.07.2018;2018;07;03;Perjantai;6;2;8
622;06.07.2018;2018;07;04;Perjantai;4;0;4
622;06.07.2018;2018;07;05;Perjantai;4;7;11
622;06.07.2018;2018;07;06;Perjantai;4;19;23
622;06.07.2018;2018;07;07;Perjantai;21;64;85
622;06.07.2018;2018;07;08;Perjantai;30;69;99
622;06.07.2018;2018;07;09;Perjantai;27;73;100
622;06.07.2018;2018;07;10;Perjantai;23;47;70
622;06.07.2018;2018;07;11;Perjantai;22;55;77
622;06.07.2018;2018;07;12;Perjantai;45;55;100
622;06.07.2018;2018;07;13;Perjantai;53;101;154
622;06.07.2018;2018;07;14;Perjantai;108;85;193
622;06.07.2018;2018;07;15;Perjantai;72;94;166
622;06.07.2018;2018;07;16;Perjantai;141;135;276
622;06.07.2018;2018;07;17;Perjantai;112;97;209
622;06.07.2018;2018;07;18;Perjantai;113;93;206
622;06.07.2018;2018;07;19;Perjantai;87;87;174
622;06.07.2018;2018;07;20;Perjantai;70;73;143
622;06.07.2018;2018;07;21;Perjantai;58;33;91
622;06.07.2018;2018;07;22;Perjantai;60;41;101
622;06.07.2018;2018;07;23;Perjantai;29;14;43
622;07.07.2018;2018;07;00;Lauantai;32;22;54
622;07.07.2018;2018;07;01;Lauantai;24;7;31
622;07.07.2018;2018;07;02;Lauantai;18;6;24
622;07.07.2018;2018;07;03;Lauantai;20;1;21
622;07.07.2018;2018;07;04;Lauantai;20;3;23
622;07.07.2018;2018;07;05;Lauantai;6;4;10
622;07.07.2018;2018;07;06;Lauantai;6;7;13
622;07.07.2018;2018;07;07;Lauantai;10;18;28
622;07.07.2018;2018;07;08;Lauantai;8;20;28
622;07.07.2018;2018;07;09;Lauantai;6;16;22
622;07.07.2018;2018;07;10;Lauantai;18;30;48
622;07.07.2018;2018;07;11;Lauantai;24;56;80
622;07.07.2018;2018;07;12;Lauantai;42;104;146
622;07.07.2018;2018;07;13;Lauantai;66;110;176
622;07.07.2018;2018;07;14;Lauantai;95;89;184
622;07.07.2018;2018;07;15;Lauantai;88;83;171
622;07.07.2018;2018;07;16;Lauantai;97;77;174
622;07.07.2018;2018;07;17;Lauantai;105;72;177
622;07.07.2018;2018;07;18;Lauantai;76;63;139
622;07.07.2018;2018;07;19;Lauantai;76;65;141
622;07.07.2018;2018;07;20;Lauantai;49;56;105
622;07.07.2018;2018;07;21;Lauantai;61;52;113
622;07.07.2018;2018;07;22;Lauantai;50;34;84
622;07.07.2018;2018;07;23;Lauantai;24;19;43
622;08.07.2018;2018;07;00;Sunnuntai;23;9;32
622;08.07.2018;2018;07;01;Sunnuntai;29;14;43
622;08.07.2018;2018;07;02;Sunnuntai;21;10;31
622;08.07.2018;2018;07;03;Sunnuntai;21;10;31
622;08.07.2018;2018;07;04;Sunnuntai;11;6;17
622;08.07.2018;2018;07;05;Sunnuntai;17;0;17
622;08.07.2018;2018;07;06;Sunnuntai;10;11;21
622;08.07.2018;2018;07;07;Sunnuntai;6;12;18
622;08.07.2018;2018;07;08;Sunnuntai;6;8;14
622;08.07.2018;2018;07;09;Sunnuntai;8;10;18
622;08.07.2018;2018;07;10;Sunnuntai;18;19;37
622;08.07.2018;2018;07;11;Sunnuntai;19;35;54
622;08.07.2018;2018;07;12;Sunnuntai;35;72;107
622;08.07.2018;2018;07;13;Sunnuntai;41;88;129
622;08.07.2018;2018;07;14;Sunnuntai;52;80;132
622;08.07.2018;2018;07;15;Sunnuntai;85;88;173
622;08.07.2018;2018;07;16;Sunnuntai;90;91;181
622;08.07.2018;2018;07;17;Sunnuntai;76;78;154
622;08.07.2018;2018;07;18;Sunnuntai;84;71;155
622;08.07.2018;2018;07;19;Sunnuntai;107;61;168
622;08.07.2018;2018;07;20;Sunnuntai;73;57;130
622;08.07.2018;2018;07;21;Sunnuntai;72;47;119
622;08.07.2018;2018;07;22;Sunnuntai;48;32;80
622;08.07.2018;2018;07;23;Sunnuntai;24;9;33
622;09.07.2018;2018;07;00;Maanantai;13;6;19
622;09.07.2018;2018;07;01;Maanantai;12;1;13
622;09.07.2018;2018;07;02;Maanantai;6;5;11
622;09.07.2018;2018;07;03;Maanantai;8;0;8
622;09.07.2018;2018;07;04;Maanantai;3;1;4
622;09.07.2018;2018;07;05;Maanantai;3;6;9
622;09.07.2018;2018;07;06;Maanantai;11;15;26
622;09.07.2018;2018;07;07;Maanantai;24;72;96
622;09.07.2018;2018;07;08;Maanantai;31;62;93
622;09.07.2018;2018;07;09;Maanantai;49;63;112
622;09.07.2018;2018;07;10;Maanantai;33;65;98
622;09.07.2018;2018;07;11;Maanantai;49;70;119
622;09.07.2018;2018;07;12;Maanantai;38;97;135
622;09.07.2018;2018;07;13;Maanantai;91;64;155
622;09.07.2018;2018;07;14;Maanantai;104;123;227
622;09.07.2018;2018;07;15;Maanantai;88;88;176
622;09.07.2018;2018;07;16;Maanantai;178;101;279
622;09.07.2018;2018;07;17;Maanantai;187;96;283
622;09.07.2018;2018;07;18;Maanantai;114;98;212
622;09.07.2018;2018;07;19;Maanantai;115;89;204
622;09.07.2018;2018;07;20;Maanantai;119;85;204
622;09.07.2018;2018;07;21;Maanantai;109;52;161
622;09.07.2018;2018;07;22;Maanantai;70;37;107
622;09.07.2018;2018;07;23;Maanantai;45;21;66
622;10.07.2018;2018;07;00;Tiistai;21;12;33
622;10.07.2018;2018;07;01;Tiistai;18;7;25
622;10.07.2018;2018;07;02;Tiistai;7;3;10
622;10.07.2018;2018;07;03;Tiistai;7;6;13
622;10.07.2018;2018;07;04;Tiistai;3;0;3
622;10.07.2018;2018;07;05;Tiistai;3;5;8
622;10.07.2018;2018;07;06;Tiistai;7;15;22
622;10.07.2018;2018;07;07;Tiistai;22;71;93
622;10.07.2018;2018;07;08;Tiistai;23;81;104
622;10.07.2018;2018;07;09;Tiistai;32;67;99
622;10.07.2018;2018;07;10;Tiistai;34;34;68
622;10.07.2018;2018;07;11;Tiistai;45;62;107
622;10.07.2018;2018;07;12;Tiistai;63;114;177
622;10.07.2018;2018;07;13;Tiistai;94;65;159
622;10.07.2018;2018;07;14;Tiistai;104;128;232
622;10.07.2018;2018;07;15;Tiistai;119;104;223
622;10.07.2018;2018;07;16;Tiistai;161;107;268
622;10.07.2018;2018;07;17;Tiistai;186;87;273
622;10.07.2018;2018;07;18;Tiistai;166;126;292
622;10.07.2018;2018;07;19;Tiistai;144;96;240
622;10.07.2018;2018;07;20;Tiistai;123;103;226
622;10.07.2018;2018;07;21;Tiistai;122;71;193
622;10.07.2018;2018;07;22;Tiistai;74;33;107
622;10.07.2018;2018;07;23;Tiistai;32;13;45
622;11.07.2018;2018;07;00;Keskiviikko;17;6;23
622;11.07.2018;2018;07;01;Keskiviikko;10;6;16
622;11.07.2018;2018;07;02;Keskiviikko;8;2;10
622;11.07.2018;2018;07;03;Keskiviikko;4;1;5
622;11.07.2018;2018;07;04;Keskiviikko;1;6;7
622;11.07.2018;2018;07;05;Keskiviikko;4;3;7
622;11.07.2018;2018;07;06;Keskiviikko;5;19;24
622;11.07.2018;2018;07;07;Keskiviikko;26;72;98
622;11.07.2018;2018;07;08;Keskiviikko;34;70;104
622;11.07.2018;2018;07;09;Keskiviikko;40;54;94
622;11.07.2018;2018;07;10;Keskiviikko;38;60;98
622;11.07.2018;2018;07;11;Keskiviikko;48;71;119
622;11.07.2018;2018;07;12;Keskiviikko;55;102;157
622;11.07.2018;2018;07;13;Keskiviikko;69;98;167
622;11.07.2018;2018;07;14;Keskiviikko;91;67;158
622;11.07.2018;2018;07;15;Keskiviikko;119;62;181
622;11.07.2018;2018;07;16;Keskiviikko;153;104;257
622;11.07.2018;2018;07;17;Keskiviikko;154;130;284
622;11.07.2018;2018;07;18;Keskiviikko;141;113;254
622;11.07.2018;2018;07;19;Keskiviikko;118;107;225
622;11.07.2018;2018;07;20;Keskiviikko;146;104;250
622;11.07.2018;2018;07;21;Keskiviikko;118;65;183
622;11.07.2018;2018;07;22;Keskiviikko;84;42;126
622;11.07.2018;2018;07;23;Keskiviikko;40;15;55
622;12.07.2018;2018;07;00;Torstai;26;10;36
622;12.07.2018;2018;07;01;Torstai;20;6;26
622;12.07.2018;2018;07;02;Torstai;6;5;11
622;12.07.2018;2018;07;03;Torstai;6;4;10
622;12.07.2018;2018;07;04;Torstai;7;1;8
622;12.07.2018;2018;07;05;Torstai;2;5;7
622;12.07.2018;2018;07;06;Torstai;10;11;21
622;12.07.2018;2018;07;07;Torstai;21;84;105
622;12.07.2018;2018;07;08;Torstai;29;70;99
622;12.07.2018;2018;07;09;Torstai;38;73;111
622;12.07.2018;2018;07;10;Torstai;32;45;77
622;12.07.2018;2018;07;11;Torstai;33;76;109
622;12.07.2018;2018;07;12;Torstai;62;93;155
622;12.07.2018;2018;07;13;Torstai;67;76;143
622;12.07.2018;2018;07;14;Torstai;94;106;200
622;12.07.2018;2018;07;15;Torstai;124;105;229
622;12.07.2018;2018;07;16;Torstai;160;82;242
622;12.07.2018;2018;07;17;Torstai;154;145;299
622;12.07.2018;2018;07;18;Torstai;144;130;274
622;12.07.2018;2018;07;19;Torstai;135;100;235
622;12.07.2018;2018;07;20;Torstai;132;84;216
622;12.07.2018;2018;07;21;Torstai;98;72;170
622;12.07.2018;2018;07;22;Torstai;98;39;137
622;12.07.2018;2018;07;23;Torstai;53;19;72
622;13.07.2018;2018;07;00;Perjantai;38;12;50
622;13.07.2018;2018;07;01;Perjantai;41;7;48
622;13.07.2018;2018;07;02;Perjantai;7;3;10
622;13.07.2018;2018;07;03;Perjantai;9;5;14
622;13.07.2018;2018;07;04;Perjantai;4;0;4
622;13.07.2018;2018;07;05;Perjantai;3;5;8
622;13.07.2018;2018;07;06;Perjantai;10;11;21
622;13.07.2018;2018;07;07;Perjantai;25;43;68
622;13.07.2018;2018;07;08;Perjantai;32;65;97
622;13.07.2018;2018;07;09;Perjantai;34;67;101
622;13.07.2018;2018;07;10;Perjantai;44;43;87
622;13.07.2018;2018;07;11;Perjantai;35;55;90
622;13.07.2018;2018;07;12;Perjantai;59;111;170
622;13.07.2018;2018;07;13;Perjantai;87;87;174
622;13.07.2018;2018;07;14;Perjantai;95;78;173
622;13.07.2018;2018;07;15;Perjantai;128;140;268
622;13.07.2018;2018;07;16;Perjantai;137;106;243
622;13.07.2018;2018;07;17;Perjantai;105;135;240
622;13.07.2018;2018;07;18;Perjantai;106;106;212
622;13.07.2018;2018;07;19;Perjantai;104;108;212
622;13.07.2018;2018;07;20;Perjantai;120;89;209
622;13.07.2018;2018;07;21;Perjantai;75;65;140
622;13.07.2018;2018;07;22;Perjantai;79;51;130
622;13.07.2018;2018;07;23;Perjantai;69;31;100
622;14.07.2018;2018;07;00;Lauantai;47;9;56
622;14.07.2018;2018;07;01;Lauantai;50;10;60
622;14.07.2018;2018;07;02;Lauantai;40;3;43
622;14.07.2018;2018;07;03;Lauantai;21;8;29
622;14.07.2018;2018;07;04;Lauantai;27;4;31
622;14.07.2018;2018;07;05;Lauantai;10;2;12
622;14.07.2018;2018;07;06;Lauantai;18;8;26
622;14.07.2018;2018;07;07;Lauantai;10;8;18
622;14.07.2018;2018;07;08;Lauantai;9;8;17
622;14.07.2018;2018;07;09;Lauantai;11;16;27
622;14.07.2018;2018;07;10;Lauantai;16;32;48
622;14.07.2018;2018;07;11;Lauantai;25;38;63
622;14.07.2018;2018;07;12;Lauantai;27;41;68
622;14.07.2018;2018;07;13;Lauantai;37;49;86
622;14.07.2018;2018;07;14;Lauantai;56;90;146
622;14.07.2018;2018;07;15;Lauantai;51;102;153
622;14.07.2018;2018;07;16;Lauantai;75;70;145
622;14.07.2018;2018;07;17;Lauantai;85;68;153
622;14.07.2018;2018;07;18;Lauantai;70;69;139
622;14.07.2018;2018;07;19;Lauantai;81;78;159
622;14.07.2018;2018;07;20;Lauantai;66;82;148
622;14.07.2018;2018;07;21;Lauantai;73;74;147
622;14.07.2018;2018;07;22;Lauantai;54;53;107
622;14.07.2018;2018;07;23;Lauantai;54;34;88
622;15.07.2018;2018;07;00;Sunnuntai;58;24;82
622;15.07.2018;2018;07;01;Sunnuntai;61;16;77
622;15.07.2018;2018;07;02;Sunnuntai;18;8;26
622;15.07.2018;2018;07;03;Sunnuntai;28;1;29
622;15.07.2018;2018;07;04;Sunnuntai;33;7;40
622;15.07.2018;2018;07;05;Sunnuntai;15;4;19
622;15.07.2018;2018;07;06;Sunnuntai;9;5;14
622;15.07.2018;2018;07;07;Sunnuntai;15;12;27
622;15.07.2018;2018;07;08;Sunnuntai;7;12;19
622;15.07.2018;2018;07;09;Sunnuntai;13;23;36
622;15.07.2018;2018;07;10;Sunnuntai;21;39;60
622;15.07.2018;2018;07;11;Sunnuntai;38;69;107
622;15.07.2018;2018;07;12;Sunnuntai;48;80;128
622;15.07.2018;2018;07;13;Sunnuntai;81;124;205
622;15.07.2018;2018;07;14;Sunnuntai;92;133;225
622;15.07.2018;2018;07;15;Sunnuntai;116;106;222
622;15.07.2018;2018;07;16;Sunnuntai;107;101;208
622;15.07.2018;2018;07;17;Sunnuntai;126;113;239
622;15.07.2018;2018;07;18;Sunnuntai;123;101;224
622;15.07.2018;2018;07;19;Sunnuntai;85;44;129
622;15.07.2018;2018;07;20;Sunnuntai;69;60;129
622;15.07.2018;2018;07;21;Sunnuntai;62;43;105
622;15.07.2018;2018;07;22;Sunnuntai;54;46;100
622;15.07.2018;2018;07;23;Sunnuntai;38;30;68
622;16.07.2018;2018;07;00;Maanantai;21;8;29
622;16.07.2018;2018;07;01;Maanantai;22;7;29
622;16.07.2018;2018;07;02;Maanantai;6;4;10
622;16.07.2018;2018;07;03;Maanantai;10;5;15
622;16.07.2018;2018;07;04;Maanantai;6;1;7
622;16.07.2018;2018;07;05;Maanantai;6;3;9
622;16.07.2018;2018;07;06;Maanantai;8;16;24
622;16.07.2018;2018;07;07;Maanantai;15;68;83
622;16.07.2018;2018;07;08;Maanantai;34;72;106
622;16.07.2018;2018;07;09;Maanantai;31;68;99
622;16.07.2018;2018;07;10;Maanantai;30;47;77
622;16.07.2018;2018;07;11;Maanantai;52;55;107
622;16.07.2018;2018;07;12;Maanantai;71;81;152
622;16.07.2018;2018;07;13;Maanantai;67;107;174
622;16.07.2018;2018;07;14;Maanantai;87;115;202
622;16.07.2018;2018;07;15;Maanantai;94;102;196
622;16.07.2018;2018;07;16;Maanantai;159;110;269
622;16.07.2018;2018;07;17;Maanantai;157;38;195
622;16.07.2018;2018;07;18;Maanantai;123;98;221
622;16.07.2018;2018;07;19;Maanantai;122;109;231
622;16.07.2018;2018;07;20;Maanantai;119;96;215
622;16.07.2018;2018;07;21;Maanantai;92;67;159
622;16.07.2018;2018;07;22;Maanantai;84;42;126
622;16.07.2018;2018;07;23;Maanantai;55;22;77
622;17.07.2018;2018;07;00;Tiistai;20;8;28
622;17.07.2018;2018;07;01;Tiistai;16;4;20
622;17.07.2018;2018;07;02;Tiistai;8;5;13
622;17.07.2018;2018;07;03;Tiistai;8;7;15
622;17.07.2018;2018;07;04;Tiistai;5;0;5
622;17.07.2018;2018;07;05;Tiistai;1;2;3
622;17.07.2018;2018;07;06;Tiistai;6;21;27
622;17.07.2018;2018;07;07;Tiistai;22;70;92
622;17.07.2018;2018;07;08;Tiistai;49;55;104
622;17.07.2018;2018;07;09;Tiistai;30;73;103
622;17.07.2018;2018;07;10;Tiistai;38;48;86
622;17.07.2018;2018;07;11;Tiistai;42;73;115
622;17.07.2018;2018;07;12;Tiistai;54;101;155
622;17.07.2018;2018;07;13;Tiistai;69;100;169
622;17.07.2018;2018;07;14;Tiistai;68;116;184
622;17.07.2018;2018;07;15;Tiistai;98;107;205
622;17.07.2018;2018;07;16;Tiistai;156;85;241
622;17.07.2018;2018;07;17;Tiistai;141;120;261
622;17.07.2018;2018;07;18;Tiistai;146;117;263
622;17.07.2018;2018;07;19;Tiistai;136;98;234
622;17.07.2018;2018;07;20;Tiistai;150;77;227
622;17.07.2018;2018;07;21;Tiistai;131;76;207
622;17.07.2018;2018;07;22;Tiistai;108;59;167
622;17.07.2018;2018;07;23;Tiistai;69;18;87
622;18.07.2018;2018;07;00;Keskiviikko;34;9;43
622;18.07.2018;2018;07;01;Keskiviikko;27;7;34
622;18.07.2018;2018;07;02;Keskiviikko;10;1;11
622;18.07.2018;2018;07;03;Keskiviikko;11;4;15
622;18.07.2018;2018;07;04;Keskiviikko;7;2;9
622;18.07.2018;2018;07;05;Keskiviikko;6;2;8
622;18.07.2018;2018;07;06;Keskiviikko;10;22;32
622;18.07.2018;2018;07;07;Keskiviikko;33;52;85
622;18.07.2018;2018;07;08;Keskiviikko;30;68;98
622;18.07.2018;2018;07;09;Keskiviikko;35;75;110
622;18.07.2018;2018;07;10;Keskiviikko;37;71;108
622;18.07.2018;2018;07;11;Keskiviikko;47;83;130
622;18.07.2018;2018;07;12;Keskiviikko;47;73;120
622;18.07.2018;2018;07;13;Keskiviikko;54;57;111
622;18.07.2018;2018;07;14;Keskiviikko;96;74;170
622;18.07.2018;2018;07;15;Keskiviikko;73;86;159
622;18.07.2018;2018;07;16;Keskiviikko;123;116;239
622;18.07.2018;2018;07;17;Keskiviikko;134;96;230
622;18.07.2018;2018;07;18;Keskiviikko;128;130;258
622;18.07.2018;2018;07;19;Keskiviikko;140;109;249
622;18.07.2018;2018;07;20;Keskiviikko;122;80;202
622;18.07.2018;2018;07;21;Keskiviikko;93;77;170
622;18.07.2018;2018;07;22;Keskiviikko;98;48;146
622;18.07.2018;2018;07;23;Keskiviikko;72;29;101
622;19.07.2018;2018;07;00;Torstai;35;16;51
622;19.07.2018;2018;07;01;Torstai;28;12;40
622;19.07.2018;2018;07;02;Torstai;7;2;9
622;19.07.2018;2018;07;03;Torstai;7;4;11
622;19.07.2018;2018;07;04;Torstai;5;5;10
622;19.07.2018;2018;07;05;Torstai;6;4;10
622;19.07.2018;2018;07;06;Torstai;10;25;35
622;19.07.2018;2018;07;07;Torstai;25;67;92
622;19.07.2018;2018;07;08;Torstai;33;72;105
622;19.07.2018;2018;07;09;Torstai;26;47;73
622;19.07.2018;2018;07;10;Torstai;18;36;54
622;19.07.2018;2018;07;11;Torstai;42;46;88
622;19.07.2018;2018;07;12;Torstai;48;64;112
622;19.07.2018;2018;07;13;Torstai;57;63;120
622;19.07.2018;2018;07;14;Torstai;67;93;160
622;19.07.2018;2018;07;15;Torstai;80;103;183
622;19.07.2018;2018;07;16;Torstai;119;101;220
622;19.07.2018;2018;07;17;Torstai;139;101;240
622;19.07.2018;2018;07;18;Torstai;119;88;207
622;19.07.2018;2018;07;19;Torstai;110;126;236
622;19.07.2018;2018;07;20;Torstai;83;69;152
622;19.07.2018;2018;07;21;Torstai;125;77;202
622;19.07.2018;2018;07;22;Torstai;92;41;133
622;19.07.2018;2018;07;23;Torstai;59;21;80
622;20.07.2018;2018;07;00;Perjantai;32;14;46
622;20.07.2018;2018;07;01;Perjantai;16;7;23
622;20.07.2018;2018;07;02;Perjantai;19;4;23
622;20.07.2018;2018;07;03;Perjantai;4;2;6
622;20.07.2018;2018;07;04;Perjantai;1;1;2
622;20.07.2018;2018;07;05;Perjantai;3;3;6
622;20.07.2018;2018;07;06;Perjantai;7;13;20
622;20.07.2018;2018;07;07;Perjantai;17;62;79
622;20.07.2018;2018;07;08;Perjantai;32;65;97
622;20.07.2018;2018;07;09;Perjantai;26;52;78
622;20.07.2018;2018;07;10;Perjantai;32;51;83
622;20.07.2018;2018;07;11;Perjantai;36;55;91
622;20.07.2018;2018;07;12;Perjantai;36;80;116
622;20.07.2018;2018;07;13;Perjantai;64;68;132
622;20.07.2018;2018;07;14;Perjantai;81;58;139
622;20.07.2018;2018;07;15;Perjantai;112;110;222
622;20.07.2018;2018;07;16;Perjantai;99;95;194
622;20.07.2018;2018;07;17;Perjantai;91;106;197
622;20.07.2018;2018;07;18;Perjantai;109;78;187
622;20.07.2018;2018;07;19;Perjantai;93;88;181
622;20.07.2018;2018;07;20;Perjantai;85;107;192
622;20.07.2018;2018;07;21;Perjantai;81;60;141
622;20.07.2018;2018;07;22;Perjantai;92;65;157
622;20.07.2018;2018;07;23;Perjantai;76;41;117
622;21.07.2018;2018;07;00;Lauantai;56;25;81
622;21.07.2018;2018;07;01;Lauantai;33;12;45
622;21.07.2018;2018;07;02;Lauantai;30;13;43
622;21.07.2018;2018;07;03;Lauantai;21;5;26
622;21.07.2018;2018;07;04;Lauantai;21;9;30
622;21.07.2018;2018;07;05;Lauantai;15;2;17
622;21.07.2018;2018;07;06;Lauantai;7;4;11
622;21.07.2018;2018;07;07;Lauantai;17;12;29
622;21.07.2018;2018;07;08;Lauantai;10;7;17
622;21.07.2018;2018;07;09;Lauantai;11;21;32
622;21.07.2018;2018;07;10;Lauantai;17;26;43
622;21.07.2018;2018;07;11;Lauantai;20;38;58
622;21.07.2018;2018;07;12;Lauantai;30;48;78
622;21.07.2018;2018;07;13;Lauantai;44;64;108
622;21.07.2018;2018;07;14;Lauantai;31;44;75
622;21.07.2018;2018;07;15;Lauantai;58;37;95
622;21.07.2018;2018;07;16;Lauantai;44;43;87
622;21.07.2018;2018;07;17;Lauantai;50;49;99
622;21.07.2018;2018;07;18;Lauantai;44;45;89
622;21.07.2018;2018;07;19;Lauantai;49;68;117
622;21.07.2018;2018;07;20;Lauantai;64;55;119
622;21.07.2018;2018;07;21;Lauantai;47;56;103
622;21.07.2018;2018;07;22;Lauantai;46;25;71
622;21.07.2018;2018;07;23;Lauantai;29;27;56
622;22.07.2018;2018;07;00;Sunnuntai;27;24;51
622;22.07.2018;2018;07;01;Sunnuntai;20;10;30
622;22.07.2018;2018;07;02;Sunnuntai;8;5;13
622;22.07.2018;2018;07;03;Sunnuntai;21;7;28
622;22.07.2018;2018;07;04;Sunnuntai;17;5;22
622;22.07.2018;2018;07;05;Sunnuntai;10;1;11
622;22.07.2018;2018;07;06;Sunnuntai;7;4;11
622;22.07.2018;2018;07;07;Sunnuntai;7;9;16
622;22.07.2018;2018;07;08;Sunnuntai;10;7;17
622;22.07.2018;2018;07;09;Sunnuntai;9;17;26
622;22.07.2018;2018;07;10;Sunnuntai;9;16;25
622;22.07.2018;2018;07;11;Sunnuntai;18;22;40
622;22.07.2018;2018;07;12;Sunnuntai;28;40;68
622;22.07.2018;2018;07;13;Sunnuntai;43;59;102
622;22.07.2018;2018;07;14;Sunnuntai;42;41;83
622;22.07.2018;2018;07;15;Sunnuntai;39;23;62
622;22.07.2018;2018;07;16;Sunnuntai;44;36;80
622;22.07.2018;2018;07;17;Sunnuntai;22;16;38
622;22.07.2018;2018;07;18;Sunnuntai;28;28;56
622;22.07.2018;2018;07;19;Sunnuntai;41;43;84
622;22.07.2018;2018;07;20;Sunnuntai;30;26;56
622;22.07.2018;2018;07;21;Sunnuntai;22;27;49
622;22.07.2018;2018;07;22;Sunnuntai;32;11;43
622;22.07.2018;2018;07;23;Sunnuntai;13;13;26
622;23.07.2018;2018;07;00;Maanantai;8;5;13
622;23.07.2018;2018;07;01;Maanantai;4;5;9
622;23.07.2018;2018;07;02;Maanantai;5;4;9
622;23.07.2018;2018;07;03;Maanantai;3;3;6
622;23.07.2018;2018;07;04;Maanantai;4;5;9
622;23.07.2018;2018;07;05;Maanantai;5;3;8
622;23.07.2018;2018;07;06;Maanantai;7;14;21
622;23.07.2018;2018;07;07;Maanantai;20;54;74
622;23.07.2018;2018;07;08;Maanantai;23;67;90
622;23.07.2018;2018;07;09;Maanantai;24;49;73
622;23.07.2018;2018;07;10;Maanantai;21;47;68
622;23.07.2018;2018;07;11;Maanantai;26;43;69
622;23.07.2018;2018;07;12;Maanantai;41;57;98
622;23.07.2018;2018;07;13;Maanantai;63;66;129
622;23.07.2018;2018;07;14;Maanantai;59;56;115
622;23.07.2018;2018;07;15;Maanantai;74;64;138
622;23.07.2018;2018;07;16;Maanantai;125;113;238
622;23.07.2018;2018;07;17;Maanantai;144;83;227
622;23.07.2018;2018;07;18;Maanantai;85;89;174
622;23.07.2018;2018;07;19;Maanantai;86;101;187
622;23.07.2018;2018;07;20;Maanantai;85;85;170
622;23.07.2018;2018;07;21;Maanantai;79;62;141
622;23.07.2018;2018;07;22;Maanantai;87;49;136
622;23.07.2018;2018;07;23;Maanantai;32;24;56
622;24.07.2018;2018;07;00;Tiistai;30;15;45
622;24.07.2018;2018;07;01;Tiistai;17;9;26
622;24.07.2018;2018;07;02;Tiistai;2;4;6
622;24.07.2018;2018;07;03;Tiistai;13;5;18
622;24.07.2018;2018;07;04;Tiistai;5;3;8
622;24.07.2018;2018;07;05;Tiistai;2;6;8
622;24.07.2018;2018;07;06;Tiistai;8;19;27
622;24.07.2018;2018;07;07;Tiistai;20;64;84
622;24.07.2018;2018;07;08;Tiistai;33;65;98
622;24.07.2018;2018;07;09;Tiistai;30;68;98
622;24.07.2018;2018;07;10;Tiistai;24;71;95
622;24.07.2018;2018;07;11;Tiistai;39;77;116
622;24.07.2018;2018;07;12;Tiistai;40;74;114
622;24.07.2018;2018;07;13;Tiistai;64;96;160
622;24.07.2018;2018;07;14;Tiistai;81;75;156
622;24.07.2018;2018;07;15;Tiistai;86;69;155
622;24.07.2018;2018;07;16;Tiistai;137;66;203
622;24.07.2018;2018;07;17;Tiistai;107;82;189
622;24.07.2018;2018;07;18;Tiistai;134;125;259
622;24.07.2018;2018;07;19;Tiistai;125;93;218
622;24.07.2018;2018;07;20;Tiistai;135;92;227
622;24.07.2018;2018;07;21;Tiistai;95;68;163
622;24.07.2018;2018;07;22;Tiistai;92;45;137
622;24.07.2018;2018;07;23;Tiistai;58;25;83
622;25.07.2018;2018;07;00;Keskiviikko;38;13;51
622;25.07.2018;2018;07;01;Keskiviikko;20;8;28
622;25.07.2018;2018;07;02;Keskiviikko;7;2;9
622;25.07.2018;2018;07;03;Keskiviikko;12;8;20
622;25.07.2018;2018;07;04;Keskiviikko;7;3;10
622;25.07.2018;2018;07;05;Keskiviikko;3;6;9
622;25.07.2018;2018;07;06;Keskiviikko;12;13;25
622;25.07.2018;2018;07;07;Keskiviikko;24;61;85
622;25.07.2018;2018;07;08;Keskiviikko;28;83;111
622;25.07.2018;2018;07;09;Keskiviikko;30;71;101
622;25.07.2018;2018;07;10;Keskiviikko;23;55;78
622;25.07.2018;2018;07;11;Keskiviikko;42;49;91
622;25.07.2018;2018;07;12;Keskiviikko;72;104;176
622;25.07.2018;2018;07;13;Keskiviikko;57;67;124
622;25.07.2018;2018;07;14;Keskiviikko;81;68;149
622;25.07.2018;2018;07;15;Keskiviikko;100;83;183
622;25.07.2018;2018;07;16;Keskiviikko;121;79;200
622;25.07.2018;2018;07;17;Keskiviikko;119;94;213
622;25.07.2018;2018;07;18;Keskiviikko;99;80;179
622;25.07.2018;2018;07;19;Keskiviikko;114;105;219
622;25.07.2018;2018;07;20;Keskiviikko;102;68;170
622;25.07.2018;2018;07;21;Keskiviikko;90;63;153
622;25.07.2018;2018;07;22;Keskiviikko;79;41;120
622;25.07.2018;2018;07;23;Keskiviikko;63;32;95
622;26.07.2018;2018;07;00;Torstai;29;19;48
622;26.07.2018;2018;07;01;Torstai;21;9;30
622;26.07.2018;2018;07;02;Torstai;9;4;13
622;26.07.2018;2018;07;03;Torstai;15;5;20
622;26.07.2018;2018;07;04;Torstai;11;3;14
622;26.07.2018;2018;07;05;Torstai;4;11;15
622;26.07.2018;2018;07;06;Torstai;9;20;29
622;26.07.2018;2018;07;07;Torstai;17;53;70
622;26.07.2018;2018;07;08;Torstai;31;68;99
622;26.07.2018;2018;07;09;Torstai;23;66;89
622;26.07.2018;2018;07;10;Torstai;32;46;78
622;26.07.2018;2018;07;11;Torstai;45;30;75
622;26.07.2018;2018;07;12;Torstai;47;82;129
622;26.07.2018;2018;07;13;Torstai;48;71;119
622;26.07.2018;2018;07;14;Torstai;71;85;156
622;26.07.2018;2018;07;15;Torstai;84;54;138
622;26.07.2018;2018;07;16;Torstai;91;54;145
622;26.07.2018;2018;07;17;Torstai;125;79;204
622;26.07.2018;2018;07;18;Torstai;97;104;201
622;26.07.2018;2018;07;19;Torstai;75;75;150
622;26.07.2018;2018;07;20;Torstai;96;75;171
622;26.07.2018;2018;07;21;Torstai;71;54;125
622;26.07.2018;2018;07;22;Torstai;66;37;103
622;26.07.2018;2018;07;23;Torstai;37;20;57
622;27.07.2018;2018;07;00;Perjantai;30;8;38
622;27.07.2018;2018;07;01;Perjantai;18;8;26
622;27.07.2018;2018;07;02;Perjantai;2;3;5
622;27.07.2018;2018;07;03;Perjantai;6;1;7
622;27.07.2018;2018;07;04;Perjantai;4;1;5
622;27.07.2018;2018;07;05;Perjantai;5;11;16
622;27.07.2018;2018;07;06;Perjantai;8;17;25
622;27.07.2018;2018;07;07;Perjantai;21;50;71
622;27.07.2018;2018;07;08;Perjantai;24;54;78
622;27.07.2018;2018;07;09;Perjantai;20;69;89
622;27.07.2018;2018;07;10;Perjantai;29;36;65
622;27.07.2018;2018;07;11;Perjantai;40;72;112
622;27.07.2018;2018;07;12;Perjantai;40;75;115
622;27.07.2018;2018;07;13;Perjantai;57;92;149
622;27.07.2018;2018;07;14;Perjantai;90;96;186
622;27.07.2018;2018;07;15;Perjantai;87;127;214
622;27.07.2018;2018;07;16;Perjantai;101;100;201
622;27.07.2018;2018;07;17;Perjantai;134;114;248
622;27.07.2018;2018;07;18;Perjantai;91;85;176
622;27.07.2018;2018;07;19;Perjantai;106;122;228
622;27.07.2018;2018;07;20;Perjantai;80;131;211
622;27.07.2018;2018;07;21;Perjantai;57;62;119
622;27.07.2018;2018;07;22;Perjantai;77;44;121
622;27.07.2018;2018;07;23;Perjantai;70;46;116
622;28.07.2018;2018;07;00;Lauantai;70;19;89
622;28.07.2018;2018;07;01;Lauantai;97;18;115
622;28.07.2018;2018;07;02;Lauantai;107;12;119
622;28.07.2018;2018;07;03;Lauantai;41;13;54
622;28.07.2018;2018;07;04;Lauantai;29;4;33
622;28.07.2018;2018;07;05;Lauantai;21;3;24
622;28.07.2018;2018;07;06;Lauantai;13;8;21
622;28.07.2018;2018;07;07;Lauantai;9;9;18
622;28.07.2018;2018;07;08;Lauantai;5;9;14
622;28.07.2018;2018;07;09;Lauantai;11;19;30
622;28.07.2018;2018;07;10;Lauantai;22;23;45
622;28.07.2018;2018;07;11;Lauantai;19;48;67
622;28.07.2018;2018;07;12;Lauantai;57;80;137
622;28.07.2018;2018;07;13;Lauantai;56;103;159
622;28.07.2018;2018;07;14;Lauantai;90;128;218
622;28.07.2018;2018;07;15;Lauantai;92;122;214
622;28.07.2018;2018;07;16;Lauantai;88;81;169
622;28.07.2018;2018;07;17;Lauantai;96;120;216
622;28.07.2018;2018;07;18;Lauantai;85;85;170
622;28.07.2018;2018;07;19;Lauantai;106;103;209
622;28.07.2018;2018;07;20;Lauantai;102;86;188
622;28.07.2018;2018;07;21;Lauantai;56;64;120
622;28.07.2018;2018;07;22;Lauantai;60;51;111
622;28.07.2018;2018;07;23;Lauantai;61;45;106
622;29.07.2018;2018;07;00;Sunnuntai;52;25;77
622;29.07.2018;2018;07;01;Sunnuntai;83;8;91
622;29.07.2018;2018;07;02;Sunnuntai;104;15;119
622;29.07.2018;2018;07;03;Sunnuntai;54;5;59
622;29.07.2018;2018;07;04;Sunnuntai;43;3;46
622;29.07.2018;2018;07;05;Sunnuntai;25;5;30
622;29.07.2018;2018;07;06;Sunnuntai;15;5;20
622;29.07.2018;2018;07;07;Sunnuntai;11;15;26
622;29.07.2018;2018;07;08;Sunnuntai;7;4;11
622;29.07.2018;2018;07;09;Sunnuntai;7;14;21
622;29.07.2018;2018;07;10;Sunnuntai;14;41;55
622;29.07.2018;2018;07;11;Sunnuntai;29;29;58
622;29.07.2018;2018;07;12;Sunnuntai;42;64;106
622;29.07.2018;2018;07;13;Sunnuntai;69;101;170
622;29.07.2018;2018;07;14;Sunnuntai;61;100;161
622;29.07.2018;2018;07;15;Sunnuntai;69;63;132
622;29.07.2018;2018;07;16;Sunnuntai;76;73;149
622;29.07.2018;2018;07;17;Sunnuntai;87;75;162
622;29.07.2018;2018;07;18;Sunnuntai;82;59;141
622;29.07.2018;2018;07;19;Sunnuntai;94;91;185
622;29.07.2018;2018;07;20;Sunnuntai;118;43;161
622;29.07.2018;2018;07;21;Sunnuntai;71;45;116
622;29.07.2018;2018;07;22;Sunnuntai;54;42;96
622;29.07.2018;2018;07;23;Sunnuntai;43;19;62
622;30.07.2018;2018;07;00;Maanantai;16;8;24
622;30.07.2018;2018;07;01;Maanantai;9;13;22
622;30.07.2018;2018;07;02;Maanantai;3;4;7
622;30.07.2018;2018;07;03;Maanantai;8;6;14
622;30.07.2018;2018;07;04;Maanantai;4;4;8
622;30.07.2018;2018;07;05;Maanantai;3;3;6
622;30.07.2018;2018;07;06;Maanantai;5;17;22
622;30.07.2018;2018;07;07;Maanantai;24;69;93
622;30.07.2018;2018;07;08;Maanantai;30;85;115
622;30.07.2018;2018;07;09;Maanantai;42;63;105
622;30.07.2018;2018;07;10;Maanantai;21;39;60
622;30.07.2018;2018;07;11;Maanantai;44;40;84
622;30.07.2018;2018;07;12;Maanantai;56;55;111
622;30.07.2018;2018;07;13;Maanantai;54;67;121
622;30.07.2018;2018;07;14;Maanantai;53;92;145
622;30.07.2018;2018;07;15;Maanantai;99;70;169
622;30.07.2018;2018;07;16;Maanantai;154;116;270
622;30.07.2018;2018;07;17;Maanantai;162;78;240
622;30.07.2018;2018;07;18;Maanantai;102;101;203
622;30.07.2018;2018;07;19;Maanantai;131;85;216
622;30.07.2018;2018;07;20;Maanantai;107;71;178
622;30.07.2018;2018;07;21;Maanantai;75;46;121
622;30.07.2018;2018;07;22;Maanantai;55;27;82
622;30.07.2018;2018;07;23;Maanantai;44;18;62
622;31.07.2018;2018;07;00;Tiistai;25;5;30
622;31.07.2018;2018;07;01;Tiistai;7;3;10
622;31.07.2018;2018;07;02;Tiistai;5;4;9
622;31.07.2018;2018;07;03;Tiistai;4;4;8
622;31.07.2018;2018;07;04;Tiistai;3;1;4
622;31.07.2018;2018;07;05;Tiistai;1;0;1
622;31.07.2018;2018;07;06;Tiistai;5;14;19
622;31.07.2018;2018;07;07;Tiistai;23;51;74
622;31.07.2018;2018;07;08;Tiistai;35;91;126
622;31.07.2018;2018;07;09;Tiistai;35;49;84
622;31.07.2018;2018;07;10;Tiistai;36;70;106
622;31.07.2018;2018;07;11;Tiistai;34;38;72
622;31.07.2018;2018;07;12;Tiistai;46;75;121
622;31.07.2018;2018;07;13;Tiistai;57;74;131
622;31.07.2018;2018;07;14;Tiistai;66;82;148
622;31.07.2018;2018;07;15;Tiistai;80;78;158
622;31.07.2018;2018;07;16;Tiistai;115;50;165
622;31.07.2018;2018;07;17;Tiistai;119;64;183
622;31.07.2018;2018;07;18;Tiistai;107;75;182
622;31.07.2018;2018;07;19;Tiistai;104;81;185
622;31.07.2018;2018;07;20;Tiistai;103;79;182
622;31.07.2018;2018;07;21;Tiistai;96;54;150
622;31.07.2018;2018;07;22;Tiistai;77;55;132
622;31.07.2018;2018;07;23;Tiistai;54;9;63
622;01.08.2018;2018;08;00;Keskiviikko;25;8;33
622;01.08.2018;2018;08;01;Keskiviikko;15;10;25
622;01.08.2018;2018;08;02;Keskiviikko;11;4;15
622;01.08.2018;2018;08;03;Keskiviikko;10;3;13
622;01.08.2018;2018;08;04;Keskiviikko;2;1;3
622;01.08.2018;2018;08;05;Keskiviikko;5;1;6
622;01.08.2018;2018;08;06;Keskiviikko;11;16;27
622;01.08.2018;2018;08;07;Keskiviikko;18;68;86
622;01.08.2018;2018;08;08;Keskiviikko;22;78;100
622;01.08.2018;2018;08;09;Keskiviikko;45;73;118
622;01.08.2018;2018;08;10;Keskiviikko;34;64;98
622;01.08.2018;2018;08;11;Keskiviikko;48;48;96
622;01.08.2018;2018;08;12;Keskiviikko;46;40;86
622;01.08.2018;2018;08;13;Keskiviikko;41;60;101
622;01.08.2018;2018;08;14;Keskiviikko;81;74;155
622;01.08.2018;2018;08;15;Keskiviikko;72;57;129
622;01.08.2018;2018;08;16;Keskiviikko;143;71;214
622;01.08.2018;2018;08;17;Keskiviikko;113;79;192
622;01.08.2018;2018;08;18;Keskiviikko;63;59;122
622;01.08.2018;2018;08;19;Keskiviikko;103;66;169
622;01.08.2018;2018;08;20;Keskiviikko;76;55;131
622;01.08.2018;2018;08;21;Keskiviikko;58;55;113
622;01.08.2018;2018;08;22;Keskiviikko;67;51;118
622;01.08.2018;2018;08;23;Keskiviikko;33;21;54
622;02.08.2018;2018;08;00;Torstai;51;6;57
622;02.08.2018;2018;08;01;Torstai;40;6;46
622;02.08.2018;2018;08;02;Torstai;9;0;9
622;02.08.2018;2018;08;03;Torstai;11;0;11
622;02.08.2018;2018;08;04;Torstai;10;0;10
622;02.08.2018;2018;08;05;Torstai;10;0;10
622;02.08.2018;2018;08;06;Torstai;35;0;35
622;02.08.2018;2018;08;07;Torstai;92;0;92
622;02.08.2018;2018;08;08;Torstai;105;0;105
622;02.08.2018;2018;08;09;Torstai;73;0;73
622;02.08.2018;2018;08;10;Torstai;54;0;54
622;02.08.2018;2018;08;11;Torstai;88;0;88
622;02.08.2018;2018;08;12;Torstai;112;0;112
622;02.08.2018;2018;08;13;Torstai;120;0;120
622;02.08.2018;2018;08;14;Torstai;160;0;160
622;02.08.2018;2018;08;15;Torstai;183;0;183
622;02.08.2018;2018;08;16;Torstai;220;0;220
622;02.08.2018;2018;08;17;Torstai;240;0;240
622;02.08.2018;2018;08;18;Torstai;207;0;207
622;02.08.2018;2018;08;19;Torstai;236;0;236
622;02.08.2018;2018;08;20;Torstai;152;0;152
622;02.08.2018;2018;08;21;Torstai;202;0;202
622;02.08.2018;2018;08;22;Torstai;133;0;133
622;02.08.2018;2018;08;23;Torstai;80;0;80
622;03.08.2018;2018;08;00;Perjantai;46;0;46
622;03.08.2018;2018;08;01;Perjantai;23;0;23
622;03.08.2018;2018;08;02;Perjantai;23;0;23
622;03.08.2018;2018;08;03;Perjantai;6;0;6
622;03.08.2018;2018;08;04;Perjantai;2;0;2
622;03.08.2018;2018;08;05;Perjantai;6;0;6
622;03.08.2018;2018;08;06;Perjantai;20;0;20
622;03.08.2018;2018;08;07;Perjantai;79;0;79
622;03.08.2018;2018;08;08;Perjantai;97;0;97
622;03.08.2018;2018;08;09;Perjantai;78;0;78
622;03.08.2018;2018;08;10;Perjantai;83;0;83
622;03.08.2018;2018;08;11;Perjantai;91;0;91
622;03.08.2018;2018;08;12;Perjantai;116;0;116
622;03.08.2018;2018;08;13;Perjantai;132;0;132
622;03.08.2018;2018;08;14;Perjantai;139;0;139
622;03.08.2018;2018;08;15;Perjantai;222;0;222
622;03.08.2018;2018;08;16;Perjantai;194;0;194
622;03.08.2018;2018;08;17;Perjantai;197;0;197
622;03.08.2018;2018;08;18;Perjantai;187;0;187
622;03.08.2018;2018;08;19;Perjantai;181;0;181
622;03.08.2018;2018;08;20;Perjantai;192;0;192
622;03.08.2018;2018;08;21;Perjantai;141;0;141
622;03.08.2018;2018;08;22;Perjantai;157;0;157
622;03.08.2018;2018;08;23;Perjantai;117;0;117
622;04.08.2018;2018;08;00;Lauantai;81;0;81
622;04.08.2018;2018;08;01;Lauantai;45;0;45
622;04.08.2018;2018;08;02;Lauantai;43;0;43
622;04.08.2018;2018;08;03;Lauantai;26;0;26
622;04.08.2018;2018;08;04;Lauantai;30;0;30
622;04.08.2018;2018;08;05;Lauantai;17;0;17
622;04.08.2018;2018;08;06;Lauantai;11;0;11
622;04.08.2018;2018;08;07;Lauantai;29;0;29
622;04.08.2018;2018;08;08;Lauantai;17;0;17
622;04.08.2018;2018;08;09;Lauantai;32;0;32
622;04.08.2018;2018;08;10;Lauantai;43;0;43
622;04.08.2018;2018;08;11;Lauantai;58;0;58
622;04.08.2018;2018;08;12;Lauantai;78;0;78
622;04.08.2018;2018;08;13;Lauantai;108;0;108
622;04.08.2018;2018;08;14;Lauantai;75;0;75
622;04.08.2018;2018;08;15;Lauantai;95;0;95
622;04.08.2018;2018;08;16;Lauantai;87;0;87
622;04.08.2018;2018;08;17;Lauantai;99;0;99
622;04.08.2018;2018;08;18;Lauantai;89;0;89
622;04.08.2018;2018;08;19;Lauantai;117;0;117
622;04.08.2018;2018;08;20;Lauantai;119;0;119
622;04.08.2018;2018;08;21;Lauantai;103;0;103
622;04.08.2018;2018;08;22;Lauantai;71;0;71
622;04.08.2018;2018;08;23;Lauantai;56;0;56
622;05.08.2018;2018;08;00;Sunnuntai;51;0;51
622;05.08.2018;2018;08;01;Sunnuntai;30;0;30
622;05.08.2018;2018;08;02;Sunnuntai;13;0;13
622;05.08.2018;2018;08;03;Sunnuntai;28;0;28
622;05.08.2018;2018;08;04;Sunnuntai;22;0;22
622;05.08.2018;2018;08;05;Sunnuntai;11;0;11
622;05.08.2018;2018;08;06;Sunnuntai;11;0;11
622;05.08.2018;2018;08;07;Sunnuntai;16;0;16
622;05.08.2018;2018;08;08;Sunnuntai;17;0;17
622;05.08.2018;2018;08;09;Sunnuntai;26;0;26
622;05.08.2018;2018;08;10;Sunnuntai;25;0;25
622;05.08.2018;2018;08;11;Sunnuntai;40;0;40
622;05.08.2018;2018;08;12;Sunnuntai;68;0;68
622;05.08.2018;2018;08;13;Sunnuntai;102;0;102
622;05.08.2018;2018;08;14;Sunnuntai;83;0;83
622;05.08.2018;2018;08;15;Sunnuntai;62;0;62
622;05.08.2018;2018;08;16;Sunnuntai;80;0;80
622;05.08.2018;2018;08;17;Sunnuntai;38;0;38
622;05.08.2018;2018;08;18;Sunnuntai;56;0;56
622;05.08.2018;2018;08;19;Sunnuntai;84;0;84
622;05.08.2018;2018;08;20;Sunnuntai;56;0;56
622;05.08.2018;2018;08;21;Sunnuntai;49;0;49
622;05.08.2018;2018;08;22;Sunnuntai;43;0;43
622;05.08.2018;2018;08;23;Sunnuntai;26;0;26
622;06.08.2018;2018;08;00;Maanantai;0;0;0
622;06.08.2018;2018;08;01;Maanantai;0;0;0
622;06.08.2018;2018;08;02;Maanantai;0;0;0
622;06.08.2018;2018;08;03;Maanantai;0;0;0
622;06.08.2018;2018;08;04;Maanantai;0;0;0
622;06.08.2018;2018;08;05;Maanantai;5;5;10
622;06.08.2018;2018;08;06;Maanantai;10;10;20
622;06.08.2018;2018;08;07;Maanantai;15;15;30
622;06.08.2018;2018;08;08;Maanantai;20;30;50
622;06.08.2018;2018;08;09;Maanantai;26;40;66
622;06.08.2018;2018;08;10;Maanantai;31;24;55
622;06.08.2018;2018;08;11;Maanantai;21;35;56
622;06.08.2018;2018;08;12;Maanantai;24;27;51
622;06.08.2018;2018;08;13;Maanantai;21;18;39
622;06.08.2018;2018;08;14;Maanantai;22;23;45
622;06.08.2018;2018;08;15;Maanantai;40;23;63
622;06.08.2018;2018;08;16;Maanantai;80;52;132
622;06.08.2018;2018;08;17;Maanantai;67;60;127
622;06.08.2018;2018;08;18;Maanantai;73;67;140
622;06.08.2018;2018;08;19;Maanantai;38;56;94
622;06.08.2018;2018;08;20;Maanantai;57;30;87
622;06.08.2018;2018;08;21;Maanantai;41;28;69
622;06.08.2018;2018;08;22;Maanantai;35;17;52
622;06.08.2018;2018;08;23;Maanantai;14;13;27
622;07.08.2018;2018;08;00;Tiistai;9;5;14
622;07.08.2018;2018;08;01;Tiistai;7;9;16
622;07.08.2018;2018;08;02;Tiistai;5;2;7
622;07.08.2018;2018;08;03;Tiistai;4;1;5
622;07.08.2018;2018;08;04;Tiistai;0;1;1
622;07.08.2018;2018;08;05;Tiistai;0;4;4
622;07.08.2018;2018;08;06;Tiistai;7;24;31
622;07.08.2018;2018;08;07;Tiistai;37;69;106
622;07.08.2018;2018;08;08;Tiistai;45;124;169
622;07.08.2018;2018;08;09;Tiistai;59;90;149
622;07.08.2018;2018;08;10;Tiistai;37;78;115
622;07.08.2018;2018;08;11;Tiistai;43;55;98
622;07.08.2018;2018;08;12;Tiistai;42;74;116
622;07.08.2018;2018;08;13;Tiistai;45;67;112
622;07.08.2018;2018;08;14;Tiistai;71;72;143
622;07.08.2018;2018;08;15;Tiistai;85;91;176
622;07.08.2018;2018;08;16;Tiistai;126;94;220
622;07.08.2018;2018;08;17;Tiistai;135;95;230
622;07.08.2018;2018;08;18;Tiistai;104;96;200
622;07.08.2018;2018;08;19;Tiistai;89;84;173
622;07.08.2018;2018;08;20;Tiistai;89;64;153
622;07.08.2018;2018;08;21;Tiistai;54;54;108
622;07.08.2018;2018;08;22;Tiistai;66;31;97
622;07.08.2018;2018;08;23;Tiistai;21;13;34
622;08.08.2018;2018;08;00;Keskiviikko;16;6;22
622;08.08.2018;2018;08;01;Keskiviikko;11;7;18
622;08.08.2018;2018;08;02;Keskiviikko;3;1;4
622;08.08.2018;2018;08;03;Keskiviikko;5;1;6
622;08.08.2018;2018;08;04;Keskiviikko;2;1;3
622;08.08.2018;2018;08;05;Keskiviikko;0;2;2
622;08.08.2018;2018;08;06;Keskiviikko;8;22;30
622;08.08.2018;2018;08;07;Keskiviikko;32;86;118
622;08.08.2018;2018;08;08;Keskiviikko;52;112;164
622;08.08.2018;2018;08;09;Keskiviikko;65;96;161
622;08.08.2018;2018;08;10;Keskiviikko;42;75;117
622;08.08.2018;2018;08;11;Keskiviikko;40;38;78
622;08.08.2018;2018;08;12;Keskiviikko;66;39;105
622;08.08.2018;2018;08;13;Keskiviikko;59;69;128
622;08.08.2018;2018;08;14;Keskiviikko;60;61;121
622;08.08.2018;2018;08;15;Keskiviikko;79;65;144
622;08.08.2018;2018;08;16;Keskiviikko;114;87;201
622;08.08.2018;2018;08;17;Keskiviikko;151;143;294
622;08.08.2018;2018;08;18;Keskiviikko;131;74;205
622;08.08.2018;2018;08;19;Keskiviikko;106;81;187
622;08.08.2018;2018;08;20;Keskiviikko;111;61;172
622;08.08.2018;2018;08;21;Keskiviikko;85;23;108
622;08.08.2018;2018;08;22;Keskiviikko;49;31;80
622;08.08.2018;2018;08;23;Keskiviikko;22;12;34
622;09.08.2018;2018;08;00;Torstai;16;11;27
622;09.08.2018;2018;08;01;Torstai;4;2;6
622;09.08.2018;2018;08;02;Torstai;2;6;8
622;09.08.2018;2018;08;03;Torstai;4;2;6
622;09.08.2018;2018;08;04;Torstai;6;1;7
622;09.08.2018;2018;08;05;Torstai;3;4;7
622;09.08.2018;2018;08;06;Torstai;9;15;24
622;09.08.2018;2018;08;07;Torstai;18;57;75
622;09.08.2018;2018;08;08;Torstai;37;95;132
622;09.08.2018;2018;08;09;Torstai;71;53;124
622;09.08.2018;2018;08;10;Torstai;31;69;100
622;09.08.2018;2018;08;11;Torstai;31;43;74
622;09.08.2018;2018;08;12;Torstai;39;43;82
622;09.08.2018;2018;08;13;Torstai;49;64;113
622;09.08.2018;2018;08;14;Torstai;59;46;105
622;09.08.2018;2018;08;15;Torstai;65;61;126
622;09.08.2018;2018;08;16;Torstai;105;86;191
622;09.08.2018;2018;08;17;Torstai;100;102;202
622;09.08.2018;2018;08;18;Torstai;98;55;153
622;09.08.2018;2018;08;19;Torstai;80;76;156
622;09.08.2018;2018;08;20;Torstai;86;49;135
622;09.08.2018;2018;08;21;Torstai;51;29;80
622;09.08.2018;2018;08;22;Torstai;38;25;63
622;09.08.2018;2018;08;23;Torstai;19;15;34
622;10.08.2018;2018;08;00;Perjantai;12;4;16
622;10.08.2018;2018;08;01;Perjantai;8;3;11
622;10.08.2018;2018;08;02;Perjantai;5;4;9
622;10.08.2018;2018;08;03;Perjantai;4;2;6
622;10.08.2018;2018;08;04;Perjantai;1;1;2
622;10.08.2018;2018;08;05;Perjantai;0;3;3
622;10.08.2018;2018;08;06;Perjantai;9;18;27
622;10.08.2018;2018;08;07;Perjantai;26;79;105
622;10.08.2018;2018;08;08;Perjantai;47;106;153
622;10.08.2018;2018;08;09;Perjantai;77;122;199
622;10.08.2018;2018;08;10;Perjantai;35;78;113
622;10.08.2018;2018;08;11;Perjantai;49;33;82
622;10.08.2018;2018;08;12;Perjantai;61;80;141
622;10.08.2018;2018;08;13;Perjantai;75;66;141
622;10.08.2018;2018;08;14;Perjantai;83;48;131
622;10.08.2018;2018;08;15;Perjantai;109;101;210
622;10.08.2018;2018;08;16;Perjantai;139;101;240
622;10.08.2018;2018;08;17;Perjantai;114;103;217
622;10.08.2018;2018;08;18;Perjantai;104;40;144
622;10.08.2018;2018;08;19;Perjantai;86;52;138
622;10.08.2018;2018;08;20;Perjantai;84;64;148
622;10.08.2018;2018;08;21;Perjantai;51;35;86
622;10.08.2018;2018;08;22;Perjantai;29;9;38
622;10.08.2018;2018;08;23;Perjantai;14;9;23
622;11.08.2018;2018;08;00;Lauantai;10;5;15
622;11.08.2018;2018;08;01;Lauantai;22;9;31
622;11.08.2018;2018;08;02;Lauantai;9;5;14
622;11.08.2018;2018;08;03;Lauantai;5;4;9
622;11.08.2018;2018;08;04;Lauantai;4;3;7
622;11.08.2018;2018;08;05;Lauantai;3;3;6
622;11.08.2018;2018;08;06;Lauantai;11;5;16
622;11.08.2018;2018;08;07;Lauantai;4;7;11
622;11.08.2018;2018;08;08;Lauantai;4;11;15
622;11.08.2018;2018;08;09;Lauantai;9;19;28
622;11.08.2018;2018;08;10;Lauantai;12;42;54
622;11.08.2018;2018;08;11;Lauantai;28;37;65
622;11.08.2018;2018;08;12;Lauantai;29;47;76
622;11.08.2018;2018;08;13;Lauantai;38;62;100
622;11.08.2018;2018;08;14;Lauantai;56;47;103
622;11.08.2018;2018;08;15;Lauantai;47;45;92
622;11.08.2018;2018;08;16;Lauantai;52;46;98
622;11.08.2018;2018;08;17;Lauantai;66;62;128
622;11.08.2018;2018;08;18;Lauantai;51;39;90
622;11.08.2018;2018;08;19;Lauantai;45;54;99
622;11.08.2018;2018;08;20;Lauantai;36;34;70
622;11.08.2018;2018;08;21;Lauantai;31;36;67
622;11.08.2018;2018;08;22;Lauantai;34;29;63
622;11.08.2018;2018;08;23;Lauantai;22;15;37
622;12.08.2018;2018;08;00;Sunnuntai;32;14;46
622;12.08.2018;2018;08;01;Sunnuntai;16;8;24
622;12.08.2018;2018;08;02;Sunnuntai;12;3;15
622;12.08.2018;2018;08;03;Sunnuntai;13;2;15
622;12.08.2018;2018;08;04;Sunnuntai;6;7;13
622;12.08.2018;2018;08;05;Sunnuntai;12;3;15
622;12.08.2018;2018;08;06;Sunnuntai;9;8;17
622;12.08.2018;2018;08;07;Sunnuntai;6;8;14
622;12.08.2018;2018;08;08;Sunnuntai;8;9;17
622;12.08.2018;2018;08;09;Sunnuntai;8;17;25
622;12.08.2018;2018;08;10;Sunnuntai;16;17;33
622;12.08.2018;2018;08;11;Sunnuntai;13;34;47
622;12.08.2018;2018;08;12;Sunnuntai;34;41;75
622;12.08.2018;2018;08;13;Sunnuntai;51;57;108
622;12.08.2018;2018;08;14;Sunnuntai;58;68;126
622;12.08.2018;2018;08;15;Sunnuntai;74;62;136
622;12.08.2018;2018;08;16;Sunnuntai;77;39;116
622;12.08.2018;2018;08;17;Sunnuntai;74;51;125
622;12.08.2018;2018;08;18;Sunnuntai;57;47;104
622;12.08.2018;2018;08;19;Sunnuntai;69;56;125
622;12.08.2018;2018;08;20;Sunnuntai;60;48;108
622;12.08.2018;2018;08;21;Sunnuntai;39;29;68
622;12.08.2018;2018;08;22;Sunnuntai;26;11;37
622;12.08.2018;2018;08;23;Sunnuntai;20;12;32
622;13.08.2018;2018;08;00;Maanantai;5;8;13
622;13.08.2018;2018;08;01;Maanantai;6;1;7
622;13.08.2018;2018;08;02;Maanantai;5;2;7
622;13.08.2018;2018;08;03;Maanantai;1;3;4
622;13.08.2018;2018;08;04;Maanantai;1;0;1
622;13.08.2018;2018;08;05;Maanantai;2;3;5
622;13.08.2018;2018;08;06;Maanantai;4;16;20
622;13.08.2018;2018;08;07;Maanantai;28;38;66
622;13.08.2018;2018;08;08;Maanantai;53;82;135
622;13.08.2018;2018;08;09;Maanantai;73;109;182
622;13.08.2018;2018;08;10;Maanantai;34;82;116
622;13.08.2018;2018;08;11;Maanantai;22;39;61
622;13.08.2018;2018;08;12;Maanantai;36;24;60
622;13.08.2018;2018;08;13;Maanantai;39;68;107
622;13.08.2018;2018;08;14;Maanantai;45;47;92
622;13.08.2018;2018;08;15;Maanantai;72;48;120
622;13.08.2018;2018;08;16;Maanantai;88;87;175
622;13.08.2018;2018;08;17;Maanantai;135;72;207
622;13.08.2018;2018;08;18;Maanantai;82;61;143
622;13.08.2018;2018;08;19;Maanantai;53;49;102
622;13.08.2018;2018;08;20;Maanantai;46;28;74
622;13.08.2018;2018;08;21;Maanantai;38;26;64
622;13.08.2018;2018;08;22;Maanantai;24;17;41
622;13.08.2018;2018;08;23;Maanantai;11;15;26
622;14.08.2018;2018;08;00;Tiistai;9;9;18
622;14.08.2018;2018;08;01;Tiistai;4;2;6
622;14.08.2018;2018;08;02;Tiistai;7;3;10
622;14.08.2018;2018;08;03;Tiistai;3;1;4
622;14.08.2018;2018;08;04;Tiistai;2;3;5
622;14.08.2018;2018;08;05;Tiistai;1;3;4
622;14.08.2018;2018;08;06;Tiistai;10;19;29
622;14.08.2018;2018;08;07;Tiistai;28;83;111
622;14.08.2018;2018;08;08;Tiistai;96;139;235
622;14.08.2018;2018;08;09;Tiistai;70;103;173
622;14.08.2018;2018;08;10;Tiistai;31;68;99
622;14.08.2018;2018;08;11;Tiistai;24;59;83
622;14.08.2018;2018;08;12;Tiistai;46;63;109
622;14.08.2018;2018;08;13;Tiistai;39;76;115
622;14.08.2018;2018;08;14;Tiistai;71;52;123
622;14.08.2018;2018;08;15;Tiistai;84;53;137
622;14.08.2018;2018;08;16;Tiistai;131;92;223
622;14.08.2018;2018;08;17;Tiistai;141;85;226
622;14.08.2018;2018;08;18;Tiistai;108;83;191
622;14.08.2018;2018;08;19;Tiistai;63;48;111
622;14.08.2018;2018;08;20;Tiistai;62;57;119
622;14.08.2018;2018;08;21;Tiistai;61;37;98
622;14.08.2018;2018;08;22;Tiistai;44;26;70
622;14.08.2018;2018;08;23;Tiistai;20;11;31
622;15.08.2018;2018;08;00;Keskiviikko;8;3;11
622;15.08.2018;2018;08;01;Keskiviikko;6;3;9
622;15.08.2018;2018;08;02;Keskiviikko;1;0;1
622;15.08.2018;2018;08;03;Keskiviikko;3;2;5
622;15.08.2018;2018;08;04;Keskiviikko;2;1;3
622;15.08.2018;2018;08;05;Keskiviikko;1;4;5
622;15.08.2018;2018;08;06;Keskiviikko;5;16;21
622;15.08.2018;2018;08;07;Keskiviikko;26;72;98
622;15.08.2018;2018;08;08;Keskiviikko;74;143;217
622;15.08.2018;2018;08;09;Keskiviikko;63;119;182
622;15.08.2018;2018;08;10;Keskiviikko;43;62;105
622;15.08.2018;2018;08;11;Keskiviikko;33;61;94
622;15.08.2018;2018;08;12;Keskiviikko;38;57;95
622;15.08.2018;2018;08;13;Keskiviikko;58;59;117
622;15.08.2018;2018;08;14;Keskiviikko;63;83;146
622;15.08.2018;2018;08;15;Keskiviikko;85;77;162
622;15.08.2018;2018;08;16;Keskiviikko;134;63;197
622;15.08.2018;2018;08;17;Keskiviikko;155;96;251
622;15.08.2018;2018;08;18;Keskiviikko;104;69;173
622;15.08.2018;2018;08;19;Keskiviikko;90;55;145
622;15.08.2018;2018;08;20;Keskiviikko;60;64;124
622;15.08.2018;2018;08;21;Keskiviikko;55;41;96
622;15.08.2018;2018;08;22;Keskiviikko;55;17;72
622;15.08.2018;2018;08;23;Keskiviikko;25;17;42
622;16.08.2018;2018;08;00;Torstai;6;1;7
622;16.08.2018;2018;08;01;Torstai;6;2;8
622;16.08.2018;2018;08;02;Torstai;6;3;9
622;16.08.2018;2018;08;03;Torstai;0;2;2
622;16.08.2018;2018;08;04;Torstai;0;2;2
622;16.08.2018;2018;08;05;Torstai;0;6;6
622;16.08.2018;2018;08;06;Torstai;8;17;25
622;16.08.2018;2018;08;07;Torstai;24;66;90
622;16.08.2018;2018;08;08;Torstai;97;145;242
622;16.08.2018;2018;08;09;Torstai;75;91;166
622;16.08.2018;2018;08;10;Torstai;27;53;80
622;16.08.2018;2018;08;11;Torstai;30;52;82
622;16.08.2018;2018;08;12;Torstai;39;44;83
622;16.08.2018;2018;08;13;Torstai;48;66;114
622;16.08.2018;2018;08;14;Torstai;51;44;95
622;16.08.2018;2018;08;15;Torstai;62;56;118
622;16.08.2018;2018;08;16;Torstai;108;77;185
622;16.08.2018;2018;08;17;Torstai;168;92;260
622;16.08.2018;2018;08;18;Torstai;88;86;174
622;16.08.2018;2018;08;19;Torstai;78;65;143
622;16.08.2018;2018;08;20;Torstai;60;42;102
622;16.08.2018;2018;08;21;Torstai;87;55;142
622;16.08.2018;2018;08;22;Torstai;70;30;100
622;16.08.2018;2018;08;23;Torstai;39;13;52
622;17.08.2018;2018;08;00;Perjantai;21;7;28
622;17.08.2018;2018;08;01;Perjantai;11;0;11
622;17.08.2018;2018;08;02;Perjantai;13;2;15
622;17.08.2018;2018;08;03;Perjantai;5;0;5
622;17.08.2018;2018;08;04;Perjantai;3;1;4
622;17.08.2018;2018;08;05;Perjantai;4;8;12
622;17.08.2018;2018;08;06;Perjantai;9;19;28
622;17.08.2018;2018;08;07;Perjantai;23;68;91
622;17.08.2018;2018;08;08;Perjantai;74;91;165
622;17.08.2018;2018;08;09;Perjantai;76;68;144
622;17.08.2018;2018;08;10;Perjantai;42;72;114
622;17.08.2018;2018;08;11;Perjantai;27;41;68
622;17.08.2018;2018;08;12;Perjantai;36;43;79
622;17.08.2018;2018;08;13;Perjantai;34;56;90
622;17.08.2018;2018;08;14;Perjantai;53;62;115
622;17.08.2018;2018;08;15;Perjantai;85;67;152
622;17.08.2018;2018;08;16;Perjantai;101;76;177
622;17.08.2018;2018;08;17;Perjantai;86;57;143
622;17.08.2018;2018;08;18;Perjantai;84;60;144
622;17.08.2018;2018;08;19;Perjantai;68;41;109
622;17.08.2018;2018;08;20;Perjantai;57;36;93
622;17.08.2018;2018;08;21;Perjantai;40;22;62
622;17.08.2018;2018;08;22;Perjantai;51;20;71
622;17.08.2018;2018;08;23;Perjantai;23;13;36
622;18.08.2018;2018;08;00;Lauantai;13;2;15
622;18.08.2018;2018;08;01;Lauantai;8;7;15
622;18.08.2018;2018;08;02;Lauantai;6;0;6
622;18.08.2018;2018;08;03;Lauantai;6;2;8
622;18.08.2018;2018;08;04;Lauantai;9;5;14
622;18.08.2018;2018;08;05;Lauantai;5;2;7
622;18.08.2018;2018;08;06;Lauantai;2;5;7
622;18.08.2018;2018;08;07;Lauantai;4;13;17
622;18.08.2018;2018;08;08;Lauantai;8;9;17
622;18.08.2018;2018;08;09;Lauantai;9;23;32
622;18.08.2018;2018;08;10;Lauantai;21;20;41
622;18.08.2018;2018;08;11;Lauantai;33;26;59
622;18.08.2018;2018;08;12;Lauantai;44;44;88
622;18.08.2018;2018;08;13;Lauantai;37;60;97
622;18.08.2018;2018;08;14;Lauantai;32;66;98
622;18.08.2018;2018;08;15;Lauantai;58;55;113
622;18.08.2018;2018;08;16;Lauantai;75;65;140
622;18.08.2018;2018;08;17;Lauantai;60;89;149
622;18.08.2018;2018;08;18;Lauantai;54;74;128
622;18.08.2018;2018;08;19;Lauantai;60;59;119
622;18.08.2018;2018;08;20;Lauantai;47;70;117
622;18.08.2018;2018;08;21;Lauantai;48;43;91
622;18.08.2018;2018;08;22;Lauantai;37;33;70
622;18.08.2018;2018;08;23;Lauantai;38;16;54
622;19.08.2018;2018;08;00;Sunnuntai;34;21;55
622;19.08.2018;2018;08;01;Sunnuntai;68;8;76
622;19.08.2018;2018;08;02;Sunnuntai;25;5;30
622;19.08.2018;2018;08;03;Sunnuntai;0;0;0
622;19.08.2018;2018;08;04;Sunnuntai;26;7;33
622;19.08.2018;2018;08;05;Sunnuntai;4;3;7
622;19.08.2018;2018;08;06;Sunnuntai;13;5;18
622;19.08.2018;2018;08;07;Sunnuntai;2;6;8
622;19.08.2018;2018;08;08;Sunnuntai;2;7;9
622;19.08.2018;2018;08;09;Sunnuntai;10;13;23
622;19.08.2018;2018;08;10;Sunnuntai;10;16;26
622;19.08.2018;2018;08;11;Sunnuntai;12;25;37
622;19.08.2018;2018;08;12;Sunnuntai;25;33;58
622;19.08.2018;2018;08;13;Sunnuntai;34;47;81
622;19.08.2018;2018;08;14;Sunnuntai;26;56;82
622;19.08.2018;2018;08;15;Sunnuntai;41;46;87
622;19.08.2018;2018;08;16;Sunnuntai;49;42;91
622;19.08.2018;2018;08;17;Sunnuntai;58;34;92
622;19.08.2018;2018;08;18;Sunnuntai;34;38;72
622;19.08.2018;2018;08;19;Sunnuntai;40;52;92
622;19.08.2018;2018;08;20;Sunnuntai;45;34;79
622;19.08.2018;2018;08;21;Sunnuntai;36;15;51
622;19.08.2018;2018;08;22;Sunnuntai;29;13;42
622;19.08.2018;2018;08;23;Sunnuntai;6;5;11
622;20.08.2018;2018;08;00;Maanantai;3;3;6
622;20.08.2018;2018;08;01;Maanantai;1;2;3
622;20.08.2018;2018;08;02;Maanantai;2;1;3
622;20.08.2018;2018;08;03;Maanantai;3;0;3
622;20.08.2018;2018;08;04;Maanantai;2;1;3
622;20.08.2018;2018;08;05;Maanantai;1;4;5
622;20.08.2018;2018;08;06;Maanantai;5;14;19
622;20.08.2018;2018;08;07;Maanantai;30;69;99
622;20.08.2018;2018;08;08;Maanantai;76;98;174
622;20.08.2018;2018;08;09;Maanantai;64;81;145
622;20.08.2018;2018;08;10;Maanantai;24;64;88
622;20.08.2018;2018;08;11;Maanantai;27;33;60
622;20.08.2018;2018;08;12;Maanantai;28;36;64
622;20.08.2018;2018;08;13;Maanantai;26;51;77
622;20.08.2018;2018;08;14;Maanantai;50;55;105
622;20.08.2018;2018;08;15;Maanantai;77;66;143
622;20.08.2018;2018;08;16;Maanantai;104;84;188
622;20.08.2018;2018;08;17;Maanantai;133;77;210
622;20.08.2018;2018;08;18;Maanantai;93;89;182
622;20.08.2018;2018;08;19;Maanantai;83;51;134
622;20.08.2018;2018;08;20;Maanantai;65;30;95
622;20.08.2018;2018;08;21;Maanantai;31;25;56
622;20.08.2018;2018;08;22;Maanantai;45;21;66
622;20.08.2018;2018;08;23;Maanantai;13;7;20
622;21.08.2018;2018;08;00;Tiistai;9;3;12
622;21.08.2018;2018;08;01;Tiistai;6;1;7
622;21.08.2018;2018;08;02;Tiistai;2;1;3
622;21.08.2018;2018;08;03;Tiistai;1;0;1
622;21.08.2018;2018;08;04;Tiistai;2;0;2
622;21.08.2018;2018;08;05;Tiistai;1;2;3
622;21.08.2018;2018;08;06;Tiistai;4;19;23
622;21.08.2018;2018;08;07;Tiistai;39;49;88
622;21.08.2018;2018;08;08;Tiistai;85;85;170
622;21.08.2018;2018;08;09;Tiistai;46;94;140
622;21.08.2018;2018;08;10;Tiistai;45;42;87
622;21.08.2018;2018;08;11;Tiistai;44;39;83
622;21.08.2018;2018;08;12;Tiistai;51;48;99
622;21.08.2018;2018;08;13;Tiistai;48;72;120
622;21.08.2018;2018;08;14;Tiistai;54;45;99
622;21.08.2018;2018;08;15;Tiistai;86;53;139
622;21.08.2018;2018;08;16;Tiistai;103;68;171
622;21.08.2018;2018;08;17;Tiistai;132;84;216
622;21.08.2018;2018;08;18;Tiistai;81;67;148
622;21.08.2018;2018;08;19;Tiistai;63;48;111
622;21.08.2018;2018;08;20;Tiistai;73;39;112
622;21.08.2018;2018;08;21;Tiistai;41;19;60
622;21.08.2018;2018;08;22;Tiistai;34;27;61
622;21.08.2018;2018;08;23;Tiistai;13;7;20
622;22.08.2018;2018;08;00;Keskiviikko;9;5;14
622;22.08.2018;2018;08;01;Keskiviikko;4;2;6
622;22.08.2018;2018;08;02;Keskiviikko;1;0;1
622;22.08.2018;2018;08;03;Keskiviikko;5;1;6
622;22.08.2018;2018;08;04;Keskiviikko;0;1;1
622;22.08.2018;2018;08;05;Keskiviikko;0;1;1
622;22.08.2018;2018;08;06;Keskiviikko;3;16;19
622;22.08.2018;2018;08;07;Keskiviikko;27;73;100
622;22.08.2018;2018;08;08;Keskiviikko;70;104;174
622;22.08.2018;2018;08;09;Keskiviikko;75;87;162
622;22.08.2018;2018;08;10;Keskiviikko;47;44;91
622;22.08.2018;2018;08;11;Keskiviikko;22;57;79
622;22.08.2018;2018;08;12;Keskiviikko;28;37;65
622;22.08.2018;2018;08;13;Keskiviikko;35;48;83
622;22.08.2018;2018;08;14;Keskiviikko;39;57;96
622;22.08.2018;2018;08;15;Keskiviikko;101;44;145
622;22.08.2018;2018;08;16;Keskiviikko;126;81;207
622;22.08.2018;2018;08;17;Keskiviikko;149;74;223
622;22.08.2018;2018;08;18;Keskiviikko;91;55;146
622;22.08.2018;2018;08;19;Keskiviikko;72;48;120
622;22.08.2018;2018;08;20;Keskiviikko;53;22;75
622;22.08.2018;2018;08;21;Keskiviikko;41;12;53
622;22.08.2018;2018;08;22;Keskiviikko;30;13;43
622;22.08.2018;2018;08;23;Keskiviikko;16;7;23
622;23.08.2018;2018;08;00;Torstai;6;1;7
622;23.08.2018;2018;08;01;Torstai;5;1;6
622;23.08.2018;2018;08;02;Torstai;2;1;3
622;23.08.2018;2018;08;03;Torstai;1;0;1
622;23.08.2018;2018;08;04;Torstai;0;0;0
622;23.08.2018;2018;08;05;Torstai;0;4;4
622;23.08.2018;2018;08;06;Torstai;4;12;16
622;23.08.2018;2018;08;07;Torstai;17;45;62
622;23.08.2018;2018;08;08;Torstai;48;69;117
622;23.08.2018;2018;08;09;Torstai;47;42;89
622;23.08.2018;2018;08;10;Torstai;8;9;17
622;23.08.2018;2018;08;11;Torstai;2;10;12
622;23.08.2018;2018;08;12;Torstai;15;10;25
622;23.08.2018;2018;08;13;Torstai;22;28;50
622;23.08.2018;2018;08;14;Torstai;29;17;46
622;23.08.2018;2018;08;15;Torstai;55;45;100
622;23.08.2018;2018;08;16;Torstai;61;46;107
622;23.08.2018;2018;08;17;Torstai;89;50;139
622;23.08.2018;2018;08;18;Torstai;64;47;111
622;23.08.2018;2018;08;19;Torstai;69;31;100
622;23.08.2018;2018;08;20;Torstai;55;38;93
622;23.08.2018;2018;08;21;Torstai;47;22;69
622;23.08.2018;2018;08;22;Torstai;29;14;43
622;23.08.2018;2018;08;23;Torstai;9;8;17
622;24.08.2018;2018;08;00;Perjantai;7;3;10
622;24.08.2018;2018;08;01;Perjantai;4;0;4
622;24.08.2018;2018;08;02;Perjantai;0;0;0
622;24.08.2018;2018;08;03;Perjantai;1;2;3
622;24.08.2018;2018;08;04;Perjantai;0;4;4
622;24.08.2018;2018;08;05;Perjantai;1;0;1
622;24.08.2018;2018;08;06;Perjantai;2;9;11
622;24.08.2018;2018;08;07;Perjantai;18;44;62
622;24.08.2018;2018;08;08;Perjantai;27;65;92
622;24.08.2018;2018;08;09;Perjantai;46;62;108
622;24.08.2018;2018;08;10;Perjantai;11;31;42
622;24.08.2018;2018;08;11;Perjantai;10;18;28
622;24.08.2018;2018;08;12;Perjantai;11;11;22
622;24.08.2018;2018;08;13;Perjantai;12;28;40
622;24.08.2018;2018;08;14;Perjantai;28;24;52
622;24.08.2018;2018;08;15;Perjantai;53;27;80
622;24.08.2018;2018;08;16;Perjantai;61;48;109
622;24.08.2018;2018;08;17;Perjantai;62;42;104
622;24.08.2018;2018;08;18;Perjantai;38;29;67
622;24.08.2018;2018;08;19;Perjantai;42;43;85
622;24.08.2018;2018;08;20;Perjantai;39;36;75
622;24.08.2018;2018;08;21;Perjantai;33;15;48
622;24.08.2018;2018;08;22;Perjantai;20;7;27
622;24.08.2018;2018;08;23;Perjantai;16;3;19
622;25.08.2018;2018;08;00;Lauantai;6;2;8
622;25.08.2018;2018;08;01;Lauantai;6;5;11
622;25.08.2018;2018;08;02;Lauantai;4;4;8
622;25.08.2018;2018;08;03;Lauantai;4;0;4
622;25.08.2018;2018;08;04;Lauantai;3;1;4
622;25.08.2018;2018;08;05;Lauantai;4;2;6
622;25.08.2018;2018;08;06;Lauantai;4;4;8
622;25.08.2018;2018;08;07;Lauantai;8;9;17
622;25.08.2018;2018;08;08;Lauantai;4;4;8
622;25.08.2018;2018;08;09;Lauantai;10;14;24
622;25.08.2018;2018;08;10;Lauantai;6;17;23
622;25.08.2018;2018;08;11;Lauantai;5;22;27
622;25.08.2018;2018;08;12;Lauantai;21;31;52
622;25.08.2018;2018;08;13;Lauantai;24;58;82
622;25.08.2018;2018;08;14;Lauantai;49;64;113
622;25.08.2018;2018;08;15;Lauantai;63;69;132
622;25.08.2018;2018;08;16;Lauantai;65;44;109
622;25.08.2018;2018;08;17;Lauantai;52;40;92
622;25.08.2018;2018;08;18;Lauantai;51;36;87
622;25.08.2018;2018;08;19;Lauantai;49;51;100
622;25.08.2018;2018;08;20;Lauantai;45;29;74
622;25.08.2018;2018;08;21;Lauantai;23;10;33
622;25.08.2018;2018;08;22;Lauantai;26;23;49
622;25.08.2018;2018;08;23;Lauantai;17;12;29
622;26.08.2018;2018;08;00;Sunnuntai;8;7;15
622;26.08.2018;2018;08;01;Sunnuntai;13;9;22
622;26.08.2018;2018;08;02;Sunnuntai;8;8;16
622;26.08.2018;2018;08;03;Sunnuntai;7;7;14
622;26.08.2018;2018;08;04;Sunnuntai;5;2;7
622;26.08.2018;2018;08;05;Sunnuntai;6;2;8
622;26.08.2018;2018;08;06;Sunnuntai;5;5;10
622;26.08.2018;2018;08;07;Sunnuntai;7;9;16
622;26.08.2018;2018;08;08;Sunnuntai;9;6;15
622;26.08.2018;2018;08;09;Sunnuntai;7;4;11
622;26.08.2018;2018;08;10;Sunnuntai;15;12;27
622;26.08.2018;2018;08;11;Sunnuntai;15;26;41
622;26.08.2018;2018;08;12;Sunnuntai;38;55;93
622;26.08.2018;2018;08;13;Sunnuntai;45;71;116
622;26.08.2018;2018;08;14;Sunnuntai;42;47;89
622;26.08.2018;2018;08;15;Sunnuntai;62;71;133
622;26.08.2018;2018;08;16;Sunnuntai;44;29;73
622;26.08.2018;2018;08;17;Sunnuntai;27;24;51
622;26.08.2018;2018;08;18;Sunnuntai;26;12;38
622;26.08.2018;2018;08;19;Sunnuntai;23;15;38
622;26.08.2018;2018;08;20;Sunnuntai;33;17;50
622;26.08.2018;2018;08;21;Sunnuntai;9;11;20
622;26.08.2018;2018;08;22;Sunnuntai;10;3;13
622;26.08.2018;2018;08;23;Sunnuntai;4;3;7
622;27.08.2018;2018;08;00;Maanantai;2;3;5
622;27.08.2018;2018;08;01;Maanantai;4;2;6
622;27.08.2018;2018;08;02;Maanantai;1;0;1
622;27.08.2018;2018;08;03;Maanantai;2;1;3
622;27.08.2018;2018;08;04;Maanantai;0;0;0
622;27.08.2018;2018;08;05;Maanantai;1;2;3
622;27.08.2018;2018;08;06;Maanantai;9;13;22
622;27.08.2018;2018;08;07;Maanantai;25;31;56
622;27.08.2018;2018;08;08;Maanantai;65;95;160
622;27.08.2018;2018;08;09;Maanantai;45;61;106
622;27.08.2018;2018;08;10;Maanantai;19;33;52
622;27.08.2018;2018;08;11;Maanantai;11;16;27
622;27.08.2018;2018;08;12;Maanantai;25;36;61
622;27.08.2018;2018;08;13;Maanantai;21;18;39
622;27.08.2018;2018;08;14;Maanantai;27;29;56
622;27.08.2018;2018;08;15;Maanantai;63;40;103
622;27.08.2018;2018;08;16;Maanantai;81;55;136
622;27.08.2018;2018;08;17;Maanantai;111;72;183
622;27.08.2018;2018;08;18;Maanantai;67;79;146
622;27.08.2018;2018;08;19;Maanantai;59;50;109
622;27.08.2018;2018;08;20;Maanantai;45;32;77
622;27.08.2018;2018;08;21;Maanantai;38;24;62
622;27.08.2018;2018;08;22;Maanantai;32;20;52
622;27.08.2018;2018;08;23;Maanantai;4;2;6
622;28.08.2018;2018;08;00;Tiistai;10;3;13
622;28.08.2018;2018;08;01;Tiistai;4;1;5
622;28.08.2018;2018;08;02;Tiistai;2;1;3
622;28.08.2018;2018;08;03;Tiistai;0;0;0
622;28.08.2018;2018;08;04;Tiistai;2;0;2
622;28.08.2018;2018;08;05;Tiistai;0;1;1
622;28.08.2018;2018;08;06;Tiistai;9;7;16
622;28.08.2018;2018;08;07;Tiistai;21;75;96
622;28.08.2018;2018;08;08;Tiistai;62;128;190
622;28.08.2018;2018;08;09;Tiistai;51;87;138
622;28.08.2018;2018;08;10;Tiistai;27;58;85
622;28.08.2018;2018;08;11;Tiistai;22;42;64
622;28.08.2018;2018;08;12;Tiistai;36;53;89
622;28.08.2018;2018;08;13;Tiistai;42;34;76
622;28.08.2018;2018;08;14;Tiistai;46;51;97
622;28.08.2018;2018;08;15;Tiistai;79;70;149
622;28.08.2018;2018;08;16;Tiistai;112;60;172
622;28.08.2018;2018;08;17;Tiistai;140;79;219
622;28.08.2018;2018;08;18;Tiistai;77;62;139
622;28.08.2018;2018;08;19;Tiistai;70;35;105
622;28.08.2018;2018;08;20;Tiistai;56;43;99
622;28.08.2018;2018;08;21;Tiistai;49;29;78
622;28.08.2018;2018;08;22;Tiistai;26;13;39
622;28.08.2018;2018;08;23;Tiistai;11;4;15
622;29.08.2018;2018;08;00;Keskiviikko;5;4;9
622;29.08.2018;2018;08;01;Keskiviikko;7;1;8
622;29.08.2018;2018;08;02;Keskiviikko;0;0;0
622;29.08.2018;2018;08;03;Keskiviikko;1;0;1
622;29.08.2018;2018;08;04;Keskiviikko;0;0;0
622;29.08.2018;2018;08;05;Keskiviikko;1;6;7
622;29.08.2018;2018;08;06;Keskiviikko;3;13;16
622;29.08.2018;2018;08;07;Keskiviikko;20;77;97
622;29.08.2018;2018;08;08;Keskiviikko;75;103;178
622;29.08.2018;2018;08;09;Keskiviikko;61;71;132
622;29.08.2018;2018;08;10;Keskiviikko;58;41;99
622;29.08.2018;2018;08;11;Keskiviikko;31;47;78
622;29.08.2018;2018;08;12;Keskiviikko;42;37;79
622;29.08.2018;2018;08;13;Keskiviikko;45;48;93
622;29.08.2018;2018;08;14;Keskiviikko;57;47;104
622;29.08.2018;2018;08;15;Keskiviikko;97;58;155
622;29.08.2018;2018;08;16;Keskiviikko;105;47;152
622;29.08.2018;2018;08;17;Keskiviikko;129;74;203
622;29.08.2018;2018;08;18;Keskiviikko;92;70;162
622;29.08.2018;2018;08;19;Keskiviikko;80;60;140
622;29.08.2018;2018;08;20;Keskiviikko;80;49;129
622;29.08.2018;2018;08;21;Keskiviikko;50;32;82
622;29.08.2018;2018;08;22;Keskiviikko;30;27;57
622;29.08.2018;2018;08;23;Keskiviikko;16;5;21
622;30.08.2018;2018;08;00;Torstai;4;4;8
622;30.08.2018;2018;08;01;Torstai;3;4;7
622;30.08.2018;2018;08;02;Torstai;4;5;9
622;30.08.2018;2018;08;03;Torstai;2;1;3
622;30.08.2018;2018;08;04;Torstai;2;0;2
622;30.08.2018;2018;08;05;Torstai;0;3;3
622;30.08.2018;2018;08;06;Torstai;5;13;18
622;30.08.2018;2018;08;07;Torstai;17;66;83
622;30.08.2018;2018;08;08;Torstai;83;122;205
622;30.08.2018;2018;08;09;Torstai;71;47;118
622;30.08.2018;2018;08;10;Torstai;30;38;68
622;30.08.2018;2018;08;11;Torstai;19;46;65
622;30.08.2018;2018;08;12;Torstai;25;47;72
622;30.08.2018;2018;08;13;Torstai;39;46;85
622;30.08.2018;2018;08;14;Torstai;66;59;125
622;30.08.2018;2018;08;15;Torstai;87;59;146
622;30.08.2018;2018;08;16;Torstai;117;67;184
622;30.08.2018;2018;08;17;Torstai;124;83;207
622;30.08.2018;2018;08;18;Torstai;83;48;131
622;30.08.2018;2018;08;19;Torstai;79;22;101
622;30.08.2018;2018;08;20;Torstai;44;24;68
622;30.08.2018;2018;08;21;Torstai;45;26;71
622;30.08.2018;2018;08;22;Torstai;29;20;49
622;30.08.2018;2018;08;23;Torstai;12;8;20
622;31.08.2018;2018;08;00;Perjantai;4;1;5
622;31.08.2018;2018;08;01;Perjantai;1;1;2
622;31.08.2018;2018;08;02;Perjantai;1;2;3
622;31.08.2018;2018;08;03;Perjantai;2;1;3
622;31.08.2018;2018;08;04;Perjantai;1;0;1
622;31.08.2018;2018;08;05;Perjantai;1;1;2
622;31.08.2018;2018;08;06;Perjantai;4;15;19
622;31.08.2018;2018;08;07;Perjantai;21;58;79
622;31.08.2018;2018;08;08;Perjantai;63;57;120
622;31.08.2018;2018;08;09;Perjantai;59;53;112
622;31.08.2018;2018;08;10;Perjantai;31;46;77
622;31.08.2018;2018;08;11;Perjantai;18;40;58
622;31.08.2018;2018;08;12;Perjantai;29;35;64
622;31.08.2018;2018;08;13;Perjantai;36;61;97
622;31.08.2018;2018;08;14;Perjantai;54;59;113
622;31.08.2018;2018;08;15;Perjantai;82;63;145
622;31.08.2018;2018;08;16;Perjantai;91;57;148
622;31.08.2018;2018;08;17;Perjantai;100;84;184
622;31.08.2018;2018;08;18;Perjantai;56;66;122
622;31.08.2018;2018;08;19;Perjantai;53;44;97
622;31.08.2018;2018;08;20;Perjantai;68;40;108
622;31.08.2018;2018;08;21;Perjantai;28;14;42
622;31.08.2018;2018;08;22;Perjantai;35;26;61
622;31.08.2018;2018;08;23;Perjantai;21;5;26
622;01.09.2018;2018;09;00;Lauantai;13;1;14
622;01.09.2018;2018;09;01;Lauantai;17;4;21
622;01.09.2018;2018;09;02;Lauantai;9;0;9
622;01.09.2018;2018;09;03;Lauantai;5;1;6
622;01.09.2018;2018;09;04;Lauantai;3;4;7
622;01.09.2018;2018;09;05;Lauantai;5;6;11
622;01.09.2018;2018;09;06;Lauantai;5;1;6
622;01.09.2018;2018;09;07;Lauantai;6;5;11
622;01.09.2018;2018;09;08;Lauantai;2;2;4
622;01.09.2018;2018;09;09;Lauantai;7;14;21
622;01.09.2018;2018;09;10;Lauantai;17;25;42
622;01.09.2018;2018;09;11;Lauantai;26;40;66
622;01.09.2018;2018;09;12;Lauantai;47;35;82
622;01.09.2018;2018;09;13;Lauantai;57;69;126
622;01.09.2018;2018;09;14;Lauantai;44;37;81
622;01.09.2018;2018;09;15;Lauantai;59;36;95
622;01.09.2018;2018;09;16;Lauantai;56;52;108
622;01.09.2018;2018;09;17;Lauantai;45;71;116
622;01.09.2018;2018;09;18;Lauantai;54;49;103
622;01.09.2018;2018;09;19;Lauantai;34;29;63
622;01.09.2018;2018;09;20;Lauantai;52;37;89
622;01.09.2018;2018;09;21;Lauantai;34;30;64
622;01.09.2018;2018;09;22;Lauantai;30;12;42
622;01.09.2018;2018;09;23;Lauantai;22;12;34
622;02.09.2018;2018;09;00;Sunnuntai;11;10;21
622;02.09.2018;2018;09;01;Sunnuntai;12;7;19
622;02.09.2018;2018;09;02;Sunnuntai;6;3;9
622;02.09.2018;2018;09;03;Sunnuntai;8;4;12
622;02.09.2018;2018;09;04;Sunnuntai;7;2;9
622;02.09.2018;2018;09;05;Sunnuntai;7;5;12
622;02.09.2018;2018;09;06;Sunnuntai;5;2;7
622;02.09.2018;2018;09;07;Sunnuntai;2;8;10
622;02.09.2018;2018;09;08;Sunnuntai;3;3;6
622;02.09.2018;2018;09;09;Sunnuntai;8;7;15
622;02.09.2018;2018;09;10;Sunnuntai;6;14;20
622;02.09.2018;2018;09;11;Sunnuntai;12;20;32
622;02.09.2018;2018;09;12;Sunnuntai;26;28;54
622;02.09.2018;2018;09;13;Sunnuntai;49;65;114
622;02.09.2018;2018;09;14;Sunnuntai;37;62;99
622;02.09.2018;2018;09;15;Sunnuntai;59;68;127
622;02.09.2018;2018;09;16;Sunnuntai;62;57;119
622;02.09.2018;2018;09;17;Sunnuntai;60;73;133
622;02.09.2018;2018;09;18;Sunnuntai;58;32;90
622;02.09.2018;2018;09;19;Sunnuntai;62;40;102
622;02.09.2018;2018;09;20;Sunnuntai;45;31;76
622;02.09.2018;2018;09;21;Sunnuntai;29;15;44
622;02.09.2018;2018;09;22;Sunnuntai;5;7;12
622;02.09.2018;2018;09;23;Sunnuntai;0;0;0
622;03.09.2018;2018;09;00;Maanantai;5;4;9
622;03.09.2018;2018;09;01;Maanantai;7;2;9
622;03.09.2018;2018;09;02;Maanantai;7;3;10
622;03.09.2018;2018;09;03;Maanantai;5;0;5
622;03.09.2018;2018;09;04;Maanantai;5;0;5
622;03.09.2018;2018;09;05;Maanantai;3;2;5
622;03.09.2018;2018;09;06;Maanantai;4;0;4
622;03.09.2018;2018;09;07;Maanantai;31;48;79
622;03.09.2018;2018;09;08;Maanantai;94;94;188
622;03.09.2018;2018;09;09;Maanantai;66;86;152
622;03.09.2018;2018;09;10;Maanantai;44;77;121
622;03.09.2018;2018;09;11;Maanantai;29;52;81
622;03.09.2018;2018;09;12;Maanantai;33;49;82
622;03.09.2018;2018;09;13;Maanantai;44;78;122
622;03.09.2018;2018;09;14;Maanantai;68;77;145
622;03.09.2018;2018;09;15;Maanantai;104;72;176
622;03.09.2018;2018;09;16;Maanantai;139;68;207
622;03.09.2018;2018;09;17;Maanantai;161;117;278
622;03.09.2018;2018;09;18;Maanantai;91;69;160
622;03.09.2018;2018;09;19;Maanantai;95;60;155
622;03.09.2018;2018;09;20;Maanantai;68;51;119
622;03.09.2018;2018;09;21;Maanantai;75;35;110
622;03.09.2018;2018;09;22;Maanantai;57;13;70
622;03.09.2018;2018;09;23;Maanantai;17;12;29
622;04.09.2018;2018;09;00;Tiistai;5;4;9
622;04.09.2018;2018;09;01;Tiistai;7;2;9
622;04.09.2018;2018;09;02;Tiistai;7;3;10
622;04.09.2018;2018;09;03;Tiistai;5;0;5
622;04.09.2018;2018;09;04;Tiistai;5;0;5
622;04.09.2018;2018;09;05;Tiistai;3;2;5
622;04.09.2018;2018;09;06;Tiistai;4;25;29
622;04.09.2018;2018;09;07;Tiistai;31;48;79
622;04.09.2018;2018;09;08;Tiistai;94;94;188
622;04.09.2018;2018;09;09;Tiistai;66;86;152
622;04.09.2018;2018;09;10;Tiistai;44;77;121
622;04.09.2018;2018;09;11;Tiistai;29;50;79
622;04.09.2018;2018;09;12;Tiistai;52;59;111
622;04.09.2018;2018;09;13;Tiistai;64;47;111
622;04.09.2018;2018;09;14;Tiistai;51;50;101
622;04.09.2018;2018;09;15;Tiistai;74;72;146
622;04.09.2018;2018;09;16;Tiistai;132;73;205
622;04.09.2018;2018;09;17;Tiistai;155;103;258
622;04.09.2018;2018;09;18;Tiistai;100;73;173
622;04.09.2018;2018;09;19;Tiistai;81;67;148
622;04.09.2018;2018;09;20;Tiistai;80;60;140
622;04.09.2018;2018;09;21;Tiistai;60;34;94
622;04.09.2018;2018;09;22;Tiistai;41;27;68
622;04.09.2018;2018;09;23;Tiistai;21;5;26
622;05.09.2018;2018;09;00;Keskiviikko;15;4;19
622;05.09.2018;2018;09;01;Keskiviikko;6;2;8
622;05.09.2018;2018;09;02;Keskiviikko;4;6;10
622;05.09.2018;2018;09;03;Keskiviikko;5;3;8
622;05.09.2018;2018;09;04;Keskiviikko;1;0;1
622;05.09.2018;2018;09;05;Keskiviikko;0;5;5
622;05.09.2018;2018;09;06;Keskiviikko;5;23;28
622;05.09.2018;2018;09;07;Keskiviikko;35;59;94
622;05.09.2018;2018;09;08;Keskiviikko;78;123;201
622;05.09.2018;2018;09;09;Keskiviikko;98;92;190
622;05.09.2018;2018;09;10;Keskiviikko;41;57;98
622;05.09.2018;2018;09;11;Keskiviikko;24;49;73
622;05.09.2018;2018;09;12;Keskiviikko;42;47;89
622;05.09.2018;2018;09;13;Keskiviikko;77;73;150
622;05.09.2018;2018;09;14;Keskiviikko;62;63;125
622;05.09.2018;2018;09;15;Keskiviikko;94;63;157
622;05.09.2018;2018;09;16;Keskiviikko;114;89;203
622;05.09.2018;2018;09;17;Keskiviikko;146;84;230
622;05.09.2018;2018;09;18;Keskiviikko;79;51;130
622;05.09.2018;2018;09;19;Keskiviikko;79;58;137
622;05.09.2018;2018;09;20;Keskiviikko;64;44;108
622;05.09.2018;2018;09;21;Keskiviikko;45;20;65
622;05.09.2018;2018;09;22;Keskiviikko;31;17;48
622;05.09.2018;2018;09;23;Keskiviikko;19;16;35
622;06.09.2018;2018;09;00;Torstai;11;8;19
622;06.09.2018;2018;09;01;Torstai;9;4;13
622;06.09.2018;2018;09;02;Torstai;1;3;4
622;06.09.2018;2018;09;03;Torstai;6;1;7
622;06.09.2018;2018;09;04;Torstai;2;3;5
622;06.09.2018;2018;09;05;Torstai;0;4;4
622;06.09.2018;2018;09;06;Torstai;5;13;18
622;06.09.2018;2018;09;07;Torstai;28;41;69
622;06.09.2018;2018;09;08;Torstai;76;107;183
622;06.09.2018;2018;09;09;Torstai;73;79;152
622;06.09.2018;2018;09;10;Torstai;29;36;65
622;06.09.2018;2018;09;11;Torstai;18;41;59
622;06.09.2018;2018;09;12;Torstai;34;38;72
622;06.09.2018;2018;09;13;Torstai;48;45;93
622;06.09.2018;2018;09;14;Torstai;52;53;105
622;06.09.2018;2018;09;15;Torstai;79;50;129
622;06.09.2018;2018;09;16;Torstai;107;58;165
622;06.09.2018;2018;09;17;Torstai;123;83;206
622;06.09.2018;2018;09;18;Torstai;76;54;130
622;06.09.2018;2018;09;19;Torstai;91;52;143
622;06.09.2018;2018;09;20;Torstai;75;18;93
622;06.09.2018;2018;09;21;Torstai;48;36;84
622;06.09.2018;2018;09;22;Torstai;37;23;60
622;06.09.2018;2018;09;23;Torstai;25;8;33
622;07.09.2018;2018;09;00;Perjantai;12;4;16
622;07.09.2018;2018;09;01;Perjantai;7;3;10
622;07.09.2018;2018;09;02;Perjantai;7;4;11
622;07.09.2018;2018;09;03;Perjantai;7;1;8
622;07.09.2018;2018;09;04;Perjantai;10;0;10
622;07.09.2018;2018;09;05;Perjantai;5;5;10
622;07.09.2018;2018;09;06;Perjantai;5;25;30
622;07.09.2018;2018;09;07;Perjantai;28;54;82
622;07.09.2018;2018;09;08;Perjantai;61;71;132
622;07.09.2018;2018;09;09;Perjantai;68;83;151
622;07.09.2018;2018;09;10;Perjantai;34;66;100
622;07.09.2018;2018;09;11;Perjantai;41;58;99
622;07.09.2018;2018;09;12;Perjantai;42;38;80
622;07.09.2018;2018;09;13;Perjantai;39;64;103
622;07.09.2018;2018;09;14;Perjantai;60;77;137
622;07.09.2018;2018;09;15;Perjantai;100;75;175
622;07.09.2018;2018;09;16;Perjantai;128;86;214
622;07.09.2018;2018;09;17;Perjantai;91;80;171
622;07.09.2018;2018;09;18;Perjantai;66;71;137
622;07.09.2018;2018;09;19;Perjantai;61;48;109
622;07.09.2018;2018;09;20;Perjantai;51;46;97
622;07.09.2018;2018;09;21;Perjantai;59;36;95
622;07.09.2018;2018;09;22;Perjantai;39;23;62
622;07.09.2018;2018;09;23;Perjantai;22;7;29
622;08.09.2018;2018;09;00;Lauantai;24;16;40
622;08.09.2018;2018;09;01;Lauantai;10;3;13
622;08.09.2018;2018;09;02;Lauantai;18;9;27
622;08.09.2018;2018;09;03;Lauantai;8;3;11
622;08.09.2018;2018;09;04;Lauantai;5;2;7
622;08.09.2018;2018;09;05;Lauantai;3;6;9
622;08.09.2018;2018;09;06;Lauantai;6;3;9
622;08.09.2018;2018;09;07;Lauantai;4;9;13
622;08.09.2018;2018;09;08;Lauantai;4;6;10
622;08.09.2018;2018;09;09;Lauantai;14;31;45
622;08.09.2018;2018;09;10;Lauantai;35;43;78
622;08.09.2018;2018;09;11;Lauantai;32;69;101
622;08.09.2018;2018;09;12;Lauantai;57;42;99
622;08.09.2018;2018;09;13;Lauantai;58;68;126
622;08.09.2018;2018;09;14;Lauantai;87;67;154
622;08.09.2018;2018;09;15;Lauantai;62;60;122
622;08.09.2018;2018;09;16;Lauantai;73;65;138
622;08.09.2018;2018;09;17;Lauantai;46;48;94
622;08.09.2018;2018;09;18;Lauantai;69;57;126
622;08.09.2018;2018;09;19;Lauantai;46;49;95
622;08.09.2018;2018;09;20;Lauantai;44;23;67
622;08.09.2018;2018;09;21;Lauantai;32;31;63
622;08.09.2018;2018;09;22;Lauantai;31;24;55
622;08.09.2018;2018;09;23;Lauantai;17;10;27
622;09.09.2018;2018;09;00;Sunnuntai;9;7;16
622;09.09.2018;2018;09;01;Sunnuntai;11;5;16
622;09.09.2018;2018;09;02;Sunnuntai;7;1;8
622;09.09.2018;2018;09;03;Sunnuntai;6;2;8
622;09.09.2018;2018;09;04;Sunnuntai;7;2;9
622;09.09.2018;2018;09;05;Sunnuntai;4;0;4
622;09.09.2018;2018;09;06;Sunnuntai;3;5;8
622;09.09.2018;2018;09;07;Sunnuntai;7;9;16
622;09.09.2018;2018;09;08;Sunnuntai;4;6;10
622;09.09.2018;2018;09;09;Sunnuntai;4;10;14
622;09.09.2018;2018;09;10;Sunnuntai;10;16;26
622;09.09.2018;2018;09;11;Sunnuntai;18;23;41
622;09.09.2018;2018;09;12;Sunnuntai;30;38;68
622;09.09.2018;2018;09;13;Sunnuntai;56;62;118
622;09.09.2018;2018;09;14;Sunnuntai;74;43;117
622;09.09.2018;2018;09;15;Sunnuntai;66;56;122
622;09.09.2018;2018;09;16;Sunnuntai;69;41;110
622;09.09.2018;2018;09;17;Sunnuntai;60;69;129
622;09.09.2018;2018;09;18;Sunnuntai;53;53;106
622;09.09.2018;2018;09;19;Sunnuntai;59;52;111
622;09.09.2018;2018;09;20;Sunnuntai;41;40;81
622;09.09.2018;2018;09;21;Sunnuntai;42;25;67
622;09.09.2018;2018;09;22;Sunnuntai;23;16;39
622;09.09.2018;2018;09;23;Sunnuntai;13;4;17
622;10.09.2018;2018;09;00;Maanantai;5;5;10
622;10.09.2018;2018;09;01;Maanantai;4;2;6
622;10.09.2018;2018;09;02;Maanantai;2;3;5
622;10.09.2018;2018;09;03;Maanantai;2;0;2
622;10.09.2018;2018;09;04;Maanantai;2;0;2
622;10.09.2018;2018;09;05;Maanantai;0;2;2
622;10.09.2018;2018;09;06;Maanantai;5;12;17
622;10.09.2018;2018;09;07;Maanantai;19;69;88
622;10.09.2018;2018;09;08;Maanantai;107;98;205
622;10.09.2018;2018;09;09;Maanantai;46;76;122
622;10.09.2018;2018;09;10;Maanantai;36;74;110
622;10.09.2018;2018;09;11;Maanantai;30;37;67
622;10.09.2018;2018;09;12;Maanantai;45;54;99
622;10.09.2018;2018;09;13;Maanantai;53;43;96
622;10.09.2018;2018;09;14;Maanantai;51;62;113
622;10.09.2018;2018;09;15;Maanantai;79;77;156
622;10.09.2018;2018;09;16;Maanantai;122;78;200
622;10.09.2018;2018;09;17;Maanantai;149;92;241
622;10.09.2018;2018;09;18;Maanantai;107;62;169
622;10.09.2018;2018;09;19;Maanantai;94;61;155
622;10.09.2018;2018;09;20;Maanantai;69;40;109
622;10.09.2018;2018;09;21;Maanantai;52;43;95
622;10.09.2018;2018;09;22;Maanantai;33;22;55
622;10.09.2018;2018;09;23;Maanantai;23;11;34
622;11.09.2018;2018;09;00;Tiistai;6;5;11
622;11.09.2018;2018;09;01;Tiistai;5;3;8
622;11.09.2018;2018;09;02;Tiistai;3;3;6
622;11.09.2018;2018;09;03;Tiistai;2;1;3
622;11.09.2018;2018;09;04;Tiistai;1;0;1
622;11.09.2018;2018;09;05;Tiistai;1;5;6
622;11.09.2018;2018;09;06;Tiistai;3;8;11
622;11.09.2018;2018;09;07;Tiistai;20;64;84
622;11.09.2018;2018;09;08;Tiistai;83;113;196
622;11.09.2018;2018;09;09;Tiistai;46;98;144
622;11.09.2018;2018;09;10;Tiistai;29;45;74
622;11.09.2018;2018;09;11;Tiistai;27;34;61
622;11.09.2018;2018;09;12;Tiistai;42;44;86
622;11.09.2018;2018;09;13;Tiistai;32;42;74
622;11.09.2018;2018;09;14;Tiistai;56;49;105
622;11.09.2018;2018;09;15;Tiistai;63;62;125
622;11.09.2018;2018;09;16;Tiistai;101;64;165
622;11.09.2018;2018;09;17;Tiistai;88;52;140
622;11.09.2018;2018;09;18;Tiistai;48;28;76
622;11.09.2018;2018;09;19;Tiistai;29;28;57
622;11.09.2018;2018;09;20;Tiistai;26;23;49
622;11.09.2018;2018;09;21;Tiistai;24;16;40
622;11.09.2018;2018;09;22;Tiistai;16;10;26
622;11.09.2018;2018;09;23;Tiistai;6;4;10
622;12.09.2018;2018;09;00;Keskiviikko;5;5;10
622;12.09.2018;2018;09;01;Keskiviikko;2;0;2
622;12.09.2018;2018;09;02;Keskiviikko;1;2;3
622;12.09.2018;2018;09;03;Keskiviikko;2;0;2
622;12.09.2018;2018;09;04;Keskiviikko;2;0;2
622;12.09.2018;2018;09;05;Keskiviikko;2;0;2
622;12.09.2018;2018;09;06;Keskiviikko;4;12;16
622;12.09.2018;2018;09;07;Keskiviikko;18;38;56
622;12.09.2018;2018;09;08;Keskiviikko;50;36;86
622;12.09.2018;2018;09;09;Keskiviikko;64;67;131
622;12.09.2018;2018;09;10;Keskiviikko;44;58;102
622;12.09.2018;2018;09;11;Keskiviikko;30;16;46
622;12.09.2018;2018;09;12;Keskiviikko;29;32;61
622;12.09.2018;2018;09;13;Keskiviikko;28;43;71
622;12.09.2018;2018;09;14;Keskiviikko;24;36;60
622;12.09.2018;2018;09;15;Keskiviikko;56;45;101
622;12.09.2018;2018;09;16;Keskiviikko;52;39;91
622;12.09.2018;2018;09;17;Keskiviikko;62;31;93
622;12.09.2018;2018;09;18;Keskiviikko;41;48;89
622;12.09.2018;2018;09;19;Keskiviikko;35;19;54
622;12.09.2018;2018;09;20;Keskiviikko;26;37;63
622;12.09.2018;2018;09;21;Keskiviikko;23;18;41
622;12.09.2018;2018;09;22;Keskiviikko;25;8;33
622;12.09.2018;2018;09;23;Keskiviikko;11;7;18
622;13.09.2018;2018;09;00;Torstai;4;3;7
622;13.09.2018;2018;09;01;Torstai;4;3;7
622;13.09.2018;2018;09;02;Torstai;8;1;9
622;13.09.2018;2018;09;03;Torstai;9;0;9
622;13.09.2018;2018;09;04;Torstai;5;0;5
622;13.09.2018;2018;09;05;Torstai;3;5;8
622;13.09.2018;2018;09;06;Torstai;6;14;20
622;13.09.2018;2018;09;07;Torstai;20;57;77
622;13.09.2018;2018;09;08;Torstai;74;82;156
622;13.09.2018;2018;09;09;Torstai;59;43;102
622;13.09.2018;2018;09;10;Torstai;35;53;88
622;13.09.2018;2018;09;11;Torstai;15;30;45
622;13.09.2018;2018;09;12;Torstai;28;49;77
622;13.09.2018;2018;09;13;Torstai;21;44;65
622;13.09.2018;2018;09;14;Torstai;38;47;85
622;13.09.2018;2018;09;15;Torstai;51;48;99
622;13.09.2018;2018;09;16;Torstai;85;65;150
622;13.09.2018;2018;09;17;Torstai;116;89;205
622;13.09.2018;2018;09;18;Torstai;56;62;118
622;13.09.2018;2018;09;19;Torstai;63;62;125
622;13.09.2018;2018;09;20;Torstai;59;46;105
622;13.09.2018;2018;09;21;Torstai;50;25;75
622;13.09.2018;2018;09;22;Torstai;32;15;47
622;13.09.2018;2018;09;23;Torstai;19;11;30
622;14.09.2018;2018;09;00;Perjantai;7;6;13
622;14.09.2018;2018;09;01;Perjantai;8;6;14
622;14.09.2018;2018;09;02;Perjantai;3;1;4
622;14.09.2018;2018;09;03;Perjantai;3;2;5
622;14.09.2018;2018;09;04;Perjantai;3;2;5
622;14.09.2018;2018;09;05;Perjantai;1;3;4
622;14.09.2018;2018;09;06;Perjantai;4;10;14
622;14.09.2018;2018;09;07;Perjantai;15;45;60
622;14.09.2018;2018;09;08;Perjantai;44;76;120
622;14.09.2018;2018;09;09;Perjantai;56;80;136
622;14.09.2018;2018;09;10;Perjantai;41;37;78
622;14.09.2018;2018;09;11;Perjantai;26;42;68
622;14.09.2018;2018;09;12;Perjantai;29;40;69
622;14.09.2018;2018;09;13;Perjantai;61;36;97
622;14.09.2018;2018;09;14;Perjantai;64;64;128
622;14.09.2018;2018;09;15;Perjantai;83;74;157
622;14.09.2018;2018;09;16;Perjantai;84;72;156
622;14.09.2018;2018;09;17;Perjantai;92;73;165
622;14.09.2018;2018;09;18;Perjantai;52;51;103
622;14.09.2018;2018;09;19;Perjantai;52;38;90
622;14.09.2018;2018;09;20;Perjantai;44;28;72
622;14.09.2018;2018;09;21;Perjantai;33;17;50
622;14.09.2018;2018;09;22;Perjantai;20;13;33
622;14.09.2018;2018;09;23;Perjantai;12;8;20
622;15.09.2018;2018;09;00;Lauantai;7;7;14
622;15.09.2018;2018;09;01;Lauantai;5;8;13
622;15.09.2018;2018;09;02;Lauantai;6;7;13
622;15.09.2018;2018;09;03;Lauantai;4;3;7
622;15.09.2018;2018;09;04;Lauantai;2;3;5
622;15.09.2018;2018;09;05;Lauantai;3;3;6
622;15.09.2018;2018;09;06;Lauantai;6;7;13
622;15.09.2018;2018;09;07;Lauantai;5;7;12
622;15.09.2018;2018;09;08;Lauantai;7;8;15
622;15.09.2018;2018;09;09;Lauantai;14;26;40
622;15.09.2018;2018;09;10;Lauantai;17;18;35
622;15.09.2018;2018;09;11;Lauantai;20;29;49
622;15.09.2018;2018;09;12;Lauantai;33;32;65
622;15.09.2018;2018;09;13;Lauantai;44;40;84
622;15.09.2018;2018;09;14;Lauantai;19;10;29
622;15.09.2018;2018;09;15;Lauantai;17;13;30
622;15.09.2018;2018;09;16;Lauantai;20;37;57
622;15.09.2018;2018;09;17;Lauantai;18;20;38
622;15.09.2018;2018;09;18;Lauantai;21;20;41
622;15.09.2018;2018;09;19;Lauantai;24;30;54
622;15.09.2018;2018;09;20;Lauantai;14;12;26
622;15.09.2018;2018;09;21;Lauantai;24;18;42
622;15.09.2018;2018;09;22;Lauantai;21;14;35
622;15.09.2018;2018;09;23;Lauantai;9;8;17
622;16.09.2018;2018;09;00;Sunnuntai;10;5;15
622;16.09.2018;2018;09;01;Sunnuntai;11;9;20
622;16.09.2018;2018;09;02;Sunnuntai;6;5;11
622;16.09.2018;2018;09;03;Sunnuntai;2;2;4
622;16.09.2018;2018;09;04;Sunnuntai;2;0;2
622;16.09.2018;2018;09;05;Sunnuntai;0;0;0
622;16.09.2018;2018;09;06;Sunnuntai;3;3;6
622;16.09.2018;2018;09;07;Sunnuntai;3;7;10
622;16.09.2018;2018;09;08;Sunnuntai;6;4;10
622;16.09.2018;2018;09;09;Sunnuntai;9;13;22
622;16.09.2018;2018;09;10;Sunnuntai;13;18;31
622;16.09.2018;2018;09;11;Sunnuntai;21;31;52
622;16.09.2018;2018;09;12;Sunnuntai;29;40;69
622;16.09.2018;2018;09;13;Sunnuntai;33;39;72
622;16.09.2018;2018;09;14;Sunnuntai;44;63;107
622;16.09.2018;2018;09;15;Sunnuntai;45;38;83
622;16.09.2018;2018;09;16;Sunnuntai;38;32;70
622;16.09.2018;2018;09;17;Sunnuntai;36;34;70
622;16.09.2018;2018;09;18;Sunnuntai;31;35;66
622;16.09.2018;2018;09;19;Sunnuntai;43;43;86
622;16.09.2018;2018;09;20;Sunnuntai;35;33;68
622;16.09.2018;2018;09;21;Sunnuntai;21;27;48
622;16.09.2018;2018;09;22;Sunnuntai;16;8;24
622;16.09.2018;2018;09;23;Sunnuntai;5;0;5
622;17.09.2018;2018;09;00;Maanantai;7;2;9
622;17.09.2018;2018;09;01;Maanantai;2;0;2
622;17.09.2018;2018;09;02;Maanantai;0;1;1
622;17.09.2018;2018;09;03;Maanantai;1;1;2
622;17.09.2018;2018;09;04;Maanantai;4;0;4
622;17.09.2018;2018;09;05;Maanantai;0;3;3
622;17.09.2018;2018;09;06;Maanantai;2;11;13
622;17.09.2018;2018;09;07;Maanantai;12;43;55
622;17.09.2018;2018;09;08;Maanantai;68;113;181
622;17.09.2018;2018;09;09;Maanantai;77;81;158
622;17.09.2018;2018;09;10;Maanantai;25;43;68
622;17.09.2018;2018;09;11;Maanantai;30;38;68
622;17.09.2018;2018;09;12;Maanantai;40;43;83
622;17.09.2018;2018;09;13;Maanantai;34;50;84
622;17.09.2018;2018;09;14;Maanantai;54;54;108
622;17.09.2018;2018;09;15;Maanantai;81;41;122
622;17.09.2018;2018;09;16;Maanantai;109;64;173
622;17.09.2018;2018;09;17;Maanantai;135;72;207
622;17.09.2018;2018;09;18;Maanantai;92;82;174
622;17.09.2018;2018;09;19;Maanantai;56;47;103
622;17.09.2018;2018;09;20;Maanantai;52;47;99
622;17.09.2018;2018;09;21;Maanantai;43;22;65
622;17.09.2018;2018;09;22;Maanantai;25;12;37
622;17.09.2018;2018;09;23;Maanantai;3;5;8
622;18.09.2018;2018;09;00;Tiistai;1;1;2
622;18.09.2018;2018;09;01;Tiistai;1;1;2
622;18.09.2018;2018;09;02;Tiistai;2;2;4
622;18.09.2018;2018;09;03;Tiistai;1;0;1
622;18.09.2018;2018;09;04;Tiistai;2;0;2
622;18.09.2018;2018;09;05;Tiistai;0;3;3
622;18.09.2018;2018;09;06;Tiistai;1;7;8
622;18.09.2018;2018;09;07;Tiistai;25;40;65
622;18.09.2018;2018;09;08;Tiistai;83;52;135
622;18.09.2018;2018;09;09;Tiistai;52;87;139
622;18.09.2018;2018;09;10;Tiistai;46;61;107
622;18.09.2018;2018;09;11;Tiistai;35;34;69
622;18.09.2018;2018;09;12;Tiistai;35;37;72
622;18.09.2018;2018;09;13;Tiistai;34;51;85
622;18.09.2018;2018;09;14;Tiistai;32;49;81
622;18.09.2018;2018;09;15;Tiistai;72;68;140
622;18.09.2018;2018;09;16;Tiistai;98;72;170
622;18.09.2018;2018;09;17;Tiistai;119;74;193
622;18.09.2018;2018;09;18;Tiistai;77;50;127
622;18.09.2018;2018;09;19;Tiistai;62;42;104
622;18.09.2018;2018;09;20;Tiistai;60;49;109
622;18.09.2018;2018;09;21;Tiistai;48;23;71
622;18.09.2018;2018;09;22;Tiistai;22;17;39
622;18.09.2018;2018;09;23;Tiistai;13;5;18
622;19.09.2018;2018;09;00;Keskiviikko;2;5;7
622;19.09.2018;2018;09;01;Keskiviikko;5;2;7
622;19.09.2018;2018;09;02;Keskiviikko;0;1;1
622;19.09.2018;2018;09;03;Keskiviikko;4;2;6
622;19.09.2018;2018;09;04;Keskiviikko;2;0;2
622;19.09.2018;2018;09;05;Keskiviikko;1;2;3
622;19.09.2018;2018;09;06;Keskiviikko;7;12;19
622;19.09.2018;2018;09;07;Keskiviikko;10;48;58
622;19.09.2018;2018;09;08;Keskiviikko;47;88;135
622;19.09.2018;2018;09;09;Keskiviikko;59;73;132
622;19.09.2018;2018;09;10;Keskiviikko;46;33;79
622;19.09.2018;2018;09;11;Keskiviikko;23;32;55
622;19.09.2018;2018;09;12;Keskiviikko;21;23;44
622;19.09.2018;2018;09;13;Keskiviikko;27;45;72
622;19.09.2018;2018;09;14;Keskiviikko;32;34;66
622;19.09.2018;2018;09;15;Keskiviikko;65;55;120
622;19.09.2018;2018;09;16;Keskiviikko;74;45;119
622;19.09.2018;2018;09;17;Keskiviikko;96;70;166
622;19.09.2018;2018;09;18;Keskiviikko;53;56;109
622;19.09.2018;2018;09;19;Keskiviikko;34;44;78
622;19.09.2018;2018;09;20;Keskiviikko;23;31;54
622;19.09.2018;2018;09;21;Keskiviikko;29;22;51
622;19.09.2018;2018;09;22;Keskiviikko;22;11;33
622;19.09.2018;2018;09;23;Keskiviikko;13;6;19
622;20.09.2018;2018;09;00;Torstai;7;7;14
622;20.09.2018;2018;09;01;Torstai;3;2;5
622;20.09.2018;2018;09;02;Torstai;10;2;12
622;20.09.2018;2018;09;03;Torstai;5;0;5
622;20.09.2018;2018;09;04;Torstai;4;1;5
622;20.09.2018;2018;09;05;Torstai;2;2;4
622;20.09.2018;2018;09;06;Torstai;4;12;16
622;20.09.2018;2018;09;07;Torstai;22;46;68
622;20.09.2018;2018;09;08;Torstai;69;77;146
622;20.09.2018;2018;09;09;Torstai;46;84;130
622;20.09.2018;2018;09;10;Torstai;30;54;84
622;20.09.2018;2018;09;11;Torstai;21;32;53
622;20.09.2018;2018;09;12;Torstai;30;35;65
622;20.09.2018;2018;09;13;Torstai;45;50;95
622;20.09.2018;2018;09;14;Torstai;45;41;86
622;20.09.2018;2018;09;15;Torstai;54;39;93
622;20.09.2018;2018;09;16;Torstai;79;61;140
622;20.09.2018;2018;09;17;Torstai;94;87;181
622;20.09.2018;2018;09;18;Torstai;55;50;105
622;20.09.2018;2018;09;19;Torstai;42;48;90
622;20.09.2018;2018;09;20;Torstai;45;38;83
622;20.09.2018;2018;09;21;Torstai;37;19;56
622;20.09.2018;2018;09;22;Torstai;25;15;40
622;20.09.2018;2018;09;23;Torstai;13;11;24
622;21.09.2018;2018;09;00;Perjantai;9;3;12
622;21.09.2018;2018;09;01;Perjantai;4;5;9
622;21.09.2018;2018;09;02;Perjantai;5;4;9
622;21.09.2018;2018;09;03;Perjantai;5;1;6
622;21.09.2018;2018;09;04;Perjantai;4;1;5
622;21.09.2018;2018;09;05;Perjantai;3;1;4
622;21.09.2018;2018;09;06;Perjantai;5;14;19
622;21.09.2018;2018;09;07;Perjantai;14;31;45
622;21.09.2018;2018;09;08;Perjantai;36;76;112
622;21.09.2018;2018;09;09;Perjantai;48;62;110
622;21.09.2018;2018;09;10;Perjantai;27;53;80
622;21.09.2018;2018;09;11;Perjantai;20;28;48
622;21.09.2018;2018;09;12;Perjantai;29;47;76
622;21.09.2018;2018;09;13;Perjantai;50;57;107
622;21.09.2018;2018;09;14;Perjantai;51;46;97
622;21.09.2018;2018;09;15;Perjantai;55;45;100
622;21.09.2018;2018;09;16;Perjantai;77;33;110
622;21.09.2018;2018;09;17;Perjantai;75;50;125
622;21.09.2018;2018;09;18;Perjantai;55;42;97
622;21.09.2018;2018;09;19;Perjantai;57;56;113
622;21.09.2018;2018;09;20;Perjantai;34;26;60
622;21.09.2018;2018;09;21;Perjantai;21;17;38
622;21.09.2018;2018;09;22;Perjantai;15;12;27
622;21.09.2018;2018;09;23;Perjantai;8;20;28
622;22.09.2018;2018;09;00;Lauantai;10;8;18
622;22.09.2018;2018;09;01;Lauantai;9;6;15
622;22.09.2018;2018;09;02;Lauantai;10;3;13
622;22.09.2018;2018;09;03;Lauantai;5;6;11
622;22.09.2018;2018;09;04;Lauantai;6;2;8
622;22.09.2018;2018;09;05;Lauantai;2;0;2
622;22.09.2018;2018;09;06;Lauantai;3;4;7
622;22.09.2018;2018;09;07;Lauantai;2;3;5
622;22.09.2018;2018;09;08;Lauantai;4;4;8
622;22.09.2018;2018;09;09;Lauantai;8;11;19
622;22.09.2018;2018;09;10;Lauantai;10;8;18
622;22.09.2018;2018;09;11;Lauantai;11;19;30
622;22.09.2018;2018;09;12;Lauantai;9;11;20
622;22.09.2018;2018;09;13;Lauantai;17;19;36
622;22.09.2018;2018;09;14;Lauantai;12;39;51
622;22.09.2018;2018;09;15;Lauantai;26;30;56
622;22.09.2018;2018;09;16;Lauantai;26;33;59
622;22.09.2018;2018;09;17;Lauantai;29;26;55
622;22.09.2018;2018;09;18;Lauantai;21;24;45
622;22.09.2018;2018;09;19;Lauantai;18;22;40
622;22.09.2018;2018;09;20;Lauantai;22;25;47
622;22.09.2018;2018;09;21;Lauantai;15;21;36
622;22.09.2018;2018;09;22;Lauantai;13;10;23
622;22.09.2018;2018;09;23;Lauantai;11;2;13
622;23.09.2018;2018;09;00;Sunnuntai;11;3;14
622;23.09.2018;2018;09;01;Sunnuntai;11;9;20
622;23.09.2018;2018;09;02;Sunnuntai;10;6;16
622;23.09.2018;2018;09;03;Sunnuntai;7;1;8
622;23.09.2018;2018;09;04;Sunnuntai;7;3;10
622;23.09.2018;2018;09;05;Sunnuntai;7;1;8
622;23.09.2018;2018;09;06;Sunnuntai;4;1;5
622;23.09.2018;2018;09;07;Sunnuntai;5;2;7
622;23.09.2018;2018;09;08;Sunnuntai;6;2;8
622;23.09.2018;2018;09;09;Sunnuntai;3;8;11
622;23.09.2018;2018;09;10;Sunnuntai;11;7;18
622;23.09.2018;2018;09;11;Sunnuntai;6;24;30
622;23.09.2018;2018;09;12;Sunnuntai;28;44;72
622;23.09.2018;2018;09;13;Sunnuntai;24;31;55
622;23.09.2018;2018;09;14;Sunnuntai;39;40;79
622;23.09.2018;2018;09;15;Sunnuntai;28;30;58
622;23.09.2018;2018;09;16;Sunnuntai;29;40;69
622;23.09.2018;2018;09;17;Sunnuntai;33;39;72
622;23.09.2018;2018;09;18;Sunnuntai;36;40;76
622;23.09.2018;2018;09;19;Sunnuntai;42;36;78
622;23.09.2018;2018;09;20;Sunnuntai;29;20;49
622;23.09.2018;2018;09;21;Sunnuntai;17;16;33
622;23.09.2018;2018;09;22;Sunnuntai;30;12;42
622;23.09.2018;2018;09;23;Sunnuntai;9;8;17
622;24.09.2018;2018;09;00;Maanantai;1;2;3
622;24.09.2018;2018;09;01;Maanantai;3;0;3
622;24.09.2018;2018;09;02;Maanantai;2;1;3
622;24.09.2018;2018;09;03;Maanantai;1;0;1
622;24.09.2018;2018;09;04;Maanantai;1;1;2
622;24.09.2018;2018;09;05;Maanantai;1;1;2
622;24.09.2018;2018;09;06;Maanantai;4;12;16
622;24.09.2018;2018;09;07;Maanantai;12;51;63
622;24.09.2018;2018;09;08;Maanantai;35;92;127
622;24.09.2018;2018;09;09;Maanantai;67;57;124
622;24.09.2018;2018;09;10;Maanantai;23;52;75
622;24.09.2018;2018;09;11;Maanantai;22;37;59
622;24.09.2018;2018;09;12;Maanantai;26;34;60
622;24.09.2018;2018;09;13;Maanantai;27;49;76
622;24.09.2018;2018;09;14;Maanantai;40;40;80
622;24.09.2018;2018;09;15;Maanantai;47;33;80
622;24.09.2018;2018;09;16;Maanantai;80;48;128
622;24.09.2018;2018;09;17;Maanantai;100;82;182
622;24.09.2018;2018;09;18;Maanantai;69;72;141
622;24.09.2018;2018;09;19;Maanantai;43;31;74
622;24.09.2018;2018;09;20;Maanantai;29;31;60
622;24.09.2018;2018;09;21;Maanantai;31;26;57
622;24.09.2018;2018;09;22;Maanantai;25;8;33
622;24.09.2018;2018;09;23;Maanantai;8;11;19
622;25.09.2018;2018;09;00;Tiistai;10;6;16
622;25.09.2018;2018;09;01;Tiistai;3;0;3
622;25.09.2018;2018;09;02;Tiistai;2;2;4
622;25.09.2018;2018;09;03;Tiistai;1;2;3
622;25.09.2018;2018;09;04;Tiistai;3;0;3
622;25.09.2018;2018;09;05;Tiistai;0;3;3
622;25.09.2018;2018;09;06;Tiistai;1;12;13
622;25.09.2018;2018;09;07;Tiistai;15;57;72
622;25.09.2018;2018;09;08;Tiistai;65;104;169
622;25.09.2018;2018;09;09;Tiistai;57;64;121
622;25.09.2018;2018;09;10;Tiistai;28;42;70
622;25.09.2018;2018;09;11;Tiistai;23;28;51
622;25.09.2018;2018;09;12;Tiistai;24;24;48
622;25.09.2018;2018;09;13;Tiistai;26;53;79
622;25.09.2018;2018;09;14;Tiistai;39;50;89
622;25.09.2018;2018;09;15;Tiistai;58;43;101
622;25.09.2018;2018;09;16;Tiistai;104;66;170
622;25.09.2018;2018;09;17;Tiistai;75;79;154
622;25.09.2018;2018;09;18;Tiistai;58;52;110
622;25.09.2018;2018;09;19;Tiistai;51;38;89
622;25.09.2018;2018;09;20;Tiistai;31;26;57
622;25.09.2018;2018;09;21;Tiistai;38;22;60
622;25.09.2018;2018;09;22;Tiistai;23;12;35
622;25.09.2018;2018;09;23;Tiistai;12;2;14
622;26.09.2018;2018;09;00;Keskiviikko;7;7;14
622;26.09.2018;2018;09;01;Keskiviikko;5;1;6
622;26.09.2018;2018;09;02;Keskiviikko;2;1;3
622;26.09.2018;2018;09;03;Keskiviikko;3;0;3
622;26.09.2018;2018;09;04;Keskiviikko;0;0;0
622;26.09.2018;2018;09;05;Keskiviikko;1;0;1
622;26.09.2018;2018;09;06;Keskiviikko;0;12;12
622;26.09.2018;2018;09;07;Keskiviikko;12;31;43
622;26.09.2018;2018;09;08;Keskiviikko;40;70;110
622;26.09.2018;2018;09;09;Keskiviikko;44;50;94
622;26.09.2018;2018;09;10;Keskiviikko;17;33;50
622;26.09.2018;2018;09;11;Keskiviikko;23;14;37
622;26.09.2018;2018;09;12;Keskiviikko;18;17;35
622;26.09.2018;2018;09;13;Keskiviikko;17;25;42
622;26.09.2018;2018;09;14;Keskiviikko;11;10;21
622;26.09.2018;2018;09;15;Keskiviikko;39;35;74
622;26.09.2018;2018;09;16;Keskiviikko;39;26;65
622;26.09.2018;2018;09;17;Keskiviikko;49;48;97
622;26.09.2018;2018;09;18;Keskiviikko;28;24;52
622;26.09.2018;2018;09;19;Keskiviikko;26;31;57
622;26.09.2018;2018;09;20;Keskiviikko;20;17;37
622;26.09.2018;2018;09;21;Keskiviikko;20;17;37
622;26.09.2018;2018;09;22;Keskiviikko;17;7;24
622;26.09.2018;2018;09;23;Keskiviikko;5;4;9
622;27.09.2018;2018;09;00;Torstai;7;2;9
622;27.09.2018;2018;09;01;Torstai;2;3;5
622;27.09.2018;2018;09;02;Torstai;1;2;3
622;27.09.2018;2018;09;03;Torstai;7;4;11
622;27.09.2018;2018;09;04;Torstai;1;2;3
622;27.09.2018;2018;09;05;Torstai;2;1;3
622;27.09.2018;2018;09;06;Torstai;1;8;9
622;27.09.2018;2018;09;07;Torstai;6;35;41
622;27.09.2018;2018;09;08;Torstai;33;58;91
622;27.09.2018;2018;09;09;Torstai;34;51;85
622;27.09.2018;2018;09;10;Torstai;23;22;45
622;27.09.2018;2018;09;11;Torstai;22;23;45
622;27.09.2018;2018;09;12;Torstai;17;23;40
622;27.09.2018;2018;09;13;Torstai;20;34;54
622;27.09.2018;2018;09;14;Torstai;26;30;56
622;27.09.2018;2018;09;15;Torstai;41;30;71
622;27.09.2018;2018;09;16;Torstai;52;46;98
622;27.09.2018;2018;09;17;Torstai;62;52;114
622;27.09.2018;2018;09;18;Torstai;28;43;71
622;27.09.2018;2018;09;19;Torstai;30;32;62
622;27.09.2018;2018;09;20;Torstai;28;21;49
622;27.09.2018;2018;09;21;Torstai;37;27;64
622;27.09.2018;2018;09;22;Torstai;21;13;34
622;27.09.2018;2018;09;23;Torstai;11;5;16
622;28.09.2018;2018;09;00;Perjantai;5;2;7
622;28.09.2018;2018;09;01;Perjantai;7;4;11
622;28.09.2018;2018;09;02;Perjantai;3;1;4
622;28.09.2018;2018;09;03;Perjantai;7;1;8
622;28.09.2018;2018;09;04;Perjantai;0;0;0
622;28.09.2018;2018;09;05;Perjantai;4;0;4
622;28.09.2018;2018;09;06;Perjantai;8;10;18
622;28.09.2018;2018;09;07;Perjantai;16;42;58
622;28.09.2018;2018;09;08;Perjantai;37;69;106
622;28.09.2018;2018;09;09;Perjantai;41;74;115
622;28.09.2018;2018;09;10;Perjantai;17;33;50
622;28.09.2018;2018;09;11;Perjantai;20;29;49
622;28.09.2018;2018;09;12;Perjantai;35;36;71
622;28.09.2018;2018;09;13;Perjantai;37;49;86
622;28.09.2018;2018;09;14;Perjantai;46;52;98
622;28.09.2018;2018;09;15;Perjantai;64;44;108
622;28.09.2018;2018;09;16;Perjantai;80;60;140
622;28.09.2018;2018;09;17;Perjantai;61;74;135
622;28.09.2018;2018;09;18;Perjantai;54;50;104
622;28.09.2018;2018;09;19;Perjantai;48;39;87
622;28.09.2018;2018;09;20;Perjantai;32;27;59
622;28.09.2018;2018;09;21;Perjantai;24;25;49
622;28.09.2018;2018;09;22;Perjantai;20;13;33
622;28.09.2018;2018;09;23;Perjantai;10;10;20
622;29.09.2018;2018;09;00;Lauantai;15;5;20
622;29.09.2018;2018;09;01;Lauantai;6;9;15
622;29.09.2018;2018;09;02;Lauantai;5;4;9
622;29.09.2018;2018;09;03;Lauantai;5;3;8
622;29.09.2018;2018;09;04;Lauantai;2;3;5
622;29.09.2018;2018;09;05;Lauantai;3;1;4
622;29.09.2018;2018;09;06;Lauantai;6;5;11
622;29.09.2018;2018;09;07;Lauantai;5;5;10
622;29.09.2018;2018;09;08;Lauantai;5;8;13
622;29.09.2018;2018;09;09;Lauantai;4;12;16
622;29.09.2018;2018;09;10;Lauantai;13;22;35
622;29.09.2018;2018;09;11;Lauantai;17;17;34
622;29.09.2018;2018;09;12;Lauantai;17;32;49
622;29.09.2018;2018;09;13;Lauantai;24;49;73
622;29.09.2018;2018;09;14;Lauantai;21;32;53
622;29.09.2018;2018;09;15;Lauantai;39;39;78
622;29.09.2018;2018;09;16;Lauantai;45;34;79
622;29.09.2018;2018;09;17;Lauantai;45;42;87
622;29.09.2018;2018;09;18;Lauantai;29;28;57
622;29.09.2018;2018;09;19;Lauantai;24;27;51
622;29.09.2018;2018;09;20;Lauantai;22;18;40
622;29.09.2018;2018;09;21;Lauantai;22;26;48
622;29.09.2018;2018;09;22;Lauantai;16;9;25
622;29.09.2018;2018;09;23;Lauantai;14;10;24
622;30.09.2018;2018;09;00;Sunnuntai;13;19;32
622;30.09.2018;2018;09;01;Sunnuntai;9;5;14
622;30.09.2018;2018;09;02;Sunnuntai;15;8;23
622;30.09.2018;2018;09;03;Sunnuntai;5;3;8
622;30.09.2018;2018;09;04;Sunnuntai;7;2;9
622;30.09.2018;2018;09;05;Sunnuntai;6;1;7
622;30.09.2018;2018;09;06;Sunnuntai;4;3;7
622;30.09.2018;2018;09;07;Sunnuntai;3;3;6
622;30.09.2018;2018;09;08;Sunnuntai;5;4;9
622;30.09.2018;2018;09;09;Sunnuntai;3;8;11
622;30.09.2018;2018;09;10;Sunnuntai;4;9;13
622;30.09.2018;2018;09;11;Sunnuntai;9;16;25
622;30.09.2018;2018;09;12;Sunnuntai;22;17;39
622;30.09.2018;2018;09;13;Sunnuntai;33;35;68
622;30.09.2018;2018;09;14;Sunnuntai;31;30;61
622;30.09.2018;2018;09;15;Sunnuntai;25;44;69
622;30.09.2018;2018;09;16;Sunnuntai;40;31;71
622;30.09.2018;2018;09;17;Sunnuntai;18;44;62
622;30.09.2018;2018;09;18;Sunnuntai;44;39;83
622;30.09.2018;2018;09;19;Sunnuntai;43;39;82
622;30.09.2018;2018;09;20;Sunnuntai;27;30;57
622;30.09.2018;2018;09;21;Sunnuntai;18;19;37
622;30.09.2018;2018;09;22;Sunnuntai;22;10;32
622;30.09.2018;2018;09;23;Sunnuntai;4;7;11