MittausID;Pvm;Vuosi;Kuukausi;Tunti;Viikonpäivä;PP_1;PP_2;PP_YHT
93;30.06.2014;2014;06;00;Maanantai;2;0;2
93;30.06.2014;2014;06;01;Maanantai;1;0;1
93;30.06.2014;2014;06;02;Maanantai;0;0;0
93;30.06.2014;2014;06;03;Maanantai;0;0;0
93;30.06.2014;2014;06;04;Maanantai;4;2;6
93;30.06.2014;2014;06;05;Maanantai;5;8;13
93;30.06.2014;2014;06;06;Maanantai;15;12;27
93;30.06.2014;2014;06;07;Maanantai;28;19;47
93;30.06.2014;2014;06;08;Maanantai;20;16;36
93;30.06.2014;2014;06;09;Maanantai;10;15;25
93;30.06.2014;2014;06;10;Maanantai;21;16;37
93;30.06.2014;2014;06;11;Maanantai;21;18;39
93;30.06.2014;2014;06;12;Maanantai;20;24;44
93;30.06.2014;2014;06;13;Maanantai;17;15;32
93;30.06.2014;2014;06;14;Maanantai;13;14;27
93;30.06.2014;2014;06;15;Maanantai;20;19;39
93;30.06.2014;2014;06;16;Maanantai;24;37;61
93;30.06.2014;2014;06;17;Maanantai;19;23;42
93;30.06.2014;2014;06;18;Maanantai;13;22;35
93;30.06.2014;2014;06;19;Maanantai;8;11;19
93;30.06.2014;2014;06;20;Maanantai;6;11;17
93;30.06.2014;2014;06;21;Maanantai;10;12;22
93;30.06.2014;2014;06;22;Maanantai;2;4;6
93;30.06.2014;2014;06;23;Maanantai;1;1;2
93;01.07.2014;2014;07;00;Tiistai;0;3;3
93;01.07.2014;2014;07;01;Tiistai;1;0;1
93;01.07.2014;2014;07;02;Tiistai;0;1;1
93;01.07.2014;2014;07;03;Tiistai;0;0;0
93;01.07.2014;2014;07;04;Tiistai;1;0;1
93;01.07.2014;2014;07;05;Tiistai;4;5;9
93;01.07.2014;2014;07;06;Tiistai;24;13;37
93;01.07.2014;2014;07;07;Tiistai;33;24;57
93;01.07.2014;2014;07;08;Tiistai;27;21;48
93;01.07.2014;2014;07;09;Tiistai;12;12;24
93;01.07.2014;2014;07;10;Tiistai;9;14;23
93;01.07.2014;2014;07;11;Tiistai;31;25;56
93;01.07.2014;2014;07;12;Tiistai;23;31;54
93;01.07.2014;2014;07;13;Tiistai;24;36;60
93;01.07.2014;2014;07;14;Tiistai;23;29;52
93;01.07.2014;2014;07;15;Tiistai;36;44;80
93;01.07.2014;2014;07;16;Tiistai;52;58;110
93;01.07.2014;2014;07;17;Tiistai;35;42;77
93;01.07.2014;2014;07;18;Tiistai;40;44;84
93;01.07.2014;2014;07;19;Tiistai;34;34;68
93;01.07.2014;2014;07;20;Tiistai;27;23;50
93;01.07.2014;2014;07;21;Tiistai;7;21;28
93;01.07.2014;2014;07;22;Tiistai;4;15;19
93;01.07.2014;2014;07;23;Tiistai;10;1;11
93;02.07.2014;2014;07;00;Keskiviikko;1;1;2
93;02.07.2014;2014;07;01;Keskiviikko;0;3;3
93;02.07.2014;2014;07;02;Keskiviikko;1;2;3
93;02.07.2014;2014;07;03;Keskiviikko;1;2;3
93;02.07.2014;2014;07;04;Keskiviikko;1;0;1
93;02.07.2014;2014;07;05;Keskiviikko;2;5;7
93;02.07.2014;2014;07;06;Keskiviikko;9;7;16
93;02.07.2014;2014;07;07;Keskiviikko;19;24;43
93;02.07.2014;2014;07;08;Keskiviikko;9;10;19
93;02.07.2014;2014;07;09;Keskiviikko;4;2;6
93;02.07.2014;2014;07;10;Keskiviikko;2;2;4
93;02.07.2014;2014;07;11;Keskiviikko;2;1;3
93;02.07.2014;2014;07;12;Keskiviikko;5;2;7
93;02.07.2014;2014;07;13;Keskiviikko;1;1;2
93;02.07.2014;2014;07;14;Keskiviikko;4;2;6
93;02.07.2014;2014;07;15;Keskiviikko;7;7;14
93;02.07.2014;2014;07;16;Keskiviikko;11;10;21
93;02.07.2014;2014;07;17;Keskiviikko;10;4;14
93;02.07.2014;2014;07;18;Keskiviikko;5;5;10
93;02.07.2014;2014;07;19;Keskiviikko;8;4;12
93;02.07.2014;2014;07;20;Keskiviikko;12;11;23
93;02.07.2014;2014;07;21;Keskiviikko;2;8;10
93;02.07.2014;2014;07;22;Keskiviikko;2;5;7
93;02.07.2014;2014;07;23;Keskiviikko;1;0;1
93;03.07.2014;2014;07;00;Torstai;4;0;4
93;03.07.2014;2014;07;01;Torstai;2;2;4
93;03.07.2014;2014;07;02;Torstai;1;1;2
93;03.07.2014;2014;07;03;Torstai;0;0;0
93;03.07.2014;2014;07;04;Torstai;0;0;0
93;03.07.2014;2014;07;05;Torstai;1;3;4
93;03.07.2014;2014;07;06;Torstai;15;5;20
93;03.07.2014;2014;07;07;Torstai;20;20;40
93;03.07.2014;2014;07;08;Torstai;12;19;31
93;03.07.2014;2014;07;09;Torstai;6;7;13
93;03.07.2014;2014;07;10;Torstai;2;2;4
93;03.07.2014;2014;07;11;Torstai;2;5;7
93;03.07.2014;2014;07;12;Torstai;8;6;14
93;03.07.2014;2014;07;13;Torstai;7;10;17
93;03.07.2014;2014;07;14;Torstai;16;12;28
93;03.07.2014;2014;07;15;Torstai;13;15;28
93;03.07.2014;2014;07;16;Torstai;21;22;43
93;03.07.2014;2014;07;17;Torstai;12;22;34
93;03.07.2014;2014;07;18;Torstai;7;9;16
93;03.07.2014;2014;07;19;Torstai;13;10;23
93;03.07.2014;2014;07;20;Torstai;15;14;29
93;03.07.2014;2014;07;21;Torstai;3;6;9
93;03.07.2014;2014;07;22;Torstai;1;4;5
93;03.07.2014;2014;07;23;Torstai;0;3;3
93;04.07.2014;2014;07;00;Perjantai;0;0;0
93;04.07.2014;2014;07;01;Perjantai;1;0;1
93;04.07.2014;2014;07;02;Perjantai;0;0;0
93;04.07.2014;2014;07;03;Perjantai;0;1;1
93;04.07.2014;2014;07;04;Perjantai;0;0;0
93;04.07.2014;2014;07;05;Perjantai;7;3;10
93;04.07.2014;2014;07;06;Perjantai;14;5;19
93;04.07.2014;2014;07;07;Perjantai;8;18;26
93;04.07.2014;2014;07;08;Perjantai;10;15;25
93;04.07.2014;2014;07;09;Perjantai;11;12;23
93;04.07.2014;2014;07;10;Perjantai;10;10;20
93;04.07.2014;2014;07;11;Perjantai;16;8;24
93;04.07.2014;2014;07;12;Perjantai;13;7;20
93;04.07.2014;2014;07;13;Perjantai;19;14;33
93;04.07.2014;2014;07;14;Perjantai;16;19;35
93;04.07.2014;2014;07;15;Perjantai;27;28;55
93;04.07.2014;2014;07;16;Perjantai;23;28;51
93;04.07.2014;2014;07;17;Perjantai;7;15;22
93;04.07.2014;2014;07;18;Perjantai;6;10;16
93;04.07.2014;2014;07;19;Perjantai;14;8;22
93;04.07.2014;2014;07;20;Perjantai;2;2;4
93;04.07.2014;2014;07;21;Perjantai;2;10;12
93;04.07.2014;2014;07;22;Perjantai;2;5;7
93;04.07.2014;2014;07;23;Perjantai;1;0;1
93;05.07.2014;2014;07;00;Lauantai;1;7;8
93;05.07.2014;2014;07;01;Lauantai;0;3;3
93;05.07.2014;2014;07;02;Lauantai;3;3;6
93;05.07.2014;2014;07;03;Lauantai;0;1;1
93;05.07.2014;2014;07;04;Lauantai;1;0;1
93;05.07.2014;2014;07;05;Lauantai;1;1;2
93;05.07.2014;2014;07;06;Lauantai;3;3;6
93;05.07.2014;2014;07;07;Lauantai;6;1;7
93;05.07.2014;2014;07;08;Lauantai;6;3;9
93;05.07.2014;2014;07;09;Lauantai;17;9;26
93;05.07.2014;2014;07;10;Lauantai;15;8;23
93;05.07.2014;2014;07;11;Lauantai;28;31;59
93;05.07.2014;2014;07;12;Lauantai;33;33;66
93;05.07.2014;2014;07;13;Lauantai;31;28;59
93;05.07.2014;2014;07;14;Lauantai;22;29;51
93;05.07.2014;2014;07;15;Lauantai;28;39;67
93;05.07.2014;2014;07;16;Lauantai;32;33;65
93;05.07.2014;2014;07;17;Lauantai;29;23;52
93;05.07.2014;2014;07;18;Lauantai;34;32;66
93;05.07.2014;2014;07;19;Lauantai;21;23;44
93;05.07.2014;2014;07;20;Lauantai;13;19;32
93;05.07.2014;2014;07;21;Lauantai;8;12;20
93;05.07.2014;2014;07;22;Lauantai;5;14;19
93;05.07.2014;2014;07;23;Lauantai;9;12;21
93;06.07.2014;2014;07;00;Sunnuntai;5;3;8
93;06.07.2014;2014;07;01;Sunnuntai;3;9;12
93;06.07.2014;2014;07;02;Sunnuntai;1;5;6
93;06.07.2014;2014;07;03;Sunnuntai;1;4;5
93;06.07.2014;2014;07;04;Sunnuntai;0;6;6
93;06.07.2014;2014;07;05;Sunnuntai;0;2;2
93;06.07.2014;2014;07;06;Sunnuntai;0;2;2
93;06.07.2014;2014;07;07;Sunnuntai;5;4;9
93;06.07.2014;2014;07;08;Sunnuntai;2;10;12
93;06.07.2014;2014;07;09;Sunnuntai;14;24;38
93;06.07.2014;2014;07;10;Sunnuntai;27;29;56
93;06.07.2014;2014;07;11;Sunnuntai;31;27;58
93;06.07.2014;2014;07;12;Sunnuntai;41;51;92
93;06.07.2014;2014;07;13;Sunnuntai;46;38;84
93;06.07.2014;2014;07;14;Sunnuntai;34;40;74
93;06.07.2014;2014;07;15;Sunnuntai;36;39;75
93;06.07.2014;2014;07;16;Sunnuntai;24;30;54
93;06.07.2014;2014;07;17;Sunnuntai;38;39;77
93;06.07.2014;2014;07;18;Sunnuntai;43;32;75
93;06.07.2014;2014;07;19;Sunnuntai;35;23;58
93;06.07.2014;2014;07;20;Sunnuntai;28;25;53
93;06.07.2014;2014;07;21;Sunnuntai;13;22;35
93;06.07.2014;2014;07;22;Sunnuntai;5;7;12
93;06.07.2014;2014;07;23;Sunnuntai;3;0;3
93;07.07.2014;2014;07;00;Maanantai;1;7;8
93;07.07.2014;2014;07;01;Maanantai;2;3;5
93;07.07.2014;2014;07;02;Maanantai;1;5;6
93;07.07.2014;2014;07;03;Maanantai;0;0;0
93;07.07.2014;2014;07;04;Maanantai;1;2;3
93;07.07.2014;2014;07;05;Maanantai;4;7;11
93;07.07.2014;2014;07;06;Maanantai;22;7;29
93;07.07.2014;2014;07;07;Maanantai;32;17;49
93;07.07.2014;2014;07;08;Maanantai;21;20;41
93;07.07.2014;2014;07;09;Maanantai;16;26;42
93;07.07.2014;2014;07;10;Maanantai;29;29;58
93;07.07.2014;2014;07;11;Maanantai;30;24;54
93;07.07.2014;2014;07;12;Maanantai;37;15;52
93;07.07.2014;2014;07;13;Maanantai;20;24;44
93;07.07.2014;2014;07;14;Maanantai;41;28;69
93;07.07.2014;2014;07;15;Maanantai;31;45;76
93;07.07.2014;2014;07;16;Maanantai;52;52;104
93;07.07.2014;2014;07;17;Maanantai;40;58;98
93;07.07.2014;2014;07;18;Maanantai;25;34;59
93;07.07.2014;2014;07;19;Maanantai;36;39;75
93;07.07.2014;2014;07;20;Maanantai;29;36;65
93;07.07.2014;2014;07;21;Maanantai;9;37;46
93;07.07.2014;2014;07;22;Maanantai;4;18;22
93;07.07.2014;2014;07;23;Maanantai;2;7;9
93;08.07.2014;2014;07;00;Tiistai;2;0;2
93;08.07.2014;2014;07;01;Tiistai;3;0;3
93;08.07.2014;2014;07;02;Tiistai;3;3;6
93;08.07.2014;2014;07;03;Tiistai;2;1;3
93;08.07.2014;2014;07;04;Tiistai;0;5;5
93;08.07.2014;2014;07;05;Tiistai;8;7;15
93;08.07.2014;2014;07;06;Tiistai;26;11;37
93;08.07.2014;2014;07;07;Tiistai;34;27;61
93;08.07.2014;2014;07;08;Tiistai;22;29;51
93;08.07.2014;2014;07;09;Tiistai;14;14;28
93;08.07.2014;2014;07;10;Tiistai;28;27;55
93;08.07.2014;2014;07;11;Tiistai;32;17;49
93;08.07.2014;2014;07;12;Tiistai;29;23;52
93;08.07.2014;2014;07;13;Tiistai;27;35;62
93;08.07.2014;2014;07;14;Tiistai;38;30;68
93;08.07.2014;2014;07;15;Tiistai;36;44;80
93;08.07.2014;2014;07;16;Tiistai;33;61;94
93;08.07.2014;2014;07;17;Tiistai;39;53;92
93;08.07.2014;2014;07;18;Tiistai;25;32;57
93;08.07.2014;2014;07;19;Tiistai;28;33;61
93;08.07.2014;2014;07;20;Tiistai;22;42;64
93;08.07.2014;2014;07;21;Tiistai;24;18;42
93;08.07.2014;2014;07;22;Tiistai;9;19;28
93;08.07.2014;2014;07;23;Tiistai;5;9;14
93;09.07.2014;2014;07;00;Keskiviikko;6;2;8
93;09.07.2014;2014;07;01;Keskiviikko;1;2;3
93;09.07.2014;2014;07;02;Keskiviikko;0;1;1
93;09.07.2014;2014;07;03;Keskiviikko;0;0;0
93;09.07.2014;2014;07;04;Keskiviikko;1;1;2
93;09.07.2014;2014;07;05;Keskiviikko;4;6;10
93;09.07.2014;2014;07;06;Keskiviikko;27;14;41
93;09.07.2014;2014;07;07;Keskiviikko;37;20;57
93;09.07.2014;2014;07;08;Keskiviikko;30;27;57
93;09.07.2014;2014;07;09;Keskiviikko;26;12;38
93;09.07.2014;2014;07;10;Keskiviikko;20;28;48
93;09.07.2014;2014;07;11;Keskiviikko;25;17;42
93;09.07.2014;2014;07;12;Keskiviikko;37;22;59
93;09.07.2014;2014;07;13;Keskiviikko;29;43;72
93;09.07.2014;2014;07;14;Keskiviikko;33;27;60
93;09.07.2014;2014;07;15;Keskiviikko;31;33;64
93;09.07.2014;2014;07;16;Keskiviikko;45;52;97
93;09.07.2014;2014;07;17;Keskiviikko;24;46;70
93;09.07.2014;2014;07;18;Keskiviikko;34;36;70
93;09.07.2014;2014;07;19;Keskiviikko;25;14;39
93;09.07.2014;2014;07;20;Keskiviikko;16;31;47
93;09.07.2014;2014;07;21;Keskiviikko;9;20;29
93;09.07.2014;2014;07;22;Keskiviikko;14;19;33
93;09.07.2014;2014;07;23;Keskiviikko;3;3;6
93;10.07.2014;2014;07;00;Torstai;0;5;5
93;10.07.2014;2014;07;01;Torstai;0;5;5
93;10.07.2014;2014;07;02;Torstai;0;2;2
93;10.07.2014;2014;07;03;Torstai;0;2;2
93;10.07.2014;2014;07;04;Torstai;1;1;2
93;10.07.2014;2014;07;05;Torstai;3;4;7
93;10.07.2014;2014;07;06;Torstai;19;5;24
93;10.07.2014;2014;07;07;Torstai;21;27;48
93;10.07.2014;2014;07;08;Torstai;16;15;31
93;10.07.2014;2014;07;09;Torstai;9;13;22
93;10.07.2014;2014;07;10;Torstai;18;14;32
93;10.07.2014;2014;07;11;Torstai;32;14;46
93;10.07.2014;2014;07;12;Torstai;23;22;45
93;10.07.2014;2014;07;13;Torstai;12;22;34
93;10.07.2014;2014;07;14;Torstai;22;28;50
93;10.07.2014;2014;07;15;Torstai;32;34;66
93;10.07.2014;2014;07;16;Torstai;42;56;98
93;10.07.2014;2014;07;17;Torstai;45;36;81
93;10.07.2014;2014;07;18;Torstai;20;29;49
93;10.07.2014;2014;07;19;Torstai;21;38;59
93;10.07.2014;2014;07;20;Torstai;23;25;48
93;10.07.2014;2014;07;21;Torstai;8;13;21
93;10.07.2014;2014;07;22;Torstai;7;2;9
93;10.07.2014;2014;07;23;Torstai;4;8;12
93;11.07.2014;2014;07;00;Perjantai;1;7;8
93;11.07.2014;2014;07;01;Perjantai;1;0;1
93;11.07.2014;2014;07;02;Perjantai;0;1;1
93;11.07.2014;2014;07;03;Perjantai;1;4;5
93;11.07.2014;2014;07;04;Perjantai;1;2;3
93;11.07.2014;2014;07;05;Perjantai;3;4;7
93;11.07.2014;2014;07;06;Perjantai;18;11;29
93;11.07.2014;2014;07;07;Perjantai;24;23;47
93;11.07.2014;2014;07;08;Perjantai;10;15;25
93;11.07.2014;2014;07;09;Perjantai;12;12;24
93;11.07.2014;2014;07;10;Perjantai;16;8;24
93;11.07.2014;2014;07;11;Perjantai;21;20;41
93;11.07.2014;2014;07;12;Perjantai;30;13;43
93;11.07.2014;2014;07;13;Perjantai;20;30;50
93;11.07.2014;2014;07;14;Perjantai;37;34;71
93;11.07.2014;2014;07;15;Perjantai;42;39;81
93;11.07.2014;2014;07;16;Perjantai;42;50;92
93;11.07.2014;2014;07;17;Perjantai;26;42;68
93;11.07.2014;2014;07;18;Perjantai;36;31;67
93;11.07.2014;2014;07;19;Perjantai;26;25;51
93;11.07.2014;2014;07;20;Perjantai;10;25;35
93;11.07.2014;2014;07;21;Perjantai;15;24;39
93;11.07.2014;2014;07;22;Perjantai;3;13;16
93;11.07.2014;2014;07;23;Perjantai;2;10;12
93;12.07.2014;2014;07;00;Lauantai;2;5;7
93;12.07.2014;2014;07;01;Lauantai;5;5;10
93;12.07.2014;2014;07;02;Lauantai;4;6;10
93;12.07.2014;2014;07;03;Lauantai;2;8;10
93;12.07.2014;2014;07;04;Lauantai;2;7;9
93;12.07.2014;2014;07;05;Lauantai;0;2;2
93;12.07.2014;2014;07;06;Lauantai;7;2;9
93;12.07.2014;2014;07;07;Lauantai;6;8;14
93;12.07.2014;2014;07;08;Lauantai;10;5;15
93;12.07.2014;2014;07;09;Lauantai;13;24;37
93;12.07.2014;2014;07;10;Lauantai;13;9;22
93;12.07.2014;2014;07;11;Lauantai;14;32;46
93;12.07.2014;2014;07;12;Lauantai;46;31;77
93;12.07.2014;2014;07;13;Lauantai;37;46;83
93;12.07.2014;2014;07;14;Lauantai;36;26;62
93;12.07.2014;2014;07;15;Lauantai;27;32;59
93;12.07.2014;2014;07;16;Lauantai;31;38;69
93;12.07.2014;2014;07;17;Lauantai;36;26;62
93;12.07.2014;2014;07;18;Lauantai;31;23;54
93;12.07.2014;2014;07;19;Lauantai;27;26;53
93;12.07.2014;2014;07;20;Lauantai;19;18;37
93;12.07.2014;2014;07;21;Lauantai;17;13;30
93;12.07.2014;2014;07;22;Lauantai;6;8;14
93;12.07.2014;2014;07;23;Lauantai;1;5;6
93;13.07.2014;2014;07;00;Sunnuntai;3;11;14
93;13.07.2014;2014;07;01;Sunnuntai;3;5;8
93;13.07.2014;2014;07;02;Sunnuntai;3;3;6
93;13.07.2014;2014;07;03;Sunnuntai;0;5;5
93;13.07.2014;2014;07;04;Sunnuntai;0;1;1
93;13.07.2014;2014;07;05;Sunnuntai;0;1;1
93;13.07.2014;2014;07;06;Sunnuntai;0;2;2
93;13.07.2014;2014;07;07;Sunnuntai;8;6;14
93;13.07.2014;2014;07;08;Sunnuntai;4;10;14
93;13.07.2014;2014;07;09;Sunnuntai;8;9;17
93;13.07.2014;2014;07;10;Sunnuntai;20;18;38
93;13.07.2014;2014;07;11;Sunnuntai;32;33;65
93;13.07.2014;2014;07;12;Sunnuntai;41;26;67
93;13.07.2014;2014;07;13;Sunnuntai;38;44;82
93;13.07.2014;2014;07;14;Sunnuntai;27;24;51
93;13.07.2014;2014;07;15;Sunnuntai;35;38;73
93;13.07.2014;2014;07;16;Sunnuntai;22;32;54
93;13.07.2014;2014;07;17;Sunnuntai;33;34;67
93;13.07.2014;2014;07;18;Sunnuntai;34;32;66
93;13.07.2014;2014;07;19;Sunnuntai;34;32;66
93;13.07.2014;2014;07;20;Sunnuntai;25;30;55
93;13.07.2014;2014;07;21;Sunnuntai;25;17;42
93;13.07.2014;2014;07;22;Sunnuntai;6;6;12
93;13.07.2014;2014;07;23;Sunnuntai;5;3;8
93;14.07.2014;2014;07;00;Maanantai;1;5;6
93;14.07.2014;2014;07;01;Maanantai;3;4;7
93;14.07.2014;2014;07;02;Maanantai;2;0;2
93;14.07.2014;2014;07;03;Maanantai;1;1;2
93;14.07.2014;2014;07;04;Maanantai;0;0;0
93;14.07.2014;2014;07;05;Maanantai;6;5;11
93;14.07.2014;2014;07;06;Maanantai;16;12;28
93;14.07.2014;2014;07;07;Maanantai;37;16;53
93;14.07.2014;2014;07;08;Maanantai;16;11;27
93;14.07.2014;2014;07;09;Maanantai;10;11;21
93;14.07.2014;2014;07;10;Maanantai;15;19;34
93;14.07.2014;2014;07;11;Maanantai;20;10;30
93;14.07.2014;2014;07;12;Maanantai;32;17;49
93;14.07.2014;2014;07;13;Maanantai;27;29;56
93;14.07.2014;2014;07;14;Maanantai;37;23;60
93;14.07.2014;2014;07;15;Maanantai;35;34;69
93;14.07.2014;2014;07;16;Maanantai;39;55;94
93;14.07.2014;2014;07;17;Maanantai;41;33;74
93;14.07.2014;2014;07;18;Maanantai;20;27;47
93;14.07.2014;2014;07;19;Maanantai;3;17;20
93;14.07.2014;2014;07;20;Maanantai;7;13;20
93;14.07.2014;2014;07;21;Maanantai;5;6;11
93;14.07.2014;2014;07;22;Maanantai;4;6;10
93;14.07.2014;2014;07;23;Maanantai;1;0;1
93;15.07.2014;2014;07;00;Tiistai;0;4;4
93;15.07.2014;2014;07;01;Tiistai;2;3;5
93;15.07.2014;2014;07;02;Tiistai;0;0;0
93;15.07.2014;2014;07;03;Tiistai;0;0;0
93;15.07.2014;2014;07;04;Tiistai;0;1;1
93;15.07.2014;2014;07;05;Tiistai;3;4;7
93;15.07.2014;2014;07;06;Tiistai;27;12;39
93;15.07.2014;2014;07;07;Tiistai;22;15;37
93;15.07.2014;2014;07;08;Tiistai;16;16;32
93;15.07.2014;2014;07;09;Tiistai;15;8;23
93;15.07.2014;2014;07;10;Tiistai;10;12;22
93;15.07.2014;2014;07;11;Tiistai;9;12;21
93;15.07.2014;2014;07;12;Tiistai;24;21;45
93;15.07.2014;2014;07;13;Tiistai;32;29;61
93;15.07.2014;2014;07;14;Tiistai;26;17;43
93;15.07.2014;2014;07;15;Tiistai;32;48;80
93;15.07.2014;2014;07;16;Tiistai;44;49;93
93;15.07.2014;2014;07;17;Tiistai;19;40;59
93;15.07.2014;2014;07;18;Tiistai;35;43;78
93;15.07.2014;2014;07;19;Tiistai;34;28;62
93;15.07.2014;2014;07;20;Tiistai;7;20;27
93;15.07.2014;2014;07;21;Tiistai;10;9;19
93;15.07.2014;2014;07;22;Tiistai;5;5;10
93;15.07.2014;2014;07;23;Tiistai;3;2;5
93;16.07.2014;2014;07;00;Keskiviikko;3;10;13
93;16.07.2014;2014;07;01;Keskiviikko;6;2;8
93;16.07.2014;2014;07;02;Keskiviikko;2;7;9
93;16.07.2014;2014;07;03;Keskiviikko;1;2;3
93;16.07.2014;2014;07;04;Keskiviikko;26;17;43
93;16.07.2014;2014;07;05;Keskiviikko;3;5;8
93;16.07.2014;2014;07;06;Keskiviikko;14;12;26
93;16.07.2014;2014;07;07;Keskiviikko;31;20;51
93;16.07.2014;2014;07;08;Keskiviikko;24;13;37
93;16.07.2014;2014;07;09;Keskiviikko;15;15;30
93;16.07.2014;2014;07;10;Keskiviikko;15;16;31
93;16.07.2014;2014;07;11;Keskiviikko;20;33;53
93;16.07.2014;2014;07;12;Keskiviikko;24;18;42
93;16.07.2014;2014;07;13;Keskiviikko;28;23;51
93;16.07.2014;2014;07;14;Keskiviikko;28;13;41
93;16.07.2014;2014;07;15;Keskiviikko;10;35;45
93;16.07.2014;2014;07;16;Keskiviikko;23;29;52
93;16.07.2014;2014;07;17;Keskiviikko;17;28;45
93;16.07.2014;2014;07;18;Keskiviikko;7;17;24
93;16.07.2014;2014;07;19;Keskiviikko;11;11;22
93;16.07.2014;2014;07;20;Keskiviikko;8;9;17
93;16.07.2014;2014;07;21;Keskiviikko;8;15;23
93;16.07.2014;2014;07;22;Keskiviikko;5;10;15
93;16.07.2014;2014;07;23;Keskiviikko;2;5;7
93;17.07.2014;2014;07;00;Torstai;3;2;5
93;17.07.2014;2014;07;01;Torstai;0;1;1
93;17.07.2014;2014;07;02;Torstai;0;0;0
93;17.07.2014;2014;07;03;Torstai;0;2;2
93;17.07.2014;2014;07;04;Torstai;0;4;4
93;17.07.2014;2014;07;05;Torstai;7;4;11
93;17.07.2014;2014;07;06;Torstai;25;15;40
93;17.07.2014;2014;07;07;Torstai;28;19;47
93;17.07.2014;2014;07;08;Torstai;16;14;30
93;17.07.2014;2014;07;09;Torstai;15;12;27
93;17.07.2014;2014;07;10;Torstai;11;9;20
93;17.07.2014;2014;07;11;Torstai;16;21;37
93;17.07.2014;2014;07;12;Torstai;26;23;49
93;17.07.2014;2014;07;13;Torstai;25;19;44
93;17.07.2014;2014;07;14;Torstai;20;21;41
93;17.07.2014;2014;07;15;Torstai;27;27;54
93;17.07.2014;2014;07;16;Torstai;26;40;66
93;17.07.2014;2014;07;17;Torstai;22;26;48
93;17.07.2014;2014;07;18;Torstai;19;22;41
93;17.07.2014;2014;07;19;Torstai;14;24;38
93;17.07.2014;2014;07;20;Torstai;10;14;24
93;17.07.2014;2014;07;21;Torstai;11;14;25
93;17.07.2014;2014;07;22;Torstai;6;14;20
93;17.07.2014;2014;07;23;Torstai;6;5;11
93;18.07.2014;2014;07;00;Perjantai;2;2;4
93;18.07.2014;2014;07;01;Perjantai;0;0;0
93;18.07.2014;2014;07;02;Perjantai;2;1;3
93;18.07.2014;2014;07;03;Perjantai;0;1;1
93;18.07.2014;2014;07;04;Perjantai;0;2;2
93;18.07.2014;2014;07;05;Perjantai;4;3;7
93;18.07.2014;2014;07;06;Perjantai;12;13;25
93;18.07.2014;2014;07;07;Perjantai;19;15;34
93;18.07.2014;2014;07;08;Perjantai;12;11;23
93;18.07.2014;2014;07;09;Perjantai;16;11;27
93;18.07.2014;2014;07;10;Perjantai;6;11;17
93;18.07.2014;2014;07;11;Perjantai;13;17;30
93;18.07.2014;2014;07;12;Perjantai;10;10;20
93;18.07.2014;2014;07;13;Perjantai;8;6;14
93;18.07.2014;2014;07;14;Perjantai;12;10;22
93;18.07.2014;2014;07;15;Perjantai;8;26;34
93;18.07.2014;2014;07;16;Perjantai;14;27;41
93;18.07.2014;2014;07;17;Perjantai;20;22;42
93;18.07.2014;2014;07;18;Perjantai;23;15;38
93;18.07.2014;2014;07;19;Perjantai;28;23;51
93;18.07.2014;2014;07;20;Perjantai;8;25;33
93;18.07.2014;2014;07;21;Perjantai;13;14;27
93;18.07.2014;2014;07;22;Perjantai;8;10;18
93;18.07.2014;2014;07;23;Perjantai;7;1;8
93;19.07.2014;2014;07;00;Lauantai;3;3;6
93;19.07.2014;2014;07;01;Lauantai;6;4;10
93;19.07.2014;2014;07;02;Lauantai;5;2;7
93;19.07.2014;2014;07;03;Lauantai;0;3;3
93;19.07.2014;2014;07;04;Lauantai;1;0;1
93;19.07.2014;2014;07;05;Lauantai;1;0;1
93;19.07.2014;2014;07;06;Lauantai;4;2;6
93;19.07.2014;2014;07;07;Lauantai;2;3;5
93;19.07.2014;2014;07;08;Lauantai;7;5;12
93;19.07.2014;2014;07;09;Lauantai;14;16;30
93;19.07.2014;2014;07;10;Lauantai;29;18;47
93;19.07.2014;2014;07;11;Lauantai;25;38;63
93;19.07.2014;2014;07;12;Lauantai;32;21;53
93;19.07.2014;2014;07;13;Lauantai;19;27;46
93;19.07.2014;2014;07;14;Lauantai;17;22;39
93;19.07.2014;2014;07;15;Lauantai;7;19;26
93;19.07.2014;2014;07;16;Lauantai;8;16;24
93;19.07.2014;2014;07;17;Lauantai;13;5;18
93;19.07.2014;2014;07;18;Lauantai;10;16;26
93;19.07.2014;2014;07;19;Lauantai;6;12;18
93;19.07.2014;2014;07;20;Lauantai;6;12;18
93;19.07.2014;2014;07;21;Lauantai;10;14;24
93;19.07.2014;2014;07;22;Lauantai;12;16;28
93;19.07.2014;2014;07;23;Lauantai;10;4;14
93;20.07.2014;2014;07;00;Sunnuntai;1;0;1
93;20.07.2014;2014;07;01;Sunnuntai;0;7;7
93;20.07.2014;2014;07;02;Sunnuntai;2;2;4
93;20.07.2014;2014;07;03;Sunnuntai;1;1;2
93;20.07.2014;2014;07;04;Sunnuntai;1;1;2
93;20.07.2014;2014;07;05;Sunnuntai;3;1;4
93;20.07.2014;2014;07;06;Sunnuntai;2;2;4
93;20.07.2014;2014;07;07;Sunnuntai;8;2;10
93;20.07.2014;2014;07;08;Sunnuntai;13;8;21
93;20.07.2014;2014;07;09;Sunnuntai;13;13;26
93;20.07.2014;2014;07;10;Sunnuntai;37;32;69
93;20.07.2014;2014;07;11;Sunnuntai;34;49;83
93;20.07.2014;2014;07;12;Sunnuntai;40;31;71
93;20.07.2014;2014;07;13;Sunnuntai;32;53;85
93;20.07.2014;2014;07;14;Sunnuntai;33;36;69
93;20.07.2014;2014;07;15;Sunnuntai;28;29;57
93;20.07.2014;2014;07;16;Sunnuntai;38;28;66
93;20.07.2014;2014;07;17;Sunnuntai;35;33;68
93;20.07.2014;2014;07;18;Sunnuntai;27;25;52
93;20.07.2014;2014;07;19;Sunnuntai;43;21;64
93;20.07.2014;2014;07;20;Sunnuntai;20;29;49
93;20.07.2014;2014;07;21;Sunnuntai;12;20;32
93;20.07.2014;2014;07;22;Sunnuntai;7;13;20
93;20.07.2014;2014;07;23;Sunnuntai;0;2;2
93;21.07.2014;2014;07;00;Maanantai;4;2;6
93;21.07.2014;2014;07;01;Maanantai;2;4;6
93;21.07.2014;2014;07;02;Maanantai;1;4;5
93;21.07.2014;2014;07;03;Maanantai;0;0;0
93;21.07.2014;2014;07;04;Maanantai;1;4;5
93;21.07.2014;2014;07;05;Maanantai;5;4;9
93;21.07.2014;2014;07;06;Maanantai;19;13;32
93;21.07.2014;2014;07;07;Maanantai;34;21;55
93;21.07.2014;2014;07;08;Maanantai;22;25;47
93;21.07.2014;2014;07;09;Maanantai;8;24;32
93;21.07.2014;2014;07;10;Maanantai;29;15;44
93;21.07.2014;2014;07;11;Maanantai;25;25;50
93;21.07.2014;2014;07;12;Maanantai;34;33;67
93;21.07.2014;2014;07;13;Maanantai;41;27;68
93;21.07.2014;2014;07;14;Maanantai;39;28;67
93;21.07.2014;2014;07;15;Maanantai;38;40;78
93;21.07.2014;2014;07;16;Maanantai;49;50;99
93;21.07.2014;2014;07;17;Maanantai;37;35;72
93;21.07.2014;2014;07;18;Maanantai;40;61;101
93;21.07.2014;2014;07;19;Maanantai;51;43;94
93;21.07.2014;2014;07;20;Maanantai;39;47;86
93;21.07.2014;2014;07;21;Maanantai;20;32;52
93;21.07.2014;2014;07;22;Maanantai;7;17;24
93;21.07.2014;2014;07;23;Maanantai;5;3;8
93;22.07.2014;2014;07;00;Tiistai;4;5;9
93;22.07.2014;2014;07;01;Tiistai;1;1;2
93;22.07.2014;2014;07;02;Tiistai;0;3;3
93;22.07.2014;2014;07;03;Tiistai;0;0;0
93;22.07.2014;2014;07;04;Tiistai;1;2;3
93;22.07.2014;2014;07;05;Tiistai;5;7;12
93;22.07.2014;2014;07;06;Tiistai;28;12;40
93;22.07.2014;2014;07;07;Tiistai;34;20;54
93;22.07.2014;2014;07;08;Tiistai;23;19;42
93;22.07.2014;2014;07;09;Tiistai;15;23;38
93;22.07.2014;2014;07;10;Tiistai;16;13;29
93;22.07.2014;2014;07;11;Tiistai;34;20;54
93;22.07.2014;2014;07;12;Tiistai;32;39;71
93;22.07.2014;2014;07;13;Tiistai;36;30;66
93;22.07.2014;2014;07;14;Tiistai;37;26;63
93;22.07.2014;2014;07;15;Tiistai;48;53;101
93;22.07.2014;2014;07;16;Tiistai;36;63;99
93;22.07.2014;2014;07;17;Tiistai;35;37;72
93;22.07.2014;2014;07;18;Tiistai;24;36;60
93;22.07.2014;2014;07;19;Tiistai;33;44;77
93;22.07.2014;2014;07;20;Tiistai;26;35;61
93;22.07.2014;2014;07;21;Tiistai;14;26;40
93;22.07.2014;2014;07;22;Tiistai;13;13;26
93;22.07.2014;2014;07;23;Tiistai;4;7;11
93;23.07.2014;2014;07;00;Keskiviikko;3;2;5
93;23.07.2014;2014;07;01;Keskiviikko;0;3;3
93;23.07.2014;2014;07;02;Keskiviikko;0;3;3
93;23.07.2014;2014;07;03;Keskiviikko;0;2;2
93;23.07.2014;2014;07;04;Keskiviikko;0;2;2
93;23.07.2014;2014;07;05;Keskiviikko;6;6;12
93;23.07.2014;2014;07;06;Keskiviikko;26;16;42
93;23.07.2014;2014;07;07;Keskiviikko;33;23;56
93;23.07.2014;2014;07;08;Keskiviikko;24;18;42
93;23.07.2014;2014;07;09;Keskiviikko;20;28;48
93;23.07.2014;2014;07;10;Keskiviikko;16;23;39
93;23.07.2014;2014;07;11;Keskiviikko;21;20;41
93;23.07.2014;2014;07;12;Keskiviikko;29;30;59
93;23.07.2014;2014;07;13;Keskiviikko;38;28;66
93;23.07.2014;2014;07;14;Keskiviikko;28;32;60
93;23.07.2014;2014;07;15;Keskiviikko;42;39;81
93;23.07.2014;2014;07;16;Keskiviikko;31;37;68
93;23.07.2014;2014;07;17;Keskiviikko;33;28;61
93;23.07.2014;2014;07;18;Keskiviikko;36;46;82
93;23.07.2014;2014;07;19;Keskiviikko;29;29;58
93;23.07.2014;2014;07;20;Keskiviikko;27;27;54
93;23.07.2014;2014;07;21;Keskiviikko;24;26;50
93;23.07.2014;2014;07;22;Keskiviikko;6;11;17
93;23.07.2014;2014;07;23;Keskiviikko;11;0;11
93;24.07.2014;2014;07;00;Torstai;7;3;10
93;24.07.2014;2014;07;01;Torstai;1;2;3
93;24.07.2014;2014;07;02;Torstai;0;7;7
93;24.07.2014;2014;07;03;Torstai;0;0;0
93;24.07.2014;2014;07;04;Torstai;0;2;2
93;24.07.2014;2014;07;05;Torstai;6;4;10
93;24.07.2014;2014;07;06;Torstai;20;11;31
93;24.07.2014;2014;07;07;Torstai;26;15;41
93;24.07.2014;2014;07;08;Torstai;25;17;42
93;24.07.2014;2014;07;09;Torstai;20;19;39
93;24.07.2014;2014;07;10;Torstai;17;20;37
93;24.07.2014;2014;07;11;Torstai;26;16;42
93;24.07.2014;2014;07;12;Torstai;33;22;55
93;24.07.2014;2014;07;13;Torstai;19;29;48
93;24.07.2014;2014;07;14;Torstai;26;27;53
93;24.07.2014;2014;07;15;Torstai;34;43;77
93;24.07.2014;2014;07;16;Torstai;36;63;99
93;24.07.2014;2014;07;17;Torstai;37;25;62
93;24.07.2014;2014;07;18;Torstai;18;42;60
93;24.07.2014;2014;07;19;Torstai;42;35;77
93;24.07.2014;2014;07;20;Torstai;29;36;65
93;24.07.2014;2014;07;21;Torstai;27;21;48
93;24.07.2014;2014;07;22;Torstai;7;12;19
93;24.07.2014;2014;07;23;Torstai;5;4;9
93;25.07.2014;2014;07;00;Perjantai;4;4;8
93;25.07.2014;2014;07;01;Perjantai;1;4;5
93;25.07.2014;2014;07;02;Perjantai;0;0;0
93;25.07.2014;2014;07;03;Perjantai;0;2;2
93;25.07.2014;2014;07;04;Perjantai;1;3;4
93;25.07.2014;2014;07;05;Perjantai;4;5;9
93;25.07.2014;2014;07;06;Perjantai;21;9;30
93;25.07.2014;2014;07;07;Perjantai;21;15;36
93;25.07.2014;2014;07;08;Perjantai;20;12;32
93;25.07.2014;2014;07;09;Perjantai;19;13;32
93;25.07.2014;2014;07;10;Perjantai;13;23;36
93;25.07.2014;2014;07;11;Perjantai;19;24;43
93;25.07.2014;2014;07;12;Perjantai;21;16;37
93;25.07.2014;2014;07;13;Perjantai;21;33;54
93;25.07.2014;2014;07;14;Perjantai;37;29;66
93;25.07.2014;2014;07;15;Perjantai;37;42;79
93;25.07.2014;2014;07;16;Perjantai;37;37;74
93;25.07.2014;2014;07;17;Perjantai;38;26;64
93;25.07.2014;2014;07;18;Perjantai;24;27;51
93;25.07.2014;2014;07;19;Perjantai;21;20;41
93;25.07.2014;2014;07;20;Perjantai;19;16;35
93;25.07.2014;2014;07;21;Perjantai;22;22;44
93;25.07.2014;2014;07;22;Perjantai;14;11;25
93;25.07.2014;2014;07;23;Perjantai;5;19;24
93;26.07.2014;2014;07;00;Lauantai;2;12;14
93;26.07.2014;2014;07;01;Lauantai;0;12;12
93;26.07.2014;2014;07;02;Lauantai;3;11;14
93;26.07.2014;2014;07;03;Lauantai;2;13;15
93;26.07.2014;2014;07;04;Lauantai;2;12;14
93;26.07.2014;2014;07;05;Lauantai;1;2;3
93;26.07.2014;2014;07;06;Lauantai;2;7;9
93;26.07.2014;2014;07;07;Lauantai;2;2;4
93;26.07.2014;2014;07;08;Lauantai;10;7;17
93;26.07.2014;2014;07;09;Lauantai;16;15;31
93;26.07.2014;2014;07;10;Lauantai;17;16;33
93;26.07.2014;2014;07;11;Lauantai;26;26;52
93;26.07.2014;2014;07;12;Lauantai;32;17;49
93;26.07.2014;2014;07;13;Lauantai;33;22;55
93;26.07.2014;2014;07;14;Lauantai;25;21;46
93;26.07.2014;2014;07;15;Lauantai;15;35;50
93;26.07.2014;2014;07;16;Lauantai;27;15;42
93;26.07.2014;2014;07;17;Lauantai;28;18;46
93;26.07.2014;2014;07;18;Lauantai;26;17;43
93;26.07.2014;2014;07;19;Lauantai;24;11;35
93;26.07.2014;2014;07;20;Lauantai;22;21;43
93;26.07.2014;2014;07;21;Lauantai;9;17;26
93;26.07.2014;2014;07;22;Lauantai;6;18;24
93;26.07.2014;2014;07;23;Lauantai;5;10;15
93;27.07.2014;2014;07;00;Sunnuntai;1;10;11
93;27.07.2014;2014;07;01;Sunnuntai;0;22;22
93;27.07.2014;2014;07;02;Sunnuntai;2;14;16
93;27.07.2014;2014;07;03;Sunnuntai;1;15;16
93;27.07.2014;2014;07;04;Sunnuntai;2;10;12
93;27.07.2014;2014;07;05;Sunnuntai;1;4;5
93;27.07.2014;2014;07;06;Sunnuntai;6;2;8
93;27.07.2014;2014;07;07;Sunnuntai;2;7;9
93;27.07.2014;2014;07;08;Sunnuntai;3;3;6
93;27.07.2014;2014;07;09;Sunnuntai;13;17;30
93;27.07.2014;2014;07;10;Sunnuntai;23;28;51
93;27.07.2014;2014;07;11;Sunnuntai;28;33;61
93;27.07.2014;2014;07;12;Sunnuntai;30;26;56
93;27.07.2014;2014;07;13;Sunnuntai;26;23;49
93;27.07.2014;2014;07;14;Sunnuntai;26;36;62
93;27.07.2014;2014;07;15;Sunnuntai;41;22;63
93;27.07.2014;2014;07;16;Sunnuntai;25;18;43
93;27.07.2014;2014;07;17;Sunnuntai;21;26;47
93;27.07.2014;2014;07;18;Sunnuntai;24;30;54
93;27.07.2014;2014;07;19;Sunnuntai;25;26;51
93;27.07.2014;2014;07;20;Sunnuntai;23;29;52
93;27.07.2014;2014;07;21;Sunnuntai;12;19;31
93;27.07.2014;2014;07;22;Sunnuntai;4;9;13
93;27.07.2014;2014;07;23;Sunnuntai;5;2;7
93;28.07.2014;2014;07;00;Maanantai;3;5;8
93;28.07.2014;2014;07;01;Maanantai;1;0;1
93;28.07.2014;2014;07;02;Maanantai;1;0;1
93;28.07.2014;2014;07;03;Maanantai;0;0;0
93;28.07.2014;2014;07;04;Maanantai;0;1;1
93;28.07.2014;2014;07;05;Maanantai;2;3;5
93;28.07.2014;2014;07;06;Maanantai;19;11;30
93;28.07.2014;2014;07;07;Maanantai;31;21;52
93;28.07.2014;2014;07;08;Maanantai;9;10;19
93;28.07.2014;2014;07;09;Maanantai;1;3;4
93;28.07.2014;2014;07;10;Maanantai;1;3;4
93;28.07.2014;2014;07;11;Maanantai;4;0;4
93;28.07.2014;2014;07;12;Maanantai;2;8;10
93;28.07.2014;2014;07;13;Maanantai;12;13;25
93;28.07.2014;2014;07;14;Maanantai;15;11;26
93;28.07.2014;2014;07;15;Maanantai;10;13;23
93;28.07.2014;2014;07;16;Maanantai;21;24;45
93;28.07.2014;2014;07;17;Maanantai;14;19;33
93;28.07.2014;2014;07;18;Maanantai;18;16;34
93;28.07.2014;2014;07;19;Maanantai;22;25;47
93;28.07.2014;2014;07;20;Maanantai;8;3;11
93;28.07.2014;2014;07;21;Maanantai;3;10;13
93;28.07.2014;2014;07;22;Maanantai;2;3;5
93;28.07.2014;2014;07;23;Maanantai;2;0;2
93;29.07.2014;2014;07;00;Tiistai;0;3;3
93;29.07.2014;2014;07;01;Tiistai;0;0;0
93;29.07.2014;2014;07;02;Tiistai;0;0;0
93;29.07.2014;2014;07;03;Tiistai;0;0;0
93;29.07.2014;2014;07;04;Tiistai;0;1;1
93;29.07.2014;2014;07;05;Tiistai;2;6;8
93;29.07.2014;2014;07;06;Tiistai;17;3;20
93;29.07.2014;2014;07;07;Tiistai;30;25;55
93;29.07.2014;2014;07;08;Tiistai;16;23;39
93;29.07.2014;2014;07;09;Tiistai;9;19;28
93;29.07.2014;2014;07;10;Tiistai;18;17;35
93;29.07.2014;2014;07;11;Tiistai;22;15;37
93;29.07.2014;2014;07;12;Tiistai;24;17;41
93;29.07.2014;2014;07;13;Tiistai;21;25;46
93;29.07.2014;2014;07;14;Tiistai;36;19;55
93;29.07.2014;2014;07;15;Tiistai;32;26;58
93;29.07.2014;2014;07;16;Tiistai;48;48;96
93;29.07.2014;2014;07;17;Tiistai;38;40;78
93;29.07.2014;2014;07;18;Tiistai;32;32;64
93;29.07.2014;2014;07;19;Tiistai;26;35;61
93;29.07.2014;2014;07;20;Tiistai;26;36;62
93;29.07.2014;2014;07;21;Tiistai;18;20;38
93;29.07.2014;2014;07;22;Tiistai;4;13;17
93;29.07.2014;2014;07;23;Tiistai;5;0;5
93;30.07.2014;2014;07;00;Keskiviikko;3;4;7
93;30.07.2014;2014;07;01;Keskiviikko;0;0;0
93;30.07.2014;2014;07;02;Keskiviikko;1;1;2
93;30.07.2014;2014;07;03;Keskiviikko;0;3;3
93;30.07.2014;2014;07;04;Keskiviikko;0;1;1
93;30.07.2014;2014;07;05;Keskiviikko;6;2;8
93;30.07.2014;2014;07;06;Keskiviikko;23;7;30
93;30.07.2014;2014;07;07;Keskiviikko;40;28;68
93;30.07.2014;2014;07;08;Keskiviikko;23;31;54
93;30.07.2014;2014;07;09;Keskiviikko;11;13;24
93;30.07.2014;2014;07;10;Keskiviikko;15;30;45
93;30.07.2014;2014;07;11;Keskiviikko;20;8;28
93;30.07.2014;2014;07;12;Keskiviikko;22;29;51
93;30.07.2014;2014;07;13;Keskiviikko;11;24;35
93;30.07.2014;2014;07;14;Keskiviikko;24;17;41
93;30.07.2014;2014;07;15;Keskiviikko;39;33;72
93;30.07.2014;2014;07;16;Keskiviikko;59;59;118
93;30.07.2014;2014;07;17;Keskiviikko;26;50;76
93;30.07.2014;2014;07;18;Keskiviikko;33;39;72
93;30.07.2014;2014;07;19;Keskiviikko;41;38;79
93;30.07.2014;2014;07;20;Keskiviikko;22;21;43
93;30.07.2014;2014;07;21;Keskiviikko;10;15;25
93;30.07.2014;2014;07;22;Keskiviikko;6;4;10
93;30.07.2014;2014;07;23;Keskiviikko;4;3;7
93;31.07.2014;2014;07;00;Torstai;2;1;3
93;31.07.2014;2014;07;01;Torstai;1;0;1
93;31.07.2014;2014;07;02;Torstai;0;0;0
93;31.07.2014;2014;07;03;Torstai;0;1;1
93;31.07.2014;2014;07;04;Torstai;0;0;0
93;31.07.2014;2014;07;05;Torstai;1;0;1
93;31.07.2014;2014;07;06;Torstai;7;4;11
93;31.07.2014;2014;07;07;Torstai;14;11;25
93;31.07.2014;2014;07;08;Torstai;3;17;20
93;31.07.2014;2014;07;09;Torstai;7;9;16
93;31.07.2014;2014;07;10;Torstai;4;7;11
93;31.07.2014;2014;07;11;Torstai;5;8;13
93;31.07.2014;2014;07;12;Torstai;4;7;11
93;31.07.2014;2014;07;13;Torstai;2;4;6
93;31.07.2014;2014;07;14;Torstai;4;2;6
93;31.07.2014;2014;07;15;Torstai;10;5;15
93;31.07.2014;2014;07;16;Torstai;9;8;17
93;31.07.2014;2014;07;17;Torstai;1;2;3
93;31.07.2014;2014;07;18;Torstai;3;3;6
93;31.07.2014;2014;07;19;Torstai;1;4;5
93;31.07.2014;2014;07;20;Torstai;12;5;17
93;31.07.2014;2014;07;21;Torstai;9;8;17
93;31.07.2014;2014;07;22;Torstai;0;5;5
93;31.07.2014;2014;07;23;Torstai;2;1;3
93;01.08.2014;2014;08;00;Perjantai;0;1;1
93;01.08.2014;2014;08;01;Perjantai;1;1;2
93;01.08.2014;2014;08;02;Perjantai;0;3;3
93;01.08.2014;2014;08;03;Perjantai;0;0;0
93;01.08.2014;2014;08;04;Perjantai;0;1;1
93;01.08.2014;2014;08;05;Perjantai;3;4;7
93;01.08.2014;2014;08;06;Perjantai;22;6;28
93;01.08.2014;2014;08;07;Perjantai;28;19;47
93;01.08.2014;2014;08;08;Perjantai;17;16;33
93;01.08.2014;2014;08;09;Perjantai;15;18;33
93;01.08.2014;2014;08;10;Perjantai;26;18;44
93;01.08.2014;2014;08;11;Perjantai;14;17;31
93;01.08.2014;2014;08;12;Perjantai;28;24;52
93;01.08.2014;2014;08;13;Perjantai;24;23;47
93;01.08.2014;2014;08;14;Perjantai;37;35;72
93;01.08.2014;2014;08;15;Perjantai;35;49;84
93;01.08.2014;2014;08;16;Perjantai;50;48;98
93;01.08.2014;2014;08;17;Perjantai;33;34;67
93;01.08.2014;2014;08;18;Perjantai;35;30;65
93;01.08.2014;2014;08;19;Perjantai;10;28;38
93;01.08.2014;2014;08;20;Perjantai;15;16;31
93;01.08.2014;2014;08;21;Perjantai;19;26;45
93;01.08.2014;2014;08;22;Perjantai;13;16;29
93;01.08.2014;2014;08;23;Perjantai;1;6;7
93;02.08.2014;2014;08;00;Lauantai;2;4;6
93;02.08.2014;2014;08;01;Lauantai;0;2;2
93;02.08.2014;2014;08;02;Lauantai;2;6;8
93;02.08.2014;2014;08;03;Lauantai;3;4;7
93;02.08.2014;2014;08;04;Lauantai;0;1;1
93;02.08.2014;2014;08;05;Lauantai;1;0;1
93;02.08.2014;2014;08;06;Lauantai;3;2;5
93;02.08.2014;2014;08;07;Lauantai;3;6;9
93;02.08.2014;2014;08;08;Lauantai;10;11;21
93;02.08.2014;2014;08;09;Lauantai;10;11;21
93;02.08.2014;2014;08;10;Lauantai;18;16;34
93;02.08.2014;2014;08;11;Lauantai;24;23;47
93;02.08.2014;2014;08;12;Lauantai;32;18;50
93;02.08.2014;2014;08;13;Lauantai;20;30;50
93;02.08.2014;2014;08;14;Lauantai;22;24;46
93;02.08.2014;2014;08;15;Lauantai;19;29;48
93;02.08.2014;2014;08;16;Lauantai;32;43;75
93;02.08.2014;2014;08;17;Lauantai;24;27;51
93;02.08.2014;2014;08;18;Lauantai;15;33;48
93;02.08.2014;2014;08;19;Lauantai;23;25;48
93;02.08.2014;2014;08;20;Lauantai;17;10;27
93;02.08.2014;2014;08;21;Lauantai;10;15;25
93;02.08.2014;2014;08;22;Lauantai;5;9;14
93;02.08.2014;2014;08;23;Lauantai;6;8;14
93;03.08.2014;2014;08;00;Sunnuntai;1;9;10
93;03.08.2014;2014;08;01;Sunnuntai;2;2;4
93;03.08.2014;2014;08;02;Sunnuntai;0;5;5
93;03.08.2014;2014;08;03;Sunnuntai;0;3;3
93;03.08.2014;2014;08;04;Sunnuntai;0;1;1
93;03.08.2014;2014;08;05;Sunnuntai;0;0;0
93;03.08.2014;2014;08;06;Sunnuntai;2;2;4
93;03.08.2014;2014;08;07;Sunnuntai;6;4;10
93;03.08.2014;2014;08;08;Sunnuntai;12;8;20
93;03.08.2014;2014;08;09;Sunnuntai;13;10;23
93;03.08.2014;2014;08;10;Sunnuntai;20;29;49
93;03.08.2014;2014;08;11;Sunnuntai;30;22;52
93;03.08.2014;2014;08;12;Sunnuntai;50;30;80
93;03.08.2014;2014;08;13;Sunnuntai;36;37;73
93;03.08.2014;2014;08;14;Sunnuntai;34;43;77
93;03.08.2014;2014;08;15;Sunnuntai;41;30;71
93;03.08.2014;2014;08;16;Sunnuntai;36;20;56
93;03.08.2014;2014;08;17;Sunnuntai;29;35;64
93;03.08.2014;2014;08;18;Sunnuntai;29;29;58
93;03.08.2014;2014;08;19;Sunnuntai;29;26;55
93;03.08.2014;2014;08;20;Sunnuntai;27;32;59
93;03.08.2014;2014;08;21;Sunnuntai;19;14;33
93;03.08.2014;2014;08;22;Sunnuntai;10;8;18
93;03.08.2014;2014;08;23;Sunnuntai;0;3;3
93;04.08.2014;2014;08;00;Maanantai;3;4;7
93;04.08.2014;2014;08;01;Maanantai;2;1;3
93;04.08.2014;2014;08;02;Maanantai;0;0;0
93;04.08.2014;2014;08;03;Maanantai;0;0;0
93;04.08.2014;2014;08;04;Maanantai;0;3;3
93;04.08.2014;2014;08;05;Maanantai;2;6;8
93;04.08.2014;2014;08;06;Maanantai;29;6;35
93;04.08.2014;2014;08;07;Maanantai;45;27;72
93;04.08.2014;2014;08;08;Maanantai;28;26;54
93;04.08.2014;2014;08;09;Maanantai;25;18;43
93;04.08.2014;2014;08;10;Maanantai;15;14;29
93;04.08.2014;2014;08;11;Maanantai;24;22;46
93;04.08.2014;2014;08;12;Maanantai;12;13;25
93;04.08.2014;2014;08;13;Maanantai;22;24;46
93;04.08.2014;2014;08;14;Maanantai;35;18;53
93;04.08.2014;2014;08;15;Maanantai;31;52;83
93;04.08.2014;2014;08;16;Maanantai;36;63;99
93;04.08.2014;2014;08;17;Maanantai;36;43;79
93;04.08.2014;2014;08;18;Maanantai;31;39;70
93;04.08.2014;2014;08;19;Maanantai;28;48;76
93;04.08.2014;2014;08;20;Maanantai;35;42;77
93;04.08.2014;2014;08;21;Maanantai;19;19;38
93;04.08.2014;2014;08;22;Maanantai;8;23;31
93;04.08.2014;2014;08;23;Maanantai;4;15;19
93;05.08.2014;2014;08;00;Tiistai;0;7;7
93;05.08.2014;2014;08;01;Tiistai;2;0;2
93;05.08.2014;2014;08;02;Tiistai;0;4;4
93;05.08.2014;2014;08;03;Tiistai;1;0;1
93;05.08.2014;2014;08;04;Tiistai;0;2;2
93;05.08.2014;2014;08;05;Tiistai;3;5;8
93;05.08.2014;2014;08;06;Tiistai;30;12;42
93;05.08.2014;2014;08;07;Tiistai;55;30;85
93;05.08.2014;2014;08;08;Tiistai;35;27;62
93;05.08.2014;2014;08;09;Tiistai;24;21;45
93;05.08.2014;2014;08;10;Tiistai;26;21;47
93;05.08.2014;2014;08;11;Tiistai;27;22;49
93;05.08.2014;2014;08;12;Tiistai;28;19;47
93;05.08.2014;2014;08;13;Tiistai;22;21;43
93;05.08.2014;2014;08;14;Tiistai;38;32;70
93;05.08.2014;2014;08;15;Tiistai;36;41;77
93;05.08.2014;2014;08;16;Tiistai;60;75;135
93;05.08.2014;2014;08;17;Tiistai;26;58;84
93;05.08.2014;2014;08;18;Tiistai;28;56;84
93;05.08.2014;2014;08;19;Tiistai;39;40;79
93;05.08.2014;2014;08;20;Tiistai;34;41;75
93;05.08.2014;2014;08;21;Tiistai;11;22;33
93;05.08.2014;2014;08;22;Tiistai;5;10;15
93;05.08.2014;2014;08;23;Tiistai;3;5;8
93;06.08.2014;2014;08;00;Keskiviikko;1;0;1
93;06.08.2014;2014;08;01;Keskiviikko;0;2;2
93;06.08.2014;2014;08;02;Keskiviikko;1;1;2
93;06.08.2014;2014;08;03;Keskiviikko;0;0;0
93;06.08.2014;2014;08;04;Keskiviikko;0;2;2
93;06.08.2014;2014;08;05;Keskiviikko;1;3;4
93;06.08.2014;2014;08;06;Keskiviikko;33;15;48
93;06.08.2014;2014;08;07;Keskiviikko;56;34;90
93;06.08.2014;2014;08;08;Keskiviikko;38;42;80
93;06.08.2014;2014;08;09;Keskiviikko;21;22;43
93;06.08.2014;2014;08;10;Keskiviikko;19;17;36
93;06.08.2014;2014;08;11;Keskiviikko;30;25;55
93;06.08.2014;2014;08;12;Keskiviikko;23;18;41
93;06.08.2014;2014;08;13;Keskiviikko;15;28;43
93;06.08.2014;2014;08;14;Keskiviikko;30;24;54
93;06.08.2014;2014;08;15;Keskiviikko;38;51;89
93;06.08.2014;2014;08;16;Keskiviikko;55;80;135
93;06.08.2014;2014;08;17;Keskiviikko;35;48;83
93;06.08.2014;2014;08;18;Keskiviikko;30;37;67
93;06.08.2014;2014;08;19;Keskiviikko;36;45;81
93;06.08.2014;2014;08;20;Keskiviikko;35;43;78
93;06.08.2014;2014;08;21;Keskiviikko;24;28;52
93;06.08.2014;2014;08;22;Keskiviikko;1;5;6
93;06.08.2014;2014;08;23;Keskiviikko;1;9;10
93;07.08.2014;2014;08;00;Torstai;0;0;0
93;07.08.2014;2014;08;01;Torstai;0;3;3
93;07.08.2014;2014;08;02;Torstai;0;1;1
93;07.08.2014;2014;08;03;Torstai;1;0;1
93;07.08.2014;2014;08;04;Torstai;1;3;4
93;07.08.2014;2014;08;05;Torstai;1;5;6
93;07.08.2014;2014;08;06;Torstai;27;17;44
93;07.08.2014;2014;08;07;Torstai;58;37;95
93;07.08.2014;2014;08;08;Torstai;26;35;61
93;07.08.2014;2014;08;09;Torstai;18;16;34
93;07.08.2014;2014;08;10;Torstai;19;10;29
93;07.08.2014;2014;08;11;Torstai;22;15;37
93;07.08.2014;2014;08;12;Torstai;24;20;44
93;07.08.2014;2014;08;13;Torstai;29;20;49
93;07.08.2014;2014;08;14;Torstai;44;27;71
93;07.08.2014;2014;08;15;Torstai;46;54;100
93;07.08.2014;2014;08;16;Torstai;48;63;111
93;07.08.2014;2014;08;17;Torstai;25;50;75
93;07.08.2014;2014;08;18;Torstai;29;37;66
93;07.08.2014;2014;08;19;Torstai;29;39;68
93;07.08.2014;2014;08;20;Torstai;23;34;57
93;07.08.2014;2014;08;21;Torstai;15;19;34
93;07.08.2014;2014;08;22;Torstai;6;4;10
93;07.08.2014;2014;08;23;Torstai;3;1;4
93;08.08.2014;2014;08;00;Perjantai;0;2;2
93;08.08.2014;2014;08;01;Perjantai;0;1;1
93;08.08.2014;2014;08;02;Perjantai;1;2;3
93;08.08.2014;2014;08;03;Perjantai;0;2;2
93;08.08.2014;2014;08;04;Perjantai;0;1;1
93;08.08.2014;2014;08;05;Perjantai;0;3;3
93;08.08.2014;2014;08;06;Perjantai;22;8;30
93;08.08.2014;2014;08;07;Perjantai;40;36;76
93;08.08.2014;2014;08;08;Perjantai;14;25;39
93;08.08.2014;2014;08;09;Perjantai;13;15;28
93;08.08.2014;2014;08;10;Perjantai;10;17;27
93;08.08.2014;2014;08;11;Perjantai;13;24;37
93;08.08.2014;2014;08;12;Perjantai;19;9;28
93;08.08.2014;2014;08;13;Perjantai;14;23;37
93;08.08.2014;2014;08;14;Perjantai;32;27;59
93;08.08.2014;2014;08;15;Perjantai;29;39;68
93;08.08.2014;2014;08;16;Perjantai;34;35;69
93;08.08.2014;2014;08;17;Perjantai;34;32;66
93;08.08.2014;2014;08;18;Perjantai;31;30;61
93;08.08.2014;2014;08;19;Perjantai;34;37;71
93;08.08.2014;2014;08;20;Perjantai;25;20;45
93;08.08.2014;2014;08;21;Perjantai;11;17;28
93;08.08.2014;2014;08;22;Perjantai;8;11;19
93;08.08.2014;2014;08;23;Perjantai;9;10;19
93;09.08.2014;2014;08;00;Lauantai;4;8;12
93;09.08.2014;2014;08;01;Lauantai;1;5;6
93;09.08.2014;2014;08;02;Lauantai;0;0;0
93;09.08.2014;2014;08;03;Lauantai;1;4;5
93;09.08.2014;2014;08;04;Lauantai;0;5;5
93;09.08.2014;2014;08;05;Lauantai;1;3;4
93;09.08.2014;2014;08;06;Lauantai;3;3;6
93;09.08.2014;2014;08;07;Lauantai;5;10;15
93;09.08.2014;2014;08;08;Lauantai;7;12;19
93;09.08.2014;2014;08;09;Lauantai;11;91;102
93;09.08.2014;2014;08;10;Lauantai;12;109;121
93;09.08.2014;2014;08;11;Lauantai;21;92;113
93;09.08.2014;2014;08;12;Lauantai;34;84;118
93;09.08.2014;2014;08;13;Lauantai;43;67;110
93;09.08.2014;2014;08;14;Lauantai;53;39;92
93;09.08.2014;2014;08;15;Lauantai;55;27;82
93;09.08.2014;2014;08;16;Lauantai;41;14;55
93;09.08.2014;2014;08;17;Lauantai;229;11;240
93;09.08.2014;2014;08;18;Lauantai;30;1;31
93;09.08.2014;2014;08;19;Lauantai;23;7;30
93;09.08.2014;2014;08;20;Lauantai;5;2;7
93;09.08.2014;2014;08;21;Lauantai;6;0;6
93;09.08.2014;2014;08;22;Lauantai;1;0;1
93;09.08.2014;2014;08;23;Lauantai;0;1;1
93;10.08.2014;2014;08;00;Sunnuntai;1;0;1
93;10.08.2014;2014;08;01;Sunnuntai;0;1;1
93;10.08.2014;2014;08;02;Sunnuntai;1;0;1
93;10.08.2014;2014;08;03;Sunnuntai;0;0;0
93;10.08.2014;2014;08;04;Sunnuntai;0;0;0
93;10.08.2014;2014;08;05;Sunnuntai;0;0;0
93;10.08.2014;2014;08;06;Sunnuntai;1;1;2
93;10.08.2014;2014;08;07;Sunnuntai;1;2;3
93;10.08.2014;2014;08;08;Sunnuntai;3;8;11
93;10.08.2014;2014;08;09;Sunnuntai;8;25;33
93;10.08.2014;2014;08;10;Sunnuntai;9;63;72
93;10.08.2014;2014;08;11;Sunnuntai;17;79;96
93;10.08.2014;2014;08;12;Sunnuntai;21;111;132
93;10.08.2014;2014;08;13;Sunnuntai;16;113;129
93;10.08.2014;2014;08;14;Sunnuntai;16;45;61
93;10.08.2014;2014;08;15;Sunnuntai;91;50;141
93;10.08.2014;2014;08;16;Sunnuntai;75;43;118
93;10.08.2014;2014;08;17;Sunnuntai;133;20;153
93;10.08.2014;2014;08;18;Sunnuntai;199;48;247
93;10.08.2014;2014;08;19;Sunnuntai;34;22;56
93;10.08.2014;2014;08;20;Sunnuntai;22;17;39
93;10.08.2014;2014;08;21;Sunnuntai;14;10;24
93;10.08.2014;2014;08;22;Sunnuntai;5;6;11
93;10.08.2014;2014;08;23;Sunnuntai;5;1;6
93;11.08.2014;2014;08;00;Maanantai;0;1;1
93;11.08.2014;2014;08;01;Maanantai;0;0;0
93;11.08.2014;2014;08;02;Maanantai;0;1;1
93;11.08.2014;2014;08;03;Maanantai;0;0;0
93;11.08.2014;2014;08;04;Maanantai;2;1;3
93;11.08.2014;2014;08;05;Maanantai;4;4;8
93;11.08.2014;2014;08;06;Maanantai;29;11;40
93;11.08.2014;2014;08;07;Maanantai;47;43;90
93;11.08.2014;2014;08;08;Maanantai;29;41;70
93;11.08.2014;2014;08;09;Maanantai;24;23;47
93;11.08.2014;2014;08;10;Maanantai;21;14;35
93;11.08.2014;2014;08;11;Maanantai;14;19;33
93;11.08.2014;2014;08;12;Maanantai;17;12;29
93;11.08.2014;2014;08;13;Maanantai;17;23;40
93;11.08.2014;2014;08;14;Maanantai;22;26;48
93;11.08.2014;2014;08;15;Maanantai;44;50;94
93;11.08.2014;2014;08;16;Maanantai;53;71;124
93;11.08.2014;2014;08;17;Maanantai;39;56;95
93;11.08.2014;2014;08;18;Maanantai;34;49;83
93;11.08.2014;2014;08;19;Maanantai;40;39;79
93;11.08.2014;2014;08;20;Maanantai;26;24;50
93;11.08.2014;2014;08;21;Maanantai;20;19;39
93;11.08.2014;2014;08;22;Maanantai;3;2;5
93;11.08.2014;2014;08;23;Maanantai;1;2;3
93;12.08.2014;2014;08;00;Tiistai;2;2;4
93;12.08.2014;2014;08;01;Tiistai;1;0;1
93;12.08.2014;2014;08;02;Tiistai;0;1;1
93;12.08.2014;2014;08;03;Tiistai;0;1;1
93;12.08.2014;2014;08;04;Tiistai;0;0;0
93;12.08.2014;2014;08;05;Tiistai;3;4;7
93;12.08.2014;2014;08;06;Tiistai;20;10;30
93;12.08.2014;2014;08;07;Tiistai;45;46;91
93;12.08.2014;2014;08;08;Tiistai;16;21;37
93;12.08.2014;2014;08;09;Tiistai;11;11;22
93;12.08.2014;2014;08;10;Tiistai;2;1;3
93;12.08.2014;2014;08;11;Tiistai;1;0;1
93;12.08.2014;2014;08;12;Tiistai;7;1;8
93;12.08.2014;2014;08;13;Tiistai;6;8;14
93;12.08.2014;2014;08;14;Tiistai;12;11;23
93;12.08.2014;2014;08;15;Tiistai;21;27;48
93;12.08.2014;2014;08;16;Tiistai;39;42;81
93;12.08.2014;2014;08;17;Tiistai;24;23;47
93;12.08.2014;2014;08;18;Tiistai;15;26;41
93;12.08.2014;2014;08;19;Tiistai;24;27;51
93;12.08.2014;2014;08;20;Tiistai;13;11;24
93;12.08.2014;2014;08;21;Tiistai;5;3;8
93;12.08.2014;2014;08;22;Tiistai;2;5;7
93;12.08.2014;2014;08;23;Tiistai;0;1;1
93;13.08.2014;2014;08;00;Keskiviikko;0;1;1
93;13.08.2014;2014;08;01;Keskiviikko;1;0;1
93;13.08.2014;2014;08;02;Keskiviikko;0;0;0
93;13.08.2014;2014;08;03;Keskiviikko;0;0;0
93;13.08.2014;2014;08;04;Keskiviikko;0;0;0
93;13.08.2014;2014;08;05;Keskiviikko;3;3;6
93;13.08.2014;2014;08;06;Keskiviikko;33;12;45
93;13.08.2014;2014;08;07;Keskiviikko;51;46;97
93;13.08.2014;2014;08;08;Keskiviikko;31;33;64
93;13.08.2014;2014;08;09;Keskiviikko;14;18;32
93;13.08.2014;2014;08;10;Keskiviikko;27;18;45
93;13.08.2014;2014;08;11;Keskiviikko;17;19;36
93;13.08.2014;2014;08;12;Keskiviikko;17;9;26
93;13.08.2014;2014;08;13;Keskiviikko;14;17;31
93;13.08.2014;2014;08;14;Keskiviikko;20;26;46
93;13.08.2014;2014;08;15;Keskiviikko;32;38;70
93;13.08.2014;2014;08;16;Keskiviikko;39;43;82
93;13.08.2014;2014;08;17;Keskiviikko;21;33;54
93;13.08.2014;2014;08;18;Keskiviikko;28;48;76
93;13.08.2014;2014;08;19;Keskiviikko;23;28;51
93;13.08.2014;2014;08;20;Keskiviikko;9;18;27
93;13.08.2014;2014;08;21;Keskiviikko;12;10;22
93;13.08.2014;2014;08;22;Keskiviikko;5;3;8
93;13.08.2014;2014;08;23;Keskiviikko;0;4;4
93;14.08.2014;2014;08;00;Torstai;2;1;3
93;14.08.2014;2014;08;01;Torstai;0;0;0
93;14.08.2014;2014;08;02;Torstai;0;0;0
93;14.08.2014;2014;08;03;Torstai;0;0;0
93;14.08.2014;2014;08;04;Torstai;1;2;3
93;14.08.2014;2014;08;05;Torstai;3;5;8
93;14.08.2014;2014;08;06;Torstai;25;8;33
93;14.08.2014;2014;08;07;Torstai;52;38;90
93;14.08.2014;2014;08;08;Torstai;18;30;48
93;14.08.2014;2014;08;09;Torstai;20;20;40
93;14.08.2014;2014;08;10;Torstai;17;10;27
93;14.08.2014;2014;08;11;Torstai;10;10;20
93;14.08.2014;2014;08;12;Torstai;12;9;21
93;14.08.2014;2014;08;13;Torstai;11;17;28
93;14.08.2014;2014;08;14;Torstai;20;13;33
93;14.08.2014;2014;08;15;Torstai;36;50;86
93;14.08.2014;2014;08;16;Torstai;34;34;68
93;14.08.2014;2014;08;17;Torstai;19;20;39
93;14.08.2014;2014;08;18;Torstai;20;15;35
93;14.08.2014;2014;08;19;Torstai;19;23;42
93;14.08.2014;2014;08;20;Torstai;7;17;24
93;14.08.2014;2014;08;21;Torstai;10;17;27
93;14.08.2014;2014;08;22;Torstai;5;5;10
93;14.08.2014;2014;08;23;Torstai;3;0;3
93;15.08.2014;2014;08;00;Perjantai;0;4;4
93;15.08.2014;2014;08;01;Perjantai;0;2;2
93;15.08.2014;2014;08;02;Perjantai;0;0;0
93;15.08.2014;2014;08;03;Perjantai;0;0;0
93;15.08.2014;2014;08;04;Perjantai;2;0;2
93;15.08.2014;2014;08;05;Perjantai;6;8;14
93;15.08.2014;2014;08;06;Perjantai;34;16;50
93;15.08.2014;2014;08;07;Perjantai;60;66;126
93;15.08.2014;2014;08;08;Perjantai;24;64;88
93;15.08.2014;2014;08;09;Perjantai;18;12;30
93;15.08.2014;2014;08;10;Perjantai;18;22;40
93;15.08.2014;2014;08;11;Perjantai;8;12;20
93;15.08.2014;2014;08;12;Perjantai;8;14;22
93;15.08.2014;2014;08;13;Perjantai;44;14;58
93;15.08.2014;2014;08;14;Perjantai;26;54;80
93;15.08.2014;2014;08;15;Perjantai;70;64;134
93;15.08.2014;2014;08;16;Perjantai;52;50;102
93;15.08.2014;2014;08;17;Perjantai;42;64;106
93;15.08.2014;2014;08;18;Perjantai;32;42;74
93;15.08.2014;2014;08;19;Perjantai;24;28;52
93;15.08.2014;2014;08;20;Perjantai;20;34;54
93;15.08.2014;2014;08;21;Perjantai;6;30;36
93;15.08.2014;2014;08;22;Perjantai;8;14;22
93;15.08.2014;2014;08;23;Perjantai;12;6;18
93;16.08.2014;2014;08;00;Lauantai;4;4;8
93;16.08.2014;2014;08;01;Lauantai;0;2;2
93;16.08.2014;2014;08;02;Lauantai;0;4;4
93;16.08.2014;2014;08;03;Lauantai;0;0;0
93;16.08.2014;2014;08;04;Lauantai;0;4;4
93;16.08.2014;2014;08;05;Lauantai;0;4;4
93;16.08.2014;2014;08;06;Lauantai;4;6;10
93;16.08.2014;2014;08;07;Lauantai;6;2;8
93;16.08.2014;2014;08;08;Lauantai;10;14;24
93;16.08.2014;2014;08;09;Lauantai;26;16;42
93;16.08.2014;2014;08;10;Lauantai;40;36;76
93;16.08.2014;2014;08;11;Lauantai;48;50;98
93;16.08.2014;2014;08;12;Lauantai;42;48;90
93;16.08.2014;2014;08;13;Lauantai;32;32;64
93;16.08.2014;2014;08;14;Lauantai;72;50;122
93;16.08.2014;2014;08;15;Lauantai;32;42;74
93;16.08.2014;2014;08;16;Lauantai;64;60;124
93;16.08.2014;2014;08;17;Lauantai;34;46;80
93;16.08.2014;2014;08;18;Lauantai;40;42;82
93;16.08.2014;2014;08;19;Lauantai;36;26;62
93;16.08.2014;2014;08;20;Lauantai;36;18;54
93;16.08.2014;2014;08;21;Lauantai;12;20;32
93;16.08.2014;2014;08;22;Lauantai;12;16;28
93;16.08.2014;2014;08;23;Lauantai;6;8;14
93;17.08.2014;2014;08;00;Sunnuntai;2;4;6
93;17.08.2014;2014;08;01;Sunnuntai;6;0;6
93;17.08.2014;2014;08;02;Sunnuntai;0;6;6
93;17.08.2014;2014;08;03;Sunnuntai;0;2;2
93;17.08.2014;2014;08;04;Sunnuntai;0;2;2
93;17.08.2014;2014;08;05;Sunnuntai;0;0;0
93;17.08.2014;2014;08;06;Sunnuntai;2;2;4
93;17.08.2014;2014;08;07;Sunnuntai;0;0;0
93;17.08.2014;2014;08;08;Sunnuntai;2;10;12
93;17.08.2014;2014;08;09;Sunnuntai;18;10;28
93;17.08.2014;2014;08;10;Sunnuntai;28;28;56
93;17.08.2014;2014;08;11;Sunnuntai;36;58;94
93;17.08.2014;2014;08;12;Sunnuntai;68;38;106
93;17.08.2014;2014;08;13;Sunnuntai;28;72;100
93;17.08.2014;2014;08;14;Sunnuntai;56;50;106
93;17.08.2014;2014;08;15;Sunnuntai;44;40;84
93;17.08.2014;2014;08;16;Sunnuntai;36;36;72
93;17.08.2014;2014;08;17;Sunnuntai;26;12;38
93;17.08.2014;2014;08;18;Sunnuntai;22;24;46
93;17.08.2014;2014;08;19;Sunnuntai;30;62;92
93;17.08.2014;2014;08;20;Sunnuntai;30;44;74
93;17.08.2014;2014;08;21;Sunnuntai;8;20;28
93;17.08.2014;2014;08;22;Sunnuntai;0;4;4
93;17.08.2014;2014;08;23;Sunnuntai;2;2;4
93;18.08.2014;2014;08;00;Maanantai;0;0;0
93;18.08.2014;2014;08;01;Maanantai;0;2;2
93;18.08.2014;2014;08;02;Maanantai;0;0;0
93;18.08.2014;2014;08;03;Maanantai;0;2;2
93;18.08.2014;2014;08;04;Maanantai;2;2;4
93;18.08.2014;2014;08;05;Maanantai;12;6;18
93;18.08.2014;2014;08;06;Maanantai;64;20;84
93;18.08.2014;2014;08;07;Maanantai;112;94;206
93;18.08.2014;2014;08;08;Maanantai;18;80;98
93;18.08.2014;2014;08;09;Maanantai;16;22;38
93;18.08.2014;2014;08;10;Maanantai;24;28;52
93;18.08.2014;2014;08;11;Maanantai;22;30;52
93;18.08.2014;2014;08;12;Maanantai;24;22;46
93;18.08.2014;2014;08;13;Maanantai;38;18;56
93;18.08.2014;2014;08;14;Maanantai;44;56;100
93;18.08.2014;2014;08;15;Maanantai;66;58;124
93;18.08.2014;2014;08;16;Maanantai;74;92;166
93;18.08.2014;2014;08;17;Maanantai;22;22;44
93;18.08.2014;2014;08;18;Maanantai;6;34;40
93;18.08.2014;2014;08;19;Maanantai;20;4;24
93;18.08.2014;2014;08;20;Maanantai;10;6;16
93;18.08.2014;2014;08;21;Maanantai;2;6;8
93;18.08.2014;2014;08;22;Maanantai;0;4;4
93;18.08.2014;2014;08;23;Maanantai;4;2;6
93;19.08.2014;2014;08;00;Tiistai;0;0;0
93;19.08.2014;2014;08;01;Tiistai;0;0;0
93;19.08.2014;2014;08;02;Tiistai;0;0;0
93;19.08.2014;2014;08;03;Tiistai;0;0;0
93;19.08.2014;2014;08;04;Tiistai;2;0;2
93;19.08.2014;2014;08;05;Tiistai;8;2;10
93;19.08.2014;2014;08;06;Tiistai;40;10;50
93;19.08.2014;2014;08;07;Tiistai;68;72;140
93;19.08.2014;2014;08;08;Tiistai;34;50;84
93;19.08.2014;2014;08;09;Tiistai;22;12;34
93;19.08.2014;2014;08;10;Tiistai;2;24;26
93;19.08.2014;2014;08;11;Tiistai;4;8;12
93;19.08.2014;2014;08;12;Tiistai;18;16;34
93;19.08.2014;2014;08;13;Tiistai;10;2;12
93;19.08.2014;2014;08;14;Tiistai;24;24;48
93;19.08.2014;2014;08;15;Tiistai;42;60;102
93;19.08.2014;2014;08;16;Tiistai;74;80;154
93;19.08.2014;2014;08;17;Tiistai;30;50;80
93;19.08.2014;2014;08;18;Tiistai;24;44;68
93;19.08.2014;2014;08;19;Tiistai;40;32;72
93;19.08.2014;2014;08;20;Tiistai;36;38;74
93;19.08.2014;2014;08;21;Tiistai;10;14;24
93;19.08.2014;2014;08;22;Tiistai;4;0;4
93;19.08.2014;2014;08;23;Tiistai;0;2;2
93;20.08.2014;2014;08;00;Keskiviikko;0;2;2
93;20.08.2014;2014;08;01;Keskiviikko;2;2;4
93;20.08.2014;2014;08;02;Keskiviikko;0;2;2
93;20.08.2014;2014;08;03;Keskiviikko;0;4;4
93;20.08.2014;2014;08;04;Keskiviikko;4;2;6
93;20.08.2014;2014;08;05;Keskiviikko;4;16;20
93;20.08.2014;2014;08;06;Keskiviikko;52;20;72
93;20.08.2014;2014;08;07;Keskiviikko;88;80;168
93;20.08.2014;2014;08;08;Keskiviikko;22;82;104
93;20.08.2014;2014;08;09;Keskiviikko;30;12;42
93;20.08.2014;2014;08;10;Keskiviikko;28;16;44
93;20.08.2014;2014;08;11;Keskiviikko;24;16;40
93;20.08.2014;2014;08;12;Keskiviikko;26;10;36
93;20.08.2014;2014;08;13;Keskiviikko;14;46;60
93;20.08.2014;2014;08;14;Keskiviikko;44;28;72
93;20.08.2014;2014;08;15;Keskiviikko;94;74;168
93;20.08.2014;2014;08;16;Keskiviikko;68;96;164
93;20.08.2014;2014;08;17;Keskiviikko;46;54;100
93;20.08.2014;2014;08;18;Keskiviikko;28;36;64
93;20.08.2014;2014;08;19;Keskiviikko;16;24;40
93;20.08.2014;2014;08;20;Keskiviikko;18;24;42
93;20.08.2014;2014;08;21;Keskiviikko;6;10;16
93;20.08.2014;2014;08;22;Keskiviikko;4;2;6
93;20.08.2014;2014;08;23;Keskiviikko;0;6;6
93;21.08.2014;2014;08;00;Torstai;0;0;0
93;21.08.2014;2014;08;01;Torstai;0;2;2
93;21.08.2014;2014;08;02;Torstai;0;2;2
93;21.08.2014;2014;08;03;Torstai;0;0;0
93;21.08.2014;2014;08;04;Torstai;4;2;6
93;21.08.2014;2014;08;05;Torstai;4;2;6
93;21.08.2014;2014;08;06;Torstai;26;22;48
93;21.08.2014;2014;08;07;Torstai;92;60;152
93;21.08.2014;2014;08;08;Torstai;28;60;88
93;21.08.2014;2014;08;09;Torstai;22;24;46
93;21.08.2014;2014;08;10;Torstai;16;10;26
93;21.08.2014;2014;08;11;Torstai;10;14;24
93;21.08.2014;2014;08;12;Torstai;14;14;28
93;21.08.2014;2014;08;13;Torstai;26;28;54
93;21.08.2014;2014;08;14;Torstai;32;30;62
93;21.08.2014;2014;08;15;Torstai;48;58;106
93;21.08.2014;2014;08;16;Torstai;62;72;134
93;21.08.2014;2014;08;17;Torstai;22;24;46
93;21.08.2014;2014;08;18;Torstai;26;30;56
93;21.08.2014;2014;08;19;Torstai;24;26;50
93;21.08.2014;2014;08;20;Torstai;26;34;60
93;21.08.2014;2014;08;21;Torstai;8;26;34
93;21.08.2014;2014;08;22;Torstai;10;0;10
93;21.08.2014;2014;08;23;Torstai;2;4;6
93;22.08.2014;2014;08;00;Perjantai;0;2;2
93;22.08.2014;2014;08;01;Perjantai;0;0;0
93;22.08.2014;2014;08;02;Perjantai;0;0;0
93;22.08.2014;2014;08;03;Perjantai;0;0;0
93;22.08.2014;2014;08;04;Perjantai;0;2;2
93;22.08.2014;2014;08;05;Perjantai;6;8;14
93;22.08.2014;2014;08;06;Perjantai;40;10;50
93;22.08.2014;2014;08;07;Perjantai;50;72;122
93;22.08.2014;2014;08;08;Perjantai;18;46;64
93;22.08.2014;2014;08;09;Perjantai;18;16;34
93;22.08.2014;2014;08;10;Perjantai;22;38;60
93;22.08.2014;2014;08;11;Perjantai;10;16;26
93;22.08.2014;2014;08;12;Perjantai;18;58;76
93;22.08.2014;2014;08;13;Perjantai;60;24;84
93;22.08.2014;2014;08;14;Perjantai;50;52;102
93;22.08.2014;2014;08;15;Perjantai;44;58;102
93;22.08.2014;2014;08;16;Perjantai;52;62;114
93;22.08.2014;2014;08;17;Perjantai;34;44;78
93;22.08.2014;2014;08;18;Perjantai;38;42;80
93;22.08.2014;2014;08;19;Perjantai;42;28;70
93;22.08.2014;2014;08;20;Perjantai;26;16;42
93;22.08.2014;2014;08;21;Perjantai;26;18;44
93;22.08.2014;2014;08;22;Perjantai;10;6;16
93;22.08.2014;2014;08;23;Perjantai;0;8;8
93;23.08.2014;2014;08;00;Lauantai;4;2;6
93;23.08.2014;2014;08;01;Lauantai;0;18;18
93;23.08.2014;2014;08;02;Lauantai;0;6;6
93;23.08.2014;2014;08;03;Lauantai;2;2;4
93;23.08.2014;2014;08;04;Lauantai;0;2;2
93;23.08.2014;2014;08;05;Lauantai;2;0;2
93;23.08.2014;2014;08;06;Lauantai;6;2;8
93;23.08.2014;2014;08;07;Lauantai;8;6;14
93;23.08.2014;2014;08;08;Lauantai;12;6;18
93;23.08.2014;2014;08;09;Lauantai;26;18;44
93;23.08.2014;2014;08;10;Lauantai;18;22;40
93;23.08.2014;2014;08;11;Lauantai;72;44;116
93;23.08.2014;2014;08;12;Lauantai;34;18;52
93;23.08.2014;2014;08;13;Lauantai;34;54;88
93;23.08.2014;2014;08;14;Lauantai;20;46;66
93;23.08.2014;2014;08;15;Lauantai;40;36;76
93;23.08.2014;2014;08;16;Lauantai;18;26;44
93;23.08.2014;2014;08;17;Lauantai;18;4;22
93;23.08.2014;2014;08;18;Lauantai;26;8;34
93;23.08.2014;2014;08;19;Lauantai;16;10;26
93;23.08.2014;2014;08;20;Lauantai;18;32;50
93;23.08.2014;2014;08;21;Lauantai;18;22;40
93;23.08.2014;2014;08;22;Lauantai;10;8;18
93;23.08.2014;2014;08;23;Lauantai;4;4;8
93;24.08.2014;2014;08;00;Sunnuntai;0;0;0
93;24.08.2014;2014;08;01;Sunnuntai;2;2;4
93;24.08.2014;2014;08;02;Sunnuntai;0;0;0
93;24.08.2014;2014;08;03;Sunnuntai;0;2;2
93;24.08.2014;2014;08;04;Sunnuntai;0;0;0
93;24.08.2014;2014;08;05;Sunnuntai;2;4;6
93;24.08.2014;2014;08;06;Sunnuntai;4;6;10
93;24.08.2014;2014;08;07;Sunnuntai;6;8;14
93;24.08.2014;2014;08;08;Sunnuntai;8;4;12
93;24.08.2014;2014;08;09;Sunnuntai;12;12;24
93;24.08.2014;2014;08;10;Sunnuntai;32;44;76
93;24.08.2014;2014;08;11;Sunnuntai;42;60;102
93;24.08.2014;2014;08;12;Sunnuntai;48;34;82
93;24.08.2014;2014;08;13;Sunnuntai;36;40;76
93;24.08.2014;2014;08;14;Sunnuntai;26;48;74
93;24.08.2014;2014;08;15;Sunnuntai;20;14;34
93;24.08.2014;2014;08;16;Sunnuntai;20;20;40
93;24.08.2014;2014;08;17;Sunnuntai;10;26;36
93;24.08.2014;2014;08;18;Sunnuntai;32;36;68
93;24.08.2014;2014;08;19;Sunnuntai;22;20;42
93;24.08.2014;2014;08;20;Sunnuntai;14;12;26
93;24.08.2014;2014;08;21;Sunnuntai;8;8;16
93;24.08.2014;2014;08;22;Sunnuntai;6;10;16
93;24.08.2014;2014;08;23;Sunnuntai;0;6;6
93;25.08.2014;2014;08;00;Maanantai;0;1;1
93;25.08.2014;2014;08;01;Maanantai;0;0;0
93;25.08.2014;2014;08;02;Maanantai;0;0;0
93;25.08.2014;2014;08;03;Maanantai;0;0;0
93;25.08.2014;2014;08;04;Maanantai;0;0;0
93;25.08.2014;2014;08;05;Maanantai;2;4;6
93;25.08.2014;2014;08;06;Maanantai;26;10;36
93;25.08.2014;2014;08;07;Maanantai;46;37;83
93;25.08.2014;2014;08;08;Maanantai;17;41;58
93;25.08.2014;2014;08;09;Maanantai;6;11;17
93;25.08.2014;2014;08;10;Maanantai;14;11;25
93;25.08.2014;2014;08;11;Maanantai;7;14;21
93;25.08.2014;2014;08;12;Maanantai;12;10;22
93;25.08.2014;2014;08;13;Maanantai;11;13;24
93;25.08.2014;2014;08;14;Maanantai;25;24;49
93;25.08.2014;2014;08;15;Maanantai;30;28;58
93;25.08.2014;2014;08;16;Maanantai;43;48;91
93;25.08.2014;2014;08;17;Maanantai;15;29;44
93;25.08.2014;2014;08;18;Maanantai;18;26;44
93;25.08.2014;2014;08;19;Maanantai;13;21;34
93;25.08.2014;2014;08;20;Maanantai;13;7;20
93;25.08.2014;2014;08;21;Maanantai;6;6;12
93;25.08.2014;2014;08;22;Maanantai;3;4;7
93;25.08.2014;2014;08;23;Maanantai;0;0;0
93;26.08.2014;2014;08;00;Tiistai;0;1;1
93;26.08.2014;2014;08;01;Tiistai;0;1;1
93;26.08.2014;2014;08;02;Tiistai;0;1;1
93;26.08.2014;2014;08;03;Tiistai;0;0;0
93;26.08.2014;2014;08;04;Tiistai;2;0;2
93;26.08.2014;2014;08;05;Tiistai;3;3;6
93;26.08.2014;2014;08;06;Tiistai;16;11;27
93;26.08.2014;2014;08;07;Tiistai;31;37;68
93;26.08.2014;2014;08;08;Tiistai;11;20;31
93;26.08.2014;2014;08;09;Tiistai;7;17;24
93;26.08.2014;2014;08;10;Tiistai;4;7;11
93;26.08.2014;2014;08;11;Tiistai;7;8;15
93;26.08.2014;2014;08;12;Tiistai;15;3;18
93;26.08.2014;2014;08;13;Tiistai;7;13;20
93;26.08.2014;2014;08;14;Tiistai;12;21;33
93;26.08.2014;2014;08;15;Tiistai;29;22;51
93;26.08.2014;2014;08;16;Tiistai;37;27;64
93;26.08.2014;2014;08;17;Tiistai;22;16;38
93;26.08.2014;2014;08;18;Tiistai;5;21;26
93;26.08.2014;2014;08;19;Tiistai;7;7;14
93;26.08.2014;2014;08;20;Tiistai;5;9;14
93;26.08.2014;2014;08;21;Tiistai;6;1;7
93;26.08.2014;2014;08;22;Tiistai;0;2;2
93;26.08.2014;2014;08;23;Tiistai;1;0;1
93;27.08.2014;2014;08;00;Keskiviikko;0;1;1
93;27.08.2014;2014;08;01;Keskiviikko;0;0;0
93;27.08.2014;2014;08;02;Keskiviikko;0;1;1
93;27.08.2014;2014;08;03;Keskiviikko;0;0;0
93;27.08.2014;2014;08;04;Keskiviikko;1;1;2
93;27.08.2014;2014;08;05;Keskiviikko;2;1;3
93;27.08.2014;2014;08;06;Keskiviikko;14;9;23
93;27.08.2014;2014;08;07;Keskiviikko;23;20;43
93;27.08.2014;2014;08;08;Keskiviikko;9;21;30
93;27.08.2014;2014;08;09;Keskiviikko;4;4;8
93;27.08.2014;2014;08;10;Keskiviikko;1;4;5
93;27.08.2014;2014;08;11;Keskiviikko;2;5;7
93;27.08.2014;2014;08;12;Keskiviikko;3;6;9
93;27.08.2014;2014;08;13;Keskiviikko;12;11;23
93;27.08.2014;2014;08;14;Keskiviikko;12;18;30
93;27.08.2014;2014;08;15;Keskiviikko;22;23;45
93;27.08.2014;2014;08;16;Keskiviikko;24;20;44
93;27.08.2014;2014;08;17;Keskiviikko;14;9;23
93;27.08.2014;2014;08;18;Keskiviikko;4;8;12
93;27.08.2014;2014;08;19;Keskiviikko;11;12;23
93;27.08.2014;2014;08;20;Keskiviikko;2;9;11
93;27.08.2014;2014;08;21;Keskiviikko;3;3;6
93;27.08.2014;2014;08;22;Keskiviikko;0;2;2
93;27.08.2014;2014;08;23;Keskiviikko;0;0;0
93;28.08.2014;2014;08;00;Torstai;0;0;0
93;28.08.2014;2014;08;01;Torstai;0;0;0
93;28.08.2014;2014;08;02;Torstai;0;0;0
93;28.08.2014;2014;08;03;Torstai;0;1;1
93;28.08.2014;2014;08;04;Torstai;3;1;4
93;28.08.2014;2014;08;05;Torstai;4;3;7
93;28.08.2014;2014;08;06;Torstai;15;15;30
93;28.08.2014;2014;08;07;Torstai;39;32;71
93;28.08.2014;2014;08;08;Torstai;9;31;40
93;28.08.2014;2014;08;09;Torstai;10;13;23
93;28.08.2014;2014;08;10;Torstai;7;7;14
93;28.08.2014;2014;08;11;Torstai;5;12;17
93;28.08.2014;2014;08;12;Torstai;3;7;10
93;28.08.2014;2014;08;13;Torstai;14;10;24
93;28.08.2014;2014;08;14;Torstai;14;17;31
93;28.08.2014;2014;08;15;Torstai;24;26;50
93;28.08.2014;2014;08;16;Torstai;30;31;61
93;28.08.2014;2014;08;17;Torstai;17;16;33
93;28.08.2014;2014;08;18;Torstai;13;14;27
93;28.08.2014;2014;08;19;Torstai;15;13;28
93;28.08.2014;2014;08;20;Torstai;5;13;18
93;28.08.2014;2014;08;21;Torstai;5;6;11
93;28.08.2014;2014;08;22;Torstai;1;0;1
93;28.08.2014;2014;08;23;Torstai;0;1;1
93;29.08.2014;2014;08;00;Perjantai;0;0;0
93;29.08.2014;2014;08;01;Perjantai;0;0;0
93;29.08.2014;2014;08;02;Perjantai;0;0;0
93;29.08.2014;2014;08;03;Perjantai;0;0;0
93;29.08.2014;2014;08;04;Perjantai;0;0;0
93;29.08.2014;2014;08;05;Perjantai;6;4;10
93;29.08.2014;2014;08;06;Perjantai;21;14;35
93;29.08.2014;2014;08;07;Perjantai;27;41;68
93;29.08.2014;2014;08;08;Perjantai;9;27;36
93;29.08.2014;2014;08;09;Perjantai;12;11;23
93;29.08.2014;2014;08;10;Perjantai;9;5;14
93;29.08.2014;2014;08;11;Perjantai;7;7;14
93;29.08.2014;2014;08;12;Perjantai;10;14;24
93;29.08.2014;2014;08;13;Perjantai;17;13;30
93;29.08.2014;2014;08;14;Perjantai;22;24;46
93;29.08.2014;2014;08;15;Perjantai;32;31;63
93;29.08.2014;2014;08;16;Perjantai;33;32;65
93;29.08.2014;2014;08;17;Perjantai;18;17;35
93;29.08.2014;2014;08;18;Perjantai;12;21;33
93;29.08.2014;2014;08;19;Perjantai;17;11;28
93;29.08.2014;2014;08;20;Perjantai;8;16;24
93;29.08.2014;2014;08;21;Perjantai;28;7;35
93;29.08.2014;2014;08;22;Perjantai;6;5;11
93;29.08.2014;2014;08;23;Perjantai;1;1;2
93;30.08.2014;2014;08;00;Lauantai;1;4;5
93;30.08.2014;2014;08;01;Lauantai;0;0;0
93;30.08.2014;2014;08;02;Lauantai;1;1;2
93;30.08.2014;2014;08;03;Lauantai;0;1;1
93;30.08.2014;2014;08;04;Lauantai;0;0;0
93;30.08.2014;2014;08;05;Lauantai;0;2;2
93;30.08.2014;2014;08;06;Lauantai;2;4;6
93;30.08.2014;2014;08;07;Lauantai;3;2;5
93;30.08.2014;2014;08;08;Lauantai;2;13;15
93;30.08.2014;2014;08;09;Lauantai;5;12;17
93;30.08.2014;2014;08;10;Lauantai;8;4;12
93;30.08.2014;2014;08;11;Lauantai;6;12;18
93;30.08.2014;2014;08;12;Lauantai;14;26;40
93;30.08.2014;2014;08;13;Lauantai;5;14;19
93;30.08.2014;2014;08;14;Lauantai;14;11;25
93;30.08.2014;2014;08;15;Lauantai;18;17;35
93;30.08.2014;2014;08;16;Lauantai;20;13;33
93;30.08.2014;2014;08;17;Lauantai;24;18;42
93;30.08.2014;2014;08;18;Lauantai;16;11;27
93;30.08.2014;2014;08;19;Lauantai;13;22;35
93;30.08.2014;2014;08;20;Lauantai;5;14;19
93;30.08.2014;2014;08;21;Lauantai;7;8;15
93;30.08.2014;2014;08;22;Lauantai;2;2;4
93;30.08.2014;2014;08;23;Lauantai;1;0;1
93;31.08.2014;2014;08;00;Sunnuntai;0;3;3
93;31.08.2014;2014;08;01;Sunnuntai;0;1;1
93;31.08.2014;2014;08;02;Sunnuntai;0;0;0
93;31.08.2014;2014;08;03;Sunnuntai;0;0;0
93;31.08.2014;2014;08;04;Sunnuntai;0;0;0
93;31.08.2014;2014;08;05;Sunnuntai;0;0;0
93;31.08.2014;2014;08;06;Sunnuntai;1;1;2
93;31.08.2014;2014;08;07;Sunnuntai;3;4;7
93;31.08.2014;2014;08;08;Sunnuntai;5;4;9
93;31.08.2014;2014;08;09;Sunnuntai;9;4;13
93;31.08.2014;2014;08;10;Sunnuntai;6;12;18
93;31.08.2014;2014;08;11;Sunnuntai;24;21;45
93;31.08.2014;2014;08;12;Sunnuntai;42;26;68
93;31.08.2014;2014;08;13;Sunnuntai;23;17;40
93;31.08.2014;2014;08;14;Sunnuntai;19;28;47
93;31.08.2014;2014;08;15;Sunnuntai;18;21;39
93;31.08.2014;2014;08;16;Sunnuntai;16;17;33
93;31.08.2014;2014;08;17;Sunnuntai;21;16;37
93;31.08.2014;2014;08;18;Sunnuntai;25;20;45
93;31.08.2014;2014;08;19;Sunnuntai;18;20;38
93;31.08.2014;2014;08;20;Sunnuntai;13;18;31
93;31.08.2014;2014;08;21;Sunnuntai;5;7;12
93;31.08.2014;2014;08;22;Sunnuntai;1;1;2
93;31.08.2014;2014;08;23;Sunnuntai;0;0;0
93;01.09.2014;2014;09;00;Maanantai;0;0;0
93;01.09.2014;2014;09;01;Maanantai;0;0;0
93;01.09.2014;2014;09;02;Maanantai;0;0;0
93;01.09.2014;2014;09;03;Maanantai;0;2;2
93;01.09.2014;2014;09;04;Maanantai;0;0;0
93;01.09.2014;2014;09;05;Maanantai;2;4;6
93;01.09.2014;2014;09;06;Maanantai;25;10;35
93;01.09.2014;2014;09;07;Maanantai;40;35;75
93;01.09.2014;2014;09;08;Maanantai;21;34;55
93;01.09.2014;2014;09;09;Maanantai;16;34;50
93;01.09.2014;2014;09;10;Maanantai;13;11;24
93;01.09.2014;2014;09;11;Maanantai;9;5;14
93;01.09.2014;2014;09;12;Maanantai;9;14;23
93;01.09.2014;2014;09;13;Maanantai;16;18;34
93;01.09.2014;2014;09;14;Maanantai;21;16;37
93;01.09.2014;2014;09;15;Maanantai;37;32;69
93;01.09.2014;2014;09;16;Maanantai;40;38;78
93;01.09.2014;2014;09;17;Maanantai;32;31;63
93;01.09.2014;2014;09;18;Maanantai;16;28;44
93;01.09.2014;2014;09;19;Maanantai;18;17;35
93;01.09.2014;2014;09;20;Maanantai;7;19;26
93;01.09.2014;2014;09;21;Maanantai;6;9;15
93;01.09.2014;2014;09;22;Maanantai;3;3;6
93;01.09.2014;2014;09;23;Maanantai;0;1;1
93;02.09.2014;2014;09;00;Tiistai;1;0;1
93;02.09.2014;2014;09;01;Tiistai;0;0;0
93;02.09.2014;2014;09;02;Tiistai;0;0;0
93;02.09.2014;2014;09;03;Tiistai;0;0;0
93;02.09.2014;2014;09;04;Tiistai;2;0;2
93;02.09.2014;2014;09;05;Tiistai;3;1;4
93;02.09.2014;2014;09;06;Tiistai;19;12;31
93;02.09.2014;2014;09;07;Tiistai;41;38;79
93;02.09.2014;2014;09;08;Tiistai;12;25;37
93;02.09.2014;2014;09;09;Tiistai;12;14;26
93;02.09.2014;2014;09;10;Tiistai;11;8;19
93;02.09.2014;2014;09;11;Tiistai;10;8;18
93;02.09.2014;2014;09;12;Tiistai;11;7;18
93;02.09.2014;2014;09;13;Tiistai;65;16;81
93;02.09.2014;2014;09;14;Tiistai;14;18;32
93;02.09.2014;2014;09;15;Tiistai;34;35;69
93;02.09.2014;2014;09;16;Tiistai;49;56;105
93;02.09.2014;2014;09;17;Tiistai;26;21;47
93;02.09.2014;2014;09;18;Tiistai;24;27;51
93;02.09.2014;2014;09;19;Tiistai;12;20;32
93;02.09.2014;2014;09;20;Tiistai;14;5;19
93;02.09.2014;2014;09;21;Tiistai;3;10;13
93;02.09.2014;2014;09;22;Tiistai;2;0;2
93;02.09.2014;2014;09;23;Tiistai;1;1;2
93;03.09.2014;2014;09;00;Keskiviikko;1;1;2
93;03.09.2014;2014;09;01;Keskiviikko;0;0;0
93;03.09.2014;2014;09;02;Keskiviikko;0;2;2
93;03.09.2014;2014;09;03;Keskiviikko;0;0;0
93;03.09.2014;2014;09;04;Keskiviikko;0;0;0
93;03.09.2014;2014;09;05;Keskiviikko;4;5;9
93;03.09.2014;2014;09;06;Keskiviikko;28;9;37
93;03.09.2014;2014;09;07;Keskiviikko;35;36;71
93;03.09.2014;2014;09;08;Keskiviikko;17;51;68
93;03.09.2014;2014;09;09;Keskiviikko;14;14;28
93;03.09.2014;2014;09;10;Keskiviikko;29;8;37
93;03.09.2014;2014;09;11;Keskiviikko;7;11;18
93;03.09.2014;2014;09;12;Keskiviikko;9;19;28
93;03.09.2014;2014;09;13;Keskiviikko;10;12;22
93;03.09.2014;2014;09;14;Keskiviikko;16;19;35
93;03.09.2014;2014;09;15;Keskiviikko;27;26;53
93;03.09.2014;2014;09;16;Keskiviikko;52;44;96
93;03.09.2014;2014;09;17;Keskiviikko;19;28;47
93;03.09.2014;2014;09;18;Keskiviikko;11;19;30
93;03.09.2014;2014;09;19;Keskiviikko;17;13;30
93;03.09.2014;2014;09;20;Keskiviikko;8;14;22
93;03.09.2014;2014;09;21;Keskiviikko;6;5;11
93;03.09.2014;2014;09;22;Keskiviikko;0;3;3
93;03.09.2014;2014;09;23;Keskiviikko;1;1;2
93;04.09.2014;2014;09;00;Torstai;1;0;1
93;04.09.2014;2014;09;01;Torstai;0;0;0
93;04.09.2014;2014;09;02;Torstai;1;1;2
93;04.09.2014;2014;09;03;Torstai;0;0;0
93;04.09.2014;2014;09;04;Torstai;0;1;1
93;04.09.2014;2014;09;05;Torstai;3;3;6
93;04.09.2014;2014;09;06;Torstai;22;11;33
93;04.09.2014;2014;09;07;Torstai;37;37;74
93;04.09.2014;2014;09;08;Torstai;12;23;35
93;04.09.2014;2014;09;09;Torstai;10;11;21
93;04.09.2014;2014;09;10;Torstai;6;10;16
93;04.09.2014;2014;09;11;Torstai;5;12;17
93;04.09.2014;2014;09;12;Torstai;13;9;22
93;04.09.2014;2014;09;13;Torstai;6;16;22
93;04.09.2014;2014;09;14;Torstai;17;15;32
93;04.09.2014;2014;09;15;Torstai;29;29;58
93;04.09.2014;2014;09;16;Torstai;37;40;77
93;04.09.2014;2014;09;17;Torstai;19;25;44
93;04.09.2014;2014;09;18;Torstai;17;20;37
93;04.09.2014;2014;09;19;Torstai;14;10;24
93;04.09.2014;2014;09;20;Torstai;15;10;25
93;04.09.2014;2014;09;21;Torstai;5;7;12
93;04.09.2014;2014;09;22;Torstai;4;5;9
93;04.09.2014;2014;09;23;Torstai;1;2;3
93;05.09.2014;2014;09;00;Perjantai;0;2;2
93;05.09.2014;2014;09;01;Perjantai;1;0;1
93;05.09.2014;2014;09;02;Perjantai;0;0;0
93;05.09.2014;2014;09;03;Perjantai;0;0;0
93;05.09.2014;2014;09;04;Perjantai;2;0;2
93;05.09.2014;2014;09;05;Perjantai;2;2;4
93;05.09.2014;2014;09;06;Perjantai;18;12;30
93;05.09.2014;2014;09;07;Perjantai;21;31;52
93;05.09.2014;2014;09;08;Perjantai;12;18;30
93;05.09.2014;2014;09;09;Perjantai;8;8;16
93;05.09.2014;2014;09;10;Perjantai;6;5;11
93;05.09.2014;2014;09;11;Perjantai;37;14;51
93;05.09.2014;2014;09;12;Perjantai;14;12;26
93;05.09.2014;2014;09;13;Perjantai;13;15;28
93;05.09.2014;2014;09;14;Perjantai;22;30;52
93;05.09.2014;2014;09;15;Perjantai;25;25;50
93;05.09.2014;2014;09;16;Perjantai;29;26;55
93;05.09.2014;2014;09;17;Perjantai;28;24;52
93;05.09.2014;2014;09;18;Perjantai;19;18;37
93;05.09.2014;2014;09;19;Perjantai;13;18;31
93;05.09.2014;2014;09;20;Perjantai;14;18;32
93;05.09.2014;2014;09;21;Perjantai;5;10;15
93;05.09.2014;2014;09;22;Perjantai;0;3;3
93;05.09.2014;2014;09;23;Perjantai;4;4;8
93;06.09.2014;2014;09;00;Lauantai;0;3;3
93;06.09.2014;2014;09;01;Lauantai;0;0;0
93;06.09.2014;2014;09;02;Lauantai;0;1;1
93;06.09.2014;2014;09;03;Lauantai;2;0;2
93;06.09.2014;2014;09;04;Lauantai;1;1;2
93;06.09.2014;2014;09;05;Lauantai;0;1;1
93;06.09.2014;2014;09;06;Lauantai;4;0;4
93;06.09.2014;2014;09;07;Lauantai;2;1;3
93;06.09.2014;2014;09;08;Lauantai;2;4;6
93;06.09.2014;2014;09;09;Lauantai;12;8;20
93;06.09.2014;2014;09;10;Lauantai;6;10;16
93;06.09.2014;2014;09;11;Lauantai;14;13;27
93;06.09.2014;2014;09;12;Lauantai;21;8;29
93;06.09.2014;2014;09;13;Lauantai;11;14;25
93;06.09.2014;2014;09;14;Lauantai;19;16;35
93;06.09.2014;2014;09;15;Lauantai;21;21;42
93;06.09.2014;2014;09;16;Lauantai;15;13;28
93;06.09.2014;2014;09;17;Lauantai;21;14;35
93;06.09.2014;2014;09;18;Lauantai;11;27;38
93;06.09.2014;2014;09;19;Lauantai;13;15;28
93;06.09.2014;2014;09;20;Lauantai;8;7;15
93;06.09.2014;2014;09;21;Lauantai;6;16;22
93;06.09.2014;2014;09;22;Lauantai;2;4;6
93;06.09.2014;2014;09;23;Lauantai;3;2;5
93;07.09.2014;2014;09;00;Sunnuntai;2;2;4
93;07.09.2014;2014;09;01;Sunnuntai;1;0;1
93;07.09.2014;2014;09;02;Sunnuntai;0;1;1
93;07.09.2014;2014;09;03;Sunnuntai;0;4;4
93;07.09.2014;2014;09;04;Sunnuntai;0;0;0
93;07.09.2014;2014;09;05;Sunnuntai;3;0;3
93;07.09.2014;2014;09;06;Sunnuntai;3;0;3
93;07.09.2014;2014;09;07;Sunnuntai;4;6;10
93;07.09.2014;2014;09;08;Sunnuntai;4;4;8
93;07.09.2014;2014;09;09;Sunnuntai;7;8;15
93;07.09.2014;2014;09;10;Sunnuntai;19;24;43
93;07.09.2014;2014;09;11;Sunnuntai;21;17;38
93;07.09.2014;2014;09;12;Sunnuntai;26;14;40
93;07.09.2014;2014;09;13;Sunnuntai;24;29;53
93;07.09.2014;2014;09;14;Sunnuntai;18;18;36
93;07.09.2014;2014;09;15;Sunnuntai;10;19;29
93;07.09.2014;2014;09;16;Sunnuntai;32;26;58
93;07.09.2014;2014;09;17;Sunnuntai;17;15;32
93;07.09.2014;2014;09;18;Sunnuntai;26;25;51
93;07.09.2014;2014;09;19;Sunnuntai;14;18;32
93;07.09.2014;2014;09;20;Sunnuntai;9;14;23
93;07.09.2014;2014;09;21;Sunnuntai;3;2;5
93;07.09.2014;2014;09;22;Sunnuntai;1;1;2
93;07.09.2014;2014;09;23;Sunnuntai;1;0;1
93;08.09.2014;2014;09;00;Maanantai;0;0;0
93;08.09.2014;2014;09;01;Maanantai;0;0;0
93;08.09.2014;2014;09;02;Maanantai;0;0;0
93;08.09.2014;2014;09;03;Maanantai;0;0;0
93;08.09.2014;2014;09;04;Maanantai;0;1;1
93;08.09.2014;2014;09;05;Maanantai;3;4;7
93;08.09.2014;2014;09;06;Maanantai;25;10;35
93;08.09.2014;2014;09;07;Maanantai;36;38;74
93;08.09.2014;2014;09;08;Maanantai;15;20;35
93;08.09.2014;2014;09;09;Maanantai;12;14;26
93;08.09.2014;2014;09;10;Maanantai;11;6;17
93;08.09.2014;2014;09;11;Maanantai;10;6;16
93;08.09.2014;2014;09;12;Maanantai;12;8;20
93;08.09.2014;2014;09;13;Maanantai;7;18;25
93;08.09.2014;2014;09;14;Maanantai;16;20;36
93;08.09.2014;2014;09;15;Maanantai;34;20;54
93;08.09.2014;2014;09;16;Maanantai;43;51;94
93;08.09.2014;2014;09;17;Maanantai;15;31;46
93;08.09.2014;2014;09;18;Maanantai;14;22;36
93;08.09.2014;2014;09;19;Maanantai;16;14;30
93;08.09.2014;2014;09;20;Maanantai;7;11;18
93;08.09.2014;2014;09;21;Maanantai;4;4;8
93;08.09.2014;2014;09;22;Maanantai;3;3;6
93;08.09.2014;2014;09;23;Maanantai;0;0;0
93;09.09.2014;2014;09;00;Tiistai;0;0;0
93;09.09.2014;2014;09;01;Tiistai;0;0;0
93;09.09.2014;2014;09;02;Tiistai;0;1;1
93;09.09.2014;2014;09;03;Tiistai;0;0;0
93;09.09.2014;2014;09;04;Tiistai;1;1;2
93;09.09.2014;2014;09;05;Tiistai;5;2;7
93;09.09.2014;2014;09;06;Tiistai;22;14;36
93;09.09.2014;2014;09;07;Tiistai;35;38;73
93;09.09.2014;2014;09;08;Tiistai;21;30;51
93;09.09.2014;2014;09;09;Tiistai;11;9;20
93;09.09.2014;2014;09;10;Tiistai;11;9;20
93;09.09.2014;2014;09;11;Tiistai;8;10;18
93;09.09.2014;2014;09;12;Tiistai;13;9;22
93;09.09.2014;2014;09;13;Tiistai;10;5;15
93;09.09.2014;2014;09;14;Tiistai;15;10;25
93;09.09.2014;2014;09;15;Tiistai;36;39;75
93;09.09.2014;2014;09;16;Tiistai;29;38;67
93;09.09.2014;2014;09;17;Tiistai;27;33;60
93;09.09.2014;2014;09;18;Tiistai;11;22;33
93;09.09.2014;2014;09;19;Tiistai;21;16;37
93;09.09.2014;2014;09;20;Tiistai;14;15;29
93;09.09.2014;2014;09;21;Tiistai;3;9;12
93;09.09.2014;2014;09;22;Tiistai;1;2;3
93;09.09.2014;2014;09;23;Tiistai;2;1;3
93;10.09.2014;2014;09;00;Keskiviikko;0;0;0
93;10.09.2014;2014;09;01;Keskiviikko;0;0;0
93;10.09.2014;2014;09;02;Keskiviikko;2;0;2
93;10.09.2014;2014;09;03;Keskiviikko;0;0;0
93;10.09.2014;2014;09;04;Keskiviikko;2;1;3
93;10.09.2014;2014;09;05;Keskiviikko;1;5;6
93;10.09.2014;2014;09;06;Keskiviikko;23;12;35
93;10.09.2014;2014;09;07;Keskiviikko;40;35;75
93;10.09.2014;2014;09;08;Keskiviikko;13;18;31
93;10.09.2014;2014;09;09;Keskiviikko;11;9;20
93;10.09.2014;2014;09;10;Keskiviikko;9;9;18
93;10.09.2014;2014;09;11;Keskiviikko;9;9;18
93;10.09.2014;2014;09;12;Keskiviikko;8;10;18
93;10.09.2014;2014;09;13;Keskiviikko;13;19;32
93;10.09.2014;2014;09;14;Keskiviikko;18;25;43
93;10.09.2014;2014;09;15;Keskiviikko;38;34;72
93;10.09.2014;2014;09;16;Keskiviikko;44;45;89
93;10.09.2014;2014;09;17;Keskiviikko;18;25;43
93;10.09.2014;2014;09;18;Keskiviikko;19;22;41
93;10.09.2014;2014;09;19;Keskiviikko;11;21;32
93;10.09.2014;2014;09;20;Keskiviikko;10;18;28
93;10.09.2014;2014;09;21;Keskiviikko;8;7;15
93;10.09.2014;2014;09;22;Keskiviikko;1;4;5
93;10.09.2014;2014;09;23;Keskiviikko;1;1;2
93;11.09.2014;2014;09;00;Torstai;1;0;1
93;11.09.2014;2014;09;01;Torstai;0;1;1
93;11.09.2014;2014;09;02;Torstai;0;0;0
93;11.09.2014;2014;09;03;Torstai;0;0;0
93;11.09.2014;2014;09;04;Torstai;1;0;1
93;11.09.2014;2014;09;05;Torstai;2;4;6
93;11.09.2014;2014;09;06;Torstai;17;13;30
93;11.09.2014;2014;09;07;Torstai;47;34;81
93;11.09.2014;2014;09;08;Torstai;9;27;36
93;11.09.2014;2014;09;09;Torstai;8;9;17
93;11.09.2014;2014;09;10;Torstai;10;11;21
93;11.09.2014;2014;09;11;Torstai;8;9;17
93;11.09.2014;2014;09;12;Torstai;10;11;21
93;11.09.2014;2014;09;13;Torstai;9;12;21
93;11.09.2014;2014;09;14;Torstai;13;32;45
93;11.09.2014;2014;09;15;Torstai;32;22;54
93;11.09.2014;2014;09;16;Torstai;32;37;69
93;11.09.2014;2014;09;17;Torstai;12;13;25
93;11.09.2014;2014;09;18;Torstai;19;15;34
93;11.09.2014;2014;09;19;Torstai;15;5;20
93;11.09.2014;2014;09;20;Torstai;6;9;15
93;11.09.2014;2014;09;21;Torstai;0;6;6
93;11.09.2014;2014;09;22;Torstai;5;3;8
93;11.09.2014;2014;09;23;Torstai;0;0;0
93;12.09.2014;2014;09;00;Perjantai;0;2;2
93;12.09.2014;2014;09;01;Perjantai;0;0;0
93;12.09.2014;2014;09;02;Perjantai;0;0;0
93;12.09.2014;2014;09;03;Perjantai;0;0;0
93;12.09.2014;2014;09;04;Perjantai;1;1;2
93;12.09.2014;2014;09;05;Perjantai;3;3;6
93;12.09.2014;2014;09;06;Perjantai;18;7;25
93;12.09.2014;2014;09;07;Perjantai;30;32;62
93;12.09.2014;2014;09;08;Perjantai;9;25;34
93;12.09.2014;2014;09;09;Perjantai;7;8;15
93;12.09.2014;2014;09;10;Perjantai;8;1;9
93;12.09.2014;2014;09;11;Perjantai;1;6;7
93;12.09.2014;2014;09;12;Perjantai;13;8;21
93;12.09.2014;2014;09;13;Perjantai;9;14;23
93;12.09.2014;2014;09;14;Perjantai;21;26;47
93;12.09.2014;2014;09;15;Perjantai;32;25;57
93;12.09.2014;2014;09;16;Perjantai;36;26;62
93;12.09.2014;2014;09;17;Perjantai;16;19;35
93;12.09.2014;2014;09;18;Perjantai;14;15;29
93;12.09.2014;2014;09;19;Perjantai;13;13;26
93;12.09.2014;2014;09;20;Perjantai;8;20;28
93;12.09.2014;2014;09;21;Perjantai;6;10;16
93;12.09.2014;2014;09;22;Perjantai;5;5;10
93;12.09.2014;2014;09;23;Perjantai;2;2;4
93;13.09.2014;2014;09;00;Lauantai;0;0;0
93;13.09.2014;2014;09;01;Lauantai;1;2;3
93;13.09.2014;2014;09;02;Lauantai;0;0;0
93;13.09.2014;2014;09;03;Lauantai;2;0;2
93;13.09.2014;2014;09;04;Lauantai;0;0;0
93;13.09.2014;2014;09;05;Lauantai;2;1;3
93;13.09.2014;2014;09;06;Lauantai;1;0;1
93;13.09.2014;2014;09;07;Lauantai;2;4;6
93;13.09.2014;2014;09;08;Lauantai;5;12;17
93;13.09.2014;2014;09;09;Lauantai;9;7;16
93;13.09.2014;2014;09;10;Lauantai;11;17;28
93;13.09.2014;2014;09;11;Lauantai;11;16;27
93;13.09.2014;2014;09;12;Lauantai;27;20;47
93;13.09.2014;2014;09;13;Lauantai;36;22;58
93;13.09.2014;2014;09;14;Lauantai;14;16;30
93;13.09.2014;2014;09;15;Lauantai;17;24;41
93;13.09.2014;2014;09;16;Lauantai;16;13;29
93;13.09.2014;2014;09;17;Lauantai;12;13;25
93;13.09.2014;2014;09;18;Lauantai;15;16;31
93;13.09.2014;2014;09;19;Lauantai;14;8;22
93;13.09.2014;2014;09;20;Lauantai;10;17;27
93;13.09.2014;2014;09;21;Lauantai;3;10;13
93;13.09.2014;2014;09;22;Lauantai;3;5;8
93;13.09.2014;2014;09;23;Lauantai;1;1;2
93;14.09.2014;2014;09;00;Sunnuntai;3;2;5
93;14.09.2014;2014;09;01;Sunnuntai;0;0;0
93;14.09.2014;2014;09;02;Sunnuntai;2;1;3
93;14.09.2014;2014;09;03;Sunnuntai;0;0;0
93;14.09.2014;2014;09;04;Sunnuntai;0;1;1
93;14.09.2014;2014;09;05;Sunnuntai;0;0;0
93;14.09.2014;2014;09;06;Sunnuntai;1;2;3
93;14.09.2014;2014;09;07;Sunnuntai;1;5;6
93;14.09.2014;2014;09;08;Sunnuntai;5;8;13
93;14.09.2014;2014;09;09;Sunnuntai;9;12;21
93;14.09.2014;2014;09;10;Sunnuntai;19;5;24
93;14.09.2014;2014;09;11;Sunnuntai;20;15;35
93;14.09.2014;2014;09;12;Sunnuntai;13;27;40
93;14.09.2014;2014;09;13;Sunnuntai;18;24;42
93;14.09.2014;2014;09;14;Sunnuntai;24;13;37
93;14.09.2014;2014;09;15;Sunnuntai;17;25;42
93;14.09.2014;2014;09;16;Sunnuntai;23;9;32
93;14.09.2014;2014;09;17;Sunnuntai;11;4;15
93;14.09.2014;2014;09;18;Sunnuntai;11;14;25
93;14.09.2014;2014;09;19;Sunnuntai;14;10;24
93;14.09.2014;2014;09;20;Sunnuntai;10;3;13
93;14.09.2014;2014;09;21;Sunnuntai;4;1;5
93;14.09.2014;2014;09;22;Sunnuntai;1;1;2
93;14.09.2014;2014;09;23;Sunnuntai;0;0;0
93;15.09.2014;2014;09;00;Maanantai;1;0;1
93;15.09.2014;2014;09;01;Maanantai;0;0;0
93;15.09.2014;2014;09;02;Maanantai;0;0;0
93;15.09.2014;2014;09;03;Maanantai;0;0;0
93;15.09.2014;2014;09;04;Maanantai;0;0;0
93;15.09.2014;2014;09;05;Maanantai;3;6;9
93;15.09.2014;2014;09;06;Maanantai;25;7;32
93;15.09.2014;2014;09;07;Maanantai;29;38;67
93;15.09.2014;2014;09;08;Maanantai;14;21;35
93;15.09.2014;2014;09;09;Maanantai;17;12;29
93;15.09.2014;2014;09;10;Maanantai;15;10;25
93;15.09.2014;2014;09;11;Maanantai;9;6;15
93;15.09.2014;2014;09;12;Maanantai;9;9;18
93;15.09.2014;2014;09;13;Maanantai;13;14;27
93;15.09.2014;2014;09;14;Maanantai;12;14;26
93;15.09.2014;2014;09;15;Maanantai;33;29;62
93;15.09.2014;2014;09;16;Maanantai;40;40;80
93;15.09.2014;2014;09;17;Maanantai;18;21;39
93;15.09.2014;2014;09;18;Maanantai;19;22;41
93;15.09.2014;2014;09;19;Maanantai;15;17;32
93;15.09.2014;2014;09;20;Maanantai;8;11;19
93;15.09.2014;2014;09;21;Maanantai;3;2;5
93;15.09.2014;2014;09;22;Maanantai;1;1;2
93;15.09.2014;2014;09;23;Maanantai;2;0;2
93;16.09.2014;2014;09;00;Tiistai;0;1;1
93;16.09.2014;2014;09;01;Tiistai;0;0;0
93;16.09.2014;2014;09;02;Tiistai;0;0;0
93;16.09.2014;2014;09;03;Tiistai;1;0;1
93;16.09.2014;2014;09;04;Tiistai;1;0;1
93;16.09.2014;2014;09;05;Tiistai;4;2;6
93;16.09.2014;2014;09;06;Tiistai;20;13;33
93;16.09.2014;2014;09;07;Tiistai;38;34;72
93;16.09.2014;2014;09;08;Tiistai;13;23;36
93;16.09.2014;2014;09;09;Tiistai;13;8;21
93;16.09.2014;2014;09;10;Tiistai;6;10;16
93;16.09.2014;2014;09;11;Tiistai;8;14;22
93;16.09.2014;2014;09;12;Tiistai;13;5;18
93;16.09.2014;2014;09;13;Tiistai;14;7;21
93;16.09.2014;2014;09;14;Tiistai;19;18;37
93;16.09.2014;2014;09;15;Tiistai;35;34;69
93;16.09.2014;2014;09;16;Tiistai;23;49;72
93;16.09.2014;2014;09;17;Tiistai;17;21;38
93;16.09.2014;2014;09;18;Tiistai;18;19;37
93;16.09.2014;2014;09;19;Tiistai;19;18;37
93;16.09.2014;2014;09;20;Tiistai;10;14;24
93;16.09.2014;2014;09;21;Tiistai;3;5;8
93;16.09.2014;2014;09;22;Tiistai;1;2;3
93;16.09.2014;2014;09;23;Tiistai;1;2;3
93;17.09.2014;2014;09;00;Keskiviikko;0;1;1
93;17.09.2014;2014;09;01;Keskiviikko;0;0;0
93;17.09.2014;2014;09;02;Keskiviikko;2;0;2
93;17.09.2014;2014;09;03;Keskiviikko;0;0;0
93;17.09.2014;2014;09;04;Keskiviikko;1;0;1
93;17.09.2014;2014;09;05;Keskiviikko;5;5;10
93;17.09.2014;2014;09;06;Keskiviikko;19;12;31
93;17.09.2014;2014;09;07;Keskiviikko;35;33;68
93;17.09.2014;2014;09;08;Keskiviikko;17;27;44
93;17.09.2014;2014;09;09;Keskiviikko;11;15;26
93;17.09.2014;2014;09;10;Keskiviikko;12;8;20
93;17.09.2014;2014;09;11;Keskiviikko;7;6;13
93;17.09.2014;2014;09;12;Keskiviikko;11;13;24
93;17.09.2014;2014;09;13;Keskiviikko;12;10;22
93;17.09.2014;2014;09;14;Keskiviikko;22;17;39
93;17.09.2014;2014;09;15;Keskiviikko;31;27;58
93;17.09.2014;2014;09;16;Keskiviikko;37;38;75
93;17.09.2014;2014;09;17;Keskiviikko;24;25;49
93;17.09.2014;2014;09;18;Keskiviikko;11;18;29
93;17.09.2014;2014;09;19;Keskiviikko;16;17;33
93;17.09.2014;2014;09;20;Keskiviikko;4;11;15
93;17.09.2014;2014;09;21;Keskiviikko;3;3;6
93;17.09.2014;2014;09;22;Keskiviikko;2;0;2
93;17.09.2014;2014;09;23;Keskiviikko;0;2;2
93;18.09.2014;2014;09;00;Torstai;0;1;1
93;18.09.2014;2014;09;01;Torstai;0;0;0
93;18.09.2014;2014;09;02;Torstai;0;0;0
93;18.09.2014;2014;09;03;Torstai;0;0;0
93;18.09.2014;2014;09;04;Torstai;1;0;1
93;18.09.2014;2014;09;05;Torstai;4;2;6
93;18.09.2014;2014;09;06;Torstai;18;12;30
93;18.09.2014;2014;09;07;Torstai;34;27;61
93;18.09.2014;2014;09;08;Torstai;16;21;37
93;18.09.2014;2014;09;09;Torstai;8;12;20
93;18.09.2014;2014;09;10;Torstai;6;5;11
93;18.09.2014;2014;09;11;Torstai;13;3;16
93;18.09.2014;2014;09;12;Torstai;10;15;25
93;18.09.2014;2014;09;13;Torstai;8;13;21
93;18.09.2014;2014;09;14;Torstai;11;16;27
93;18.09.2014;2014;09;15;Torstai;22;33;55
93;18.09.2014;2014;09;16;Torstai;25;30;55
93;18.09.2014;2014;09;17;Torstai;12;18;30
93;18.09.2014;2014;09;18;Torstai;18;20;38
93;18.09.2014;2014;09;19;Torstai;8;11;19
93;18.09.2014;2014;09;20;Torstai;5;4;9
93;18.09.2014;2014;09;21;Torstai;1;6;7
93;18.09.2014;2014;09;22;Torstai;1;4;5
93;18.09.2014;2014;09;23;Torstai;0;0;0
93;19.09.2014;2014;09;00;Perjantai;0;0;0
93;19.09.2014;2014;09;01;Perjantai;0;2;2
93;19.09.2014;2014;09;02;Perjantai;0;0;0
93;19.09.2014;2014;09;03;Perjantai;0;0;0
93;19.09.2014;2014;09;04;Perjantai;1;0;1
93;19.09.2014;2014;09;05;Perjantai;5;4;9
93;19.09.2014;2014;09;06;Perjantai;13;6;19
93;19.09.2014;2014;09;07;Perjantai;23;29;52
93;19.09.2014;2014;09;08;Perjantai;15;15;30
93;19.09.2014;2014;09;09;Perjantai;6;7;13
93;19.09.2014;2014;09;10;Perjantai;7;6;13
93;19.09.2014;2014;09;11;Perjantai;9;8;17
93;19.09.2014;2014;09;12;Perjantai;12;7;19
93;19.09.2014;2014;09;13;Perjantai;13;13;26
93;19.09.2014;2014;09;14;Perjantai;9;20;29
93;19.09.2014;2014;09;15;Perjantai;18;25;43
93;19.09.2014;2014;09;16;Perjantai;15;12;27
93;19.09.2014;2014;09;17;Perjantai;20;8;28
93;19.09.2014;2014;09;18;Perjantai;13;15;28
93;19.09.2014;2014;09;19;Perjantai;12;9;21
93;19.09.2014;2014;09;20;Perjantai;2;12;14
93;19.09.2014;2014;09;21;Perjantai;6;6;12
93;19.09.2014;2014;09;22;Perjantai;1;6;7
93;19.09.2014;2014;09;23;Perjantai;1;8;9
93;20.09.2014;2014;09;00;Lauantai;0;0;0
93;20.09.2014;2014;09;01;Lauantai;3;1;4
93;20.09.2014;2014;09;02;Lauantai;0;1;1
93;20.09.2014;2014;09;03;Lauantai;0;2;2
93;20.09.2014;2014;09;04;Lauantai;0;0;0
93;20.09.2014;2014;09;05;Lauantai;1;1;2
93;20.09.2014;2014;09;06;Lauantai;2;1;3
93;20.09.2014;2014;09;07;Lauantai;1;3;4
93;20.09.2014;2014;09;08;Lauantai;7;4;11
93;20.09.2014;2014;09;09;Lauantai;6;21;27
93;20.09.2014;2014;09;10;Lauantai;11;22;33
93;20.09.2014;2014;09;11;Lauantai;6;13;19
93;20.09.2014;2014;09;12;Lauantai;19;11;30
93;20.09.2014;2014;09;13;Lauantai;13;15;28
93;20.09.2014;2014;09;14;Lauantai;15;14;29
93;20.09.2014;2014;09;15;Lauantai;19;17;36
93;20.09.2014;2014;09;16;Lauantai;16;11;27
93;20.09.2014;2014;09;17;Lauantai;7;12;19
93;20.09.2014;2014;09;18;Lauantai;23;10;33
93;20.09.2014;2014;09;19;Lauantai;6;7;13
93;20.09.2014;2014;09;20;Lauantai;3;16;19
93;20.09.2014;2014;09;21;Lauantai;7;9;16
93;20.09.2014;2014;09;22;Lauantai;4;2;6
93;20.09.2014;2014;09;23;Lauantai;0;5;5
93;21.09.2014;2014;09;00;Sunnuntai;2;0;2
93;21.09.2014;2014;09;01;Sunnuntai;0;1;1
93;21.09.2014;2014;09;02;Sunnuntai;1;0;1
93;21.09.2014;2014;09;03;Sunnuntai;0;0;0
93;21.09.2014;2014;09;04;Sunnuntai;0;0;0
93;21.09.2014;2014;09;05;Sunnuntai;4;0;4
93;21.09.2014;2014;09;06;Sunnuntai;2;3;5
93;21.09.2014;2014;09;07;Sunnuntai;5;3;8
93;21.09.2014;2014;09;08;Sunnuntai;2;5;7
93;21.09.2014;2014;09;09;Sunnuntai;9;6;15
93;21.09.2014;2014;09;10;Sunnuntai;10;3;13
93;21.09.2014;2014;09;11;Sunnuntai;8;9;17
93;21.09.2014;2014;09;12;Sunnuntai;14;13;27
93;21.09.2014;2014;09;13;Sunnuntai;10;10;20
93;21.09.2014;2014;09;14;Sunnuntai;14;14;28
93;21.09.2014;2014;09;15;Sunnuntai;13;19;32
93;21.09.2014;2014;09;16;Sunnuntai;18;16;34
93;21.09.2014;2014;09;17;Sunnuntai;16;11;27
93;21.09.2014;2014;09;18;Sunnuntai;12;6;18
93;21.09.2014;2014;09;19;Sunnuntai;9;9;18
93;21.09.2014;2014;09;20;Sunnuntai;1;2;3
93;21.09.2014;2014;09;21;Sunnuntai;0;4;4
93;21.09.2014;2014;09;22;Sunnuntai;3;1;4
93;21.09.2014;2014;09;23;Sunnuntai;1;0;1
93;22.09.2014;2014;09;00;Maanantai;0;0;0
93;22.09.2014;2014;09;01;Maanantai;0;0;0
93;22.09.2014;2014;09;02;Maanantai;0;0;0
93;22.09.2014;2014;09;03;Maanantai;0;0;0
93;22.09.2014;2014;09;04;Maanantai;0;0;0
93;22.09.2014;2014;09;05;Maanantai;5;4;9
93;22.09.2014;2014;09;06;Maanantai;16;7;23
93;22.09.2014;2014;09;07;Maanantai;25;24;49
93;22.09.2014;2014;09;08;Maanantai;15;26;41
93;22.09.2014;2014;09;09;Maanantai;7;10;17
93;22.09.2014;2014;09;10;Maanantai;10;2;12
93;22.09.2014;2014;09;11;Maanantai;6;8;14
93;22.09.2014;2014;09;12;Maanantai;7;8;15
93;22.09.2014;2014;09;13;Maanantai;6;4;10
93;22.09.2014;2014;09;14;Maanantai;11;17;28
93;22.09.2014;2014;09;15;Maanantai;24;16;40
93;22.09.2014;2014;09;16;Maanantai;30;26;56
93;22.09.2014;2014;09;17;Maanantai;18;22;40
93;22.09.2014;2014;09;18;Maanantai;14;15;29
93;22.09.2014;2014;09;19;Maanantai;4;5;9
93;22.09.2014;2014;09;20;Maanantai;4;9;13
93;22.09.2014;2014;09;21;Maanantai;3;1;4
93;22.09.2014;2014;09;22;Maanantai;0;0;0
93;22.09.2014;2014;09;23;Maanantai;0;0;0
93;23.09.2014;2014;09;00;Tiistai;0;1;1
93;23.09.2014;2014;09;01;Tiistai;1;0;1
93;23.09.2014;2014;09;02;Tiistai;0;0;0
93;23.09.2014;2014;09;03;Tiistai;0;0;0
93;23.09.2014;2014;09;04;Tiistai;0;0;0
93;23.09.2014;2014;09;05;Tiistai;2;3;5
93;23.09.2014;2014;09;06;Tiistai;12;10;22
93;23.09.2014;2014;09;07;Tiistai;30;32;62
93;23.09.2014;2014;09;08;Tiistai;13;17;30
93;23.09.2014;2014;09;09;Tiistai;5;7;12
93;23.09.2014;2014;09;10;Tiistai;11;10;21
93;23.09.2014;2014;09;11;Tiistai;3;7;10
93;23.09.2014;2014;09;12;Tiistai;5;4;9
93;23.09.2014;2014;09;13;Tiistai;6;7;13
93;23.09.2014;2014;09;14;Tiistai;14;7;21
93;23.09.2014;2014;09;15;Tiistai;17;22;39
93;23.09.2014;2014;09;16;Tiistai;25;27;52
93;23.09.2014;2014;09;17;Tiistai;16;15;31
93;23.09.2014;2014;09;18;Tiistai;11;14;25
93;23.09.2014;2014;09;19;Tiistai;9;6;15
93;23.09.2014;2014;09;20;Tiistai;7;4;11
93;23.09.2014;2014;09;21;Tiistai;1;4;5
93;23.09.2014;2014;09;22;Tiistai;1;2;3
93;23.09.2014;2014;09;23;Tiistai;1;0;1
93;24.09.2014;2014;09;00;Keskiviikko;0;1;1
93;24.09.2014;2014;09;01;Keskiviikko;1;0;1
93;24.09.2014;2014;09;02;Keskiviikko;0;0;0
93;24.09.2014;2014;09;03;Keskiviikko;1;0;1
93;24.09.2014;2014;09;04;Keskiviikko;0;0;0
93;24.09.2014;2014;09;05;Keskiviikko;3;2;5
93;24.09.2014;2014;09;06;Keskiviikko;9;2;11
93;24.09.2014;2014;09;07;Keskiviikko;17;15;32
93;24.09.2014;2014;09;08;Keskiviikko;9;15;24
93;24.09.2014;2014;09;09;Keskiviikko;6;7;13
93;24.09.2014;2014;09;10;Keskiviikko;1;4;5
93;24.09.2014;2014;09;11;Keskiviikko;4;1;5
93;24.09.2014;2014;09;12;Keskiviikko;5;5;10
93;24.09.2014;2014;09;13;Keskiviikko;5;7;12
93;24.09.2014;2014;09;14;Keskiviikko;2;8;10
93;24.09.2014;2014;09;15;Keskiviikko;8;8;16
93;24.09.2014;2014;09;16;Keskiviikko;11;17;28
93;24.09.2014;2014;09;17;Keskiviikko;8;7;15
93;24.09.2014;2014;09;18;Keskiviikko;6;5;11
93;24.09.2014;2014;09;19;Keskiviikko;4;4;8
93;24.09.2014;2014;09;20;Keskiviikko;2;3;5
93;24.09.2014;2014;09;21;Keskiviikko;0;3;3
93;24.09.2014;2014;09;22;Keskiviikko;1;1;2
93;24.09.2014;2014;09;23;Keskiviikko;0;0;0
93;25.09.2014;2014;09;00;Torstai;0;0;0
93;25.09.2014;2014;09;01;Torstai;1;1;2
93;25.09.2014;2014;09;02;Torstai;0;0;0
93;25.09.2014;2014;09;03;Torstai;0;0;0
93;25.09.2014;2014;09;04;Torstai;1;0;1
93;25.09.2014;2014;09;05;Torstai;1;2;3
93;25.09.2014;2014;09;06;Torstai;9;6;15
93;25.09.2014;2014;09;07;Torstai;18;21;39
93;25.09.2014;2014;09;08;Torstai;9;17;26
93;25.09.2014;2014;09;09;Torstai;1;6;7
93;25.09.2014;2014;09;10;Torstai;6;5;11
93;25.09.2014;2014;09;11;Torstai;7;6;13
93;25.09.2014;2014;09;12;Torstai;5;10;15
93;25.09.2014;2014;09;13;Torstai;8;7;15
93;25.09.2014;2014;09;14;Torstai;13;8;21
93;25.09.2014;2014;09;15;Torstai;21;7;28
93;25.09.2014;2014;09;16;Torstai;22;23;45
93;25.09.2014;2014;09;17;Torstai;9;17;26
93;25.09.2014;2014;09;18;Torstai;12;11;23
93;25.09.2014;2014;09;19;Torstai;6;7;13
93;25.09.2014;2014;09;20;Torstai;4;8;12
93;25.09.2014;2014;09;21;Torstai;1;1;2
93;25.09.2014;2014;09;22;Torstai;2;0;2
93;25.09.2014;2014;09;23;Torstai;0;0;0
93;26.09.2014;2014;09;00;Perjantai;0;0;0
93;26.09.2014;2014;09;01;Perjantai;0;0;0
93;26.09.2014;2014;09;02;Perjantai;0;0;0
93;26.09.2014;2014;09;03;Perjantai;0;0;0
93;26.09.2014;2014;09;04;Perjantai;0;0;0
93;26.09.2014;2014;09;05;Perjantai;1;3;4
93;26.09.2014;2014;09;06;Perjantai;12;7;19
93;26.09.2014;2014;09;07;Perjantai;15;19;34
93;26.09.2014;2014;09;08;Perjantai;7;12;19
93;26.09.2014;2014;09;09;Perjantai;7;7;14
93;26.09.2014;2014;09;10;Perjantai;8;9;17
93;26.09.2014;2014;09;11;Perjantai;8;9;17
93;26.09.2014;2014;09;12;Perjantai;8;5;13
93;26.09.2014;2014;09;13;Perjantai;15;14;29
93;26.09.2014;2014;09;14;Perjantai;17;9;26
93;26.09.2014;2014;09;15;Perjantai;15;14;29
93;26.09.2014;2014;09;16;Perjantai;20;16;36
93;26.09.2014;2014;09;17;Perjantai;8;16;24
93;26.09.2014;2014;09;18;Perjantai;4;4;8
93;26.09.2014;2014;09;19;Perjantai;5;6;11
93;26.09.2014;2014;09;20;Perjantai;1;1;2
93;26.09.2014;2014;09;21;Perjantai;0;2;2
93;26.09.2014;2014;09;22;Perjantai;0;3;3
93;26.09.2014;2014;09;23;Perjantai;1;1;2
93;27.09.2014;2014;09;00;Lauantai;2;0;2
93;27.09.2014;2014;09;01;Lauantai;0;0;0
93;27.09.2014;2014;09;02;Lauantai;0;0;0
93;27.09.2014;2014;09;03;Lauantai;0;0;0
93;27.09.2014;2014;09;04;Lauantai;1;0;1
93;27.09.2014;2014;09;05;Lauantai;1;0;1
93;27.09.2014;2014;09;06;Lauantai;1;0;1
93;27.09.2014;2014;09;07;Lauantai;1;0;1
93;27.09.2014;2014;09;08;Lauantai;3;2;5
93;27.09.2014;2014;09;09;Lauantai;11;6;17
93;27.09.2014;2014;09;10;Lauantai;5;8;13
93;27.09.2014;2014;09;11;Lauantai;10;7;17
93;27.09.2014;2014;09;12;Lauantai;6;5;11
93;27.09.2014;2014;09;13;Lauantai;6;9;15
93;27.09.2014;2014;09;14;Lauantai;7;8;15
93;27.09.2014;2014;09;15;Lauantai;1;6;7
93;27.09.2014;2014;09;16;Lauantai;9;2;11
93;27.09.2014;2014;09;17;Lauantai;6;7;13
93;27.09.2014;2014;09;18;Lauantai;5;4;9
93;27.09.2014;2014;09;19;Lauantai;2;2;4
93;27.09.2014;2014;09;20;Lauantai;0;7;7
93;27.09.2014;2014;09;21;Lauantai;1;5;6
93;27.09.2014;2014;09;22;Lauantai;0;1;1
93;27.09.2014;2014;09;23;Lauantai;3;0;3
93;28.09.2014;2014;09;00;Sunnuntai;2;1;3
93;28.09.2014;2014;09;01;Sunnuntai;0;1;1
93;28.09.2014;2014;09;02;Sunnuntai;0;2;2
93;28.09.2014;2014;09;03;Sunnuntai;1;0;1
93;28.09.2014;2014;09;04;Sunnuntai;0;0;0
93;28.09.2014;2014;09;05;Sunnuntai;2;1;3
93;28.09.2014;2014;09;06;Sunnuntai;0;0;0
93;28.09.2014;2014;09;07;Sunnuntai;1;2;3
93;28.09.2014;2014;09;08;Sunnuntai;12;4;16
93;28.09.2014;2014;09;09;Sunnuntai;3;8;11
93;28.09.2014;2014;09;10;Sunnuntai;16;5;21
93;28.09.2014;2014;09;11;Sunnuntai;17;11;28
93;28.09.2014;2014;09;12;Sunnuntai;17;19;36
93;28.09.2014;2014;09;13;Sunnuntai;16;12;28
93;28.09.2014;2014;09;14;Sunnuntai;8;15;23
93;28.09.2014;2014;09;15;Sunnuntai;10;17;27
93;28.09.2014;2014;09;16;Sunnuntai;5;14;19
93;28.09.2014;2014;09;17;Sunnuntai;10;11;21
93;28.09.2014;2014;09;18;Sunnuntai;7;2;9
93;28.09.2014;2014;09;19;Sunnuntai;5;5;10
93;28.09.2014;2014;09;20;Sunnuntai;7;4;11
93;28.09.2014;2014;09;21;Sunnuntai;1;1;2
93;28.09.2014;2014;09;22;Sunnuntai;3;3;6
93;28.09.2014;2014;09;23;Sunnuntai;0;0;0
93;29.09.2014;2014;09;00;Maanantai;1;0;1
93;29.09.2014;2014;09;01;Maanantai;0;0;0
93;29.09.2014;2014;09;02;Maanantai;0;0;0
93;29.09.2014;2014;09;03;Maanantai;0;0;0
93;29.09.2014;2014;09;04;Maanantai;0;0;0
93;29.09.2014;2014;09;05;Maanantai;4;3;7
93;29.09.2014;2014;09;06;Maanantai;16;4;20
93;29.09.2014;2014;09;07;Maanantai;21;28;49
93;29.09.2014;2014;09;08;Maanantai;6;24;30
93;29.09.2014;2014;09;09;Maanantai;14;3;17
93;29.09.2014;2014;09;10;Maanantai;11;6;17
93;29.09.2014;2014;09;11;Maanantai;14;6;20
93;29.09.2014;2014;09;12;Maanantai;8;8;16
93;29.09.2014;2014;09;13;Maanantai;9;12;21
93;29.09.2014;2014;09;14;Maanantai;10;10;20
93;29.09.2014;2014;09;15;Maanantai;20;25;45
93;29.09.2014;2014;09;16;Maanantai;26;17;43
93;29.09.2014;2014;09;17;Maanantai;13;12;25
93;29.09.2014;2014;09;18;Maanantai;12;10;22
93;29.09.2014;2014;09;19;Maanantai;8;12;20
93;29.09.2014;2014;09;20;Maanantai;6;9;15
93;29.09.2014;2014;09;21;Maanantai;3;6;9
93;29.09.2014;2014;09;22;Maanantai;2;0;2
93;29.09.2014;2014;09;23;Maanantai;2;0;2
93;30.09.2014;2014;09;00;Tiistai;0;0;0
93;30.09.2014;2014;09;01;Tiistai;0;0;0
93;30.09.2014;2014;09;02;Tiistai;0;0;0
93;30.09.2014;2014;09;03;Tiistai;0;0;0
93;30.09.2014;2014;09;04;Tiistai;1;0;1
93;30.09.2014;2014;09;05;Tiistai;4;2;6
93;30.09.2014;2014;09;06;Tiistai;19;9;28
93;30.09.2014;2014;09;07;Tiistai;28;31;59
93;30.09.2014;2014;09;08;Tiistai;10;21;31
93;30.09.2014;2014;09;09;Tiistai;8;9;17
93;30.09.2014;2014;09;10;Tiistai;7;6;13
93;30.09.2014;2014;09;11;Tiistai;4;5;9
93;30.09.2014;2014;09;12;Tiistai;11;8;19
93;30.09.2014;2014;09;13;Tiistai;6;8;14
93;30.09.2014;2014;09;14;Tiistai;17;14;31
93;30.09.2014;2014;09;15;Tiistai;24;24;48
93;30.09.2014;2014;09;16;Tiistai;31;29;60
93;30.09.2014;2014;09;17;Tiistai;17;19;36
93;30.09.2014;2014;09;18;Tiistai;7;14;21
93;30.09.2014;2014;09;19;Tiistai;13;13;26
93;30.09.2014;2014;09;20;Tiistai;6;7;13
93;30.09.2014;2014;09;21;Tiistai;2;3;5
93;30.09.2014;2014;09;22;Tiistai;2;7;9
93;30.09.2014;2014;09;23;Tiistai;0;1;1
93;01.10.2014;2014;10;00;Keskiviikko;0;0;0
93;01.10.2014;2014;10;01;Keskiviikko;0;0;0
93;01.10.2014;2014;10;02;Keskiviikko;0;0;0
93;01.10.2014;2014;10;03;Keskiviikko;0;0;0
93;01.10.2014;2014;10;04;Keskiviikko;0;2;2
93;01.10.2014;2014;10;05;Keskiviikko;6;1;7
93;01.10.2014;2014;10;06;Keskiviikko;16;3;19
93;01.10.2014;2014;10;07;Keskiviikko;30;19;49
93;01.10.2014;2014;10;08;Keskiviikko;12;21;33
93;01.10.2014;2014;10;09;Keskiviikko;5;7;12
93;01.10.2014;2014;10;10;Keskiviikko;11;3;14
93;01.10.2014;2014;10;11;Keskiviikko;8;12;20
93;01.10.2014;2014;10;12;Keskiviikko;12;7;19
93;01.10.2014;2014;10;13;Keskiviikko;8;11;19
93;01.10.2014;2014;10;14;Keskiviikko;7;6;13
93;01.10.2014;2014;10;15;Keskiviikko;18;28;46
93;01.10.2014;2014;10;16;Keskiviikko;24;31;55
93;01.10.2014;2014;10;17;Keskiviikko;21;18;39
93;01.10.2014;2014;10;18;Keskiviikko;7;18;25
93;01.10.2014;2014;10;19;Keskiviikko;5;11;16
93;01.10.2014;2014;10;20;Keskiviikko;5;4;9
93;01.10.2014;2014;10;21;Keskiviikko;2;4;6
93;01.10.2014;2014;10;22;Keskiviikko;2;2;4
93;01.10.2014;2014;10;23;Keskiviikko;1;0;1
93;02.10.2014;2014;10;00;Torstai;0;0;0
93;02.10.2014;2014;10;01;Torstai;0;0;0
93;02.10.2014;2014;10;02;Torstai;0;0;0
93;02.10.2014;2014;10;03;Torstai;0;0;0
93;02.10.2014;2014;10;04;Torstai;1;1;2
93;02.10.2014;2014;10;05;Torstai;3;2;5
93;02.10.2014;2014;10;06;Torstai;9;5;14
93;02.10.2014;2014;10;07;Torstai;34;17;51
93;02.10.2014;2014;10;08;Torstai;10;22;32
93;02.10.2014;2014;10;09;Torstai;11;9;20
93;02.10.2014;2014;10;10;Torstai;9;5;14
93;02.10.2014;2014;10;11;Torstai;6;3;9
93;02.10.2014;2014;10;12;Torstai;3;5;8
93;02.10.2014;2014;10;13;Torstai;3;5;8
93;02.10.2014;2014;10;14;Torstai;7;9;16
93;02.10.2014;2014;10;15;Torstai;17;10;27
93;02.10.2014;2014;10;16;Torstai;22;28;50
93;02.10.2014;2014;10;17;Torstai;8;23;31
93;02.10.2014;2014;10;18;Torstai;3;10;13
93;02.10.2014;2014;10;19;Torstai;6;12;18
93;02.10.2014;2014;10;20;Torstai;5;3;8
93;02.10.2014;2014;10;21;Torstai;2;5;7
93;02.10.2014;2014;10;22;Torstai;1;0;1
93;02.10.2014;2014;10;23;Torstai;1;0;1
93;03.10.2014;2014;10;00;Perjantai;0;0;0
93;03.10.2014;2014;10;01;Perjantai;1;0;1
93;03.10.2014;2014;10;02;Perjantai;0;1;1
93;03.10.2014;2014;10;03;Perjantai;0;0;0
93;03.10.2014;2014;10;04;Perjantai;1;0;1
93;03.10.2014;2014;10;05;Perjantai;3;2;5
93;03.10.2014;2014;10;06;Perjantai;10;6;16
93;03.10.2014;2014;10;07;Perjantai;19;28;47
93;03.10.2014;2014;10;08;Perjantai;11;14;25
93;03.10.2014;2014;10;09;Perjantai;6;5;11
93;03.10.2014;2014;10;10;Perjantai;5;6;11
93;03.10.2014;2014;10;11;Perjantai;11;11;22
93;03.10.2014;2014;10;12;Perjantai;8;10;18
93;03.10.2014;2014;10;13;Perjantai;17;10;27
93;03.10.2014;2014;10;14;Perjantai;17;12;29
93;03.10.2014;2014;10;15;Perjantai;22;23;45
93;03.10.2014;2014;10;16;Perjantai;24;22;46
93;03.10.2014;2014;10;17;Perjantai;11;15;26
93;03.10.2014;2014;10;18;Perjantai;10;13;23
93;03.10.2014;2014;10;19;Perjantai;4;5;9
93;03.10.2014;2014;10;20;Perjantai;3;6;9
93;03.10.2014;2014;10;21;Perjantai;2;2;4
93;03.10.2014;2014;10;22;Perjantai;1;0;1
93;03.10.2014;2014;10;23;Perjantai;2;2;4
93;04.10.2014;2014;10;00;Lauantai;1;0;1
93;04.10.2014;2014;10;01;Lauantai;0;0;0
93;04.10.2014;2014;10;02;Lauantai;1;0;1
93;04.10.2014;2014;10;03;Lauantai;0;0;0
93;04.10.2014;2014;10;04;Lauantai;0;2;2
93;04.10.2014;2014;10;05;Lauantai;0;1;1
93;04.10.2014;2014;10;06;Lauantai;4;0;4
93;04.10.2014;2014;10;07;Lauantai;1;1;2
93;04.10.2014;2014;10;08;Lauantai;5;2;7
93;04.10.2014;2014;10;09;Lauantai;8;6;14
93;04.10.2014;2014;10;10;Lauantai;4;16;20
93;04.10.2014;2014;10;11;Lauantai;6;9;15
93;04.10.2014;2014;10;12;Lauantai;8;10;18
93;04.10.2014;2014;10;13;Lauantai;12;8;20
93;04.10.2014;2014;10;14;Lauantai;12;7;19
93;04.10.2014;2014;10;15;Lauantai;10;17;27
93;04.10.2014;2014;10;16;Lauantai;7;9;16
93;04.10.2014;2014;10;17;Lauantai;9;12;21
93;04.10.2014;2014;10;18;Lauantai;6;11;17
93;04.10.2014;2014;10;19;Lauantai;4;4;8
93;04.10.2014;2014;10;20;Lauantai;6;7;13
93;04.10.2014;2014;10;21;Lauantai;1;6;7
93;04.10.2014;2014;10;22;Lauantai;2;2;4
93;04.10.2014;2014;10;23;Lauantai;9;0;9
93;05.10.2014;2014;10;00;Sunnuntai;2;0;2
93;05.10.2014;2014;10;01;Sunnuntai;1;0;1
93;05.10.2014;2014;10;02;Sunnuntai;2;0;2
93;05.10.2014;2014;10;03;Sunnuntai;0;1;1
93;05.10.2014;2014;10;04;Sunnuntai;0;3;3
93;05.10.2014;2014;10;05;Sunnuntai;0;0;0
93;05.10.2014;2014;10;06;Sunnuntai;3;0;3
93;05.10.2014;2014;10;07;Sunnuntai;4;0;4
93;05.10.2014;2014;10;08;Sunnuntai;1;3;4
93;05.10.2014;2014;10;09;Sunnuntai;3;2;5
93;05.10.2014;2014;10;10;Sunnuntai;7;10;17
93;05.10.2014;2014;10;11;Sunnuntai;12;9;21
93;05.10.2014;2014;10;12;Sunnuntai;15;13;28
93;05.10.2014;2014;10;13;Sunnuntai;8;17;25
93;05.10.2014;2014;10;14;Sunnuntai;8;11;19
93;05.10.2014;2014;10;15;Sunnuntai;9;8;17
93;05.10.2014;2014;10;16;Sunnuntai;8;7;15
93;05.10.2014;2014;10;17;Sunnuntai;7;15;22
93;05.10.2014;2014;10;18;Sunnuntai;12;12;24
93;05.10.2014;2014;10;19;Sunnuntai;9;5;14
93;05.10.2014;2014;10;20;Sunnuntai;4;3;7
93;05.10.2014;2014;10;21;Sunnuntai;1;1;2
93;05.10.2014;2014;10;22;Sunnuntai;2;1;3
93;05.10.2014;2014;10;23;Sunnuntai;0;0;0
93;06.10.2014;2014;10;00;Maanantai;0;0;0
93;06.10.2014;2014;10;01;Maanantai;0;0;0
93;06.10.2014;2014;10;02;Maanantai;0;0;0
93;06.10.2014;2014;10;03;Maanantai;0;0;0
93;06.10.2014;2014;10;04;Maanantai;1;0;1
93;06.10.2014;2014;10;05;Maanantai;1;1;2
93;06.10.2014;2014;10;06;Maanantai;9;8;17
93;06.10.2014;2014;10;07;Maanantai;22;31;53
93;06.10.2014;2014;10;08;Maanantai;13;16;29
93;06.10.2014;2014;10;09;Maanantai;7;10;17
93;06.10.2014;2014;10;10;Maanantai;7;4;11
93;06.10.2014;2014;10;11;Maanantai;4;6;10
93;06.10.2014;2014;10;12;Maanantai;6;3;9
93;06.10.2014;2014;10;13;Maanantai;7;5;12
93;06.10.2014;2014;10;14;Maanantai;12;16;28
93;06.10.2014;2014;10;15;Maanantai;18;15;33
93;06.10.2014;2014;10;16;Maanantai;31;25;56
93;06.10.2014;2014;10;17;Maanantai;12;20;32
93;06.10.2014;2014;10;18;Maanantai;5;11;16
93;06.10.2014;2014;10;19;Maanantai;7;4;11
93;06.10.2014;2014;10;20;Maanantai;0;3;3
93;06.10.2014;2014;10;21;Maanantai;1;1;2
93;06.10.2014;2014;10;22;Maanantai;1;0;1
93;06.10.2014;2014;10;23;Maanantai;0;0;0
93;07.10.2014;2014;10;00;Tiistai;0;0;0
93;07.10.2014;2014;10;01;Tiistai;0;1;1
93;07.10.2014;2014;10;02;Tiistai;1;0;1
93;07.10.2014;2014;10;03;Tiistai;0;0;0
93;07.10.2014;2014;10;04;Tiistai;1;1;2
93;07.10.2014;2014;10;05;Tiistai;3;1;4
93;07.10.2014;2014;10;06;Tiistai;8;7;15
93;07.10.2014;2014;10;07;Tiistai;31;28;59
93;07.10.2014;2014;10;08;Tiistai;9;15;24
93;07.10.2014;2014;10;09;Tiistai;10;9;19
93;07.10.2014;2014;10;10;Tiistai;3;4;7
93;07.10.2014;2014;10;11;Tiistai;3;6;9
93;07.10.2014;2014;10;12;Tiistai;5;5;10
93;07.10.2014;2014;10;13;Tiistai;6;5;11
93;07.10.2014;2014;10;14;Tiistai;10;8;18
93;07.10.2014;2014;10;15;Tiistai;19;15;34
93;07.10.2014;2014;10;16;Tiistai;26;28;54
93;07.10.2014;2014;10;17;Tiistai;12;16;28
93;07.10.2014;2014;10;18;Tiistai;8;10;18
93;07.10.2014;2014;10;19;Tiistai;7;9;16
93;07.10.2014;2014;10;20;Tiistai;5;0;5
93;07.10.2014;2014;10;21;Tiistai;3;2;5
93;07.10.2014;2014;10;22;Tiistai;1;1;2
93;07.10.2014;2014;10;23;Tiistai;0;0;0
93;08.10.2014;2014;10;00;Keskiviikko;0;1;1
93;08.10.2014;2014;10;01;Keskiviikko;0;0;0
93;08.10.2014;2014;10;02;Keskiviikko;1;0;1
93;08.10.2014;2014;10;03;Keskiviikko;0;0;0
93;08.10.2014;2014;10;04;Keskiviikko;1;0;1
93;08.10.2014;2014;10;05;Keskiviikko;2;2;4
93;08.10.2014;2014;10;06;Keskiviikko;6;6;12
93;08.10.2014;2014;10;07;Keskiviikko;20;26;46
93;08.10.2014;2014;10;08;Keskiviikko;19;20;39
93;08.10.2014;2014;10;09;Keskiviikko;7;15;22
93;08.10.2014;2014;10;10;Keskiviikko;7;6;13
93;08.10.2014;2014;10;11;Keskiviikko;4;6;10
93;08.10.2014;2014;10;12;Keskiviikko;4;11;15
93;08.10.2014;2014;10;13;Keskiviikko;6;8;14
93;08.10.2014;2014;10;14;Keskiviikko;15;11;26
93;08.10.2014;2014;10;15;Keskiviikko;18;12;30
93;08.10.2014;2014;10;16;Keskiviikko;30;24;54
93;08.10.2014;2014;10;17;Keskiviikko;22;7;29
93;08.10.2014;2014;10;18;Keskiviikko;6;14;20
93;08.10.2014;2014;10;19;Keskiviikko;6;12;18
93;08.10.2014;2014;10;20;Keskiviikko;1;6;7
93;08.10.2014;2014;10;21;Keskiviikko;0;2;2
93;08.10.2014;2014;10;22;Keskiviikko;0;1;1
93;08.10.2014;2014;10;23;Keskiviikko;0;1;1
93;09.10.2014;2014;10;00;Torstai;0;0;0
93;09.10.2014;2014;10;01;Torstai;0;0;0
93;09.10.2014;2014;10;02;Torstai;0;0;0
93;09.10.2014;2014;10;03;Torstai;0;0;0
93;09.10.2014;2014;10;04;Torstai;0;0;0
93;09.10.2014;2014;10;05;Torstai;2;2;4
93;09.10.2014;2014;10;06;Torstai;6;7;13
93;09.10.2014;2014;10;07;Torstai;17;13;30
93;09.10.2014;2014;10;08;Torstai;6;14;20
93;09.10.2014;2014;10;09;Torstai;8;7;15
93;09.10.2014;2014;10;10;Torstai;5;2;7
93;09.10.2014;2014;10;11;Torstai;4;3;7
93;09.10.2014;2014;10;12;Torstai;4;3;7
93;09.10.2014;2014;10;13;Torstai;2;8;10
93;09.10.2014;2014;10;14;Torstai;5;3;8
93;09.10.2014;2014;10;15;Torstai;7;9;16
93;09.10.2014;2014;10;16;Torstai;15;13;28
93;09.10.2014;2014;10;17;Torstai;8;5;13
93;09.10.2014;2014;10;18;Torstai;7;6;13
93;09.10.2014;2014;10;19;Torstai;3;2;5
93;09.10.2014;2014;10;20;Torstai;2;0;2
93;09.10.2014;2014;10;21;Torstai;2;1;3
93;09.10.2014;2014;10;22;Torstai;0;0;0
93;09.10.2014;2014;10;23;Torstai;0;0;0
93;10.10.2014;2014;10;00;Perjantai;0;1;1
93;10.10.2014;2014;10;01;Perjantai;0;0;0
93;10.10.2014;2014;10;02;Perjantai;0;0;0
93;10.10.2014;2014;10;03;Perjantai;0;0;0
93;10.10.2014;2014;10;04;Perjantai;0;1;1
93;10.10.2014;2014;10;05;Perjantai;0;1;1
93;10.10.2014;2014;10;06;Perjantai;6;4;10
93;10.10.2014;2014;10;07;Perjantai;6;10;16
93;10.10.2014;2014;10;08;Perjantai;1;9;10
93;10.10.2014;2014;10;09;Perjantai;2;2;4
93;10.10.2014;2014;10;10;Perjantai;1;1;2
93;10.10.2014;2014;10;11;Perjantai;3;0;3
93;10.10.2014;2014;10;12;Perjantai;1;1;2
93;10.10.2014;2014;10;13;Perjantai;3;4;7
93;10.10.2014;2014;10;14;Perjantai;6;5;11
93;10.10.2014;2014;10;15;Perjantai;5;8;13
93;10.10.2014;2014;10;16;Perjantai;8;7;15
93;10.10.2014;2014;10;17;Perjantai;3;8;11
93;10.10.2014;2014;10;18;Perjantai;8;5;13
93;10.10.2014;2014;10;19;Perjantai;2;1;3
93;10.10.2014;2014;10;20;Perjantai;0;1;1
93;10.10.2014;2014;10;21;Perjantai;0;1;1
93;10.10.2014;2014;10;22;Perjantai;3;2;5
93;10.10.2014;2014;10;23;Perjantai;5;3;8
93;11.10.2014;2014;10;00;Lauantai;0;2;2
93;11.10.2014;2014;10;01;Lauantai;1;0;1
93;11.10.2014;2014;10;02;Lauantai;0;1;1
93;11.10.2014;2014;10;03;Lauantai;0;0;0
93;11.10.2014;2014;10;04;Lauantai;1;0;1
93;11.10.2014;2014;10;05;Lauantai;1;2;3
93;11.10.2014;2014;10;06;Lauantai;1;1;2
93;11.10.2014;2014;10;07;Lauantai;1;0;1
93;11.10.2014;2014;10;08;Lauantai;1;0;1
93;11.10.2014;2014;10;09;Lauantai;4;1;5
93;11.10.2014;2014;10;10;Lauantai;2;2;4
93;11.10.2014;2014;10;11;Lauantai;5;3;8
93;11.10.2014;2014;10;12;Lauantai;7;5;12
93;11.10.2014;2014;10;13;Lauantai;6;10;16
93;11.10.2014;2014;10;14;Lauantai;1;12;13
93;11.10.2014;2014;10;15;Lauantai;6;9;15
93;11.10.2014;2014;10;16;Lauantai;3;10;13
93;11.10.2014;2014;10;17;Lauantai;5;1;6
93;11.10.2014;2014;10;18;Lauantai;8;4;12
93;11.10.2014;2014;10;19;Lauantai;0;2;2
93;11.10.2014;2014;10;20;Lauantai;3;2;5
93;11.10.2014;2014;10;21;Lauantai;0;4;4
93;11.10.2014;2014;10;22;Lauantai;0;1;1
93;11.10.2014;2014;10;23;Lauantai;2;4;6
93;12.10.2014;2014;10;00;Sunnuntai;0;3;3
93;12.10.2014;2014;10;01;Sunnuntai;0;0;0
93;12.10.2014;2014;10;02;Sunnuntai;0;0;0
93;12.10.2014;2014;10;03;Sunnuntai;1;0;1
93;12.10.2014;2014;10;04;Sunnuntai;0;0;0
93;12.10.2014;2014;10;05;Sunnuntai;0;1;1
93;12.10.2014;2014;10;06;Sunnuntai;1;1;2
93;12.10.2014;2014;10;07;Sunnuntai;3;0;3
93;12.10.2014;2014;10;08;Sunnuntai;2;2;4
93;12.10.2014;2014;10;09;Sunnuntai;3;0;3
93;12.10.2014;2014;10;10;Sunnuntai;4;4;8
93;12.10.2014;2014;10;11;Sunnuntai;20;7;27
93;12.10.2014;2014;10;12;Sunnuntai;11;22;33
93;12.10.2014;2014;10;13;Sunnuntai;17;10;27
93;12.10.2014;2014;10;14;Sunnuntai;2;6;8
93;12.10.2014;2014;10;15;Sunnuntai;11;6;17
93;12.10.2014;2014;10;16;Sunnuntai;9;6;15
93;12.10.2014;2014;10;17;Sunnuntai;2;9;11
93;12.10.2014;2014;10;18;Sunnuntai;7;7;14
93;12.10.2014;2014;10;19;Sunnuntai;5;2;7
93;12.10.2014;2014;10;20;Sunnuntai;2;5;7
93;12.10.2014;2014;10;21;Sunnuntai;0;5;5
93;12.10.2014;2014;10;22;Sunnuntai;3;1;4
93;12.10.2014;2014;10;23;Sunnuntai;0;1;1
93;13.10.2014;2014;10;00;Maanantai;0;0;0
93;13.10.2014;2014;10;01;Maanantai;0;0;0
93;13.10.2014;2014;10;02;Maanantai;0;0;0
93;13.10.2014;2014;10;03;Maanantai;0;0;0
93;13.10.2014;2014;10;04;Maanantai;0;0;0
93;13.10.2014;2014;10;05;Maanantai;1;2;3
93;13.10.2014;2014;10;06;Maanantai;9;8;17
93;13.10.2014;2014;10;07;Maanantai;26;23;49
93;13.10.2014;2014;10;08;Maanantai;7;14;21
93;13.10.2014;2014;10;09;Maanantai;2;4;6
93;13.10.2014;2014;10;10;Maanantai;6;2;8
93;13.10.2014;2014;10;11;Maanantai;6;4;10
93;13.10.2014;2014;10;12;Maanantai;5;7;12
93;13.10.2014;2014;10;13;Maanantai;3;9;12
93;13.10.2014;2014;10;14;Maanantai;11;11;22
93;13.10.2014;2014;10;15;Maanantai;19;15;34
93;13.10.2014;2014;10;16;Maanantai;17;17;34
93;13.10.2014;2014;10;17;Maanantai;10;16;26
93;13.10.2014;2014;10;18;Maanantai;4;9;13
93;13.10.2014;2014;10;19;Maanantai;4;5;9
93;13.10.2014;2014;10;20;Maanantai;1;6;7
93;13.10.2014;2014;10;21;Maanantai;1;1;2
93;13.10.2014;2014;10;22;Maanantai;0;1;1
93;13.10.2014;2014;10;23;Maanantai;0;0;0
93;14.10.2014;2014;10;00;Tiistai;0;2;2
93;14.10.2014;2014;10;01;Tiistai;0;0;0
93;14.10.2014;2014;10;02;Tiistai;1;0;1
93;14.10.2014;2014;10;03;Tiistai;0;0;0
93;14.10.2014;2014;10;04;Tiistai;1;4;5
93;14.10.2014;2014;10;05;Tiistai;3;1;4
93;14.10.2014;2014;10;06;Tiistai;12;7;19
93;14.10.2014;2014;10;07;Tiistai;21;20;41
93;14.10.2014;2014;10;08;Tiistai;7;12;19
93;14.10.2014;2014;10;09;Tiistai;6;4;10
93;14.10.2014;2014;10;10;Tiistai;4;5;9
93;14.10.2014;2014;10;11;Tiistai;5;7;12
93;14.10.2014;2014;10;12;Tiistai;7;6;13
93;14.10.2014;2014;10;13;Tiistai;3;8;11
93;14.10.2014;2014;10;14;Tiistai;10;11;21
93;14.10.2014;2014;10;15;Tiistai;14;13;27
93;14.10.2014;2014;10;16;Tiistai;14;14;28
93;14.10.2014;2014;10;17;Tiistai;15;17;32
93;14.10.2014;2014;10;18;Tiistai;7;10;17
93;14.10.2014;2014;10;19;Tiistai;9;7;16
93;14.10.2014;2014;10;20;Tiistai;3;4;7
93;14.10.2014;2014;10;21;Tiistai;4;1;5
93;14.10.2014;2014;10;22;Tiistai;0;1;1
93;14.10.2014;2014;10;23;Tiistai;1;1;2
93;15.10.2014;2014;10;00;Keskiviikko;0;0;0
93;15.10.2014;2014;10;01;Keskiviikko;0;0;0
93;15.10.2014;2014;10;02;Keskiviikko;1;0;1
93;15.10.2014;2014;10;03;Keskiviikko;0;0;0
93;15.10.2014;2014;10;04;Keskiviikko;0;0;0
93;15.10.2014;2014;10;05;Keskiviikko;2;0;2
93;15.10.2014;2014;10;06;Keskiviikko;6;5;11
93;15.10.2014;2014;10;07;Keskiviikko;14;14;28
93;15.10.2014;2014;10;08;Keskiviikko;10;6;16
93;15.10.2014;2014;10;09;Keskiviikko;0;9;9
93;15.10.2014;2014;10;10;Keskiviikko;6;1;7
93;15.10.2014;2014;10;11;Keskiviikko;3;3;6
93;15.10.2014;2014;10;12;Keskiviikko;3;3;6
93;15.10.2014;2014;10;13;Keskiviikko;7;10;17
93;15.10.2014;2014;10;14;Keskiviikko;12;7;19
93;15.10.2014;2014;10;15;Keskiviikko;14;16;30
93;15.10.2014;2014;10;16;Keskiviikko;11;19;30
93;15.10.2014;2014;10;17;Keskiviikko;13;6;19
93;15.10.2014;2014;10;18;Keskiviikko;6;11;17
93;15.10.2014;2014;10;19;Keskiviikko;3;4;7
93;15.10.2014;2014;10;20;Keskiviikko;6;3;9
93;15.10.2014;2014;10;21;Keskiviikko;0;0;0
93;15.10.2014;2014;10;22;Keskiviikko;1;0;1
93;15.10.2014;2014;10;23;Keskiviikko;0;1;1
93;16.10.2014;2014;10;00;Torstai;0;0;0
93;16.10.2014;2014;10;01;Torstai;0;0;0
93;16.10.2014;2014;10;02;Torstai;0;0;0
93;16.10.2014;2014;10;03;Torstai;0;0;0
93;16.10.2014;2014;10;04;Torstai;0;0;0
93;16.10.2014;2014;10;05;Torstai;2;1;3
93;16.10.2014;2014;10;06;Torstai;8;7;15
93;16.10.2014;2014;10;07;Torstai;16;12;28
93;16.10.2014;2014;10;08;Torstai;8;14;22
93;16.10.2014;2014;10;09;Torstai;3;7;10
93;16.10.2014;2014;10;10;Torstai;5;3;8
93;16.10.2014;2014;10;11;Torstai;7;4;11
93;16.10.2014;2014;10;12;Torstai;5;4;9
93;16.10.2014;2014;10;13;Torstai;6;8;14
93;16.10.2014;2014;10;14;Torstai;11;15;26
93;16.10.2014;2014;10;15;Torstai;13;10;23
93;16.10.2014;2014;10;16;Torstai;11;26;37
93;16.10.2014;2014;10;17;Torstai;11;4;15
93;16.10.2014;2014;10;18;Torstai;5;9;14
93;16.10.2014;2014;10;19;Torstai;4;4;8
93;16.10.2014;2014;10;20;Torstai;5;4;9
93;16.10.2014;2014;10;21;Torstai;1;1;2
93;16.10.2014;2014;10;22;Torstai;2;1;3
93;16.10.2014;2014;10;23;Torstai;3;0;3
93;17.10.2014;2014;10;00;Perjantai;0;0;0
93;17.10.2014;2014;10;01;Perjantai;0;1;1
93;17.10.2014;2014;10;02;Perjantai;0;1;1
93;17.10.2014;2014;10;03;Perjantai;0;0;0
93;17.10.2014;2014;10;04;Perjantai;0;0;0
93;17.10.2014;2014;10;05;Perjantai;3;3;6
93;17.10.2014;2014;10;06;Perjantai;9;4;13
93;17.10.2014;2014;10;07;Perjantai;13;9;22
93;17.10.2014;2014;10;08;Perjantai;6;6;12
93;17.10.2014;2014;10;09;Perjantai;3;8;11
93;17.10.2014;2014;10;10;Perjantai;4;6;10
93;17.10.2014;2014;10;11;Perjantai;4;1;5
93;17.10.2014;2014;10;12;Perjantai;7;11;18
93;17.10.2014;2014;10;13;Perjantai;11;5;16
93;17.10.2014;2014;10;14;Perjantai;9;10;19
93;17.10.2014;2014;10;15;Perjantai;11;20;31
93;17.10.2014;2014;10;16;Perjantai;9;8;17
93;17.10.2014;2014;10;17;Perjantai;6;2;8
93;17.10.2014;2014;10;18;Perjantai;3;5;8
93;17.10.2014;2014;10;19;Perjantai;4;5;9
93;17.10.2014;2014;10;20;Perjantai;1;3;4
93;17.10.2014;2014;10;21;Perjantai;0;1;1
93;17.10.2014;2014;10;22;Perjantai;2;2;4
93;17.10.2014;2014;10;23;Perjantai;0;1;1
93;18.10.2014;2014;10;00;Lauantai;1;0;1
93;18.10.2014;2014;10;01;Lauantai;0;1;1
93;18.10.2014;2014;10;02;Lauantai;0;0;0
93;18.10.2014;2014;10;03;Lauantai;0;0;0
93;18.10.2014;2014;10;04;Lauantai;1;0;1
93;18.10.2014;2014;10;05;Lauantai;1;0;1
93;18.10.2014;2014;10;06;Lauantai;1;0;1
93;18.10.2014;2014;10;07;Lauantai;1;1;2
93;18.10.2014;2014;10;08;Lauantai;3;5;8
93;18.10.2014;2014;10;09;Lauantai;3;1;4
93;18.10.2014;2014;10;10;Lauantai;2;3;5
93;18.10.2014;2014;10;11;Lauantai;6;7;13
93;18.10.2014;2014;10;12;Lauantai;8;5;13
93;18.10.2014;2014;10;13;Lauantai;6;4;10
93;18.10.2014;2014;10;14;Lauantai;5;7;12
93;18.10.2014;2014;10;15;Lauantai;6;3;9
93;18.10.2014;2014;10;16;Lauantai;7;8;15
93;18.10.2014;2014;10;17;Lauantai;4;10;14
93;18.10.2014;2014;10;18;Lauantai;6;8;14
93;18.10.2014;2014;10;19;Lauantai;2;1;3
93;18.10.2014;2014;10;20;Lauantai;2;2;4
93;18.10.2014;2014;10;21;Lauantai;1;1;2
93;18.10.2014;2014;10;22;Lauantai;0;0;0
93;18.10.2014;2014;10;23;Lauantai;0;0;0
93;19.10.2014;2014;10;00;Sunnuntai;2;5;7
93;19.10.2014;2014;10;01;Sunnuntai;0;0;0
93;19.10.2014;2014;10;02;Sunnuntai;0;0;0
93;19.10.2014;2014;10;03;Sunnuntai;0;0;0
93;19.10.2014;2014;10;04;Sunnuntai;0;0;0
93;19.10.2014;2014;10;05;Sunnuntai;0;0;0
93;19.10.2014;2014;10;06;Sunnuntai;1;1;2
93;19.10.2014;2014;10;07;Sunnuntai;0;0;0
93;19.10.2014;2014;10;08;Sunnuntai;1;1;2
93;19.10.2014;2014;10;09;Sunnuntai;0;0;0
93;19.10.2014;2014;10;10;Sunnuntai;0;1;1
93;19.10.2014;2014;10;11;Sunnuntai;0;1;1
93;19.10.2014;2014;10;12;Sunnuntai;1;0;1
93;19.10.2014;2014;10;13;Sunnuntai;3;0;3
93;19.10.2014;2014;10;14;Sunnuntai;4;3;7
93;19.10.2014;2014;10;15;Sunnuntai;2;8;10
93;19.10.2014;2014;10;16;Sunnuntai;4;4;8
93;19.10.2014;2014;10;17;Sunnuntai;2;1;3
93;19.10.2014;2014;10;18;Sunnuntai;0;2;2
93;19.10.2014;2014;10;19;Sunnuntai;1;1;2
93;19.10.2014;2014;10;20;Sunnuntai;0;2;2
93;19.10.2014;2014;10;21;Sunnuntai;0;1;1
93;19.10.2014;2014;10;22;Sunnuntai;1;1;2
93;19.10.2014;2014;10;23;Sunnuntai;0;1;1
93;20.10.2014;2014;10;00;Maanantai;1;1;2
93;20.10.2014;2014;10;01;Maanantai;0;0;0
93;20.10.2014;2014;10;02;Maanantai;0;0;0
93;20.10.2014;2014;10;03;Maanantai;0;0;0
93;20.10.2014;2014;10;04;Maanantai;0;0;0
93;20.10.2014;2014;10;05;Maanantai;2;2;4
93;20.10.2014;2014;10;06;Maanantai;9;4;13
93;20.10.2014;2014;10;07;Maanantai;8;9;17
93;20.10.2014;2014;10;08;Maanantai;3;8;11
93;20.10.2014;2014;10;09;Maanantai;3;4;7
93;20.10.2014;2014;10;10;Maanantai;8;4;12
93;20.10.2014;2014;10;11;Maanantai;7;5;12
93;20.10.2014;2014;10;12;Maanantai;14;6;20
93;20.10.2014;2014;10;13;Maanantai;2;6;8
93;20.10.2014;2014;10;14;Maanantai;7;5;12
93;20.10.2014;2014;10;15;Maanantai;10;10;20
93;20.10.2014;2014;10;16;Maanantai;16;16;32
93;20.10.2014;2014;10;17;Maanantai;7;12;19
93;20.10.2014;2014;10;18;Maanantai;7;14;21
93;20.10.2014;2014;10;19;Maanantai;5;5;10
93;20.10.2014;2014;10;20;Maanantai;1;3;4
93;20.10.2014;2014;10;21;Maanantai;1;0;1
93;20.10.2014;2014;10;22;Maanantai;1;1;2
93;20.10.2014;2014;10;23;Maanantai;0;0;0
93;21.10.2014;2014;10;00;Tiistai;0;1;1
93;21.10.2014;2014;10;01;Tiistai;0;1;1
93;21.10.2014;2014;10;02;Tiistai;1;0;1
93;21.10.2014;2014;10;03;Tiistai;0;0;0
93;21.10.2014;2014;10;04;Tiistai;0;0;0
93;21.10.2014;2014;10;05;Tiistai;4;2;6
93;21.10.2014;2014;10;06;Tiistai;9;6;15
93;21.10.2014;2014;10;07;Tiistai;10;8;18
93;21.10.2014;2014;10;08;Tiistai;6;6;12
93;21.10.2014;2014;10;09;Tiistai;1;7;8
93;21.10.2014;2014;10;10;Tiistai;5;4;9
93;21.10.2014;2014;10;11;Tiistai;5;5;10
93;21.10.2014;2014;10;12;Tiistai;10;0;10
93;21.10.2014;2014;10;13;Tiistai;6;5;11
93;21.10.2014;2014;10;14;Tiistai;5;10;15
93;21.10.2014;2014;10;15;Tiistai;6;6;12
93;21.10.2014;2014;10;16;Tiistai;10;9;19
93;21.10.2014;2014;10;17;Tiistai;8;9;17
93;21.10.2014;2014;10;18;Tiistai;3;7;10
93;21.10.2014;2014;10;19;Tiistai;5;1;6
93;21.10.2014;2014;10;20;Tiistai;2;6;8
93;21.10.2014;2014;10;21;Tiistai;1;4;5
93;21.10.2014;2014;10;22;Tiistai;0;0;0
93;21.10.2014;2014;10;23;Tiistai;0;0;0
93;22.10.2014;2014;10;00;Keskiviikko;0;2;2
93;22.10.2014;2014;10;01;Keskiviikko;1;0;1
93;22.10.2014;2014;10;02;Keskiviikko;0;0;0
93;22.10.2014;2014;10;03;Keskiviikko;0;1;1
93;22.10.2014;2014;10;04;Keskiviikko;0;0;0
93;22.10.2014;2014;10;05;Keskiviikko;2;2;4
93;22.10.2014;2014;10;06;Keskiviikko;8;3;11
93;22.10.2014;2014;10;07;Keskiviikko;6;10;16
93;22.10.2014;2014;10;08;Keskiviikko;6;7;13
93;22.10.2014;2014;10;09;Keskiviikko;0;3;3
93;22.10.2014;2014;10;10;Keskiviikko;4;4;8
93;22.10.2014;2014;10;11;Keskiviikko;1;4;5
93;22.10.2014;2014;10;12;Keskiviikko;3;2;5
93;22.10.2014;2014;10;13;Keskiviikko;4;10;14
93;22.10.2014;2014;10;14;Keskiviikko;6;6;12
93;22.10.2014;2014;10;15;Keskiviikko;7;7;14
93;22.10.2014;2014;10;16;Keskiviikko;13;11;24
93;22.10.2014;2014;10;17;Keskiviikko;10;9;19
93;22.10.2014;2014;10;18;Keskiviikko;3;3;6
93;22.10.2014;2014;10;19;Keskiviikko;4;5;9
93;22.10.2014;2014;10;20;Keskiviikko;5;1;6
93;22.10.2014;2014;10;21;Keskiviikko;2;2;4
93;22.10.2014;2014;10;22;Keskiviikko;0;0;0
93;22.10.2014;2014;10;23;Keskiviikko;0;0;0
93;23.10.2014;2014;10;00;Torstai;0;2;2
93;23.10.2014;2014;10;01;Torstai;0;0;0
93;23.10.2014;2014;10;02;Torstai;0;0;0
93;23.10.2014;2014;10;03;Torstai;0;0;0
93;23.10.2014;2014;10;04;Torstai;0;0;0
93;23.10.2014;2014;10;05;Torstai;1;0;1
93;23.10.2014;2014;10;06;Torstai;6;4;10
93;23.10.2014;2014;10;07;Torstai;6;9;15
93;23.10.2014;2014;10;08;Torstai;4;9;13
93;23.10.2014;2014;10;09;Torstai;3;4;7
93;23.10.2014;2014;10;10;Torstai;2;1;3
93;23.10.2014;2014;10;11;Torstai;2;1;3
93;23.10.2014;2014;10;12;Torstai;5;4;9
93;23.10.2014;2014;10;13;Torstai;9;12;21
93;23.10.2014;2014;10;14;Torstai;4;4;8
93;23.10.2014;2014;10;15;Torstai;10;5;15
93;23.10.2014;2014;10;16;Torstai;7;11;18
93;23.10.2014;2014;10;17;Torstai;9;5;14
93;23.10.2014;2014;10;18;Torstai;10;3;13
93;23.10.2014;2014;10;19;Torstai;3;5;8
93;23.10.2014;2014;10;20;Torstai;1;1;2
93;23.10.2014;2014;10;21;Torstai;0;3;3
93;23.10.2014;2014;10;22;Torstai;1;0;1
93;23.10.2014;2014;10;23;Torstai;1;2;3
93;24.10.2014;2014;10;00;Perjantai;0;0;0
93;24.10.2014;2014;10;01;Perjantai;0;0;0
93;24.10.2014;2014;10;02;Perjantai;0;0;0
93;24.10.2014;2014;10;03;Perjantai;0;0;0
93;24.10.2014;2014;10;04;Perjantai;0;0;0
93;24.10.2014;2014;10;05;Perjantai;2;1;3
93;24.10.2014;2014;10;06;Perjantai;9;3;12
93;24.10.2014;2014;10;07;Perjantai;3;5;8
93;24.10.2014;2014;10;08;Perjantai;1;6;7
93;24.10.2014;2014;10;09;Perjantai;3;2;5
93;24.10.2014;2014;10;10;Perjantai;0;1;1
93;24.10.2014;2014;10;11;Perjantai;1;0;1
93;24.10.2014;2014;10;12;Perjantai;1;1;2
93;24.10.2014;2014;10;13;Perjantai;2;3;5
93;24.10.2014;2014;10;14;Perjantai;2;4;6
93;24.10.2014;2014;10;15;Perjantai;6;2;8
93;24.10.2014;2014;10;16;Perjantai;6;5;11
93;24.10.2014;2014;10;17;Perjantai;1;1;2
93;24.10.2014;2014;10;18;Perjantai;2;0;2
93;24.10.2014;2014;10;19;Perjantai;0;0;0
93;24.10.2014;2014;10;20;Perjantai;0;0;0
93;24.10.2014;2014;10;21;Perjantai;0;0;0
93;24.10.2014;2014;10;22;Perjantai;0;0;0
93;24.10.2014;2014;10;23;Perjantai;0;0;0
93;25.10.2014;2014;10;00;Lauantai;1;0;1
93;25.10.2014;2014;10;01;Lauantai;0;0;0
93;25.10.2014;2014;10;02;Lauantai;0;0;0
93;25.10.2014;2014;10;03;Lauantai;0;0;0
93;25.10.2014;2014;10;04;Lauantai;0;0;0
93;25.10.2014;2014;10;05;Lauantai;0;1;1
93;25.10.2014;2014;10;06;Lauantai;0;1;1
93;25.10.2014;2014;10;07;Lauantai;0;0;0
93;25.10.2014;2014;10;08;Lauantai;0;0;0
93;25.10.2014;2014;10;09;Lauantai;0;2;2
93;25.10.2014;2014;10;10;Lauantai;0;1;1
93;25.10.2014;2014;10;11;Lauantai;0;0;0
93;25.10.2014;2014;10;12;Lauantai;2;1;3
93;25.10.2014;2014;10;13;Lauantai;7;0;7
93;25.10.2014;2014;10;14;Lauantai;1;1;2
93;25.10.2014;2014;10;15;Lauantai;2;0;2
93;25.10.2014;2014;10;16;Lauantai;0;0;0
93;25.10.2014;2014;10;17;Lauantai;0;2;2
93;25.10.2014;2014;10;18;Lauantai;0;1;1
93;25.10.2014;2014;10;19;Lauantai;0;0;0
93;25.10.2014;2014;10;20;Lauantai;0;0;0
93;25.10.2014;2014;10;21;Lauantai;0;0;0
93;25.10.2014;2014;10;22;Lauantai;0;0;0
93;25.10.2014;2014;10;23;Lauantai;0;0;0
93;26.10.2014;2014;10;00;Sunnuntai;0;0;0
93;26.10.2014;2014;10;01;Sunnuntai;0;1;1
93;26.10.2014;2014;10;02;Sunnuntai;0;0;0
93;26.10.2014;2014;10;03;Sunnuntai;0;0;0
93;26.10.2014;2014;10;04;Sunnuntai;0;0;0
93;26.10.2014;2014;10;05;Sunnuntai;0;0;0
93;26.10.2014;2014;10;06;Sunnuntai;0;0;0
93;26.10.2014;2014;10;07;Sunnuntai;0;0;0
93;26.10.2014;2014;10;08;Sunnuntai;2;0;2
93;26.10.2014;2014;10;09;Sunnuntai;1;1;2
93;26.10.2014;2014;10;10;Sunnuntai;4;2;6
93;26.10.2014;2014;10;11;Sunnuntai;7;7;14
93;26.10.2014;2014;10;12;Sunnuntai;3;2;5
93;26.10.2014;2014;10;13;Sunnuntai;7;10;17
93;26.10.2014;2014;10;14;Sunnuntai;5;4;9
93;26.10.2014;2014;10;15;Sunnuntai;7;2;9
93;26.10.2014;2014;10;16;Sunnuntai;4;6;10
93;26.10.2014;2014;10;17;Sunnuntai;1;3;4
93;26.10.2014;2014;10;18;Sunnuntai;0;2;2
93;26.10.2014;2014;10;19;Sunnuntai;1;1;2
93;26.10.2014;2014;10;20;Sunnuntai;0;0;0
93;26.10.2014;2014;10;21;Sunnuntai;0;0;0
93;26.10.2014;2014;10;22;Sunnuntai;1;1;2
93;26.10.2014;2014;10;23;Sunnuntai;0;1;1
93;27.10.2014;2014;10;00;Maanantai;0;0;0
93;27.10.2014;2014;10;01;Maanantai;0;0;0
93;27.10.2014;2014;10;02;Maanantai;0;0;0
93;27.10.2014;2014;10;03;Maanantai;0;1;1
93;27.10.2014;2014;10;04;Maanantai;0;0;0
93;27.10.2014;2014;10;05;Maanantai;5;2;7
93;27.10.2014;2014;10;06;Maanantai;10;3;13
93;27.10.2014;2014;10;07;Maanantai;18;18;36
93;27.10.2014;2014;10;08;Maanantai;11;16;27
93;27.10.2014;2014;10;09;Maanantai;3;12;15
93;27.10.2014;2014;10;10;Maanantai;3;5;8
93;27.10.2014;2014;10;11;Maanantai;3;3;6
93;27.10.2014;2014;10;12;Maanantai;5;5;10
93;27.10.2014;2014;10;13;Maanantai;4;13;17
93;27.10.2014;2014;10;14;Maanantai;13;4;17
93;27.10.2014;2014;10;15;Maanantai;13;9;22
93;27.10.2014;2014;10;16;Maanantai;16;15;31
93;27.10.2014;2014;10;17;Maanantai;11;14;25
93;27.10.2014;2014;10;18;Maanantai;7;7;14
93;27.10.2014;2014;10;19;Maanantai;7;1;8
93;27.10.2014;2014;10;20;Maanantai;5;6;11
93;27.10.2014;2014;10;21;Maanantai;1;1;2
93;27.10.2014;2014;10;22;Maanantai;1;1;2
93;27.10.2014;2014;10;23;Maanantai;0;0;0
93;28.10.2014;2014;10;00;Tiistai;0;0;0
93;28.10.2014;2014;10;01;Tiistai;0;0;0
93;28.10.2014;2014;10;02;Tiistai;0;0;0
93;28.10.2014;2014;10;03;Tiistai;0;0;0
93;28.10.2014;2014;10;04;Tiistai;1;0;1
93;28.10.2014;2014;10;05;Tiistai;3;1;4
93;28.10.2014;2014;10;06;Tiistai;10;9;19
93;28.10.2014;2014;10;07;Tiistai;15;22;37
93;28.10.2014;2014;10;08;Tiistai;15;12;27
93;28.10.2014;2014;10;09;Tiistai;5;2;7
93;28.10.2014;2014;10;10;Tiistai;6;6;12
93;28.10.2014;2014;10;11;Tiistai;7;6;13
93;28.10.2014;2014;10;12;Tiistai;4;8;12
93;28.10.2014;2014;10;13;Tiistai;1;7;8
93;28.10.2014;2014;10;14;Tiistai;3;7;10
93;28.10.2014;2014;10;15;Tiistai;14;8;22
93;28.10.2014;2014;10;16;Tiistai;15;12;27
93;28.10.2014;2014;10;17;Tiistai;12;7;19
93;28.10.2014;2014;10;18;Tiistai;3;7;10
93;28.10.2014;2014;10;19;Tiistai;9;3;12
93;28.10.2014;2014;10;20;Tiistai;2;3;5
93;28.10.2014;2014;10;21;Tiistai;2;4;6
93;28.10.2014;2014;10;22;Tiistai;0;0;0
93;28.10.2014;2014;10;23;Tiistai;0;0;0
93;29.10.2014;2014;10;00;Keskiviikko;0;0;0
93;29.10.2014;2014;10;01;Keskiviikko;0;0;0
93;29.10.2014;2014;10;02;Keskiviikko;0;0;0
93;29.10.2014;2014;10;03;Keskiviikko;0;0;0
93;29.10.2014;2014;10;04;Keskiviikko;0;0;0
93;29.10.2014;2014;10;05;Keskiviikko;3;1;4
93;29.10.2014;2014;10;06;Keskiviikko;13;6;19
93;29.10.2014;2014;10;07;Keskiviikko;15;12;27
93;29.10.2014;2014;10;08;Keskiviikko;5;7;12
93;29.10.2014;2014;10;09;Keskiviikko;0;5;5
93;29.10.2014;2014;10;10;Keskiviikko;2;3;5
93;29.10.2014;2014;10;11;Keskiviikko;3;3;6
93;29.10.2014;2014;10;12;Keskiviikko;1;3;4
93;29.10.2014;2014;10;13;Keskiviikko;3;5;8
93;29.10.2014;2014;10;14;Keskiviikko;5;8;13
93;29.10.2014;2014;10;15;Keskiviikko;10;16;26
93;29.10.2014;2014;10;16;Keskiviikko;14;14;28
93;29.10.2014;2014;10;17;Keskiviikko;9;2;11
93;29.10.2014;2014;10;18;Keskiviikko;5;5;10
93;29.10.2014;2014;10;19;Keskiviikko;6;5;11
93;29.10.2014;2014;10;20;Keskiviikko;1;1;2
93;29.10.2014;2014;10;21;Keskiviikko;0;5;5
93;29.10.2014;2014;10;22;Keskiviikko;2;2;4
93;29.10.2014;2014;10;23;Keskiviikko;0;0;0
93;30.10.2014;2014;10;00;Torstai;0;0;0
93;30.10.2014;2014;10;01;Torstai;0;0;0
93;30.10.2014;2014;10;02;Torstai;0;0;0
93;30.10.2014;2014;10;03;Torstai;0;0;0
93;30.10.2014;2014;10;04;Torstai;0;0;0
93;30.10.2014;2014;10;05;Torstai;3;2;5
93;30.10.2014;2014;10;06;Torstai;9;6;15
93;30.10.2014;2014;10;07;Torstai;22;16;38
93;30.10.2014;2014;10;08;Torstai;10;17;27
93;30.10.2014;2014;10;09;Torstai;3;6;9
93;30.10.2014;2014;10;10;Torstai;5;9;14
93;30.10.2014;2014;10;11;Torstai;5;15;20
93;30.10.2014;2014;10;12;Torstai;9;4;13
93;30.10.2014;2014;10;13;Torstai;10;4;14
93;30.10.2014;2014;10;14;Torstai;10;11;21
93;30.10.2014;2014;10;15;Torstai;12;13;25
93;30.10.2014;2014;10;16;Torstai;20;14;34
93;30.10.2014;2014;10;17;Torstai;7;6;13
93;30.10.2014;2014;10;18;Torstai;7;15;22
93;30.10.2014;2014;10;19;Torstai;4;2;6
93;30.10.2014;2014;10;20;Torstai;3;3;6
93;30.10.2014;2014;10;21;Torstai;1;3;4
93;30.10.2014;2014;10;22;Torstai;2;1;3
93;30.10.2014;2014;10;23;Torstai;0;0;0
93;31.10.2014;2014;10;00;Perjantai;0;0;0
93;31.10.2014;2014;10;01;Perjantai;0;0;0
93;31.10.2014;2014;10;02;Perjantai;0;0;0
93;31.10.2014;2014;10;03;Perjantai;0;0;0
93;31.10.2014;2014;10;04;Perjantai;0;0;0
93;31.10.2014;2014;10;05;Perjantai;5;2;7
93;31.10.2014;2014;10;06;Perjantai;6;8;14
93;31.10.2014;2014;10;07;Perjantai;11;16;27
93;31.10.2014;2014;10;08;Perjantai;5;10;15
93;31.10.2014;2014;10;09;Perjantai;2;1;3
93;31.10.2014;2014;10;10;Perjantai;2;6;8
93;31.10.2014;2014;10;11;Perjantai;1;2;3
93;31.10.2014;2014;10;12;Perjantai;4;4;8
93;31.10.2014;2014;10;13;Perjantai;11;12;23
93;31.10.2014;2014;10;14;Perjantai;5;9;14
93;31.10.2014;2014;10;15;Perjantai;10;8;18
93;31.10.2014;2014;10;16;Perjantai;13;10;23
93;31.10.2014;2014;10;17;Perjantai;6;5;11
93;31.10.2014;2014;10;18;Perjantai;3;4;7
93;31.10.2014;2014;10;19;Perjantai;5;5;10
93;31.10.2014;2014;10;20;Perjantai;3;2;5
93;31.10.2014;2014;10;21;Perjantai;2;0;2
93;31.10.2014;2014;10;22;Perjantai;1;0;1
93;31.10.2014;2014;10;23;Perjantai;0;0;0
93;01.11.2014;2014;11;00;Lauantai;1;2;3
93;01.11.2014;2014;11;01;Lauantai;0;0;0
93;01.11.2014;2014;11;02;Lauantai;0;0;0
93;01.11.2014;2014;11;03;Lauantai;0;0;0
93;01.11.2014;2014;11;04;Lauantai;0;0;0
93;01.11.2014;2014;11;05;Lauantai;0;0;0
93;01.11.2014;2014;11;06;Lauantai;2;1;3
93;01.11.2014;2014;11;07;Lauantai;0;2;2
93;01.11.2014;2014;11;08;Lauantai;1;1;2
93;01.11.2014;2014;11;09;Lauantai;2;4;6
93;01.11.2014;2014;11;10;Lauantai;3;1;4
93;01.11.2014;2014;11;11;Lauantai;2;1;3
93;01.11.2014;2014;11;12;Lauantai;4;7;11
93;01.11.2014;2014;11;13;Lauantai;8;6;14
93;01.11.2014;2014;11;14;Lauantai;3;10;13
93;01.11.2014;2014;11;15;Lauantai;5;8;13
93;01.11.2014;2014;11;16;Lauantai;5;6;11
93;01.11.2014;2014;11;17;Lauantai;1;1;2
93;01.11.2014;2014;11;18;Lauantai;1;1;2
93;01.11.2014;2014;11;19;Lauantai;1;3;4
93;01.11.2014;2014;11;20;Lauantai;0;1;1
93;01.11.2014;2014;11;21;Lauantai;2;2;4
93;01.11.2014;2014;11;22;Lauantai;1;0;1
93;01.11.2014;2014;11;23;Lauantai;0;0;0
93;02.11.2014;2014;11;00;Sunnuntai;0;0;0
93;02.11.2014;2014;11;01;Sunnuntai;2;0;2
93;02.11.2014;2014;11;02;Sunnuntai;1;0;1
93;02.11.2014;2014;11;03;Sunnuntai;0;0;0
93;02.11.2014;2014;11;04;Sunnuntai;0;0;0
93;02.11.2014;2014;11;05;Sunnuntai;0;0;0
93;02.11.2014;2014;11;06;Sunnuntai;0;0;0
93;02.11.2014;2014;11;07;Sunnuntai;2;2;4
93;02.11.2014;2014;11;08;Sunnuntai;0;0;0
93;02.11.2014;2014;11;09;Sunnuntai;1;0;1
93;02.11.2014;2014;11;10;Sunnuntai;0;0;0
93;02.11.2014;2014;11;11;Sunnuntai;0;0;0
93;02.11.2014;2014;11;12;Sunnuntai;0;2;2
93;02.11.2014;2014;11;13;Sunnuntai;1;0;1
93;02.11.2014;2014;11;14;Sunnuntai;1;2;3
93;02.11.2014;2014;11;15;Sunnuntai;1;1;2
93;02.11.2014;2014;11;16;Sunnuntai;3;2;5
93;02.11.2014;2014;11;17;Sunnuntai;1;2;3
93;02.11.2014;2014;11;18;Sunnuntai;0;0;0
93;02.11.2014;2014;11;19;Sunnuntai;1;1;2
93;02.11.2014;2014;11;20;Sunnuntai;0;1;1
93;02.11.2014;2014;11;21;Sunnuntai;0;0;0
93;02.11.2014;2014;11;22;Sunnuntai;0;1;1
93;02.11.2014;2014;11;23;Sunnuntai;0;0;0
93;03.11.2014;2014;11;00;Maanantai;0;0;0
93;03.11.2014;2014;11;01;Maanantai;0;0;0
93;03.11.2014;2014;11;02;Maanantai;0;0;0
93;03.11.2014;2014;11;03;Maanantai;0;0;0
93;03.11.2014;2014;11;04;Maanantai;0;0;0
93;03.11.2014;2014;11;05;Maanantai;0;0;0
93;03.11.2014;2014;11;06;Maanantai;7;4;11
93;03.11.2014;2014;11;07;Maanantai;11;16;27
93;03.11.2014;2014;11;08;Maanantai;4;7;11
93;03.11.2014;2014;11;09;Maanantai;1;4;5
93;03.11.2014;2014;11;10;Maanantai;0;2;2
93;03.11.2014;2014;11;11;Maanantai;0;3;3
93;03.11.2014;2014;11;12;Maanantai;0;0;0
93;03.11.2014;2014;11;13;Maanantai;2;2;4
93;03.11.2014;2014;11;14;Maanantai;6;6;12
93;03.11.2014;2014;11;15;Maanantai;8;5;13
93;03.11.2014;2014;11;16;Maanantai;16;9;25
93;03.11.2014;2014;11;17;Maanantai;7;4;11
93;03.11.2014;2014;11;18;Maanantai;6;7;13
93;03.11.2014;2014;11;19;Maanantai;4;4;8
93;03.11.2014;2014;11;20;Maanantai;2;2;4
93;03.11.2014;2014;11;21;Maanantai;0;1;1
93;03.11.2014;2014;11;22;Maanantai;0;0;0
93;03.11.2014;2014;11;23;Maanantai;0;0;0
93;04.11.2014;2014;11;00;Tiistai;0;0;0
93;04.11.2014;2014;11;01;Tiistai;0;0;0
93;04.11.2014;2014;11;02;Tiistai;1;0;1
93;04.11.2014;2014;11;03;Tiistai;0;0;0
93;04.11.2014;2014;11;04;Tiistai;0;0;0
93;04.11.2014;2014;11;05;Tiistai;1;1;2
93;04.11.2014;2014;11;06;Tiistai;9;5;14
93;04.11.2014;2014;11;07;Tiistai;14;17;31
93;04.11.2014;2014;11;08;Tiistai;9;15;24
93;04.11.2014;2014;11;09;Tiistai;2;3;5
93;04.11.2014;2014;11;10;Tiistai;2;3;5
93;04.11.2014;2014;11;11;Tiistai;6;6;12
93;04.11.2014;2014;11;12;Tiistai;1;4;5
93;04.11.2014;2014;11;13;Tiistai;0;3;3
93;04.11.2014;2014;11;14;Tiistai;4;6;10
93;04.11.2014;2014;11;15;Tiistai;18;9;27
93;04.11.2014;2014;11;16;Tiistai;18;16;34
93;04.11.2014;2014;11;17;Tiistai;11;7;18
93;04.11.2014;2014;11;18;Tiistai;4;5;9
93;04.11.2014;2014;11;19;Tiistai;2;3;5
93;04.11.2014;2014;11;20;Tiistai;3;3;6
93;04.11.2014;2014;11;21;Tiistai;0;1;1
93;04.11.2014;2014;11;22;Tiistai;0;1;1
93;04.11.2014;2014;11;23;Tiistai;0;0;0
93;05.11.2014;2014;11;00;Keskiviikko;0;0;0
93;05.11.2014;2014;11;01;Keskiviikko;0;0;0
93;05.11.2014;2014;11;02;Keskiviikko;2;0;2
93;05.11.2014;2014;11;03;Keskiviikko;0;0;0
93;05.11.2014;2014;11;04;Keskiviikko;0;0;0
93;05.11.2014;2014;11;05;Keskiviikko;0;2;2
93;05.11.2014;2014;11;06;Keskiviikko;5;7;12
93;05.11.2014;2014;11;07;Keskiviikko;12;16;28
93;05.11.2014;2014;11;08;Keskiviikko;8;9;17
93;05.11.2014;2014;11;09;Keskiviikko;0;4;4
93;05.11.2014;2014;11;10;Keskiviikko;1;2;3
93;05.11.2014;2014;11;11;Keskiviikko;3;2;5
93;05.11.2014;2014;11;12;Keskiviikko;1;4;5
93;05.11.2014;2014;11;13;Keskiviikko;5;4;9
93;05.11.2014;2014;11;14;Keskiviikko;5;4;9
93;05.11.2014;2014;11;15;Keskiviikko;11;3;14
93;05.11.2014;2014;11;16;Keskiviikko;18;9;27
93;05.11.2014;2014;11;17;Keskiviikko;5;5;10
93;05.11.2014;2014;11;18;Keskiviikko;4;7;11
93;05.11.2014;2014;11;19;Keskiviikko;2;4;6
93;05.11.2014;2014;11;20;Keskiviikko;0;2;2
93;05.11.2014;2014;11;21;Keskiviikko;0;1;1
93;05.11.2014;2014;11;22;Keskiviikko;1;0;1
93;05.11.2014;2014;11;23;Keskiviikko;0;0;0
93;06.11.2014;2014;11;00;Torstai;0;0;0
93;06.11.2014;2014;11;01;Torstai;1;0;1
93;06.11.2014;2014;11;02;Torstai;0;0;0
93;06.11.2014;2014;11;03;Torstai;0;0;0
93;06.11.2014;2014;11;04;Torstai;0;0;0
93;06.11.2014;2014;11;05;Torstai;2;2;4
93;06.11.2014;2014;11;06;Torstai;4;3;7
93;06.11.2014;2014;11;07;Torstai;11;8;19
93;06.11.2014;2014;11;08;Torstai;5;9;14
93;06.11.2014;2014;11;09;Torstai;1;3;4
93;06.11.2014;2014;11;10;Torstai;0;4;4
93;06.11.2014;2014;11;11;Torstai;3;3;6
93;06.11.2014;2014;11;12;Torstai;2;1;3
93;06.11.2014;2014;11;13;Torstai;7;2;9
93;06.11.2014;2014;11;14;Torstai;4;5;9
93;06.11.2014;2014;11;15;Torstai;8;5;13
93;06.11.2014;2014;11;16;Torstai;5;8;13
93;06.11.2014;2014;11;17;Torstai;6;5;11
93;06.11.2014;2014;11;18;Torstai;3;1;4
93;06.11.2014;2014;11;19;Torstai;3;0;3
93;06.11.2014;2014;11;20;Torstai;0;1;1
93;06.11.2014;2014;11;21;Torstai;1;1;2
93;06.11.2014;2014;11;22;Torstai;1;0;1
93;06.11.2014;2014;11;23;Torstai;0;0;0
93;07.11.2014;2014;11;00;Perjantai;0;0;0
93;07.11.2014;2014;11;01;Perjantai;0;0;0
93;07.11.2014;2014;11;02;Perjantai;0;0;0
93;07.11.2014;2014;11;03;Perjantai;0;0;0
93;07.11.2014;2014;11;04;Perjantai;0;0;0
93;07.11.2014;2014;11;05;Perjantai;1;1;2
93;07.11.2014;2014;11;06;Perjantai;4;4;8
93;07.11.2014;2014;11;07;Perjantai;11;10;21
93;07.11.2014;2014;11;08;Perjantai;5;8;13
93;07.11.2014;2014;11;09;Perjantai;3;5;8
93;07.11.2014;2014;11;10;Perjantai;2;1;3
93;07.11.2014;2014;11;11;Perjantai;2;5;7
93;07.11.2014;2014;11;12;Perjantai;0;1;1
93;07.11.2014;2014;11;13;Perjantai;3;3;6
93;07.11.2014;2014;11;14;Perjantai;4;4;8
93;07.11.2014;2014;11;15;Perjantai;7;9;16
93;07.11.2014;2014;11;16;Perjantai;7;6;13
93;07.11.2014;2014;11;17;Perjantai;5;5;10
93;07.11.2014;2014;11;18;Perjantai;3;1;4
93;07.11.2014;2014;11;19;Perjantai;3;4;7
93;07.11.2014;2014;11;20;Perjantai;1;0;1
93;07.11.2014;2014;11;21;Perjantai;0;0;0
93;07.11.2014;2014;11;22;Perjantai;0;0;0
93;07.11.2014;2014;11;23;Perjantai;1;1;2
93;08.11.2014;2014;11;00;Lauantai;0;1;1
93;08.11.2014;2014;11;01;Lauantai;0;0;0
93;08.11.2014;2014;11;02;Lauantai;0;0;0
93;08.11.2014;2014;11;03;Lauantai;0;0;0
93;08.11.2014;2014;11;04;Lauantai;1;0;1
93;08.11.2014;2014;11;05;Lauantai;0;0;0
93;08.11.2014;2014;11;06;Lauantai;2;1;3
93;08.11.2014;2014;11;07;Lauantai;0;1;1
93;08.11.2014;2014;11;08;Lauantai;1;2;3
93;08.11.2014;2014;11;09;Lauantai;3;3;6
93;08.11.2014;2014;11;10;Lauantai;0;2;2
93;08.11.2014;2014;11;11;Lauantai;2;0;2
93;08.11.2014;2014;11;12;Lauantai;4;2;6
93;08.11.2014;2014;11;13;Lauantai;2;3;5
93;08.11.2014;2014;11;14;Lauantai;4;1;5
93;08.11.2014;2014;11;15;Lauantai;3;6;9
93;08.11.2014;2014;11;16;Lauantai;5;2;7
93;08.11.2014;2014;11;17;Lauantai;0;1;1
93;08.11.2014;2014;11;18;Lauantai;0;3;3
93;08.11.2014;2014;11;19;Lauantai;4;0;4
93;08.11.2014;2014;11;20;Lauantai;0;0;0
93;08.11.2014;2014;11;21;Lauantai;1;1;2
93;08.11.2014;2014;11;22;Lauantai;1;0;1
93;08.11.2014;2014;11;23;Lauantai;0;2;2
93;09.11.2014;2014;11;00;Sunnuntai;0;0;0
93;09.11.2014;2014;11;01;Sunnuntai;0;0;0
93;09.11.2014;2014;11;02;Sunnuntai;1;0;1
93;09.11.2014;2014;11;03;Sunnuntai;0;0;0
93;09.11.2014;2014;11;04;Sunnuntai;0;0;0
93;09.11.2014;2014;11;05;Sunnuntai;2;0;2
93;09.11.2014;2014;11;06;Sunnuntai;0;1;1
93;09.11.2014;2014;11;07;Sunnuntai;1;0;1
93;09.11.2014;2014;11;08;Sunnuntai;1;2;3
93;09.11.2014;2014;11;09;Sunnuntai;1;0;1
93;09.11.2014;2014;11;10;Sunnuntai;1;2;3
93;09.11.2014;2014;11;11;Sunnuntai;0;1;1
93;09.11.2014;2014;11;12;Sunnuntai;1;2;3
93;09.11.2014;2014;11;13;Sunnuntai;3;2;5
93;09.11.2014;2014;11;14;Sunnuntai;2;3;5
93;09.11.2014;2014;11;15;Sunnuntai;1;0;1
93;09.11.2014;2014;11;16;Sunnuntai;1;6;7
93;09.11.2014;2014;11;17;Sunnuntai;1;1;2
93;09.11.2014;2014;11;18;Sunnuntai;3;2;5
93;09.11.2014;2014;11;19;Sunnuntai;0;0;0
93;09.11.2014;2014;11;20;Sunnuntai;2;3;5
93;09.11.2014;2014;11;21;Sunnuntai;2;1;3
93;09.11.2014;2014;11;22;Sunnuntai;1;0;1
93;09.11.2014;2014;11;23;Sunnuntai;1;0;1
93;10.11.2014;2014;11;00;Maanantai;0;1;1
93;10.11.2014;2014;11;01;Maanantai;0;0;0
93;10.11.2014;2014;11;02;Maanantai;0;0;0
93;10.11.2014;2014;11;03;Maanantai;0;0;0
93;10.11.2014;2014;11;04;Maanantai;0;1;1
93;10.11.2014;2014;11;05;Maanantai;2;2;4
93;10.11.2014;2014;11;06;Maanantai;13;6;19
93;10.11.2014;2014;11;07;Maanantai;13;10;23
93;10.11.2014;2014;11;08;Maanantai;10;12;22
93;10.11.2014;2014;11;09;Maanantai;2;4;6
93;10.11.2014;2014;11;10;Maanantai;2;6;8
93;10.11.2014;2014;11;11;Maanantai;2;4;6
93;10.11.2014;2014;11;12;Maanantai;2;5;7
93;10.11.2014;2014;11;13;Maanantai;4;9;13
93;10.11.2014;2014;11;14;Maanantai;4;9;13
93;10.11.2014;2014;11;15;Maanantai;12;9;21
93;10.11.2014;2014;11;16;Maanantai;12;11;23
93;10.11.2014;2014;11;17;Maanantai;8;9;17
93;10.11.2014;2014;11;18;Maanantai;4;5;9
93;10.11.2014;2014;11;19;Maanantai;3;3;6
93;10.11.2014;2014;11;20;Maanantai;0;2;2
93;10.11.2014;2014;11;21;Maanantai;1;0;1
93;10.11.2014;2014;11;22;Maanantai;1;0;1
93;10.11.2014;2014;11;23;Maanantai;0;1;1
93;11.11.2014;2014;11;00;Tiistai;0;0;0
93;11.11.2014;2014;11;01;Tiistai;0;0;0
93;11.11.2014;2014;11;02;Tiistai;0;0;0
93;11.11.2014;2014;11;03;Tiistai;0;0;0
93;11.11.2014;2014;11;04;Tiistai;0;0;0
93;11.11.2014;2014;11;05;Tiistai;2;2;4
93;11.11.2014;2014;11;06;Tiistai;3;7;10
93;11.11.2014;2014;11;07;Tiistai;9;7;16
93;11.11.2014;2014;11;08;Tiistai;1;9;10
93;11.11.2014;2014;11;09;Tiistai;0;2;2
93;11.11.2014;2014;11;10;Tiistai;0;1;1
93;11.11.2014;2014;11;11;Tiistai;0;1;1
93;11.11.2014;2014;11;12;Tiistai;0;3;3
93;11.11.2014;2014;11;13;Tiistai;0;2;2
93;11.11.2014;2014;11;14;Tiistai;2;1;3
93;11.11.2014;2014;11;15;Tiistai;11;6;17
93;11.11.2014;2014;11;16;Tiistai;12;6;18
93;11.11.2014;2014;11;17;Tiistai;12;3;15
93;11.11.2014;2014;11;18;Tiistai;0;4;4
93;11.11.2014;2014;11;19;Tiistai;2;2;4
93;11.11.2014;2014;11;20;Tiistai;7;5;12
93;11.11.2014;2014;11;21;Tiistai;2;1;3
93;11.11.2014;2014;11;22;Tiistai;2;1;3
93;11.11.2014;2014;11;23;Tiistai;0;0;0
93;12.11.2014;2014;11;00;Keskiviikko;0;1;1
93;12.11.2014;2014;11;01;Keskiviikko;0;0;0
93;12.11.2014;2014;11;02;Keskiviikko;0;0;0
93;12.11.2014;2014;11;03;Keskiviikko;0;0;0
93;12.11.2014;2014;11;04;Keskiviikko;0;0;0
93;12.11.2014;2014;11;05;Keskiviikko;3;1;4
93;12.11.2014;2014;11;06;Keskiviikko;12;7;19
93;12.11.2014;2014;11;07;Keskiviikko;8;16;24
93;12.11.2014;2014;11;08;Keskiviikko;8;8;16
93;12.11.2014;2014;11;09;Keskiviikko;5;7;12
93;12.11.2014;2014;11;10;Keskiviikko;2;6;8
93;12.11.2014;2014;11;11;Keskiviikko;4;7;11
93;12.11.2014;2014;11;12;Keskiviikko;5;1;6
93;12.11.2014;2014;11;13;Keskiviikko;5;6;11
93;12.11.2014;2014;11;14;Keskiviikko;5;5;10
93;12.11.2014;2014;11;15;Keskiviikko;14;5;19
93;12.11.2014;2014;11;16;Keskiviikko;14;13;27
93;12.11.2014;2014;11;17;Keskiviikko;9;8;17
93;12.11.2014;2014;11;18;Keskiviikko;4;3;7
93;12.11.2014;2014;11;19;Keskiviikko;4;2;6
93;12.11.2014;2014;11;20;Keskiviikko;4;1;5
93;12.11.2014;2014;11;21;Keskiviikko;2;1;3
93;12.11.2014;2014;11;22;Keskiviikko;2;0;2
93;12.11.2014;2014;11;23;Keskiviikko;0;0;0
93;13.11.2014;2014;11;00;Torstai;0;1;1
93;13.11.2014;2014;11;01;Torstai;0;0;0
93;13.11.2014;2014;11;02;Torstai;0;0;0
93;13.11.2014;2014;11;03;Torstai;0;0;0
93;13.11.2014;2014;11;04;Torstai;0;0;0
93;13.11.2014;2014;11;05;Torstai;0;4;4
93;13.11.2014;2014;11;06;Torstai;12;7;19
93;13.11.2014;2014;11;07;Torstai;15;12;27
93;13.11.2014;2014;11;08;Torstai;2;13;15
93;13.11.2014;2014;11;09;Torstai;5;6;11
93;13.11.2014;2014;11;10;Torstai;4;3;7
93;13.11.2014;2014;11;11;Torstai;4;4;8
93;13.11.2014;2014;11;12;Torstai;2;2;4
93;13.11.2014;2014;11;13;Torstai;5;5;10
93;13.11.2014;2014;11;14;Torstai;5;9;14
93;13.11.2014;2014;11;15;Torstai;11;10;21
93;13.11.2014;2014;11;16;Torstai;17;16;33
93;13.11.2014;2014;11;17;Torstai;6;7;13
93;13.11.2014;2014;11;18;Torstai;5;6;11
93;13.11.2014;2014;11;19;Torstai;2;3;5
93;13.11.2014;2014;11;20;Torstai;4;1;5
93;13.11.2014;2014;11;21;Torstai;0;1;1
93;13.11.2014;2014;11;22;Torstai;2;0;2
93;13.11.2014;2014;11;23;Torstai;0;0;0
93;14.11.2014;2014;11;00;Perjantai;0;1;1
93;14.11.2014;2014;11;01;Perjantai;0;0;0
93;14.11.2014;2014;11;02;Perjantai;0;0;0
93;14.11.2014;2014;11;03;Perjantai;0;0;0
93;14.11.2014;2014;11;04;Perjantai;0;0;0
93;14.11.2014;2014;11;05;Perjantai;2;3;5
93;14.11.2014;2014;11;06;Perjantai;7;5;12
93;14.11.2014;2014;11;07;Perjantai;9;13;22
93;14.11.2014;2014;11;08;Perjantai;5;8;13
93;14.11.2014;2014;11;09;Perjantai;1;2;3
93;14.11.2014;2014;11;10;Perjantai;3;5;8
93;14.11.2014;2014;11;11;Perjantai;4;2;6
93;14.11.2014;2014;11;12;Perjantai;1;5;6
93;14.11.2014;2014;11;13;Perjantai;9;4;13
93;14.11.2014;2014;11;14;Perjantai;4;6;10
93;14.11.2014;2014;11;15;Perjantai;12;10;22
93;14.11.2014;2014;11;16;Perjantai;7;14;21
93;14.11.2014;2014;11;17;Perjantai;1;3;4
93;14.11.2014;2014;11;18;Perjantai;2;3;5
93;14.11.2014;2014;11;19;Perjantai;3;3;6
93;14.11.2014;2014;11;20;Perjantai;2;2;4
93;14.11.2014;2014;11;21;Perjantai;1;0;1
93;14.11.2014;2014;11;22;Perjantai;0;2;2
93;14.11.2014;2014;11;23;Perjantai;1;0;1
93;15.11.2014;2014;11;00;Lauantai;0;0;0
93;15.11.2014;2014;11;01;Lauantai;0;0;0
93;15.11.2014;2014;11;02;Lauantai;0;0;0
93;15.11.2014;2014;11;03;Lauantai;1;1;2
93;15.11.2014;2014;11;04;Lauantai;0;0;0
93;15.11.2014;2014;11;05;Lauantai;2;1;3
93;15.11.2014;2014;11;06;Lauantai;0;1;1
93;15.11.2014;2014;11;07;Lauantai;0;1;1
93;15.11.2014;2014;11;08;Lauantai;0;2;2
93;15.11.2014;2014;11;09;Lauantai;2;3;5
93;15.11.2014;2014;11;10;Lauantai;0;2;2
93;15.11.2014;2014;11;11;Lauantai;4;5;9
93;15.11.2014;2014;11;12;Lauantai;3;1;4
93;15.11.2014;2014;11;13;Lauantai;2;7;9
93;15.11.2014;2014;11;14;Lauantai;1;5;6
93;15.11.2014;2014;11;15;Lauantai;7;6;13
93;15.11.2014;2014;11;16;Lauantai;3;1;4
93;15.11.2014;2014;11;17;Lauantai;7;3;10
93;15.11.2014;2014;11;18;Lauantai;2;2;4
93;15.11.2014;2014;11;19;Lauantai;1;0;1
93;15.11.2014;2014;11;20;Lauantai;0;1;1
93;15.11.2014;2014;11;21;Lauantai;4;0;4
93;15.11.2014;2014;11;22;Lauantai;0;1;1
93;15.11.2014;2014;11;23;Lauantai;1;0;1
93;16.11.2014;2014;11;00;Sunnuntai;1;1;2
93;16.11.2014;2014;11;01;Sunnuntai;0;0;0
93;16.11.2014;2014;11;02;Sunnuntai;1;0;1
93;16.11.2014;2014;11;03;Sunnuntai;0;1;1
93;16.11.2014;2014;11;04;Sunnuntai;0;0;0
93;16.11.2014;2014;11;05;Sunnuntai;1;0;1
93;16.11.2014;2014;11;06;Sunnuntai;0;2;2
93;16.11.2014;2014;11;07;Sunnuntai;5;1;6
93;16.11.2014;2014;11;08;Sunnuntai;0;0;0
93;16.11.2014;2014;11;09;Sunnuntai;4;1;5
93;16.11.2014;2014;11;10;Sunnuntai;3;2;5
93;16.11.2014;2014;11;11;Sunnuntai;3;2;5
93;16.11.2014;2014;11;12;Sunnuntai;2;5;7
93;16.11.2014;2014;11;13;Sunnuntai;3;6;9
93;16.11.2014;2014;11;14;Sunnuntai;5;5;10
93;16.11.2014;2014;11;15;Sunnuntai;1;6;7
93;16.11.2014;2014;11;16;Sunnuntai;4;7;11
93;16.11.2014;2014;11;17;Sunnuntai;0;4;4
93;16.11.2014;2014;11;18;Sunnuntai;1;4;5
93;16.11.2014;2014;11;19;Sunnuntai;1;3;4
93;16.11.2014;2014;11;20;Sunnuntai;4;0;4
93;16.11.2014;2014;11;21;Sunnuntai;1;0;1
93;16.11.2014;2014;11;22;Sunnuntai;1;2;3
93;16.11.2014;2014;11;23;Sunnuntai;0;0;0
93;17.11.2014;2014;11;00;Maanantai;0;0;0
93;17.11.2014;2014;11;01;Maanantai;0;0;0
93;17.11.2014;2014;11;02;Maanantai;0;0;0
93;17.11.2014;2014;11;03;Maanantai;0;0;0
93;17.11.2014;2014;11;04;Maanantai;0;0;0
93;17.11.2014;2014;11;05;Maanantai;0;2;2
93;17.11.2014;2014;11;06;Maanantai;6;9;15
93;17.11.2014;2014;11;07;Maanantai;12;12;24
93;17.11.2014;2014;11;08;Maanantai;4;10;14
93;17.11.2014;2014;11;09;Maanantai;2;4;6
93;17.11.2014;2014;11;10;Maanantai;2;3;5
93;17.11.2014;2014;11;11;Maanantai;1;0;1
93;17.11.2014;2014;11;12;Maanantai;5;1;6
93;17.11.2014;2014;11;13;Maanantai;3;4;7
93;17.11.2014;2014;11;14;Maanantai;4;3;7
93;17.11.2014;2014;11;15;Maanantai;9;4;13
93;17.11.2014;2014;11;16;Maanantai;14;16;30
93;17.11.2014;2014;11;17;Maanantai;6;9;15
93;17.11.2014;2014;11;18;Maanantai;2;7;9
93;17.11.2014;2014;11;19;Maanantai;2;1;3
93;17.11.2014;2014;11;20;Maanantai;0;2;2
93;17.11.2014;2014;11;21;Maanantai;1;0;1
93;17.11.2014;2014;11;22;Maanantai;0;2;2
93;17.11.2014;2014;11;23;Maanantai;0;0;0
93;18.11.2014;2014;11;00;Tiistai;0;0;0
93;18.11.2014;2014;11;01;Tiistai;0;0;0
93;18.11.2014;2014;11;02;Tiistai;0;0;0
93;18.11.2014;2014;11;03;Tiistai;0;0;0
93;18.11.2014;2014;11;04;Tiistai;0;0;0
93;18.11.2014;2014;11;05;Tiistai;1;1;2
93;18.11.2014;2014;11;06;Tiistai;5;8;13
93;18.11.2014;2014;11;07;Tiistai;14;13;27
93;18.11.2014;2014;11;08;Tiistai;8;9;17
93;18.11.2014;2014;11;09;Tiistai;1;2;3
93;18.11.2014;2014;11;10;Tiistai;4;6;10
93;18.11.2014;2014;11;11;Tiistai;3;2;5
93;18.11.2014;2014;11;12;Tiistai;3;2;5
93;18.11.2014;2014;11;13;Tiistai;5;1;6
93;18.11.2014;2014;11;14;Tiistai;2;3;5
93;18.11.2014;2014;11;15;Tiistai;10;9;19
93;18.11.2014;2014;11;16;Tiistai;16;10;26
93;18.11.2014;2014;11;17;Tiistai;3;5;8
93;18.11.2014;2014;11;18;Tiistai;4;7;11
93;18.11.2014;2014;11;19;Tiistai;4;2;6
93;18.11.2014;2014;11;20;Tiistai;3;4;7
93;18.11.2014;2014;11;21;Tiistai;2;1;3
93;18.11.2014;2014;11;22;Tiistai;1;0;1
93;18.11.2014;2014;11;23;Tiistai;0;2;2
93;19.11.2014;2014;11;00;Keskiviikko;0;0;0
93;19.11.2014;2014;11;01;Keskiviikko;0;0;0
93;19.11.2014;2014;11;02;Keskiviikko;1;0;1
93;19.11.2014;2014;11;03;Keskiviikko;0;0;0
93;19.11.2014;2014;11;04;Keskiviikko;0;0;0
93;19.11.2014;2014;11;05;Keskiviikko;2;2;4
93;19.11.2014;2014;11;06;Keskiviikko;9;5;14
93;19.11.2014;2014;11;07;Keskiviikko;13;12;25
93;19.11.2014;2014;11;08;Keskiviikko;7;12;19
93;19.11.2014;2014;11;09;Keskiviikko;0;6;6
93;19.11.2014;2014;11;10;Keskiviikko;7;8;15
93;19.11.2014;2014;11;11;Keskiviikko;5;1;6
93;19.11.2014;2014;11;12;Keskiviikko;4;5;9
93;19.11.2014;2014;11;13;Keskiviikko;2;5;7
93;19.11.2014;2014;11;14;Keskiviikko;6;2;8
93;19.11.2014;2014;11;15;Keskiviikko;14;11;25
93;19.11.2014;2014;11;16;Keskiviikko;14;10;24
93;19.11.2014;2014;11;17;Keskiviikko;5;7;12
93;19.11.2014;2014;11;18;Keskiviikko;2;4;6
93;19.11.2014;2014;11;19;Keskiviikko;4;5;9
93;19.11.2014;2014;11;20;Keskiviikko;1;7;8
93;19.11.2014;2014;11;21;Keskiviikko;0;4;4
93;19.11.2014;2014;11;22;Keskiviikko;1;2;3
93;19.11.2014;2014;11;23;Keskiviikko;1;0;1
93;20.11.2014;2014;11;00;Torstai;0;0;0
93;20.11.2014;2014;11;01;Torstai;1;0;1
93;20.11.2014;2014;11;02;Torstai;1;0;1
93;20.11.2014;2014;11;03;Torstai;0;0;0
93;20.11.2014;2014;11;04;Torstai;0;0;0
93;20.11.2014;2014;11;05;Torstai;0;2;2
93;20.11.2014;2014;11;06;Torstai;8;6;14
93;20.11.2014;2014;11;07;Torstai;16;16;32
93;20.11.2014;2014;11;08;Torstai;12;8;20
93;20.11.2014;2014;11;09;Torstai;1;3;4
93;20.11.2014;2014;11;10;Torstai;6;4;10
93;20.11.2014;2014;11;11;Torstai;4;6;10
93;20.11.2014;2014;11;12;Torstai;1;5;6
93;20.11.2014;2014;11;13;Torstai;5;5;10
93;20.11.2014;2014;11;14;Torstai;3;5;8
93;20.11.2014;2014;11;15;Torstai;15;8;23
93;20.11.2014;2014;11;16;Torstai;13;15;28
93;20.11.2014;2014;11;17;Torstai;4;6;10
93;20.11.2014;2014;11;18;Torstai;4;5;9
93;20.11.2014;2014;11;19;Torstai;5;3;8
93;20.11.2014;2014;11;20;Torstai;1;1;2
93;20.11.2014;2014;11;21;Torstai;2;0;2
93;20.11.2014;2014;11;22;Torstai;0;1;1
93;20.11.2014;2014;11;23;Torstai;0;0;0
93;21.11.2014;2014;11;00;Perjantai;1;0;1
93;21.11.2014;2014;11;01;Perjantai;0;0;0
93;21.11.2014;2014;11;02;Perjantai;0;0;0
93;21.11.2014;2014;11;03;Perjantai;0;0;0
93;21.11.2014;2014;11;04;Perjantai;0;1;1
93;21.11.2014;2014;11;05;Perjantai;1;2;3
93;21.11.2014;2014;11;06;Perjantai;6;3;9
93;21.11.2014;2014;11;07;Perjantai;8;10;18
93;21.11.2014;2014;11;08;Perjantai;5;7;12
93;21.11.2014;2014;11;09;Perjantai;1;5;6
93;21.11.2014;2014;11;10;Perjantai;1;1;2
93;21.11.2014;2014;11;11;Perjantai;2;2;4
93;21.11.2014;2014;11;12;Perjantai;2;1;3
93;21.11.2014;2014;11;13;Perjantai;10;6;16
93;21.11.2014;2014;11;14;Perjantai;2;5;7
93;21.11.2014;2014;11;15;Perjantai;8;5;13
93;21.11.2014;2014;11;16;Perjantai;7;8;15
93;21.11.2014;2014;11;17;Perjantai;7;7;14
93;21.11.2014;2014;11;18;Perjantai;4;4;8
93;21.11.2014;2014;11;19;Perjantai;1;2;3
93;21.11.2014;2014;11;20;Perjantai;1;0;1
93;21.11.2014;2014;11;21;Perjantai;3;1;4
93;21.11.2014;2014;11;22;Perjantai;0;0;0
93;21.11.2014;2014;11;23;Perjantai;0;0;0
93;22.11.2014;2014;11;00;Lauantai;0;0;0
93;22.11.2014;2014;11;01;Lauantai;1;1;2
93;22.11.2014;2014;11;02;Lauantai;0;2;2
93;22.11.2014;2014;11;03;Lauantai;0;1;1
93;22.11.2014;2014;11;04;Lauantai;0;0;0
93;22.11.2014;2014;11;05;Lauantai;0;0;0
93;22.11.2014;2014;11;06;Lauantai;0;1;1
93;22.11.2014;2014;11;07;Lauantai;1;0;1
93;22.11.2014;2014;11;08;Lauantai;2;1;3
93;22.11.2014;2014;11;09;Lauantai;1;3;4
93;22.11.2014;2014;11;10;Lauantai;1;1;2
93;22.11.2014;2014;11;11;Lauantai;6;4;10
93;22.11.2014;2014;11;12;Lauantai;7;0;7
93;22.11.2014;2014;11;13;Lauantai;4;7;11
93;22.11.2014;2014;11;14;Lauantai;0;5;5
93;22.11.2014;2014;11;15;Lauantai;2;3;5
93;22.11.2014;2014;11;16;Lauantai;2;5;7
93;22.11.2014;2014;11;17;Lauantai;0;5;5
93;22.11.2014;2014;11;18;Lauantai;2;2;4
93;22.11.2014;2014;11;19;Lauantai;0;0;0
93;22.11.2014;2014;11;20;Lauantai;4;0;4
93;22.11.2014;2014;11;21;Lauantai;0;0;0
93;22.11.2014;2014;11;22;Lauantai;0;0;0
93;22.11.2014;2014;11;23;Lauantai;0;0;0
93;23.11.2014;2014;11;00;Sunnuntai;1;1;2
93;23.11.2014;2014;11;01;Sunnuntai;0;0;0
93;23.11.2014;2014;11;02;Sunnuntai;0;1;1
93;23.11.2014;2014;11;03;Sunnuntai;0;0;0
93;23.11.2014;2014;11;04;Sunnuntai;0;1;1
93;23.11.2014;2014;11;05;Sunnuntai;2;0;2
93;23.11.2014;2014;11;06;Sunnuntai;1;0;1
93;23.11.2014;2014;11;07;Sunnuntai;4;0;4
93;23.11.2014;2014;11;08;Sunnuntai;1;0;1
93;23.11.2014;2014;11;09;Sunnuntai;2;0;2
93;23.11.2014;2014;11;10;Sunnuntai;1;0;1
93;23.11.2014;2014;11;11;Sunnuntai;2;5;7
93;23.11.2014;2014;11;12;Sunnuntai;2;4;6
93;23.11.2014;2014;11;13;Sunnuntai;5;8;13
93;23.11.2014;2014;11;14;Sunnuntai;0;3;3
93;23.11.2014;2014;11;15;Sunnuntai;4;3;7
93;23.11.2014;2014;11;16;Sunnuntai;0;5;5
93;23.11.2014;2014;11;17;Sunnuntai;1;3;4
93;23.11.2014;2014;11;18;Sunnuntai;3;3;6
93;23.11.2014;2014;11;19;Sunnuntai;0;4;4
93;23.11.2014;2014;11;20;Sunnuntai;1;1;2
93;23.11.2014;2014;11;21;Sunnuntai;0;2;2
93;23.11.2014;2014;11;22;Sunnuntai;1;0;1
93;23.11.2014;2014;11;23;Sunnuntai;0;0;0
93;24.11.2014;2014;11;00;Maanantai;0;0;0
93;24.11.2014;2014;11;01;Maanantai;0;0;0
93;24.11.2014;2014;11;02;Maanantai;0;0;0
93;24.11.2014;2014;11;03;Maanantai;0;0;0
93;24.11.2014;2014;11;04;Maanantai;0;0;0
93;24.11.2014;2014;11;05;Maanantai;2;1;3
93;24.11.2014;2014;11;06;Maanantai;9;2;11
93;24.11.2014;2014;11;07;Maanantai;10;16;26
93;24.11.2014;2014;11;08;Maanantai;10;17;27
93;24.11.2014;2014;11;09;Maanantai;1;5;6
93;24.11.2014;2014;11;10;Maanantai;4;2;6
93;24.11.2014;2014;11;11;Maanantai;3;0;3
93;24.11.2014;2014;11;12;Maanantai;2;3;5
93;24.11.2014;2014;11;13;Maanantai;2;2;4
93;24.11.2014;2014;11;14;Maanantai;5;4;9
93;24.11.2014;2014;11;15;Maanantai;6;10;16
93;24.11.2014;2014;11;16;Maanantai;16;14;30
93;24.11.2014;2014;11;17;Maanantai;9;8;17
93;24.11.2014;2014;11;18;Maanantai;5;6;11
93;24.11.2014;2014;11;19;Maanantai;0;2;2
93;24.11.2014;2014;11;20;Maanantai;4;2;6
93;24.11.2014;2014;11;21;Maanantai;1;3;4
93;24.11.2014;2014;11;22;Maanantai;1;0;1
93;24.11.2014;2014;11;23;Maanantai;0;0;0
93;25.11.2014;2014;11;00;Tiistai;0;0;0
93;25.11.2014;2014;11;01;Tiistai;1;0;1
93;25.11.2014;2014;11;02;Tiistai;0;0;0
93;25.11.2014;2014;11;03;Tiistai;0;0;0
93;25.11.2014;2014;11;04;Tiistai;1;0;1
93;25.11.2014;2014;11;05;Tiistai;2;1;3
93;25.11.2014;2014;11;06;Tiistai;5;3;8
93;25.11.2014;2014;11;07;Tiistai;11;7;18
93;25.11.2014;2014;11;08;Tiistai;8;11;19
93;25.11.2014;2014;11;09;Tiistai;2;4;6
93;25.11.2014;2014;11;10;Tiistai;3;4;7
93;25.11.2014;2014;11;11;Tiistai;0;2;2
93;25.11.2014;2014;11;12;Tiistai;0;3;3
93;25.11.2014;2014;11;13;Tiistai;3;0;3
93;25.11.2014;2014;11;14;Tiistai;2;6;8
93;25.11.2014;2014;11;15;Tiistai;13;12;25
93;25.11.2014;2014;11;16;Tiistai;12;15;27
93;25.11.2014;2014;11;17;Tiistai;9;4;13
93;25.11.2014;2014;11;18;Tiistai;3;2;5
93;25.11.2014;2014;11;19;Tiistai;0;2;2
93;25.11.2014;2014;11;20;Tiistai;6;2;8
93;25.11.2014;2014;11;21;Tiistai;0;0;0
93;25.11.2014;2014;11;22;Tiistai;0;0;0
93;25.11.2014;2014;11;23;Tiistai;0;0;0
93;26.11.2014;2014;11;00;Keskiviikko;0;0;0
93;26.11.2014;2014;11;01;Keskiviikko;1;0;1
93;26.11.2014;2014;11;02;Keskiviikko;0;0;0
93;26.11.2014;2014;11;03;Keskiviikko;0;0;0
93;26.11.2014;2014;11;04;Keskiviikko;1;0;1
93;26.11.2014;2014;11;05;Keskiviikko;5;1;6
93;26.11.2014;2014;11;06;Keskiviikko;6;4;10
93;26.11.2014;2014;11;07;Keskiviikko;12;13;25
93;26.11.2014;2014;11;08;Keskiviikko;8;5;13
93;26.11.2014;2014;11;09;Keskiviikko;3;5;8
93;26.11.2014;2014;11;10;Keskiviikko;3;3;6
93;26.11.2014;2014;11;11;Keskiviikko;4;1;5
93;26.11.2014;2014;11;12;Keskiviikko;2;4;6
93;26.11.2014;2014;11;13;Keskiviikko;1;3;4
93;26.11.2014;2014;11;14;Keskiviikko;4;5;9
93;26.11.2014;2014;11;15;Keskiviikko;6;7;13
93;26.11.2014;2014;11;16;Keskiviikko;9;12;21
93;26.11.2014;2014;11;17;Keskiviikko;9;9;18
93;26.11.2014;2014;11;18;Keskiviikko;4;11;15
93;26.11.2014;2014;11;19;Keskiviikko;2;2;4
93;26.11.2014;2014;11;20;Keskiviikko;2;1;3
93;26.11.2014;2014;11;21;Keskiviikko;1;1;2
93;26.11.2014;2014;11;22;Keskiviikko;0;1;1
93;26.11.2014;2014;11;23;Keskiviikko;2;1;3
93;27.11.2014;2014;11;00;Torstai;0;0;0
93;27.11.2014;2014;11;01;Torstai;0;0;0
93;27.11.2014;2014;11;02;Torstai;0;0;0
93;27.11.2014;2014;11;03;Torstai;0;0;0
93;27.11.2014;2014;11;04;Torstai;1;0;1
93;27.11.2014;2014;11;05;Torstai;2;1;3
93;27.11.2014;2014;11;06;Torstai;10;4;14
93;27.11.2014;2014;11;07;Torstai;10;12;22
93;27.11.2014;2014;11;08;Torstai;5;10;15
93;27.11.2014;2014;11;09;Torstai;5;7;12
93;27.11.2014;2014;11;10;Torstai;3;1;4
93;27.11.2014;2014;11;11;Torstai;4;3;7
93;27.11.2014;2014;11;12;Torstai;3;4;7
93;27.11.2014;2014;11;13;Torstai;2;4;6
93;27.11.2014;2014;11;14;Torstai;4;4;8
93;27.11.2014;2014;11;15;Torstai;10;8;18
93;27.11.2014;2014;11;16;Torstai;15;8;23
93;27.11.2014;2014;11;17;Torstai;6;8;14
93;27.11.2014;2014;11;18;Torstai;3;4;7
93;27.11.2014;2014;11;19;Torstai;1;2;3
93;27.11.2014;2014;11;20;Torstai;1;1;2
93;27.11.2014;2014;11;21;Torstai;0;0;0
93;27.11.2014;2014;11;22;Torstai;0;0;0
93;27.11.2014;2014;11;23;Torstai;1;1;2
93;28.11.2014;2014;11;00;Perjantai;0;1;1
93;28.11.2014;2014;11;01;Perjantai;0;0;0
93;28.11.2014;2014;11;02;Perjantai;0;0;0
93;28.11.2014;2014;11;03;Perjantai;0;0;0
93;28.11.2014;2014;11;04;Perjantai;0;0;0
93;28.11.2014;2014;11;05;Perjantai;2;1;3
93;28.11.2014;2014;11;06;Perjantai;6;7;13
93;28.11.2014;2014;11;07;Perjantai;8;16;24
93;28.11.2014;2014;11;08;Perjantai;3;5;8
93;28.11.2014;2014;11;09;Perjantai;0;2;2
93;28.11.2014;2014;11;10;Perjantai;2;5;7
93;28.11.2014;2014;11;11;Perjantai;2;0;2
93;28.11.2014;2014;11;12;Perjantai;3;2;5
93;28.11.2014;2014;11;13;Perjantai;5;4;9
93;28.11.2014;2014;11;14;Perjantai;5;8;13
93;28.11.2014;2014;11;15;Perjantai;8;5;13
93;28.11.2014;2014;11;16;Perjantai;11;4;15
93;28.11.2014;2014;11;17;Perjantai;3;4;7
93;28.11.2014;2014;11;18;Perjantai;3;3;6
93;28.11.2014;2014;11;19;Perjantai;2;1;3
93;28.11.2014;2014;11;20;Perjantai;2;4;6
93;28.11.2014;2014;11;21;Perjantai;0;0;0
93;28.11.2014;2014;11;22;Perjantai;1;1;2
93;28.11.2014;2014;11;23;Perjantai;3;0;3
93;29.11.2014;2014;11;00;Lauantai;0;0;0
93;29.11.2014;2014;11;01;Lauantai;0;1;1
93;29.11.2014;2014;11;02;Lauantai;0;0;0
93;29.11.2014;2014;11;03;Lauantai;0;0;0
93;29.11.2014;2014;11;04;Lauantai;0;0;0
93;29.11.2014;2014;11;05;Lauantai;0;1;1
93;29.11.2014;2014;11;06;Lauantai;1;0;1
93;29.11.2014;2014;11;07;Lauantai;0;1;1
93;29.11.2014;2014;11;08;Lauantai;4;3;7
93;29.11.2014;2014;11;09;Lauantai;2;5;7
93;29.11.2014;2014;11;10;Lauantai;1;2;3
93;29.11.2014;2014;11;11;Lauantai;3;4;7
93;29.11.2014;2014;11;12;Lauantai;4;3;7
93;29.11.2014;2014;11;13;Lauantai;6;4;10
93;29.11.2014;2014;11;14;Lauantai;5;7;12
93;29.11.2014;2014;11;15;Lauantai;4;5;9
93;29.11.2014;2014;11;16;Lauantai;7;4;11
93;29.11.2014;2014;11;17;Lauantai;4;2;6
93;29.11.2014;2014;11;18;Lauantai;0;2;2
93;29.11.2014;2014;11;19;Lauantai;0;2;2
93;29.11.2014;2014;11;20;Lauantai;2;0;2
93;29.11.2014;2014;11;21;Lauantai;2;2;4
93;29.11.2014;2014;11;22;Lauantai;0;1;1
93;29.11.2014;2014;11;23;Lauantai;0;0;0
93;30.11.2014;2014;11;00;Sunnuntai;0;0;0
93;30.11.2014;2014;11;01;Sunnuntai;0;1;1
93;30.11.2014;2014;11;02;Sunnuntai;0;0;0
93;30.11.2014;2014;11;03;Sunnuntai;0;0;0
93;30.11.2014;2014;11;04;Sunnuntai;0;0;0
93;30.11.2014;2014;11;05;Sunnuntai;1;0;1
93;30.11.2014;2014;11;06;Sunnuntai;1;2;3
93;30.11.2014;2014;11;07;Sunnuntai;3;1;4
93;30.11.2014;2014;11;08;Sunnuntai;0;1;1
93;30.11.2014;2014;11;09;Sunnuntai;1;2;3
93;30.11.2014;2014;11;10;Sunnuntai;1;3;4
93;30.11.2014;2014;11;11;Sunnuntai;14;3;17
93;30.11.2014;2014;11;12;Sunnuntai;3;3;6
93;30.11.2014;2014;11;13;Sunnuntai;6;4;10
93;30.11.2014;2014;11;14;Sunnuntai;6;6;12
93;30.11.2014;2014;11;15;Sunnuntai;5;6;11
93;30.11.2014;2014;11;16;Sunnuntai;5;3;8
93;30.11.2014;2014;11;17;Sunnuntai;2;1;3
93;30.11.2014;2014;11;18;Sunnuntai;1;2;3
93;30.11.2014;2014;11;19;Sunnuntai;4;3;7
93;30.11.2014;2014;11;20;Sunnuntai;3;1;4
93;30.11.2014;2014;11;21;Sunnuntai;0;4;4
93;30.11.2014;2014;11;22;Sunnuntai;0;0;0
93;30.11.2014;2014;11;23;Sunnuntai;0;1;1
93;01.12.2014;2014;12;00;Maanantai;0;0;0
93;01.12.2014;2014;12;01;Maanantai;0;0;0
93;01.12.2014;2014;12;02;Maanantai;0;0;0
93;01.12.2014;2014;12;03;Maanantai;0;0;0
93;01.12.2014;2014;12;04;Maanantai;0;0;0
93;01.12.2014;2014;12;05;Maanantai;0;1;1
93;01.12.2014;2014;12;06;Maanantai;9;6;15
93;01.12.2014;2014;12;07;Maanantai;17;7;24
93;01.12.2014;2014;12;08;Maanantai;6;10;16
93;01.12.2014;2014;12;09;Maanantai;2;3;5
93;01.12.2014;2014;12;10;Maanantai;4;5;9
93;01.12.2014;2014;12;11;Maanantai;3;1;4
93;01.12.2014;2014;12;12;Maanantai;3;4;7
93;01.12.2014;2014;12;13;Maanantai;2;5;7
93;01.12.2014;2014;12;14;Maanantai;3;2;5
93;01.12.2014;2014;12;15;Maanantai;12;1;13
93;01.12.2014;2014;12;16;Maanantai;7;12;19
93;01.12.2014;2014;12;17;Maanantai;8;6;14
93;01.12.2014;2014;12;18;Maanantai;3;6;9
93;01.12.2014;2014;12;19;Maanantai;3;2;5
93;01.12.2014;2014;12;20;Maanantai;4;3;7
93;01.12.2014;2014;12;21;Maanantai;0;1;1
93;01.12.2014;2014;12;22;Maanantai;0;1;1
93;01.12.2014;2014;12;23;Maanantai;0;0;0
93;02.12.2014;2014;12;00;Tiistai;0;0;0
93;02.12.2014;2014;12;01;Tiistai;1;0;1
93;02.12.2014;2014;12;02;Tiistai;0;0;0
93;02.12.2014;2014;12;03;Tiistai;0;1;1
93;02.12.2014;2014;12;04;Tiistai;1;0;1
93;02.12.2014;2014;12;05;Tiistai;1;2;3
93;02.12.2014;2014;12;06;Tiistai;6;4;10
93;02.12.2014;2014;12;07;Tiistai;7;11;18
93;02.12.2014;2014;12;08;Tiistai;4;7;11
93;02.12.2014;2014;12;09;Tiistai;3;6;9
93;02.12.2014;2014;12;10;Tiistai;2;1;3
93;02.12.2014;2014;12;11;Tiistai;3;3;6
93;02.12.2014;2014;12;12;Tiistai;2;6;8
93;02.12.2014;2014;12;13;Tiistai;4;1;5
93;02.12.2014;2014;12;14;Tiistai;4;4;8
93;02.12.2014;2014;12;15;Tiistai;4;8;12
93;02.12.2014;2014;12;16;Tiistai;11;7;18
93;02.12.2014;2014;12;17;Tiistai;10;5;15
93;02.12.2014;2014;12;18;Tiistai;8;5;13
93;02.12.2014;2014;12;19;Tiistai;1;4;5
93;02.12.2014;2014;12;20;Tiistai;2;1;3
93;02.12.2014;2014;12;21;Tiistai;3;0;3
93;02.12.2014;2014;12;22;Tiistai;0;2;2
93;02.12.2014;2014;12;23;Tiistai;2;0;2
93;03.12.2014;2014;12;00;Keskiviikko;0;0;0
93;03.12.2014;2014;12;01;Keskiviikko;0;0;0
93;03.12.2014;2014;12;02;Keskiviikko;0;0;0
93;03.12.2014;2014;12;03;Keskiviikko;0;0;0
93;03.12.2014;2014;12;04;Keskiviikko;0;0;0
93;03.12.2014;2014;12;05;Keskiviikko;1;1;2
93;03.12.2014;2014;12;06;Keskiviikko;3;4;7
93;03.12.2014;2014;12;07;Keskiviikko;10;15;25
93;03.12.2014;2014;12;08;Keskiviikko;3;11;14
93;03.12.2014;2014;12;09;Keskiviikko;4;4;8
93;03.12.2014;2014;12;10;Keskiviikko;0;5;5
93;03.12.2014;2014;12;11;Keskiviikko;3;2;5
93;03.12.2014;2014;12;12;Keskiviikko;3;2;5
93;03.12.2014;2014;12;13;Keskiviikko;3;2;5
93;03.12.2014;2014;12;14;Keskiviikko;4;7;11
93;03.12.2014;2014;12;15;Keskiviikko;7;4;11
93;03.12.2014;2014;12;16;Keskiviikko;13;6;19
93;03.12.2014;2014;12;17;Keskiviikko;10;1;11
93;03.12.2014;2014;12;18;Keskiviikko;4;4;8
93;03.12.2014;2014;12;19;Keskiviikko;1;0;1
93;03.12.2014;2014;12;20;Keskiviikko;0;0;0
93;03.12.2014;2014;12;21;Keskiviikko;0;0;0
93;03.12.2014;2014;12;22;Keskiviikko;0;2;2
93;03.12.2014;2014;12;23;Keskiviikko;0;0;0
93;04.12.2014;2014;12;00;Torstai;0;0;0
93;04.12.2014;2014;12;01;Torstai;0;0;0
93;04.12.2014;2014;12;02;Torstai;0;0;0
93;04.12.2014;2014;12;03;Torstai;0;0;0
93;04.12.2014;2014;12;04;Torstai;0;0;0
93;04.12.2014;2014;12;05;Torstai;0;1;1
93;04.12.2014;2014;12;06;Torstai;7;3;10
93;04.12.2014;2014;12;07;Torstai;12;6;18
93;04.12.2014;2014;12;08;Torstai;6;10;16
93;04.12.2014;2014;12;09;Torstai;2;2;4
93;04.12.2014;2014;12;10;Torstai;3;2;5
93;04.12.2014;2014;12;11;Torstai;1;1;2
93;04.12.2014;2014;12;12;Torstai;5;0;5
93;04.12.2014;2014;12;13;Torstai;4;4;8
93;04.12.2014;2014;12;14;Torstai;3;3;6
93;04.12.2014;2014;12;15;Torstai;7;4;11
93;04.12.2014;2014;12;16;Torstai;9;8;17
93;04.12.2014;2014;12;17;Torstai;4;8;12
93;04.12.2014;2014;12;18;Torstai;5;3;8
93;04.12.2014;2014;12;19;Torstai;3;2;5
93;04.12.2014;2014;12;20;Torstai;1;1;2
93;04.12.2014;2014;12;21;Torstai;1;3;4
93;04.12.2014;2014;12;22;Torstai;1;0;1
93;04.12.2014;2014;12;23;Torstai;0;1;1
93;05.12.2014;2014;12;00;Perjantai;0;1;1
93;05.12.2014;2014;12;01;Perjantai;0;0;0
93;05.12.2014;2014;12;02;Perjantai;0;0;0
93;05.12.2014;2014;12;03;Perjantai;0;0;0
93;05.12.2014;2014;12;04;Perjantai;0;0;0
93;05.12.2014;2014;12;05;Perjantai;1;2;3
93;05.12.2014;2014;12;06;Perjantai;6;3;9
93;05.12.2014;2014;12;07;Perjantai;6;14;20
93;05.12.2014;2014;12;08;Perjantai;3;8;11
93;05.12.2014;2014;12;09;Perjantai;4;3;7
93;05.12.2014;2014;12;10;Perjantai;1;6;7
93;05.12.2014;2014;12;11;Perjantai;4;0;4
93;05.12.2014;2014;12;12;Perjantai;2;0;2
93;05.12.2014;2014;12;13;Perjantai;3;3;6
93;05.12.2014;2014;12;14;Perjantai;7;4;11
93;05.12.2014;2014;12;15;Perjantai;16;8;24
93;05.12.2014;2014;12;16;Perjantai;17;9;26
93;05.12.2014;2014;12;17;Perjantai;5;8;13
93;05.12.2014;2014;12;18;Perjantai;1;5;6
93;05.12.2014;2014;12;19;Perjantai;2;2;4
93;05.12.2014;2014;12;20;Perjantai;0;0;0
93;05.12.2014;2014;12;21;Perjantai;2;6;8
93;05.12.2014;2014;12;22;Perjantai;0;1;1
93;05.12.2014;2014;12;23;Perjantai;1;1;2
93;06.12.2014;2014;12;00;Lauantai;0;2;2
93;06.12.2014;2014;12;01;Lauantai;0;1;1
93;06.12.2014;2014;12;02;Lauantai;1;3;4
93;06.12.2014;2014;12;03;Lauantai;0;0;0
93;06.12.2014;2014;12;04;Lauantai;1;0;1
93;06.12.2014;2014;12;05;Lauantai;0;0;0
93;06.12.2014;2014;12;06;Lauantai;0;1;1
93;06.12.2014;2014;12;07;Lauantai;0;0;0
93;06.12.2014;2014;12;08;Lauantai;2;0;2
93;06.12.2014;2014;12;09;Lauantai;0;1;1
93;06.12.2014;2014;12;10;Lauantai;0;0;0
93;06.12.2014;2014;12;11;Lauantai;6;3;9
93;06.12.2014;2014;12;12;Lauantai;2;1;3
93;06.12.2014;2014;12;13;Lauantai;1;4;5
93;06.12.2014;2014;12;14;Lauantai;1;2;3
93;06.12.2014;2014;12;15;Lauantai;1;5;6
93;06.12.2014;2014;12;16;Lauantai;2;3;5
93;06.12.2014;2014;12;17;Lauantai;2;2;4
93;06.12.2014;2014;12;18;Lauantai;1;1;2
93;06.12.2014;2014;12;19;Lauantai;1;0;1
93;06.12.2014;2014;12;20;Lauantai;0;0;0
93;06.12.2014;2014;12;21;Lauantai;0;1;1
93;06.12.2014;2014;12;22;Lauantai;2;1;3
93;06.12.2014;2014;12;23;Lauantai;0;0;0
93;07.12.2014;2014;12;00;Sunnuntai;0;0;0
93;07.12.2014;2014;12;01;Sunnuntai;1;0;1
93;07.12.2014;2014;12;02;Sunnuntai;0;0;0
93;07.12.2014;2014;12;03;Sunnuntai;0;0;0
93;07.12.2014;2014;12;04;Sunnuntai;0;0;0
93;07.12.2014;2014;12;05;Sunnuntai;0;0;0
93;07.12.2014;2014;12;06;Sunnuntai;0;1;1
93;07.12.2014;2014;12;07;Sunnuntai;2;1;3
93;07.12.2014;2014;12;08;Sunnuntai;2;0;2
93;07.12.2014;2014;12;09;Sunnuntai;1;1;2
93;07.12.2014;2014;12;10;Sunnuntai;1;1;2
93;07.12.2014;2014;12;11;Sunnuntai;2;2;4
93;07.12.2014;2014;12;12;Sunnuntai;3;10;13
93;07.12.2014;2014;12;13;Sunnuntai;3;3;6
93;07.12.2014;2014;12;14;Sunnuntai;2;2;4
93;07.12.2014;2014;12;15;Sunnuntai;1;0;1
93;07.12.2014;2014;12;16;Sunnuntai;3;0;3
93;07.12.2014;2014;12;17;Sunnuntai;2;4;6
93;07.12.2014;2014;12;18;Sunnuntai;3;1;4
93;07.12.2014;2014;12;19;Sunnuntai;2;0;2
93;07.12.2014;2014;12;20;Sunnuntai;1;0;1
93;07.12.2014;2014;12;21;Sunnuntai;2;1;3
93;07.12.2014;2014;12;22;Sunnuntai;1;0;1
93;07.12.2014;2014;12;23;Sunnuntai;0;0;0
93;08.12.2014;2014;12;00;Maanantai;0;0;0
93;08.12.2014;2014;12;01;Maanantai;0;0;0
93;08.12.2014;2014;12;02;Maanantai;1;0;1
93;08.12.2014;2014;12;03;Maanantai;0;0;0
93;08.12.2014;2014;12;04;Maanantai;0;0;0
93;08.12.2014;2014;12;05;Maanantai;1;1;2
93;08.12.2014;2014;12;06;Maanantai;6;3;9
93;08.12.2014;2014;12;07;Maanantai;12;7;19
93;08.12.2014;2014;12;08;Maanantai;2;12;14
93;08.12.2014;2014;12;09;Maanantai;2;5;7
93;08.12.2014;2014;12;10;Maanantai;7;1;8
93;08.12.2014;2014;12;11;Maanantai;0;3;3
93;08.12.2014;2014;12;12;Maanantai;1;2;3
93;08.12.2014;2014;12;13;Maanantai;3;4;7
93;08.12.2014;2014;12;14;Maanantai;5;3;8
93;08.12.2014;2014;12;15;Maanantai;6;9;15
93;08.12.2014;2014;12;16;Maanantai;16;7;23
93;08.12.2014;2014;12;17;Maanantai;6;6;12
93;08.12.2014;2014;12;18;Maanantai;3;7;10
93;08.12.2014;2014;12;19;Maanantai;2;1;3
93;08.12.2014;2014;12;20;Maanantai;1;1;2
93;08.12.2014;2014;12;21;Maanantai;0;1;1
93;08.12.2014;2014;12;22;Maanantai;0;2;2
93;08.12.2014;2014;12;23;Maanantai;0;0;0
93;09.12.2014;2014;12;00;Tiistai;0;0;0
93;09.12.2014;2014;12;01;Tiistai;0;0;0
93;09.12.2014;2014;12;02;Tiistai;0;0;0
93;09.12.2014;2014;12;03;Tiistai;0;0;0
93;09.12.2014;2014;12;04;Tiistai;0;1;1
93;09.12.2014;2014;12;05;Tiistai;1;0;1
93;09.12.2014;2014;12;06;Tiistai;8;4;12
93;09.12.2014;2014;12;07;Tiistai;18;8;26
93;09.12.2014;2014;12;08;Tiistai;3;12;15
93;09.12.2014;2014;12;09;Tiistai;2;3;5
93;09.12.2014;2014;12;10;Tiistai;5;6;11
93;09.12.2014;2014;12;11;Tiistai;1;2;3
93;09.12.2014;2014;12;12;Tiistai;1;6;7
93;09.12.2014;2014;12;13;Tiistai;3;2;5
93;09.12.2014;2014;12;14;Tiistai;3;10;13
93;09.12.2014;2014;12;15;Tiistai;14;10;24
93;09.12.2014;2014;12;16;Tiistai;9;16;25
93;09.12.2014;2014;12;17;Tiistai;10;3;13
93;09.12.2014;2014;12;18;Tiistai;6;4;10
93;09.12.2014;2014;12;19;Tiistai;3;3;6
93;09.12.2014;2014;12;20;Tiistai;1;2;3
93;09.12.2014;2014;12;21;Tiistai;0;1;1
93;09.12.2014;2014;12;22;Tiistai;1;2;3
93;09.12.2014;2014;12;23;Tiistai;0;0;0
93;10.12.2014;2014;12;00;Keskiviikko;0;1;1
93;10.12.2014;2014;12;01;Keskiviikko;0;0;0
93;10.12.2014;2014;12;02;Keskiviikko;0;0;0
93;10.12.2014;2014;12;03;Keskiviikko;0;0;0
93;10.12.2014;2014;12;04;Keskiviikko;1;1;2
93;10.12.2014;2014;12;05;Keskiviikko;2;1;3
93;10.12.2014;2014;12;06;Keskiviikko;3;3;6
93;10.12.2014;2014;12;07;Keskiviikko;14;12;26
93;10.12.2014;2014;12;08;Keskiviikko;3;9;12
93;10.12.2014;2014;12;09;Keskiviikko;4;2;6
93;10.12.2014;2014;12;10;Keskiviikko;1;4;5
93;10.12.2014;2014;12;11;Keskiviikko;1;3;4
93;10.12.2014;2014;12;12;Keskiviikko;0;2;2
93;10.12.2014;2014;12;13;Keskiviikko;2;1;3
93;10.12.2014;2014;12;14;Keskiviikko;3;6;9
93;10.12.2014;2014;12;15;Keskiviikko;10;6;16
93;10.12.2014;2014;12;16;Keskiviikko;10;6;16
93;10.12.2014;2014;12;17;Keskiviikko;6;6;12
93;10.12.2014;2014;12;18;Keskiviikko;3;1;4
93;10.12.2014;2014;12;19;Keskiviikko;4;0;4
93;10.12.2014;2014;12;20;Keskiviikko;1;1;2
93;10.12.2014;2014;12;21;Keskiviikko;1;2;3
93;10.12.2014;2014;12;22;Keskiviikko;1;2;3
93;10.12.2014;2014;12;23;Keskiviikko;0;0;0
93;11.12.2014;2014;12;00;Torstai;0;0;0
93;11.12.2014;2014;12;01;Torstai;0;0;0
93;11.12.2014;2014;12;02;Torstai;0;0;0
93;11.12.2014;2014;12;03;Torstai;0;0;0
93;11.12.2014;2014;12;04;Torstai;0;0;0
93;11.12.2014;2014;12;05;Torstai;0;1;1
93;11.12.2014;2014;12;06;Torstai;5;3;8
93;11.12.2014;2014;12;07;Torstai;9;10;19
93;11.12.2014;2014;12;08;Torstai;3;7;10
93;11.12.2014;2014;12;09;Torstai;1;4;5
93;11.12.2014;2014;12;10;Torstai;4;1;5
93;11.12.2014;2014;12;11;Torstai;1;2;3
93;11.12.2014;2014;12;12;Torstai;1;3;4
93;11.12.2014;2014;12;13;Torstai;1;4;5
93;11.12.2014;2014;12;14;Torstai;6;4;10
93;11.12.2014;2014;12;15;Torstai;6;5;11
93;11.12.2014;2014;12;16;Torstai;12;10;22
93;11.12.2014;2014;12;17;Torstai;8;4;12
93;11.12.2014;2014;12;18;Torstai;2;5;7
93;11.12.2014;2014;12;19;Torstai;4;0;4
93;11.12.2014;2014;12;20;Torstai;0;2;2
93;11.12.2014;2014;12;21;Torstai;0;0;0
93;11.12.2014;2014;12;22;Torstai;0;1;1
93;11.12.2014;2014;12;23;Torstai;2;0;2
93;12.12.2014;2014;12;00;Perjantai;0;0;0
93;12.12.2014;2014;12;01;Perjantai;0;0;0
93;12.12.2014;2014;12;02;Perjantai;0;0;0
93;12.12.2014;2014;12;03;Perjantai;0;0;0
93;12.12.2014;2014;12;04;Perjantai;0;0;0
93;12.12.2014;2014;12;05;Perjantai;1;2;3
93;12.12.2014;2014;12;06;Perjantai;3;3;6
93;12.12.2014;2014;12;07;Perjantai;9;7;16
93;12.12.2014;2014;12;08;Perjantai;3;7;10
93;12.12.2014;2014;12;09;Perjantai;1;2;3
93;12.12.2014;2014;12;10;Perjantai;1;2;3
93;12.12.2014;2014;12;11;Perjantai;2;2;4
93;12.12.2014;2014;12;12;Perjantai;0;1;1
93;12.12.2014;2014;12;13;Perjantai;2;4;6
93;12.12.2014;2014;12;14;Perjantai;6;2;8
93;12.12.2014;2014;12;15;Perjantai;6;7;13
93;12.12.2014;2014;12;16;Perjantai;10;2;12
93;12.12.2014;2014;12;17;Perjantai;13;6;19
93;12.12.2014;2014;12;18;Perjantai;3;3;6
93;12.12.2014;2014;12;19;Perjantai;1;2;3
93;12.12.2014;2014;12;20;Perjantai;1;2;3
93;12.12.2014;2014;12;21;Perjantai;0;3;3
93;12.12.2014;2014;12;22;Perjantai;1;2;3
93;12.12.2014;2014;12;23;Perjantai;0;0;0
93;13.12.2014;2014;12;00;Lauantai;0;0;0
93;13.12.2014;2014;12;01;Lauantai;0;1;1
93;13.12.2014;2014;12;02;Lauantai;0;1;1
93;13.12.2014;2014;12;03;Lauantai;0;0;0
93;13.12.2014;2014;12;04;Lauantai;0;0;0
93;13.12.2014;2014;12;05;Lauantai;0;1;1
93;13.12.2014;2014;12;06;Lauantai;0;1;1
93;13.12.2014;2014;12;07;Lauantai;2;3;5
93;13.12.2014;2014;12;08;Lauantai;2;1;3
93;13.12.2014;2014;12;09;Lauantai;0;1;1
93;13.12.2014;2014;12;10;Lauantai;1;2;3
93;13.12.2014;2014;12;11;Lauantai;4;1;5
93;13.12.2014;2014;12;12;Lauantai;2;2;4
93;13.12.2014;2014;12;13;Lauantai;5;2;7
93;13.12.2014;2014;12;14;Lauantai;5;4;9
93;13.12.2014;2014;12;15;Lauantai;3;0;3
93;13.12.2014;2014;12;16;Lauantai;3;3;6
93;13.12.2014;2014;12;17;Lauantai;4;3;7
93;13.12.2014;2014;12;18;Lauantai;1;1;2
93;13.12.2014;2014;12;19;Lauantai;0;1;1
93;13.12.2014;2014;12;20;Lauantai;1;5;6
93;13.12.2014;2014;12;21;Lauantai;0;0;0
93;13.12.2014;2014;12;22;Lauantai;0;0;0
93;13.12.2014;2014;12;23;Lauantai;0;0;0
93;14.12.2014;2014;12;00;Sunnuntai;0;0;0
93;14.12.2014;2014;12;01;Sunnuntai;1;0;1
93;14.12.2014;2014;12;02;Sunnuntai;0;0;0
93;14.12.2014;2014;12;03;Sunnuntai;0;0;0
93;14.12.2014;2014;12;04;Sunnuntai;0;0;0
93;14.12.2014;2014;12;05;Sunnuntai;0;0;0
93;14.12.2014;2014;12;06;Sunnuntai;0;0;0
93;14.12.2014;2014;12;07;Sunnuntai;4;2;6
93;14.12.2014;2014;12;08;Sunnuntai;0;0;0
93;14.12.2014;2014;12;09;Sunnuntai;3;3;6
93;14.12.2014;2014;12;10;Sunnuntai;5;5;10
93;14.12.2014;2014;12;11;Sunnuntai;6;2;8
93;14.12.2014;2014;12;12;Sunnuntai;3;5;8
93;14.12.2014;2014;12;13;Sunnuntai;2;5;7
93;14.12.2014;2014;12;14;Sunnuntai;5;10;15
93;14.12.2014;2014;12;15;Sunnuntai;6;4;10
93;14.12.2014;2014;12;16;Sunnuntai;4;2;6
93;14.12.2014;2014;12;17;Sunnuntai;5;3;8
93;14.12.2014;2014;12;18;Sunnuntai;2;1;3
93;14.12.2014;2014;12;19;Sunnuntai;1;1;2
93;14.12.2014;2014;12;20;Sunnuntai;3;1;4
93;14.12.2014;2014;12;21;Sunnuntai;0;1;1
93;14.12.2014;2014;12;22;Sunnuntai;1;1;2
93;14.12.2014;2014;12;23;Sunnuntai;0;0;0
93;15.12.2014;2014;12;00;Maanantai;0;2;2
93;15.12.2014;2014;12;01;Maanantai;0;0;0
93;15.12.2014;2014;12;02;Maanantai;0;0;0
93;15.12.2014;2014;12;03;Maanantai;0;0;0
93;15.12.2014;2014;12;04;Maanantai;0;1;1
93;15.12.2014;2014;12;05;Maanantai;1;1;2
93;15.12.2014;2014;12;06;Maanantai;7;4;11
93;15.12.2014;2014;12;07;Maanantai;12;11;23
93;15.12.2014;2014;12;08;Maanantai;7;10;17
93;15.12.2014;2014;12;09;Maanantai;4;4;8
93;15.12.2014;2014;12;10;Maanantai;2;3;5
93;15.12.2014;2014;12;11;Maanantai;3;3;6
93;15.12.2014;2014;12;12;Maanantai;1;4;5
93;15.12.2014;2014;12;13;Maanantai;4;4;8
93;15.12.2014;2014;12;14;Maanantai;5;5;10
93;15.12.2014;2014;12;15;Maanantai;10;3;13
93;15.12.2014;2014;12;16;Maanantai;9;8;17
93;15.12.2014;2014;12;17;Maanantai;4;5;9
93;15.12.2014;2014;12;18;Maanantai;5;5;10
93;15.12.2014;2014;12;19;Maanantai;0;2;2
93;15.12.2014;2014;12;20;Maanantai;2;2;4
93;15.12.2014;2014;12;21;Maanantai;0;0;0
93;15.12.2014;2014;12;22;Maanantai;1;3;4
93;15.12.2014;2014;12;23;Maanantai;0;1;1
93;16.12.2014;2014;12;00;Tiistai;0;0;0
93;16.12.2014;2014;12;01;Tiistai;0;0;0
93;16.12.2014;2014;12;02;Tiistai;0;0;0
93;16.12.2014;2014;12;03;Tiistai;0;0;0
93;16.12.2014;2014;12;04;Tiistai;1;2;3
93;16.12.2014;2014;12;05;Tiistai;6;3;9
93;16.12.2014;2014;12;06;Tiistai;7;3;10
93;16.12.2014;2014;12;07;Tiistai;8;8;16
93;16.12.2014;2014;12;08;Tiistai;4;8;12
93;16.12.2014;2014;12;09;Tiistai;3;4;7
93;16.12.2014;2014;12;10;Tiistai;2;1;3
93;16.12.2014;2014;12;11;Tiistai;0;2;2
93;16.12.2014;2014;12;12;Tiistai;2;2;4
93;16.12.2014;2014;12;13;Tiistai;5;1;6
93;16.12.2014;2014;12;14;Tiistai;5;3;8
93;16.12.2014;2014;12;15;Tiistai;10;7;17
93;16.12.2014;2014;12;16;Tiistai;11;8;19
93;16.12.2014;2014;12;17;Tiistai;2;7;9
93;16.12.2014;2014;12;18;Tiistai;6;5;11
93;16.12.2014;2014;12;19;Tiistai;2;1;3
93;16.12.2014;2014;12;20;Tiistai;1;1;2
93;16.12.2014;2014;12;21;Tiistai;0;0;0
93;16.12.2014;2014;12;22;Tiistai;0;2;2
93;16.12.2014;2014;12;23;Tiistai;0;0;0
93;17.12.2014;2014;12;00;Keskiviikko;1;0;1
93;17.12.2014;2014;12;01;Keskiviikko;0;0;0
93;17.12.2014;2014;12;02;Keskiviikko;0;0;0
93;17.12.2014;2014;12;03;Keskiviikko;0;0;0
93;17.12.2014;2014;12;04;Keskiviikko;0;0;0
93;17.12.2014;2014;12;05;Keskiviikko;3;1;4
93;17.12.2014;2014;12;06;Keskiviikko;4;4;8
93;17.12.2014;2014;12;07;Keskiviikko;10;9;19
93;17.12.2014;2014;12;08;Keskiviikko;4;10;14
93;17.12.2014;2014;12;09;Keskiviikko;3;8;11
93;17.12.2014;2014;12;10;Keskiviikko;2;1;3
93;17.12.2014;2014;12;11;Keskiviikko;2;6;8
93;17.12.2014;2014;12;12;Keskiviikko;7;2;9
93;17.12.2014;2014;12;13;Keskiviikko;2;6;8
93;17.12.2014;2014;12;14;Keskiviikko;5;4;9
93;17.12.2014;2014;12;15;Keskiviikko;3;2;5
93;17.12.2014;2014;12;16;Keskiviikko;13;12;25
93;17.12.2014;2014;12;17;Keskiviikko;8;4;12
93;17.12.2014;2014;12;18;Keskiviikko;6;4;10
93;17.12.2014;2014;12;19;Keskiviikko;0;1;1
93;17.12.2014;2014;12;20;Keskiviikko;3;0;3
93;17.12.2014;2014;12;21;Keskiviikko;1;1;2
93;17.12.2014;2014;12;22;Keskiviikko;0;2;2
93;17.12.2014;2014;12;23;Keskiviikko;0;0;0
93;18.12.2014;2014;12;00;Torstai;0;0;0
93;18.12.2014;2014;12;01;Torstai;0;0;0
93;18.12.2014;2014;12;02;Torstai;0;0;0
93;18.12.2014;2014;12;03;Torstai;0;0;0
93;18.12.2014;2014;12;04;Torstai;0;1;1
93;18.12.2014;2014;12;05;Torstai;1;2;3
93;18.12.2014;2014;12;06;Torstai;8;5;13
93;18.12.2014;2014;12;07;Torstai;10;7;17
93;18.12.2014;2014;12;08;Torstai;3;5;8
93;18.12.2014;2014;12;09;Torstai;2;2;4
93;18.12.2014;2014;12;10;Torstai;1;2;3
93;18.12.2014;2014;12;11;Torstai;1;2;3
93;18.12.2014;2014;12;12;Torstai;5;3;8
93;18.12.2014;2014;12;13;Torstai;3;4;7
93;18.12.2014;2014;12;14;Torstai;5;5;10
93;18.12.2014;2014;12;15;Torstai;7;3;10
93;18.12.2014;2014;12;16;Torstai;8;13;21
93;18.12.2014;2014;12;17;Torstai;2;0;2
93;18.12.2014;2014;12;18;Torstai;5;4;9
93;18.12.2014;2014;12;19;Torstai;1;6;7
93;18.12.2014;2014;12;20;Torstai;0;3;3
93;18.12.2014;2014;12;21;Torstai;0;1;1
93;18.12.2014;2014;12;22;Torstai;0;2;2
93;18.12.2014;2014;12;23;Torstai;0;0;0
93;19.12.2014;2014;12;00;Perjantai;0;0;0
93;19.12.2014;2014;12;01;Perjantai;0;0;0
93;19.12.2014;2014;12;02;Perjantai;0;0;0
93;19.12.2014;2014;12;03;Perjantai;0;0;0
93;19.12.2014;2014;12;04;Perjantai;0;1;1
93;19.12.2014;2014;12;05;Perjantai;1;1;2
93;19.12.2014;2014;12;06;Perjantai;2;9;11
93;19.12.2014;2014;12;07;Perjantai;8;13;21
93;19.12.2014;2014;12;08;Perjantai;4;5;9
93;19.12.2014;2014;12;09;Perjantai;2;1;3
93;19.12.2014;2014;12;10;Perjantai;0;1;1
93;19.12.2014;2014;12;11;Perjantai;4;3;7
93;19.12.2014;2014;12;12;Perjantai;4;3;7
93;19.12.2014;2014;12;13;Perjantai;4;3;7
93;19.12.2014;2014;12;14;Perjantai;3;5;8
93;19.12.2014;2014;12;15;Perjantai;14;4;18
93;19.12.2014;2014;12;16;Perjantai;7;6;13
93;19.12.2014;2014;12;17;Perjantai;7;1;8
93;19.12.2014;2014;12;18;Perjantai;0;1;1
93;19.12.2014;2014;12;19;Perjantai;3;2;5
93;19.12.2014;2014;12;20;Perjantai;0;1;1
93;19.12.2014;2014;12;21;Perjantai;0;2;2
93;19.12.2014;2014;12;22;Perjantai;0;2;2
93;19.12.2014;2014;12;23;Perjantai;1;0;1
93;20.12.2014;2014;12;00;Lauantai;0;0;0
93;20.12.2014;2014;12;01;Lauantai;0;0;0
93;20.12.2014;2014;12;02;Lauantai;0;0;0
93;20.12.2014;2014;12;03;Lauantai;0;0;0
93;20.12.2014;2014;12;04;Lauantai;1;0;1
93;20.12.2014;2014;12;05;Lauantai;0;0;0
93;20.12.2014;2014;12;06;Lauantai;0;0;0
93;20.12.2014;2014;12;07;Lauantai;1;1;2
93;20.12.2014;2014;12;08;Lauantai;2;0;2
93;20.12.2014;2014;12;09;Lauantai;3;1;4
93;20.12.2014;2014;12;10;Lauantai;2;2;4
93;20.12.2014;2014;12;11;Lauantai;1;0;1
93;20.12.2014;2014;12;12;Lauantai;5;3;8
93;20.12.2014;2014;12;13;Lauantai;2;3;5
93;20.12.2014;2014;12;14;Lauantai;0;3;3
93;20.12.2014;2014;12;15;Lauantai;1;3;4
93;20.12.2014;2014;12;16;Lauantai;1;3;4
93;20.12.2014;2014;12;17;Lauantai;1;2;3
93;20.12.2014;2014;12;18;Lauantai;2;2;4
93;20.12.2014;2014;12;19;Lauantai;0;1;1
93;20.12.2014;2014;12;20;Lauantai;2;1;3
93;20.12.2014;2014;12;21;Lauantai;0;2;2
93;20.12.2014;2014;12;22;Lauantai;0;2;2
93;20.12.2014;2014;12;23;Lauantai;0;0;0
93;21.12.2014;2014;12;00;Sunnuntai;0;0;0
93;21.12.2014;2014;12;01;Sunnuntai;1;0;1
93;21.12.2014;2014;12;02;Sunnuntai;0;0;0
93;21.12.2014;2014;12;03;Sunnuntai;0;0;0
93;21.12.2014;2014;12;04;Sunnuntai;0;0;0
93;21.12.2014;2014;12;05;Sunnuntai;0;0;0
93;21.12.2014;2014;12;06;Sunnuntai;1;1;2
93;21.12.2014;2014;12;07;Sunnuntai;1;0;1
93;21.12.2014;2014;12;08;Sunnuntai;1;2;3
93;21.12.2014;2014;12;09;Sunnuntai;0;11;11
93;21.12.2014;2014;12;10;Sunnuntai;3;2;5
93;21.12.2014;2014;12;11;Sunnuntai;4;4;8
93;21.12.2014;2014;12;12;Sunnuntai;2;2;4
93;21.12.2014;2014;12;13;Sunnuntai;1;1;2
93;21.12.2014;2014;12;14;Sunnuntai;1;4;5
93;21.12.2014;2014;12;15;Sunnuntai;4;2;6
93;21.12.2014;2014;12;16;Sunnuntai;1;1;2
93;21.12.2014;2014;12;17;Sunnuntai;1;0;1
93;21.12.2014;2014;12;18;Sunnuntai;0;2;2
93;21.12.2014;2014;12;19;Sunnuntai;3;1;4
93;21.12.2014;2014;12;20;Sunnuntai;0;0;0
93;21.12.2014;2014;12;21;Sunnuntai;0;2;2
93;21.12.2014;2014;12;22;Sunnuntai;1;0;1
93;21.12.2014;2014;12;23;Sunnuntai;0;0;0
93;22.12.2014;2014;12;00;Maanantai;0;0;0
93;22.12.2014;2014;12;01;Maanantai;1;1;2
93;22.12.2014;2014;12;02;Maanantai;0;0;0
93;22.12.2014;2014;12;03;Maanantai;0;0;0
93;22.12.2014;2014;12;04;Maanantai;0;0;0
93;22.12.2014;2014;12;05;Maanantai;0;3;3
93;22.12.2014;2014;12;06;Maanantai;7;4;11
93;22.12.2014;2014;12;07;Maanantai;3;7;10
93;22.12.2014;2014;12;08;Maanantai;5;5;10
93;22.12.2014;2014;12;09;Maanantai;2;3;5
93;22.12.2014;2014;12;10;Maanantai;1;2;3
93;22.12.2014;2014;12;11;Maanantai;1;0;1
93;22.12.2014;2014;12;12;Maanantai;0;1;1
93;22.12.2014;2014;12;13;Maanantai;2;1;3
93;22.12.2014;2014;12;14;Maanantai;3;2;5
93;22.12.2014;2014;12;15;Maanantai;8;5;13
93;22.12.2014;2014;12;16;Maanantai;11;5;16
93;22.12.2014;2014;12;17;Maanantai;6;4;10
93;22.12.2014;2014;12;18;Maanantai;5;4;9
93;22.12.2014;2014;12;19;Maanantai;3;3;6
93;22.12.2014;2014;12;20;Maanantai;0;1;1
93;22.12.2014;2014;12;21;Maanantai;1;1;2
93;22.12.2014;2014;12;22;Maanantai;0;2;2
93;22.12.2014;2014;12;23;Maanantai;1;1;2
93;23.12.2014;2014;12;00;Tiistai;0;0;0
93;23.12.2014;2014;12;01;Tiistai;0;1;1
93;23.12.2014;2014;12;02;Tiistai;0;0;0
93;23.12.2014;2014;12;03;Tiistai;0;0;0
93;23.12.2014;2014;12;04;Tiistai;0;0;0
93;23.12.2014;2014;12;05;Tiistai;0;1;1
93;23.12.2014;2014;12;06;Tiistai;3;1;4
93;23.12.2014;2014;12;07;Tiistai;3;4;7
93;23.12.2014;2014;12;08;Tiistai;3;5;8
93;23.12.2014;2014;12;09;Tiistai;1;2;3
93;23.12.2014;2014;12;10;Tiistai;2;0;2
93;23.12.2014;2014;12;11;Tiistai;0;2;2
93;23.12.2014;2014;12;12;Tiistai;3;2;5
93;23.12.2014;2014;12;13;Tiistai;1;2;3
93;23.12.2014;2014;12;14;Tiistai;1;2;3
93;23.12.2014;2014;12;15;Tiistai;5;2;7
93;23.12.2014;2014;12;16;Tiistai;5;0;5
93;23.12.2014;2014;12;17;Tiistai;2;4;6
93;23.12.2014;2014;12;18;Tiistai;0;0;0
93;23.12.2014;2014;12;19;Tiistai;0;0;0
93;23.12.2014;2014;12;20;Tiistai;2;1;3
93;23.12.2014;2014;12;21;Tiistai;0;1;1
93;23.12.2014;2014;12;22;Tiistai;1;1;2
93;23.12.2014;2014;12;23;Tiistai;0;1;1
93;24.12.2014;2014;12;00;Keskiviikko;0;0;0
93;24.12.2014;2014;12;01;Keskiviikko;0;0;0
93;24.12.2014;2014;12;02;Keskiviikko;0;0;0
93;24.12.2014;2014;12;03;Keskiviikko;0;0;0
93;24.12.2014;2014;12;04;Keskiviikko;2;0;2
93;24.12.2014;2014;12;05;Keskiviikko;0;1;1
93;24.12.2014;2014;12;06;Keskiviikko;0;0;0
93;24.12.2014;2014;12;07;Keskiviikko;0;0;0
93;24.12.2014;2014;12;08;Keskiviikko;0;0;0
93;24.12.2014;2014;12;09;Keskiviikko;0;0;0
93;24.12.2014;2014;12;10;Keskiviikko;0;0;0
93;24.12.2014;2014;12;11;Keskiviikko;0;1;1
93;24.12.2014;2014;12;12;Keskiviikko;1;3;4
93;24.12.2014;2014;12;13;Keskiviikko;2;1;3
93;24.12.2014;2014;12;14;Keskiviikko;0;0;0
93;24.12.2014;2014;12;15;Keskiviikko;0;0;0
93;24.12.2014;2014;12;16;Keskiviikko;0;0;0
93;24.12.2014;2014;12;17;Keskiviikko;1;0;1
93;24.12.2014;2014;12;18;Keskiviikko;0;0;0
93;24.12.2014;2014;12;19;Keskiviikko;0;0;0
93;24.12.2014;2014;12;20;Keskiviikko;0;0;0
93;24.12.2014;2014;12;21;Keskiviikko;0;0;0
93;24.12.2014;2014;12;22;Keskiviikko;0;0;0
93;24.12.2014;2014;12;23;Keskiviikko;0;0;0
93;25.12.2014;2014;12;00;Torstai;0;0;0
93;25.12.2014;2014;12;01;Torstai;0;0;0
93;25.12.2014;2014;12;02;Torstai;0;0;0
93;25.12.2014;2014;12;03;Torstai;0;0;0
93;25.12.2014;2014;12;04;Torstai;0;0;0
93;25.12.2014;2014;12;05;Torstai;0;0;0
93;25.12.2014;2014;12;06;Torstai;0;0;0
93;25.12.2014;2014;12;07;Torstai;0;0;0
93;25.12.2014;2014;12;08;Torstai;0;0;0
93;25.12.2014;2014;12;09;Torstai;0;0;0
93;25.12.2014;2014;12;10;Torstai;0;0;0
93;25.12.2014;2014;12;11;Torstai;0;0;0
93;25.12.2014;2014;12;12;Torstai;1;0;1
93;25.12.2014;2014;12;13;Torstai;0;1;1
93;25.12.2014;2014;12;14;Torstai;0;0;0
93;25.12.2014;2014;12;15;Torstai;2;0;2
93;25.12.2014;2014;12;16;Torstai;3;0;3
93;25.12.2014;2014;12;17;Torstai;2;0;2
93;25.12.2014;2014;12;18;Torstai;1;1;2
93;25.12.2014;2014;12;19;Torstai;1;2;3
93;25.12.2014;2014;12;20;Torstai;1;0;1
93;25.12.2014;2014;12;21;Torstai;0;0;0
93;25.12.2014;2014;12;22;Torstai;0;0;0
93;25.12.2014;2014;12;23;Torstai;0;1;1
93;26.12.2014;2014;12;00;Perjantai;0;0;0
93;26.12.2014;2014;12;01;Perjantai;0;0;0
93;26.12.2014;2014;12;02;Perjantai;0;0;0
93;26.12.2014;2014;12;03;Perjantai;0;0;0
93;26.12.2014;2014;12;04;Perjantai;0;0;0
93;26.12.2014;2014;12;05;Perjantai;0;0;0
93;26.12.2014;2014;12;06;Perjantai;0;0;0
93;26.12.2014;2014;12;07;Perjantai;0;0;0
93;26.12.2014;2014;12;08;Perjantai;1;0;1
93;26.12.2014;2014;12;09;Perjantai;0;1;1
93;26.12.2014;2014;12;10;Perjantai;0;0;0
93;26.12.2014;2014;12;11;Perjantai;2;0;2
93;26.12.2014;2014;12;12;Perjantai;0;0;0
93;26.12.2014;2014;12;13;Perjantai;0;2;2
93;26.12.2014;2014;12;14;Perjantai;3;1;4
93;26.12.2014;2014;12;15;Perjantai;1;3;4
93;26.12.2014;2014;12;16;Perjantai;0;0;0
93;26.12.2014;2014;12;17;Perjantai;0;0;0
93;26.12.2014;2014;12;18;Perjantai;0;0;0
93;26.12.2014;2014;12;19;Perjantai;3;2;5
93;26.12.2014;2014;12;20;Perjantai;1;0;1
93;26.12.2014;2014;12;21;Perjantai;0;0;0
93;26.12.2014;2014;12;22;Perjantai;0;0;0
93;26.12.2014;2014;12;23;Perjantai;0;0;0
93;27.12.2014;2014;12;00;Lauantai;0;0;0
93;27.12.2014;2014;12;01;Lauantai;0;0;0
93;27.12.2014;2014;12;02;Lauantai;0;0;0
93;27.12.2014;2014;12;03;Lauantai;0;0;0
93;27.12.2014;2014;12;04;Lauantai;0;0;0
93;27.12.2014;2014;12;05;Lauantai;0;0;0
93;27.12.2014;2014;12;06;Lauantai;1;0;1
93;27.12.2014;2014;12;07;Lauantai;0;0;0
93;27.12.2014;2014;12;08;Lauantai;1;0;1
93;27.12.2014;2014;12;09;Lauantai;0;1;1
93;27.12.2014;2014;12;10;Lauantai;1;0;1
93;27.12.2014;2014;12;11;Lauantai;2;0;2
93;27.12.2014;2014;12;12;Lauantai;1;0;1
93;27.12.2014;2014;12;13;Lauantai;6;7;13
93;27.12.2014;2014;12;14;Lauantai;0;2;2
93;27.12.2014;2014;12;15;Lauantai;4;0;4
93;27.12.2014;2014;12;16;Lauantai;2;2;4
93;27.12.2014;2014;12;17;Lauantai;0;0;0
93;27.12.2014;2014;12;18;Lauantai;1;0;1
93;27.12.2014;2014;12;19;Lauantai;1;0;1
93;27.12.2014;2014;12;20;Lauantai;1;0;1
93;27.12.2014;2014;12;21;Lauantai;0;0;0
93;27.12.2014;2014;12;22;Lauantai;0;0;0
93;27.12.2014;2014;12;23;Lauantai;0;0;0
93;28.12.2014;2014;12;00;Sunnuntai;0;0;0
93;28.12.2014;2014;12;01;Sunnuntai;0;0;0
93;28.12.2014;2014;12;02;Sunnuntai;0;0;0
93;28.12.2014;2014;12;03;Sunnuntai;0;0;0
93;28.12.2014;2014;12;04;Sunnuntai;0;0;0
93;28.12.2014;2014;12;05;Sunnuntai;0;0;0
93;28.12.2014;2014;12;06;Sunnuntai;0;0;0
93;28.12.2014;2014;12;07;Sunnuntai;3;0;3
93;28.12.2014;2014;12;08;Sunnuntai;0;0;0
93;28.12.2014;2014;12;09;Sunnuntai;0;0;0
93;28.12.2014;2014;12;10;Sunnuntai;0;0;0
93;28.12.2014;2014;12;11;Sunnuntai;14;0;14
93;28.12.2014;2014;12;12;Sunnuntai;0;0;0
93;28.12.2014;2014;12;13;Sunnuntai;0;0;0
93;28.12.2014;2014;12;14;Sunnuntai;0;2;2
93;28.12.2014;2014;12;15;Sunnuntai;0;2;2
93;28.12.2014;2014;12;16;Sunnuntai;1;0;1
93;28.12.2014;2014;12;17;Sunnuntai;2;0;2
93;28.12.2014;2014;12;18;Sunnuntai;0;1;1
93;28.12.2014;2014;12;19;Sunnuntai;1;1;2
93;28.12.2014;2014;12;20;Sunnuntai;0;2;2
93;28.12.2014;2014;12;21;Sunnuntai;0;0;0
93;28.12.2014;2014;12;22;Sunnuntai;0;0;0
93;28.12.2014;2014;12;23;Sunnuntai;0;0;0
93;29.12.2014;2014;12;00;Maanantai;0;0;0
93;29.12.2014;2014;12;01;Maanantai;0;0;0
93;29.12.2014;2014;12;02;Maanantai;0;0;0
93;29.12.2014;2014;12;03;Maanantai;0;0;0
93;29.12.2014;2014;12;04;Maanantai;0;0;0
93;29.12.2014;2014;12;05;Maanantai;0;1;1
93;29.12.2014;2014;12;06;Maanantai;3;4;7
93;29.12.2014;2014;12;07;Maanantai;6;5;11
93;29.12.2014;2014;12;08;Maanantai;5;3;8
93;29.12.2014;2014;12;09;Maanantai;0;1;1
93;29.12.2014;2014;12;10;Maanantai;2;1;3
93;29.12.2014;2014;12;11;Maanantai;0;2;2
93;29.12.2014;2014;12;12;Maanantai;1;4;5
93;29.12.2014;2014;12;13;Maanantai;2;4;6
93;29.12.2014;2014;12;14;Maanantai;3;0;3
93;29.12.2014;2014;12;15;Maanantai;2;3;5
93;29.12.2014;2014;12;16;Maanantai;14;6;20
93;29.12.2014;2014;12;17;Maanantai;4;5;9
93;29.12.2014;2014;12;18;Maanantai;2;1;3
93;29.12.2014;2014;12;19;Maanantai;3;3;6
93;29.12.2014;2014;12;20;Maanantai;0;0;0
93;29.12.2014;2014;12;21;Maanantai;4;1;5
93;29.12.2014;2014;12;22;Maanantai;2;1;3
93;29.12.2014;2014;12;23;Maanantai;0;0;0
93;30.12.2014;2014;12;00;Tiistai;0;0;0
93;30.12.2014;2014;12;01;Tiistai;0;0;0
93;30.12.2014;2014;12;02;Tiistai;0;0;0
93;30.12.2014;2014;12;03;Tiistai;0;0;0
93;30.12.2014;2014;12;04;Tiistai;0;0;0
93;30.12.2014;2014;12;05;Tiistai;0;1;1
93;30.12.2014;2014;12;06;Tiistai;5;5;10
93;30.12.2014;2014;12;07;Tiistai;2;6;8
93;30.12.2014;2014;12;08;Tiistai;5;2;7
93;30.12.2014;2014;12;09;Tiistai;3;4;7
93;30.12.2014;2014;12;10;Tiistai;0;1;1
93;30.12.2014;2014;12;11;Tiistai;4;1;5
93;30.12.2014;2014;12;12;Tiistai;2;9;11
93;30.12.2014;2014;12;13;Tiistai;3;3;6
93;30.12.2014;2014;12;14;Tiistai;4;1;5
93;30.12.2014;2014;12;15;Tiistai;9;7;16
93;30.12.2014;2014;12;16;Tiistai;10;4;14
93;30.12.2014;2014;12;17;Tiistai;0;6;6
93;30.12.2014;2014;12;18;Tiistai;3;0;3
93;30.12.2014;2014;12;19;Tiistai;1;1;2
93;30.12.2014;2014;12;20;Tiistai;0;2;2
93;30.12.2014;2014;12;21;Tiistai;0;0;0
93;30.12.2014;2014;12;22;Tiistai;2;2;4
93;30.12.2014;2014;12;23;Tiistai;0;0;0
93;31.12.2014;2014;12;00;Keskiviikko;0;0;0
93;31.12.2014;2014;12;01;Keskiviikko;0;0;0
93;31.12.2014;2014;12;02;Keskiviikko;0;0;0
93;31.12.2014;2014;12;03;Keskiviikko;0;0;0
93;31.12.2014;2014;12;04;Keskiviikko;0;0;0
93;31.12.2014;2014;12;05;Keskiviikko;0;0;0
93;31.12.2014;2014;12;06;Keskiviikko;3;2;5
93;31.12.2014;2014;12;07;Keskiviikko;3;3;6
93;31.12.2014;2014;12;08;Keskiviikko;4;4;8
93;31.12.2014;2014;12;09;Keskiviikko;1;2;3
93;31.12.2014;2014;12;10;Keskiviikko;5;1;6
93;31.12.2014;2014;12;11;Keskiviikko;4;1;5
93;31.12.2014;2014;12;12;Keskiviikko;2;2;4
93;31.12.2014;2014;12;13;Keskiviikko;2;5;7
93;31.12.2014;2014;12;14;Keskiviikko;1;3;4
93;31.12.2014;2014;12;15;Keskiviikko;6;12;18
93;31.12.2014;2014;12;16;Keskiviikko;2;1;3
93;31.12.2014;2014;12;17;Keskiviikko;2;2;4
93;31.12.2014;2014;12;18;Keskiviikko;0;0;0
93;31.12.2014;2014;12;19;Keskiviikko;5;0;5
93;31.12.2014;2014;12;20;Keskiviikko;0;4;4
93;31.12.2014;2014;12;21;Keskiviikko;0;0;0
93;31.12.2014;2014;12;22;Keskiviikko;0;0;0
93;31.12.2014;2014;12;23;Keskiviikko;0;1;1
93;01.01.2015;2015;01;00;Torstai;1;0;1
93;01.01.2015;2015;01;01;Torstai;1;0;1
93;01.01.2015;2015;01;02;Torstai;0;0;0
93;01.01.2015;2015;01;03;Torstai;0;0;0
93;01.01.2015;2015;01;04;Torstai;0;1;1
93;01.01.2015;2015;01;05;Torstai;1;0;1
93;01.01.2015;2015;01;06;Torstai;0;0;0
93;01.01.2015;2015;01;07;Torstai;0;0;0
93;01.01.2015;2015;01;08;Torstai;1;2;3
93;01.01.2015;2015;01;09;Torstai;1;0;1
93;01.01.2015;2015;01;10;Torstai;3;4;7
93;01.01.2015;2015;01;11;Torstai;2;0;2
93;01.01.2015;2015;01;12;Torstai;1;6;7
93;01.01.2015;2015;01;13;Torstai;1;1;2
93;01.01.2015;2015;01;14;Torstai;2;4;6
93;01.01.2015;2015;01;15;Torstai;3;0;3
93;01.01.2015;2015;01;16;Torstai;0;2;2
93;01.01.2015;2015;01;17;Torstai;1;1;2
93;01.01.2015;2015;01;18;Torstai;2;1;3
93;01.01.2015;2015;01;19;Torstai;1;1;2
93;01.01.2015;2015;01;20;Torstai;0;0;0
93;01.01.2015;2015;01;21;Torstai;0;3;3
93;01.01.2015;2015;01;22;Torstai;2;0;2
93;01.01.2015;2015;01;23;Torstai;3;0;3
93;02.01.2015;2015;01;00;Perjantai;0;2;2
93;02.01.2015;2015;01;01;Perjantai;0;0;0
93;02.01.2015;2015;01;02;Perjantai;0;0;0
93;02.01.2015;2015;01;03;Perjantai;0;0;0
93;02.01.2015;2015;01;04;Perjantai;0;0;0
93;02.01.2015;2015;01;05;Perjantai;1;2;3
93;02.01.2015;2015;01;06;Perjantai;4;1;5
93;02.01.2015;2015;01;07;Perjantai;1;4;5
93;02.01.2015;2015;01;08;Perjantai;4;4;8
93;02.01.2015;2015;01;09;Perjantai;2;1;3
93;02.01.2015;2015;01;10;Perjantai;0;1;1
93;02.01.2015;2015;01;11;Perjantai;4;3;7
93;02.01.2015;2015;01;12;Perjantai;2;1;3
93;02.01.2015;2015;01;13;Perjantai;3;1;4
93;02.01.2015;2015;01;14;Perjantai;1;3;4
93;02.01.2015;2015;01;15;Perjantai;5;3;8
93;02.01.2015;2015;01;16;Perjantai;4;4;8
93;02.01.2015;2015;01;17;Perjantai;1;3;4
93;02.01.2015;2015;01;18;Perjantai;0;1;1
93;02.01.2015;2015;01;19;Perjantai;0;0;0
93;02.01.2015;2015;01;20;Perjantai;3;0;3
93;02.01.2015;2015;01;21;Perjantai;0;0;0
93;02.01.2015;2015;01;22;Perjantai;0;1;1
93;02.01.2015;2015;01;23;Perjantai;0;0;0
93;03.01.2015;2015;01;00;Lauantai;0;0;0
93;03.01.2015;2015;01;01;Lauantai;0;0;0
93;03.01.2015;2015;01;02;Lauantai;0;0;0
93;03.01.2015;2015;01;03;Lauantai;0;0;0
93;03.01.2015;2015;01;04;Lauantai;0;0;0
93;03.01.2015;2015;01;05;Lauantai;0;1;1
93;03.01.2015;2015;01;06;Lauantai;0;0;0
93;03.01.2015;2015;01;07;Lauantai;2;1;3
93;03.01.2015;2015;01;08;Lauantai;1;0;1
93;03.01.2015;2015;01;09;Lauantai;2;1;3
93;03.01.2015;2015;01;10;Lauantai;1;1;2
93;03.01.2015;2015;01;11;Lauantai;1;0;1
93;03.01.2015;2015;01;12;Lauantai;3;0;3
93;03.01.2015;2015;01;13;Lauantai;0;1;1
93;03.01.2015;2015;01;14;Lauantai;2;3;5
93;03.01.2015;2015;01;15;Lauantai;1;2;3
93;03.01.2015;2015;01;16;Lauantai;2;1;3
93;03.01.2015;2015;01;17;Lauantai;0;0;0
93;03.01.2015;2015;01;18;Lauantai;0;0;0
93;03.01.2015;2015;01;19;Lauantai;1;0;1
93;03.01.2015;2015;01;20;Lauantai;0;1;1
93;03.01.2015;2015;01;21;Lauantai;0;0;0
93;03.01.2015;2015;01;22;Lauantai;0;0;0
93;03.01.2015;2015;01;23;Lauantai;0;0;0
93;04.01.2015;2015;01;00;Sunnuntai;0;0;0
93;04.01.2015;2015;01;01;Sunnuntai;0;0;0
93;04.01.2015;2015;01;02;Sunnuntai;0;0;0
93;04.01.2015;2015;01;03;Sunnuntai;0;0;0
93;04.01.2015;2015;01;04;Sunnuntai;0;0;0
93;04.01.2015;2015;01;05;Sunnuntai;0;0;0
93;04.01.2015;2015;01;06;Sunnuntai;0;0;0
93;04.01.2015;2015;01;07;Sunnuntai;2;0;2
93;04.01.2015;2015;01;08;Sunnuntai;0;1;1
93;04.01.2015;2015;01;09;Sunnuntai;0;0;0
93;04.01.2015;2015;01;10;Sunnuntai;0;1;1
93;04.01.2015;2015;01;11;Sunnuntai;11;0;11
93;04.01.2015;2015;01;12;Sunnuntai;1;1;2
93;04.01.2015;2015;01;13;Sunnuntai;0;5;5
93;04.01.2015;2015;01;14;Sunnuntai;1;0;1
93;04.01.2015;2015;01;15;Sunnuntai;2;1;3
93;04.01.2015;2015;01;16;Sunnuntai;2;2;4
93;04.01.2015;2015;01;17;Sunnuntai;2;2;4
93;04.01.2015;2015;01;18;Sunnuntai;1;0;1
93;04.01.2015;2015;01;19;Sunnuntai;2;1;3
93;04.01.2015;2015;01;20;Sunnuntai;1;1;2
93;04.01.2015;2015;01;21;Sunnuntai;0;0;0
93;04.01.2015;2015;01;22;Sunnuntai;3;1;4
93;04.01.2015;2015;01;23;Sunnuntai;0;1;1
93;05.01.2015;2015;01;00;Maanantai;0;0;0
93;05.01.2015;2015;01;01;Maanantai;0;0;0
93;05.01.2015;2015;01;02;Maanantai;0;0;0
93;05.01.2015;2015;01;03;Maanantai;0;0;0
93;05.01.2015;2015;01;04;Maanantai;0;1;1
93;05.01.2015;2015;01;05;Maanantai;1;1;2
93;05.01.2015;2015;01;06;Maanantai;1;2;3
93;05.01.2015;2015;01;07;Maanantai;9;4;13
93;05.01.2015;2015;01;08;Maanantai;6;5;11
93;05.01.2015;2015;01;09;Maanantai;0;1;1
93;05.01.2015;2015;01;10;Maanantai;1;0;1
93;05.01.2015;2015;01;11;Maanantai;1;2;3
93;05.01.2015;2015;01;12;Maanantai;0;0;0
93;05.01.2015;2015;01;13;Maanantai;0;2;2
93;05.01.2015;2015;01;14;Maanantai;4;2;6
93;05.01.2015;2015;01;15;Maanantai;2;2;4
93;05.01.2015;2015;01;16;Maanantai;3;3;6
93;05.01.2015;2015;01;17;Maanantai;3;2;5
93;05.01.2015;2015;01;18;Maanantai;1;1;2
93;05.01.2015;2015;01;19;Maanantai;2;1;3
93;05.01.2015;2015;01;20;Maanantai;0;0;0
93;05.01.2015;2015;01;21;Maanantai;0;0;0
93;05.01.2015;2015;01;22;Maanantai;0;0;0
93;05.01.2015;2015;01;23;Maanantai;0;0;0
93;06.01.2015;2015;01;00;Tiistai;0;0;0
93;06.01.2015;2015;01;01;Tiistai;0;1;1
93;06.01.2015;2015;01;02;Tiistai;0;0;0
93;06.01.2015;2015;01;03;Tiistai;0;1;1
93;06.01.2015;2015;01;04;Tiistai;1;0;1
93;06.01.2015;2015;01;05;Tiistai;0;0;0
93;06.01.2015;2015;01;06;Tiistai;0;0;0
93;06.01.2015;2015;01;07;Tiistai;0;0;0
93;06.01.2015;2015;01;08;Tiistai;0;0;0
93;06.01.2015;2015;01;09;Tiistai;0;0;0
93;06.01.2015;2015;01;10;Tiistai;0;0;0
93;06.01.2015;2015;01;11;Tiistai;0;0;0
93;06.01.2015;2015;01;12;Tiistai;0;1;1
93;06.01.2015;2015;01;13;Tiistai;0;0;0
93;06.01.2015;2015;01;14;Tiistai;2;0;2
93;06.01.2015;2015;01;15;Tiistai;0;0;0
93;06.01.2015;2015;01;16;Tiistai;0;3;3
93;06.01.2015;2015;01;17;Tiistai;2;0;2
93;06.01.2015;2015;01;18;Tiistai;0;0;0
93;06.01.2015;2015;01;19;Tiistai;1;0;1
93;06.01.2015;2015;01;20;Tiistai;0;0;0
93;06.01.2015;2015;01;21;Tiistai;0;0;0
93;06.01.2015;2015;01;22;Tiistai;0;0;0
93;06.01.2015;2015;01;23;Tiistai;0;0;0
93;07.01.2015;2015;01;00;Keskiviikko;0;0;0
93;07.01.2015;2015;01;01;Keskiviikko;0;0;0
93;07.01.2015;2015;01;02;Keskiviikko;1;0;1
93;07.01.2015;2015;01;03;Keskiviikko;0;0;0
93;07.01.2015;2015;01;04;Keskiviikko;0;1;1
93;07.01.2015;2015;01;05;Keskiviikko;3;0;3
93;07.01.2015;2015;01;06;Keskiviikko;7;2;9
93;07.01.2015;2015;01;07;Keskiviikko;13;11;24
93;07.01.2015;2015;01;08;Keskiviikko;4;12;16
93;07.01.2015;2015;01;09;Keskiviikko;5;0;5
93;07.01.2015;2015;01;10;Keskiviikko;1;3;4
93;07.01.2015;2015;01;11;Keskiviikko;0;0;0
93;07.01.2015;2015;01;12;Keskiviikko;3;2;5
93;07.01.2015;2015;01;13;Keskiviikko;4;2;6
93;07.01.2015;2015;01;14;Keskiviikko;1;3;4
93;07.01.2015;2015;01;15;Keskiviikko;1;5;6
93;07.01.2015;2015;01;16;Keskiviikko;14;9;23
93;07.01.2015;2015;01;17;Keskiviikko;9;3;12
93;07.01.2015;2015;01;18;Keskiviikko;3;1;4
93;07.01.2015;2015;01;19;Keskiviikko;3;0;3
93;07.01.2015;2015;01;20;Keskiviikko;1;0;1
93;07.01.2015;2015;01;21;Keskiviikko;0;0;0
93;07.01.2015;2015;01;22;Keskiviikko;0;0;0
93;07.01.2015;2015;01;23;Keskiviikko;0;0;0
93;08.01.2015;2015;01;00;Torstai;0;0;0
93;08.01.2015;2015;01;01;Torstai;0;0;0
93;08.01.2015;2015;01;02;Torstai;0;0;0
93;08.01.2015;2015;01;03;Torstai;0;0;0
93;08.01.2015;2015;01;04;Torstai;0;1;1
93;08.01.2015;2015;01;05;Torstai;1;2;3
93;08.01.2015;2015;01;06;Torstai;7;4;11
93;08.01.2015;2015;01;07;Torstai;10;13;23
93;08.01.2015;2015;01;08;Torstai;6;12;18
93;08.01.2015;2015;01;09;Torstai;1;1;2
93;08.01.2015;2015;01;10;Torstai;3;3;6
93;08.01.2015;2015;01;11;Torstai;3;1;4
93;08.01.2015;2015;01;12;Torstai;2;2;4
93;08.01.2015;2015;01;13;Torstai;2;2;4
93;08.01.2015;2015;01;14;Torstai;4;3;7
93;08.01.2015;2015;01;15;Torstai;10;2;12
93;08.01.2015;2015;01;16;Torstai;18;7;25
93;08.01.2015;2015;01;17;Torstai;5;7;12
93;08.01.2015;2015;01;18;Torstai;4;5;9
93;08.01.2015;2015;01;19;Torstai;1;0;1
93;08.01.2015;2015;01;20;Torstai;1;0;1
93;08.01.2015;2015;01;21;Torstai;0;1;1
93;08.01.2015;2015;01;22;Torstai;0;1;1
93;08.01.2015;2015;01;23;Torstai;0;2;2
93;09.01.2015;2015;01;00;Perjantai;0;0;0
93;09.01.2015;2015;01;01;Perjantai;0;0;0
93;09.01.2015;2015;01;02;Perjantai;0;0;0
93;09.01.2015;2015;01;03;Perjantai;0;0;0
93;09.01.2015;2015;01;04;Perjantai;0;0;0
93;09.01.2015;2015;01;05;Perjantai;1;0;1
93;09.01.2015;2015;01;06;Perjantai;7;2;9
93;09.01.2015;2015;01;07;Perjantai;7;9;16
93;09.01.2015;2015;01;08;Perjantai;8;12;20
93;09.01.2015;2015;01;09;Perjantai;2;1;3
93;09.01.2015;2015;01;10;Perjantai;1;1;2
93;09.01.2015;2015;01;11;Perjantai;1;4;5
93;09.01.2015;2015;01;12;Perjantai;0;1;1
93;09.01.2015;2015;01;13;Perjantai;6;1;7
93;09.01.2015;2015;01;14;Perjantai;3;2;5
93;09.01.2015;2015;01;15;Perjantai;7;7;14
93;09.01.2015;2015;01;16;Perjantai;12;4;16
93;09.01.2015;2015;01;17;Perjantai;8;6;14
93;09.01.2015;2015;01;18;Perjantai;2;4;6
93;09.01.2015;2015;01;19;Perjantai;0;1;1
93;09.01.2015;2015;01;20;Perjantai;2;1;3
93;09.01.2015;2015;01;21;Perjantai;0;1;1
93;09.01.2015;2015;01;22;Perjantai;0;1;1
93;09.01.2015;2015;01;23;Perjantai;0;1;1
93;10.01.2015;2015;01;00;Lauantai;1;1;2
93;10.01.2015;2015;01;01;Lauantai;0;0;0
93;10.01.2015;2015;01;02;Lauantai;0;0;0
93;10.01.2015;2015;01;03;Lauantai;0;0;0
93;10.01.2015;2015;01;04;Lauantai;0;0;0
93;10.01.2015;2015;01;05;Lauantai;0;1;1
93;10.01.2015;2015;01;06;Lauantai;0;0;0
93;10.01.2015;2015;01;07;Lauantai;0;0;0
93;10.01.2015;2015;01;08;Lauantai;0;1;1
93;10.01.2015;2015;01;09;Lauantai;3;1;4
93;10.01.2015;2015;01;10;Lauantai;0;1;1
93;10.01.2015;2015;01;11;Lauantai;8;2;10
93;10.01.2015;2015;01;12;Lauantai;1;0;1
93;10.01.2015;2015;01;13;Lauantai;3;3;6
93;10.01.2015;2015;01;14;Lauantai;3;2;5
93;10.01.2015;2015;01;15;Lauantai;0;2;2
93;10.01.2015;2015;01;16;Lauantai;0;0;0
93;10.01.2015;2015;01;17;Lauantai;1;1;2
93;10.01.2015;2015;01;18;Lauantai;1;1;2
93;10.01.2015;2015;01;19;Lauantai;0;0;0
93;10.01.2015;2015;01;20;Lauantai;0;2;2
93;10.01.2015;2015;01;21;Lauantai;0;0;0
93;10.01.2015;2015;01;22;Lauantai;1;0;1
93;10.01.2015;2015;01;23;Lauantai;0;0;0
93;11.01.2015;2015;01;00;Sunnuntai;0;0;0
93;11.01.2015;2015;01;01;Sunnuntai;0;0;0
93;11.01.2015;2015;01;02;Sunnuntai;0;0;0
93;11.01.2015;2015;01;03;Sunnuntai;0;0;0
93;11.01.2015;2015;01;04;Sunnuntai;0;0;0
93;11.01.2015;2015;01;05;Sunnuntai;0;0;0
93;11.01.2015;2015;01;06;Sunnuntai;1;0;1
93;11.01.2015;2015;01;07;Sunnuntai;2;0;2
93;11.01.2015;2015;01;08;Sunnuntai;0;0;0
93;11.01.2015;2015;01;09;Sunnuntai;1;1;2
93;11.01.2015;2015;01;10;Sunnuntai;0;1;1
93;11.01.2015;2015;01;11;Sunnuntai;1;0;1
93;11.01.2015;2015;01;12;Sunnuntai;0;2;2
93;11.01.2015;2015;01;13;Sunnuntai;2;1;3
93;11.01.2015;2015;01;14;Sunnuntai;0;3;3
93;11.01.2015;2015;01;15;Sunnuntai;2;0;2
93;11.01.2015;2015;01;16;Sunnuntai;0;1;1
93;11.01.2015;2015;01;17;Sunnuntai;1;1;2
93;11.01.2015;2015;01;18;Sunnuntai;0;1;1
93;11.01.2015;2015;01;19;Sunnuntai;0;0;0
93;11.01.2015;2015;01;20;Sunnuntai;0;1;1
93;11.01.2015;2015;01;21;Sunnuntai;0;0;0
93;11.01.2015;2015;01;22;Sunnuntai;0;0;0
93;11.01.2015;2015;01;23;Sunnuntai;1;0;1
93;12.01.2015;2015;01;00;Maanantai;0;0;0
93;12.01.2015;2015;01;01;Maanantai;0;0;0
93;12.01.2015;2015;01;02;Maanantai;0;0;0
93;12.01.2015;2015;01;03;Maanantai;0;0;0
93;12.01.2015;2015;01;04;Maanantai;0;0;0
93;12.01.2015;2015;01;05;Maanantai;0;0;0
93;12.01.2015;2015;01;06;Maanantai;3;1;4
93;12.01.2015;2015;01;07;Maanantai;5;3;8
93;12.01.2015;2015;01;08;Maanantai;3;9;12
93;12.01.2015;2015;01;09;Maanantai;0;0;0
93;12.01.2015;2015;01;10;Maanantai;1;0;1
93;12.01.2015;2015;01;11;Maanantai;1;3;4
93;12.01.2015;2015;01;12;Maanantai;0;0;0
93;12.01.2015;2015;01;13;Maanantai;1;0;1
93;12.01.2015;2015;01;14;Maanantai;1;0;1
93;12.01.2015;2015;01;15;Maanantai;1;1;2
93;12.01.2015;2015;01;16;Maanantai;8;5;13
93;12.01.2015;2015;01;17;Maanantai;2;3;5
93;12.01.2015;2015;01;18;Maanantai;0;0;0
93;12.01.2015;2015;01;19;Maanantai;0;0;0
93;12.01.2015;2015;01;20;Maanantai;1;0;1
93;12.01.2015;2015;01;21;Maanantai;0;0;0
93;12.01.2015;2015;01;22;Maanantai;0;0;0
93;12.01.2015;2015;01;23;Maanantai;0;0;0
93;13.01.2015;2015;01;00;Tiistai;0;0;0
93;13.01.2015;2015;01;01;Tiistai;0;0;0
93;13.01.2015;2015;01;02;Tiistai;0;0;0
93;13.01.2015;2015;01;03;Tiistai;0;0;0
93;13.01.2015;2015;01;04;Tiistai;0;1;1
93;13.01.2015;2015;01;05;Tiistai;0;1;1
93;13.01.2015;2015;01;06;Tiistai;2;1;3
93;13.01.2015;2015;01;07;Tiistai;6;5;11
93;13.01.2015;2015;01;08;Tiistai;7;6;13
93;13.01.2015;2015;01;09;Tiistai;2;3;5
93;13.01.2015;2015;01;10;Tiistai;1;1;2
93;13.01.2015;2015;01;11;Tiistai;2;2;4
93;13.01.2015;2015;01;12;Tiistai;0;1;1
93;13.01.2015;2015;01;13;Tiistai;2;0;2
93;13.01.2015;2015;01;14;Tiistai;3;2;5
93;13.01.2015;2015;01;15;Tiistai;7;2;9
93;13.01.2015;2015;01;16;Tiistai;9;6;15
93;13.01.2015;2015;01;17;Tiistai;2;2;4
93;13.01.2015;2015;01;18;Tiistai;3;3;6
93;13.01.2015;2015;01;19;Tiistai;4;0;4
93;13.01.2015;2015;01;20;Tiistai;1;2;3
93;13.01.2015;2015;01;21;Tiistai;0;1;1
93;13.01.2015;2015;01;22;Tiistai;0;1;1
93;13.01.2015;2015;01;23;Tiistai;0;0;0
93;14.01.2015;2015;01;00;Keskiviikko;0;0;0
93;14.01.2015;2015;01;01;Keskiviikko;0;0;0
93;14.01.2015;2015;01;02;Keskiviikko;0;0;0
93;14.01.2015;2015;01;03;Keskiviikko;0;0;0
93;14.01.2015;2015;01;04;Keskiviikko;0;1;1
93;14.01.2015;2015;01;05;Keskiviikko;0;1;1
93;14.01.2015;2015;01;06;Keskiviikko;4;3;7
93;14.01.2015;2015;01;07;Keskiviikko;12;4;16
93;14.01.2015;2015;01;08;Keskiviikko;4;8;12
93;14.01.2015;2015;01;09;Keskiviikko;1;1;2
93;14.01.2015;2015;01;10;Keskiviikko;1;1;2
93;14.01.2015;2015;01;11;Keskiviikko;0;2;2
93;14.01.2015;2015;01;12;Keskiviikko;2;2;4
93;14.01.2015;2015;01;13;Keskiviikko;2;0;2
93;14.01.2015;2015;01;14;Keskiviikko;6;1;7
93;14.01.2015;2015;01;15;Keskiviikko;5;2;7
93;14.01.2015;2015;01;16;Keskiviikko;11;8;19
93;14.01.2015;2015;01;17;Keskiviikko;6;3;9
93;14.01.2015;2015;01;18;Keskiviikko;2;5;7
93;14.01.2015;2015;01;19;Keskiviikko;2;0;2
93;14.01.2015;2015;01;20;Keskiviikko;1;0;1
93;14.01.2015;2015;01;21;Keskiviikko;0;2;2
93;14.01.2015;2015;01;22;Keskiviikko;0;0;0
93;14.01.2015;2015;01;23;Keskiviikko;0;0;0
93;15.01.2015;2015;01;00;Torstai;0;0;0
93;15.01.2015;2015;01;01;Torstai;0;0;0
93;15.01.2015;2015;01;02;Torstai;0;0;0
93;15.01.2015;2015;01;03;Torstai;0;0;0
93;15.01.2015;2015;01;04;Torstai;0;1;1
93;15.01.2015;2015;01;05;Torstai;0;1;1
93;15.01.2015;2015;01;06;Torstai;9;7;16
93;15.01.2015;2015;01;07;Torstai;17;9;26
93;15.01.2015;2015;01;08;Torstai;3;11;14
93;15.01.2015;2015;01;09;Torstai;5;1;6
93;15.01.2015;2015;01;10;Torstai;0;0;0
93;15.01.2015;2015;01;11;Torstai;2;2;4
93;15.01.2015;2015;01;12;Torstai;2;1;3
93;15.01.2015;2015;01;13;Torstai;3;1;4
93;15.01.2015;2015;01;14;Torstai;3;4;7
93;15.01.2015;2015;01;15;Torstai;14;11;25
93;15.01.2015;2015;01;16;Torstai;13;10;23
93;15.01.2015;2015;01;17;Torstai;10;7;17
93;15.01.2015;2015;01;18;Torstai;0;6;6
93;15.01.2015;2015;01;19;Torstai;3;0;3
93;15.01.2015;2015;01;20;Torstai;2;0;2
93;15.01.2015;2015;01;21;Torstai;1;1;2
93;15.01.2015;2015;01;22;Torstai;0;3;3
93;15.01.2015;2015;01;23;Torstai;0;0;0
93;16.01.2015;2015;01;00;Perjantai;0;1;1
93;16.01.2015;2015;01;01;Perjantai;0;0;0
93;16.01.2015;2015;01;02;Perjantai;0;0;0
93;16.01.2015;2015;01;03;Perjantai;0;0;0
93;16.01.2015;2015;01;04;Perjantai;1;1;2
93;16.01.2015;2015;01;05;Perjantai;0;1;1
93;16.01.2015;2015;01;06;Perjantai;9;3;12
93;16.01.2015;2015;01;07;Perjantai;10;11;21
93;16.01.2015;2015;01;08;Perjantai;3;4;7
93;16.01.2015;2015;01;09;Perjantai;1;1;2
93;16.01.2015;2015;01;10;Perjantai;0;0;0
93;16.01.2015;2015;01;11;Perjantai;0;2;2
93;16.01.2015;2015;01;12;Perjantai;0;0;0
93;16.01.2015;2015;01;13;Perjantai;2;5;7
93;16.01.2015;2015;01;14;Perjantai;3;1;4
93;16.01.2015;2015;01;15;Perjantai;4;5;9
93;16.01.2015;2015;01;16;Perjantai;9;9;18
93;16.01.2015;2015;01;17;Perjantai;6;0;6
93;16.01.2015;2015;01;18;Perjantai;6;4;10
93;16.01.2015;2015;01;19;Perjantai;1;1;2
93;16.01.2015;2015;01;20;Perjantai;0;2;2
93;16.01.2015;2015;01;21;Perjantai;1;0;1
93;16.01.2015;2015;01;22;Perjantai;0;0;0
93;16.01.2015;2015;01;23;Perjantai;0;0;0
93;17.01.2015;2015;01;00;Lauantai;0;1;1
93;17.01.2015;2015;01;01;Lauantai;0;0;0
93;17.01.2015;2015;01;02;Lauantai;0;0;0
93;17.01.2015;2015;01;03;Lauantai;0;0;0
93;17.01.2015;2015;01;04;Lauantai;0;0;0
93;17.01.2015;2015;01;05;Lauantai;0;0;0
93;17.01.2015;2015;01;06;Lauantai;0;0;0
93;17.01.2015;2015;01;07;Lauantai;2;1;3
93;17.01.2015;2015;01;08;Lauantai;2;1;3
93;17.01.2015;2015;01;09;Lauantai;1;1;2
93;17.01.2015;2015;01;10;Lauantai;0;0;0
93;17.01.2015;2015;01;11;Lauantai;0;0;0
93;17.01.2015;2015;01;12;Lauantai;0;1;1
93;17.01.2015;2015;01;13;Lauantai;3;1;4
93;17.01.2015;2015;01;14;Lauantai;1;3;4
93;17.01.2015;2015;01;15;Lauantai;3;0;3
93;17.01.2015;2015;01;16;Lauantai;2;1;3
93;17.01.2015;2015;01;17;Lauantai;1;1;2
93;17.01.2015;2015;01;18;Lauantai;0;2;2
93;17.01.2015;2015;01;19;Lauantai;0;0;0
93;17.01.2015;2015;01;20;Lauantai;1;1;2
93;17.01.2015;2015;01;21;Lauantai;0;0;0
93;17.01.2015;2015;01;22;Lauantai;1;0;1
93;17.01.2015;2015;01;23;Lauantai;0;0;0
93;18.01.2015;2015;01;00;Sunnuntai;0;0;0
93;18.01.2015;2015;01;01;Sunnuntai;0;0;0
93;18.01.2015;2015;01;02;Sunnuntai;0;0;0
93;18.01.2015;2015;01;03;Sunnuntai;0;0;0
93;18.01.2015;2015;01;04;Sunnuntai;0;0;0
93;18.01.2015;2015;01;05;Sunnuntai;0;0;0
93;18.01.2015;2015;01;06;Sunnuntai;0;0;0
93;18.01.2015;2015;01;07;Sunnuntai;3;0;3
93;18.01.2015;2015;01;08;Sunnuntai;0;1;1
93;18.01.2015;2015;01;09;Sunnuntai;0;0;0
93;18.01.2015;2015;01;10;Sunnuntai;3;1;4
93;18.01.2015;2015;01;11;Sunnuntai;5;2;7
93;18.01.2015;2015;01;12;Sunnuntai;0;6;6
93;18.01.2015;2015;01;13;Sunnuntai;1;5;6
93;18.01.2015;2015;01;14;Sunnuntai;4;1;5
93;18.01.2015;2015;01;15;Sunnuntai;1;2;3
93;18.01.2015;2015;01;16;Sunnuntai;1;0;1
93;18.01.2015;2015;01;17;Sunnuntai;1;0;1
93;18.01.2015;2015;01;18;Sunnuntai;1;3;4
93;18.01.2015;2015;01;19;Sunnuntai;2;1;3
93;18.01.2015;2015;01;20;Sunnuntai;0;2;2
93;18.01.2015;2015;01;21;Sunnuntai;0;0;0
93;18.01.2015;2015;01;22;Sunnuntai;0;0;0
93;18.01.2015;2015;01;23;Sunnuntai;0;0;0
93;19.01.2015;2015;01;00;Maanantai;0;0;0
93;19.01.2015;2015;01;01;Maanantai;0;0;0
93;19.01.2015;2015;01;02;Maanantai;0;0;0
93;19.01.2015;2015;01;03;Maanantai;0;0;0
93;19.01.2015;2015;01;04;Maanantai;0;0;0
93;19.01.2015;2015;01;05;Maanantai;0;0;0
93;19.01.2015;2015;01;06;Maanantai;5;5;10
93;19.01.2015;2015;01;07;Maanantai;15;10;25
93;19.01.2015;2015;01;08;Maanantai;5;8;13
93;19.01.2015;2015;01;09;Maanantai;0;2;2
93;19.01.2015;2015;01;10;Maanantai;3;1;4
93;19.01.2015;2015;01;11;Maanantai;0;0;0
93;19.01.2015;2015;01;12;Maanantai;2;2;4
93;19.01.2015;2015;01;13;Maanantai;1;0;1
93;19.01.2015;2015;01;14;Maanantai;4;2;6
93;19.01.2015;2015;01;15;Maanantai;3;6;9
93;19.01.2015;2015;01;16;Maanantai;13;7;20
93;19.01.2015;2015;01;17;Maanantai;6;4;10
93;19.01.2015;2015;01;18;Maanantai;2;5;7
93;19.01.2015;2015;01;19;Maanantai;2;0;2
93;19.01.2015;2015;01;20;Maanantai;0;2;2
93;19.01.2015;2015;01;21;Maanantai;1;0;1
93;19.01.2015;2015;01;22;Maanantai;0;1;1
93;19.01.2015;2015;01;23;Maanantai;0;0;0
93;20.01.2015;2015;01;00;Tiistai;0;0;0
93;20.01.2015;2015;01;01;Tiistai;0;0;0
93;20.01.2015;2015;01;02;Tiistai;0;0;0
93;20.01.2015;2015;01;03;Tiistai;0;0;0
93;20.01.2015;2015;01;04;Tiistai;0;0;0
93;20.01.2015;2015;01;05;Tiistai;0;0;0
93;20.01.2015;2015;01;06;Tiistai;4;1;5
93;20.01.2015;2015;01;07;Tiistai;7;5;12
93;20.01.2015;2015;01;08;Tiistai;1;8;9
93;20.01.2015;2015;01;09;Tiistai;0;0;0
93;20.01.2015;2015;01;10;Tiistai;0;0;0
93;20.01.2015;2015;01;11;Tiistai;0;1;1
93;20.01.2015;2015;01;12;Tiistai;1;0;1
93;20.01.2015;2015;01;13;Tiistai;0;1;1
93;20.01.2015;2015;01;14;Tiistai;1;3;4
93;20.01.2015;2015;01;15;Tiistai;3;2;5
93;20.01.2015;2015;01;16;Tiistai;8;5;13
93;20.01.2015;2015;01;17;Tiistai;3;1;4
93;20.01.2015;2015;01;18;Tiistai;2;2;4
93;20.01.2015;2015;01;19;Tiistai;1;0;1
93;20.01.2015;2015;01;20;Tiistai;0;0;0
93;20.01.2015;2015;01;21;Tiistai;0;0;0
93;20.01.2015;2015;01;22;Tiistai;0;0;0
93;20.01.2015;2015;01;23;Tiistai;0;0;0
93;21.01.2015;2015;01;00;Keskiviikko;0;0;0
93;21.01.2015;2015;01;01;Keskiviikko;0;0;0
93;21.01.2015;2015;01;02;Keskiviikko;0;0;0
93;21.01.2015;2015;01;03;Keskiviikko;0;0;0
93;21.01.2015;2015;01;04;Keskiviikko;0;0;0
93;21.01.2015;2015;01;05;Keskiviikko;2;0;2
93;21.01.2015;2015;01;06;Keskiviikko;5;4;9
93;21.01.2015;2015;01;07;Keskiviikko;8;8;16
93;21.01.2015;2015;01;08;Keskiviikko;3;7;10
93;21.01.2015;2015;01;09;Keskiviikko;2;0;2
93;21.01.2015;2015;01;10;Keskiviikko;1;1;2
93;21.01.2015;2015;01;11;Keskiviikko;4;1;5
93;21.01.2015;2015;01;12;Keskiviikko;3;2;5
93;21.01.2015;2015;01;13;Keskiviikko;3;0;3
93;21.01.2015;2015;01;14;Keskiviikko;1;3;4
93;21.01.2015;2015;01;15;Keskiviikko;3;3;6
93;21.01.2015;2015;01;16;Keskiviikko;8;7;15
93;21.01.2015;2015;01;17;Keskiviikko;4;1;5
93;21.01.2015;2015;01;18;Keskiviikko;5;5;10
93;21.01.2015;2015;01;19;Keskiviikko;0;2;2
93;21.01.2015;2015;01;20;Keskiviikko;0;1;1
93;21.01.2015;2015;01;21;Keskiviikko;0;0;0
93;21.01.2015;2015;01;22;Keskiviikko;0;0;0
93;21.01.2015;2015;01;23;Keskiviikko;0;0;0
93;22.01.2015;2015;01;00;Torstai;0;0;0
93;22.01.2015;2015;01;01;Torstai;0;0;0
93;22.01.2015;2015;01;02;Torstai;0;0;0
93;22.01.2015;2015;01;03;Torstai;0;0;0
93;22.01.2015;2015;01;04;Torstai;0;0;0
93;22.01.2015;2015;01;05;Torstai;0;0;0
93;22.01.2015;2015;01;06;Torstai;4;1;5
93;22.01.2015;2015;01;07;Torstai;7;7;14
93;22.01.2015;2015;01;08;Torstai;2;8;10
93;22.01.2015;2015;01;09;Torstai;0;0;0
93;22.01.2015;2015;01;10;Torstai;0;0;0
93;22.01.2015;2015;01;11;Torstai;0;1;1
93;22.01.2015;2015;01;12;Torstai;0;0;0
93;22.01.2015;2015;01;13;Torstai;3;1;4
93;22.01.2015;2015;01;14;Torstai;0;3;3
93;22.01.2015;2015;01;15;Torstai;2;2;4
93;22.01.2015;2015;01;16;Torstai;8;7;15
93;22.01.2015;2015;01;17;Torstai;4;3;7
93;22.01.2015;2015;01;18;Torstai;1;1;2
93;22.01.2015;2015;01;19;Torstai;1;0;1
93;22.01.2015;2015;01;20;Torstai;0;0;0
93;22.01.2015;2015;01;21;Torstai;0;0;0
93;22.01.2015;2015;01;22;Torstai;0;0;0
93;22.01.2015;2015;01;23;Torstai;0;0;0
93;23.01.2015;2015;01;00;Perjantai;0;0;0
93;23.01.2015;2015;01;01;Perjantai;0;0;0
93;23.01.2015;2015;01;02;Perjantai;0;0;0
93;23.01.2015;2015;01;03;Perjantai;0;0;0
93;23.01.2015;2015;01;04;Perjantai;0;0;0
93;23.01.2015;2015;01;05;Perjantai;0;0;0
93;23.01.2015;2015;01;06;Perjantai;3;1;4
93;23.01.2015;2015;01;07;Perjantai;6;6;12
93;23.01.2015;2015;01;08;Perjantai;1;5;6
93;23.01.2015;2015;01;09;Perjantai;0;0;0
93;23.01.2015;2015;01;10;Perjantai;0;0;0
93;23.01.2015;2015;01;11;Perjantai;0;2;2
93;23.01.2015;2015;01;12;Perjantai;0;0;0
93;23.01.2015;2015;01;13;Perjantai;0;2;2
93;23.01.2015;2015;01;14;Perjantai;1;0;1
93;23.01.2015;2015;01;15;Perjantai;5;2;7
93;23.01.2015;2015;01;16;Perjantai;7;4;11
93;23.01.2015;2015;01;17;Perjantai;3;1;4
93;23.01.2015;2015;01;18;Perjantai;0;1;1
93;23.01.2015;2015;01;19;Perjantai;0;0;0
93;23.01.2015;2015;01;20;Perjantai;1;0;1
93;23.01.2015;2015;01;21;Perjantai;0;1;1
93;23.01.2015;2015;01;22;Perjantai;0;0;0
93;23.01.2015;2015;01;23;Perjantai;0;0;0
93;24.01.2015;2015;01;00;Lauantai;1;0;1
93;24.01.2015;2015;01;01;Lauantai;0;0;0
93;24.01.2015;2015;01;02;Lauantai;0;0;0
93;24.01.2015;2015;01;03;Lauantai;0;0;0
93;24.01.2015;2015;01;04;Lauantai;0;0;0
93;24.01.2015;2015;01;05;Lauantai;0;0;0
93;24.01.2015;2015;01;06;Lauantai;0;0;0
93;24.01.2015;2015;01;07;Lauantai;0;0;0
93;24.01.2015;2015;01;08;Lauantai;0;0;0
93;24.01.2015;2015;01;09;Lauantai;2;1;3
93;24.01.2015;2015;01;10;Lauantai;0;3;3
93;24.01.2015;2015;01;11;Lauantai;0;1;1
93;24.01.2015;2015;01;12;Lauantai;0;0;0
93;24.01.2015;2015;01;13;Lauantai;2;2;4
93;24.01.2015;2015;01;14;Lauantai;0;1;1
93;24.01.2015;2015;01;15;Lauantai;3;2;5
93;24.01.2015;2015;01;16;Lauantai;0;1;1
93;24.01.2015;2015;01;17;Lauantai;0;1;1
93;24.01.2015;2015;01;18;Lauantai;0;0;0
93;24.01.2015;2015;01;19;Lauantai;0;1;1
93;24.01.2015;2015;01;20;Lauantai;0;1;1
93;24.01.2015;2015;01;21;Lauantai;0;0;0
93;24.01.2015;2015;01;22;Lauantai;0;1;1
93;24.01.2015;2015;01;23;Lauantai;0;0;0
93;25.01.2015;2015;01;00;Sunnuntai;0;0;0
93;25.01.2015;2015;01;01;Sunnuntai;0;0;0
93;25.01.2015;2015;01;02;Sunnuntai;0;0;0
93;25.01.2015;2015;01;03;Sunnuntai;0;0;0
93;25.01.2015;2015;01;04;Sunnuntai;0;0;0
93;25.01.2015;2015;01;05;Sunnuntai;0;0;0
93;25.01.2015;2015;01;06;Sunnuntai;0;0;0
93;25.01.2015;2015;01;07;Sunnuntai;0;0;0
93;25.01.2015;2015;01;08;Sunnuntai;0;0;0
93;25.01.2015;2015;01;09;Sunnuntai;2;1;3
93;25.01.2015;2015;01;10;Sunnuntai;1;0;1
93;25.01.2015;2015;01;11;Sunnuntai;10;0;10
93;25.01.2015;2015;01;12;Sunnuntai;5;4;9
93;25.01.2015;2015;01;13;Sunnuntai;1;2;3
93;25.01.2015;2015;01;14;Sunnuntai;1;6;7
93;25.01.2015;2015;01;15;Sunnuntai;3;1;4
93;25.01.2015;2015;01;16;Sunnuntai;1;2;3
93;25.01.2015;2015;01;17;Sunnuntai;3;3;6
93;25.01.2015;2015;01;18;Sunnuntai;0;1;1
93;25.01.2015;2015;01;19;Sunnuntai;1;1;2
93;25.01.2015;2015;01;20;Sunnuntai;0;0;0
93;25.01.2015;2015;01;21;Sunnuntai;0;0;0
93;25.01.2015;2015;01;22;Sunnuntai;0;0;0
93;25.01.2015;2015;01;23;Sunnuntai;0;1;1
93;26.01.2015;2015;01;00;Maanantai;0;0;0
93;26.01.2015;2015;01;01;Maanantai;0;0;0
93;26.01.2015;2015;01;02;Maanantai;0;0;0
93;26.01.2015;2015;01;03;Maanantai;0;0;0
93;26.01.2015;2015;01;04;Maanantai;0;0;0
93;26.01.2015;2015;01;05;Maanantai;1;0;1
93;26.01.2015;2015;01;06;Maanantai;12;2;14
93;26.01.2015;2015;01;07;Maanantai;10;9;19
93;26.01.2015;2015;01;08;Maanantai;7;14;21
93;26.01.2015;2015;01;09;Maanantai;1;0;1
93;26.01.2015;2015;01;10;Maanantai;2;1;3
93;26.01.2015;2015;01;11;Maanantai;2;1;3
93;26.01.2015;2015;01;12;Maanantai;4;2;6
93;26.01.2015;2015;01;13;Maanantai;2;2;4
93;26.01.2015;2015;01;14;Maanantai;2;5;7
93;26.01.2015;2015;01;15;Maanantai;4;4;8
93;26.01.2015;2015;01;16;Maanantai;14;9;23
93;26.01.2015;2015;01;17;Maanantai;7;7;14
93;26.01.2015;2015;01;18;Maanantai;0;1;1
93;26.01.2015;2015;01;19;Maanantai;1;0;1
93;26.01.2015;2015;01;20;Maanantai;4;1;5
93;26.01.2015;2015;01;21;Maanantai;0;1;1
93;26.01.2015;2015;01;22;Maanantai;0;1;1
93;26.01.2015;2015;01;23;Maanantai;0;0;0
93;27.01.2015;2015;01;00;Tiistai;0;0;0
93;27.01.2015;2015;01;01;Tiistai;0;0;0
93;27.01.2015;2015;01;02;Tiistai;0;0;0
93;27.01.2015;2015;01;03;Tiistai;0;0;0
93;27.01.2015;2015;01;04;Tiistai;1;0;1
93;27.01.2015;2015;01;05;Tiistai;0;2;2
93;27.01.2015;2015;01;06;Tiistai;7;2;9
93;27.01.2015;2015;01;07;Tiistai;10;11;21
93;27.01.2015;2015;01;08;Tiistai;3;9;12
93;27.01.2015;2015;01;09;Tiistai;1;1;2
93;27.01.2015;2015;01;10;Tiistai;0;2;2
93;27.01.2015;2015;01;11;Tiistai;1;1;2
93;27.01.2015;2015;01;12;Tiistai;3;2;5
93;27.01.2015;2015;01;13;Tiistai;2;1;3
93;27.01.2015;2015;01;14;Tiistai;7;4;11
93;27.01.2015;2015;01;15;Tiistai;8;8;16
93;27.01.2015;2015;01;16;Tiistai;11;7;18
93;27.01.2015;2015;01;17;Tiistai;1;5;6
93;27.01.2015;2015;01;18;Tiistai;9;6;15
93;27.01.2015;2015;01;19;Tiistai;2;1;3
93;27.01.2015;2015;01;20;Tiistai;0;2;2
93;27.01.2015;2015;01;21;Tiistai;0;1;1
93;27.01.2015;2015;01;22;Tiistai;2;1;3
93;27.01.2015;2015;01;23;Tiistai;0;0;0
93;28.01.2015;2015;01;00;Keskiviikko;0;0;0
93;28.01.2015;2015;01;01;Keskiviikko;0;0;0
93;28.01.2015;2015;01;02;Keskiviikko;0;0;0
93;28.01.2015;2015;01;03;Keskiviikko;0;0;0
93;28.01.2015;2015;01;04;Keskiviikko;0;0;0
93;28.01.2015;2015;01;05;Keskiviikko;2;2;4
93;28.01.2015;2015;01;06;Keskiviikko;4;5;9
93;28.01.2015;2015;01;07;Keskiviikko;9;12;21
93;28.01.2015;2015;01;08;Keskiviikko;10;10;20
93;28.01.2015;2015;01;09;Keskiviikko;3;4;7
93;28.01.2015;2015;01;10;Keskiviikko;3;6;9
93;28.01.2015;2015;01;11;Keskiviikko;2;1;3
93;28.01.2015;2015;01;12;Keskiviikko;0;0;0
93;28.01.2015;2015;01;13;Keskiviikko;1;0;1
93;28.01.2015;2015;01;14;Keskiviikko;4;2;6
93;28.01.2015;2015;01;15;Keskiviikko;5;5;10
93;28.01.2015;2015;01;16;Keskiviikko;28;20;48
93;28.01.2015;2015;01;17;Keskiviikko;7;3;10
93;28.01.2015;2015;01;18;Keskiviikko;7;3;10
93;28.01.2015;2015;01;19;Keskiviikko;0;1;1
93;28.01.2015;2015;01;20;Keskiviikko;1;2;3
93;28.01.2015;2015;01;21;Keskiviikko;0;1;1
93;28.01.2015;2015;01;22;Keskiviikko;0;2;2
93;28.01.2015;2015;01;23;Keskiviikko;0;0;0
93;29.01.2015;2015;01;00;Torstai;0;0;0
93;29.01.2015;2015;01;01;Torstai;0;0;0
93;29.01.2015;2015;01;02;Torstai;0;0;0
93;29.01.2015;2015;01;03;Torstai;0;0;0
93;29.01.2015;2015;01;04;Torstai;0;0;0
93;29.01.2015;2015;01;05;Torstai;0;1;1
93;29.01.2015;2015;01;06;Torstai;2;1;3
93;29.01.2015;2015;01;07;Torstai;5;8;13
93;29.01.2015;2015;01;08;Torstai;8;8;16
93;29.01.2015;2015;01;09;Torstai;1;1;2
93;29.01.2015;2015;01;10;Torstai;0;4;4
93;29.01.2015;2015;01;11;Torstai;1;0;1
93;29.01.2015;2015;01;12;Torstai;1;1;2
93;29.01.2015;2015;01;13;Torstai;2;0;2
93;29.01.2015;2015;01;14;Torstai;1;2;3
93;29.01.2015;2015;01;15;Torstai;6;1;7
93;29.01.2015;2015;01;16;Torstai;16;8;24
93;29.01.2015;2015;01;17;Torstai;3;4;7
93;29.01.2015;2015;01;18;Torstai;1;1;2
93;29.01.2015;2015;01;19;Torstai;0;0;0
93;29.01.2015;2015;01;20;Torstai;0;1;1
93;29.01.2015;2015;01;21;Torstai;0;0;0
93;29.01.2015;2015;01;22;Torstai;0;2;2
93;29.01.2015;2015;01;23;Torstai;0;0;0
93;30.01.2015;2015;01;00;Perjantai;0;0;0
93;30.01.2015;2015;01;01;Perjantai;0;0;0
93;30.01.2015;2015;01;02;Perjantai;0;0;0
93;30.01.2015;2015;01;03;Perjantai;0;0;0
93;30.01.2015;2015;01;04;Perjantai;0;0;0
93;30.01.2015;2015;01;05;Perjantai;1;1;2
93;30.01.2015;2015;01;06;Perjantai;3;1;4
93;30.01.2015;2015;01;07;Perjantai;7;7;14
93;30.01.2015;2015;01;08;Perjantai;5;6;11
93;30.01.2015;2015;01;09;Perjantai;2;1;3
93;30.01.2015;2015;01;10;Perjantai;2;2;4
93;30.01.2015;2015;01;11;Perjantai;0;0;0
93;30.01.2015;2015;01;12;Perjantai;0;1;1
93;30.01.2015;2015;01;13;Perjantai;1;1;2
93;30.01.2015;2015;01;14;Perjantai;3;3;6
93;30.01.2015;2015;01;15;Perjantai;3;2;5
93;30.01.2015;2015;01;16;Perjantai;8;1;9
93;30.01.2015;2015;01;17;Perjantai;2;3;5
93;30.01.2015;2015;01;18;Perjantai;1;3;4
93;30.01.2015;2015;01;19;Perjantai;2;1;3
93;30.01.2015;2015;01;20;Perjantai;2;0;2
93;30.01.2015;2015;01;21;Perjantai;0;0;0
93;30.01.2015;2015;01;22;Perjantai;1;1;2
93;30.01.2015;2015;01;23;Perjantai;1;1;2
93;31.01.2015;2015;01;00;Lauantai;0;0;0
93;31.01.2015;2015;01;01;Lauantai;0;0;0
93;31.01.2015;2015;01;02;Lauantai;0;0;0
93;31.01.2015;2015;01;03;Lauantai;0;0;0
93;31.01.2015;2015;01;04;Lauantai;0;0;0
93;31.01.2015;2015;01;05;Lauantai;0;1;1
93;31.01.2015;2015;01;06;Lauantai;1;0;1
93;31.01.2015;2015;01;07;Lauantai;1;2;3
93;31.01.2015;2015;01;08;Lauantai;2;0;2
93;31.01.2015;2015;01;09;Lauantai;2;0;2
93;31.01.2015;2015;01;10;Lauantai;2;1;3
93;31.01.2015;2015;01;11;Lauantai;1;1;2
93;31.01.2015;2015;01;12;Lauantai;2;4;6
93;31.01.2015;2015;01;13;Lauantai;1;0;1
93;31.01.2015;2015;01;14;Lauantai;7;3;10
93;31.01.2015;2015;01;15;Lauantai;0;3;3
93;31.01.2015;2015;01;16;Lauantai;4;0;4
93;31.01.2015;2015;01;17;Lauantai;0;2;2
93;31.01.2015;2015;01;18;Lauantai;0;1;1
93;31.01.2015;2015;01;19;Lauantai;0;0;0
93;31.01.2015;2015;01;20;Lauantai;2;0;2
93;31.01.2015;2015;01;21;Lauantai;0;2;2
93;31.01.2015;2015;01;22;Lauantai;0;0;0
93;31.01.2015;2015;01;23;Lauantai;0;0;0
93;01.02.2015;2015;02;00;Sunnuntai;0;0;0
93;01.02.2015;2015;02;01;Sunnuntai;0;0;0
93;01.02.2015;2015;02;02;Sunnuntai;0;0;0
93;01.02.2015;2015;02;03;Sunnuntai;0;0;0
93;01.02.2015;2015;02;04;Sunnuntai;0;0;0
93;01.02.2015;2015;02;05;Sunnuntai;0;0;0
93;01.02.2015;2015;02;06;Sunnuntai;0;0;0
93;01.02.2015;2015;02;07;Sunnuntai;8;0;8
93;01.02.2015;2015;02;08;Sunnuntai;0;0;0
93;01.02.2015;2015;02;09;Sunnuntai;0;0;0
93;01.02.2015;2015;02;10;Sunnuntai;0;0;0
93;01.02.2015;2015;02;11;Sunnuntai;0;1;1
93;01.02.2015;2015;02;12;Sunnuntai;0;2;2
93;01.02.2015;2015;02;13;Sunnuntai;1;0;1
93;01.02.2015;2015;02;14;Sunnuntai;0;0;0
93;01.02.2015;2015;02;15;Sunnuntai;0;2;2
93;01.02.2015;2015;02;16;Sunnuntai;2;1;3
93;01.02.2015;2015;02;17;Sunnuntai;0;0;0
93;01.02.2015;2015;02;18;Sunnuntai;1;0;1
93;01.02.2015;2015;02;19;Sunnuntai;2;2;4
93;01.02.2015;2015;02;20;Sunnuntai;0;0;0
93;01.02.2015;2015;02;21;Sunnuntai;1;0;1
93;01.02.2015;2015;02;22;Sunnuntai;0;0;0
93;01.02.2015;2015;02;23;Sunnuntai;0;3;3
93;02.02.2015;2015;02;00;Maanantai;0;0;0
93;02.02.2015;2015;02;01;Maanantai;0;0;0
93;02.02.2015;2015;02;02;Maanantai;0;0;0
93;02.02.2015;2015;02;03;Maanantai;0;0;0
93;02.02.2015;2015;02;04;Maanantai;0;0;0
93;02.02.2015;2015;02;05;Maanantai;1;1;2
93;02.02.2015;2015;02;06;Maanantai;4;1;5
93;02.02.2015;2015;02;07;Maanantai;10;11;21
93;02.02.2015;2015;02;08;Maanantai;3;10;13
93;02.02.2015;2015;02;09;Maanantai;2;1;3
93;02.02.2015;2015;02;10;Maanantai;2;2;4
93;02.02.2015;2015;02;11;Maanantai;1;3;4
93;02.02.2015;2015;02;12;Maanantai;0;1;1
93;02.02.2015;2015;02;13;Maanantai;2;0;2
93;02.02.2015;2015;02;14;Maanantai;4;4;8
93;02.02.2015;2015;02;15;Maanantai;7;4;11
93;02.02.2015;2015;02;16;Maanantai;10;6;16
93;02.02.2015;2015;02;17;Maanantai;5;4;9
93;02.02.2015;2015;02;18;Maanantai;2;2;4
93;02.02.2015;2015;02;19;Maanantai;2;2;4
93;02.02.2015;2015;02;20;Maanantai;2;2;4
93;02.02.2015;2015;02;21;Maanantai;0;0;0
93;02.02.2015;2015;02;22;Maanantai;0;0;0
93;02.02.2015;2015;02;23;Maanantai;0;0;0
93;03.02.2015;2015;02;00;Tiistai;0;0;0
93;03.02.2015;2015;02;01;Tiistai;0;0;0
93;03.02.2015;2015;02;02;Tiistai;0;0;0
93;03.02.2015;2015;02;03;Tiistai;0;0;0
93;03.02.2015;2015;02;04;Tiistai;0;0;0
93;03.02.2015;2015;02;05;Tiistai;1;0;1
93;03.02.2015;2015;02;06;Tiistai;2;2;4
93;03.02.2015;2015;02;07;Tiistai;16;9;25
93;03.02.2015;2015;02;08;Tiistai;9;11;20
93;03.02.2015;2015;02;09;Tiistai;3;1;4
93;03.02.2015;2015;02;10;Tiistai;0;2;2
93;03.02.2015;2015;02;11;Tiistai;0;1;1
93;03.02.2015;2015;02;12;Tiistai;1;2;3
93;03.02.2015;2015;02;13;Tiistai;1;0;1
93;03.02.2015;2015;02;14;Tiistai;0;2;2
93;03.02.2015;2015;02;15;Tiistai;7;6;13
93;03.02.2015;2015;02;16;Tiistai;8;6;14
93;03.02.2015;2015;02;17;Tiistai;4;4;8
93;03.02.2015;2015;02;18;Tiistai;2;2;4
93;03.02.2015;2015;02;19;Tiistai;1;1;2
93;03.02.2015;2015;02;20;Tiistai;3;2;5
93;03.02.2015;2015;02;21;Tiistai;0;0;0
93;03.02.2015;2015;02;22;Tiistai;0;0;0
93;03.02.2015;2015;02;23;Tiistai;0;0;0
93;04.02.2015;2015;02;00;Keskiviikko;0;0;0
93;04.02.2015;2015;02;01;Keskiviikko;0;0;0
93;04.02.2015;2015;02;02;Keskiviikko;0;0;0
93;04.02.2015;2015;02;03;Keskiviikko;0;0;0
93;04.02.2015;2015;02;04;Keskiviikko;0;0;0
93;04.02.2015;2015;02;05;Keskiviikko;2;0;2
93;04.02.2015;2015;02;06;Keskiviikko;2;2;4
93;04.02.2015;2015;02;07;Keskiviikko;10;13;23
93;04.02.2015;2015;02;08;Keskiviikko;7;9;16
93;04.02.2015;2015;02;09;Keskiviikko;3;3;6
93;04.02.2015;2015;02;10;Keskiviikko;1;2;3
93;04.02.2015;2015;02;11;Keskiviikko;3;1;4
93;04.02.2015;2015;02;12;Keskiviikko;1;1;2
93;04.02.2015;2015;02;13;Keskiviikko;6;3;9
93;04.02.2015;2015;02;14;Keskiviikko;2;4;6
93;04.02.2015;2015;02;15;Keskiviikko;5;4;9
93;04.02.2015;2015;02;16;Keskiviikko;14;10;24
93;04.02.2015;2015;02;17;Keskiviikko;8;2;10
93;04.02.2015;2015;02;18;Keskiviikko;1;3;4
93;04.02.2015;2015;02;19;Keskiviikko;1;0;1
93;04.02.2015;2015;02;20;Keskiviikko;1;2;3
93;04.02.2015;2015;02;21;Keskiviikko;0;0;0
93;04.02.2015;2015;02;22;Keskiviikko;0;0;0
93;04.02.2015;2015;02;23;Keskiviikko;0;0;0
93;05.02.2015;2015;02;00;Torstai;0;0;0
93;05.02.2015;2015;02;01;Torstai;0;0;0
93;05.02.2015;2015;02;02;Torstai;0;0;0
93;05.02.2015;2015;02;03;Torstai;0;0;0
93;05.02.2015;2015;02;04;Torstai;0;0;0
93;05.02.2015;2015;02;05;Torstai;2;1;3
93;05.02.2015;2015;02;06;Torstai;9;4;13
93;05.02.2015;2015;02;07;Torstai;12;8;20
93;05.02.2015;2015;02;08;Torstai;5;10;15
93;05.02.2015;2015;02;09;Torstai;2;5;7
93;05.02.2015;2015;02;10;Torstai;0;0;0
93;05.02.2015;2015;02;11;Torstai;2;2;4
93;05.02.2015;2015;02;12;Torstai;2;2;4
93;05.02.2015;2015;02;13;Torstai;5;3;8
93;05.02.2015;2015;02;14;Torstai;3;3;6
93;05.02.2015;2015;02;15;Torstai;7;8;15
93;05.02.2015;2015;02;16;Torstai;10;12;22
93;05.02.2015;2015;02;17;Torstai;7;1;8
93;05.02.2015;2015;02;18;Torstai;4;5;9
93;05.02.2015;2015;02;19;Torstai;5;3;8
93;05.02.2015;2015;02;20;Torstai;1;2;3
93;05.02.2015;2015;02;21;Torstai;1;1;2
93;05.02.2015;2015;02;22;Torstai;0;0;0
93;05.02.2015;2015;02;23;Torstai;0;1;1
93;06.02.2015;2015;02;00;Perjantai;0;0;0
93;06.02.2015;2015;02;01;Perjantai;0;0;0
93;06.02.2015;2015;02;02;Perjantai;0;0;0
93;06.02.2015;2015;02;03;Perjantai;0;1;1
93;06.02.2015;2015;02;04;Perjantai;0;0;0
93;06.02.2015;2015;02;05;Perjantai;1;1;2
93;06.02.2015;2015;02;06;Perjantai;3;3;6
93;06.02.2015;2015;02;07;Perjantai;12;9;21
93;06.02.2015;2015;02;08;Perjantai;5;5;10
93;06.02.2015;2015;02;09;Perjantai;3;1;4
93;06.02.2015;2015;02;10;Perjantai;4;1;5
93;06.02.2015;2015;02;11;Perjantai;0;4;4
93;06.02.2015;2015;02;12;Perjantai;6;5;11
93;06.02.2015;2015;02;13;Perjantai;7;2;9
93;06.02.2015;2015;02;14;Perjantai;5;8;13
93;06.02.2015;2015;02;15;Perjantai;7;4;11
93;06.02.2015;2015;02;16;Perjantai;9;6;15
93;06.02.2015;2015;02;17;Perjantai;5;7;12
93;06.02.2015;2015;02;18;Perjantai;5;2;7
93;06.02.2015;2015;02;19;Perjantai;2;2;4
93;06.02.2015;2015;02;20;Perjantai;1;0;1
93;06.02.2015;2015;02;21;Perjantai;1;1;2
93;06.02.2015;2015;02;22;Perjantai;2;2;4
93;06.02.2015;2015;02;23;Perjantai;2;0;2
93;07.02.2015;2015;02;00;Lauantai;0;0;0
93;07.02.2015;2015;02;01;Lauantai;0;1;1
93;07.02.2015;2015;02;02;Lauantai;0;0;0
93;07.02.2015;2015;02;03;Lauantai;0;0;0
93;07.02.2015;2015;02;04;Lauantai;0;0;0
93;07.02.2015;2015;02;05;Lauantai;0;0;0
93;07.02.2015;2015;02;06;Lauantai;0;0;0
93;07.02.2015;2015;02;07;Lauantai;0;0;0
93;07.02.2015;2015;02;08;Lauantai;0;1;1
93;07.02.2015;2015;02;09;Lauantai;4;2;6
93;07.02.2015;2015;02;10;Lauantai;2;3;5
93;07.02.2015;2015;02;11;Lauantai;1;2;3
93;07.02.2015;2015;02;12;Lauantai;1;1;2
93;07.02.2015;2015;02;13;Lauantai;3;6;9
93;07.02.2015;2015;02;14;Lauantai;1;1;2
93;07.02.2015;2015;02;15;Lauantai;1;2;3
93;07.02.2015;2015;02;16;Lauantai;2;0;2
93;07.02.2015;2015;02;17;Lauantai;1;1;2
93;07.02.2015;2015;02;18;Lauantai;1;1;2
93;07.02.2015;2015;02;19;Lauantai;1;1;2
93;07.02.2015;2015;02;20;Lauantai;1;1;2
93;07.02.2015;2015;02;21;Lauantai;0;0;0
93;07.02.2015;2015;02;22;Lauantai;0;0;0
93;07.02.2015;2015;02;23;Lauantai;0;0;0
93;08.02.2015;2015;02;00;Sunnuntai;1;0;1
93;08.02.2015;2015;02;01;Sunnuntai;0;0;0
93;08.02.2015;2015;02;02;Sunnuntai;0;0;0
93;08.02.2015;2015;02;03;Sunnuntai;0;0;0
93;08.02.2015;2015;02;04;Sunnuntai;0;0;0
93;08.02.2015;2015;02;05;Sunnuntai;0;0;0
93;08.02.2015;2015;02;06;Sunnuntai;0;0;0
93;08.02.2015;2015;02;07;Sunnuntai;1;1;2
93;08.02.2015;2015;02;08;Sunnuntai;0;1;1
93;08.02.2015;2015;02;09;Sunnuntai;0;0;0
93;08.02.2015;2015;02;10;Sunnuntai;1;2;3
93;08.02.2015;2015;02;11;Sunnuntai;2;0;2
93;08.02.2015;2015;02;12;Sunnuntai;2;2;4
93;08.02.2015;2015;02;13;Sunnuntai;0;2;2
93;08.02.2015;2015;02;14;Sunnuntai;1;1;2
93;08.02.2015;2015;02;15;Sunnuntai;3;1;4
93;08.02.2015;2015;02;16;Sunnuntai;1;1;2
93;08.02.2015;2015;02;17;Sunnuntai;1;1;2
93;08.02.2015;2015;02;18;Sunnuntai;0;2;2
93;08.02.2015;2015;02;19;Sunnuntai;1;1;2
93;08.02.2015;2015;02;20;Sunnuntai;0;0;0
93;08.02.2015;2015;02;21;Sunnuntai;1;0;1
93;08.02.2015;2015;02;22;Sunnuntai;1;0;1
93;08.02.2015;2015;02;23;Sunnuntai;0;0;0
93;09.02.2015;2015;02;00;Maanantai;0;0;0
93;09.02.2015;2015;02;01;Maanantai;0;0;0
93;09.02.2015;2015;02;02;Maanantai;0;0;0
93;09.02.2015;2015;02;03;Maanantai;0;0;0
93;09.02.2015;2015;02;04;Maanantai;0;0;0
93;09.02.2015;2015;02;05;Maanantai;0;0;0
93;09.02.2015;2015;02;06;Maanantai;3;4;7
93;09.02.2015;2015;02;07;Maanantai;15;7;22
93;09.02.2015;2015;02;08;Maanantai;7;17;24
93;09.02.2015;2015;02;09;Maanantai;2;1;3
93;09.02.2015;2015;02;10;Maanantai;1;0;1
93;09.02.2015;2015;02;11;Maanantai;0;4;4
93;09.02.2015;2015;02;12;Maanantai;2;5;7
93;09.02.2015;2015;02;13;Maanantai;7;4;11
93;09.02.2015;2015;02;14;Maanantai;4;4;8
93;09.02.2015;2015;02;15;Maanantai;8;1;9
93;09.02.2015;2015;02;16;Maanantai;18;8;26
93;09.02.2015;2015;02;17;Maanantai;6;7;13
93;09.02.2015;2015;02;18;Maanantai;6;6;12
93;09.02.2015;2015;02;19;Maanantai;3;0;3
93;09.02.2015;2015;02;20;Maanantai;1;2;3
93;09.02.2015;2015;02;21;Maanantai;0;1;1
93;09.02.2015;2015;02;22;Maanantai;0;0;0
93;09.02.2015;2015;02;23;Maanantai;0;1;1
93;10.02.2015;2015;02;00;Tiistai;0;0;0
93;10.02.2015;2015;02;01;Tiistai;0;0;0
93;10.02.2015;2015;02;02;Tiistai;0;0;0
93;10.02.2015;2015;02;03;Tiistai;1;0;1
93;10.02.2015;2015;02;04;Tiistai;0;0;0
93;10.02.2015;2015;02;05;Tiistai;0;0;0
93;10.02.2015;2015;02;06;Tiistai;9;1;10
93;10.02.2015;2015;02;07;Tiistai;8;8;16
93;10.02.2015;2015;02;08;Tiistai;8;11;19
93;10.02.2015;2015;02;09;Tiistai;2;5;7
93;10.02.2015;2015;02;10;Tiistai;0;5;5
93;10.02.2015;2015;02;11;Tiistai;8;4;12
93;10.02.2015;2015;02;12;Tiistai;4;2;6
93;10.02.2015;2015;02;13;Tiistai;1;5;6
93;10.02.2015;2015;02;14;Tiistai;2;6;8
93;10.02.2015;2015;02;15;Tiistai;7;5;12
93;10.02.2015;2015;02;16;Tiistai;13;9;22
93;10.02.2015;2015;02;17;Tiistai;3;6;9
93;10.02.2015;2015;02;18;Tiistai;4;3;7
93;10.02.2015;2015;02;19;Tiistai;0;2;2
93;10.02.2015;2015;02;20;Tiistai;4;0;4
93;10.02.2015;2015;02;21;Tiistai;0;0;0
93;10.02.2015;2015;02;22;Tiistai;0;1;1
93;10.02.2015;2015;02;23;Tiistai;0;0;0
93;11.02.2015;2015;02;00;Keskiviikko;0;0;0
93;11.02.2015;2015;02;01;Keskiviikko;0;0;0
93;11.02.2015;2015;02;02;Keskiviikko;0;0;0
93;11.02.2015;2015;02;03;Keskiviikko;0;0;0
93;11.02.2015;2015;02;04;Keskiviikko;0;0;0
93;11.02.2015;2015;02;05;Keskiviikko;0;0;0
93;11.02.2015;2015;02;06;Keskiviikko;11;1;12
93;11.02.2015;2015;02;07;Keskiviikko;13;4;17
93;11.02.2015;2015;02;08;Keskiviikko;2;5;7
93;11.02.2015;2015;02;09;Keskiviikko;0;3;3
93;11.02.2015;2015;02;10;Keskiviikko;1;1;2
93;11.02.2015;2015;02;11;Keskiviikko;1;2;3
93;11.02.2015;2015;02;12;Keskiviikko;1;1;2
93;11.02.2015;2015;02;13;Keskiviikko;2;1;3
93;11.02.2015;2015;02;14;Keskiviikko;2;2;4
93;11.02.2015;2015;02;15;Keskiviikko;3;4;7
93;11.02.2015;2015;02;16;Keskiviikko;5;10;15
93;11.02.2015;2015;02;17;Keskiviikko;6;3;9
93;11.02.2015;2015;02;18;Keskiviikko;0;2;2
93;11.02.2015;2015;02;19;Keskiviikko;0;0;0
93;11.02.2015;2015;02;20;Keskiviikko;2;1;3
93;11.02.2015;2015;02;21;Keskiviikko;1;1;2
93;11.02.2015;2015;02;22;Keskiviikko;0;1;1
93;11.02.2015;2015;02;23;Keskiviikko;1;2;3
93;12.02.2015;2015;02;00;Torstai;0;0;0
93;12.02.2015;2015;02;01;Torstai;0;0;0
93;12.02.2015;2015;02;02;Torstai;0;0;0
93;12.02.2015;2015;02;03;Torstai;0;0;0
93;12.02.2015;2015;02;04;Torstai;0;0;0
93;12.02.2015;2015;02;05;Torstai;0;0;0
93;12.02.2015;2015;02;06;Torstai;2;1;3
93;12.02.2015;2015;02;07;Torstai;5;7;12
93;12.02.2015;2015;02;08;Torstai;1;6;7
93;12.02.2015;2015;02;09;Torstai;2;0;2
93;12.02.2015;2015;02;10;Torstai;0;0;0
93;12.02.2015;2015;02;11;Torstai;0;2;2
93;12.02.2015;2015;02;12;Torstai;2;1;3
93;12.02.2015;2015;02;13;Torstai;2;0;2
93;12.02.2015;2015;02;14;Torstai;1;2;3
93;12.02.2015;2015;02;15;Torstai;7;3;10
93;12.02.2015;2015;02;16;Torstai;7;5;12
93;12.02.2015;2015;02;17;Torstai;5;2;7
93;12.02.2015;2015;02;18;Torstai;1;1;2
93;12.02.2015;2015;02;19;Torstai;1;1;2
93;12.02.2015;2015;02;20;Torstai;2;0;2
93;12.02.2015;2015;02;21;Torstai;0;2;2
93;12.02.2015;2015;02;22;Torstai;1;0;1
93;12.02.2015;2015;02;23;Torstai;0;0;0
93;13.02.2015;2015;02;00;Perjantai;0;0;0
93;13.02.2015;2015;02;01;Perjantai;0;0;0
93;13.02.2015;2015;02;02;Perjantai;0;0;0
93;13.02.2015;2015;02;03;Perjantai;0;0;0
93;13.02.2015;2015;02;04;Perjantai;0;0;0
93;13.02.2015;2015;02;05;Perjantai;0;0;0
93;13.02.2015;2015;02;06;Perjantai;5;0;5
93;13.02.2015;2015;02;07;Perjantai;2;11;13
93;13.02.2015;2015;02;08;Perjantai;2;4;6
93;13.02.2015;2015;02;09;Perjantai;2;0;2
93;13.02.2015;2015;02;10;Perjantai;2;3;5
93;13.02.2015;2015;02;11;Perjantai;3;5;8
93;13.02.2015;2015;02;12;Perjantai;2;1;3
93;13.02.2015;2015;02;13;Perjantai;1;2;3
93;13.02.2015;2015;02;14;Perjantai;0;1;1
93;13.02.2015;2015;02;15;Perjantai;6;7;13
93;13.02.2015;2015;02;16;Perjantai;11;3;14
93;13.02.2015;2015;02;17;Perjantai;4;2;6
93;13.02.2015;2015;02;18;Perjantai;0;1;1
93;13.02.2015;2015;02;19;Perjantai;3;3;6
93;13.02.2015;2015;02;20;Perjantai;4;3;7
93;13.02.2015;2015;02;21;Perjantai;0;0;0
93;13.02.2015;2015;02;22;Perjantai;0;1;1
93;13.02.2015;2015;02;23;Perjantai;0;0;0
93;14.02.2015;2015;02;00;Lauantai;0;0;0
93;14.02.2015;2015;02;01;Lauantai;0;0;0
93;14.02.2015;2015;02;02;Lauantai;0;0;0
93;14.02.2015;2015;02;03;Lauantai;0;0;0
93;14.02.2015;2015;02;04;Lauantai;0;0;0
93;14.02.2015;2015;02;05;Lauantai;0;0;0
93;14.02.2015;2015;02;06;Lauantai;0;1;1
93;14.02.2015;2015;02;07;Lauantai;0;0;0
93;14.02.2015;2015;02;08;Lauantai;0;1;1
93;14.02.2015;2015;02;09;Lauantai;0;4;4
93;14.02.2015;2015;02;10;Lauantai;0;2;2
93;14.02.2015;2015;02;11;Lauantai;1;0;1
93;14.02.2015;2015;02;12;Lauantai;1;2;3
93;14.02.2015;2015;02;13;Lauantai;1;2;3
93;14.02.2015;2015;02;14;Lauantai;3;1;4
93;14.02.2015;2015;02;15;Lauantai;2;0;2
93;14.02.2015;2015;02;16;Lauantai;0;1;1
93;14.02.2015;2015;02;17;Lauantai;0;1;1
93;14.02.2015;2015;02;18;Lauantai;0;1;1
93;14.02.2015;2015;02;19;Lauantai;0;0;0
93;14.02.2015;2015;02;20;Lauantai;0;0;0
93;14.02.2015;2015;02;21;Lauantai;0;0;0
93;14.02.2015;2015;02;22;Lauantai;0;0;0
93;14.02.2015;2015;02;23;Lauantai;0;0;0
93;15.02.2015;2015;02;00;Sunnuntai;0;0;0
93;15.02.2015;2015;02;01;Sunnuntai;0;0;0
93;15.02.2015;2015;02;02;Sunnuntai;0;0;0
93;15.02.2015;2015;02;03;Sunnuntai;0;0;0
93;15.02.2015;2015;02;04;Sunnuntai;0;0;0
93;15.02.2015;2015;02;05;Sunnuntai;1;0;1
93;15.02.2015;2015;02;06;Sunnuntai;2;0;2
93;15.02.2015;2015;02;07;Sunnuntai;2;0;2
93;15.02.2015;2015;02;08;Sunnuntai;0;0;0
93;15.02.2015;2015;02;09;Sunnuntai;0;1;1
93;15.02.2015;2015;02;10;Sunnuntai;1;0;1
93;15.02.2015;2015;02;11;Sunnuntai;0;2;2
93;15.02.2015;2015;02;12;Sunnuntai;0;0;0
93;15.02.2015;2015;02;13;Sunnuntai;0;1;1
93;15.02.2015;2015;02;14;Sunnuntai;2;5;7
93;15.02.2015;2015;02;15;Sunnuntai;2;1;3
93;15.02.2015;2015;02;16;Sunnuntai;3;0;3
93;15.02.2015;2015;02;17;Sunnuntai;1;0;1
93;15.02.2015;2015;02;18;Sunnuntai;4;4;8
93;15.02.2015;2015;02;19;Sunnuntai;0;0;0
93;15.02.2015;2015;02;20;Sunnuntai;0;0;0
93;15.02.2015;2015;02;21;Sunnuntai;3;0;3
93;15.02.2015;2015;02;22;Sunnuntai;0;1;1
93;15.02.2015;2015;02;23;Sunnuntai;0;0;0
93;16.02.2015;2015;02;00;Maanantai;0;0;0
93;16.02.2015;2015;02;01;Maanantai;0;0;0
93;16.02.2015;2015;02;02;Maanantai;0;0;0
93;16.02.2015;2015;02;03;Maanantai;0;0;0
93;16.02.2015;2015;02;04;Maanantai;0;0;0
93;16.02.2015;2015;02;05;Maanantai;0;2;2
93;16.02.2015;2015;02;06;Maanantai;7;3;10
93;16.02.2015;2015;02;07;Maanantai;12;9;21
93;16.02.2015;2015;02;08;Maanantai;10;11;21
93;16.02.2015;2015;02;09;Maanantai;6;2;8
93;16.02.2015;2015;02;10;Maanantai;0;2;2
93;16.02.2015;2015;02;11;Maanantai;3;1;4
93;16.02.2015;2015;02;12;Maanantai;5;2;7
93;16.02.2015;2015;02;13;Maanantai;5;3;8
93;16.02.2015;2015;02;14;Maanantai;6;1;7
93;16.02.2015;2015;02;15;Maanantai;7;9;16
93;16.02.2015;2015;02;16;Maanantai;22;8;30
93;16.02.2015;2015;02;17;Maanantai;5;6;11
93;16.02.2015;2015;02;18;Maanantai;3;3;6
93;16.02.2015;2015;02;19;Maanantai;2;3;5
93;16.02.2015;2015;02;20;Maanantai;1;1;2
93;16.02.2015;2015;02;21;Maanantai;1;1;2
93;16.02.2015;2015;02;22;Maanantai;1;1;2
93;16.02.2015;2015;02;23;Maanantai;0;0;0
93;17.02.2015;2015;02;00;Tiistai;0;0;0
93;17.02.2015;2015;02;01;Tiistai;0;0;0
93;17.02.2015;2015;02;02;Tiistai;0;0;0
93;17.02.2015;2015;02;03;Tiistai;0;0;0
93;17.02.2015;2015;02;04;Tiistai;0;0;0
93;17.02.2015;2015;02;05;Tiistai;1;1;2
93;17.02.2015;2015;02;06;Tiistai;10;4;14
93;17.02.2015;2015;02;07;Tiistai;14;7;21
93;17.02.2015;2015;02;08;Tiistai;6;8;14
93;17.02.2015;2015;02;09;Tiistai;3;5;8
93;17.02.2015;2015;02;10;Tiistai;1;7;8
93;17.02.2015;2015;02;11;Tiistai;6;4;10
93;17.02.2015;2015;02;12;Tiistai;2;3;5
93;17.02.2015;2015;02;13;Tiistai;2;7;9
93;17.02.2015;2015;02;14;Tiistai;4;7;11
93;17.02.2015;2015;02;15;Tiistai;11;3;14
93;17.02.2015;2015;02;16;Tiistai;10;10;20
93;17.02.2015;2015;02;17;Tiistai;7;6;13
93;17.02.2015;2015;02;18;Tiistai;4;4;8
93;17.02.2015;2015;02;19;Tiistai;3;6;9
93;17.02.2015;2015;02;20;Tiistai;2;1;3
93;17.02.2015;2015;02;21;Tiistai;1;0;1
93;17.02.2015;2015;02;22;Tiistai;0;1;1
93;17.02.2015;2015;02;23;Tiistai;0;0;0
93;18.02.2015;2015;02;00;Keskiviikko;0;1;1
93;18.02.2015;2015;02;01;Keskiviikko;0;0;0
93;18.02.2015;2015;02;02;Keskiviikko;0;0;0
93;18.02.2015;2015;02;03;Keskiviikko;0;0;0
93;18.02.2015;2015;02;04;Keskiviikko;0;0;0
93;18.02.2015;2015;02;05;Keskiviikko;0;0;0
93;18.02.2015;2015;02;06;Keskiviikko;4;4;8
93;18.02.2015;2015;02;07;Keskiviikko;13;9;22
93;18.02.2015;2015;02;08;Keskiviikko;5;8;13
93;18.02.2015;2015;02;09;Keskiviikko;3;5;8
93;18.02.2015;2015;02;10;Keskiviikko;2;0;2
93;18.02.2015;2015;02;11;Keskiviikko;8;3;11
93;18.02.2015;2015;02;12;Keskiviikko;2;3;5
93;18.02.2015;2015;02;13;Keskiviikko;1;7;8
93;18.02.2015;2015;02;14;Keskiviikko;5;8;13
93;18.02.2015;2015;02;15;Keskiviikko;6;2;8
93;18.02.2015;2015;02;16;Keskiviikko;10;16;26
93;18.02.2015;2015;02;17;Keskiviikko;8;3;11
93;18.02.2015;2015;02;18;Keskiviikko;8;4;12
93;18.02.2015;2015;02;19;Keskiviikko;3;4;7
93;18.02.2015;2015;02;20;Keskiviikko;1;6;7
93;18.02.2015;2015;02;21;Keskiviikko;0;2;2
93;18.02.2015;2015;02;22;Keskiviikko;0;0;0
93;18.02.2015;2015;02;23;Keskiviikko;0;0;0
93;19.02.2015;2015;02;00;Torstai;0;1;1
93;19.02.2015;2015;02;01;Torstai;0;0;0
93;19.02.2015;2015;02;02;Torstai;0;0;0
93;19.02.2015;2015;02;03;Torstai;0;0;0
93;19.02.2015;2015;02;04;Torstai;0;0;0
93;19.02.2015;2015;02;05;Torstai;1;1;2
93;19.02.2015;2015;02;06;Torstai;3;3;6
93;19.02.2015;2015;02;07;Torstai;12;4;16
93;19.02.2015;2015;02;08;Torstai;5;11;16
93;19.02.2015;2015;02;09;Torstai;2;6;8
93;19.02.2015;2015;02;10;Torstai;1;1;2
93;19.02.2015;2015;02;11;Torstai;0;6;6
93;19.02.2015;2015;02;12;Torstai;1;2;3
93;19.02.2015;2015;02;13;Torstai;1;2;3
93;19.02.2015;2015;02;14;Torstai;1;3;4
93;19.02.2015;2015;02;15;Torstai;2;4;6
93;19.02.2015;2015;02;16;Torstai;13;7;20
93;19.02.2015;2015;02;17;Torstai;5;1;6
93;19.02.2015;2015;02;18;Torstai;5;1;6
93;19.02.2015;2015;02;19;Torstai;1;2;3
93;19.02.2015;2015;02;20;Torstai;2;1;3
93;19.02.2015;2015;02;21;Torstai;0;0;0
93;19.02.2015;2015;02;22;Torstai;0;1;1
93;19.02.2015;2015;02;23;Torstai;0;0;0
93;20.02.2015;2015;02;00;Perjantai;0;1;1
93;20.02.2015;2015;02;01;Perjantai;0;0;0
93;20.02.2015;2015;02;02;Perjantai;0;0;0
93;20.02.2015;2015;02;03;Perjantai;0;0;0
93;20.02.2015;2015;02;04;Perjantai;1;0;1
93;20.02.2015;2015;02;05;Perjantai;0;0;0
93;20.02.2015;2015;02;06;Perjantai;2;3;5
93;20.02.2015;2015;02;07;Perjantai;6;8;14
93;20.02.2015;2015;02;08;Perjantai;5;7;12
93;20.02.2015;2015;02;09;Perjantai;0;3;3
93;20.02.2015;2015;02;10;Perjantai;0;0;0
93;20.02.2015;2015;02;11;Perjantai;0;1;1
93;20.02.2015;2015;02;12;Perjantai;1;0;1
93;20.02.2015;2015;02;13;Perjantai;0;2;2
93;20.02.2015;2015;02;14;Perjantai;1;1;2
93;20.02.2015;2015;02;15;Perjantai;5;3;8
93;20.02.2015;2015;02;16;Perjantai;8;9;17
93;20.02.2015;2015;02;17;Perjantai;4;2;6
93;20.02.2015;2015;02;18;Perjantai;2;0;2
93;20.02.2015;2015;02;19;Perjantai;2;2;4
93;20.02.2015;2015;02;20;Perjantai;5;4;9
93;20.02.2015;2015;02;21;Perjantai;0;0;0
93;20.02.2015;2015;02;22;Perjantai;0;1;1
93;20.02.2015;2015;02;23;Perjantai;1;0;1
93;21.02.2015;2015;02;00;Lauantai;0;0;0
93;21.02.2015;2015;02;01;Lauantai;0;0;0
93;21.02.2015;2015;02;02;Lauantai;0;0;0
93;21.02.2015;2015;02;03;Lauantai;0;0;0
93;21.02.2015;2015;02;04;Lauantai;0;0;0
93;21.02.2015;2015;02;05;Lauantai;0;1;1
93;21.02.2015;2015;02;06;Lauantai;1;0;1
93;21.02.2015;2015;02;07;Lauantai;0;2;2
93;21.02.2015;2015;02;08;Lauantai;3;0;3
93;21.02.2015;2015;02;09;Lauantai;2;1;3
93;21.02.2015;2015;02;10;Lauantai;7;3;10
93;21.02.2015;2015;02;11;Lauantai;1;3;4
93;21.02.2015;2015;02;12;Lauantai;3;4;7
93;21.02.2015;2015;02;13;Lauantai;2;4;6
93;21.02.2015;2015;02;14;Lauantai;5;2;7
93;21.02.2015;2015;02;15;Lauantai;2;1;3
93;21.02.2015;2015;02;16;Lauantai;3;1;4
93;21.02.2015;2015;02;17;Lauantai;2;0;2
93;21.02.2015;2015;02;18;Lauantai;0;1;1
93;21.02.2015;2015;02;19;Lauantai;0;0;0
93;21.02.2015;2015;02;20;Lauantai;0;1;1
93;21.02.2015;2015;02;21;Lauantai;0;0;0
93;21.02.2015;2015;02;22;Lauantai;0;0;0
93;21.02.2015;2015;02;23;Lauantai;1;0;1
93;22.02.2015;2015;02;00;Sunnuntai;0;0;0
93;22.02.2015;2015;02;01;Sunnuntai;0;0;0
93;22.02.2015;2015;02;02;Sunnuntai;0;0;0
93;22.02.2015;2015;02;03;Sunnuntai;0;0;0
93;22.02.2015;2015;02;04;Sunnuntai;0;0;0
93;22.02.2015;2015;02;05;Sunnuntai;0;0;0
93;22.02.2015;2015;02;06;Sunnuntai;0;0;0
93;22.02.2015;2015;02;07;Sunnuntai;8;0;8
93;22.02.2015;2015;02;08;Sunnuntai;1;1;2
93;22.02.2015;2015;02;09;Sunnuntai;2;1;3
93;22.02.2015;2015;02;10;Sunnuntai;0;1;1
93;22.02.2015;2015;02;11;Sunnuntai;5;1;6
93;22.02.2015;2015;02;12;Sunnuntai;12;4;16
93;22.02.2015;2015;02;13;Sunnuntai;1;5;6
93;22.02.2015;2015;02;14;Sunnuntai;4;1;5
93;22.02.2015;2015;02;15;Sunnuntai;2;4;6
93;22.02.2015;2015;02;16;Sunnuntai;1;1;2
93;22.02.2015;2015;02;17;Sunnuntai;3;0;3
93;22.02.2015;2015;02;18;Sunnuntai;0;2;2
93;22.02.2015;2015;02;19;Sunnuntai;3;1;4
93;22.02.2015;2015;02;20;Sunnuntai;0;0;0
93;22.02.2015;2015;02;21;Sunnuntai;0;1;1
93;22.02.2015;2015;02;22;Sunnuntai;0;0;0
93;22.02.2015;2015;02;23;Sunnuntai;0;0;0
93;23.02.2015;2015;02;00;Maanantai;0;0;0
93;23.02.2015;2015;02;01;Maanantai;0;0;0
93;23.02.2015;2015;02;02;Maanantai;0;0;0
93;23.02.2015;2015;02;03;Maanantai;0;0;0
93;23.02.2015;2015;02;04;Maanantai;0;0;0
93;23.02.2015;2015;02;05;Maanantai;0;0;0
93;23.02.2015;2015;02;06;Maanantai;6;6;12
93;23.02.2015;2015;02;07;Maanantai;8;8;16
93;23.02.2015;2015;02;08;Maanantai;2;13;15
93;23.02.2015;2015;02;09;Maanantai;2;2;4
93;23.02.2015;2015;02;10;Maanantai;2;5;7
93;23.02.2015;2015;02;11;Maanantai;6;3;9
93;23.02.2015;2015;02;12;Maanantai;1;3;4
93;23.02.2015;2015;02;13;Maanantai;5;5;10
93;23.02.2015;2015;02;14;Maanantai;5;3;8
93;23.02.2015;2015;02;15;Maanantai;11;4;15
93;23.02.2015;2015;02;16;Maanantai;15;7;22
93;23.02.2015;2015;02;17;Maanantai;5;4;9
93;23.02.2015;2015;02;18;Maanantai;5;2;7
93;23.02.2015;2015;02;19;Maanantai;3;1;4
93;23.02.2015;2015;02;20;Maanantai;3;0;3
93;23.02.2015;2015;02;21;Maanantai;0;1;1
93;23.02.2015;2015;02;22;Maanantai;0;1;1
93;23.02.2015;2015;02;23;Maanantai;0;0;0
93;24.02.2015;2015;02;00;Tiistai;0;0;0
93;24.02.2015;2015;02;01;Tiistai;0;0;0
93;24.02.2015;2015;02;02;Tiistai;0;0;0
93;24.02.2015;2015;02;03;Tiistai;0;0;0
93;24.02.2015;2015;02;04;Tiistai;0;0;0
93;24.02.2015;2015;02;05;Tiistai;1;0;1
93;24.02.2015;2015;02;06;Tiistai;7;3;10
93;24.02.2015;2015;02;07;Tiistai;10;14;24
93;24.02.2015;2015;02;08;Tiistai;6;6;12
93;24.02.2015;2015;02;09;Tiistai;0;2;2
93;24.02.2015;2015;02;10;Tiistai;0;3;3
93;24.02.2015;2015;02;11;Tiistai;0;3;3
93;24.02.2015;2015;02;12;Tiistai;4;0;4
93;24.02.2015;2015;02;13;Tiistai;2;0;2
93;24.02.2015;2015;02;14;Tiistai;5;1;6
93;24.02.2015;2015;02;15;Tiistai;7;4;11
93;24.02.2015;2015;02;16;Tiistai;11;7;18
93;24.02.2015;2015;02;17;Tiistai;7;4;11
93;24.02.2015;2015;02;18;Tiistai;3;1;4
93;24.02.2015;2015;02;19;Tiistai;3;5;8
93;24.02.2015;2015;02;20;Tiistai;5;2;7
93;24.02.2015;2015;02;21;Tiistai;0;0;0
93;24.02.2015;2015;02;22;Tiistai;0;2;2
93;24.02.2015;2015;02;23;Tiistai;0;0;0
93;25.02.2015;2015;02;00;Keskiviikko;0;2;2
93;25.02.2015;2015;02;01;Keskiviikko;0;0;0
93;25.02.2015;2015;02;02;Keskiviikko;0;0;0
93;25.02.2015;2015;02;03;Keskiviikko;0;0;0
93;25.02.2015;2015;02;04;Keskiviikko;0;0;0
93;25.02.2015;2015;02;05;Keskiviikko;3;0;3
93;25.02.2015;2015;02;06;Keskiviikko;10;6;16
93;25.02.2015;2015;02;07;Keskiviikko;10;8;18
93;25.02.2015;2015;02;08;Keskiviikko;7;7;14
93;25.02.2015;2015;02;09;Keskiviikko;2;5;7
93;25.02.2015;2015;02;10;Keskiviikko;0;1;1
93;25.02.2015;2015;02;11;Keskiviikko;2;4;6
93;25.02.2015;2015;02;12;Keskiviikko;5;3;8
93;25.02.2015;2015;02;13;Keskiviikko;0;1;1
93;25.02.2015;2015;02;14;Keskiviikko;5;4;9
93;25.02.2015;2015;02;15;Keskiviikko;6;6;12
93;25.02.2015;2015;02;16;Keskiviikko;15;10;25
93;25.02.2015;2015;02;17;Keskiviikko;5;3;8
93;25.02.2015;2015;02;18;Keskiviikko;1;1;2
93;25.02.2015;2015;02;19;Keskiviikko;1;4;5
93;25.02.2015;2015;02;20;Keskiviikko;0;1;1
93;25.02.2015;2015;02;21;Keskiviikko;1;0;1
93;25.02.2015;2015;02;22;Keskiviikko;2;0;2
93;25.02.2015;2015;02;23;Keskiviikko;0;0;0
93;26.02.2015;2015;02;00;Torstai;0;1;1
93;26.02.2015;2015;02;01;Torstai;0;0;0
93;26.02.2015;2015;02;02;Torstai;0;0;0
93;26.02.2015;2015;02;03;Torstai;0;0;0
93;26.02.2015;2015;02;04;Torstai;1;0;1
93;26.02.2015;2015;02;05;Torstai;1;0;1
93;26.02.2015;2015;02;06;Torstai;5;2;7
93;26.02.2015;2015;02;07;Torstai;8;11;19
93;26.02.2015;2015;02;08;Torstai;8;7;15
93;26.02.2015;2015;02;09;Torstai;2;3;5
93;26.02.2015;2015;02;10;Torstai;6;1;7
93;26.02.2015;2015;02;11;Torstai;2;4;6
93;26.02.2015;2015;02;12;Torstai;0;0;0
93;26.02.2015;2015;02;13;Torstai;2;2;4
93;26.02.2015;2015;02;14;Torstai;5;5;10
93;26.02.2015;2015;02;15;Torstai;8;3;11
93;26.02.2015;2015;02;16;Torstai;14;9;23
93;26.02.2015;2015;02;17;Torstai;5;6;11
93;26.02.2015;2015;02;18;Torstai;3;3;6
93;26.02.2015;2015;02;19;Torstai;2;2;4
93;26.02.2015;2015;02;20;Torstai;2;0;2
93;26.02.2015;2015;02;21;Torstai;1;0;1
93;26.02.2015;2015;02;22;Torstai;2;1;3
93;26.02.2015;2015;02;23;Torstai;0;0;0
93;27.02.2015;2015;02;00;Perjantai;0;0;0
93;27.02.2015;2015;02;01;Perjantai;0;0;0
93;27.02.2015;2015;02;02;Perjantai;0;0;0
93;27.02.2015;2015;02;03;Perjantai;0;0;0
93;27.02.2015;2015;02;04;Perjantai;0;0;0
93;27.02.2015;2015;02;05;Perjantai;1;0;1
93;27.02.2015;2015;02;06;Perjantai;6;0;6
93;27.02.2015;2015;02;07;Perjantai;6;3;9
93;27.02.2015;2015;02;08;Perjantai;1;1;2
93;27.02.2015;2015;02;09;Perjantai;0;2;2
93;27.02.2015;2015;02;10;Perjantai;2;2;4
93;27.02.2015;2015;02;11;Perjantai;1;0;1
93;27.02.2015;2015;02;12;Perjantai;3;0;3
93;27.02.2015;2015;02;13;Perjantai;4;1;5
93;27.02.2015;2015;02;14;Perjantai;3;4;7
93;27.02.2015;2015;02;15;Perjantai;6;5;11
93;27.02.2015;2015;02;16;Perjantai;10;2;12
93;27.02.2015;2015;02;17;Perjantai;3;1;4
93;27.02.2015;2015;02;18;Perjantai;5;1;6
93;27.02.2015;2015;02;19;Perjantai;3;1;4
93;27.02.2015;2015;02;20;Perjantai;1;0;1
93;27.02.2015;2015;02;21;Perjantai;1;0;1
93;27.02.2015;2015;02;22;Perjantai;0;3;3
93;27.02.2015;2015;02;23;Perjantai;2;0;2
93;28.02.2015;2015;02;00;Lauantai;0;0;0
93;28.02.2015;2015;02;01;Lauantai;0;0;0
93;28.02.2015;2015;02;02;Lauantai;0;0;0
93;28.02.2015;2015;02;03;Lauantai;0;0;0
93;28.02.2015;2015;02;04;Lauantai;0;0;0
93;28.02.2015;2015;02;05;Lauantai;0;0;0
93;28.02.2015;2015;02;06;Lauantai;0;1;1
93;28.02.2015;2015;02;07;Lauantai;1;0;1
93;28.02.2015;2015;02;08;Lauantai;0;1;1
93;28.02.2015;2015;02;09;Lauantai;2;0;2
93;28.02.2015;2015;02;10;Lauantai;2;0;2
93;28.02.2015;2015;02;11;Lauantai;5;0;5
93;28.02.2015;2015;02;12;Lauantai;1;1;2
93;28.02.2015;2015;02;13;Lauantai;0;1;1
93;28.02.2015;2015;02;14;Lauantai;0;1;1
93;28.02.2015;2015;02;15;Lauantai;8;2;10
93;28.02.2015;2015;02;16;Lauantai;2;3;5
93;28.02.2015;2015;02;17;Lauantai;2;1;3
93;28.02.2015;2015;02;18;Lauantai;2;1;3
93;28.02.2015;2015;02;19;Lauantai;2;2;4
93;28.02.2015;2015;02;20;Lauantai;2;0;2
93;28.02.2015;2015;02;21;Lauantai;4;0;4
93;28.02.2015;2015;02;22;Lauantai;0;0;0
93;28.02.2015;2015;02;23;Lauantai;0;0;0
93;01.03.2015;2015;03;00;Sunnuntai;0;0;0
93;01.03.2015;2015;03;01;Sunnuntai;0;0;0
93;01.03.2015;2015;03;02;Sunnuntai;0;0;0
93;01.03.2015;2015;03;03;Sunnuntai;0;0;0
93;01.03.2015;2015;03;04;Sunnuntai;0;0;0
93;01.03.2015;2015;03;05;Sunnuntai;0;0;0
93;01.03.2015;2015;03;06;Sunnuntai;0;0;0
93;01.03.2015;2015;03;07;Sunnuntai;1;0;1
93;01.03.2015;2015;03;08;Sunnuntai;3;0;3
93;01.03.2015;2015;03;09;Sunnuntai;2;2;4
93;01.03.2015;2015;03;10;Sunnuntai;2;1;3
93;01.03.2015;2015;03;11;Sunnuntai;3;3;6
93;01.03.2015;2015;03;12;Sunnuntai;4;2;6
93;01.03.2015;2015;03;13;Sunnuntai;10;2;12
93;01.03.2015;2015;03;14;Sunnuntai;0;3;3
93;01.03.2015;2015;03;15;Sunnuntai;4;0;4
93;01.03.2015;2015;03;16;Sunnuntai;4;4;8
93;01.03.2015;2015;03;17;Sunnuntai;1;0;1
93;01.03.2015;2015;03;18;Sunnuntai;0;0;0
93;01.03.2015;2015;03;19;Sunnuntai;3;1;4
93;01.03.2015;2015;03;20;Sunnuntai;0;0;0
93;01.03.2015;2015;03;21;Sunnuntai;2;0;2
93;01.03.2015;2015;03;22;Sunnuntai;0;0;0
93;01.03.2015;2015;03;23;Sunnuntai;0;0;0
93;02.03.2015;2015;03;00;Maanantai;0;0;0
93;02.03.2015;2015;03;01;Maanantai;0;0;0
93;02.03.2015;2015;03;02;Maanantai;0;0;0
93;02.03.2015;2015;03;03;Maanantai;0;0;0
93;02.03.2015;2015;03;04;Maanantai;0;0;0
93;02.03.2015;2015;03;05;Maanantai;1;1;2
93;02.03.2015;2015;03;06;Maanantai;1;4;5
93;02.03.2015;2015;03;07;Maanantai;10;6;16
93;02.03.2015;2015;03;08;Maanantai;5;5;10
93;02.03.2015;2015;03;09;Maanantai;2;0;2
93;02.03.2015;2015;03;10;Maanantai;0;2;2
93;02.03.2015;2015;03;11;Maanantai;1;1;2
93;02.03.2015;2015;03;12;Maanantai;3;3;6
93;02.03.2015;2015;03;13;Maanantai;2;2;4
93;02.03.2015;2015;03;14;Maanantai;3;2;5
93;02.03.2015;2015;03;15;Maanantai;8;3;11
93;02.03.2015;2015;03;16;Maanantai;12;6;18
93;02.03.2015;2015;03;17;Maanantai;9;3;12
93;02.03.2015;2015;03;18;Maanantai;3;4;7
93;02.03.2015;2015;03;19;Maanantai;3;1;4
93;02.03.2015;2015;03;20;Maanantai;3;2;5
93;02.03.2015;2015;03;21;Maanantai;0;2;2
93;02.03.2015;2015;03;22;Maanantai;0;1;1
93;02.03.2015;2015;03;23;Maanantai;0;0;0
93;03.03.2015;2015;03;00;Tiistai;0;0;0
93;03.03.2015;2015;03;01;Tiistai;0;1;1
93;03.03.2015;2015;03;02;Tiistai;0;0;0
93;03.03.2015;2015;03;03;Tiistai;0;0;0
93;03.03.2015;2015;03;04;Tiistai;0;0;0
93;03.03.2015;2015;03;05;Tiistai;1;2;3
93;03.03.2015;2015;03;06;Tiistai;6;3;9
93;03.03.2015;2015;03;07;Tiistai;1;5;6
93;03.03.2015;2015;03;08;Tiistai;5;10;15
93;03.03.2015;2015;03;09;Tiistai;3;2;5
93;03.03.2015;2015;03;10;Tiistai;2;4;6
93;03.03.2015;2015;03;11;Tiistai;3;2;5
93;03.03.2015;2015;03;12;Tiistai;4;1;5
93;03.03.2015;2015;03;13;Tiistai;2;2;4
93;03.03.2015;2015;03;14;Tiistai;5;3;8
93;03.03.2015;2015;03;15;Tiistai;13;6;19
93;03.03.2015;2015;03;16;Tiistai;10;5;15
93;03.03.2015;2015;03;17;Tiistai;7;4;11
93;03.03.2015;2015;03;18;Tiistai;4;5;9
93;03.03.2015;2015;03;19;Tiistai;4;0;4
93;03.03.2015;2015;03;20;Tiistai;2;1;3
93;03.03.2015;2015;03;21;Tiistai;0;1;1
93;03.03.2015;2015;03;22;Tiistai;1;0;1
93;03.03.2015;2015;03;23;Tiistai;0;0;0
93;04.03.2015;2015;03;00;Keskiviikko;0;1;1
93;04.03.2015;2015;03;01;Keskiviikko;0;1;1
93;04.03.2015;2015;03;02;Keskiviikko;0;0;0
93;04.03.2015;2015;03;03;Keskiviikko;0;0;0
93;04.03.2015;2015;03;04;Keskiviikko;0;0;0
93;04.03.2015;2015;03;05;Keskiviikko;0;1;1
93;04.03.2015;2015;03;06;Keskiviikko;1;3;4
93;04.03.2015;2015;03;07;Keskiviikko;7;5;12
93;04.03.2015;2015;03;08;Keskiviikko;5;5;10
93;04.03.2015;2015;03;09;Keskiviikko;1;4;5
93;04.03.2015;2015;03;10;Keskiviikko;1;2;3
93;04.03.2015;2015;03;11;Keskiviikko;1;1;2
93;04.03.2015;2015;03;12;Keskiviikko;1;3;4
93;04.03.2015;2015;03;13;Keskiviikko;2;1;3
93;04.03.2015;2015;03;14;Keskiviikko;5;4;9
93;04.03.2015;2015;03;15;Keskiviikko;7;2;9
93;04.03.2015;2015;03;16;Keskiviikko;7;8;15
93;04.03.2015;2015;03;17;Keskiviikko;9;1;10
93;04.03.2015;2015;03;18;Keskiviikko;2;4;6
93;04.03.2015;2015;03;19;Keskiviikko;2;3;5
93;04.03.2015;2015;03;20;Keskiviikko;0;0;0
93;04.03.2015;2015;03;21;Keskiviikko;0;0;0
93;04.03.2015;2015;03;22;Keskiviikko;1;0;1
93;04.03.2015;2015;03;23;Keskiviikko;0;0;0
93;05.03.2015;2015;03;00;Torstai;0;0;0
93;05.03.2015;2015;03;01;Torstai;0;1;1
93;05.03.2015;2015;03;02;Torstai;0;0;0
93;05.03.2015;2015;03;03;Torstai;0;1;1
93;05.03.2015;2015;03;04;Torstai;0;0;0
93;05.03.2015;2015;03;05;Torstai;1;0;1
93;05.03.2015;2015;03;06;Torstai;1;3;4
93;05.03.2015;2015;03;07;Torstai;8;7;15
93;05.03.2015;2015;03;08;Torstai;5;4;9
93;05.03.2015;2015;03;09;Torstai;4;5;9
93;05.03.2015;2015;03;10;Torstai;5;2;7
93;05.03.2015;2015;03;11;Torstai;5;3;8
93;05.03.2015;2015;03;12;Torstai;3;2;5
93;05.03.2015;2015;03;13;Torstai;2;3;5
93;05.03.2015;2015;03;14;Torstai;1;1;2
93;05.03.2015;2015;03;15;Torstai;6;6;12
93;05.03.2015;2015;03;16;Torstai;15;6;21
93;05.03.2015;2015;03;17;Torstai;8;5;13
93;05.03.2015;2015;03;18;Torstai;5;1;6
93;05.03.2015;2015;03;19;Torstai;1;0;1
93;05.03.2015;2015;03;20;Torstai;3;4;7
93;05.03.2015;2015;03;21;Torstai;0;2;2
93;05.03.2015;2015;03;22;Torstai;0;1;1
93;05.03.2015;2015;03;23;Torstai;0;0;0
93;06.03.2015;2015;03;00;Perjantai;0;0;0
93;06.03.2015;2015;03;01;Perjantai;0;0;0
93;06.03.2015;2015;03;02;Perjantai;0;0;0
93;06.03.2015;2015;03;03;Perjantai;0;0;0
93;06.03.2015;2015;03;04;Perjantai;0;0;0
93;06.03.2015;2015;03;05;Perjantai;1;0;1
93;06.03.2015;2015;03;06;Perjantai;1;1;2
93;06.03.2015;2015;03;07;Perjantai;5;5;10
93;06.03.2015;2015;03;08;Perjantai;3;1;4
93;06.03.2015;2015;03;09;Perjantai;1;1;2
93;06.03.2015;2015;03;10;Perjantai;1;1;2
93;06.03.2015;2015;03;11;Perjantai;0;0;0
93;06.03.2015;2015;03;12;Perjantai;5;2;7
93;06.03.2015;2015;03;13;Perjantai;5;2;7
93;06.03.2015;2015;03;14;Perjantai;2;2;4
93;06.03.2015;2015;03;15;Perjantai;8;3;11
93;06.03.2015;2015;03;16;Perjantai;3;5;8
93;06.03.2015;2015;03;17;Perjantai;6;2;8
93;06.03.2015;2015;03;18;Perjantai;1;2;3
93;06.03.2015;2015;03;19;Perjantai;3;4;7
93;06.03.2015;2015;03;20;Perjantai;0;0;0
93;06.03.2015;2015;03;21;Perjantai;0;2;2
93;06.03.2015;2015;03;22;Perjantai;0;3;3
93;06.03.2015;2015;03;23;Perjantai;0;0;0
93;07.03.2015;2015;03;00;Lauantai;0;0;0
93;07.03.2015;2015;03;01;Lauantai;0;0;0
93;07.03.2015;2015;03;02;Lauantai;0;0;0
93;07.03.2015;2015;03;03;Lauantai;0;0;0
93;07.03.2015;2015;03;04;Lauantai;1;1;2
93;07.03.2015;2015;03;05;Lauantai;0;0;0
93;07.03.2015;2015;03;06;Lauantai;0;0;0
93;07.03.2015;2015;03;07;Lauantai;2;1;3
93;07.03.2015;2015;03;08;Lauantai;2;2;4
93;07.03.2015;2015;03;09;Lauantai;2;2;4
93;07.03.2015;2015;03;10;Lauantai;3;3;6
93;07.03.2015;2015;03;11;Lauantai;3;2;5
93;07.03.2015;2015;03;12;Lauantai;2;2;4
93;07.03.2015;2015;03;13;Lauantai;1;2;3
93;07.03.2015;2015;03;14;Lauantai;1;2;3
93;07.03.2015;2015;03;15;Lauantai;1;0;1
93;07.03.2015;2015;03;16;Lauantai;0;0;0
93;07.03.2015;2015;03;17;Lauantai;1;1;2
93;07.03.2015;2015;03;18;Lauantai;0;0;0
93;07.03.2015;2015;03;19;Lauantai;0;0;0
93;07.03.2015;2015;03;20;Lauantai;0;0;0
93;07.03.2015;2015;03;21;Lauantai;0;0;0
93;07.03.2015;2015;03;22;Lauantai;0;0;0
93;07.03.2015;2015;03;23;Lauantai;0;0;0
93;08.03.2015;2015;03;00;Sunnuntai;0;0;0
93;08.03.2015;2015;03;01;Sunnuntai;0;0;0
93;08.03.2015;2015;03;02;Sunnuntai;0;0;0
93;08.03.2015;2015;03;03;Sunnuntai;0;0;0
93;08.03.2015;2015;03;04;Sunnuntai;0;0;0
93;08.03.2015;2015;03;05;Sunnuntai;0;0;0
93;08.03.2015;2015;03;06;Sunnuntai;0;1;1
93;08.03.2015;2015;03;07;Sunnuntai;2;0;2
93;08.03.2015;2015;03;08;Sunnuntai;0;1;1
93;08.03.2015;2015;03;09;Sunnuntai;1;1;2
93;08.03.2015;2015;03;10;Sunnuntai;3;3;6
93;08.03.2015;2015;03;11;Sunnuntai;2;1;3
93;08.03.2015;2015;03;12;Sunnuntai;5;1;6
93;08.03.2015;2015;03;13;Sunnuntai;3;6;9
93;08.03.2015;2015;03;14;Sunnuntai;2;2;4
93;08.03.2015;2015;03;15;Sunnuntai;1;4;5
93;08.03.2015;2015;03;16;Sunnuntai;11;6;17
93;08.03.2015;2015;03;17;Sunnuntai;5;3;8
93;08.03.2015;2015;03;18;Sunnuntai;1;3;4
93;08.03.2015;2015;03;19;Sunnuntai;1;2;3
93;08.03.2015;2015;03;20;Sunnuntai;2;1;3
93;08.03.2015;2015;03;21;Sunnuntai;0;0;0
93;08.03.2015;2015;03;22;Sunnuntai;0;0;0
93;08.03.2015;2015;03;23;Sunnuntai;0;0;0
93;09.03.2015;2015;03;00;Maanantai;0;0;0
93;09.03.2015;2015;03;01;Maanantai;0;0;0
93;09.03.2015;2015;03;02;Maanantai;0;0;0
93;09.03.2015;2015;03;03;Maanantai;0;0;0
93;09.03.2015;2015;03;04;Maanantai;0;0;0
93;09.03.2015;2015;03;05;Maanantai;1;1;2
93;09.03.2015;2015;03;06;Maanantai;9;5;14
93;09.03.2015;2015;03;07;Maanantai;14;14;28
93;09.03.2015;2015;03;08;Maanantai;7;15;22
93;09.03.2015;2015;03;09;Maanantai;4;5;9
93;09.03.2015;2015;03;10;Maanantai;1;2;3
93;09.03.2015;2015;03;11;Maanantai;5;7;12
93;09.03.2015;2015;03;12;Maanantai;3;4;7
93;09.03.2015;2015;03;13;Maanantai;3;3;6
93;09.03.2015;2015;03;14;Maanantai;4;5;9
93;09.03.2015;2015;03;15;Maanantai;15;8;23
93;09.03.2015;2015;03;16;Maanantai;14;16;30
93;09.03.2015;2015;03;17;Maanantai;5;8;13
93;09.03.2015;2015;03;18;Maanantai;3;3;6
93;09.03.2015;2015;03;19;Maanantai;4;3;7
93;09.03.2015;2015;03;20;Maanantai;4;3;7
93;09.03.2015;2015;03;21;Maanantai;3;2;5
93;09.03.2015;2015;03;22;Maanantai;0;1;1
93;09.03.2015;2015;03;23;Maanantai;0;0;0
93;10.03.2015;2015;03;00;Tiistai;0;0;0
93;10.03.2015;2015;03;01;Tiistai;0;0;0
93;10.03.2015;2015;03;02;Tiistai;0;0;0
93;10.03.2015;2015;03;03;Tiistai;0;0;0
93;10.03.2015;2015;03;04;Tiistai;0;0;0
93;10.03.2015;2015;03;05;Tiistai;0;1;1
93;10.03.2015;2015;03;06;Tiistai;11;6;17
93;10.03.2015;2015;03;07;Tiistai;13;15;28
93;10.03.2015;2015;03;08;Tiistai;3;7;10
93;10.03.2015;2015;03;09;Tiistai;4;4;8
93;10.03.2015;2015;03;10;Tiistai;5;7;12
93;10.03.2015;2015;03;11;Tiistai;0;5;5
93;10.03.2015;2015;03;12;Tiistai;4;4;8
93;10.03.2015;2015;03;13;Tiistai;8;2;10
93;10.03.2015;2015;03;14;Tiistai;6;0;6
93;10.03.2015;2015;03;15;Tiistai;9;6;15
93;10.03.2015;2015;03;16;Tiistai;14;11;25
93;10.03.2015;2015;03;17;Tiistai;2;5;7
93;10.03.2015;2015;03;18;Tiistai;4;4;8
93;10.03.2015;2015;03;19;Tiistai;4;2;6
93;10.03.2015;2015;03;20;Tiistai;2;3;5
93;10.03.2015;2015;03;21;Tiistai;0;2;2
93;10.03.2015;2015;03;22;Tiistai;1;3;4
93;10.03.2015;2015;03;23;Tiistai;0;0;0
93;11.03.2015;2015;03;00;Keskiviikko;0;0;0
93;11.03.2015;2015;03;01;Keskiviikko;0;0;0
93;11.03.2015;2015;03;02;Keskiviikko;0;0;0
93;11.03.2015;2015;03;03;Keskiviikko;0;0;0
93;11.03.2015;2015;03;04;Keskiviikko;0;0;0
93;11.03.2015;2015;03;05;Keskiviikko;0;1;1
93;11.03.2015;2015;03;06;Keskiviikko;5;5;10
93;11.03.2015;2015;03;07;Keskiviikko;15;14;29
93;11.03.2015;2015;03;08;Keskiviikko;6;8;14
93;11.03.2015;2015;03;09;Keskiviikko;3;5;8
93;11.03.2015;2015;03;10;Keskiviikko;4;4;8
93;11.03.2015;2015;03;11;Keskiviikko;5;3;8
93;11.03.2015;2015;03;12;Keskiviikko;6;5;11
93;11.03.2015;2015;03;13;Keskiviikko;4;7;11
93;11.03.2015;2015;03;14;Keskiviikko;4;5;9
93;11.03.2015;2015;03;15;Keskiviikko;12;8;20
93;11.03.2015;2015;03;16;Keskiviikko;17;18;35
93;11.03.2015;2015;03;17;Keskiviikko;14;2;16
93;11.03.2015;2015;03;18;Keskiviikko;2;4;6
93;11.03.2015;2015;03;19;Keskiviikko;4;5;9
93;11.03.2015;2015;03;20;Keskiviikko;1;3;4
93;11.03.2015;2015;03;21;Keskiviikko;1;0;1
93;11.03.2015;2015;03;22;Keskiviikko;0;0;0
93;11.03.2015;2015;03;23;Keskiviikko;0;0;0
93;12.03.2015;2015;03;00;Torstai;0;0;0
93;12.03.2015;2015;03;01;Torstai;1;0;1
93;12.03.2015;2015;03;02;Torstai;0;0;0
93;12.03.2015;2015;03;03;Torstai;0;0;0
93;12.03.2015;2015;03;04;Torstai;0;0;0
93;12.03.2015;2015;03;05;Torstai;0;2;2
93;12.03.2015;2015;03;06;Torstai;9;5;14
93;12.03.2015;2015;03;07;Torstai;7;15;22
93;12.03.2015;2015;03;08;Torstai;5;8;13
93;12.03.2015;2015;03;09;Torstai;5;6;11
93;12.03.2015;2015;03;10;Torstai;2;3;5
93;12.03.2015;2015;03;11;Torstai;7;2;9
93;12.03.2015;2015;03;12;Torstai;4;4;8
93;12.03.2015;2015;03;13;Torstai;5;4;9
93;12.03.2015;2015;03;14;Torstai;6;10;16
93;12.03.2015;2015;03;15;Torstai;14;6;20
93;12.03.2015;2015;03;16;Torstai;16;12;28
93;12.03.2015;2015;03;17;Torstai;10;7;17
93;12.03.2015;2015;03;18;Torstai;5;2;7
93;12.03.2015;2015;03;19;Torstai;4;9;13
93;12.03.2015;2015;03;20;Torstai;3;1;4
93;12.03.2015;2015;03;21;Torstai;0;1;1
93;12.03.2015;2015;03;22;Torstai;0;0;0
93;12.03.2015;2015;03;23;Torstai;0;0;0
93;13.03.2015;2015;03;00;Perjantai;1;0;1
93;13.03.2015;2015;03;01;Perjantai;0;0;0
93;13.03.2015;2015;03;02;Perjantai;0;0;0
93;13.03.2015;2015;03;03;Perjantai;0;0;0
93;13.03.2015;2015;03;04;Perjantai;0;0;0
93;13.03.2015;2015;03;05;Perjantai;0;2;2
93;13.03.2015;2015;03;06;Perjantai;4;4;8
93;13.03.2015;2015;03;07;Perjantai;5;16;21
93;13.03.2015;2015;03;08;Perjantai;5;6;11
93;13.03.2015;2015;03;09;Perjantai;4;3;7
93;13.03.2015;2015;03;10;Perjantai;5;7;12
93;13.03.2015;2015;03;11;Perjantai;4;4;8
93;13.03.2015;2015;03;12;Perjantai;4;4;8
93;13.03.2015;2015;03;13;Perjantai;4;9;13
93;13.03.2015;2015;03;14;Perjantai;9;4;13
93;13.03.2015;2015;03;15;Perjantai;11;8;19
93;13.03.2015;2015;03;16;Perjantai;15;9;24
93;13.03.2015;2015;03;17;Perjantai;6;3;9
93;13.03.2015;2015;03;18;Perjantai;2;4;6
93;13.03.2015;2015;03;19;Perjantai;1;4;5
93;13.03.2015;2015;03;20;Perjantai;1;5;6
93;13.03.2015;2015;03;21;Perjantai;5;2;7
93;13.03.2015;2015;03;22;Perjantai;0;2;2
93;13.03.2015;2015;03;23;Perjantai;2;1;3
93;14.03.2015;2015;03;00;Lauantai;0;0;0
93;14.03.2015;2015;03;01;Lauantai;0;0;0
93;14.03.2015;2015;03;02;Lauantai;0;0;0
93;14.03.2015;2015;03;03;Lauantai;0;0;0
93;14.03.2015;2015;03;04;Lauantai;0;0;0
93;14.03.2015;2015;03;05;Lauantai;0;1;1
93;14.03.2015;2015;03;06;Lauantai;1;2;3
93;14.03.2015;2015;03;07;Lauantai;3;2;5
93;14.03.2015;2015;03;08;Lauantai;0;4;4
93;14.03.2015;2015;03;09;Lauantai;4;4;8
93;14.03.2015;2015;03;10;Lauantai;5;4;9
93;14.03.2015;2015;03;11;Lauantai;9;6;15
93;14.03.2015;2015;03;12;Lauantai;8;5;13
93;14.03.2015;2015;03;13;Lauantai;4;10;14
93;14.03.2015;2015;03;14;Lauantai;13;5;18
93;14.03.2015;2015;03;15;Lauantai;11;10;21
93;14.03.2015;2015;03;16;Lauantai;9;8;17
93;14.03.2015;2015;03;17;Lauantai;6;7;13
93;14.03.2015;2015;03;18;Lauantai;12;7;19
93;14.03.2015;2015;03;19;Lauantai;4;2;6
93;14.03.2015;2015;03;20;Lauantai;0;1;1
93;14.03.2015;2015;03;21;Lauantai;1;0;1
93;14.03.2015;2015;03;22;Lauantai;0;0;0
93;14.03.2015;2015;03;23;Lauantai;0;2;2
93;15.03.2015;2015;03;00;Sunnuntai;0;0;0
93;15.03.2015;2015;03;01;Sunnuntai;0;0;0
93;15.03.2015;2015;03;02;Sunnuntai;0;0;0
93;15.03.2015;2015;03;03;Sunnuntai;0;0;0
93;15.03.2015;2015;03;04;Sunnuntai;1;0;1
93;15.03.2015;2015;03;05;Sunnuntai;0;0;0
93;15.03.2015;2015;03;06;Sunnuntai;1;2;3
93;15.03.2015;2015;03;07;Sunnuntai;4;0;4
93;15.03.2015;2015;03;08;Sunnuntai;1;2;3
93;15.03.2015;2015;03;09;Sunnuntai;0;3;3
93;15.03.2015;2015;03;10;Sunnuntai;2;15;17
93;15.03.2015;2015;03;11;Sunnuntai;17;7;24
93;15.03.2015;2015;03;12;Sunnuntai;14;8;22
93;15.03.2015;2015;03;13;Sunnuntai;17;7;24
93;15.03.2015;2015;03;14;Sunnuntai;15;11;26
93;15.03.2015;2015;03;15;Sunnuntai;6;8;14
93;15.03.2015;2015;03;16;Sunnuntai;3;10;13
93;15.03.2015;2015;03;17;Sunnuntai;11;8;19
93;15.03.2015;2015;03;18;Sunnuntai;5;2;7
93;15.03.2015;2015;03;19;Sunnuntai;4;1;5
93;15.03.2015;2015;03;20;Sunnuntai;2;2;4
93;15.03.2015;2015;03;21;Sunnuntai;0;0;0
93;15.03.2015;2015;03;22;Sunnuntai;3;1;4
93;15.03.2015;2015;03;23;Sunnuntai;0;0;0
93;16.03.2015;2015;03;00;Maanantai;0;1;1
93;16.03.2015;2015;03;01;Maanantai;0;0;0
93;16.03.2015;2015;03;02;Maanantai;0;0;0
93;16.03.2015;2015;03;03;Maanantai;0;0;0
93;16.03.2015;2015;03;04;Maanantai;0;0;0
93;16.03.2015;2015;03;05;Maanantai;1;2;3
93;16.03.2015;2015;03;06;Maanantai;10;5;15
93;16.03.2015;2015;03;07;Maanantai;8;12;20
93;16.03.2015;2015;03;08;Maanantai;7;13;20
93;16.03.2015;2015;03;09;Maanantai;2;7;9
93;16.03.2015;2015;03;10;Maanantai;1;0;1
93;16.03.2015;2015;03;11;Maanantai;4;3;7
93;16.03.2015;2015;03;12;Maanantai;4;6;10
93;16.03.2015;2015;03;13;Maanantai;5;8;13
93;16.03.2015;2015;03;14;Maanantai;7;4;11
93;16.03.2015;2015;03;15;Maanantai;17;12;29
93;16.03.2015;2015;03;16;Maanantai;23;14;37
93;16.03.2015;2015;03;17;Maanantai;8;11;19
93;16.03.2015;2015;03;18;Maanantai;6;5;11
93;16.03.2015;2015;03;19;Maanantai;7;8;15
93;16.03.2015;2015;03;20;Maanantai;3;2;5
93;16.03.2015;2015;03;21;Maanantai;0;5;5
93;16.03.2015;2015;03;22;Maanantai;0;0;0
93;16.03.2015;2015;03;23;Maanantai;0;0;0
93;17.03.2015;2015;03;00;Tiistai;0;0;0
93;17.03.2015;2015;03;01;Tiistai;0;0;0
93;17.03.2015;2015;03;02;Tiistai;0;0;0
93;17.03.2015;2015;03;03;Tiistai;0;0;0
93;17.03.2015;2015;03;04;Tiistai;0;0;0
93;17.03.2015;2015;03;05;Tiistai;0;3;3
93;17.03.2015;2015;03;06;Tiistai;11;5;16
93;17.03.2015;2015;03;07;Tiistai;11;17;28
93;17.03.2015;2015;03;08;Tiistai;4;9;13
93;17.03.2015;2015;03;09;Tiistai;5;0;5
93;17.03.2015;2015;03;10;Tiistai;7;8;15
93;17.03.2015;2015;03;11;Tiistai;4;3;7
93;17.03.2015;2015;03;12;Tiistai;4;11;15
93;17.03.2015;2015;03;13;Tiistai;1;5;6
93;17.03.2015;2015;03;14;Tiistai;5;8;13
93;17.03.2015;2015;03;15;Tiistai;19;15;34
93;17.03.2015;2015;03;16;Tiistai;27;12;39
93;17.03.2015;2015;03;17;Tiistai;15;11;26
93;17.03.2015;2015;03;18;Tiistai;10;7;17
93;17.03.2015;2015;03;19;Tiistai;5;5;10
93;17.03.2015;2015;03;20;Tiistai;1;1;2
93;17.03.2015;2015;03;21;Tiistai;0;2;2
93;17.03.2015;2015;03;22;Tiistai;1;1;2
93;17.03.2015;2015;03;23;Tiistai;0;0;0
93;18.03.2015;2015;03;00;Keskiviikko;0;0;0
93;18.03.2015;2015;03;01;Keskiviikko;0;0;0
93;18.03.2015;2015;03;02;Keskiviikko;0;0;0
93;18.03.2015;2015;03;03;Keskiviikko;0;0;0
93;18.03.2015;2015;03;04;Keskiviikko;0;0;0
93;18.03.2015;2015;03;05;Keskiviikko;3;2;5
93;18.03.2015;2015;03;06;Keskiviikko;5;8;13
93;18.03.2015;2015;03;07;Keskiviikko;10;17;27
93;18.03.2015;2015;03;08;Keskiviikko;8;14;22
93;18.03.2015;2015;03;09;Keskiviikko;4;5;9
93;18.03.2015;2015;03;10;Keskiviikko;6;3;9
93;18.03.2015;2015;03;11;Keskiviikko;5;5;10
93;18.03.2015;2015;03;12;Keskiviikko;5;3;8
93;18.03.2015;2015;03;13;Keskiviikko;4;12;16
93;18.03.2015;2015;03;14;Keskiviikko;13;5;18
93;18.03.2015;2015;03;15;Keskiviikko;19;7;26
93;18.03.2015;2015;03;16;Keskiviikko;17;11;28
93;18.03.2015;2015;03;17;Keskiviikko;16;9;25
93;18.03.2015;2015;03;18;Keskiviikko;6;4;10
93;18.03.2015;2015;03;19;Keskiviikko;5;4;9
93;18.03.2015;2015;03;20;Keskiviikko;6;5;11
93;18.03.2015;2015;03;21;Keskiviikko;2;3;5
93;18.03.2015;2015;03;22;Keskiviikko;0;0;0
93;18.03.2015;2015;03;23;Keskiviikko;0;0;0
93;19.03.2015;2015;03;00;Torstai;0;0;0
93;19.03.2015;2015;03;01;Torstai;0;0;0
93;19.03.2015;2015;03;02;Torstai;0;0;0
93;19.03.2015;2015;03;03;Torstai;0;0;0
93;19.03.2015;2015;03;04;Torstai;0;0;0
93;19.03.2015;2015;03;05;Torstai;0;3;3
93;19.03.2015;2015;03;06;Torstai;6;5;11
93;19.03.2015;2015;03;07;Torstai;9;20;29
93;19.03.2015;2015;03;08;Torstai;6;13;19
93;19.03.2015;2015;03;09;Torstai;1;3;4
93;19.03.2015;2015;03;10;Torstai;2;2;4
93;19.03.2015;2015;03;11;Torstai;1;1;2
93;19.03.2015;2015;03;12;Torstai;2;2;4
93;19.03.2015;2015;03;13;Torstai;2;3;5
93;19.03.2015;2015;03;14;Torstai;9;5;14
93;19.03.2015;2015;03;15;Torstai;17;3;20
93;19.03.2015;2015;03;16;Torstai;13;17;30
93;19.03.2015;2015;03;17;Torstai;6;2;8
93;19.03.2015;2015;03;18;Torstai;4;6;10
93;19.03.2015;2015;03;19;Torstai;4;5;9
93;19.03.2015;2015;03;20;Torstai;3;0;3
93;19.03.2015;2015;03;21;Torstai;1;3;4
93;19.03.2015;2015;03;22;Torstai;1;1;2
93;19.03.2015;2015;03;23;Torstai;0;1;1
93;20.03.2015;2015;03;00;Perjantai;0;0;0
93;20.03.2015;2015;03;01;Perjantai;0;0;0
93;20.03.2015;2015;03;02;Perjantai;0;0;0
93;20.03.2015;2015;03;03;Perjantai;0;0;0
93;20.03.2015;2015;03;04;Perjantai;0;0;0
93;20.03.2015;2015;03;05;Perjantai;0;2;2
93;20.03.2015;2015;03;06;Perjantai;5;7;12
93;20.03.2015;2015;03;07;Perjantai;3;13;16
93;20.03.2015;2015;03;08;Perjantai;4;6;10
93;20.03.2015;2015;03;09;Perjantai;1;2;3
93;20.03.2015;2015;03;10;Perjantai;3;4;7
93;20.03.2015;2015;03;11;Perjantai;3;7;10
93;20.03.2015;2015;03;12;Perjantai;5;4;9
93;20.03.2015;2015;03;13;Perjantai;9;7;16
93;20.03.2015;2015;03;14;Perjantai;12;6;18
93;20.03.2015;2015;03;15;Perjantai;9;7;16
93;20.03.2015;2015;03;16;Perjantai;12;6;18
93;20.03.2015;2015;03;17;Perjantai;8;4;12
93;20.03.2015;2015;03;18;Perjantai;2;7;9
93;20.03.2015;2015;03;19;Perjantai;5;4;9
93;20.03.2015;2015;03;20;Perjantai;2;3;5
93;20.03.2015;2015;03;21;Perjantai;0;1;1
93;20.03.2015;2015;03;22;Perjantai;0;1;1
93;20.03.2015;2015;03;23;Perjantai;0;0;0
93;21.03.2015;2015;03;00;Lauantai;0;0;0
93;21.03.2015;2015;03;01;Lauantai;0;0;0
93;21.03.2015;2015;03;02;Lauantai;0;0;0
93;21.03.2015;2015;03;03;Lauantai;0;0;0
93;21.03.2015;2015;03;04;Lauantai;0;0;0
93;21.03.2015;2015;03;05;Lauantai;0;0;0
93;21.03.2015;2015;03;06;Lauantai;0;0;0
93;21.03.2015;2015;03;07;Lauantai;0;1;1
93;21.03.2015;2015;03;08;Lauantai;1;2;3
93;21.03.2015;2015;03;09;Lauantai;3;2;5
93;21.03.2015;2015;03;10;Lauantai;7;3;10
93;21.03.2015;2015;03;11;Lauantai;4;6;10
93;21.03.2015;2015;03;12;Lauantai;4;3;7
93;21.03.2015;2015;03;13;Lauantai;3;2;5
93;21.03.2015;2015;03;14;Lauantai;3;3;6
93;21.03.2015;2015;03;15;Lauantai;4;1;5
93;21.03.2015;2015;03;16;Lauantai;3;8;11
93;21.03.2015;2015;03;17;Lauantai;6;5;11
93;21.03.2015;2015;03;18;Lauantai;4;1;5
93;21.03.2015;2015;03;19;Lauantai;1;0;1
93;21.03.2015;2015;03;20;Lauantai;1;2;3
93;21.03.2015;2015;03;21;Lauantai;0;1;1
93;21.03.2015;2015;03;22;Lauantai;0;0;0
93;21.03.2015;2015;03;23;Lauantai;0;0;0
93;22.03.2015;2015;03;00;Sunnuntai;0;0;0
93;22.03.2015;2015;03;01;Sunnuntai;0;0;0
93;22.03.2015;2015;03;02;Sunnuntai;0;0;0
93;22.03.2015;2015;03;03;Sunnuntai;0;0;0
93;22.03.2015;2015;03;04;Sunnuntai;0;0;0
93;22.03.2015;2015;03;05;Sunnuntai;0;0;0
93;22.03.2015;2015;03;06;Sunnuntai;0;0;0
93;22.03.2015;2015;03;07;Sunnuntai;2;0;2
93;22.03.2015;2015;03;08;Sunnuntai;2;0;2
93;22.03.2015;2015;03;09;Sunnuntai;2;2;4
93;22.03.2015;2015;03;10;Sunnuntai;2;3;5
93;22.03.2015;2015;03;11;Sunnuntai;4;2;6
93;22.03.2015;2015;03;12;Sunnuntai;2;10;12
93;22.03.2015;2015;03;13;Sunnuntai;1;3;4
93;22.03.2015;2015;03;14;Sunnuntai;0;3;3
93;22.03.2015;2015;03;15;Sunnuntai;0;3;3
93;22.03.2015;2015;03;16;Sunnuntai;1;2;3
93;22.03.2015;2015;03;17;Sunnuntai;2;1;3
93;22.03.2015;2015;03;18;Sunnuntai;3;5;8
93;22.03.2015;2015;03;19;Sunnuntai;2;1;3
93;22.03.2015;2015;03;20;Sunnuntai;0;1;1
93;22.03.2015;2015;03;21;Sunnuntai;0;0;0
93;22.03.2015;2015;03;22;Sunnuntai;0;0;0
93;22.03.2015;2015;03;23;Sunnuntai;0;0;0
93;23.03.2015;2015;03;00;Maanantai;0;0;0
93;23.03.2015;2015;03;01;Maanantai;0;0;0
93;23.03.2015;2015;03;02;Maanantai;0;0;0
93;23.03.2015;2015;03;03;Maanantai;0;0;0
93;23.03.2015;2015;03;04;Maanantai;0;0;0
93;23.03.2015;2015;03;05;Maanantai;0;1;1
93;23.03.2015;2015;03;06;Maanantai;7;7;14
93;23.03.2015;2015;03;07;Maanantai;10;10;20
93;23.03.2015;2015;03;08;Maanantai;1;15;16
93;23.03.2015;2015;03;09;Maanantai;3;6;9
93;23.03.2015;2015;03;10;Maanantai;5;1;6
93;23.03.2015;2015;03;11;Maanantai;1;6;7
93;23.03.2015;2015;03;12;Maanantai;2;4;6
93;23.03.2015;2015;03;13;Maanantai;5;3;8
93;23.03.2015;2015;03;14;Maanantai;4;2;6
93;23.03.2015;2015;03;15;Maanantai;9;9;18
93;23.03.2015;2015;03;16;Maanantai;21;10;31
93;23.03.2015;2015;03;17;Maanantai;3;2;5
93;23.03.2015;2015;03;18;Maanantai;2;2;4
93;23.03.2015;2015;03;19;Maanantai;3;1;4
93;23.03.2015;2015;03;20;Maanantai;1;2;3
93;23.03.2015;2015;03;21;Maanantai;1;0;1
93;23.03.2015;2015;03;22;Maanantai;0;1;1
93;23.03.2015;2015;03;23;Maanantai;0;0;0
93;24.03.2015;2015;03;00;Tiistai;0;0;0
93;24.03.2015;2015;03;01;Tiistai;0;0;0
93;24.03.2015;2015;03;02;Tiistai;0;0;0
93;24.03.2015;2015;03;03;Tiistai;0;0;0
93;24.03.2015;2015;03;04;Tiistai;0;0;0
93;24.03.2015;2015;03;05;Tiistai;1;1;2
93;24.03.2015;2015;03;06;Tiistai;3;5;8
93;24.03.2015;2015;03;07;Tiistai;12;11;23
93;24.03.2015;2015;03;08;Tiistai;3;13;16
93;24.03.2015;2015;03;09;Tiistai;2;1;3
93;24.03.2015;2015;03;10;Tiistai;0;1;1
93;24.03.2015;2015;03;11;Tiistai;2;1;3
93;24.03.2015;2015;03;12;Tiistai;1;1;2
93;24.03.2015;2015;03;13;Tiistai;0;0;0
93;24.03.2015;2015;03;14;Tiistai;5;1;6
93;24.03.2015;2015;03;15;Tiistai;8;5;13
93;24.03.2015;2015;03;16;Tiistai;16;8;24
93;24.03.2015;2015;03;17;Tiistai;4;3;7
93;24.03.2015;2015;03;18;Tiistai;6;2;8
93;24.03.2015;2015;03;19;Tiistai;2;3;5
93;24.03.2015;2015;03;20;Tiistai;2;1;3
93;24.03.2015;2015;03;21;Tiistai;0;1;1
93;24.03.2015;2015;03;22;Tiistai;1;1;2
93;24.03.2015;2015;03;23;Tiistai;0;0;0
93;25.03.2015;2015;03;00;Keskiviikko;0;0;0
93;25.03.2015;2015;03;01;Keskiviikko;0;0;0
93;25.03.2015;2015;03;02;Keskiviikko;0;0;0
93;25.03.2015;2015;03;03;Keskiviikko;0;0;0
93;25.03.2015;2015;03;04;Keskiviikko;0;0;0
93;25.03.2015;2015;03;05;Keskiviikko;0;1;1
93;25.03.2015;2015;03;06;Keskiviikko;0;1;1
93;25.03.2015;2015;03;07;Keskiviikko;9;12;21
93;25.03.2015;2015;03;08;Keskiviikko;4;8;12
93;25.03.2015;2015;03;09;Keskiviikko;1;3;4
93;25.03.2015;2015;03;10;Keskiviikko;3;1;4
93;25.03.2015;2015;03;11;Keskiviikko;1;4;5
93;25.03.2015;2015;03;12;Keskiviikko;10;2;12
93;25.03.2015;2015;03;13;Keskiviikko;3;7;10
93;25.03.2015;2015;03;14;Keskiviikko;12;2;14
93;25.03.2015;2015;03;15;Keskiviikko;9;7;16
93;25.03.2015;2015;03;16;Keskiviikko;16;13;29
93;25.03.2015;2015;03;17;Keskiviikko;8;0;8
93;25.03.2015;2015;03;18;Keskiviikko;5;2;7
93;25.03.2015;2015;03;19;Keskiviikko;5;2;7
93;25.03.2015;2015;03;20;Keskiviikko;2;2;4
93;25.03.2015;2015;03;21;Keskiviikko;0;1;1
93;25.03.2015;2015;03;22;Keskiviikko;2;0;2
93;25.03.2015;2015;03;23;Keskiviikko;0;0;0
93;26.03.2015;2015;03;00;Torstai;0;0;0
93;26.03.2015;2015;03;01;Torstai;0;2;2
93;26.03.2015;2015;03;02;Torstai;0;0;0
93;26.03.2015;2015;03;03;Torstai;0;0;0
93;26.03.2015;2015;03;04;Torstai;0;0;0
93;26.03.2015;2015;03;05;Torstai;0;1;1
93;26.03.2015;2015;03;06;Torstai;9;7;16
93;26.03.2015;2015;03;07;Torstai;20;17;37
93;26.03.2015;2015;03;08;Torstai;6;5;11
93;26.03.2015;2015;03;09;Torstai;3;3;6
93;26.03.2015;2015;03;10;Torstai;4;2;6
93;26.03.2015;2015;03;11;Torstai;6;7;13
93;26.03.2015;2015;03;12;Torstai;5;6;11
93;26.03.2015;2015;03;13;Torstai;8;5;13
93;26.03.2015;2015;03;14;Torstai;6;7;13
93;26.03.2015;2015;03;15;Torstai;12;6;18
93;26.03.2015;2015;03;16;Torstai;11;7;18
93;26.03.2015;2015;03;17;Torstai;9;5;14
93;26.03.2015;2015;03;18;Torstai;7;6;13
93;26.03.2015;2015;03;19;Torstai;3;3;6
93;26.03.2015;2015;03;20;Torstai;3;3;6
93;26.03.2015;2015;03;21;Torstai;1;2;3
93;26.03.2015;2015;03;22;Torstai;0;2;2
93;26.03.2015;2015;03;23;Torstai;0;0;0
93;27.03.2015;2015;03;00;Perjantai;0;0;0
93;27.03.2015;2015;03;01;Perjantai;0;0;0
93;27.03.2015;2015;03;02;Perjantai;0;0;0
93;27.03.2015;2015;03;03;Perjantai;0;0;0
93;27.03.2015;2015;03;04;Perjantai;0;0;0
93;27.03.2015;2015;03;05;Perjantai;0;1;1
93;27.03.2015;2015;03;06;Perjantai;6;6;12
93;27.03.2015;2015;03;07;Perjantai;11;13;24
93;27.03.2015;2015;03;08;Perjantai;4;8;12
93;27.03.2015;2015;03;09;Perjantai;2;0;2
93;27.03.2015;2015;03;10;Perjantai;5;2;7
93;27.03.2015;2015;03;11;Perjantai;1;1;2
93;27.03.2015;2015;03;12;Perjantai;3;4;7
93;27.03.2015;2015;03;13;Perjantai;5;1;6
93;27.03.2015;2015;03;14;Perjantai;4;5;9
93;27.03.2015;2015;03;15;Perjantai;18;3;21
93;27.03.2015;2015;03;16;Perjantai;12;8;20
93;27.03.2015;2015;03;17;Perjantai;4;5;9
93;27.03.2015;2015;03;18;Perjantai;2;2;4
93;27.03.2015;2015;03;19;Perjantai;5;2;7
93;27.03.2015;2015;03;20;Perjantai;3;1;4
93;27.03.2015;2015;03;21;Perjantai;0;1;1
93;27.03.2015;2015;03;22;Perjantai;2;0;2
93;27.03.2015;2015;03;23;Perjantai;0;0;0
93;28.03.2015;2015;03;00;Lauantai;0;1;1
93;28.03.2015;2015;03;01;Lauantai;0;0;0
93;28.03.2015;2015;03;02;Lauantai;0;0;0
93;28.03.2015;2015;03;03;Lauantai;0;1;1
93;28.03.2015;2015;03;04;Lauantai;0;0;0
93;28.03.2015;2015;03;05;Lauantai;2;0;2
93;28.03.2015;2015;03;06;Lauantai;0;0;0
93;28.03.2015;2015;03;07;Lauantai;0;0;0
93;28.03.2015;2015;03;08;Lauantai;0;0;0
93;28.03.2015;2015;03;09;Lauantai;2;3;5
93;28.03.2015;2015;03;10;Lauantai;1;1;2
93;28.03.2015;2015;03;11;Lauantai;2;3;5
93;28.03.2015;2015;03;12;Lauantai;1;1;2
93;28.03.2015;2015;03;13;Lauantai;2;0;2
93;28.03.2015;2015;03;14;Lauantai;0;2;2
93;28.03.2015;2015;03;15;Lauantai;1;0;1
93;28.03.2015;2015;03;16;Lauantai;1;1;2
93;28.03.2015;2015;03;17;Lauantai;0;1;1
93;28.03.2015;2015;03;18;Lauantai;0;0;0
93;28.03.2015;2015;03;19;Lauantai;3;1;4
93;28.03.2015;2015;03;20;Lauantai;0;0;0
93;28.03.2015;2015;03;21;Lauantai;0;0;0
93;28.03.2015;2015;03;22;Lauantai;1;0;1
93;28.03.2015;2015;03;23;Lauantai;0;0;0
93;29.03.2015;2015;03;00;Sunnuntai;0;1;1
93;29.03.2015;2015;03;01;Sunnuntai;0;0;0
93;29.03.2015;2015;03;02;Sunnuntai;0;0;0
93;29.03.2015;2015;03;03;Sunnuntai;0;0;0
93;29.03.2015;2015;03;04;Sunnuntai;0;0;0
93;29.03.2015;2015;03;05;Sunnuntai;0;0;0
93;29.03.2015;2015;03;06;Sunnuntai;0;0;0
93;29.03.2015;2015;03;07;Sunnuntai;3;0;3
93;29.03.2015;2015;03;08;Sunnuntai;2;1;3
93;29.03.2015;2015;03;09;Sunnuntai;2;1;3
93;29.03.2015;2015;03;10;Sunnuntai;3;1;4
93;29.03.2015;2015;03;11;Sunnuntai;1;9;10
93;29.03.2015;2015;03;12;Sunnuntai;3;3;6
93;29.03.2015;2015;03;13;Sunnuntai;0;10;10
93;29.03.2015;2015;03;14;Sunnuntai;2;3;5
93;29.03.2015;2015;03;15;Sunnuntai;3;2;5
93;29.03.2015;2015;03;16;Sunnuntai;3;3;6
93;29.03.2015;2015;03;17;Sunnuntai;4;5;9
93;29.03.2015;2015;03;18;Sunnuntai;1;4;5
93;29.03.2015;2015;03;19;Sunnuntai;3;3;6
93;29.03.2015;2015;03;20;Sunnuntai;0;3;3
93;29.03.2015;2015;03;21;Sunnuntai;2;1;3
93;29.03.2015;2015;03;22;Sunnuntai;2;0;2
93;29.03.2015;2015;03;23;Sunnuntai;0;0;0
93;30.03.2015;2015;03;00;Maanantai;0;1;1
93;30.03.2015;2015;03;01;Maanantai;0;0;0
93;30.03.2015;2015;03;02;Maanantai;0;0;0
93;30.03.2015;2015;03;03;Maanantai;0;0;0
93;30.03.2015;2015;03;04;Maanantai;0;0;0
93;30.03.2015;2015;03;05;Maanantai;0;0;0
93;30.03.2015;2015;03;06;Maanantai;3;3;6
93;30.03.2015;2015;03;07;Maanantai;6;6;12
93;30.03.2015;2015;03;08;Maanantai;4;10;14
93;30.03.2015;2015;03;09;Maanantai;1;0;1
93;30.03.2015;2015;03;10;Maanantai;0;2;2
93;30.03.2015;2015;03;11;Maanantai;0;1;1
93;30.03.2015;2015;03;12;Maanantai;4;5;9
93;30.03.2015;2015;03;13;Maanantai;4;3;7
93;30.03.2015;2015;03;14;Maanantai;4;0;4
93;30.03.2015;2015;03;15;Maanantai;8;9;17
93;30.03.2015;2015;03;16;Maanantai;14;10;24
93;30.03.2015;2015;03;17;Maanantai;5;4;9
93;30.03.2015;2015;03;18;Maanantai;3;6;9
93;30.03.2015;2015;03;19;Maanantai;3;4;7
93;30.03.2015;2015;03;20;Maanantai;2;1;3
93;30.03.2015;2015;03;21;Maanantai;0;1;1
93;30.03.2015;2015;03;22;Maanantai;1;1;2
93;30.03.2015;2015;03;23;Maanantai;0;0;0
93;31.03.2015;2015;03;00;Tiistai;0;0;0
93;31.03.2015;2015;03;01;Tiistai;0;0;0
93;31.03.2015;2015;03;02;Tiistai;0;1;1
93;31.03.2015;2015;03;03;Tiistai;0;0;0
93;31.03.2015;2015;03;04;Tiistai;0;0;0
93;31.03.2015;2015;03;05;Tiistai;0;0;0
93;31.03.2015;2015;03;06;Tiistai;4;2;6
93;31.03.2015;2015;03;07;Tiistai;4;4;8
93;31.03.2015;2015;03;08;Tiistai;7;4;11
93;31.03.2015;2015;03;09;Tiistai;0;1;1
93;31.03.2015;2015;03;10;Tiistai;0;2;2
93;31.03.2015;2015;03;11;Tiistai;2;3;5
93;31.03.2015;2015;03;12;Tiistai;2;2;4
93;31.03.2015;2015;03;13;Tiistai;0;4;4
93;31.03.2015;2015;03;14;Tiistai;3;0;3
93;31.03.2015;2015;03;15;Tiistai;4;4;8
93;31.03.2015;2015;03;16;Tiistai;9;6;15
93;31.03.2015;2015;03;17;Tiistai;4;6;10
93;31.03.2015;2015;03;18;Tiistai;4;7;11
93;31.03.2015;2015;03;19;Tiistai;3;4;7
93;31.03.2015;2015;03;20;Tiistai;3;1;4
93;31.03.2015;2015;03;21;Tiistai;3;3;6
93;31.03.2015;2015;03;22;Tiistai;0;1;1
93;31.03.2015;2015;03;23;Tiistai;0;0;0
93;01.04.2015;2015;04;00;Keskiviikko;0;0;0
93;01.04.2015;2015;04;01;Keskiviikko;0;0;0
93;01.04.2015;2015;04;02;Keskiviikko;0;0;0
93;01.04.2015;2015;04;03;Keskiviikko;0;0;0
93;01.04.2015;2015;04;04;Keskiviikko;0;0;0
93;01.04.2015;2015;04;05;Keskiviikko;0;1;1
93;01.04.2015;2015;04;06;Keskiviikko;7;5;12
93;01.04.2015;2015;04;07;Keskiviikko;11;16;27
93;01.04.2015;2015;04;08;Keskiviikko;6;8;14
93;01.04.2015;2015;04;09;Keskiviikko;7;4;11
93;01.04.2015;2015;04;10;Keskiviikko;2;2;4
93;01.04.2015;2015;04;11;Keskiviikko;2;1;3
93;01.04.2015;2015;04;12;Keskiviikko;5;7;12
93;01.04.2015;2015;04;13;Keskiviikko;1;9;10
93;01.04.2015;2015;04;14;Keskiviikko;5;3;8
93;01.04.2015;2015;04;15;Keskiviikko;22;8;30
93;01.04.2015;2015;04;16;Keskiviikko;20;12;32
93;01.04.2015;2015;04;17;Keskiviikko;16;17;33
93;01.04.2015;2015;04;18;Keskiviikko;7;2;9
93;01.04.2015;2015;04;19;Keskiviikko;1;16;17
93;01.04.2015;2015;04;20;Keskiviikko;3;6;9
93;01.04.2015;2015;04;21;Keskiviikko;2;1;3
93;01.04.2015;2015;04;22;Keskiviikko;0;0;0
93;01.04.2015;2015;04;23;Keskiviikko;0;1;1
93;02.04.2015;2015;04;00;Torstai;0;2;2
93;02.04.2015;2015;04;01;Torstai;0;0;0
93;02.04.2015;2015;04;02;Torstai;0;0;0
93;02.04.2015;2015;04;03;Torstai;0;0;0
93;02.04.2015;2015;04;04;Torstai;0;0;0
93;02.04.2015;2015;04;05;Torstai;1;0;1
93;02.04.2015;2015;04;06;Torstai;9;3;12
93;02.04.2015;2015;04;07;Torstai;6;14;20
93;02.04.2015;2015;04;08;Torstai;8;3;11
93;02.04.2015;2015;04;09;Torstai;1;3;4
93;02.04.2015;2015;04;10;Torstai;7;4;11
93;02.04.2015;2015;04;11;Torstai;3;5;8
93;02.04.2015;2015;04;12;Torstai;5;1;6
93;02.04.2015;2015;04;13;Torstai;4;9;13
93;02.04.2015;2015;04;14;Torstai;12;15;27
93;02.04.2015;2015;04;15;Torstai;10;15;25
93;02.04.2015;2015;04;16;Torstai;13;10;23
93;02.04.2015;2015;04;17;Torstai;4;6;10
93;02.04.2015;2015;04;18;Torstai;3;2;5
93;02.04.2015;2015;04;19;Torstai;7;11;18
93;02.04.2015;2015;04;20;Torstai;1;4;5
93;02.04.2015;2015;04;21;Torstai;3;2;5
93;02.04.2015;2015;04;22;Torstai;2;1;3
93;02.04.2015;2015;04;23;Torstai;0;0;0
93;03.04.2015;2015;04;00;Perjantai;0;0;0
93;03.04.2015;2015;04;01;Perjantai;0;1;1
93;03.04.2015;2015;04;02;Perjantai;0;0;0
93;03.04.2015;2015;04;03;Perjantai;0;0;0
93;03.04.2015;2015;04;04;Perjantai;0;0;0
93;03.04.2015;2015;04;05;Perjantai;0;0;0
93;03.04.2015;2015;04;06;Perjantai;0;0;0
93;03.04.2015;2015;04;07;Perjantai;1;0;1
93;03.04.2015;2015;04;08;Perjantai;1;1;2
93;03.04.2015;2015;04;09;Perjantai;3;3;6
93;03.04.2015;2015;04;10;Perjantai;5;4;9
93;03.04.2015;2015;04;11;Perjantai;4;1;5
93;03.04.2015;2015;04;12;Perjantai;5;9;14
93;03.04.2015;2015;04;13;Perjantai;7;8;15
93;03.04.2015;2015;04;14;Perjantai;5;4;9
93;03.04.2015;2015;04;15;Perjantai;7;5;12
93;03.04.2015;2015;04;16;Perjantai;1;9;10
93;03.04.2015;2015;04;17;Perjantai;2;6;8
93;03.04.2015;2015;04;18;Perjantai;5;4;9
93;03.04.2015;2015;04;19;Perjantai;7;1;8
93;03.04.2015;2015;04;20;Perjantai;2;4;6
93;03.04.2015;2015;04;21;Perjantai;0;2;2
93;03.04.2015;2015;04;22;Perjantai;1;1;2
93;03.04.2015;2015;04;23;Perjantai;0;0;0
93;04.04.2015;2015;04;00;Lauantai;0;0;0
93;04.04.2015;2015;04;01;Lauantai;0;0;0
93;04.04.2015;2015;04;02;Lauantai;0;0;0
93;04.04.2015;2015;04;03;Lauantai;0;0;0
93;04.04.2015;2015;04;04;Lauantai;0;0;0
93;04.04.2015;2015;04;05;Lauantai;0;1;1
93;04.04.2015;2015;04;06;Lauantai;1;0;1
93;04.04.2015;2015;04;07;Lauantai;1;0;1
93;04.04.2015;2015;04;08;Lauantai;0;1;1
93;04.04.2015;2015;04;09;Lauantai;4;4;8
93;04.04.2015;2015;04;10;Lauantai;3;2;5
93;04.04.2015;2015;04;11;Lauantai;4;10;14
93;04.04.2015;2015;04;12;Lauantai;7;8;15
93;04.04.2015;2015;04;13;Lauantai;12;8;20
93;04.04.2015;2015;04;14;Lauantai;12;11;23
93;04.04.2015;2015;04;15;Lauantai;9;12;21
93;04.04.2015;2015;04;16;Lauantai;3;9;12
93;04.04.2015;2015;04;17;Lauantai;8;6;14
93;04.04.2015;2015;04;18;Lauantai;2;7;9
93;04.04.2015;2015;04;19;Lauantai;5;4;9
93;04.04.2015;2015;04;20;Lauantai;5;6;11
93;04.04.2015;2015;04;21;Lauantai;2;5;7
93;04.04.2015;2015;04;22;Lauantai;0;2;2
93;04.04.2015;2015;04;23;Lauantai;1;0;1
93;05.04.2015;2015;04;00;Sunnuntai;1;1;2
93;05.04.2015;2015;04;01;Sunnuntai;0;0;0
93;05.04.2015;2015;04;02;Sunnuntai;0;0;0
93;05.04.2015;2015;04;03;Sunnuntai;0;0;0
93;05.04.2015;2015;04;04;Sunnuntai;0;0;0
93;05.04.2015;2015;04;05;Sunnuntai;1;1;2
93;05.04.2015;2015;04;06;Sunnuntai;1;0;1
93;05.04.2015;2015;04;07;Sunnuntai;1;1;2
93;05.04.2015;2015;04;08;Sunnuntai;4;1;5
93;05.04.2015;2015;04;09;Sunnuntai;2;4;6
93;05.04.2015;2015;04;10;Sunnuntai;7;6;13
93;05.04.2015;2015;04;11;Sunnuntai;7;15;22
93;05.04.2015;2015;04;12;Sunnuntai;9;12;21
93;05.04.2015;2015;04;13;Sunnuntai;20;28;48
93;05.04.2015;2015;04;14;Sunnuntai;16;13;29
93;05.04.2015;2015;04;15;Sunnuntai;25;17;42
93;05.04.2015;2015;04;16;Sunnuntai;17;22;39
93;05.04.2015;2015;04;17;Sunnuntai;21;21;42
93;05.04.2015;2015;04;18;Sunnuntai;7;6;13
93;05.04.2015;2015;04;19;Sunnuntai;8;9;17
93;05.04.2015;2015;04;20;Sunnuntai;3;4;7
93;05.04.2015;2015;04;21;Sunnuntai;3;2;5
93;05.04.2015;2015;04;22;Sunnuntai;0;2;2
93;05.04.2015;2015;04;23;Sunnuntai;1;0;1
93;06.04.2015;2015;04;00;Maanantai;0;0;0
93;06.04.2015;2015;04;01;Maanantai;0;0;0
93;06.04.2015;2015;04;02;Maanantai;0;0;0
93;06.04.2015;2015;04;03;Maanantai;0;0;0
93;06.04.2015;2015;04;04;Maanantai;0;0;0
93;06.04.2015;2015;04;05;Maanantai;0;0;0
93;06.04.2015;2015;04;06;Maanantai;1;1;2
93;06.04.2015;2015;04;07;Maanantai;0;2;2
93;06.04.2015;2015;04;08;Maanantai;1;5;6
93;06.04.2015;2015;04;09;Maanantai;5;7;12
93;06.04.2015;2015;04;10;Maanantai;5;7;12
93;06.04.2015;2015;04;11;Maanantai;18;6;24
93;06.04.2015;2015;04;12;Maanantai;6;5;11
93;06.04.2015;2015;04;13;Maanantai;2;3;5
93;06.04.2015;2015;04;14;Maanantai;8;2;10
93;06.04.2015;2015;04;15;Maanantai;2;3;5
93;06.04.2015;2015;04;16;Maanantai;3;0;3
93;06.04.2015;2015;04;17;Maanantai;3;5;8
93;06.04.2015;2015;04;18;Maanantai;8;2;10
93;06.04.2015;2015;04;19;Maanantai;3;4;7
93;06.04.2015;2015;04;20;Maanantai;1;3;4
93;06.04.2015;2015;04;21;Maanantai;1;0;1
93;06.04.2015;2015;04;22;Maanantai;0;0;0
93;06.04.2015;2015;04;23;Maanantai;0;0;0
93;07.04.2015;2015;04;00;Tiistai;0;0;0
93;07.04.2015;2015;04;01;Tiistai;0;0;0
93;07.04.2015;2015;04;02;Tiistai;0;0;0
93;07.04.2015;2015;04;03;Tiistai;0;0;0
93;07.04.2015;2015;04;04;Tiistai;0;1;1
93;07.04.2015;2015;04;05;Tiistai;2;1;3
93;07.04.2015;2015;04;06;Tiistai;9;7;16
93;07.04.2015;2015;04;07;Tiistai;13;15;28
93;07.04.2015;2015;04;08;Tiistai;7;7;14
93;07.04.2015;2015;04;09;Tiistai;3;2;5
93;07.04.2015;2015;04;10;Tiistai;3;0;3
93;07.04.2015;2015;04;11;Tiistai;7;2;9
93;07.04.2015;2015;04;12;Tiistai;8;9;17
93;07.04.2015;2015;04;13;Tiistai;5;13;18
93;07.04.2015;2015;04;14;Tiistai;6;10;16
93;07.04.2015;2015;04;15;Tiistai;19;11;30
93;07.04.2015;2015;04;16;Tiistai;18;20;38
93;07.04.2015;2015;04;17;Tiistai;10;11;21
93;07.04.2015;2015;04;18;Tiistai;16;9;25
93;07.04.2015;2015;04;19;Tiistai;2;8;10
93;07.04.2015;2015;04;20;Tiistai;6;8;14
93;07.04.2015;2015;04;21;Tiistai;2;4;6
93;07.04.2015;2015;04;22;Tiistai;0;1;1
93;07.04.2015;2015;04;23;Tiistai;0;3;3
93;08.04.2015;2015;04;00;Keskiviikko;0;1;1
93;08.04.2015;2015;04;01;Keskiviikko;0;0;0
93;08.04.2015;2015;04;02;Keskiviikko;0;0;0
93;08.04.2015;2015;04;03;Keskiviikko;0;1;1
93;08.04.2015;2015;04;04;Keskiviikko;0;1;1
93;08.04.2015;2015;04;05;Keskiviikko;0;1;1
93;08.04.2015;2015;04;06;Keskiviikko;7;4;11
93;08.04.2015;2015;04;07;Keskiviikko;9;17;26
93;08.04.2015;2015;04;08;Keskiviikko;5;4;9
93;08.04.2015;2015;04;09;Keskiviikko;4;4;8
93;08.04.2015;2015;04;10;Keskiviikko;5;2;7
93;08.04.2015;2015;04;11;Keskiviikko;7;2;9
93;08.04.2015;2015;04;12;Keskiviikko;4;4;8
93;08.04.2015;2015;04;13;Keskiviikko;5;3;8
93;08.04.2015;2015;04;14;Keskiviikko;3;8;11
93;08.04.2015;2015;04;15;Keskiviikko;10;16;26
93;08.04.2015;2015;04;16;Keskiviikko;19;9;28
93;08.04.2015;2015;04;17;Keskiviikko;11;2;13
93;08.04.2015;2015;04;18;Keskiviikko;2;4;6
93;08.04.2015;2015;04;19;Keskiviikko;5;5;10
93;08.04.2015;2015;04;20;Keskiviikko;5;2;7
93;08.04.2015;2015;04;21;Keskiviikko;1;1;2
93;08.04.2015;2015;04;22;Keskiviikko;0;1;1
93;08.04.2015;2015;04;23;Keskiviikko;1;1;2
93;09.04.2015;2015;04;00;Torstai;0;0;0
93;09.04.2015;2015;04;01;Torstai;0;0;0
93;09.04.2015;2015;04;02;Torstai;0;0;0
93;09.04.2015;2015;04;03;Torstai;0;3;3
93;09.04.2015;2015;04;04;Torstai;0;1;1
93;09.04.2015;2015;04;05;Torstai;0;1;1
93;09.04.2015;2015;04;06;Torstai;8;9;17
93;09.04.2015;2015;04;07;Torstai;17;23;40
93;09.04.2015;2015;04;08;Torstai;8;12;20
93;09.04.2015;2015;04;09;Torstai;3;3;6
93;09.04.2015;2015;04;10;Torstai;4;9;13
93;09.04.2015;2015;04;11;Torstai;4;5;9
93;09.04.2015;2015;04;12;Torstai;4;2;6
93;09.04.2015;2015;04;13;Torstai;3;7;10
93;09.04.2015;2015;04;14;Torstai;5;9;14
93;09.04.2015;2015;04;15;Torstai;10;9;19
93;09.04.2015;2015;04;16;Torstai;19;12;31
93;09.04.2015;2015;04;17;Torstai;9;5;14
93;09.04.2015;2015;04;18;Torstai;7;5;12
93;09.04.2015;2015;04;19;Torstai;3;5;8
93;09.04.2015;2015;04;20;Torstai;3;3;6
93;09.04.2015;2015;04;21;Torstai;1;5;6
93;09.04.2015;2015;04;22;Torstai;1;1;2
93;09.04.2015;2015;04;23;Torstai;0;0;0
93;10.04.2015;2015;04;00;Perjantai;0;0;0
93;10.04.2015;2015;04;01;Perjantai;0;0;0
93;10.04.2015;2015;04;02;Perjantai;0;0;0
93;10.04.2015;2015;04;03;Perjantai;0;0;0
93;10.04.2015;2015;04;04;Perjantai;0;1;1
93;10.04.2015;2015;04;05;Perjantai;0;2;2
93;10.04.2015;2015;04;06;Perjantai;5;3;8
93;10.04.2015;2015;04;07;Perjantai;10;18;28
93;10.04.2015;2015;04;08;Perjantai;7;12;19
93;10.04.2015;2015;04;09;Perjantai;8;4;12
93;10.04.2015;2015;04;10;Perjantai;5;7;12
93;10.04.2015;2015;04;11;Perjantai;2;7;9
93;10.04.2015;2015;04;12;Perjantai;2;3;5
93;10.04.2015;2015;04;13;Perjantai;3;5;8
93;10.04.2015;2015;04;14;Perjantai;7;5;12
93;10.04.2015;2015;04;15;Perjantai;12;6;18
93;10.04.2015;2015;04;16;Perjantai;12;7;19
93;10.04.2015;2015;04;17;Perjantai;7;11;18
93;10.04.2015;2015;04;18;Perjantai;3;2;5
93;10.04.2015;2015;04;19;Perjantai;2;5;7
93;10.04.2015;2015;04;20;Perjantai;3;3;6
93;10.04.2015;2015;04;21;Perjantai;2;1;3
93;10.04.2015;2015;04;22;Perjantai;0;0;0
93;10.04.2015;2015;04;23;Perjantai;1;0;1
93;11.04.2015;2015;04;00;Lauantai;0;0;0
93;11.04.2015;2015;04;01;Lauantai;0;0;0
93;11.04.2015;2015;04;02;Lauantai;0;1;1
93;11.04.2015;2015;04;03;Lauantai;0;0;0
93;11.04.2015;2015;04;04;Lauantai;0;0;0
93;11.04.2015;2015;04;05;Lauantai;0;2;2
93;11.04.2015;2015;04;06;Lauantai;1;1;2
93;11.04.2015;2015;04;07;Lauantai;3;0;3
93;11.04.2015;2015;04;08;Lauantai;1;5;6
93;11.04.2015;2015;04;09;Lauantai;5;6;11
93;11.04.2015;2015;04;10;Lauantai;11;9;20
93;11.04.2015;2015;04;11;Lauantai;11;12;23
93;11.04.2015;2015;04;12;Lauantai;16;15;31
93;11.04.2015;2015;04;13;Lauantai;14;14;28
93;11.04.2015;2015;04;14;Lauantai;14;17;31
93;11.04.2015;2015;04;15;Lauantai;18;13;31
93;11.04.2015;2015;04;16;Lauantai;27;25;52
93;11.04.2015;2015;04;17;Lauantai;21;10;31
93;11.04.2015;2015;04;18;Lauantai;11;15;26
93;11.04.2015;2015;04;19;Lauantai;11;8;19
93;11.04.2015;2015;04;20;Lauantai;5;3;8
93;11.04.2015;2015;04;21;Lauantai;3;4;7
93;11.04.2015;2015;04;22;Lauantai;2;3;5
93;11.04.2015;2015;04;23;Lauantai;1;1;2
93;12.04.2015;2015;04;00;Sunnuntai;0;0;0
93;12.04.2015;2015;04;01;Sunnuntai;1;0;1
93;12.04.2015;2015;04;02;Sunnuntai;0;0;0
93;12.04.2015;2015;04;03;Sunnuntai;0;0;0
93;12.04.2015;2015;04;04;Sunnuntai;0;0;0
93;12.04.2015;2015;04;05;Sunnuntai;0;0;0
93;12.04.2015;2015;04;06;Sunnuntai;1;1;2
93;12.04.2015;2015;04;07;Sunnuntai;4;2;6
93;12.04.2015;2015;04;08;Sunnuntai;5;3;8
93;12.04.2015;2015;04;09;Sunnuntai;6;6;12
93;12.04.2015;2015;04;10;Sunnuntai;11;23;34
93;12.04.2015;2015;04;11;Sunnuntai;27;31;58
93;12.04.2015;2015;04;12;Sunnuntai;28;30;58
93;12.04.2015;2015;04;13;Sunnuntai;27;35;62
93;12.04.2015;2015;04;14;Sunnuntai;29;21;50
93;12.04.2015;2015;04;15;Sunnuntai;20;27;47
93;12.04.2015;2015;04;16;Sunnuntai;21;26;47
93;12.04.2015;2015;04;17;Sunnuntai;17;8;25
93;12.04.2015;2015;04;18;Sunnuntai;18;18;36
93;12.04.2015;2015;04;19;Sunnuntai;18;17;35
93;12.04.2015;2015;04;20;Sunnuntai;7;3;10
93;12.04.2015;2015;04;21;Sunnuntai;4;1;5
93;12.04.2015;2015;04;22;Sunnuntai;0;2;2
93;12.04.2015;2015;04;23;Sunnuntai;0;0;0
93;13.04.2015;2015;04;00;Maanantai;0;0;0
93;13.04.2015;2015;04;01;Maanantai;0;0;0
93;13.04.2015;2015;04;02;Maanantai;0;0;0
93;13.04.2015;2015;04;03;Maanantai;0;0;0
93;13.04.2015;2015;04;04;Maanantai;0;2;2
93;13.04.2015;2015;04;05;Maanantai;1;0;1
93;13.04.2015;2015;04;06;Maanantai;15;4;19
93;13.04.2015;2015;04;07;Maanantai;14;26;40
93;13.04.2015;2015;04;08;Maanantai;11;15;26
93;13.04.2015;2015;04;09;Maanantai;7;11;18
93;13.04.2015;2015;04;10;Maanantai;6;4;10
93;13.04.2015;2015;04;11;Maanantai;5;6;11
93;13.04.2015;2015;04;12;Maanantai;6;7;13
93;13.04.2015;2015;04;13;Maanantai;5;7;12
93;13.04.2015;2015;04;14;Maanantai;6;5;11
93;13.04.2015;2015;04;15;Maanantai;12;14;26
93;13.04.2015;2015;04;16;Maanantai;18;17;35
93;13.04.2015;2015;04;17;Maanantai;12;12;24
93;13.04.2015;2015;04;18;Maanantai;3;8;11
93;13.04.2015;2015;04;19;Maanantai;4;3;7
93;13.04.2015;2015;04;20;Maanantai;3;3;6
93;13.04.2015;2015;04;21;Maanantai;0;1;1
93;13.04.2015;2015;04;22;Maanantai;0;0;0
93;13.04.2015;2015;04;23;Maanantai;0;0;0
93;14.04.2015;2015;04;00;Tiistai;0;1;1
93;14.04.2015;2015;04;01;Tiistai;0;0;0
93;14.04.2015;2015;04;02;Tiistai;0;0;0
93;14.04.2015;2015;04;03;Tiistai;0;0;0
93;14.04.2015;2015;04;04;Tiistai;1;2;3
93;14.04.2015;2015;04;05;Tiistai;1;0;1
93;14.04.2015;2015;04;06;Tiistai;19;11;30
93;14.04.2015;2015;04;07;Tiistai;23;24;47
93;14.04.2015;2015;04;08;Tiistai;14;12;26
93;14.04.2015;2015;04;09;Tiistai;7;3;10
93;14.04.2015;2015;04;10;Tiistai;7;4;11
93;14.04.2015;2015;04;11;Tiistai;3;7;10
93;14.04.2015;2015;04;12;Tiistai;8;7;15
93;14.04.2015;2015;04;13;Tiistai;6;4;10
93;14.04.2015;2015;04;14;Tiistai;14;9;23
93;14.04.2015;2015;04;15;Tiistai;20;21;41
93;14.04.2015;2015;04;16;Tiistai;26;26;52
93;14.04.2015;2015;04;17;Tiistai;18;21;39
93;14.04.2015;2015;04;18;Tiistai;13;17;30
93;14.04.2015;2015;04;19;Tiistai;9;18;27
93;14.04.2015;2015;04;20;Tiistai;9;6;15
93;14.04.2015;2015;04;21;Tiistai;1;4;5
93;14.04.2015;2015;04;22;Tiistai;3;1;4
93;14.04.2015;2015;04;23;Tiistai;0;2;2
93;15.04.2015;2015;04;00;Keskiviikko;0;1;1
93;15.04.2015;2015;04;01;Keskiviikko;0;0;0
93;15.04.2015;2015;04;02;Keskiviikko;0;0;0
93;15.04.2015;2015;04;03;Keskiviikko;0;0;0
93;15.04.2015;2015;04;04;Keskiviikko;1;2;3
93;15.04.2015;2015;04;05;Keskiviikko;2;0;2
93;15.04.2015;2015;04;06;Keskiviikko;8;3;11
93;15.04.2015;2015;04;07;Keskiviikko;21;17;38
93;15.04.2015;2015;04;08;Keskiviikko;10;10;20
93;15.04.2015;2015;04;09;Keskiviikko;7;5;12
93;15.04.2015;2015;04;10;Keskiviikko;4;4;8
93;15.04.2015;2015;04;11;Keskiviikko;4;5;9
93;15.04.2015;2015;04;12;Keskiviikko;4;5;9
93;15.04.2015;2015;04;13;Keskiviikko;4;8;12
93;15.04.2015;2015;04;14;Keskiviikko;9;3;12
93;15.04.2015;2015;04;15;Keskiviikko;9;11;20
93;15.04.2015;2015;04;16;Keskiviikko;18;17;35
93;15.04.2015;2015;04;17;Keskiviikko;14;17;31
93;15.04.2015;2015;04;18;Keskiviikko;7;8;15
93;15.04.2015;2015;04;19;Keskiviikko;4;8;12
93;15.04.2015;2015;04;20;Keskiviikko;6;5;11
93;15.04.2015;2015;04;21;Keskiviikko;2;2;4
93;15.04.2015;2015;04;22;Keskiviikko;0;4;4
93;15.04.2015;2015;04;23;Keskiviikko;1;0;1
93;16.04.2015;2015;04;00;Torstai;0;0;0
93;16.04.2015;2015;04;01;Torstai;0;1;1
93;16.04.2015;2015;04;02;Torstai;0;1;1
93;16.04.2015;2015;04;03;Torstai;0;0;0
93;16.04.2015;2015;04;04;Torstai;2;1;3
93;16.04.2015;2015;04;05;Torstai;1;0;1
93;16.04.2015;2015;04;06;Torstai;11;5;16
93;16.04.2015;2015;04;07;Torstai;18;19;37
93;16.04.2015;2015;04;08;Torstai;5;16;21
93;16.04.2015;2015;04;09;Torstai;5;2;7
93;16.04.2015;2015;04;10;Torstai;5;6;11
93;16.04.2015;2015;04;11;Torstai;4;2;6
93;16.04.2015;2015;04;12;Torstai;0;7;7
93;16.04.2015;2015;04;13;Torstai;2;6;8
93;16.04.2015;2015;04;14;Torstai;8;10;18
93;16.04.2015;2015;04;15;Torstai;13;15;28
93;16.04.2015;2015;04;16;Torstai;21;16;37
93;16.04.2015;2015;04;17;Torstai;13;12;25
93;16.04.2015;2015;04;18;Torstai;11;11;22
93;16.04.2015;2015;04;19;Torstai;11;9;20
93;16.04.2015;2015;04;20;Torstai;6;9;15
93;16.04.2015;2015;04;21;Torstai;3;2;5
93;16.04.2015;2015;04;22;Torstai;1;1;2
93;16.04.2015;2015;04;23;Torstai;0;0;0
93;17.04.2015;2015;04;00;Perjantai;0;0;0
93;17.04.2015;2015;04;01;Perjantai;0;1;1
93;17.04.2015;2015;04;02;Perjantai;0;0;0
93;17.04.2015;2015;04;03;Perjantai;0;0;0
93;17.04.2015;2015;04;04;Perjantai;2;1;3
93;17.04.2015;2015;04;05;Perjantai;0;2;2
93;17.04.2015;2015;04;06;Perjantai;10;9;19
93;17.04.2015;2015;04;07;Perjantai;17;23;40
93;17.04.2015;2015;04;08;Perjantai;12;14;26
93;17.04.2015;2015;04;09;Perjantai;7;4;11
93;17.04.2015;2015;04;10;Perjantai;13;3;16
93;17.04.2015;2015;04;11;Perjantai;7;8;15
93;17.04.2015;2015;04;12;Perjantai;10;11;21
93;17.04.2015;2015;04;13;Perjantai;15;8;23
93;17.04.2015;2015;04;14;Perjantai;13;21;34
93;17.04.2015;2015;04;15;Perjantai;22;25;47
93;17.04.2015;2015;04;16;Perjantai;20;29;49
93;17.04.2015;2015;04;17;Perjantai;17;12;29
93;17.04.2015;2015;04;18;Perjantai;11;12;23
93;17.04.2015;2015;04;19;Perjantai;5;12;17
93;17.04.2015;2015;04;20;Perjantai;4;7;11
93;17.04.2015;2015;04;21;Perjantai;4;4;8
93;17.04.2015;2015;04;22;Perjantai;0;1;1
93;17.04.2015;2015;04;23;Perjantai;1;0;1
93;18.04.2015;2015;04;00;Lauantai;1;1;2
93;18.04.2015;2015;04;01;Lauantai;0;0;0
93;18.04.2015;2015;04;02;Lauantai;0;0;0
93;18.04.2015;2015;04;03;Lauantai;0;1;1
93;18.04.2015;2015;04;04;Lauantai;0;0;0
93;18.04.2015;2015;04;05;Lauantai;0;0;0
93;18.04.2015;2015;04;06;Lauantai;1;0;1
93;18.04.2015;2015;04;07;Lauantai;5;1;6
93;18.04.2015;2015;04;08;Lauantai;4;5;9
93;18.04.2015;2015;04;09;Lauantai;5;5;10
93;18.04.2015;2015;04;10;Lauantai;15;10;25
93;18.04.2015;2015;04;11;Lauantai;19;16;35
93;18.04.2015;2015;04;12;Lauantai;11;10;21
93;18.04.2015;2015;04;13;Lauantai;10;10;20
93;18.04.2015;2015;04;14;Lauantai;19;9;28
93;18.04.2015;2015;04;15;Lauantai;15;12;27
93;18.04.2015;2015;04;16;Lauantai;14;11;25
93;18.04.2015;2015;04;17;Lauantai;3;6;9
93;18.04.2015;2015;04;18;Lauantai;4;16;20
93;18.04.2015;2015;04;19;Lauantai;14;11;25
93;18.04.2015;2015;04;20;Lauantai;5;6;11
93;18.04.2015;2015;04;21;Lauantai;5;7;12
93;18.04.2015;2015;04;22;Lauantai;1;1;2
93;18.04.2015;2015;04;23;Lauantai;1;1;2
93;19.04.2015;2015;04;00;Sunnuntai;1;0;1
93;19.04.2015;2015;04;01;Sunnuntai;0;0;0
93;19.04.2015;2015;04;02;Sunnuntai;0;0;0
93;19.04.2015;2015;04;03;Sunnuntai;0;0;0
93;19.04.2015;2015;04;04;Sunnuntai;0;0;0
93;19.04.2015;2015;04;05;Sunnuntai;0;1;1
93;19.04.2015;2015;04;06;Sunnuntai;2;0;2
93;19.04.2015;2015;04;07;Sunnuntai;1;4;5
93;19.04.2015;2015;04;08;Sunnuntai;6;7;13
93;19.04.2015;2015;04;09;Sunnuntai;10;3;13
93;19.04.2015;2015;04;10;Sunnuntai;16;7;23
93;19.04.2015;2015;04;11;Sunnuntai;13;11;24
93;19.04.2015;2015;04;12;Sunnuntai;9;18;27
93;19.04.2015;2015;04;13;Sunnuntai;13;21;34
93;19.04.2015;2015;04;14;Sunnuntai;18;9;27
93;19.04.2015;2015;04;15;Sunnuntai;11;13;24
93;19.04.2015;2015;04;16;Sunnuntai;19;14;33
93;19.04.2015;2015;04;17;Sunnuntai;9;14;23
93;19.04.2015;2015;04;18;Sunnuntai;2;11;13
93;19.04.2015;2015;04;19;Sunnuntai;3;5;8
93;19.04.2015;2015;04;20;Sunnuntai;1;7;8
93;19.04.2015;2015;04;21;Sunnuntai;1;2;3
93;19.04.2015;2015;04;22;Sunnuntai;2;0;2
93;19.04.2015;2015;04;23;Sunnuntai;0;0;0
93;20.04.2015;2015;04;00;Maanantai;0;0;0
93;20.04.2015;2015;04;01;Maanantai;0;0;0
93;20.04.2015;2015;04;02;Maanantai;0;0;0
93;20.04.2015;2015;04;03;Maanantai;0;0;0
93;20.04.2015;2015;04;04;Maanantai;1;1;2
93;20.04.2015;2015;04;05;Maanantai;2;2;4
93;20.04.2015;2015;04;06;Maanantai;13;10;23
93;20.04.2015;2015;04;07;Maanantai;29;21;50
93;20.04.2015;2015;04;08;Maanantai;11;21;32
93;20.04.2015;2015;04;09;Maanantai;7;6;13
93;20.04.2015;2015;04;10;Maanantai;9;5;14
93;20.04.2015;2015;04;11;Maanantai;5;7;12
93;20.04.2015;2015;04;12;Maanantai;7;12;19
93;20.04.2015;2015;04;13;Maanantai;8;11;19
93;20.04.2015;2015;04;14;Maanantai;10;9;19
93;20.04.2015;2015;04;15;Maanantai;18;22;40
93;20.04.2015;2015;04;16;Maanantai;29;28;57
93;20.04.2015;2015;04;17;Maanantai;23;21;44
93;20.04.2015;2015;04;18;Maanantai;15;31;46
93;20.04.2015;2015;04;19;Maanantai;13;15;28
93;20.04.2015;2015;04;20;Maanantai;11;4;15
93;20.04.2015;2015;04;21;Maanantai;2;6;8
93;20.04.2015;2015;04;22;Maanantai;3;1;4
93;20.04.2015;2015;04;23;Maanantai;1;0;1
93;21.04.2015;2015;04;00;Tiistai;0;0;0
93;21.04.2015;2015;04;01;Tiistai;0;0;0
93;21.04.2015;2015;04;02;Tiistai;0;0;0
93;21.04.2015;2015;04;03;Tiistai;0;0;0
93;21.04.2015;2015;04;04;Tiistai;1;0;1
93;21.04.2015;2015;04;05;Tiistai;2;2;4
93;21.04.2015;2015;04;06;Tiistai;12;11;23
93;21.04.2015;2015;04;07;Tiistai;28;26;54
93;21.04.2015;2015;04;08;Tiistai;16;19;35
93;21.04.2015;2015;04;09;Tiistai;10;6;16
93;21.04.2015;2015;04;10;Tiistai;6;14;20
93;21.04.2015;2015;04;11;Tiistai;4;7;11
93;21.04.2015;2015;04;12;Tiistai;8;5;13
93;21.04.2015;2015;04;13;Tiistai;6;1;7
93;21.04.2015;2015;04;14;Tiistai;10;16;26
93;21.04.2015;2015;04;15;Tiistai;13;15;28
93;21.04.2015;2015;04;16;Tiistai;39;22;61
93;21.04.2015;2015;04;17;Tiistai;22;18;40
93;21.04.2015;2015;04;18;Tiistai;22;13;35
93;21.04.2015;2015;04;19;Tiistai;11;24;35
93;21.04.2015;2015;04;20;Tiistai;5;10;15
93;21.04.2015;2015;04;21;Tiistai;2;9;11
93;21.04.2015;2015;04;22;Tiistai;7;4;11
93;21.04.2015;2015;04;23;Tiistai;1;0;1
93;22.04.2015;2015;04;00;Keskiviikko;0;0;0
93;22.04.2015;2015;04;01;Keskiviikko;0;0;0
93;22.04.2015;2015;04;02;Keskiviikko;0;0;0
93;22.04.2015;2015;04;03;Keskiviikko;0;0;0
93;22.04.2015;2015;04;04;Keskiviikko;3;0;3
93;22.04.2015;2015;04;05;Keskiviikko;3;1;4
93;22.04.2015;2015;04;06;Keskiviikko;18;9;27
93;22.04.2015;2015;04;07;Keskiviikko;25;23;48
93;22.04.2015;2015;04;08;Keskiviikko;10;19;29
93;22.04.2015;2015;04;09;Keskiviikko;4;8;12
93;22.04.2015;2015;04;10;Keskiviikko;7;8;15
93;22.04.2015;2015;04;11;Keskiviikko;5;7;12
93;22.04.2015;2015;04;12;Keskiviikko;4;8;12
93;22.04.2015;2015;04;13;Keskiviikko;1;6;7
93;22.04.2015;2015;04;14;Keskiviikko;10;14;24
93;22.04.2015;2015;04;15;Keskiviikko;22;18;40
93;22.04.2015;2015;04;16;Keskiviikko;23;24;47
93;22.04.2015;2015;04;17;Keskiviikko;23;18;41
93;22.04.2015;2015;04;18;Keskiviikko;9;17;26
93;22.04.2015;2015;04;19;Keskiviikko;9;11;20
93;22.04.2015;2015;04;20;Keskiviikko;5;4;9
93;22.04.2015;2015;04;21;Keskiviikko;2;3;5
93;22.04.2015;2015;04;22;Keskiviikko;2;2;4
93;22.04.2015;2015;04;23;Keskiviikko;0;0;0
93;23.04.2015;2015;04;00;Torstai;0;0;0
93;23.04.2015;2015;04;01;Torstai;0;0;0
93;23.04.2015;2015;04;02;Torstai;0;0;0
93;23.04.2015;2015;04;03;Torstai;0;0;0
93;23.04.2015;2015;04;04;Torstai;1;0;1
93;23.04.2015;2015;04;05;Torstai;1;2;3
93;23.04.2015;2015;04;06;Torstai;12;8;20
93;23.04.2015;2015;04;07;Torstai;16;19;35
93;23.04.2015;2015;04;08;Torstai;9;22;31
93;23.04.2015;2015;04;09;Torstai;9;10;19
93;23.04.2015;2015;04;10;Torstai;3;6;9
93;23.04.2015;2015;04;11;Torstai;11;4;15
93;23.04.2015;2015;04;12;Torstai;11;6;17
93;23.04.2015;2015;04;13;Torstai;7;6;13
93;23.04.2015;2015;04;14;Torstai;11;15;26
93;23.04.2015;2015;04;15;Torstai;15;17;32
93;23.04.2015;2015;04;16;Torstai;28;26;54
93;23.04.2015;2015;04;17;Torstai;16;21;37
93;23.04.2015;2015;04;18;Torstai;16;22;38
93;23.04.2015;2015;04;19;Torstai;20;13;33
93;23.04.2015;2015;04;20;Torstai;15;10;25
93;23.04.2015;2015;04;21;Torstai;1;6;7
93;23.04.2015;2015;04;22;Torstai;2;5;7
93;23.04.2015;2015;04;23;Torstai;1;0;1
93;24.04.2015;2015;04;00;Perjantai;0;0;0
93;24.04.2015;2015;04;01;Perjantai;0;0;0
93;24.04.2015;2015;04;02;Perjantai;0;0;0
93;24.04.2015;2015;04;03;Perjantai;0;0;0
93;24.04.2015;2015;04;04;Perjantai;0;0;0
93;24.04.2015;2015;04;05;Perjantai;3;2;5
93;24.04.2015;2015;04;06;Perjantai;14;14;28
93;24.04.2015;2015;04;07;Perjantai;17;31;48
93;24.04.2015;2015;04;08;Perjantai;11;13;24
93;24.04.2015;2015;04;09;Perjantai;8;3;11
93;24.04.2015;2015;04;10;Perjantai;8;8;16
93;24.04.2015;2015;04;11;Perjantai;8;7;15
93;24.04.2015;2015;04;12;Perjantai;13;6;19
93;24.04.2015;2015;04;13;Perjantai;13;14;27
93;24.04.2015;2015;04;14;Perjantai;9;11;20
93;24.04.2015;2015;04;15;Perjantai;28;27;55
93;24.04.2015;2015;04;16;Perjantai;28;19;47
93;24.04.2015;2015;04;17;Perjantai;17;22;39
93;24.04.2015;2015;04;18;Perjantai;7;8;15
93;24.04.2015;2015;04;19;Perjantai;15;17;32
93;24.04.2015;2015;04;20;Perjantai;5;9;14
93;24.04.2015;2015;04;21;Perjantai;2;11;13
93;24.04.2015;2015;04;22;Perjantai;2;3;5
93;24.04.2015;2015;04;23;Perjantai;2;0;2
93;25.04.2015;2015;04;00;Lauantai;0;3;3
93;25.04.2015;2015;04;01;Lauantai;0;1;1
93;25.04.2015;2015;04;02;Lauantai;1;1;2
93;25.04.2015;2015;04;03;Lauantai;0;0;0
93;25.04.2015;2015;04;04;Lauantai;0;0;0
93;25.04.2015;2015;04;05;Lauantai;2;0;2
93;25.04.2015;2015;04;06;Lauantai;1;1;2
93;25.04.2015;2015;04;07;Lauantai;4;3;7
93;25.04.2015;2015;04;08;Lauantai;5;8;13
93;25.04.2015;2015;04;09;Lauantai;11;3;14
93;25.04.2015;2015;04;10;Lauantai;13;10;23
93;25.04.2015;2015;04;11;Lauantai;14;9;23
93;25.04.2015;2015;04;12;Lauantai;10;11;21
93;25.04.2015;2015;04;13;Lauantai;8;15;23
93;25.04.2015;2015;04;14;Lauantai;6;24;30
93;25.04.2015;2015;04;15;Lauantai;13;12;25
93;25.04.2015;2015;04;16;Lauantai;10;9;19
93;25.04.2015;2015;04;17;Lauantai;3;6;9
93;25.04.2015;2015;04;18;Lauantai;8;5;13
93;25.04.2015;2015;04;19;Lauantai;11;4;15
93;25.04.2015;2015;04;20;Lauantai;5;10;15
93;25.04.2015;2015;04;21;Lauantai;3;3;6
93;25.04.2015;2015;04;22;Lauantai;2;4;6
93;25.04.2015;2015;04;23;Lauantai;2;0;2
93;26.04.2015;2015;04;00;Sunnuntai;0;4;4
93;26.04.2015;2015;04;01;Sunnuntai;1;0;1
93;26.04.2015;2015;04;02;Sunnuntai;0;0;0
93;26.04.2015;2015;04;03;Sunnuntai;1;2;3
93;26.04.2015;2015;04;04;Sunnuntai;0;1;1
93;26.04.2015;2015;04;05;Sunnuntai;2;0;2
93;26.04.2015;2015;04;06;Sunnuntai;3;0;3
93;26.04.2015;2015;04;07;Sunnuntai;4;2;6
93;26.04.2015;2015;04;08;Sunnuntai;2;3;5
93;26.04.2015;2015;04;09;Sunnuntai;8;1;9
93;26.04.2015;2015;04;10;Sunnuntai;12;15;27
93;26.04.2015;2015;04;11;Sunnuntai;8;22;30
93;26.04.2015;2015;04;12;Sunnuntai;23;24;47
93;26.04.2015;2015;04;13;Sunnuntai;18;25;43
93;26.04.2015;2015;04;14;Sunnuntai;12;23;35
93;26.04.2015;2015;04;15;Sunnuntai;25;33;58
93;26.04.2015;2015;04;16;Sunnuntai;14;16;30
93;26.04.2015;2015;04;17;Sunnuntai;15;21;36
93;26.04.2015;2015;04;18;Sunnuntai;12;17;29
93;26.04.2015;2015;04;19;Sunnuntai;11;21;32
93;26.04.2015;2015;04;20;Sunnuntai;8;5;13
93;26.04.2015;2015;04;21;Sunnuntai;4;4;8
93;26.04.2015;2015;04;22;Sunnuntai;0;1;1
93;26.04.2015;2015;04;23;Sunnuntai;5;0;5
93;27.04.2015;2015;04;00;Maanantai;0;0;0
93;27.04.2015;2015;04;01;Maanantai;0;0;0
93;27.04.2015;2015;04;02;Maanantai;0;0;0
93;27.04.2015;2015;04;03;Maanantai;1;0;1
93;27.04.2015;2015;04;04;Maanantai;0;0;0
93;27.04.2015;2015;04;05;Maanantai;1;0;1
93;27.04.2015;2015;04;06;Maanantai;6;4;10
93;27.04.2015;2015;04;07;Maanantai;12;19;31
93;27.04.2015;2015;04;08;Maanantai;7;18;25
93;27.04.2015;2015;04;09;Maanantai;7;2;9
93;27.04.2015;2015;04;10;Maanantai;2;1;3
93;27.04.2015;2015;04;11;Maanantai;3;2;5
93;27.04.2015;2015;04;12;Maanantai;1;2;3
93;27.04.2015;2015;04;13;Maanantai;4;11;15
93;27.04.2015;2015;04;14;Maanantai;7;8;15
93;27.04.2015;2015;04;15;Maanantai;13;7;20
93;27.04.2015;2015;04;16;Maanantai;21;25;46
93;27.04.2015;2015;04;17;Maanantai;15;18;33
93;27.04.2015;2015;04;18;Maanantai;14;10;24
93;27.04.2015;2015;04;19;Maanantai;17;14;31
93;27.04.2015;2015;04;20;Maanantai;7;11;18
93;27.04.2015;2015;04;21;Maanantai;4;2;6
93;27.04.2015;2015;04;22;Maanantai;0;2;2
93;27.04.2015;2015;04;23;Maanantai;0;0;0
93;28.04.2015;2015;04;00;Tiistai;0;0;0
93;28.04.2015;2015;04;01;Tiistai;0;0;0
93;28.04.2015;2015;04;02;Tiistai;0;0;0
93;28.04.2015;2015;04;03;Tiistai;0;0;0
93;28.04.2015;2015;04;04;Tiistai;1;0;1
93;28.04.2015;2015;04;05;Tiistai;5;3;8
93;28.04.2015;2015;04;06;Tiistai;17;11;28
93;28.04.2015;2015;04;07;Tiistai;30;36;66
93;28.04.2015;2015;04;08;Tiistai;10;21;31
93;28.04.2015;2015;04;09;Tiistai;12;8;20
93;28.04.2015;2015;04;10;Tiistai;9;13;22
93;28.04.2015;2015;04;11;Tiistai;2;12;14
93;28.04.2015;2015;04;12;Tiistai;6;7;13
93;28.04.2015;2015;04;13;Tiistai;19;11;30
93;28.04.2015;2015;04;14;Tiistai;13;11;24
93;28.04.2015;2015;04;15;Tiistai;24;26;50
93;28.04.2015;2015;04;16;Tiistai;40;28;68
93;28.04.2015;2015;04;17;Tiistai;16;18;34
93;28.04.2015;2015;04;18;Tiistai;18;21;39
93;28.04.2015;2015;04;19;Tiistai;15;11;26
93;28.04.2015;2015;04;20;Tiistai;11;15;26
93;28.04.2015;2015;04;21;Tiistai;4;5;9
93;28.04.2015;2015;04;22;Tiistai;2;3;5
93;28.04.2015;2015;04;23;Tiistai;0;0;0
93;29.04.2015;2015;04;00;Keskiviikko;0;1;1
93;29.04.2015;2015;04;01;Keskiviikko;0;0;0
93;29.04.2015;2015;04;02;Keskiviikko;0;0;0
93;29.04.2015;2015;04;03;Keskiviikko;0;0;0
93;29.04.2015;2015;04;04;Keskiviikko;2;0;2
93;29.04.2015;2015;04;05;Keskiviikko;4;4;8
93;29.04.2015;2015;04;06;Keskiviikko;22;5;27
93;29.04.2015;2015;04;07;Keskiviikko;20;33;53
93;29.04.2015;2015;04;08;Keskiviikko;10;16;26
93;29.04.2015;2015;04;09;Keskiviikko;13;13;26
93;29.04.2015;2015;04;10;Keskiviikko;12;12;24
93;29.04.2015;2015;04;11;Keskiviikko;10;7;17
93;29.04.2015;2015;04;12;Keskiviikko;8;12;20
93;29.04.2015;2015;04;13;Keskiviikko;13;14;27
93;29.04.2015;2015;04;14;Keskiviikko;12;13;25
93;29.04.2015;2015;04;15;Keskiviikko;11;15;26
93;29.04.2015;2015;04;16;Keskiviikko;41;35;76
93;29.04.2015;2015;04;17;Keskiviikko;11;16;27
93;29.04.2015;2015;04;18;Keskiviikko;9;12;21
93;29.04.2015;2015;04;19;Keskiviikko;14;18;32
93;29.04.2015;2015;04;20;Keskiviikko;12;9;21
93;29.04.2015;2015;04;21;Keskiviikko;3;4;7
93;29.04.2015;2015;04;22;Keskiviikko;1;3;4
93;29.04.2015;2015;04;23;Keskiviikko;0;0;0
93;30.04.2015;2015;04;00;Torstai;0;0;0
93;30.04.2015;2015;04;01;Torstai;0;0;0
93;30.04.2015;2015;04;02;Torstai;0;0;0
93;30.04.2015;2015;04;03;Torstai;0;0;0
93;30.04.2015;2015;04;04;Torstai;2;0;2
93;30.04.2015;2015;04;05;Torstai;3;3;6
93;30.04.2015;2015;04;06;Torstai;6;8;14
93;30.04.2015;2015;04;07;Torstai;23;22;45
93;30.04.2015;2015;04;08;Torstai;8;15;23
93;30.04.2015;2015;04;09;Torstai;9;10;19
93;30.04.2015;2015;04;10;Torstai;4;7;11
93;30.04.2015;2015;04;11;Torstai;5;5;10
93;30.04.2015;2015;04;12;Torstai;10;15;25
93;30.04.2015;2015;04;13;Torstai;8;11;19
93;30.04.2015;2015;04;14;Torstai;15;20;35
93;30.04.2015;2015;04;15;Torstai;26;21;47
93;30.04.2015;2015;04;16;Torstai;26;22;48
93;30.04.2015;2015;04;17;Torstai;13;7;20
93;30.04.2015;2015;04;18;Torstai;18;13;31
93;30.04.2015;2015;04;19;Torstai;8;15;23
93;30.04.2015;2015;04;20;Torstai;5;5;10
93;30.04.2015;2015;04;21;Torstai;2;5;7
93;30.04.2015;2015;04;22;Torstai;3;4;7
93;30.04.2015;2015;04;23;Torstai;2;0;2
93;01.05.2015;2015;05;00;Perjantai;1;0;1
93;01.05.2015;2015;05;01;Perjantai;1;1;2
93;01.05.2015;2015;05;02;Perjantai;0;0;0
93;01.05.2015;2015;05;03;Perjantai;2;4;6
93;01.05.2015;2015;05;04;Perjantai;0;0;0
93;01.05.2015;2015;05;05;Perjantai;0;0;0
93;01.05.2015;2015;05;06;Perjantai;2;2;4
93;01.05.2015;2015;05;07;Perjantai;1;2;3
93;01.05.2015;2015;05;08;Perjantai;5;2;7
93;01.05.2015;2015;05;09;Perjantai;6;9;15
93;01.05.2015;2015;05;10;Perjantai;12;10;22
93;01.05.2015;2015;05;11;Perjantai;17;11;28
93;01.05.2015;2015;05;12;Perjantai;36;11;47
93;01.05.2015;2015;05;13;Perjantai;15;21;36
93;01.05.2015;2015;05;14;Perjantai;11;18;29
93;01.05.2015;2015;05;15;Perjantai;2;14;16
93;01.05.2015;2015;05;16;Perjantai;2;11;13
93;01.05.2015;2015;05;17;Perjantai;2;8;10
93;01.05.2015;2015;05;18;Perjantai;5;4;9
93;01.05.2015;2015;05;19;Perjantai;2;5;7
93;01.05.2015;2015;05;20;Perjantai;14;7;21
93;01.05.2015;2015;05;21;Perjantai;2;2;4
93;01.05.2015;2015;05;22;Perjantai;1;5;6
93;01.05.2015;2015;05;23;Perjantai;1;1;2
93;02.05.2015;2015;05;00;Lauantai;0;0;0
93;02.05.2015;2015;05;01;Lauantai;0;2;2
93;02.05.2015;2015;05;02;Lauantai;0;0;0
93;02.05.2015;2015;05;03;Lauantai;0;1;1
93;02.05.2015;2015;05;04;Lauantai;1;0;1
93;02.05.2015;2015;05;05;Lauantai;0;1;1
93;02.05.2015;2015;05;06;Lauantai;1;1;2
93;02.05.2015;2015;05;07;Lauantai;2;0;2
93;02.05.2015;2015;05;08;Lauantai;5;2;7
93;02.05.2015;2015;05;09;Lauantai;12;14;26
93;02.05.2015;2015;05;10;Lauantai;17;13;30
93;02.05.2015;2015;05;11;Lauantai;28;14;42
93;02.05.2015;2015;05;12;Lauantai;13;25;38
93;02.05.2015;2015;05;13;Lauantai;22;13;35
93;02.05.2015;2015;05;14;Lauantai;8;16;24
93;02.05.2015;2015;05;15;Lauantai;21;26;47
93;02.05.2015;2015;05;16;Lauantai;9;16;25
93;02.05.2015;2015;05;17;Lauantai;18;13;31
93;02.05.2015;2015;05;18;Lauantai;8;20;28
93;02.05.2015;2015;05;19;Lauantai;13;8;21
93;02.05.2015;2015;05;20;Lauantai;7;7;14
93;02.05.2015;2015;05;21;Lauantai;1;1;2
93;02.05.2015;2015;05;22;Lauantai;0;3;3
93;02.05.2015;2015;05;23;Lauantai;0;0;0
93;03.05.2015;2015;05;00;Sunnuntai;1;0;1
93;03.05.2015;2015;05;01;Sunnuntai;0;0;0
93;03.05.2015;2015;05;02;Sunnuntai;0;0;0
93;03.05.2015;2015;05;03;Sunnuntai;0;0;0
93;03.05.2015;2015;05;04;Sunnuntai;0;1;1
93;03.05.2015;2015;05;05;Sunnuntai;0;0;0
93;03.05.2015;2015;05;06;Sunnuntai;0;0;0
93;03.05.2015;2015;05;07;Sunnuntai;3;2;5
93;03.05.2015;2015;05;08;Sunnuntai;0;1;1
93;03.05.2015;2015;05;09;Sunnuntai;3;2;5
93;03.05.2015;2015;05;10;Sunnuntai;1;3;4
93;03.05.2015;2015;05;11;Sunnuntai;3;3;6
93;03.05.2015;2015;05;12;Sunnuntai;9;6;15
93;03.05.2015;2015;05;13;Sunnuntai;10;11;21
93;03.05.2015;2015;05;14;Sunnuntai;9;4;13
93;03.05.2015;2015;05;15;Sunnuntai;13;11;24
93;03.05.2015;2015;05;16;Sunnuntai;4;5;9
93;03.05.2015;2015;05;17;Sunnuntai;4;5;9
93;03.05.2015;2015;05;18;Sunnuntai;7;6;13
93;03.05.2015;2015;05;19;Sunnuntai;6;15;21
93;03.05.2015;2015;05;20;Sunnuntai;6;12;18
93;03.05.2015;2015;05;21;Sunnuntai;8;6;14
93;03.05.2015;2015;05;22;Sunnuntai;0;2;2
93;03.05.2015;2015;05;23;Sunnuntai;0;0;0
93;04.05.2015;2015;05;00;Maanantai;0;1;1
93;04.05.2015;2015;05;01;Maanantai;0;0;0
93;04.05.2015;2015;05;02;Maanantai;0;0;0
93;04.05.2015;2015;05;03;Maanantai;0;0;0
93;04.05.2015;2015;05;04;Maanantai;0;2;2
93;04.05.2015;2015;05;05;Maanantai;0;3;3
93;04.05.2015;2015;05;06;Maanantai;24;13;37
93;04.05.2015;2015;05;07;Maanantai;35;29;64
93;04.05.2015;2015;05;08;Maanantai;8;23;31
93;04.05.2015;2015;05;09;Maanantai;15;12;27
93;04.05.2015;2015;05;10;Maanantai;9;6;15
93;04.05.2015;2015;05;11;Maanantai;11;19;30
93;04.05.2015;2015;05;12;Maanantai;9;9;18
93;04.05.2015;2015;05;13;Maanantai;17;14;31
93;04.05.2015;2015;05;14;Maanantai;14;7;21
93;04.05.2015;2015;05;15;Maanantai;26;24;50
93;04.05.2015;2015;05;16;Maanantai;39;36;75
93;04.05.2015;2015;05;17;Maanantai;18;23;41
93;04.05.2015;2015;05;18;Maanantai;23;29;52
93;04.05.2015;2015;05;19;Maanantai;23;26;49
93;04.05.2015;2015;05;20;Maanantai;14;21;35
93;04.05.2015;2015;05;21;Maanantai;3;7;10
93;04.05.2015;2015;05;22;Maanantai;1;3;4
93;04.05.2015;2015;05;23;Maanantai;0;1;1
93;05.05.2015;2015;05;00;Tiistai;1;0;1
93;05.05.2015;2015;05;01;Tiistai;0;0;0
93;05.05.2015;2015;05;02;Tiistai;0;0;0
93;05.05.2015;2015;05;03;Tiistai;0;0;0
93;05.05.2015;2015;05;04;Tiistai;0;0;0
93;05.05.2015;2015;05;05;Tiistai;4;3;7
93;05.05.2015;2015;05;06;Tiistai;26;15;41
93;05.05.2015;2015;05;07;Tiistai;27;38;65
93;05.05.2015;2015;05;08;Tiistai;18;23;41
93;05.05.2015;2015;05;09;Tiistai;11;14;25
93;05.05.2015;2015;05;10;Tiistai;8;12;20
93;05.05.2015;2015;05;11;Tiistai;7;8;15
93;05.05.2015;2015;05;12;Tiistai;17;7;24
93;05.05.2015;2015;05;13;Tiistai;10;13;23
93;05.05.2015;2015;05;14;Tiistai;18;20;38
93;05.05.2015;2015;05;15;Tiistai;21;20;41
93;05.05.2015;2015;05;16;Tiistai;46;36;82
93;05.05.2015;2015;05;17;Tiistai;16;23;39
93;05.05.2015;2015;05;18;Tiistai;12;28;40
93;05.05.2015;2015;05;19;Tiistai;22;18;40
93;05.05.2015;2015;05;20;Tiistai;8;14;22
93;05.05.2015;2015;05;21;Tiistai;7;12;19
93;05.05.2015;2015;05;22;Tiistai;3;3;6
93;05.05.2015;2015;05;23;Tiistai;1;1;2
93;06.05.2015;2015;05;00;Keskiviikko;0;1;1
93;06.05.2015;2015;05;01;Keskiviikko;1;0;1
93;06.05.2015;2015;05;02;Keskiviikko;0;1;1
93;06.05.2015;2015;05;03;Keskiviikko;0;0;0
93;06.05.2015;2015;05;04;Keskiviikko;1;1;2
93;06.05.2015;2015;05;05;Keskiviikko;4;1;5
93;06.05.2015;2015;05;06;Keskiviikko;16;8;24
93;06.05.2015;2015;05;07;Keskiviikko;32;31;63
93;06.05.2015;2015;05;08;Keskiviikko;13;17;30
93;06.05.2015;2015;05;09;Keskiviikko;12;8;20
93;06.05.2015;2015;05;10;Keskiviikko;10;6;16
93;06.05.2015;2015;05;11;Keskiviikko;11;7;18
93;06.05.2015;2015;05;12;Keskiviikko;9;9;18
93;06.05.2015;2015;05;13;Keskiviikko;16;18;34
93;06.05.2015;2015;05;14;Keskiviikko;18;16;34
93;06.05.2015;2015;05;15;Keskiviikko;22;18;40
93;06.05.2015;2015;05;16;Keskiviikko;29;28;57
93;06.05.2015;2015;05;17;Keskiviikko;14;32;46
93;06.05.2015;2015;05;18;Keskiviikko;16;21;37
93;06.05.2015;2015;05;19;Keskiviikko;12;6;18
93;06.05.2015;2015;05;20;Keskiviikko;7;4;11
93;06.05.2015;2015;05;21;Keskiviikko;2;6;8
93;06.05.2015;2015;05;22;Keskiviikko;1;1;2
93;06.05.2015;2015;05;23;Keskiviikko;1;1;2
93;07.05.2015;2015;05;00;Torstai;0;0;0
93;07.05.2015;2015;05;01;Torstai;0;0;0
93;07.05.2015;2015;05;02;Torstai;0;0;0
93;07.05.2015;2015;05;03;Torstai;0;0;0
93;07.05.2015;2015;05;04;Torstai;1;1;2
93;07.05.2015;2015;05;05;Torstai;1;3;4
93;07.05.2015;2015;05;06;Torstai;23;9;32
93;07.05.2015;2015;05;07;Torstai;31;26;57
93;07.05.2015;2015;05;08;Torstai;16;14;30
93;07.05.2015;2015;05;09;Torstai;9;12;21
93;07.05.2015;2015;05;10;Torstai;12;11;23
93;07.05.2015;2015;05;11;Torstai;10;8;18
93;07.05.2015;2015;05;12;Torstai;7;18;25
93;07.05.2015;2015;05;13;Torstai;13;9;22
93;07.05.2015;2015;05;14;Torstai;15;19;34
93;07.05.2015;2015;05;15;Torstai;24;24;48
93;07.05.2015;2015;05;16;Torstai;23;35;58
93;07.05.2015;2015;05;17;Torstai;22;18;40
93;07.05.2015;2015;05;18;Torstai;17;22;39
93;07.05.2015;2015;05;19;Torstai;13;20;33
93;07.05.2015;2015;05;20;Torstai;10;17;27
93;07.05.2015;2015;05;21;Torstai;3;3;6
93;07.05.2015;2015;05;22;Torstai;2;3;5
93;07.05.2015;2015;05;23;Torstai;0;1;1
93;08.05.2015;2015;05;00;Perjantai;0;0;0
93;08.05.2015;2015;05;01;Perjantai;0;0;0
93;08.05.2015;2015;05;02;Perjantai;0;0;0
93;08.05.2015;2015;05;03;Perjantai;0;0;0
93;08.05.2015;2015;05;04;Perjantai;1;2;3
93;08.05.2015;2015;05;05;Perjantai;1;2;3
93;08.05.2015;2015;05;06;Perjantai;12;10;22
93;08.05.2015;2015;05;07;Perjantai;30;28;58
93;08.05.2015;2015;05;08;Perjantai;9;20;29
93;08.05.2015;2015;05;09;Perjantai;8;8;16
93;08.05.2015;2015;05;10;Perjantai;2;3;5
93;08.05.2015;2015;05;11;Perjantai;1;1;2
93;08.05.2015;2015;05;12;Perjantai;4;1;5
93;08.05.2015;2015;05;13;Perjantai;15;7;22
93;08.05.2015;2015;05;14;Perjantai;14;25;39
93;08.05.2015;2015;05;15;Perjantai;21;23;44
93;08.05.2015;2015;05;16;Perjantai;27;21;48
93;08.05.2015;2015;05;17;Perjantai;16;22;38
93;08.05.2015;2015;05;18;Perjantai;6;16;22
93;08.05.2015;2015;05;19;Perjantai;5;12;17
93;08.05.2015;2015;05;20;Perjantai;6;5;11
93;08.05.2015;2015;05;21;Perjantai;0;6;6
93;08.05.2015;2015;05;22;Perjantai;1;0;1
93;08.05.2015;2015;05;23;Perjantai;1;1;2
93;09.05.2015;2015;05;00;Lauantai;1;1;2
93;09.05.2015;2015;05;01;Lauantai;0;2;2
93;09.05.2015;2015;05;02;Lauantai;0;0;0
93;09.05.2015;2015;05;03;Lauantai;0;1;1
93;09.05.2015;2015;05;04;Lauantai;0;0;0
93;09.05.2015;2015;05;05;Lauantai;1;3;4
93;09.05.2015;2015;05;06;Lauantai;0;0;0
93;09.05.2015;2015;05;07;Lauantai;3;0;3
93;09.05.2015;2015;05;08;Lauantai;3;3;6
93;09.05.2015;2015;05;09;Lauantai;7;8;15
93;09.05.2015;2015;05;10;Lauantai;6;9;15
93;09.05.2015;2015;05;11;Lauantai;4;5;9
93;09.05.2015;2015;05;12;Lauantai;4;7;11
93;09.05.2015;2015;05;13;Lauantai;6;5;11
93;09.05.2015;2015;05;14;Lauantai;8;7;15
93;09.05.2015;2015;05;15;Lauantai;12;14;26
93;09.05.2015;2015;05;16;Lauantai;5;5;10
93;09.05.2015;2015;05;17;Lauantai;3;6;9
93;09.05.2015;2015;05;18;Lauantai;3;6;9
93;09.05.2015;2015;05;19;Lauantai;1;6;7
93;09.05.2015;2015;05;20;Lauantai;6;5;11
93;09.05.2015;2015;05;21;Lauantai;3;6;9
93;09.05.2015;2015;05;22;Lauantai;1;3;4
93;09.05.2015;2015;05;23;Lauantai;0;0;0
93;10.05.2015;2015;05;00;Sunnuntai;1;1;2
93;10.05.2015;2015;05;01;Sunnuntai;0;0;0
93;10.05.2015;2015;05;02;Sunnuntai;0;0;0
93;10.05.2015;2015;05;03;Sunnuntai;0;0;0
93;10.05.2015;2015;05;04;Sunnuntai;0;1;1
93;10.05.2015;2015;05;05;Sunnuntai;1;1;2
93;10.05.2015;2015;05;06;Sunnuntai;2;1;3
93;10.05.2015;2015;05;07;Sunnuntai;4;4;8
93;10.05.2015;2015;05;08;Sunnuntai;2;2;4
93;10.05.2015;2015;05;09;Sunnuntai;23;14;37
93;10.05.2015;2015;05;10;Sunnuntai;27;15;42
93;10.05.2015;2015;05;11;Sunnuntai;33;47;80
93;10.05.2015;2015;05;12;Sunnuntai;20;25;45
93;10.05.2015;2015;05;13;Sunnuntai;29;23;52
93;10.05.2015;2015;05;14;Sunnuntai;23;23;46
93;10.05.2015;2015;05;15;Sunnuntai;16;15;31
93;10.05.2015;2015;05;16;Sunnuntai;19;19;38
93;10.05.2015;2015;05;17;Sunnuntai;28;14;42
93;10.05.2015;2015;05;18;Sunnuntai;23;26;49
93;10.05.2015;2015;05;19;Sunnuntai;16;24;40
93;10.05.2015;2015;05;20;Sunnuntai;12;11;23
93;10.05.2015;2015;05;21;Sunnuntai;5;8;13
93;10.05.2015;2015;05;22;Sunnuntai;0;2;2
93;10.05.2015;2015;05;23;Sunnuntai;0;1;1
93;11.05.2015;2015;05;00;Maanantai;0;0;0
93;11.05.2015;2015;05;01;Maanantai;0;0;0
93;11.05.2015;2015;05;02;Maanantai;0;0;0
93;11.05.2015;2015;05;03;Maanantai;1;0;1
93;11.05.2015;2015;05;04;Maanantai;0;1;1
93;11.05.2015;2015;05;05;Maanantai;0;2;2
93;11.05.2015;2015;05;06;Maanantai;12;6;18
93;11.05.2015;2015;05;07;Maanantai;30;22;52
93;11.05.2015;2015;05;08;Maanantai;11;27;38
93;11.05.2015;2015;05;09;Maanantai;17;7;24
93;11.05.2015;2015;05;10;Maanantai;11;9;20
93;11.05.2015;2015;05;11;Maanantai;16;5;21
93;11.05.2015;2015;05;12;Maanantai;10;9;19
93;11.05.2015;2015;05;13;Maanantai;9;17;26
93;11.05.2015;2015;05;14;Maanantai;22;15;37
93;11.05.2015;2015;05;15;Maanantai;30;24;54
93;11.05.2015;2015;05;16;Maanantai;36;37;73
93;11.05.2015;2015;05;17;Maanantai;18;16;34
93;11.05.2015;2015;05;18;Maanantai;11;28;39
93;11.05.2015;2015;05;19;Maanantai;14;20;34
93;11.05.2015;2015;05;20;Maanantai;17;17;34
93;11.05.2015;2015;05;21;Maanantai;7;6;13
93;11.05.2015;2015;05;22;Maanantai;4;2;6
93;11.05.2015;2015;05;23;Maanantai;1;0;1
93;12.05.2015;2015;05;00;Tiistai;0;1;1
93;12.05.2015;2015;05;01;Tiistai;0;0;0
93;12.05.2015;2015;05;02;Tiistai;0;0;0
93;12.05.2015;2015;05;03;Tiistai;1;0;1
93;12.05.2015;2015;05;04;Tiistai;0;1;1
93;12.05.2015;2015;05;05;Tiistai;2;1;3
93;12.05.2015;2015;05;06;Tiistai;13;11;24
93;12.05.2015;2015;05;07;Tiistai;18;22;40
93;12.05.2015;2015;05;08;Tiistai;9;8;17
93;12.05.2015;2015;05;09;Tiistai;1;4;5
93;12.05.2015;2015;05;10;Tiistai;3;0;3
93;12.05.2015;2015;05;11;Tiistai;5;8;13
93;12.05.2015;2015;05;12;Tiistai;2;1;3
93;12.05.2015;2015;05;13;Tiistai;3;2;5
93;12.05.2015;2015;05;14;Tiistai;6;6;12
93;12.05.2015;2015;05;15;Tiistai;15;9;24
93;12.05.2015;2015;05;16;Tiistai;18;18;36
93;12.05.2015;2015;05;17;Tiistai;3;8;11
93;12.05.2015;2015;05;18;Tiistai;10;16;26
93;12.05.2015;2015;05;19;Tiistai;11;12;23
93;12.05.2015;2015;05;20;Tiistai;8;6;14
93;12.05.2015;2015;05;21;Tiistai;3;3;6
93;12.05.2015;2015;05;22;Tiistai;0;1;1
93;12.05.2015;2015;05;23;Tiistai;0;0;0
93;13.05.2015;2015;05;00;Keskiviikko;0;0;0
93;13.05.2015;2015;05;01;Keskiviikko;0;0;0
93;13.05.2015;2015;05;02;Keskiviikko;0;0;0
93;13.05.2015;2015;05;03;Keskiviikko;0;0;0
93;13.05.2015;2015;05;04;Keskiviikko;1;0;1
93;13.05.2015;2015;05;05;Keskiviikko;2;3;5
93;13.05.2015;2015;05;06;Keskiviikko;9;5;14
93;13.05.2015;2015;05;07;Keskiviikko;22;30;52
93;13.05.2015;2015;05;08;Keskiviikko;11;14;25
93;13.05.2015;2015;05;09;Keskiviikko;12;9;21
93;13.05.2015;2015;05;10;Keskiviikko;4;8;12
93;13.05.2015;2015;05;11;Keskiviikko;1;5;6
93;13.05.2015;2015;05;12;Keskiviikko;3;2;5
93;13.05.2015;2015;05;13;Keskiviikko;6;6;12
93;13.05.2015;2015;05;14;Keskiviikko;5;3;8
93;13.05.2015;2015;05;15;Keskiviikko;11;13;24
93;13.05.2015;2015;05;16;Keskiviikko;26;13;39
93;13.05.2015;2015;05;17;Keskiviikko;9;5;14
93;13.05.2015;2015;05;18;Keskiviikko;2;3;5
93;13.05.2015;2015;05;19;Keskiviikko;2;8;10
93;13.05.2015;2015;05;20;Keskiviikko;4;2;6
93;13.05.2015;2015;05;21;Keskiviikko;2;2;4
93;13.05.2015;2015;05;22;Keskiviikko;1;1;2
93;13.05.2015;2015;05;23;Keskiviikko;1;0;1
93;14.05.2015;2015;05;00;Torstai;0;1;1
93;14.05.2015;2015;05;01;Torstai;0;1;1
93;14.05.2015;2015;05;02;Torstai;0;0;0
93;14.05.2015;2015;05;03;Torstai;0;0;0
93;14.05.2015;2015;05;04;Torstai;0;1;1
93;14.05.2015;2015;05;05;Torstai;0;0;0
93;14.05.2015;2015;05;06;Torstai;4;2;6
93;14.05.2015;2015;05;07;Torstai;0;2;2
93;14.05.2015;2015;05;08;Torstai;3;8;11
93;14.05.2015;2015;05;09;Torstai;8;1;9
93;14.05.2015;2015;05;10;Torstai;4;4;8
93;14.05.2015;2015;05;11;Torstai;2;2;4
93;14.05.2015;2015;05;12;Torstai;14;10;24
93;14.05.2015;2015;05;13;Torstai;10;9;19
93;14.05.2015;2015;05;14;Torstai;11;2;13
93;14.05.2015;2015;05;15;Torstai;9;15;24
93;14.05.2015;2015;05;16;Torstai;9;4;13
93;14.05.2015;2015;05;17;Torstai;6;4;10
93;14.05.2015;2015;05;18;Torstai;4;5;9
93;14.05.2015;2015;05;19;Torstai;5;9;14
93;14.05.2015;2015;05;20;Torstai;6;1;7
93;14.05.2015;2015;05;21;Torstai;3;1;4
93;14.05.2015;2015;05;22;Torstai;0;0;0
93;14.05.2015;2015;05;23;Torstai;1;0;1
93;15.05.2015;2015;05;00;Perjantai;0;2;2
93;15.05.2015;2015;05;01;Perjantai;0;0;0
93;15.05.2015;2015;05;02;Perjantai;1;1;2
93;15.05.2015;2015;05;03;Perjantai;0;0;0
93;15.05.2015;2015;05;04;Perjantai;0;0;0
93;15.05.2015;2015;05;05;Perjantai;0;2;2
93;15.05.2015;2015;05;06;Perjantai;7;4;11
93;15.05.2015;2015;05;07;Perjantai;12;18;30
93;15.05.2015;2015;05;08;Perjantai;4;12;16
93;15.05.2015;2015;05;09;Perjantai;3;2;5
93;15.05.2015;2015;05;10;Perjantai;5;5;10
93;15.05.2015;2015;05;11;Perjantai;2;1;3
93;15.05.2015;2015;05;12;Perjantai;4;4;8
93;15.05.2015;2015;05;13;Perjantai;5;4;9
93;15.05.2015;2015;05;14;Perjantai;7;8;15
93;15.05.2015;2015;05;15;Perjantai;8;5;13
93;15.05.2015;2015;05;16;Perjantai;15;7;22
93;15.05.2015;2015;05;17;Perjantai;6;7;13
93;15.05.2015;2015;05;18;Perjantai;5;10;15
93;15.05.2015;2015;05;19;Perjantai;9;6;15
93;15.05.2015;2015;05;20;Perjantai;7;11;18
93;15.05.2015;2015;05;21;Perjantai;6;5;11
93;15.05.2015;2015;05;22;Perjantai;1;1;2
93;15.05.2015;2015;05;23;Perjantai;0;0;0
93;16.05.2015;2015;05;00;Lauantai;0;2;2
93;16.05.2015;2015;05;01;Lauantai;2;0;2
93;16.05.2015;2015;05;02;Lauantai;0;1;1
93;16.05.2015;2015;05;03;Lauantai;0;0;0
93;16.05.2015;2015;05;04;Lauantai;0;0;0
93;16.05.2015;2015;05;05;Lauantai;0;0;0
93;16.05.2015;2015;05;06;Lauantai;2;2;4
93;16.05.2015;2015;05;07;Lauantai;3;3;6
93;16.05.2015;2015;05;08;Lauantai;8;4;12
93;16.05.2015;2015;05;09;Lauantai;12;4;16
93;16.05.2015;2015;05;10;Lauantai;12;9;21
93;16.05.2015;2015;05;11;Lauantai;14;24;38
93;16.05.2015;2015;05;12;Lauantai;12;20;32
93;16.05.2015;2015;05;13;Lauantai;18;15;33
93;16.05.2015;2015;05;14;Lauantai;7;21;28
93;16.05.2015;2015;05;15;Lauantai;18;19;37
93;16.05.2015;2015;05;16;Lauantai;19;13;32
93;16.05.2015;2015;05;17;Lauantai;13;21;34
93;16.05.2015;2015;05;18;Lauantai;17;10;27
93;16.05.2015;2015;05;19;Lauantai;6;14;20
93;16.05.2015;2015;05;20;Lauantai;5;13;18
93;16.05.2015;2015;05;21;Lauantai;7;13;20
93;16.05.2015;2015;05;22;Lauantai;2;1;3
93;16.05.2015;2015;05;23;Lauantai;2;1;3
93;17.05.2015;2015;05;00;Sunnuntai;4;5;9
93;17.05.2015;2015;05;01;Sunnuntai;2;1;3
93;17.05.2015;2015;05;02;Sunnuntai;0;0;0
93;17.05.2015;2015;05;03;Sunnuntai;1;0;1
93;17.05.2015;2015;05;04;Sunnuntai;1;0;1
93;17.05.2015;2015;05;05;Sunnuntai;0;5;5
93;17.05.2015;2015;05;06;Sunnuntai;1;2;3
93;17.05.2015;2015;05;07;Sunnuntai;1;3;4
93;17.05.2015;2015;05;08;Sunnuntai;7;5;12
93;17.05.2015;2015;05;09;Sunnuntai;15;6;21
93;17.05.2015;2015;05;10;Sunnuntai;6;12;18
93;17.05.2015;2015;05;11;Sunnuntai;6;15;21
93;17.05.2015;2015;05;12;Sunnuntai;45;12;57
93;17.05.2015;2015;05;13;Sunnuntai;18;14;32
93;17.05.2015;2015;05;14;Sunnuntai;16;14;30
93;17.05.2015;2015;05;15;Sunnuntai;18;8;26
93;17.05.2015;2015;05;16;Sunnuntai;14;13;27
93;17.05.2015;2015;05;17;Sunnuntai;23;17;40
93;17.05.2015;2015;05;18;Sunnuntai;13;15;28
93;17.05.2015;2015;05;19;Sunnuntai;15;18;33
93;17.05.2015;2015;05;20;Sunnuntai;15;13;28
93;17.05.2015;2015;05;21;Sunnuntai;4;10;14
93;17.05.2015;2015;05;22;Sunnuntai;0;2;2
93;17.05.2015;2015;05;23;Sunnuntai;0;0;0
93;18.05.2015;2015;05;00;Maanantai;0;0;0
93;18.05.2015;2015;05;01;Maanantai;0;0;0
93;18.05.2015;2015;05;02;Maanantai;0;0;0
93;18.05.2015;2015;05;03;Maanantai;0;0;0
93;18.05.2015;2015;05;04;Maanantai;0;2;2
93;18.05.2015;2015;05;05;Maanantai;6;5;11
93;18.05.2015;2015;05;06;Maanantai;18;13;31
93;18.05.2015;2015;05;07;Maanantai;44;36;80
93;18.05.2015;2015;05;08;Maanantai;14;18;32
93;18.05.2015;2015;05;09;Maanantai;16;12;28
93;18.05.2015;2015;05;10;Maanantai;7;8;15
93;18.05.2015;2015;05;11;Maanantai;12;8;20
93;18.05.2015;2015;05;12;Maanantai;17;13;30
93;18.05.2015;2015;05;13;Maanantai;7;11;18
93;18.05.2015;2015;05;14;Maanantai;16;34;50
93;18.05.2015;2015;05;15;Maanantai;25;25;50
93;18.05.2015;2015;05;16;Maanantai;41;40;81
93;18.05.2015;2015;05;17;Maanantai;14;21;35
93;18.05.2015;2015;05;18;Maanantai;9;19;28
93;18.05.2015;2015;05;19;Maanantai;19;18;37
93;18.05.2015;2015;05;20;Maanantai;7;7;14
93;18.05.2015;2015;05;21;Maanantai;6;6;12
93;18.05.2015;2015;05;22;Maanantai;1;3;4
93;18.05.2015;2015;05;23;Maanantai;1;0;1
93;19.05.2015;2015;05;00;Tiistai;0;1;1
93;19.05.2015;2015;05;01;Tiistai;0;0;0
93;19.05.2015;2015;05;02;Tiistai;0;0;0
93;19.05.2015;2015;05;03;Tiistai;0;0;0
93;19.05.2015;2015;05;04;Tiistai;0;2;2
93;19.05.2015;2015;05;05;Tiistai;5;4;9
93;19.05.2015;2015;05;06;Tiistai;16;11;27
93;19.05.2015;2015;05;07;Tiistai;24;32;56
93;19.05.2015;2015;05;08;Tiistai;12;14;26
93;19.05.2015;2015;05;09;Tiistai;6;10;16
93;19.05.2015;2015;05;10;Tiistai;4;2;6
93;19.05.2015;2015;05;11;Tiistai;9;5;14
93;19.05.2015;2015;05;12;Tiistai;12;7;19
93;19.05.2015;2015;05;13;Tiistai;8;9;17
93;19.05.2015;2015;05;14;Tiistai;13;12;25
93;19.05.2015;2015;05;15;Tiistai;12;17;29
93;19.05.2015;2015;05;16;Tiistai;26;28;54
93;19.05.2015;2015;05;17;Tiistai;17;13;30
93;19.05.2015;2015;05;18;Tiistai;21;10;31
93;19.05.2015;2015;05;19;Tiistai;8;9;17
93;19.05.2015;2015;05;20;Tiistai;2;6;8
93;19.05.2015;2015;05;21;Tiistai;6;10;16
93;19.05.2015;2015;05;22;Tiistai;2;3;5
93;19.05.2015;2015;05;23;Tiistai;0;0;0
93;20.05.2015;2015;05;00;Keskiviikko;0;0;0
93;20.05.2015;2015;05;01;Keskiviikko;0;0;0
93;20.05.2015;2015;05;02;Keskiviikko;1;0;1
93;20.05.2015;2015;05;03;Keskiviikko;0;0;0
93;20.05.2015;2015;05;04;Keskiviikko;1;1;2
93;20.05.2015;2015;05;05;Keskiviikko;4;3;7
93;20.05.2015;2015;05;06;Keskiviikko;13;9;22
93;20.05.2015;2015;05;07;Keskiviikko;24;26;50
93;20.05.2015;2015;05;08;Keskiviikko;12;19;31
93;20.05.2015;2015;05;09;Keskiviikko;9;9;18
93;20.05.2015;2015;05;10;Keskiviikko;12;6;18
93;20.05.2015;2015;05;11;Keskiviikko;8;7;15
93;20.05.2015;2015;05;12;Keskiviikko;18;8;26
93;20.05.2015;2015;05;13;Keskiviikko;2;4;6
93;20.05.2015;2015;05;14;Keskiviikko;6;1;7
93;20.05.2015;2015;05;15;Keskiviikko;6;14;20
93;20.05.2015;2015;05;16;Keskiviikko;28;23;51
93;20.05.2015;2015;05;17;Keskiviikko;15;13;28
93;20.05.2015;2015;05;18;Keskiviikko;14;10;24
93;20.05.2015;2015;05;19;Keskiviikko;18;12;30
93;20.05.2015;2015;05;20;Keskiviikko;5;10;15
93;20.05.2015;2015;05;21;Keskiviikko;4;8;12
93;20.05.2015;2015;05;22;Keskiviikko;1;2;3
93;20.05.2015;2015;05;23;Keskiviikko;0;2;2
93;21.05.2015;2015;05;00;Torstai;0;0;0
93;21.05.2015;2015;05;01;Torstai;1;0;1
93;21.05.2015;2015;05;02;Torstai;0;0;0
93;21.05.2015;2015;05;03;Torstai;0;0;0
93;21.05.2015;2015;05;04;Torstai;2;1;3
93;21.05.2015;2015;05;05;Torstai;1;4;5
93;21.05.2015;2015;05;06;Torstai;16;11;27
93;21.05.2015;2015;05;07;Torstai;38;30;68
93;21.05.2015;2015;05;08;Torstai;16;20;36
93;21.05.2015;2015;05;09;Torstai;11;12;23
93;21.05.2015;2015;05;10;Torstai;17;11;28
93;21.05.2015;2015;05;11;Torstai;15;14;29
93;21.05.2015;2015;05;12;Torstai;18;10;28
93;21.05.2015;2015;05;13;Torstai;7;14;21
93;21.05.2015;2015;05;14;Torstai;10;18;28
93;21.05.2015;2015;05;15;Torstai;20;30;50
93;21.05.2015;2015;05;16;Torstai;29;38;67
93;21.05.2015;2015;05;17;Torstai;23;27;50
93;21.05.2015;2015;05;18;Torstai;22;35;57
93;21.05.2015;2015;05;19;Torstai;33;36;69
93;21.05.2015;2015;05;20;Torstai;23;10;33
93;21.05.2015;2015;05;21;Torstai;9;16;25
93;21.05.2015;2015;05;22;Torstai;6;3;9
93;21.05.2015;2015;05;23;Torstai;5;0;5
93;22.05.2015;2015;05;00;Perjantai;0;1;1
93;22.05.2015;2015;05;01;Perjantai;0;0;0
93;22.05.2015;2015;05;02;Perjantai;0;0;0
93;22.05.2015;2015;05;03;Perjantai;0;0;0
93;22.05.2015;2015;05;04;Perjantai;2;1;3
93;22.05.2015;2015;05;05;Perjantai;3;3;6
93;22.05.2015;2015;05;06;Perjantai;20;11;31
93;22.05.2015;2015;05;07;Perjantai;40;35;75
93;22.05.2015;2015;05;08;Perjantai;22;15;37
93;22.05.2015;2015;05;09;Perjantai;14;14;28
93;22.05.2015;2015;05;10;Perjantai;13;17;30
93;22.05.2015;2015;05;11;Perjantai;19;9;28
93;22.05.2015;2015;05;12;Perjantai;8;30;38
93;22.05.2015;2015;05;13;Perjantai;5;17;22
93;22.05.2015;2015;05;14;Perjantai;20;10;30
93;22.05.2015;2015;05;15;Perjantai;29;25;54
93;22.05.2015;2015;05;16;Perjantai;25;42;67
93;22.05.2015;2015;05;17;Perjantai;22;23;45
93;22.05.2015;2015;05;18;Perjantai;20;33;53
93;22.05.2015;2015;05;19;Perjantai;20;20;40
93;22.05.2015;2015;05;20;Perjantai;15;7;22
93;22.05.2015;2015;05;21;Perjantai;6;11;17
93;22.05.2015;2015;05;22;Perjantai;5;5;10
93;22.05.2015;2015;05;23;Perjantai;0;1;1
93;23.05.2015;2015;05;00;Lauantai;0;2;2
93;23.05.2015;2015;05;01;Lauantai;1;1;2
93;23.05.2015;2015;05;02;Lauantai;0;2;2
93;23.05.2015;2015;05;03;Lauantai;0;1;1
93;23.05.2015;2015;05;04;Lauantai;0;0;0
93;23.05.2015;2015;05;05;Lauantai;3;3;6
93;23.05.2015;2015;05;06;Lauantai;1;1;2
93;23.05.2015;2015;05;07;Lauantai;3;3;6
93;23.05.2015;2015;05;08;Lauantai;5;3;8
93;23.05.2015;2015;05;09;Lauantai;2;5;7
93;23.05.2015;2015;05;10;Lauantai;7;7;14
93;23.05.2015;2015;05;11;Lauantai;4;0;4
93;23.05.2015;2015;05;12;Lauantai;1;1;2
93;23.05.2015;2015;05;13;Lauantai;4;1;5
93;23.05.2015;2015;05;14;Lauantai;2;2;4
93;23.05.2015;2015;05;15;Lauantai;2;6;8
93;23.05.2015;2015;05;16;Lauantai;1;2;3
93;23.05.2015;2015;05;17;Lauantai;2;4;6
93;23.05.2015;2015;05;18;Lauantai;0;1;1
93;23.05.2015;2015;05;19;Lauantai;1;0;1
93;23.05.2015;2015;05;20;Lauantai;0;3;3
93;23.05.2015;2015;05;21;Lauantai;2;2;4
93;23.05.2015;2015;05;22;Lauantai;1;2;3
93;23.05.2015;2015;05;23;Lauantai;1;0;1
93;24.05.2015;2015;05;00;Sunnuntai;1;2;3
93;24.05.2015;2015;05;01;Sunnuntai;0;0;0
93;24.05.2015;2015;05;02;Sunnuntai;0;1;1
93;24.05.2015;2015;05;03;Sunnuntai;0;0;0
93;24.05.2015;2015;05;04;Sunnuntai;0;1;1
93;24.05.2015;2015;05;05;Sunnuntai;0;0;0
93;24.05.2015;2015;05;06;Sunnuntai;2;1;3
93;24.05.2015;2015;05;07;Sunnuntai;5;2;7
93;24.05.2015;2015;05;08;Sunnuntai;1;4;5
93;24.05.2015;2015;05;09;Sunnuntai;11;8;19
93;24.05.2015;2015;05;10;Sunnuntai;27;21;48
93;24.05.2015;2015;05;11;Sunnuntai;21;12;33
93;24.05.2015;2015;05;12;Sunnuntai;44;18;62
93;24.05.2015;2015;05;13;Sunnuntai;22;25;47
93;24.05.2015;2015;05;14;Sunnuntai;21;21;42
93;24.05.2015;2015;05;15;Sunnuntai;15;17;32
93;24.05.2015;2015;05;16;Sunnuntai;7;16;23
93;24.05.2015;2015;05;17;Sunnuntai;18;20;38
93;24.05.2015;2015;05;18;Sunnuntai;20;8;28
93;24.05.2015;2015;05;19;Sunnuntai;28;18;46
93;24.05.2015;2015;05;20;Sunnuntai;14;13;27
93;24.05.2015;2015;05;21;Sunnuntai;8;6;14
93;24.05.2015;2015;05;22;Sunnuntai;2;7;9
93;24.05.2015;2015;05;23;Sunnuntai;2;0;2
93;25.05.2015;2015;05;00;Maanantai;0;1;1
93;25.05.2015;2015;05;01;Maanantai;0;0;0
93;25.05.2015;2015;05;02;Maanantai;1;0;1
93;25.05.2015;2015;05;03;Maanantai;0;0;0
93;25.05.2015;2015;05;04;Maanantai;1;1;2
93;25.05.2015;2015;05;05;Maanantai;6;2;8
93;25.05.2015;2015;05;06;Maanantai;31;9;40
93;25.05.2015;2015;05;07;Maanantai;49;32;81
93;25.05.2015;2015;05;08;Maanantai;19;24;43
93;25.05.2015;2015;05;09;Maanantai;9;15;24
93;25.05.2015;2015;05;10;Maanantai;17;11;28
93;25.05.2015;2015;05;11;Maanantai;12;14;26
93;25.05.2015;2015;05;12;Maanantai;17;15;32
93;25.05.2015;2015;05;13;Maanantai;17;15;32
93;25.05.2015;2015;05;14;Maanantai;8;16;24
93;25.05.2015;2015;05;15;Maanantai;19;29;48
93;25.05.2015;2015;05;16;Maanantai;35;49;84
93;25.05.2015;2015;05;17;Maanantai;22;32;54
93;25.05.2015;2015;05;18;Maanantai;9;22;31
93;25.05.2015;2015;05;19;Maanantai;19;11;30
93;25.05.2015;2015;05;20;Maanantai;15;17;32
93;25.05.2015;2015;05;21;Maanantai;6;7;13
93;25.05.2015;2015;05;22;Maanantai;4;4;8
93;25.05.2015;2015;05;23;Maanantai;1;2;3
93;26.05.2015;2015;05;00;Tiistai;0;0;0
93;26.05.2015;2015;05;01;Tiistai;1;0;1
93;26.05.2015;2015;05;02;Tiistai;0;0;0
93;26.05.2015;2015;05;03;Tiistai;1;0;1
93;26.05.2015;2015;05;04;Tiistai;1;1;2
93;26.05.2015;2015;05;05;Tiistai;5;2;7
93;26.05.2015;2015;05;06;Tiistai;21;10;31
93;26.05.2015;2015;05;07;Tiistai;23;24;47
93;26.05.2015;2015;05;08;Tiistai;9;26;35
93;26.05.2015;2015;05;09;Tiistai;2;7;9
93;26.05.2015;2015;05;10;Tiistai;9;12;21
93;26.05.2015;2015;05;11;Tiistai;13;9;22
93;26.05.2015;2015;05;12;Tiistai;11;11;22
93;26.05.2015;2015;05;13;Tiistai;10;8;18
93;26.05.2015;2015;05;14;Tiistai;14;12;26
93;26.05.2015;2015;05;15;Tiistai;23;16;39
93;26.05.2015;2015;05;16;Tiistai;35;44;79
93;26.05.2015;2015;05;17;Tiistai;30;26;56
93;26.05.2015;2015;05;18;Tiistai;27;26;53
93;26.05.2015;2015;05;19;Tiistai;27;23;50
93;26.05.2015;2015;05;20;Tiistai;13;20;33
93;26.05.2015;2015;05;21;Tiistai;5;3;8
93;26.05.2015;2015;05;22;Tiistai;2;2;4
93;26.05.2015;2015;05;23;Tiistai;0;1;1
93;27.05.2015;2015;05;00;Keskiviikko;0;4;4
93;27.05.2015;2015;05;01;Keskiviikko;1;0;1
93;27.05.2015;2015;05;02;Keskiviikko;1;0;1
93;27.05.2015;2015;05;03;Keskiviikko;0;0;0
93;27.05.2015;2015;05;04;Keskiviikko;1;3;4
93;27.05.2015;2015;05;05;Keskiviikko;4;1;5
93;27.05.2015;2015;05;06;Keskiviikko;9;6;15
93;27.05.2015;2015;05;07;Keskiviikko;20;21;41
93;27.05.2015;2015;05;08;Keskiviikko;15;19;34
93;27.05.2015;2015;05;09;Keskiviikko;17;9;26
93;27.05.2015;2015;05;10;Keskiviikko;7;4;11
93;27.05.2015;2015;05;11;Keskiviikko;3;9;12
93;27.05.2015;2015;05;12;Keskiviikko;4;7;11
93;27.05.2015;2015;05;13;Keskiviikko;1;5;6
93;27.05.2015;2015;05;14;Keskiviikko;2;8;10
93;27.05.2015;2015;05;15;Keskiviikko;8;13;21
93;27.05.2015;2015;05;16;Keskiviikko;27;23;50
93;27.05.2015;2015;05;17;Keskiviikko;17;24;41
93;27.05.2015;2015;05;18;Keskiviikko;18;13;31
93;27.05.2015;2015;05;19;Keskiviikko;15;22;37
93;27.05.2015;2015;05;20;Keskiviikko;19;5;24
93;27.05.2015;2015;05;21;Keskiviikko;6;4;10
93;27.05.2015;2015;05;22;Keskiviikko;3;3;6
93;27.05.2015;2015;05;23;Keskiviikko;3;3;6
93;28.05.2015;2015;05;00;Torstai;1;4;5
93;28.05.2015;2015;05;01;Torstai;1;0;1
93;28.05.2015;2015;05;02;Torstai;0;0;0
93;28.05.2015;2015;05;03;Torstai;1;0;1
93;28.05.2015;2015;05;04;Torstai;1;1;2
93;28.05.2015;2015;05;05;Torstai;5;0;5
93;28.05.2015;2015;05;06;Torstai;29;15;44
93;28.05.2015;2015;05;07;Torstai;32;36;68
93;28.05.2015;2015;05;08;Torstai;21;22;43
93;28.05.2015;2015;05;09;Torstai;8;15;23
93;28.05.2015;2015;05;10;Torstai;11;10;21
93;28.05.2015;2015;05;11;Torstai;8;8;16
93;28.05.2015;2015;05;12;Torstai;9;9;18
93;28.05.2015;2015;05;13;Torstai;15;7;22
93;28.05.2015;2015;05;14;Torstai;12;13;25
93;28.05.2015;2015;05;15;Torstai;24;24;48
93;28.05.2015;2015;05;16;Torstai;38;37;75
93;28.05.2015;2015;05;17;Torstai;22;29;51
93;28.05.2015;2015;05;18;Torstai;16;29;45
93;28.05.2015;2015;05;19;Torstai;16;16;32
93;28.05.2015;2015;05;20;Torstai;8;9;17
93;28.05.2015;2015;05;21;Torstai;11;9;20
93;28.05.2015;2015;05;22;Torstai;5;2;7
93;28.05.2015;2015;05;23;Torstai;0;0;0
93;29.05.2015;2015;05;00;Perjantai;1;0;1
93;29.05.2015;2015;05;01;Perjantai;0;0;0
93;29.05.2015;2015;05;02;Perjantai;1;0;1
93;29.05.2015;2015;05;03;Perjantai;0;1;1
93;29.05.2015;2015;05;04;Perjantai;1;1;2
93;29.05.2015;2015;05;05;Perjantai;4;2;6
93;29.05.2015;2015;05;06;Perjantai;14;9;23
93;29.05.2015;2015;05;07;Perjantai;26;40;66
93;29.05.2015;2015;05;08;Perjantai;23;21;44
93;29.05.2015;2015;05;09;Perjantai;11;9;20
93;29.05.2015;2015;05;10;Perjantai;12;6;18
93;29.05.2015;2015;05;11;Perjantai;14;14;28
93;29.05.2015;2015;05;12;Perjantai;16;16;32
93;29.05.2015;2015;05;13;Perjantai;14;15;29
93;29.05.2015;2015;05;14;Perjantai;19;20;39
93;29.05.2015;2015;05;15;Perjantai;37;22;59
93;29.05.2015;2015;05;16;Perjantai;24;38;62
93;29.05.2015;2015;05;17;Perjantai;22;15;37
93;29.05.2015;2015;05;18;Perjantai;1;8;9
93;29.05.2015;2015;05;19;Perjantai;8;3;11
93;29.05.2015;2015;05;20;Perjantai;2;4;6
93;29.05.2015;2015;05;21;Perjantai;2;5;7
93;29.05.2015;2015;05;22;Perjantai;1;2;3
93;29.05.2015;2015;05;23;Perjantai;0;0;0
93;30.05.2015;2015;05;00;Lauantai;0;0;0
93;30.05.2015;2015;05;01;Lauantai;0;0;0
93;30.05.2015;2015;05;02;Lauantai;0;3;3
93;30.05.2015;2015;05;03;Lauantai;0;1;1
93;30.05.2015;2015;05;04;Lauantai;0;0;0
93;30.05.2015;2015;05;05;Lauantai;0;0;0
93;30.05.2015;2015;05;06;Lauantai;2;0;2
93;30.05.2015;2015;05;07;Lauantai;7;6;13
93;30.05.2015;2015;05;08;Lauantai;7;11;18
93;30.05.2015;2015;05;09;Lauantai;11;9;20
93;30.05.2015;2015;05;10;Lauantai;13;20;33
93;30.05.2015;2015;05;11;Lauantai;20;21;41
93;30.05.2015;2015;05;12;Lauantai;25;14;39
93;30.05.2015;2015;05;13;Lauantai;24;22;46
93;30.05.2015;2015;05;14;Lauantai;26;27;53
93;30.05.2015;2015;05;15;Lauantai;26;17;43
93;30.05.2015;2015;05;16;Lauantai;14;15;29
93;30.05.2015;2015;05;17;Lauantai;17;15;32
93;30.05.2015;2015;05;18;Lauantai;19;20;39
93;30.05.2015;2015;05;19;Lauantai;20;19;39
93;30.05.2015;2015;05;20;Lauantai;12;14;26
93;30.05.2015;2015;05;21;Lauantai;9;18;27
93;30.05.2015;2015;05;22;Lauantai;2;11;13
93;30.05.2015;2015;05;23;Lauantai;0;3;3
93;31.05.2015;2015;05;00;Sunnuntai;1;5;6
93;31.05.2015;2015;05;01;Sunnuntai;9;4;13
93;31.05.2015;2015;05;02;Sunnuntai;0;7;7
93;31.05.2015;2015;05;03;Sunnuntai;1;0;1
93;31.05.2015;2015;05;04;Sunnuntai;0;1;1
93;31.05.2015;2015;05;05;Sunnuntai;1;2;3
93;31.05.2015;2015;05;06;Sunnuntai;4;1;5
93;31.05.2015;2015;05;07;Sunnuntai;3;5;8
93;31.05.2015;2015;05;08;Sunnuntai;11;12;23
93;31.05.2015;2015;05;09;Sunnuntai;12;9;21
93;31.05.2015;2015;05;10;Sunnuntai;14;16;30
93;31.05.2015;2015;05;11;Sunnuntai;7;8;15
93;31.05.2015;2015;05;12;Sunnuntai;6;8;14
93;31.05.2015;2015;05;13;Sunnuntai;4;3;7
93;31.05.2015;2015;05;14;Sunnuntai;5;7;12
93;31.05.2015;2015;05;15;Sunnuntai;6;4;10
93;31.05.2015;2015;05;16;Sunnuntai;5;9;14
93;31.05.2015;2015;05;17;Sunnuntai;9;7;16
93;31.05.2015;2015;05;18;Sunnuntai;3;13;16
93;31.05.2015;2015;05;19;Sunnuntai;8;4;12
93;31.05.2015;2015;05;20;Sunnuntai;4;3;7
93;31.05.2015;2015;05;21;Sunnuntai;6;8;14
93;31.05.2015;2015;05;22;Sunnuntai;3;3;6
93;31.05.2015;2015;05;23;Sunnuntai;3;2;5
93;01.06.2015;2015;06;00;Maanantai;0;2;2
93;01.06.2015;2015;06;01;Maanantai;0;0;0
93;01.06.2015;2015;06;02;Maanantai;1;0;1
93;01.06.2015;2015;06;03;Maanantai;0;1;1
93;01.06.2015;2015;06;04;Maanantai;3;1;4
93;01.06.2015;2015;06;05;Maanantai;2;5;7
93;01.06.2015;2015;06;06;Maanantai;20;10;30
93;01.06.2015;2015;06;07;Maanantai;22;26;48
93;01.06.2015;2015;06;08;Maanantai;7;19;26
93;01.06.2015;2015;06;09;Maanantai;7;4;11
93;01.06.2015;2015;06;10;Maanantai;10;4;14
93;01.06.2015;2015;06;11;Maanantai;3;1;4
93;01.06.2015;2015;06;12;Maanantai;9;6;15
93;01.06.2015;2015;06;13;Maanantai;10;13;23
93;01.06.2015;2015;06;14;Maanantai;11;18;29
93;01.06.2015;2015;06;15;Maanantai;24;28;52
93;01.06.2015;2015;06;16;Maanantai;30;25;55
93;01.06.2015;2015;06;17;Maanantai;10;17;27
93;01.06.2015;2015;06;18;Maanantai;7;8;15
93;01.06.2015;2015;06;19;Maanantai;5;6;11
93;01.06.2015;2015;06;20;Maanantai;2;4;6
93;01.06.2015;2015;06;21;Maanantai;3;4;7
93;01.06.2015;2015;06;22;Maanantai;2;4;6
93;01.06.2015;2015;06;23;Maanantai;3;1;4
93;02.06.2015;2015;06;00;Tiistai;0;0;0
93;02.06.2015;2015;06;01;Tiistai;0;0;0
93;02.06.2015;2015;06;02;Tiistai;0;0;0
93;02.06.2015;2015;06;03;Tiistai;0;1;1
93;02.06.2015;2015;06;04;Tiistai;2;2;4
93;02.06.2015;2015;06;05;Tiistai;5;9;14
93;02.06.2015;2015;06;06;Tiistai;22;12;34
93;02.06.2015;2015;06;07;Tiistai;32;39;71
93;02.06.2015;2015;06;08;Tiistai;21;19;40
93;02.06.2015;2015;06;09;Tiistai;13;14;27
93;02.06.2015;2015;06;10;Tiistai;19;12;31
93;02.06.2015;2015;06;11;Tiistai;21;8;29
93;02.06.2015;2015;06;12;Tiistai;11;11;22
93;02.06.2015;2015;06;13;Tiistai;20;12;32
93;02.06.2015;2015;06;14;Tiistai;16;21;37
93;02.06.2015;2015;06;15;Tiistai;30;14;44
93;02.06.2015;2015;06;16;Tiistai;48;46;94
93;02.06.2015;2015;06;17;Tiistai;24;27;51
93;02.06.2015;2015;06;18;Tiistai;17;29;46
93;02.06.2015;2015;06;19;Tiistai;24;39;63
93;02.06.2015;2015;06;20;Tiistai;22;17;39
93;02.06.2015;2015;06;21;Tiistai;10;13;23
93;02.06.2015;2015;06;22;Tiistai;7;13;20
93;02.06.2015;2015;06;23;Tiistai;1;1;2
93;03.06.2015;2015;06;00;Keskiviikko;3;3;6
93;03.06.2015;2015;06;01;Keskiviikko;0;1;1
93;03.06.2015;2015;06;02;Keskiviikko;0;1;1
93;03.06.2015;2015;06;03;Keskiviikko;0;1;1
93;03.06.2015;2015;06;04;Keskiviikko;2;3;5
93;03.06.2015;2015;06;05;Keskiviikko;1;2;3
93;03.06.2015;2015;06;06;Keskiviikko;9;1;10
93;03.06.2015;2015;06;07;Keskiviikko;13;12;25
93;03.06.2015;2015;06;08;Keskiviikko;3;16;19
93;03.06.2015;2015;06;09;Keskiviikko;3;2;5
93;03.06.2015;2015;06;10;Keskiviikko;0;1;1
93;03.06.2015;2015;06;11;Keskiviikko;0;1;1
93;03.06.2015;2015;06;12;Keskiviikko;7;3;10
93;03.06.2015;2015;06;13;Keskiviikko;2;2;4
93;03.06.2015;2015;06;14;Keskiviikko;7;8;15
93;03.06.2015;2015;06;15;Keskiviikko;10;6;16
93;03.06.2015;2015;06;16;Keskiviikko;25;17;42
93;03.06.2015;2015;06;17;Keskiviikko;16;11;27
93;03.06.2015;2015;06;18;Keskiviikko;8;14;22
93;03.06.2015;2015;06;19;Keskiviikko;11;6;17
93;03.06.2015;2015;06;20;Keskiviikko;13;8;21
93;03.06.2015;2015;06;21;Keskiviikko;6;9;15
93;03.06.2015;2015;06;22;Keskiviikko;4;3;7
93;03.06.2015;2015;06;23;Keskiviikko;1;2;3
93;04.06.2015;2015;06;00;Torstai;2;1;3
93;04.06.2015;2015;06;01;Torstai;0;0;0
93;04.06.2015;2015;06;02;Torstai;0;0;0
93;04.06.2015;2015;06;03;Torstai;0;1;1
93;04.06.2015;2015;06;04;Torstai;2;1;3
93;04.06.2015;2015;06;05;Torstai;2;2;4
93;04.06.2015;2015;06;06;Torstai;16;8;24
93;04.06.2015;2015;06;07;Torstai;20;32;52
93;04.06.2015;2015;06;08;Torstai;11;17;28
93;04.06.2015;2015;06;09;Torstai;13;17;30
93;04.06.2015;2015;06;10;Torstai;19;10;29
93;04.06.2015;2015;06;11;Torstai;22;6;28
93;04.06.2015;2015;06;12;Torstai;20;16;36
93;04.06.2015;2015;06;13;Torstai;14;14;28
93;04.06.2015;2015;06;14;Torstai;21;17;38
93;04.06.2015;2015;06;15;Torstai;18;35;53
93;04.06.2015;2015;06;16;Torstai;43;45;88
93;04.06.2015;2015;06;17;Torstai;26;24;50
93;04.06.2015;2015;06;18;Torstai;19;30;49
93;04.06.2015;2015;06;19;Torstai;23;23;46
93;04.06.2015;2015;06;20;Torstai;13;20;33
93;04.06.2015;2015;06;21;Torstai;14;14;28
93;04.06.2015;2015;06;22;Torstai;3;13;16
93;04.06.2015;2015;06;23;Torstai;2;2;4
93;05.06.2015;2015;06;00;Perjantai;2;1;3
93;05.06.2015;2015;06;01;Perjantai;1;3;4
93;05.06.2015;2015;06;02;Perjantai;0;0;0
93;05.06.2015;2015;06;03;Perjantai;0;0;0
93;05.06.2015;2015;06;04;Perjantai;3;2;5
93;05.06.2015;2015;06;05;Perjantai;7;2;9
93;05.06.2015;2015;06;06;Perjantai;22;6;28
93;05.06.2015;2015;06;07;Perjantai;21;34;55
93;05.06.2015;2015;06;08;Perjantai;14;15;29
93;05.06.2015;2015;06;09;Perjantai;14;9;23
93;05.06.2015;2015;06;10;Perjantai;9;7;16
93;05.06.2015;2015;06;11;Perjantai;15;5;20
93;05.06.2015;2015;06;12;Perjantai;12;7;19
93;05.06.2015;2015;06;13;Perjantai;13;12;25
93;05.06.2015;2015;06;14;Perjantai;14;26;40
93;05.06.2015;2015;06;15;Perjantai;31;28;59
93;05.06.2015;2015;06;16;Perjantai;32;40;72
93;05.06.2015;2015;06;17;Perjantai;18;18;36
93;05.06.2015;2015;06;18;Perjantai;12;17;29
93;05.06.2015;2015;06;19;Perjantai;14;20;34
93;05.06.2015;2015;06;20;Perjantai;8;14;22
93;05.06.2015;2015;06;21;Perjantai;7;11;18
93;05.06.2015;2015;06;22;Perjantai;1;7;8
93;05.06.2015;2015;06;23;Perjantai;1;3;4
93;06.06.2015;2015;06;00;Lauantai;0;6;6
93;06.06.2015;2015;06;01;Lauantai;2;3;5
93;06.06.2015;2015;06;02;Lauantai;3;2;5
93;06.06.2015;2015;06;03;Lauantai;1;1;2
93;06.06.2015;2015;06;04;Lauantai;1;3;4
93;06.06.2015;2015;06;05;Lauantai;1;1;2
93;06.06.2015;2015;06;06;Lauantai;6;2;8
93;06.06.2015;2015;06;07;Lauantai;4;1;5
93;06.06.2015;2015;06;08;Lauantai;12;9;21
93;06.06.2015;2015;06;09;Lauantai;20;20;40
93;06.06.2015;2015;06;10;Lauantai;14;28;42
93;06.06.2015;2015;06;11;Lauantai;26;24;50
93;06.06.2015;2015;06;12;Lauantai;21;24;45
93;06.06.2015;2015;06;13;Lauantai;26;16;42
93;06.06.2015;2015;06;14;Lauantai;13;18;31
93;06.06.2015;2015;06;15;Lauantai;11;16;27
93;06.06.2015;2015;06;16;Lauantai;10;7;17
93;06.06.2015;2015;06;17;Lauantai;18;10;28
93;06.06.2015;2015;06;18;Lauantai;5;4;9
93;06.06.2015;2015;06;19;Lauantai;2;3;5
93;06.06.2015;2015;06;20;Lauantai;1;2;3
93;06.06.2015;2015;06;21;Lauantai;4;1;5
93;06.06.2015;2015;06;22;Lauantai;1;2;3
93;06.06.2015;2015;06;23;Lauantai;1;0;1
93;07.06.2015;2015;06;00;Sunnuntai;0;0;0
93;07.06.2015;2015;06;01;Sunnuntai;0;0;0
93;07.06.2015;2015;06;02;Sunnuntai;0;0;0
93;07.06.2015;2015;06;03;Sunnuntai;0;0;0
93;07.06.2015;2015;06;04;Sunnuntai;0;0;0
93;07.06.2015;2015;06;05;Sunnuntai;1;0;1
93;07.06.2015;2015;06;06;Sunnuntai;2;0;2
93;07.06.2015;2015;06;07;Sunnuntai;0;1;1
93;07.06.2015;2015;06;08;Sunnuntai;1;1;2
93;07.06.2015;2015;06;09;Sunnuntai;2;2;4
93;07.06.2015;2015;06;10;Sunnuntai;5;4;9
93;07.06.2015;2015;06;11;Sunnuntai;1;1;2
93;07.06.2015;2015;06;12;Sunnuntai;2;1;3
93;07.06.2015;2015;06;13;Sunnuntai;7;2;9
93;07.06.2015;2015;06;14;Sunnuntai;1;1;2
93;07.06.2015;2015;06;15;Sunnuntai;2;4;6
93;07.06.2015;2015;06;16;Sunnuntai;1;0;1
93;07.06.2015;2015;06;17;Sunnuntai;1;0;1
93;07.06.2015;2015;06;18;Sunnuntai;1;2;3
93;07.06.2015;2015;06;19;Sunnuntai;4;3;7
93;07.06.2015;2015;06;20;Sunnuntai;2;0;2
93;07.06.2015;2015;06;21;Sunnuntai;0;1;1
93;07.06.2015;2015;06;22;Sunnuntai;0;0;0
93;07.06.2015;2015;06;23;Sunnuntai;1;1;2
93;08.06.2015;2015;06;00;Maanantai;3;0;3
93;08.06.2015;2015;06;01;Maanantai;3;5;8
93;08.06.2015;2015;06;02;Maanantai;0;0;0
93;08.06.2015;2015;06;03;Maanantai;0;0;0
93;08.06.2015;2015;06;04;Maanantai;2;2;4
93;08.06.2015;2015;06;05;Maanantai;3;3;6
93;08.06.2015;2015;06;06;Maanantai;14;8;22
93;08.06.2015;2015;06;07;Maanantai;19;39;58
93;08.06.2015;2015;06;08;Maanantai;16;16;32
93;08.06.2015;2015;06;09;Maanantai;19;13;32
93;08.06.2015;2015;06;10;Maanantai;17;20;37
93;08.06.2015;2015;06;11;Maanantai;21;11;32
93;08.06.2015;2015;06;12;Maanantai;16;12;28
93;08.06.2015;2015;06;13;Maanantai;8;16;24
93;08.06.2015;2015;06;14;Maanantai;11;22;33
93;08.06.2015;2015;06;15;Maanantai;22;21;43
93;08.06.2015;2015;06;16;Maanantai;37;40;77
93;08.06.2015;2015;06;17;Maanantai;27;35;62
93;08.06.2015;2015;06;18;Maanantai;26;19;45
93;08.06.2015;2015;06;19;Maanantai;20;21;41
93;08.06.2015;2015;06;20;Maanantai;12;15;27
93;08.06.2015;2015;06;21;Maanantai;6;18;24
93;08.06.2015;2015;06;22;Maanantai;5;5;10
93;08.06.2015;2015;06;23;Maanantai;0;5;5
93;09.06.2015;2015;06;00;Tiistai;2;6;8
93;09.06.2015;2015;06;01;Tiistai;0;0;0
93;09.06.2015;2015;06;02;Tiistai;0;0;0
93;09.06.2015;2015;06;03;Tiistai;0;0;0
93;09.06.2015;2015;06;04;Tiistai;2;1;3
93;09.06.2015;2015;06;05;Tiistai;3;4;7
93;09.06.2015;2015;06;06;Tiistai;20;12;32
93;09.06.2015;2015;06;07;Tiistai;38;48;86
93;09.06.2015;2015;06;08;Tiistai;22;28;50
93;09.06.2015;2015;06;09;Tiistai;23;16;39
93;09.06.2015;2015;06;10;Tiistai;16;12;28
93;09.06.2015;2015;06;11;Tiistai;18;14;32
93;09.06.2015;2015;06;12;Tiistai;16;10;26
93;09.06.2015;2015;06;13;Tiistai;19;18;37
93;09.06.2015;2015;06;14;Tiistai;12;21;33
93;09.06.2015;2015;06;15;Tiistai;30;26;56
93;09.06.2015;2015;06;16;Tiistai;49;44;93
93;09.06.2015;2015;06;17;Tiistai;26;43;69
93;09.06.2015;2015;06;18;Tiistai;26;29;55
93;09.06.2015;2015;06;19;Tiistai;15;28;43
93;09.06.2015;2015;06;20;Tiistai;6;17;23
93;09.06.2015;2015;06;21;Tiistai;11;11;22
93;09.06.2015;2015;06;22;Tiistai;3;9;12
93;09.06.2015;2015;06;23;Tiistai;4;2;6
93;10.06.2015;2015;06;00;Keskiviikko;0;0;0
93;10.06.2015;2015;06;01;Keskiviikko;1;2;3
93;10.06.2015;2015;06;02;Keskiviikko;0;0;0
93;10.06.2015;2015;06;03;Keskiviikko;0;1;1
93;10.06.2015;2015;06;04;Keskiviikko;1;1;2
93;10.06.2015;2015;06;05;Keskiviikko;2;3;5
93;10.06.2015;2015;06;06;Keskiviikko;17;11;28
93;10.06.2015;2015;06;07;Keskiviikko;26;36;62
93;10.06.2015;2015;06;08;Keskiviikko;8;13;21
93;10.06.2015;2015;06;09;Keskiviikko;3;5;8
93;10.06.2015;2015;06;10;Keskiviikko;3;3;6
93;10.06.2015;2015;06;11;Keskiviikko;6;1;7
93;10.06.2015;2015;06;12;Keskiviikko;2;7;9
93;10.06.2015;2015;06;13;Keskiviikko;11;8;19
93;10.06.2015;2015;06;14;Keskiviikko;22;12;34
93;10.06.2015;2015;06;15;Keskiviikko;17;17;34
93;10.06.2015;2015;06;16;Keskiviikko;40;34;74
93;10.06.2015;2015;06;17;Keskiviikko;11;24;35
93;10.06.2015;2015;06;18;Keskiviikko;16;14;30
93;10.06.2015;2015;06;19;Keskiviikko;17;15;32
93;10.06.2015;2015;06;20;Keskiviikko;13;14;27
93;10.06.2015;2015;06;21;Keskiviikko;10;8;18
93;10.06.2015;2015;06;22;Keskiviikko;5;3;8
93;10.06.2015;2015;06;23;Keskiviikko;0;5;5
93;11.06.2015;2015;06;00;Torstai;0;0;0
93;11.06.2015;2015;06;01;Torstai;1;0;1
93;11.06.2015;2015;06;02;Torstai;1;0;1
93;11.06.2015;2015;06;03;Torstai;0;0;0
93;11.06.2015;2015;06;04;Torstai;3;3;6
93;11.06.2015;2015;06;05;Torstai;4;6;10
93;11.06.2015;2015;06;06;Torstai;19;13;32
93;11.06.2015;2015;06;07;Torstai;28;30;58
93;11.06.2015;2015;06;08;Torstai;21;18;39
93;11.06.2015;2015;06;09;Torstai;14;10;24
93;11.06.2015;2015;06;10;Torstai;4;14;18
93;11.06.2015;2015;06;11;Torstai;10;4;14
93;11.06.2015;2015;06;12;Torstai;11;11;22
93;11.06.2015;2015;06;13;Torstai;19;20;39
93;11.06.2015;2015;06;14;Torstai;13;19;32
93;11.06.2015;2015;06;15;Torstai;33;24;57
93;11.06.2015;2015;06;16;Torstai;41;37;78
93;11.06.2015;2015;06;17;Torstai;16;26;42
93;11.06.2015;2015;06;18;Torstai;17;20;37
93;11.06.2015;2015;06;19;Torstai;26;36;62
93;11.06.2015;2015;06;20;Torstai;16;17;33
93;11.06.2015;2015;06;21;Torstai;13;12;25
93;11.06.2015;2015;06;22;Torstai;1;3;4
93;11.06.2015;2015;06;23;Torstai;2;9;11
93;12.06.2015;2015;06;00;Perjantai;1;3;4
93;12.06.2015;2015;06;01;Perjantai;1;0;1
93;12.06.2015;2015;06;02;Perjantai;0;0;0
93;12.06.2015;2015;06;03;Perjantai;0;0;0
93;12.06.2015;2015;06;04;Perjantai;3;1;4
93;12.06.2015;2015;06;05;Perjantai;2;5;7
93;12.06.2015;2015;06;06;Perjantai;21;10;31
93;12.06.2015;2015;06;07;Perjantai;17;26;43
93;12.06.2015;2015;06;08;Perjantai;14;17;31
93;12.06.2015;2015;06;09;Perjantai;13;10;23
93;12.06.2015;2015;06;10;Perjantai;14;13;27
93;12.06.2015;2015;06;11;Perjantai;14;5;19
93;12.06.2015;2015;06;12;Perjantai;18;12;30
93;12.06.2015;2015;06;13;Perjantai;12;20;32
93;12.06.2015;2015;06;14;Perjantai;13;19;32
93;12.06.2015;2015;06;15;Perjantai;30;32;62
93;12.06.2015;2015;06;16;Perjantai;28;42;70
93;12.06.2015;2015;06;17;Perjantai;26;19;45
93;12.06.2015;2015;06;18;Perjantai;16;20;36
93;12.06.2015;2015;06;19;Perjantai;16;10;26
93;12.06.2015;2015;06;20;Perjantai;13;17;30
93;12.06.2015;2015;06;21;Perjantai;8;14;22
93;12.06.2015;2015;06;22;Perjantai;6;2;8
93;12.06.2015;2015;06;23;Perjantai;1;1;2
93;13.06.2015;2015;06;00;Lauantai;0;4;4
93;13.06.2015;2015;06;01;Lauantai;3;2;5
93;13.06.2015;2015;06;02;Lauantai;1;1;2
93;13.06.2015;2015;06;03;Lauantai;3;3;6
93;13.06.2015;2015;06;04;Lauantai;1;2;3
93;13.06.2015;2015;06;05;Lauantai;0;2;2
93;13.06.2015;2015;06;06;Lauantai;0;2;2
93;13.06.2015;2015;06;07;Lauantai;4;4;8
93;13.06.2015;2015;06;08;Lauantai;4;3;7
93;13.06.2015;2015;06;09;Lauantai;8;2;10
93;13.06.2015;2015;06;10;Lauantai;12;3;15
93;13.06.2015;2015;06;11;Lauantai;2;4;6
93;13.06.2015;2015;06;12;Lauantai;7;18;25
93;13.06.2015;2015;06;13;Lauantai;13;10;23
93;13.06.2015;2015;06;14;Lauantai;13;15;28
93;13.06.2015;2015;06;15;Lauantai;20;20;40
93;13.06.2015;2015;06;16;Lauantai;16;18;34
93;13.06.2015;2015;06;17;Lauantai;12;15;27
93;13.06.2015;2015;06;18;Lauantai;19;14;33
93;13.06.2015;2015;06;19;Lauantai;9;19;28
93;13.06.2015;2015;06;20;Lauantai;12;8;20
93;13.06.2015;2015;06;21;Lauantai;5;6;11
93;13.06.2015;2015;06;22;Lauantai;7;5;12
93;13.06.2015;2015;06;23;Lauantai;1;5;6
93;14.06.2015;2015;06;00;Sunnuntai;1;4;5
93;14.06.2015;2015;06;01;Sunnuntai;2;6;8
93;14.06.2015;2015;06;02;Sunnuntai;0;2;2
93;14.06.2015;2015;06;03;Sunnuntai;2;1;3
93;14.06.2015;2015;06;04;Sunnuntai;0;0;0
93;14.06.2015;2015;06;05;Sunnuntai;0;1;1
93;14.06.2015;2015;06;06;Sunnuntai;2;2;4
93;14.06.2015;2015;06;07;Sunnuntai;8;6;14
93;14.06.2015;2015;06;08;Sunnuntai;10;6;16
93;14.06.2015;2015;06;09;Sunnuntai;15;10;25
93;14.06.2015;2015;06;10;Sunnuntai;20;14;34
93;14.06.2015;2015;06;11;Sunnuntai;34;27;61
93;14.06.2015;2015;06;12;Sunnuntai;46;38;84
93;14.06.2015;2015;06;13;Sunnuntai;33;43;76
93;14.06.2015;2015;06;14;Sunnuntai;29;36;65
93;14.06.2015;2015;06;15;Sunnuntai;36;32;68
93;14.06.2015;2015;06;16;Sunnuntai;27;28;55
93;14.06.2015;2015;06;17;Sunnuntai;17;22;39
93;14.06.2015;2015;06;18;Sunnuntai;17;24;41
93;14.06.2015;2015;06;19;Sunnuntai;18;25;43
93;14.06.2015;2015;06;20;Sunnuntai;14;8;22
93;14.06.2015;2015;06;21;Sunnuntai;6;8;14
93;14.06.2015;2015;06;22;Sunnuntai;2;4;6
93;14.06.2015;2015;06;23;Sunnuntai;1;1;2
93;15.06.2015;2015;06;00;Maanantai;0;1;1
93;15.06.2015;2015;06;01;Maanantai;0;0;0
93;15.06.2015;2015;06;02;Maanantai;0;0;0
93;15.06.2015;2015;06;03;Maanantai;0;0;0
93;15.06.2015;2015;06;04;Maanantai;1;0;1
93;15.06.2015;2015;06;05;Maanantai;1;4;5
93;15.06.2015;2015;06;06;Maanantai;10;3;13
93;15.06.2015;2015;06;07;Maanantai;7;5;12
93;15.06.2015;2015;06;08;Maanantai;1;8;9
93;15.06.2015;2015;06;09;Maanantai;3;2;5
93;15.06.2015;2015;06;10;Maanantai;4;2;6
93;15.06.2015;2015;06;11;Maanantai;3;3;6
93;15.06.2015;2015;06;12;Maanantai;3;1;4
93;15.06.2015;2015;06;13;Maanantai;3;4;7
93;15.06.2015;2015;06;14;Maanantai;7;4;11
93;15.06.2015;2015;06;15;Maanantai;8;7;15
93;15.06.2015;2015;06;16;Maanantai;11;12;23
93;15.06.2015;2015;06;17;Maanantai;3;5;8
93;15.06.2015;2015;06;18;Maanantai;5;7;12
93;15.06.2015;2015;06;19;Maanantai;3;0;3
93;15.06.2015;2015;06;20;Maanantai;4;2;6
93;15.06.2015;2015;06;21;Maanantai;1;1;2
93;15.06.2015;2015;06;22;Maanantai;0;1;1
93;15.06.2015;2015;06;23;Maanantai;0;0;0
93;16.06.2015;2015;06;00;Tiistai;0;0;0
93;16.06.2015;2015;06;01;Tiistai;0;0;0
93;16.06.2015;2015;06;02;Tiistai;0;0;0
93;16.06.2015;2015;06;03;Tiistai;0;0;0
93;16.06.2015;2015;06;04;Tiistai;2;1;3
93;16.06.2015;2015;06;05;Tiistai;3;3;6
93;16.06.2015;2015;06;06;Tiistai;13;5;18
93;16.06.2015;2015;06;07;Tiistai;16;16;32
93;16.06.2015;2015;06;08;Tiistai;3;10;13
93;16.06.2015;2015;06;09;Tiistai;3;8;11
93;16.06.2015;2015;06;10;Tiistai;6;0;6
93;16.06.2015;2015;06;11;Tiistai;5;9;14
93;16.06.2015;2015;06;12;Tiistai;9;1;10
93;16.06.2015;2015;06;13;Tiistai;5;9;14
93;16.06.2015;2015;06;14;Tiistai;4;7;11
93;16.06.2015;2015;06;15;Tiistai;10;16;26
93;16.06.2015;2015;06;16;Tiistai;19;13;32
93;16.06.2015;2015;06;17;Tiistai;10;10;20
93;16.06.2015;2015;06;18;Tiistai;10;7;17
93;16.06.2015;2015;06;19;Tiistai;6;3;9
93;16.06.2015;2015;06;20;Tiistai;4;7;11
93;16.06.2015;2015;06;21;Tiistai;4;5;9
93;16.06.2015;2015;06;22;Tiistai;0;3;3
93;16.06.2015;2015;06;23;Tiistai;2;1;3
93;17.06.2015;2015;06;00;Keskiviikko;0;0;0
93;17.06.2015;2015;06;01;Keskiviikko;0;1;1
93;17.06.2015;2015;06;02;Keskiviikko;0;0;0
93;17.06.2015;2015;06;03;Keskiviikko;0;0;0
93;17.06.2015;2015;06;04;Keskiviikko;1;1;2
93;17.06.2015;2015;06;05;Keskiviikko;1;3;4
93;17.06.2015;2015;06;06;Keskiviikko;21;8;29
93;17.06.2015;2015;06;07;Keskiviikko;20;32;52
93;17.06.2015;2015;06;08;Keskiviikko;6;17;23
93;17.06.2015;2015;06;09;Keskiviikko;5;10;15
93;17.06.2015;2015;06;10;Keskiviikko;10;9;19
93;17.06.2015;2015;06;11;Keskiviikko;20;6;26
93;17.06.2015;2015;06;12;Keskiviikko;15;16;31
93;17.06.2015;2015;06;13;Keskiviikko;12;14;26
93;17.06.2015;2015;06;14;Keskiviikko;15;28;43
93;17.06.2015;2015;06;15;Keskiviikko;21;24;45
93;17.06.2015;2015;06;16;Keskiviikko;45;41;86
93;17.06.2015;2015;06;17;Keskiviikko;28;25;53
93;17.06.2015;2015;06;18;Keskiviikko;14;25;39
93;17.06.2015;2015;06;19;Keskiviikko;17;25;42
93;17.06.2015;2015;06;20;Keskiviikko;18;16;34
93;17.06.2015;2015;06;21;Keskiviikko;4;14;18
93;17.06.2015;2015;06;22;Keskiviikko;5;9;14
93;17.06.2015;2015;06;23;Keskiviikko;4;3;7
93;18.06.2015;2015;06;00;Torstai;1;4;5
93;18.06.2015;2015;06;01;Torstai;2;1;3
93;18.06.2015;2015;06;02;Torstai;0;0;0
93;18.06.2015;2015;06;03;Torstai;0;1;1
93;18.06.2015;2015;06;04;Torstai;0;1;1
93;18.06.2015;2015;06;05;Torstai;1;1;2
93;18.06.2015;2015;06;06;Torstai;18;7;25
93;18.06.2015;2015;06;07;Torstai;17;29;46
93;18.06.2015;2015;06;08;Torstai;16;24;40
93;18.06.2015;2015;06;09;Torstai;11;11;22
93;18.06.2015;2015;06;10;Torstai;8;7;15
93;18.06.2015;2015;06;11;Torstai;12;10;22
93;18.06.2015;2015;06;12;Torstai;10;6;16
93;18.06.2015;2015;06;13;Torstai;14;15;29
93;18.06.2015;2015;06;14;Torstai;18;23;41
93;18.06.2015;2015;06;15;Torstai;25;18;43
93;18.06.2015;2015;06;16;Torstai;23;24;47
93;18.06.2015;2015;06;17;Torstai;26;30;56
93;18.06.2015;2015;06;18;Torstai;16;17;33
93;18.06.2015;2015;06;19;Torstai;28;17;45
93;18.06.2015;2015;06;20;Torstai;8;13;21
93;18.06.2015;2015;06;21;Torstai;7;3;10
93;18.06.2015;2015;06;22;Torstai;1;3;4
93;18.06.2015;2015;06;23;Torstai;0;0;0
93;19.06.2015;2015;06;00;Perjantai;2;1;3
93;19.06.2015;2015;06;01;Perjantai;0;5;5
93;19.06.2015;2015;06;02;Perjantai;0;0;0
93;19.06.2015;2015;06;03;Perjantai;0;1;1
93;19.06.2015;2015;06;04;Perjantai;1;1;2
93;19.06.2015;2015;06;05;Perjantai;0;0;0
93;19.06.2015;2015;06;06;Perjantai;2;0;2
93;19.06.2015;2015;06;07;Perjantai;5;5;10
93;19.06.2015;2015;06;08;Perjantai;13;5;18
93;19.06.2015;2015;06;09;Perjantai;8;8;16
93;19.06.2015;2015;06;10;Perjantai;16;23;39
93;19.06.2015;2015;06;11;Perjantai;16;11;27
93;19.06.2015;2015;06;12;Perjantai;10;15;25
93;19.06.2015;2015;06;13;Perjantai;15;15;30
93;19.06.2015;2015;06;14;Perjantai;20;18;38
93;19.06.2015;2015;06;15;Perjantai;17;27;44
93;19.06.2015;2015;06;16;Perjantai;14;15;29
93;19.06.2015;2015;06;17;Perjantai;12;15;27
93;19.06.2015;2015;06;18;Perjantai;7;11;18
93;19.06.2015;2015;06;19;Perjantai;15;7;22
93;19.06.2015;2015;06;20;Perjantai;7;8;15
93;19.06.2015;2015;06;21;Perjantai;4;8;12
93;19.06.2015;2015;06;22;Perjantai;4;12;16
93;19.06.2015;2015;06;23;Perjantai;3;2;5
93;20.06.2015;2015;06;00;Lauantai;2;3;5
93;20.06.2015;2015;06;01;Lauantai;6;2;8
93;20.06.2015;2015;06;02;Lauantai;0;0;0
93;20.06.2015;2015;06;03;Lauantai;3;4;7
93;20.06.2015;2015;06;04;Lauantai;3;7;10
93;20.06.2015;2015;06;05;Lauantai;1;0;1
93;20.06.2015;2015;06;06;Lauantai;1;0;1
93;20.06.2015;2015;06;07;Lauantai;3;6;9
93;20.06.2015;2015;06;08;Lauantai;7;1;8
93;20.06.2015;2015;06;09;Lauantai;3;6;9
93;20.06.2015;2015;06;10;Lauantai;5;14;19
93;20.06.2015;2015;06;11;Lauantai;21;20;41
93;20.06.2015;2015;06;12;Lauantai;18;27;45
93;20.06.2015;2015;06;13;Lauantai;23;18;41
93;20.06.2015;2015;06;14;Lauantai;16;18;34
93;20.06.2015;2015;06;15;Lauantai;23;32;55
93;20.06.2015;2015;06;16;Lauantai;20;29;49
93;20.06.2015;2015;06;17;Lauantai;26;14;40
93;20.06.2015;2015;06;18;Lauantai;30;19;49
93;20.06.2015;2015;06;19;Lauantai;16;21;37
93;20.06.2015;2015;06;20;Lauantai;19;2;21
93;20.06.2015;2015;06;21;Lauantai;8;13;21
93;20.06.2015;2015;06;22;Lauantai;5;4;9
93;20.06.2015;2015;06;23;Lauantai;2;5;7
93;21.06.2015;2015;06;00;Sunnuntai;1;10;11
93;21.06.2015;2015;06;01;Sunnuntai;1;2;3
93;21.06.2015;2015;06;02;Sunnuntai;4;0;4
93;21.06.2015;2015;06;03;Sunnuntai;1;1;2
93;21.06.2015;2015;06;04;Sunnuntai;1;0;1
93;21.06.2015;2015;06;05;Sunnuntai;0;0;0
93;21.06.2015;2015;06;06;Sunnuntai;1;2;3
93;21.06.2015;2015;06;07;Sunnuntai;0;0;0
93;21.06.2015;2015;06;08;Sunnuntai;3;4;7
93;21.06.2015;2015;06;09;Sunnuntai;3;8;11
93;21.06.2015;2015;06;10;Sunnuntai;2;0;2
93;21.06.2015;2015;06;11;Sunnuntai;5;5;10
93;21.06.2015;2015;06;12;Sunnuntai;11;4;15
93;21.06.2015;2015;06;13;Sunnuntai;18;9;27
93;21.06.2015;2015;06;14;Sunnuntai;15;16;31
93;21.06.2015;2015;06;15;Sunnuntai;13;14;27
93;21.06.2015;2015;06;16;Sunnuntai;15;17;32
93;21.06.2015;2015;06;17;Sunnuntai;26;20;46
93;21.06.2015;2015;06;18;Sunnuntai;32;34;66
93;21.06.2015;2015;06;19;Sunnuntai;28;28;56
93;21.06.2015;2015;06;20;Sunnuntai;14;7;21
93;21.06.2015;2015;06;21;Sunnuntai;15;9;24
93;21.06.2015;2015;06;22;Sunnuntai;3;4;7
93;21.06.2015;2015;06;23;Sunnuntai;5;3;8
93;22.06.2015;2015;06;00;Maanantai;1;3;4
93;22.06.2015;2015;06;01;Maanantai;2;0;2
93;22.06.2015;2015;06;02;Maanantai;2;3;5
93;22.06.2015;2015;06;03;Maanantai;0;0;0
93;22.06.2015;2015;06;04;Maanantai;1;1;2
93;22.06.2015;2015;06;05;Maanantai;7;8;15
93;22.06.2015;2015;06;06;Maanantai;25;15;40
93;22.06.2015;2015;06;07;Maanantai;39;41;80
93;22.06.2015;2015;06;08;Maanantai;22;33;55
93;22.06.2015;2015;06;09;Maanantai;19;9;28
93;22.06.2015;2015;06;10;Maanantai;15;16;31
93;22.06.2015;2015;06;11;Maanantai;29;16;45
93;22.06.2015;2015;06;12;Maanantai;28;14;42
93;22.06.2015;2015;06;13;Maanantai;19;30;49
93;22.06.2015;2015;06;14;Maanantai;26;27;53
93;22.06.2015;2015;06;15;Maanantai;38;43;81
93;22.06.2015;2015;06;16;Maanantai;50;58;108
93;22.06.2015;2015;06;17;Maanantai;42;43;85
93;22.06.2015;2015;06;18;Maanantai;20;31;51
93;22.06.2015;2015;06;19;Maanantai;24;26;50
93;22.06.2015;2015;06;20;Maanantai;6;12;18
93;22.06.2015;2015;06;21;Maanantai;4;3;7
93;22.06.2015;2015;06;22;Maanantai;1;4;5
93;22.06.2015;2015;06;23;Maanantai;0;1;1
93;23.06.2015;2015;06;00;Tiistai;2;0;2
93;23.06.2015;2015;06;01;Tiistai;0;0;0
93;23.06.2015;2015;06;02;Tiistai;1;0;1
93;23.06.2015;2015;06;03;Tiistai;0;0;0
93;23.06.2015;2015;06;04;Tiistai;0;0;0
93;23.06.2015;2015;06;05;Tiistai;1;1;2
93;23.06.2015;2015;06;06;Tiistai;5;8;13
93;23.06.2015;2015;06;07;Tiistai;13;21;34
93;23.06.2015;2015;06;08;Tiistai;7;14;21
93;23.06.2015;2015;06;09;Tiistai;5;2;7
93;23.06.2015;2015;06;10;Tiistai;5;4;9
93;23.06.2015;2015;06;11;Tiistai;1;0;1
93;23.06.2015;2015;06;12;Tiistai;1;1;2
93;23.06.2015;2015;06;13;Tiistai;2;2;4
93;23.06.2015;2015;06;14;Tiistai;5;4;9
93;23.06.2015;2015;06;15;Tiistai;11;3;14
93;23.06.2015;2015;06;16;Tiistai;19;13;32
93;23.06.2015;2015;06;17;Tiistai;10;9;19
93;23.06.2015;2015;06;18;Tiistai;5;4;9
93;23.06.2015;2015;06;19;Tiistai;6;3;9
93;23.06.2015;2015;06;20;Tiistai;2;2;4
93;23.06.2015;2015;06;21;Tiistai;2;1;3
93;23.06.2015;2015;06;22;Tiistai;0;5;5
93;23.06.2015;2015;06;23;Tiistai;0;0;0
93;24.06.2015;2015;06;00;Keskiviikko;3;0;3
93;24.06.2015;2015;06;01;Keskiviikko;0;0;0
93;24.06.2015;2015;06;02;Keskiviikko;0;0;0
93;24.06.2015;2015;06;03;Keskiviikko;0;0;0
93;24.06.2015;2015;06;04;Keskiviikko;0;0;0
93;24.06.2015;2015;06;05;Keskiviikko;3;0;3
93;24.06.2015;2015;06;06;Keskiviikko;11;12;23
93;24.06.2015;2015;06;07;Keskiviikko;17;33;50
93;24.06.2015;2015;06;08;Keskiviikko;18;18;36
93;24.06.2015;2015;06;09;Keskiviikko;5;13;18
93;24.06.2015;2015;06;10;Keskiviikko;12;8;20
93;24.06.2015;2015;06;11;Keskiviikko;20;24;44
93;24.06.2015;2015;06;12;Keskiviikko;5;8;13
93;24.06.2015;2015;06;13;Keskiviikko;9;8;17
93;24.06.2015;2015;06;14;Keskiviikko;2;3;5
93;24.06.2015;2015;06;15;Keskiviikko;12;13;25
93;24.06.2015;2015;06;16;Keskiviikko;23;8;31
93;24.06.2015;2015;06;17;Keskiviikko;17;12;29
93;24.06.2015;2015;06;18;Keskiviikko;6;8;14
93;24.06.2015;2015;06;19;Keskiviikko;6;7;13
93;24.06.2015;2015;06;20;Keskiviikko;7;9;16
93;24.06.2015;2015;06;21;Keskiviikko;7;8;15
93;24.06.2015;2015;06;22;Keskiviikko;9;4;13
93;24.06.2015;2015;06;23;Keskiviikko;2;3;5
93;25.06.2015;2015;06;00;Torstai;0;1;1
93;25.06.2015;2015;06;01;Torstai;0;0;0
93;25.06.2015;2015;06;02;Torstai;1;0;1
93;25.06.2015;2015;06;03;Torstai;0;0;0
93;25.06.2015;2015;06;04;Torstai;0;0;0
93;25.06.2015;2015;06;05;Torstai;2;1;3
93;25.06.2015;2015;06;06;Torstai;6;4;10
93;25.06.2015;2015;06;07;Torstai;9;14;23
93;25.06.2015;2015;06;08;Torstai;1;13;14
93;25.06.2015;2015;06;09;Torstai;6;0;6
93;25.06.2015;2015;06;10;Torstai;2;3;5
93;25.06.2015;2015;06;11;Torstai;2;4;6
93;25.06.2015;2015;06;12;Torstai;1;1;2
93;25.06.2015;2015;06;13;Torstai;6;3;9
93;25.06.2015;2015;06;14;Torstai;3;5;8
93;25.06.2015;2015;06;15;Torstai;5;11;16
93;25.06.2015;2015;06;16;Torstai;14;9;23
93;25.06.2015;2015;06;17;Torstai;9;7;16
93;25.06.2015;2015;06;18;Torstai;12;3;15
93;25.06.2015;2015;06;19;Torstai;10;15;25
93;25.06.2015;2015;06;20;Torstai;6;3;9
93;25.06.2015;2015;06;21;Torstai;2;2;4
93;25.06.2015;2015;06;22;Torstai;0;3;3
93;25.06.2015;2015;06;23;Torstai;1;1;2
93;26.06.2015;2015;06;00;Perjantai;2;0;2
93;26.06.2015;2015;06;01;Perjantai;1;0;1
93;26.06.2015;2015;06;02;Perjantai;0;1;1
93;26.06.2015;2015;06;03;Perjantai;0;0;0
93;26.06.2015;2015;06;04;Perjantai;0;2;2
93;26.06.2015;2015;06;05;Perjantai;4;3;7
93;26.06.2015;2015;06;06;Perjantai;11;11;22
93;26.06.2015;2015;06;07;Perjantai;25;29;54
93;26.06.2015;2015;06;08;Perjantai;15;18;33
93;26.06.2015;2015;06;09;Perjantai;8;11;19
93;26.06.2015;2015;06;10;Perjantai;7;7;14
93;26.06.2015;2015;06;11;Perjantai;14;9;23
93;26.06.2015;2015;06;12;Perjantai;5;6;11
93;26.06.2015;2015;06;13;Perjantai;15;9;24
93;26.06.2015;2015;06;14;Perjantai;22;24;46
93;26.06.2015;2015;06;15;Perjantai;28;28;56
93;26.06.2015;2015;06;16;Perjantai;31;25;56
93;26.06.2015;2015;06;17;Perjantai;21;22;43
93;26.06.2015;2015;06;18;Perjantai;13;14;27
93;26.06.2015;2015;06;19;Perjantai;10;26;36
93;26.06.2015;2015;06;20;Perjantai;10;14;24
93;26.06.2015;2015;06;21;Perjantai;3;4;7
93;26.06.2015;2015;06;22;Perjantai;4;6;10
93;26.06.2015;2015;06;23;Perjantai;3;1;4
93;27.06.2015;2015;06;00;Lauantai;0;2;2
93;27.06.2015;2015;06;01;Lauantai;1;3;4
93;27.06.2015;2015;06;02;Lauantai;0;0;0
93;27.06.2015;2015;06;03;Lauantai;0;0;0
93;27.06.2015;2015;06;04;Lauantai;1;3;4
93;27.06.2015;2015;06;05;Lauantai;0;1;1
93;27.06.2015;2015;06;06;Lauantai;1;3;4
93;27.06.2015;2015;06;07;Lauantai;2;0;2
93;27.06.2015;2015;06;08;Lauantai;4;7;11
93;27.06.2015;2015;06;09;Lauantai;6;7;13
93;27.06.2015;2015;06;10;Lauantai;13;10;23
93;27.06.2015;2015;06;11;Lauantai;16;9;25
93;27.06.2015;2015;06;12;Lauantai;11;6;17
93;27.06.2015;2015;06;13;Lauantai;4;21;25
93;27.06.2015;2015;06;14;Lauantai;15;17;32
93;27.06.2015;2015;06;15;Lauantai;16;12;28
93;27.06.2015;2015;06;16;Lauantai;11;9;20
93;27.06.2015;2015;06;17;Lauantai;15;23;38
93;27.06.2015;2015;06;18;Lauantai;22;32;54
93;27.06.2015;2015;06;19;Lauantai;15;9;24
93;27.06.2015;2015;06;20;Lauantai;17;8;25
93;27.06.2015;2015;06;21;Lauantai;5;4;9
93;27.06.2015;2015;06;22;Lauantai;0;17;17
93;27.06.2015;2015;06;23;Lauantai;0;3;3
93;28.06.2015;2015;06;00;Sunnuntai;0;3;3
93;28.06.2015;2015;06;01;Sunnuntai;5;1;6
93;28.06.2015;2015;06;02;Sunnuntai;1;0;1
93;28.06.2015;2015;06;03;Sunnuntai;2;2;4
93;28.06.2015;2015;06;04;Sunnuntai;0;1;1
93;28.06.2015;2015;06;05;Sunnuntai;2;2;4
93;28.06.2015;2015;06;06;Sunnuntai;2;1;3
93;28.06.2015;2015;06;07;Sunnuntai;4;3;7
93;28.06.2015;2015;06;08;Sunnuntai;8;7;15
93;28.06.2015;2015;06;09;Sunnuntai;10;11;21
93;28.06.2015;2015;06;10;Sunnuntai;21;13;34
93;28.06.2015;2015;06;11;Sunnuntai;19;29;48
93;28.06.2015;2015;06;12;Sunnuntai;41;23;64
93;28.06.2015;2015;06;13;Sunnuntai;18;39;57
93;28.06.2015;2015;06;14;Sunnuntai;41;18;59
93;28.06.2015;2015;06;15;Sunnuntai;27;45;72
93;28.06.2015;2015;06;16;Sunnuntai;40;27;67
93;28.06.2015;2015;06;17;Sunnuntai;42;34;76
93;28.06.2015;2015;06;18;Sunnuntai;35;26;61
93;28.06.2015;2015;06;19;Sunnuntai;34;34;68
93;28.06.2015;2015;06;20;Sunnuntai;27;20;47
93;28.06.2015;2015;06;21;Sunnuntai;8;13;21
93;28.06.2015;2015;06;22;Sunnuntai;10;8;18
93;28.06.2015;2015;06;23;Sunnuntai;7;1;8
93;29.06.2015;2015;06;00;Maanantai;0;0;0
93;29.06.2015;2015;06;01;Maanantai;2;2;4
93;29.06.2015;2015;06;02;Maanantai;0;0;0
93;29.06.2015;2015;06;03;Maanantai;0;0;0
93;29.06.2015;2015;06;04;Maanantai;0;1;1
93;29.06.2015;2015;06;05;Maanantai;3;8;11
93;29.06.2015;2015;06;06;Maanantai;21;12;33
93;29.06.2015;2015;06;07;Maanantai;35;24;59
93;29.06.2015;2015;06;08;Maanantai;19;27;46
93;29.06.2015;2015;06;09;Maanantai;17;12;29
93;29.06.2015;2015;06;10;Maanantai;23;13;36
93;29.06.2015;2015;06;11;Maanantai;18;22;40
93;29.06.2015;2015;06;12;Maanantai;25;21;46
93;29.06.2015;2015;06;13;Maanantai;20;21;41
93;29.06.2015;2015;06;14;Maanantai;34;15;49
93;29.06.2015;2015;06;15;Maanantai;35;38;73
93;29.06.2015;2015;06;16;Maanantai;41;47;88
93;29.06.2015;2015;06;17;Maanantai;39;46;85
93;29.06.2015;2015;06;18;Maanantai;31;29;60
93;29.06.2015;2015;06;19;Maanantai;21;25;46
93;29.06.2015;2015;06;20;Maanantai;12;8;20
93;29.06.2015;2015;06;21;Maanantai;3;14;17
93;29.06.2015;2015;06;22;Maanantai;1;2;3
93;29.06.2015;2015;06;23;Maanantai;0;2;2
93;30.06.2015;2015;06;00;Tiistai;1;2;3
93;30.06.2015;2015;06;01;Tiistai;1;1;2
93;30.06.2015;2015;06;02;Tiistai;0;2;2
93;30.06.2015;2015;06;03;Tiistai;1;1;2
93;30.06.2015;2015;06;04;Tiistai;1;1;2
93;30.06.2015;2015;06;05;Tiistai;5;7;12
93;30.06.2015;2015;06;06;Tiistai;7;10;17
93;30.06.2015;2015;06;07;Tiistai;18;18;36
93;30.06.2015;2015;06;08;Tiistai;8;20;28
93;30.06.2015;2015;06;09;Tiistai;6;9;15
93;30.06.2015;2015;06;10;Tiistai;12;1;13
93;30.06.2015;2015;06;11;Tiistai;8;11;19
93;30.06.2015;2015;06;12;Tiistai;18;10;28
93;30.06.2015;2015;06;13;Tiistai;12;11;23
93;30.06.2015;2015;06;14;Tiistai;16;13;29
93;30.06.2015;2015;06;15;Tiistai;29;19;48
93;30.06.2015;2015;06;16;Tiistai;30;21;51
93;30.06.2015;2015;06;17;Tiistai;25;28;53
93;30.06.2015;2015;06;18;Tiistai;22;23;45
93;30.06.2015;2015;06;19;Tiistai;21;26;47
93;30.06.2015;2015;06;20;Tiistai;15;20;35
93;30.06.2015;2015;06;21;Tiistai;13;11;24
93;30.06.2015;2015;06;22;Tiistai;2;2;4
93;30.06.2015;2015;06;23;Tiistai;1;8;9
93;01.07.2015;2015;07;00;Keskiviikko;4;2;6
93;01.07.2015;2015;07;01;Keskiviikko;1;0;1
93;01.07.2015;2015;07;02;Keskiviikko;1;0;1
93;01.07.2015;2015;07;03;Keskiviikko;0;0;0
93;01.07.2015;2015;07;04;Keskiviikko;1;3;4
93;01.07.2015;2015;07;05;Keskiviikko;5;8;13
93;01.07.2015;2015;07;06;Keskiviikko;26;10;36
93;01.07.2015;2015;07;07;Keskiviikko;31;31;62
93;01.07.2015;2015;07;08;Keskiviikko;26;31;57
93;01.07.2015;2015;07;09;Keskiviikko;21;13;34
93;01.07.2015;2015;07;10;Keskiviikko;20;15;35
93;01.07.2015;2015;07;11;Keskiviikko;23;23;46
93;01.07.2015;2015;07;12;Keskiviikko;22;19;41
93;01.07.2015;2015;07;13;Keskiviikko;28;32;60
93;01.07.2015;2015;07;14;Keskiviikko;29;31;60
93;01.07.2015;2015;07;15;Keskiviikko;56;52;108
93;01.07.2015;2015;07;16;Keskiviikko;53;52;105
93;01.07.2015;2015;07;17;Keskiviikko;43;45;88
93;01.07.2015;2015;07;18;Keskiviikko;45;35;80
93;01.07.2015;2015;07;19;Keskiviikko;27;51;78
93;01.07.2015;2015;07;20;Keskiviikko;24;40;64
93;01.07.2015;2015;07;21;Keskiviikko;10;19;29
93;01.07.2015;2015;07;22;Keskiviikko;6;9;15
93;01.07.2015;2015;07;23;Keskiviikko;3;7;10
93;02.07.2015;2015;07;00;Torstai;6;0;6
93;02.07.2015;2015;07;01;Torstai;1;3;4
93;02.07.2015;2015;07;02;Torstai;0;2;2
93;02.07.2015;2015;07;03;Torstai;0;2;2
93;02.07.2015;2015;07;04;Torstai;0;2;2
93;02.07.2015;2015;07;05;Torstai;2;4;6
93;02.07.2015;2015;07;06;Torstai;25;8;33
93;02.07.2015;2015;07;07;Torstai;17;32;49
93;02.07.2015;2015;07;08;Torstai;23;20;43
93;02.07.2015;2015;07;09;Torstai;9;11;20
93;02.07.2015;2015;07;10;Torstai;24;8;32
93;02.07.2015;2015;07;11;Torstai;19;17;36
93;02.07.2015;2015;07;12;Torstai;25;25;50
93;02.07.2015;2015;07;13;Torstai;21;26;47
93;02.07.2015;2015;07;14;Torstai;27;24;51
93;02.07.2015;2015;07;15;Torstai;28;43;71
93;02.07.2015;2015;07;16;Torstai;42;42;84
93;02.07.2015;2015;07;17;Torstai;28;35;63
93;02.07.2015;2015;07;18;Torstai;15;21;36
93;02.07.2015;2015;07;19;Torstai;8;2;10
93;02.07.2015;2015;07;20;Torstai;6;5;11
93;02.07.2015;2015;07;21;Torstai;6;10;16
93;02.07.2015;2015;07;22;Torstai;5;4;9
93;02.07.2015;2015;07;23;Torstai;3;2;5
93;03.07.2015;2015;07;00;Perjantai;1;3;4
93;03.07.2015;2015;07;01;Perjantai;1;1;2
93;03.07.2015;2015;07;02;Perjantai;2;2;4
93;03.07.2015;2015;07;03;Perjantai;0;1;1
93;03.07.2015;2015;07;04;Perjantai;0;1;1
93;03.07.2015;2015;07;05;Perjantai;2;5;7
93;03.07.2015;2015;07;06;Perjantai;16;7;23
93;03.07.2015;2015;07;07;Perjantai;18;34;52
93;03.07.2015;2015;07;08;Perjantai;16;15;31
93;03.07.2015;2015;07;09;Perjantai;12;10;22
93;03.07.2015;2015;07;10;Perjantai;38;23;61
93;03.07.2015;2015;07;11;Perjantai;26;18;44
93;03.07.2015;2015;07;12;Perjantai;27;28;55
93;03.07.2015;2015;07;13;Perjantai;39;43;82
93;03.07.2015;2015;07;14;Perjantai;42;26;68
93;03.07.2015;2015;07;15;Perjantai;55;42;97
93;03.07.2015;2015;07;16;Perjantai;34;46;80
93;03.07.2015;2015;07;17;Perjantai;36;32;68
93;03.07.2015;2015;07;18;Perjantai;15;25;40
93;03.07.2015;2015;07;19;Perjantai;21;24;45
93;03.07.2015;2015;07;20;Perjantai;4;10;14
93;03.07.2015;2015;07;21;Perjantai;4;16;20
93;03.07.2015;2015;07;22;Perjantai;0;4;4
93;03.07.2015;2015;07;23;Perjantai;0;1;1
93;04.07.2015;2015;07;00;Lauantai;1;1;2
93;04.07.2015;2015;07;01;Lauantai;1;0;1
93;04.07.2015;2015;07;02;Lauantai;2;1;3
93;04.07.2015;2015;07;03;Lauantai;0;0;0
93;04.07.2015;2015;07;04;Lauantai;0;0;0
93;04.07.2015;2015;07;05;Lauantai;1;0;1
93;04.07.2015;2015;07;06;Lauantai;1;0;1
93;04.07.2015;2015;07;07;Lauantai;3;0;3
93;04.07.2015;2015;07;08;Lauantai;1;2;3
93;04.07.2015;2015;07;09;Lauantai;5;6;11
93;04.07.2015;2015;07;10;Lauantai;3;2;5
93;04.07.2015;2015;07;11;Lauantai;2;5;7
93;04.07.2015;2015;07;12;Lauantai;7;4;11
93;04.07.2015;2015;07;13;Lauantai;4;7;11
93;04.07.2015;2015;07;14;Lauantai;8;8;16
93;04.07.2015;2015;07;15;Lauantai;6;14;20
93;04.07.2015;2015;07;16;Lauantai;11;10;21
93;04.07.2015;2015;07;17;Lauantai;19;17;36
93;04.07.2015;2015;07;18;Lauantai;13;16;29
93;04.07.2015;2015;07;19;Lauantai;17;11;28
93;04.07.2015;2015;07;20;Lauantai;1;9;10
93;04.07.2015;2015;07;21;Lauantai;6;5;11
93;04.07.2015;2015;07;22;Lauantai;2;5;7
93;04.07.2015;2015;07;23;Lauantai;5;6;11
93;05.07.2015;2015;07;00;Sunnuntai;2;4;6
93;05.07.2015;2015;07;01;Sunnuntai;0;2;2
93;05.07.2015;2015;07;02;Sunnuntai;5;0;5
93;05.07.2015;2015;07;03;Sunnuntai;1;4;5
93;05.07.2015;2015;07;04;Sunnuntai;3;0;3
93;05.07.2015;2015;07;05;Sunnuntai;1;1;2
93;05.07.2015;2015;07;06;Sunnuntai;2;1;3
93;05.07.2015;2015;07;07;Sunnuntai;2;2;4
93;05.07.2015;2015;07;08;Sunnuntai;3;6;9
93;05.07.2015;2015;07;09;Sunnuntai;9;8;17
93;05.07.2015;2015;07;10;Sunnuntai;16;20;36
93;05.07.2015;2015;07;11;Sunnuntai;28;20;48
93;05.07.2015;2015;07;12;Sunnuntai;32;23;55
93;05.07.2015;2015;07;13;Sunnuntai;26;38;64
93;05.07.2015;2015;07;14;Sunnuntai;24;20;44
93;05.07.2015;2015;07;15;Sunnuntai;24;13;37
93;05.07.2015;2015;07;16;Sunnuntai;17;20;37
93;05.07.2015;2015;07;17;Sunnuntai;29;23;52
93;05.07.2015;2015;07;18;Sunnuntai;16;35;51
93;05.07.2015;2015;07;19;Sunnuntai;20;25;45
93;05.07.2015;2015;07;20;Sunnuntai;18;16;34
93;05.07.2015;2015;07;21;Sunnuntai;10;12;22
93;05.07.2015;2015;07;22;Sunnuntai;7;1;8
93;05.07.2015;2015;07;23;Sunnuntai;5;3;8
93;06.07.2015;2015;07;00;Maanantai;0;2;2
93;06.07.2015;2015;07;01;Maanantai;1;0;1
93;06.07.2015;2015;07;02;Maanantai;0;0;0
93;06.07.2015;2015;07;03;Maanantai;0;0;0
93;06.07.2015;2015;07;04;Maanantai;0;0;0
93;06.07.2015;2015;07;05;Maanantai;5;5;10
93;06.07.2015;2015;07;06;Maanantai;20;14;34
93;06.07.2015;2015;07;07;Maanantai;25;26;51
93;06.07.2015;2015;07;08;Maanantai;23;20;43
93;06.07.2015;2015;07;09;Maanantai;14;12;26
93;06.07.2015;2015;07;10;Maanantai;23;8;31
93;06.07.2015;2015;07;11;Maanantai;25;19;44
93;06.07.2015;2015;07;12;Maanantai;9;20;29
93;06.07.2015;2015;07;13;Maanantai;24;18;42
93;06.07.2015;2015;07;14;Maanantai;28;37;65
93;06.07.2015;2015;07;15;Maanantai;40;50;90
93;06.07.2015;2015;07;16;Maanantai;55;47;102
93;06.07.2015;2015;07;17;Maanantai;29;47;76
93;06.07.2015;2015;07;18;Maanantai;40;48;88
93;06.07.2015;2015;07;19;Maanantai;46;35;81
93;06.07.2015;2015;07;20;Maanantai;20;19;39
93;06.07.2015;2015;07;21;Maanantai;13;26;39
93;06.07.2015;2015;07;22;Maanantai;11;9;20
93;06.07.2015;2015;07;23;Maanantai;3;6;9
93;07.07.2015;2015;07;00;Tiistai;2;3;5
93;07.07.2015;2015;07;01;Tiistai;0;2;2
93;07.07.2015;2015;07;02;Tiistai;0;1;1
93;07.07.2015;2015;07;03;Tiistai;0;0;0
93;07.07.2015;2015;07;04;Tiistai;1;0;1
93;07.07.2015;2015;07;05;Tiistai;7;2;9
93;07.07.2015;2015;07;06;Tiistai;21;14;35
93;07.07.2015;2015;07;07;Tiistai;27;21;48
93;07.07.2015;2015;07;08;Tiistai;15;23;38
93;07.07.2015;2015;07;09;Tiistai;13;9;22
93;07.07.2015;2015;07;10;Tiistai;17;18;35
93;07.07.2015;2015;07;11;Tiistai;10;12;22
93;07.07.2015;2015;07;12;Tiistai;6;9;15
93;07.07.2015;2015;07;13;Tiistai;17;10;27
93;07.07.2015;2015;07;14;Tiistai;22;20;42
93;07.07.2015;2015;07;15;Tiistai;34;27;61
93;07.07.2015;2015;07;16;Tiistai;37;40;77
93;07.07.2015;2015;07;17;Tiistai;33;36;69
93;07.07.2015;2015;07;18;Tiistai;36;29;65
93;07.07.2015;2015;07;19;Tiistai;23;31;54
93;07.07.2015;2015;07;20;Tiistai;13;30;43
93;07.07.2015;2015;07;21;Tiistai;11;21;32
93;07.07.2015;2015;07;22;Tiistai;8;3;11
93;07.07.2015;2015;07;23;Tiistai;4;4;8
93;08.07.2015;2015;07;00;Keskiviikko;2;7;9
93;08.07.2015;2015;07;01;Keskiviikko;0;0;0
93;08.07.2015;2015;07;02;Keskiviikko;1;1;2
93;08.07.2015;2015;07;03;Keskiviikko;0;1;1
93;08.07.2015;2015;07;04;Keskiviikko;0;1;1
93;08.07.2015;2015;07;05;Keskiviikko;5;3;8
93;08.07.2015;2015;07;06;Keskiviikko;15;10;25
93;08.07.2015;2015;07;07;Keskiviikko;29;34;63
93;08.07.2015;2015;07;08;Keskiviikko;10;16;26
93;08.07.2015;2015;07;09;Keskiviikko;17;10;27
93;08.07.2015;2015;07;10;Keskiviikko;12;13;25
93;08.07.2015;2015;07;11;Keskiviikko;8;17;25
93;08.07.2015;2015;07;12;Keskiviikko;23;12;35
93;08.07.2015;2015;07;13;Keskiviikko;18;22;40
93;08.07.2015;2015;07;14;Keskiviikko;16;31;47
93;08.07.2015;2015;07;15;Keskiviikko;35;23;58
93;08.07.2015;2015;07;16;Keskiviikko;25;32;57
93;08.07.2015;2015;07;17;Keskiviikko;20;32;52
93;08.07.2015;2015;07;18;Keskiviikko;15;34;49
93;08.07.2015;2015;07;19;Keskiviikko;24;19;43
93;08.07.2015;2015;07;20;Keskiviikko;17;23;40
93;08.07.2015;2015;07;21;Keskiviikko;7;13;20
93;08.07.2015;2015;07;22;Keskiviikko;12;14;26
93;08.07.2015;2015;07;23;Keskiviikko;1;1;2
93;09.07.2015;2015;07;00;Torstai;3;3;6
93;09.07.2015;2015;07;01;Torstai;1;0;1
93;09.07.2015;2015;07;02;Torstai;0;3;3
93;09.07.2015;2015;07;03;Torstai;0;2;2
93;09.07.2015;2015;07;04;Torstai;0;1;1
93;09.07.2015;2015;07;05;Torstai;3;2;5
93;09.07.2015;2015;07;06;Torstai;9;5;14
93;09.07.2015;2015;07;07;Torstai;15;15;30
93;09.07.2015;2015;07;08;Torstai;7;8;15
93;09.07.2015;2015;07;09;Torstai;5;5;10
93;09.07.2015;2015;07;10;Torstai;7;9;16
93;09.07.2015;2015;07;11;Torstai;5;7;12
93;09.07.2015;2015;07;12;Torstai;5;3;8
93;09.07.2015;2015;07;13;Torstai;0;3;3
93;09.07.2015;2015;07;14;Torstai;6;7;13
93;09.07.2015;2015;07;15;Torstai;14;13;27
93;09.07.2015;2015;07;16;Torstai;14;16;30
93;09.07.2015;2015;07;17;Torstai;11;12;23
93;09.07.2015;2015;07;18;Torstai;16;8;24
93;09.07.2015;2015;07;19;Torstai;9;10;19
93;09.07.2015;2015;07;20;Torstai;5;14;19
93;09.07.2015;2015;07;21;Torstai;4;5;9
93;09.07.2015;2015;07;22;Torstai;5;0;5
93;09.07.2015;2015;07;23;Torstai;0;0;0
93;10.07.2015;2015;07;00;Perjantai;0;1;1
93;10.07.2015;2015;07;01;Perjantai;2;0;2
93;10.07.2015;2015;07;02;Perjantai;0;2;2
93;10.07.2015;2015;07;03;Perjantai;0;1;1
93;10.07.2015;2015;07;04;Perjantai;0;0;0
93;10.07.2015;2015;07;05;Perjantai;2;2;4
93;10.07.2015;2015;07;06;Perjantai;10;5;15
93;10.07.2015;2015;07;07;Perjantai;11;13;24
93;10.07.2015;2015;07;08;Perjantai;5;11;16
93;10.07.2015;2015;07;09;Perjantai;8;3;11
93;10.07.2015;2015;07;10;Perjantai;12;2;14
93;10.07.2015;2015;07;11;Perjantai;12;11;23
93;10.07.2015;2015;07;12;Perjantai;15;11;26
93;10.07.2015;2015;07;13;Perjantai;27;25;52
93;10.07.2015;2015;07;14;Perjantai;16;16;32
93;10.07.2015;2015;07;15;Perjantai;30;30;60
93;10.07.2015;2015;07;16;Perjantai;27;24;51
93;10.07.2015;2015;07;17;Perjantai;14;18;32
93;10.07.2015;2015;07;18;Perjantai;19;29;48
93;10.07.2015;2015;07;19;Perjantai;14;26;40
93;10.07.2015;2015;07;20;Perjantai;18;21;39
93;10.07.2015;2015;07;21;Perjantai;2;4;6
93;10.07.2015;2015;07;22;Perjantai;3;4;7
93;10.07.2015;2015;07;23;Perjantai;4;0;4
93;11.07.2015;2015;07;00;Lauantai;1;2;3
93;11.07.2015;2015;07;01;Lauantai;0;5;5
93;11.07.2015;2015;07;02;Lauantai;0;1;1
93;11.07.2015;2015;07;03;Lauantai;2;1;3
93;11.07.2015;2015;07;04;Lauantai;1;1;2
93;11.07.2015;2015;07;05;Lauantai;1;0;1
93;11.07.2015;2015;07;06;Lauantai;3;2;5
93;11.07.2015;2015;07;07;Lauantai;5;5;10
93;11.07.2015;2015;07;08;Lauantai;5;6;11
93;11.07.2015;2015;07;09;Lauantai;9;12;21
93;11.07.2015;2015;07;10;Lauantai;16;15;31
93;11.07.2015;2015;07;11;Lauantai;26;26;52
93;11.07.2015;2015;07;12;Lauantai;21;13;34
93;11.07.2015;2015;07;13;Lauantai;15;32;47
93;11.07.2015;2015;07;14;Lauantai;24;31;55
93;11.07.2015;2015;07;15;Lauantai;19;19;38
93;11.07.2015;2015;07;16;Lauantai;32;18;50
93;11.07.2015;2015;07;17;Lauantai;19;21;40
93;11.07.2015;2015;07;18;Lauantai;15;8;23
93;11.07.2015;2015;07;19;Lauantai;9;10;19
93;11.07.2015;2015;07;20;Lauantai;15;10;25
93;11.07.2015;2015;07;21;Lauantai;7;12;19
93;11.07.2015;2015;07;22;Lauantai;10;5;15
93;11.07.2015;2015;07;23;Lauantai;0;5;5
93;12.07.2015;2015;07;00;Sunnuntai;2;5;7
93;12.07.2015;2015;07;01;Sunnuntai;1;2;3
93;12.07.2015;2015;07;02;Sunnuntai;1;2;3
93;12.07.2015;2015;07;03;Sunnuntai;0;0;0
93;12.07.2015;2015;07;04;Sunnuntai;0;5;5
93;12.07.2015;2015;07;05;Sunnuntai;0;0;0
93;12.07.2015;2015;07;06;Sunnuntai;0;0;0
93;12.07.2015;2015;07;07;Sunnuntai;2;2;4
93;12.07.2015;2015;07;08;Sunnuntai;5;2;7
93;12.07.2015;2015;07;09;Sunnuntai;7;8;15
93;12.07.2015;2015;07;10;Sunnuntai;9;16;25
93;12.07.2015;2015;07;11;Sunnuntai;32;24;56
93;12.07.2015;2015;07;12;Sunnuntai;24;18;42
93;12.07.2015;2015;07;13;Sunnuntai;26;23;49
93;12.07.2015;2015;07;14;Sunnuntai;35;31;66
93;12.07.2015;2015;07;15;Sunnuntai;19;31;50
93;12.07.2015;2015;07;16;Sunnuntai;24;23;47
93;12.07.2015;2015;07;17;Sunnuntai;30;34;64
93;12.07.2015;2015;07;18;Sunnuntai;21;33;54
93;12.07.2015;2015;07;19;Sunnuntai;31;12;43
93;12.07.2015;2015;07;20;Sunnuntai;23;12;35
93;12.07.2015;2015;07;21;Sunnuntai;4;5;9
93;12.07.2015;2015;07;22;Sunnuntai;6;4;10
93;12.07.2015;2015;07;23;Sunnuntai;2;3;5
93;13.07.2015;2015;07;00;Maanantai;2;1;3
93;13.07.2015;2015;07;01;Maanantai;0;1;1
93;13.07.2015;2015;07;02;Maanantai;0;0;0
93;13.07.2015;2015;07;03;Maanantai;0;0;0
93;13.07.2015;2015;07;04;Maanantai;0;0;0
93;13.07.2015;2015;07;05;Maanantai;3;2;5
93;13.07.2015;2015;07;06;Maanantai;22;9;31
93;13.07.2015;2015;07;07;Maanantai;23;18;41
93;13.07.2015;2015;07;08;Maanantai;18;18;36
93;13.07.2015;2015;07;09;Maanantai;14;9;23
93;13.07.2015;2015;07;10;Maanantai;13;9;22
93;13.07.2015;2015;07;11;Maanantai;11;8;19
93;13.07.2015;2015;07;12;Maanantai;22;15;37
93;13.07.2015;2015;07;13;Maanantai;13;11;24
93;13.07.2015;2015;07;14;Maanantai;15;13;28
93;13.07.2015;2015;07;15;Maanantai;23;30;53
93;13.07.2015;2015;07;16;Maanantai;26;60;86
93;13.07.2015;2015;07;17;Maanantai;37;34;71
93;13.07.2015;2015;07;18;Maanantai;26;24;50
93;13.07.2015;2015;07;19;Maanantai;33;31;64
93;13.07.2015;2015;07;20;Maanantai;11;22;33
93;13.07.2015;2015;07;21;Maanantai;14;11;25
93;13.07.2015;2015;07;22;Maanantai;8;9;17
93;13.07.2015;2015;07;23;Maanantai;1;3;4
93;14.07.2015;2015;07;00;Tiistai;2;1;3
93;14.07.2015;2015;07;01;Tiistai;0;1;1
93;14.07.2015;2015;07;02;Tiistai;0;0;0
93;14.07.2015;2015;07;03;Tiistai;1;0;1
93;14.07.2015;2015;07;04;Tiistai;0;1;1
93;14.07.2015;2015;07;05;Tiistai;2;3;5
93;14.07.2015;2015;07;06;Tiistai;23;12;35
93;14.07.2015;2015;07;07;Tiistai;17;22;39
93;14.07.2015;2015;07;08;Tiistai;16;18;34
93;14.07.2015;2015;07;09;Tiistai;22;10;32
93;14.07.2015;2015;07;10;Tiistai;20;18;38
93;14.07.2015;2015;07;11;Tiistai;12;20;32
93;14.07.2015;2015;07;12;Tiistai;17;23;40
93;14.07.2015;2015;07;13;Tiistai;17;26;43
93;14.07.2015;2015;07;14;Tiistai;19;26;45
93;14.07.2015;2015;07;15;Tiistai;26;34;60
93;14.07.2015;2015;07;16;Tiistai;39;44;83
93;14.07.2015;2015;07;17;Tiistai;36;31;67
93;14.07.2015;2015;07;18;Tiistai;27;21;48
93;14.07.2015;2015;07;19;Tiistai;28;36;64
93;14.07.2015;2015;07;20;Tiistai;23;33;56
93;14.07.2015;2015;07;21;Tiistai;17;10;27
93;14.07.2015;2015;07;22;Tiistai;5;10;15
93;14.07.2015;2015;07;23;Tiistai;1;3;4
93;15.07.2015;2015;07;00;Keskiviikko;0;0;0
93;15.07.2015;2015;07;01;Keskiviikko;0;0;0
93;15.07.2015;2015;07;02;Keskiviikko;0;0;0
93;15.07.2015;2015;07;03;Keskiviikko;0;1;1
93;15.07.2015;2015;07;04;Keskiviikko;0;0;0
93;15.07.2015;2015;07;05;Keskiviikko;2;3;5
93;15.07.2015;2015;07;06;Keskiviikko;18;10;28
93;15.07.2015;2015;07;07;Keskiviikko;24;27;51
93;15.07.2015;2015;07;08;Keskiviikko;23;16;39
93;15.07.2015;2015;07;09;Keskiviikko;10;8;18
93;15.07.2015;2015;07;10;Keskiviikko;5;10;15
93;15.07.2015;2015;07;11;Keskiviikko;18;16;34
93;15.07.2015;2015;07;12;Keskiviikko;24;21;45
93;15.07.2015;2015;07;13;Keskiviikko;15;15;30
93;15.07.2015;2015;07;14;Keskiviikko;26;21;47
93;15.07.2015;2015;07;15;Keskiviikko;24;33;57
93;15.07.2015;2015;07;16;Keskiviikko;41;43;84
93;15.07.2015;2015;07;17;Keskiviikko;37;43;80
93;15.07.2015;2015;07;18;Keskiviikko;25;32;57
93;15.07.2015;2015;07;19;Keskiviikko;28;33;61
93;15.07.2015;2015;07;20;Keskiviikko;17;22;39
93;15.07.2015;2015;07;21;Keskiviikko;17;14;31
93;15.07.2015;2015;07;22;Keskiviikko;10;9;19
93;15.07.2015;2015;07;23;Keskiviikko;0;5;5
93;16.07.2015;2015;07;00;Torstai;0;1;1
93;16.07.2015;2015;07;01;Torstai;0;4;4
93;16.07.2015;2015;07;02;Torstai;0;2;2
93;16.07.2015;2015;07;03;Torstai;1;0;1
93;16.07.2015;2015;07;04;Torstai;0;2;2
93;16.07.2015;2015;07;05;Torstai;3;2;5
93;16.07.2015;2015;07;06;Torstai;13;5;18
93;16.07.2015;2015;07;07;Torstai;13;17;30
93;16.07.2015;2015;07;08;Torstai;9;11;20
93;16.07.2015;2015;07;09;Torstai;5;5;10
93;16.07.2015;2015;07;10;Torstai;10;6;16
93;16.07.2015;2015;07;11;Torstai;6;14;20
93;16.07.2015;2015;07;12;Torstai;12;9;21
93;16.07.2015;2015;07;13;Torstai;5;15;20
93;16.07.2015;2015;07;14;Torstai;24;14;38
93;16.07.2015;2015;07;15;Torstai;19;20;39
93;16.07.2015;2015;07;16;Torstai;27;29;56
93;16.07.2015;2015;07;17;Torstai;20;27;47
93;16.07.2015;2015;07;18;Torstai;19;24;43
93;16.07.2015;2015;07;19;Torstai;21;20;41
93;16.07.2015;2015;07;20;Torstai;12;16;28
93;16.07.2015;2015;07;21;Torstai;11;10;21
93;16.07.2015;2015;07;22;Torstai;4;8;12
93;16.07.2015;2015;07;23;Torstai;2;1;3
93;17.07.2015;2015;07;00;Perjantai;0;3;3
93;17.07.2015;2015;07;01;Perjantai;0;0;0
93;17.07.2015;2015;07;02;Perjantai;0;1;1
93;17.07.2015;2015;07;03;Perjantai;1;1;2
93;17.07.2015;2015;07;04;Perjantai;0;0;0
93;17.07.2015;2015;07;05;Perjantai;2;3;5
93;17.07.2015;2015;07;06;Perjantai;17;10;27
93;17.07.2015;2015;07;07;Perjantai;19;21;40
93;17.07.2015;2015;07;08;Perjantai;7;8;15
93;17.07.2015;2015;07;09;Perjantai;18;11;29
93;17.07.2015;2015;07;10;Perjantai;22;11;33
93;17.07.2015;2015;07;11;Perjantai;20;12;32
93;17.07.2015;2015;07;12;Perjantai;39;18;57
93;17.07.2015;2015;07;13;Perjantai;20;32;52
93;17.07.2015;2015;07;14;Perjantai;28;39;67
93;17.07.2015;2015;07;15;Perjantai;40;27;67
93;17.07.2015;2015;07;16;Perjantai;29;46;75
93;17.07.2015;2015;07;17;Perjantai;24;31;55
93;17.07.2015;2015;07;18;Perjantai;35;27;62
93;17.07.2015;2015;07;19;Perjantai;24;29;53
93;17.07.2015;2015;07;20;Perjantai;24;23;47
93;17.07.2015;2015;07;21;Perjantai;4;13;17
93;17.07.2015;2015;07;22;Perjantai;7;6;13
93;17.07.2015;2015;07;23;Perjantai;3;6;9
93;18.07.2015;2015;07;00;Lauantai;0;0;0
93;18.07.2015;2015;07;01;Lauantai;1;4;5
93;18.07.2015;2015;07;02;Lauantai;1;1;2
93;18.07.2015;2015;07;03;Lauantai;0;2;2
93;18.07.2015;2015;07;04;Lauantai;1;2;3
93;18.07.2015;2015;07;05;Lauantai;0;1;1
93;18.07.2015;2015;07;06;Lauantai;1;3;4
93;18.07.2015;2015;07;07;Lauantai;3;4;7
93;18.07.2015;2015;07;08;Lauantai;10;6;16
93;18.07.2015;2015;07;09;Lauantai;4;6;10
93;18.07.2015;2015;07;10;Lauantai;23;12;35
93;18.07.2015;2015;07;11;Lauantai;19;30;49
93;18.07.2015;2015;07;12;Lauantai;41;30;71
93;18.07.2015;2015;07;13;Lauantai;44;36;80
93;18.07.2015;2015;07;14;Lauantai;44;19;63
93;18.07.2015;2015;07;15;Lauantai;42;37;79
93;18.07.2015;2015;07;16;Lauantai;28;32;60
93;18.07.2015;2015;07;17;Lauantai;31;27;58
93;18.07.2015;2015;07;18;Lauantai;21;37;58
93;18.07.2015;2015;07;19;Lauantai;23;25;48
93;18.07.2015;2015;07;20;Lauantai;14;12;26
93;18.07.2015;2015;07;21;Lauantai;3;13;16
93;18.07.2015;2015;07;22;Lauantai;0;3;3
93;18.07.2015;2015;07;23;Lauantai;1;6;7
93;19.07.2015;2015;07;00;Sunnuntai;0;3;3
93;19.07.2015;2015;07;01;Sunnuntai;1;3;4
93;19.07.2015;2015;07;02;Sunnuntai;0;0;0
93;19.07.2015;2015;07;03;Sunnuntai;1;1;2
93;19.07.2015;2015;07;04;Sunnuntai;0;1;1
93;19.07.2015;2015;07;05;Sunnuntai;0;1;1
93;19.07.2015;2015;07;06;Sunnuntai;2;2;4
93;19.07.2015;2015;07;07;Sunnuntai;3;4;7
93;19.07.2015;2015;07;08;Sunnuntai;1;8;9
93;19.07.2015;2015;07;09;Sunnuntai;13;2;15
93;19.07.2015;2015;07;10;Sunnuntai;8;14;22
93;19.07.2015;2015;07;11;Sunnuntai;15;6;21
93;19.07.2015;2015;07;12;Sunnuntai;13;5;18
93;19.07.2015;2015;07;13;Sunnuntai;6;11;17
93;19.07.2015;2015;07;14;Sunnuntai;11;18;29
93;19.07.2015;2015;07;15;Sunnuntai;1;8;9
93;19.07.2015;2015;07;16;Sunnuntai;7;11;18
93;19.07.2015;2015;07;17;Sunnuntai;11;8;19
93;19.07.2015;2015;07;18;Sunnuntai;18;23;41
93;19.07.2015;2015;07;19;Sunnuntai;25;26;51
93;19.07.2015;2015;07;20;Sunnuntai;17;15;32
93;19.07.2015;2015;07;21;Sunnuntai;11;9;20
93;19.07.2015;2015;07;22;Sunnuntai;10;8;18
93;19.07.2015;2015;07;23;Sunnuntai;0;4;4
93;20.07.2015;2015;07;00;Maanantai;2;2;4
93;20.07.2015;2015;07;01;Maanantai;0;1;1
93;20.07.2015;2015;07;02;Maanantai;0;0;0
93;20.07.2015;2015;07;03;Maanantai;0;0;0
93;20.07.2015;2015;07;04;Maanantai;1;0;1
93;20.07.2015;2015;07;05;Maanantai;1;1;2
93;20.07.2015;2015;07;06;Maanantai;16;9;25
93;20.07.2015;2015;07;07;Maanantai;22;26;48
93;20.07.2015;2015;07;08;Maanantai;23;15;38
93;20.07.2015;2015;07;09;Maanantai;21;13;34
93;20.07.2015;2015;07;10;Maanantai;25;26;51
93;20.07.2015;2015;07;11;Maanantai;31;25;56
93;20.07.2015;2015;07;12;Maanantai;28;28;56
93;20.07.2015;2015;07;13;Maanantai;45;33;78
93;20.07.2015;2015;07;14;Maanantai;29;36;65
93;20.07.2015;2015;07;15;Maanantai;35;44;79
93;20.07.2015;2015;07;16;Maanantai;42;45;87
93;20.07.2015;2015;07;17;Maanantai;34;45;79
93;20.07.2015;2015;07;18;Maanantai;34;50;84
93;20.07.2015;2015;07;19;Maanantai;37;25;62
93;20.07.2015;2015;07;20;Maanantai;22;26;48
93;20.07.2015;2015;07;21;Maanantai;9;16;25
93;20.07.2015;2015;07;22;Maanantai;6;12;18
93;20.07.2015;2015;07;23;Maanantai;2;4;6
93;21.07.2015;2015;07;00;Tiistai;5;3;8
93;21.07.2015;2015;07;01;Tiistai;2;0;2
93;21.07.2015;2015;07;02;Tiistai;0;0;0
93;21.07.2015;2015;07;03;Tiistai;0;0;0
93;21.07.2015;2015;07;04;Tiistai;4;0;4
93;21.07.2015;2015;07;05;Tiistai;0;0;0
93;21.07.2015;2015;07;06;Tiistai;19;8;27
93;21.07.2015;2015;07;07;Tiistai;19;26;45
93;21.07.2015;2015;07;08;Tiistai;13;15;28
93;21.07.2015;2015;07;09;Tiistai;7;11;18
93;21.07.2015;2015;07;10;Tiistai;14;6;20
93;21.07.2015;2015;07;11;Tiistai;11;14;25
93;21.07.2015;2015;07;12;Tiistai;15;12;27
93;21.07.2015;2015;07;13;Tiistai;20;23;43
93;21.07.2015;2015;07;14;Tiistai;15;24;39
93;21.07.2015;2015;07;15;Tiistai;35;26;61
93;21.07.2015;2015;07;16;Tiistai;41;34;75
93;21.07.2015;2015;07;17;Tiistai;35;38;73
93;21.07.2015;2015;07;18;Tiistai;33;31;64
93;21.07.2015;2015;07;19;Tiistai;47;41;88
93;21.07.2015;2015;07;20;Tiistai;21;43;64
93;21.07.2015;2015;07;21;Tiistai;8;17;25
93;21.07.2015;2015;07;22;Tiistai;3;3;6
93;21.07.2015;2015;07;23;Tiistai;4;6;10
93;22.07.2015;2015;07;00;Keskiviikko;2;1;3
93;22.07.2015;2015;07;01;Keskiviikko;1;0;1
93;22.07.2015;2015;07;02;Keskiviikko;1;0;1
93;22.07.2015;2015;07;03;Keskiviikko;0;0;0
93;22.07.2015;2015;07;04;Keskiviikko;7;1;8
93;22.07.2015;2015;07;05;Keskiviikko;2;4;6
93;22.07.2015;2015;07;06;Keskiviikko;17;10;27
93;22.07.2015;2015;07;07;Keskiviikko;23;20;43
93;22.07.2015;2015;07;08;Keskiviikko;17;16;33
93;22.07.2015;2015;07;09;Keskiviikko;8;9;17
93;22.07.2015;2015;07;10;Keskiviikko;20;21;41
93;22.07.2015;2015;07;11;Keskiviikko;32;18;50
93;22.07.2015;2015;07;12;Keskiviikko;17;23;40
93;22.07.2015;2015;07;13;Keskiviikko;12;21;33
93;22.07.2015;2015;07;14;Keskiviikko;21;29;50
93;22.07.2015;2015;07;15;Keskiviikko;27;35;62
93;22.07.2015;2015;07;16;Keskiviikko;43;38;81
93;22.07.2015;2015;07;17;Keskiviikko;40;44;84
93;22.07.2015;2015;07;18;Keskiviikko;23;45;68
93;22.07.2015;2015;07;19;Keskiviikko;40;41;81
93;22.07.2015;2015;07;20;Keskiviikko;16;22;38
93;22.07.2015;2015;07;21;Keskiviikko;7;12;19
93;22.07.2015;2015;07;22;Keskiviikko;9;12;21
93;22.07.2015;2015;07;23;Keskiviikko;5;2;7
93;23.07.2015;2015;07;00;Torstai;0;1;1
93;23.07.2015;2015;07;01;Torstai;1;1;2
93;23.07.2015;2015;07;02;Torstai;1;1;2
93;23.07.2015;2015;07;03;Torstai;0;0;0
93;23.07.2015;2015;07;04;Torstai;1;1;2
93;23.07.2015;2015;07;05;Torstai;3;3;6
93;23.07.2015;2015;07;06;Torstai;17;9;26
93;23.07.2015;2015;07;07;Torstai;22;20;42
93;23.07.2015;2015;07;08;Torstai;23;15;38
93;23.07.2015;2015;07;09;Torstai;8;15;23
93;23.07.2015;2015;07;10;Torstai;26;17;43
93;23.07.2015;2015;07;11;Torstai;27;37;64
93;23.07.2015;2015;07;12;Torstai;30;32;62
93;23.07.2015;2015;07;13;Torstai;35;29;64
93;23.07.2015;2015;07;14;Torstai;9;27;36
93;23.07.2015;2015;07;15;Torstai;40;41;81
93;23.07.2015;2015;07;16;Torstai;38;43;81
93;23.07.2015;2015;07;17;Torstai;23;31;54
93;23.07.2015;2015;07;18;Torstai;14;23;37
93;23.07.2015;2015;07;19;Torstai;9;13;22
93;23.07.2015;2015;07;20;Torstai;8;10;18
93;23.07.2015;2015;07;21;Torstai;5;7;12
93;23.07.2015;2015;07;22;Torstai;4;8;12
93;23.07.2015;2015;07;23;Torstai;5;0;5
93;24.07.2015;2015;07;00;Perjantai;0;1;1
93;24.07.2015;2015;07;01;Perjantai;0;0;0
93;24.07.2015;2015;07;02;Perjantai;0;2;2
93;24.07.2015;2015;07;03;Perjantai;1;0;1
93;24.07.2015;2015;07;04;Perjantai;0;0;0
93;24.07.2015;2015;07;05;Perjantai;0;1;1
93;24.07.2015;2015;07;06;Perjantai;2;3;5
93;24.07.2015;2015;07;07;Perjantai;6;10;16
93;24.07.2015;2015;07;08;Perjantai;5;8;13
93;24.07.2015;2015;07;09;Perjantai;3;6;9
93;24.07.2015;2015;07;10;Perjantai;5;6;11
93;24.07.2015;2015;07;11;Perjantai;12;3;15
93;24.07.2015;2015;07;12;Perjantai;10;7;17
93;24.07.2015;2015;07;13;Perjantai;8;7;15
93;24.07.2015;2015;07;14;Perjantai;8;2;10
93;24.07.2015;2015;07;15;Perjantai;21;17;38
93;24.07.2015;2015;07;16;Perjantai;12;13;25
93;24.07.2015;2015;07;17;Perjantai;10;10;20
93;24.07.2015;2015;07;18;Perjantai;13;15;28
93;24.07.2015;2015;07;19;Perjantai;15;12;27
93;24.07.2015;2015;07;20;Perjantai;14;9;23
93;24.07.2015;2015;07;21;Perjantai;8;6;14
93;24.07.2015;2015;07;22;Perjantai;7;9;16
93;24.07.2015;2015;07;23;Perjantai;2;12;14
93;25.07.2015;2015;07;00;Lauantai;1;10;11
93;25.07.2015;2015;07;01;Lauantai;0;10;10
93;25.07.2015;2015;07;02;Lauantai;0;14;14
93;25.07.2015;2015;07;03;Lauantai;0;2;2
93;25.07.2015;2015;07;04;Lauantai;0;1;1
93;25.07.2015;2015;07;05;Lauantai;0;2;2
93;25.07.2015;2015;07;06;Lauantai;4;1;5
93;25.07.2015;2015;07;07;Lauantai;4;2;6
93;25.07.2015;2015;07;08;Lauantai;2;6;8
93;25.07.2015;2015;07;09;Lauantai;7;10;17
93;25.07.2015;2015;07;10;Lauantai;11;14;25
93;25.07.2015;2015;07;11;Lauantai;10;11;21
93;25.07.2015;2015;07;12;Lauantai;25;30;55
93;25.07.2015;2015;07;13;Lauantai;23;20;43
93;25.07.2015;2015;07;14;Lauantai;31;22;53
93;25.07.2015;2015;07;15;Lauantai;26;23;49
93;25.07.2015;2015;07;16;Lauantai;27;16;43
93;25.07.2015;2015;07;17;Lauantai;30;23;53
93;25.07.2015;2015;07;18;Lauantai;34;20;54
93;25.07.2015;2015;07;19;Lauantai;28;20;48
93;25.07.2015;2015;07;20;Lauantai;23;15;38
93;25.07.2015;2015;07;21;Lauantai;14;11;25
93;25.07.2015;2015;07;22;Lauantai;6;6;12
93;25.07.2015;2015;07;23;Lauantai;8;14;22
93;26.07.2015;2015;07;00;Sunnuntai;0;20;20
93;26.07.2015;2015;07;01;Sunnuntai;0;14;14
93;26.07.2015;2015;07;02;Sunnuntai;1;17;18
93;26.07.2015;2015;07;03;Sunnuntai;1;2;3
93;26.07.2015;2015;07;04;Sunnuntai;1;12;13
93;26.07.2015;2015;07;05;Sunnuntai;2;5;7
93;26.07.2015;2015;07;06;Sunnuntai;1;2;3
93;26.07.2015;2015;07;07;Sunnuntai;4;2;6
93;26.07.2015;2015;07;08;Sunnuntai;4;5;9
93;26.07.2015;2015;07;09;Sunnuntai;10;4;14
93;26.07.2015;2015;07;10;Sunnuntai;10;15;25
93;26.07.2015;2015;07;11;Sunnuntai;29;16;45
93;26.07.2015;2015;07;12;Sunnuntai;31;13;44
93;26.07.2015;2015;07;13;Sunnuntai;21;19;40
93;26.07.2015;2015;07;14;Sunnuntai;10;27;37
93;26.07.2015;2015;07;15;Sunnuntai;8;14;22
93;26.07.2015;2015;07;16;Sunnuntai;5;16;21
93;26.07.2015;2015;07;17;Sunnuntai;6;8;14
93;26.07.2015;2015;07;18;Sunnuntai;13;10;23
93;26.07.2015;2015;07;19;Sunnuntai;7;3;10
93;26.07.2015;2015;07;20;Sunnuntai;2;6;8
93;26.07.2015;2015;07;21;Sunnuntai;6;5;11
93;26.07.2015;2015;07;22;Sunnuntai;2;1;3
93;26.07.2015;2015;07;23;Sunnuntai;3;4;7
93;27.07.2015;2015;07;00;Maanantai;1;0;1
93;27.07.2015;2015;07;01;Maanantai;0;0;0
93;27.07.2015;2015;07;02;Maanantai;0;0;0
93;27.07.2015;2015;07;03;Maanantai;0;0;0
93;27.07.2015;2015;07;04;Maanantai;0;0;0
93;27.07.2015;2015;07;05;Maanantai;4;4;8
93;27.07.2015;2015;07;06;Maanantai;11;2;13
93;27.07.2015;2015;07;07;Maanantai;14;14;28
93;27.07.2015;2015;07;08;Maanantai;11;11;22
93;27.07.2015;2015;07;09;Maanantai;3;5;8
93;27.07.2015;2015;07;10;Maanantai;5;2;7
93;27.07.2015;2015;07;11;Maanantai;7;6;13
93;27.07.2015;2015;07;12;Maanantai;10;11;21
93;27.07.2015;2015;07;13;Maanantai;14;9;23
93;27.07.2015;2015;07;14;Maanantai;17;18;35
93;27.07.2015;2015;07;15;Maanantai;26;28;54
93;27.07.2015;2015;07;16;Maanantai;18;33;51
93;27.07.2015;2015;07;17;Maanantai;23;28;51
93;27.07.2015;2015;07;18;Maanantai;23;32;55
93;27.07.2015;2015;07;19;Maanantai;26;27;53
93;27.07.2015;2015;07;20;Maanantai;13;16;29
93;27.07.2015;2015;07;21;Maanantai;7;13;20
93;27.07.2015;2015;07;22;Maanantai;3;9;12
93;27.07.2015;2015;07;23;Maanantai;6;2;8
93;28.07.2015;2015;07;00;Tiistai;4;8;12
93;28.07.2015;2015;07;01;Tiistai;2;3;5
93;28.07.2015;2015;07;02;Tiistai;0;5;5
93;28.07.2015;2015;07;03;Tiistai;3;0;3
93;28.07.2015;2015;07;04;Tiistai;0;1;1
93;28.07.2015;2015;07;05;Tiistai;3;5;8
93;28.07.2015;2015;07;06;Tiistai;17;9;26
93;28.07.2015;2015;07;07;Tiistai;25;26;51
93;28.07.2015;2015;07;08;Tiistai;14;16;30
93;28.07.2015;2015;07;09;Tiistai;17;11;28
93;28.07.2015;2015;07;10;Tiistai;11;21;32
93;28.07.2015;2015;07;11;Tiistai;16;20;36
93;28.07.2015;2015;07;12;Tiistai;16;25;41
93;28.07.2015;2015;07;13;Tiistai;5;7;12
93;28.07.2015;2015;07;14;Tiistai;29;33;62
93;28.07.2015;2015;07;15;Tiistai;55;34;89
93;28.07.2015;2015;07;16;Tiistai;46;57;103
93;28.07.2015;2015;07;17;Tiistai;36;35;71
93;28.07.2015;2015;07;18;Tiistai;19;38;57
93;28.07.2015;2015;07;19;Tiistai;29;40;69
93;28.07.2015;2015;07;20;Tiistai;22;25;47
93;28.07.2015;2015;07;21;Tiistai;8;18;26
93;28.07.2015;2015;07;22;Tiistai;6;10;16
93;28.07.2015;2015;07;23;Tiistai;3;9;12
93;29.07.2015;2015;07;00;Keskiviikko;1;4;5
93;29.07.2015;2015;07;01;Keskiviikko;3;0;3
93;29.07.2015;2015;07;02;Keskiviikko;2;0;2
93;29.07.2015;2015;07;03;Keskiviikko;0;1;1
93;29.07.2015;2015;07;04;Keskiviikko;0;2;2
93;29.07.2015;2015;07;05;Keskiviikko;2;3;5
93;29.07.2015;2015;07;06;Keskiviikko;16;3;19
93;29.07.2015;2015;07;07;Keskiviikko;27;39;66
93;29.07.2015;2015;07;08;Keskiviikko;17;17;34
93;29.07.2015;2015;07;09;Keskiviikko;16;14;30
93;29.07.2015;2015;07;10;Keskiviikko;20;24;44
93;29.07.2015;2015;07;11;Keskiviikko;24;22;46
93;29.07.2015;2015;07;12;Keskiviikko;24;23;47
93;29.07.2015;2015;07;13;Keskiviikko;32;17;49
93;29.07.2015;2015;07;14;Keskiviikko;32;16;48
93;29.07.2015;2015;07;15;Keskiviikko;36;33;69
93;29.07.2015;2015;07;16;Keskiviikko;26;40;66
93;29.07.2015;2015;07;17;Keskiviikko;16;24;40
93;29.07.2015;2015;07;18;Keskiviikko;8;8;16
93;29.07.2015;2015;07;19;Keskiviikko;7;15;22
93;29.07.2015;2015;07;20;Keskiviikko;6;14;20
93;29.07.2015;2015;07;21;Keskiviikko;2;4;6
93;29.07.2015;2015;07;22;Keskiviikko;3;3;6
93;29.07.2015;2015;07;23;Keskiviikko;2;0;2
93;30.07.2015;2015;07;00;Torstai;0;3;3
93;30.07.2015;2015;07;01;Torstai;0;1;1
93;30.07.2015;2015;07;02;Torstai;6;0;6
93;30.07.2015;2015;07;03;Torstai;0;3;3
93;30.07.2015;2015;07;04;Torstai;0;1;1
93;30.07.2015;2015;07;05;Torstai;4;6;10
93;30.07.2015;2015;07;06;Torstai;12;1;13
93;30.07.2015;2015;07;07;Torstai;20;25;45
93;30.07.2015;2015;07;08;Torstai;8;18;26
93;30.07.2015;2015;07;09;Torstai;14;7;21
93;30.07.2015;2015;07;10;Torstai;21;12;33
93;30.07.2015;2015;07;11;Torstai;13;10;23
93;30.07.2015;2015;07;12;Torstai;33;20;53
93;30.07.2015;2015;07;13;Torstai;18;23;41
93;30.07.2015;2015;07;14;Torstai;31;19;50
93;30.07.2015;2015;07;15;Torstai;18;42;60
93;30.07.2015;2015;07;16;Torstai;50;36;86
93;30.07.2015;2015;07;17;Torstai;47;41;88
93;30.07.2015;2015;07;18;Torstai;26;38;64
93;30.07.2015;2015;07;19;Torstai;36;52;88
93;30.07.2015;2015;07;20;Torstai;31;23;54
93;30.07.2015;2015;07;21;Torstai;14;25;39
93;30.07.2015;2015;07;22;Torstai;7;10;17
93;30.07.2015;2015;07;23;Torstai;4;7;11
93;31.07.2015;2015;07;00;Perjantai;1;1;2
93;31.07.2015;2015;07;01;Perjantai;0;0;0
93;31.07.2015;2015;07;02;Perjantai;0;4;4
93;31.07.2015;2015;07;03;Perjantai;0;0;0
93;31.07.2015;2015;07;04;Perjantai;0;2;2
93;31.07.2015;2015;07;05;Perjantai;2;5;7
93;31.07.2015;2015;07;06;Perjantai;15;4;19
93;31.07.2015;2015;07;07;Perjantai;13;23;36
93;31.07.2015;2015;07;08;Perjantai;14;16;30
93;31.07.2015;2015;07;09;Perjantai;9;13;22
93;31.07.2015;2015;07;10;Perjantai;24;17;41
93;31.07.2015;2015;07;11;Perjantai;30;11;41
93;31.07.2015;2015;07;12;Perjantai;16;14;30
93;31.07.2015;2015;07;13;Perjantai;21;8;29
93;31.07.2015;2015;07;14;Perjantai;15;23;38
93;31.07.2015;2015;07;15;Perjantai;26;33;59
93;31.07.2015;2015;07;16;Perjantai;30;34;64
93;31.07.2015;2015;07;17;Perjantai;15;22;37
93;31.07.2015;2015;07;18;Perjantai;19;17;36
93;31.07.2015;2015;07;19;Perjantai;17;22;39
93;31.07.2015;2015;07;20;Perjantai;16;19;35
93;31.07.2015;2015;07;21;Perjantai;7;12;19
93;31.07.2015;2015;07;22;Perjantai;3;3;6
93;31.07.2015;2015;07;23;Perjantai;2;11;13
93;01.08.2015;2015;08;00;Lauantai;7;6;13
93;01.08.2015;2015;08;01;Lauantai;1;2;3
93;01.08.2015;2015;08;02;Lauantai;0;1;1
93;01.08.2015;2015;08;03;Lauantai;1;2;3
93;01.08.2015;2015;08;04;Lauantai;1;1;2
93;01.08.2015;2015;08;05;Lauantai;0;1;1
93;01.08.2015;2015;08;06;Lauantai;2;2;4
93;01.08.2015;2015;08;07;Lauantai;3;3;6
93;01.08.2015;2015;08;08;Lauantai;1;2;3
93;01.08.2015;2015;08;09;Lauantai;4;4;8
93;01.08.2015;2015;08;10;Lauantai;5;4;9
93;01.08.2015;2015;08;11;Lauantai;2;9;11
93;01.08.2015;2015;08;12;Lauantai;7;5;12
93;01.08.2015;2015;08;13;Lauantai;17;5;22
93;01.08.2015;2015;08;14;Lauantai;7;16;23
93;01.08.2015;2015;08;15;Lauantai;5;8;13
93;01.08.2015;2015;08;16;Lauantai;10;4;14
93;01.08.2015;2015;08;17;Lauantai;6;6;12
93;01.08.2015;2015;08;18;Lauantai;9;1;10
93;01.08.2015;2015;08;19;Lauantai;2;4;6
93;01.08.2015;2015;08;20;Lauantai;3;10;13
93;01.08.2015;2015;08;21;Lauantai;3;8;11
93;01.08.2015;2015;08;22;Lauantai;4;4;8
93;01.08.2015;2015;08;23;Lauantai;1;3;4
93;02.08.2015;2015;08;00;Sunnuntai;3;4;7
93;02.08.2015;2015;08;01;Sunnuntai;1;0;1
93;02.08.2015;2015;08;02;Sunnuntai;1;1;2
93;02.08.2015;2015;08;03;Sunnuntai;0;0;0
93;02.08.2015;2015;08;04;Sunnuntai;0;1;1
93;02.08.2015;2015;08;05;Sunnuntai;0;0;0
93;02.08.2015;2015;08;06;Sunnuntai;0;1;1
93;02.08.2015;2015;08;07;Sunnuntai;0;0;0
93;02.08.2015;2015;08;08;Sunnuntai;0;0;0
93;02.08.2015;2015;08;09;Sunnuntai;5;7;12
93;02.08.2015;2015;08;10;Sunnuntai;6;4;10
93;02.08.2015;2015;08;11;Sunnuntai;19;14;33
93;02.08.2015;2015;08;12;Sunnuntai;21;11;32
93;02.08.2015;2015;08;13;Sunnuntai;21;19;40
93;02.08.2015;2015;08;14;Sunnuntai;23;18;41
93;02.08.2015;2015;08;15;Sunnuntai;19;8;27
93;02.08.2015;2015;08;16;Sunnuntai;16;23;39
93;02.08.2015;2015;08;17;Sunnuntai;13;26;39
93;02.08.2015;2015;08;18;Sunnuntai;16;14;30
93;02.08.2015;2015;08;19;Sunnuntai;20;16;36
93;02.08.2015;2015;08;20;Sunnuntai;9;4;13
93;02.08.2015;2015;08;21;Sunnuntai;3;8;11
93;02.08.2015;2015;08;22;Sunnuntai;5;5;10
93;02.08.2015;2015;08;23;Sunnuntai;1;3;4
93;03.08.2015;2015;08;00;Maanantai;0;1;1
93;03.08.2015;2015;08;01;Maanantai;3;0;3
93;03.08.2015;2015;08;02;Maanantai;0;0;0
93;03.08.2015;2015;08;03;Maanantai;1;1;2
93;03.08.2015;2015;08;04;Maanantai;0;2;2
93;03.08.2015;2015;08;05;Maanantai;2;4;6
93;03.08.2015;2015;08;06;Maanantai;15;2;17
93;03.08.2015;2015;08;07;Maanantai;19;29;48
93;03.08.2015;2015;08;08;Maanantai;15;17;32
93;03.08.2015;2015;08;09;Maanantai;4;5;9
93;03.08.2015;2015;08;10;Maanantai;11;1;12
93;03.08.2015;2015;08;11;Maanantai;12;11;23
93;03.08.2015;2015;08;12;Maanantai;10;14;24
93;03.08.2015;2015;08;13;Maanantai;22;24;46
93;03.08.2015;2015;08;14;Maanantai;23;16;39
93;03.08.2015;2015;08;15;Maanantai;24;27;51
93;03.08.2015;2015;08;16;Maanantai;47;55;102
93;03.08.2015;2015;08;17;Maanantai;24;11;35
93;03.08.2015;2015;08;18;Maanantai;25;26;51
93;03.08.2015;2015;08;19;Maanantai;15;21;36
93;03.08.2015;2015;08;20;Maanantai;12;23;35
93;03.08.2015;2015;08;21;Maanantai;4;8;12
93;03.08.2015;2015;08;22;Maanantai;6;9;15
93;03.08.2015;2015;08;23;Maanantai;1;8;9
93;04.08.2015;2015;08;00;Tiistai;1;0;1
93;04.08.2015;2015;08;01;Tiistai;0;0;0
93;04.08.2015;2015;08;02;Tiistai;0;1;1
93;04.08.2015;2015;08;03;Tiistai;1;2;3
93;04.08.2015;2015;08;04;Tiistai;0;2;2
93;04.08.2015;2015;08;05;Tiistai;1;5;6
93;04.08.2015;2015;08;06;Tiistai;26;8;34
93;04.08.2015;2015;08;07;Tiistai;30;37;67
93;04.08.2015;2015;08;08;Tiistai;24;23;47
93;04.08.2015;2015;08;09;Tiistai;11;11;22
93;04.08.2015;2015;08;10;Tiistai;16;9;25
93;04.08.2015;2015;08;11;Tiistai;8;22;30
93;04.08.2015;2015;08;12;Tiistai;15;18;33
93;04.08.2015;2015;08;13;Tiistai;25;17;42
93;04.08.2015;2015;08;14;Tiistai;26;23;49
93;04.08.2015;2015;08;15;Tiistai;42;37;79
93;04.08.2015;2015;08;16;Tiistai;61;51;112
93;04.08.2015;2015;08;17;Tiistai;29;60;89
93;04.08.2015;2015;08;18;Tiistai;34;31;65
93;04.08.2015;2015;08;19;Tiistai;32;30;62
93;04.08.2015;2015;08;20;Tiistai;19;19;38
93;04.08.2015;2015;08;21;Tiistai;13;16;29
93;04.08.2015;2015;08;22;Tiistai;6;4;10
93;04.08.2015;2015;08;23;Tiistai;1;7;8
93;05.08.2015;2015;08;00;Keskiviikko;1;2;3
93;05.08.2015;2015;08;01;Keskiviikko;0;0;0
93;05.08.2015;2015;08;02;Keskiviikko;0;0;0
93;05.08.2015;2015;08;03;Keskiviikko;1;2;3
93;05.08.2015;2015;08;04;Keskiviikko;0;1;1
93;05.08.2015;2015;08;05;Keskiviikko;4;4;8
93;05.08.2015;2015;08;06;Keskiviikko;28;7;35
93;05.08.2015;2015;08;07;Keskiviikko;27;37;64
93;05.08.2015;2015;08;08;Keskiviikko;34;23;57
93;05.08.2015;2015;08;09;Keskiviikko;10;9;19
93;05.08.2015;2015;08;10;Keskiviikko;21;17;38
93;05.08.2015;2015;08;11;Keskiviikko;24;22;46
93;05.08.2015;2015;08;12;Keskiviikko;28;28;56
93;05.08.2015;2015;08;13;Keskiviikko;34;30;64
93;05.08.2015;2015;08;14;Keskiviikko;41;42;83
93;05.08.2015;2015;08;15;Keskiviikko;43;53;96
93;05.08.2015;2015;08;16;Keskiviikko;57;60;117
93;05.08.2015;2015;08;17;Keskiviikko;40;48;88
93;05.08.2015;2015;08;18;Keskiviikko;37;43;80
93;05.08.2015;2015;08;19;Keskiviikko;36;32;68
93;05.08.2015;2015;08;20;Keskiviikko;33;29;62
93;05.08.2015;2015;08;21;Keskiviikko;6;12;18
93;05.08.2015;2015;08;22;Keskiviikko;10;13;23
93;05.08.2015;2015;08;23;Keskiviikko;5;3;8
93;06.08.2015;2015;08;00;Torstai;1;0;1
93;06.08.2015;2015;08;01;Torstai;0;1;1
93;06.08.2015;2015;08;02;Torstai;4;0;4
93;06.08.2015;2015;08;03;Torstai;1;1;2
93;06.08.2015;2015;08;04;Torstai;0;1;1
93;06.08.2015;2015;08;05;Torstai;2;5;7
93;06.08.2015;2015;08;06;Torstai;19;3;22
93;06.08.2015;2015;08;07;Torstai;21;38;59
93;06.08.2015;2015;08;08;Torstai;13;18;31
93;06.08.2015;2015;08;09;Torstai;4;4;8
93;06.08.2015;2015;08;10;Torstai;5;4;9
93;06.08.2015;2015;08;11;Torstai;14;3;17
93;06.08.2015;2015;08;12;Torstai;6;3;9
93;06.08.2015;2015;08;13;Torstai;12;10;22
93;06.08.2015;2015;08;14;Torstai;14;16;30
93;06.08.2015;2015;08;15;Torstai;13;24;37
93;06.08.2015;2015;08;16;Torstai;26;23;49
93;06.08.2015;2015;08;17;Torstai;8;12;20
93;06.08.2015;2015;08;18;Torstai;12;11;23
93;06.08.2015;2015;08;19;Torstai;13;8;21
93;06.08.2015;2015;08;20;Torstai;2;9;11
93;06.08.2015;2015;08;21;Torstai;1;2;3
93;06.08.2015;2015;08;22;Torstai;2;6;8
93;06.08.2015;2015;08;23;Torstai;2;6;8
93;07.08.2015;2015;08;00;Perjantai;0;1;1
93;07.08.2015;2015;08;01;Perjantai;1;0;1
93;07.08.2015;2015;08;02;Perjantai;0;1;1
93;07.08.2015;2015;08;03;Perjantai;1;1;2
93;07.08.2015;2015;08;04;Perjantai;0;0;0
93;07.08.2015;2015;08;05;Perjantai;2;2;4
93;07.08.2015;2015;08;06;Perjantai;11;6;17
93;07.08.2015;2015;08;07;Perjantai;19;25;44
93;07.08.2015;2015;08;08;Perjantai;16;17;33
93;07.08.2015;2015;08;09;Perjantai;5;10;15
93;07.08.2015;2015;08;10;Perjantai;2;1;3
93;07.08.2015;2015;08;11;Perjantai;16;7;23
93;07.08.2015;2015;08;12;Perjantai;13;11;24
93;07.08.2015;2015;08;13;Perjantai;11;20;31
93;07.08.2015;2015;08;14;Perjantai;20;10;30
93;07.08.2015;2015;08;15;Perjantai;32;28;60
93;07.08.2015;2015;08;16;Perjantai;22;32;54
93;07.08.2015;2015;08;17;Perjantai;19;30;49
93;07.08.2015;2015;08;18;Perjantai;32;27;59
93;07.08.2015;2015;08;19;Perjantai;41;29;70
93;07.08.2015;2015;08;20;Perjantai;23;28;51
93;07.08.2015;2015;08;21;Perjantai;7;16;23
93;07.08.2015;2015;08;22;Perjantai;6;7;13
93;07.08.2015;2015;08;23;Perjantai;5;6;11
93;08.08.2015;2015;08;00;Lauantai;0;2;2
93;08.08.2015;2015;08;01;Lauantai;2;2;4
93;08.08.2015;2015;08;02;Lauantai;0;4;4
93;08.08.2015;2015;08;03;Lauantai;0;3;3
93;08.08.2015;2015;08;04;Lauantai;1;1;2
93;08.08.2015;2015;08;05;Lauantai;2;1;3
93;08.08.2015;2015;08;06;Lauantai;2;3;5
93;08.08.2015;2015;08;07;Lauantai;3;6;9
93;08.08.2015;2015;08;08;Lauantai;4;1;5
93;08.08.2015;2015;08;09;Lauantai;11;9;20
93;08.08.2015;2015;08;10;Lauantai;7;9;16
93;08.08.2015;2015;08;11;Lauantai;18;10;28
93;08.08.2015;2015;08;12;Lauantai;13;16;29
93;08.08.2015;2015;08;13;Lauantai;31;15;46
93;08.08.2015;2015;08;14;Lauantai;14;17;31
93;08.08.2015;2015;08;15;Lauantai;11;20;31
93;08.08.2015;2015;08;16;Lauantai;6;7;13
93;08.08.2015;2015;08;17;Lauantai;11;13;24
93;08.08.2015;2015;08;18;Lauantai;17;14;31
93;08.08.2015;2015;08;19;Lauantai;26;17;43
93;08.08.2015;2015;08;20;Lauantai;10;10;20
93;08.08.2015;2015;08;21;Lauantai;5;16;21
93;08.08.2015;2015;08;22;Lauantai;4;5;9
93;08.08.2015;2015;08;23;Lauantai;3;6;9
93;09.08.2015;2015;08;00;Sunnuntai;4;1;5
93;09.08.2015;2015;08;01;Sunnuntai;0;2;2
93;09.08.2015;2015;08;02;Sunnuntai;2;2;4
93;09.08.2015;2015;08;03;Sunnuntai;0;1;1
93;09.08.2015;2015;08;04;Sunnuntai;0;2;2
93;09.08.2015;2015;08;05;Sunnuntai;0;1;1
93;09.08.2015;2015;08;06;Sunnuntai;2;1;3
93;09.08.2015;2015;08;07;Sunnuntai;4;6;10
93;09.08.2015;2015;08;08;Sunnuntai;3;3;6
93;09.08.2015;2015;08;09;Sunnuntai;8;10;18
93;09.08.2015;2015;08;10;Sunnuntai;20;12;32
93;09.08.2015;2015;08;11;Sunnuntai;16;12;28
93;09.08.2015;2015;08;12;Sunnuntai;24;19;43
93;09.08.2015;2015;08;13;Sunnuntai;32;26;58
93;09.08.2015;2015;08;14;Sunnuntai;34;33;67
93;09.08.2015;2015;08;15;Sunnuntai;23;25;48
93;09.08.2015;2015;08;16;Sunnuntai;45;18;63
93;09.08.2015;2015;08;17;Sunnuntai;32;20;52
93;09.08.2015;2015;08;18;Sunnuntai;25;25;50
93;09.08.2015;2015;08;19;Sunnuntai;14;27;41
93;09.08.2015;2015;08;20;Sunnuntai;21;19;40
93;09.08.2015;2015;08;21;Sunnuntai;11;13;24
93;09.08.2015;2015;08;22;Sunnuntai;4;2;6
93;09.08.2015;2015;08;23;Sunnuntai;1;2;3
93;10.08.2015;2015;08;00;Maanantai;1;5;6
93;10.08.2015;2015;08;01;Maanantai;2;1;3
93;10.08.2015;2015;08;02;Maanantai;0;0;0
93;10.08.2015;2015;08;03;Maanantai;0;0;0
93;10.08.2015;2015;08;04;Maanantai;0;1;1
93;10.08.2015;2015;08;05;Maanantai;5;3;8
93;10.08.2015;2015;08;06;Maanantai;21;6;27
93;10.08.2015;2015;08;07;Maanantai;33;34;67
93;10.08.2015;2015;08;08;Maanantai;18;27;45
93;10.08.2015;2015;08;09;Maanantai;20;15;35
93;10.08.2015;2015;08;10;Maanantai;13;7;20
93;10.08.2015;2015;08;11;Maanantai;22;12;34
93;10.08.2015;2015;08;12;Maanantai;35;24;59
93;10.08.2015;2015;08;13;Maanantai;30;23;53
93;10.08.2015;2015;08;14;Maanantai;26;25;51
93;10.08.2015;2015;08;15;Maanantai;28;49;77
93;10.08.2015;2015;08;16;Maanantai;60;57;117
93;10.08.2015;2015;08;17;Maanantai;37;52;89
93;10.08.2015;2015;08;18;Maanantai;35;44;79
93;10.08.2015;2015;08;19;Maanantai;25;47;72
93;10.08.2015;2015;08;20;Maanantai;21;22;43
93;10.08.2015;2015;08;21;Maanantai;10;19;29
93;10.08.2015;2015;08;22;Maanantai;1;7;8
93;10.08.2015;2015;08;23;Maanantai;4;1;5
93;11.08.2015;2015;08;00;Tiistai;0;1;1
93;11.08.2015;2015;08;01;Tiistai;0;1;1
93;11.08.2015;2015;08;02;Tiistai;0;0;0
93;11.08.2015;2015;08;03;Tiistai;0;1;1
93;11.08.2015;2015;08;04;Tiistai;0;2;2
93;11.08.2015;2015;08;05;Tiistai;7;2;9
93;11.08.2015;2015;08;06;Tiistai;22;10;32
93;11.08.2015;2015;08;07;Tiistai;31;45;76
93;11.08.2015;2015;08;08;Tiistai;29;37;66
93;11.08.2015;2015;08;09;Tiistai;17;8;25
93;11.08.2015;2015;08;10;Tiistai;17;23;40
93;11.08.2015;2015;08;11;Tiistai;25;15;40
93;11.08.2015;2015;08;12;Tiistai;27;13;40
93;11.08.2015;2015;08;13;Tiistai;26;26;52
93;11.08.2015;2015;08;14;Tiistai;39;28;67
93;11.08.2015;2015;08;15;Tiistai;42;49;91
93;11.08.2015;2015;08;16;Tiistai;57;63;120
93;11.08.2015;2015;08;17;Tiistai;29;47;76
93;11.08.2015;2015;08;18;Tiistai;12;34;46
93;11.08.2015;2015;08;19;Tiistai;17;20;37
93;11.08.2015;2015;08;20;Tiistai;17;13;30
93;11.08.2015;2015;08;21;Tiistai;15;21;36
93;11.08.2015;2015;08;22;Tiistai;7;6;13
93;11.08.2015;2015;08;23;Tiistai;0;5;5
93;12.08.2015;2015;08;00;Keskiviikko;0;2;2
93;12.08.2015;2015;08;01;Keskiviikko;1;0;1
93;12.08.2015;2015;08;02;Keskiviikko;1;0;1
93;12.08.2015;2015;08;03;Keskiviikko;0;1;1
93;12.08.2015;2015;08;04;Keskiviikko;0;2;2
93;12.08.2015;2015;08;05;Keskiviikko;0;2;2
93;12.08.2015;2015;08;06;Keskiviikko;11;5;16
93;12.08.2015;2015;08;07;Keskiviikko;28;37;65
93;12.08.2015;2015;08;08;Keskiviikko;22;33;55
93;12.08.2015;2015;08;09;Keskiviikko;24;6;30
93;12.08.2015;2015;08;10;Keskiviikko;7;10;17
93;12.08.2015;2015;08;11;Keskiviikko;9;13;22
93;12.08.2015;2015;08;12;Keskiviikko;12;13;25
93;12.08.2015;2015;08;13;Keskiviikko;12;17;29
93;12.08.2015;2015;08;14;Keskiviikko;40;19;59
93;12.08.2015;2015;08;15;Keskiviikko;31;31;62
93;12.08.2015;2015;08;16;Keskiviikko;47;44;91
93;12.08.2015;2015;08;17;Keskiviikko;31;36;67
93;12.08.2015;2015;08;18;Keskiviikko;36;30;66
93;12.08.2015;2015;08;19;Keskiviikko;31;44;75
93;12.08.2015;2015;08;20;Keskiviikko;18;38;56
93;12.08.2015;2015;08;21;Keskiviikko;13;13;26
93;12.08.2015;2015;08;22;Keskiviikko;3;3;6
93;12.08.2015;2015;08;23;Keskiviikko;0;2;2
93;13.08.2015;2015;08;00;Torstai;0;0;0
93;13.08.2015;2015;08;01;Torstai;0;0;0
93;13.08.2015;2015;08;02;Torstai;0;0;0
93;13.08.2015;2015;08;03;Torstai;0;2;2
93;13.08.2015;2015;08;04;Torstai;0;0;0
93;13.08.2015;2015;08;05;Torstai;2;7;9
93;13.08.2015;2015;08;06;Torstai;26;8;34
93;13.08.2015;2015;08;07;Torstai;41;46;87
93;13.08.2015;2015;08;08;Torstai;24;37;61
93;13.08.2015;2015;08;09;Torstai;16;12;28
93;13.08.2015;2015;08;10;Torstai;9;12;21
93;13.08.2015;2015;08;11;Torstai;8;11;19
93;13.08.2015;2015;08;12;Torstai;13;13;26
93;13.08.2015;2015;08;13;Torstai;17;19;36
93;13.08.2015;2015;08;14;Torstai;27;25;52
93;13.08.2015;2015;08;15;Torstai;36;38;74
93;13.08.2015;2015;08;16;Torstai;49;52;101
93;13.08.2015;2015;08;17;Torstai;34;29;63
93;13.08.2015;2015;08;18;Torstai;17;29;46
93;13.08.2015;2015;08;19;Torstai;15;24;39
93;13.08.2015;2015;08;20;Torstai;12;20;32
93;13.08.2015;2015;08;21;Torstai;13;15;28
93;13.08.2015;2015;08;22;Torstai;3;9;12
93;13.08.2015;2015;08;23;Torstai;0;3;3
93;14.08.2015;2015;08;00;Perjantai;0;0;0
93;14.08.2015;2015;08;01;Perjantai;0;0;0
93;14.08.2015;2015;08;02;Perjantai;0;0;0
93;14.08.2015;2015;08;03;Perjantai;0;1;1
93;14.08.2015;2015;08;04;Perjantai;0;1;1
93;14.08.2015;2015;08;05;Perjantai;1;4;5
93;14.08.2015;2015;08;06;Perjantai;13;7;20
93;14.08.2015;2015;08;07;Perjantai;30;42;72
93;14.08.2015;2015;08;08;Perjantai;17;41;58
93;14.08.2015;2015;08;09;Perjantai;9;23;32
93;14.08.2015;2015;08;10;Perjantai;13;7;20
93;14.08.2015;2015;08;11;Perjantai;19;7;26
93;14.08.2015;2015;08;12;Perjantai;16;20;36
93;14.08.2015;2015;08;13;Perjantai;18;17;35
93;14.08.2015;2015;08;14;Perjantai;31;25;56
93;14.08.2015;2015;08;15;Perjantai;40;40;80
93;14.08.2015;2015;08;16;Perjantai;29;41;70
93;14.08.2015;2015;08;17;Perjantai;20;32;52
93;14.08.2015;2015;08;18;Perjantai;18;16;34
93;14.08.2015;2015;08;19;Perjantai;11;14;25
93;14.08.2015;2015;08;20;Perjantai;14;22;36
93;14.08.2015;2015;08;21;Perjantai;16;12;28
93;14.08.2015;2015;08;22;Perjantai;5;4;9
93;14.08.2015;2015;08;23;Perjantai;8;4;12
93;15.08.2015;2015;08;00;Lauantai;0;2;2
93;15.08.2015;2015;08;01;Lauantai;0;4;4
93;15.08.2015;2015;08;02;Lauantai;0;3;3
93;15.08.2015;2015;08;03;Lauantai;0;1;1
93;15.08.2015;2015;08;04;Lauantai;0;0;0
93;15.08.2015;2015;08;05;Lauantai;1;2;3
93;15.08.2015;2015;08;06;Lauantai;4;0;4
93;15.08.2015;2015;08;07;Lauantai;6;4;10
93;15.08.2015;2015;08;08;Lauantai;12;8;20
93;15.08.2015;2015;08;09;Lauantai;10;11;21
93;15.08.2015;2015;08;10;Lauantai;17;10;27
93;15.08.2015;2015;08;11;Lauantai;13;26;39
93;15.08.2015;2015;08;12;Lauantai;15;19;34
93;15.08.2015;2015;08;13;Lauantai;20;28;48
93;15.08.2015;2015;08;14;Lauantai;18;23;41
93;15.08.2015;2015;08;15;Lauantai;16;29;45
93;15.08.2015;2015;08;16;Lauantai;23;34;57
93;15.08.2015;2015;08;17;Lauantai;20;33;53
93;15.08.2015;2015;08;18;Lauantai;22;23;45
93;15.08.2015;2015;08;19;Lauantai;26;17;43
93;15.08.2015;2015;08;20;Lauantai;8;18;26
93;15.08.2015;2015;08;21;Lauantai;5;2;7
93;15.08.2015;2015;08;22;Lauantai;6;8;14
93;15.08.2015;2015;08;23;Lauantai;7;2;9
93;16.08.2015;2015;08;00;Sunnuntai;3;2;5
93;16.08.2015;2015;08;01;Sunnuntai;1;0;1
93;16.08.2015;2015;08;02;Sunnuntai;2;1;3
93;16.08.2015;2015;08;03;Sunnuntai;0;0;0
93;16.08.2015;2015;08;04;Sunnuntai;0;2;2
93;16.08.2015;2015;08;05;Sunnuntai;1;1;2
93;16.08.2015;2015;08;06;Sunnuntai;1;0;1
93;16.08.2015;2015;08;07;Sunnuntai;5;2;7
93;16.08.2015;2015;08;08;Sunnuntai;6;1;7
93;16.08.2015;2015;08;09;Sunnuntai;10;8;18
93;16.08.2015;2015;08;10;Sunnuntai;19;35;54
93;16.08.2015;2015;08;11;Sunnuntai;21;28;49
93;16.08.2015;2015;08;12;Sunnuntai;30;27;57
93;16.08.2015;2015;08;13;Sunnuntai;38;35;73
93;16.08.2015;2015;08;14;Sunnuntai;46;45;91
93;16.08.2015;2015;08;15;Sunnuntai;44;27;71
93;16.08.2015;2015;08;16;Sunnuntai;50;21;71
93;16.08.2015;2015;08;17;Sunnuntai;30;34;64
93;16.08.2015;2015;08;18;Sunnuntai;24;28;52
93;16.08.2015;2015;08;19;Sunnuntai;20;23;43
93;16.08.2015;2015;08;20;Sunnuntai;21;26;47
93;16.08.2015;2015;08;21;Sunnuntai;12;12;24
93;16.08.2015;2015;08;22;Sunnuntai;2;3;5
93;16.08.2015;2015;08;23;Sunnuntai;2;2;4
93;17.08.2015;2015;08;00;Maanantai;1;0;1
93;17.08.2015;2015;08;01;Maanantai;0;0;0
93;17.08.2015;2015;08;02;Maanantai;0;0;0
93;17.08.2015;2015;08;03;Maanantai;0;0;0
93;17.08.2015;2015;08;04;Maanantai;1;1;2
93;17.08.2015;2015;08;05;Maanantai;5;1;6
93;17.08.2015;2015;08;06;Maanantai;24;10;34
93;17.08.2015;2015;08;07;Maanantai;49;46;95
93;17.08.2015;2015;08;08;Maanantai;21;28;49
93;17.08.2015;2015;08;09;Maanantai;20;12;32
93;17.08.2015;2015;08;10;Maanantai;6;18;24
93;17.08.2015;2015;08;11;Maanantai;21;15;36
93;17.08.2015;2015;08;12;Maanantai;15;23;38
93;17.08.2015;2015;08;13;Maanantai;19;36;55
93;17.08.2015;2015;08;14;Maanantai;31;27;58
93;17.08.2015;2015;08;15;Maanantai;40;48;88
93;17.08.2015;2015;08;16;Maanantai;46;81;127
93;17.08.2015;2015;08;17;Maanantai;48;41;89
93;17.08.2015;2015;08;18;Maanantai;34;44;78
93;17.08.2015;2015;08;19;Maanantai;35;27;62
93;17.08.2015;2015;08;20;Maanantai;24;20;44
93;17.08.2015;2015;08;21;Maanantai;11;27;38
93;17.08.2015;2015;08;22;Maanantai;4;10;14
93;17.08.2015;2015;08;23;Maanantai;1;1;2
93;18.08.2015;2015;08;00;Tiistai;1;0;1
93;18.08.2015;2015;08;01;Tiistai;0;0;0
93;18.08.2015;2015;08;02;Tiistai;0;0;0
93;18.08.2015;2015;08;03;Tiistai;0;0;0
93;18.08.2015;2015;08;04;Tiistai;1;2;3
93;18.08.2015;2015;08;05;Tiistai;5;5;10
93;18.08.2015;2015;08;06;Tiistai;36;14;50
93;18.08.2015;2015;08;07;Tiistai;54;51;105
93;18.08.2015;2015;08;08;Tiistai;19;29;48
93;18.08.2015;2015;08;09;Tiistai;18;12;30
93;18.08.2015;2015;08;10;Tiistai;15;15;30
93;18.08.2015;2015;08;11;Tiistai;12;22;34
93;18.08.2015;2015;08;12;Tiistai;30;10;40
93;18.08.2015;2015;08;13;Tiistai;18;25;43
93;18.08.2015;2015;08;14;Tiistai;29;18;47
93;18.08.2015;2015;08;15;Tiistai;51;57;108
93;18.08.2015;2015;08;16;Tiistai;56;88;144
93;18.08.2015;2015;08;17;Tiistai;42;51;93
93;18.08.2015;2015;08;18;Tiistai;29;54;83
93;18.08.2015;2015;08;19;Tiistai;34;29;63
93;18.08.2015;2015;08;20;Tiistai;22;19;41
93;18.08.2015;2015;08;21;Tiistai;13;16;29
93;18.08.2015;2015;08;22;Tiistai;8;11;19
93;18.08.2015;2015;08;23;Tiistai;4;0;4
93;19.08.2015;2015;08;00;Keskiviikko;1;1;2
93;19.08.2015;2015;08;01;Keskiviikko;0;0;0
93;19.08.2015;2015;08;02;Keskiviikko;0;0;0
93;19.08.2015;2015;08;03;Keskiviikko;0;0;0
93;19.08.2015;2015;08;04;Keskiviikko;1;1;2
93;19.08.2015;2015;08;05;Keskiviikko;6;6;12
93;19.08.2015;2015;08;06;Keskiviikko;33;13;46
93;19.08.2015;2015;08;07;Keskiviikko;46;55;101
93;19.08.2015;2015;08;08;Keskiviikko;30;29;59
93;19.08.2015;2015;08;09;Keskiviikko;15;12;27
93;19.08.2015;2015;08;10;Keskiviikko;15;12;27
93;19.08.2015;2015;08;11;Keskiviikko;21;10;31
93;19.08.2015;2015;08;12;Keskiviikko;16;24;40
93;19.08.2015;2015;08;13;Keskiviikko;32;31;63
93;19.08.2015;2015;08;14;Keskiviikko;27;30;57
93;19.08.2015;2015;08;15;Keskiviikko;46;47;93
93;19.08.2015;2015;08;16;Keskiviikko;55;59;114
93;19.08.2015;2015;08;17;Keskiviikko;34;50;84
93;19.08.2015;2015;08;18;Keskiviikko;29;35;64
93;19.08.2015;2015;08;19;Keskiviikko;29;43;72
93;19.08.2015;2015;08;20;Keskiviikko;30;36;66
93;19.08.2015;2015;08;21;Keskiviikko;7;6;13
93;19.08.2015;2015;08;22;Keskiviikko;3;5;8
93;19.08.2015;2015;08;23;Keskiviikko;0;2;2
93;20.08.2015;2015;08;00;Torstai;1;0;1
93;20.08.2015;2015;08;01;Torstai;0;0;0
93;20.08.2015;2015;08;02;Torstai;0;0;0
93;20.08.2015;2015;08;03;Torstai;0;0;0
93;20.08.2015;2015;08;04;Torstai;1;0;1
93;20.08.2015;2015;08;05;Torstai;4;3;7
93;20.08.2015;2015;08;06;Torstai;24;17;41
93;20.08.2015;2015;08;07;Torstai;53;47;100
93;20.08.2015;2015;08;08;Torstai;26;33;59
93;20.08.2015;2015;08;09;Torstai;15;12;27
93;20.08.2015;2015;08;10;Torstai;21;21;42
93;20.08.2015;2015;08;11;Torstai;14;16;30
93;20.08.2015;2015;08;12;Torstai;13;13;26
93;20.08.2015;2015;08;13;Torstai;21;22;43
93;20.08.2015;2015;08;14;Torstai;26;22;48
93;20.08.2015;2015;08;15;Torstai;37;35;72
93;20.08.2015;2015;08;16;Torstai;45;61;106
93;20.08.2015;2015;08;17;Torstai;52;37;89
93;20.08.2015;2015;08;18;Torstai;35;31;66
93;20.08.2015;2015;08;19;Torstai;21;32;53
93;20.08.2015;2015;08;20;Torstai;12;27;39
93;20.08.2015;2015;08;21;Torstai;12;11;23
93;20.08.2015;2015;08;22;Torstai;3;11;14
93;20.08.2015;2015;08;23;Torstai;2;5;7
93;21.08.2015;2015;08;00;Perjantai;1;2;3
93;21.08.2015;2015;08;01;Perjantai;0;0;0
93;21.08.2015;2015;08;02;Perjantai;0;0;0
93;21.08.2015;2015;08;03;Perjantai;0;0;0
93;21.08.2015;2015;08;04;Perjantai;1;2;3
93;21.08.2015;2015;08;05;Perjantai;4;4;8
93;21.08.2015;2015;08;06;Perjantai;9;7;16
93;21.08.2015;2015;08;07;Perjantai;39;54;93
93;21.08.2015;2015;08;08;Perjantai;14;20;34
93;21.08.2015;2015;08;09;Perjantai;6;7;13
93;21.08.2015;2015;08;10;Perjantai;2;8;10
93;21.08.2015;2015;08;11;Perjantai;8;2;10
93;21.08.2015;2015;08;12;Perjantai;18;11;29
93;21.08.2015;2015;08;13;Perjantai;26;20;46
93;21.08.2015;2015;08;14;Perjantai;32;33;65
93;21.08.2015;2015;08;15;Perjantai;48;40;88
93;21.08.2015;2015;08;16;Perjantai;44;37;81
93;21.08.2015;2015;08;17;Perjantai;36;30;66
93;21.08.2015;2015;08;18;Perjantai;12;37;49
93;21.08.2015;2015;08;19;Perjantai;15;16;31
93;21.08.2015;2015;08;20;Perjantai;13;11;24
93;21.08.2015;2015;08;21;Perjantai;2;10;12
93;21.08.2015;2015;08;22;Perjantai;7;5;12
93;21.08.2015;2015;08;23;Perjantai;0;4;4
93;22.08.2015;2015;08;00;Lauantai;0;2;2
93;22.08.2015;2015;08;01;Lauantai;3;2;5
93;22.08.2015;2015;08;02;Lauantai;1;3;4
93;22.08.2015;2015;08;03;Lauantai;0;0;0
93;22.08.2015;2015;08;04;Lauantai;0;0;0
93;22.08.2015;2015;08;05;Lauantai;0;0;0
93;22.08.2015;2015;08;06;Lauantai;4;2;6
93;22.08.2015;2015;08;07;Lauantai;5;1;6
93;22.08.2015;2015;08;08;Lauantai;5;7;12
93;22.08.2015;2015;08;09;Lauantai;8;9;17
93;22.08.2015;2015;08;10;Lauantai;13;9;22
93;22.08.2015;2015;08;11;Lauantai;15;30;45
93;22.08.2015;2015;08;12;Lauantai;45;28;73
93;22.08.2015;2015;08;13;Lauantai;22;23;45
93;22.08.2015;2015;08;14;Lauantai;12;27;39
93;22.08.2015;2015;08;15;Lauantai;33;41;74
93;22.08.2015;2015;08;16;Lauantai;18;32;50
93;22.08.2015;2015;08;17;Lauantai;39;49;88
93;22.08.2015;2015;08;18;Lauantai;11;40;51
93;22.08.2015;2015;08;19;Lauantai;31;18;49
93;22.08.2015;2015;08;20;Lauantai;17;23;40
93;22.08.2015;2015;08;21;Lauantai;15;13;28
93;22.08.2015;2015;08;22;Lauantai;6;10;16
93;22.08.2015;2015;08;23;Lauantai;1;6;7
93;23.08.2015;2015;08;00;Sunnuntai;4;3;7
93;23.08.2015;2015;08;01;Sunnuntai;0;1;1
93;23.08.2015;2015;08;02;Sunnuntai;4;3;7
93;23.08.2015;2015;08;03;Sunnuntai;2;3;5
93;23.08.2015;2015;08;04;Sunnuntai;0;0;0
93;23.08.2015;2015;08;05;Sunnuntai;0;0;0
93;23.08.2015;2015;08;06;Sunnuntai;2;2;4
93;23.08.2015;2015;08;07;Sunnuntai;5;2;7
93;23.08.2015;2015;08;08;Sunnuntai;3;7;10
93;23.08.2015;2015;08;09;Sunnuntai;17;18;35
93;23.08.2015;2015;08;10;Sunnuntai;28;51;79
93;23.08.2015;2015;08;11;Sunnuntai;27;35;62
93;23.08.2015;2015;08;12;Sunnuntai;57;42;99
93;23.08.2015;2015;08;13;Sunnuntai;33;43;76
93;23.08.2015;2015;08;14;Sunnuntai;41;28;69
93;23.08.2015;2015;08;15;Sunnuntai;37;42;79
93;23.08.2015;2015;08;16;Sunnuntai;44;26;70
93;23.08.2015;2015;08;17;Sunnuntai;40;30;70
93;23.08.2015;2015;08;18;Sunnuntai;38;42;80
93;23.08.2015;2015;08;19;Sunnuntai;37;23;60
93;23.08.2015;2015;08;20;Sunnuntai;15;16;31
93;23.08.2015;2015;08;21;Sunnuntai;13;12;25
93;23.08.2015;2015;08;22;Sunnuntai;7;4;11
93;23.08.2015;2015;08;23;Sunnuntai;0;3;3
93;24.08.2015;2015;08;00;Maanantai;0;1;1
93;24.08.2015;2015;08;01;Maanantai;0;0;0
93;24.08.2015;2015;08;02;Maanantai;0;0;0
93;24.08.2015;2015;08;03;Maanantai;0;0;0
93;24.08.2015;2015;08;04;Maanantai;1;1;2
93;24.08.2015;2015;08;05;Maanantai;5;3;8
93;24.08.2015;2015;08;06;Maanantai;29;7;36
93;24.08.2015;2015;08;07;Maanantai;42;41;83
93;24.08.2015;2015;08;08;Maanantai;25;27;52
93;24.08.2015;2015;08;09;Maanantai;18;9;27
93;24.08.2015;2015;08;10;Maanantai;21;19;40
93;24.08.2015;2015;08;11;Maanantai;17;6;23
93;24.08.2015;2015;08;12;Maanantai;13;24;37
93;24.08.2015;2015;08;13;Maanantai;13;21;34
93;24.08.2015;2015;08;14;Maanantai;24;22;46
93;24.08.2015;2015;08;15;Maanantai;31;43;74
93;24.08.2015;2015;08;16;Maanantai;40;54;94
93;24.08.2015;2015;08;17;Maanantai;46;46;92
93;24.08.2015;2015;08;18;Maanantai;34;35;69
93;24.08.2015;2015;08;19;Maanantai;19;37;56
93;24.08.2015;2015;08;20;Maanantai;18;19;37
93;24.08.2015;2015;08;21;Maanantai;6;13;19
93;24.08.2015;2015;08;22;Maanantai;7;7;14
93;24.08.2015;2015;08;23;Maanantai;0;2;2
93;25.08.2015;2015;08;00;Tiistai;0;1;1
93;25.08.2015;2015;08;01;Tiistai;0;0;0
93;25.08.2015;2015;08;02;Tiistai;0;0;0
93;25.08.2015;2015;08;03;Tiistai;0;0;0
93;25.08.2015;2015;08;04;Tiistai;0;1;1
93;25.08.2015;2015;08;05;Tiistai;2;5;7
93;25.08.2015;2015;08;06;Tiistai;29;13;42
93;25.08.2015;2015;08;07;Tiistai;46;50;96
93;25.08.2015;2015;08;08;Tiistai;27;26;53
93;25.08.2015;2015;08;09;Tiistai;20;17;37
93;25.08.2015;2015;08;10;Tiistai;18;17;35
93;25.08.2015;2015;08;11;Tiistai;19;18;37
93;25.08.2015;2015;08;12;Tiistai;21;21;42
93;25.08.2015;2015;08;13;Tiistai;22;24;46
93;25.08.2015;2015;08;14;Tiistai;20;29;49
93;25.08.2015;2015;08;15;Tiistai;34;57;91
93;25.08.2015;2015;08;16;Tiistai;54;69;123
93;25.08.2015;2015;08;17;Tiistai;30;39;69
93;25.08.2015;2015;08;18;Tiistai;38;44;82
93;25.08.2015;2015;08;19;Tiistai;27;28;55
93;25.08.2015;2015;08;20;Tiistai;20;25;45
93;25.08.2015;2015;08;21;Tiistai;13;15;28
93;25.08.2015;2015;08;22;Tiistai;3;5;8
93;25.08.2015;2015;08;23;Tiistai;0;0;0
93;26.08.2015;2015;08;00;Keskiviikko;0;1;1
93;26.08.2015;2015;08;01;Keskiviikko;0;0;0
93;26.08.2015;2015;08;02;Keskiviikko;0;0;0
93;26.08.2015;2015;08;03;Keskiviikko;0;0;0
93;26.08.2015;2015;08;04;Keskiviikko;0;0;0
93;26.08.2015;2015;08;05;Keskiviikko;5;8;13
93;26.08.2015;2015;08;06;Keskiviikko;26;7;33
93;26.08.2015;2015;08;07;Keskiviikko;49;62;111
93;26.08.2015;2015;08;08;Keskiviikko;16;15;31
93;26.08.2015;2015;08;09;Keskiviikko;22;14;36
93;26.08.2015;2015;08;10;Keskiviikko;15;7;22
93;26.08.2015;2015;08;11;Keskiviikko;18;20;38
93;26.08.2015;2015;08;12;Keskiviikko;15;14;29
93;26.08.2015;2015;08;13;Keskiviikko;15;17;32
93;26.08.2015;2015;08;14;Keskiviikko;11;28;39
93;26.08.2015;2015;08;15;Keskiviikko;43;43;86
93;26.08.2015;2015;08;16;Keskiviikko;56;57;113
93;26.08.2015;2015;08;17;Keskiviikko;38;52;90
93;26.08.2015;2015;08;18;Keskiviikko;30;35;65
93;26.08.2015;2015;08;19;Keskiviikko;33;37;70
93;26.08.2015;2015;08;20;Keskiviikko;21;21;42
93;26.08.2015;2015;08;21;Keskiviikko;16;17;33
93;26.08.2015;2015;08;22;Keskiviikko;5;8;13
93;26.08.2015;2015;08;23;Keskiviikko;1;1;2
93;27.08.2015;2015;08;00;Torstai;0;0;0
93;27.08.2015;2015;08;01;Torstai;0;0;0
93;27.08.2015;2015;08;02;Torstai;0;1;1
93;27.08.2015;2015;08;03;Torstai;0;0;0
93;27.08.2015;2015;08;04;Torstai;0;1;1
93;27.08.2015;2015;08;05;Torstai;4;5;9
93;27.08.2015;2015;08;06;Torstai;13;8;21
93;27.08.2015;2015;08;07;Torstai;30;35;65
93;27.08.2015;2015;08;08;Torstai;15;20;35
93;27.08.2015;2015;08;09;Torstai;12;10;22
93;27.08.2015;2015;08;10;Torstai;7;9;16
93;27.08.2015;2015;08;11;Torstai;6;13;19
93;27.08.2015;2015;08;12;Torstai;15;20;35
93;27.08.2015;2015;08;13;Torstai;8;15;23
93;27.08.2015;2015;08;14;Torstai;19;13;32
93;27.08.2015;2015;08;15;Torstai;29;20;49
93;27.08.2015;2015;08;16;Torstai;34;29;63
93;27.08.2015;2015;08;17;Torstai;17;24;41
93;27.08.2015;2015;08;18;Torstai;12;21;33
93;27.08.2015;2015;08;19;Torstai;24;24;48
93;27.08.2015;2015;08;20;Torstai;12;15;27
93;27.08.2015;2015;08;21;Torstai;8;10;18
93;27.08.2015;2015;08;22;Torstai;2;1;3
93;27.08.2015;2015;08;23;Torstai;0;3;3
93;28.08.2015;2015;08;00;Perjantai;0;0;0
93;28.08.2015;2015;08;01;Perjantai;0;0;0
93;28.08.2015;2015;08;02;Perjantai;0;0;0
93;28.08.2015;2015;08;03;Perjantai;0;0;0
93;28.08.2015;2015;08;04;Perjantai;0;0;0
93;28.08.2015;2015;08;05;Perjantai;2;2;4
93;28.08.2015;2015;08;06;Perjantai;11;6;17
93;28.08.2015;2015;08;07;Perjantai;17;22;39
93;28.08.2015;2015;08;08;Perjantai;4;17;21
93;28.08.2015;2015;08;09;Perjantai;3;6;9
93;28.08.2015;2015;08;10;Perjantai;3;3;6
93;28.08.2015;2015;08;11;Perjantai;5;1;6
93;28.08.2015;2015;08;12;Perjantai;1;3;4
93;28.08.2015;2015;08;13;Perjantai;1;3;4
93;28.08.2015;2015;08;14;Perjantai;11;6;17
93;28.08.2015;2015;08;15;Perjantai;11;10;21
93;28.08.2015;2015;08;16;Perjantai;13;11;24
93;28.08.2015;2015;08;17;Perjantai;11;3;14
93;28.08.2015;2015;08;18;Perjantai;11;1;12
93;28.08.2015;2015;08;19;Perjantai;0;0;0
93;28.08.2015;2015;08;20;Perjantai;2;3;5
93;28.08.2015;2015;08;21;Perjantai;1;1;2
93;28.08.2015;2015;08;22;Perjantai;0;0;0
93;28.08.2015;2015;08;23;Perjantai;1;1;2
93;29.08.2015;2015;08;00;Lauantai;0;0;0
93;29.08.2015;2015;08;01;Lauantai;0;1;1
93;29.08.2015;2015;08;02;Lauantai;0;2;2
93;29.08.2015;2015;08;03;Lauantai;0;0;0
93;29.08.2015;2015;08;04;Lauantai;0;0;0
93;29.08.2015;2015;08;05;Lauantai;0;1;1
93;29.08.2015;2015;08;06;Lauantai;1;2;3
93;29.08.2015;2015;08;07;Lauantai;2;2;4
93;29.08.2015;2015;08;08;Lauantai;1;6;7
93;29.08.2015;2015;08;09;Lauantai;15;7;22
93;29.08.2015;2015;08;10;Lauantai;16;9;25
93;29.08.2015;2015;08;11;Lauantai;11;8;19
93;29.08.2015;2015;08;12;Lauantai;17;19;36
93;29.08.2015;2015;08;13;Lauantai;26;21;47
93;29.08.2015;2015;08;14;Lauantai;21;15;36
93;29.08.2015;2015;08;15;Lauantai;13;10;23
93;29.08.2015;2015;08;16;Lauantai;21;37;58
93;29.08.2015;2015;08;17;Lauantai;17;25;42
93;29.08.2015;2015;08;18;Lauantai;27;17;44
93;29.08.2015;2015;08;19;Lauantai;18;23;41
93;29.08.2015;2015;08;20;Lauantai;8;15;23
93;29.08.2015;2015;08;21;Lauantai;4;11;15
93;29.08.2015;2015;08;22;Lauantai;5;10;15
93;29.08.2015;2015;08;23;Lauantai;0;0;0
93;30.08.2015;2015;08;00;Sunnuntai;3;1;4
93;30.08.2015;2015;08;01;Sunnuntai;1;0;1
93;30.08.2015;2015;08;02;Sunnuntai;0;0;0
93;30.08.2015;2015;08;03;Sunnuntai;5;1;6
93;30.08.2015;2015;08;04;Sunnuntai;0;4;4
93;30.08.2015;2015;08;05;Sunnuntai;1;1;2
93;30.08.2015;2015;08;06;Sunnuntai;1;3;4
93;30.08.2015;2015;08;07;Sunnuntai;5;1;6
93;30.08.2015;2015;08;08;Sunnuntai;7;3;10
93;30.08.2015;2015;08;09;Sunnuntai;10;7;17
93;30.08.2015;2015;08;10;Sunnuntai;11;14;25
93;30.08.2015;2015;08;11;Sunnuntai;18;23;41
93;30.08.2015;2015;08;12;Sunnuntai;22;15;37
93;30.08.2015;2015;08;13;Sunnuntai;20;28;48
93;30.08.2015;2015;08;14;Sunnuntai;15;17;32
93;30.08.2015;2015;08;15;Sunnuntai;23;18;41
93;30.08.2015;2015;08;16;Sunnuntai;31;19;50
93;30.08.2015;2015;08;17;Sunnuntai;28;32;60
93;30.08.2015;2015;08;18;Sunnuntai;34;30;64
93;30.08.2015;2015;08;19;Sunnuntai;15;17;32
93;30.08.2015;2015;08;20;Sunnuntai;15;12;27
93;30.08.2015;2015;08;21;Sunnuntai;7;5;12
93;30.08.2015;2015;08;22;Sunnuntai;2;8;10
93;30.08.2015;2015;08;23;Sunnuntai;0;1;1
93;31.08.2015;2015;08;00;Maanantai;0;0;0
93;31.08.2015;2015;08;01;Maanantai;0;0;0
93;31.08.2015;2015;08;02;Maanantai;1;1;2
93;31.08.2015;2015;08;03;Maanantai;1;0;1
93;31.08.2015;2015;08;04;Maanantai;0;0;0
93;31.08.2015;2015;08;05;Maanantai;3;4;7
93;31.08.2015;2015;08;06;Maanantai;29;13;42
93;31.08.2015;2015;08;07;Maanantai;44;42;86
93;31.08.2015;2015;08;08;Maanantai;14;33;47
93;31.08.2015;2015;08;09;Maanantai;14;10;24
93;31.08.2015;2015;08;10;Maanantai;12;11;23
93;31.08.2015;2015;08;11;Maanantai;11;12;23
93;31.08.2015;2015;08;12;Maanantai;11;14;25
93;31.08.2015;2015;08;13;Maanantai;17;17;34
93;31.08.2015;2015;08;14;Maanantai;19;19;38
93;31.08.2015;2015;08;15;Maanantai;34;42;76
93;31.08.2015;2015;08;16;Maanantai;49;63;112
93;31.08.2015;2015;08;17;Maanantai;37;36;73
93;31.08.2015;2015;08;18;Maanantai;21;13;34
93;31.08.2015;2015;08;19;Maanantai;16;17;33
93;31.08.2015;2015;08;20;Maanantai;7;19;26
93;31.08.2015;2015;08;21;Maanantai;3;7;10
93;31.08.2015;2015;08;22;Maanantai;3;2;5
93;31.08.2015;2015;08;23;Maanantai;0;1;1
93;01.09.2015;2015;09;00;Tiistai;1;0;1
93;01.09.2015;2015;09;01;Tiistai;0;0;0
93;01.09.2015;2015;09;02;Tiistai;0;0;0
93;01.09.2015;2015;09;03;Tiistai;0;0;0
93;01.09.2015;2015;09;04;Tiistai;1;1;2
93;01.09.2015;2015;09;05;Tiistai;1;4;5
93;01.09.2015;2015;09;06;Tiistai;15;13;28
93;01.09.2015;2015;09;07;Tiistai;42;38;80
93;01.09.2015;2015;09;08;Tiistai;22;23;45
93;01.09.2015;2015;09;09;Tiistai;12;9;21
93;01.09.2015;2015;09;10;Tiistai;7;3;10
93;01.09.2015;2015;09;11;Tiistai;19;18;37
93;01.09.2015;2015;09;12;Tiistai;18;13;31
93;01.09.2015;2015;09;13;Tiistai;14;12;26
93;01.09.2015;2015;09;14;Tiistai;14;20;34
93;01.09.2015;2015;09;15;Tiistai;26;29;55
93;01.09.2015;2015;09;16;Tiistai;45;58;103
93;01.09.2015;2015;09;17;Tiistai;22;26;48
93;01.09.2015;2015;09;18;Tiistai;16;25;41
93;01.09.2015;2015;09;19;Tiistai;26;29;55
93;01.09.2015;2015;09;20;Tiistai;14;27;41
93;01.09.2015;2015;09;21;Tiistai;6;12;18
93;01.09.2015;2015;09;22;Tiistai;1;4;5
93;01.09.2015;2015;09;23;Tiistai;0;0;0
93;02.09.2015;2015;09;00;Keskiviikko;1;0;1
93;02.09.2015;2015;09;01;Keskiviikko;0;0;0
93;02.09.2015;2015;09;02;Keskiviikko;0;0;0
93;02.09.2015;2015;09;03;Keskiviikko;0;0;0
93;02.09.2015;2015;09;04;Keskiviikko;1;1;2
93;02.09.2015;2015;09;05;Keskiviikko;2;5;7
93;02.09.2015;2015;09;06;Keskiviikko;22;11;33
93;02.09.2015;2015;09;07;Keskiviikko;38;50;88
93;02.09.2015;2015;09;08;Keskiviikko;14;26;40
93;02.09.2015;2015;09;09;Keskiviikko;13;8;21
93;02.09.2015;2015;09;10;Keskiviikko;12;4;16
93;02.09.2015;2015;09;11;Keskiviikko;14;9;23
93;02.09.2015;2015;09;12;Keskiviikko;16;11;27
93;02.09.2015;2015;09;13;Keskiviikko;7;6;13
93;02.09.2015;2015;09;14;Keskiviikko;20;27;47
93;02.09.2015;2015;09;15;Keskiviikko;34;31;65
93;02.09.2015;2015;09;16;Keskiviikko;38;47;85
93;02.09.2015;2015;09;17;Keskiviikko;33;23;56
93;02.09.2015;2015;09;18;Keskiviikko;19;17;36
93;02.09.2015;2015;09;19;Keskiviikko;13;22;35
93;02.09.2015;2015;09;20;Keskiviikko;10;14;24
93;02.09.2015;2015;09;21;Keskiviikko;3;9;12
93;02.09.2015;2015;09;22;Keskiviikko;4;6;10
93;02.09.2015;2015;09;23;Keskiviikko;0;1;1
93;03.09.2015;2015;09;00;Torstai;0;0;0
93;03.09.2015;2015;09;01;Torstai;1;0;1
93;03.09.2015;2015;09;02;Torstai;0;0;0
93;03.09.2015;2015;09;03;Torstai;0;0;0
93;03.09.2015;2015;09;04;Torstai;0;1;1
93;03.09.2015;2015;09;05;Torstai;3;2;5
93;03.09.2015;2015;09;06;Torstai;13;10;23
93;03.09.2015;2015;09;07;Torstai;35;35;70
93;03.09.2015;2015;09;08;Torstai;11;19;30
93;03.09.2015;2015;09;09;Torstai;18;6;24
93;03.09.2015;2015;09;10;Torstai;5;4;9
93;03.09.2015;2015;09;11;Torstai;11;9;20
93;03.09.2015;2015;09;12;Torstai;6;9;15
93;03.09.2015;2015;09;13;Torstai;17;15;32
93;03.09.2015;2015;09;14;Torstai;21;18;39
93;03.09.2015;2015;09;15;Torstai;25;23;48
93;03.09.2015;2015;09;16;Torstai;35;41;76
93;03.09.2015;2015;09;17;Torstai;27;17;44
93;03.09.2015;2015;09;18;Torstai;16;25;41
93;03.09.2015;2015;09;19;Torstai;20;17;37
93;03.09.2015;2015;09;20;Torstai;15;11;26
93;03.09.2015;2015;09;21;Torstai;5;6;11
93;03.09.2015;2015;09;22;Torstai;3;8;11
93;03.09.2015;2015;09;23;Torstai;0;0;0
93;04.09.2015;2015;09;00;Perjantai;1;0;1
93;04.09.2015;2015;09;01;Perjantai;0;0;0
93;04.09.2015;2015;09;02;Perjantai;0;0;0
93;04.09.2015;2015;09;03;Perjantai;0;0;0
93;04.09.2015;2015;09;04;Perjantai;0;0;0
93;04.09.2015;2015;09;05;Perjantai;1;2;3
93;04.09.2015;2015;09;06;Perjantai;12;5;17
93;04.09.2015;2015;09;07;Perjantai;36;38;74
93;04.09.2015;2015;09;08;Perjantai;13;25;38
93;04.09.2015;2015;09;09;Perjantai;9;12;21
93;04.09.2015;2015;09;10;Perjantai;12;4;16
93;04.09.2015;2015;09;11;Perjantai;15;9;24
93;04.09.2015;2015;09;12;Perjantai;12;8;20
93;04.09.2015;2015;09;13;Perjantai;12;18;30
93;04.09.2015;2015;09;14;Perjantai;19;36;55
93;04.09.2015;2015;09;15;Perjantai;28;22;50
93;04.09.2015;2015;09;16;Perjantai;23;30;53
93;04.09.2015;2015;09;17;Perjantai;16;33;49
93;04.09.2015;2015;09;18;Perjantai;21;16;37
93;04.09.2015;2015;09;19;Perjantai;9;7;16
93;04.09.2015;2015;09;20;Perjantai;15;11;26
93;04.09.2015;2015;09;21;Perjantai;0;8;8
93;04.09.2015;2015;09;22;Perjantai;4;1;5
93;04.09.2015;2015;09;23;Perjantai;2;0;2
93;05.09.2015;2015;09;00;Lauantai;2;0;2
93;05.09.2015;2015;09;01;Lauantai;0;2;2
93;05.09.2015;2015;09;02;Lauantai;0;1;1
93;05.09.2015;2015;09;03;Lauantai;0;0;0
93;05.09.2015;2015;09;04;Lauantai;0;1;1
93;05.09.2015;2015;09;05;Lauantai;0;2;2
93;05.09.2015;2015;09;06;Lauantai;3;3;6
93;05.09.2015;2015;09;07;Lauantai;3;3;6
93;05.09.2015;2015;09;08;Lauantai;3;1;4
93;05.09.2015;2015;09;09;Lauantai;7;7;14
93;05.09.2015;2015;09;10;Lauantai;10;8;18
93;05.09.2015;2015;09;11;Lauantai;15;10;25
93;05.09.2015;2015;09;12;Lauantai;7;11;18
93;05.09.2015;2015;09;13;Lauantai;13;10;23
93;05.09.2015;2015;09;14;Lauantai;20;12;32
93;05.09.2015;2015;09;15;Lauantai;14;14;28
93;05.09.2015;2015;09;16;Lauantai;5;4;9
93;05.09.2015;2015;09;17;Lauantai;15;13;28
93;05.09.2015;2015;09;18;Lauantai;16;12;28
93;05.09.2015;2015;09;19;Lauantai;11;8;19
93;05.09.2015;2015;09;20;Lauantai;2;4;6
93;05.09.2015;2015;09;21;Lauantai;1;7;8
93;05.09.2015;2015;09;22;Lauantai;0;4;4
93;05.09.2015;2015;09;23;Lauantai;1;0;1
93;06.09.2015;2015;09;00;Sunnuntai;0;0;0
93;06.09.2015;2015;09;01;Sunnuntai;0;0;0
93;06.09.2015;2015;09;02;Sunnuntai;0;1;1
93;06.09.2015;2015;09;03;Sunnuntai;0;1;1
93;06.09.2015;2015;09;04;Sunnuntai;0;1;1
93;06.09.2015;2015;09;05;Sunnuntai;1;0;1
93;06.09.2015;2015;09;06;Sunnuntai;2;1;3
93;06.09.2015;2015;09;07;Sunnuntai;0;1;1
93;06.09.2015;2015;09;08;Sunnuntai;3;1;4
93;06.09.2015;2015;09;09;Sunnuntai;3;2;5
93;06.09.2015;2015;09;10;Sunnuntai;1;3;4
93;06.09.2015;2015;09;11;Sunnuntai;2;0;2
93;06.09.2015;2015;09;12;Sunnuntai;2;4;6
93;06.09.2015;2015;09;13;Sunnuntai;5;9;14
93;06.09.2015;2015;09;14;Sunnuntai;4;4;8
93;06.09.2015;2015;09;15;Sunnuntai;18;7;25
93;06.09.2015;2015;09;16;Sunnuntai;14;10;24
93;06.09.2015;2015;09;17;Sunnuntai;8;1;9
93;06.09.2015;2015;09;18;Sunnuntai;3;12;15
93;06.09.2015;2015;09;19;Sunnuntai;4;7;11
93;06.09.2015;2015;09;20;Sunnuntai;1;6;7
93;06.09.2015;2015;09;21;Sunnuntai;0;3;3
93;06.09.2015;2015;09;22;Sunnuntai;1;1;2
93;06.09.2015;2015;09;23;Sunnuntai;0;0;0
93;07.09.2015;2015;09;00;Maanantai;0;0;0
93;07.09.2015;2015;09;01;Maanantai;0;0;0
93;07.09.2015;2015;09;02;Maanantai;1;0;1
93;07.09.2015;2015;09;03;Maanantai;0;0;0
93;07.09.2015;2015;09;04;Maanantai;0;0;0
93;07.09.2015;2015;09;05;Maanantai;3;3;6
93;07.09.2015;2015;09;06;Maanantai;13;10;23
93;07.09.2015;2015;09;07;Maanantai;28;29;57
93;07.09.2015;2015;09;08;Maanantai;13;21;34
93;07.09.2015;2015;09;09;Maanantai;11;8;19
93;07.09.2015;2015;09;10;Maanantai;7;3;10
93;07.09.2015;2015;09;11;Maanantai;6;7;13
93;07.09.2015;2015;09;12;Maanantai;10;9;19
93;07.09.2015;2015;09;13;Maanantai;7;7;14
93;07.09.2015;2015;09;14;Maanantai;18;17;35
93;07.09.2015;2015;09;15;Maanantai;23;25;48
93;07.09.2015;2015;09;16;Maanantai;34;45;79
93;07.09.2015;2015;09;17;Maanantai;18;18;36
93;07.09.2015;2015;09;18;Maanantai;9;16;25
93;07.09.2015;2015;09;19;Maanantai;9;14;23
93;07.09.2015;2015;09;20;Maanantai;5;12;17
93;07.09.2015;2015;09;21;Maanantai;6;4;10
93;07.09.2015;2015;09;22;Maanantai;2;1;3
93;07.09.2015;2015;09;23;Maanantai;0;0;0
93;08.09.2015;2015;09;00;Tiistai;0;0;0
93;08.09.2015;2015;09;01;Tiistai;0;1;1
93;08.09.2015;2015;09;02;Tiistai;0;0;0
93;08.09.2015;2015;09;03;Tiistai;0;0;0
93;08.09.2015;2015;09;04;Tiistai;0;0;0
93;08.09.2015;2015;09;05;Tiistai;3;4;7
93;08.09.2015;2015;09;06;Tiistai;16;13;29
93;08.09.2015;2015;09;07;Tiistai;32;34;66
93;08.09.2015;2015;09;08;Tiistai;18;24;42
93;08.09.2015;2015;09;09;Tiistai;12;5;17
93;08.09.2015;2015;09;10;Tiistai;4;5;9
93;08.09.2015;2015;09;11;Tiistai;7;6;13
93;08.09.2015;2015;09;12;Tiistai;5;4;9
93;08.09.2015;2015;09;13;Tiistai;11;11;22
93;08.09.2015;2015;09;14;Tiistai;23;15;38
93;08.09.2015;2015;09;15;Tiistai;24;33;57
93;08.09.2015;2015;09;16;Tiistai;41;41;82
93;08.09.2015;2015;09;17;Tiistai;22;28;50
93;08.09.2015;2015;09;18;Tiistai;20;21;41
93;08.09.2015;2015;09;19;Tiistai;23;19;42
93;08.09.2015;2015;09;20;Tiistai;9;12;21
93;08.09.2015;2015;09;21;Tiistai;2;3;5
93;08.09.2015;2015;09;22;Tiistai;1;4;5
93;08.09.2015;2015;09;23;Tiistai;0;2;2
93;09.09.2015;2015;09;00;Keskiviikko;0;0;0
93;09.09.2015;2015;09;01;Keskiviikko;0;0;0
93;09.09.2015;2015;09;02;Keskiviikko;0;0;0
93;09.09.2015;2015;09;03;Keskiviikko;0;0;0
93;09.09.2015;2015;09;04;Keskiviikko;0;0;0
93;09.09.2015;2015;09;05;Keskiviikko;4;4;8
93;09.09.2015;2015;09;06;Keskiviikko;19;8;27
93;09.09.2015;2015;09;07;Keskiviikko;36;33;69
93;09.09.2015;2015;09;08;Keskiviikko;17;22;39
93;09.09.2015;2015;09;09;Keskiviikko;12;12;24
93;09.09.2015;2015;09;10;Keskiviikko;10;5;15
93;09.09.2015;2015;09;11;Keskiviikko;9;8;17
93;09.09.2015;2015;09;12;Keskiviikko;9;15;24
93;09.09.2015;2015;09;13;Keskiviikko;14;10;24
93;09.09.2015;2015;09;14;Keskiviikko;18;25;43
93;09.09.2015;2015;09;15;Keskiviikko;27;23;50
93;09.09.2015;2015;09;16;Keskiviikko;44;35;79
93;09.09.2015;2015;09;17;Keskiviikko;28;22;50
93;09.09.2015;2015;09;18;Keskiviikko;22;14;36
93;09.09.2015;2015;09;19;Keskiviikko;8;19;27
93;09.09.2015;2015;09;20;Keskiviikko;10;17;27
93;09.09.2015;2015;09;21;Keskiviikko;0;4;4
93;09.09.2015;2015;09;22;Keskiviikko;0;3;3
93;09.09.2015;2015;09;23;Keskiviikko;1;2;3
93;10.09.2015;2015;09;00;Torstai;0;1;1
93;10.09.2015;2015;09;01;Torstai;1;2;3
93;10.09.2015;2015;09;02;Torstai;0;0;0
93;10.09.2015;2015;09;03;Torstai;0;0;0
93;10.09.2015;2015;09;04;Torstai;0;0;0
93;10.09.2015;2015;09;05;Torstai;6;3;9
93;10.09.2015;2015;09;06;Torstai;17;8;25
93;10.09.2015;2015;09;07;Torstai;35;38;73
93;10.09.2015;2015;09;08;Torstai;16;23;39
93;10.09.2015;2015;09;09;Torstai;9;12;21
93;10.09.2015;2015;09;10;Torstai;11;6;17
93;10.09.2015;2015;09;11;Torstai;11;17;28
93;10.09.2015;2015;09;12;Torstai;12;9;21
93;10.09.2015;2015;09;13;Torstai;12;5;17
93;10.09.2015;2015;09;14;Torstai;21;11;32
93;10.09.2015;2015;09;15;Torstai;23;32;55
93;10.09.2015;2015;09;16;Torstai;45;46;91
93;10.09.2015;2015;09;17;Torstai;26;23;49
93;10.09.2015;2015;09;18;Torstai;17;21;38
93;10.09.2015;2015;09;19;Torstai;19;23;42
93;10.09.2015;2015;09;20;Torstai;9;17;26
93;10.09.2015;2015;09;21;Torstai;4;2;6
93;10.09.2015;2015;09;22;Torstai;1;4;5
93;10.09.2015;2015;09;23;Torstai;0;0;0
93;11.09.2015;2015;09;00;Perjantai;0;0;0
93;11.09.2015;2015;09;01;Perjantai;0;0;0
93;11.09.2015;2015;09;02;Perjantai;0;0;0
93;11.09.2015;2015;09;03;Perjantai;0;0;0
93;11.09.2015;2015;09;04;Perjantai;0;3;3
93;11.09.2015;2015;09;05;Perjantai;1;4;5
93;11.09.2015;2015;09;06;Perjantai;16;8;24
93;11.09.2015;2015;09;07;Perjantai;26;30;56
93;11.09.2015;2015;09;08;Perjantai;12;32;44
93;11.09.2015;2015;09;09;Perjantai;7;11;18
93;11.09.2015;2015;09;10;Perjantai;6;9;15
93;11.09.2015;2015;09;11;Perjantai;12;11;23
93;11.09.2015;2015;09;12;Perjantai;13;6;19
93;11.09.2015;2015;09;13;Perjantai;18;17;35
93;11.09.2015;2015;09;14;Perjantai;26;27;53
93;11.09.2015;2015;09;15;Perjantai;29;24;53
93;11.09.2015;2015;09;16;Perjantai;34;35;69
93;11.09.2015;2015;09;17;Perjantai;32;14;46
93;11.09.2015;2015;09;18;Perjantai;17;21;38
93;11.09.2015;2015;09;19;Perjantai;21;20;41
93;11.09.2015;2015;09;20;Perjantai;8;12;20
93;11.09.2015;2015;09;21;Perjantai;0;8;8
93;11.09.2015;2015;09;22;Perjantai;0;4;4
93;11.09.2015;2015;09;23;Perjantai;0;1;1
93;12.09.2015;2015;09;00;Lauantai;0;0;0
93;12.09.2015;2015;09;01;Lauantai;2;1;3
93;12.09.2015;2015;09;02;Lauantai;0;1;1
93;12.09.2015;2015;09;03;Lauantai;0;0;0
93;12.09.2015;2015;09;04;Lauantai;0;1;1
93;12.09.2015;2015;09;05;Lauantai;1;0;1
93;12.09.2015;2015;09;06;Lauantai;0;1;1
93;12.09.2015;2015;09;07;Lauantai;2;1;3
93;12.09.2015;2015;09;08;Lauantai;3;7;10
93;12.09.2015;2015;09;09;Lauantai;14;4;18
93;12.09.2015;2015;09;10;Lauantai;8;17;25
93;12.09.2015;2015;09;11;Lauantai;18;23;41
93;12.09.2015;2015;09;12;Lauantai;22;20;42
93;12.09.2015;2015;09;13;Lauantai;33;18;51
93;12.09.2015;2015;09;14;Lauantai;30;19;49
93;12.09.2015;2015;09;15;Lauantai;20;29;49
93;12.09.2015;2015;09;16;Lauantai;17;15;32
93;12.09.2015;2015;09;17;Lauantai;20;23;43
93;12.09.2015;2015;09;18;Lauantai;14;22;36
93;12.09.2015;2015;09;19;Lauantai;18;17;35
93;12.09.2015;2015;09;20;Lauantai;4;6;10
93;12.09.2015;2015;09;21;Lauantai;5;10;15
93;12.09.2015;2015;09;22;Lauantai;3;0;3
93;12.09.2015;2015;09;23;Lauantai;3;2;5
93;13.09.2015;2015;09;00;Sunnuntai;0;0;0
93;13.09.2015;2015;09;01;Sunnuntai;0;0;0
93;13.09.2015;2015;09;02;Sunnuntai;0;5;5
93;13.09.2015;2015;09;03;Sunnuntai;0;0;0
93;13.09.2015;2015;09;04;Sunnuntai;0;1;1
93;13.09.2015;2015;09;05;Sunnuntai;3;1;4
93;13.09.2015;2015;09;06;Sunnuntai;1;0;1
93;13.09.2015;2015;09;07;Sunnuntai;1;1;2
93;13.09.2015;2015;09;08;Sunnuntai;6;5;11
93;13.09.2015;2015;09;09;Sunnuntai;6;6;12
93;13.09.2015;2015;09;10;Sunnuntai;8;12;20
93;13.09.2015;2015;09;11;Sunnuntai;28;14;42
93;13.09.2015;2015;09;12;Sunnuntai;30;30;60
93;13.09.2015;2015;09;13;Sunnuntai;27;29;56
93;13.09.2015;2015;09;14;Sunnuntai;16;21;37
93;13.09.2015;2015;09;15;Sunnuntai;16;30;46
93;13.09.2015;2015;09;16;Sunnuntai;17;17;34
93;13.09.2015;2015;09;17;Sunnuntai;17;12;29
93;13.09.2015;2015;09;18;Sunnuntai;19;17;36
93;13.09.2015;2015;09;19;Sunnuntai;11;12;23
93;13.09.2015;2015;09;20;Sunnuntai;15;10;25
93;13.09.2015;2015;09;21;Sunnuntai;4;3;7
93;13.09.2015;2015;09;22;Sunnuntai;0;3;3
93;13.09.2015;2015;09;23;Sunnuntai;0;1;1
93;14.09.2015;2015;09;00;Maanantai;0;0;0
93;14.09.2015;2015;09;01;Maanantai;0;0;0
93;14.09.2015;2015;09;02;Maanantai;0;0;0
93;14.09.2015;2015;09;03;Maanantai;1;0;1
93;14.09.2015;2015;09;04;Maanantai;1;1;2
93;14.09.2015;2015;09;05;Maanantai;3;2;5
93;14.09.2015;2015;09;06;Maanantai;22;11;33
93;14.09.2015;2015;09;07;Maanantai;33;36;69
93;14.09.2015;2015;09;08;Maanantai;10;29;39
93;14.09.2015;2015;09;09;Maanantai;13;10;23
93;14.09.2015;2015;09;10;Maanantai;17;6;23
93;14.09.2015;2015;09;11;Maanantai;10;14;24
93;14.09.2015;2015;09;12;Maanantai;13;14;27
93;14.09.2015;2015;09;13;Maanantai;11;16;27
93;14.09.2015;2015;09;14;Maanantai;20;14;34
93;14.09.2015;2015;09;15;Maanantai;34;39;73
93;14.09.2015;2015;09;16;Maanantai;33;32;65
93;14.09.2015;2015;09;17;Maanantai;31;26;57
93;14.09.2015;2015;09;18;Maanantai;19;27;46
93;14.09.2015;2015;09;19;Maanantai;11;26;37
93;14.09.2015;2015;09;20;Maanantai;13;12;25
93;14.09.2015;2015;09;21;Maanantai;4;5;9
93;14.09.2015;2015;09;22;Maanantai;2;5;7
93;14.09.2015;2015;09;23;Maanantai;0;0;0
93;15.09.2015;2015;09;00;Tiistai;1;0;1
93;15.09.2015;2015;09;01;Tiistai;0;0;0
93;15.09.2015;2015;09;02;Tiistai;0;0;0
93;15.09.2015;2015;09;03;Tiistai;0;0;0
93;15.09.2015;2015;09;04;Tiistai;0;0;0
93;15.09.2015;2015;09;05;Tiistai;4;2;6
93;15.09.2015;2015;09;06;Tiistai;17;10;27
93;15.09.2015;2015;09;07;Tiistai;32;41;73
93;15.09.2015;2015;09;08;Tiistai;16;25;41
93;15.09.2015;2015;09;09;Tiistai;10;13;23
93;15.09.2015;2015;09;10;Tiistai;9;10;19
93;15.09.2015;2015;09;11;Tiistai;13;8;21
93;15.09.2015;2015;09;12;Tiistai;15;12;27
93;15.09.2015;2015;09;13;Tiistai;13;20;33
93;15.09.2015;2015;09;14;Tiistai;21;16;37
93;15.09.2015;2015;09;15;Tiistai;30;26;56
93;15.09.2015;2015;09;16;Tiistai;38;47;85
93;15.09.2015;2015;09;17;Tiistai;20;19;39
93;15.09.2015;2015;09;18;Tiistai;14;24;38
93;15.09.2015;2015;09;19;Tiistai;19;17;36
93;15.09.2015;2015;09;20;Tiistai;7;20;27
93;15.09.2015;2015;09;21;Tiistai;1;6;7
93;15.09.2015;2015;09;22;Tiistai;1;2;3
93;15.09.2015;2015;09;23;Tiistai;0;0;0
93;16.09.2015;2015;09;00;Keskiviikko;1;0;1
93;16.09.2015;2015;09;01;Keskiviikko;1;0;1
93;16.09.2015;2015;09;02;Keskiviikko;0;0;0
93;16.09.2015;2015;09;03;Keskiviikko;0;0;0
93;16.09.2015;2015;09;04;Keskiviikko;0;0;0
93;16.09.2015;2015;09;05;Keskiviikko;3;1;4
93;16.09.2015;2015;09;06;Keskiviikko;12;4;16
93;16.09.2015;2015;09;07;Keskiviikko;30;26;56
93;16.09.2015;2015;09;08;Keskiviikko;8;21;29
93;16.09.2015;2015;09;09;Keskiviikko;7;8;15
93;16.09.2015;2015;09;10;Keskiviikko;3;2;5
93;16.09.2015;2015;09;11;Keskiviikko;7;6;13
93;16.09.2015;2015;09;12;Keskiviikko;5;3;8
93;16.09.2015;2015;09;13;Keskiviikko;8;3;11
93;16.09.2015;2015;09;14;Keskiviikko;7;12;19
93;16.09.2015;2015;09;15;Keskiviikko;24;20;44
93;16.09.2015;2015;09;16;Keskiviikko;36;28;64
93;16.09.2015;2015;09;17;Keskiviikko;19;9;28
93;16.09.2015;2015;09;18;Keskiviikko;15;11;26
93;16.09.2015;2015;09;19;Keskiviikko;9;16;25
93;16.09.2015;2015;09;20;Keskiviikko;5;10;15
93;16.09.2015;2015;09;21;Keskiviikko;3;1;4
93;16.09.2015;2015;09;22;Keskiviikko;1;2;3
93;16.09.2015;2015;09;23;Keskiviikko;0;0;0
93;17.09.2015;2015;09;00;Torstai;0;0;0
93;17.09.2015;2015;09;01;Torstai;0;1;1
93;17.09.2015;2015;09;02;Torstai;0;0;0
93;17.09.2015;2015;09;03;Torstai;0;2;2
93;17.09.2015;2015;09;04;Torstai;1;0;1
93;17.09.2015;2015;09;05;Torstai;2;1;3
93;17.09.2015;2015;09;06;Torstai;16;5;21
93;17.09.2015;2015;09;07;Torstai;35;27;62
93;17.09.2015;2015;09;08;Torstai;12;21;33
93;17.09.2015;2015;09;09;Torstai;7;10;17
93;17.09.2015;2015;09;10;Torstai;10;10;20
93;17.09.2015;2015;09;11;Torstai;5;6;11
93;17.09.2015;2015;09;12;Torstai;13;7;20
93;17.09.2015;2015;09;13;Torstai;9;7;16
93;17.09.2015;2015;09;14;Torstai;8;10;18
93;17.09.2015;2015;09;15;Torstai;28;32;60
93;17.09.2015;2015;09;16;Torstai;31;34;65
93;17.09.2015;2015;09;17;Torstai;20;29;49
93;17.09.2015;2015;09;18;Torstai;15;14;29
93;17.09.2015;2015;09;19;Torstai;7;18;25
93;17.09.2015;2015;09;20;Torstai;4;11;15
93;17.09.2015;2015;09;21;Torstai;3;4;7
93;17.09.2015;2015;09;22;Torstai;2;1;3
93;17.09.2015;2015;09;23;Torstai;1;0;1
93;18.09.2015;2015;09;00;Perjantai;0;0;0
93;18.09.2015;2015;09;01;Perjantai;2;0;2
93;18.09.2015;2015;09;02;Perjantai;0;0;0
93;18.09.2015;2015;09;03;Perjantai;0;0;0
93;18.09.2015;2015;09;04;Perjantai;0;0;0
93;18.09.2015;2015;09;05;Perjantai;2;1;3
93;18.09.2015;2015;09;06;Perjantai;7;2;9
93;18.09.2015;2015;09;07;Perjantai;13;17;30
93;18.09.2015;2015;09;08;Perjantai;8;14;22
93;18.09.2015;2015;09;09;Perjantai;4;7;11
93;18.09.2015;2015;09;10;Perjantai;3;1;4
93;18.09.2015;2015;09;11;Perjantai;1;0;1
93;18.09.2015;2015;09;12;Perjantai;2;2;4
93;18.09.2015;2015;09;13;Perjantai;4;3;7
93;18.09.2015;2015;09;14;Perjantai;7;5;12
93;18.09.2015;2015;09;15;Perjantai;10;6;16
93;18.09.2015;2015;09;16;Perjantai;14;3;17
93;18.09.2015;2015;09;17;Perjantai;7;6;13
93;18.09.2015;2015;09;18;Perjantai;4;9;13
93;18.09.2015;2015;09;19;Perjantai;4;4;8
93;18.09.2015;2015;09;20;Perjantai;2;4;6
93;18.09.2015;2015;09;21;Perjantai;0;3;3
93;18.09.2015;2015;09;22;Perjantai;0;0;0
93;18.09.2015;2015;09;23;Perjantai;2;3;5
93;19.09.2015;2015;09;00;Lauantai;0;0;0
93;19.09.2015;2015;09;01;Lauantai;1;0;1
93;19.09.2015;2015;09;02;Lauantai;0;0;0
93;19.09.2015;2015;09;03;Lauantai;0;0;0
93;19.09.2015;2015;09;04;Lauantai;0;0;0
93;19.09.2015;2015;09;05;Lauantai;0;0;0
93;19.09.2015;2015;09;06;Lauantai;0;2;2
93;19.09.2015;2015;09;07;Lauantai;0;1;1
93;19.09.2015;2015;09;08;Lauantai;4;2;6
93;19.09.2015;2015;09;09;Lauantai;4;5;9
93;19.09.2015;2015;09;10;Lauantai;7;2;9
93;19.09.2015;2015;09;11;Lauantai;12;7;19
93;19.09.2015;2015;09;12;Lauantai;7;10;17
93;19.09.2015;2015;09;13;Lauantai;13;11;24
93;19.09.2015;2015;09;14;Lauantai;7;8;15
93;19.09.2015;2015;09;15;Lauantai;6;6;12
93;19.09.2015;2015;09;16;Lauantai;8;5;13
93;19.09.2015;2015;09;17;Lauantai;8;8;16
93;19.09.2015;2015;09;18;Lauantai;8;2;10
93;19.09.2015;2015;09;19;Lauantai;2;5;7
93;19.09.2015;2015;09;20;Lauantai;5;5;10
93;19.09.2015;2015;09;21;Lauantai;1;2;3
93;19.09.2015;2015;09;22;Lauantai;2;1;3
93;19.09.2015;2015;09;23;Lauantai;0;5;5
93;20.09.2015;2015;09;00;Sunnuntai;0;1;1
93;20.09.2015;2015;09;01;Sunnuntai;1;0;1
93;20.09.2015;2015;09;02;Sunnuntai;0;2;2
93;20.09.2015;2015;09;03;Sunnuntai;0;0;0
93;20.09.2015;2015;09;04;Sunnuntai;0;0;0
93;20.09.2015;2015;09;05;Sunnuntai;0;0;0
93;20.09.2015;2015;09;06;Sunnuntai;1;0;1
93;20.09.2015;2015;09;07;Sunnuntai;5;1;6
93;20.09.2015;2015;09;08;Sunnuntai;4;4;8
93;20.09.2015;2015;09;09;Sunnuntai;13;6;19
93;20.09.2015;2015;09;10;Sunnuntai;13;16;29
93;20.09.2015;2015;09;11;Sunnuntai;21;11;32
93;20.09.2015;2015;09;12;Sunnuntai;20;11;31
93;20.09.2015;2015;09;13;Sunnuntai;23;22;45
93;20.09.2015;2015;09;14;Sunnuntai;16;19;35
93;20.09.2015;2015;09;15;Sunnuntai;26;18;44
93;20.09.2015;2015;09;16;Sunnuntai;4;9;13
93;20.09.2015;2015;09;17;Sunnuntai;7;3;10
93;20.09.2015;2015;09;18;Sunnuntai;5;8;13
93;20.09.2015;2015;09;19;Sunnuntai;9;12;21
93;20.09.2015;2015;09;20;Sunnuntai;1;2;3
93;20.09.2015;2015;09;21;Sunnuntai;2;0;2
93;20.09.2015;2015;09;22;Sunnuntai;1;0;1
93;20.09.2015;2015;09;23;Sunnuntai;1;2;3
93;21.09.2015;2015;09;00;Maanantai;0;0;0
93;21.09.2015;2015;09;01;Maanantai;0;0;0
93;21.09.2015;2015;09;02;Maanantai;0;0;0
93;21.09.2015;2015;09;03;Maanantai;0;0;0
93;21.09.2015;2015;09;04;Maanantai;0;1;1
93;21.09.2015;2015;09;05;Maanantai;2;2;4
93;21.09.2015;2015;09;06;Maanantai;17;6;23
93;21.09.2015;2015;09;07;Maanantai;34;30;64
93;21.09.2015;2015;09;08;Maanantai;17;24;41
93;21.09.2015;2015;09;09;Maanantai;9;14;23
93;21.09.2015;2015;09;10;Maanantai;11;2;13
93;21.09.2015;2015;09;11;Maanantai;10;8;18
93;21.09.2015;2015;09;12;Maanantai;10;10;20
93;21.09.2015;2015;09;13;Maanantai;15;9;24
93;21.09.2015;2015;09;14;Maanantai;10;15;25
93;21.09.2015;2015;09;15;Maanantai;34;36;70
93;21.09.2015;2015;09;16;Maanantai;37;41;78
93;21.09.2015;2015;09;17;Maanantai;29;24;53
93;21.09.2015;2015;09;18;Maanantai;17;32;49
93;21.09.2015;2015;09;19;Maanantai;11;26;37
93;21.09.2015;2015;09;20;Maanantai;11;16;27
93;21.09.2015;2015;09;21;Maanantai;2;3;5
93;21.09.2015;2015;09;22;Maanantai;1;5;6
93;21.09.2015;2015;09;23;Maanantai;0;1;1
93;22.09.2015;2015;09;00;Tiistai;0;0;0
93;22.09.2015;2015;09;01;Tiistai;0;0;0
93;22.09.2015;2015;09;02;Tiistai;0;0;0
93;22.09.2015;2015;09;03;Tiistai;0;0;0
93;22.09.2015;2015;09;04;Tiistai;0;0;0
93;22.09.2015;2015;09;05;Tiistai;3;2;5
93;22.09.2015;2015;09;06;Tiistai;6;5;11
93;22.09.2015;2015;09;07;Tiistai;19;22;41
93;22.09.2015;2015;09;08;Tiistai;8;17;25
93;22.09.2015;2015;09;09;Tiistai;3;2;5
93;22.09.2015;2015;09;10;Tiistai;3;2;5
93;22.09.2015;2015;09;11;Tiistai;1;2;3
93;22.09.2015;2015;09;12;Tiistai;4;1;5
93;22.09.2015;2015;09;13;Tiistai;1;5;6
93;22.09.2015;2015;09;14;Tiistai;11;13;24
93;22.09.2015;2015;09;15;Tiistai;19;15;34
93;22.09.2015;2015;09;16;Tiistai;24;29;53
93;22.09.2015;2015;09;17;Tiistai;15;12;27
93;22.09.2015;2015;09;18;Tiistai;9;5;14
93;22.09.2015;2015;09;19;Tiistai;1;3;4
93;22.09.2015;2015;09;20;Tiistai;5;5;10
93;22.09.2015;2015;09;21;Tiistai;0;2;2
93;22.09.2015;2015;09;22;Tiistai;0;3;3
93;22.09.2015;2015;09;23;Tiistai;0;0;0
93;23.09.2015;2015;09;00;Keskiviikko;0;0;0
93;23.09.2015;2015;09;01;Keskiviikko;0;0;0
93;23.09.2015;2015;09;02;Keskiviikko;0;0;0
93;23.09.2015;2015;09;03;Keskiviikko;0;0;0
93;23.09.2015;2015;09;04;Keskiviikko;0;1;1
93;23.09.2015;2015;09;05;Keskiviikko;1;3;4
93;23.09.2015;2015;09;06;Keskiviikko;9;6;15
93;23.09.2015;2015;09;07;Keskiviikko;28;25;53
93;23.09.2015;2015;09;08;Keskiviikko;16;15;31
93;23.09.2015;2015;09;09;Keskiviikko;8;8;16
93;23.09.2015;2015;09;10;Keskiviikko;11;2;13
93;23.09.2015;2015;09;11;Keskiviikko;8;9;17
93;23.09.2015;2015;09;12;Keskiviikko;5;5;10
93;23.09.2015;2015;09;13;Keskiviikko;4;4;8
93;23.09.2015;2015;09;14;Keskiviikko;10;17;27
93;23.09.2015;2015;09;15;Keskiviikko;17;18;35
93;23.09.2015;2015;09;16;Keskiviikko;23;27;50
93;23.09.2015;2015;09;17;Keskiviikko;20;9;29
93;23.09.2015;2015;09;18;Keskiviikko;8;9;17
93;23.09.2015;2015;09;19;Keskiviikko;8;10;18
93;23.09.2015;2015;09;20;Keskiviikko;5;10;15
93;23.09.2015;2015;09;21;Keskiviikko;2;5;7
93;23.09.2015;2015;09;22;Keskiviikko;0;2;2
93;23.09.2015;2015;09;23;Keskiviikko;1;2;3
93;24.09.2015;2015;09;00;Torstai;0;0;0
93;24.09.2015;2015;09;01;Torstai;0;1;1
93;24.09.2015;2015;09;02;Torstai;0;0;0
93;24.09.2015;2015;09;03;Torstai;0;0;0
93;24.09.2015;2015;09;04;Torstai;0;1;1
93;24.09.2015;2015;09;05;Torstai;2;3;5
93;24.09.2015;2015;09;06;Torstai;7;3;10
93;24.09.2015;2015;09;07;Torstai;29;29;58
93;24.09.2015;2015;09;08;Torstai;19;23;42
93;24.09.2015;2015;09;09;Torstai;7;1;8
93;24.09.2015;2015;09;10;Torstai;13;4;17
93;24.09.2015;2015;09;11;Torstai;9;11;20
93;24.09.2015;2015;09;12;Torstai;7;9;16
93;24.09.2015;2015;09;13;Torstai;8;7;15
93;24.09.2015;2015;09;14;Torstai;11;20;31
93;24.09.2015;2015;09;15;Torstai;25;15;40
93;24.09.2015;2015;09;16;Torstai;29;29;58
93;24.09.2015;2015;09;17;Torstai;10;21;31
93;24.09.2015;2015;09;18;Torstai;9;19;28
93;24.09.2015;2015;09;19;Torstai;17;10;27
93;24.09.2015;2015;09;20;Torstai;11;19;30
93;24.09.2015;2015;09;21;Torstai;0;3;3
93;24.09.2015;2015;09;22;Torstai;2;1;3
93;24.09.2015;2015;09;23;Torstai;0;2;2
93;25.09.2015;2015;09;00;Perjantai;1;1;2
93;25.09.2015;2015;09;01;Perjantai;0;0;0
93;25.09.2015;2015;09;02;Perjantai;0;1;1
93;25.09.2015;2015;09;03;Perjantai;0;0;0
93;25.09.2015;2015;09;04;Perjantai;0;2;2
93;25.09.2015;2015;09;05;Perjantai;3;3;6
93;25.09.2015;2015;09;06;Perjantai;9;4;13
93;25.09.2015;2015;09;07;Perjantai;20;29;49
93;25.09.2015;2015;09;08;Perjantai;13;25;38
93;25.09.2015;2015;09;09;Perjantai;4;6;10
93;25.09.2015;2015;09;10;Perjantai;6;6;12
93;25.09.2015;2015;09;11;Perjantai;9;5;14
93;25.09.2015;2015;09;12;Perjantai;8;6;14
93;25.09.2015;2015;09;13;Perjantai;13;8;21
93;25.09.2015;2015;09;14;Perjantai;17;14;31
93;25.09.2015;2015;09;15;Perjantai;20;20;40
93;25.09.2015;2015;09;16;Perjantai;26;16;42
93;25.09.2015;2015;09;17;Perjantai;17;14;31
93;25.09.2015;2015;09;18;Perjantai;8;16;24
93;25.09.2015;2015;09;19;Perjantai;6;12;18
93;25.09.2015;2015;09;20;Perjantai;6;7;13
93;25.09.2015;2015;09;21;Perjantai;0;4;4
93;25.09.2015;2015;09;22;Perjantai;1;2;3
93;25.09.2015;2015;09;23;Perjantai;1;1;2
93;26.09.2015;2015;09;00;Lauantai;1;2;3
93;26.09.2015;2015;09;01;Lauantai;6;1;7
93;26.09.2015;2015;09;02;Lauantai;0;3;3
93;26.09.2015;2015;09;03;Lauantai;0;1;1
93;26.09.2015;2015;09;04;Lauantai;0;1;1
93;26.09.2015;2015;09;05;Lauantai;0;1;1
93;26.09.2015;2015;09;06;Lauantai;1;0;1
93;26.09.2015;2015;09;07;Lauantai;1;0;1
93;26.09.2015;2015;09;08;Lauantai;5;5;10
93;26.09.2015;2015;09;09;Lauantai;11;2;13
93;26.09.2015;2015;09;10;Lauantai;8;5;13
93;26.09.2015;2015;09;11;Lauantai;6;4;10
93;26.09.2015;2015;09;12;Lauantai;16;21;37
93;26.09.2015;2015;09;13;Lauantai;18;20;38
93;26.09.2015;2015;09;14;Lauantai;11;21;32
93;26.09.2015;2015;09;15;Lauantai;9;21;30
93;26.09.2015;2015;09;16;Lauantai;10;14;24
93;26.09.2015;2015;09;17;Lauantai;16;10;26
93;26.09.2015;2015;09;18;Lauantai;11;10;21
93;26.09.2015;2015;09;19;Lauantai;7;10;17
93;26.09.2015;2015;09;20;Lauantai;6;3;9
93;26.09.2015;2015;09;21;Lauantai;5;5;10
93;26.09.2015;2015;09;22;Lauantai;5;1;6
93;26.09.2015;2015;09;23;Lauantai;3;1;4
93;27.09.2015;2015;09;00;Sunnuntai;0;0;0
93;27.09.2015;2015;09;01;Sunnuntai;0;0;0
93;27.09.2015;2015;09;02;Sunnuntai;0;1;1
93;27.09.2015;2015;09;03;Sunnuntai;0;0;0
93;27.09.2015;2015;09;04;Sunnuntai;0;0;0
93;27.09.2015;2015;09;05;Sunnuntai;0;0;0
93;27.09.2015;2015;09;06;Sunnuntai;0;2;2
93;27.09.2015;2015;09;07;Sunnuntai;1;1;2
93;27.09.2015;2015;09;08;Sunnuntai;2;2;4
93;27.09.2015;2015;09;09;Sunnuntai;9;1;10
93;27.09.2015;2015;09;10;Sunnuntai;4;4;8
93;27.09.2015;2015;09;11;Sunnuntai;10;5;15
93;27.09.2015;2015;09;12;Sunnuntai;11;7;18
93;27.09.2015;2015;09;13;Sunnuntai;11;12;23
93;27.09.2015;2015;09;14;Sunnuntai;18;16;34
93;27.09.2015;2015;09;15;Sunnuntai;12;16;28
93;27.09.2015;2015;09;16;Sunnuntai;7;13;20
93;27.09.2015;2015;09;17;Sunnuntai;6;18;24
93;27.09.2015;2015;09;18;Sunnuntai;15;8;23
93;27.09.2015;2015;09;19;Sunnuntai;7;12;19
93;27.09.2015;2015;09;20;Sunnuntai;4;2;6
93;27.09.2015;2015;09;21;Sunnuntai;2;5;7
93;27.09.2015;2015;09;22;Sunnuntai;1;2;3
93;27.09.2015;2015;09;23;Sunnuntai;0;0;0
93;28.09.2015;2015;09;00;Maanantai;0;0;0
93;28.09.2015;2015;09;01;Maanantai;0;0;0
93;28.09.2015;2015;09;02;Maanantai;0;0;0
93;28.09.2015;2015;09;03;Maanantai;0;0;0
93;28.09.2015;2015;09;04;Maanantai;0;1;1
93;28.09.2015;2015;09;05;Maanantai;4;1;5
93;28.09.2015;2015;09;06;Maanantai;13;9;22
93;28.09.2015;2015;09;07;Maanantai;28;24;52
93;28.09.2015;2015;09;08;Maanantai;18;22;40
93;28.09.2015;2015;09;09;Maanantai;11;14;25
93;28.09.2015;2015;09;10;Maanantai;10;5;15
93;28.09.2015;2015;09;11;Maanantai;7;6;13
93;28.09.2015;2015;09;12;Maanantai;11;11;22
93;28.09.2015;2015;09;13;Maanantai;11;12;23
93;28.09.2015;2015;09;14;Maanantai;16;10;26
93;28.09.2015;2015;09;15;Maanantai;20;22;42
93;28.09.2015;2015;09;16;Maanantai;30;29;59
93;28.09.2015;2015;09;17;Maanantai;20;17;37
93;28.09.2015;2015;09;18;Maanantai;13;30;43
93;28.09.2015;2015;09;19;Maanantai;7;10;17
93;28.09.2015;2015;09;20;Maanantai;6;9;15
93;28.09.2015;2015;09;21;Maanantai;2;1;3
93;28.09.2015;2015;09;22;Maanantai;0;6;6
93;28.09.2015;2015;09;23;Maanantai;0;1;1
93;29.09.2015;2015;09;00;Tiistai;1;0;1
93;29.09.2015;2015;09;01;Tiistai;2;2;4
93;29.09.2015;2015;09;02;Tiistai;1;1;2
93;29.09.2015;2015;09;03;Tiistai;0;0;0
93;29.09.2015;2015;09;04;Tiistai;0;2;2
93;29.09.2015;2015;09;05;Tiistai;3;2;5
93;29.09.2015;2015;09;06;Tiistai;13;11;24
93;29.09.2015;2015;09;07;Tiistai;31;23;54
93;29.09.2015;2015;09;08;Tiistai;16;18;34
93;29.09.2015;2015;09;09;Tiistai;8;6;14
93;29.09.2015;2015;09;10;Tiistai;4;10;14
93;29.09.2015;2015;09;11;Tiistai;11;8;19
93;29.09.2015;2015;09;12;Tiistai;9;6;15
93;29.09.2015;2015;09;13;Tiistai;13;9;22
93;29.09.2015;2015;09;14;Tiistai;7;13;20
93;29.09.2015;2015;09;15;Tiistai;22;26;48
93;29.09.2015;2015;09;16;Tiistai;29;29;58
93;29.09.2015;2015;09;17;Tiistai;19;17;36
93;29.09.2015;2015;09;18;Tiistai;7;14;21
93;29.09.2015;2015;09;19;Tiistai;8;9;17
93;29.09.2015;2015;09;20;Tiistai;5;6;11
93;29.09.2015;2015;09;21;Tiistai;0;7;7
93;29.09.2015;2015;09;22;Tiistai;0;0;0
93;29.09.2015;2015;09;23;Tiistai;0;0;0
93;30.09.2015;2015;09;00;Keskiviikko;2;1;3
93;30.09.2015;2015;09;01;Keskiviikko;1;0;1
93;30.09.2015;2015;09;02;Keskiviikko;0;0;0
93;30.09.2015;2015;09;03;Keskiviikko;0;0;0
93;30.09.2015;2015;09;04;Keskiviikko;0;1;1
93;30.09.2015;2015;09;05;Keskiviikko;4;1;5
93;30.09.2015;2015;09;06;Keskiviikko;14;10;24
93;30.09.2015;2015;09;07;Keskiviikko;30;20;50
93;30.09.2015;2015;09;08;Keskiviikko;19;23;42
93;30.09.2015;2015;09;09;Keskiviikko;5;8;13
93;30.09.2015;2015;09;10;Keskiviikko;11;5;16
93;30.09.2015;2015;09;11;Keskiviikko;8;9;17
93;30.09.2015;2015;09;12;Keskiviikko;10;12;22
93;30.09.2015;2015;09;13;Keskiviikko;7;9;16
93;30.09.2015;2015;09;14;Keskiviikko;14;10;24
93;30.09.2015;2015;09;15;Keskiviikko;18;25;43
93;30.09.2015;2015;09;16;Keskiviikko;36;35;71
93;30.09.2015;2015;09;17;Keskiviikko;19;19;38
93;30.09.2015;2015;09;18;Keskiviikko;7;12;19
93;30.09.2015;2015;09;19;Keskiviikko;15;14;29
93;30.09.2015;2015;09;20;Keskiviikko;7;14;21
93;30.09.2015;2015;09;21;Keskiviikko;2;2;4
93;30.09.2015;2015;09;22;Keskiviikko;2;1;3
93;30.09.2015;2015;09;23;Keskiviikko;1;2;3
93;01.10.2015;2015;10;00;Torstai;0;0;0
93;01.10.2015;2015;10;01;Torstai;0;0;0
93;01.10.2015;2015;10;02;Torstai;0;0;0
93;01.10.2015;2015;10;03;Torstai;0;0;0
93;01.10.2015;2015;10;04;Torstai;0;2;2
93;01.10.2015;2015;10;05;Torstai;2;1;3
93;01.10.2015;2015;10;06;Torstai;9;12;21
93;01.10.2015;2015;10;07;Torstai;23;22;45
93;01.10.2015;2015;10;08;Torstai;12;21;33
93;01.10.2015;2015;10;09;Torstai;3;7;10
93;01.10.2015;2015;10;10;Torstai;7;6;13
93;01.10.2015;2015;10;11;Torstai;5;7;12
93;01.10.2015;2015;10;12;Torstai;4;3;7
93;01.10.2015;2015;10;13;Torstai;9;8;17
93;01.10.2015;2015;10;14;Torstai;14;10;24
93;01.10.2015;2015;10;15;Torstai;25;20;45
93;01.10.2015;2015;10;16;Torstai;30;28;58
93;01.10.2015;2015;10;17;Torstai;11;8;19
93;01.10.2015;2015;10;18;Torstai;14;9;23
93;01.10.2015;2015;10;19;Torstai;8;16;24
93;01.10.2015;2015;10;20;Torstai;4;9;13
93;01.10.2015;2015;10;21;Torstai;1;3;4
93;01.10.2015;2015;10;22;Torstai;2;0;2
93;01.10.2015;2015;10;23;Torstai;0;1;1
93;02.10.2015;2015;10;00;Perjantai;0;0;0
93;02.10.2015;2015;10;01;Perjantai;0;0;0
93;02.10.2015;2015;10;02;Perjantai;0;0;0
93;02.10.2015;2015;10;03;Perjantai;0;0;0
93;02.10.2015;2015;10;04;Perjantai;0;1;1
93;02.10.2015;2015;10;05;Perjantai;1;1;2
93;02.10.2015;2015;10;06;Perjantai;5;3;8
93;02.10.2015;2015;10;07;Perjantai;9;11;20
93;02.10.2015;2015;10;08;Perjantai;0;16;16
93;02.10.2015;2015;10;09;Perjantai;6;3;9
93;02.10.2015;2015;10;10;Perjantai;1;3;4
93;02.10.2015;2015;10;11;Perjantai;3;3;6
93;02.10.2015;2015;10;12;Perjantai;6;0;6
93;02.10.2015;2015;10;13;Perjantai;3;2;5
93;02.10.2015;2015;10;14;Perjantai;2;3;5
93;02.10.2015;2015;10;15;Perjantai;8;5;13
93;02.10.2015;2015;10;16;Perjantai;16;9;25
93;02.10.2015;2015;10;17;Perjantai;3;4;7
93;02.10.2015;2015;10;18;Perjantai;3;6;9
93;02.10.2015;2015;10;19;Perjantai;6;5;11
93;02.10.2015;2015;10;20;Perjantai;1;0;1
93;02.10.2015;2015;10;21;Perjantai;1;0;1
93;02.10.2015;2015;10;22;Perjantai;0;2;2
93;02.10.2015;2015;10;23;Perjantai;1;1;2
93;03.10.2015;2015;10;00;Lauantai;0;1;1
93;03.10.2015;2015;10;01;Lauantai;0;0;0
93;03.10.2015;2015;10;02;Lauantai;0;0;0
93;03.10.2015;2015;10;03;Lauantai;0;0;0
93;03.10.2015;2015;10;04;Lauantai;0;1;1
93;03.10.2015;2015;10;05;Lauantai;2;1;3
93;03.10.2015;2015;10;06;Lauantai;1;0;1
93;03.10.2015;2015;10;07;Lauantai;2;2;4
93;03.10.2015;2015;10;08;Lauantai;0;3;3
93;03.10.2015;2015;10;09;Lauantai;6;3;9
93;03.10.2015;2015;10;10;Lauantai;7;3;10
93;03.10.2015;2015;10;11;Lauantai;4;7;11
93;03.10.2015;2015;10;12;Lauantai;7;5;12
93;03.10.2015;2015;10;13;Lauantai;6;6;12
93;03.10.2015;2015;10;14;Lauantai;9;9;18
93;03.10.2015;2015;10;15;Lauantai;11;13;24
93;03.10.2015;2015;10;16;Lauantai;8;6;14
93;03.10.2015;2015;10;17;Lauantai;5;10;15
93;03.10.2015;2015;10;18;Lauantai;4;10;14
93;03.10.2015;2015;10;19;Lauantai;8;4;12
93;03.10.2015;2015;10;20;Lauantai;1;5;6
93;03.10.2015;2015;10;21;Lauantai;0;5;5
93;03.10.2015;2015;10;22;Lauantai;3;1;4
93;03.10.2015;2015;10;23;Lauantai;2;0;2
93;04.10.2015;2015;10;00;Sunnuntai;0;0;0
93;04.10.2015;2015;10;01;Sunnuntai;0;0;0
93;04.10.2015;2015;10;02;Sunnuntai;0;1;1
93;04.10.2015;2015;10;03;Sunnuntai;0;0;0
93;04.10.2015;2015;10;04;Sunnuntai;0;0;0
93;04.10.2015;2015;10;05;Sunnuntai;0;0;0
93;04.10.2015;2015;10;06;Sunnuntai;0;0;0
93;04.10.2015;2015;10;07;Sunnuntai;6;0;6
93;04.10.2015;2015;10;08;Sunnuntai;5;1;6
93;04.10.2015;2015;10;09;Sunnuntai;7;6;13
93;04.10.2015;2015;10;10;Sunnuntai;5;9;14
93;04.10.2015;2015;10;11;Sunnuntai;5;0;5
93;04.10.2015;2015;10;12;Sunnuntai;12;10;22
93;04.10.2015;2015;10;13;Sunnuntai;11;7;18
93;04.10.2015;2015;10;14;Sunnuntai;7;7;14
93;04.10.2015;2015;10;15;Sunnuntai;14;5;19
93;04.10.2015;2015;10;16;Sunnuntai;5;6;11
93;04.10.2015;2015;10;17;Sunnuntai;8;4;12
93;04.10.2015;2015;10;18;Sunnuntai;10;7;17
93;04.10.2015;2015;10;19;Sunnuntai;4;2;6
93;04.10.2015;2015;10;20;Sunnuntai;1;6;7
93;04.10.2015;2015;10;21;Sunnuntai;3;2;5
93;04.10.2015;2015;10;22;Sunnuntai;0;3;3
93;04.10.2015;2015;10;23;Sunnuntai;0;0;0
93;05.10.2015;2015;10;00;Maanantai;0;1;1
93;05.10.2015;2015;10;01;Maanantai;0;0;0
93;05.10.2015;2015;10;02;Maanantai;0;0;0
93;05.10.2015;2015;10;03;Maanantai;0;0;0
93;05.10.2015;2015;10;04;Maanantai;0;2;2
93;05.10.2015;2015;10;05;Maanantai;4;2;6
93;05.10.2015;2015;10;06;Maanantai;10;6;16
93;05.10.2015;2015;10;07;Maanantai;20;26;46
93;05.10.2015;2015;10;08;Maanantai;20;27;47
93;05.10.2015;2015;10;09;Maanantai;7;11;18
93;05.10.2015;2015;10;10;Maanantai;2;4;6
93;05.10.2015;2015;10;11;Maanantai;5;2;7
93;05.10.2015;2015;10;12;Maanantai;14;8;22
93;05.10.2015;2015;10;13;Maanantai;11;9;20
93;05.10.2015;2015;10;14;Maanantai;16;13;29
93;05.10.2015;2015;10;15;Maanantai;17;24;41
93;05.10.2015;2015;10;16;Maanantai;29;20;49
93;05.10.2015;2015;10;17;Maanantai;21;10;31
93;05.10.2015;2015;10;18;Maanantai;7;13;20
93;05.10.2015;2015;10;19;Maanantai;8;8;16
93;05.10.2015;2015;10;20;Maanantai;5;1;6
93;05.10.2015;2015;10;21;Maanantai;1;3;4
93;05.10.2015;2015;10;22;Maanantai;1;1;2
93;05.10.2015;2015;10;23;Maanantai;0;0;0
93;06.10.2015;2015;10;00;Tiistai;0;0;0
93;06.10.2015;2015;10;01;Tiistai;0;0;0
93;06.10.2015;2015;10;02;Tiistai;0;0;0
93;06.10.2015;2015;10;03;Tiistai;0;0;0
93;06.10.2015;2015;10;04;Tiistai;0;0;0
93;06.10.2015;2015;10;05;Tiistai;3;2;5
93;06.10.2015;2015;10;06;Tiistai;8;5;13
93;06.10.2015;2015;10;07;Tiistai;24;28;52
93;06.10.2015;2015;10;08;Tiistai;15;21;36
93;06.10.2015;2015;10;09;Tiistai;6;8;14
93;06.10.2015;2015;10;10;Tiistai;8;7;15
93;06.10.2015;2015;10;11;Tiistai;8;6;14
93;06.10.2015;2015;10;12;Tiistai;4;6;10
93;06.10.2015;2015;10;13;Tiistai;7;8;15
93;06.10.2015;2015;10;14;Tiistai;9;10;19
93;06.10.2015;2015;10;15;Tiistai;17;20;37
93;06.10.2015;2015;10;16;Tiistai;34;33;67
93;06.10.2015;2015;10;17;Tiistai;17;12;29
93;06.10.2015;2015;10;18;Tiistai;14;12;26
93;06.10.2015;2015;10;19;Tiistai;10;11;21
93;06.10.2015;2015;10;20;Tiistai;1;6;7
93;06.10.2015;2015;10;21;Tiistai;2;10;12
93;06.10.2015;2015;10;22;Tiistai;0;1;1
93;06.10.2015;2015;10;23;Tiistai;0;0;0
93;07.10.2015;2015;10;00;Keskiviikko;0;0;0
93;07.10.2015;2015;10;01;Keskiviikko;0;0;0
93;07.10.2015;2015;10;02;Keskiviikko;0;0;0
93;07.10.2015;2015;10;03;Keskiviikko;0;0;0
93;07.10.2015;2015;10;04;Keskiviikko;0;1;1
93;07.10.2015;2015;10;05;Keskiviikko;5;2;7
93;07.10.2015;2015;10;06;Keskiviikko;10;7;17
93;07.10.2015;2015;10;07;Keskiviikko;31;24;55
93;07.10.2015;2015;10;08;Keskiviikko;9;19;28
93;07.10.2015;2015;10;09;Keskiviikko;6;6;12
93;07.10.2015;2015;10;10;Keskiviikko;4;5;9
93;07.10.2015;2015;10;11;Keskiviikko;6;6;12
93;07.10.2015;2015;10;12;Keskiviikko;4;5;9
93;07.10.2015;2015;10;13;Keskiviikko;6;11;17
93;07.10.2015;2015;10;14;Keskiviikko;11;8;19
93;07.10.2015;2015;10;15;Keskiviikko;20;10;30
93;07.10.2015;2015;10;16;Keskiviikko;35;21;56
93;07.10.2015;2015;10;17;Keskiviikko;17;13;30
93;07.10.2015;2015;10;18;Keskiviikko;9;15;24
93;07.10.2015;2015;10;19;Keskiviikko;5;5;10
93;07.10.2015;2015;10;20;Keskiviikko;3;6;9
93;07.10.2015;2015;10;21;Keskiviikko;2;1;3
93;07.10.2015;2015;10;22;Keskiviikko;0;2;2
93;07.10.2015;2015;10;23;Keskiviikko;0;0;0
93;08.10.2015;2015;10;00;Torstai;0;0;0
93;08.10.2015;2015;10;01;Torstai;0;0;0
93;08.10.2015;2015;10;02;Torstai;0;0;0
93;08.10.2015;2015;10;03;Torstai;0;0;0
93;08.10.2015;2015;10;04;Torstai;0;1;1
93;08.10.2015;2015;10;05;Torstai;1;2;3
93;08.10.2015;2015;10;06;Torstai;13;3;16
93;08.10.2015;2015;10;07;Torstai;19;22;41
93;08.10.2015;2015;10;08;Torstai;7;21;28
93;08.10.2015;2015;10;09;Torstai;10;2;12
93;08.10.2015;2015;10;10;Torstai;5;7;12
93;08.10.2015;2015;10;11;Torstai;2;6;8
93;08.10.2015;2015;10;12;Torstai;12;3;15
93;08.10.2015;2015;10;13;Torstai;1;8;9
93;08.10.2015;2015;10;14;Torstai;15;11;26
93;08.10.2015;2015;10;15;Torstai;10;22;32
93;08.10.2015;2015;10;16;Torstai;23;20;43
93;08.10.2015;2015;10;17;Torstai;11;14;25
93;08.10.2015;2015;10;18;Torstai;8;7;15
93;08.10.2015;2015;10;19;Torstai;4;3;7
93;08.10.2015;2015;10;20;Torstai;2;2;4
93;08.10.2015;2015;10;21;Torstai;2;4;6
93;08.10.2015;2015;10;22;Torstai;0;1;1
93;08.10.2015;2015;10;23;Torstai;0;0;0
93;09.10.2015;2015;10;00;Perjantai;0;0;0
93;09.10.2015;2015;10;01;Perjantai;0;0;0
93;09.10.2015;2015;10;02;Perjantai;0;0;0
93;09.10.2015;2015;10;03;Perjantai;0;0;0
93;09.10.2015;2015;10;04;Perjantai;0;0;0
93;09.10.2015;2015;10;05;Perjantai;1;2;3
93;09.10.2015;2015;10;06;Perjantai;8;5;13
93;09.10.2015;2015;10;07;Perjantai;14;18;32
93;09.10.2015;2015;10;08;Perjantai;9;20;29
93;09.10.2015;2015;10;09;Perjantai;5;5;10
93;09.10.2015;2015;10;10;Perjantai;3;3;6
93;09.10.2015;2015;10;11;Perjantai;1;7;8
93;09.10.2015;2015;10;12;Perjantai;5;2;7
93;09.10.2015;2015;10;13;Perjantai;10;8;18
93;09.10.2015;2015;10;14;Perjantai;12;10;22
93;09.10.2015;2015;10;15;Perjantai;16;12;28
93;09.10.2015;2015;10;16;Perjantai;13;11;24
93;09.10.2015;2015;10;17;Perjantai;11;8;19
93;09.10.2015;2015;10;18;Perjantai;4;7;11
93;09.10.2015;2015;10;19;Perjantai;4;6;10
93;09.10.2015;2015;10;20;Perjantai;3;3;6
93;09.10.2015;2015;10;21;Perjantai;2;4;6
93;09.10.2015;2015;10;22;Perjantai;2;0;2
93;09.10.2015;2015;10;23;Perjantai;1;0;1
93;10.10.2015;2015;10;00;Lauantai;1;1;2
93;10.10.2015;2015;10;01;Lauantai;0;1;1
93;10.10.2015;2015;10;02;Lauantai;0;1;1
93;10.10.2015;2015;10;03;Lauantai;0;1;1
93;10.10.2015;2015;10;04;Lauantai;0;0;0
93;10.10.2015;2015;10;05;Lauantai;0;0;0
93;10.10.2015;2015;10;06;Lauantai;0;2;2
93;10.10.2015;2015;10;07;Lauantai;0;0;0
93;10.10.2015;2015;10;08;Lauantai;0;0;0
93;10.10.2015;2015;10;09;Lauantai;4;6;10
93;10.10.2015;2015;10;10;Lauantai;3;2;5
93;10.10.2015;2015;10;11;Lauantai;8;6;14
93;10.10.2015;2015;10;12;Lauantai;17;3;20
93;10.10.2015;2015;10;13;Lauantai;8;15;23
93;10.10.2015;2015;10;14;Lauantai;5;8;13
93;10.10.2015;2015;10;15;Lauantai;5;6;11
93;10.10.2015;2015;10;16;Lauantai;13;13;26
93;10.10.2015;2015;10;17;Lauantai;4;12;16
93;10.10.2015;2015;10;18;Lauantai;6;7;13
93;10.10.2015;2015;10;19;Lauantai;5;1;6
93;10.10.2015;2015;10;20;Lauantai;2;9;11
93;10.10.2015;2015;10;21;Lauantai;2;1;3
93;10.10.2015;2015;10;22;Lauantai;0;2;2
93;10.10.2015;2015;10;23;Lauantai;1;1;2
93;11.10.2015;2015;10;00;Sunnuntai;0;1;1
93;11.10.2015;2015;10;01;Sunnuntai;0;0;0
93;11.10.2015;2015;10;02;Sunnuntai;0;0;0
93;11.10.2015;2015;10;03;Sunnuntai;0;0;0
93;11.10.2015;2015;10;04;Sunnuntai;0;0;0
93;11.10.2015;2015;10;05;Sunnuntai;0;0;0
93;11.10.2015;2015;10;06;Sunnuntai;1;0;1
93;11.10.2015;2015;10;07;Sunnuntai;0;0;0
93;11.10.2015;2015;10;08;Sunnuntai;0;1;1
93;11.10.2015;2015;10;09;Sunnuntai;3;3;6
93;11.10.2015;2015;10;10;Sunnuntai;12;7;19
93;11.10.2015;2015;10;11;Sunnuntai;2;9;11
93;11.10.2015;2015;10;12;Sunnuntai;18;14;32
93;11.10.2015;2015;10;13;Sunnuntai;12;14;26
93;11.10.2015;2015;10;14;Sunnuntai;11;13;24
93;11.10.2015;2015;10;15;Sunnuntai;10;7;17
93;11.10.2015;2015;10;16;Sunnuntai;5;14;19
93;11.10.2015;2015;10;17;Sunnuntai;8;8;16
93;11.10.2015;2015;10;18;Sunnuntai;8;4;12
93;11.10.2015;2015;10;19;Sunnuntai;4;5;9
93;11.10.2015;2015;10;20;Sunnuntai;5;4;9
93;11.10.2015;2015;10;21;Sunnuntai;0;2;2
93;11.10.2015;2015;10;22;Sunnuntai;0;3;3
93;11.10.2015;2015;10;23;Sunnuntai;1;0;1
93;12.10.2015;2015;10;00;Maanantai;0;0;0
93;12.10.2015;2015;10;01;Maanantai;0;0;0
93;12.10.2015;2015;10;02;Maanantai;1;0;1
93;12.10.2015;2015;10;03;Maanantai;0;0;0
93;12.10.2015;2015;10;04;Maanantai;0;1;1
93;12.10.2015;2015;10;05;Maanantai;2;2;4
93;12.10.2015;2015;10;06;Maanantai;15;4;19
93;12.10.2015;2015;10;07;Maanantai;21;26;47
93;12.10.2015;2015;10;08;Maanantai;16;19;35
93;12.10.2015;2015;10;09;Maanantai;3;11;14
93;12.10.2015;2015;10;10;Maanantai;3;3;6
93;12.10.2015;2015;10;11;Maanantai;5;6;11
93;12.10.2015;2015;10;12;Maanantai;5;0;5
93;12.10.2015;2015;10;13;Maanantai;7;7;14
93;12.10.2015;2015;10;14;Maanantai;9;11;20
93;12.10.2015;2015;10;15;Maanantai;15;24;39
93;12.10.2015;2015;10;16;Maanantai;25;22;47
93;12.10.2015;2015;10;17;Maanantai;13;9;22
93;12.10.2015;2015;10;18;Maanantai;12;9;21
93;12.10.2015;2015;10;19;Maanantai;5;8;13
93;12.10.2015;2015;10;20;Maanantai;3;1;4
93;12.10.2015;2015;10;21;Maanantai;1;2;3
93;12.10.2015;2015;10;22;Maanantai;1;0;1
93;12.10.2015;2015;10;23;Maanantai;0;0;0
93;13.10.2015;2015;10;00;Tiistai;1;0;1
93;13.10.2015;2015;10;01;Tiistai;0;0;0
93;13.10.2015;2015;10;02;Tiistai;0;0;0
93;13.10.2015;2015;10;03;Tiistai;0;0;0
93;13.10.2015;2015;10;04;Tiistai;2;1;3
93;13.10.2015;2015;10;05;Tiistai;0;2;2
93;13.10.2015;2015;10;06;Tiistai;10;10;20
93;13.10.2015;2015;10;07;Tiistai;19;25;44
93;13.10.2015;2015;10;08;Tiistai;18;22;40
93;13.10.2015;2015;10;09;Tiistai;6;5;11
93;13.10.2015;2015;10;10;Tiistai;2;4;6
93;13.10.2015;2015;10;11;Tiistai;6;6;12
93;13.10.2015;2015;10;12;Tiistai;6;6;12
93;13.10.2015;2015;10;13;Tiistai;5;15;20
93;13.10.2015;2015;10;14;Tiistai;17;20;37
93;13.10.2015;2015;10;15;Tiistai;19;21;40
93;13.10.2015;2015;10;16;Tiistai;28;19;47
93;13.10.2015;2015;10;17;Tiistai;19;17;36
93;13.10.2015;2015;10;18;Tiistai;7;11;18
93;13.10.2015;2015;10;19;Tiistai;6;12;18
93;13.10.2015;2015;10;20;Tiistai;8;5;13
93;13.10.2015;2015;10;21;Tiistai;3;1;4
93;13.10.2015;2015;10;22;Tiistai;0;2;2
93;13.10.2015;2015;10;23;Tiistai;0;0;0
93;14.10.2015;2015;10;00;Keskiviikko;1;0;1
93;14.10.2015;2015;10;01;Keskiviikko;0;0;0
93;14.10.2015;2015;10;02;Keskiviikko;0;0;0
93;14.10.2015;2015;10;03;Keskiviikko;1;0;1
93;14.10.2015;2015;10;04;Keskiviikko;0;0;0
93;14.10.2015;2015;10;05;Keskiviikko;2;1;3
93;14.10.2015;2015;10;06;Keskiviikko;9;7;16
93;14.10.2015;2015;10;07;Keskiviikko;22;21;43
93;14.10.2015;2015;10;08;Keskiviikko;14;23;37
93;14.10.2015;2015;10;09;Keskiviikko;5;5;10
93;14.10.2015;2015;10;10;Keskiviikko;4;5;9
93;14.10.2015;2015;10;11;Keskiviikko;6;1;7
93;14.10.2015;2015;10;12;Keskiviikko;5;5;10
93;14.10.2015;2015;10;13;Keskiviikko;8;8;16
93;14.10.2015;2015;10;14;Keskiviikko;12;15;27
93;14.10.2015;2015;10;15;Keskiviikko;18;19;37
93;14.10.2015;2015;10;16;Keskiviikko;26;21;47
93;14.10.2015;2015;10;17;Keskiviikko;24;13;37
93;14.10.2015;2015;10;18;Keskiviikko;4;16;20
93;14.10.2015;2015;10;19;Keskiviikko;6;4;10
93;14.10.2015;2015;10;20;Keskiviikko;5;4;9
93;14.10.2015;2015;10;21;Keskiviikko;2;3;5
93;14.10.2015;2015;10;22;Keskiviikko;0;3;3
93;14.10.2015;2015;10;23;Keskiviikko;0;0;0
93;15.10.2015;2015;10;00;Torstai;1;0;1
93;15.10.2015;2015;10;01;Torstai;0;0;0
93;15.10.2015;2015;10;02;Torstai;1;0;1
93;15.10.2015;2015;10;03;Torstai;0;0;0
93;15.10.2015;2015;10;04;Torstai;0;0;0
93;15.10.2015;2015;10;05;Torstai;2;0;2
93;15.10.2015;2015;10;06;Torstai;11;10;21
93;15.10.2015;2015;10;07;Torstai;24;24;48
93;15.10.2015;2015;10;08;Torstai;10;23;33
93;15.10.2015;2015;10;09;Torstai;6;7;13
93;15.10.2015;2015;10;10;Torstai;9;4;13
93;15.10.2015;2015;10;11;Torstai;2;4;6
93;15.10.2015;2015;10;12;Torstai;4;5;9
93;15.10.2015;2015;10;13;Torstai;5;10;15
93;15.10.2015;2015;10;14;Torstai;8;15;23
93;15.10.2015;2015;10;15;Torstai;24;22;46
93;15.10.2015;2015;10;16;Torstai;23;30;53
93;15.10.2015;2015;10;17;Torstai;21;15;36
93;15.10.2015;2015;10;18;Torstai;9;6;15
93;15.10.2015;2015;10;19;Torstai;5;11;16
93;15.10.2015;2015;10;20;Torstai;5;5;10
93;15.10.2015;2015;10;21;Torstai;1;2;3
93;15.10.2015;2015;10;22;Torstai;2;1;3
93;15.10.2015;2015;10;23;Torstai;1;0;1
93;16.10.2015;2015;10;00;Perjantai;1;1;2
93;16.10.2015;2015;10;01;Perjantai;0;0;0
93;16.10.2015;2015;10;02;Perjantai;1;0;1
93;16.10.2015;2015;10;03;Perjantai;1;0;1
93;16.10.2015;2015;10;04;Perjantai;0;0;0
93;16.10.2015;2015;10;05;Perjantai;2;1;3
93;16.10.2015;2015;10;06;Perjantai;8;4;12
93;16.10.2015;2015;10;07;Perjantai;19;15;34
93;16.10.2015;2015;10;08;Perjantai;6;17;23
93;16.10.2015;2015;10;09;Perjantai;6;4;10
93;16.10.2015;2015;10;10;Perjantai;5;4;9
93;16.10.2015;2015;10;11;Perjantai;5;4;9
93;16.10.2015;2015;10;12;Perjantai;6;8;14
93;16.10.2015;2015;10;13;Perjantai;8;14;22
93;16.10.2015;2015;10;14;Perjantai;12;14;26
93;16.10.2015;2015;10;15;Perjantai;27;17;44
93;16.10.2015;2015;10;16;Perjantai;11;21;32
93;16.10.2015;2015;10;17;Perjantai;16;10;26
93;16.10.2015;2015;10;18;Perjantai;10;6;16
93;16.10.2015;2015;10;19;Perjantai;9;4;13
93;16.10.2015;2015;10;20;Perjantai;2;6;8
93;16.10.2015;2015;10;21;Perjantai;1;4;5
93;16.10.2015;2015;10;22;Perjantai;1;0;1
93;16.10.2015;2015;10;23;Perjantai;1;1;2
93;17.10.2015;2015;10;00;Lauantai;1;0;1
93;17.10.2015;2015;10;01;Lauantai;0;0;0
93;17.10.2015;2015;10;02;Lauantai;0;1;1
93;17.10.2015;2015;10;03;Lauantai;0;0;0
93;17.10.2015;2015;10;04;Lauantai;0;0;0
93;17.10.2015;2015;10;05;Lauantai;0;0;0
93;17.10.2015;2015;10;06;Lauantai;2;1;3
93;17.10.2015;2015;10;07;Lauantai;3;0;3
93;17.10.2015;2015;10;08;Lauantai;2;2;4
93;17.10.2015;2015;10;09;Lauantai;7;1;8
93;17.10.2015;2015;10;10;Lauantai;8;5;13
93;17.10.2015;2015;10;11;Lauantai;15;10;25
93;17.10.2015;2015;10;12;Lauantai;6;9;15
93;17.10.2015;2015;10;13;Lauantai;11;11;22
93;17.10.2015;2015;10;14;Lauantai;10;10;20
93;17.10.2015;2015;10;15;Lauantai;14;14;28
93;17.10.2015;2015;10;16;Lauantai;8;12;20
93;17.10.2015;2015;10;17;Lauantai;7;13;20
93;17.10.2015;2015;10;18;Lauantai;5;8;13
93;17.10.2015;2015;10;19;Lauantai;6;5;11
93;17.10.2015;2015;10;20;Lauantai;0;2;2
93;17.10.2015;2015;10;21;Lauantai;12;11;23
93;17.10.2015;2015;10;22;Lauantai;0;0;0
93;17.10.2015;2015;10;23;Lauantai;4;1;5
93;18.10.2015;2015;10;00;Sunnuntai;1;0;1
93;18.10.2015;2015;10;01;Sunnuntai;0;1;1
93;18.10.2015;2015;10;02;Sunnuntai;0;0;0
93;18.10.2015;2015;10;03;Sunnuntai;0;0;0
93;18.10.2015;2015;10;04;Sunnuntai;0;0;0
93;18.10.2015;2015;10;05;Sunnuntai;0;0;0
93;18.10.2015;2015;10;06;Sunnuntai;1;1;2
93;18.10.2015;2015;10;07;Sunnuntai;1;0;1
93;18.10.2015;2015;10;08;Sunnuntai;0;3;3
93;18.10.2015;2015;10;09;Sunnuntai;5;4;9
93;18.10.2015;2015;10;10;Sunnuntai;14;5;19
93;18.10.2015;2015;10;11;Sunnuntai;12;3;15
93;18.10.2015;2015;10;12;Sunnuntai;8;11;19
93;18.10.2015;2015;10;13;Sunnuntai;6;16;22
93;18.10.2015;2015;10;14;Sunnuntai;12;8;20
93;18.10.2015;2015;10;15;Sunnuntai;7;6;13
93;18.10.2015;2015;10;16;Sunnuntai;9;16;25
93;18.10.2015;2015;10;17;Sunnuntai;6;13;19
93;18.10.2015;2015;10;18;Sunnuntai;6;4;10
93;18.10.2015;2015;10;19;Sunnuntai;5;2;7
93;18.10.2015;2015;10;20;Sunnuntai;7;0;7
93;18.10.2015;2015;10;21;Sunnuntai;3;3;6
93;18.10.2015;2015;10;22;Sunnuntai;2;2;4
93;18.10.2015;2015;10;23;Sunnuntai;1;0;1
93;19.10.2015;2015;10;00;Maanantai;0;0;0
93;19.10.2015;2015;10;01;Maanantai;0;0;0
93;19.10.2015;2015;10;02;Maanantai;0;0;0
93;19.10.2015;2015;10;03;Maanantai;0;1;1
93;19.10.2015;2015;10;04;Maanantai;0;2;2
93;19.10.2015;2015;10;05;Maanantai;1;3;4
93;19.10.2015;2015;10;06;Maanantai;7;6;13
93;19.10.2015;2015;10;07;Maanantai;12;15;27
93;19.10.2015;2015;10;08;Maanantai;9;16;25
93;19.10.2015;2015;10;09;Maanantai;8;6;14
93;19.10.2015;2015;10;10;Maanantai;18;3;21
93;19.10.2015;2015;10;11;Maanantai;10;4;14
93;19.10.2015;2015;10;12;Maanantai;14;5;19
93;19.10.2015;2015;10;13;Maanantai;13;8;21
93;19.10.2015;2015;10;14;Maanantai;7;6;13
93;19.10.2015;2015;10;15;Maanantai;15;12;27
93;19.10.2015;2015;10;16;Maanantai;23;22;45
93;19.10.2015;2015;10;17;Maanantai;29;15;44
93;19.10.2015;2015;10;18;Maanantai;8;18;26
93;19.10.2015;2015;10;19;Maanantai;5;5;10
93;19.10.2015;2015;10;20;Maanantai;1;6;7
93;19.10.2015;2015;10;21;Maanantai;0;8;8
93;19.10.2015;2015;10;22;Maanantai;2;3;5
93;19.10.2015;2015;10;23;Maanantai;0;3;3
93;20.10.2015;2015;10;00;Tiistai;1;0;1
93;20.10.2015;2015;10;01;Tiistai;0;0;0
93;20.10.2015;2015;10;02;Tiistai;0;0;0
93;20.10.2015;2015;10;03;Tiistai;0;0;0
93;20.10.2015;2015;10;04;Tiistai;0;1;1
93;20.10.2015;2015;10;05;Tiistai;1;2;3
93;20.10.2015;2015;10;06;Tiistai;8;5;13
93;20.10.2015;2015;10;07;Tiistai;9;18;27
93;20.10.2015;2015;10;08;Tiistai;9;13;22
93;20.10.2015;2015;10;09;Tiistai;6;7;13
93;20.10.2015;2015;10;10;Tiistai;8;3;11
93;20.10.2015;2015;10;11;Tiistai;4;4;8
93;20.10.2015;2015;10;12;Tiistai;7;2;9
93;20.10.2015;2015;10;13;Tiistai;5;6;11
93;20.10.2015;2015;10;14;Tiistai;7;9;16
93;20.10.2015;2015;10;15;Tiistai;7;3;10
93;20.10.2015;2015;10;16;Tiistai;17;14;31
93;20.10.2015;2015;10;17;Tiistai;12;7;19
93;20.10.2015;2015;10;18;Tiistai;8;5;13
93;20.10.2015;2015;10;19;Tiistai;2;1;3
93;20.10.2015;2015;10;20;Tiistai;0;2;2
93;20.10.2015;2015;10;21;Tiistai;3;2;5
93;20.10.2015;2015;10;22;Tiistai;0;1;1
93;20.10.2015;2015;10;23;Tiistai;2;0;2
93;21.10.2015;2015;10;00;Keskiviikko;0;0;0
93;21.10.2015;2015;10;01;Keskiviikko;0;0;0
93;21.10.2015;2015;10;02;Keskiviikko;0;0;0
93;21.10.2015;2015;10;03;Keskiviikko;0;0;0
93;21.10.2015;2015;10;04;Keskiviikko;0;1;1
93;21.10.2015;2015;10;05;Keskiviikko;1;2;3
93;21.10.2015;2015;10;06;Keskiviikko;6;2;8
93;21.10.2015;2015;10;07;Keskiviikko;8;13;21
93;21.10.2015;2015;10;08;Keskiviikko;3;16;19
93;21.10.2015;2015;10;09;Keskiviikko;1;6;7
93;21.10.2015;2015;10;10;Keskiviikko;5;3;8
93;21.10.2015;2015;10;11;Keskiviikko;2;4;6
93;21.10.2015;2015;10;12;Keskiviikko;6;1;7
93;21.10.2015;2015;10;13;Keskiviikko;8;4;12
93;21.10.2015;2015;10;14;Keskiviikko;5;4;9
93;21.10.2015;2015;10;15;Keskiviikko;9;12;21
93;21.10.2015;2015;10;16;Keskiviikko;15;6;21
93;21.10.2015;2015;10;17;Keskiviikko;19;7;26
93;21.10.2015;2015;10;18;Keskiviikko;6;7;13
93;21.10.2015;2015;10;19;Keskiviikko;0;0;0
93;21.10.2015;2015;10;20;Keskiviikko;3;3;6
93;21.10.2015;2015;10;21;Keskiviikko;0;5;5
93;21.10.2015;2015;10;22;Keskiviikko;0;0;0
93;21.10.2015;2015;10;23;Keskiviikko;0;0;0
93;22.10.2015;2015;10;00;Torstai;1;0;1
93;22.10.2015;2015;10;01;Torstai;0;2;2
93;22.10.2015;2015;10;02;Torstai;0;0;0
93;22.10.2015;2015;10;03;Torstai;0;0;0
93;22.10.2015;2015;10;04;Torstai;0;1;1
93;22.10.2015;2015;10;05;Torstai;0;1;1
93;22.10.2015;2015;10;06;Torstai;3;2;5
93;22.10.2015;2015;10;07;Torstai;5;8;13
93;22.10.2015;2015;10;08;Torstai;3;11;14
93;22.10.2015;2015;10;09;Torstai;4;6;10
93;22.10.2015;2015;10;10;Torstai;3;3;6
93;22.10.2015;2015;10;11;Torstai;5;3;8
93;22.10.2015;2015;10;12;Torstai;4;2;6
93;22.10.2015;2015;10;13;Torstai;3;1;4
93;22.10.2015;2015;10;14;Torstai;3;5;8
93;22.10.2015;2015;10;15;Torstai;7;10;17
93;22.10.2015;2015;10;16;Torstai;10;16;26
93;22.10.2015;2015;10;17;Torstai;14;8;22
93;22.10.2015;2015;10;18;Torstai;7;5;12
93;22.10.2015;2015;10;19;Torstai;6;2;8
93;22.10.2015;2015;10;20;Torstai;0;1;1
93;22.10.2015;2015;10;21;Torstai;1;5;6
93;22.10.2015;2015;10;22;Torstai;0;0;0
93;22.10.2015;2015;10;23;Torstai;0;0;0
93;23.10.2015;2015;10;00;Perjantai;0;0;0
93;23.10.2015;2015;10;01;Perjantai;0;0;0
93;23.10.2015;2015;10;02;Perjantai;0;0;0
93;23.10.2015;2015;10;03;Perjantai;0;0;0
93;23.10.2015;2015;10;04;Perjantai;0;1;1
93;23.10.2015;2015;10;05;Perjantai;1;1;2
93;23.10.2015;2015;10;06;Perjantai;11;2;13
93;23.10.2015;2015;10;07;Perjantai;4;4;8
93;23.10.2015;2015;10;08;Perjantai;1;13;14
93;23.10.2015;2015;10;09;Perjantai;5;6;11
93;23.10.2015;2015;10;10;Perjantai;2;1;3
93;23.10.2015;2015;10;11;Perjantai;3;2;5
93;23.10.2015;2015;10;12;Perjantai;5;4;9
93;23.10.2015;2015;10;13;Perjantai;2;2;4
93;23.10.2015;2015;10;14;Perjantai;9;7;16
93;23.10.2015;2015;10;15;Perjantai;9;4;13
93;23.10.2015;2015;10;16;Perjantai;8;10;18
93;23.10.2015;2015;10;17;Perjantai;8;9;17
93;23.10.2015;2015;10;18;Perjantai;2;9;11
93;23.10.2015;2015;10;19;Perjantai;2;1;3
93;23.10.2015;2015;10;20;Perjantai;3;2;5
93;23.10.2015;2015;10;21;Perjantai;2;1;3
93;23.10.2015;2015;10;22;Perjantai;1;0;1
93;23.10.2015;2015;10;23;Perjantai;0;2;2
93;24.10.2015;2015;10;00;Lauantai;1;0;1
93;24.10.2015;2015;10;01;Lauantai;1;0;1
93;24.10.2015;2015;10;02;Lauantai;0;0;0
93;24.10.2015;2015;10;03;Lauantai;1;0;1
93;24.10.2015;2015;10;04;Lauantai;1;0;1
93;24.10.2015;2015;10;05;Lauantai;1;0;1
93;24.10.2015;2015;10;06;Lauantai;0;0;0
93;24.10.2015;2015;10;07;Lauantai;0;1;1
93;24.10.2015;2015;10;08;Lauantai;1;2;3
93;24.10.2015;2015;10;09;Lauantai;8;8;16
93;24.10.2015;2015;10;10;Lauantai;4;5;9
93;24.10.2015;2015;10;11;Lauantai;6;6;12
93;24.10.2015;2015;10;12;Lauantai;6;10;16
93;24.10.2015;2015;10;13;Lauantai;9;9;18
93;24.10.2015;2015;10;14;Lauantai;6;16;22
93;24.10.2015;2015;10;15;Lauantai;5;14;19
93;24.10.2015;2015;10;16;Lauantai;9;4;13
93;24.10.2015;2015;10;17;Lauantai;6;6;12
93;24.10.2015;2015;10;18;Lauantai;9;3;12
93;24.10.2015;2015;10;19;Lauantai;3;3;6
93;24.10.2015;2015;10;20;Lauantai;3;1;4
93;24.10.2015;2015;10;21;Lauantai;15;5;20
93;24.10.2015;2015;10;22;Lauantai;0;6;6
93;24.10.2015;2015;10;23;Lauantai;0;0;0
93;25.10.2015;2015;10;00;Sunnuntai;0;0;0
93;25.10.2015;2015;10;01;Sunnuntai;0;0;0
93;25.10.2015;2015;10;02;Sunnuntai;0;0;0
93;25.10.2015;2015;10;03;Sunnuntai;0;1;1
93;25.10.2015;2015;10;04;Sunnuntai;0;0;0
93;25.10.2015;2015;10;05;Sunnuntai;0;0;0
93;25.10.2015;2015;10;06;Sunnuntai;2;0;2
93;25.10.2015;2015;10;07;Sunnuntai;2;0;2
93;25.10.2015;2015;10;08;Sunnuntai;2;2;4
93;25.10.2015;2015;10;09;Sunnuntai;2;1;3
93;25.10.2015;2015;10;10;Sunnuntai;3;2;5
93;25.10.2015;2015;10;11;Sunnuntai;4;3;7
93;25.10.2015;2015;10;12;Sunnuntai;1;3;4
93;25.10.2015;2015;10;13;Sunnuntai;0;2;2
93;25.10.2015;2015;10;14;Sunnuntai;0;1;1
93;25.10.2015;2015;10;15;Sunnuntai;2;0;2
93;25.10.2015;2015;10;16;Sunnuntai;0;0;0
93;25.10.2015;2015;10;17;Sunnuntai;0;0;0
93;25.10.2015;2015;10;18;Sunnuntai;4;5;9
93;25.10.2015;2015;10;19;Sunnuntai;0;2;2
93;25.10.2015;2015;10;20;Sunnuntai;2;0;2
93;25.10.2015;2015;10;21;Sunnuntai;0;0;0
93;25.10.2015;2015;10;22;Sunnuntai;0;0;0
93;25.10.2015;2015;10;23;Sunnuntai;1;0;1
93;26.10.2015;2015;10;00;Maanantai;1;0;1
93;26.10.2015;2015;10;01;Maanantai;1;1;2
93;26.10.2015;2015;10;02;Maanantai;0;0;0
93;26.10.2015;2015;10;03;Maanantai;0;0;0
93;26.10.2015;2015;10;04;Maanantai;0;0;0
93;26.10.2015;2015;10;05;Maanantai;0;0;0
93;26.10.2015;2015;10;06;Maanantai;18;6;24
93;26.10.2015;2015;10;07;Maanantai;19;25;44
93;26.10.2015;2015;10;08;Maanantai;11;16;27
93;26.10.2015;2015;10;09;Maanantai;8;9;17
93;26.10.2015;2015;10;10;Maanantai;7;6;13
93;26.10.2015;2015;10;11;Maanantai;2;7;9
93;26.10.2015;2015;10;12;Maanantai;7;6;13
93;26.10.2015;2015;10;13;Maanantai;10;13;23
93;26.10.2015;2015;10;14;Maanantai;13;11;24
93;26.10.2015;2015;10;15;Maanantai;19;18;37
93;26.10.2015;2015;10;16;Maanantai;21;26;47
93;26.10.2015;2015;10;17;Maanantai;19;12;31
93;26.10.2015;2015;10;18;Maanantai;8;8;16
93;26.10.2015;2015;10;19;Maanantai;4;8;12
93;26.10.2015;2015;10;20;Maanantai;3;5;8
93;26.10.2015;2015;10;21;Maanantai;3;4;7
93;26.10.2015;2015;10;22;Maanantai;0;3;3
93;26.10.2015;2015;10;23;Maanantai;0;0;0
93;27.10.2015;2015;10;00;Tiistai;1;0;1
93;27.10.2015;2015;10;01;Tiistai;0;0;0
93;27.10.2015;2015;10;02;Tiistai;0;0;0
93;27.10.2015;2015;10;03;Tiistai;1;0;1
93;27.10.2015;2015;10;04;Tiistai;0;0;0
93;27.10.2015;2015;10;05;Tiistai;3;2;5
93;27.10.2015;2015;10;06;Tiistai;9;4;13
93;27.10.2015;2015;10;07;Tiistai;11;16;27
93;27.10.2015;2015;10;08;Tiistai;8;17;25
93;27.10.2015;2015;10;09;Tiistai;7;6;13
93;27.10.2015;2015;10;10;Tiistai;6;1;7
93;27.10.2015;2015;10;11;Tiistai;5;2;7
93;27.10.2015;2015;10;12;Tiistai;1;4;5
93;27.10.2015;2015;10;13;Tiistai;4;7;11
93;27.10.2015;2015;10;14;Tiistai;6;8;14
93;27.10.2015;2015;10;15;Tiistai;9;13;22
93;27.10.2015;2015;10;16;Tiistai;17;14;31
93;27.10.2015;2015;10;17;Tiistai;9;7;16
93;27.10.2015;2015;10;18;Tiistai;10;7;17
93;27.10.2015;2015;10;19;Tiistai;5;7;12
93;27.10.2015;2015;10;20;Tiistai;2;0;2
93;27.10.2015;2015;10;21;Tiistai;2;4;6
93;27.10.2015;2015;10;22;Tiistai;0;1;1
93;27.10.2015;2015;10;23;Tiistai;0;0;0
93;28.10.2015;2015;10;00;Keskiviikko;1;0;1
93;28.10.2015;2015;10;01;Keskiviikko;0;0;0
93;28.10.2015;2015;10;02;Keskiviikko;0;0;0
93;28.10.2015;2015;10;03;Keskiviikko;1;0;1
93;28.10.2015;2015;10;04;Keskiviikko;0;0;0
93;28.10.2015;2015;10;05;Keskiviikko;0;2;2
93;28.10.2015;2015;10;06;Keskiviikko;9;10;19
93;28.10.2015;2015;10;07;Keskiviikko;19;20;39
93;28.10.2015;2015;10;08;Keskiviikko;6;21;27
93;28.10.2015;2015;10;09;Keskiviikko;5;4;9
93;28.10.2015;2015;10;10;Keskiviikko;3;2;5
93;28.10.2015;2015;10;11;Keskiviikko;3;1;4
93;28.10.2015;2015;10;12;Keskiviikko;9;5;14
93;28.10.2015;2015;10;13;Keskiviikko;1;7;8
93;28.10.2015;2015;10;14;Keskiviikko;11;15;26
93;28.10.2015;2015;10;15;Keskiviikko;18;14;32
93;28.10.2015;2015;10;16;Keskiviikko;22;20;42
93;28.10.2015;2015;10;17;Keskiviikko;13;8;21
93;28.10.2015;2015;10;18;Keskiviikko;7;4;11
93;28.10.2015;2015;10;19;Keskiviikko;6;8;14
93;28.10.2015;2015;10;20;Keskiviikko;2;3;5
93;28.10.2015;2015;10;21;Keskiviikko;1;3;4
93;28.10.2015;2015;10;22;Keskiviikko;1;3;4
93;28.10.2015;2015;10;23;Keskiviikko;0;0;0
93;29.10.2015;2015;10;00;Torstai;1;0;1
93;29.10.2015;2015;10;01;Torstai;0;0;0
93;29.10.2015;2015;10;02;Torstai;0;0;0
93;29.10.2015;2015;10;03;Torstai;1;0;1
93;29.10.2015;2015;10;04;Torstai;0;0;0
93;29.10.2015;2015;10;05;Torstai;0;2;2
93;29.10.2015;2015;10;06;Torstai;8;3;11
93;29.10.2015;2015;10;07;Torstai;17;23;40
93;29.10.2015;2015;10;08;Torstai;9;18;27
93;29.10.2015;2015;10;09;Torstai;9;2;11
93;29.10.2015;2015;10;10;Torstai;5;2;7
93;29.10.2015;2015;10;11;Torstai;8;3;11
93;29.10.2015;2015;10;12;Torstai;1;11;12
93;29.10.2015;2015;10;13;Torstai;3;11;14
93;29.10.2015;2015;10;14;Torstai;8;6;14
93;29.10.2015;2015;10;15;Torstai;12;11;23
93;29.10.2015;2015;10;16;Torstai;21;20;41
93;29.10.2015;2015;10;17;Torstai;15;7;22
93;29.10.2015;2015;10;18;Torstai;4;3;7
93;29.10.2015;2015;10;19;Torstai;1;4;5
93;29.10.2015;2015;10;20;Torstai;1;2;3
93;29.10.2015;2015;10;21;Torstai;3;2;5
93;29.10.2015;2015;10;22;Torstai;2;2;4
93;29.10.2015;2015;10;23;Torstai;0;2;2
93;30.10.2015;2015;10;00;Perjantai;1;0;1
93;30.10.2015;2015;10;01;Perjantai;0;0;0
93;30.10.2015;2015;10;02;Perjantai;0;0;0
93;30.10.2015;2015;10;03;Perjantai;0;0;0
93;30.10.2015;2015;10;04;Perjantai;0;0;0
93;30.10.2015;2015;10;05;Perjantai;1;2;3
93;30.10.2015;2015;10;06;Perjantai;4;4;8
93;30.10.2015;2015;10;07;Perjantai;8;18;26
93;30.10.2015;2015;10;08;Perjantai;8;14;22
93;30.10.2015;2015;10;09;Perjantai;5;6;11
93;30.10.2015;2015;10;10;Perjantai;1;3;4
93;30.10.2015;2015;10;11;Perjantai;3;6;9
93;30.10.2015;2015;10;12;Perjantai;5;3;8
93;30.10.2015;2015;10;13;Perjantai;5;8;13
93;30.10.2015;2015;10;14;Perjantai;6;9;15
93;30.10.2015;2015;10;15;Perjantai;12;11;23
93;30.10.2015;2015;10;16;Perjantai;14;12;26
93;30.10.2015;2015;10;17;Perjantai;10;6;16
93;30.10.2015;2015;10;18;Perjantai;8;7;15
93;30.10.2015;2015;10;19;Perjantai;4;1;5
93;30.10.2015;2015;10;20;Perjantai;1;2;3
93;30.10.2015;2015;10;21;Perjantai;1;1;2
93;30.10.2015;2015;10;22;Perjantai;2;1;3
93;30.10.2015;2015;10;23;Perjantai;1;0;1
93;31.10.2015;2015;10;00;Lauantai;0;1;1
93;31.10.2015;2015;10;01;Lauantai;0;0;0
93;31.10.2015;2015;10;02;Lauantai;0;1;1
93;31.10.2015;2015;10;03;Lauantai;0;1;1
93;31.10.2015;2015;10;04;Lauantai;0;0;0
93;31.10.2015;2015;10;05;Lauantai;1;0;1
93;31.10.2015;2015;10;06;Lauantai;0;0;0
93;31.10.2015;2015;10;07;Lauantai;2;0;2
93;31.10.2015;2015;10;08;Lauantai;1;2;3
93;31.10.2015;2015;10;09;Lauantai;0;1;1
93;31.10.2015;2015;10;10;Lauantai;2;3;5
93;31.10.2015;2015;10;11;Lauantai;2;5;7
93;31.10.2015;2015;10;12;Lauantai;2;5;7
93;31.10.2015;2015;10;13;Lauantai;5;2;7
93;31.10.2015;2015;10;14;Lauantai;4;5;9
93;31.10.2015;2015;10;15;Lauantai;4;7;11
93;31.10.2015;2015;10;16;Lauantai;3;4;7
93;31.10.2015;2015;10;17;Lauantai;3;3;6
93;31.10.2015;2015;10;18;Lauantai;4;2;6
93;31.10.2015;2015;10;19;Lauantai;4;5;9
93;31.10.2015;2015;10;20;Lauantai;3;3;6
93;31.10.2015;2015;10;21;Lauantai;1;2;3
93;31.10.2015;2015;10;22;Lauantai;0;0;0
93;31.10.2015;2015;10;23;Lauantai;1;1;2
93;01.11.2015;2015;11;00;Sunnuntai;0;1;1
93;01.11.2015;2015;11;01;Sunnuntai;0;0;0
93;01.11.2015;2015;11;02;Sunnuntai;0;0;0
93;01.11.2015;2015;11;03;Sunnuntai;0;0;0
93;01.11.2015;2015;11;04;Sunnuntai;0;0;0
93;01.11.2015;2015;11;05;Sunnuntai;0;0;0
93;01.11.2015;2015;11;06;Sunnuntai;2;2;4
93;01.11.2015;2015;11;07;Sunnuntai;1;0;1
93;01.11.2015;2015;11;08;Sunnuntai;0;1;1
93;01.11.2015;2015;11;09;Sunnuntai;1;2;3
93;01.11.2015;2015;11;10;Sunnuntai;4;1;5
93;01.11.2015;2015;11;11;Sunnuntai;8;7;15
93;01.11.2015;2015;11;12;Sunnuntai;7;7;14
93;01.11.2015;2015;11;13;Sunnuntai;9;8;17
93;01.11.2015;2015;11;14;Sunnuntai;6;10;16
93;01.11.2015;2015;11;15;Sunnuntai;8;8;16
93;01.11.2015;2015;11;16;Sunnuntai;10;5;15
93;01.11.2015;2015;11;17;Sunnuntai;4;7;11
93;01.11.2015;2015;11;18;Sunnuntai;0;1;1
93;01.11.2015;2015;11;19;Sunnuntai;6;1;7
93;01.11.2015;2015;11;20;Sunnuntai;0;4;4
93;01.11.2015;2015;11;21;Sunnuntai;1;1;2
93;01.11.2015;2015;11;22;Sunnuntai;1;0;1
93;01.11.2015;2015;11;23;Sunnuntai;0;0;0
93;02.11.2015;2015;11;00;Maanantai;0;0;0
93;02.11.2015;2015;11;01;Maanantai;0;0;0
93;02.11.2015;2015;11;02;Maanantai;0;0;0
93;02.11.2015;2015;11;03;Maanantai;0;0;0
93;02.11.2015;2015;11;04;Maanantai;0;0;0
93;02.11.2015;2015;11;05;Maanantai;3;2;5
93;02.11.2015;2015;11;06;Maanantai;11;4;15
93;02.11.2015;2015;11;07;Maanantai;17;14;31
93;02.11.2015;2015;11;08;Maanantai;13;26;39
93;02.11.2015;2015;11;09;Maanantai;7;8;15
93;02.11.2015;2015;11;10;Maanantai;3;3;6
93;02.11.2015;2015;11;11;Maanantai;2;3;5
93;02.11.2015;2015;11;12;Maanantai;5;3;8
93;02.11.2015;2015;11;13;Maanantai;5;3;8
93;02.11.2015;2015;11;14;Maanantai;13;8;21
93;02.11.2015;2015;11;15;Maanantai;13;18;31
93;02.11.2015;2015;11;16;Maanantai;21;16;37
93;02.11.2015;2015;11;17;Maanantai;12;7;19
93;02.11.2015;2015;11;18;Maanantai;7;10;17
93;02.11.2015;2015;11;19;Maanantai;1;2;3
93;02.11.2015;2015;11;20;Maanantai;1;3;4
93;02.11.2015;2015;11;21;Maanantai;1;4;5
93;02.11.2015;2015;11;22;Maanantai;0;0;0
93;02.11.2015;2015;11;23;Maanantai;0;0;0
93;03.11.2015;2015;11;00;Tiistai;0;1;1
93;03.11.2015;2015;11;01;Tiistai;0;0;0
93;03.11.2015;2015;11;02;Tiistai;0;0;0
93;03.11.2015;2015;11;03;Tiistai;0;0;0
93;03.11.2015;2015;11;04;Tiistai;0;2;2
93;03.11.2015;2015;11;05;Tiistai;1;2;3
93;03.11.2015;2015;11;06;Tiistai;7;3;10
93;03.11.2015;2015;11;07;Tiistai;15;18;33
93;03.11.2015;2015;11;08;Tiistai;11;17;28
93;03.11.2015;2015;11;09;Tiistai;8;4;12
93;03.11.2015;2015;11;10;Tiistai;6;9;15
93;03.11.2015;2015;11;11;Tiistai;5;8;13
93;03.11.2015;2015;11;12;Tiistai;11;7;18
93;03.11.2015;2015;11;13;Tiistai;10;8;18
93;03.11.2015;2015;11;14;Tiistai;12;11;23
93;03.11.2015;2015;11;15;Tiistai;12;11;23
93;03.11.2015;2015;11;16;Tiistai;16;18;34
93;03.11.2015;2015;11;17;Tiistai;7;13;20
93;03.11.2015;2015;11;18;Tiistai;9;11;20
93;03.11.2015;2015;11;19;Tiistai;8;5;13
93;03.11.2015;2015;11;20;Tiistai;4;2;6
93;03.11.2015;2015;11;21;Tiistai;2;1;3
93;03.11.2015;2015;11;22;Tiistai;0;2;2
93;03.11.2015;2015;11;23;Tiistai;0;2;2
93;04.11.2015;2015;11;00;Keskiviikko;1;0;1
93;04.11.2015;2015;11;01;Keskiviikko;0;0;0
93;04.11.2015;2015;11;02;Keskiviikko;0;0;0
93;04.11.2015;2015;11;03;Keskiviikko;0;0;0
93;04.11.2015;2015;11;04;Keskiviikko;0;2;2
93;04.11.2015;2015;11;05;Keskiviikko;0;3;3
93;04.11.2015;2015;11;06;Keskiviikko;13;7;20
93;04.11.2015;2015;11;07;Keskiviikko;22;27;49
93;04.11.2015;2015;11;08;Keskiviikko;6;20;26
93;04.11.2015;2015;11;09;Keskiviikko;3;2;5
93;04.11.2015;2015;11;10;Keskiviikko;10;14;24
93;04.11.2015;2015;11;11;Keskiviikko;4;13;17
93;04.11.2015;2015;11;12;Keskiviikko;6;6;12
93;04.11.2015;2015;11;13;Keskiviikko;14;13;27
93;04.11.2015;2015;11;14;Keskiviikko;20;11;31
93;04.11.2015;2015;11;15;Keskiviikko;16;15;31
93;04.11.2015;2015;11;16;Keskiviikko;27;18;45
93;04.11.2015;2015;11;17;Keskiviikko;17;9;26
93;04.11.2015;2015;11;18;Keskiviikko;7;6;13
93;04.11.2015;2015;11;19;Keskiviikko;8;6;14
93;04.11.2015;2015;11;20;Keskiviikko;2;7;9
93;04.11.2015;2015;11;21;Keskiviikko;0;4;4
93;04.11.2015;2015;11;22;Keskiviikko;0;1;1
93;04.11.2015;2015;11;23;Keskiviikko;1;0;1
93;05.11.2015;2015;11;00;Torstai;0;1;1
93;05.11.2015;2015;11;01;Torstai;0;0;0
93;05.11.2015;2015;11;02;Torstai;0;0;0
93;05.11.2015;2015;11;03;Torstai;0;0;0
93;05.11.2015;2015;11;04;Torstai;0;1;1
93;05.11.2015;2015;11;05;Torstai;2;1;3
93;05.11.2015;2015;11;06;Torstai;9;6;15
93;05.11.2015;2015;11;07;Torstai;17;26;43
93;05.11.2015;2015;11;08;Torstai;14;13;27
93;05.11.2015;2015;11;09;Torstai;7;6;13
93;05.11.2015;2015;11;10;Torstai;9;3;12
93;05.11.2015;2015;11;11;Torstai;3;2;5
93;05.11.2015;2015;11;12;Torstai;3;2;5
93;05.11.2015;2015;11;13;Torstai;3;11;14
93;05.11.2015;2015;11;14;Torstai;8;7;15
93;05.11.2015;2015;11;15;Torstai;15;17;32
93;05.11.2015;2015;11;16;Torstai;21;20;41
93;05.11.2015;2015;11;17;Torstai;13;13;26
93;05.11.2015;2015;11;18;Torstai;7;6;13
93;05.11.2015;2015;11;19;Torstai;3;8;11
93;05.11.2015;2015;11;20;Torstai;2;2;4
93;05.11.2015;2015;11;21;Torstai;1;1;2
93;05.11.2015;2015;11;22;Torstai;0;1;1
93;05.11.2015;2015;11;23;Torstai;1;0;1
93;06.11.2015;2015;11;00;Perjantai;0;0;0
93;06.11.2015;2015;11;01;Perjantai;0;0;0
93;06.11.2015;2015;11;02;Perjantai;0;0;0
93;06.11.2015;2015;11;03;Perjantai;0;0;0
93;06.11.2015;2015;11;04;Perjantai;0;1;1
93;06.11.2015;2015;11;05;Perjantai;1;2;3
93;06.11.2015;2015;11;06;Perjantai;8;5;13
93;06.11.2015;2015;11;07;Perjantai;11;21;32
93;06.11.2015;2015;11;08;Perjantai;10;13;23
93;06.11.2015;2015;11;09;Perjantai;5;3;8
93;06.11.2015;2015;11;10;Perjantai;4;2;6
93;06.11.2015;2015;11;11;Perjantai;2;7;9
93;06.11.2015;2015;11;12;Perjantai;4;5;9
93;06.11.2015;2015;11;13;Perjantai;4;4;8
93;06.11.2015;2015;11;14;Perjantai;12;7;19
93;06.11.2015;2015;11;15;Perjantai;18;8;26
93;06.11.2015;2015;11;16;Perjantai;17;14;31
93;06.11.2015;2015;11;17;Perjantai;6;6;12
93;06.11.2015;2015;11;18;Perjantai;4;3;7
93;06.11.2015;2015;11;19;Perjantai;5;3;8
93;06.11.2015;2015;11;20;Perjantai;2;2;4
93;06.11.2015;2015;11;21;Perjantai;0;3;3
93;06.11.2015;2015;11;22;Perjantai;0;0;0
93;06.11.2015;2015;11;23;Perjantai;0;1;1
93;07.11.2015;2015;11;00;Lauantai;0;0;0
93;07.11.2015;2015;11;01;Lauantai;0;0;0
93;07.11.2015;2015;11;02;Lauantai;0;0;0
93;07.11.2015;2015;11;03;Lauantai;0;2;2
93;07.11.2015;2015;11;04;Lauantai;1;1;2
93;07.11.2015;2015;11;05;Lauantai;0;0;0
93;07.11.2015;2015;11;06;Lauantai;0;1;1
93;07.11.2015;2015;11;07;Lauantai;0;1;1
93;07.11.2015;2015;11;08;Lauantai;2;1;3
93;07.11.2015;2015;11;09;Lauantai;3;3;6
93;07.11.2015;2015;11;10;Lauantai;2;2;4
93;07.11.2015;2015;11;11;Lauantai;1;0;1
93;07.11.2015;2015;11;12;Lauantai;5;2;7
93;07.11.2015;2015;11;13;Lauantai;4;7;11
93;07.11.2015;2015;11;14;Lauantai;7;3;10
93;07.11.2015;2015;11;15;Lauantai;7;4;11
93;07.11.2015;2015;11;16;Lauantai;1;4;5
93;07.11.2015;2015;11;17;Lauantai;2;7;9
93;07.11.2015;2015;11;18;Lauantai;4;2;6
93;07.11.2015;2015;11;19;Lauantai;3;0;3
93;07.11.2015;2015;11;20;Lauantai;1;0;1
93;07.11.2015;2015;11;21;Lauantai;1;0;1
93;07.11.2015;2015;11;22;Lauantai;0;1;1
93;07.11.2015;2015;11;23;Lauantai;0;1;1
93;08.11.2015;2015;11;00;Sunnuntai;0;0;0
93;08.11.2015;2015;11;01;Sunnuntai;0;0;0
93;08.11.2015;2015;11;02;Sunnuntai;0;1;1
93;08.11.2015;2015;11;03;Sunnuntai;0;0;0
93;08.11.2015;2015;11;04;Sunnuntai;0;0;0
93;08.11.2015;2015;11;05;Sunnuntai;0;1;1
93;08.11.2015;2015;11;06;Sunnuntai;1;1;2
93;08.11.2015;2015;11;07;Sunnuntai;0;0;0
93;08.11.2015;2015;11;08;Sunnuntai;0;1;1
93;08.11.2015;2015;11;09;Sunnuntai;2;2;4
93;08.11.2015;2015;11;10;Sunnuntai;5;1;6
93;08.11.2015;2015;11;11;Sunnuntai;2;7;9
93;08.11.2015;2015;11;12;Sunnuntai;4;3;7
93;08.11.2015;2015;11;13;Sunnuntai;5;6;11
93;08.11.2015;2015;11;14;Sunnuntai;10;4;14
93;08.11.2015;2015;11;15;Sunnuntai;6;2;8
93;08.11.2015;2015;11;16;Sunnuntai;6;2;8
93;08.11.2015;2015;11;17;Sunnuntai;2;2;4
93;08.11.2015;2015;11;18;Sunnuntai;1;6;7
93;08.11.2015;2015;11;19;Sunnuntai;1;0;1
93;08.11.2015;2015;11;20;Sunnuntai;0;5;5
93;08.11.2015;2015;11;21;Sunnuntai;6;2;8
93;08.11.2015;2015;11;22;Sunnuntai;1;1;2
93;08.11.2015;2015;11;23;Sunnuntai;1;0;1
93;09.11.2015;2015;11;00;Maanantai;0;0;0
93;09.11.2015;2015;11;01;Maanantai;0;0;0
93;09.11.2015;2015;11;02;Maanantai;0;0;0
93;09.11.2015;2015;11;03;Maanantai;0;0;0
93;09.11.2015;2015;11;04;Maanantai;0;1;1
93;09.11.2015;2015;11;05;Maanantai;2;1;3
93;09.11.2015;2015;11;06;Maanantai;9;5;14
93;09.11.2015;2015;11;07;Maanantai;19;16;35
93;09.11.2015;2015;11;08;Maanantai;10;18;28
93;09.11.2015;2015;11;09;Maanantai;8;7;15
93;09.11.2015;2015;11;10;Maanantai;4;1;5
93;09.11.2015;2015;11;11;Maanantai;7;4;11
93;09.11.2015;2015;11;12;Maanantai;5;7;12
93;09.11.2015;2015;11;13;Maanantai;3;7;10
93;09.11.2015;2015;11;14;Maanantai;8;12;20
93;09.11.2015;2015;11;15;Maanantai;9;20;29
93;09.11.2015;2015;11;16;Maanantai;18;15;33
93;09.11.2015;2015;11;17;Maanantai;19;6;25
93;09.11.2015;2015;11;18;Maanantai;6;17;23
93;09.11.2015;2015;11;19;Maanantai;4;1;5
93;09.11.2015;2015;11;20;Maanantai;2;3;5
93;09.11.2015;2015;11;21;Maanantai;1;4;5
93;09.11.2015;2015;11;22;Maanantai;0;1;1
93;09.11.2015;2015;11;23;Maanantai;0;0;0
93;10.11.2015;2015;11;00;Tiistai;1;0;1
93;10.11.2015;2015;11;01;Tiistai;0;0;0
93;10.11.2015;2015;11;02;Tiistai;0;0;0
93;10.11.2015;2015;11;03;Tiistai;0;0;0
93;10.11.2015;2015;11;04;Tiistai;0;0;0
93;10.11.2015;2015;11;05;Tiistai;1;0;1
93;10.11.2015;2015;11;06;Tiistai;5;4;9
93;10.11.2015;2015;11;07;Tiistai;15;10;25
93;10.11.2015;2015;11;08;Tiistai;11;12;23
93;10.11.2015;2015;11;09;Tiistai;4;4;8
93;10.11.2015;2015;11;10;Tiistai;4;2;6
93;10.11.2015;2015;11;11;Tiistai;4;4;8
93;10.11.2015;2015;11;12;Tiistai;3;0;3
93;10.11.2015;2015;11;13;Tiistai;0;7;7
93;10.11.2015;2015;11;14;Tiistai;3;5;8
93;10.11.2015;2015;11;15;Tiistai;11;8;19
93;10.11.2015;2015;11;16;Tiistai;9;9;18
93;10.11.2015;2015;11;17;Tiistai;7;7;14
93;10.11.2015;2015;11;18;Tiistai;4;1;5
93;10.11.2015;2015;11;19;Tiistai;3;3;6
93;10.11.2015;2015;11;20;Tiistai;4;2;6
93;10.11.2015;2015;11;21;Tiistai;1;2;3
93;10.11.2015;2015;11;22;Tiistai;0;0;0
93;10.11.2015;2015;11;23;Tiistai;0;0;0
93;11.11.2015;2015;11;00;Keskiviikko;2;0;2
93;11.11.2015;2015;11;01;Keskiviikko;0;0;0
93;11.11.2015;2015;11;02;Keskiviikko;0;0;0
93;11.11.2015;2015;11;03;Keskiviikko;0;0;0
93;11.11.2015;2015;11;04;Keskiviikko;1;0;1
93;11.11.2015;2015;11;05;Keskiviikko;1;1;2
93;11.11.2015;2015;11;06;Keskiviikko;13;4;17
93;11.11.2015;2015;11;07;Keskiviikko;17;18;35
93;11.11.2015;2015;11;08;Keskiviikko;6;10;16
93;11.11.2015;2015;11;09;Keskiviikko;1;5;6
93;11.11.2015;2015;11;10;Keskiviikko;6;4;10
93;11.11.2015;2015;11;11;Keskiviikko;2;9;11
93;11.11.2015;2015;11;12;Keskiviikko;2;3;5
93;11.11.2015;2015;11;13;Keskiviikko;2;10;12
93;11.11.2015;2015;11;14;Keskiviikko;5;6;11
93;11.11.2015;2015;11;15;Keskiviikko;7;15;22
93;11.11.2015;2015;11;16;Keskiviikko;15;9;24
93;11.11.2015;2015;11;17;Keskiviikko;15;9;24
93;11.11.2015;2015;11;18;Keskiviikko;7;4;11
93;11.11.2015;2015;11;19;Keskiviikko;2;2;4
93;11.11.2015;2015;11;20;Keskiviikko;4;7;11
93;11.11.2015;2015;11;21;Keskiviikko;2;0;2
93;11.11.2015;2015;11;22;Keskiviikko;2;0;2
93;11.11.2015;2015;11;23;Keskiviikko;0;0;0
93;12.11.2015;2015;11;00;Torstai;0;0;0
93;12.11.2015;2015;11;01;Torstai;0;0;0
93;12.11.2015;2015;11;02;Torstai;0;0;0
93;12.11.2015;2015;11;03;Torstai;0;0;0
93;12.11.2015;2015;11;04;Torstai;1;0;1
93;12.11.2015;2015;11;05;Torstai;1;0;1
93;12.11.2015;2015;11;06;Torstai;5;5;10
93;12.11.2015;2015;11;07;Torstai;14;18;32
93;12.11.2015;2015;11;08;Torstai;5;15;20
93;12.11.2015;2015;11;09;Torstai;10;3;13
93;12.11.2015;2015;11;10;Torstai;4;4;8
93;12.11.2015;2015;11;11;Torstai;3;7;10
93;12.11.2015;2015;11;12;Torstai;1;2;3
93;12.11.2015;2015;11;13;Torstai;2;4;6
93;12.11.2015;2015;11;14;Torstai;4;4;8
93;12.11.2015;2015;11;15;Torstai;10;9;19
93;12.11.2015;2015;11;16;Torstai;21;10;31
93;12.11.2015;2015;11;17;Torstai;6;7;13
93;12.11.2015;2015;11;18;Torstai;7;2;9
93;12.11.2015;2015;11;19;Torstai;2;2;4
93;12.11.2015;2015;11;20;Torstai;2;3;5
93;12.11.2015;2015;11;21;Torstai;0;2;2
93;12.11.2015;2015;11;22;Torstai;1;2;3
93;12.11.2015;2015;11;23;Torstai;0;1;1
93;13.11.2015;2015;11;00;Perjantai;0;0;0
93;13.11.2015;2015;11;01;Perjantai;0;0;0
93;13.11.2015;2015;11;02;Perjantai;0;0;0
93;13.11.2015;2015;11;03;Perjantai;1;0;1
93;13.11.2015;2015;11;04;Perjantai;0;1;1
93;13.11.2015;2015;11;05;Perjantai;2;0;2
93;13.11.2015;2015;11;06;Perjantai;7;2;9
93;13.11.2015;2015;11;07;Perjantai;11;16;27
93;13.11.2015;2015;11;08;Perjantai;8;10;18
93;13.11.2015;2015;11;09;Perjantai;4;10;14
93;13.11.2015;2015;11;10;Perjantai;3;3;6
93;13.11.2015;2015;11;11;Perjantai;1;3;4
93;13.11.2015;2015;11;12;Perjantai;7;4;11
93;13.11.2015;2015;11;13;Perjantai;7;6;13
93;13.11.2015;2015;11;14;Perjantai;13;6;19
93;13.11.2015;2015;11;15;Perjantai;10;9;19
93;13.11.2015;2015;11;16;Perjantai;14;20;34
93;13.11.2015;2015;11;17;Perjantai;5;6;11
93;13.11.2015;2015;11;18;Perjantai;2;7;9
93;13.11.2015;2015;11;19;Perjantai;3;3;6
93;13.11.2015;2015;11;20;Perjantai;1;2;3
93;13.11.2015;2015;11;21;Perjantai;4;0;4
93;13.11.2015;2015;11;22;Perjantai;0;0;0
93;13.11.2015;2015;11;23;Perjantai;1;0;1
93;14.11.2015;2015;11;00;Lauantai;0;1;1
93;14.11.2015;2015;11;01;Lauantai;0;0;0
93;14.11.2015;2015;11;02;Lauantai;0;0;0
93;14.11.2015;2015;11;03;Lauantai;1;0;1
93;14.11.2015;2015;11;04;Lauantai;0;0;0
93;14.11.2015;2015;11;05;Lauantai;0;0;0
93;14.11.2015;2015;11;06;Lauantai;0;0;0
93;14.11.2015;2015;11;07;Lauantai;0;0;0
93;14.11.2015;2015;11;08;Lauantai;0;1;1
93;14.11.2015;2015;11;09;Lauantai;2;3;5
93;14.11.2015;2015;11;10;Lauantai;6;0;6
93;14.11.2015;2015;11;11;Lauantai;3;2;5
93;14.11.2015;2015;11;12;Lauantai;6;1;7
93;14.11.2015;2015;11;13;Lauantai;1;4;5
93;14.11.2015;2015;11;14;Lauantai;2;2;4
93;14.11.2015;2015;11;15;Lauantai;3;1;4
93;14.11.2015;2015;11;16;Lauantai;1;5;6
93;14.11.2015;2015;11;17;Lauantai;2;4;6
93;14.11.2015;2015;11;18;Lauantai;2;2;4
93;14.11.2015;2015;11;19;Lauantai;3;1;4
93;14.11.2015;2015;11;20;Lauantai;1;0;1
93;14.11.2015;2015;11;21;Lauantai;0;1;1
93;14.11.2015;2015;11;22;Lauantai;9;5;14
93;14.11.2015;2015;11;23;Lauantai;0;0;0
93;15.11.2015;2015;11;00;Sunnuntai;2;1;3
93;15.11.2015;2015;11;01;Sunnuntai;0;0;0
93;15.11.2015;2015;11;02;Sunnuntai;0;0;0
93;15.11.2015;2015;11;03;Sunnuntai;0;0;0
93;15.11.2015;2015;11;04;Sunnuntai;0;1;1
93;15.11.2015;2015;11;05;Sunnuntai;0;0;0
93;15.11.2015;2015;11;06;Sunnuntai;0;0;0
93;15.11.2015;2015;11;07;Sunnuntai;1;0;1
93;15.11.2015;2015;11;08;Sunnuntai;1;1;2
93;15.11.2015;2015;11;09;Sunnuntai;7;2;9
93;15.11.2015;2015;11;10;Sunnuntai;3;10;13
93;15.11.2015;2015;11;11;Sunnuntai;6;5;11
93;15.11.2015;2015;11;12;Sunnuntai;8;4;12
93;15.11.2015;2015;11;13;Sunnuntai;4;6;10
93;15.11.2015;2015;11;14;Sunnuntai;2;3;5
93;15.11.2015;2015;11;15;Sunnuntai;2;2;4
93;15.11.2015;2015;11;16;Sunnuntai;3;2;5
93;15.11.2015;2015;11;17;Sunnuntai;3;7;10
93;15.11.2015;2015;11;18;Sunnuntai;1;3;4
93;15.11.2015;2015;11;19;Sunnuntai;3;2;5
93;15.11.2015;2015;11;20;Sunnuntai;3;0;3
93;15.11.2015;2015;11;21;Sunnuntai;0;0;0
93;15.11.2015;2015;11;22;Sunnuntai;0;1;1
93;15.11.2015;2015;11;23;Sunnuntai;0;0;0
93;16.11.2015;2015;11;00;Maanantai;0;0;0
93;16.11.2015;2015;11;01;Maanantai;0;0;0
93;16.11.2015;2015;11;02;Maanantai;0;0;0
93;16.11.2015;2015;11;03;Maanantai;0;0;0
93;16.11.2015;2015;11;04;Maanantai;0;1;1
93;16.11.2015;2015;11;05;Maanantai;0;4;4
93;16.11.2015;2015;11;06;Maanantai;8;6;14
93;16.11.2015;2015;11;07;Maanantai;15;17;32
93;16.11.2015;2015;11;08;Maanantai;12;18;30
93;16.11.2015;2015;11;09;Maanantai;9;4;13
93;16.11.2015;2015;11;10;Maanantai;3;5;8
93;16.11.2015;2015;11;11;Maanantai;3;3;6
93;16.11.2015;2015;11;12;Maanantai;2;5;7
93;16.11.2015;2015;11;13;Maanantai;5;2;7
93;16.11.2015;2015;11;14;Maanantai;7;4;11
93;16.11.2015;2015;11;15;Maanantai;16;11;27
93;16.11.2015;2015;11;16;Maanantai;19;9;28
93;16.11.2015;2015;11;17;Maanantai;13;8;21
93;16.11.2015;2015;11;18;Maanantai;3;13;16
93;16.11.2015;2015;11;19;Maanantai;7;3;10
93;16.11.2015;2015;11;20;Maanantai;5;0;5
93;16.11.2015;2015;11;21;Maanantai;0;2;2
93;16.11.2015;2015;11;22;Maanantai;1;2;3
93;16.11.2015;2015;11;23;Maanantai;0;1;1
93;17.11.2015;2015;11;00;Tiistai;0;0;0
93;17.11.2015;2015;11;01;Tiistai;0;0;0
93;17.11.2015;2015;11;02;Tiistai;0;0;0
93;17.11.2015;2015;11;03;Tiistai;0;0;0
93;17.11.2015;2015;11;04;Tiistai;1;2;3
93;17.11.2015;2015;11;05;Tiistai;0;2;2
93;17.11.2015;2015;11;06;Tiistai;6;5;11
93;17.11.2015;2015;11;07;Tiistai;14;18;32
93;17.11.2015;2015;11;08;Tiistai;12;19;31
93;17.11.2015;2015;11;09;Tiistai;5;3;8
93;17.11.2015;2015;11;10;Tiistai;8;1;9
93;17.11.2015;2015;11;11;Tiistai;5;8;13
93;17.11.2015;2015;11;12;Tiistai;4;2;6
93;17.11.2015;2015;11;13;Tiistai;2;2;4
93;17.11.2015;2015;11;14;Tiistai;5;3;8
93;17.11.2015;2015;11;15;Tiistai;17;8;25
93;17.11.2015;2015;11;16;Tiistai;18;12;30
93;17.11.2015;2015;11;17;Tiistai;7;5;12
93;17.11.2015;2015;11;18;Tiistai;3;4;7
93;17.11.2015;2015;11;19;Tiistai;5;4;9
93;17.11.2015;2015;11;20;Tiistai;2;1;3
93;17.11.2015;2015;11;21;Tiistai;0;3;3
93;17.11.2015;2015;11;22;Tiistai;1;0;1
93;17.11.2015;2015;11;23;Tiistai;0;0;0
93;18.11.2015;2015;11;00;Keskiviikko;0;1;1
93;18.11.2015;2015;11;01;Keskiviikko;0;1;1
93;18.11.2015;2015;11;02;Keskiviikko;0;0;0
93;18.11.2015;2015;11;03;Keskiviikko;0;0;0
93;18.11.2015;2015;11;04;Keskiviikko;0;1;1
93;18.11.2015;2015;11;05;Keskiviikko;0;3;3
93;18.11.2015;2015;11;06;Keskiviikko;6;6;12
93;18.11.2015;2015;11;07;Keskiviikko;14;16;30
93;18.11.2015;2015;11;08;Keskiviikko;9;13;22
93;18.11.2015;2015;11;09;Keskiviikko;1;6;7
93;18.11.2015;2015;11;10;Keskiviikko;4;2;6
93;18.11.2015;2015;11;11;Keskiviikko;4;2;6
93;18.11.2015;2015;11;12;Keskiviikko;3;7;10
93;18.11.2015;2015;11;13;Keskiviikko;4;5;9
93;18.11.2015;2015;11;14;Keskiviikko;6;8;14
93;18.11.2015;2015;11;15;Keskiviikko;10;12;22
93;18.11.2015;2015;11;16;Keskiviikko;21;10;31
93;18.11.2015;2015;11;17;Keskiviikko;10;7;17
93;18.11.2015;2015;11;18;Keskiviikko;9;10;19
93;18.11.2015;2015;11;19;Keskiviikko;9;8;17
93;18.11.2015;2015;11;20;Keskiviikko;4;4;8
93;18.11.2015;2015;11;21;Keskiviikko;3;4;7
93;18.11.2015;2015;11;22;Keskiviikko;0;0;0
93;18.11.2015;2015;11;23;Keskiviikko;0;0;0
93;19.11.2015;2015;11;00;Torstai;0;0;0
93;19.11.2015;2015;11;01;Torstai;0;0;0
93;19.11.2015;2015;11;02;Torstai;0;0;0
93;19.11.2015;2015;11;03;Torstai;0;0;0
93;19.11.2015;2015;11;04;Torstai;0;0;0
93;19.11.2015;2015;11;05;Torstai;1;2;3
93;19.11.2015;2015;11;06;Torstai;7;5;12
93;19.11.2015;2015;11;07;Torstai;16;15;31
93;19.11.2015;2015;11;08;Torstai;11;14;25
93;19.11.2015;2015;11;09;Torstai;10;4;14
93;19.11.2015;2015;11;10;Torstai;4;6;10
93;19.11.2015;2015;11;11;Torstai;7;7;14
93;19.11.2015;2015;11;12;Torstai;1;6;7
93;19.11.2015;2015;11;13;Torstai;5;6;11
93;19.11.2015;2015;11;14;Torstai;10;13;23
93;19.11.2015;2015;11;15;Torstai;15;10;25
93;19.11.2015;2015;11;16;Torstai;11;13;24
93;19.11.2015;2015;11;17;Torstai;12;7;19
93;19.11.2015;2015;11;18;Torstai;6;2;8
93;19.11.2015;2015;11;19;Torstai;5;2;7
93;19.11.2015;2015;11;20;Torstai;2;4;6
93;19.11.2015;2015;11;21;Torstai;1;5;6
93;19.11.2015;2015;11;22;Torstai;0;0;0
93;19.11.2015;2015;11;23;Torstai;1;0;1
93;20.11.2015;2015;11;00;Perjantai;0;0;0
93;20.11.2015;2015;11;01;Perjantai;0;0;0
93;20.11.2015;2015;11;02;Perjantai;0;0;0
93;20.11.2015;2015;11;03;Perjantai;0;0;0
93;20.11.2015;2015;11;04;Perjantai;0;1;1
93;20.11.2015;2015;11;05;Perjantai;0;2;2
93;20.11.2015;2015;11;06;Perjantai;7;2;9
93;20.11.2015;2015;11;07;Perjantai;7;11;18
93;20.11.2015;2015;11;08;Perjantai;7;13;20
93;20.11.2015;2015;11;09;Perjantai;1;3;4
93;20.11.2015;2015;11;10;Perjantai;7;4;11
93;20.11.2015;2015;11;11;Perjantai;5;5;10
93;20.11.2015;2015;11;12;Perjantai;2;4;6
93;20.11.2015;2015;11;13;Perjantai;5;6;11
93;20.11.2015;2015;11;14;Perjantai;6;11;17
93;20.11.2015;2015;11;15;Perjantai;12;3;15
93;20.11.2015;2015;11;16;Perjantai;12;5;17
93;20.11.2015;2015;11;17;Perjantai;7;4;11
93;20.11.2015;2015;11;18;Perjantai;3;5;8
93;20.11.2015;2015;11;19;Perjantai;3;4;7
93;20.11.2015;2015;11;20;Perjantai;1;2;3
93;20.11.2015;2015;11;21;Perjantai;1;2;3
93;20.11.2015;2015;11;22;Perjantai;0;0;0
93;20.11.2015;2015;11;23;Perjantai;1;2;3
93;21.11.2015;2015;11;00;Lauantai;0;0;0
93;21.11.2015;2015;11;01;Lauantai;0;0;0
93;21.11.2015;2015;11;02;Lauantai;0;0;0
93;21.11.2015;2015;11;03;Lauantai;0;0;0
93;21.11.2015;2015;11;04;Lauantai;0;0;0
93;21.11.2015;2015;11;05;Lauantai;0;2;2
93;21.11.2015;2015;11;06;Lauantai;2;0;2
93;21.11.2015;2015;11;07;Lauantai;0;1;1
93;21.11.2015;2015;11;08;Lauantai;1;2;3
93;21.11.2015;2015;11;09;Lauantai;1;3;4
93;21.11.2015;2015;11;10;Lauantai;5;1;6
93;21.11.2015;2015;11;11;Lauantai;4;1;5
93;21.11.2015;2015;11;12;Lauantai;2;0;2
93;21.11.2015;2015;11;13;Lauantai;4;6;10
93;21.11.2015;2015;11;14;Lauantai;5;3;8
93;21.11.2015;2015;11;15;Lauantai;1;1;2
93;21.11.2015;2015;11;16;Lauantai;2;3;5
93;21.11.2015;2015;11;17;Lauantai;3;2;5
93;21.11.2015;2015;11;18;Lauantai;2;3;5
93;21.11.2015;2015;11;19;Lauantai;2;3;5
93;21.11.2015;2015;11;20;Lauantai;0;1;1
93;21.11.2015;2015;11;21;Lauantai;1;0;1
93;21.11.2015;2015;11;22;Lauantai;2;5;7
93;21.11.2015;2015;11;23;Lauantai;0;1;1
93;22.11.2015;2015;11;00;Sunnuntai;0;1;1
93;22.11.2015;2015;11;01;Sunnuntai;1;0;1
93;22.11.2015;2015;11;02;Sunnuntai;1;0;1
93;22.11.2015;2015;11;03;Sunnuntai;0;1;1
93;22.11.2015;2015;11;04;Sunnuntai;0;1;1
93;22.11.2015;2015;11;05;Sunnuntai;0;0;0
93;22.11.2015;2015;11;06;Sunnuntai;1;0;1
93;22.11.2015;2015;11;07;Sunnuntai;2;0;2
93;22.11.2015;2015;11;08;Sunnuntai;1;14;15
93;22.11.2015;2015;11;09;Sunnuntai;1;0;1
93;22.11.2015;2015;11;10;Sunnuntai;5;0;5
93;22.11.2015;2015;11;11;Sunnuntai;13;0;13
93;22.11.2015;2015;11;12;Sunnuntai;3;3;6
93;22.11.2015;2015;11;13;Sunnuntai;3;4;7
93;22.11.2015;2015;11;14;Sunnuntai;5;3;8
93;22.11.2015;2015;11;15;Sunnuntai;3;1;4
93;22.11.2015;2015;11;16;Sunnuntai;2;1;3
93;22.11.2015;2015;11;17;Sunnuntai;0;2;2
93;22.11.2015;2015;11;18;Sunnuntai;1;2;3
93;22.11.2015;2015;11;19;Sunnuntai;2;0;2
93;22.11.2015;2015;11;20;Sunnuntai;0;1;1
93;22.11.2015;2015;11;21;Sunnuntai;1;0;1
93;22.11.2015;2015;11;22;Sunnuntai;0;0;0
93;22.11.2015;2015;11;23;Sunnuntai;1;0;1
93;23.11.2015;2015;11;00;Maanantai;0;0;0
93;23.11.2015;2015;11;01;Maanantai;0;0;0
93;23.11.2015;2015;11;02;Maanantai;0;0;0
93;23.11.2015;2015;11;03;Maanantai;1;0;1
93;23.11.2015;2015;11;04;Maanantai;0;1;1
93;23.11.2015;2015;11;05;Maanantai;1;1;2
93;23.11.2015;2015;11;06;Maanantai;7;4;11
93;23.11.2015;2015;11;07;Maanantai;10;19;29
93;23.11.2015;2015;11;08;Maanantai;9;13;22
93;23.11.2015;2015;11;09;Maanantai;2;5;7
93;23.11.2015;2015;11;10;Maanantai;2;5;7
93;23.11.2015;2015;11;11;Maanantai;5;2;7
93;23.11.2015;2015;11;12;Maanantai;2;10;12
93;23.11.2015;2015;11;13;Maanantai;3;7;10
93;23.11.2015;2015;11;14;Maanantai;3;5;8
93;23.11.2015;2015;11;15;Maanantai;11;7;18
93;23.11.2015;2015;11;16;Maanantai;22;7;29
93;23.11.2015;2015;11;17;Maanantai;12;9;21
93;23.11.2015;2015;11;18;Maanantai;4;3;7
93;23.11.2015;2015;11;19;Maanantai;2;2;4
93;23.11.2015;2015;11;20;Maanantai;0;1;1
93;23.11.2015;2015;11;21;Maanantai;1;2;3
93;23.11.2015;2015;11;22;Maanantai;1;1;2
93;23.11.2015;2015;11;23;Maanantai;0;0;0
93;24.11.2015;2015;11;00;Tiistai;1;0;1
93;24.11.2015;2015;11;01;Tiistai;0;0;0
93;24.11.2015;2015;11;02;Tiistai;0;0;0
93;24.11.2015;2015;11;03;Tiistai;0;0;0
93;24.11.2015;2015;11;04;Tiistai;1;1;2
93;24.11.2015;2015;11;05;Tiistai;1;1;2
93;24.11.2015;2015;11;06;Tiistai;9;3;12
93;24.11.2015;2015;11;07;Tiistai;17;14;31
93;24.11.2015;2015;11;08;Tiistai;9;14;23
93;24.11.2015;2015;11;09;Tiistai;3;5;8
93;24.11.2015;2015;11;10;Tiistai;1;2;3
93;24.11.2015;2015;11;11;Tiistai;2;5;7
93;24.11.2015;2015;11;12;Tiistai;5;0;5
93;24.11.2015;2015;11;13;Tiistai;0;11;11
93;24.11.2015;2015;11;14;Tiistai;6;7;13
93;24.11.2015;2015;11;15;Tiistai;9;7;16
93;24.11.2015;2015;11;16;Tiistai;16;12;28
93;24.11.2015;2015;11;17;Tiistai;8;7;15
93;24.11.2015;2015;11;18;Tiistai;5;7;12
93;24.11.2015;2015;11;19;Tiistai;3;7;10
93;24.11.2015;2015;11;20;Tiistai;4;1;5
93;24.11.2015;2015;11;21;Tiistai;1;3;4
93;24.11.2015;2015;11;22;Tiistai;1;1;2
93;24.11.2015;2015;11;23;Tiistai;0;0;0
93;25.11.2015;2015;11;00;Keskiviikko;1;0;1
93;25.11.2015;2015;11;01;Keskiviikko;0;0;0
93;25.11.2015;2015;11;02;Keskiviikko;0;0;0
93;25.11.2015;2015;11;03;Keskiviikko;0;0;0
93;25.11.2015;2015;11;04;Keskiviikko;1;0;1
93;25.11.2015;2015;11;05;Keskiviikko;0;1;1
93;25.11.2015;2015;11;06;Keskiviikko;7;2;9
93;25.11.2015;2015;11;07;Keskiviikko;12;7;19
93;25.11.2015;2015;11;08;Keskiviikko;7;9;16
93;25.11.2015;2015;11;09;Keskiviikko;1;3;4
93;25.11.2015;2015;11;10;Keskiviikko;2;3;5
93;25.11.2015;2015;11;11;Keskiviikko;1;4;5
93;25.11.2015;2015;11;12;Keskiviikko;2;2;4
93;25.11.2015;2015;11;13;Keskiviikko;2;4;6
93;25.11.2015;2015;11;14;Keskiviikko;5;3;8
93;25.11.2015;2015;11;15;Keskiviikko;6;5;11
93;25.11.2015;2015;11;16;Keskiviikko;8;10;18
93;25.11.2015;2015;11;17;Keskiviikko;7;1;8
93;25.11.2015;2015;11;18;Keskiviikko;3;3;6
93;25.11.2015;2015;11;19;Keskiviikko;1;2;3
93;25.11.2015;2015;11;20;Keskiviikko;1;3;4
93;25.11.2015;2015;11;21;Keskiviikko;0;1;1
93;25.11.2015;2015;11;22;Keskiviikko;0;0;0
93;25.11.2015;2015;11;23;Keskiviikko;0;0;0
93;26.11.2015;2015;11;00;Torstai;1;0;1
93;26.11.2015;2015;11;01;Torstai;0;0;0
93;26.11.2015;2015;11;02;Torstai;0;0;0
93;26.11.2015;2015;11;03;Torstai;0;0;0
93;26.11.2015;2015;11;04;Torstai;0;0;0
93;26.11.2015;2015;11;05;Torstai;2;1;3
93;26.11.2015;2015;11;06;Torstai;4;5;9
93;26.11.2015;2015;11;07;Torstai;12;13;25
93;26.11.2015;2015;11;08;Torstai;11;13;24
93;26.11.2015;2015;11;09;Torstai;4;3;7
93;26.11.2015;2015;11;10;Torstai;6;6;12
93;26.11.2015;2015;11;11;Torstai;4;7;11
93;26.11.2015;2015;11;12;Torstai;2;3;5
93;26.11.2015;2015;11;13;Torstai;5;6;11
93;26.11.2015;2015;11;14;Torstai;3;2;5
93;26.11.2015;2015;11;15;Torstai;7;7;14
93;26.11.2015;2015;11;16;Torstai;16;7;23
93;26.11.2015;2015;11;17;Torstai;13;10;23
93;26.11.2015;2015;11;18;Torstai;3;4;7
93;26.11.2015;2015;11;19;Torstai;3;3;6
93;26.11.2015;2015;11;20;Torstai;4;2;6
93;26.11.2015;2015;11;21;Torstai;0;2;2
93;26.11.2015;2015;11;22;Torstai;0;2;2
93;26.11.2015;2015;11;23;Torstai;0;0;0
93;27.11.2015;2015;11;00;Perjantai;1;0;1
93;27.11.2015;2015;11;01;Perjantai;0;0;0
93;27.11.2015;2015;11;02;Perjantai;0;0;0
93;27.11.2015;2015;11;03;Perjantai;0;0;0
93;27.11.2015;2015;11;04;Perjantai;0;0;0
93;27.11.2015;2015;11;05;Perjantai;1;1;2
93;27.11.2015;2015;11;06;Perjantai;7;5;12
93;27.11.2015;2015;11;07;Perjantai;12;8;20
93;27.11.2015;2015;11;08;Perjantai;5;8;13
93;27.11.2015;2015;11;09;Perjantai;2;2;4
93;27.11.2015;2015;11;10;Perjantai;4;2;6
93;27.11.2015;2015;11;11;Perjantai;1;2;3
93;27.11.2015;2015;11;12;Perjantai;4;0;4
93;27.11.2015;2015;11;13;Perjantai;2;3;5
93;27.11.2015;2015;11;14;Perjantai;8;7;15
93;27.11.2015;2015;11;15;Perjantai;12;5;17
93;27.11.2015;2015;11;16;Perjantai;5;4;9
93;27.11.2015;2015;11;17;Perjantai;8;5;13
93;27.11.2015;2015;11;18;Perjantai;3;9;12
93;27.11.2015;2015;11;19;Perjantai;2;1;3
93;27.11.2015;2015;11;20;Perjantai;2;1;3
93;27.11.2015;2015;11;21;Perjantai;1;1;2
93;27.11.2015;2015;11;22;Perjantai;0;0;0
93;27.11.2015;2015;11;23;Perjantai;0;1;1
93;28.11.2015;2015;11;00;Lauantai;0;0;0
93;28.11.2015;2015;11;01;Lauantai;0;1;1
93;28.11.2015;2015;11;02;Lauantai;0;0;0
93;28.11.2015;2015;11;03;Lauantai;0;1;1
93;28.11.2015;2015;11;04;Lauantai;0;1;1
93;28.11.2015;2015;11;05;Lauantai;0;0;0
93;28.11.2015;2015;11;06;Lauantai;2;1;3
93;28.11.2015;2015;11;07;Lauantai;0;0;0
93;28.11.2015;2015;11;08;Lauantai;3;0;3
93;28.11.2015;2015;11;09;Lauantai;5;2;7
93;28.11.2015;2015;11;10;Lauantai;2;4;6
93;28.11.2015;2015;11;11;Lauantai;1;1;2
93;28.11.2015;2015;11;12;Lauantai;2;0;2
93;28.11.2015;2015;11;13;Lauantai;0;2;2
93;28.11.2015;2015;11;14;Lauantai;4;1;5
93;28.11.2015;2015;11;15;Lauantai;0;4;4
93;28.11.2015;2015;11;16;Lauantai;1;2;3
93;28.11.2015;2015;11;17;Lauantai;1;0;1
93;28.11.2015;2015;11;18;Lauantai;1;3;4
93;28.11.2015;2015;11;19;Lauantai;2;1;3
93;28.11.2015;2015;11;20;Lauantai;0;0;0
93;28.11.2015;2015;11;21;Lauantai;0;1;1
93;28.11.2015;2015;11;22;Lauantai;0;0;0
93;28.11.2015;2015;11;23;Lauantai;0;1;1
93;29.11.2015;2015;11;00;Sunnuntai;0;0;0
93;29.11.2015;2015;11;01;Sunnuntai;0;1;1
93;29.11.2015;2015;11;02;Sunnuntai;0;2;2
93;29.11.2015;2015;11;03;Sunnuntai;0;0;0
93;29.11.2015;2015;11;04;Sunnuntai;0;0;0
93;29.11.2015;2015;11;05;Sunnuntai;0;0;0
93;29.11.2015;2015;11;06;Sunnuntai;0;1;1
93;29.11.2015;2015;11;07;Sunnuntai;2;0;2
93;29.11.2015;2015;11;08;Sunnuntai;1;1;2
93;29.11.2015;2015;11;09;Sunnuntai;4;2;6
93;29.11.2015;2015;11;10;Sunnuntai;18;1;19
93;29.11.2015;2015;11;11;Sunnuntai;7;1;8
93;29.11.2015;2015;11;12;Sunnuntai;7;6;13
93;29.11.2015;2015;11;13;Sunnuntai;7;7;14
93;29.11.2015;2015;11;14;Sunnuntai;3;9;12
93;29.11.2015;2015;11;15;Sunnuntai;3;5;8
93;29.11.2015;2015;11;16;Sunnuntai;0;1;1
93;29.11.2015;2015;11;17;Sunnuntai;2;1;3
93;29.11.2015;2015;11;18;Sunnuntai;3;5;8
93;29.11.2015;2015;11;19;Sunnuntai;1;2;3
93;29.11.2015;2015;11;20;Sunnuntai;1;0;1
93;29.11.2015;2015;11;21;Sunnuntai;0;0;0
93;29.11.2015;2015;11;22;Sunnuntai;1;1;2
93;29.11.2015;2015;11;23;Sunnuntai;0;0;0
93;30.11.2015;2015;11;00;Maanantai;0;0;0
93;30.11.2015;2015;11;01;Maanantai;0;0;0
93;30.11.2015;2015;11;02;Maanantai;0;0;0
93;30.11.2015;2015;11;03;Maanantai;0;0;0
93;30.11.2015;2015;11;04;Maanantai;0;1;1
93;30.11.2015;2015;11;05;Maanantai;2;2;4
93;30.11.2015;2015;11;06;Maanantai;6;6;12
93;30.11.2015;2015;11;07;Maanantai;12;13;25
93;30.11.2015;2015;11;08;Maanantai;11;16;27
93;30.11.2015;2015;11;09;Maanantai;5;2;7
93;30.11.2015;2015;11;10;Maanantai;2;8;10
93;30.11.2015;2015;11;11;Maanantai;1;4;5
93;30.11.2015;2015;11;12;Maanantai;4;2;6
93;30.11.2015;2015;11;13;Maanantai;3;6;9
93;30.11.2015;2015;11;14;Maanantai;6;3;9
93;30.11.2015;2015;11;15;Maanantai;10;7;17
93;30.11.2015;2015;11;16;Maanantai;17;11;28
93;30.11.2015;2015;11;17;Maanantai;11;7;18
93;30.11.2015;2015;11;18;Maanantai;1;4;5
93;30.11.2015;2015;11;19;Maanantai;4;2;6
93;30.11.2015;2015;11;20;Maanantai;0;4;4
93;30.11.2015;2015;11;21;Maanantai;2;1;3
93;30.11.2015;2015;11;22;Maanantai;0;1;1
93;30.11.2015;2015;11;23;Maanantai;0;0;0
93;01.12.2015;2015;12;00;Tiistai;0;0;0
93;01.12.2015;2015;12;01;Tiistai;0;0;0
93;01.12.2015;2015;12;02;Tiistai;0;0;0
93;01.12.2015;2015;12;03;Tiistai;0;0;0
93;01.12.2015;2015;12;04;Tiistai;0;0;0
93;01.12.2015;2015;12;05;Tiistai;2;2;4
93;01.12.2015;2015;12;06;Tiistai;7;3;10
93;01.12.2015;2015;12;07;Tiistai;13;21;34
93;01.12.2015;2015;12;08;Tiistai;5;11;16
93;01.12.2015;2015;12;09;Tiistai;4;3;7
93;01.12.2015;2015;12;10;Tiistai;4;3;7
93;01.12.2015;2015;12;11;Tiistai;3;7;10
93;01.12.2015;2015;12;12;Tiistai;3;4;7
93;01.12.2015;2015;12;13;Tiistai;3;3;6
93;01.12.2015;2015;12;14;Tiistai;7;3;10
93;01.12.2015;2015;12;15;Tiistai;12;7;19
93;01.12.2015;2015;12;16;Tiistai;18;13;31
93;01.12.2015;2015;12;17;Tiistai;7;6;13
93;01.12.2015;2015;12;18;Tiistai;6;6;12
93;01.12.2015;2015;12;19;Tiistai;2;2;4
93;01.12.2015;2015;12;20;Tiistai;2;2;4
93;01.12.2015;2015;12;21;Tiistai;1;2;3
93;01.12.2015;2015;12;22;Tiistai;0;1;1
93;01.12.2015;2015;12;23;Tiistai;0;0;0
93;02.12.2015;2015;12;00;Keskiviikko;0;0;0
93;02.12.2015;2015;12;01;Keskiviikko;0;0;0
93;02.12.2015;2015;12;02;Keskiviikko;0;0;0
93;02.12.2015;2015;12;03;Keskiviikko;0;0;0
93;02.12.2015;2015;12;04;Keskiviikko;0;0;0
93;02.12.2015;2015;12;05;Keskiviikko;1;2;3
93;02.12.2015;2015;12;06;Keskiviikko;8;5;13
93;02.12.2015;2015;12;07;Keskiviikko;9;10;19
93;02.12.2015;2015;12;08;Keskiviikko;4;11;15
93;02.12.2015;2015;12;09;Keskiviikko;3;4;7
93;02.12.2015;2015;12;10;Keskiviikko;5;3;8
93;02.12.2015;2015;12;11;Keskiviikko;4;5;9
93;02.12.2015;2015;12;12;Keskiviikko;6;3;9
93;02.12.2015;2015;12;13;Keskiviikko;3;2;5
93;02.12.2015;2015;12;14;Keskiviikko;4;4;8
93;02.12.2015;2015;12;15;Keskiviikko;12;8;20
93;02.12.2015;2015;12;16;Keskiviikko;14;10;24
93;02.12.2015;2015;12;17;Keskiviikko;10;3;13
93;02.12.2015;2015;12;18;Keskiviikko;5;4;9
93;02.12.2015;2015;12;19;Keskiviikko;3;4;7
93;02.12.2015;2015;12;20;Keskiviikko;1;6;7
93;02.12.2015;2015;12;21;Keskiviikko;1;1;2
93;02.12.2015;2015;12;22;Keskiviikko;0;1;1
93;02.12.2015;2015;12;23;Keskiviikko;0;1;1
93;03.12.2015;2015;12;00;Torstai;0;0;0
93;03.12.2015;2015;12;01;Torstai;0;0;0
93;03.12.2015;2015;12;02;Torstai;0;0;0
93;03.12.2015;2015;12;03;Torstai;0;0;0
93;03.12.2015;2015;12;04;Torstai;0;0;0
93;03.12.2015;2015;12;05;Torstai;1;3;4
93;03.12.2015;2015;12;06;Torstai;5;4;9
93;03.12.2015;2015;12;07;Torstai;11;15;26
93;03.12.2015;2015;12;08;Torstai;7;9;16
93;03.12.2015;2015;12;09;Torstai;2;2;4
93;03.12.2015;2015;12;10;Torstai;0;1;1
93;03.12.2015;2015;12;11;Torstai;2;0;2
93;03.12.2015;2015;12;12;Torstai;1;2;3
93;03.12.2015;2015;12;13;Torstai;4;2;6
93;03.12.2015;2015;12;14;Torstai;5;5;10
93;03.12.2015;2015;12;15;Torstai;9;10;19
93;03.12.2015;2015;12;16;Torstai;11;5;16
93;03.12.2015;2015;12;17;Torstai;9;9;18
93;03.12.2015;2015;12;18;Torstai;4;4;8
93;03.12.2015;2015;12;19;Torstai;2;2;4
93;03.12.2015;2015;12;20;Torstai;1;3;4
93;03.12.2015;2015;12;21;Torstai;0;2;2
93;03.12.2015;2015;12;22;Torstai;1;1;2
93;03.12.2015;2015;12;23;Torstai;0;0;0
93;04.12.2015;2015;12;00;Perjantai;0;0;0
93;04.12.2015;2015;12;01;Perjantai;0;0;0
93;04.12.2015;2015;12;02;Perjantai;0;0;0
93;04.12.2015;2015;12;03;Perjantai;0;0;0
93;04.12.2015;2015;12;04;Perjantai;0;0;0
93;04.12.2015;2015;12;05;Perjantai;1;3;4
93;04.12.2015;2015;12;06;Perjantai;6;3;9
93;04.12.2015;2015;12;07;Perjantai;10;12;22
93;04.12.2015;2015;12;08;Perjantai;4;15;19
93;04.12.2015;2015;12;09;Perjantai;2;3;5
93;04.12.2015;2015;12;10;Perjantai;5;2;7
93;04.12.2015;2015;12;11;Perjantai;1;0;1
93;04.12.2015;2015;12;12;Perjantai;2;0;2
93;04.12.2015;2015;12;13;Perjantai;7;4;11
93;04.12.2015;2015;12;14;Perjantai;9;5;14
93;04.12.2015;2015;12;15;Perjantai;6;6;12
93;04.12.2015;2015;12;16;Perjantai;10;12;22
93;04.12.2015;2015;12;17;Perjantai;12;4;16
93;04.12.2015;2015;12;18;Perjantai;4;5;9
93;04.12.2015;2015;12;19;Perjantai;3;2;5
93;04.12.2015;2015;12;20;Perjantai;1;2;3
93;04.12.2015;2015;12;21;Perjantai;0;1;1
93;04.12.2015;2015;12;22;Perjantai;0;0;0
93;04.12.2015;2015;12;23;Perjantai;0;0;0
93;05.12.2015;2015;12;00;Lauantai;0;1;1
93;05.12.2015;2015;12;01;Lauantai;0;0;0
93;05.12.2015;2015;12;02;Lauantai;1;0;1
93;05.12.2015;2015;12;03;Lauantai;0;0;0
93;05.12.2015;2015;12;04;Lauantai;0;0;0
93;05.12.2015;2015;12;05;Lauantai;1;1;2
93;05.12.2015;2015;12;06;Lauantai;0;0;0
93;05.12.2015;2015;12;07;Lauantai;0;0;0
93;05.12.2015;2015;12;08;Lauantai;1;1;2
93;05.12.2015;2015;12;09;Lauantai;1;2;3
93;05.12.2015;2015;12;10;Lauantai;4;2;6
93;05.12.2015;2015;12;11;Lauantai;3;1;4
93;05.12.2015;2015;12;12;Lauantai;3;2;5
93;05.12.2015;2015;12;13;Lauantai;1;6;7
93;05.12.2015;2015;12;14;Lauantai;3;5;8
93;05.12.2015;2015;12;15;Lauantai;0;1;1
93;05.12.2015;2015;12;16;Lauantai;0;0;0
93;05.12.2015;2015;12;17;Lauantai;3;0;3
93;05.12.2015;2015;12;18;Lauantai;0;1;1
93;05.12.2015;2015;12;19;Lauantai;0;0;0
93;05.12.2015;2015;12;20;Lauantai;0;1;1
93;05.12.2015;2015;12;21;Lauantai;1;0;1
93;05.12.2015;2015;12;22;Lauantai;0;0;0
93;05.12.2015;2015;12;23;Lauantai;0;0;0
93;06.12.2015;2015;12;00;Sunnuntai;0;0;0
93;06.12.2015;2015;12;01;Sunnuntai;0;0;0
93;06.12.2015;2015;12;02;Sunnuntai;0;0;0
93;06.12.2015;2015;12;03;Sunnuntai;0;0;0
93;06.12.2015;2015;12;04;Sunnuntai;0;0;0
93;06.12.2015;2015;12;05;Sunnuntai;0;0;0
93;06.12.2015;2015;12;06;Sunnuntai;0;1;1
93;06.12.2015;2015;12;07;Sunnuntai;3;0;3
93;06.12.2015;2015;12;08;Sunnuntai;2;0;2
93;06.12.2015;2015;12;09;Sunnuntai;1;0;1
93;06.12.2015;2015;12;10;Sunnuntai;0;1;1
93;06.12.2015;2015;12;11;Sunnuntai;9;3;12
93;06.12.2015;2015;12;12;Sunnuntai;1;1;2
93;06.12.2015;2015;12;13;Sunnuntai;1;0;1
93;06.12.2015;2015;12;14;Sunnuntai;1;2;3
93;06.12.2015;2015;12;15;Sunnuntai;1;4;5
93;06.12.2015;2015;12;16;Sunnuntai;1;2;3
93;06.12.2015;2015;12;17;Sunnuntai;6;1;7
93;06.12.2015;2015;12;18;Sunnuntai;0;1;1
93;06.12.2015;2015;12;19;Sunnuntai;0;0;0
93;06.12.2015;2015;12;20;Sunnuntai;1;1;2
93;06.12.2015;2015;12;21;Sunnuntai;2;1;3
93;06.12.2015;2015;12;22;Sunnuntai;0;0;0
93;06.12.2015;2015;12;23;Sunnuntai;0;0;0
93;07.12.2015;2015;12;00;Maanantai;0;0;0
93;07.12.2015;2015;12;01;Maanantai;0;0;0
93;07.12.2015;2015;12;02;Maanantai;0;0;0
93;07.12.2015;2015;12;03;Maanantai;0;0;0
93;07.12.2015;2015;12;04;Maanantai;0;0;0
93;07.12.2015;2015;12;05;Maanantai;2;2;4
93;07.12.2015;2015;12;06;Maanantai;7;2;9
93;07.12.2015;2015;12;07;Maanantai;11;10;21
93;07.12.2015;2015;12;08;Maanantai;5;14;19
93;07.12.2015;2015;12;09;Maanantai;4;1;5
93;07.12.2015;2015;12;10;Maanantai;1;3;4
93;07.12.2015;2015;12;11;Maanantai;1;3;4
93;07.12.2015;2015;12;12;Maanantai;1;3;4
93;07.12.2015;2015;12;13;Maanantai;0;6;6
93;07.12.2015;2015;12;14;Maanantai;4;3;7
93;07.12.2015;2015;12;15;Maanantai;6;8;14
93;07.12.2015;2015;12;16;Maanantai;16;17;33
93;07.12.2015;2015;12;17;Maanantai;7;1;8
93;07.12.2015;2015;12;18;Maanantai;2;5;7
93;07.12.2015;2015;12;19;Maanantai;4;1;5
93;07.12.2015;2015;12;20;Maanantai;4;3;7
93;07.12.2015;2015;12;21;Maanantai;0;0;0
93;07.12.2015;2015;12;22;Maanantai;0;1;1
93;07.12.2015;2015;12;23;Maanantai;0;0;0
93;08.12.2015;2015;12;00;Tiistai;0;0;0
93;08.12.2015;2015;12;01;Tiistai;0;0;0
93;08.12.2015;2015;12;02;Tiistai;0;0;0
93;08.12.2015;2015;12;03;Tiistai;0;0;0
93;08.12.2015;2015;12;04;Tiistai;0;0;0
93;08.12.2015;2015;12;05;Tiistai;3;2;5
93;08.12.2015;2015;12;06;Tiistai;8;4;12
93;08.12.2015;2015;12;07;Tiistai;12;13;25
93;08.12.2015;2015;12;08;Tiistai;12;10;22
93;08.12.2015;2015;12;09;Tiistai;3;0;3
93;08.12.2015;2015;12;10;Tiistai;1;4;5
93;08.12.2015;2015;12;11;Tiistai;0;1;1
93;08.12.2015;2015;12;12;Tiistai;3;3;6
93;08.12.2015;2015;12;13;Tiistai;0;6;6
93;08.12.2015;2015;12;14;Tiistai;7;5;12
93;08.12.2015;2015;12;15;Tiistai;10;13;23
93;08.12.2015;2015;12;16;Tiistai;14;12;26
93;08.12.2015;2015;12;17;Tiistai;12;9;21
93;08.12.2015;2015;12;18;Tiistai;8;4;12
93;08.12.2015;2015;12;19;Tiistai;3;2;5
93;08.12.2015;2015;12;20;Tiistai;3;8;11
93;08.12.2015;2015;12;21;Tiistai;2;0;2
93;08.12.2015;2015;12;22;Tiistai;0;0;0
93;08.12.2015;2015;12;23;Tiistai;0;0;0
93;09.12.2015;2015;12;00;Keskiviikko;0;0;0
93;09.12.2015;2015;12;01;Keskiviikko;0;0;0
93;09.12.2015;2015;12;02;Keskiviikko;0;0;0
93;09.12.2015;2015;12;03;Keskiviikko;0;0;0
93;09.12.2015;2015;12;04;Keskiviikko;0;0;0
93;09.12.2015;2015;12;05;Keskiviikko;1;2;3
93;09.12.2015;2015;12;06;Keskiviikko;5;2;7
93;09.12.2015;2015;12;07;Keskiviikko;12;11;23
93;09.12.2015;2015;12;08;Keskiviikko;5;13;18
93;09.12.2015;2015;12;09;Keskiviikko;1;3;4
93;09.12.2015;2015;12;10;Keskiviikko;3;1;4
93;09.12.2015;2015;12;11;Keskiviikko;1;4;5
93;09.12.2015;2015;12;12;Keskiviikko;3;2;5
93;09.12.2015;2015;12;13;Keskiviikko;1;0;1
93;09.12.2015;2015;12;14;Keskiviikko;5;3;8
93;09.12.2015;2015;12;15;Keskiviikko;8;5;13
93;09.12.2015;2015;12;16;Keskiviikko;7;7;14
93;09.12.2015;2015;12;17;Keskiviikko;2;2;4
93;09.12.2015;2015;12;18;Keskiviikko;4;0;4
93;09.12.2015;2015;12;19;Keskiviikko;1;1;2
93;09.12.2015;2015;12;20;Keskiviikko;2;5;7
93;09.12.2015;2015;12;21;Keskiviikko;1;4;5
93;09.12.2015;2015;12;22;Keskiviikko;0;0;0
93;09.12.2015;2015;12;23;Keskiviikko;0;0;0
93;10.12.2015;2015;12;00;Torstai;0;1;1
93;10.12.2015;2015;12;01;Torstai;0;0;0
93;10.12.2015;2015;12;02;Torstai;0;0;0
93;10.12.2015;2015;12;03;Torstai;0;0;0
93;10.12.2015;2015;12;04;Torstai;0;0;0
93;10.12.2015;2015;12;05;Torstai;1;2;3
93;10.12.2015;2015;12;06;Torstai;6;4;10
93;10.12.2015;2015;12;07;Torstai;9;10;19
93;10.12.2015;2015;12;08;Torstai;7;7;14
93;10.12.2015;2015;12;09;Torstai;4;1;5
93;10.12.2015;2015;12;10;Torstai;5;2;7
93;10.12.2015;2015;12;11;Torstai;3;2;5
93;10.12.2015;2015;12;12;Torstai;1;0;1
93;10.12.2015;2015;12;13;Torstai;1;1;2
93;10.12.2015;2015;12;14;Torstai;3;4;7
93;10.12.2015;2015;12;15;Torstai;5;6;11
93;10.12.2015;2015;12;16;Torstai;11;8;19
93;10.12.2015;2015;12;17;Torstai;4;2;6
93;10.12.2015;2015;12;18;Torstai;5;2;7
93;10.12.2015;2015;12;19;Torstai;0;2;2
93;10.12.2015;2015;12;20;Torstai;2;3;5
93;10.12.2015;2015;12;21;Torstai;0;2;2
93;10.12.2015;2015;12;22;Torstai;0;1;1
93;10.12.2015;2015;12;23;Torstai;0;0;0
93;11.12.2015;2015;12;00;Perjantai;0;0;0
93;11.12.2015;2015;12;01;Perjantai;0;0;0
93;11.12.2015;2015;12;02;Perjantai;0;1;1
93;11.12.2015;2015;12;03;Perjantai;0;0;0
93;11.12.2015;2015;12;04;Perjantai;0;0;0
93;11.12.2015;2015;12;05;Perjantai;1;2;3
93;11.12.2015;2015;12;06;Perjantai;2;3;5
93;11.12.2015;2015;12;07;Perjantai;3;9;12
93;11.12.2015;2015;12;08;Perjantai;3;8;11
93;11.12.2015;2015;12;09;Perjantai;2;1;3
93;11.12.2015;2015;12;10;Perjantai;4;1;5
93;11.12.2015;2015;12;11;Perjantai;1;2;3
93;11.12.2015;2015;12;12;Perjantai;3;0;3
93;11.12.2015;2015;12;13;Perjantai;0;5;5
93;11.12.2015;2015;12;14;Perjantai;8;3;11
93;11.12.2015;2015;12;15;Perjantai;8;6;14
93;11.12.2015;2015;12;16;Perjantai;11;7;18
93;11.12.2015;2015;12;17;Perjantai;3;4;7
93;11.12.2015;2015;12;18;Perjantai;2;4;6
93;11.12.2015;2015;12;19;Perjantai;0;0;0
93;11.12.2015;2015;12;20;Perjantai;5;4;9
93;11.12.2015;2015;12;21;Perjantai;0;2;2
93;11.12.2015;2015;12;22;Perjantai;0;2;2
93;11.12.2015;2015;12;23;Perjantai;1;0;1
93;12.12.2015;2015;12;00;Lauantai;0;0;0
93;12.12.2015;2015;12;01;Lauantai;1;2;3
93;12.12.2015;2015;12;02;Lauantai;1;0;1
93;12.12.2015;2015;12;03;Lauantai;0;0;0
93;12.12.2015;2015;12;04;Lauantai;0;0;0
93;12.12.2015;2015;12;05;Lauantai;1;2;3
93;12.12.2015;2015;12;06;Lauantai;0;3;3
93;12.12.2015;2015;12;07;Lauantai;2;0;2
93;12.12.2015;2015;12;08;Lauantai;4;1;5
93;12.12.2015;2015;12;09;Lauantai;1;2;3
93;12.12.2015;2015;12;10;Lauantai;4;0;4
93;12.12.2015;2015;12;11;Lauantai;6;1;7
93;12.12.2015;2015;12;12;Lauantai;2;9;11
93;12.12.2015;2015;12;13;Lauantai;4;2;6
93;12.12.2015;2015;12;14;Lauantai;3;3;6
93;12.12.2015;2015;12;15;Lauantai;2;1;3
93;12.12.2015;2015;12;16;Lauantai;1;2;3
93;12.12.2015;2015;12;17;Lauantai;1;6;7
93;12.12.2015;2015;12;18;Lauantai;1;1;2
93;12.12.2015;2015;12;19;Lauantai;3;2;5
93;12.12.2015;2015;12;20;Lauantai;0;3;3
93;12.12.2015;2015;12;21;Lauantai;0;0;0
93;12.12.2015;2015;12;22;Lauantai;2;0;2
93;12.12.2015;2015;12;23;Lauantai;7;1;8
93;13.12.2015;2015;12;00;Sunnuntai;0;0;0
93;13.12.2015;2015;12;01;Sunnuntai;0;1;1
93;13.12.2015;2015;12;02;Sunnuntai;1;1;2
93;13.12.2015;2015;12;03;Sunnuntai;0;0;0
93;13.12.2015;2015;12;04;Sunnuntai;0;0;0
93;13.12.2015;2015;12;05;Sunnuntai;0;0;0
93;13.12.2015;2015;12;06;Sunnuntai;0;0;0
93;13.12.2015;2015;12;07;Sunnuntai;2;0;2
93;13.12.2015;2015;12;08;Sunnuntai;0;2;2
93;13.12.2015;2015;12;09;Sunnuntai;4;0;4
93;13.12.2015;2015;12;10;Sunnuntai;0;1;1
93;13.12.2015;2015;12;11;Sunnuntai;2;4;6
93;13.12.2015;2015;12;12;Sunnuntai;0;2;2
93;13.12.2015;2015;12;13;Sunnuntai;1;1;2
93;13.12.2015;2015;12;14;Sunnuntai;3;4;7
93;13.12.2015;2015;12;15;Sunnuntai;0;0;0
93;13.12.2015;2015;12;16;Sunnuntai;3;4;7
93;13.12.2015;2015;12;17;Sunnuntai;0;1;1
93;13.12.2015;2015;12;18;Sunnuntai;1;0;1
93;13.12.2015;2015;12;19;Sunnuntai;1;0;1
93;13.12.2015;2015;12;20;Sunnuntai;1;0;1
93;13.12.2015;2015;12;21;Sunnuntai;0;1;1
93;13.12.2015;2015;12;22;Sunnuntai;0;0;0
93;13.12.2015;2015;12;23;Sunnuntai;0;1;1
93;14.12.2015;2015;12;00;Maanantai;0;0;0
93;14.12.2015;2015;12;01;Maanantai;0;0;0
93;14.12.2015;2015;12;02;Maanantai;0;0;0
93;14.12.2015;2015;12;03;Maanantai;0;0;0
93;14.12.2015;2015;12;04;Maanantai;0;1;1
93;14.12.2015;2015;12;05;Maanantai;1;0;1
93;14.12.2015;2015;12;06;Maanantai;6;2;8
93;14.12.2015;2015;12;07;Maanantai;13;8;21
93;14.12.2015;2015;12;08;Maanantai;2;16;18
93;14.12.2015;2015;12;09;Maanantai;5;3;8
93;14.12.2015;2015;12;10;Maanantai;0;0;0
93;14.12.2015;2015;12;11;Maanantai;6;1;7
93;14.12.2015;2015;12;12;Maanantai;2;3;5
93;14.12.2015;2015;12;13;Maanantai;0;5;5
93;14.12.2015;2015;12;14;Maanantai;3;5;8
93;14.12.2015;2015;12;15;Maanantai;5;4;9
93;14.12.2015;2015;12;16;Maanantai;15;11;26
93;14.12.2015;2015;12;17;Maanantai;8;3;11
93;14.12.2015;2015;12;18;Maanantai;4;5;9
93;14.12.2015;2015;12;19;Maanantai;1;3;4
93;14.12.2015;2015;12;20;Maanantai;2;2;4
93;14.12.2015;2015;12;21;Maanantai;0;1;1
93;14.12.2015;2015;12;22;Maanantai;0;1;1
93;14.12.2015;2015;12;23;Maanantai;1;0;1
93;15.12.2015;2015;12;00;Tiistai;1;0;1
93;15.12.2015;2015;12;01;Tiistai;0;0;0
93;15.12.2015;2015;12;02;Tiistai;0;0;0
93;15.12.2015;2015;12;03;Tiistai;0;0;0
93;15.12.2015;2015;12;04;Tiistai;0;0;0
93;15.12.2015;2015;12;05;Tiistai;1;1;2
93;15.12.2015;2015;12;06;Tiistai;3;5;8
93;15.12.2015;2015;12;07;Tiistai;7;14;21
93;15.12.2015;2015;12;08;Tiistai;7;11;18
93;15.12.2015;2015;12;09;Tiistai;8;2;10
93;15.12.2015;2015;12;10;Tiistai;2;0;2
93;15.12.2015;2015;12;11;Tiistai;4;3;7
93;15.12.2015;2015;12;12;Tiistai;0;4;4
93;15.12.2015;2015;12;13;Tiistai;5;3;8
93;15.12.2015;2015;12;14;Tiistai;5;3;8
93;15.12.2015;2015;12;15;Tiistai;6;7;13
93;15.12.2015;2015;12;16;Tiistai;13;8;21
93;15.12.2015;2015;12;17;Tiistai;6;6;12
93;15.12.2015;2015;12;18;Tiistai;9;7;16
93;15.12.2015;2015;12;19;Tiistai;1;2;3
93;15.12.2015;2015;12;20;Tiistai;4;6;10
93;15.12.2015;2015;12;21;Tiistai;0;0;0
93;15.12.2015;2015;12;22;Tiistai;0;1;1
93;15.12.2015;2015;12;23;Tiistai;0;0;0
93;16.12.2015;2015;12;00;Keskiviikko;1;0;1
93;16.12.2015;2015;12;01;Keskiviikko;0;0;0
93;16.12.2015;2015;12;02;Keskiviikko;0;0;0
93;16.12.2015;2015;12;03;Keskiviikko;0;0;0
93;16.12.2015;2015;12;04;Keskiviikko;0;1;1
93;16.12.2015;2015;12;05;Keskiviikko;1;1;2
93;16.12.2015;2015;12;06;Keskiviikko;6;3;9
93;16.12.2015;2015;12;07;Keskiviikko;8;13;21
93;16.12.2015;2015;12;08;Keskiviikko;3;18;21
93;16.12.2015;2015;12;09;Keskiviikko;2;1;3
93;16.12.2015;2015;12;10;Keskiviikko;1;1;2
93;16.12.2015;2015;12;11;Keskiviikko;0;5;5
93;16.12.2015;2015;12;12;Keskiviikko;4;4;8
93;16.12.2015;2015;12;13;Keskiviikko;4;3;7
93;16.12.2015;2015;12;14;Keskiviikko;4;0;4
93;16.12.2015;2015;12;15;Keskiviikko;5;5;10
93;16.12.2015;2015;12;16;Keskiviikko;10;7;17
93;16.12.2015;2015;12;17;Keskiviikko;14;3;17
93;16.12.2015;2015;12;18;Keskiviikko;3;5;8
93;16.12.2015;2015;12;19;Keskiviikko;2;2;4
93;16.12.2015;2015;12;20;Keskiviikko;3;2;5
93;16.12.2015;2015;12;21;Keskiviikko;0;1;1
93;16.12.2015;2015;12;22;Keskiviikko;1;0;1
93;16.12.2015;2015;12;23;Keskiviikko;0;0;0
93;17.12.2015;2015;12;00;Torstai;1;0;1
93;17.12.2015;2015;12;01;Torstai;0;0;0
93;17.12.2015;2015;12;02;Torstai;0;0;0
93;17.12.2015;2015;12;03;Torstai;0;0;0
93;17.12.2015;2015;12;04;Torstai;0;0;0
93;17.12.2015;2015;12;05;Torstai;0;1;1
93;17.12.2015;2015;12;06;Torstai;2;3;5
93;17.12.2015;2015;12;07;Torstai;6;11;17
93;17.12.2015;2015;12;08;Torstai;5;12;17
93;17.12.2015;2015;12;09;Torstai;4;2;6
93;17.12.2015;2015;12;10;Torstai;2;2;4
93;17.12.2015;2015;12;11;Torstai;0;2;2
93;17.12.2015;2015;12;12;Torstai;2;2;4
93;17.12.2015;2015;12;13;Torstai;2;5;7
93;17.12.2015;2015;12;14;Torstai;2;6;8
93;17.12.2015;2015;12;15;Torstai;3;1;4
93;17.12.2015;2015;12;16;Torstai;11;4;15
93;17.12.2015;2015;12;17;Torstai;6;3;9
93;17.12.2015;2015;12;18;Torstai;3;2;5
93;17.12.2015;2015;12;19;Torstai;4;2;6
93;17.12.2015;2015;12;20;Torstai;1;3;4
93;17.12.2015;2015;12;21;Torstai;1;1;2
93;17.12.2015;2015;12;22;Torstai;1;0;1
93;17.12.2015;2015;12;23;Torstai;0;0;0
93;18.12.2015;2015;12;00;Perjantai;1;0;1
93;18.12.2015;2015;12;01;Perjantai;0;0;0
93;18.12.2015;2015;12;02;Perjantai;0;0;0
93;18.12.2015;2015;12;03;Perjantai;0;0;0
93;18.12.2015;2015;12;04;Perjantai;0;0;0
93;18.12.2015;2015;12;05;Perjantai;0;1;1
93;18.12.2015;2015;12;06;Perjantai;5;2;7
93;18.12.2015;2015;12;07;Perjantai;6;12;18
93;18.12.2015;2015;12;08;Perjantai;5;8;13
93;18.12.2015;2015;12;09;Perjantai;6;4;10
93;18.12.2015;2015;12;10;Perjantai;0;3;3
93;18.12.2015;2015;12;11;Perjantai;1;3;4
93;18.12.2015;2015;12;12;Perjantai;0;0;0
93;18.12.2015;2015;12;13;Perjantai;3;3;6
93;18.12.2015;2015;12;14;Perjantai;5;4;9
93;18.12.2015;2015;12;15;Perjantai;7;4;11
93;18.12.2015;2015;12;16;Perjantai;11;2;13
93;18.12.2015;2015;12;17;Perjantai;3;1;4
93;18.12.2015;2015;12;18;Perjantai;2;3;5
93;18.12.2015;2015;12;19;Perjantai;2;2;4
93;18.12.2015;2015;12;20;Perjantai;3;0;3
93;18.12.2015;2015;12;21;Perjantai;0;3;3
93;18.12.2015;2015;12;22;Perjantai;1;0;1
93;18.12.2015;2015;12;23;Perjantai;1;1;2
93;19.12.2015;2015;12;00;Lauantai;0;0;0
93;19.12.2015;2015;12;01;Lauantai;0;1;1
93;19.12.2015;2015;12;02;Lauantai;0;0;0
93;19.12.2015;2015;12;03;Lauantai;0;0;0
93;19.12.2015;2015;12;04;Lauantai;0;0;0
93;19.12.2015;2015;12;05;Lauantai;0;0;0
93;19.12.2015;2015;12;06;Lauantai;0;0;0
93;19.12.2015;2015;12;07;Lauantai;0;0;0
93;19.12.2015;2015;12;08;Lauantai;1;0;1
93;19.12.2015;2015;12;09;Lauantai;0;0;0
93;19.12.2015;2015;12;10;Lauantai;2;6;8
93;19.12.2015;2015;12;11;Lauantai;3;1;4
93;19.12.2015;2015;12;12;Lauantai;2;8;10
93;19.12.2015;2015;12;13;Lauantai;2;2;4
93;19.12.2015;2015;12;14;Lauantai;3;1;4
93;19.12.2015;2015;12;15;Lauantai;0;3;3
93;19.12.2015;2015;12;16;Lauantai;1;1;2
93;19.12.2015;2015;12;17;Lauantai;0;1;1
93;19.12.2015;2015;12;18;Lauantai;0;1;1
93;19.12.2015;2015;12;19;Lauantai;0;0;0
93;19.12.2015;2015;12;20;Lauantai;0;0;0
93;19.12.2015;2015;12;21;Lauantai;0;0;0
93;19.12.2015;2015;12;22;Lauantai;1;0;1
93;19.12.2015;2015;12;23;Lauantai;0;0;0
93;20.12.2015;2015;12;00;Sunnuntai;0;0;0
93;20.12.2015;2015;12;01;Sunnuntai;0;1;1
93;20.12.2015;2015;12;02;Sunnuntai;0;1;1
93;20.12.2015;2015;12;03;Sunnuntai;0;0;0
93;20.12.2015;2015;12;04;Sunnuntai;0;0;0
93;20.12.2015;2015;12;05;Sunnuntai;0;0;0
93;20.12.2015;2015;12;06;Sunnuntai;0;0;0
93;20.12.2015;2015;12;07;Sunnuntai;0;0;0
93;20.12.2015;2015;12;08;Sunnuntai;1;0;1
93;20.12.2015;2015;12;09;Sunnuntai;2;0;2
93;20.12.2015;2015;12;10;Sunnuntai;3;1;4
93;20.12.2015;2015;12;11;Sunnuntai;2;1;3
93;20.12.2015;2015;12;12;Sunnuntai;4;3;7
93;20.12.2015;2015;12;13;Sunnuntai;0;0;0
93;20.12.2015;2015;12;14;Sunnuntai;2;2;4
93;20.12.2015;2015;12;15;Sunnuntai;0;1;1
93;20.12.2015;2015;12;16;Sunnuntai;0;1;1
93;20.12.2015;2015;12;17;Sunnuntai;0;0;0
93;20.12.2015;2015;12;18;Sunnuntai;0;0;0
93;20.12.2015;2015;12;19;Sunnuntai;1;1;2
93;20.12.2015;2015;12;20;Sunnuntai;1;2;3
93;20.12.2015;2015;12;21;Sunnuntai;1;1;2
93;20.12.2015;2015;12;22;Sunnuntai;1;0;1
93;20.12.2015;2015;12;23;Sunnuntai;0;0;0
93;21.12.2015;2015;12;00;Maanantai;0;0;0
93;21.12.2015;2015;12;01;Maanantai;0;0;0
93;21.12.2015;2015;12;02;Maanantai;0;0;0
93;21.12.2015;2015;12;03;Maanantai;0;0;0
93;21.12.2015;2015;12;04;Maanantai;0;0;0
93;21.12.2015;2015;12;05;Maanantai;0;2;2
93;21.12.2015;2015;12;06;Maanantai;3;1;4
93;21.12.2015;2015;12;07;Maanantai;4;9;13
93;21.12.2015;2015;12;08;Maanantai;2;9;11
93;21.12.2015;2015;12;09;Maanantai;1;0;1
93;21.12.2015;2015;12;10;Maanantai;1;0;1
93;21.12.2015;2015;12;11;Maanantai;0;3;3
93;21.12.2015;2015;12;12;Maanantai;0;2;2
93;21.12.2015;2015;12;13;Maanantai;5;1;6
93;21.12.2015;2015;12;14;Maanantai;4;6;10
93;21.12.2015;2015;12;15;Maanantai;4;5;9
93;21.12.2015;2015;12;16;Maanantai;14;2;16
93;21.12.2015;2015;12;17;Maanantai;4;3;7
93;21.12.2015;2015;12;18;Maanantai;2;0;2
93;21.12.2015;2015;12;19;Maanantai;1;2;3
93;21.12.2015;2015;12;20;Maanantai;1;1;2
93;21.12.2015;2015;12;21;Maanantai;1;0;1
93;21.12.2015;2015;12;22;Maanantai;2;1;3
93;21.12.2015;2015;12;23;Maanantai;0;0;0
93;22.12.2015;2015;12;00;Tiistai;0;0;0
93;22.12.2015;2015;12;01;Tiistai;0;0;0
93;22.12.2015;2015;12;02;Tiistai;0;0;0
93;22.12.2015;2015;12;03;Tiistai;0;0;0
93;22.12.2015;2015;12;04;Tiistai;0;0;0
93;22.12.2015;2015;12;05;Tiistai;1;1;2
93;22.12.2015;2015;12;06;Tiistai;3;2;5
93;22.12.2015;2015;12;07;Tiistai;4;7;11
93;22.12.2015;2015;12;08;Tiistai;1;7;8
93;22.12.2015;2015;12;09;Tiistai;6;0;6
93;22.12.2015;2015;12;10;Tiistai;2;1;3
93;22.12.2015;2015;12;11;Tiistai;0;5;5
93;22.12.2015;2015;12;12;Tiistai;1;2;3
93;22.12.2015;2015;12;13;Tiistai;1;3;4
93;22.12.2015;2015;12;14;Tiistai;6;6;12
93;22.12.2015;2015;12;15;Tiistai;3;3;6
93;22.12.2015;2015;12;16;Tiistai;10;4;14
93;22.12.2015;2015;12;17;Tiistai;3;2;5
93;22.12.2015;2015;12;18;Tiistai;4;2;6
93;22.12.2015;2015;12;19;Tiistai;1;3;4
93;22.12.2015;2015;12;20;Tiistai;1;1;2
93;22.12.2015;2015;12;21;Tiistai;1;1;2
93;22.12.2015;2015;12;22;Tiistai;2;0;2
93;22.12.2015;2015;12;23;Tiistai;2;0;2
93;23.12.2015;2015;12;00;Keskiviikko;0;0;0
93;23.12.2015;2015;12;01;Keskiviikko;0;0;0
93;23.12.2015;2015;12;02;Keskiviikko;0;1;1
93;23.12.2015;2015;12;03;Keskiviikko;0;0;0
93;23.12.2015;2015;12;04;Keskiviikko;0;0;0
93;23.12.2015;2015;12;05;Keskiviikko;0;0;0
93;23.12.2015;2015;12;06;Keskiviikko;2;1;3
93;23.12.2015;2015;12;07;Keskiviikko;0;4;4
93;23.12.2015;2015;12;08;Keskiviikko;4;5;9
93;23.12.2015;2015;12;09;Keskiviikko;0;2;2
93;23.12.2015;2015;12;10;Keskiviikko;1;0;1
93;23.12.2015;2015;12;11;Keskiviikko;0;2;2
93;23.12.2015;2015;12;12;Keskiviikko;2;2;4
93;23.12.2015;2015;12;13;Keskiviikko;3;7;10
93;23.12.2015;2015;12;14;Keskiviikko;3;0;3
93;23.12.2015;2015;12;15;Keskiviikko;5;2;7
93;23.12.2015;2015;12;16;Keskiviikko;5;2;7
93;23.12.2015;2015;12;17;Keskiviikko;0;0;0
93;23.12.2015;2015;12;18;Keskiviikko;1;5;6
93;23.12.2015;2015;12;19;Keskiviikko;1;1;2
93;23.12.2015;2015;12;20;Keskiviikko;1;1;2
93;23.12.2015;2015;12;21;Keskiviikko;0;1;1
93;23.12.2015;2015;12;22;Keskiviikko;0;1;1
93;23.12.2015;2015;12;23;Keskiviikko;0;1;1
93;24.12.2015;2015;12;00;Torstai;0;0;0
93;24.12.2015;2015;12;01;Torstai;0;0;0
93;24.12.2015;2015;12;02;Torstai;0;0;0
93;24.12.2015;2015;12;03;Torstai;0;0;0
93;24.12.2015;2015;12;04;Torstai;0;0;0
93;24.12.2015;2015;12;05;Torstai;0;0;0
93;24.12.2015;2015;12;06;Torstai;1;0;1
93;24.12.2015;2015;12;07;Torstai;0;0;0
93;24.12.2015;2015;12;08;Torstai;1;0;1
93;24.12.2015;2015;12;09;Torstai;0;0;0
93;24.12.2015;2015;12;10;Torstai;0;0;0
93;24.12.2015;2015;12;11;Torstai;0;2;2
93;24.12.2015;2015;12;12;Torstai;2;3;5
93;24.12.2015;2015;12;13;Torstai;1;3;4
93;24.12.2015;2015;12;14;Torstai;0;1;1
93;24.12.2015;2015;12;15;Torstai;1;0;1
93;24.12.2015;2015;12;16;Torstai;0;0;0
93;24.12.2015;2015;12;17;Torstai;0;0;0
93;24.12.2015;2015;12;18;Torstai;2;0;2
93;24.12.2015;2015;12;19;Torstai;1;1;2
93;24.12.2015;2015;12;20;Torstai;0;0;0
93;24.12.2015;2015;12;21;Torstai;0;2;2
93;24.12.2015;2015;12;22;Torstai;0;0;0
93;24.12.2015;2015;12;23;Torstai;0;0;0
93;25.12.2015;2015;12;00;Perjantai;0;0;0
93;25.12.2015;2015;12;01;Perjantai;0;0;0
93;25.12.2015;2015;12;02;Perjantai;0;0;0
93;25.12.2015;2015;12;03;Perjantai;0;0;0
93;25.12.2015;2015;12;04;Perjantai;0;0;0
93;25.12.2015;2015;12;05;Perjantai;0;0;0
93;25.12.2015;2015;12;06;Perjantai;0;0;0
93;25.12.2015;2015;12;07;Perjantai;0;0;0
93;25.12.2015;2015;12;08;Perjantai;0;0;0
93;25.12.2015;2015;12;09;Perjantai;0;0;0
93;25.12.2015;2015;12;10;Perjantai;0;0;0
93;25.12.2015;2015;12;11;Perjantai;0;0;0
93;25.12.2015;2015;12;12;Perjantai;1;0;1
93;25.12.2015;2015;12;13;Perjantai;0;0;0
93;25.12.2015;2015;12;14;Perjantai;0;2;2
93;25.12.2015;2015;12;15;Perjantai;1;1;2
93;25.12.2015;2015;12;16;Perjantai;1;0;1
93;25.12.2015;2015;12;17;Perjantai;0;0;0
93;25.12.2015;2015;12;18;Perjantai;0;0;0
93;25.12.2015;2015;12;19;Perjantai;0;0;0
93;25.12.2015;2015;12;20;Perjantai;0;0;0
93;25.12.2015;2015;12;21;Perjantai;1;0;1
93;25.12.2015;2015;12;22;Perjantai;0;0;0
93;25.12.2015;2015;12;23;Perjantai;0;1;1
93;26.12.2015;2015;12;00;Lauantai;0;0;0
93;26.12.2015;2015;12;01;Lauantai;0;0;0
93;26.12.2015;2015;12;02;Lauantai;0;0;0
93;26.12.2015;2015;12;03;Lauantai;0;0;0
93;26.12.2015;2015;12;04;Lauantai;0;0;0
93;26.12.2015;2015;12;05;Lauantai;0;0;0
93;26.12.2015;2015;12;06;Lauantai;0;0;0
93;26.12.2015;2015;12;07;Lauantai;0;0;0
93;26.12.2015;2015;12;08;Lauantai;1;0;1
93;26.12.2015;2015;12;09;Lauantai;2;2;4
93;26.12.2015;2015;12;10;Lauantai;1;0;1
93;26.12.2015;2015;12;11;Lauantai;4;0;4
93;26.12.2015;2015;12;12;Lauantai;0;6;6
93;26.12.2015;2015;12;13;Lauantai;5;1;6
93;26.12.2015;2015;12;14;Lauantai;3;4;7
93;26.12.2015;2015;12;15;Lauantai;1;0;1
93;26.12.2015;2015;12;16;Lauantai;0;1;1
93;26.12.2015;2015;12;17;Lauantai;0;2;2
93;26.12.2015;2015;12;18;Lauantai;0;0;0
93;26.12.2015;2015;12;19;Lauantai;0;0;0
93;26.12.2015;2015;12;20;Lauantai;1;0;1
93;26.12.2015;2015;12;21;Lauantai;0;0;0
93;26.12.2015;2015;12;22;Lauantai;1;0;1
93;26.12.2015;2015;12;23;Lauantai;0;0;0
93;27.12.2015;2015;12;00;Sunnuntai;0;0;0
93;27.12.2015;2015;12;01;Sunnuntai;0;0;0
93;27.12.2015;2015;12;02;Sunnuntai;0;2;2
93;27.12.2015;2015;12;03;Sunnuntai;0;0;0
93;27.12.2015;2015;12;04;Sunnuntai;0;2;2
93;27.12.2015;2015;12;05;Sunnuntai;0;0;0
93;27.12.2015;2015;12;06;Sunnuntai;2;0;2
93;27.12.2015;2015;12;07;Sunnuntai;2;0;2
93;27.12.2015;2015;12;08;Sunnuntai;0;2;2
93;27.12.2015;2015;12;09;Sunnuntai;0;0;0
93;27.12.2015;2015;12;10;Sunnuntai;0;0;0
93;27.12.2015;2015;12;11;Sunnuntai;10;1;11
93;27.12.2015;2015;12;12;Sunnuntai;6;0;6
93;27.12.2015;2015;12;13;Sunnuntai;0;1;1
93;27.12.2015;2015;12;14;Sunnuntai;2;5;7
93;27.12.2015;2015;12;15;Sunnuntai;0;0;0
93;27.12.2015;2015;12;16;Sunnuntai;0;2;2
93;27.12.2015;2015;12;17;Sunnuntai;1;0;1
93;27.12.2015;2015;12;18;Sunnuntai;1;0;1
93;27.12.2015;2015;12;19;Sunnuntai;2;1;3
93;27.12.2015;2015;12;20;Sunnuntai;4;1;5
93;27.12.2015;2015;12;21;Sunnuntai;2;0;2
93;27.12.2015;2015;12;22;Sunnuntai;0;0;0
93;27.12.2015;2015;12;23;Sunnuntai;0;0;0
93;28.12.2015;2015;12;00;Maanantai;0;1;1
93;28.12.2015;2015;12;01;Maanantai;1;2;3
93;28.12.2015;2015;12;02;Maanantai;0;0;0
93;28.12.2015;2015;12;03;Maanantai;0;0;0
93;28.12.2015;2015;12;04;Maanantai;0;1;1
93;28.12.2015;2015;12;05;Maanantai;0;2;2
93;28.12.2015;2015;12;06;Maanantai;3;1;4
93;28.12.2015;2015;12;07;Maanantai;2;4;6
93;28.12.2015;2015;12;08;Maanantai;2;7;9
93;28.12.2015;2015;12;09;Maanantai;1;1;2
93;28.12.2015;2015;12;10;Maanantai;1;1;2
93;28.12.2015;2015;12;11;Maanantai;1;2;3
93;28.12.2015;2015;12;12;Maanantai;2;1;3
93;28.12.2015;2015;12;13;Maanantai;0;3;3
93;28.12.2015;2015;12;14;Maanantai;6;4;10
93;28.12.2015;2015;12;15;Maanantai;5;2;7
93;28.12.2015;2015;12;16;Maanantai;9;2;11
93;28.12.2015;2015;12;17;Maanantai;2;3;5
93;28.12.2015;2015;12;18;Maanantai;1;0;1
93;28.12.2015;2015;12;19;Maanantai;2;1;3
93;28.12.2015;2015;12;20;Maanantai;1;0;1
93;28.12.2015;2015;12;21;Maanantai;0;0;0
93;28.12.2015;2015;12;22;Maanantai;0;2;2
93;28.12.2015;2015;12;23;Maanantai;0;0;0
93;29.12.2015;2015;12;00;Tiistai;0;0;0
93;29.12.2015;2015;12;01;Tiistai;0;0;0
93;29.12.2015;2015;12;02;Tiistai;0;0;0
93;29.12.2015;2015;12;03;Tiistai;0;0;0
93;29.12.2015;2015;12;04;Tiistai;0;1;1
93;29.12.2015;2015;12;05;Tiistai;0;1;1
93;29.12.2015;2015;12;06;Tiistai;1;1;2
93;29.12.2015;2015;12;07;Tiistai;4;6;10
93;29.12.2015;2015;12;08;Tiistai;3;5;8
93;29.12.2015;2015;12;09;Tiistai;1;0;1
93;29.12.2015;2015;12;10;Tiistai;0;1;1
93;29.12.2015;2015;12;11;Tiistai;0;2;2
93;29.12.2015;2015;12;12;Tiistai;1;0;1
93;29.12.2015;2015;12;13;Tiistai;1;0;1
93;29.12.2015;2015;12;14;Tiistai;3;1;4
93;29.12.2015;2015;12;15;Tiistai;5;1;6
93;29.12.2015;2015;12;16;Tiistai;2;3;5
93;29.12.2015;2015;12;17;Tiistai;7;3;10
93;29.12.2015;2015;12;18;Tiistai;3;1;4
93;29.12.2015;2015;12;19;Tiistai;2;0;2
93;29.12.2015;2015;12;20;Tiistai;1;0;1
93;29.12.2015;2015;12;21;Tiistai;0;0;0
93;29.12.2015;2015;12;22;Tiistai;0;0;0
93;29.12.2015;2015;12;23;Tiistai;0;0;0
93;30.12.2015;2015;12;00;Keskiviikko;0;0;0
93;30.12.2015;2015;12;01;Keskiviikko;0;0;0
93;30.12.2015;2015;12;02;Keskiviikko;0;0;0
93;30.12.2015;2015;12;03;Keskiviikko;0;0;0
93;30.12.2015;2015;12;04;Keskiviikko;2;0;2
93;30.12.2015;2015;12;05;Keskiviikko;0;1;1
93;30.12.2015;2015;12;06;Keskiviikko;1;0;1
93;30.12.2015;2015;12;07;Keskiviikko;3;4;7
93;30.12.2015;2015;12;08;Keskiviikko;4;5;9
93;30.12.2015;2015;12;09;Keskiviikko;3;1;4
93;30.12.2015;2015;12;10;Keskiviikko;3;4;7
93;30.12.2015;2015;12;11;Keskiviikko;7;2;9
93;30.12.2015;2015;12;12;Keskiviikko;2;6;8
93;30.12.2015;2015;12;13;Keskiviikko;2;3;5
93;30.12.2015;2015;12;14;Keskiviikko;5;4;9
93;30.12.2015;2015;12;15;Keskiviikko;6;0;6
93;30.12.2015;2015;12;16;Keskiviikko;7;3;10
93;30.12.2015;2015;12;17;Keskiviikko;3;3;6
93;30.12.2015;2015;12;18;Keskiviikko;1;1;2
93;30.12.2015;2015;12;19;Keskiviikko;4;2;6
93;30.12.2015;2015;12;20;Keskiviikko;3;2;5
93;30.12.2015;2015;12;21;Keskiviikko;2;1;3
93;30.12.2015;2015;12;22;Keskiviikko;0;2;2
93;30.12.2015;2015;12;23;Keskiviikko;0;0;0
93;31.12.2015;2015;12;00;Torstai;0;0;0
93;31.12.2015;2015;12;01;Torstai;0;0;0
93;31.12.2015;2015;12;02;Torstai;0;0;0
93;31.12.2015;2015;12;03;Torstai;0;0;0
93;31.12.2015;2015;12;04;Torstai;0;0;0
93;31.12.2015;2015;12;05;Torstai;2;1;3
93;31.12.2015;2015;12;06;Torstai;1;0;1
93;31.12.2015;2015;12;07;Torstai;2;4;6
93;31.12.2015;2015;12;08;Torstai;3;5;8
93;31.12.2015;2015;12;09;Torstai;2;1;3
93;31.12.2015;2015;12;10;Torstai;5;2;7
93;31.12.2015;2015;12;11;Torstai;0;2;2
93;31.12.2015;2015;12;12;Torstai;6;3;9
93;31.12.2015;2015;12;13;Torstai;2;3;5
93;31.12.2015;2015;12;14;Torstai;4;2;6
93;31.12.2015;2015;12;15;Torstai;5;4;9
93;31.12.2015;2015;12;16;Torstai;2;0;2
93;31.12.2015;2015;12;17;Torstai;2;2;4
93;31.12.2015;2015;12;18;Torstai;1;0;1
93;31.12.2015;2015;12;19;Torstai;1;0;1
93;31.12.2015;2015;12;20;Torstai;0;0;0
93;31.12.2015;2015;12;21;Torstai;0;0;0
93;31.12.2015;2015;12;22;Torstai;0;0;0
93;31.12.2015;2015;12;23;Torstai;0;0;0
93;01.01.2016;2016;01;00;Perjantai;0;0;0
93;01.01.2016;2016;01;01;Perjantai;0;1;1
93;01.01.2016;2016;01;02;Perjantai;0;1;1
93;01.01.2016;2016;01;03;Perjantai;0;0;0
93;01.01.2016;2016;01;04;Perjantai;0;0;0
93;01.01.2016;2016;01;05;Perjantai;0;0;0
93;01.01.2016;2016;01;06;Perjantai;0;0;0
93;01.01.2016;2016;01;07;Perjantai;0;0;0
93;01.01.2016;2016;01;08;Perjantai;2;1;3
93;01.01.2016;2016;01;09;Perjantai;1;1;2
93;01.01.2016;2016;01;10;Perjantai;4;0;4
93;01.01.2016;2016;01;11;Perjantai;2;1;3
93;01.01.2016;2016;01;12;Perjantai;2;0;2
93;01.01.2016;2016;01;13;Perjantai;0;7;7
93;01.01.2016;2016;01;14;Perjantai;3;0;3
93;01.01.2016;2016;01;15;Perjantai;3;3;6
93;01.01.2016;2016;01;16;Perjantai;4;1;5
93;01.01.2016;2016;01;17;Perjantai;0;3;3
93;01.01.2016;2016;01;18;Perjantai;1;2;3
93;01.01.2016;2016;01;19;Perjantai;0;0;0
93;01.01.2016;2016;01;20;Perjantai;1;0;1
93;01.01.2016;2016;01;21;Perjantai;0;0;0
93;01.01.2016;2016;01;22;Perjantai;0;0;0
93;01.01.2016;2016;01;23;Perjantai;1;0;1
93;02.01.2016;2016;01;00;Lauantai;0;0;0
93;02.01.2016;2016;01;01;Lauantai;0;1;1
93;02.01.2016;2016;01;02;Lauantai;0;0;0
93;02.01.2016;2016;01;03;Lauantai;1;1;2
93;02.01.2016;2016;01;04;Lauantai;0;0;0
93;02.01.2016;2016;01;05;Lauantai;0;1;1
93;02.01.2016;2016;01;06;Lauantai;0;1;1
93;02.01.2016;2016;01;07;Lauantai;0;0;0
93;02.01.2016;2016;01;08;Lauantai;0;0;0
93;02.01.2016;2016;01;09;Lauantai;0;1;1
93;02.01.2016;2016;01;10;Lauantai;3;1;4
93;02.01.2016;2016;01;11;Lauantai;0;1;1
93;02.01.2016;2016;01;12;Lauantai;0;3;3
93;02.01.2016;2016;01;13;Lauantai;2;0;2
93;02.01.2016;2016;01;14;Lauantai;2;2;4
93;02.01.2016;2016;01;15;Lauantai;1;1;2
93;02.01.2016;2016;01;16;Lauantai;0;0;0
93;02.01.2016;2016;01;17;Lauantai;0;0;0
93;02.01.2016;2016;01;18;Lauantai;0;0;0
93;02.01.2016;2016;01;19;Lauantai;0;0;0
93;02.01.2016;2016;01;20;Lauantai;1;0;1
93;02.01.2016;2016;01;21;Lauantai;0;0;0
93;02.01.2016;2016;01;22;Lauantai;1;1;2
93;02.01.2016;2016;01;23;Lauantai;0;0;0
93;03.01.2016;2016;01;00;Sunnuntai;0;0;0
93;03.01.2016;2016;01;01;Sunnuntai;0;0;0
93;03.01.2016;2016;01;02;Sunnuntai;0;0;0
93;03.01.2016;2016;01;03;Sunnuntai;0;0;0
93;03.01.2016;2016;01;04;Sunnuntai;0;0;0
93;03.01.2016;2016;01;05;Sunnuntai;0;0;0
93;03.01.2016;2016;01;06;Sunnuntai;0;1;1
93;03.01.2016;2016;01;07;Sunnuntai;0;0;0
93;03.01.2016;2016;01;08;Sunnuntai;0;0;0
93;03.01.2016;2016;01;09;Sunnuntai;1;1;2
93;03.01.2016;2016;01;10;Sunnuntai;2;1;3
93;03.01.2016;2016;01;11;Sunnuntai;0;0;0
93;03.01.2016;2016;01;12;Sunnuntai;2;7;9
93;03.01.2016;2016;01;13;Sunnuntai;2;1;3
93;03.01.2016;2016;01;14;Sunnuntai;4;1;5
93;03.01.2016;2016;01;15;Sunnuntai;4;5;9
93;03.01.2016;2016;01;16;Sunnuntai;1;1;2
93;03.01.2016;2016;01;17;Sunnuntai;2;1;3
93;03.01.2016;2016;01;18;Sunnuntai;0;2;2
93;03.01.2016;2016;01;19;Sunnuntai;1;0;1
93;03.01.2016;2016;01;20;Sunnuntai;0;0;0
93;03.01.2016;2016;01;21;Sunnuntai;0;1;1
93;03.01.2016;2016;01;22;Sunnuntai;0;0;0
93;03.01.2016;2016;01;23;Sunnuntai;0;0;0
93;04.01.2016;2016;01;00;Maanantai;0;0;0
93;04.01.2016;2016;01;01;Maanantai;0;0;0
93;04.01.2016;2016;01;02;Maanantai;0;0;0
93;04.01.2016;2016;01;03;Maanantai;0;0;0
93;04.01.2016;2016;01;04;Maanantai;0;2;2
93;04.01.2016;2016;01;05;Maanantai;0;1;1
93;04.01.2016;2016;01;06;Maanantai;1;1;2
93;04.01.2016;2016;01;07;Maanantai;3;2;5
93;04.01.2016;2016;01;08;Maanantai;3;6;9
93;04.01.2016;2016;01;09;Maanantai;0;2;2
93;04.01.2016;2016;01;10;Maanantai;1;0;1
93;04.01.2016;2016;01;11;Maanantai;2;1;3
93;04.01.2016;2016;01;12;Maanantai;0;0;0
93;04.01.2016;2016;01;13;Maanantai;2;1;3
93;04.01.2016;2016;01;14;Maanantai;1;3;4
93;04.01.2016;2016;01;15;Maanantai;1;1;2
93;04.01.2016;2016;01;16;Maanantai;5;4;9
93;04.01.2016;2016;01;17;Maanantai;5;3;8
93;04.01.2016;2016;01;18;Maanantai;1;2;3
93;04.01.2016;2016;01;19;Maanantai;1;0;1
93;04.01.2016;2016;01;20;Maanantai;1;0;1
93;04.01.2016;2016;01;21;Maanantai;1;1;2
93;04.01.2016;2016;01;22;Maanantai;0;0;0
93;04.01.2016;2016;01;23;Maanantai;0;0;0
93;05.01.2016;2016;01;00;Tiistai;0;0;0
93;05.01.2016;2016;01;01;Tiistai;0;0;0
93;05.01.2016;2016;01;02;Tiistai;0;0;0
93;05.01.2016;2016;01;03;Tiistai;0;0;0
93;05.01.2016;2016;01;04;Tiistai;0;0;0
93;05.01.2016;2016;01;05;Tiistai;0;2;2
93;05.01.2016;2016;01;06;Tiistai;2;4;6
93;05.01.2016;2016;01;07;Tiistai;4;3;7
93;05.01.2016;2016;01;08;Tiistai;3;7;10
93;05.01.2016;2016;01;09;Tiistai;1;1;2
93;05.01.2016;2016;01;10;Tiistai;0;1;1
93;05.01.2016;2016;01;11;Tiistai;3;1;4
93;05.01.2016;2016;01;12;Tiistai;0;1;1
93;05.01.2016;2016;01;13;Tiistai;1;0;1
93;05.01.2016;2016;01;14;Tiistai;4;1;5
93;05.01.2016;2016;01;15;Tiistai;4;5;9
93;05.01.2016;2016;01;16;Tiistai;10;2;12
93;05.01.2016;2016;01;17;Tiistai;3;0;3
93;05.01.2016;2016;01;18;Tiistai;1;3;4
93;05.01.2016;2016;01;19;Tiistai;0;0;0
93;05.01.2016;2016;01;20;Tiistai;1;0;1
93;05.01.2016;2016;01;21;Tiistai;0;0;0
93;05.01.2016;2016;01;22;Tiistai;0;0;0
93;05.01.2016;2016;01;23;Tiistai;0;1;1
93;06.01.2016;2016;01;00;Keskiviikko;0;0;0
93;06.01.2016;2016;01;01;Keskiviikko;0;0;0
93;06.01.2016;2016;01;02;Keskiviikko;0;0;0
93;06.01.2016;2016;01;03;Keskiviikko;0;0;0
93;06.01.2016;2016;01;04;Keskiviikko;0;0;0
93;06.01.2016;2016;01;05;Keskiviikko;0;0;0
93;06.01.2016;2016;01;06;Keskiviikko;0;0;0
93;06.01.2016;2016;01;07;Keskiviikko;0;0;0
93;06.01.2016;2016;01;08;Keskiviikko;0;0;0
93;06.01.2016;2016;01;09;Keskiviikko;0;0;0
93;06.01.2016;2016;01;10;Keskiviikko;0;0;0
93;06.01.2016;2016;01;11;Keskiviikko;0;0;0
93;06.01.2016;2016;01;12;Keskiviikko;1;0;1
93;06.01.2016;2016;01;13;Keskiviikko;1;2;3
93;06.01.2016;2016;01;14;Keskiviikko;0;1;1
93;06.01.2016;2016;01;15;Keskiviikko;1;0;1
93;06.01.2016;2016;01;16;Keskiviikko;1;1;2
93;06.01.2016;2016;01;17;Keskiviikko;0;0;0
93;06.01.2016;2016;01;18;Keskiviikko;0;1;1
93;06.01.2016;2016;01;19;Keskiviikko;0;0;0
93;06.01.2016;2016;01;20;Keskiviikko;0;0;0
93;06.01.2016;2016;01;21;Keskiviikko;0;0;0
93;06.01.2016;2016;01;22;Keskiviikko;0;0;0
93;06.01.2016;2016;01;23;Keskiviikko;0;0;0
93;07.01.2016;2016;01;00;Torstai;0;0;0
93;07.01.2016;2016;01;01;Torstai;0;1;1
93;07.01.2016;2016;01;02;Torstai;0;0;0
93;07.01.2016;2016;01;03;Torstai;0;0;0
93;07.01.2016;2016;01;04;Torstai;0;0;0
93;07.01.2016;2016;01;05;Torstai;0;0;0
93;07.01.2016;2016;01;06;Torstai;2;2;4
93;07.01.2016;2016;01;07;Torstai;1;0;1
93;07.01.2016;2016;01;08;Torstai;0;3;3
93;07.01.2016;2016;01;09;Torstai;1;1;2
93;07.01.2016;2016;01;10;Torstai;0;0;0
93;07.01.2016;2016;01;11;Torstai;0;0;0
93;07.01.2016;2016;01;12;Torstai;0;0;0
93;07.01.2016;2016;01;13;Torstai;1;0;1
93;07.01.2016;2016;01;14;Torstai;1;0;1
93;07.01.2016;2016;01;15;Torstai;0;3;3
93;07.01.2016;2016;01;16;Torstai;1;1;2
93;07.01.2016;2016;01;17;Torstai;3;0;3
93;07.01.2016;2016;01;18;Torstai;0;0;0
93;07.01.2016;2016;01;19;Torstai;0;0;0
93;07.01.2016;2016;01;20;Torstai;2;0;2
93;07.01.2016;2016;01;21;Torstai;0;1;1
93;07.01.2016;2016;01;22;Torstai;0;0;0
93;07.01.2016;2016;01;23;Torstai;0;0;0
93;08.01.2016;2016;01;00;Perjantai;0;0;0
93;08.01.2016;2016;01;01;Perjantai;0;0;0
93;08.01.2016;2016;01;02;Perjantai;0;0;0
93;08.01.2016;2016;01;03;Perjantai;0;0;0
93;08.01.2016;2016;01;04;Perjantai;0;0;0
93;08.01.2016;2016;01;05;Perjantai;0;1;1
93;08.01.2016;2016;01;06;Perjantai;2;0;2
93;08.01.2016;2016;01;07;Perjantai;1;4;5
93;08.01.2016;2016;01;08;Perjantai;1;3;4
93;08.01.2016;2016;01;09;Perjantai;1;1;2
93;08.01.2016;2016;01;10;Perjantai;0;0;0
93;08.01.2016;2016;01;11;Perjantai;1;0;1
93;08.01.2016;2016;01;12;Perjantai;1;0;1
93;08.01.2016;2016;01;13;Perjantai;0;1;1
93;08.01.2016;2016;01;14;Perjantai;0;1;1
93;08.01.2016;2016;01;15;Perjantai;2;0;2
93;08.01.2016;2016;01;16;Perjantai;4;2;6
93;08.01.2016;2016;01;17;Perjantai;4;1;5
93;08.01.2016;2016;01;18;Perjantai;2;2;4
93;08.01.2016;2016;01;19;Perjantai;1;1;2
93;08.01.2016;2016;01;20;Perjantai;2;0;2
93;08.01.2016;2016;01;21;Perjantai;0;1;1
93;08.01.2016;2016;01;22;Perjantai;0;1;1
93;08.01.2016;2016;01;23;Perjantai;0;0;0
93;09.01.2016;2016;01;00;Lauantai;0;0;0
93;09.01.2016;2016;01;01;Lauantai;0;0;0
93;09.01.2016;2016;01;02;Lauantai;0;0;0
93;09.01.2016;2016;01;03;Lauantai;0;0;0
93;09.01.2016;2016;01;04;Lauantai;0;0;0
93;09.01.2016;2016;01;05;Lauantai;0;0;0
93;09.01.2016;2016;01;06;Lauantai;0;0;0
93;09.01.2016;2016;01;07;Lauantai;2;2;4
93;09.01.2016;2016;01;08;Lauantai;0;0;0
93;09.01.2016;2016;01;09;Lauantai;0;0;0
93;09.01.2016;2016;01;10;Lauantai;0;0;0
93;09.01.2016;2016;01;11;Lauantai;1;0;1
93;09.01.2016;2016;01;12;Lauantai;0;0;0
93;09.01.2016;2016;01;13;Lauantai;2;1;3
93;09.01.2016;2016;01;14;Lauantai;0;0;0
93;09.01.2016;2016;01;15;Lauantai;0;0;0
93;09.01.2016;2016;01;16;Lauantai;1;3;4
93;09.01.2016;2016;01;17;Lauantai;1;3;4
93;09.01.2016;2016;01;18;Lauantai;1;0;1
93;09.01.2016;2016;01;19;Lauantai;0;0;0
93;09.01.2016;2016;01;20;Lauantai;0;0;0
93;09.01.2016;2016;01;21;Lauantai;2;3;5
93;09.01.2016;2016;01;22;Lauantai;0;0;0
93;09.01.2016;2016;01;23;Lauantai;0;0;0
93;10.01.2016;2016;01;00;Sunnuntai;0;0;0
93;10.01.2016;2016;01;01;Sunnuntai;0;0;0
93;10.01.2016;2016;01;02;Sunnuntai;0;0;0
93;10.01.2016;2016;01;03;Sunnuntai;0;0;0
93;10.01.2016;2016;01;04;Sunnuntai;0;0;0
93;10.01.2016;2016;01;05;Sunnuntai;0;0;0
93;10.01.2016;2016;01;06;Sunnuntai;1;0;1
93;10.01.2016;2016;01;07;Sunnuntai;0;1;1
93;10.01.2016;2016;01;08;Sunnuntai;0;0;0
93;10.01.2016;2016;01;09;Sunnuntai;2;0;2
93;10.01.2016;2016;01;10;Sunnuntai;12;0;12
93;10.01.2016;2016;01;11;Sunnuntai;2;1;3
93;10.01.2016;2016;01;12;Sunnuntai;0;2;2
93;10.01.2016;2016;01;13;Sunnuntai;0;4;4
93;10.01.2016;2016;01;14;Sunnuntai;0;2;2
93;10.01.2016;2016;01;15;Sunnuntai;2;0;2
93;10.01.2016;2016;01;16;Sunnuntai;0;1;1
93;10.01.2016;2016;01;17;Sunnuntai;0;2;2
93;10.01.2016;2016;01;18;Sunnuntai;0;0;0
93;10.01.2016;2016;01;19;Sunnuntai;0;0;0
93;10.01.2016;2016;01;20;Sunnuntai;1;0;1
93;10.01.2016;2016;01;21;Sunnuntai;0;0;0
93;10.01.2016;2016;01;22;Sunnuntai;0;0;0
93;10.01.2016;2016;01;23;Sunnuntai;0;0;0
93;11.01.2016;2016;01;00;Maanantai;0;0;0
93;11.01.2016;2016;01;01;Maanantai;0;0;0
93;11.01.2016;2016;01;02;Maanantai;0;0;0
93;11.01.2016;2016;01;03;Maanantai;0;0;0
93;11.01.2016;2016;01;04;Maanantai;0;0;0
93;11.01.2016;2016;01;05;Maanantai;1;0;1
93;11.01.2016;2016;01;06;Maanantai;4;2;6
93;11.01.2016;2016;01;07;Maanantai;6;10;16
93;11.01.2016;2016;01;08;Maanantai;4;6;10
93;11.01.2016;2016;01;09;Maanantai;3;1;4
93;11.01.2016;2016;01;10;Maanantai;1;1;2
93;11.01.2016;2016;01;11;Maanantai;0;1;1
93;11.01.2016;2016;01;12;Maanantai;2;0;2
93;11.01.2016;2016;01;13;Maanantai;1;0;1
93;11.01.2016;2016;01;14;Maanantai;3;3;6
93;11.01.2016;2016;01;15;Maanantai;5;4;9
93;11.01.2016;2016;01;16;Maanantai;5;6;11
93;11.01.2016;2016;01;17;Maanantai;8;3;11
93;11.01.2016;2016;01;18;Maanantai;3;4;7
93;11.01.2016;2016;01;19;Maanantai;1;0;1
93;11.01.2016;2016;01;20;Maanantai;2;3;5
93;11.01.2016;2016;01;21;Maanantai;1;1;2
93;11.01.2016;2016;01;22;Maanantai;0;1;1
93;11.01.2016;2016;01;23;Maanantai;0;0;0
93;12.01.2016;2016;01;00;Tiistai;0;1;1
93;12.01.2016;2016;01;01;Tiistai;0;0;0
93;12.01.2016;2016;01;02;Tiistai;0;0;0
93;12.01.2016;2016;01;03;Tiistai;0;0;0
93;12.01.2016;2016;01;04;Tiistai;0;0;0
93;12.01.2016;2016;01;05;Tiistai;1;1;2
93;12.01.2016;2016;01;06;Tiistai;2;3;5
93;12.01.2016;2016;01;07;Tiistai;5;7;12
93;12.01.2016;2016;01;08;Tiistai;4;7;11
93;12.01.2016;2016;01;09;Tiistai;1;2;3
93;12.01.2016;2016;01;10;Tiistai;0;1;1
93;12.01.2016;2016;01;11;Tiistai;1;0;1
93;12.01.2016;2016;01;12;Tiistai;1;0;1
93;12.01.2016;2016;01;13;Tiistai;0;1;1
93;12.01.2016;2016;01;14;Tiistai;3;1;4
93;12.01.2016;2016;01;15;Tiistai;3;2;5
93;12.01.2016;2016;01;16;Tiistai;7;5;12
93;12.01.2016;2016;01;17;Tiistai;6;4;10
93;12.01.2016;2016;01;18;Tiistai;3;0;3
93;12.01.2016;2016;01;19;Tiistai;2;0;2
93;12.01.2016;2016;01;20;Tiistai;0;0;0
93;12.01.2016;2016;01;21;Tiistai;0;1;1
93;12.01.2016;2016;01;22;Tiistai;0;0;0
93;12.01.2016;2016;01;23;Tiistai;0;0;0
93;13.01.2016;2016;01;00;Keskiviikko;0;0;0
93;13.01.2016;2016;01;01;Keskiviikko;0;0;0
93;13.01.2016;2016;01;02;Keskiviikko;0;0;0
93;13.01.2016;2016;01;03;Keskiviikko;0;0;0
93;13.01.2016;2016;01;04;Keskiviikko;0;0;0
93;13.01.2016;2016;01;05;Keskiviikko;0;0;0
93;13.01.2016;2016;01;06;Keskiviikko;3;4;7
93;13.01.2016;2016;01;07;Keskiviikko;7;7;14
93;13.01.2016;2016;01;08;Keskiviikko;3;6;9
93;13.01.2016;2016;01;09;Keskiviikko;0;0;0
93;13.01.2016;2016;01;10;Keskiviikko;1;0;1
93;13.01.2016;2016;01;11;Keskiviikko;0;0;0
93;13.01.2016;2016;01;12;Keskiviikko;0;0;0
93;13.01.2016;2016;01;13;Keskiviikko;1;0;1
93;13.01.2016;2016;01;14;Keskiviikko;2;2;4
93;13.01.2016;2016;01;15;Keskiviikko;4;2;6
93;13.01.2016;2016;01;16;Keskiviikko;3;4;7
93;13.01.2016;2016;01;17;Keskiviikko;5;4;9
93;13.01.2016;2016;01;18;Keskiviikko;2;1;3
93;13.01.2016;2016;01;19;Keskiviikko;2;0;2
93;13.01.2016;2016;01;20;Keskiviikko;1;0;1
93;13.01.2016;2016;01;21;Keskiviikko;0;1;1
93;13.01.2016;2016;01;22;Keskiviikko;0;0;0
93;13.01.2016;2016;01;23;Keskiviikko;0;0;0
93;14.01.2016;2016;01;00;Torstai;0;0;0
93;14.01.2016;2016;01;01;Torstai;0;0;0
93;14.01.2016;2016;01;02;Torstai;0;0;0
93;14.01.2016;2016;01;03;Torstai;0;0;0
93;14.01.2016;2016;01;04;Torstai;0;0;0
93;14.01.2016;2016;01;05;Torstai;0;1;1
93;14.01.2016;2016;01;06;Torstai;2;1;3
93;14.01.2016;2016;01;07;Torstai;5;9;14
93;14.01.2016;2016;01;08;Torstai;6;7;13
93;14.01.2016;2016;01;09;Torstai;2;2;4
93;14.01.2016;2016;01;10;Torstai;1;4;5
93;14.01.2016;2016;01;11;Torstai;1;3;4
93;14.01.2016;2016;01;12;Torstai;1;1;2
93;14.01.2016;2016;01;13;Torstai;3;0;3
93;14.01.2016;2016;01;14;Torstai;1;0;1
93;14.01.2016;2016;01;15;Torstai;3;2;5
93;14.01.2016;2016;01;16;Torstai;4;7;11
93;14.01.2016;2016;01;17;Torstai;7;4;11
93;14.01.2016;2016;01;18;Torstai;4;6;10
93;14.01.2016;2016;01;19;Torstai;2;3;5
93;14.01.2016;2016;01;20;Torstai;2;0;2
93;14.01.2016;2016;01;21;Torstai;0;2;2
93;14.01.2016;2016;01;22;Torstai;0;1;1
93;14.01.2016;2016;01;23;Torstai;0;0;0
93;15.01.2016;2016;01;00;Perjantai;0;0;0
93;15.01.2016;2016;01;01;Perjantai;0;0;0
93;15.01.2016;2016;01;02;Perjantai;0;0;0
93;15.01.2016;2016;01;03;Perjantai;0;0;0
93;15.01.2016;2016;01;04;Perjantai;0;0;0
93;15.01.2016;2016;01;05;Perjantai;0;0;0
93;15.01.2016;2016;01;06;Perjantai;4;1;5
93;15.01.2016;2016;01;07;Perjantai;6;6;12
93;15.01.2016;2016;01;08;Perjantai;3;6;9
93;15.01.2016;2016;01;09;Perjantai;0;1;1
93;15.01.2016;2016;01;10;Perjantai;2;1;3
93;15.01.2016;2016;01;11;Perjantai;1;2;3
93;15.01.2016;2016;01;12;Perjantai;0;1;1
93;15.01.2016;2016;01;13;Perjantai;0;1;1
93;15.01.2016;2016;01;14;Perjantai;3;2;5
93;15.01.2016;2016;01;15;Perjantai;5;2;7
93;15.01.2016;2016;01;16;Perjantai;2;3;5
93;15.01.2016;2016;01;17;Perjantai;3;4;7
93;15.01.2016;2016;01;18;Perjantai;3;1;4
93;15.01.2016;2016;01;19;Perjantai;2;1;3
93;15.01.2016;2016;01;20;Perjantai;2;0;2
93;15.01.2016;2016;01;21;Perjantai;0;4;4
93;15.01.2016;2016;01;22;Perjantai;0;0;0
93;15.01.2016;2016;01;23;Perjantai;0;0;0
93;16.01.2016;2016;01;00;Lauantai;0;0;0
93;16.01.2016;2016;01;01;Lauantai;0;0;0
93;16.01.2016;2016;01;02;Lauantai;0;0;0
93;16.01.2016;2016;01;03;Lauantai;0;1;1
93;16.01.2016;2016;01;04;Lauantai;0;0;0
93;16.01.2016;2016;01;05;Lauantai;0;0;0
93;16.01.2016;2016;01;06;Lauantai;1;1;2
93;16.01.2016;2016;01;07;Lauantai;0;0;0
93;16.01.2016;2016;01;08;Lauantai;0;0;0
93;16.01.2016;2016;01;09;Lauantai;2;0;2
93;16.01.2016;2016;01;10;Lauantai;0;1;1
93;16.01.2016;2016;01;11;Lauantai;0;0;0
93;16.01.2016;2016;01;12;Lauantai;0;0;0
93;16.01.2016;2016;01;13;Lauantai;2;1;3
93;16.01.2016;2016;01;14;Lauantai;1;3;4
93;16.01.2016;2016;01;15;Lauantai;3;0;3
93;16.01.2016;2016;01;16;Lauantai;1;1;2
93;16.01.2016;2016;01;17;Lauantai;2;1;3
93;16.01.2016;2016;01;18;Lauantai;2;3;5
93;16.01.2016;2016;01;19;Lauantai;0;1;1
93;16.01.2016;2016;01;20;Lauantai;0;0;0
93;16.01.2016;2016;01;21;Lauantai;0;0;0
93;16.01.2016;2016;01;22;Lauantai;0;0;0
93;16.01.2016;2016;01;23;Lauantai;0;0;0
93;17.01.2016;2016;01;00;Sunnuntai;0;0;0
93;17.01.2016;2016;01;01;Sunnuntai;0;0;0
93;17.01.2016;2016;01;02;Sunnuntai;0;1;1
93;17.01.2016;2016;01;03;Sunnuntai;0;1;1
93;17.01.2016;2016;01;04;Sunnuntai;0;0;0
93;17.01.2016;2016;01;05;Sunnuntai;0;0;0
93;17.01.2016;2016;01;06;Sunnuntai;0;0;0
93;17.01.2016;2016;01;07;Sunnuntai;0;0;0
93;17.01.2016;2016;01;08;Sunnuntai;1;0;1
93;17.01.2016;2016;01;09;Sunnuntai;0;0;0
93;17.01.2016;2016;01;10;Sunnuntai;0;0;0
93;17.01.2016;2016;01;11;Sunnuntai;1;0;1
93;17.01.2016;2016;01;12;Sunnuntai;0;1;1
93;17.01.2016;2016;01;13;Sunnuntai;0;1;1
93;17.01.2016;2016;01;14;Sunnuntai;2;1;3
93;17.01.2016;2016;01;15;Sunnuntai;1;1;2
93;17.01.2016;2016;01;16;Sunnuntai;0;1;1
93;17.01.2016;2016;01;17;Sunnuntai;0;0;0
93;17.01.2016;2016;01;18;Sunnuntai;0;0;0
93;17.01.2016;2016;01;19;Sunnuntai;0;0;0
93;17.01.2016;2016;01;20;Sunnuntai;0;0;0
93;17.01.2016;2016;01;21;Sunnuntai;0;0;0
93;17.01.2016;2016;01;22;Sunnuntai;0;0;0
93;17.01.2016;2016;01;23;Sunnuntai;0;0;0
93;18.01.2016;2016;01;00;Maanantai;0;0;0
93;18.01.2016;2016;01;01;Maanantai;0;0;0
93;18.01.2016;2016;01;02;Maanantai;1;1;2
93;18.01.2016;2016;01;03;Maanantai;0;0;0
93;18.01.2016;2016;01;04;Maanantai;0;0;0
93;18.01.2016;2016;01;05;Maanantai;1;0;1
93;18.01.2016;2016;01;06;Maanantai;2;0;2
93;18.01.2016;2016;01;07;Maanantai;4;3;7
93;18.01.2016;2016;01;08;Maanantai;0;4;4
93;18.01.2016;2016;01;09;Maanantai;1;3;4
93;18.01.2016;2016;01;10;Maanantai;1;0;1
93;18.01.2016;2016;01;11;Maanantai;0;1;1
93;18.01.2016;2016;01;12;Maanantai;0;0;0
93;18.01.2016;2016;01;13;Maanantai;0;1;1
93;18.01.2016;2016;01;14;Maanantai;1;0;1
93;18.01.2016;2016;01;15;Maanantai;1;3;4
93;18.01.2016;2016;01;16;Maanantai;1;1;2
93;18.01.2016;2016;01;17;Maanantai;6;2;8
93;18.01.2016;2016;01;18;Maanantai;1;0;1
93;18.01.2016;2016;01;19;Maanantai;1;0;1
93;18.01.2016;2016;01;20;Maanantai;1;0;1
93;18.01.2016;2016;01;21;Maanantai;0;1;1
93;18.01.2016;2016;01;22;Maanantai;0;0;0
93;18.01.2016;2016;01;23;Maanantai;0;0;0
93;19.01.2016;2016;01;00;Tiistai;0;0;0
93;19.01.2016;2016;01;01;Tiistai;0;0;0
93;19.01.2016;2016;01;02;Tiistai;0;0;0
93;19.01.2016;2016;01;03;Tiistai;0;0;0
93;19.01.2016;2016;01;04;Tiistai;0;0;0
93;19.01.2016;2016;01;05;Tiistai;1;0;1
93;19.01.2016;2016;01;06;Tiistai;1;2;3
93;19.01.2016;2016;01;07;Tiistai;2;3;5
93;19.01.2016;2016;01;08;Tiistai;1;1;2
93;19.01.2016;2016;01;09;Tiistai;0;0;0
93;19.01.2016;2016;01;10;Tiistai;0;0;0
93;19.01.2016;2016;01;11;Tiistai;0;2;2
93;19.01.2016;2016;01;12;Tiistai;1;0;1
93;19.01.2016;2016;01;13;Tiistai;0;0;0
93;19.01.2016;2016;01;14;Tiistai;0;1;1
93;19.01.2016;2016;01;15;Tiistai;0;1;1
93;19.01.2016;2016;01;16;Tiistai;4;2;6
93;19.01.2016;2016;01;17;Tiistai;1;0;1
93;19.01.2016;2016;01;18;Tiistai;1;0;1
93;19.01.2016;2016;01;19;Tiistai;0;0;0
93;19.01.2016;2016;01;20;Tiistai;0;0;0
93;19.01.2016;2016;01;21;Tiistai;0;1;1
93;19.01.2016;2016;01;22;Tiistai;0;0;0
93;19.01.2016;2016;01;23;Tiistai;0;0;0
93;20.01.2016;2016;01;00;Keskiviikko;0;0;0
93;20.01.2016;2016;01;01;Keskiviikko;0;0;0
93;20.01.2016;2016;01;02;Keskiviikko;0;0;0
93;20.01.2016;2016;01;03;Keskiviikko;0;0;0
93;20.01.2016;2016;01;04;Keskiviikko;0;0;0
93;20.01.2016;2016;01;05;Keskiviikko;0;0;0
93;20.01.2016;2016;01;06;Keskiviikko;1;1;2
93;20.01.2016;2016;01;07;Keskiviikko;3;2;5
93;20.01.2016;2016;01;08;Keskiviikko;1;1;2
93;20.01.2016;2016;01;09;Keskiviikko;1;0;1
93;20.01.2016;2016;01;10;Keskiviikko;0;0;0
93;20.01.2016;2016;01;11;Keskiviikko;0;1;1
93;20.01.2016;2016;01;12;Keskiviikko;0;0;0
93;20.01.2016;2016;01;13;Keskiviikko;0;1;1
93;20.01.2016;2016;01;14;Keskiviikko;0;0;0
93;20.01.2016;2016;01;15;Keskiviikko;0;2;2
93;20.01.2016;2016;01;16;Keskiviikko;2;1;3
93;20.01.2016;2016;01;17;Keskiviikko;1;2;3
93;20.01.2016;2016;01;18;Keskiviikko;1;0;1
93;20.01.2016;2016;01;19;Keskiviikko;0;0;0
93;20.01.2016;2016;01;20;Keskiviikko;1;0;1
93;20.01.2016;2016;01;21;Keskiviikko;0;1;1
93;20.01.2016;2016;01;22;Keskiviikko;0;0;0
93;20.01.2016;2016;01;23;Keskiviikko;0;0;0
93;21.01.2016;2016;01;00;Torstai;0;0;0
93;21.01.2016;2016;01;01;Torstai;0;0;0
93;21.01.2016;2016;01;02;Torstai;0;0;0
93;21.01.2016;2016;01;03;Torstai;0;0;0
93;21.01.2016;2016;01;04;Torstai;0;0;0
93;21.01.2016;2016;01;05;Torstai;0;0;0
93;21.01.2016;2016;01;06;Torstai;1;0;1
93;21.01.2016;2016;01;07;Torstai;2;2;4
93;21.01.2016;2016;01;08;Torstai;1;3;4
93;21.01.2016;2016;01;09;Torstai;1;0;1
93;21.01.2016;2016;01;10;Torstai;0;0;0
93;21.01.2016;2016;01;11;Torstai;0;1;1
93;21.01.2016;2016;01;12;Torstai;0;1;1
93;21.01.2016;2016;01;13;Torstai;0;0;0
93;21.01.2016;2016;01;14;Torstai;2;1;3
93;21.01.2016;2016;01;15;Torstai;0;0;0
93;21.01.2016;2016;01;16;Torstai;1;0;1
93;21.01.2016;2016;01;17;Torstai;1;1;2
93;21.01.2016;2016;01;18;Torstai;2;0;2
93;21.01.2016;2016;01;19;Torstai;0;0;0
93;21.01.2016;2016;01;20;Torstai;1;1;2
93;21.01.2016;2016;01;21;Torstai;0;1;1
93;21.01.2016;2016;01;22;Torstai;0;0;0
93;21.01.2016;2016;01;23;Torstai;0;0;0
93;22.01.2016;2016;01;00;Perjantai;0;0;0
93;22.01.2016;2016;01;01;Perjantai;0;0;0
93;22.01.2016;2016;01;02;Perjantai;0;0;0
93;22.01.2016;2016;01;03;Perjantai;0;0;0
93;22.01.2016;2016;01;04;Perjantai;1;0;1
93;22.01.2016;2016;01;05;Perjantai;0;0;0
93;22.01.2016;2016;01;06;Perjantai;1;1;2
93;22.01.2016;2016;01;07;Perjantai;4;3;7
93;22.01.2016;2016;01;08;Perjantai;2;4;6
93;22.01.2016;2016;01;09;Perjantai;0;1;1
93;22.01.2016;2016;01;10;Perjantai;2;1;3
93;22.01.2016;2016;01;11;Perjantai;1;1;2
93;22.01.2016;2016;01;12;Perjantai;1;1;2
93;22.01.2016;2016;01;13;Perjantai;0;0;0
93;22.01.2016;2016;01;14;Perjantai;2;3;5
93;22.01.2016;2016;01;15;Perjantai;4;1;5
93;22.01.2016;2016;01;16;Perjantai;3;0;3
93;22.01.2016;2016;01;17;Perjantai;5;5;10
93;22.01.2016;2016;01;18;Perjantai;0;2;2
93;22.01.2016;2016;01;19;Perjantai;0;2;2
93;22.01.2016;2016;01;20;Perjantai;1;0;1
93;22.01.2016;2016;01;21;Perjantai;0;2;2
93;22.01.2016;2016;01;22;Perjantai;1;1;2
93;22.01.2016;2016;01;23;Perjantai;0;0;0
93;23.01.2016;2016;01;00;Lauantai;0;0;0
93;23.01.2016;2016;01;01;Lauantai;0;0;0
93;23.01.2016;2016;01;02;Lauantai;0;0;0
93;23.01.2016;2016;01;03;Lauantai;1;0;1
93;23.01.2016;2016;01;04;Lauantai;0;0;0
93;23.01.2016;2016;01;05;Lauantai;1;2;3
93;23.01.2016;2016;01;06;Lauantai;2;0;2
93;23.01.2016;2016;01;07;Lauantai;1;0;1
93;23.01.2016;2016;01;08;Lauantai;1;1;2
93;23.01.2016;2016;01;09;Lauantai;6;3;9
93;23.01.2016;2016;01;10;Lauantai;1;4;5
93;23.01.2016;2016;01;11;Lauantai;1;4;5
93;23.01.2016;2016;01;12;Lauantai;9;2;11
93;23.01.2016;2016;01;13;Lauantai;4;4;8
93;23.01.2016;2016;01;14;Lauantai;10;3;13
93;23.01.2016;2016;01;15;Lauantai;1;3;4
93;23.01.2016;2016;01;16;Lauantai;0;2;2
93;23.01.2016;2016;01;17;Lauantai;6;3;9
93;23.01.2016;2016;01;18;Lauantai;1;3;4
93;23.01.2016;2016;01;19;Lauantai;1;3;4
93;23.01.2016;2016;01;20;Lauantai;1;5;6
93;23.01.2016;2016;01;21;Lauantai;0;0;0
93;23.01.2016;2016;01;22;Lauantai;0;1;1
93;23.01.2016;2016;01;23;Lauantai;2;0;2
93;24.01.2016;2016;01;00;Sunnuntai;0;0;0
93;24.01.2016;2016;01;01;Sunnuntai;0;0;0
93;24.01.2016;2016;01;02;Sunnuntai;1;0;1
93;24.01.2016;2016;01;03;Sunnuntai;0;0;0
93;24.01.2016;2016;01;04;Sunnuntai;0;0;0
93;24.01.2016;2016;01;05;Sunnuntai;0;0;0
93;24.01.2016;2016;01;06;Sunnuntai;0;0;0
93;24.01.2016;2016;01;07;Sunnuntai;2;0;2
93;24.01.2016;2016;01;08;Sunnuntai;2;0;2
93;24.01.2016;2016;01;09;Sunnuntai;2;3;5
93;24.01.2016;2016;01;10;Sunnuntai;2;4;6
93;24.01.2016;2016;01;11;Sunnuntai;13;5;18
93;24.01.2016;2016;01;12;Sunnuntai;2;0;2
93;24.01.2016;2016;01;13;Sunnuntai;3;4;7
93;24.01.2016;2016;01;14;Sunnuntai;5;7;12
93;24.01.2016;2016;01;15;Sunnuntai;1;3;4
93;24.01.2016;2016;01;16;Sunnuntai;1;0;1
93;24.01.2016;2016;01;17;Sunnuntai;3;1;4
93;24.01.2016;2016;01;18;Sunnuntai;0;0;0
93;24.01.2016;2016;01;19;Sunnuntai;5;1;6
93;24.01.2016;2016;01;20;Sunnuntai;0;2;2
93;24.01.2016;2016;01;21;Sunnuntai;1;1;2
93;24.01.2016;2016;01;22;Sunnuntai;1;2;3
93;24.01.2016;2016;01;23;Sunnuntai;0;1;1
93;25.01.2016;2016;01;00;Maanantai;0;0;0
93;25.01.2016;2016;01;01;Maanantai;0;0;0
93;25.01.2016;2016;01;02;Maanantai;0;0;0
93;25.01.2016;2016;01;03;Maanantai;0;0;0
93;25.01.2016;2016;01;04;Maanantai;0;0;0
93;25.01.2016;2016;01;05;Maanantai;1;1;2
93;25.01.2016;2016;01;06;Maanantai;3;3;6
93;25.01.2016;2016;01;07;Maanantai;11;10;21
93;25.01.2016;2016;01;08;Maanantai;6;13;19
93;25.01.2016;2016;01;09;Maanantai;4;2;6
93;25.01.2016;2016;01;10;Maanantai;3;3;6
93;25.01.2016;2016;01;11;Maanantai;2;4;6
93;25.01.2016;2016;01;12;Maanantai;2;3;5
93;25.01.2016;2016;01;13;Maanantai;2;3;5
93;25.01.2016;2016;01;14;Maanantai;4;2;6
93;25.01.2016;2016;01;15;Maanantai;7;6;13
93;25.01.2016;2016;01;16;Maanantai;14;8;22
93;25.01.2016;2016;01;17;Maanantai;16;6;22
93;25.01.2016;2016;01;18;Maanantai;9;2;11
93;25.01.2016;2016;01;19;Maanantai;2;1;3
93;25.01.2016;2016;01;20;Maanantai;1;5;6
93;25.01.2016;2016;01;21;Maanantai;0;2;2
93;25.01.2016;2016;01;22;Maanantai;1;2;3
93;25.01.2016;2016;01;23;Maanantai;0;0;0
93;26.01.2016;2016;01;00;Tiistai;0;1;1
93;26.01.2016;2016;01;01;Tiistai;0;0;0
93;26.01.2016;2016;01;02;Tiistai;0;0;0
93;26.01.2016;2016;01;03;Tiistai;0;0;0
93;26.01.2016;2016;01;04;Tiistai;0;0;0
93;26.01.2016;2016;01;05;Tiistai;1;1;2
93;26.01.2016;2016;01;06;Tiistai;5;4;9
93;26.01.2016;2016;01;07;Tiistai;11;11;22
93;26.01.2016;2016;01;08;Tiistai;2;6;8
93;26.01.2016;2016;01;09;Tiistai;2;0;2
93;26.01.2016;2016;01;10;Tiistai;0;0;0
93;26.01.2016;2016;01;11;Tiistai;1;1;2
93;26.01.2016;2016;01;12;Tiistai;1;0;1
93;26.01.2016;2016;01;13;Tiistai;1;0;1
93;26.01.2016;2016;01;14;Tiistai;3;0;3
93;26.01.2016;2016;01;15;Tiistai;4;7;11
93;26.01.2016;2016;01;16;Tiistai;14;4;18
93;26.01.2016;2016;01;17;Tiistai;3;4;7
93;26.01.2016;2016;01;18;Tiistai;2;3;5
93;26.01.2016;2016;01;19;Tiistai;2;1;3
93;26.01.2016;2016;01;20;Tiistai;1;0;1
93;26.01.2016;2016;01;21;Tiistai;0;3;3
93;26.01.2016;2016;01;22;Tiistai;0;2;2
93;26.01.2016;2016;01;23;Tiistai;0;0;0
93;27.01.2016;2016;01;00;Keskiviikko;0;0;0
93;27.01.2016;2016;01;01;Keskiviikko;0;0;0
93;27.01.2016;2016;01;02;Keskiviikko;0;0;0
93;27.01.2016;2016;01;03;Keskiviikko;0;0;0
93;27.01.2016;2016;01;04;Keskiviikko;0;0;0
93;27.01.2016;2016;01;05;Keskiviikko;0;1;1
93;27.01.2016;2016;01;06;Keskiviikko;7;0;7
93;27.01.2016;2016;01;07;Keskiviikko;5;13;18
93;27.01.2016;2016;01;08;Keskiviikko;8;7;15
93;27.01.2016;2016;01;09;Keskiviikko;4;0;4
93;27.01.2016;2016;01;10;Keskiviikko;2;3;5
93;27.01.2016;2016;01;11;Keskiviikko;2;2;4
93;27.01.2016;2016;01;12;Keskiviikko;0;0;0
93;27.01.2016;2016;01;13;Keskiviikko;1;1;2
93;27.01.2016;2016;01;14;Keskiviikko;2;4;6
93;27.01.2016;2016;01;15;Keskiviikko;2;7;9
93;27.01.2016;2016;01;16;Keskiviikko;13;4;17
93;27.01.2016;2016;01;17;Keskiviikko;7;3;10
93;27.01.2016;2016;01;18;Keskiviikko;2;5;7
93;27.01.2016;2016;01;19;Keskiviikko;2;1;3
93;27.01.2016;2016;01;20;Keskiviikko;2;2;4
93;27.01.2016;2016;01;21;Keskiviikko;0;1;1
93;27.01.2016;2016;01;22;Keskiviikko;0;1;1
93;27.01.2016;2016;01;23;Keskiviikko;0;0;0
93;28.01.2016;2016;01;00;Torstai;0;2;2
93;28.01.2016;2016;01;01;Torstai;0;0;0
93;28.01.2016;2016;01;02;Torstai;0;0;0
93;28.01.2016;2016;01;03;Torstai;0;0;0
93;28.01.2016;2016;01;04;Torstai;0;0;0
93;28.01.2016;2016;01;05;Torstai;0;2;2
93;28.01.2016;2016;01;06;Torstai;2;1;3
93;28.01.2016;2016;01;07;Torstai;7;12;19
93;28.01.2016;2016;01;08;Torstai;9;11;20
93;28.01.2016;2016;01;09;Torstai;1;2;3
93;28.01.2016;2016;01;10;Torstai;3;4;7
93;28.01.2016;2016;01;11;Torstai;1;3;4
93;28.01.2016;2016;01;12;Torstai;3;2;5
93;28.01.2016;2016;01;13;Torstai;2;0;2
93;28.01.2016;2016;01;14;Torstai;7;3;10
93;28.01.2016;2016;01;15;Torstai;2;5;7
93;28.01.2016;2016;01;16;Torstai;9;6;15
93;28.01.2016;2016;01;17;Torstai;9;5;14
93;28.01.2016;2016;01;18;Torstai;6;2;8
93;28.01.2016;2016;01;19;Torstai;4;2;6
93;28.01.2016;2016;01;20;Torstai;1;2;3
93;28.01.2016;2016;01;21;Torstai;0;0;0
93;28.01.2016;2016;01;22;Torstai;1;1;2
93;28.01.2016;2016;01;23;Torstai;1;0;1
93;29.01.2016;2016;01;00;Perjantai;0;0;0
93;29.01.2016;2016;01;01;Perjantai;0;0;0
93;29.01.2016;2016;01;02;Perjantai;0;0;0
93;29.01.2016;2016;01;03;Perjantai;0;0;0
93;29.01.2016;2016;01;04;Perjantai;0;0;0
93;29.01.2016;2016;01;05;Perjantai;0;2;2
93;29.01.2016;2016;01;06;Perjantai;2;2;4
93;29.01.2016;2016;01;07;Perjantai;6;11;17
93;29.01.2016;2016;01;08;Perjantai;1;10;11
93;29.01.2016;2016;01;09;Perjantai;2;1;3
93;29.01.2016;2016;01;10;Perjantai;2;2;4
93;29.01.2016;2016;01;11;Perjantai;1;1;2
93;29.01.2016;2016;01;12;Perjantai;3;1;4
93;29.01.2016;2016;01;13;Perjantai;1;5;6
93;29.01.2016;2016;01;14;Perjantai;6;2;8
93;29.01.2016;2016;01;15;Perjantai;9;2;11
93;29.01.2016;2016;01;16;Perjantai;10;4;14
93;29.01.2016;2016;01;17;Perjantai;9;4;13
93;29.01.2016;2016;01;18;Perjantai;0;5;5
93;29.01.2016;2016;01;19;Perjantai;0;0;0
93;29.01.2016;2016;01;20;Perjantai;1;1;2
93;29.01.2016;2016;01;21;Perjantai;0;0;0
93;29.01.2016;2016;01;22;Perjantai;1;0;1
93;29.01.2016;2016;01;23;Perjantai;0;0;0
93;30.01.2016;2016;01;00;Lauantai;2;0;2
93;30.01.2016;2016;01;01;Lauantai;0;0;0
93;30.01.2016;2016;01;02;Lauantai;0;0;0
93;30.01.2016;2016;01;03;Lauantai;0;0;0
93;30.01.2016;2016;01;04;Lauantai;0;0;0
93;30.01.2016;2016;01;05;Lauantai;0;0;0
93;30.01.2016;2016;01;06;Lauantai;0;0;0
93;30.01.2016;2016;01;07;Lauantai;0;0;0
93;30.01.2016;2016;01;08;Lauantai;0;0;0
93;30.01.2016;2016;01;09;Lauantai;0;0;0
93;30.01.2016;2016;01;10;Lauantai;4;0;4
93;30.01.2016;2016;01;11;Lauantai;5;0;5
93;30.01.2016;2016;01;12;Lauantai;0;3;3
93;30.01.2016;2016;01;13;Lauantai;3;0;3
93;30.01.2016;2016;01;14;Lauantai;3;2;5
93;30.01.2016;2016;01;15;Lauantai;2;5;7
93;30.01.2016;2016;01;16;Lauantai;3;0;3
93;30.01.2016;2016;01;17;Lauantai;0;5;5
93;30.01.2016;2016;01;18;Lauantai;3;2;5
93;30.01.2016;2016;01;19;Lauantai;1;4;5
93;30.01.2016;2016;01;20;Lauantai;0;0;0
93;30.01.2016;2016;01;21;Lauantai;1;1;2
93;30.01.2016;2016;01;22;Lauantai;0;1;1
93;30.01.2016;2016;01;23;Lauantai;1;1;2
93;31.01.2016;2016;01;00;Sunnuntai;0;0;0
93;31.01.2016;2016;01;01;Sunnuntai;0;0;0
93;31.01.2016;2016;01;02;Sunnuntai;0;0;0
93;31.01.2016;2016;01;03;Sunnuntai;0;0;0
93;31.01.2016;2016;01;04;Sunnuntai;0;0;0
93;31.01.2016;2016;01;05;Sunnuntai;0;0;0
93;31.01.2016;2016;01;06;Sunnuntai;0;1;1
93;31.01.2016;2016;01;07;Sunnuntai;1;0;1
93;31.01.2016;2016;01;08;Sunnuntai;2;2;4
93;31.01.2016;2016;01;09;Sunnuntai;2;0;2
93;31.01.2016;2016;01;10;Sunnuntai;1;0;1
93;31.01.2016;2016;01;11;Sunnuntai;11;1;12
93;31.01.2016;2016;01;12;Sunnuntai;3;0;3
93;31.01.2016;2016;01;13;Sunnuntai;0;5;5
93;31.01.2016;2016;01;14;Sunnuntai;0;5;5
93;31.01.2016;2016;01;15;Sunnuntai;9;5;14
93;31.01.2016;2016;01;16;Sunnuntai;0;3;3
93;31.01.2016;2016;01;17;Sunnuntai;1;1;2
93;31.01.2016;2016;01;18;Sunnuntai;1;1;2
93;31.01.2016;2016;01;19;Sunnuntai;1;0;1
93;31.01.2016;2016;01;20;Sunnuntai;0;1;1
93;31.01.2016;2016;01;21;Sunnuntai;1;0;1
93;31.01.2016;2016;01;22;Sunnuntai;1;0;1
93;31.01.2016;2016;01;23;Sunnuntai;0;1;1
93;01.02.2016;2016;02;00;Maanantai;0;0;0
93;01.02.2016;2016;02;01;Maanantai;1;0;1
93;01.02.2016;2016;02;02;Maanantai;0;0;0
93;01.02.2016;2016;02;03;Maanantai;0;0;0
93;01.02.2016;2016;02;04;Maanantai;0;0;0
93;01.02.2016;2016;02;05;Maanantai;1;0;1
93;01.02.2016;2016;02;06;Maanantai;4;1;5
93;01.02.2016;2016;02;07;Maanantai;8;10;18
93;01.02.2016;2016;02;08;Maanantai;6;12;18
93;01.02.2016;2016;02;09;Maanantai;4;4;8
93;01.02.2016;2016;02;10;Maanantai;3;1;4
93;01.02.2016;2016;02;11;Maanantai;1;2;3
93;01.02.2016;2016;02;12;Maanantai;1;4;5
93;01.02.2016;2016;02;13;Maanantai;4;2;6
93;01.02.2016;2016;02;14;Maanantai;1;3;4
93;01.02.2016;2016;02;15;Maanantai;9;6;15
93;01.02.2016;2016;02;16;Maanantai;6;6;12
93;01.02.2016;2016;02;17;Maanantai;9;3;12
93;01.02.2016;2016;02;18;Maanantai;3;7;10
93;01.02.2016;2016;02;19;Maanantai;2;3;5
93;01.02.2016;2016;02;20;Maanantai;1;0;1
93;01.02.2016;2016;02;21;Maanantai;0;2;2
93;01.02.2016;2016;02;22;Maanantai;1;0;1
93;01.02.2016;2016;02;23;Maanantai;0;0;0
93;02.02.2016;2016;02;00;Tiistai;0;0;0
93;02.02.2016;2016;02;01;Tiistai;0;0;0
93;02.02.2016;2016;02;02;Tiistai;0;0;0
93;02.02.2016;2016;02;03;Tiistai;0;0;0
93;02.02.2016;2016;02;04;Tiistai;0;0;0
93;02.02.2016;2016;02;05;Tiistai;2;2;4
93;02.02.2016;2016;02;06;Tiistai;4;4;8
93;02.02.2016;2016;02;07;Tiistai;7;10;17
93;02.02.2016;2016;02;08;Tiistai;4;10;14
93;02.02.2016;2016;02;09;Tiistai;3;0;3
93;02.02.2016;2016;02;10;Tiistai;0;2;2
93;02.02.2016;2016;02;11;Tiistai;1;1;2
93;02.02.2016;2016;02;12;Tiistai;1;1;2
93;02.02.2016;2016;02;13;Tiistai;0;0;0
93;02.02.2016;2016;02;14;Tiistai;4;2;6
93;02.02.2016;2016;02;15;Tiistai;9;5;14
93;02.02.2016;2016;02;16;Tiistai;10;4;14
93;02.02.2016;2016;02;17;Tiistai;10;5;15
93;02.02.2016;2016;02;18;Tiistai;5;11;16
93;02.02.2016;2016;02;19;Tiistai;1;0;1
93;02.02.2016;2016;02;20;Tiistai;2;6;8
93;02.02.2016;2016;02;21;Tiistai;0;0;0
93;02.02.2016;2016;02;22;Tiistai;0;1;1
93;02.02.2016;2016;02;23;Tiistai;0;0;0
93;03.02.2016;2016;02;00;Keskiviikko;0;0;0
93;03.02.2016;2016;02;01;Keskiviikko;0;0;0
93;03.02.2016;2016;02;02;Keskiviikko;0;0;0
93;03.02.2016;2016;02;03;Keskiviikko;0;0;0
93;03.02.2016;2016;02;04;Keskiviikko;0;0;0
93;03.02.2016;2016;02;05;Keskiviikko;1;1;2
93;03.02.2016;2016;02;06;Keskiviikko;3;2;5
93;03.02.2016;2016;02;07;Keskiviikko;10;10;20
93;03.02.2016;2016;02;08;Keskiviikko;7;13;20
93;03.02.2016;2016;02;09;Keskiviikko;1;1;2
93;03.02.2016;2016;02;10;Keskiviikko;2;1;3
93;03.02.2016;2016;02;11;Keskiviikko;1;2;3
93;03.02.2016;2016;02;12;Keskiviikko;0;0;0
93;03.02.2016;2016;02;13;Keskiviikko;1;1;2
93;03.02.2016;2016;02;14;Keskiviikko;4;2;6
93;03.02.2016;2016;02;15;Keskiviikko;5;1;6
93;03.02.2016;2016;02;16;Keskiviikko;16;8;24
93;03.02.2016;2016;02;17;Keskiviikko;6;9;15
93;03.02.2016;2016;02;18;Keskiviikko;1;4;5
93;03.02.2016;2016;02;19;Keskiviikko;2;0;2
93;03.02.2016;2016;02;20;Keskiviikko;1;1;2
93;03.02.2016;2016;02;21;Keskiviikko;0;1;1
93;03.02.2016;2016;02;22;Keskiviikko;0;0;0
93;03.02.2016;2016;02;23;Keskiviikko;0;0;0
93;04.02.2016;2016;02;00;Torstai;0;0;0
93;04.02.2016;2016;02;01;Torstai;0;0;0
93;04.02.2016;2016;02;02;Torstai;0;0;0
93;04.02.2016;2016;02;03;Torstai;0;0;0
93;04.02.2016;2016;02;04;Torstai;0;0;0
93;04.02.2016;2016;02;05;Torstai;0;1;1
93;04.02.2016;2016;02;06;Torstai;3;3;6
93;04.02.2016;2016;02;07;Torstai;6;7;13
93;04.02.2016;2016;02;08;Torstai;8;11;19
93;04.02.2016;2016;02;09;Torstai;3;0;3
93;04.02.2016;2016;02;10;Torstai;4;2;6
93;04.02.2016;2016;02;11;Torstai;2;4;6
93;04.02.2016;2016;02;12;Torstai;1;2;3
93;04.02.2016;2016;02;13;Torstai;2;3;5
93;04.02.2016;2016;02;14;Torstai;3;3;6
93;04.02.2016;2016;02;15;Torstai;3;6;9
93;04.02.2016;2016;02;16;Torstai;5;4;9
93;04.02.2016;2016;02;17;Torstai;5;4;9
93;04.02.2016;2016;02;18;Torstai;0;4;4
93;04.02.2016;2016;02;19;Torstai;3;0;3
93;04.02.2016;2016;02;20;Torstai;1;1;2
93;04.02.2016;2016;02;21;Torstai;0;1;1
93;04.02.2016;2016;02;22;Torstai;1;1;2
93;04.02.2016;2016;02;23;Torstai;0;0;0
93;05.02.2016;2016;02;00;Perjantai;0;0;0
93;05.02.2016;2016;02;01;Perjantai;0;0;0
93;05.02.2016;2016;02;02;Perjantai;0;0;0
93;05.02.2016;2016;02;03;Perjantai;0;0;0
93;05.02.2016;2016;02;04;Perjantai;0;0;0
93;05.02.2016;2016;02;05;Perjantai;0;1;1
93;05.02.2016;2016;02;06;Perjantai;4;3;7
93;05.02.2016;2016;02;07;Perjantai;5;7;12
93;05.02.2016;2016;02;08;Perjantai;5;14;19
93;05.02.2016;2016;02;09;Perjantai;4;1;5
93;05.02.2016;2016;02;10;Perjantai;3;3;6
93;05.02.2016;2016;02;11;Perjantai;3;2;5
93;05.02.2016;2016;02;12;Perjantai;2;2;4
93;05.02.2016;2016;02;13;Perjantai;1;1;2
93;05.02.2016;2016;02;14;Perjantai;5;0;5
93;05.02.2016;2016;02;15;Perjantai;7;5;12
93;05.02.2016;2016;02;16;Perjantai;7;6;13
93;05.02.2016;2016;02;17;Perjantai;6;2;8
93;05.02.2016;2016;02;18;Perjantai;2;2;4
93;05.02.2016;2016;02;19;Perjantai;1;1;2
93;05.02.2016;2016;02;20;Perjantai;1;0;1
93;05.02.2016;2016;02;21;Perjantai;0;1;1
93;05.02.2016;2016;02;22;Perjantai;0;0;0
93;05.02.2016;2016;02;23;Perjantai;0;0;0
93;06.02.2016;2016;02;00;Lauantai;1;0;1
93;06.02.2016;2016;02;01;Lauantai;0;0;0
93;06.02.2016;2016;02;02;Lauantai;0;0;0
93;06.02.2016;2016;02;03;Lauantai;0;0;0
93;06.02.2016;2016;02;04;Lauantai;0;0;0
93;06.02.2016;2016;02;05;Lauantai;0;1;1
93;06.02.2016;2016;02;06;Lauantai;0;1;1
93;06.02.2016;2016;02;07;Lauantai;0;0;0
93;06.02.2016;2016;02;08;Lauantai;3;0;3
93;06.02.2016;2016;02;09;Lauantai;3;0;3
93;06.02.2016;2016;02;10;Lauantai;2;1;3
93;06.02.2016;2016;02;11;Lauantai;2;3;5
93;06.02.2016;2016;02;12;Lauantai;4;2;6
93;06.02.2016;2016;02;13;Lauantai;1;2;3
93;06.02.2016;2016;02;14;Lauantai;2;2;4
93;06.02.2016;2016;02;15;Lauantai;4;4;8
93;06.02.2016;2016;02;16;Lauantai;2;0;2
93;06.02.2016;2016;02;17;Lauantai;1;1;2
93;06.02.2016;2016;02;18;Lauantai;1;0;1
93;06.02.2016;2016;02;19;Lauantai;0;0;0
93;06.02.2016;2016;02;20;Lauantai;0;1;1
93;06.02.2016;2016;02;21;Lauantai;0;0;0
93;06.02.2016;2016;02;22;Lauantai;0;0;0
93;06.02.2016;2016;02;23;Lauantai;0;0;0
93;07.02.2016;2016;02;00;Sunnuntai;0;0;0
93;07.02.2016;2016;02;01;Sunnuntai;0;0;0
93;07.02.2016;2016;02;02;Sunnuntai;0;0;0
93;07.02.2016;2016;02;03;Sunnuntai;0;0;0
93;07.02.2016;2016;02;04;Sunnuntai;0;0;0
93;07.02.2016;2016;02;05;Sunnuntai;0;0;0
93;07.02.2016;2016;02;06;Sunnuntai;0;0;0
93;07.02.2016;2016;02;07;Sunnuntai;0;0;0
93;07.02.2016;2016;02;08;Sunnuntai;0;0;0
93;07.02.2016;2016;02;09;Sunnuntai;1;0;1
93;07.02.2016;2016;02;10;Sunnuntai;3;3;6
93;07.02.2016;2016;02;11;Sunnuntai;8;1;9
93;07.02.2016;2016;02;12;Sunnuntai;6;2;8
93;07.02.2016;2016;02;13;Sunnuntai;4;3;7
93;07.02.2016;2016;02;14;Sunnuntai;0;4;4
93;07.02.2016;2016;02;15;Sunnuntai;1;1;2
93;07.02.2016;2016;02;16;Sunnuntai;1;3;4
93;07.02.2016;2016;02;17;Sunnuntai;0;0;0
93;07.02.2016;2016;02;18;Sunnuntai;2;1;3
93;07.02.2016;2016;02;19;Sunnuntai;0;0;0
93;07.02.2016;2016;02;20;Sunnuntai;0;1;1
93;07.02.2016;2016;02;21;Sunnuntai;0;0;0
93;07.02.2016;2016;02;22;Sunnuntai;0;0;0
93;07.02.2016;2016;02;23;Sunnuntai;0;0;0
93;08.02.2016;2016;02;00;Maanantai;0;0;0
93;08.02.2016;2016;02;01;Maanantai;0;0;0
93;08.02.2016;2016;02;02;Maanantai;0;0;0
93;08.02.2016;2016;02;03;Maanantai;0;0;0
93;08.02.2016;2016;02;04;Maanantai;0;2;2
93;08.02.2016;2016;02;05;Maanantai;1;1;2
93;08.02.2016;2016;02;06;Maanantai;5;1;6
93;08.02.2016;2016;02;07;Maanantai;6;11;17
93;08.02.2016;2016;02;08;Maanantai;1;8;9
93;08.02.2016;2016;02;09;Maanantai;3;2;5
93;08.02.2016;2016;02;10;Maanantai;1;0;1
93;08.02.2016;2016;02;11;Maanantai;0;1;1
93;08.02.2016;2016;02;12;Maanantai;3;1;4
93;08.02.2016;2016;02;13;Maanantai;3;1;4
93;08.02.2016;2016;02;14;Maanantai;2;4;6
93;08.02.2016;2016;02;15;Maanantai;11;3;14
93;08.02.2016;2016;02;16;Maanantai;9;4;13
93;08.02.2016;2016;02;17;Maanantai;5;3;8
93;08.02.2016;2016;02;18;Maanantai;3;2;5
93;08.02.2016;2016;02;19;Maanantai;1;1;2
93;08.02.2016;2016;02;20;Maanantai;2;0;2
93;08.02.2016;2016;02;21;Maanantai;0;2;2
93;08.02.2016;2016;02;22;Maanantai;0;1;1
93;08.02.2016;2016;02;23;Maanantai;0;0;0
93;09.02.2016;2016;02;00;Tiistai;0;0;0
93;09.02.2016;2016;02;01;Tiistai;0;1;1
93;09.02.2016;2016;02;02;Tiistai;0;0;0
93;09.02.2016;2016;02;03;Tiistai;0;0;0
93;09.02.2016;2016;02;04;Tiistai;0;0;0
93;09.02.2016;2016;02;05;Tiistai;0;0;0
93;09.02.2016;2016;02;06;Tiistai;3;4;7
93;09.02.2016;2016;02;07;Tiistai;4;8;12
93;09.02.2016;2016;02;08;Tiistai;3;7;10
93;09.02.2016;2016;02;09;Tiistai;1;1;2
93;09.02.2016;2016;02;10;Tiistai;0;0;0
93;09.02.2016;2016;02;11;Tiistai;1;3;4
93;09.02.2016;2016;02;12;Tiistai;1;0;1
93;09.02.2016;2016;02;13;Tiistai;1;5;6
93;09.02.2016;2016;02;14;Tiistai;1;4;5
93;09.02.2016;2016;02;15;Tiistai;4;1;5
93;09.02.2016;2016;02;16;Tiistai;7;3;10
93;09.02.2016;2016;02;17;Tiistai;4;0;4
93;09.02.2016;2016;02;18;Tiistai;1;4;5
93;09.02.2016;2016;02;19;Tiistai;0;0;0
93;09.02.2016;2016;02;20;Tiistai;2;0;2
93;09.02.2016;2016;02;21;Tiistai;3;1;4
93;09.02.2016;2016;02;22;Tiistai;0;1;1
93;09.02.2016;2016;02;23;Tiistai;0;0;0
93;10.02.2016;2016;02;00;Keskiviikko;0;0;0
93;10.02.2016;2016;02;01;Keskiviikko;0;0;0
93;10.02.2016;2016;02;02;Keskiviikko;0;0;0
93;10.02.2016;2016;02;03;Keskiviikko;0;0;0
93;10.02.2016;2016;02;04;Keskiviikko;0;0;0
93;10.02.2016;2016;02;05;Keskiviikko;1;0;1
93;10.02.2016;2016;02;06;Keskiviikko;3;1;4
93;10.02.2016;2016;02;07;Keskiviikko;5;10;15
93;10.02.2016;2016;02;08;Keskiviikko;1;10;11
93;10.02.2016;2016;02;09;Keskiviikko;1;0;1
93;10.02.2016;2016;02;10;Keskiviikko;2;2;4
93;10.02.2016;2016;02;11;Keskiviikko;0;1;1
93;10.02.2016;2016;02;12;Keskiviikko;1;0;1
93;10.02.2016;2016;02;13;Keskiviikko;2;2;4
93;10.02.2016;2016;02;14;Keskiviikko;1;1;2
93;10.02.2016;2016;02;15;Keskiviikko;7;4;11
93;10.02.2016;2016;02;16;Keskiviikko;8;4;12
93;10.02.2016;2016;02;17;Keskiviikko;9;4;13
93;10.02.2016;2016;02;18;Keskiviikko;1;2;3
93;10.02.2016;2016;02;19;Keskiviikko;2;0;2
93;10.02.2016;2016;02;20;Keskiviikko;3;0;3
93;10.02.2016;2016;02;21;Keskiviikko;0;2;2
93;10.02.2016;2016;02;22;Keskiviikko;0;0;0
93;10.02.2016;2016;02;23;Keskiviikko;0;0;0
93;11.02.2016;2016;02;00;Torstai;0;0;0
93;11.02.2016;2016;02;01;Torstai;0;0;0
93;11.02.2016;2016;02;02;Torstai;0;0;0
93;11.02.2016;2016;02;03;Torstai;0;0;0
93;11.02.2016;2016;02;04;Torstai;0;0;0
93;11.02.2016;2016;02;05;Torstai;0;1;1
93;11.02.2016;2016;02;06;Torstai;2;1;3
93;11.02.2016;2016;02;07;Torstai;3;10;13
93;11.02.2016;2016;02;08;Torstai;5;11;16
93;11.02.2016;2016;02;09;Torstai;1;0;1
93;11.02.2016;2016;02;10;Torstai;3;2;5
93;11.02.2016;2016;02;11;Torstai;1;2;3
93;11.02.2016;2016;02;12;Torstai;0;2;2
93;11.02.2016;2016;02;13;Torstai;4;0;4
93;11.02.2016;2016;02;14;Torstai;1;1;2
93;11.02.2016;2016;02;15;Torstai;6;5;11
93;11.02.2016;2016;02;16;Torstai;9;3;12
93;11.02.2016;2016;02;17;Torstai;8;2;10
93;11.02.2016;2016;02;18;Torstai;2;4;6
93;11.02.2016;2016;02;19;Torstai;1;2;3
93;11.02.2016;2016;02;20;Torstai;3;2;5
93;11.02.2016;2016;02;21;Torstai;0;0;0
93;11.02.2016;2016;02;22;Torstai;0;0;0
93;11.02.2016;2016;02;23;Torstai;0;0;0
93;12.02.2016;2016;02;00;Perjantai;0;0;0
93;12.02.2016;2016;02;01;Perjantai;0;0;0
93;12.02.2016;2016;02;02;Perjantai;0;0;0
93;12.02.2016;2016;02;03;Perjantai;0;0;0
93;12.02.2016;2016;02;04;Perjantai;0;0;0
93;12.02.2016;2016;02;05;Perjantai;0;0;0
93;12.02.2016;2016;02;06;Perjantai;1;1;2
93;12.02.2016;2016;02;07;Perjantai;7;8;15
93;12.02.2016;2016;02;08;Perjantai;4;5;9
93;12.02.2016;2016;02;09;Perjantai;1;3;4
93;12.02.2016;2016;02;10;Perjantai;4;1;5
93;12.02.2016;2016;02;11;Perjantai;1;2;3
93;12.02.2016;2016;02;12;Perjantai;3;0;3
93;12.02.2016;2016;02;13;Perjantai;0;1;1
93;12.02.2016;2016;02;14;Perjantai;2;1;3
93;12.02.2016;2016;02;15;Perjantai;9;3;12
93;12.02.2016;2016;02;16;Perjantai;4;4;8
93;12.02.2016;2016;02;17;Perjantai;1;2;3
93;12.02.2016;2016;02;18;Perjantai;1;1;2
93;12.02.2016;2016;02;19;Perjantai;0;0;0
93;12.02.2016;2016;02;20;Perjantai;1;0;1
93;12.02.2016;2016;02;21;Perjantai;2;1;3
93;12.02.2016;2016;02;22;Perjantai;0;0;0
93;12.02.2016;2016;02;23;Perjantai;0;0;0
93;13.02.2016;2016;02;00;Lauantai;0;0;0
93;13.02.2016;2016;02;01;Lauantai;0;1;1
93;13.02.2016;2016;02;02;Lauantai;0;0;0
93;13.02.2016;2016;02;03;Lauantai;0;0;0
93;13.02.2016;2016;02;04;Lauantai;0;0;0
93;13.02.2016;2016;02;05;Lauantai;0;0;0
93;13.02.2016;2016;02;06;Lauantai;0;0;0
93;13.02.2016;2016;02;07;Lauantai;0;0;0
93;13.02.2016;2016;02;08;Lauantai;0;0;0
93;13.02.2016;2016;02;09;Lauantai;2;0;2
93;13.02.2016;2016;02;10;Lauantai;2;2;4
93;13.02.2016;2016;02;11;Lauantai;7;2;9
93;13.02.2016;2016;02;12;Lauantai;1;2;3
93;13.02.2016;2016;02;13;Lauantai;1;2;3
93;13.02.2016;2016;02;14;Lauantai;1;0;1
93;13.02.2016;2016;02;15;Lauantai;0;1;1
93;13.02.2016;2016;02;16;Lauantai;4;1;5
93;13.02.2016;2016;02;17;Lauantai;0;1;1
93;13.02.2016;2016;02;18;Lauantai;2;3;5
93;13.02.2016;2016;02;19;Lauantai;2;0;2
93;13.02.2016;2016;02;20;Lauantai;0;0;0
93;13.02.2016;2016;02;21;Lauantai;0;0;0
93;13.02.2016;2016;02;22;Lauantai;1;0;1
93;13.02.2016;2016;02;23;Lauantai;1;0;1
93;14.02.2016;2016;02;00;Sunnuntai;0;0;0
93;14.02.2016;2016;02;01;Sunnuntai;0;0;0
93;14.02.2016;2016;02;02;Sunnuntai;0;0;0
93;14.02.2016;2016;02;03;Sunnuntai;0;1;1
93;14.02.2016;2016;02;04;Sunnuntai;0;0;0
93;14.02.2016;2016;02;05;Sunnuntai;0;0;0
93;14.02.2016;2016;02;06;Sunnuntai;1;0;1
93;14.02.2016;2016;02;07;Sunnuntai;0;0;0
93;14.02.2016;2016;02;08;Sunnuntai;0;0;0
93;14.02.2016;2016;02;09;Sunnuntai;1;0;1
93;14.02.2016;2016;02;10;Sunnuntai;5;0;5
93;14.02.2016;2016;02;11;Sunnuntai;15;1;16
93;14.02.2016;2016;02;12;Sunnuntai;7;5;12
93;14.02.2016;2016;02;13;Sunnuntai;1;4;5
93;14.02.2016;2016;02;14;Sunnuntai;3;2;5
93;14.02.2016;2016;02;15;Sunnuntai;0;7;7
93;14.02.2016;2016;02;16;Sunnuntai;0;0;0
93;14.02.2016;2016;02;17;Sunnuntai;0;1;1
93;14.02.2016;2016;02;18;Sunnuntai;1;1;2
93;14.02.2016;2016;02;19;Sunnuntai;0;3;3
93;14.02.2016;2016;02;20;Sunnuntai;0;0;0
93;14.02.2016;2016;02;21;Sunnuntai;1;0;1
93;14.02.2016;2016;02;22;Sunnuntai;2;1;3
93;14.02.2016;2016;02;23;Sunnuntai;0;0;0
93;15.02.2016;2016;02;00;Maanantai;0;0;0
93;15.02.2016;2016;02;01;Maanantai;0;0;0
93;15.02.2016;2016;02;02;Maanantai;0;0;0
93;15.02.2016;2016;02;03;Maanantai;0;0;0
93;15.02.2016;2016;02;04;Maanantai;0;0;0
93;15.02.2016;2016;02;05;Maanantai;0;2;2
93;15.02.2016;2016;02;06;Maanantai;6;4;10
93;15.02.2016;2016;02;07;Maanantai;5;10;15
93;15.02.2016;2016;02;08;Maanantai;5;9;14
93;15.02.2016;2016;02;09;Maanantai;4;4;8
93;15.02.2016;2016;02;10;Maanantai;2;2;4
93;15.02.2016;2016;02;11;Maanantai;2;2;4
93;15.02.2016;2016;02;12;Maanantai;2;2;4
93;15.02.2016;2016;02;13;Maanantai;3;2;5
93;15.02.2016;2016;02;14;Maanantai;4;3;7
93;15.02.2016;2016;02;15;Maanantai;10;7;17
93;15.02.2016;2016;02;16;Maanantai;8;6;14
93;15.02.2016;2016;02;17;Maanantai;9;2;11
93;15.02.2016;2016;02;18;Maanantai;5;5;10
93;15.02.2016;2016;02;19;Maanantai;1;4;5
93;15.02.2016;2016;02;20;Maanantai;1;3;4
93;15.02.2016;2016;02;21;Maanantai;1;0;1
93;15.02.2016;2016;02;22;Maanantai;0;1;1
93;15.02.2016;2016;02;23;Maanantai;0;0;0
93;16.02.2016;2016;02;00;Tiistai;0;0;0
93;16.02.2016;2016;02;01;Tiistai;0;0;0
93;16.02.2016;2016;02;02;Tiistai;0;0;0
93;16.02.2016;2016;02;03;Tiistai;0;0;0
93;16.02.2016;2016;02;04;Tiistai;0;0;0
93;16.02.2016;2016;02;05;Tiistai;1;2;3
93;16.02.2016;2016;02;06;Tiistai;3;5;8
93;16.02.2016;2016;02;07;Tiistai;5;13;18
93;16.02.2016;2016;02;08;Tiistai;3;8;11
93;16.02.2016;2016;02;09;Tiistai;3;1;4
93;16.02.2016;2016;02;10;Tiistai;4;1;5
93;16.02.2016;2016;02;11;Tiistai;1;3;4
93;16.02.2016;2016;02;12;Tiistai;2;0;2
93;16.02.2016;2016;02;13;Tiistai;2;2;4
93;16.02.2016;2016;02;14;Tiistai;4;5;9
93;16.02.2016;2016;02;15;Tiistai;10;12;22
93;16.02.2016;2016;02;16;Tiistai;14;4;18
93;16.02.2016;2016;02;17;Tiistai;4;7;11
93;16.02.2016;2016;02;18;Tiistai;6;4;10
93;16.02.2016;2016;02;19;Tiistai;3;0;3
93;16.02.2016;2016;02;20;Tiistai;1;2;3
93;16.02.2016;2016;02;21;Tiistai;0;3;3
93;16.02.2016;2016;02;22;Tiistai;2;1;3
93;16.02.2016;2016;02;23;Tiistai;0;0;0
93;17.02.2016;2016;02;00;Keskiviikko;0;0;0
93;17.02.2016;2016;02;01;Keskiviikko;0;0;0
93;17.02.2016;2016;02;02;Keskiviikko;0;0;0
93;17.02.2016;2016;02;03;Keskiviikko;0;0;0
93;17.02.2016;2016;02;04;Keskiviikko;0;0;0
93;17.02.2016;2016;02;05;Keskiviikko;0;1;1
93;17.02.2016;2016;02;06;Keskiviikko;3;5;8
93;17.02.2016;2016;02;07;Keskiviikko;9;10;19
93;17.02.2016;2016;02;08;Keskiviikko;2;5;7
93;17.02.2016;2016;02;09;Keskiviikko;2;3;5
93;17.02.2016;2016;02;10;Keskiviikko;3;2;5
93;17.02.2016;2016;02;11;Keskiviikko;2;1;3
93;17.02.2016;2016;02;12;Keskiviikko;3;1;4
93;17.02.2016;2016;02;13;Keskiviikko;2;4;6
93;17.02.2016;2016;02;14;Keskiviikko;3;1;4
93;17.02.2016;2016;02;15;Keskiviikko;8;2;10
93;17.02.2016;2016;02;16;Keskiviikko;14;10;24
93;17.02.2016;2016;02;17;Keskiviikko;5;2;7
93;17.02.2016;2016;02;18;Keskiviikko;5;1;6
93;17.02.2016;2016;02;19;Keskiviikko;3;1;4
93;17.02.2016;2016;02;20;Keskiviikko;2;1;3
93;17.02.2016;2016;02;21;Keskiviikko;2;3;5
93;17.02.2016;2016;02;22;Keskiviikko;0;0;0
93;17.02.2016;2016;02;23;Keskiviikko;0;0;0
93;18.02.2016;2016;02;00;Torstai;0;0;0
93;18.02.2016;2016;02;01;Torstai;0;0;0
93;18.02.2016;2016;02;02;Torstai;0;0;0
93;18.02.2016;2016;02;03;Torstai;0;0;0
93;18.02.2016;2016;02;04;Torstai;0;0;0
93;18.02.2016;2016;02;05;Torstai;0;1;1
93;18.02.2016;2016;02;06;Torstai;4;5;9
93;18.02.2016;2016;02;07;Torstai;5;14;19
93;18.02.2016;2016;02;08;Torstai;7;5;12
93;18.02.2016;2016;02;09;Torstai;2;2;4
93;18.02.2016;2016;02;10;Torstai;4;2;6
93;18.02.2016;2016;02;11;Torstai;3;2;5
93;18.02.2016;2016;02;12;Torstai;1;3;4
93;18.02.2016;2016;02;13;Torstai;3;0;3
93;18.02.2016;2016;02;14;Torstai;2;0;2
93;18.02.2016;2016;02;15;Torstai;7;7;14
93;18.02.2016;2016;02;16;Torstai;8;9;17
93;18.02.2016;2016;02;17;Torstai;5;2;7
93;18.02.2016;2016;02;18;Torstai;3;7;10
93;18.02.2016;2016;02;19;Torstai;3;3;6
93;18.02.2016;2016;02;20;Torstai;2;1;3
93;18.02.2016;2016;02;21;Torstai;0;2;2
93;18.02.2016;2016;02;22;Torstai;0;1;1
93;18.02.2016;2016;02;23;Torstai;0;0;0
93;19.02.2016;2016;02;00;Perjantai;0;0;0
93;19.02.2016;2016;02;01;Perjantai;0;0;0
93;19.02.2016;2016;02;02;Perjantai;0;0;0
93;19.02.2016;2016;02;03;Perjantai;0;0;0
93;19.02.2016;2016;02;04;Perjantai;0;0;0
93;19.02.2016;2016;02;05;Perjantai;0;1;1
93;19.02.2016;2016;02;06;Perjantai;5;2;7
93;19.02.2016;2016;02;07;Perjantai;5;10;15
93;19.02.2016;2016;02;08;Perjantai;4;5;9
93;19.02.2016;2016;02;09;Perjantai;5;2;7
93;19.02.2016;2016;02;10;Perjantai;2;3;5
93;19.02.2016;2016;02;11;Perjantai;2;1;3
93;19.02.2016;2016;02;12;Perjantai;2;1;3
93;19.02.2016;2016;02;13;Perjantai;2;1;3
93;19.02.2016;2016;02;14;Perjantai;1;7;8
93;19.02.2016;2016;02;15;Perjantai;7;5;12
93;19.02.2016;2016;02;16;Perjantai;7;5;12
93;19.02.2016;2016;02;17;Perjantai;9;4;13
93;19.02.2016;2016;02;18;Perjantai;2;3;5
93;19.02.2016;2016;02;19;Perjantai;0;0;0
93;19.02.2016;2016;02;20;Perjantai;2;0;2
93;19.02.2016;2016;02;21;Perjantai;0;0;0
93;19.02.2016;2016;02;22;Perjantai;0;0;0
93;19.02.2016;2016;02;23;Perjantai;0;0;0
93;20.02.2016;2016;02;00;Lauantai;1;0;1
93;20.02.2016;2016;02;01;Lauantai;1;0;1
93;20.02.2016;2016;02;02;Lauantai;0;0;0
93;20.02.2016;2016;02;03;Lauantai;0;0;0
93;20.02.2016;2016;02;04;Lauantai;0;0;0
93;20.02.2016;2016;02;05;Lauantai;0;0;0
93;20.02.2016;2016;02;06;Lauantai;1;0;1
93;20.02.2016;2016;02;07;Lauantai;2;1;3
93;20.02.2016;2016;02;08;Lauantai;3;1;4
93;20.02.2016;2016;02;09;Lauantai;2;1;3
93;20.02.2016;2016;02;10;Lauantai;2;3;5
93;20.02.2016;2016;02;11;Lauantai;6;4;10
93;20.02.2016;2016;02;12;Lauantai;0;1;1
93;20.02.2016;2016;02;13;Lauantai;5;2;7
93;20.02.2016;2016;02;14;Lauantai;0;3;3
93;20.02.2016;2016;02;15;Lauantai;1;5;6
93;20.02.2016;2016;02;16;Lauantai;8;2;10
93;20.02.2016;2016;02;17;Lauantai;2;2;4
93;20.02.2016;2016;02;18;Lauantai;0;2;2
93;20.02.2016;2016;02;19;Lauantai;0;4;4
93;20.02.2016;2016;02;20;Lauantai;0;1;1
93;20.02.2016;2016;02;21;Lauantai;1;1;2
93;20.02.2016;2016;02;22;Lauantai;0;1;1
93;20.02.2016;2016;02;23;Lauantai;1;2;3
93;21.02.2016;2016;02;00;Sunnuntai;2;0;2
93;21.02.2016;2016;02;01;Sunnuntai;0;0;0
93;21.02.2016;2016;02;02;Sunnuntai;0;0;0
93;21.02.2016;2016;02;03;Sunnuntai;0;0;0
93;21.02.2016;2016;02;04;Sunnuntai;0;0;0
93;21.02.2016;2016;02;05;Sunnuntai;0;0;0
93;21.02.2016;2016;02;06;Sunnuntai;0;0;0
93;21.02.2016;2016;02;07;Sunnuntai;0;0;0
93;21.02.2016;2016;02;08;Sunnuntai;0;0;0
93;21.02.2016;2016;02;09;Sunnuntai;1;0;1
93;21.02.2016;2016;02;10;Sunnuntai;1;0;1
93;21.02.2016;2016;02;11;Sunnuntai;17;2;19
93;21.02.2016;2016;02;12;Sunnuntai;0;0;0
93;21.02.2016;2016;02;13;Sunnuntai;6;2;8
93;21.02.2016;2016;02;14;Sunnuntai;4;2;6
93;21.02.2016;2016;02;15;Sunnuntai;5;3;8
93;21.02.2016;2016;02;16;Sunnuntai;1;4;5
93;21.02.2016;2016;02;17;Sunnuntai;1;0;1
93;21.02.2016;2016;02;18;Sunnuntai;1;2;3
93;21.02.2016;2016;02;19;Sunnuntai;1;0;1
93;21.02.2016;2016;02;20;Sunnuntai;0;3;3
93;21.02.2016;2016;02;21;Sunnuntai;0;0;0
93;21.02.2016;2016;02;22;Sunnuntai;1;0;1
93;21.02.2016;2016;02;23;Sunnuntai;0;1;1
93;22.02.2016;2016;02;00;Maanantai;0;0;0
93;22.02.2016;2016;02;01;Maanantai;0;0;0
93;22.02.2016;2016;02;02;Maanantai;0;0;0
93;22.02.2016;2016;02;03;Maanantai;0;0;0
93;22.02.2016;2016;02;04;Maanantai;0;0;0
93;22.02.2016;2016;02;05;Maanantai;1;1;2
93;22.02.2016;2016;02;06;Maanantai;7;4;11
93;22.02.2016;2016;02;07;Maanantai;8;9;17
93;22.02.2016;2016;02;08;Maanantai;6;8;14
93;22.02.2016;2016;02;09;Maanantai;2;0;2
93;22.02.2016;2016;02;10;Maanantai;1;0;1
93;22.02.2016;2016;02;11;Maanantai;3;1;4
93;22.02.2016;2016;02;12;Maanantai;1;0;1
93;22.02.2016;2016;02;13;Maanantai;0;2;2
93;22.02.2016;2016;02;14;Maanantai;3;3;6
93;22.02.2016;2016;02;15;Maanantai;3;5;8
93;22.02.2016;2016;02;16;Maanantai;12;9;21
93;22.02.2016;2016;02;17;Maanantai;8;2;10
93;22.02.2016;2016;02;18;Maanantai;4;5;9
93;22.02.2016;2016;02;19;Maanantai;2;1;3
93;22.02.2016;2016;02;20;Maanantai;2;0;2
93;22.02.2016;2016;02;21;Maanantai;0;0;0
93;22.02.2016;2016;02;22;Maanantai;0;0;0
93;22.02.2016;2016;02;23;Maanantai;0;0;0
93;23.02.2016;2016;02;00;Tiistai;0;0;0
93;23.02.2016;2016;02;01;Tiistai;0;0;0
93;23.02.2016;2016;02;02;Tiistai;0;0;0
93;23.02.2016;2016;02;03;Tiistai;1;1;2
93;23.02.2016;2016;02;04;Tiistai;0;0;0
93;23.02.2016;2016;02;05;Tiistai;0;1;1
93;23.02.2016;2016;02;06;Tiistai;6;4;10
93;23.02.2016;2016;02;07;Tiistai;4;16;20
93;23.02.2016;2016;02;08;Tiistai;7;8;15
93;23.02.2016;2016;02;09;Tiistai;1;0;1
93;23.02.2016;2016;02;10;Tiistai;1;3;4
93;23.02.2016;2016;02;11;Tiistai;3;1;4
93;23.02.2016;2016;02;12;Tiistai;0;3;3
93;23.02.2016;2016;02;13;Tiistai;1;0;1
93;23.02.2016;2016;02;14;Tiistai;2;3;5
93;23.02.2016;2016;02;15;Tiistai;7;6;13
93;23.02.2016;2016;02;16;Tiistai;15;6;21
93;23.02.2016;2016;02;17;Tiistai;5;8;13
93;23.02.2016;2016;02;18;Tiistai;2;2;4
93;23.02.2016;2016;02;19;Tiistai;5;2;7
93;23.02.2016;2016;02;20;Tiistai;2;1;3
93;23.02.2016;2016;02;21;Tiistai;0;1;1
93;23.02.2016;2016;02;22;Tiistai;3;1;4
93;23.02.2016;2016;02;23;Tiistai;0;0;0
93;24.02.2016;2016;02;00;Keskiviikko;0;1;1
93;24.02.2016;2016;02;01;Keskiviikko;0;0;0
93;24.02.2016;2016;02;02;Keskiviikko;0;0;0
93;24.02.2016;2016;02;03;Keskiviikko;0;0;0
93;24.02.2016;2016;02;04;Keskiviikko;0;0;0
93;24.02.2016;2016;02;05;Keskiviikko;0;1;1
93;24.02.2016;2016;02;06;Keskiviikko;6;3;9
93;24.02.2016;2016;02;07;Keskiviikko;8;10;18
93;24.02.2016;2016;02;08;Keskiviikko;7;12;19
93;24.02.2016;2016;02;09;Keskiviikko;5;2;7
93;24.02.2016;2016;02;10;Keskiviikko;1;3;4
93;24.02.2016;2016;02;11;Keskiviikko;0;1;1
93;24.02.2016;2016;02;12;Keskiviikko;0;1;1
93;24.02.2016;2016;02;13;Keskiviikko;4;1;5
93;24.02.2016;2016;02;14;Keskiviikko;2;2;4
93;24.02.2016;2016;02;15;Keskiviikko;7;6;13
93;24.02.2016;2016;02;16;Keskiviikko;12;5;17
93;24.02.2016;2016;02;17;Keskiviikko;7;4;11
93;24.02.2016;2016;02;18;Keskiviikko;5;5;10
93;24.02.2016;2016;02;19;Keskiviikko;2;2;4
93;24.02.2016;2016;02;20;Keskiviikko;1;2;3
93;24.02.2016;2016;02;21;Keskiviikko;0;0;0
93;24.02.2016;2016;02;22;Keskiviikko;1;0;1
93;24.02.2016;2016;02;23;Keskiviikko;0;0;0
93;25.02.2016;2016;02;00;Torstai;0;1;1
93;25.02.2016;2016;02;01;Torstai;0;0;0
93;25.02.2016;2016;02;02;Torstai;0;0;0
93;25.02.2016;2016;02;03;Torstai;0;0;0
93;25.02.2016;2016;02;04;Torstai;0;0;0
93;25.02.2016;2016;02;05;Torstai;0;0;0
93;25.02.2016;2016;02;06;Torstai;4;7;11
93;25.02.2016;2016;02;07;Torstai;4;11;15
93;25.02.2016;2016;02;08;Torstai;4;14;18
93;25.02.2016;2016;02;09;Torstai;3;2;5
93;25.02.2016;2016;02;10;Torstai;3;2;5
93;25.02.2016;2016;02;11;Torstai;1;3;4
93;25.02.2016;2016;02;12;Torstai;3;1;4
93;25.02.2016;2016;02;13;Torstai;4;1;5
93;25.02.2016;2016;02;14;Torstai;2;3;5
93;25.02.2016;2016;02;15;Torstai;9;2;11
93;25.02.2016;2016;02;16;Torstai;19;6;25
93;25.02.2016;2016;02;17;Torstai;4;4;8
93;25.02.2016;2016;02;18;Torstai;3;5;8
93;25.02.2016;2016;02;19;Torstai;3;1;4
93;25.02.2016;2016;02;20;Torstai;6;1;7
93;25.02.2016;2016;02;21;Torstai;1;1;2
93;25.02.2016;2016;02;22;Torstai;0;1;1
93;25.02.2016;2016;02;23;Torstai;0;0;0
93;26.02.2016;2016;02;00;Perjantai;0;0;0
93;26.02.2016;2016;02;01;Perjantai;0;0;0
93;26.02.2016;2016;02;02;Perjantai;0;0;0
93;26.02.2016;2016;02;03;Perjantai;0;0;0
93;26.02.2016;2016;02;04;Perjantai;0;0;0
93;26.02.2016;2016;02;05;Perjantai;0;0;0
93;26.02.2016;2016;02;06;Perjantai;4;0;4
93;26.02.2016;2016;02;07;Perjantai;4;6;10
93;26.02.2016;2016;02;08;Perjantai;3;6;9
93;26.02.2016;2016;02;09;Perjantai;4;2;6
93;26.02.2016;2016;02;10;Perjantai;1;0;1
93;26.02.2016;2016;02;11;Perjantai;1;2;3
93;26.02.2016;2016;02;12;Perjantai;1;0;1
93;26.02.2016;2016;02;13;Perjantai;2;4;6
93;26.02.2016;2016;02;14;Perjantai;1;1;2
93;26.02.2016;2016;02;15;Perjantai;5;4;9
93;26.02.2016;2016;02;16;Perjantai;5;7;12
93;26.02.2016;2016;02;17;Perjantai;5;5;10
93;26.02.2016;2016;02;18;Perjantai;3;3;6
93;26.02.2016;2016;02;19;Perjantai;0;1;1
93;26.02.2016;2016;02;20;Perjantai;3;0;3
93;26.02.2016;2016;02;21;Perjantai;1;1;2
93;26.02.2016;2016;02;22;Perjantai;0;1;1
93;26.02.2016;2016;02;23;Perjantai;0;3;3
93;27.02.2016;2016;02;00;Lauantai;1;0;1
93;27.02.2016;2016;02;01;Lauantai;0;0;0
93;27.02.2016;2016;02;02;Lauantai;0;0;0
93;27.02.2016;2016;02;03;Lauantai;0;0;0
93;27.02.2016;2016;02;04;Lauantai;0;0;0
93;27.02.2016;2016;02;05;Lauantai;0;1;1
93;27.02.2016;2016;02;06;Lauantai;0;0;0
93;27.02.2016;2016;02;07;Lauantai;2;0;2
93;27.02.2016;2016;02;08;Lauantai;1;1;2
93;27.02.2016;2016;02;09;Lauantai;3;1;4
93;27.02.2016;2016;02;10;Lauantai;2;1;3
93;27.02.2016;2016;02;11;Lauantai;1;2;3
93;27.02.2016;2016;02;12;Lauantai;1;4;5
93;27.02.2016;2016;02;13;Lauantai;1;1;2
93;27.02.2016;2016;02;14;Lauantai;2;2;4
93;27.02.2016;2016;02;15;Lauantai;0;2;2
93;27.02.2016;2016;02;16;Lauantai;4;2;6
93;27.02.2016;2016;02;17;Lauantai;0;3;3
93;27.02.2016;2016;02;18;Lauantai;5;1;6
93;27.02.2016;2016;02;19;Lauantai;0;0;0
93;27.02.2016;2016;02;20;Lauantai;0;2;2
93;27.02.2016;2016;02;21;Lauantai;0;0;0
93;27.02.2016;2016;02;22;Lauantai;0;1;1
93;27.02.2016;2016;02;23;Lauantai;0;0;0
93;28.02.2016;2016;02;00;Sunnuntai;0;0;0
93;28.02.2016;2016;02;01;Sunnuntai;0;0;0
93;28.02.2016;2016;02;02;Sunnuntai;0;0;0
93;28.02.2016;2016;02;03;Sunnuntai;0;0;0
93;28.02.2016;2016;02;04;Sunnuntai;0;0;0
93;28.02.2016;2016;02;05;Sunnuntai;0;0;0
93;28.02.2016;2016;02;06;Sunnuntai;0;0;0
93;28.02.2016;2016;02;07;Sunnuntai;1;0;1
93;28.02.2016;2016;02;08;Sunnuntai;1;0;1
93;28.02.2016;2016;02;09;Sunnuntai;0;0;0
93;28.02.2016;2016;02;10;Sunnuntai;1;1;2
93;28.02.2016;2016;02;11;Sunnuntai;5;1;6
93;28.02.2016;2016;02;12;Sunnuntai;2;5;7
93;28.02.2016;2016;02;13;Sunnuntai;2;3;5
93;28.02.2016;2016;02;14;Sunnuntai;1;1;2
93;28.02.2016;2016;02;15;Sunnuntai;3;2;5
93;28.02.2016;2016;02;16;Sunnuntai;1;1;2
93;28.02.2016;2016;02;17;Sunnuntai;0;1;1
93;28.02.2016;2016;02;18;Sunnuntai;1;0;1
93;28.02.2016;2016;02;19;Sunnuntai;1;0;1
93;28.02.2016;2016;02;20;Sunnuntai;0;1;1
93;28.02.2016;2016;02;21;Sunnuntai;0;0;0
93;28.02.2016;2016;02;22;Sunnuntai;0;0;0
93;28.02.2016;2016;02;23;Sunnuntai;0;0;0
93;29.02.2016;2016;02;00;Maanantai;0;0;0
93;29.02.2016;2016;02;01;Maanantai;0;0;0
93;29.02.2016;2016;02;02;Maanantai;0;0;0
93;29.02.2016;2016;02;03;Maanantai;0;0;0
93;29.02.2016;2016;02;04;Maanantai;0;0;0
93;29.02.2016;2016;02;05;Maanantai;0;0;0
93;29.02.2016;2016;02;06;Maanantai;4;1;5
93;29.02.2016;2016;02;07;Maanantai;8;8;16
93;29.02.2016;2016;02;08;Maanantai;3;10;13
93;29.02.2016;2016;02;09;Maanantai;1;2;3
93;29.02.2016;2016;02;10;Maanantai;0;1;1
93;29.02.2016;2016;02;11;Maanantai;2;3;5
93;29.02.2016;2016;02;12;Maanantai;2;0;2
93;29.02.2016;2016;02;13;Maanantai;2;2;4
93;29.02.2016;2016;02;14;Maanantai;1;3;4
93;29.02.2016;2016;02;15;Maanantai;5;6;11
93;29.02.2016;2016;02;16;Maanantai;8;3;11
93;29.02.2016;2016;02;17;Maanantai;4;5;9
93;29.02.2016;2016;02;18;Maanantai;3;3;6
93;29.02.2016;2016;02;19;Maanantai;1;0;1
93;29.02.2016;2016;02;20;Maanantai;3;1;4
93;29.02.2016;2016;02;21;Maanantai;1;1;2
93;29.02.2016;2016;02;22;Maanantai;1;1;2
93;29.02.2016;2016;02;23;Maanantai;0;0;0
93;01.03.2016;2016;03;00;Tiistai;0;0;0
93;01.03.2016;2016;03;01;Tiistai;0;0;0
93;01.03.2016;2016;03;02;Tiistai;0;0;0
93;01.03.2016;2016;03;03;Tiistai;0;0;0
93;01.03.2016;2016;03;04;Tiistai;0;0;0
93;01.03.2016;2016;03;05;Tiistai;2;1;3
93;01.03.2016;2016;03;06;Tiistai;2;1;3
93;01.03.2016;2016;03;07;Tiistai;7;20;27
93;01.03.2016;2016;03;08;Tiistai;6;11;17
93;01.03.2016;2016;03;09;Tiistai;3;0;3
93;01.03.2016;2016;03;10;Tiistai;3;1;4
93;01.03.2016;2016;03;11;Tiistai;2;3;5
93;01.03.2016;2016;03;12;Tiistai;5;5;10
93;01.03.2016;2016;03;13;Tiistai;1;1;2
93;01.03.2016;2016;03;14;Tiistai;5;4;9
93;01.03.2016;2016;03;15;Tiistai;12;7;19
93;01.03.2016;2016;03;16;Tiistai;14;10;24
93;01.03.2016;2016;03;17;Tiistai;8;3;11
93;01.03.2016;2016;03;18;Tiistai;4;5;9
93;01.03.2016;2016;03;19;Tiistai;4;5;9
93;01.03.2016;2016;03;20;Tiistai;2;1;3
93;01.03.2016;2016;03;21;Tiistai;0;0;0
93;01.03.2016;2016;03;22;Tiistai;0;2;2
93;01.03.2016;2016;03;23;Tiistai;0;0;0
93;02.03.2016;2016;03;00;Keskiviikko;0;0;0
93;02.03.2016;2016;03;01;Keskiviikko;0;1;1
93;02.03.2016;2016;03;02;Keskiviikko;0;0;0
93;02.03.2016;2016;03;03;Keskiviikko;0;0;0
93;02.03.2016;2016;03;04;Keskiviikko;0;0;0
93;02.03.2016;2016;03;05;Keskiviikko;1;0;1
93;02.03.2016;2016;03;06;Keskiviikko;7;5;12
93;02.03.2016;2016;03;07;Keskiviikko;8;18;26
93;02.03.2016;2016;03;08;Keskiviikko;5;11;16
93;02.03.2016;2016;03;09;Keskiviikko;0;3;3
93;02.03.2016;2016;03;10;Keskiviikko;2;3;5
93;02.03.2016;2016;03;11;Keskiviikko;0;1;1
93;02.03.2016;2016;03;12;Keskiviikko;1;1;2
93;02.03.2016;2016;03;13;Keskiviikko;3;1;4
93;02.03.2016;2016;03;14;Keskiviikko;3;4;7
93;02.03.2016;2016;03;15;Keskiviikko;11;9;20
93;02.03.2016;2016;03;16;Keskiviikko;22;8;30
93;02.03.2016;2016;03;17;Keskiviikko;10;5;15
93;02.03.2016;2016;03;18;Keskiviikko;5;3;8
93;02.03.2016;2016;03;19;Keskiviikko;2;2;4
93;02.03.2016;2016;03;20;Keskiviikko;1;2;3
93;02.03.2016;2016;03;21;Keskiviikko;1;0;1
93;02.03.2016;2016;03;22;Keskiviikko;1;1;2
93;02.03.2016;2016;03;23;Keskiviikko;0;0;0
93;03.03.2016;2016;03;00;Torstai;0;0;0
93;03.03.2016;2016;03;01;Torstai;0;0;0
93;03.03.2016;2016;03;02;Torstai;0;0;0
93;03.03.2016;2016;03;03;Torstai;0;0;0
93;03.03.2016;2016;03;04;Torstai;0;0;0
93;03.03.2016;2016;03;05;Torstai;0;0;0
93;03.03.2016;2016;03;06;Torstai;3;4;7
93;03.03.2016;2016;03;07;Torstai;9;17;26
93;03.03.2016;2016;03;08;Torstai;3;8;11
93;03.03.2016;2016;03;09;Torstai;3;2;5
93;03.03.2016;2016;03;10;Torstai;1;1;2
93;03.03.2016;2016;03;11;Torstai;1;2;3
93;03.03.2016;2016;03;12;Torstai;1;1;2
93;03.03.2016;2016;03;13;Torstai;3;3;6
93;03.03.2016;2016;03;14;Torstai;0;3;3
93;03.03.2016;2016;03;15;Torstai;12;6;18
93;03.03.2016;2016;03;16;Torstai;8;2;10
93;03.03.2016;2016;03;17;Torstai;6;1;7
93;03.03.2016;2016;03;18;Torstai;5;1;6
93;03.03.2016;2016;03;19;Torstai;1;2;3
93;03.03.2016;2016;03;20;Torstai;1;1;2
93;03.03.2016;2016;03;21;Torstai;0;1;1
93;03.03.2016;2016;03;22;Torstai;0;1;1
93;03.03.2016;2016;03;23;Torstai;0;0;0
93;04.03.2016;2016;03;00;Perjantai;0;0;0
93;04.03.2016;2016;03;01;Perjantai;1;0;1
93;04.03.2016;2016;03;02;Perjantai;0;0;0
93;04.03.2016;2016;03;03;Perjantai;0;0;0
93;04.03.2016;2016;03;04;Perjantai;0;0;0
93;04.03.2016;2016;03;05;Perjantai;0;0;0
93;04.03.2016;2016;03;06;Perjantai;3;5;8
93;04.03.2016;2016;03;07;Perjantai;6;9;15
93;04.03.2016;2016;03;08;Perjantai;2;4;6
93;04.03.2016;2016;03;09;Perjantai;1;2;3
93;04.03.2016;2016;03;10;Perjantai;2;5;7
93;04.03.2016;2016;03;11;Perjantai;2;2;4
93;04.03.2016;2016;03;12;Perjantai;1;0;1
93;04.03.2016;2016;03;13;Perjantai;2;4;6
93;04.03.2016;2016;03;14;Perjantai;4;2;6
93;04.03.2016;2016;03;15;Perjantai;7;5;12
93;04.03.2016;2016;03;16;Perjantai;11;0;11
93;04.03.2016;2016;03;17;Perjantai;4;4;8
93;04.03.2016;2016;03;18;Perjantai;3;3;6
93;04.03.2016;2016;03;19;Perjantai;4;2;6
93;04.03.2016;2016;03;20;Perjantai;1;0;1
93;04.03.2016;2016;03;21;Perjantai;0;1;1
93;04.03.2016;2016;03;22;Perjantai;0;0;0
93;04.03.2016;2016;03;23;Perjantai;1;0;1
93;05.03.2016;2016;03;00;Lauantai;0;0;0
93;05.03.2016;2016;03;01;Lauantai;0;1;1
93;05.03.2016;2016;03;02;Lauantai;0;0;0
93;05.03.2016;2016;03;03;Lauantai;0;0;0
93;05.03.2016;2016;03;04;Lauantai;0;0;0
93;05.03.2016;2016;03;05;Lauantai;0;1;1
93;05.03.2016;2016;03;06;Lauantai;1;0;1
93;05.03.2016;2016;03;07;Lauantai;0;0;0
93;05.03.2016;2016;03;08;Lauantai;0;1;1
93;05.03.2016;2016;03;09;Lauantai;0;3;3
93;05.03.2016;2016;03;10;Lauantai;4;1;5
93;05.03.2016;2016;03;11;Lauantai;0;4;4
93;05.03.2016;2016;03;12;Lauantai;1;0;1
93;05.03.2016;2016;03;13;Lauantai;0;5;5
93;05.03.2016;2016;03;14;Lauantai;3;0;3
93;05.03.2016;2016;03;15;Lauantai;2;3;5
93;05.03.2016;2016;03;16;Lauantai;1;2;3
93;05.03.2016;2016;03;17;Lauantai;3;2;5
93;05.03.2016;2016;03;18;Lauantai;2;0;2
93;05.03.2016;2016;03;19;Lauantai;0;0;0
93;05.03.2016;2016;03;20;Lauantai;0;0;0
93;05.03.2016;2016;03;21;Lauantai;0;1;1
93;05.03.2016;2016;03;22;Lauantai;0;0;0
93;05.03.2016;2016;03;23;Lauantai;1;0;1
93;06.03.2016;2016;03;00;Sunnuntai;0;0;0
93;06.03.2016;2016;03;01;Sunnuntai;1;0;1
93;06.03.2016;2016;03;02;Sunnuntai;0;0;0
93;06.03.2016;2016;03;03;Sunnuntai;0;0;0
93;06.03.2016;2016;03;04;Sunnuntai;0;0;0
93;06.03.2016;2016;03;05;Sunnuntai;0;0;0
93;06.03.2016;2016;03;06;Sunnuntai;1;1;2
93;06.03.2016;2016;03;07;Sunnuntai;0;0;0
93;06.03.2016;2016;03;08;Sunnuntai;4;2;6
93;06.03.2016;2016;03;09;Sunnuntai;4;0;4
93;06.03.2016;2016;03;10;Sunnuntai;1;2;3
93;06.03.2016;2016;03;11;Sunnuntai;1;3;4
93;06.03.2016;2016;03;12;Sunnuntai;1;2;3
93;06.03.2016;2016;03;13;Sunnuntai;6;8;14
93;06.03.2016;2016;03;14;Sunnuntai;3;4;7
93;06.03.2016;2016;03;15;Sunnuntai;1;4;5
93;06.03.2016;2016;03;16;Sunnuntai;2;0;2
93;06.03.2016;2016;03;17;Sunnuntai;0;1;1
93;06.03.2016;2016;03;18;Sunnuntai;1;2;3
93;06.03.2016;2016;03;19;Sunnuntai;3;3;6
93;06.03.2016;2016;03;20;Sunnuntai;1;1;2
93;06.03.2016;2016;03;21;Sunnuntai;0;0;0
93;06.03.2016;2016;03;22;Sunnuntai;0;1;1
93;06.03.2016;2016;03;23;Sunnuntai;2;0;2
93;07.03.2016;2016;03;00;Maanantai;1;0;1
93;07.03.2016;2016;03;01;Maanantai;1;0;1
93;07.03.2016;2016;03;02;Maanantai;0;0;0
93;07.03.2016;2016;03;03;Maanantai;0;0;0
93;07.03.2016;2016;03;04;Maanantai;0;0;0
93;07.03.2016;2016;03;05;Maanantai;0;1;1
93;07.03.2016;2016;03;06;Maanantai;1;3;4
93;07.03.2016;2016;03;07;Maanantai;7;8;15
93;07.03.2016;2016;03;08;Maanantai;4;6;10
93;07.03.2016;2016;03;09;Maanantai;3;3;6
93;07.03.2016;2016;03;10;Maanantai;1;0;1
93;07.03.2016;2016;03;11;Maanantai;3;2;5
93;07.03.2016;2016;03;12;Maanantai;0;2;2
93;07.03.2016;2016;03;13;Maanantai;2;2;4
93;07.03.2016;2016;03;14;Maanantai;3;4;7
93;07.03.2016;2016;03;15;Maanantai;3;1;4
93;07.03.2016;2016;03;16;Maanantai;10;6;16
93;07.03.2016;2016;03;17;Maanantai;6;1;7
93;07.03.2016;2016;03;18;Maanantai;3;7;10
93;07.03.2016;2016;03;19;Maanantai;3;1;4
93;07.03.2016;2016;03;20;Maanantai;1;1;2
93;07.03.2016;2016;03;21;Maanantai;1;1;2
93;07.03.2016;2016;03;22;Maanantai;0;1;1
93;07.03.2016;2016;03;23;Maanantai;0;0;0
93;08.03.2016;2016;03;00;Tiistai;1;0;1
93;08.03.2016;2016;03;01;Tiistai;0;0;0
93;08.03.2016;2016;03;02;Tiistai;0;0;0
93;08.03.2016;2016;03;03;Tiistai;0;0;0
93;08.03.2016;2016;03;04;Tiistai;0;0;0
93;08.03.2016;2016;03;05;Tiistai;0;2;2
93;08.03.2016;2016;03;06;Tiistai;3;2;5
93;08.03.2016;2016;03;07;Tiistai;5;7;12
93;08.03.2016;2016;03;08;Tiistai;2;8;10
93;08.03.2016;2016;03;09;Tiistai;4;0;4
93;08.03.2016;2016;03;10;Tiistai;3;3;6
93;08.03.2016;2016;03;11;Tiistai;1;4;5
93;08.03.2016;2016;03;12;Tiistai;3;2;5
93;08.03.2016;2016;03;13;Tiistai;1;6;7
93;08.03.2016;2016;03;14;Tiistai;3;1;4
93;08.03.2016;2016;03;15;Tiistai;6;2;8
93;08.03.2016;2016;03;16;Tiistai;10;3;13
93;08.03.2016;2016;03;17;Tiistai;4;0;4
93;08.03.2016;2016;03;18;Tiistai;2;3;5
93;08.03.2016;2016;03;19;Tiistai;1;2;3
93;08.03.2016;2016;03;20;Tiistai;0;0;0
93;08.03.2016;2016;03;21;Tiistai;0;0;0
93;08.03.2016;2016;03;22;Tiistai;0;0;0
93;08.03.2016;2016;03;23;Tiistai;0;0;0
93;09.03.2016;2016;03;00;Keskiviikko;1;0;1
93;09.03.2016;2016;03;01;Keskiviikko;0;1;1
93;09.03.2016;2016;03;02;Keskiviikko;0;0;0
93;09.03.2016;2016;03;03;Keskiviikko;0;0;0
93;09.03.2016;2016;03;04;Keskiviikko;0;0;0
93;09.03.2016;2016;03;05;Keskiviikko;0;2;2
93;09.03.2016;2016;03;06;Keskiviikko;1;1;2
93;09.03.2016;2016;03;07;Keskiviikko;3;8;11
93;09.03.2016;2016;03;08;Keskiviikko;2;4;6
93;09.03.2016;2016;03;09;Keskiviikko;3;3;6
93;09.03.2016;2016;03;10;Keskiviikko;4;1;5
93;09.03.2016;2016;03;11;Keskiviikko;0;2;2
93;09.03.2016;2016;03;12;Keskiviikko;1;1;2
93;09.03.2016;2016;03;13;Keskiviikko;4;4;8
93;09.03.2016;2016;03;14;Keskiviikko;3;0;3
93;09.03.2016;2016;03;15;Keskiviikko;5;3;8
93;09.03.2016;2016;03;16;Keskiviikko;10;4;14
93;09.03.2016;2016;03;17;Keskiviikko;9;3;12
93;09.03.2016;2016;03;18;Keskiviikko;2;2;4
93;09.03.2016;2016;03;19;Keskiviikko;2;0;2
93;09.03.2016;2016;03;20;Keskiviikko;1;0;1
93;09.03.2016;2016;03;21;Keskiviikko;1;1;2
93;09.03.2016;2016;03;22;Keskiviikko;0;1;1
93;09.03.2016;2016;03;23;Keskiviikko;0;1;1
93;10.03.2016;2016;03;00;Torstai;1;0;1
93;10.03.2016;2016;03;01;Torstai;0;0;0
93;10.03.2016;2016;03;02;Torstai;0;0;0
93;10.03.2016;2016;03;03;Torstai;0;0;0
93;10.03.2016;2016;03;04;Torstai;0;0;0
93;10.03.2016;2016;03;05;Torstai;0;0;0
93;10.03.2016;2016;03;06;Torstai;5;0;5
93;10.03.2016;2016;03;07;Torstai;5;4;9
93;10.03.2016;2016;03;08;Torstai;3;7;10
93;10.03.2016;2016;03;09;Torstai;4;0;4
93;10.03.2016;2016;03;10;Torstai;2;1;3
93;10.03.2016;2016;03;11;Torstai;5;3;8
93;10.03.2016;2016;03;12;Torstai;0;2;2
93;10.03.2016;2016;03;13;Torstai;0;6;6
93;10.03.2016;2016;03;14;Torstai;4;1;5
93;10.03.2016;2016;03;15;Torstai;2;5;7
93;10.03.2016;2016;03;16;Torstai;9;5;14
93;10.03.2016;2016;03;17;Torstai;10;1;11
93;10.03.2016;2016;03;18;Torstai;6;2;8
93;10.03.2016;2016;03;19;Torstai;0;2;2
93;10.03.2016;2016;03;20;Torstai;2;2;4
93;10.03.2016;2016;03;21;Torstai;3;3;6
93;10.03.2016;2016;03;22;Torstai;1;0;1
93;10.03.2016;2016;03;23;Torstai;0;0;0
93;11.03.2016;2016;03;00;Perjantai;1;0;1
93;11.03.2016;2016;03;01;Perjantai;0;0;0
93;11.03.2016;2016;03;02;Perjantai;0;0;0
93;11.03.2016;2016;03;03;Perjantai;0;0;0
93;11.03.2016;2016;03;04;Perjantai;0;0;0
93;11.03.2016;2016;03;05;Perjantai;0;2;2
93;11.03.2016;2016;03;06;Perjantai;0;1;1
93;11.03.2016;2016;03;07;Perjantai;4;3;7
93;11.03.2016;2016;03;08;Perjantai;2;3;5
93;11.03.2016;2016;03;09;Perjantai;6;0;6
93;11.03.2016;2016;03;10;Perjantai;2;3;5
93;11.03.2016;2016;03;11;Perjantai;1;4;5
93;11.03.2016;2016;03;12;Perjantai;1;1;2
93;11.03.2016;2016;03;13;Perjantai;1;0;1
93;11.03.2016;2016;03;14;Perjantai;1;0;1
93;11.03.2016;2016;03;15;Perjantai;4;2;6
93;11.03.2016;2016;03;16;Perjantai;6;2;8
93;11.03.2016;2016;03;17;Perjantai;2;1;3
93;11.03.2016;2016;03;18;Perjantai;0;2;2
93;11.03.2016;2016;03;19;Perjantai;0;0;0
93;11.03.2016;2016;03;20;Perjantai;1;0;1
93;11.03.2016;2016;03;21;Perjantai;0;1;1
93;11.03.2016;2016;03;22;Perjantai;0;0;0
93;11.03.2016;2016;03;23;Perjantai;0;0;0
93;12.03.2016;2016;03;00;Lauantai;0;0;0
93;12.03.2016;2016;03;01;Lauantai;0;0;0
93;12.03.2016;2016;03;02;Lauantai;0;0;0
93;12.03.2016;2016;03;03;Lauantai;0;0;0
93;12.03.2016;2016;03;04;Lauantai;0;0;0
93;12.03.2016;2016;03;05;Lauantai;0;0;0
93;12.03.2016;2016;03;06;Lauantai;0;0;0
93;12.03.2016;2016;03;07;Lauantai;0;0;0
93;12.03.2016;2016;03;08;Lauantai;3;2;5
93;12.03.2016;2016;03;09;Lauantai;5;1;6
93;12.03.2016;2016;03;10;Lauantai;1;3;4
93;12.03.2016;2016;03;11;Lauantai;3;4;7
93;12.03.2016;2016;03;12;Lauantai;4;1;5
93;12.03.2016;2016;03;13;Lauantai;2;5;7
93;12.03.2016;2016;03;14;Lauantai;2;4;6
93;12.03.2016;2016;03;15;Lauantai;1;1;2
93;12.03.2016;2016;03;16;Lauantai;2;3;5
93;12.03.2016;2016;03;17;Lauantai;3;3;6
93;12.03.2016;2016;03;18;Lauantai;3;0;3
93;12.03.2016;2016;03;19;Lauantai;1;0;1
93;12.03.2016;2016;03;20;Lauantai;0;1;1
93;12.03.2016;2016;03;21;Lauantai;0;0;0
93;12.03.2016;2016;03;22;Lauantai;0;1;1
93;12.03.2016;2016;03;23;Lauantai;1;0;1
93;13.03.2016;2016;03;00;Sunnuntai;0;0;0
93;13.03.2016;2016;03;01;Sunnuntai;0;1;1
93;13.03.2016;2016;03;02;Sunnuntai;0;0;0
93;13.03.2016;2016;03;03;Sunnuntai;0;0;0
93;13.03.2016;2016;03;04;Sunnuntai;0;1;1
93;13.03.2016;2016;03;05;Sunnuntai;0;0;0
93;13.03.2016;2016;03;06;Sunnuntai;1;0;1
93;13.03.2016;2016;03;07;Sunnuntai;1;0;1
93;13.03.2016;2016;03;08;Sunnuntai;2;2;4
93;13.03.2016;2016;03;09;Sunnuntai;4;1;5
93;13.03.2016;2016;03;10;Sunnuntai;4;3;7
93;13.03.2016;2016;03;11;Sunnuntai;13;1;14
93;13.03.2016;2016;03;12;Sunnuntai;2;3;5
93;13.03.2016;2016;03;13;Sunnuntai;7;4;11
93;13.03.2016;2016;03;14;Sunnuntai;8;2;10
93;13.03.2016;2016;03;15;Sunnuntai;0;2;2
93;13.03.2016;2016;03;16;Sunnuntai;2;5;7
93;13.03.2016;2016;03;17;Sunnuntai;1;3;4
93;13.03.2016;2016;03;18;Sunnuntai;4;4;8
93;13.03.2016;2016;03;19;Sunnuntai;2;2;4
93;13.03.2016;2016;03;20;Sunnuntai;0;0;0
93;13.03.2016;2016;03;21;Sunnuntai;0;1;1
93;13.03.2016;2016;03;22;Sunnuntai;1;1;2
93;13.03.2016;2016;03;23;Sunnuntai;0;0;0
93;14.03.2016;2016;03;00;Maanantai;0;0;0
93;14.03.2016;2016;03;01;Maanantai;0;0;0
93;14.03.2016;2016;03;02;Maanantai;0;0;0
93;14.03.2016;2016;03;03;Maanantai;0;0;0
93;14.03.2016;2016;03;04;Maanantai;0;0;0
93;14.03.2016;2016;03;05;Maanantai;0;1;1
93;14.03.2016;2016;03;06;Maanantai;3;3;6
93;14.03.2016;2016;03;07;Maanantai;9;14;23
93;14.03.2016;2016;03;08;Maanantai;5;15;20
93;14.03.2016;2016;03;09;Maanantai;2;1;3
93;14.03.2016;2016;03;10;Maanantai;5;0;5
93;14.03.2016;2016;03;11;Maanantai;2;3;5
93;14.03.2016;2016;03;12;Maanantai;2;0;2
93;14.03.2016;2016;03;13;Maanantai;1;2;3
93;14.03.2016;2016;03;14;Maanantai;4;5;9
93;14.03.2016;2016;03;15;Maanantai;9;7;16
93;14.03.2016;2016;03;16;Maanantai;8;7;15
93;14.03.2016;2016;03;17;Maanantai;13;2;15
93;14.03.2016;2016;03;18;Maanantai;3;6;9
93;14.03.2016;2016;03;19;Maanantai;4;2;6
93;14.03.2016;2016;03;20;Maanantai;1;3;4
93;14.03.2016;2016;03;21;Maanantai;0;1;1
93;14.03.2016;2016;03;22;Maanantai;0;1;1
93;14.03.2016;2016;03;23;Maanantai;0;0;0
93;15.03.2016;2016;03;00;Tiistai;0;0;0
93;15.03.2016;2016;03;01;Tiistai;0;0;0
93;15.03.2016;2016;03;02;Tiistai;0;0;0
93;15.03.2016;2016;03;03;Tiistai;0;0;0
93;15.03.2016;2016;03;04;Tiistai;0;0;0
93;15.03.2016;2016;03;05;Tiistai;1;1;2
93;15.03.2016;2016;03;06;Tiistai;7;5;12
93;15.03.2016;2016;03;07;Tiistai;9;12;21
93;15.03.2016;2016;03;08;Tiistai;8;7;15
93;15.03.2016;2016;03;09;Tiistai;1;3;4
93;15.03.2016;2016;03;10;Tiistai;1;1;2
93;15.03.2016;2016;03;11;Tiistai;3;0;3
93;15.03.2016;2016;03;12;Tiistai;3;2;5
93;15.03.2016;2016;03;13;Tiistai;6;7;13
93;15.03.2016;2016;03;14;Tiistai;4;5;9
93;15.03.2016;2016;03;15;Tiistai;7;12;19
93;15.03.2016;2016;03;16;Tiistai;15;7;22
93;15.03.2016;2016;03;17;Tiistai;12;8;20
93;15.03.2016;2016;03;18;Tiistai;4;1;5
93;15.03.2016;2016;03;19;Tiistai;1;4;5
93;15.03.2016;2016;03;20;Tiistai;2;0;2
93;15.03.2016;2016;03;21;Tiistai;3;1;4
93;15.03.2016;2016;03;22;Tiistai;1;0;1
93;15.03.2016;2016;03;23;Tiistai;0;1;1
93;16.03.2016;2016;03;00;Keskiviikko;0;0;0
93;16.03.2016;2016;03;01;Keskiviikko;0;0;0
93;16.03.2016;2016;03;02;Keskiviikko;0;0;0
93;16.03.2016;2016;03;03;Keskiviikko;0;0;0
93;16.03.2016;2016;03;04;Keskiviikko;0;0;0
93;16.03.2016;2016;03;05;Keskiviikko;1;2;3
93;16.03.2016;2016;03;06;Keskiviikko;3;4;7
93;16.03.2016;2016;03;07;Keskiviikko;10;9;19
93;16.03.2016;2016;03;08;Keskiviikko;4;10;14
93;16.03.2016;2016;03;09;Keskiviikko;3;2;5
93;16.03.2016;2016;03;10;Keskiviikko;3;2;5
93;16.03.2016;2016;03;11;Keskiviikko;3;1;4
93;16.03.2016;2016;03;12;Keskiviikko;5;5;10
93;16.03.2016;2016;03;13;Keskiviikko;2;2;4
93;16.03.2016;2016;03;14;Keskiviikko;8;4;12
93;16.03.2016;2016;03;15;Keskiviikko;7;3;10
93;16.03.2016;2016;03;16;Keskiviikko;15;7;22
93;16.03.2016;2016;03;17;Keskiviikko;11;5;16
93;16.03.2016;2016;03;18;Keskiviikko;3;7;10
93;16.03.2016;2016;03;19;Keskiviikko;1;3;4
93;16.03.2016;2016;03;20;Keskiviikko;1;2;3
93;16.03.2016;2016;03;21;Keskiviikko;1;0;1
93;16.03.2016;2016;03;22;Keskiviikko;0;2;2
93;16.03.2016;2016;03;23;Keskiviikko;0;1;1
93;17.03.2016;2016;03;00;Torstai;0;0;0
93;17.03.2016;2016;03;01;Torstai;0;0;0
93;17.03.2016;2016;03;02;Torstai;0;0;0
93;17.03.2016;2016;03;03;Torstai;0;0;0
93;17.03.2016;2016;03;04;Torstai;0;0;0
93;17.03.2016;2016;03;05;Torstai;0;2;2
93;17.03.2016;2016;03;06;Torstai;5;1;6
93;17.03.2016;2016;03;07;Torstai;8;10;18
93;17.03.2016;2016;03;08;Torstai;6;10;16
93;17.03.2016;2016;03;09;Torstai;9;2;11
93;17.03.2016;2016;03;10;Torstai;2;5;7
93;17.03.2016;2016;03;11;Torstai;2;1;3
93;17.03.2016;2016;03;12;Torstai;4;5;9
93;17.03.2016;2016;03;13;Torstai;3;4;7
93;17.03.2016;2016;03;14;Torstai;1;2;3
93;17.03.2016;2016;03;15;Torstai;9;5;14
93;17.03.2016;2016;03;16;Torstai;14;8;22
93;17.03.2016;2016;03;17;Torstai;10;5;15
93;17.03.2016;2016;03;18;Torstai;2;1;3
93;17.03.2016;2016;03;19;Torstai;0;5;5
93;17.03.2016;2016;03;20;Torstai;3;0;3
93;17.03.2016;2016;03;21;Torstai;0;2;2
93;17.03.2016;2016;03;22;Torstai;1;3;4
93;17.03.2016;2016;03;23;Torstai;0;0;0
93;18.03.2016;2016;03;00;Perjantai;0;0;0
93;18.03.2016;2016;03;01;Perjantai;0;0;0
93;18.03.2016;2016;03;02;Perjantai;0;0;0
93;18.03.2016;2016;03;03;Perjantai;0;0;0
93;18.03.2016;2016;03;04;Perjantai;0;0;0
93;18.03.2016;2016;03;05;Perjantai;2;1;3
93;18.03.2016;2016;03;06;Perjantai;3;2;5
93;18.03.2016;2016;03;07;Perjantai;7;7;14
93;18.03.2016;2016;03;08;Perjantai;4;8;12
93;18.03.2016;2016;03;09;Perjantai;2;1;3
93;18.03.2016;2016;03;10;Perjantai;6;1;7
93;18.03.2016;2016;03;11;Perjantai;1;1;2
93;18.03.2016;2016;03;12;Perjantai;3;3;6
93;18.03.2016;2016;03;13;Perjantai;4;3;7
93;18.03.2016;2016;03;14;Perjantai;5;2;7
93;18.03.2016;2016;03;15;Perjantai;6;5;11
93;18.03.2016;2016;03;16;Perjantai;5;6;11
93;18.03.2016;2016;03;17;Perjantai;3;5;8
93;18.03.2016;2016;03;18;Perjantai;1;4;5
93;18.03.2016;2016;03;19;Perjantai;2;3;5
93;18.03.2016;2016;03;20;Perjantai;1;2;3
93;18.03.2016;2016;03;21;Perjantai;0;1;1
93;18.03.2016;2016;03;22;Perjantai;1;1;2
93;18.03.2016;2016;03;23;Perjantai;0;0;0
93;19.03.2016;2016;03;00;Lauantai;0;0;0
93;19.03.2016;2016;03;01;Lauantai;0;0;0
93;19.03.2016;2016;03;02;Lauantai;0;0;0
93;19.03.2016;2016;03;03;Lauantai;0;0;0
93;19.03.2016;2016;03;04;Lauantai;0;0;0
93;19.03.2016;2016;03;05;Lauantai;0;0;0
93;19.03.2016;2016;03;06;Lauantai;0;0;0
93;19.03.2016;2016;03;07;Lauantai;0;0;0
93;19.03.2016;2016;03;08;Lauantai;1;0;1
93;19.03.2016;2016;03;09;Lauantai;0;2;2
93;19.03.2016;2016;03;10;Lauantai;4;3;7
93;19.03.2016;2016;03;11;Lauantai;5;0;5
93;19.03.2016;2016;03;12;Lauantai;3;4;7
93;19.03.2016;2016;03;13;Lauantai;6;4;10
93;19.03.2016;2016;03;14;Lauantai;2;7;9
93;19.03.2016;2016;03;15;Lauantai;5;5;10
93;19.03.2016;2016;03;16;Lauantai;5;1;6
93;19.03.2016;2016;03;17;Lauantai;3;3;6
93;19.03.2016;2016;03;18;Lauantai;1;1;2
93;19.03.2016;2016;03;19;Lauantai;1;5;6
93;19.03.2016;2016;03;20;Lauantai;0;0;0
93;19.03.2016;2016;03;21;Lauantai;1;1;2
93;19.03.2016;2016;03;22;Lauantai;0;0;0
93;19.03.2016;2016;03;23;Lauantai;0;1;1
93;20.03.2016;2016;03;00;Sunnuntai;0;1;1
93;20.03.2016;2016;03;01;Sunnuntai;0;0;0
93;20.03.2016;2016;03;02;Sunnuntai;0;0;0
93;20.03.2016;2016;03;03;Sunnuntai;0;0;0
93;20.03.2016;2016;03;04;Sunnuntai;0;0;0
93;20.03.2016;2016;03;05;Sunnuntai;0;0;0
93;20.03.2016;2016;03;06;Sunnuntai;1;0;1
93;20.03.2016;2016;03;07;Sunnuntai;2;0;2
93;20.03.2016;2016;03;08;Sunnuntai;2;1;3
93;20.03.2016;2016;03;09;Sunnuntai;2;4;6
93;20.03.2016;2016;03;10;Sunnuntai;3;7;10
93;20.03.2016;2016;03;11;Sunnuntai;10;3;13
93;20.03.2016;2016;03;12;Sunnuntai;2;1;3
93;20.03.2016;2016;03;13;Sunnuntai;3;5;8
93;20.03.2016;2016;03;14;Sunnuntai;4;3;7
93;20.03.2016;2016;03;15;Sunnuntai;3;6;9
93;20.03.2016;2016;03;16;Sunnuntai;10;4;14
93;20.03.2016;2016;03;17;Sunnuntai;3;2;5
93;20.03.2016;2016;03;18;Sunnuntai;2;2;4
93;20.03.2016;2016;03;19;Sunnuntai;0;2;2
93;20.03.2016;2016;03;20;Sunnuntai;1;0;1
93;20.03.2016;2016;03;21;Sunnuntai;0;2;2
93;20.03.2016;2016;03;22;Sunnuntai;2;1;3
93;20.03.2016;2016;03;23;Sunnuntai;0;0;0
93;21.03.2016;2016;03;00;Maanantai;0;0;0
93;21.03.2016;2016;03;01;Maanantai;0;0;0
93;21.03.2016;2016;03;02;Maanantai;0;0;0
93;21.03.2016;2016;03;03;Maanantai;0;0;0
93;21.03.2016;2016;03;04;Maanantai;0;0;0
93;21.03.2016;2016;03;05;Maanantai;0;0;0
93;21.03.2016;2016;03;06;Maanantai;4;2;6
93;21.03.2016;2016;03;07;Maanantai;6;8;14
93;21.03.2016;2016;03;08;Maanantai;2;6;8
93;21.03.2016;2016;03;09;Maanantai;2;0;2
93;21.03.2016;2016;03;10;Maanantai;1;0;1
93;21.03.2016;2016;03;11;Maanantai;1;1;2
93;21.03.2016;2016;03;12;Maanantai;3;1;4
93;21.03.2016;2016;03;13;Maanantai;4;6;10
93;21.03.2016;2016;03;14;Maanantai;3;4;7
93;21.03.2016;2016;03;15;Maanantai;8;5;13
93;21.03.2016;2016;03;16;Maanantai;7;7;14
93;21.03.2016;2016;03;17;Maanantai;1;4;5
93;21.03.2016;2016;03;18;Maanantai;4;1;5
93;21.03.2016;2016;03;19;Maanantai;4;2;6
93;21.03.2016;2016;03;20;Maanantai;2;3;5
93;21.03.2016;2016;03;21;Maanantai;0;1;1
93;21.03.2016;2016;03;22;Maanantai;0;1;1
93;21.03.2016;2016;03;23;Maanantai;0;0;0
93;22.03.2016;2016;03;00;Tiistai;0;0;0
93;22.03.2016;2016;03;01;Tiistai;0;0;0
93;22.03.2016;2016;03;02;Tiistai;0;0;0
93;22.03.2016;2016;03;03;Tiistai;0;0;0
93;22.03.2016;2016;03;04;Tiistai;0;0;0
93;22.03.2016;2016;03;05;Tiistai;1;0;1
93;22.03.2016;2016;03;06;Tiistai;3;2;5
93;22.03.2016;2016;03;07;Tiistai;4;7;11
93;22.03.2016;2016;03;08;Tiistai;2;8;10
93;22.03.2016;2016;03;09;Tiistai;4;1;5
93;22.03.2016;2016;03;10;Tiistai;2;3;5
93;22.03.2016;2016;03;11;Tiistai;9;2;11
93;22.03.2016;2016;03;12;Tiistai;3;1;4
93;22.03.2016;2016;03;13;Tiistai;5;5;10
93;22.03.2016;2016;03;14;Tiistai;4;4;8
93;22.03.2016;2016;03;15;Tiistai;8;8;16
93;22.03.2016;2016;03;16;Tiistai;8;5;13
93;22.03.2016;2016;03;17;Tiistai;6;7;13
93;22.03.2016;2016;03;18;Tiistai;5;2;7
93;22.03.2016;2016;03;19;Tiistai;2;3;5
93;22.03.2016;2016;03;20;Tiistai;1;4;5
93;22.03.2016;2016;03;21;Tiistai;0;0;0
93;22.03.2016;2016;03;22;Tiistai;0;1;1
93;22.03.2016;2016;03;23;Tiistai;0;0;0
93;23.03.2016;2016;03;00;Keskiviikko;0;0;0
93;23.03.2016;2016;03;01;Keskiviikko;0;0;0
93;23.03.2016;2016;03;02;Keskiviikko;0;0;0
93;23.03.2016;2016;03;03;Keskiviikko;0;0;0
93;23.03.2016;2016;03;04;Keskiviikko;0;0;0
93;23.03.2016;2016;03;05;Keskiviikko;0;0;0
93;23.03.2016;2016;03;06;Keskiviikko;1;2;3
93;23.03.2016;2016;03;07;Keskiviikko;13;6;19
93;23.03.2016;2016;03;08;Keskiviikko;5;13;18
93;23.03.2016;2016;03;09;Keskiviikko;2;2;4
93;23.03.2016;2016;03;10;Keskiviikko;2;2;4
93;23.03.2016;2016;03;11;Keskiviikko;1;1;2
93;23.03.2016;2016;03;12;Keskiviikko;2;2;4
93;23.03.2016;2016;03;13;Keskiviikko;2;2;4
93;23.03.2016;2016;03;14;Keskiviikko;3;3;6
93;23.03.2016;2016;03;15;Keskiviikko;5;7;12
93;23.03.2016;2016;03;16;Keskiviikko;11;7;18
93;23.03.2016;2016;03;17;Keskiviikko;10;3;13
93;23.03.2016;2016;03;18;Keskiviikko;0;2;2
93;23.03.2016;2016;03;19;Keskiviikko;3;0;3
93;23.03.2016;2016;03;20;Keskiviikko;2;7;9
93;23.03.2016;2016;03;21;Keskiviikko;0;0;0
93;23.03.2016;2016;03;22;Keskiviikko;2;0;2
93;23.03.2016;2016;03;23;Keskiviikko;0;1;1
93;24.03.2016;2016;03;00;Torstai;0;0;0
93;24.03.2016;2016;03;01;Torstai;0;0;0
93;24.03.2016;2016;03;02;Torstai;0;0;0
93;24.03.2016;2016;03;03;Torstai;0;0;0
93;24.03.2016;2016;03;04;Torstai;0;0;0
93;24.03.2016;2016;03;05;Torstai;0;1;1
93;24.03.2016;2016;03;06;Torstai;2;1;3
93;24.03.2016;2016;03;07;Torstai;9;8;17
93;24.03.2016;2016;03;08;Torstai;1;9;10
93;24.03.2016;2016;03;09;Torstai;7;1;8
93;24.03.2016;2016;03;10;Torstai;2;1;3
93;24.03.2016;2016;03;11;Torstai;4;3;7
93;24.03.2016;2016;03;12;Torstai;4;2;6
93;24.03.2016;2016;03;13;Torstai;2;5;7
93;24.03.2016;2016;03;14;Torstai;2;1;3
93;24.03.2016;2016;03;15;Torstai;7;5;12
93;24.03.2016;2016;03;16;Torstai;5;5;10
93;24.03.2016;2016;03;17;Torstai;2;1;3
93;24.03.2016;2016;03;18;Torstai;1;1;2
93;24.03.2016;2016;03;19;Torstai;0;2;2
93;24.03.2016;2016;03;20;Torstai;2;2;4
93;24.03.2016;2016;03;21;Torstai;0;1;1
93;24.03.2016;2016;03;22;Torstai;0;0;0
93;24.03.2016;2016;03;23;Torstai;0;0;0
93;25.03.2016;2016;03;00;Perjantai;0;0;0
93;25.03.2016;2016;03;01;Perjantai;0;0;0
93;25.03.2016;2016;03;02;Perjantai;0;0;0
93;25.03.2016;2016;03;03;Perjantai;0;0;0
93;25.03.2016;2016;03;04;Perjantai;0;0;0
93;25.03.2016;2016;03;05;Perjantai;0;0;0
93;25.03.2016;2016;03;06;Perjantai;0;0;0
93;25.03.2016;2016;03;07;Perjantai;0;0;0
93;25.03.2016;2016;03;08;Perjantai;1;1;2
93;25.03.2016;2016;03;09;Perjantai;1;1;2
93;25.03.2016;2016;03;10;Perjantai;0;0;0
93;25.03.2016;2016;03;11;Perjantai;2;0;2
93;25.03.2016;2016;03;12;Perjantai;0;3;3
93;25.03.2016;2016;03;13;Perjantai;0;1;1
93;25.03.2016;2016;03;14;Perjantai;2;1;3
93;25.03.2016;2016;03;15;Perjantai;3;1;4
93;25.03.2016;2016;03;16;Perjantai;0;4;4
93;25.03.2016;2016;03;17;Perjantai;0;2;2
93;25.03.2016;2016;03;18;Perjantai;1;1;2
93;25.03.2016;2016;03;19;Perjantai;1;2;3
93;25.03.2016;2016;03;20;Perjantai;1;1;2
93;25.03.2016;2016;03;21;Perjantai;2;0;2
93;25.03.2016;2016;03;22;Perjantai;0;0;0
93;25.03.2016;2016;03;23;Perjantai;0;0;0
93;26.03.2016;2016;03;00;Lauantai;0;0;0
93;26.03.2016;2016;03;01;Lauantai;0;0;0
93;26.03.2016;2016;03;02;Lauantai;0;0;0
93;26.03.2016;2016;03;03;Lauantai;0;0;0
93;26.03.2016;2016;03;04;Lauantai;0;1;1
93;26.03.2016;2016;03;05;Lauantai;0;0;0
93;26.03.2016;2016;03;06;Lauantai;0;0;0
93;26.03.2016;2016;03;07;Lauantai;2;0;2
93;26.03.2016;2016;03;08;Lauantai;2;0;2
93;26.03.2016;2016;03;09;Lauantai;7;2;9
93;26.03.2016;2016;03;10;Lauantai;1;5;6
93;26.03.2016;2016;03;11;Lauantai;4;3;7
93;26.03.2016;2016;03;12;Lauantai;2;0;2
93;26.03.2016;2016;03;13;Lauantai;1;8;9
93;26.03.2016;2016;03;14;Lauantai;4;2;6
93;26.03.2016;2016;03;15;Lauantai;0;1;1
93;26.03.2016;2016;03;16;Lauantai;5;3;8
93;26.03.2016;2016;03;17;Lauantai;2;1;3
93;26.03.2016;2016;03;18;Lauantai;2;4;6
93;26.03.2016;2016;03;19;Lauantai;2;3;5
93;26.03.2016;2016;03;20;Lauantai;0;0;0
93;26.03.2016;2016;03;21;Lauantai;0;1;1
93;26.03.2016;2016;03;22;Lauantai;0;0;0
93;26.03.2016;2016;03;23;Lauantai;0;0;0
93;27.03.2016;2016;03;00;Sunnuntai;0;0;0
93;27.03.2016;2016;03;01;Sunnuntai;0;0;0
93;27.03.2016;2016;03;02;Sunnuntai;0;0;0
93;27.03.2016;2016;03;03;Sunnuntai;0;0;0
93;27.03.2016;2016;03;04;Sunnuntai;0;0;0
93;27.03.2016;2016;03;05;Sunnuntai;0;0;0
93;27.03.2016;2016;03;06;Sunnuntai;0;1;1
93;27.03.2016;2016;03;07;Sunnuntai;1;0;1
93;27.03.2016;2016;03;08;Sunnuntai;2;1;3
93;27.03.2016;2016;03;09;Sunnuntai;3;1;4
93;27.03.2016;2016;03;10;Sunnuntai;6;1;7
93;27.03.2016;2016;03;11;Sunnuntai;3;5;8
93;27.03.2016;2016;03;12;Sunnuntai;8;4;12
93;27.03.2016;2016;03;13;Sunnuntai;7;9;16
93;27.03.2016;2016;03;14;Sunnuntai;6;4;10
93;27.03.2016;2016;03;15;Sunnuntai;9;4;13
93;27.03.2016;2016;03;16;Sunnuntai;8;8;16
93;27.03.2016;2016;03;17;Sunnuntai;6;3;9
93;27.03.2016;2016;03;18;Sunnuntai;6;4;10
93;27.03.2016;2016;03;19;Sunnuntai;6;4;10
93;27.03.2016;2016;03;20;Sunnuntai;3;8;11
93;27.03.2016;2016;03;21;Sunnuntai;0;1;1
93;27.03.2016;2016;03;22;Sunnuntai;0;0;0
93;27.03.2016;2016;03;23;Sunnuntai;0;0;0
93;28.03.2016;2016;03;00;Maanantai;0;0;0
93;28.03.2016;2016;03;01;Maanantai;0;1;1
93;28.03.2016;2016;03;02;Maanantai;1;0;1
93;28.03.2016;2016;03;03;Maanantai;0;0;0
93;28.03.2016;2016;03;04;Maanantai;0;0;0
93;28.03.2016;2016;03;05;Maanantai;0;0;0
93;28.03.2016;2016;03;06;Maanantai;0;2;2
93;28.03.2016;2016;03;07;Maanantai;3;2;5
93;28.03.2016;2016;03;08;Maanantai;1;1;2
93;28.03.2016;2016;03;09;Maanantai;8;1;9
93;28.03.2016;2016;03;10;Maanantai;6;4;10
93;28.03.2016;2016;03;11;Maanantai;4;1;5
93;28.03.2016;2016;03;12;Maanantai;9;7;16
93;28.03.2016;2016;03;13;Maanantai;14;9;23
93;28.03.2016;2016;03;14;Maanantai;13;5;18
93;28.03.2016;2016;03;15;Maanantai;20;13;33
93;28.03.2016;2016;03;16;Maanantai;11;19;30
93;28.03.2016;2016;03;17;Maanantai;17;13;30
93;28.03.2016;2016;03;18;Maanantai;7;7;14
93;28.03.2016;2016;03;19;Maanantai;10;9;19
93;28.03.2016;2016;03;20;Maanantai;3;6;9
93;28.03.2016;2016;03;21;Maanantai;2;4;6
93;28.03.2016;2016;03;22;Maanantai;0;0;0
93;28.03.2016;2016;03;23;Maanantai;0;0;0
93;29.03.2016;2016;03;00;Tiistai;0;0;0
93;29.03.2016;2016;03;01;Tiistai;0;0;0
93;29.03.2016;2016;03;02;Tiistai;0;0;0
93;29.03.2016;2016;03;03;Tiistai;0;0;0
93;29.03.2016;2016;03;04;Tiistai;0;0;0
93;29.03.2016;2016;03;05;Tiistai;1;2;3
93;29.03.2016;2016;03;06;Tiistai;7;2;9
93;29.03.2016;2016;03;07;Tiistai;8;12;20
93;29.03.2016;2016;03;08;Tiistai;11;7;18
93;29.03.2016;2016;03;09;Tiistai;5;2;7
93;29.03.2016;2016;03;10;Tiistai;6;6;12
93;29.03.2016;2016;03;11;Tiistai;3;4;7
93;29.03.2016;2016;03;12;Tiistai;9;6;15
93;29.03.2016;2016;03;13;Tiistai;11;12;23
93;29.03.2016;2016;03;14;Tiistai;9;8;17
93;29.03.2016;2016;03;15;Tiistai;14;15;29
93;29.03.2016;2016;03;16;Tiistai;19;14;33
93;29.03.2016;2016;03;17;Tiistai;17;14;31
93;29.03.2016;2016;03;18;Tiistai;13;20;33
93;29.03.2016;2016;03;19;Tiistai;17;10;27
93;29.03.2016;2016;03;20;Tiistai;7;9;16
93;29.03.2016;2016;03;21;Tiistai;4;1;5
93;29.03.2016;2016;03;22;Tiistai;0;1;1
93;29.03.2016;2016;03;23;Tiistai;0;0;0
93;30.03.2016;2016;03;00;Keskiviikko;0;0;0
93;30.03.2016;2016;03;01;Keskiviikko;0;0;0
93;30.03.2016;2016;03;02;Keskiviikko;0;0;0
93;30.03.2016;2016;03;03;Keskiviikko;0;0;0
93;30.03.2016;2016;03;04;Keskiviikko;0;0;0
93;30.03.2016;2016;03;05;Keskiviikko;1;1;2
93;30.03.2016;2016;03;06;Keskiviikko;5;5;10
93;30.03.2016;2016;03;07;Keskiviikko;12;13;25
93;30.03.2016;2016;03;08;Keskiviikko;6;11;17
93;30.03.2016;2016;03;09;Keskiviikko;4;5;9
93;30.03.2016;2016;03;10;Keskiviikko;2;0;2
93;30.03.2016;2016;03;11;Keskiviikko;1;2;3
93;30.03.2016;2016;03;12;Keskiviikko;2;3;5
93;30.03.2016;2016;03;13;Keskiviikko;3;5;8
93;30.03.2016;2016;03;14;Keskiviikko;12;6;18
93;30.03.2016;2016;03;15;Keskiviikko;13;15;28
93;30.03.2016;2016;03;16;Keskiviikko;18;13;31
93;30.03.2016;2016;03;17;Keskiviikko;14;14;28
93;30.03.2016;2016;03;18;Keskiviikko;10;15;25
93;30.03.2016;2016;03;19;Keskiviikko;4;5;9
93;30.03.2016;2016;03;20;Keskiviikko;3;3;6
93;30.03.2016;2016;03;21;Keskiviikko;0;0;0
93;30.03.2016;2016;03;22;Keskiviikko;0;1;1
93;30.03.2016;2016;03;23;Keskiviikko;0;0;0
93;31.03.2016;2016;03;00;Torstai;0;0;0
93;31.03.2016;2016;03;01;Torstai;0;0;0
93;31.03.2016;2016;03;02;Torstai;0;0;0
93;31.03.2016;2016;03;03;Torstai;0;0;0
93;31.03.2016;2016;03;04;Torstai;0;0;0
93;31.03.2016;2016;03;05;Torstai;1;1;2
93;31.03.2016;2016;03;06;Torstai;5;4;9
93;31.03.2016;2016;03;07;Torstai;12;15;27
93;31.03.2016;2016;03;08;Torstai;2;19;21
93;31.03.2016;2016;03;09;Torstai;6;3;9
93;31.03.2016;2016;03;10;Torstai;4;8;12
93;31.03.2016;2016;03;11;Torstai;6;5;11
93;31.03.2016;2016;03;12;Torstai;3;5;8
93;31.03.2016;2016;03;13;Torstai;7;4;11
93;31.03.2016;2016;03;14;Torstai;6;9;15
93;31.03.2016;2016;03;15;Torstai;19;11;30
93;31.03.2016;2016;03;16;Torstai;23;15;38
93;31.03.2016;2016;03;17;Torstai;13;11;24
93;31.03.2016;2016;03;18;Torstai;3;5;8
93;31.03.2016;2016;03;19;Torstai;7;6;13
93;31.03.2016;2016;03;20;Torstai;3;1;4
93;31.03.2016;2016;03;21;Torstai;1;5;6
93;31.03.2016;2016;03;22;Torstai;1;0;1
93;31.03.2016;2016;03;23;Torstai;0;0;0
93;01.04.2016;2016;04;00;Perjantai;0;0;0
93;01.04.2016;2016;04;01;Perjantai;0;0;0
93;01.04.2016;2016;04;02;Perjantai;0;0;0
93;01.04.2016;2016;04;03;Perjantai;0;0;0
93;01.04.2016;2016;04;04;Perjantai;0;0;0
93;01.04.2016;2016;04;05;Perjantai;0;1;1
93;01.04.2016;2016;04;06;Perjantai;8;4;12
93;01.04.2016;2016;04;07;Perjantai;7;14;21
93;01.04.2016;2016;04;08;Perjantai;5;14;19
93;01.04.2016;2016;04;09;Perjantai;1;3;4
93;01.04.2016;2016;04;10;Perjantai;5;1;6
93;01.04.2016;2016;04;11;Perjantai;8;5;13
93;01.04.2016;2016;04;12;Perjantai;6;4;10
93;01.04.2016;2016;04;13;Perjantai;8;6;14
93;01.04.2016;2016;04;14;Perjantai;13;9;22
93;01.04.2016;2016;04;15;Perjantai;26;13;39
93;01.04.2016;2016;04;16;Perjantai;15;10;25
93;01.04.2016;2016;04;17;Perjantai;7;25;32
93;01.04.2016;2016;04;18;Perjantai;5;12;17
93;01.04.2016;2016;04;19;Perjantai;6;8;14
93;01.04.2016;2016;04;20;Perjantai;5;3;8
93;01.04.2016;2016;04;21;Perjantai;0;4;4
93;01.04.2016;2016;04;22;Perjantai;2;1;3
93;01.04.2016;2016;04;23;Perjantai;1;0;1
93;02.04.2016;2016;04;00;Lauantai;0;0;0
93;02.04.2016;2016;04;01;Lauantai;2;0;2
93;02.04.2016;2016;04;02;Lauantai;0;0;0
93;02.04.2016;2016;04;03;Lauantai;0;0;0
93;02.04.2016;2016;04;04;Lauantai;1;0;1
93;02.04.2016;2016;04;05;Lauantai;1;0;1
93;02.04.2016;2016;04;06;Lauantai;0;1;1
93;02.04.2016;2016;04;07;Lauantai;1;0;1
93;02.04.2016;2016;04;08;Lauantai;3;1;4
93;02.04.2016;2016;04;09;Lauantai;6;3;9
93;02.04.2016;2016;04;10;Lauantai;7;5;12
93;02.04.2016;2016;04;11;Lauantai;4;7;11
93;02.04.2016;2016;04;12;Lauantai;9;9;18
93;02.04.2016;2016;04;13;Lauantai;9;8;17
93;02.04.2016;2016;04;14;Lauantai;6;14;20
93;02.04.2016;2016;04;15;Lauantai;23;7;30
93;02.04.2016;2016;04;16;Lauantai;14;9;23
93;02.04.2016;2016;04;17;Lauantai;6;4;10
93;02.04.2016;2016;04;18;Lauantai;5;7;12
93;02.04.2016;2016;04;19;Lauantai;8;7;15
93;02.04.2016;2016;04;20;Lauantai;2;7;9
93;02.04.2016;2016;04;21;Lauantai;3;2;5
93;02.04.2016;2016;04;22;Lauantai;3;1;4
93;02.04.2016;2016;04;23;Lauantai;1;0;1
93;03.04.2016;2016;04;00;Sunnuntai;1;0;1
93;03.04.2016;2016;04;01;Sunnuntai;0;1;1
93;03.04.2016;2016;04;02;Sunnuntai;4;1;5
93;03.04.2016;2016;04;03;Sunnuntai;0;0;0
93;03.04.2016;2016;04;04;Sunnuntai;0;2;2
93;03.04.2016;2016;04;05;Sunnuntai;1;0;1
93;03.04.2016;2016;04;06;Sunnuntai;1;0;1
93;03.04.2016;2016;04;07;Sunnuntai;2;1;3
93;03.04.2016;2016;04;08;Sunnuntai;2;1;3
93;03.04.2016;2016;04;09;Sunnuntai;6;5;11
93;03.04.2016;2016;04;10;Sunnuntai;15;13;28
93;03.04.2016;2016;04;11;Sunnuntai;11;17;28
93;03.04.2016;2016;04;12;Sunnuntai;20;9;29
93;03.04.2016;2016;04;13;Sunnuntai;24;16;40
93;03.04.2016;2016;04;14;Sunnuntai;22;19;41
93;03.04.2016;2016;04;15;Sunnuntai;9;18;27
93;03.04.2016;2016;04;16;Sunnuntai;19;15;34
93;03.04.2016;2016;04;17;Sunnuntai;22;20;42
93;03.04.2016;2016;04;18;Sunnuntai;15;9;24
93;03.04.2016;2016;04;19;Sunnuntai;5;10;15
93;03.04.2016;2016;04;20;Sunnuntai;8;5;13
93;03.04.2016;2016;04;21;Sunnuntai;0;2;2
93;03.04.2016;2016;04;22;Sunnuntai;1;0;1
93;03.04.2016;2016;04;23;Sunnuntai;0;0;0
93;04.04.2016;2016;04;00;Maanantai;0;0;0
93;04.04.2016;2016;04;01;Maanantai;0;0;0
93;04.04.2016;2016;04;02;Maanantai;0;0;0
93;04.04.2016;2016;04;03;Maanantai;0;0;0
93;04.04.2016;2016;04;04;Maanantai;0;0;0
93;04.04.2016;2016;04;05;Maanantai;1;1;2
93;04.04.2016;2016;04;06;Maanantai;11;6;17
93;04.04.2016;2016;04;07;Maanantai;19;18;37
93;04.04.2016;2016;04;08;Maanantai;5;21;26
93;04.04.2016;2016;04;09;Maanantai;5;2;7
93;04.04.2016;2016;04;10;Maanantai;7;3;10
93;04.04.2016;2016;04;11;Maanantai;9;4;13
93;04.04.2016;2016;04;12;Maanantai;2;9;11
93;04.04.2016;2016;04;13;Maanantai;7;6;13
93;04.04.2016;2016;04;14;Maanantai;12;9;21
93;04.04.2016;2016;04;15;Maanantai;24;14;38
93;04.04.2016;2016;04;16;Maanantai;16;19;35
93;04.04.2016;2016;04;17;Maanantai;15;11;26
93;04.04.2016;2016;04;18;Maanantai;15;16;31
93;04.04.2016;2016;04;19;Maanantai;6;13;19
93;04.04.2016;2016;04;20;Maanantai;3;3;6
93;04.04.2016;2016;04;21;Maanantai;2;2;4
93;04.04.2016;2016;04;22;Maanantai;0;3;3
93;04.04.2016;2016;04;23;Maanantai;0;1;1
93;05.04.2016;2016;04;00;Tiistai;0;0;0
93;05.04.2016;2016;04;01;Tiistai;0;0;0
93;05.04.2016;2016;04;02;Tiistai;0;0;0
93;05.04.2016;2016;04;03;Tiistai;1;1;2
93;05.04.2016;2016;04;04;Tiistai;0;0;0
93;05.04.2016;2016;04;05;Tiistai;1;3;4
93;05.04.2016;2016;04;06;Tiistai;3;6;9
93;05.04.2016;2016;04;07;Tiistai;12;17;29
93;05.04.2016;2016;04;08;Tiistai;6;12;18
93;05.04.2016;2016;04;09;Tiistai;3;2;5
93;05.04.2016;2016;04;10;Tiistai;3;3;6
93;05.04.2016;2016;04;11;Tiistai;3;1;4
93;05.04.2016;2016;04;12;Tiistai;3;2;5
93;05.04.2016;2016;04;13;Tiistai;2;2;4
93;05.04.2016;2016;04;14;Tiistai;6;6;12
93;05.04.2016;2016;04;15;Tiistai;15;9;24
93;05.04.2016;2016;04;16;Tiistai;18;8;26
93;05.04.2016;2016;04;17;Tiistai;11;5;16
93;05.04.2016;2016;04;18;Tiistai;7;8;15
93;05.04.2016;2016;04;19;Tiistai;4;3;7
93;05.04.2016;2016;04;20;Tiistai;2;7;9
93;05.04.2016;2016;04;21;Tiistai;0;1;1
93;05.04.2016;2016;04;22;Tiistai;2;2;4
93;05.04.2016;2016;04;23;Tiistai;1;1;2
93;06.04.2016;2016;04;00;Keskiviikko;0;0;0
93;06.04.2016;2016;04;01;Keskiviikko;0;0;0
93;06.04.2016;2016;04;02;Keskiviikko;0;0;0
93;06.04.2016;2016;04;03;Keskiviikko;0;0;0
93;06.04.2016;2016;04;04;Keskiviikko;0;0;0
93;06.04.2016;2016;04;05;Keskiviikko;0;0;0
93;06.04.2016;2016;04;06;Keskiviikko;6;6;12
93;06.04.2016;2016;04;07;Keskiviikko;14;14;28
93;06.04.2016;2016;04;08;Keskiviikko;2;13;15
93;06.04.2016;2016;04;09;Keskiviikko;3;3;6
93;06.04.2016;2016;04;10;Keskiviikko;6;3;9
93;06.04.2016;2016;04;11;Keskiviikko;7;3;10
93;06.04.2016;2016;04;12;Keskiviikko;5;3;8
93;06.04.2016;2016;04;13;Keskiviikko;2;2;4
93;06.04.2016;2016;04;14;Keskiviikko;6;17;23
93;06.04.2016;2016;04;15;Keskiviikko;13;10;23
93;06.04.2016;2016;04;16;Keskiviikko;15;4;19
93;06.04.2016;2016;04;17;Keskiviikko;4;4;8
93;06.04.2016;2016;04;18;Keskiviikko;1;2;3
93;06.04.2016;2016;04;19;Keskiviikko;5;7;12
93;06.04.2016;2016;04;20;Keskiviikko;0;1;1
93;06.04.2016;2016;04;21;Keskiviikko;1;3;4
93;06.04.2016;2016;04;22;Keskiviikko;0;1;1
93;06.04.2016;2016;04;23;Keskiviikko;1;0;1
93;07.04.2016;2016;04;00;Torstai;0;0;0
93;07.04.2016;2016;04;01;Torstai;0;0;0
93;07.04.2016;2016;04;02;Torstai;0;0;0
93;07.04.2016;2016;04;03;Torstai;2;0;2
93;07.04.2016;2016;04;04;Torstai;1;0;1
93;07.04.2016;2016;04;05;Torstai;0;0;0
93;07.04.2016;2016;04;06;Torstai;6;6;12
93;07.04.2016;2016;04;07;Torstai;12;14;26
93;07.04.2016;2016;04;08;Torstai;3;16;19
93;07.04.2016;2016;04;09;Torstai;2;1;3
93;07.04.2016;2016;04;10;Torstai;2;2;4
93;07.04.2016;2016;04;11;Torstai;1;2;3
93;07.04.2016;2016;04;12;Torstai;2;0;2
93;07.04.2016;2016;04;13;Torstai;3;3;6
93;07.04.2016;2016;04;14;Torstai;5;2;7
93;07.04.2016;2016;04;15;Torstai;12;9;21
93;07.04.2016;2016;04;16;Torstai;23;12;35
93;07.04.2016;2016;04;17;Torstai;12;8;20
93;07.04.2016;2016;04;18;Torstai;5;7;12
93;07.04.2016;2016;04;19;Torstai;4;7;11
93;07.04.2016;2016;04;20;Torstai;1;5;6
93;07.04.2016;2016;04;21;Torstai;1;0;1
93;07.04.2016;2016;04;22;Torstai;1;4;5
93;07.04.2016;2016;04;23;Torstai;0;0;0
93;08.04.2016;2016;04;00;Perjantai;0;0;0
93;08.04.2016;2016;04;01;Perjantai;0;0;0
93;08.04.2016;2016;04;02;Perjantai;0;0;0
93;08.04.2016;2016;04;03;Perjantai;0;0;0
93;08.04.2016;2016;04;04;Perjantai;0;0;0
93;08.04.2016;2016;04;05;Perjantai;0;0;0
93;08.04.2016;2016;04;06;Perjantai;8;4;12
93;08.04.2016;2016;04;07;Perjantai;13;20;33
93;08.04.2016;2016;04;08;Perjantai;5;14;19
93;08.04.2016;2016;04;09;Perjantai;3;5;8
93;08.04.2016;2016;04;10;Perjantai;5;1;6
93;08.04.2016;2016;04;11;Perjantai;6;4;10
93;08.04.2016;2016;04;12;Perjantai;5;4;9
93;08.04.2016;2016;04;13;Perjantai;4;11;15
93;08.04.2016;2016;04;14;Perjantai;10;8;18
93;08.04.2016;2016;04;15;Perjantai;11;10;21
93;08.04.2016;2016;04;16;Perjantai;17;19;36
93;08.04.2016;2016;04;17;Perjantai;14;7;21
93;08.04.2016;2016;04;18;Perjantai;9;2;11
93;08.04.2016;2016;04;19;Perjantai;8;7;15
93;08.04.2016;2016;04;20;Perjantai;4;5;9
93;08.04.2016;2016;04;21;Perjantai;0;2;2
93;08.04.2016;2016;04;22;Perjantai;0;0;0
93;08.04.2016;2016;04;23;Perjantai;0;0;0
93;09.04.2016;2016;04;00;Lauantai;0;2;2
93;09.04.2016;2016;04;01;Lauantai;0;1;1
93;09.04.2016;2016;04;02;Lauantai;0;0;0
93;09.04.2016;2016;04;03;Lauantai;0;0;0
93;09.04.2016;2016;04;04;Lauantai;0;0;0
93;09.04.2016;2016;04;05;Lauantai;0;0;0
93;09.04.2016;2016;04;06;Lauantai;3;2;5
93;09.04.2016;2016;04;07;Lauantai;2;1;3
93;09.04.2016;2016;04;08;Lauantai;4;2;6
93;09.04.2016;2016;04;09;Lauantai;9;6;15
93;09.04.2016;2016;04;10;Lauantai;12;4;16
93;09.04.2016;2016;04;11;Lauantai;20;16;36
93;09.04.2016;2016;04;12;Lauantai;14;24;38
93;09.04.2016;2016;04;13;Lauantai;14;18;32
93;09.04.2016;2016;04;14;Lauantai;19;19;38
93;09.04.2016;2016;04;15;Lauantai;10;16;26
93;09.04.2016;2016;04;16;Lauantai;6;24;30
93;09.04.2016;2016;04;17;Lauantai;17;4;21
93;09.04.2016;2016;04;18;Lauantai;14;17;31
93;09.04.2016;2016;04;19;Lauantai;10;6;16
93;09.04.2016;2016;04;20;Lauantai;7;6;13
93;09.04.2016;2016;04;21;Lauantai;2;2;4
93;09.04.2016;2016;04;22;Lauantai;2;4;6
93;09.04.2016;2016;04;23;Lauantai;1;0;1
93;10.04.2016;2016;04;00;Sunnuntai;0;0;0
93;10.04.2016;2016;04;01;Sunnuntai;1;0;1
93;10.04.2016;2016;04;02;Sunnuntai;0;0;0
93;10.04.2016;2016;04;03;Sunnuntai;0;1;1
93;10.04.2016;2016;04;04;Sunnuntai;0;0;0
93;10.04.2016;2016;04;05;Sunnuntai;3;1;4
93;10.04.2016;2016;04;06;Sunnuntai;3;0;3
93;10.04.2016;2016;04;07;Sunnuntai;1;1;2
93;10.04.2016;2016;04;08;Sunnuntai;8;3;11
93;10.04.2016;2016;04;09;Sunnuntai;7;11;18
93;10.04.2016;2016;04;10;Sunnuntai;8;6;14
93;10.04.2016;2016;04;11;Sunnuntai;9;21;30
93;10.04.2016;2016;04;12;Sunnuntai;22;26;48
93;10.04.2016;2016;04;13;Sunnuntai;16;24;40
93;10.04.2016;2016;04;14;Sunnuntai;23;18;41
93;10.04.2016;2016;04;15;Sunnuntai;19;13;32
93;10.04.2016;2016;04;16;Sunnuntai;13;17;30
93;10.04.2016;2016;04;17;Sunnuntai;16;11;27
93;10.04.2016;2016;04;18;Sunnuntai;8;15;23
93;10.04.2016;2016;04;19;Sunnuntai;10;10;20
93;10.04.2016;2016;04;20;Sunnuntai;9;5;14
93;10.04.2016;2016;04;21;Sunnuntai;8;1;9
93;10.04.2016;2016;04;22;Sunnuntai;1;1;2
93;10.04.2016;2016;04;23;Sunnuntai;0;0;0
93;11.04.2016;2016;04;00;Maanantai;0;0;0
93;11.04.2016;2016;04;01;Maanantai;0;0;0
93;11.04.2016;2016;04;02;Maanantai;0;0;0
93;11.04.2016;2016;04;03;Maanantai;0;0;0
93;11.04.2016;2016;04;04;Maanantai;0;1;1
93;11.04.2016;2016;04;05;Maanantai;3;1;4
93;11.04.2016;2016;04;06;Maanantai;23;8;31
93;11.04.2016;2016;04;07;Maanantai;21;32;53
93;11.04.2016;2016;04;08;Maanantai;9;23;32
93;11.04.2016;2016;04;09;Maanantai;6;2;8
93;11.04.2016;2016;04;10;Maanantai;6;5;11
93;11.04.2016;2016;04;11;Maanantai;6;4;10
93;11.04.2016;2016;04;12;Maanantai;2;5;7
93;11.04.2016;2016;04;13;Maanantai;6;15;21
93;11.04.2016;2016;04;14;Maanantai;14;15;29
93;11.04.2016;2016;04;15;Maanantai;29;17;46
93;11.04.2016;2016;04;16;Maanantai;34;37;71
93;11.04.2016;2016;04;17;Maanantai;21;27;48
93;11.04.2016;2016;04;18;Maanantai;15;19;34
93;11.04.2016;2016;04;19;Maanantai;6;10;16
93;11.04.2016;2016;04;20;Maanantai;12;8;20
93;11.04.2016;2016;04;21;Maanantai;4;6;10
93;11.04.2016;2016;04;22;Maanantai;1;0;1
93;11.04.2016;2016;04;23;Maanantai;0;1;1
93;12.04.2016;2016;04;00;Tiistai;0;0;0
93;12.04.2016;2016;04;01;Tiistai;0;0;0
93;12.04.2016;2016;04;02;Tiistai;0;0;0
93;12.04.2016;2016;04;03;Tiistai;0;0;0
93;12.04.2016;2016;04;04;Tiistai;0;0;0
93;12.04.2016;2016;04;05;Tiistai;2;2;4
93;12.04.2016;2016;04;06;Tiistai;15;10;25
93;12.04.2016;2016;04;07;Tiistai;20;26;46
93;12.04.2016;2016;04;08;Tiistai;11;18;29
93;12.04.2016;2016;04;09;Tiistai;6;5;11
93;12.04.2016;2016;04;10;Tiistai;2;8;10
93;12.04.2016;2016;04;11;Tiistai;7;5;12
93;12.04.2016;2016;04;12;Tiistai;9;2;11
93;12.04.2016;2016;04;13;Tiistai;3;7;10
93;12.04.2016;2016;04;14;Tiistai;17;9;26
93;12.04.2016;2016;04;15;Tiistai;19;30;49
93;12.04.2016;2016;04;16;Tiistai;28;33;61
93;12.04.2016;2016;04;17;Tiistai;23;21;44
93;12.04.2016;2016;04;18;Tiistai;8;10;18
93;12.04.2016;2016;04;19;Tiistai;6;10;16
93;12.04.2016;2016;04;20;Tiistai;4;7;11
93;12.04.2016;2016;04;21;Tiistai;2;6;8
93;12.04.2016;2016;04;22;Tiistai;5;0;5
93;12.04.2016;2016;04;23;Tiistai;0;0;0
93;13.04.2016;2016;04;00;Keskiviikko;0;0;0
93;13.04.2016;2016;04;01;Keskiviikko;1;0;1
93;13.04.2016;2016;04;02;Keskiviikko;0;0;0
93;13.04.2016;2016;04;03;Keskiviikko;0;0;0
93;13.04.2016;2016;04;04;Keskiviikko;0;0;0
93;13.04.2016;2016;04;05;Keskiviikko;2;1;3
93;13.04.2016;2016;04;06;Keskiviikko;13;8;21
93;13.04.2016;2016;04;07;Keskiviikko;16;21;37
93;13.04.2016;2016;04;08;Keskiviikko;13;15;28
93;13.04.2016;2016;04;09;Keskiviikko;5;3;8
93;13.04.2016;2016;04;10;Keskiviikko;8;3;11
93;13.04.2016;2016;04;11;Keskiviikko;4;5;9
93;13.04.2016;2016;04;12;Keskiviikko;6;4;10
93;13.04.2016;2016;04;13;Keskiviikko;6;9;15
93;13.04.2016;2016;04;14;Keskiviikko;8;6;14
93;13.04.2016;2016;04;15;Keskiviikko;12;15;27
93;13.04.2016;2016;04;16;Keskiviikko;23;19;42
93;13.04.2016;2016;04;17;Keskiviikko;7;18;25
93;13.04.2016;2016;04;18;Keskiviikko;6;8;14
93;13.04.2016;2016;04;19;Keskiviikko;4;6;10
93;13.04.2016;2016;04;20;Keskiviikko;5;4;9
93;13.04.2016;2016;04;21;Keskiviikko;2;2;4
93;13.04.2016;2016;04;22;Keskiviikko;0;0;0
93;13.04.2016;2016;04;23;Keskiviikko;1;1;2
93;14.04.2016;2016;04;00;Torstai;0;0;0
93;14.04.2016;2016;04;01;Torstai;0;0;0
93;14.04.2016;2016;04;02;Torstai;0;0;0
93;14.04.2016;2016;04;03;Torstai;0;0;0
93;14.04.2016;2016;04;04;Torstai;0;0;0
93;14.04.2016;2016;04;05;Torstai;1;1;2
93;14.04.2016;2016;04;06;Torstai;12;5;17
93;14.04.2016;2016;04;07;Torstai;14;19;33
93;14.04.2016;2016;04;08;Torstai;8;16;24
93;14.04.2016;2016;04;09;Torstai;5;3;8
93;14.04.2016;2016;04;10;Torstai;7;3;10
93;14.04.2016;2016;04;11;Torstai;7;9;16
93;14.04.2016;2016;04;12;Torstai;2;3;5
93;14.04.2016;2016;04;13;Torstai;6;4;10
93;14.04.2016;2016;04;14;Torstai;5;12;17
93;14.04.2016;2016;04;15;Torstai;18;17;35
93;14.04.2016;2016;04;16;Torstai;22;25;47
93;14.04.2016;2016;04;17;Torstai;23;11;34
93;14.04.2016;2016;04;18;Torstai;8;10;18
93;14.04.2016;2016;04;19;Torstai;12;10;22
93;14.04.2016;2016;04;20;Torstai;6;8;14
93;14.04.2016;2016;04;21;Torstai;2;4;6
93;14.04.2016;2016;04;22;Torstai;1;2;3
93;14.04.2016;2016;04;23;Torstai;1;0;1
93;15.04.2016;2016;04;00;Perjantai;0;0;0
93;15.04.2016;2016;04;01;Perjantai;0;0;0
93;15.04.2016;2016;04;02;Perjantai;0;0;0
93;15.04.2016;2016;04;03;Perjantai;0;0;0
93;15.04.2016;2016;04;04;Perjantai;0;0;0
93;15.04.2016;2016;04;05;Perjantai;0;0;0
93;15.04.2016;2016;04;06;Perjantai;5;6;11
93;15.04.2016;2016;04;07;Perjantai;18;24;42
93;15.04.2016;2016;04;08;Perjantai;9;16;25
93;15.04.2016;2016;04;09;Perjantai;8;0;8
93;15.04.2016;2016;04;10;Perjantai;8;4;12
93;15.04.2016;2016;04;11;Perjantai;6;6;12
93;15.04.2016;2016;04;12;Perjantai;8;9;17
93;15.04.2016;2016;04;13;Perjantai;6;11;17
93;15.04.2016;2016;04;14;Perjantai;17;19;36
93;15.04.2016;2016;04;15;Perjantai;17;14;31
93;15.04.2016;2016;04;16;Perjantai;26;21;47
93;15.04.2016;2016;04;17;Perjantai;13;12;25
93;15.04.2016;2016;04;18;Perjantai;12;23;35
93;15.04.2016;2016;04;19;Perjantai;15;13;28
93;15.04.2016;2016;04;20;Perjantai;2;6;8
93;15.04.2016;2016;04;21;Perjantai;7;14;21
93;15.04.2016;2016;04;22;Perjantai;4;2;6
93;15.04.2016;2016;04;23;Perjantai;2;0;2
93;16.04.2016;2016;04;00;Lauantai;0;0;0
93;16.04.2016;2016;04;01;Lauantai;0;0;0
93;16.04.2016;2016;04;02;Lauantai;0;2;2
93;16.04.2016;2016;04;03;Lauantai;0;0;0
93;16.04.2016;2016;04;04;Lauantai;0;0;0
93;16.04.2016;2016;04;05;Lauantai;0;0;0
93;16.04.2016;2016;04;06;Lauantai;1;0;1
93;16.04.2016;2016;04;07;Lauantai;4;5;9
93;16.04.2016;2016;04;08;Lauantai;6;5;11
93;16.04.2016;2016;04;09;Lauantai;13;5;18
93;16.04.2016;2016;04;10;Lauantai;11;4;15
93;16.04.2016;2016;04;11;Lauantai;6;7;13
93;16.04.2016;2016;04;12;Lauantai;15;16;31
93;16.04.2016;2016;04;13;Lauantai;21;16;37
93;16.04.2016;2016;04;14;Lauantai;13;28;41
93;16.04.2016;2016;04;15;Lauantai;12;6;18
93;16.04.2016;2016;04;16;Lauantai;6;11;17
93;16.04.2016;2016;04;17;Lauantai;5;8;13
93;16.04.2016;2016;04;18;Lauantai;10;8;18
93;16.04.2016;2016;04;19;Lauantai;10;8;18
93;16.04.2016;2016;04;20;Lauantai;11;3;14
93;16.04.2016;2016;04;21;Lauantai;6;7;13
93;16.04.2016;2016;04;22;Lauantai;0;0;0
93;16.04.2016;2016;04;23;Lauantai;1;0;1
93;17.04.2016;2016;04;00;Sunnuntai;1;4;5
93;17.04.2016;2016;04;01;Sunnuntai;0;0;0
93;17.04.2016;2016;04;02;Sunnuntai;0;1;1
93;17.04.2016;2016;04;03;Sunnuntai;0;0;0
93;17.04.2016;2016;04;04;Sunnuntai;0;0;0
93;17.04.2016;2016;04;05;Sunnuntai;1;0;1
93;17.04.2016;2016;04;06;Sunnuntai;0;1;1
93;17.04.2016;2016;04;07;Sunnuntai;4;2;6
93;17.04.2016;2016;04;08;Sunnuntai;0;2;2
93;17.04.2016;2016;04;09;Sunnuntai;4;1;5
93;17.04.2016;2016;04;10;Sunnuntai;4;6;10
93;17.04.2016;2016;04;11;Sunnuntai;6;4;10
93;17.04.2016;2016;04;12;Sunnuntai;11;9;20
93;17.04.2016;2016;04;13;Sunnuntai;11;8;19
93;17.04.2016;2016;04;14;Sunnuntai;19;12;31
93;17.04.2016;2016;04;15;Sunnuntai;8;16;24
93;17.04.2016;2016;04;16;Sunnuntai;8;3;11
93;17.04.2016;2016;04;17;Sunnuntai;9;12;21
93;17.04.2016;2016;04;18;Sunnuntai;5;4;9
93;17.04.2016;2016;04;19;Sunnuntai;4;5;9
93;17.04.2016;2016;04;20;Sunnuntai;5;5;10
93;17.04.2016;2016;04;21;Sunnuntai;2;3;5
93;17.04.2016;2016;04;22;Sunnuntai;1;0;1
93;17.04.2016;2016;04;23;Sunnuntai;0;0;0
93;18.04.2016;2016;04;00;Maanantai;0;0;0
93;18.04.2016;2016;04;01;Maanantai;0;0;0
93;18.04.2016;2016;04;02;Maanantai;0;0;0
93;18.04.2016;2016;04;03;Maanantai;0;0;0
93;18.04.2016;2016;04;04;Maanantai;0;0;0
93;18.04.2016;2016;04;05;Maanantai;2;0;2
93;18.04.2016;2016;04;06;Maanantai;13;6;19
93;18.04.2016;2016;04;07;Maanantai;17;26;43
93;18.04.2016;2016;04;08;Maanantai;10;20;30
93;18.04.2016;2016;04;09;Maanantai;2;2;4
93;18.04.2016;2016;04;10;Maanantai;4;5;9
93;18.04.2016;2016;04;11;Maanantai;9;8;17
93;18.04.2016;2016;04;12;Maanantai;9;3;12
93;18.04.2016;2016;04;13;Maanantai;6;14;20
93;18.04.2016;2016;04;14;Maanantai;7;7;14
93;18.04.2016;2016;04;15;Maanantai;28;11;39
93;18.04.2016;2016;04;16;Maanantai;24;19;43
93;18.04.2016;2016;04;17;Maanantai;12;17;29
93;18.04.2016;2016;04;18;Maanantai;11;8;19
93;18.04.2016;2016;04;19;Maanantai;7;12;19
93;18.04.2016;2016;04;20;Maanantai;8;9;17
93;18.04.2016;2016;04;21;Maanantai;2;3;5
93;18.04.2016;2016;04;22;Maanantai;0;3;3
93;18.04.2016;2016;04;23;Maanantai;0;0;0
93;19.04.2016;2016;04;00;Tiistai;0;0;0
93;19.04.2016;2016;04;01;Tiistai;0;1;1
93;19.04.2016;2016;04;02;Tiistai;1;0;1
93;19.04.2016;2016;04;03;Tiistai;0;0;0
93;19.04.2016;2016;04;04;Tiistai;0;0;0
93;19.04.2016;2016;04;05;Tiistai;1;0;1
93;19.04.2016;2016;04;06;Tiistai;14;5;19
93;19.04.2016;2016;04;07;Tiistai;18;19;37
93;19.04.2016;2016;04;08;Tiistai;9;16;25
93;19.04.2016;2016;04;09;Tiistai;4;3;7
93;19.04.2016;2016;04;10;Tiistai;3;7;10
93;19.04.2016;2016;04;11;Tiistai;4;6;10
93;19.04.2016;2016;04;12;Tiistai;6;8;14
93;19.04.2016;2016;04;13;Tiistai;8;6;14
93;19.04.2016;2016;04;14;Tiistai;4;8;12
93;19.04.2016;2016;04;15;Tiistai;10;11;21
93;19.04.2016;2016;04;16;Tiistai;23;22;45
93;19.04.2016;2016;04;17;Tiistai;9;9;18
93;19.04.2016;2016;04;18;Tiistai;4;9;13
93;19.04.2016;2016;04;19;Tiistai;5;4;9
93;19.04.2016;2016;04;20;Tiistai;3;5;8
93;19.04.2016;2016;04;21;Tiistai;0;1;1
93;19.04.2016;2016;04;22;Tiistai;0;1;1
93;19.04.2016;2016;04;23;Tiistai;0;0;0
93;20.04.2016;2016;04;00;Keskiviikko;0;0;0
93;20.04.2016;2016;04;01;Keskiviikko;0;0;0
93;20.04.2016;2016;04;02;Keskiviikko;0;0;0
93;20.04.2016;2016;04;03;Keskiviikko;0;0;0
93;20.04.2016;2016;04;04;Keskiviikko;0;0;0
93;20.04.2016;2016;04;05;Keskiviikko;0;1;1
93;20.04.2016;2016;04;06;Keskiviikko;7;6;13
93;20.04.2016;2016;04;07;Keskiviikko;11;20;31
93;20.04.2016;2016;04;08;Keskiviikko;5;16;21
93;20.04.2016;2016;04;09;Keskiviikko;4;2;6
93;20.04.2016;2016;04;10;Keskiviikko;4;1;5
93;20.04.2016;2016;04;11;Keskiviikko;0;3;3
93;20.04.2016;2016;04;12;Keskiviikko;3;4;7
93;20.04.2016;2016;04;13;Keskiviikko;7;3;10
93;20.04.2016;2016;04;14;Keskiviikko;6;7;13
93;20.04.2016;2016;04;15;Keskiviikko;11;7;18
93;20.04.2016;2016;04;16;Keskiviikko;26;10;36
93;20.04.2016;2016;04;17;Keskiviikko;9;7;16
93;20.04.2016;2016;04;18;Keskiviikko;8;9;17
93;20.04.2016;2016;04;19;Keskiviikko;5;4;9
93;20.04.2016;2016;04;20;Keskiviikko;3;6;9
93;20.04.2016;2016;04;21;Keskiviikko;1;0;1
93;20.04.2016;2016;04;22;Keskiviikko;0;3;3
93;20.04.2016;2016;04;23;Keskiviikko;0;0;0
93;21.04.2016;2016;04;00;Torstai;0;0;0
93;21.04.2016;2016;04;01;Torstai;0;0;0
93;21.04.2016;2016;04;02;Torstai;0;0;0
93;21.04.2016;2016;04;03;Torstai;0;0;0
93;21.04.2016;2016;04;04;Torstai;0;0;0
93;21.04.2016;2016;04;05;Torstai;0;2;2
93;21.04.2016;2016;04;06;Torstai;10;9;19
93;21.04.2016;2016;04;07;Torstai;16;23;39
93;21.04.2016;2016;04;08;Torstai;7;19;26
93;21.04.2016;2016;04;09;Torstai;9;2;11
93;21.04.2016;2016;04;10;Torstai;5;3;8
93;21.04.2016;2016;04;11;Torstai;3;5;8
93;21.04.2016;2016;04;12;Torstai;7;6;13
93;21.04.2016;2016;04;13;Torstai;7;10;17
93;21.04.2016;2016;04;14;Torstai;12;11;23
93;21.04.2016;2016;04;15;Torstai;16;14;30
93;21.04.2016;2016;04;16;Torstai;34;18;52
93;21.04.2016;2016;04;17;Torstai;16;15;31
93;21.04.2016;2016;04;18;Torstai;6;13;19
93;21.04.2016;2016;04;19;Torstai;11;15;26
93;21.04.2016;2016;04;20;Torstai;5;4;9
93;21.04.2016;2016;04;21;Torstai;1;3;4
93;21.04.2016;2016;04;22;Torstai;2;1;3
93;21.04.2016;2016;04;23;Torstai;0;0;0
93;22.04.2016;2016;04;00;Perjantai;0;1;1
93;22.04.2016;2016;04;01;Perjantai;0;0;0
93;22.04.2016;2016;04;02;Perjantai;0;0;0
93;22.04.2016;2016;04;03;Perjantai;0;0;0
93;22.04.2016;2016;04;04;Perjantai;0;0;0
93;22.04.2016;2016;04;05;Perjantai;2;2;4
93;22.04.2016;2016;04;06;Perjantai;13;8;21
93;22.04.2016;2016;04;07;Perjantai;14;22;36
93;22.04.2016;2016;04;08;Perjantai;9;17;26
93;22.04.2016;2016;04;09;Perjantai;5;4;9
93;22.04.2016;2016;04;10;Perjantai;3;9;12
93;22.04.2016;2016;04;11;Perjantai;6;6;12
93;22.04.2016;2016;04;12;Perjantai;5;8;13
93;22.04.2016;2016;04;13;Perjantai;11;9;20
93;22.04.2016;2016;04;14;Perjantai;15;11;26
93;22.04.2016;2016;04;15;Perjantai;15;10;25
93;22.04.2016;2016;04;16;Perjantai;20;15;35
93;22.04.2016;2016;04;17;Perjantai;17;15;32
93;22.04.2016;2016;04;18;Perjantai;10;16;26
93;22.04.2016;2016;04;19;Perjantai;8;14;22
93;22.04.2016;2016;04;20;Perjantai;4;7;11
93;22.04.2016;2016;04;21;Perjantai;2;2;4
93;22.04.2016;2016;04;22;Perjantai;3;5;8
93;22.04.2016;2016;04;23;Perjantai;1;0;1
93;23.04.2016;2016;04;00;Lauantai;0;1;1
93;23.04.2016;2016;04;01;Lauantai;0;3;3
93;23.04.2016;2016;04;02;Lauantai;0;0;0
93;23.04.2016;2016;04;03;Lauantai;0;0;0
93;23.04.2016;2016;04;04;Lauantai;0;0;0
93;23.04.2016;2016;04;05;Lauantai;0;1;1
93;23.04.2016;2016;04;06;Lauantai;1;0;1
93;23.04.2016;2016;04;07;Lauantai;2;2;4
93;23.04.2016;2016;04;08;Lauantai;6;4;10
93;23.04.2016;2016;04;09;Lauantai;11;3;14
93;23.04.2016;2016;04;10;Lauantai;15;9;24
93;23.04.2016;2016;04;11;Lauantai;6;15;21
93;23.04.2016;2016;04;12;Lauantai;8;8;16
93;23.04.2016;2016;04;13;Lauantai;15;13;28
93;23.04.2016;2016;04;14;Lauantai;17;11;28
93;23.04.2016;2016;04;15;Lauantai;7;12;19
93;23.04.2016;2016;04;16;Lauantai;7;12;19
93;23.04.2016;2016;04;17;Lauantai;12;21;33
93;23.04.2016;2016;04;18;Lauantai;10;4;14
93;23.04.2016;2016;04;19;Lauantai;7;8;15
93;23.04.2016;2016;04;20;Lauantai;1;4;5
93;23.04.2016;2016;04;21;Lauantai;6;1;7
93;23.04.2016;2016;04;22;Lauantai;2;2;4
93;23.04.2016;2016;04;23;Lauantai;0;1;1
93;24.04.2016;2016;04;00;Sunnuntai;0;0;0
93;24.04.2016;2016;04;01;Sunnuntai;3;0;3
93;24.04.2016;2016;04;02;Sunnuntai;0;0;0
93;24.04.2016;2016;04;03;Sunnuntai;1;1;2
93;24.04.2016;2016;04;04;Sunnuntai;0;2;2
93;24.04.2016;2016;04;05;Sunnuntai;1;0;1
93;24.04.2016;2016;04;06;Sunnuntai;3;0;3
93;24.04.2016;2016;04;07;Sunnuntai;3;3;6
93;24.04.2016;2016;04;08;Sunnuntai;4;4;8
93;24.04.2016;2016;04;09;Sunnuntai;8;6;14
93;24.04.2016;2016;04;10;Sunnuntai;8;14;22
93;24.04.2016;2016;04;11;Sunnuntai;21;15;36
93;24.04.2016;2016;04;12;Sunnuntai;20;11;31
93;24.04.2016;2016;04;13;Sunnuntai;12;8;20
93;24.04.2016;2016;04;14;Sunnuntai;7;17;24
93;24.04.2016;2016;04;15;Sunnuntai;14;11;25
93;24.04.2016;2016;04;16;Sunnuntai;16;17;33
93;24.04.2016;2016;04;17;Sunnuntai;12;14;26
93;24.04.2016;2016;04;18;Sunnuntai;9;8;17
93;24.04.2016;2016;04;19;Sunnuntai;9;5;14
93;24.04.2016;2016;04;20;Sunnuntai;10;0;10
93;24.04.2016;2016;04;21;Sunnuntai;4;2;6
93;24.04.2016;2016;04;22;Sunnuntai;1;2;3
93;24.04.2016;2016;04;23;Sunnuntai;1;0;1
93;25.04.2016;2016;04;00;Maanantai;0;1;1
93;25.04.2016;2016;04;01;Maanantai;0;0;0
93;25.04.2016;2016;04;02;Maanantai;0;0;0
93;25.04.2016;2016;04;03;Maanantai;0;0;0
93;25.04.2016;2016;04;04;Maanantai;0;0;0
93;25.04.2016;2016;04;05;Maanantai;3;1;4
93;25.04.2016;2016;04;06;Maanantai;13;9;22
93;25.04.2016;2016;04;07;Maanantai;22;18;40
93;25.04.2016;2016;04;08;Maanantai;4;20;24
93;25.04.2016;2016;04;09;Maanantai;4;8;12
93;25.04.2016;2016;04;10;Maanantai;5;3;8
93;25.04.2016;2016;04;11;Maanantai;5;6;11
93;25.04.2016;2016;04;12;Maanantai;3;2;5
93;25.04.2016;2016;04;13;Maanantai;2;2;4
93;25.04.2016;2016;04;14;Maanantai;5;7;12
93;25.04.2016;2016;04;15;Maanantai;10;5;15
93;25.04.2016;2016;04;16;Maanantai;15;12;27
93;25.04.2016;2016;04;17;Maanantai;6;5;11
93;25.04.2016;2016;04;18;Maanantai;5;6;11
93;25.04.2016;2016;04;19;Maanantai;2;6;8
93;25.04.2016;2016;04;20;Maanantai;3;3;6
93;25.04.2016;2016;04;21;Maanantai;1;1;2
93;25.04.2016;2016;04;22;Maanantai;0;0;0
93;25.04.2016;2016;04;23;Maanantai;0;0;0
93;26.04.2016;2016;04;00;Tiistai;0;0;0
93;26.04.2016;2016;04;01;Tiistai;0;0;0
93;26.04.2016;2016;04;02;Tiistai;0;0;0
93;26.04.2016;2016;04;03;Tiistai;0;0;0
93;26.04.2016;2016;04;04;Tiistai;1;0;1
93;26.04.2016;2016;04;05;Tiistai;2;2;4
93;26.04.2016;2016;04;06;Tiistai;11;8;19
93;26.04.2016;2016;04;07;Tiistai;15;21;36
93;26.04.2016;2016;04;08;Tiistai;8;22;30
93;26.04.2016;2016;04;09;Tiistai;5;2;7
93;26.04.2016;2016;04;10;Tiistai;2;2;4
93;26.04.2016;2016;04;11;Tiistai;4;4;8
93;26.04.2016;2016;04;12;Tiistai;0;4;4
93;26.04.2016;2016;04;13;Tiistai;4;2;6
93;26.04.2016;2016;04;14;Tiistai;4;12;16
93;26.04.2016;2016;04;15;Tiistai;10;8;18
93;26.04.2016;2016;04;16;Tiistai;20;6;26
93;26.04.2016;2016;04;17;Tiistai;15;8;23
93;26.04.2016;2016;04;18;Tiistai;3;9;12
93;26.04.2016;2016;04;19;Tiistai;3;6;9
93;26.04.2016;2016;04;20;Tiistai;5;4;9
93;26.04.2016;2016;04;21;Tiistai;1;1;2
93;26.04.2016;2016;04;22;Tiistai;1;0;1
93;26.04.2016;2016;04;23;Tiistai;0;0;0
93;27.04.2016;2016;04;00;Keskiviikko;0;0;0
93;27.04.2016;2016;04;01;Keskiviikko;0;0;0
93;27.04.2016;2016;04;02;Keskiviikko;0;0;0
93;27.04.2016;2016;04;03;Keskiviikko;0;0;0
93;27.04.2016;2016;04;04;Keskiviikko;2;0;2
93;27.04.2016;2016;04;05;Keskiviikko;2;1;3
93;27.04.2016;2016;04;06;Keskiviikko;10;7;17
93;27.04.2016;2016;04;07;Keskiviikko;15;25;40
93;27.04.2016;2016;04;08;Keskiviikko;3;16;19
93;27.04.2016;2016;04;09;Keskiviikko;2;4;6
93;27.04.2016;2016;04;10;Keskiviikko;5;6;11
93;27.04.2016;2016;04;11;Keskiviikko;4;0;4
93;27.04.2016;2016;04;12;Keskiviikko;4;2;6
93;27.04.2016;2016;04;13;Keskiviikko;7;6;13
93;27.04.2016;2016;04;14;Keskiviikko;11;5;16
93;27.04.2016;2016;04;15;Keskiviikko;15;11;26
93;27.04.2016;2016;04;16;Keskiviikko;21;13;34
93;27.04.2016;2016;04;17;Keskiviikko;12;8;20
93;27.04.2016;2016;04;18;Keskiviikko;5;10;15
93;27.04.2016;2016;04;19;Keskiviikko;4;9;13
93;27.04.2016;2016;04;20;Keskiviikko;4;4;8
93;27.04.2016;2016;04;21;Keskiviikko;1;4;5
93;27.04.2016;2016;04;22;Keskiviikko;1;0;1
93;27.04.2016;2016;04;23;Keskiviikko;1;1;2
93;28.04.2016;2016;04;00;Torstai;0;0;0
93;28.04.2016;2016;04;01;Torstai;0;0;0
93;28.04.2016;2016;04;02;Torstai;0;0;0
93;28.04.2016;2016;04;03;Torstai;0;0;0
93;28.04.2016;2016;04;04;Torstai;0;1;1
93;28.04.2016;2016;04;05;Torstai;0;0;0
93;28.04.2016;2016;04;06;Torstai;13;12;25
93;28.04.2016;2016;04;07;Torstai;23;24;47
93;28.04.2016;2016;04;08;Torstai;11;22;33
93;28.04.2016;2016;04;09;Torstai;8;6;14
93;28.04.2016;2016;04;10;Torstai;7;9;16
93;28.04.2016;2016;04;11;Torstai;5;7;12
93;28.04.2016;2016;04;12;Torstai;8;10;18
93;28.04.2016;2016;04;13;Torstai;9;12;21
93;28.04.2016;2016;04;14;Torstai;12;8;20
93;28.04.2016;2016;04;15;Torstai;26;19;45
93;28.04.2016;2016;04;16;Torstai;37;32;69
93;28.04.2016;2016;04;17;Torstai;25;18;43
93;28.04.2016;2016;04;18;Torstai;15;18;33
93;28.04.2016;2016;04;19;Torstai;11;14;25
93;28.04.2016;2016;04;20;Torstai;10;12;22
93;28.04.2016;2016;04;21;Torstai;1;6;7
93;28.04.2016;2016;04;22;Torstai;2;2;4
93;28.04.2016;2016;04;23;Torstai;0;1;1
93;29.04.2016;2016;04;00;Perjantai;0;1;1
93;29.04.2016;2016;04;01;Perjantai;0;0;0
93;29.04.2016;2016;04;02;Perjantai;0;0;0
93;29.04.2016;2016;04;03;Perjantai;0;0;0
93;29.04.2016;2016;04;04;Perjantai;0;0;0
93;29.04.2016;2016;04;05;Perjantai;0;3;3
93;29.04.2016;2016;04;06;Perjantai;16;11;27
93;29.04.2016;2016;04;07;Perjantai;14;24;38
93;29.04.2016;2016;04;08;Perjantai;9;23;32
93;29.04.2016;2016;04;09;Perjantai;9;5;14
93;29.04.2016;2016;04;10;Perjantai;12;8;20
93;29.04.2016;2016;04;11;Perjantai;10;11;21
93;29.04.2016;2016;04;12;Perjantai;5;3;8
93;29.04.2016;2016;04;13;Perjantai;10;8;18
93;29.04.2016;2016;04;14;Perjantai;9;3;12
93;29.04.2016;2016;04;15;Perjantai;18;19;37
93;29.04.2016;2016;04;16;Perjantai;13;14;27
93;29.04.2016;2016;04;17;Perjantai;9;8;17
93;29.04.2016;2016;04;18;Perjantai;6;13;19
93;29.04.2016;2016;04;19;Perjantai;8;3;11
93;29.04.2016;2016;04;20;Perjantai;4;12;16
93;29.04.2016;2016;04;21;Perjantai;9;3;12
93;29.04.2016;2016;04;22;Perjantai;1;2;3
93;29.04.2016;2016;04;23;Perjantai;0;1;1
93;30.04.2016;2016;04;00;Lauantai;0;3;3
93;30.04.2016;2016;04;01;Lauantai;2;0;2
93;30.04.2016;2016;04;02;Lauantai;0;1;1
93;30.04.2016;2016;04;03;Lauantai;0;0;0
93;30.04.2016;2016;04;04;Lauantai;0;0;0
93;30.04.2016;2016;04;05;Lauantai;0;2;2
93;30.04.2016;2016;04;06;Lauantai;2;1;3
93;30.04.2016;2016;04;07;Lauantai;2;4;6
93;30.04.2016;2016;04;08;Lauantai;4;5;9
93;30.04.2016;2016;04;09;Lauantai;16;5;21
93;30.04.2016;2016;04;10;Lauantai;19;18;37
93;30.04.2016;2016;04;11;Lauantai;22;27;49
93;30.04.2016;2016;04;12;Lauantai;16;24;40
93;30.04.2016;2016;04;13;Lauantai;24;28;52
93;30.04.2016;2016;04;14;Lauantai;24;11;35
93;30.04.2016;2016;04;15;Lauantai;13;14;27
93;30.04.2016;2016;04;16;Lauantai;14;24;38
93;30.04.2016;2016;04;17;Lauantai;13;13;26
93;30.04.2016;2016;04;18;Lauantai;9;12;21
93;30.04.2016;2016;04;19;Lauantai;10;11;21
93;30.04.2016;2016;04;20;Lauantai;6;5;11
93;30.04.2016;2016;04;21;Lauantai;4;5;9
93;30.04.2016;2016;04;22;Lauantai;3;4;7
93;30.04.2016;2016;04;23;Lauantai;1;1;2
93;01.05.2016;2016;05;00;Sunnuntai;1;3;4
93;01.05.2016;2016;05;01;Sunnuntai;0;10;10
93;01.05.2016;2016;05;02;Sunnuntai;0;3;3
93;01.05.2016;2016;05;03;Sunnuntai;0;0;0
93;01.05.2016;2016;05;04;Sunnuntai;0;1;1
93;01.05.2016;2016;05;05;Sunnuntai;0;2;2
93;01.05.2016;2016;05;06;Sunnuntai;1;0;1
93;01.05.2016;2016;05;07;Sunnuntai;3;2;5
93;01.05.2016;2016;05;08;Sunnuntai;4;3;7
93;01.05.2016;2016;05;09;Sunnuntai;20;8;28
93;01.05.2016;2016;05;10;Sunnuntai;14;10;24
93;01.05.2016;2016;05;11;Sunnuntai;34;23;57
93;01.05.2016;2016;05;12;Sunnuntai;73;23;96
93;01.05.2016;2016;05;13;Sunnuntai;36;57;93
93;01.05.2016;2016;05;14;Sunnuntai;28;44;72
93;01.05.2016;2016;05;15;Sunnuntai;24;47;71
93;01.05.2016;2016;05;16;Sunnuntai;18;28;46
93;01.05.2016;2016;05;17;Sunnuntai;15;27;42
93;01.05.2016;2016;05;18;Sunnuntai;17;17;34
93;01.05.2016;2016;05;19;Sunnuntai;17;10;27
93;01.05.2016;2016;05;20;Sunnuntai;9;6;15
93;01.05.2016;2016;05;21;Sunnuntai;5;3;8
93;01.05.2016;2016;05;22;Sunnuntai;1;0;1
93;01.05.2016;2016;05;23;Sunnuntai;1;2;3
93;02.05.2016;2016;05;00;Maanantai;0;0;0
93;02.05.2016;2016;05;01;Maanantai;0;0;0
93;02.05.2016;2016;05;02;Maanantai;0;0;0
93;02.05.2016;2016;05;03;Maanantai;0;0;0
93;02.05.2016;2016;05;04;Maanantai;0;0;0
93;02.05.2016;2016;05;05;Maanantai;4;2;6
93;02.05.2016;2016;05;06;Maanantai;20;11;31
93;02.05.2016;2016;05;07;Maanantai;28;27;55
93;02.05.2016;2016;05;08;Maanantai;18;26;44
93;02.05.2016;2016;05;09;Maanantai;10;62;72
93;02.05.2016;2016;05;10;Maanantai;52;2;54
93;02.05.2016;2016;05;11;Maanantai;5;7;12
93;02.05.2016;2016;05;12;Maanantai;6;6;12
93;02.05.2016;2016;05;13;Maanantai;12;5;17
93;02.05.2016;2016;05;14;Maanantai;11;16;27
93;02.05.2016;2016;05;15;Maanantai;20;21;41
93;02.05.2016;2016;05;16;Maanantai;34;39;73
93;02.05.2016;2016;05;17;Maanantai;23;23;46
93;02.05.2016;2016;05;18;Maanantai;17;26;43
93;02.05.2016;2016;05;19;Maanantai;14;20;34
93;02.05.2016;2016;05;20;Maanantai;11;9;20
93;02.05.2016;2016;05;21;Maanantai;4;13;17
93;02.05.2016;2016;05;22;Maanantai;2;5;7
93;02.05.2016;2016;05;23;Maanantai;1;0;1
93;03.05.2016;2016;05;00;Tiistai;0;0;0
93;03.05.2016;2016;05;01;Tiistai;0;1;1
93;03.05.2016;2016;05;02;Tiistai;0;0;0
93;03.05.2016;2016;05;03;Tiistai;0;0;0
93;03.05.2016;2016;05;04;Tiistai;0;0;0
93;03.05.2016;2016;05;05;Tiistai;4;1;5
93;03.05.2016;2016;05;06;Tiistai;26;14;40
93;03.05.2016;2016;05;07;Tiistai;34;38;72
93;03.05.2016;2016;05;08;Tiistai;16;25;41
93;03.05.2016;2016;05;09;Tiistai;7;4;11
93;03.05.2016;2016;05;10;Tiistai;13;6;19
93;03.05.2016;2016;05;11;Tiistai;9;11;20
93;03.05.2016;2016;05;12;Tiistai;16;14;30
93;03.05.2016;2016;05;13;Tiistai;15;10;25
93;03.05.2016;2016;05;14;Tiistai;17;15;32
93;03.05.2016;2016;05;15;Tiistai;23;25;48
93;03.05.2016;2016;05;16;Tiistai;40;45;85
93;03.05.2016;2016;05;17;Tiistai;18;38;56
93;03.05.2016;2016;05;18;Tiistai;15;20;35
93;03.05.2016;2016;05;19;Tiistai;16;14;30
93;03.05.2016;2016;05;20;Tiistai;14;19;33
93;03.05.2016;2016;05;21;Tiistai;3;12;15
93;03.05.2016;2016;05;22;Tiistai;1;1;2
93;03.05.2016;2016;05;23;Tiistai;0;1;1
93;04.05.2016;2016;05;00;Keskiviikko;0;0;0
93;04.05.2016;2016;05;01;Keskiviikko;0;0;0
93;04.05.2016;2016;05;02;Keskiviikko;0;0;0
93;04.05.2016;2016;05;03;Keskiviikko;0;0;0
93;04.05.2016;2016;05;04;Keskiviikko;1;0;1
93;04.05.2016;2016;05;05;Keskiviikko;1;1;2
93;04.05.2016;2016;05;06;Keskiviikko;25;18;43
93;04.05.2016;2016;05;07;Keskiviikko;33;29;62
93;04.05.2016;2016;05;08;Keskiviikko;15;20;35
93;04.05.2016;2016;05;09;Keskiviikko;11;7;18
93;04.05.2016;2016;05;10;Keskiviikko;7;6;13
93;04.05.2016;2016;05;11;Keskiviikko;7;15;22
93;04.05.2016;2016;05;12;Keskiviikko;9;5;14
93;04.05.2016;2016;05;13;Keskiviikko;10;11;21
93;04.05.2016;2016;05;14;Keskiviikko;11;21;32
93;04.05.2016;2016;05;15;Keskiviikko;25;27;52
93;04.05.2016;2016;05;16;Keskiviikko;34;48;82
93;04.05.2016;2016;05;17;Keskiviikko;35;34;69
93;04.05.2016;2016;05;18;Keskiviikko;10;28;38
93;04.05.2016;2016;05;19;Keskiviikko;22;21;43
93;04.05.2016;2016;05;20;Keskiviikko;16;11;27
93;04.05.2016;2016;05;21;Keskiviikko;6;7;13
93;04.05.2016;2016;05;22;Keskiviikko;5;7;12
93;04.05.2016;2016;05;23;Keskiviikko;1;1;2
93;05.05.2016;2016;05;00;Torstai;0;7;7
93;05.05.2016;2016;05;01;Torstai;2;1;3
93;05.05.2016;2016;05;02;Torstai;0;0;0
93;05.05.2016;2016;05;03;Torstai;0;1;1
93;05.05.2016;2016;05;04;Torstai;0;0;0
93;05.05.2016;2016;05;05;Torstai;1;1;2
93;05.05.2016;2016;05;06;Torstai;2;2;4
93;05.05.2016;2016;05;07;Torstai;1;4;5
93;05.05.2016;2016;05;08;Torstai;6;5;11
93;05.05.2016;2016;05;09;Torstai;14;10;24
93;05.05.2016;2016;05;10;Torstai;20;30;50
93;05.05.2016;2016;05;11;Torstai;20;31;51
93;05.05.2016;2016;05;12;Torstai;32;26;58
93;05.05.2016;2016;05;13;Torstai;34;29;63
93;05.05.2016;2016;05;14;Torstai;26;30;56
93;05.05.2016;2016;05;15;Torstai;37;34;71
93;05.05.2016;2016;05;16;Torstai;25;38;63
93;05.05.2016;2016;05;17;Torstai;16;29;45
93;05.05.2016;2016;05;18;Torstai;31;19;50
93;05.05.2016;2016;05;19;Torstai;12;20;32
93;05.05.2016;2016;05;20;Torstai;11;13;24
93;05.05.2016;2016;05;21;Torstai;9;6;15
93;05.05.2016;2016;05;22;Torstai;8;2;10
93;05.05.2016;2016;05;23;Torstai;0;0;0
93;06.05.2016;2016;05;00;Perjantai;2;2;4
93;06.05.2016;2016;05;01;Perjantai;0;1;1
93;06.05.2016;2016;05;02;Perjantai;0;0;0
93;06.05.2016;2016;05;03;Perjantai;0;0;0
93;06.05.2016;2016;05;04;Perjantai;1;0;1
93;06.05.2016;2016;05;05;Perjantai;2;3;5
93;06.05.2016;2016;05;06;Perjantai;12;13;25
93;06.05.2016;2016;05;07;Perjantai;17;28;45
93;06.05.2016;2016;05;08;Perjantai;7;24;31
93;06.05.2016;2016;05;09;Perjantai;16;4;20
93;06.05.2016;2016;05;10;Perjantai;13;10;23
93;06.05.2016;2016;05;11;Perjantai;13;22;35
93;06.05.2016;2016;05;12;Perjantai;19;8;27
93;06.05.2016;2016;05;13;Perjantai;26;13;39
93;06.05.2016;2016;05;14;Perjantai;40;31;71
93;06.05.2016;2016;05;15;Perjantai;35;41;76
93;06.05.2016;2016;05;16;Perjantai;36;33;69
93;06.05.2016;2016;05;17;Perjantai;28;27;55
93;06.05.2016;2016;05;18;Perjantai;20;25;45
93;06.05.2016;2016;05;19;Perjantai;20;13;33
93;06.05.2016;2016;05;20;Perjantai;12;12;24
93;06.05.2016;2016;05;21;Perjantai;3;6;9
93;06.05.2016;2016;05;22;Perjantai;0;2;2
93;06.05.2016;2016;05;23;Perjantai;2;0;2
93;07.05.2016;2016;05;00;Lauantai;0;0;0
93;07.05.2016;2016;05;01;Lauantai;0;3;3
93;07.05.2016;2016;05;02;Lauantai;1;0;1
93;07.05.2016;2016;05;03;Lauantai;0;3;3
93;07.05.2016;2016;05;04;Lauantai;2;2;4
93;07.05.2016;2016;05;05;Lauantai;3;2;5
93;07.05.2016;2016;05;06;Lauantai;1;3;4
93;07.05.2016;2016;05;07;Lauantai;4;1;5
93;07.05.2016;2016;05;08;Lauantai;3;6;9
93;07.05.2016;2016;05;09;Lauantai;14;8;22
93;07.05.2016;2016;05;10;Lauantai;13;20;33
93;07.05.2016;2016;05;11;Lauantai;28;15;43
93;07.05.2016;2016;05;12;Lauantai;22;18;40
93;07.05.2016;2016;05;13;Lauantai;33;23;56
93;07.05.2016;2016;05;14;Lauantai;16;32;48
93;07.05.2016;2016;05;15;Lauantai;23;30;53
93;07.05.2016;2016;05;16;Lauantai;16;26;42
93;07.05.2016;2016;05;17;Lauantai;24;34;58
93;07.05.2016;2016;05;18;Lauantai;17;26;43
93;07.05.2016;2016;05;19;Lauantai;17;28;45
93;07.05.2016;2016;05;20;Lauantai;15;7;22
93;07.05.2016;2016;05;21;Lauantai;19;15;34
93;07.05.2016;2016;05;22;Lauantai;5;3;8
93;07.05.2016;2016;05;23;Lauantai;1;3;4
93;08.05.2016;2016;05;00;Sunnuntai;1;4;5
93;08.05.2016;2016;05;01;Sunnuntai;1;0;1
93;08.05.2016;2016;05;02;Sunnuntai;1;1;2
93;08.05.2016;2016;05;03;Sunnuntai;1;0;1
93;08.05.2016;2016;05;04;Sunnuntai;0;0;0
93;08.05.2016;2016;05;05;Sunnuntai;2;0;2
93;08.05.2016;2016;05;06;Sunnuntai;3;3;6
93;08.05.2016;2016;05;07;Sunnuntai;9;3;12
93;08.05.2016;2016;05;08;Sunnuntai;7;3;10
93;08.05.2016;2016;05;09;Sunnuntai;10;9;19
93;08.05.2016;2016;05;10;Sunnuntai;26;12;38
93;08.05.2016;2016;05;11;Sunnuntai;29;39;68
93;08.05.2016;2016;05;12;Sunnuntai;31;25;56
93;08.05.2016;2016;05;13;Sunnuntai;30;29;59
93;08.05.2016;2016;05;14;Sunnuntai;29;27;56
93;08.05.2016;2016;05;15;Sunnuntai;19;25;44
93;08.05.2016;2016;05;16;Sunnuntai;17;20;37
93;08.05.2016;2016;05;17;Sunnuntai;10;27;37
93;08.05.2016;2016;05;18;Sunnuntai;25;15;40
93;08.05.2016;2016;05;19;Sunnuntai;23;16;39
93;08.05.2016;2016;05;20;Sunnuntai;9;13;22
93;08.05.2016;2016;05;21;Sunnuntai;4;14;18
93;08.05.2016;2016;05;22;Sunnuntai;2;1;3
93;08.05.2016;2016;05;23;Sunnuntai;0;0;0
93;09.05.2016;2016;05;00;Maanantai;0;0;0
93;09.05.2016;2016;05;01;Maanantai;0;0;0
93;09.05.2016;2016;05;02;Maanantai;0;0;0
93;09.05.2016;2016;05;03;Maanantai;0;0;0
93;09.05.2016;2016;05;04;Maanantai;1;0;1
93;09.05.2016;2016;05;05;Maanantai;7;1;8
93;09.05.2016;2016;05;06;Maanantai;28;18;46
93;09.05.2016;2016;05;07;Maanantai;37;41;78
93;09.05.2016;2016;05;08;Maanantai;18;25;43
93;09.05.2016;2016;05;09;Maanantai;14;12;26
93;09.05.2016;2016;05;10;Maanantai;11;5;16
93;09.05.2016;2016;05;11;Maanantai;9;10;19
93;09.05.2016;2016;05;12;Maanantai;17;14;31
93;09.05.2016;2016;05;13;Maanantai;12;11;23
93;09.05.2016;2016;05;14;Maanantai;10;26;36
93;09.05.2016;2016;05;15;Maanantai;31;24;55
93;09.05.2016;2016;05;16;Maanantai;58;35;93
93;09.05.2016;2016;05;17;Maanantai;28;38;66
93;09.05.2016;2016;05;18;Maanantai;23;19;42
93;09.05.2016;2016;05;19;Maanantai;17;18;35
93;09.05.2016;2016;05;20;Maanantai;8;16;24
93;09.05.2016;2016;05;21;Maanantai;2;9;11
93;09.05.2016;2016;05;22;Maanantai;1;3;4
93;09.05.2016;2016;05;23;Maanantai;0;0;0
93;10.05.2016;2016;05;00;Tiistai;1;0;1
93;10.05.2016;2016;05;01;Tiistai;0;0;0
93;10.05.2016;2016;05;02;Tiistai;0;1;1
93;10.05.2016;2016;05;03;Tiistai;0;0;0
93;10.05.2016;2016;05;04;Tiistai;0;0;0
93;10.05.2016;2016;05;05;Tiistai;3;0;3
93;10.05.2016;2016;05;06;Tiistai;7;8;15
93;10.05.2016;2016;05;07;Tiistai;10;15;25
93;10.05.2016;2016;05;08;Tiistai;5;12;17
93;10.05.2016;2016;05;09;Tiistai;4;0;4
93;10.05.2016;2016;05;10;Tiistai;3;4;7
93;10.05.2016;2016;05;11;Tiistai;5;5;10
93;10.05.2016;2016;05;12;Tiistai;1;0;1
93;10.05.2016;2016;05;13;Tiistai;3;4;7
93;10.05.2016;2016;05;14;Tiistai;1;9;10
93;10.05.2016;2016;05;15;Tiistai;11;10;21
93;10.05.2016;2016;05;16;Tiistai;21;13;34
93;10.05.2016;2016;05;17;Tiistai;10;7;17
93;10.05.2016;2016;05;18;Tiistai;11;11;22
93;10.05.2016;2016;05;19;Tiistai;10;8;18
93;10.05.2016;2016;05;20;Tiistai;6;10;16
93;10.05.2016;2016;05;21;Tiistai;6;4;10
93;10.05.2016;2016;05;22;Tiistai;0;4;4
93;10.05.2016;2016;05;23;Tiistai;0;0;0
93;11.05.2016;2016;05;00;Keskiviikko;0;0;0
93;11.05.2016;2016;05;01;Keskiviikko;0;0;0
93;11.05.2016;2016;05;02;Keskiviikko;0;0;0
93;11.05.2016;2016;05;03;Keskiviikko;0;1;1
93;11.05.2016;2016;05;04;Keskiviikko;0;0;0
93;11.05.2016;2016;05;05;Keskiviikko;2;2;4
93;11.05.2016;2016;05;06;Keskiviikko;25;15;40
93;11.05.2016;2016;05;07;Keskiviikko;33;35;68
93;11.05.2016;2016;05;08;Keskiviikko;19;29;48
93;11.05.2016;2016;05;09;Keskiviikko;16;11;27
93;11.05.2016;2016;05;10;Keskiviikko;18;11;29
93;11.05.2016;2016;05;11;Keskiviikko;12;6;18
93;11.05.2016;2016;05;12;Keskiviikko;5;9;14
93;11.05.2016;2016;05;13;Keskiviikko;12;16;28
93;11.05.2016;2016;05;14;Keskiviikko;10;20;30
93;11.05.2016;2016;05;15;Keskiviikko;23;28;51
93;11.05.2016;2016;05;16;Keskiviikko;43;40;83
93;11.05.2016;2016;05;17;Keskiviikko;35;27;62
93;11.05.2016;2016;05;18;Keskiviikko;15;21;36
93;11.05.2016;2016;05;19;Keskiviikko;19;23;42
93;11.05.2016;2016;05;20;Keskiviikko;11;12;23
93;11.05.2016;2016;05;21;Keskiviikko;6;4;10
93;11.05.2016;2016;05;22;Keskiviikko;3;4;7
93;11.05.2016;2016;05;23;Keskiviikko;1;3;4
93;12.05.2016;2016;05;00;Torstai;1;0;1
93;12.05.2016;2016;05;01;Torstai;0;1;1
93;12.05.2016;2016;05;02;Torstai;0;0;0
93;12.05.2016;2016;05;03;Torstai;0;0;0
93;12.05.2016;2016;05;04;Torstai;1;0;1
93;12.05.2016;2016;05;05;Torstai;4;4;8
93;12.05.2016;2016;05;06;Torstai;24;12;36
93;12.05.2016;2016;05;07;Torstai;36;32;68
93;12.05.2016;2016;05;08;Torstai;18;22;40
93;12.05.2016;2016;05;09;Torstai;15;7;22
93;12.05.2016;2016;05;10;Torstai;12;8;20
93;12.05.2016;2016;05;11;Torstai;14;10;24
93;12.05.2016;2016;05;12;Torstai;13;16;29
93;12.05.2016;2016;05;13;Torstai;15;19;34
93;12.05.2016;2016;05;14;Torstai;15;19;34
93;12.05.2016;2016;05;15;Torstai;27;31;58
93;12.05.2016;2016;05;16;Torstai;42;36;78
93;12.05.2016;2016;05;17;Torstai;28;31;59
93;12.05.2016;2016;05;18;Torstai;26;23;49
93;12.05.2016;2016;05;19;Torstai;15;31;46
93;12.05.2016;2016;05;20;Torstai;14;11;25
93;12.05.2016;2016;05;21;Torstai;5;11;16
93;12.05.2016;2016;05;22;Torstai;1;3;4
93;12.05.2016;2016;05;23;Torstai;1;1;2
93;13.05.2016;2016;05;00;Perjantai;1;0;1
93;13.05.2016;2016;05;01;Perjantai;0;1;1
93;13.05.2016;2016;05;02;Perjantai;0;0;0
93;13.05.2016;2016;05;03;Perjantai;0;0;0
93;13.05.2016;2016;05;04;Perjantai;1;0;1
93;13.05.2016;2016;05;05;Perjantai;3;1;4
93;13.05.2016;2016;05;06;Perjantai;17;14;31
93;13.05.2016;2016;05;07;Perjantai;24;37;61
93;13.05.2016;2016;05;08;Perjantai;15;19;34
93;13.05.2016;2016;05;09;Perjantai;6;5;11
93;13.05.2016;2016;05;10;Perjantai;17;11;28
93;13.05.2016;2016;05;11;Perjantai;7;5;12
93;13.05.2016;2016;05;12;Perjantai;15;9;24
93;13.05.2016;2016;05;13;Perjantai;9;13;22
93;13.05.2016;2016;05;14;Perjantai;22;7;29
93;13.05.2016;2016;05;15;Perjantai;33;25;58
93;13.05.2016;2016;05;16;Perjantai;34;24;58
93;13.05.2016;2016;05;17;Perjantai;9;19;28
93;13.05.2016;2016;05;18;Perjantai;6;15;21
93;13.05.2016;2016;05;19;Perjantai;10;12;22
93;13.05.2016;2016;05;20;Perjantai;2;6;8
93;13.05.2016;2016;05;21;Perjantai;2;9;11
93;13.05.2016;2016;05;22;Perjantai;2;0;2
93;13.05.2016;2016;05;23;Perjantai;1;1;2
93;14.05.2016;2016;05;00;Lauantai;1;1;2
93;14.05.2016;2016;05;01;Lauantai;1;2;3
93;14.05.2016;2016;05;02;Lauantai;0;0;0
93;14.05.2016;2016;05;03;Lauantai;1;2;3
93;14.05.2016;2016;05;04;Lauantai;0;0;0
93;14.05.2016;2016;05;05;Lauantai;1;0;1
93;14.05.2016;2016;05;06;Lauantai;1;0;1
93;14.05.2016;2016;05;07;Lauantai;5;3;8
93;14.05.2016;2016;05;08;Lauantai;5;5;10
93;14.05.2016;2016;05;09;Lauantai;6;11;17
93;14.05.2016;2016;05;10;Lauantai;17;5;22
93;14.05.2016;2016;05;11;Lauantai;9;7;16
93;14.05.2016;2016;05;12;Lauantai;9;7;16
93;14.05.2016;2016;05;13;Lauantai;12;12;24
93;14.05.2016;2016;05;14;Lauantai;5;5;10
93;14.05.2016;2016;05;15;Lauantai;16;14;30
93;14.05.2016;2016;05;16;Lauantai;17;13;30
93;14.05.2016;2016;05;17;Lauantai;9;14;23
93;14.05.2016;2016;05;18;Lauantai;9;10;19
93;14.05.2016;2016;05;19;Lauantai;6;13;19
93;14.05.2016;2016;05;20;Lauantai;10;4;14
93;14.05.2016;2016;05;21;Lauantai;6;6;12
93;14.05.2016;2016;05;22;Lauantai;2;4;6
93;14.05.2016;2016;05;23;Lauantai;2;0;2
93;15.05.2016;2016;05;00;Sunnuntai;2;1;3
93;15.05.2016;2016;05;01;Sunnuntai;0;0;0
93;15.05.2016;2016;05;02;Sunnuntai;0;0;0
93;15.05.2016;2016;05;03;Sunnuntai;0;0;0
93;15.05.2016;2016;05;04;Sunnuntai;0;1;1
93;15.05.2016;2016;05;05;Sunnuntai;1;1;2
93;15.05.2016;2016;05;06;Sunnuntai;3;0;3
93;15.05.2016;2016;05;07;Sunnuntai;6;1;7
93;15.05.2016;2016;05;08;Sunnuntai;2;5;7
93;15.05.2016;2016;05;09;Sunnuntai;7;6;13
93;15.05.2016;2016;05;10;Sunnuntai;17;13;30
93;15.05.2016;2016;05;11;Sunnuntai;14;12;26
93;15.05.2016;2016;05;12;Sunnuntai;10;17;27
93;15.05.2016;2016;05;13;Sunnuntai;12;9;21
93;15.05.2016;2016;05;14;Sunnuntai;4;6;10
93;15.05.2016;2016;05;15;Sunnuntai;3;8;11
93;15.05.2016;2016;05;16;Sunnuntai;7;3;10
93;15.05.2016;2016;05;17;Sunnuntai;9;7;16
93;15.05.2016;2016;05;18;Sunnuntai;16;3;19
93;15.05.2016;2016;05;19;Sunnuntai;8;7;15
93;15.05.2016;2016;05;20;Sunnuntai;5;6;11
93;15.05.2016;2016;05;21;Sunnuntai;0;2;2
93;15.05.2016;2016;05;22;Sunnuntai;1;2;3
93;15.05.2016;2016;05;23;Sunnuntai;0;0;0
93;16.05.2016;2016;05;00;Maanantai;0;2;2
93;16.05.2016;2016;05;01;Maanantai;0;0;0
93;16.05.2016;2016;05;02;Maanantai;0;0;0
93;16.05.2016;2016;05;03;Maanantai;0;0;0
93;16.05.2016;2016;05;04;Maanantai;1;0;1
93;16.05.2016;2016;05;05;Maanantai;4;5;9
93;16.05.2016;2016;05;06;Maanantai;19;12;31
93;16.05.2016;2016;05;07;Maanantai;36;32;68
93;16.05.2016;2016;05;08;Maanantai;21;31;52
93;16.05.2016;2016;05;09;Maanantai;11;15;26
93;16.05.2016;2016;05;10;Maanantai;12;8;20
93;16.05.2016;2016;05;11;Maanantai;8;6;14
93;16.05.2016;2016;05;12;Maanantai;10;7;17
93;16.05.2016;2016;05;13;Maanantai;12;19;31
93;16.05.2016;2016;05;14;Maanantai;25;21;46
93;16.05.2016;2016;05;15;Maanantai;29;35;64
93;16.05.2016;2016;05;16;Maanantai;48;44;92
93;16.05.2016;2016;05;17;Maanantai;22;28;50
93;16.05.2016;2016;05;18;Maanantai;28;35;63
93;16.05.2016;2016;05;19;Maanantai;22;31;53
93;16.05.2016;2016;05;20;Maanantai;14;15;29
93;16.05.2016;2016;05;21;Maanantai;6;12;18
93;16.05.2016;2016;05;22;Maanantai;4;3;7
93;16.05.2016;2016;05;23;Maanantai;2;2;4
93;17.05.2016;2016;05;00;Tiistai;0;2;2
93;17.05.2016;2016;05;01;Tiistai;0;0;0
93;17.05.2016;2016;05;02;Tiistai;0;1;1
93;17.05.2016;2016;05;03;Tiistai;0;0;0
93;17.05.2016;2016;05;04;Tiistai;1;0;1
93;17.05.2016;2016;05;05;Tiistai;4;3;7
93;17.05.2016;2016;05;06;Tiistai;12;13;25
93;17.05.2016;2016;05;07;Tiistai;22;20;42
93;17.05.2016;2016;05;08;Tiistai;9;16;25
93;17.05.2016;2016;05;09;Tiistai;2;3;5
93;17.05.2016;2016;05;10;Tiistai;0;2;2
93;17.05.2016;2016;05;11;Tiistai;1;1;2
93;17.05.2016;2016;05;12;Tiistai;2;0;2
93;17.05.2016;2016;05;13;Tiistai;6;5;11
93;17.05.2016;2016;05;14;Tiistai;6;3;9
93;17.05.2016;2016;05;15;Tiistai;12;17;29
93;17.05.2016;2016;05;16;Tiistai;27;19;46
93;17.05.2016;2016;05;17;Tiistai;19;19;38
93;17.05.2016;2016;05;18;Tiistai;17;16;33
93;17.05.2016;2016;05;19;Tiistai;15;11;26
93;17.05.2016;2016;05;20;Tiistai;7;8;15
93;17.05.2016;2016;05;21;Tiistai;2;2;4
93;17.05.2016;2016;05;22;Tiistai;2;2;4
93;17.05.2016;2016;05;23;Tiistai;2;2;4
93;18.05.2016;2016;05;00;Keskiviikko;0;0;0
93;18.05.2016;2016;05;01;Keskiviikko;0;0;0
93;18.05.2016;2016;05;02;Keskiviikko;0;0;0
93;18.05.2016;2016;05;03;Keskiviikko;0;0;0
93;18.05.2016;2016;05;04;Keskiviikko;1;0;1
93;18.05.2016;2016;05;05;Keskiviikko;4;4;8
93;18.05.2016;2016;05;06;Keskiviikko;26;14;40
93;18.05.2016;2016;05;07;Keskiviikko;37;35;72
93;18.05.2016;2016;05;08;Keskiviikko;17;31;48
93;18.05.2016;2016;05;09;Keskiviikko;13;6;19
93;18.05.2016;2016;05;10;Keskiviikko;14;12;26
93;18.05.2016;2016;05;11;Keskiviikko;9;14;23
93;18.05.2016;2016;05;12;Keskiviikko;7;11;18
93;18.05.2016;2016;05;13;Keskiviikko;5;13;18
93;18.05.2016;2016;05;14;Keskiviikko;16;10;26
93;18.05.2016;2016;05;15;Keskiviikko;14;30;44
93;18.05.2016;2016;05;16;Keskiviikko;34;27;61
93;18.05.2016;2016;05;17;Keskiviikko;13;11;24
93;18.05.2016;2016;05;18;Keskiviikko;6;16;22
93;18.05.2016;2016;05;19;Keskiviikko;2;4;6
93;18.05.2016;2016;05;20;Keskiviikko;2;5;7
93;18.05.2016;2016;05;21;Keskiviikko;0;4;4
93;18.05.2016;2016;05;22;Keskiviikko;3;3;6
93;18.05.2016;2016;05;23;Keskiviikko;0;0;0
93;19.05.2016;2016;05;00;Torstai;0;0;0
93;19.05.2016;2016;05;01;Torstai;0;0;0
93;19.05.2016;2016;05;02;Torstai;0;0;0
93;19.05.2016;2016;05;03;Torstai;0;0;0
93;19.05.2016;2016;05;04;Torstai;0;0;0
93;19.05.2016;2016;05;05;Torstai;2;1;3
93;19.05.2016;2016;05;06;Torstai;12;5;17
93;19.05.2016;2016;05;07;Torstai;21;24;45
93;19.05.2016;2016;05;08;Torstai;10;20;30
93;19.05.2016;2016;05;09;Torstai;6;3;9
93;19.05.2016;2016;05;10;Torstai;6;5;11
93;19.05.2016;2016;05;11;Torstai;4;4;8
93;19.05.2016;2016;05;12;Torstai;4;2;6
93;19.05.2016;2016;05;13;Torstai;13;21;34
93;19.05.2016;2016;05;14;Torstai;10;13;23
93;19.05.2016;2016;05;15;Torstai;33;6;39
93;19.05.2016;2016;05;16;Torstai;29;23;52
93;19.05.2016;2016;05;17;Torstai;8;9;17
93;19.05.2016;2016;05;18;Torstai;7;6;13
93;19.05.2016;2016;05;19;Torstai;6;10;16
93;19.05.2016;2016;05;20;Torstai;1;9;10
93;19.05.2016;2016;05;21;Torstai;2;7;9
93;19.05.2016;2016;05;22;Torstai;1;5;6
93;19.05.2016;2016;05;23;Torstai;0;3;3
93;20.05.2016;2016;05;00;Perjantai;0;0;0
93;20.05.2016;2016;05;01;Perjantai;0;0;0
93;20.05.2016;2016;05;02;Perjantai;0;0;0
93;20.05.2016;2016;05;03;Perjantai;0;1;1
93;20.05.2016;2016;05;04;Perjantai;0;1;1
93;20.05.2016;2016;05;05;Perjantai;3;5;8
93;20.05.2016;2016;05;06;Perjantai;23;12;35
93;20.05.2016;2016;05;07;Perjantai;21;36;57
93;20.05.2016;2016;05;08;Perjantai;25;25;50
93;20.05.2016;2016;05;09;Perjantai;15;12;27
93;20.05.2016;2016;05;10;Perjantai;10;11;21
93;20.05.2016;2016;05;11;Perjantai;12;15;27
93;20.05.2016;2016;05;12;Perjantai;19;17;36
93;20.05.2016;2016;05;13;Perjantai;12;10;22
93;20.05.2016;2016;05;14;Perjantai;22;25;47
93;20.05.2016;2016;05;15;Perjantai;40;29;69
93;20.05.2016;2016;05;16;Perjantai;40;31;71
93;20.05.2016;2016;05;17;Perjantai;30;22;52
93;20.05.2016;2016;05;18;Perjantai;23;33;56
93;20.05.2016;2016;05;19;Perjantai;17;14;31
93;20.05.2016;2016;05;20;Perjantai;17;10;27
93;20.05.2016;2016;05;21;Perjantai;3;18;21
93;20.05.2016;2016;05;22;Perjantai;8;10;18
93;20.05.2016;2016;05;23;Perjantai;4;2;6
93;21.05.2016;2016;05;00;Lauantai;2;0;2
93;21.05.2016;2016;05;01;Lauantai;2;2;4
93;21.05.2016;2016;05;02;Lauantai;1;2;3
93;21.05.2016;2016;05;03;Lauantai;0;1;1
93;21.05.2016;2016;05;04;Lauantai;0;0;0
93;21.05.2016;2016;05;05;Lauantai;1;1;2
93;21.05.2016;2016;05;06;Lauantai;3;3;6
93;21.05.2016;2016;05;07;Lauantai;2;3;5
93;21.05.2016;2016;05;08;Lauantai;10;6;16
93;21.05.2016;2016;05;09;Lauantai;21;28;49
93;21.05.2016;2016;05;10;Lauantai;25;34;59
93;21.05.2016;2016;05;11;Lauantai;35;31;66
93;21.05.2016;2016;05;12;Lauantai;34;30;64
93;21.05.2016;2016;05;13;Lauantai;23;31;54
93;21.05.2016;2016;05;14;Lauantai;20;24;44
93;21.05.2016;2016;05;15;Lauantai;20;34;54
93;21.05.2016;2016;05;16;Lauantai;16;17;33
93;21.05.2016;2016;05;17;Lauantai;6;17;23
93;21.05.2016;2016;05;18;Lauantai;13;6;19
93;21.05.2016;2016;05;19;Lauantai;14;10;24
93;21.05.2016;2016;05;20;Lauantai;4;5;9
93;21.05.2016;2016;05;21;Lauantai;8;8;16
93;21.05.2016;2016;05;22;Lauantai;3;8;11
93;21.05.2016;2016;05;23;Lauantai;2;1;3
93;22.05.2016;2016;05;00;Sunnuntai;0;0;0
93;22.05.2016;2016;05;01;Sunnuntai;0;0;0
93;22.05.2016;2016;05;02;Sunnuntai;0;3;3
93;22.05.2016;2016;05;03;Sunnuntai;0;0;0
93;22.05.2016;2016;05;04;Sunnuntai;0;0;0
93;22.05.2016;2016;05;05;Sunnuntai;4;1;5
93;22.05.2016;2016;05;06;Sunnuntai;2;1;3
93;22.05.2016;2016;05;07;Sunnuntai;2;0;2
93;22.05.2016;2016;05;08;Sunnuntai;4;5;9
93;22.05.2016;2016;05;09;Sunnuntai;11;16;27
93;22.05.2016;2016;05;10;Sunnuntai;11;22;33
93;22.05.2016;2016;05;11;Sunnuntai;27;14;41
93;22.05.2016;2016;05;12;Sunnuntai;35;33;68
93;22.05.2016;2016;05;13;Sunnuntai;23;37;60
93;22.05.2016;2016;05;14;Sunnuntai;23;39;62
93;22.05.2016;2016;05;15;Sunnuntai;32;35;67
93;22.05.2016;2016;05;16;Sunnuntai;33;27;60
93;22.05.2016;2016;05;17;Sunnuntai;22;21;43
93;22.05.2016;2016;05;18;Sunnuntai;26;18;44
93;22.05.2016;2016;05;19;Sunnuntai;14;13;27
93;22.05.2016;2016;05;20;Sunnuntai;19;5;24
93;22.05.2016;2016;05;21;Sunnuntai;7;7;14
93;22.05.2016;2016;05;22;Sunnuntai;0;1;1
93;22.05.2016;2016;05;23;Sunnuntai;4;5;9
93;23.05.2016;2016;05;00;Maanantai;0;1;1
93;23.05.2016;2016;05;01;Maanantai;0;2;2
93;23.05.2016;2016;05;02;Maanantai;0;1;1
93;23.05.2016;2016;05;03;Maanantai;0;0;0
93;23.05.2016;2016;05;04;Maanantai;0;0;0
93;23.05.2016;2016;05;05;Maanantai;7;2;9
93;23.05.2016;2016;05;06;Maanantai;23;14;37
93;23.05.2016;2016;05;07;Maanantai;41;43;84
93;23.05.2016;2016;05;08;Maanantai;23;34;57
93;23.05.2016;2016;05;09;Maanantai;16;14;30
93;23.05.2016;2016;05;10;Maanantai;15;9;24
93;23.05.2016;2016;05;11;Maanantai;14;8;22
93;23.05.2016;2016;05;12;Maanantai;20;16;36
93;23.05.2016;2016;05;13;Maanantai;17;20;37
93;23.05.2016;2016;05;14;Maanantai;19;24;43
93;23.05.2016;2016;05;15;Maanantai;27;34;61
93;23.05.2016;2016;05;16;Maanantai;62;52;114
93;23.05.2016;2016;05;17;Maanantai;32;38;70
93;23.05.2016;2016;05;18;Maanantai;34;41;75
93;23.05.2016;2016;05;19;Maanantai;35;43;78
93;23.05.2016;2016;05;20;Maanantai;19;13;32
93;23.05.2016;2016;05;21;Maanantai;10;15;25
93;23.05.2016;2016;05;22;Maanantai;5;11;16
93;23.05.2016;2016;05;23;Maanantai;2;2;4
93;24.05.2016;2016;05;00;Tiistai;2;1;3
93;24.05.2016;2016;05;01;Tiistai;0;0;0
93;24.05.2016;2016;05;02;Tiistai;0;0;0
93;24.05.2016;2016;05;03;Tiistai;0;0;0
93;24.05.2016;2016;05;04;Tiistai;1;0;1
93;24.05.2016;2016;05;05;Tiistai;9;2;11
93;24.05.2016;2016;05;06;Tiistai;28;16;44
93;24.05.2016;2016;05;07;Tiistai;42;39;81
93;24.05.2016;2016;05;08;Tiistai;26;36;62
93;24.05.2016;2016;05;09;Tiistai;24;18;42
93;24.05.2016;2016;05;10;Tiistai;13;10;23
93;24.05.2016;2016;05;11;Tiistai;20;21;41
93;24.05.2016;2016;05;12;Tiistai;9;37;46
93;24.05.2016;2016;05;13;Tiistai;20;22;42
93;24.05.2016;2016;05;14;Tiistai;21;22;43
93;24.05.2016;2016;05;15;Tiistai;22;34;56
93;24.05.2016;2016;05;16;Tiistai;40;42;82
93;24.05.2016;2016;05;17;Tiistai;18;11;29
93;24.05.2016;2016;05;18;Tiistai;13;17;30
93;24.05.2016;2016;05;19;Tiistai;7;9;16
93;24.05.2016;2016;05;20;Tiistai;12;7;19
93;24.05.2016;2016;05;21;Tiistai;4;7;11
93;24.05.2016;2016;05;22;Tiistai;4;9;13
93;24.05.2016;2016;05;23;Tiistai;0;3;3
93;25.05.2016;2016;05;00;Keskiviikko;1;2;3
93;25.05.2016;2016;05;01;Keskiviikko;0;0;0
93;25.05.2016;2016;05;02;Keskiviikko;0;0;0
93;25.05.2016;2016;05;03;Keskiviikko;0;0;0
93;25.05.2016;2016;05;04;Keskiviikko;0;0;0
93;25.05.2016;2016;05;05;Keskiviikko;7;1;8
93;25.05.2016;2016;05;06;Keskiviikko;14;12;26
93;25.05.2016;2016;05;07;Keskiviikko;18;24;42
93;25.05.2016;2016;05;08;Keskiviikko;14;20;34
93;25.05.2016;2016;05;09;Keskiviikko;8;6;14
93;25.05.2016;2016;05;10;Keskiviikko;8;13;21
93;25.05.2016;2016;05;11;Keskiviikko;7;4;11
93;25.05.2016;2016;05;12;Keskiviikko;5;6;11
93;25.05.2016;2016;05;13;Keskiviikko;10;9;19
93;25.05.2016;2016;05;14;Keskiviikko;13;12;25
93;25.05.2016;2016;05;15;Keskiviikko;15;12;27
93;25.05.2016;2016;05;16;Keskiviikko;27;21;48
93;25.05.2016;2016;05;17;Keskiviikko;11;16;27
93;25.05.2016;2016;05;18;Keskiviikko;10;6;16
93;25.05.2016;2016;05;19;Keskiviikko;17;11;28
93;25.05.2016;2016;05;20;Keskiviikko;7;9;16
93;25.05.2016;2016;05;21;Keskiviikko;0;7;7
93;25.05.2016;2016;05;22;Keskiviikko;1;6;7
93;25.05.2016;2016;05;23;Keskiviikko;0;3;3
93;26.05.2016;2016;05;00;Torstai;1;0;1
93;26.05.2016;2016;05;01;Torstai;1;0;1
93;26.05.2016;2016;05;02;Torstai;0;0;0
93;26.05.2016;2016;05;03;Torstai;0;0;0
93;26.05.2016;2016;05;04;Torstai;0;0;0
93;26.05.2016;2016;05;05;Torstai;3;2;5
93;26.05.2016;2016;05;06;Torstai;21;14;35
93;26.05.2016;2016;05;07;Torstai;35;32;67
93;26.05.2016;2016;05;08;Torstai;29;25;54
93;26.05.2016;2016;05;09;Torstai;8;10;18
93;26.05.2016;2016;05;10;Torstai;7;4;11
93;26.05.2016;2016;05;11;Torstai;7;9;16
93;26.05.2016;2016;05;12;Torstai;9;6;15
93;26.05.2016;2016;05;13;Torstai;32;10;42
93;26.05.2016;2016;05;14;Torstai;8;14;22
93;26.05.2016;2016;05;15;Torstai;18;24;42
93;26.05.2016;2016;05;16;Torstai;38;41;79
93;26.05.2016;2016;05;17;Torstai;19;21;40
93;26.05.2016;2016;05;18;Torstai;12;26;38
93;26.05.2016;2016;05;19;Torstai;15;16;31
93;26.05.2016;2016;05;20;Torstai;13;20;33
93;26.05.2016;2016;05;21;Torstai;7;16;23
93;26.05.2016;2016;05;22;Torstai;2;4;6
93;26.05.2016;2016;05;23;Torstai;3;1;4
93;27.05.2016;2016;05;00;Perjantai;1;0;1
93;27.05.2016;2016;05;01;Perjantai;0;1;1
93;27.05.2016;2016;05;02;Perjantai;0;0;0
93;27.05.2016;2016;05;03;Perjantai;0;0;0
93;27.05.2016;2016;05;04;Perjantai;1;0;1
93;27.05.2016;2016;05;05;Perjantai;5;3;8
93;27.05.2016;2016;05;06;Perjantai;28;9;37
93;27.05.2016;2016;05;07;Perjantai;34;42;76
93;27.05.2016;2016;05;08;Perjantai;28;27;55
93;27.05.2016;2016;05;09;Perjantai;11;14;25
93;27.05.2016;2016;05;10;Perjantai;13;18;31
93;27.05.2016;2016;05;11;Perjantai;13;12;25
93;27.05.2016;2016;05;12;Perjantai;15;15;30
93;27.05.2016;2016;05;13;Perjantai;12;24;36
93;27.05.2016;2016;05;14;Perjantai;27;26;53
93;27.05.2016;2016;05;15;Perjantai;35;35;70
93;27.05.2016;2016;05;16;Perjantai;42;28;70
93;27.05.2016;2016;05;17;Perjantai;27;24;51
93;27.05.2016;2016;05;18;Perjantai;15;28;43
93;27.05.2016;2016;05;19;Perjantai;16;23;39
93;27.05.2016;2016;05;20;Perjantai;17;13;30
93;27.05.2016;2016;05;21;Perjantai;6;9;15
93;27.05.2016;2016;05;22;Perjantai;4;6;10
93;27.05.2016;2016;05;23;Perjantai;7;2;9
93;28.05.2016;2016;05;00;Lauantai;3;6;9
93;28.05.2016;2016;05;01;Lauantai;1;4;5
93;28.05.2016;2016;05;02;Lauantai;0;2;2
93;28.05.2016;2016;05;03;Lauantai;0;0;0
93;28.05.2016;2016;05;04;Lauantai;1;1;2
93;28.05.2016;2016;05;05;Lauantai;2;1;3
93;28.05.2016;2016;05;06;Lauantai;4;2;6
93;28.05.2016;2016;05;07;Lauantai;6;4;10
93;28.05.2016;2016;05;08;Lauantai;4;24;28
93;28.05.2016;2016;05;09;Lauantai;19;21;40
93;28.05.2016;2016;05;10;Lauantai;28;28;56
93;28.05.2016;2016;05;11;Lauantai;34;31;65
93;28.05.2016;2016;05;12;Lauantai;29;33;62
93;28.05.2016;2016;05;13;Lauantai;49;36;85
93;28.05.2016;2016;05;14;Lauantai;25;40;65
93;28.05.2016;2016;05;15;Lauantai;39;32;71
93;28.05.2016;2016;05;16;Lauantai;27;37;64
93;28.05.2016;2016;05;17;Lauantai;25;30;55
93;28.05.2016;2016;05;18;Lauantai;30;31;61
93;28.05.2016;2016;05;19;Lauantai;29;24;53
93;28.05.2016;2016;05;20;Lauantai;14;27;41
93;28.05.2016;2016;05;21;Lauantai;13;6;19
93;28.05.2016;2016;05;22;Lauantai;5;5;10
93;28.05.2016;2016;05;23;Lauantai;6;5;11
93;29.05.2016;2016;05;00;Sunnuntai;1;2;3
93;29.05.2016;2016;05;01;Sunnuntai;1;1;2
93;29.05.2016;2016;05;02;Sunnuntai;2;1;3
93;29.05.2016;2016;05;03;Sunnuntai;1;5;6
93;29.05.2016;2016;05;04;Sunnuntai;2;3;5
93;29.05.2016;2016;05;05;Sunnuntai;1;1;2
93;29.05.2016;2016;05;06;Sunnuntai;3;2;5
93;29.05.2016;2016;05;07;Sunnuntai;1;1;2
93;29.05.2016;2016;05;08;Sunnuntai;14;8;22
93;29.05.2016;2016;05;09;Sunnuntai;25;20;45
93;29.05.2016;2016;05;10;Sunnuntai;38;35;73
93;29.05.2016;2016;05;11;Sunnuntai;50;43;93
93;29.05.2016;2016;05;12;Sunnuntai;57;50;107
93;29.05.2016;2016;05;13;Sunnuntai;36;44;80
93;29.05.2016;2016;05;14;Sunnuntai;40;62;102
93;29.05.2016;2016;05;15;Sunnuntai;36;33;69
93;29.05.2016;2016;05;16;Sunnuntai;30;31;61
93;29.05.2016;2016;05;17;Sunnuntai;36;29;65
93;29.05.2016;2016;05;18;Sunnuntai;24;29;53
93;29.05.2016;2016;05;19;Sunnuntai;38;28;66
93;29.05.2016;2016;05;20;Sunnuntai;9;17;26
93;29.05.2016;2016;05;21;Sunnuntai;9;16;25
93;29.05.2016;2016;05;22;Sunnuntai;9;5;14
93;29.05.2016;2016;05;23;Sunnuntai;3;1;4
93;30.05.2016;2016;05;00;Maanantai;2;0;2
93;30.05.2016;2016;05;01;Maanantai;0;1;1
93;30.05.2016;2016;05;02;Maanantai;0;1;1
93;30.05.2016;2016;05;03;Maanantai;0;0;0
93;30.05.2016;2016;05;04;Maanantai;0;0;0
93;30.05.2016;2016;05;05;Maanantai;6;1;7
93;30.05.2016;2016;05;06;Maanantai;37;14;51
93;30.05.2016;2016;05;07;Maanantai;48;41;89
93;30.05.2016;2016;05;08;Maanantai;27;40;67
93;30.05.2016;2016;05;09;Maanantai;13;17;30
93;30.05.2016;2016;05;10;Maanantai;17;19;36
93;30.05.2016;2016;05;11;Maanantai;15;14;29
93;30.05.2016;2016;05;12;Maanantai;18;19;37
93;30.05.2016;2016;05;13;Maanantai;26;20;46
93;30.05.2016;2016;05;14;Maanantai;26;24;50
93;30.05.2016;2016;05;15;Maanantai;34;57;91
93;30.05.2016;2016;05;16;Maanantai;71;49;120
93;30.05.2016;2016;05;17;Maanantai;40;57;97
93;30.05.2016;2016;05;18;Maanantai;24;52;76
93;30.05.2016;2016;05;19;Maanantai;36;39;75
93;30.05.2016;2016;05;20;Maanantai;15;21;36
93;30.05.2016;2016;05;21;Maanantai;10;24;34
93;30.05.2016;2016;05;22;Maanantai;3;6;9
93;30.05.2016;2016;05;23;Maanantai;1;4;5
93;31.05.2016;2016;05;00;Tiistai;0;1;1
93;31.05.2016;2016;05;01;Tiistai;0;0;0
93;31.05.2016;2016;05;02;Tiistai;1;0;1
93;31.05.2016;2016;05;03;Tiistai;0;0;0
93;31.05.2016;2016;05;04;Tiistai;0;0;0
93;31.05.2016;2016;05;05;Tiistai;6;3;9
93;31.05.2016;2016;05;06;Tiistai;28;14;42
93;31.05.2016;2016;05;07;Tiistai;42;57;99
93;31.05.2016;2016;05;08;Tiistai;33;31;64
93;31.05.2016;2016;05;09;Tiistai;22;20;42
93;31.05.2016;2016;05;10;Tiistai;19;14;33
93;31.05.2016;2016;05;11;Tiistai;20;11;31
93;31.05.2016;2016;05;12;Tiistai;22;29;51
93;31.05.2016;2016;05;13;Tiistai;24;37;61
93;31.05.2016;2016;05;14;Tiistai;23;30;53
93;31.05.2016;2016;05;15;Tiistai;48;39;87
93;31.05.2016;2016;05;16;Tiistai;58;58;116
93;31.05.2016;2016;05;17;Tiistai;36;41;77
93;31.05.2016;2016;05;18;Tiistai;33;45;78
93;31.05.2016;2016;05;19;Tiistai;39;29;68
93;31.05.2016;2016;05;20;Tiistai;27;43;70
93;31.05.2016;2016;05;21;Tiistai;14;21;35
93;31.05.2016;2016;05;22;Tiistai;5;12;17
93;31.05.2016;2016;05;23;Tiistai;1;7;8
93;01.06.2016;2016;06;00;Keskiviikko;0;0;0
93;01.06.2016;2016;06;01;Keskiviikko;0;1;1
93;01.06.2016;2016;06;02;Keskiviikko;0;0;0
93;01.06.2016;2016;06;03;Keskiviikko;0;0;0
93;01.06.2016;2016;06;04;Keskiviikko;0;0;0
93;01.06.2016;2016;06;05;Keskiviikko;5;4;9
93;01.06.2016;2016;06;06;Keskiviikko;31;20;51
93;01.06.2016;2016;06;07;Keskiviikko;45;44;89
93;01.06.2016;2016;06;08;Keskiviikko;23;38;61
93;01.06.2016;2016;06;09;Keskiviikko;16;14;30
93;01.06.2016;2016;06;10;Keskiviikko;11;7;18
93;01.06.2016;2016;06;11;Keskiviikko;9;1;10
93;01.06.2016;2016;06;12;Keskiviikko;3;6;9
93;01.06.2016;2016;06;13;Keskiviikko;12;12;24
93;01.06.2016;2016;06;14;Keskiviikko;10;20;30
93;01.06.2016;2016;06;15;Keskiviikko;30;35;65
93;01.06.2016;2016;06;16;Keskiviikko;51;50;101
93;01.06.2016;2016;06;17;Keskiviikko;36;43;79
93;01.06.2016;2016;06;18;Keskiviikko;24;45;69
93;01.06.2016;2016;06;19;Keskiviikko;24;51;75
93;01.06.2016;2016;06;20;Keskiviikko;19;27;46
93;01.06.2016;2016;06;21;Keskiviikko;17;18;35
93;01.06.2016;2016;06;22;Keskiviikko;6;13;19
93;01.06.2016;2016;06;23;Keskiviikko;0;3;3
93;02.06.2016;2016;06;00;Torstai;2;2;4
93;02.06.2016;2016;06;01;Torstai;1;1;2
93;02.06.2016;2016;06;02;Torstai;0;0;0
93;02.06.2016;2016;06;03;Torstai;0;2;2
93;02.06.2016;2016;06;04;Torstai;1;1;2
93;02.06.2016;2016;06;05;Torstai;4;1;5
93;02.06.2016;2016;06;06;Torstai;33;19;52
93;02.06.2016;2016;06;07;Torstai;40;47;87
93;02.06.2016;2016;06;08;Torstai;37;31;68
93;02.06.2016;2016;06;09;Torstai;20;12;32
93;02.06.2016;2016;06;10;Torstai;10;12;22
93;02.06.2016;2016;06;11;Torstai;21;22;43
93;02.06.2016;2016;06;12;Torstai;22;24;46
93;02.06.2016;2016;06;13;Torstai;23;18;41
93;02.06.2016;2016;06;14;Torstai;28;35;63
93;02.06.2016;2016;06;15;Torstai;40;42;82
93;02.06.2016;2016;06;16;Torstai;61;55;116
93;02.06.2016;2016;06;17;Torstai;46;45;91
93;02.06.2016;2016;06;18;Torstai;44;45;89
93;02.06.2016;2016;06;19;Torstai;35;39;74
93;02.06.2016;2016;06;20;Torstai;20;28;48
93;02.06.2016;2016;06;21;Torstai;12;26;38
93;02.06.2016;2016;06;22;Torstai;5;5;10
93;02.06.2016;2016;06;23;Torstai;0;2;2
93;03.06.2016;2016;06;00;Perjantai;1;2;3
93;03.06.2016;2016;06;01;Perjantai;1;2;3
93;03.06.2016;2016;06;02;Perjantai;0;0;0
93;03.06.2016;2016;06;03;Perjantai;0;0;0
93;03.06.2016;2016;06;04;Perjantai;0;1;1
93;03.06.2016;2016;06;05;Perjantai;4;2;6
93;03.06.2016;2016;06;06;Perjantai;19;14;33
93;03.06.2016;2016;06;07;Perjantai;17;28;45
93;03.06.2016;2016;06;08;Perjantai;18;30;48
93;03.06.2016;2016;06;09;Perjantai;12;7;19
93;03.06.2016;2016;06;10;Perjantai;10;8;18
93;03.06.2016;2016;06;11;Perjantai;11;9;20
93;03.06.2016;2016;06;12;Perjantai;10;14;24
93;03.06.2016;2016;06;13;Perjantai;13;15;28
93;03.06.2016;2016;06;14;Perjantai;8;15;23
93;03.06.2016;2016;06;15;Perjantai;25;22;47
93;03.06.2016;2016;06;16;Perjantai;29;25;54
93;03.06.2016;2016;06;17;Perjantai;24;15;39
93;03.06.2016;2016;06;18;Perjantai;9;20;29
93;03.06.2016;2016;06;19;Perjantai;10;13;23
93;03.06.2016;2016;06;20;Perjantai;6;7;13
93;03.06.2016;2016;06;21;Perjantai;4;5;9
93;03.06.2016;2016;06;22;Perjantai;8;7;15
93;03.06.2016;2016;06;23;Perjantai;0;6;6
93;04.06.2016;2016;06;00;Lauantai;7;3;10
93;04.06.2016;2016;06;01;Lauantai;1;0;1
93;04.06.2016;2016;06;02;Lauantai;0;0;0
93;04.06.2016;2016;06;03;Lauantai;0;1;1
93;04.06.2016;2016;06;04;Lauantai;0;0;0
93;04.06.2016;2016;06;05;Lauantai;1;3;4
93;04.06.2016;2016;06;06;Lauantai;2;1;3
93;04.06.2016;2016;06;07;Lauantai;2;3;5
93;04.06.2016;2016;06;08;Lauantai;6;3;9
93;04.06.2016;2016;06;09;Lauantai;4;4;8
93;04.06.2016;2016;06;10;Lauantai;18;4;22
93;04.06.2016;2016;06;11;Lauantai;7;17;24
93;04.06.2016;2016;06;12;Lauantai;9;15;24
93;04.06.2016;2016;06;13;Lauantai;14;16;30
93;04.06.2016;2016;06;14;Lauantai;11;5;16
93;04.06.2016;2016;06;15;Lauantai;7;19;26
93;04.06.2016;2016;06;16;Lauantai;8;9;17
93;04.06.2016;2016;06;17;Lauantai;8;8;16
93;04.06.2016;2016;06;18;Lauantai;4;7;11
93;04.06.2016;2016;06;19;Lauantai;10;5;15
93;04.06.2016;2016;06;20;Lauantai;6;6;12
93;04.06.2016;2016;06;21;Lauantai;4;9;13
93;04.06.2016;2016;06;22;Lauantai;7;4;11
93;04.06.2016;2016;06;23;Lauantai;1;1;2
93;05.06.2016;2016;06;00;Sunnuntai;0;6;6
93;05.06.2016;2016;06;01;Sunnuntai;0;4;4
93;05.06.2016;2016;06;02;Sunnuntai;2;0;2
93;05.06.2016;2016;06;03;Sunnuntai;1;11;12
93;05.06.2016;2016;06;04;Sunnuntai;1;2;3
93;05.06.2016;2016;06;05;Sunnuntai;2;0;2
93;05.06.2016;2016;06;06;Sunnuntai;2;0;2
93;05.06.2016;2016;06;07;Sunnuntai;0;0;0
93;05.06.2016;2016;06;08;Sunnuntai;7;3;10
93;05.06.2016;2016;06;09;Sunnuntai;4;11;15
93;05.06.2016;2016;06;10;Sunnuntai;4;11;15
93;05.06.2016;2016;06;11;Sunnuntai;17;12;29
93;05.06.2016;2016;06;12;Sunnuntai;11;11;22
93;05.06.2016;2016;06;13;Sunnuntai;13;20;33
93;05.06.2016;2016;06;14;Sunnuntai;18;16;34
93;05.06.2016;2016;06;15;Sunnuntai;18;14;32
93;05.06.2016;2016;06;16;Sunnuntai;7;18;25
93;05.06.2016;2016;06;17;Sunnuntai;13;18;31
93;05.06.2016;2016;06;18;Sunnuntai;3;14;17
93;05.06.2016;2016;06;19;Sunnuntai;13;9;22
93;05.06.2016;2016;06;20;Sunnuntai;9;8;17
93;05.06.2016;2016;06;21;Sunnuntai;6;11;17
93;05.06.2016;2016;06;22;Sunnuntai;8;1;9
93;05.06.2016;2016;06;23;Sunnuntai;1;1;2
93;06.06.2016;2016;06;00;Maanantai;3;0;3
93;06.06.2016;2016;06;01;Maanantai;0;0;0
93;06.06.2016;2016;06;02;Maanantai;0;4;4
93;06.06.2016;2016;06;03;Maanantai;4;0;4
93;06.06.2016;2016;06;04;Maanantai;1;0;1
93;06.06.2016;2016;06;05;Maanantai;2;0;2
93;06.06.2016;2016;06;06;Maanantai;25;17;42
93;06.06.2016;2016;06;07;Maanantai;31;36;67
93;06.06.2016;2016;06;08;Maanantai;21;24;45
93;06.06.2016;2016;06;09;Maanantai;11;6;17
93;06.06.2016;2016;06;10;Maanantai;6;7;13
93;06.06.2016;2016;06;11;Maanantai;13;10;23
93;06.06.2016;2016;06;12;Maanantai;9;6;15
93;06.06.2016;2016;06;13;Maanantai;17;15;32
93;06.06.2016;2016;06;14;Maanantai;11;13;24
93;06.06.2016;2016;06;15;Maanantai;30;28;58
93;06.06.2016;2016;06;16;Maanantai;50;43;93
93;06.06.2016;2016;06;17;Maanantai;29;38;67
93;06.06.2016;2016;06;18;Maanantai;15;38;53
93;06.06.2016;2016;06;19;Maanantai;23;23;46
93;06.06.2016;2016;06;20;Maanantai;12;15;27
93;06.06.2016;2016;06;21;Maanantai;6;24;30
93;06.06.2016;2016;06;22;Maanantai;6;10;16
93;06.06.2016;2016;06;23;Maanantai;0;4;4
93;07.06.2016;2016;06;00;Tiistai;0;1;1
93;07.06.2016;2016;06;01;Tiistai;0;0;0
93;07.06.2016;2016;06;02;Tiistai;0;0;0
93;07.06.2016;2016;06;03;Tiistai;0;0;0
93;07.06.2016;2016;06;04;Tiistai;0;0;0
93;07.06.2016;2016;06;05;Tiistai;3;3;6
93;07.06.2016;2016;06;06;Tiistai;30;9;39
93;07.06.2016;2016;06;07;Tiistai;37;36;73
93;07.06.2016;2016;06;08;Tiistai;22;32;54
93;07.06.2016;2016;06;09;Tiistai;20;11;31
93;07.06.2016;2016;06;10;Tiistai;13;19;32
93;07.06.2016;2016;06;11;Tiistai;11;17;28
93;07.06.2016;2016;06;12;Tiistai;9;10;19
93;07.06.2016;2016;06;13;Tiistai;16;12;28
93;07.06.2016;2016;06;14;Tiistai;19;16;35
93;07.06.2016;2016;06;15;Tiistai;28;31;59
93;07.06.2016;2016;06;16;Tiistai;56;67;123
93;07.06.2016;2016;06;17;Tiistai;33;34;67
93;07.06.2016;2016;06;18;Tiistai;31;29;60
93;07.06.2016;2016;06;19;Tiistai;26;26;52
93;07.06.2016;2016;06;20;Tiistai;16;14;30
93;07.06.2016;2016;06;21;Tiistai;16;21;37
93;07.06.2016;2016;06;22;Tiistai;3;4;7
93;07.06.2016;2016;06;23;Tiistai;0;1;1
93;08.06.2016;2016;06;00;Keskiviikko;2;2;4
93;08.06.2016;2016;06;01;Keskiviikko;0;0;0
93;08.06.2016;2016;06;02;Keskiviikko;0;0;0
93;08.06.2016;2016;06;03;Keskiviikko;4;0;4
93;08.06.2016;2016;06;04;Keskiviikko;0;0;0
93;08.06.2016;2016;06;05;Keskiviikko;2;1;3
93;08.06.2016;2016;06;06;Keskiviikko;6;3;9
93;08.06.2016;2016;06;07;Keskiviikko;9;9;18
93;08.06.2016;2016;06;08;Keskiviikko;8;6;14
93;08.06.2016;2016;06;09;Keskiviikko;3;5;8
93;08.06.2016;2016;06;10;Keskiviikko;4;3;7
93;08.06.2016;2016;06;11;Keskiviikko;6;4;10
93;08.06.2016;2016;06;12;Keskiviikko;0;1;1
93;08.06.2016;2016;06;13;Keskiviikko;3;7;10
93;08.06.2016;2016;06;14;Keskiviikko;7;2;9
93;08.06.2016;2016;06;15;Keskiviikko;7;5;12
93;08.06.2016;2016;06;16;Keskiviikko;9;7;16
93;08.06.2016;2016;06;17;Keskiviikko;4;2;6
93;08.06.2016;2016;06;18;Keskiviikko;3;6;9
93;08.06.2016;2016;06;19;Keskiviikko;0;1;1
93;08.06.2016;2016;06;20;Keskiviikko;2;2;4
93;08.06.2016;2016;06;21;Keskiviikko;2;2;4
93;08.06.2016;2016;06;22;Keskiviikko;2;3;5
93;08.06.2016;2016;06;23;Keskiviikko;1;2;3
93;09.06.2016;2016;06;00;Torstai;4;0;4
93;09.06.2016;2016;06;01;Torstai;0;0;0
93;09.06.2016;2016;06;02;Torstai;0;0;0
93;09.06.2016;2016;06;03;Torstai;0;0;0
93;09.06.2016;2016;06;04;Torstai;0;0;0
93;09.06.2016;2016;06;05;Torstai;2;0;2
93;09.06.2016;2016;06;06;Torstai;8;2;10
93;09.06.2016;2016;06;07;Torstai;9;17;26
93;09.06.2016;2016;06;08;Torstai;5;16;21
93;09.06.2016;2016;06;09;Torstai;6;3;9
93;09.06.2016;2016;06;10;Torstai;4;3;7
93;09.06.2016;2016;06;11;Torstai;6;3;9
93;09.06.2016;2016;06;12;Torstai;10;5;15
93;09.06.2016;2016;06;13;Torstai;6;7;13
93;09.06.2016;2016;06;14;Torstai;8;4;12
93;09.06.2016;2016;06;15;Torstai;13;13;26
93;09.06.2016;2016;06;16;Torstai;18;21;39
93;09.06.2016;2016;06;17;Torstai;22;15;37
93;09.06.2016;2016;06;18;Torstai;10;13;23
93;09.06.2016;2016;06;19;Torstai;20;9;29
93;09.06.2016;2016;06;20;Torstai;9;15;24
93;09.06.2016;2016;06;21;Torstai;5;10;15
93;09.06.2016;2016;06;22;Torstai;3;6;9
93;09.06.2016;2016;06;23;Torstai;0;2;2
93;10.06.2016;2016;06;00;Perjantai;1;0;1
93;10.06.2016;2016;06;01;Perjantai;1;0;1
93;10.06.2016;2016;06;02;Perjantai;0;2;2
93;10.06.2016;2016;06;03;Perjantai;0;0;0
93;10.06.2016;2016;06;04;Perjantai;0;0;0
93;10.06.2016;2016;06;05;Perjantai;7;3;10
93;10.06.2016;2016;06;06;Perjantai;17;8;25
93;10.06.2016;2016;06;07;Perjantai;19;22;41
93;10.06.2016;2016;06;08;Perjantai;15;16;31
93;10.06.2016;2016;06;09;Perjantai;6;10;16
93;10.06.2016;2016;06;10;Perjantai;4;5;9
93;10.06.2016;2016;06;11;Perjantai;6;6;12
93;10.06.2016;2016;06;12;Perjantai;5;4;9
93;10.06.2016;2016;06;13;Perjantai;5;9;14
93;10.06.2016;2016;06;14;Perjantai;16;12;28
93;10.06.2016;2016;06;15;Perjantai;15;24;39
93;10.06.2016;2016;06;16;Perjantai;19;15;34
93;10.06.2016;2016;06;17;Perjantai;11;18;29
93;10.06.2016;2016;06;18;Perjantai;11;19;30
93;10.06.2016;2016;06;19;Perjantai;9;15;24
93;10.06.2016;2016;06;20;Perjantai;6;10;16
93;10.06.2016;2016;06;21;Perjantai;4;7;11
93;10.06.2016;2016;06;22;Perjantai;6;1;7
93;10.06.2016;2016;06;23;Perjantai;2;5;7
93;11.06.2016;2016;06;00;Lauantai;4;3;7
93;11.06.2016;2016;06;01;Lauantai;0;2;2
93;11.06.2016;2016;06;02;Lauantai;0;0;0
93;11.06.2016;2016;06;03;Lauantai;0;0;0
93;11.06.2016;2016;06;04;Lauantai;0;3;3
93;11.06.2016;2016;06;05;Lauantai;0;1;1
93;11.06.2016;2016;06;06;Lauantai;1;1;2
93;11.06.2016;2016;06;07;Lauantai;3;5;8
93;11.06.2016;2016;06;08;Lauantai;10;2;12
93;11.06.2016;2016;06;09;Lauantai;8;9;17
93;11.06.2016;2016;06;10;Lauantai;9;11;20
93;11.06.2016;2016;06;11;Lauantai;12;9;21
93;11.06.2016;2016;06;12;Lauantai;13;15;28
93;11.06.2016;2016;06;13;Lauantai;24;18;42
93;11.06.2016;2016;06;14;Lauantai;19;18;37
93;11.06.2016;2016;06;15;Lauantai;18;23;41
93;11.06.2016;2016;06;16;Lauantai;11;13;24
93;11.06.2016;2016;06;17;Lauantai;16;5;21
93;11.06.2016;2016;06;18;Lauantai;11;12;23
93;11.06.2016;2016;06;19;Lauantai;9;13;22
93;11.06.2016;2016;06;20;Lauantai;4;7;11
93;11.06.2016;2016;06;21;Lauantai;5;17;22
93;11.06.2016;2016;06;22;Lauantai;6;4;10
93;11.06.2016;2016;06;23;Lauantai;1;6;7
93;12.06.2016;2016;06;00;Sunnuntai;2;3;5
93;12.06.2016;2016;06;01;Sunnuntai;2;0;2
93;12.06.2016;2016;06;02;Sunnuntai;0;0;0
93;12.06.2016;2016;06;03;Sunnuntai;0;2;2
93;12.06.2016;2016;06;04;Sunnuntai;0;0;0
93;12.06.2016;2016;06;05;Sunnuntai;2;1;3
93;12.06.2016;2016;06;06;Sunnuntai;4;3;7
93;12.06.2016;2016;06;07;Sunnuntai;2;4;6
93;12.06.2016;2016;06;08;Sunnuntai;7;5;12
93;12.06.2016;2016;06;09;Sunnuntai;12;7;19
93;12.06.2016;2016;06;10;Sunnuntai;9;22;31
93;12.06.2016;2016;06;11;Sunnuntai;28;22;50
93;12.06.2016;2016;06;12;Sunnuntai;36;35;71
93;12.06.2016;2016;06;13;Sunnuntai;24;37;61
93;12.06.2016;2016;06;14;Sunnuntai;24;31;55
93;12.06.2016;2016;06;15;Sunnuntai;22;28;50
93;12.06.2016;2016;06;16;Sunnuntai;16;28;44
93;12.06.2016;2016;06;17;Sunnuntai;24;23;47
93;12.06.2016;2016;06;18;Sunnuntai;22;22;44
93;12.06.2016;2016;06;19;Sunnuntai;26;19;45
93;12.06.2016;2016;06;20;Sunnuntai;14;8;22
93;12.06.2016;2016;06;21;Sunnuntai;5;9;14
93;12.06.2016;2016;06;22;Sunnuntai;3;13;16
93;12.06.2016;2016;06;23;Sunnuntai;2;2;4
93;13.06.2016;2016;06;00;Maanantai;0;3;3
93;13.06.2016;2016;06;01;Maanantai;0;0;0
93;13.06.2016;2016;06;02;Maanantai;0;0;0
93;13.06.2016;2016;06;03;Maanantai;0;0;0
93;13.06.2016;2016;06;04;Maanantai;1;0;1
93;13.06.2016;2016;06;05;Maanantai;3;1;4
93;13.06.2016;2016;06;06;Maanantai;32;14;46
93;13.06.2016;2016;06;07;Maanantai;44;29;73
93;13.06.2016;2016;06;08;Maanantai;18;26;44
93;13.06.2016;2016;06;09;Maanantai;10;8;18
93;13.06.2016;2016;06;10;Maanantai;11;13;24
93;13.06.2016;2016;06;11;Maanantai;11;9;20
93;13.06.2016;2016;06;12;Maanantai;16;12;28
93;13.06.2016;2016;06;13;Maanantai;15;18;33
93;13.06.2016;2016;06;14;Maanantai;14;20;34
93;13.06.2016;2016;06;15;Maanantai;42;37;79
93;13.06.2016;2016;06;16;Maanantai;47;44;91
93;13.06.2016;2016;06;17;Maanantai;29;38;67
93;13.06.2016;2016;06;18;Maanantai;24;22;46
93;13.06.2016;2016;06;19;Maanantai;16;27;43
93;13.06.2016;2016;06;20;Maanantai;9;23;32
93;13.06.2016;2016;06;21;Maanantai;9;16;25
93;13.06.2016;2016;06;22;Maanantai;5;11;16
93;13.06.2016;2016;06;23;Maanantai;4;0;4
93;14.06.2016;2016;06;00;Tiistai;0;1;1
93;14.06.2016;2016;06;01;Tiistai;0;1;1
93;14.06.2016;2016;06;02;Tiistai;0;3;3
93;14.06.2016;2016;06;03;Tiistai;2;0;2
93;14.06.2016;2016;06;04;Tiistai;0;0;0
93;14.06.2016;2016;06;05;Tiistai;5;1;6
93;14.06.2016;2016;06;06;Tiistai;28;15;43
93;14.06.2016;2016;06;07;Tiistai;38;47;85
93;14.06.2016;2016;06;08;Tiistai;18;26;44
93;14.06.2016;2016;06;09;Tiistai;25;11;36
93;14.06.2016;2016;06;10;Tiistai;10;14;24
93;14.06.2016;2016;06;11;Tiistai;14;12;26
93;14.06.2016;2016;06;12;Tiistai;18;20;38
93;14.06.2016;2016;06;13;Tiistai;18;8;26
93;14.06.2016;2016;06;14;Tiistai;32;24;56
93;14.06.2016;2016;06;15;Tiistai;26;44;70
93;14.06.2016;2016;06;16;Tiistai;58;53;111
93;14.06.2016;2016;06;17;Tiistai;36;44;80
93;14.06.2016;2016;06;18;Tiistai;24;28;52
93;14.06.2016;2016;06;19;Tiistai;28;27;55
93;14.06.2016;2016;06;20;Tiistai;16;27;43
93;14.06.2016;2016;06;21;Tiistai;3;17;20
93;14.06.2016;2016;06;22;Tiistai;1;11;12
93;14.06.2016;2016;06;23;Tiistai;2;4;6
93;15.06.2016;2016;06;00;Keskiviikko;0;1;1
93;15.06.2016;2016;06;01;Keskiviikko;0;0;0
93;15.06.2016;2016;06;02;Keskiviikko;0;2;2
93;15.06.2016;2016;06;03;Keskiviikko;0;0;0
93;15.06.2016;2016;06;04;Keskiviikko;2;2;4
93;15.06.2016;2016;06;05;Keskiviikko;2;1;3
93;15.06.2016;2016;06;06;Keskiviikko;34;19;53
93;15.06.2016;2016;06;07;Keskiviikko;46;43;89
93;15.06.2016;2016;06;08;Keskiviikko;29;27;56
93;15.06.2016;2016;06;09;Keskiviikko;15;18;33
93;15.06.2016;2016;06;10;Keskiviikko;16;18;34
93;15.06.2016;2016;06;11;Keskiviikko;21;18;39
93;15.06.2016;2016;06;12;Keskiviikko;18;15;33
93;15.06.2016;2016;06;13;Keskiviikko;23;12;35
93;15.06.2016;2016;06;14;Keskiviikko;19;29;48
93;15.06.2016;2016;06;15;Keskiviikko;28;43;71
93;15.06.2016;2016;06;16;Keskiviikko;45;63;108
93;15.06.2016;2016;06;17;Keskiviikko;34;48;82
93;15.06.2016;2016;06;18;Keskiviikko;33;24;57
93;15.06.2016;2016;06;19;Keskiviikko;24;41;65
93;15.06.2016;2016;06;20;Keskiviikko;18;26;44
93;15.06.2016;2016;06;21;Keskiviikko;5;19;24
93;15.06.2016;2016;06;22;Keskiviikko;6;4;10
93;15.06.2016;2016;06;23;Keskiviikko;1;1;2
93;16.06.2016;2016;06;00;Torstai;0;3;3
93;16.06.2016;2016;06;01;Torstai;1;2;3
93;16.06.2016;2016;06;02;Torstai;1;0;1
93;16.06.2016;2016;06;03;Torstai;0;0;0
93;16.06.2016;2016;06;04;Torstai;1;0;1
93;16.06.2016;2016;06;05;Torstai;5;2;7
93;16.06.2016;2016;06;06;Torstai;20;12;32
93;16.06.2016;2016;06;07;Torstai;26;33;59
93;16.06.2016;2016;06;08;Torstai;16;26;42
93;16.06.2016;2016;06;09;Torstai;15;8;23
93;16.06.2016;2016;06;10;Torstai;12;19;31
93;16.06.2016;2016;06;11;Torstai;19;13;32
93;16.06.2016;2016;06;12;Torstai;14;10;24
93;16.06.2016;2016;06;13;Torstai;13;12;25
93;16.06.2016;2016;06;14;Torstai;8;7;15
93;16.06.2016;2016;06;15;Torstai;12;19;31
93;16.06.2016;2016;06;16;Torstai;28;16;44
93;16.06.2016;2016;06;17;Torstai;15;8;23
93;16.06.2016;2016;06;18;Torstai;8;6;14
93;16.06.2016;2016;06;19;Torstai;5;9;14
93;16.06.2016;2016;06;20;Torstai;4;8;12
93;16.06.2016;2016;06;21;Torstai;3;1;4
93;16.06.2016;2016;06;22;Torstai;3;6;9
93;16.06.2016;2016;06;23;Torstai;1;2;3
93;17.06.2016;2016;06;00;Perjantai;1;2;3
93;17.06.2016;2016;06;01;Perjantai;0;0;0
93;17.06.2016;2016;06;02;Perjantai;0;0;0
93;17.06.2016;2016;06;03;Perjantai;0;0;0
93;17.06.2016;2016;06;04;Perjantai;1;0;1
93;17.06.2016;2016;06;05;Perjantai;1;1;2
93;17.06.2016;2016;06;06;Perjantai;6;5;11
93;17.06.2016;2016;06;07;Perjantai;4;10;14
93;17.06.2016;2016;06;08;Perjantai;5;10;15
93;17.06.2016;2016;06;09;Perjantai;3;1;4
93;17.06.2016;2016;06;10;Perjantai;3;3;6
93;17.06.2016;2016;06;11;Perjantai;4;7;11
93;17.06.2016;2016;06;12;Perjantai;3;2;5
93;17.06.2016;2016;06;13;Perjantai;7;3;10
93;17.06.2016;2016;06;14;Perjantai;7;5;12
93;17.06.2016;2016;06;15;Perjantai;10;5;15
93;17.06.2016;2016;06;16;Perjantai;14;17;31
93;17.06.2016;2016;06;17;Perjantai;17;10;27
93;17.06.2016;2016;06;18;Perjantai;17;19;36
93;17.06.2016;2016;06;19;Perjantai;30;30;60
93;17.06.2016;2016;06;20;Perjantai;14;15;29
93;17.06.2016;2016;06;21;Perjantai;3;10;13
93;17.06.2016;2016;06;22;Perjantai;1;4;5
93;17.06.2016;2016;06;23;Perjantai;2;3;5
93;18.06.2016;2016;06;00;Lauantai;4;4;8
93;18.06.2016;2016;06;01;Lauantai;1;1;2
93;18.06.2016;2016;06;02;Lauantai;0;2;2
93;18.06.2016;2016;06;03;Lauantai;3;1;4
93;18.06.2016;2016;06;04;Lauantai;2;3;5
93;18.06.2016;2016;06;05;Lauantai;1;2;3
93;18.06.2016;2016;06;06;Lauantai;1;1;2
93;18.06.2016;2016;06;07;Lauantai;5;5;10
93;18.06.2016;2016;06;08;Lauantai;6;6;12
93;18.06.2016;2016;06;09;Lauantai;10;11;21
93;18.06.2016;2016;06;10;Lauantai;17;23;40
93;18.06.2016;2016;06;11;Lauantai;8;7;15
93;18.06.2016;2016;06;12;Lauantai;9;5;14
93;18.06.2016;2016;06;13;Lauantai;9;3;12
93;18.06.2016;2016;06;14;Lauantai;2;9;11
93;18.06.2016;2016;06;15;Lauantai;2;6;8
93;18.06.2016;2016;06;16;Lauantai;8;8;16
93;18.06.2016;2016;06;17;Lauantai;7;7;14
93;18.06.2016;2016;06;18;Lauantai;2;5;7
93;18.06.2016;2016;06;19;Lauantai;6;1;7
93;18.06.2016;2016;06;20;Lauantai;1;9;10
93;18.06.2016;2016;06;21;Lauantai;2;4;6
93;18.06.2016;2016;06;22;Lauantai;2;2;4
93;18.06.2016;2016;06;23;Lauantai;1;0;1
93;19.06.2016;2016;06;00;Sunnuntai;1;0;1
93;19.06.2016;2016;06;01;Sunnuntai;0;1;1
93;19.06.2016;2016;06;02;Sunnuntai;7;0;7
93;19.06.2016;2016;06;03;Sunnuntai;0;5;5
93;19.06.2016;2016;06;04;Sunnuntai;1;1;2
93;19.06.2016;2016;06;05;Sunnuntai;1;1;2
93;19.06.2016;2016;06;06;Sunnuntai;2;1;3
93;19.06.2016;2016;06;07;Sunnuntai;4;5;9
93;19.06.2016;2016;06;08;Sunnuntai;7;5;12
93;19.06.2016;2016;06;09;Sunnuntai;10;8;18
93;19.06.2016;2016;06;10;Sunnuntai;9;17;26
93;19.06.2016;2016;06;11;Sunnuntai;20;22;42
93;19.06.2016;2016;06;12;Sunnuntai;22;34;56
93;19.06.2016;2016;06;13;Sunnuntai;27;25;52
93;19.06.2016;2016;06;14;Sunnuntai;11;14;25
93;19.06.2016;2016;06;15;Sunnuntai;9;8;17
93;19.06.2016;2016;06;16;Sunnuntai;8;15;23
93;19.06.2016;2016;06;17;Sunnuntai;7;11;18
93;19.06.2016;2016;06;18;Sunnuntai;2;9;11
93;19.06.2016;2016;06;19;Sunnuntai;5;5;10
93;19.06.2016;2016;06;20;Sunnuntai;5;8;13
93;19.06.2016;2016;06;21;Sunnuntai;8;7;15
93;19.06.2016;2016;06;22;Sunnuntai;5;1;6
93;19.06.2016;2016;06;23;Sunnuntai;2;0;2
93;20.06.2016;2016;06;00;Maanantai;0;2;2
93;20.06.2016;2016;06;01;Maanantai;1;0;1
93;20.06.2016;2016;06;02;Maanantai;0;1;1
93;20.06.2016;2016;06;03;Maanantai;0;1;1
93;20.06.2016;2016;06;04;Maanantai;1;0;1
93;20.06.2016;2016;06;05;Maanantai;4;4;8
93;20.06.2016;2016;06;06;Maanantai;22;13;35
93;20.06.2016;2016;06;07;Maanantai;22;34;56
93;20.06.2016;2016;06;08;Maanantai;15;24;39
93;20.06.2016;2016;06;09;Maanantai;15;11;26
93;20.06.2016;2016;06;10;Maanantai;12;8;20
93;20.06.2016;2016;06;11;Maanantai;14;12;26
93;20.06.2016;2016;06;12;Maanantai;17;11;28
93;20.06.2016;2016;06;13;Maanantai;17;14;31
93;20.06.2016;2016;06;14;Maanantai;8;16;24
93;20.06.2016;2016;06;15;Maanantai;31;33;64
93;20.06.2016;2016;06;16;Maanantai;39;39;78
93;20.06.2016;2016;06;17;Maanantai;23;21;44
93;20.06.2016;2016;06;18;Maanantai;16;19;35
93;20.06.2016;2016;06;19;Maanantai;23;15;38
93;20.06.2016;2016;06;20;Maanantai;13;21;34
93;20.06.2016;2016;06;21;Maanantai;6;21;27
93;20.06.2016;2016;06;22;Maanantai;4;10;14
93;20.06.2016;2016;06;23;Maanantai;2;0;2
93;21.06.2016;2016;06;00;Tiistai;2;5;7
93;21.06.2016;2016;06;01;Tiistai;4;2;6
93;21.06.2016;2016;06;02;Tiistai;0;0;0
93;21.06.2016;2016;06;03;Tiistai;1;0;1
93;21.06.2016;2016;06;04;Tiistai;2;3;5
93;21.06.2016;2016;06;05;Tiistai;8;6;14
93;21.06.2016;2016;06;06;Tiistai;25;17;42
93;21.06.2016;2016;06;07;Tiistai;29;37;66
93;21.06.2016;2016;06;08;Tiistai;34;27;61
93;21.06.2016;2016;06;09;Tiistai;17;17;34
93;21.06.2016;2016;06;10;Tiistai;11;9;20
93;21.06.2016;2016;06;11;Tiistai;14;25;39
93;21.06.2016;2016;06;12;Tiistai;15;22;37
93;21.06.2016;2016;06;13;Tiistai;23;16;39
93;21.06.2016;2016;06;14;Tiistai;15;15;30
93;21.06.2016;2016;06;15;Tiistai;34;38;72
93;21.06.2016;2016;06;16;Tiistai;49;44;93
93;21.06.2016;2016;06;17;Tiistai;38;36;74
93;21.06.2016;2016;06;18;Tiistai;31;28;59
93;21.06.2016;2016;06;19;Tiistai;43;35;78
93;21.06.2016;2016;06;20;Tiistai;21;33;54
93;21.06.2016;2016;06;21;Tiistai;13;15;28
93;21.06.2016;2016;06;22;Tiistai;5;9;14
93;21.06.2016;2016;06;23;Tiistai;2;6;8
93;22.06.2016;2016;06;00;Keskiviikko;0;0;0
93;22.06.2016;2016;06;01;Keskiviikko;0;1;1
93;22.06.2016;2016;06;02;Keskiviikko;3;0;3
93;22.06.2016;2016;06;03;Keskiviikko;1;4;5
93;22.06.2016;2016;06;04;Keskiviikko;0;0;0
93;22.06.2016;2016;06;05;Keskiviikko;6;1;7
93;22.06.2016;2016;06;06;Keskiviikko;29;15;44
93;22.06.2016;2016;06;07;Keskiviikko;28;31;59
93;22.06.2016;2016;06;08;Keskiviikko;21;29;50
93;22.06.2016;2016;06;09;Keskiviikko;16;19;35
93;22.06.2016;2016;06;10;Keskiviikko;8;12;20
93;22.06.2016;2016;06;11;Keskiviikko;24;13;37
93;22.06.2016;2016;06;12;Keskiviikko;17;12;29
93;22.06.2016;2016;06;13;Keskiviikko;16;14;30
93;22.06.2016;2016;06;14;Keskiviikko;18;29;47
93;22.06.2016;2016;06;15;Keskiviikko;38;40;78
93;22.06.2016;2016;06;16;Keskiviikko;38;40;78
93;22.06.2016;2016;06;17;Keskiviikko;34;23;57
93;22.06.2016;2016;06;18;Keskiviikko;21;25;46
93;22.06.2016;2016;06;19;Keskiviikko;13;29;42
93;22.06.2016;2016;06;20;Keskiviikko;13;35;48
93;22.06.2016;2016;06;21;Keskiviikko;11;11;22
93;22.06.2016;2016;06;22;Keskiviikko;4;8;12
93;22.06.2016;2016;06;23;Keskiviikko;2;0;2
93;23.06.2016;2016;06;00;Torstai;1;1;2
93;23.06.2016;2016;06;01;Torstai;0;0;0
93;23.06.2016;2016;06;02;Torstai;0;1;1
93;23.06.2016;2016;06;03;Torstai;2;0;2
93;23.06.2016;2016;06;04;Torstai;1;1;2
93;23.06.2016;2016;06;05;Torstai;4;1;5
93;23.06.2016;2016;06;06;Torstai;11;11;22
93;23.06.2016;2016;06;07;Torstai;22;21;43
93;23.06.2016;2016;06;08;Torstai;16;22;38
93;23.06.2016;2016;06;09;Torstai;13;7;20
93;23.06.2016;2016;06;10;Torstai;20;14;34
93;23.06.2016;2016;06;11;Torstai;21;11;32
93;23.06.2016;2016;06;12;Torstai;17;25;42
93;23.06.2016;2016;06;13;Torstai;26;25;51
93;23.06.2016;2016;06;14;Torstai;25;24;49
93;23.06.2016;2016;06;15;Torstai;20;35;55
93;23.06.2016;2016;06;16;Torstai;25;30;55
93;23.06.2016;2016;06;17;Torstai;21;14;35
93;23.06.2016;2016;06;18;Torstai;28;26;54
93;23.06.2016;2016;06;19;Torstai;17;24;41
93;23.06.2016;2016;06;20;Torstai;10;16;26
93;23.06.2016;2016;06;21;Torstai;8;12;20
93;23.06.2016;2016;06;22;Torstai;6;10;16
93;23.06.2016;2016;06;23;Torstai;1;1;2
93;24.06.2016;2016;06;00;Perjantai;2;3;5
93;24.06.2016;2016;06;01;Perjantai;0;6;6
93;24.06.2016;2016;06;02;Perjantai;1;1;2
93;24.06.2016;2016;06;03;Perjantai;0;0;0
93;24.06.2016;2016;06;04;Perjantai;0;0;0
93;24.06.2016;2016;06;05;Perjantai;0;1;1
93;24.06.2016;2016;06;06;Perjantai;5;1;6
93;24.06.2016;2016;06;07;Perjantai;4;4;8
93;24.06.2016;2016;06;08;Perjantai;6;2;8
93;24.06.2016;2016;06;09;Perjantai;12;17;29
93;24.06.2016;2016;06;10;Perjantai;7;21;28
93;24.06.2016;2016;06;11;Perjantai;28;23;51
93;24.06.2016;2016;06;12;Perjantai;14;28;42
93;24.06.2016;2016;06;13;Perjantai;12;28;40
93;24.06.2016;2016;06;14;Perjantai;16;23;39
93;24.06.2016;2016;06;15;Perjantai;18;32;50
93;24.06.2016;2016;06;16;Perjantai;13;9;22
93;24.06.2016;2016;06;17;Perjantai;16;15;31
93;24.06.2016;2016;06;18;Perjantai;16;15;31
93;24.06.2016;2016;06;19;Perjantai;13;15;28
93;24.06.2016;2016;06;20;Perjantai;13;14;27
93;24.06.2016;2016;06;21;Perjantai;8;5;13
93;24.06.2016;2016;06;22;Perjantai;9;6;15
93;24.06.2016;2016;06;23;Perjantai;4;4;8
93;25.06.2016;2016;06;00;Lauantai;5;4;9
93;25.06.2016;2016;06;01;Lauantai;2;2;4
93;25.06.2016;2016;06;02;Lauantai;5;1;6
93;25.06.2016;2016;06;03;Lauantai;2;0;2
93;25.06.2016;2016;06;04;Lauantai;3;4;7
93;25.06.2016;2016;06;05;Lauantai;1;2;3
93;25.06.2016;2016;06;06;Lauantai;2;2;4
93;25.06.2016;2016;06;07;Lauantai;1;2;3
93;25.06.2016;2016;06;08;Lauantai;2;4;6
93;25.06.2016;2016;06;09;Lauantai;5;10;15
93;25.06.2016;2016;06;10;Lauantai;22;16;38
93;25.06.2016;2016;06;11;Lauantai;7;8;15
93;25.06.2016;2016;06;12;Lauantai;8;2;10
93;25.06.2016;2016;06;13;Lauantai;12;1;13
93;25.06.2016;2016;06;14;Lauantai;3;1;4
93;25.06.2016;2016;06;15;Lauantai;1;6;7
93;25.06.2016;2016;06;16;Lauantai;8;4;12
93;25.06.2016;2016;06;17;Lauantai;8;6;14
93;25.06.2016;2016;06;18;Lauantai;8;17;25
93;25.06.2016;2016;06;19;Lauantai;17;16;33
93;25.06.2016;2016;06;20;Lauantai;15;8;23
93;25.06.2016;2016;06;21;Lauantai;2;14;16
93;25.06.2016;2016;06;22;Lauantai;11;1;12
93;25.06.2016;2016;06;23;Lauantai;4;7;11
93;26.06.2016;2016;06;00;Sunnuntai;0;2;2
93;26.06.2016;2016;06;01;Sunnuntai;2;2;4
93;26.06.2016;2016;06;02;Sunnuntai;2;3;5
93;26.06.2016;2016;06;03;Sunnuntai;2;0;2
93;26.06.2016;2016;06;04;Sunnuntai;2;1;3
93;26.06.2016;2016;06;05;Sunnuntai;1;0;1
93;26.06.2016;2016;06;06;Sunnuntai;3;2;5
93;26.06.2016;2016;06;07;Sunnuntai;0;3;3
93;26.06.2016;2016;06;08;Sunnuntai;13;4;17
93;26.06.2016;2016;06;09;Sunnuntai;8;14;22
93;26.06.2016;2016;06;10;Sunnuntai;10;12;22
93;26.06.2016;2016;06;11;Sunnuntai;9;20;29
93;26.06.2016;2016;06;12;Sunnuntai;39;31;70
93;26.06.2016;2016;06;13;Sunnuntai;45;30;75
93;26.06.2016;2016;06;14;Sunnuntai;37;24;61
93;26.06.2016;2016;06;15;Sunnuntai;27;38;65
93;26.06.2016;2016;06;16;Sunnuntai;34;37;71
93;26.06.2016;2016;06;17;Sunnuntai;25;38;63
93;26.06.2016;2016;06;18;Sunnuntai;24;39;63
93;26.06.2016;2016;06;19;Sunnuntai;41;35;76
93;26.06.2016;2016;06;20;Sunnuntai;23;14;37
93;26.06.2016;2016;06;21;Sunnuntai;14;10;24
93;26.06.2016;2016;06;22;Sunnuntai;3;10;13
93;26.06.2016;2016;06;23;Sunnuntai;4;9;13
93;27.06.2016;2016;06;00;Maanantai;1;7;8
93;27.06.2016;2016;06;01;Maanantai;2;0;2
93;27.06.2016;2016;06;02;Maanantai;0;4;4
93;27.06.2016;2016;06;03;Maanantai;0;2;2
93;27.06.2016;2016;06;04;Maanantai;2;0;2
93;27.06.2016;2016;06;05;Maanantai;4;4;8
93;27.06.2016;2016;06;06;Maanantai;29;10;39
93;27.06.2016;2016;06;07;Maanantai;32;37;69
93;27.06.2016;2016;06;08;Maanantai;20;22;42
93;27.06.2016;2016;06;09;Maanantai;13;13;26
93;27.06.2016;2016;06;10;Maanantai;26;9;35
93;27.06.2016;2016;06;11;Maanantai;20;16;36
93;27.06.2016;2016;06;12;Maanantai;30;22;52
93;27.06.2016;2016;06;13;Maanantai;31;18;49
93;27.06.2016;2016;06;14;Maanantai;16;28;44
93;27.06.2016;2016;06;15;Maanantai;46;63;109
93;27.06.2016;2016;06;16;Maanantai;49;52;101
93;27.06.2016;2016;06;17;Maanantai;29;43;72
93;27.06.2016;2016;06;18;Maanantai;23;29;52
93;27.06.2016;2016;06;19;Maanantai;19;20;39
93;27.06.2016;2016;06;20;Maanantai;10;21;31
93;27.06.2016;2016;06;21;Maanantai;6;17;23
93;27.06.2016;2016;06;22;Maanantai;1;8;9
93;27.06.2016;2016;06;23;Maanantai;0;1;1
93;28.06.2016;2016;06;00;Tiistai;3;2;5
93;28.06.2016;2016;06;01;Tiistai;0;0;0
93;28.06.2016;2016;06;02;Tiistai;0;0;0
93;28.06.2016;2016;06;03;Tiistai;0;0;0
93;28.06.2016;2016;06;04;Tiistai;1;0;1
93;28.06.2016;2016;06;05;Tiistai;3;3;6
93;28.06.2016;2016;06;06;Tiistai;16;9;25
93;28.06.2016;2016;06;07;Tiistai;5;17;22
93;28.06.2016;2016;06;08;Tiistai;4;14;18
93;28.06.2016;2016;06;09;Tiistai;4;1;5
93;28.06.2016;2016;06;10;Tiistai;5;2;7
93;28.06.2016;2016;06;11;Tiistai;3;3;6
93;28.06.2016;2016;06;12;Tiistai;3;1;4
93;28.06.2016;2016;06;13;Tiistai;18;6;24
93;28.06.2016;2016;06;14;Tiistai;14;13;27
93;28.06.2016;2016;06;15;Tiistai;18;29;47
93;28.06.2016;2016;06;16;Tiistai;42;24;66
93;28.06.2016;2016;06;17;Tiistai;30;21;51
93;28.06.2016;2016;06;18;Tiistai;11;27;38
93;28.06.2016;2016;06;19;Tiistai;33;17;50
93;28.06.2016;2016;06;20;Tiistai;22;18;40
93;28.06.2016;2016;06;21;Tiistai;9;19;28
93;28.06.2016;2016;06;22;Tiistai;3;8;11
93;28.06.2016;2016;06;23;Tiistai;2;4;6
93;29.06.2016;2016;06;00;Keskiviikko;0;0;0
93;29.06.2016;2016;06;01;Keskiviikko;2;2;4
93;29.06.2016;2016;06;02;Keskiviikko;1;1;2
93;29.06.2016;2016;06;03;Keskiviikko;0;0;0
93;29.06.2016;2016;06;04;Keskiviikko;2;0;2
93;29.06.2016;2016;06;05;Keskiviikko;4;2;6
93;29.06.2016;2016;06;06;Keskiviikko;23;14;37
93;29.06.2016;2016;06;07;Keskiviikko;23;31;54
93;29.06.2016;2016;06;08;Keskiviikko;22;29;51
93;29.06.2016;2016;06;09;Keskiviikko;16;13;29
93;29.06.2016;2016;06;10;Keskiviikko;14;9;23
93;29.06.2016;2016;06;11;Keskiviikko;19;15;34
93;29.06.2016;2016;06;12;Keskiviikko;16;10;26
93;29.06.2016;2016;06;13;Keskiviikko;23;18;41
93;29.06.2016;2016;06;14;Keskiviikko;22;23;45
93;29.06.2016;2016;06;15;Keskiviikko;32;37;69
93;29.06.2016;2016;06;16;Keskiviikko;25;30;55
93;29.06.2016;2016;06;17;Keskiviikko;22;15;37
93;29.06.2016;2016;06;18;Keskiviikko;20;18;38
93;29.06.2016;2016;06;19;Keskiviikko;13;21;34
93;29.06.2016;2016;06;20;Keskiviikko;11;32;43
93;29.06.2016;2016;06;21;Keskiviikko;14;16;30
93;29.06.2016;2016;06;22;Keskiviikko;4;7;11
93;29.06.2016;2016;06;23;Keskiviikko;4;6;10
93;30.06.2016;2016;06;00;Torstai;0;2;2
93;30.06.2016;2016;06;01;Torstai;6;0;6
93;30.06.2016;2016;06;02;Torstai;1;1;2
93;30.06.2016;2016;06;03;Torstai;0;0;0
93;30.06.2016;2016;06;04;Torstai;1;0;1
93;30.06.2016;2016;06;05;Torstai;4;8;12
93;30.06.2016;2016;06;06;Torstai;22;8;30
93;30.06.2016;2016;06;07;Torstai;23;30;53
93;30.06.2016;2016;06;08;Torstai;19;27;46
93;30.06.2016;2016;06;09;Torstai;8;10;18
93;30.06.2016;2016;06;10;Torstai;23;21;44
93;30.06.2016;2016;06;11;Torstai;26;27;53
93;30.06.2016;2016;06;12;Torstai;31;18;49
93;30.06.2016;2016;06;13;Torstai;24;9;33
93;30.06.2016;2016;06;14;Torstai;30;30;60
93;30.06.2016;2016;06;15;Torstai;32;36;68
93;30.06.2016;2016;06;16;Torstai;19;15;34
93;30.06.2016;2016;06;17;Torstai;19;19;38
93;30.06.2016;2016;06;18;Torstai;12;4;16
93;30.06.2016;2016;06;19;Torstai;19;13;32
93;30.06.2016;2016;06;20;Torstai;14;23;37
93;30.06.2016;2016;06;21;Torstai;8;15;23
93;30.06.2016;2016;06;22;Torstai;7;6;13
93;30.06.2016;2016;06;23;Torstai;4;1;5
93;01.07.2016;2016;07;00;Perjantai;0;3;3
93;01.07.2016;2016;07;01;Perjantai;0;1;1
93;01.07.2016;2016;07;02;Perjantai;1;2;3
93;01.07.2016;2016;07;03;Perjantai;0;2;2
93;01.07.2016;2016;07;04;Perjantai;0;0;0
93;01.07.2016;2016;07;05;Perjantai;3;4;7
93;01.07.2016;2016;07;06;Perjantai;15;9;24
93;01.07.2016;2016;07;07;Perjantai;11;24;35
93;01.07.2016;2016;07;08;Perjantai;12;18;30
93;01.07.2016;2016;07;09;Perjantai;8;11;19
93;01.07.2016;2016;07;10;Perjantai;13;14;27
93;01.07.2016;2016;07;11;Perjantai;8;16;24
93;01.07.2016;2016;07;12;Perjantai;7;18;25
93;01.07.2016;2016;07;13;Perjantai;12;6;18
93;01.07.2016;2016;07;14;Perjantai;16;13;29
93;01.07.2016;2016;07;15;Perjantai;14;18;32
93;01.07.2016;2016;07;16;Perjantai;24;11;35
93;01.07.2016;2016;07;17;Perjantai;3;13;16
93;01.07.2016;2016;07;18;Perjantai;11;9;20
93;01.07.2016;2016;07;19;Perjantai;16;15;31
93;01.07.2016;2016;07;20;Perjantai;8;17;25
93;01.07.2016;2016;07;21;Perjantai;11;6;17
93;01.07.2016;2016;07;22;Perjantai;4;3;7
93;01.07.2016;2016;07;23;Perjantai;3;4;7
93;02.07.2016;2016;07;00;Lauantai;0;0;0
93;02.07.2016;2016;07;01;Lauantai;0;4;4
93;02.07.2016;2016;07;02;Lauantai;2;2;4
93;02.07.2016;2016;07;03;Lauantai;0;3;3
93;02.07.2016;2016;07;04;Lauantai;1;1;2
93;02.07.2016;2016;07;05;Lauantai;1;1;2
93;02.07.2016;2016;07;06;Lauantai;0;2;2
93;02.07.2016;2016;07;07;Lauantai;6;3;9
93;02.07.2016;2016;07;08;Lauantai;11;7;18
93;02.07.2016;2016;07;09;Lauantai;7;15;22
93;02.07.2016;2016;07;10;Lauantai;14;13;27
93;02.07.2016;2016;07;11;Lauantai;17;30;47
93;02.07.2016;2016;07;12;Lauantai;26;20;46
93;02.07.2016;2016;07;13;Lauantai;14;23;37
93;02.07.2016;2016;07;14;Lauantai;24;30;54
93;02.07.2016;2016;07;15;Lauantai;9;25;34
93;02.07.2016;2016;07;16;Lauantai;19;12;31
93;02.07.2016;2016;07;17;Lauantai;7;15;22
93;02.07.2016;2016;07;18;Lauantai;19;18;37
93;02.07.2016;2016;07;19;Lauantai;14;18;32
93;02.07.2016;2016;07;20;Lauantai;18;12;30
93;02.07.2016;2016;07;21;Lauantai;12;8;20
93;02.07.2016;2016;07;22;Lauantai;7;6;13
93;02.07.2016;2016;07;23;Lauantai;11;12;23
93;03.07.2016;2016;07;00;Sunnuntai;2;2;4
93;03.07.2016;2016;07;01;Sunnuntai;3;3;6
93;03.07.2016;2016;07;02;Sunnuntai;5;4;9
93;03.07.2016;2016;07;03;Sunnuntai;2;1;3
93;03.07.2016;2016;07;04;Sunnuntai;2;3;5
93;03.07.2016;2016;07;05;Sunnuntai;2;4;6
93;03.07.2016;2016;07;06;Sunnuntai;1;2;3
93;03.07.2016;2016;07;07;Sunnuntai;2;3;5
93;03.07.2016;2016;07;08;Sunnuntai;4;3;7
93;03.07.2016;2016;07;09;Sunnuntai;4;3;7
93;03.07.2016;2016;07;10;Sunnuntai;5;3;8
93;03.07.2016;2016;07;11;Sunnuntai;3;3;6
93;03.07.2016;2016;07;12;Sunnuntai;4;0;4
93;03.07.2016;2016;07;13;Sunnuntai;13;5;18
93;03.07.2016;2016;07;14;Sunnuntai;8;3;11
93;03.07.2016;2016;07;15;Sunnuntai;8;8;16
93;03.07.2016;2016;07;16;Sunnuntai;16;11;27
93;03.07.2016;2016;07;17;Sunnuntai;19;28;47
93;03.07.2016;2016;07;18;Sunnuntai;23;26;49
93;03.07.2016;2016;07;19;Sunnuntai;19;22;41
93;03.07.2016;2016;07;20;Sunnuntai;14;14;28
93;03.07.2016;2016;07;21;Sunnuntai;6;5;11
93;03.07.2016;2016;07;22;Sunnuntai;2;3;5
93;03.07.2016;2016;07;23;Sunnuntai;1;3;4
93;04.07.2016;2016;07;00;Maanantai;2;0;2
93;04.07.2016;2016;07;01;Maanantai;1;0;1
93;04.07.2016;2016;07;02;Maanantai;2;0;2
93;04.07.2016;2016;07;03;Maanantai;0;3;3
93;04.07.2016;2016;07;04;Maanantai;0;0;0
93;04.07.2016;2016;07;05;Maanantai;6;2;8
93;04.07.2016;2016;07;06;Maanantai;13;5;18
93;04.07.2016;2016;07;07;Maanantai;11;14;25
93;04.07.2016;2016;07;08;Maanantai;11;13;24
93;04.07.2016;2016;07;09;Maanantai;6;5;11
93;04.07.2016;2016;07;10;Maanantai;12;10;22
93;04.07.2016;2016;07;11;Maanantai;9;7;16
93;04.07.2016;2016;07;12;Maanantai;1;1;2
93;04.07.2016;2016;07;13;Maanantai;6;4;10
93;04.07.2016;2016;07;14;Maanantai;7;12;19
93;04.07.2016;2016;07;15;Maanantai;11;12;23
93;04.07.2016;2016;07;16;Maanantai;16;21;37
93;04.07.2016;2016;07;17;Maanantai;13;16;29
93;04.07.2016;2016;07;18;Maanantai;8;19;27
93;04.07.2016;2016;07;19;Maanantai;19;10;29
93;04.07.2016;2016;07;20;Maanantai;7;3;10
93;04.07.2016;2016;07;21;Maanantai;1;2;3
93;04.07.2016;2016;07;22;Maanantai;2;2;4
93;04.07.2016;2016;07;23;Maanantai;0;2;2
93;05.07.2016;2016;07;00;Tiistai;0;1;1
93;05.07.2016;2016;07;01;Tiistai;1;1;2
93;05.07.2016;2016;07;02;Tiistai;1;0;1
93;05.07.2016;2016;07;03;Tiistai;0;0;0
93;05.07.2016;2016;07;04;Tiistai;3;6;9
93;05.07.2016;2016;07;05;Tiistai;1;2;3
93;05.07.2016;2016;07;06;Tiistai;9;6;15
93;05.07.2016;2016;07;07;Tiistai;9;14;23
93;05.07.2016;2016;07;08;Tiistai;6;11;17
93;05.07.2016;2016;07;09;Tiistai;5;3;8
93;05.07.2016;2016;07;10;Tiistai;5;2;7
93;05.07.2016;2016;07;11;Tiistai;4;4;8
93;05.07.2016;2016;07;12;Tiistai;7;12;19
93;05.07.2016;2016;07;13;Tiistai;15;13;28
93;05.07.2016;2016;07;14;Tiistai;14;14;28
93;05.07.2016;2016;07;15;Tiistai;6;13;19
93;05.07.2016;2016;07;16;Tiistai;11;10;21
93;05.07.2016;2016;07;17;Tiistai;11;7;18
93;05.07.2016;2016;07;18;Tiistai;4;7;11
93;05.07.2016;2016;07;19;Tiistai;7;9;16
93;05.07.2016;2016;07;20;Tiistai;3;6;9
93;05.07.2016;2016;07;21;Tiistai;2;4;6
93;05.07.2016;2016;07;22;Tiistai;1;5;6
93;05.07.2016;2016;07;23;Tiistai;2;1;3
93;06.07.2016;2016;07;00;Keskiviikko;0;0;0
93;06.07.2016;2016;07;01;Keskiviikko;2;2;4
93;06.07.2016;2016;07;02;Keskiviikko;0;1;1
93;06.07.2016;2016;07;03;Keskiviikko;0;0;0
93;06.07.2016;2016;07;04;Keskiviikko;1;0;1
93;06.07.2016;2016;07;05;Keskiviikko;3;2;5
93;06.07.2016;2016;07;06;Keskiviikko;13;6;19
93;06.07.2016;2016;07;07;Keskiviikko;13;14;27
93;06.07.2016;2016;07;08;Keskiviikko;10;10;20
93;06.07.2016;2016;07;09;Keskiviikko;3;1;4
93;06.07.2016;2016;07;10;Keskiviikko;3;7;10
93;06.07.2016;2016;07;11;Keskiviikko;6;5;11
93;06.07.2016;2016;07;12;Keskiviikko;8;12;20
93;06.07.2016;2016;07;13;Keskiviikko;14;15;29
93;06.07.2016;2016;07;14;Keskiviikko;16;25;41
93;06.07.2016;2016;07;15;Keskiviikko;17;17;34
93;06.07.2016;2016;07;16;Keskiviikko;23;27;50
93;06.07.2016;2016;07;17;Keskiviikko;20;30;50
93;06.07.2016;2016;07;18;Keskiviikko;6;6;12
93;06.07.2016;2016;07;19;Keskiviikko;5;4;9
93;06.07.2016;2016;07;20;Keskiviikko;9;10;19
93;06.07.2016;2016;07;21;Keskiviikko;6;14;20
93;06.07.2016;2016;07;22;Keskiviikko;1;1;2
93;06.07.2016;2016;07;23;Keskiviikko;0;2;2
93;07.07.2016;2016;07;00;Torstai;0;1;1
93;07.07.2016;2016;07;01;Torstai;1;1;2
93;07.07.2016;2016;07;02;Torstai;1;1;2
93;07.07.2016;2016;07;03;Torstai;1;3;4
93;07.07.2016;2016;07;04;Torstai;1;0;1
93;07.07.2016;2016;07;05;Torstai;4;2;6
93;07.07.2016;2016;07;06;Torstai;12;11;23
93;07.07.2016;2016;07;07;Torstai;16;17;33
93;07.07.2016;2016;07;08;Torstai;22;17;39
93;07.07.2016;2016;07;09;Torstai;7;3;10
93;07.07.2016;2016;07;10;Torstai;2;2;4
93;07.07.2016;2016;07;11;Torstai;5;5;10
93;07.07.2016;2016;07;12;Torstai;2;2;4
93;07.07.2016;2016;07;13;Torstai;3;3;6
93;07.07.2016;2016;07;14;Torstai;11;7;18
93;07.07.2016;2016;07;15;Torstai;15;20;35
93;07.07.2016;2016;07;16;Torstai;20;16;36
93;07.07.2016;2016;07;17;Torstai;11;13;24
93;07.07.2016;2016;07;18;Torstai;13;18;31
93;07.07.2016;2016;07;19;Torstai;23;18;41
93;07.07.2016;2016;07;20;Torstai;3;11;14
93;07.07.2016;2016;07;21;Torstai;14;14;28
93;07.07.2016;2016;07;22;Torstai;4;8;12
93;07.07.2016;2016;07;23;Torstai;0;3;3
93;08.07.2016;2016;07;00;Perjantai;10;1;11
93;08.07.2016;2016;07;01;Perjantai;1;0;1
93;08.07.2016;2016;07;02;Perjantai;0;0;0
93;08.07.2016;2016;07;03;Perjantai;0;0;0
93;08.07.2016;2016;07;04;Perjantai;3;2;5
93;08.07.2016;2016;07;05;Perjantai;4;8;12
93;08.07.2016;2016;07;06;Perjantai;10;3;13
93;08.07.2016;2016;07;07;Perjantai;11;15;26
93;08.07.2016;2016;07;08;Perjantai;13;17;30
93;08.07.2016;2016;07;09;Perjantai;10;16;26
93;08.07.2016;2016;07;10;Perjantai;17;9;26
93;08.07.2016;2016;07;11;Perjantai;7;8;15
93;08.07.2016;2016;07;12;Perjantai;22;22;44
93;08.07.2016;2016;07;13;Perjantai;29;21;50
93;08.07.2016;2016;07;14;Perjantai;19;19;38
93;08.07.2016;2016;07;15;Perjantai;26;27;53
93;08.07.2016;2016;07;16;Perjantai;33;25;58
93;08.07.2016;2016;07;17;Perjantai;20;26;46
93;08.07.2016;2016;07;18;Perjantai;28;28;56
93;08.07.2016;2016;07;19;Perjantai;29;17;46
93;08.07.2016;2016;07;20;Perjantai;4;21;25
93;08.07.2016;2016;07;21;Perjantai;12;16;28
93;08.07.2016;2016;07;22;Perjantai;17;15;32
93;08.07.2016;2016;07;23;Perjantai;1;2;3
93;09.07.2016;2016;07;00;Lauantai;3;3;6
93;09.07.2016;2016;07;01;Lauantai;2;1;3
93;09.07.2016;2016;07;02;Lauantai;0;0;0
93;09.07.2016;2016;07;03;Lauantai;0;0;0
93;09.07.2016;2016;07;04;Lauantai;1;0;1
93;09.07.2016;2016;07;05;Lauantai;0;3;3
93;09.07.2016;2016;07;06;Lauantai;3;1;4
93;09.07.2016;2016;07;07;Lauantai;6;3;9
93;09.07.2016;2016;07;08;Lauantai;1;3;4
93;09.07.2016;2016;07;09;Lauantai;3;4;7
93;09.07.2016;2016;07;10;Lauantai;12;6;18
93;09.07.2016;2016;07;11;Lauantai;4;12;16
93;09.07.2016;2016;07;12;Lauantai;13;19;32
93;09.07.2016;2016;07;13;Lauantai;16;13;29
93;09.07.2016;2016;07;14;Lauantai;18;17;35
93;09.07.2016;2016;07;15;Lauantai;20;11;31
93;09.07.2016;2016;07;16;Lauantai;18;14;32
93;09.07.2016;2016;07;17;Lauantai;16;8;24
93;09.07.2016;2016;07;18;Lauantai;19;15;34
93;09.07.2016;2016;07;19;Lauantai;19;12;31
93;09.07.2016;2016;07;20;Lauantai;11;4;15
93;09.07.2016;2016;07;21;Lauantai;7;6;13
93;09.07.2016;2016;07;22;Lauantai;2;4;6
93;09.07.2016;2016;07;23;Lauantai;5;3;8
93;10.07.2016;2016;07;00;Sunnuntai;1;6;7
93;10.07.2016;2016;07;01;Sunnuntai;7;3;10
93;10.07.2016;2016;07;02;Sunnuntai;0;0;0
93;10.07.2016;2016;07;03;Sunnuntai;0;0;0
93;10.07.2016;2016;07;04;Sunnuntai;0;5;5
93;10.07.2016;2016;07;05;Sunnuntai;1;0;1
93;10.07.2016;2016;07;06;Sunnuntai;1;3;4
93;10.07.2016;2016;07;07;Sunnuntai;3;0;3
93;10.07.2016;2016;07;08;Sunnuntai;11;4;15
93;10.07.2016;2016;07;09;Sunnuntai;14;16;30
93;10.07.2016;2016;07;10;Sunnuntai;18;4;22
93;10.07.2016;2016;07;11;Sunnuntai;13;25;38
93;10.07.2016;2016;07;12;Sunnuntai;32;33;65
93;10.07.2016;2016;07;13;Sunnuntai;27;21;48
93;10.07.2016;2016;07;14;Sunnuntai;22;26;48
93;10.07.2016;2016;07;15;Sunnuntai;17;25;42
93;10.07.2016;2016;07;16;Sunnuntai;29;31;60
93;10.07.2016;2016;07;17;Sunnuntai;18;28;46
93;10.07.2016;2016;07;18;Sunnuntai;23;15;38
93;10.07.2016;2016;07;19;Sunnuntai;23;24;47
93;10.07.2016;2016;07;20;Sunnuntai;21;17;38
93;10.07.2016;2016;07;21;Sunnuntai;13;23;36
93;10.07.2016;2016;07;22;Sunnuntai;7;1;8
93;10.07.2016;2016;07;23;Sunnuntai;5;6;11
93;11.07.2016;2016;07;00;Maanantai;0;1;1
93;11.07.2016;2016;07;01;Maanantai;0;5;5
93;11.07.2016;2016;07;02;Maanantai;1;4;5
93;11.07.2016;2016;07;03;Maanantai;0;0;0
93;11.07.2016;2016;07;04;Maanantai;0;2;2
93;11.07.2016;2016;07;05;Maanantai;3;3;6
93;11.07.2016;2016;07;06;Maanantai;23;15;38
93;11.07.2016;2016;07;07;Maanantai;18;25;43
93;11.07.2016;2016;07;08;Maanantai;17;19;36
93;11.07.2016;2016;07;09;Maanantai;11;5;16
93;11.07.2016;2016;07;10;Maanantai;14;10;24
93;11.07.2016;2016;07;11;Maanantai;22;20;42
93;11.07.2016;2016;07;12;Maanantai;28;17;45
93;11.07.2016;2016;07;13;Maanantai;32;25;57
93;11.07.2016;2016;07;14;Maanantai;29;46;75
93;11.07.2016;2016;07;15;Maanantai;48;55;103
93;11.07.2016;2016;07;16;Maanantai;43;52;95
93;11.07.2016;2016;07;17;Maanantai;28;38;66
93;11.07.2016;2016;07;18;Maanantai;38;45;83
93;11.07.2016;2016;07;19;Maanantai;34;43;77
93;11.07.2016;2016;07;20;Maanantai;28;20;48
93;11.07.2016;2016;07;21;Maanantai;28;25;53
93;11.07.2016;2016;07;22;Maanantai;7;11;18
93;11.07.2016;2016;07;23;Maanantai;4;9;13
93;12.07.2016;2016;07;00;Tiistai;0;4;4
93;12.07.2016;2016;07;01;Tiistai;0;4;4
93;12.07.2016;2016;07;02;Tiistai;1;2;3
93;12.07.2016;2016;07;03;Tiistai;0;0;0
93;12.07.2016;2016;07;04;Tiistai;2;1;3
93;12.07.2016;2016;07;05;Tiistai;4;3;7
93;12.07.2016;2016;07;06;Tiistai;30;13;43
93;12.07.2016;2016;07;07;Tiistai;28;27;55
93;12.07.2016;2016;07;08;Tiistai;20;19;39
93;12.07.2016;2016;07;09;Tiistai;24;23;47
93;12.07.2016;2016;07;10;Tiistai;13;7;20
93;12.07.2016;2016;07;11;Tiistai;19;31;50
93;12.07.2016;2016;07;12;Tiistai;35;25;60
93;12.07.2016;2016;07;13;Tiistai;39;41;80
93;12.07.2016;2016;07;14;Tiistai;38;30;68
93;12.07.2016;2016;07;15;Tiistai;32;48;80
93;12.07.2016;2016;07;16;Tiistai;30;47;77
93;12.07.2016;2016;07;17;Tiistai;16;44;60
93;12.07.2016;2016;07;18;Tiistai;21;24;45
93;12.07.2016;2016;07;19;Tiistai;26;27;53
93;12.07.2016;2016;07;20;Tiistai;33;28;61
93;12.07.2016;2016;07;21;Tiistai;17;17;34
93;12.07.2016;2016;07;22;Tiistai;6;14;20
93;12.07.2016;2016;07;23;Tiistai;4;5;9
93;13.07.2016;2016;07;00;Keskiviikko;0;2;2
93;13.07.2016;2016;07;01;Keskiviikko;0;1;1
93;13.07.2016;2016;07;02;Keskiviikko;1;0;1
93;13.07.2016;2016;07;03;Keskiviikko;3;0;3
93;13.07.2016;2016;07;04;Keskiviikko;1;2;3
93;13.07.2016;2016;07;05;Keskiviikko;4;2;6
93;13.07.2016;2016;07;06;Keskiviikko;23;14;37
93;13.07.2016;2016;07;07;Keskiviikko;23;22;45
93;13.07.2016;2016;07;08;Keskiviikko;21;22;43
93;13.07.2016;2016;07;09;Keskiviikko;14;11;25
93;13.07.2016;2016;07;10;Keskiviikko;19;21;40
93;13.07.2016;2016;07;11;Keskiviikko;23;22;45
93;13.07.2016;2016;07;12;Keskiviikko;21;18;39
93;13.07.2016;2016;07;13;Keskiviikko;37;21;58
93;13.07.2016;2016;07;14;Keskiviikko;33;32;65
93;13.07.2016;2016;07;15;Keskiviikko;32;49;81
93;13.07.2016;2016;07;16;Keskiviikko;43;54;97
93;13.07.2016;2016;07;17;Keskiviikko;37;34;71
93;13.07.2016;2016;07;18;Keskiviikko;29;36;65
93;13.07.2016;2016;07;19;Keskiviikko;29;38;67
93;13.07.2016;2016;07;20;Keskiviikko;28;30;58
93;13.07.2016;2016;07;21;Keskiviikko;24;14;38
93;13.07.2016;2016;07;22;Keskiviikko;13;19;32
93;13.07.2016;2016;07;23;Keskiviikko;0;5;5
93;14.07.2016;2016;07;00;Torstai;3;4;7
93;14.07.2016;2016;07;01;Torstai;0;4;4
93;14.07.2016;2016;07;02;Torstai;0;0;0
93;14.07.2016;2016;07;03;Torstai;2;0;2
93;14.07.2016;2016;07;04;Torstai;2;1;3
93;14.07.2016;2016;07;05;Torstai;5;5;10
93;14.07.2016;2016;07;06;Torstai;22;10;32
93;14.07.2016;2016;07;07;Torstai;20;19;39
93;14.07.2016;2016;07;08;Torstai;14;17;31
93;14.07.2016;2016;07;09;Torstai;12;17;29
93;14.07.2016;2016;07;10;Torstai;25;20;45
93;14.07.2016;2016;07;11;Torstai;43;25;68
93;14.07.2016;2016;07;12;Torstai;20;32;52
93;14.07.2016;2016;07;13;Torstai;30;22;52
93;14.07.2016;2016;07;14;Torstai;21;24;45
93;14.07.2016;2016;07;15;Torstai;29;40;69
93;14.07.2016;2016;07;16;Torstai;33;40;73
93;14.07.2016;2016;07;17;Torstai;34;37;71
93;14.07.2016;2016;07;18;Torstai;22;24;46
93;14.07.2016;2016;07;19;Torstai;18;23;41
93;14.07.2016;2016;07;20;Torstai;20;23;43
93;14.07.2016;2016;07;21;Torstai;15;13;28
93;14.07.2016;2016;07;22;Torstai;10;17;27
93;14.07.2016;2016;07;23;Torstai;4;8;12
93;15.07.2016;2016;07;00;Perjantai;4;7;11
93;15.07.2016;2016;07;01;Perjantai;3;3;6
93;15.07.2016;2016;07;02;Perjantai;0;6;6
93;15.07.2016;2016;07;03;Perjantai;0;1;1
93;15.07.2016;2016;07;04;Perjantai;3;0;3
93;15.07.2016;2016;07;05;Perjantai;4;4;8
93;15.07.2016;2016;07;06;Perjantai;14;4;18
93;15.07.2016;2016;07;07;Perjantai;13;13;26
93;15.07.2016;2016;07;08;Perjantai;12;11;23
93;15.07.2016;2016;07;09;Perjantai;8;10;18
93;15.07.2016;2016;07;10;Perjantai;11;11;22
93;15.07.2016;2016;07;11;Perjantai;16;11;27
93;15.07.2016;2016;07;12;Perjantai;22;18;40
93;15.07.2016;2016;07;13;Perjantai;23;18;41
93;15.07.2016;2016;07;14;Perjantai;22;29;51
93;15.07.2016;2016;07;15;Perjantai;13;11;24
93;15.07.2016;2016;07;16;Perjantai;24;17;41
93;15.07.2016;2016;07;17;Perjantai;8;7;15
93;15.07.2016;2016;07;18;Perjantai;12;25;37
93;15.07.2016;2016;07;19;Perjantai;18;20;38
93;15.07.2016;2016;07;20;Perjantai;11;12;23
93;15.07.2016;2016;07;21;Perjantai;12;15;27
93;15.07.2016;2016;07;22;Perjantai;0;16;16
93;15.07.2016;2016;07;23;Perjantai;5;1;6
93;16.07.2016;2016;07;00;Lauantai;2;2;4
93;16.07.2016;2016;07;01;Lauantai;3;2;5
93;16.07.2016;2016;07;02;Lauantai;0;2;2
93;16.07.2016;2016;07;03;Lauantai;0;2;2
93;16.07.2016;2016;07;04;Lauantai;1;3;4
93;16.07.2016;2016;07;05;Lauantai;1;3;4
93;16.07.2016;2016;07;06;Lauantai;1;1;2
93;16.07.2016;2016;07;07;Lauantai;0;0;0
93;16.07.2016;2016;07;08;Lauantai;0;1;1
93;16.07.2016;2016;07;09;Lauantai;3;1;4
93;16.07.2016;2016;07;10;Lauantai;2;4;6
93;16.07.2016;2016;07;11;Lauantai;3;9;12
93;16.07.2016;2016;07;12;Lauantai;2;3;5
93;16.07.2016;2016;07;13;Lauantai;5;3;8
93;16.07.2016;2016;07;14;Lauantai;2;6;8
93;16.07.2016;2016;07;15;Lauantai;0;10;10
93;16.07.2016;2016;07;16;Lauantai;3;9;12
93;16.07.2016;2016;07;17;Lauantai;18;8;26
93;16.07.2016;2016;07;18;Lauantai;16;13;29
93;16.07.2016;2016;07;19;Lauantai;10;18;28
93;16.07.2016;2016;07;20;Lauantai;16;9;25
93;16.07.2016;2016;07;21;Lauantai;7;7;14
93;16.07.2016;2016;07;22;Lauantai;3;3;6
93;16.07.2016;2016;07;23;Lauantai;5;8;13
93;17.07.2016;2016;07;00;Sunnuntai;0;7;7
93;17.07.2016;2016;07;01;Sunnuntai;2;0;2
93;17.07.2016;2016;07;02;Sunnuntai;1;1;2
93;17.07.2016;2016;07;03;Sunnuntai;3;3;6
93;17.07.2016;2016;07;04;Sunnuntai;0;5;5
93;17.07.2016;2016;07;05;Sunnuntai;2;0;2
93;17.07.2016;2016;07;06;Sunnuntai;4;3;7
93;17.07.2016;2016;07;07;Sunnuntai;2;3;5
93;17.07.2016;2016;07;08;Sunnuntai;8;6;14
93;17.07.2016;2016;07;09;Sunnuntai;12;3;15
93;17.07.2016;2016;07;10;Sunnuntai;10;9;19
93;17.07.2016;2016;07;11;Sunnuntai;17;15;32
93;17.07.2016;2016;07;12;Sunnuntai;21;25;46
93;17.07.2016;2016;07;13;Sunnuntai;14;14;28
93;17.07.2016;2016;07;14;Sunnuntai;13;15;28
93;17.07.2016;2016;07;15;Sunnuntai;8;15;23
93;17.07.2016;2016;07;16;Sunnuntai;10;2;12
93;17.07.2016;2016;07;17;Sunnuntai;6;6;12
93;17.07.2016;2016;07;18;Sunnuntai;19;12;31
93;17.07.2016;2016;07;19;Sunnuntai;23;11;34
93;17.07.2016;2016;07;20;Sunnuntai;30;21;51
93;17.07.2016;2016;07;21;Sunnuntai;9;11;20
93;17.07.2016;2016;07;22;Sunnuntai;2;8;10
93;17.07.2016;2016;07;23;Sunnuntai;1;2;3
93;18.07.2016;2016;07;00;Maanantai;2;2;4
93;18.07.2016;2016;07;01;Maanantai;1;3;4
93;18.07.2016;2016;07;02;Maanantai;1;0;1
93;18.07.2016;2016;07;03;Maanantai;0;0;0
93;18.07.2016;2016;07;04;Maanantai;2;3;5
93;18.07.2016;2016;07;05;Maanantai;2;1;3
93;18.07.2016;2016;07;06;Maanantai;22;9;31
93;18.07.2016;2016;07;07;Maanantai;17;18;35
93;18.07.2016;2016;07;08;Maanantai;8;23;31
93;18.07.2016;2016;07;09;Maanantai;12;5;17
93;18.07.2016;2016;07;10;Maanantai;19;14;33
93;18.07.2016;2016;07;11;Maanantai;24;21;45
93;18.07.2016;2016;07;12;Maanantai;30;20;50
93;18.07.2016;2016;07;13;Maanantai;21;27;48
93;18.07.2016;2016;07;14;Maanantai;36;40;76
93;18.07.2016;2016;07;15;Maanantai;35;24;59
93;18.07.2016;2016;07;16;Maanantai;35;53;88
93;18.07.2016;2016;07;17;Maanantai;32;39;71
93;18.07.2016;2016;07;18;Maanantai;23;37;60
93;18.07.2016;2016;07;19;Maanantai;23;43;66
93;18.07.2016;2016;07;20;Maanantai;20;31;51
93;18.07.2016;2016;07;21;Maanantai;19;20;39
93;18.07.2016;2016;07;22;Maanantai;5;11;16
93;18.07.2016;2016;07;23;Maanantai;1;4;5
93;19.07.2016;2016;07;00;Tiistai;3;1;4
93;19.07.2016;2016;07;01;Tiistai;0;3;3
93;19.07.2016;2016;07;02;Tiistai;0;1;1
93;19.07.2016;2016;07;03;Tiistai;0;0;0
93;19.07.2016;2016;07;04;Tiistai;1;0;1
93;19.07.2016;2016;07;05;Tiistai;1;2;3
93;19.07.2016;2016;07;06;Tiistai;26;6;32
93;19.07.2016;2016;07;07;Tiistai;27;23;50
93;19.07.2016;2016;07;08;Tiistai;14;22;36
93;19.07.2016;2016;07;09;Tiistai;11;10;21
93;19.07.2016;2016;07;10;Tiistai;18;16;34
93;19.07.2016;2016;07;11;Tiistai;22;18;40
93;19.07.2016;2016;07;12;Tiistai;26;31;57
93;19.07.2016;2016;07;13;Tiistai;32;28;60
93;19.07.2016;2016;07;14;Tiistai;28;26;54
93;19.07.2016;2016;07;15;Tiistai;22;33;55
93;19.07.2016;2016;07;16;Tiistai;38;43;81
93;19.07.2016;2016;07;17;Tiistai;21;36;57
93;19.07.2016;2016;07;18;Tiistai;27;38;65
93;19.07.2016;2016;07;19;Tiistai;19;30;49
93;19.07.2016;2016;07;20;Tiistai;21;26;47
93;19.07.2016;2016;07;21;Tiistai;15;23;38
93;19.07.2016;2016;07;22;Tiistai;1;19;20
93;19.07.2016;2016;07;23;Tiistai;1;2;3
93;20.07.2016;2016;07;00;Keskiviikko;3;2;5
93;20.07.2016;2016;07;01;Keskiviikko;0;1;1
93;20.07.2016;2016;07;02;Keskiviikko;0;1;1
93;20.07.2016;2016;07;03;Keskiviikko;0;1;1
93;20.07.2016;2016;07;04;Keskiviikko;0;1;1
93;20.07.2016;2016;07;05;Keskiviikko;2;5;7
93;20.07.2016;2016;07;06;Keskiviikko;30;7;37
93;20.07.2016;2016;07;07;Keskiviikko;21;28;49
93;20.07.2016;2016;07;08;Keskiviikko;13;21;34
93;20.07.2016;2016;07;09;Keskiviikko;15;15;30
93;20.07.2016;2016;07;10;Keskiviikko;26;19;45
93;20.07.2016;2016;07;11;Keskiviikko;22;18;40
93;20.07.2016;2016;07;12;Keskiviikko;32;28;60
93;20.07.2016;2016;07;13;Keskiviikko;23;24;47
93;20.07.2016;2016;07;14;Keskiviikko;31;34;65
93;20.07.2016;2016;07;15;Keskiviikko;30;43;73
93;20.07.2016;2016;07;16;Keskiviikko;32;40;72
93;20.07.2016;2016;07;17;Keskiviikko;48;44;92
93;20.07.2016;2016;07;18;Keskiviikko;34;44;78
93;20.07.2016;2016;07;19;Keskiviikko;31;55;86
93;20.07.2016;2016;07;20;Keskiviikko;29;29;58
93;20.07.2016;2016;07;21;Keskiviikko;20;25;45
93;20.07.2016;2016;07;22;Keskiviikko;14;16;30
93;20.07.2016;2016;07;23;Keskiviikko;4;4;8
93;21.07.2016;2016;07;00;Torstai;2;1;3
93;21.07.2016;2016;07;01;Torstai;2;2;4
93;21.07.2016;2016;07;02;Torstai;3;1;4
93;21.07.2016;2016;07;03;Torstai;0;1;1
93;21.07.2016;2016;07;04;Torstai;0;1;1
93;21.07.2016;2016;07;05;Torstai;2;5;7
93;21.07.2016;2016;07;06;Torstai;23;5;28
93;21.07.2016;2016;07;07;Torstai;17;24;41
93;21.07.2016;2016;07;08;Torstai;23;20;43
93;21.07.2016;2016;07;09;Torstai;18;12;30
93;21.07.2016;2016;07;10;Torstai;26;22;48
93;21.07.2016;2016;07;11;Torstai;25;18;43
93;21.07.2016;2016;07;12;Torstai;32;18;50
93;21.07.2016;2016;07;13;Torstai;22;27;49
93;21.07.2016;2016;07;14;Torstai;31;35;66
93;21.07.2016;2016;07;15;Torstai;20;51;71
93;21.07.2016;2016;07;16;Torstai;46;54;100
93;21.07.2016;2016;07;17;Torstai;30;48;78
93;21.07.2016;2016;07;18;Torstai;29;24;53
93;21.07.2016;2016;07;19;Torstai;27;40;67
93;21.07.2016;2016;07;20;Torstai;29;25;54
93;21.07.2016;2016;07;21;Torstai;15;31;46
93;21.07.2016;2016;07;22;Torstai;12;20;32
93;21.07.2016;2016;07;23;Torstai;6;8;14
93;22.07.2016;2016;07;00;Perjantai;3;1;4
93;22.07.2016;2016;07;01;Perjantai;1;1;2
93;22.07.2016;2016;07;02;Perjantai;2;0;2
93;22.07.2016;2016;07;03;Perjantai;3;2;5
93;22.07.2016;2016;07;04;Perjantai;2;3;5
93;22.07.2016;2016;07;05;Perjantai;3;6;9
93;22.07.2016;2016;07;06;Perjantai;26;2;28
93;22.07.2016;2016;07;07;Perjantai;16;22;38
93;22.07.2016;2016;07;08;Perjantai;15;19;34
93;22.07.2016;2016;07;09;Perjantai;11;2;13
93;22.07.2016;2016;07;10;Perjantai;27;15;42
93;22.07.2016;2016;07;11;Perjantai;18;17;35
93;22.07.2016;2016;07;12;Perjantai;21;30;51
93;22.07.2016;2016;07;13;Perjantai;31;32;63
93;22.07.2016;2016;07;14;Perjantai;38;31;69
93;22.07.2016;2016;07;15;Perjantai;28;44;72
93;22.07.2016;2016;07;16;Perjantai;37;37;74
93;22.07.2016;2016;07;17;Perjantai;29;36;65
93;22.07.2016;2016;07;18;Perjantai;20;22;42
93;22.07.2016;2016;07;19;Perjantai;15;26;41
93;22.07.2016;2016;07;20;Perjantai;8;17;25
93;22.07.2016;2016;07;21;Perjantai;20;19;39
93;22.07.2016;2016;07;22;Perjantai;8;17;25
93;22.07.2016;2016;07;23;Perjantai;3;10;13
93;23.07.2016;2016;07;00;Lauantai;5;3;8
93;23.07.2016;2016;07;01;Lauantai;0;11;11
93;23.07.2016;2016;07;02;Lauantai;4;1;5
93;23.07.2016;2016;07;03;Lauantai;0;4;4
93;23.07.2016;2016;07;04;Lauantai;1;0;1
93;23.07.2016;2016;07;05;Lauantai;0;1;1
93;23.07.2016;2016;07;06;Lauantai;3;3;6
93;23.07.2016;2016;07;07;Lauantai;6;7;13
93;23.07.2016;2016;07;08;Lauantai;6;10;16
93;23.07.2016;2016;07;09;Lauantai;15;6;21
93;23.07.2016;2016;07;10;Lauantai;29;14;43
93;23.07.2016;2016;07;11;Lauantai;40;28;68
93;23.07.2016;2016;07;12;Lauantai;34;17;51
93;23.07.2016;2016;07;13;Lauantai;39;31;70
93;23.07.2016;2016;07;14;Lauantai;27;36;63
93;23.07.2016;2016;07;15;Lauantai;31;31;62
93;23.07.2016;2016;07;16;Lauantai;29;33;62
93;23.07.2016;2016;07;17;Lauantai;18;40;58
93;23.07.2016;2016;07;18;Lauantai;30;37;67
93;23.07.2016;2016;07;19;Lauantai;29;25;54
93;23.07.2016;2016;07;20;Lauantai;22;15;37
93;23.07.2016;2016;07;21;Lauantai;15;32;47
93;23.07.2016;2016;07;22;Lauantai;12;21;33
93;23.07.2016;2016;07;23;Lauantai;5;5;10
93;24.07.2016;2016;07;00;Sunnuntai;4;6;10
93;24.07.2016;2016;07;01;Sunnuntai;4;9;13
93;24.07.2016;2016;07;02;Sunnuntai;0;8;8
93;24.07.2016;2016;07;03;Sunnuntai;1;1;2
93;24.07.2016;2016;07;04;Sunnuntai;1;3;4
93;24.07.2016;2016;07;05;Sunnuntai;1;1;2
93;24.07.2016;2016;07;06;Sunnuntai;1;5;6
93;24.07.2016;2016;07;07;Sunnuntai;4;3;7
93;24.07.2016;2016;07;08;Sunnuntai;9;8;17
93;24.07.2016;2016;07;09;Sunnuntai;6;18;24
93;24.07.2016;2016;07;10;Sunnuntai;23;26;49
93;24.07.2016;2016;07;11;Sunnuntai;59;25;84
93;24.07.2016;2016;07;12;Sunnuntai;69;45;114
93;24.07.2016;2016;07;13;Sunnuntai;31;37;68
93;24.07.2016;2016;07;14;Sunnuntai;26;32;58
93;24.07.2016;2016;07;15;Sunnuntai;32;37;69
93;24.07.2016;2016;07;16;Sunnuntai;19;25;44
93;24.07.2016;2016;07;17;Sunnuntai;18;21;39
93;24.07.2016;2016;07;18;Sunnuntai;30;31;61
93;24.07.2016;2016;07;19;Sunnuntai;33;46;79
93;24.07.2016;2016;07;20;Sunnuntai;25;27;52
93;24.07.2016;2016;07;21;Sunnuntai;16;24;40
93;24.07.2016;2016;07;22;Sunnuntai;7;4;11
93;24.07.2016;2016;07;23;Sunnuntai;9;4;13
93;25.07.2016;2016;07;00;Maanantai;4;8;12
93;25.07.2016;2016;07;01;Maanantai;7;4;11
93;25.07.2016;2016;07;02;Maanantai;2;1;3
93;25.07.2016;2016;07;03;Maanantai;0;2;2
93;25.07.2016;2016;07;04;Maanantai;2;2;4
93;25.07.2016;2016;07;05;Maanantai;3;5;8
93;25.07.2016;2016;07;06;Maanantai;23;12;35
93;25.07.2016;2016;07;07;Maanantai;27;27;54
93;25.07.2016;2016;07;08;Maanantai;12;11;23
93;25.07.2016;2016;07;09;Maanantai;15;14;29
93;25.07.2016;2016;07;10;Maanantai;15;20;35
93;25.07.2016;2016;07;11;Maanantai;24;13;37
93;25.07.2016;2016;07;12;Maanantai;35;16;51
93;25.07.2016;2016;07;13;Maanantai;31;23;54
93;25.07.2016;2016;07;14;Maanantai;39;36;75
93;25.07.2016;2016;07;15;Maanantai;39;58;97
93;25.07.2016;2016;07;16;Maanantai;52;49;101
93;25.07.2016;2016;07;17;Maanantai;48;51;99
93;25.07.2016;2016;07;18;Maanantai;32;47;79
93;25.07.2016;2016;07;19;Maanantai;27;41;68
93;25.07.2016;2016;07;20;Maanantai;27;27;54
93;25.07.2016;2016;07;21;Maanantai;7;27;34
93;25.07.2016;2016;07;22;Maanantai;9;7;16
93;25.07.2016;2016;07;23;Maanantai;3;7;10
93;26.07.2016;2016;07;00;Tiistai;0;2;2
93;26.07.2016;2016;07;01;Tiistai;0;2;2
93;26.07.2016;2016;07;02;Tiistai;1;0;1
93;26.07.2016;2016;07;03;Tiistai;2;0;2
93;26.07.2016;2016;07;04;Tiistai;2;3;5
93;26.07.2016;2016;07;05;Tiistai;3;4;7
93;26.07.2016;2016;07;06;Tiistai;26;18;44
93;26.07.2016;2016;07;07;Tiistai;27;35;62
93;26.07.2016;2016;07;08;Tiistai;22;37;59
93;26.07.2016;2016;07;09;Tiistai;10;22;32
93;26.07.2016;2016;07;10;Tiistai;20;29;49
93;26.07.2016;2016;07;11;Tiistai;40;38;78
93;26.07.2016;2016;07;12;Tiistai;34;36;70
93;26.07.2016;2016;07;13;Tiistai;34;22;56
93;26.07.2016;2016;07;14;Tiistai;40;41;81
93;26.07.2016;2016;07;15;Tiistai;62;53;115
93;26.07.2016;2016;07;16;Tiistai;39;44;83
93;26.07.2016;2016;07;17;Tiistai;49;51;100
93;26.07.2016;2016;07;18;Tiistai;33;58;91
93;26.07.2016;2016;07;19;Tiistai;41;47;88
93;26.07.2016;2016;07;20;Tiistai;27;28;55
93;26.07.2016;2016;07;21;Tiistai;17;22;39
93;26.07.2016;2016;07;22;Tiistai;6;10;16
93;26.07.2016;2016;07;23;Tiistai;1;18;19
93;27.07.2016;2016;07;00;Keskiviikko;6;2;8
93;27.07.2016;2016;07;01;Keskiviikko;5;8;13
93;27.07.2016;2016;07;02;Keskiviikko;2;2;4
93;27.07.2016;2016;07;03;Keskiviikko;0;2;2
93;27.07.2016;2016;07;04;Keskiviikko;0;0;0
93;27.07.2016;2016;07;05;Keskiviikko;4;8;12
93;27.07.2016;2016;07;06;Keskiviikko;18;7;25
93;27.07.2016;2016;07;07;Keskiviikko;13;30;43
93;27.07.2016;2016;07;08;Keskiviikko;10;15;25
93;27.07.2016;2016;07;09;Keskiviikko;1;4;5
93;27.07.2016;2016;07;10;Keskiviikko;7;2;9
93;27.07.2016;2016;07;11;Keskiviikko;6;5;11
93;27.07.2016;2016;07;12;Keskiviikko;16;13;29
93;27.07.2016;2016;07;13;Keskiviikko;18;22;40
93;27.07.2016;2016;07;14;Keskiviikko;20;10;30
93;27.07.2016;2016;07;15;Keskiviikko;30;22;52
93;27.07.2016;2016;07;16;Keskiviikko;41;36;77
93;27.07.2016;2016;07;17;Keskiviikko;40;24;64
93;27.07.2016;2016;07;18;Keskiviikko;31;24;55
93;27.07.2016;2016;07;19;Keskiviikko;25;48;73
93;27.07.2016;2016;07;20;Keskiviikko;20;34;54
93;27.07.2016;2016;07;21;Keskiviikko;17;21;38
93;27.07.2016;2016;07;22;Keskiviikko;5;17;22
93;27.07.2016;2016;07;23;Keskiviikko;4;3;7
93;28.07.2016;2016;07;00;Torstai;2;4;6
93;28.07.2016;2016;07;01;Torstai;0;5;5
93;28.07.2016;2016;07;02;Torstai;3;5;8
93;28.07.2016;2016;07;03;Torstai;0;0;0
93;28.07.2016;2016;07;04;Torstai;0;0;0
93;28.07.2016;2016;07;05;Torstai;7;4;11
93;28.07.2016;2016;07;06;Torstai;15;12;27
93;28.07.2016;2016;07;07;Torstai;26;21;47
93;28.07.2016;2016;07;08;Torstai;17;20;37
93;28.07.2016;2016;07;09;Torstai;9;14;23
93;28.07.2016;2016;07;10;Torstai;20;14;34
93;28.07.2016;2016;07;11;Torstai;14;16;30
93;28.07.2016;2016;07;12;Torstai;20;13;33
93;28.07.2016;2016;07;13;Torstai;27;24;51
93;28.07.2016;2016;07;14;Torstai;33;18;51
93;28.07.2016;2016;07;15;Torstai;28;41;69
93;28.07.2016;2016;07;16;Torstai;44;50;94
93;28.07.2016;2016;07;17;Torstai;30;31;61
93;28.07.2016;2016;07;18;Torstai;16;26;42
93;28.07.2016;2016;07;19;Torstai;23;41;64
93;28.07.2016;2016;07;20;Torstai;17;13;30
93;28.07.2016;2016;07;21;Torstai;13;14;27
93;28.07.2016;2016;07;22;Torstai;7;4;11
93;28.07.2016;2016;07;23;Torstai;2;1;3
93;29.07.2016;2016;07;00;Perjantai;1;3;4
93;29.07.2016;2016;07;01;Perjantai;0;4;4
93;29.07.2016;2016;07;02;Perjantai;0;1;1
93;29.07.2016;2016;07;03;Perjantai;0;0;0
93;29.07.2016;2016;07;04;Perjantai;0;0;0
93;29.07.2016;2016;07;05;Perjantai;6;4;10
93;29.07.2016;2016;07;06;Perjantai;16;9;25
93;29.07.2016;2016;07;07;Perjantai;14;16;30
93;29.07.2016;2016;07;08;Perjantai;8;12;20
93;29.07.2016;2016;07;09;Perjantai;13;19;32
93;29.07.2016;2016;07;10;Perjantai;26;19;45
93;29.07.2016;2016;07;11;Perjantai;20;21;41
93;29.07.2016;2016;07;12;Perjantai;28;17;45
93;29.07.2016;2016;07;13;Perjantai;31;22;53
93;29.07.2016;2016;07;14;Perjantai;34;21;55
93;29.07.2016;2016;07;15;Perjantai;36;25;61
93;29.07.2016;2016;07;16;Perjantai;19;26;45
93;29.07.2016;2016;07;17;Perjantai;24;32;56
93;29.07.2016;2016;07;18;Perjantai;49;25;74
93;29.07.2016;2016;07;19;Perjantai;33;11;44
93;29.07.2016;2016;07;20;Perjantai;12;33;45
93;29.07.2016;2016;07;21;Perjantai;13;18;31
93;29.07.2016;2016;07;22;Perjantai;14;12;26
93;29.07.2016;2016;07;23;Perjantai;4;11;15
93;30.07.2016;2016;07;00;Lauantai;3;14;17
93;30.07.2016;2016;07;01;Lauantai;1;21;22
93;30.07.2016;2016;07;02;Lauantai;3;21;24
93;30.07.2016;2016;07;03;Lauantai;0;11;11
93;30.07.2016;2016;07;04;Lauantai;0;9;9
93;30.07.2016;2016;07;05;Lauantai;1;2;3
93;30.07.2016;2016;07;06;Lauantai;1;1;2
93;30.07.2016;2016;07;07;Lauantai;4;1;5
93;30.07.2016;2016;07;08;Lauantai;5;9;14
93;30.07.2016;2016;07;09;Lauantai;22;10;32
93;30.07.2016;2016;07;10;Lauantai;19;17;36
93;30.07.2016;2016;07;11;Lauantai;26;20;46
93;30.07.2016;2016;07;12;Lauantai;39;26;65
93;30.07.2016;2016;07;13;Lauantai;25;25;50
93;30.07.2016;2016;07;14;Lauantai;19;26;45
93;30.07.2016;2016;07;15;Lauantai;7;9;16
93;30.07.2016;2016;07;16;Lauantai;13;5;18
93;30.07.2016;2016;07;17;Lauantai;17;15;32
93;30.07.2016;2016;07;18;Lauantai;24;20;44
93;30.07.2016;2016;07;19;Lauantai;25;19;44
93;30.07.2016;2016;07;20;Lauantai;17;14;31
93;30.07.2016;2016;07;21;Lauantai;12;13;25
93;30.07.2016;2016;07;22;Lauantai;8;10;18
93;30.07.2016;2016;07;23;Lauantai;6;5;11
93;31.07.2016;2016;07;00;Sunnuntai;1;9;10
93;31.07.2016;2016;07;01;Sunnuntai;0;17;17
93;31.07.2016;2016;07;02;Sunnuntai;0;13;13
93;31.07.2016;2016;07;03;Sunnuntai;0;9;9
93;31.07.2016;2016;07;04;Sunnuntai;0;5;5
93;31.07.2016;2016;07;05;Sunnuntai;2;2;4
93;31.07.2016;2016;07;06;Sunnuntai;1;4;5
93;31.07.2016;2016;07;07;Sunnuntai;2;4;6
93;31.07.2016;2016;07;08;Sunnuntai;3;5;8
93;31.07.2016;2016;07;09;Sunnuntai;9;9;18
93;31.07.2016;2016;07;10;Sunnuntai;9;7;16
93;31.07.2016;2016;07;11;Sunnuntai;9;12;21
93;31.07.2016;2016;07;12;Sunnuntai;4;6;10
93;31.07.2016;2016;07;13;Sunnuntai;8;7;15
93;31.07.2016;2016;07;14;Sunnuntai;16;13;29
93;31.07.2016;2016;07;15;Sunnuntai;15;15;30
93;31.07.2016;2016;07;16;Sunnuntai;6;13;19
93;31.07.2016;2016;07;17;Sunnuntai;12;9;21
93;31.07.2016;2016;07;18;Sunnuntai;8;1;9
93;31.07.2016;2016;07;19;Sunnuntai;5;14;19
93;31.07.2016;2016;07;20;Sunnuntai;11;9;20
93;31.07.2016;2016;07;21;Sunnuntai;2;5;7
93;31.07.2016;2016;07;22;Sunnuntai;1;2;3
93;31.07.2016;2016;07;23;Sunnuntai;2;5;7
93;01.08.2016;2016;08;00;Maanantai;1;0;1
93;01.08.2016;2016;08;01;Maanantai;2;0;2
93;01.08.2016;2016;08;02;Maanantai;0;0;0
93;01.08.2016;2016;08;03;Maanantai;0;3;3
93;01.08.2016;2016;08;04;Maanantai;0;1;1
93;01.08.2016;2016;08;05;Maanantai;2;2;4
93;01.08.2016;2016;08;06;Maanantai;24;12;36
93;01.08.2016;2016;08;07;Maanantai;28;27;55
93;01.08.2016;2016;08;08;Maanantai;10;20;30
93;01.08.2016;2016;08;09;Maanantai;7;6;13
93;01.08.2016;2016;08;10;Maanantai;18;6;24
93;01.08.2016;2016;08;11;Maanantai;19;16;35
93;01.08.2016;2016;08;12;Maanantai;18;12;30
93;01.08.2016;2016;08;13;Maanantai;26;17;43
93;01.08.2016;2016;08;14;Maanantai;17;14;31
93;01.08.2016;2016;08;15;Maanantai;34;35;69
93;01.08.2016;2016;08;16;Maanantai;51;42;93
93;01.08.2016;2016;08;17;Maanantai;25;38;63
93;01.08.2016;2016;08;18;Maanantai;23;31;54
93;01.08.2016;2016;08;19;Maanantai;26;31;57
93;01.08.2016;2016;08;20;Maanantai;25;25;50
93;01.08.2016;2016;08;21;Maanantai;8;25;33
93;01.08.2016;2016;08;22;Maanantai;14;13;27
93;01.08.2016;2016;08;23;Maanantai;5;2;7
93;02.08.2016;2016;08;00;Tiistai;2;2;4
93;02.08.2016;2016;08;01;Tiistai;0;2;2
93;02.08.2016;2016;08;02;Tiistai;0;2;2
93;02.08.2016;2016;08;03;Tiistai;0;1;1
93;02.08.2016;2016;08;04;Tiistai;0;1;1
93;02.08.2016;2016;08;05;Tiistai;7;3;10
93;02.08.2016;2016;08;06;Tiistai;24;12;36
93;02.08.2016;2016;08;07;Tiistai;29;34;63
93;02.08.2016;2016;08;08;Tiistai;9;16;25
93;02.08.2016;2016;08;09;Tiistai;4;2;6
93;02.08.2016;2016;08;10;Tiistai;5;3;8
93;02.08.2016;2016;08;11;Tiistai;16;9;25
93;02.08.2016;2016;08;12;Tiistai;14;15;29
93;02.08.2016;2016;08;13;Tiistai;13;10;23
93;02.08.2016;2016;08;14;Tiistai;6;10;16
93;02.08.2016;2016;08;15;Tiistai;8;14;22
93;02.08.2016;2016;08;16;Tiistai;25;24;49
93;02.08.2016;2016;08;17;Tiistai;8;22;30
93;02.08.2016;2016;08;18;Tiistai;19;16;35
93;02.08.2016;2016;08;19;Tiistai;18;20;38
93;02.08.2016;2016;08;20;Tiistai;11;20;31
93;02.08.2016;2016;08;21;Tiistai;2;11;13
93;02.08.2016;2016;08;22;Tiistai;2;7;9
93;02.08.2016;2016;08;23;Tiistai;1;0;1
93;03.08.2016;2016;08;00;Keskiviikko;3;1;4
93;03.08.2016;2016;08;01;Keskiviikko;0;0;0
93;03.08.2016;2016;08;02;Keskiviikko;0;0;0
93;03.08.2016;2016;08;03;Keskiviikko;0;0;0
93;03.08.2016;2016;08;04;Keskiviikko;0;0;0
93;03.08.2016;2016;08;05;Keskiviikko;4;3;7
93;03.08.2016;2016;08;06;Keskiviikko;15;9;24
93;03.08.2016;2016;08;07;Keskiviikko;24;25;49
93;03.08.2016;2016;08;08;Keskiviikko;14;16;30
93;03.08.2016;2016;08;09;Keskiviikko;11;10;21
93;03.08.2016;2016;08;10;Keskiviikko;8;11;19
93;03.08.2016;2016;08;11;Keskiviikko;23;20;43
93;03.08.2016;2016;08;12;Keskiviikko;11;13;24
93;03.08.2016;2016;08;13;Keskiviikko;17;17;34
93;03.08.2016;2016;08;14;Keskiviikko;11;10;21
93;03.08.2016;2016;08;15;Keskiviikko;14;16;30
93;03.08.2016;2016;08;16;Keskiviikko;20;20;40
93;03.08.2016;2016;08;17;Keskiviikko;9;13;22
93;03.08.2016;2016;08;18;Keskiviikko;17;16;33
93;03.08.2016;2016;08;19;Keskiviikko;11;19;30
93;03.08.2016;2016;08;20;Keskiviikko;14;21;35
93;03.08.2016;2016;08;21;Keskiviikko;10;14;24
93;03.08.2016;2016;08;22;Keskiviikko;10;10;20
93;03.08.2016;2016;08;23;Keskiviikko;2;5;7
93;04.08.2016;2016;08;00;Torstai;2;2;4
93;04.08.2016;2016;08;01;Torstai;0;0;0
93;04.08.2016;2016;08;02;Torstai;3;0;3
93;04.08.2016;2016;08;03;Torstai;0;0;0
93;04.08.2016;2016;08;04;Torstai;0;0;0
93;04.08.2016;2016;08;05;Torstai;5;3;8
93;04.08.2016;2016;08;06;Torstai;14;15;29
93;04.08.2016;2016;08;07;Torstai;20;27;47
93;04.08.2016;2016;08;08;Torstai;9;19;28
93;04.08.2016;2016;08;09;Torstai;14;18;32
93;04.08.2016;2016;08;10;Torstai;18;10;28
93;04.08.2016;2016;08;11;Torstai;24;12;36
93;04.08.2016;2016;08;12;Torstai;20;17;37
93;04.08.2016;2016;08;13;Torstai;24;17;41
93;04.08.2016;2016;08;14;Torstai;18;21;39
93;04.08.2016;2016;08;15;Torstai;26;35;61
93;04.08.2016;2016;08;16;Torstai;44;42;86
93;04.08.2016;2016;08;17;Torstai;13;14;27
93;04.08.2016;2016;08;18;Torstai;13;18;31
93;04.08.2016;2016;08;19;Torstai;19;14;33
93;04.08.2016;2016;08;20;Torstai;2;6;8
93;04.08.2016;2016;08;21;Torstai;11;15;26
93;04.08.2016;2016;08;22;Torstai;3;9;12
93;04.08.2016;2016;08;23;Torstai;0;2;2
93;05.08.2016;2016;08;00;Perjantai;0;2;2
93;05.08.2016;2016;08;01;Perjantai;0;0;0
93;05.08.2016;2016;08;02;Perjantai;3;0;3
93;05.08.2016;2016;08;03;Perjantai;0;0;0
93;05.08.2016;2016;08;04;Perjantai;0;0;0
93;05.08.2016;2016;08;05;Perjantai;4;3;7
93;05.08.2016;2016;08;06;Perjantai;7;9;16
93;05.08.2016;2016;08;07;Perjantai;7;17;24
93;05.08.2016;2016;08;08;Perjantai;9;13;22
93;05.08.2016;2016;08;09;Perjantai;16;6;22
93;05.08.2016;2016;08;10;Perjantai;7;5;12
93;05.08.2016;2016;08;11;Perjantai;11;2;13
93;05.08.2016;2016;08;12;Perjantai;10;8;18
93;05.08.2016;2016;08;13;Perjantai;20;12;32
93;05.08.2016;2016;08;14;Perjantai;18;22;40
93;05.08.2016;2016;08;15;Perjantai;16;25;41
93;05.08.2016;2016;08;16;Perjantai;48;26;74
93;05.08.2016;2016;08;17;Perjantai;24;26;50
93;05.08.2016;2016;08;18;Perjantai;25;20;45
93;05.08.2016;2016;08;19;Perjantai;18;23;41
93;05.08.2016;2016;08;20;Perjantai;17;24;41
93;05.08.2016;2016;08;21;Perjantai;11;12;23
93;05.08.2016;2016;08;22;Perjantai;8;11;19
93;05.08.2016;2016;08;23;Perjantai;9;7;16
93;06.08.2016;2016;08;00;Lauantai;3;4;7
93;06.08.2016;2016;08;01;Lauantai;0;1;1
93;06.08.2016;2016;08;02;Lauantai;0;0;0
93;06.08.2016;2016;08;03;Lauantai;0;0;0
93;06.08.2016;2016;08;04;Lauantai;0;1;1
93;06.08.2016;2016;08;05;Lauantai;0;3;3
93;06.08.2016;2016;08;06;Lauantai;3;0;3
93;06.08.2016;2016;08;07;Lauantai;3;6;9
93;06.08.2016;2016;08;08;Lauantai;10;6;16
93;06.08.2016;2016;08;09;Lauantai;8;8;16
93;06.08.2016;2016;08;10;Lauantai;23;22;45
93;06.08.2016;2016;08;11;Lauantai;20;24;44
93;06.08.2016;2016;08;12;Lauantai;32;24;56
93;06.08.2016;2016;08;13;Lauantai;20;20;40
93;06.08.2016;2016;08;14;Lauantai;22;14;36
93;06.08.2016;2016;08;15;Lauantai;12;18;30
93;06.08.2016;2016;08;16;Lauantai;17;16;33
93;06.08.2016;2016;08;17;Lauantai;14;21;35
93;06.08.2016;2016;08;18;Lauantai;15;16;31
93;06.08.2016;2016;08;19;Lauantai;23;15;38
93;06.08.2016;2016;08;20;Lauantai;17;11;28
93;06.08.2016;2016;08;21;Lauantai;12;8;20
93;06.08.2016;2016;08;22;Lauantai;3;9;12
93;06.08.2016;2016;08;23;Lauantai;3;10;13
93;07.08.2016;2016;08;00;Sunnuntai;0;6;6
93;07.08.2016;2016;08;01;Sunnuntai;6;4;10
93;07.08.2016;2016;08;02;Sunnuntai;0;5;5
93;07.08.2016;2016;08;03;Sunnuntai;2;1;3
93;07.08.2016;2016;08;04;Sunnuntai;2;1;3
93;07.08.2016;2016;08;05;Sunnuntai;2;1;3
93;07.08.2016;2016;08;06;Sunnuntai;3;0;3
93;07.08.2016;2016;08;07;Sunnuntai;4;2;6
93;07.08.2016;2016;08;08;Sunnuntai;3;2;5
93;07.08.2016;2016;08;09;Sunnuntai;12;11;23
93;07.08.2016;2016;08;10;Sunnuntai;13;23;36
93;07.08.2016;2016;08;11;Sunnuntai;21;21;42
93;07.08.2016;2016;08;12;Sunnuntai;27;29;56
93;07.08.2016;2016;08;13;Sunnuntai;20;15;35
93;07.08.2016;2016;08;14;Sunnuntai;14;16;30
93;07.08.2016;2016;08;15;Sunnuntai;14;16;30
93;07.08.2016;2016;08;16;Sunnuntai;14;18;32
93;07.08.2016;2016;08;17;Sunnuntai;32;22;54
93;07.08.2016;2016;08;18;Sunnuntai;23;28;51
93;07.08.2016;2016;08;19;Sunnuntai;24;32;56
93;07.08.2016;2016;08;20;Sunnuntai;15;20;35
93;07.08.2016;2016;08;21;Sunnuntai;14;13;27
93;07.08.2016;2016;08;22;Sunnuntai;3;14;17
93;07.08.2016;2016;08;23;Sunnuntai;3;6;9
93;08.08.2016;2016;08;00;Maanantai;1;1;2
93;08.08.2016;2016;08;01;Maanantai;3;2;5
93;08.08.2016;2016;08;02;Maanantai;1;2;3
93;08.08.2016;2016;08;03;Maanantai;0;0;0
93;08.08.2016;2016;08;04;Maanantai;2;1;3
93;08.08.2016;2016;08;05;Maanantai;3;7;10
93;08.08.2016;2016;08;06;Maanantai;23;9;32
93;08.08.2016;2016;08;07;Maanantai;27;39;66
93;08.08.2016;2016;08;08;Maanantai;21;17;38
93;08.08.2016;2016;08;09;Maanantai;15;21;36
93;08.08.2016;2016;08;10;Maanantai;20;11;31
93;08.08.2016;2016;08;11;Maanantai;24;10;34
93;08.08.2016;2016;08;12;Maanantai;15;17;32
93;08.08.2016;2016;08;13;Maanantai;23;14;37
93;08.08.2016;2016;08;14;Maanantai;23;27;50
93;08.08.2016;2016;08;15;Maanantai;28;47;75
93;08.08.2016;2016;08;16;Maanantai;43;46;89
93;08.08.2016;2016;08;17;Maanantai;29;18;47
93;08.08.2016;2016;08;18;Maanantai;15;27;42
93;08.08.2016;2016;08;19;Maanantai;13;23;36
93;08.08.2016;2016;08;20;Maanantai;10;38;48
93;08.08.2016;2016;08;21;Maanantai;15;13;28
93;08.08.2016;2016;08;22;Maanantai;6;7;13
93;08.08.2016;2016;08;23;Maanantai;0;0;0
93;09.08.2016;2016;08;00;Tiistai;2;2;4
93;09.08.2016;2016;08;01;Tiistai;2;1;3
93;09.08.2016;2016;08;02;Tiistai;0;2;2
93;09.08.2016;2016;08;03;Tiistai;0;0;0
93;09.08.2016;2016;08;04;Tiistai;0;0;0
93;09.08.2016;2016;08;05;Tiistai;4;4;8
93;09.08.2016;2016;08;06;Tiistai;18;6;24
93;09.08.2016;2016;08;07;Tiistai;29;24;53
93;09.08.2016;2016;08;08;Tiistai;21;29;50
93;09.08.2016;2016;08;09;Tiistai;11;10;21
93;09.08.2016;2016;08;10;Tiistai;14;15;29
93;09.08.2016;2016;08;11;Tiistai;11;7;18
93;09.08.2016;2016;08;12;Tiistai;13;7;20
93;09.08.2016;2016;08;13;Tiistai;15;8;23
93;09.08.2016;2016;08;14;Tiistai;17;12;29
93;09.08.2016;2016;08;15;Tiistai;22;22;44
93;09.08.2016;2016;08;16;Tiistai;44;41;85
93;09.08.2016;2016;08;17;Tiistai;12;23;35
93;09.08.2016;2016;08;18;Tiistai;15;16;31
93;09.08.2016;2016;08;19;Tiistai;13;26;39
93;09.08.2016;2016;08;20;Tiistai;11;20;31
93;09.08.2016;2016;08;21;Tiistai;11;17;28
93;09.08.2016;2016;08;22;Tiistai;4;5;9
93;09.08.2016;2016;08;23;Tiistai;2;1;3
93;10.08.2016;2016;08;00;Keskiviikko;0;0;0
93;10.08.2016;2016;08;01;Keskiviikko;0;0;0
93;10.08.2016;2016;08;02;Keskiviikko;1;0;1
93;10.08.2016;2016;08;03;Keskiviikko;0;0;0
93;10.08.2016;2016;08;04;Keskiviikko;0;0;0
93;10.08.2016;2016;08;05;Keskiviikko;1;5;6
93;10.08.2016;2016;08;06;Keskiviikko;12;6;18
93;10.08.2016;2016;08;07;Keskiviikko;8;10;18
93;10.08.2016;2016;08;08;Keskiviikko;8;19;27
93;10.08.2016;2016;08;09;Keskiviikko;9;10;19
93;10.08.2016;2016;08;10;Keskiviikko;7;9;16
93;10.08.2016;2016;08;11;Keskiviikko;12;8;20
93;10.08.2016;2016;08;12;Keskiviikko;10;7;17
93;10.08.2016;2016;08;13;Keskiviikko;21;16;37
93;10.08.2016;2016;08;14;Keskiviikko;33;24;57
93;10.08.2016;2016;08;15;Keskiviikko;15;25;40
93;10.08.2016;2016;08;16;Keskiviikko;17;18;35
93;10.08.2016;2016;08;17;Keskiviikko;16;9;25
93;10.08.2016;2016;08;18;Keskiviikko;17;14;31
93;10.08.2016;2016;08;19;Keskiviikko;11;11;22
93;10.08.2016;2016;08;20;Keskiviikko;7;10;17
93;10.08.2016;2016;08;21;Keskiviikko;12;14;26
93;10.08.2016;2016;08;22;Keskiviikko;2;1;3
93;10.08.2016;2016;08;23;Keskiviikko;1;0;1
93;11.08.2016;2016;08;00;Torstai;1;1;2
93;11.08.2016;2016;08;01;Torstai;1;1;2
93;11.08.2016;2016;08;02;Torstai;0;0;0
93;11.08.2016;2016;08;03;Torstai;0;0;0
93;11.08.2016;2016;08;04;Torstai;1;1;2
93;11.08.2016;2016;08;05;Torstai;0;4;4
93;11.08.2016;2016;08;06;Torstai;18;10;28
93;11.08.2016;2016;08;07;Torstai;30;34;64
93;11.08.2016;2016;08;08;Torstai;19;17;36
93;11.08.2016;2016;08;09;Torstai;15;11;26
93;11.08.2016;2016;08;10;Torstai;8;13;21
93;11.08.2016;2016;08;11;Torstai;17;8;25
93;11.08.2016;2016;08;12;Torstai;6;11;17
93;11.08.2016;2016;08;13;Torstai;20;7;27
93;11.08.2016;2016;08;14;Torstai;19;35;54
93;11.08.2016;2016;08;15;Torstai;17;32;49
93;11.08.2016;2016;08;16;Torstai;33;35;68
93;11.08.2016;2016;08;17;Torstai;17;32;49
93;11.08.2016;2016;08;18;Torstai;20;18;38
93;11.08.2016;2016;08;19;Torstai;18;16;34
93;11.08.2016;2016;08;20;Torstai;9;15;24
93;11.08.2016;2016;08;21;Torstai;8;13;21
93;11.08.2016;2016;08;22;Torstai;4;2;6
93;11.08.2016;2016;08;23;Torstai;0;0;0
93;12.08.2016;2016;08;00;Perjantai;1;0;1
93;12.08.2016;2016;08;01;Perjantai;0;0;0
93;12.08.2016;2016;08;02;Perjantai;0;0;0
93;12.08.2016;2016;08;03;Perjantai;0;0;0
93;12.08.2016;2016;08;04;Perjantai;0;3;3
93;12.08.2016;2016;08;05;Perjantai;0;2;2
93;12.08.2016;2016;08;06;Perjantai;16;3;19
93;12.08.2016;2016;08;07;Perjantai;12;25;37
93;12.08.2016;2016;08;08;Perjantai;7;15;22
93;12.08.2016;2016;08;09;Perjantai;4;2;6
93;12.08.2016;2016;08;10;Perjantai;0;1;1
93;12.08.2016;2016;08;11;Perjantai;3;0;3
93;12.08.2016;2016;08;12;Perjantai;4;5;9
93;12.08.2016;2016;08;13;Perjantai;11;6;17
93;12.08.2016;2016;08;14;Perjantai;12;17;29
93;12.08.2016;2016;08;15;Perjantai;13;18;31
93;12.08.2016;2016;08;16;Perjantai;22;9;31
93;12.08.2016;2016;08;17;Perjantai;18;17;35
93;12.08.2016;2016;08;18;Perjantai;12;19;31
93;12.08.2016;2016;08;19;Perjantai;15;15;30
93;12.08.2016;2016;08;20;Perjantai;12;9;21
93;12.08.2016;2016;08;21;Perjantai;8;7;15
93;12.08.2016;2016;08;22;Perjantai;5;7;12
93;12.08.2016;2016;08;23;Perjantai;3;0;3
93;13.08.2016;2016;08;00;Lauantai;0;1;1
93;13.08.2016;2016;08;01;Lauantai;0;0;0
93;13.08.2016;2016;08;02;Lauantai;0;0;0
93;13.08.2016;2016;08;03;Lauantai;0;3;3
93;13.08.2016;2016;08;04;Lauantai;0;0;0
93;13.08.2016;2016;08;05;Lauantai;1;0;1
93;13.08.2016;2016;08;06;Lauantai;1;1;2
93;13.08.2016;2016;08;07;Lauantai;3;1;4
93;13.08.2016;2016;08;08;Lauantai;1;4;5
93;13.08.2016;2016;08;09;Lauantai;1;3;4
93;13.08.2016;2016;08;10;Lauantai;4;0;4
93;13.08.2016;2016;08;11;Lauantai;1;6;7
93;13.08.2016;2016;08;12;Lauantai;5;5;10
93;13.08.2016;2016;08;13;Lauantai;3;5;8
93;13.08.2016;2016;08;14;Lauantai;2;0;2
93;13.08.2016;2016;08;15;Lauantai;5;3;8
93;13.08.2016;2016;08;16;Lauantai;5;5;10
93;13.08.2016;2016;08;17;Lauantai;5;2;7
93;13.08.2016;2016;08;18;Lauantai;2;2;4
93;13.08.2016;2016;08;19;Lauantai;7;4;11
93;13.08.2016;2016;08;20;Lauantai;0;5;5
93;13.08.2016;2016;08;21;Lauantai;1;9;10
93;13.08.2016;2016;08;22;Lauantai;6;3;9
93;13.08.2016;2016;08;23;Lauantai;1;1;2
93;14.08.2016;2016;08;00;Sunnuntai;1;0;1
93;14.08.2016;2016;08;01;Sunnuntai;2;0;2
93;14.08.2016;2016;08;02;Sunnuntai;0;0;0
93;14.08.2016;2016;08;03;Sunnuntai;0;0;0
93;14.08.2016;2016;08;04;Sunnuntai;0;1;1
93;14.08.2016;2016;08;05;Sunnuntai;2;0;2
93;14.08.2016;2016;08;06;Sunnuntai;1;2;3
93;14.08.2016;2016;08;07;Sunnuntai;4;0;4
93;14.08.2016;2016;08;08;Sunnuntai;5;3;8
93;14.08.2016;2016;08;09;Sunnuntai;5;5;10
93;14.08.2016;2016;08;10;Sunnuntai;24;16;40
93;14.08.2016;2016;08;11;Sunnuntai;21;21;42
93;14.08.2016;2016;08;12;Sunnuntai;14;21;35
93;14.08.2016;2016;08;13;Sunnuntai;22;17;39
93;14.08.2016;2016;08;14;Sunnuntai;21;19;40
93;14.08.2016;2016;08;15;Sunnuntai;34;21;55
93;14.08.2016;2016;08;16;Sunnuntai;28;21;49
93;14.08.2016;2016;08;17;Sunnuntai;20;26;46
93;14.08.2016;2016;08;18;Sunnuntai;21;33;54
93;14.08.2016;2016;08;19;Sunnuntai;34;39;73
93;14.08.2016;2016;08;20;Sunnuntai;13;17;30
93;14.08.2016;2016;08;21;Sunnuntai;11;12;23
93;14.08.2016;2016;08;22;Sunnuntai;1;2;3
93;14.08.2016;2016;08;23;Sunnuntai;1;1;2
93;15.08.2016;2016;08;00;Maanantai;3;0;3
93;15.08.2016;2016;08;01;Maanantai;0;1;1
93;15.08.2016;2016;08;02;Maanantai;0;0;0
93;15.08.2016;2016;08;03;Maanantai;0;1;1
93;15.08.2016;2016;08;04;Maanantai;0;2;2
93;15.08.2016;2016;08;05;Maanantai;4;1;5
93;15.08.2016;2016;08;06;Maanantai;14;11;25
93;15.08.2016;2016;08;07;Maanantai;31;29;60
93;15.08.2016;2016;08;08;Maanantai;17;24;41
93;15.08.2016;2016;08;09;Maanantai;16;12;28
93;15.08.2016;2016;08;10;Maanantai;10;12;22
93;15.08.2016;2016;08;11;Maanantai;11;7;18
93;15.08.2016;2016;08;12;Maanantai;11;12;23
93;15.08.2016;2016;08;13;Maanantai;11;11;22
93;15.08.2016;2016;08;14;Maanantai;25;17;42
93;15.08.2016;2016;08;15;Maanantai;30;29;59
93;15.08.2016;2016;08;16;Maanantai;40;37;77
93;15.08.2016;2016;08;17;Maanantai;21;25;46
93;15.08.2016;2016;08;18;Maanantai;25;46;71
93;15.08.2016;2016;08;19;Maanantai;21;27;48
93;15.08.2016;2016;08;20;Maanantai;13;10;23
93;15.08.2016;2016;08;21;Maanantai;3;10;13
93;15.08.2016;2016;08;22;Maanantai;6;5;11
93;15.08.2016;2016;08;23;Maanantai;1;1;2
93;16.08.2016;2016;08;00;Tiistai;0;1;1
93;16.08.2016;2016;08;01;Tiistai;0;0;0
93;16.08.2016;2016;08;02;Tiistai;0;0;0
93;16.08.2016;2016;08;03;Tiistai;0;0;0
93;16.08.2016;2016;08;04;Tiistai;1;1;2
93;16.08.2016;2016;08;05;Tiistai;2;1;3
93;16.08.2016;2016;08;06;Tiistai;16;8;24
93;16.08.2016;2016;08;07;Tiistai;28;28;56
93;16.08.2016;2016;08;08;Tiistai;12;29;41
93;16.08.2016;2016;08;09;Tiistai;10;9;19
93;16.08.2016;2016;08;10;Tiistai;7;2;9
93;16.08.2016;2016;08;11;Tiistai;11;7;18
93;16.08.2016;2016;08;12;Tiistai;6;4;10
93;16.08.2016;2016;08;13;Tiistai;4;12;16
93;16.08.2016;2016;08;14;Tiistai;11;16;27
93;16.08.2016;2016;08;15;Tiistai;14;15;29
93;16.08.2016;2016;08;16;Tiistai;32;35;67
93;16.08.2016;2016;08;17;Tiistai;14;12;26
93;16.08.2016;2016;08;18;Tiistai;9;11;20
93;16.08.2016;2016;08;19;Tiistai;8;16;24
93;16.08.2016;2016;08;20;Tiistai;4;5;9
93;16.08.2016;2016;08;21;Tiistai;3;9;12
93;16.08.2016;2016;08;22;Tiistai;0;0;0
93;16.08.2016;2016;08;23;Tiistai;0;0;0
93;17.08.2016;2016;08;00;Keskiviikko;1;0;1
93;17.08.2016;2016;08;01;Keskiviikko;0;0;0
93;17.08.2016;2016;08;02;Keskiviikko;0;0;0
93;17.08.2016;2016;08;03;Keskiviikko;0;0;0
93;17.08.2016;2016;08;04;Keskiviikko;1;2;3
93;17.08.2016;2016;08;05;Keskiviikko;4;2;6
93;17.08.2016;2016;08;06;Keskiviikko;17;7;24
93;17.08.2016;2016;08;07;Keskiviikko;24;25;49
93;17.08.2016;2016;08;08;Keskiviikko;13;19;32
93;17.08.2016;2016;08;09;Keskiviikko;10;10;20
93;17.08.2016;2016;08;10;Keskiviikko;8;6;14
93;17.08.2016;2016;08;11;Keskiviikko;4;8;12
93;17.08.2016;2016;08;12;Keskiviikko;7;7;14
93;17.08.2016;2016;08;13;Keskiviikko;15;10;25
93;17.08.2016;2016;08;14;Keskiviikko;17;17;34
93;17.08.2016;2016;08;15;Keskiviikko;14;22;36
93;17.08.2016;2016;08;16;Keskiviikko;36;33;69
93;17.08.2016;2016;08;17;Keskiviikko;29;19;48
93;17.08.2016;2016;08;18;Keskiviikko;31;33;64
93;17.08.2016;2016;08;19;Keskiviikko;23;29;52
93;17.08.2016;2016;08;20;Keskiviikko;24;24;48
93;17.08.2016;2016;08;21;Keskiviikko;7;13;20
93;17.08.2016;2016;08;22;Keskiviikko;2;4;6
93;17.08.2016;2016;08;23;Keskiviikko;3;3;6
93;18.08.2016;2016;08;00;Torstai;1;1;2
93;18.08.2016;2016;08;01;Torstai;1;2;3
93;18.08.2016;2016;08;02;Torstai;0;0;0
93;18.08.2016;2016;08;03;Torstai;0;0;0
93;18.08.2016;2016;08;04;Torstai;0;0;0
93;18.08.2016;2016;08;05;Torstai;4;4;8
93;18.08.2016;2016;08;06;Torstai;20;9;29
93;18.08.2016;2016;08;07;Torstai;35;36;71
93;18.08.2016;2016;08;08;Torstai;19;24;43
93;18.08.2016;2016;08;09;Torstai;7;13;20
93;18.08.2016;2016;08;10;Torstai;12;15;27
93;18.08.2016;2016;08;11;Torstai;13;14;27
93;18.08.2016;2016;08;12;Torstai;19;20;39
93;18.08.2016;2016;08;13;Torstai;16;15;31
93;18.08.2016;2016;08;14;Torstai;19;21;40
93;18.08.2016;2016;08;15;Torstai;28;23;51
93;18.08.2016;2016;08;16;Torstai;38;51;89
93;18.08.2016;2016;08;17;Torstai;37;31;68
93;18.08.2016;2016;08;18;Torstai;24;24;48
93;18.08.2016;2016;08;19;Torstai;22;28;50
93;18.08.2016;2016;08;20;Torstai;13;18;31
93;18.08.2016;2016;08;21;Torstai;4;15;19
93;18.08.2016;2016;08;22;Torstai;5;8;13
93;18.08.2016;2016;08;23;Torstai;2;6;8
93;19.08.2016;2016;08;00;Perjantai;1;2;3
93;19.08.2016;2016;08;01;Perjantai;0;0;0
93;19.08.2016;2016;08;02;Perjantai;0;0;0
93;19.08.2016;2016;08;03;Perjantai;0;0;0
93;19.08.2016;2016;08;04;Perjantai;0;0;0
93;19.08.2016;2016;08;05;Perjantai;3;2;5
93;19.08.2016;2016;08;06;Perjantai;8;5;13
93;19.08.2016;2016;08;07;Perjantai;6;18;24
93;19.08.2016;2016;08;08;Perjantai;4;10;14
93;19.08.2016;2016;08;09;Perjantai;7;4;11
93;19.08.2016;2016;08;10;Perjantai;7;25;32
93;19.08.2016;2016;08;11;Perjantai;9;3;12
93;19.08.2016;2016;08;12;Perjantai;5;4;9
93;19.08.2016;2016;08;13;Perjantai;9;9;18
93;19.08.2016;2016;08;14;Perjantai;15;16;31
93;19.08.2016;2016;08;15;Perjantai;10;13;23
93;19.08.2016;2016;08;16;Perjantai;20;12;32
93;19.08.2016;2016;08;17;Perjantai;20;5;25
93;19.08.2016;2016;08;18;Perjantai;13;19;32
93;19.08.2016;2016;08;19;Perjantai;15;23;38
93;19.08.2016;2016;08;20;Perjantai;19;11;30
93;19.08.2016;2016;08;21;Perjantai;11;14;25
93;19.08.2016;2016;08;22;Perjantai;6;10;16
93;19.08.2016;2016;08;23;Perjantai;2;6;8
93;20.08.2016;2016;08;00;Lauantai;0;11;11
93;20.08.2016;2016;08;01;Lauantai;0;0;0
93;20.08.2016;2016;08;02;Lauantai;0;3;3
93;20.08.2016;2016;08;03;Lauantai;0;0;0
93;20.08.2016;2016;08;04;Lauantai;0;0;0
93;20.08.2016;2016;08;05;Lauantai;1;2;3
93;20.08.2016;2016;08;06;Lauantai;1;3;4
93;20.08.2016;2016;08;07;Lauantai;0;3;3
93;20.08.2016;2016;08;08;Lauantai;3;5;8
93;20.08.2016;2016;08;09;Lauantai;7;10;17
93;20.08.2016;2016;08;10;Lauantai;17;5;22
93;20.08.2016;2016;08;11;Lauantai;20;24;44
93;20.08.2016;2016;08;12;Lauantai;25;10;35
93;20.08.2016;2016;08;13;Lauantai;19;16;35
93;20.08.2016;2016;08;14;Lauantai;14;23;37
93;20.08.2016;2016;08;15;Lauantai;18;20;38
93;20.08.2016;2016;08;16;Lauantai;24;16;40
93;20.08.2016;2016;08;17;Lauantai;19;16;35
93;20.08.2016;2016;08;18;Lauantai;13;16;29
93;20.08.2016;2016;08;19;Lauantai;5;6;11
93;20.08.2016;2016;08;20;Lauantai;5;7;12
93;20.08.2016;2016;08;21;Lauantai;8;8;16
93;20.08.2016;2016;08;22;Lauantai;3;3;6
93;20.08.2016;2016;08;23;Lauantai;0;1;1
93;21.08.2016;2016;08;00;Sunnuntai;2;6;8
93;21.08.2016;2016;08;01;Sunnuntai;1;2;3
93;21.08.2016;2016;08;02;Sunnuntai;0;0;0
93;21.08.2016;2016;08;03;Sunnuntai;0;0;0
93;21.08.2016;2016;08;04;Sunnuntai;0;1;1
93;21.08.2016;2016;08;05;Sunnuntai;1;2;3
93;21.08.2016;2016;08;06;Sunnuntai;1;2;3
93;21.08.2016;2016;08;07;Sunnuntai;5;3;8
93;21.08.2016;2016;08;08;Sunnuntai;2;0;2
93;21.08.2016;2016;08;09;Sunnuntai;5;7;12
93;21.08.2016;2016;08;10;Sunnuntai;11;7;18
93;21.08.2016;2016;08;11;Sunnuntai;21;12;33
93;21.08.2016;2016;08;12;Sunnuntai;10;17;27
93;21.08.2016;2016;08;13;Sunnuntai;13;20;33
93;21.08.2016;2016;08;14;Sunnuntai;19;25;44
93;21.08.2016;2016;08;15;Sunnuntai;20;13;33
93;21.08.2016;2016;08;16;Sunnuntai;12;19;31
93;21.08.2016;2016;08;17;Sunnuntai;13;19;32
93;21.08.2016;2016;08;18;Sunnuntai;26;26;52
93;21.08.2016;2016;08;19;Sunnuntai;23;24;47
93;21.08.2016;2016;08;20;Sunnuntai;11;24;35
93;21.08.2016;2016;08;21;Sunnuntai;9;1;10
93;21.08.2016;2016;08;22;Sunnuntai;1;2;3
93;21.08.2016;2016;08;23;Sunnuntai;0;0;0
93;22.08.2016;2016;08;00;Maanantai;0;0;0
93;22.08.2016;2016;08;01;Maanantai;0;0;0
93;22.08.2016;2016;08;02;Maanantai;0;0;0
93;22.08.2016;2016;08;03;Maanantai;0;0;0
93;22.08.2016;2016;08;04;Maanantai;0;1;1
93;22.08.2016;2016;08;05;Maanantai;1;3;4
93;22.08.2016;2016;08;06;Maanantai;8;5;13
93;22.08.2016;2016;08;07;Maanantai;14;19;33
93;22.08.2016;2016;08;08;Maanantai;9;16;25
93;22.08.2016;2016;08;09;Maanantai;2;1;3
93;22.08.2016;2016;08;10;Maanantai;1;0;1
93;22.08.2016;2016;08;11;Maanantai;6;4;10
93;22.08.2016;2016;08;12;Maanantai;5;4;9
93;22.08.2016;2016;08;13;Maanantai;5;12;17
93;22.08.2016;2016;08;14;Maanantai;7;6;13
93;22.08.2016;2016;08;15;Maanantai;13;9;22
93;22.08.2016;2016;08;16;Maanantai;16;16;32
93;22.08.2016;2016;08;17;Maanantai;10;5;15
93;22.08.2016;2016;08;18;Maanantai;3;7;10
93;22.08.2016;2016;08;19;Maanantai;6;2;8
93;22.08.2016;2016;08;20;Maanantai;2;4;6
93;22.08.2016;2016;08;21;Maanantai;2;6;8
93;22.08.2016;2016;08;22;Maanantai;1;1;2
93;22.08.2016;2016;08;23;Maanantai;2;0;2
93;23.08.2016;2016;08;00;Tiistai;0;0;0
93;23.08.2016;2016;08;01;Tiistai;0;1;1
93;23.08.2016;2016;08;02;Tiistai;0;0;0
93;23.08.2016;2016;08;03;Tiistai;0;0;0
93;23.08.2016;2016;08;04;Tiistai;1;1;2
93;23.08.2016;2016;08;05;Tiistai;2;3;5
93;23.08.2016;2016;08;06;Tiistai;18;6;24
93;23.08.2016;2016;08;07;Tiistai;22;35;57
93;23.08.2016;2016;08;08;Tiistai;21;25;46
93;23.08.2016;2016;08;09;Tiistai;12;10;22
93;23.08.2016;2016;08;10;Tiistai;15;4;19
93;23.08.2016;2016;08;11;Tiistai;13;13;26
93;23.08.2016;2016;08;12;Tiistai;6;8;14
93;23.08.2016;2016;08;13;Tiistai;14;12;26
93;23.08.2016;2016;08;14;Tiistai;17;14;31
93;23.08.2016;2016;08;15;Tiistai;22;24;46
93;23.08.2016;2016;08;16;Tiistai;49;39;88
93;23.08.2016;2016;08;17;Tiistai;28;23;51
93;23.08.2016;2016;08;18;Tiistai;19;32;51
93;23.08.2016;2016;08;19;Tiistai;30;38;68
93;23.08.2016;2016;08;20;Tiistai;18;20;38
93;23.08.2016;2016;08;21;Tiistai;8;22;30
93;23.08.2016;2016;08;22;Tiistai;3;9;12
93;23.08.2016;2016;08;23;Tiistai;1;0;1
93;24.08.2016;2016;08;00;Keskiviikko;1;0;1
93;24.08.2016;2016;08;01;Keskiviikko;0;0;0
93;24.08.2016;2016;08;02;Keskiviikko;0;0;0
93;24.08.2016;2016;08;03;Keskiviikko;0;0;0
93;24.08.2016;2016;08;04;Keskiviikko;1;0;1
93;24.08.2016;2016;08;05;Keskiviikko;1;3;4
93;24.08.2016;2016;08;06;Keskiviikko;24;10;34
93;24.08.2016;2016;08;07;Keskiviikko;27;33;60
93;24.08.2016;2016;08;08;Keskiviikko;12;26;38
93;24.08.2016;2016;08;09;Keskiviikko;11;18;29
93;24.08.2016;2016;08;10;Keskiviikko;17;16;33
93;24.08.2016;2016;08;11;Keskiviikko;8;16;24
93;24.08.2016;2016;08;12;Keskiviikko;20;23;43
93;24.08.2016;2016;08;13;Keskiviikko;24;21;45
93;24.08.2016;2016;08;14;Keskiviikko;21;14;35
93;24.08.2016;2016;08;15;Keskiviikko;17;40;57
93;24.08.2016;2016;08;16;Keskiviikko;52;34;86
93;24.08.2016;2016;08;17;Keskiviikko;31;24;55
93;24.08.2016;2016;08;18;Keskiviikko;16;34;50
93;24.08.2016;2016;08;19;Keskiviikko;28;26;54
93;24.08.2016;2016;08;20;Keskiviikko;12;13;25
93;24.08.2016;2016;08;21;Keskiviikko;7;11;18
93;24.08.2016;2016;08;22;Keskiviikko;3;4;7
93;24.08.2016;2016;08;23;Keskiviikko;1;1;2
93;25.08.2016;2016;08;00;Torstai;1;1;2
93;25.08.2016;2016;08;01;Torstai;0;0;0
93;25.08.2016;2016;08;02;Torstai;0;0;0
93;25.08.2016;2016;08;03;Torstai;0;0;0
93;25.08.2016;2016;08;04;Torstai;1;0;1
93;25.08.2016;2016;08;05;Torstai;2;2;4
93;25.08.2016;2016;08;06;Torstai;18;9;27
93;25.08.2016;2016;08;07;Torstai;17;37;54
93;25.08.2016;2016;08;08;Torstai;13;14;27
93;25.08.2016;2016;08;09;Torstai;3;4;7
93;25.08.2016;2016;08;10;Torstai;2;2;4
93;25.08.2016;2016;08;11;Torstai;0;5;5
93;25.08.2016;2016;08;12;Torstai;6;4;10
93;25.08.2016;2016;08;13;Torstai;9;6;15
93;25.08.2016;2016;08;14;Torstai;10;10;20
93;25.08.2016;2016;08;15;Torstai;20;26;46
93;25.08.2016;2016;08;16;Torstai;30;21;51
93;25.08.2016;2016;08;17;Torstai;13;20;33
93;25.08.2016;2016;08;18;Torstai;14;6;20
93;25.08.2016;2016;08;19;Torstai;16;20;36
93;25.08.2016;2016;08;20;Torstai;6;14;20
93;25.08.2016;2016;08;21;Torstai;1;6;7
93;25.08.2016;2016;08;22;Torstai;0;3;3
93;25.08.2016;2016;08;23;Torstai;0;1;1
93;26.08.2016;2016;08;00;Perjantai;1;2;3
93;26.08.2016;2016;08;01;Perjantai;0;0;0
93;26.08.2016;2016;08;02;Perjantai;0;0;0
93;26.08.2016;2016;08;03;Perjantai;0;0;0
93;26.08.2016;2016;08;04;Perjantai;1;2;3
93;26.08.2016;2016;08;05;Perjantai;2;1;3
93;26.08.2016;2016;08;06;Perjantai;16;12;28
93;26.08.2016;2016;08;07;Perjantai;18;34;52
93;26.08.2016;2016;08;08;Perjantai;18;16;34
93;26.08.2016;2016;08;09;Perjantai;7;8;15
93;26.08.2016;2016;08;10;Perjantai;11;8;19
93;26.08.2016;2016;08;11;Perjantai;7;13;20
93;26.08.2016;2016;08;12;Perjantai;12;9;21
93;26.08.2016;2016;08;13;Perjantai;17;14;31
93;26.08.2016;2016;08;14;Perjantai;14;21;35
93;26.08.2016;2016;08;15;Perjantai;40;30;70
93;26.08.2016;2016;08;16;Perjantai;30;23;53
93;26.08.2016;2016;08;17;Perjantai;33;29;62
93;26.08.2016;2016;08;18;Perjantai;27;23;50
93;26.08.2016;2016;08;19;Perjantai;19;20;39
93;26.08.2016;2016;08;20;Perjantai;11;19;30
93;26.08.2016;2016;08;21;Perjantai;7;9;16
93;26.08.2016;2016;08;22;Perjantai;8;1;9
93;26.08.2016;2016;08;23;Perjantai;3;5;8
93;27.08.2016;2016;08;00;Lauantai;0;4;4
93;27.08.2016;2016;08;01;Lauantai;0;1;1
93;27.08.2016;2016;08;02;Lauantai;0;0;0
93;27.08.2016;2016;08;03;Lauantai;0;1;1
93;27.08.2016;2016;08;04;Lauantai;1;0;1
93;27.08.2016;2016;08;05;Lauantai;0;1;1
93;27.08.2016;2016;08;06;Lauantai;0;1;1
93;27.08.2016;2016;08;07;Lauantai;1;1;2
93;27.08.2016;2016;08;08;Lauantai;3;1;4
93;27.08.2016;2016;08;09;Lauantai;3;3;6
93;27.08.2016;2016;08;10;Lauantai;2;2;4
93;27.08.2016;2016;08;11;Lauantai;2;0;2
93;27.08.2016;2016;08;12;Lauantai;1;11;12
93;27.08.2016;2016;08;13;Lauantai;1;4;5
93;27.08.2016;2016;08;14;Lauantai;3;3;6
93;27.08.2016;2016;08;15;Lauantai;2;2;4
93;27.08.2016;2016;08;16;Lauantai;2;2;4
93;27.08.2016;2016;08;17;Lauantai;5;6;11
93;27.08.2016;2016;08;18;Lauantai;1;6;7
93;27.08.2016;2016;08;19;Lauantai;1;1;2
93;27.08.2016;2016;08;20;Lauantai;2;2;4
93;27.08.2016;2016;08;21;Lauantai;3;4;7
93;27.08.2016;2016;08;22;Lauantai;3;0;3
93;27.08.2016;2016;08;23;Lauantai;0;2;2
93;28.08.2016;2016;08;00;Sunnuntai;0;1;1
93;28.08.2016;2016;08;01;Sunnuntai;1;1;2
93;28.08.2016;2016;08;02;Sunnuntai;0;0;0
93;28.08.2016;2016;08;03;Sunnuntai;0;3;3
93;28.08.2016;2016;08;04;Sunnuntai;0;0;0
93;28.08.2016;2016;08;05;Sunnuntai;1;0;1
93;28.08.2016;2016;08;06;Sunnuntai;1;1;2
93;28.08.2016;2016;08;07;Sunnuntai;2;2;4
93;28.08.2016;2016;08;08;Sunnuntai;6;2;8
93;28.08.2016;2016;08;09;Sunnuntai;3;6;9
93;28.08.2016;2016;08;10;Sunnuntai;5;8;13
93;28.08.2016;2016;08;11;Sunnuntai;13;24;37
93;28.08.2016;2016;08;12;Sunnuntai;16;27;43
93;28.08.2016;2016;08;13;Sunnuntai;23;22;45
93;28.08.2016;2016;08;14;Sunnuntai;27;13;40
93;28.08.2016;2016;08;15;Sunnuntai;15;15;30
93;28.08.2016;2016;08;16;Sunnuntai;11;11;22
93;28.08.2016;2016;08;17;Sunnuntai;18;19;37
93;28.08.2016;2016;08;18;Sunnuntai;15;12;27
93;28.08.2016;2016;08;19;Sunnuntai;19;15;34
93;28.08.2016;2016;08;20;Sunnuntai;11;12;23
93;28.08.2016;2016;08;21;Sunnuntai;7;8;15
93;28.08.2016;2016;08;22;Sunnuntai;5;2;7
93;28.08.2016;2016;08;23;Sunnuntai;1;1;2
93;29.08.2016;2016;08;00;Maanantai;0;0;0
93;29.08.2016;2016;08;01;Maanantai;0;0;0
93;29.08.2016;2016;08;02;Maanantai;0;1;1
93;29.08.2016;2016;08;03;Maanantai;0;0;0
93;29.08.2016;2016;08;04;Maanantai;0;1;1
93;29.08.2016;2016;08;05;Maanantai;2;1;3
93;29.08.2016;2016;08;06;Maanantai;19;10;29
93;29.08.2016;2016;08;07;Maanantai;31;35;66
93;29.08.2016;2016;08;08;Maanantai;18;31;49
93;29.08.2016;2016;08;09;Maanantai;8;13;21
93;29.08.2016;2016;08;10;Maanantai;10;6;16
93;29.08.2016;2016;08;11;Maanantai;8;12;20
93;29.08.2016;2016;08;12;Maanantai;13;11;24
93;29.08.2016;2016;08;13;Maanantai;17;7;24
93;29.08.2016;2016;08;14;Maanantai;20;20;40
93;29.08.2016;2016;08;15;Maanantai;34;34;68
93;29.08.2016;2016;08;16;Maanantai;50;35;85
93;29.08.2016;2016;08;17;Maanantai;26;26;52
93;29.08.2016;2016;08;18;Maanantai;25;25;50
93;29.08.2016;2016;08;19;Maanantai;23;30;53
93;29.08.2016;2016;08;20;Maanantai;7;16;23
93;29.08.2016;2016;08;21;Maanantai;5;6;11
93;29.08.2016;2016;08;22;Maanantai;4;5;9
93;29.08.2016;2016;08;23;Maanantai;0;1;1
93;30.08.2016;2016;08;00;Tiistai;1;0;1
93;30.08.2016;2016;08;01;Tiistai;0;0;0
93;30.08.2016;2016;08;02;Tiistai;0;0;0
93;30.08.2016;2016;08;03;Tiistai;0;0;0
93;30.08.2016;2016;08;04;Tiistai;0;3;3
93;30.08.2016;2016;08;05;Tiistai;4;3;7
93;30.08.2016;2016;08;06;Tiistai;19;14;33
93;30.08.2016;2016;08;07;Tiistai;27;35;62
93;30.08.2016;2016;08;08;Tiistai;18;23;41
93;30.08.2016;2016;08;09;Tiistai;8;6;14
93;30.08.2016;2016;08;10;Tiistai;15;14;29
93;30.08.2016;2016;08;11;Tiistai;17;9;26
93;30.08.2016;2016;08;12;Tiistai;17;9;26
93;30.08.2016;2016;08;13;Tiistai;11;8;19
93;30.08.2016;2016;08;14;Tiistai;11;15;26
93;30.08.2016;2016;08;15;Tiistai;25;25;50
93;30.08.2016;2016;08;16;Tiistai;41;35;76
93;30.08.2016;2016;08;17;Tiistai;15;25;40
93;30.08.2016;2016;08;18;Tiistai;16;20;36
93;30.08.2016;2016;08;19;Tiistai;13;16;29
93;30.08.2016;2016;08;20;Tiistai;5;12;17
93;30.08.2016;2016;08;21;Tiistai;3;7;10
93;30.08.2016;2016;08;22;Tiistai;1;3;4
93;30.08.2016;2016;08;23;Tiistai;0;0;0
93;31.08.2016;2016;08;00;Keskiviikko;1;0;1
93;31.08.2016;2016;08;01;Keskiviikko;0;0;0
93;31.08.2016;2016;08;02;Keskiviikko;0;0;0
93;31.08.2016;2016;08;03;Keskiviikko;0;0;0
93;31.08.2016;2016;08;04;Keskiviikko;0;1;1
93;31.08.2016;2016;08;05;Keskiviikko;4;2;6
93;31.08.2016;2016;08;06;Keskiviikko;18;11;29
93;31.08.2016;2016;08;07;Keskiviikko;24;40;64
93;31.08.2016;2016;08;08;Keskiviikko;14;20;34
93;31.08.2016;2016;08;09;Keskiviikko;10;12;22
93;31.08.2016;2016;08;10;Keskiviikko;9;5;14
93;31.08.2016;2016;08;11;Keskiviikko;9;8;17
93;31.08.2016;2016;08;12;Keskiviikko;12;16;28
93;31.08.2016;2016;08;13;Keskiviikko;15;14;29
93;31.08.2016;2016;08;14;Keskiviikko;22;17;39
93;31.08.2016;2016;08;15;Keskiviikko;29;22;51
93;31.08.2016;2016;08;16;Keskiviikko;42;38;80
93;31.08.2016;2016;08;17;Keskiviikko;26;28;54
93;31.08.2016;2016;08;18;Keskiviikko;23;18;41
93;31.08.2016;2016;08;19;Keskiviikko;13;20;33
93;31.08.2016;2016;08;20;Keskiviikko;9;15;24
93;31.08.2016;2016;08;21;Keskiviikko;3;4;7
93;31.08.2016;2016;08;22;Keskiviikko;4;1;5
93;31.08.2016;2016;08;23;Keskiviikko;0;1;1
93;01.09.2016;2016;09;00;Torstai;0;0;0
93;01.09.2016;2016;09;01;Torstai;0;0;0
93;01.09.2016;2016;09;02;Torstai;0;0;0
93;01.09.2016;2016;09;03;Torstai;0;0;0
93;01.09.2016;2016;09;04;Torstai;0;2;2
93;01.09.2016;2016;09;05;Torstai;1;1;2
93;01.09.2016;2016;09;06;Torstai;20;8;28
93;01.09.2016;2016;09;07;Torstai;15;24;39
93;01.09.2016;2016;09;08;Torstai;6;24;30
93;01.09.2016;2016;09;09;Torstai;10;4;14
93;01.09.2016;2016;09;10;Torstai;5;4;9
93;01.09.2016;2016;09;11;Torstai;4;5;9
93;01.09.2016;2016;09;12;Torstai;44;4;48
93;01.09.2016;2016;09;13;Torstai;8;10;18
93;01.09.2016;2016;09;14;Torstai;10;4;14
93;01.09.2016;2016;09;15;Torstai;17;47;64
93;01.09.2016;2016;09;16;Torstai;38;32;70
93;01.09.2016;2016;09;17;Torstai;11;29;40
93;01.09.2016;2016;09;18;Torstai;15;19;34
93;01.09.2016;2016;09;19;Torstai;19;18;37
93;01.09.2016;2016;09;20;Torstai;8;7;15
93;01.09.2016;2016;09;21;Torstai;3;6;9
93;01.09.2016;2016;09;22;Torstai;1;2;3
93;01.09.2016;2016;09;23;Torstai;0;1;1
93;02.09.2016;2016;09;00;Perjantai;0;0;0
93;02.09.2016;2016;09;01;Perjantai;0;1;1
93;02.09.2016;2016;09;02;Perjantai;0;0;0
93;02.09.2016;2016;09;03;Perjantai;0;0;0
93;02.09.2016;2016;09;04;Perjantai;0;1;1
93;02.09.2016;2016;09;05;Perjantai;2;1;3
93;02.09.2016;2016;09;06;Perjantai;15;7;22
93;02.09.2016;2016;09;07;Perjantai;19;27;46
93;02.09.2016;2016;09;08;Perjantai;10;16;26
93;02.09.2016;2016;09;09;Perjantai;7;5;12
93;02.09.2016;2016;09;10;Perjantai;2;7;9
93;02.09.2016;2016;09;11;Perjantai;3;1;4
93;02.09.2016;2016;09;12;Perjantai;10;2;12
93;02.09.2016;2016;09;13;Perjantai;11;10;21
93;02.09.2016;2016;09;14;Perjantai;14;24;38
93;02.09.2016;2016;09;15;Perjantai;25;22;47
93;02.09.2016;2016;09;16;Perjantai;35;17;52
93;02.09.2016;2016;09;17;Perjantai;14;28;42
93;02.09.2016;2016;09;18;Perjantai;9;20;29
93;02.09.2016;2016;09;19;Perjantai;15;20;35
93;02.09.2016;2016;09;20;Perjantai;9;16;25
93;02.09.2016;2016;09;21;Perjantai;4;9;13
93;02.09.2016;2016;09;22;Perjantai;1;1;2
93;02.09.2016;2016;09;23;Perjantai;1;2;3
93;03.09.2016;2016;09;00;Lauantai;1;0;1
93;03.09.2016;2016;09;01;Lauantai;0;4;4
93;03.09.2016;2016;09;02;Lauantai;0;0;0
93;03.09.2016;2016;09;03;Lauantai;1;1;2
93;03.09.2016;2016;09;04;Lauantai;0;0;0
93;03.09.2016;2016;09;05;Lauantai;1;0;1
93;03.09.2016;2016;09;06;Lauantai;1;0;1
93;03.09.2016;2016;09;07;Lauantai;4;1;5
93;03.09.2016;2016;09;08;Lauantai;5;3;8
93;03.09.2016;2016;09;09;Lauantai;6;4;10
93;03.09.2016;2016;09;10;Lauantai;7;11;18
93;03.09.2016;2016;09;11;Lauantai;18;15;33
93;03.09.2016;2016;09;12;Lauantai;15;26;41
93;03.09.2016;2016;09;13;Lauantai;24;20;44
93;03.09.2016;2016;09;14;Lauantai;27;13;40
93;03.09.2016;2016;09;15;Lauantai;14;28;42
93;03.09.2016;2016;09;16;Lauantai;21;24;45
93;03.09.2016;2016;09;17;Lauantai;24;35;59
93;03.09.2016;2016;09;18;Lauantai;13;14;27
93;03.09.2016;2016;09;19;Lauantai;13;16;29
93;03.09.2016;2016;09;20;Lauantai;5;4;9
93;03.09.2016;2016;09;21;Lauantai;2;7;9
93;03.09.2016;2016;09;22;Lauantai;5;5;10
93;03.09.2016;2016;09;23;Lauantai;3;0;3
93;04.09.2016;2016;09;00;Sunnuntai;0;1;1
93;04.09.2016;2016;09;01;Sunnuntai;1;3;4
93;04.09.2016;2016;09;02;Sunnuntai;0;4;4
93;04.09.2016;2016;09;03;Sunnuntai;0;0;0
93;04.09.2016;2016;09;04;Sunnuntai;1;0;1
93;04.09.2016;2016;09;05;Sunnuntai;1;1;2
93;04.09.2016;2016;09;06;Sunnuntai;5;2;7
93;04.09.2016;2016;09;07;Sunnuntai;1;1;2
93;04.09.2016;2016;09;08;Sunnuntai;9;1;10
93;04.09.2016;2016;09;09;Sunnuntai;10;4;14
93;04.09.2016;2016;09;10;Sunnuntai;14;19;33
93;04.09.2016;2016;09;11;Sunnuntai;27;22;49
93;04.09.2016;2016;09;12;Sunnuntai;22;30;52
93;04.09.2016;2016;09;13;Sunnuntai;30;29;59
93;04.09.2016;2016;09;14;Sunnuntai;25;16;41
93;04.09.2016;2016;09;15;Sunnuntai;19;22;41
93;04.09.2016;2016;09;16;Sunnuntai;14;20;34
93;04.09.2016;2016;09;17;Sunnuntai;28;17;45
93;04.09.2016;2016;09;18;Sunnuntai;14;21;35
93;04.09.2016;2016;09;19;Sunnuntai;14;15;29
93;04.09.2016;2016;09;20;Sunnuntai;7;13;20
93;04.09.2016;2016;09;21;Sunnuntai;1;13;14
93;04.09.2016;2016;09;22;Sunnuntai;0;1;1
93;04.09.2016;2016;09;23;Sunnuntai;1;1;2
93;05.09.2016;2016;09;00;Maanantai;1;0;1
93;05.09.2016;2016;09;01;Maanantai;0;0;0
93;05.09.2016;2016;09;02;Maanantai;0;0;0
93;05.09.2016;2016;09;03;Maanantai;0;0;0
93;05.09.2016;2016;09;04;Maanantai;0;1;1
93;05.09.2016;2016;09;05;Maanantai;2;0;2
93;05.09.2016;2016;09;06;Maanantai;17;12;29
93;05.09.2016;2016;09;07;Maanantai;27;29;56
93;05.09.2016;2016;09;08;Maanantai;11;20;31
93;05.09.2016;2016;09;09;Maanantai;10;6;16
93;05.09.2016;2016;09;10;Maanantai;10;7;17
93;05.09.2016;2016;09;11;Maanantai;9;8;17
93;05.09.2016;2016;09;12;Maanantai;11;6;17
93;05.09.2016;2016;09;13;Maanantai;18;5;23
93;05.09.2016;2016;09;14;Maanantai;8;12;20
93;05.09.2016;2016;09;15;Maanantai;33;23;56
93;05.09.2016;2016;09;16;Maanantai;33;34;67
93;05.09.2016;2016;09;17;Maanantai;24;24;48
93;05.09.2016;2016;09;18;Maanantai;17;26;43
93;05.09.2016;2016;09;19;Maanantai;15;9;24
93;05.09.2016;2016;09;20;Maanantai;4;16;20
93;05.09.2016;2016;09;21;Maanantai;5;7;12
93;05.09.2016;2016;09;22;Maanantai;2;4;6
93;05.09.2016;2016;09;23;Maanantai;0;0;0
93;06.09.2016;2016;09;00;Tiistai;0;0;0
93;06.09.2016;2016;09;01;Tiistai;0;0;0
93;06.09.2016;2016;09;02;Tiistai;0;0;0
93;06.09.2016;2016;09;03;Tiistai;0;1;1
93;06.09.2016;2016;09;04;Tiistai;0;3;3
93;06.09.2016;2016;09;05;Tiistai;2;1;3
93;06.09.2016;2016;09;06;Tiistai;21;11;32
93;06.09.2016;2016;09;07;Tiistai;26;30;56
93;06.09.2016;2016;09;08;Tiistai;15;31;46
93;06.09.2016;2016;09;09;Tiistai;9;4;13
93;06.09.2016;2016;09;10;Tiistai;10;6;16
93;06.09.2016;2016;09;11;Tiistai;15;12;27
93;06.09.2016;2016;09;12;Tiistai;5;10;15
93;06.09.2016;2016;09;13;Tiistai;11;7;18
93;06.09.2016;2016;09;14;Tiistai;21;8;29
93;06.09.2016;2016;09;15;Tiistai;25;24;49
93;06.09.2016;2016;09;16;Tiistai;31;39;70
93;06.09.2016;2016;09;17;Tiistai;21;18;39
93;06.09.2016;2016;09;18;Tiistai;23;28;51
93;06.09.2016;2016;09;19;Tiistai;11;16;27
93;06.09.2016;2016;09;20;Tiistai;8;11;19
93;06.09.2016;2016;09;21;Tiistai;5;8;13
93;06.09.2016;2016;09;22;Tiistai;1;1;2
93;06.09.2016;2016;09;23;Tiistai;0;0;0
93;07.09.2016;2016;09;00;Keskiviikko;0;0;0
93;07.09.2016;2016;09;01;Keskiviikko;0;0;0
93;07.09.2016;2016;09;02;Keskiviikko;0;0;0
93;07.09.2016;2016;09;03;Keskiviikko;0;0;0
93;07.09.2016;2016;09;04;Keskiviikko;0;3;3
93;07.09.2016;2016;09;05;Keskiviikko;1;0;1
93;07.09.2016;2016;09;06;Keskiviikko;13;10;23
93;07.09.2016;2016;09;07;Keskiviikko;23;27;50
93;07.09.2016;2016;09;08;Keskiviikko;11;16;27
93;07.09.2016;2016;09;09;Keskiviikko;9;9;18
93;07.09.2016;2016;09;10;Keskiviikko;16;1;17
93;07.09.2016;2016;09;11;Keskiviikko;12;8;20
93;07.09.2016;2016;09;12;Keskiviikko;7;12;19
93;07.09.2016;2016;09;13;Keskiviikko;7;5;12
93;07.09.2016;2016;09;14;Keskiviikko;11;13;24
93;07.09.2016;2016;09;15;Keskiviikko;22;21;43
93;07.09.2016;2016;09;16;Keskiviikko;28;36;64
93;07.09.2016;2016;09;17;Keskiviikko;19;16;35
93;07.09.2016;2016;09;18;Keskiviikko;14;12;26
93;07.09.2016;2016;09;19;Keskiviikko;9;19;28
93;07.09.2016;2016;09;20;Keskiviikko;5;9;14
93;07.09.2016;2016;09;21;Keskiviikko;3;5;8
93;07.09.2016;2016;09;22;Keskiviikko;1;2;3
93;07.09.2016;2016;09;23;Keskiviikko;0;0;0
93;08.09.2016;2016;09;00;Torstai;0;1;1
93;08.09.2016;2016;09;01;Torstai;0;2;2
93;08.09.2016;2016;09;02;Torstai;0;0;0
93;08.09.2016;2016;09;03;Torstai;0;0;0
93;08.09.2016;2016;09;04;Torstai;0;2;2
93;08.09.2016;2016;09;05;Torstai;1;0;1
93;08.09.2016;2016;09;06;Torstai;18;12;30
93;08.09.2016;2016;09;07;Torstai;24;32;56
93;08.09.2016;2016;09;08;Torstai;11;17;28
93;08.09.2016;2016;09;09;Torstai;7;5;12
93;08.09.2016;2016;09;10;Torstai;8;6;14
93;08.09.2016;2016;09;11;Torstai;4;12;16
93;08.09.2016;2016;09;12;Torstai;7;11;18
93;08.09.2016;2016;09;13;Torstai;16;6;22
93;08.09.2016;2016;09;14;Torstai;19;15;34
93;08.09.2016;2016;09;15;Torstai;27;23;50
93;08.09.2016;2016;09;16;Torstai;29;24;53
93;08.09.2016;2016;09;17;Torstai;18;13;31
93;08.09.2016;2016;09;18;Torstai;9;20;29
93;08.09.2016;2016;09;19;Torstai;14;7;21
93;08.09.2016;2016;09;20;Torstai;3;12;15
93;08.09.2016;2016;09;21;Torstai;3;3;6
93;08.09.2016;2016;09;22;Torstai;0;2;2
93;08.09.2016;2016;09;23;Torstai;0;0;0
93;09.09.2016;2016;09;00;Perjantai;0;0;0
93;09.09.2016;2016;09;01;Perjantai;0;0;0
93;09.09.2016;2016;09;02;Perjantai;0;0;0
93;09.09.2016;2016;09;03;Perjantai;0;0;0
93;09.09.2016;2016;09;04;Perjantai;0;0;0
93;09.09.2016;2016;09;05;Perjantai;3;2;5
93;09.09.2016;2016;09;06;Perjantai;13;10;23
93;09.09.2016;2016;09;07;Perjantai;13;29;42
93;09.09.2016;2016;09;08;Perjantai;8;20;28
93;09.09.2016;2016;09;09;Perjantai;13;5;18
93;09.09.2016;2016;09;10;Perjantai;14;11;25
93;09.09.2016;2016;09;11;Perjantai;6;17;23
93;09.09.2016;2016;09;12;Perjantai;11;5;16
93;09.09.2016;2016;09;13;Perjantai;11;10;21
93;09.09.2016;2016;09;14;Perjantai;17;21;38
93;09.09.2016;2016;09;15;Perjantai;34;34;68
93;09.09.2016;2016;09;16;Perjantai;29;23;52
93;09.09.2016;2016;09;17;Perjantai;22;14;36
93;09.09.2016;2016;09;18;Perjantai;8;10;18
93;09.09.2016;2016;09;19;Perjantai;16;18;34
93;09.09.2016;2016;09;20;Perjantai;9;19;28
93;09.09.2016;2016;09;21;Perjantai;3;10;13
93;09.09.2016;2016;09;22;Perjantai;5;4;9
93;09.09.2016;2016;09;23;Perjantai;2;0;2
93;10.09.2016;2016;09;00;Lauantai;1;0;1
93;10.09.2016;2016;09;01;Lauantai;1;0;1
93;10.09.2016;2016;09;02;Lauantai;0;0;0
93;10.09.2016;2016;09;03;Lauantai;0;0;0
93;10.09.2016;2016;09;04;Lauantai;0;1;1
93;10.09.2016;2016;09;05;Lauantai;0;2;2
93;10.09.2016;2016;09;06;Lauantai;1;2;3
93;10.09.2016;2016;09;07;Lauantai;2;1;3
93;10.09.2016;2016;09;08;Lauantai;3;0;3
93;10.09.2016;2016;09;09;Lauantai;5;2;7
93;10.09.2016;2016;09;10;Lauantai;17;10;27
93;10.09.2016;2016;09;11;Lauantai;14;9;23
93;10.09.2016;2016;09;12;Lauantai;9;12;21
93;10.09.2016;2016;09;13;Lauantai;5;5;10
93;10.09.2016;2016;09;14;Lauantai;11;18;29
93;10.09.2016;2016;09;15;Lauantai;12;12;24
93;10.09.2016;2016;09;16;Lauantai;15;22;37
93;10.09.2016;2016;09;17;Lauantai;23;14;37
93;10.09.2016;2016;09;18;Lauantai;9;8;17
93;10.09.2016;2016;09;19;Lauantai;6;6;12
93;10.09.2016;2016;09;20;Lauantai;8;6;14
93;10.09.2016;2016;09;21;Lauantai;4;5;9
93;10.09.2016;2016;09;22;Lauantai;0;0;0
93;10.09.2016;2016;09;23;Lauantai;2;0;2
93;11.09.2016;2016;09;00;Sunnuntai;0;1;1
93;11.09.2016;2016;09;01;Sunnuntai;2;0;2
93;11.09.2016;2016;09;02;Sunnuntai;0;1;1
93;11.09.2016;2016;09;03;Sunnuntai;0;1;1
93;11.09.2016;2016;09;04;Sunnuntai;0;2;2
93;11.09.2016;2016;09;05;Sunnuntai;1;0;1
93;11.09.2016;2016;09;06;Sunnuntai;2;1;3
93;11.09.2016;2016;09;07;Sunnuntai;5;3;8
93;11.09.2016;2016;09;08;Sunnuntai;4;2;6
93;11.09.2016;2016;09;09;Sunnuntai;11;7;18
93;11.09.2016;2016;09;10;Sunnuntai;15;11;26
93;11.09.2016;2016;09;11;Sunnuntai;9;16;25
93;11.09.2016;2016;09;12;Sunnuntai;17;11;28
93;11.09.2016;2016;09;13;Sunnuntai;13;13;26
93;11.09.2016;2016;09;14;Sunnuntai;12;19;31
93;11.09.2016;2016;09;15;Sunnuntai;9;14;23
93;11.09.2016;2016;09;16;Sunnuntai;18;8;26
93;11.09.2016;2016;09;17;Sunnuntai;19;15;34
93;11.09.2016;2016;09;18;Sunnuntai;13;12;25
93;11.09.2016;2016;09;19;Sunnuntai;7;12;19
93;11.09.2016;2016;09;20;Sunnuntai;4;7;11
93;11.09.2016;2016;09;21;Sunnuntai;2;1;3
93;11.09.2016;2016;09;22;Sunnuntai;0;1;1
93;11.09.2016;2016;09;23;Sunnuntai;0;0;0
93;12.09.2016;2016;09;00;Maanantai;0;0;0
93;12.09.2016;2016;09;01;Maanantai;0;0;0
93;12.09.2016;2016;09;02;Maanantai;0;0;0
93;12.09.2016;2016;09;03;Maanantai;0;0;0
93;12.09.2016;2016;09;04;Maanantai;0;0;0
93;12.09.2016;2016;09;05;Maanantai;4;0;4
93;12.09.2016;2016;09;06;Maanantai;14;8;22
93;12.09.2016;2016;09;07;Maanantai;9;12;21
93;12.09.2016;2016;09;08;Maanantai;13;16;29
93;12.09.2016;2016;09;09;Maanantai;7;4;11
93;12.09.2016;2016;09;10;Maanantai;6;3;9
93;12.09.2016;2016;09;11;Maanantai;6;5;11
93;12.09.2016;2016;09;12;Maanantai;4;12;16
93;12.09.2016;2016;09;13;Maanantai;12;6;18
93;12.09.2016;2016;09;14;Maanantai;9;14;23
93;12.09.2016;2016;09;15;Maanantai;22;16;38
93;12.09.2016;2016;09;16;Maanantai;21;22;43
93;12.09.2016;2016;09;17;Maanantai;15;14;29
93;12.09.2016;2016;09;18;Maanantai;8;14;22
93;12.09.2016;2016;09;19;Maanantai;14;15;29
93;12.09.2016;2016;09;20;Maanantai;8;22;30
93;12.09.2016;2016;09;21;Maanantai;1;13;14
93;12.09.2016;2016;09;22;Maanantai;1;2;3
93;12.09.2016;2016;09;23;Maanantai;1;1;2
93;13.09.2016;2016;09;00;Tiistai;0;0;0
93;13.09.2016;2016;09;01;Tiistai;0;0;0
93;13.09.2016;2016;09;02;Tiistai;0;0;0
93;13.09.2016;2016;09;03;Tiistai;0;0;0
93;13.09.2016;2016;09;04;Tiistai;0;3;3
93;13.09.2016;2016;09;05;Tiistai;5;2;7
93;13.09.2016;2016;09;06;Tiistai;22;12;34
93;13.09.2016;2016;09;07;Tiistai;29;30;59
93;13.09.2016;2016;09;08;Tiistai;16;21;37
93;13.09.2016;2016;09;09;Tiistai;8;11;19
93;13.09.2016;2016;09;10;Tiistai;10;11;21
93;13.09.2016;2016;09;11;Tiistai;18;19;37
93;13.09.2016;2016;09;12;Tiistai;11;12;23
93;13.09.2016;2016;09;13;Tiistai;15;14;29
93;13.09.2016;2016;09;14;Tiistai;24;17;41
93;13.09.2016;2016;09;15;Tiistai;30;32;62
93;13.09.2016;2016;09;16;Tiistai;36;36;72
93;13.09.2016;2016;09;17;Tiistai;23;23;46
93;13.09.2016;2016;09;18;Tiistai;12;46;58
93;13.09.2016;2016;09;19;Tiistai;12;14;26
93;13.09.2016;2016;09;20;Tiistai;12;10;22
93;13.09.2016;2016;09;21;Tiistai;5;8;13
93;13.09.2016;2016;09;22;Tiistai;2;3;5
93;13.09.2016;2016;09;23;Tiistai;0;0;0
93;14.09.2016;2016;09;00;Keskiviikko;0;0;0
93;14.09.2016;2016;09;01;Keskiviikko;0;0;0
93;14.09.2016;2016;09;02;Keskiviikko;0;0;0
93;14.09.2016;2016;09;03;Keskiviikko;0;0;0
93;14.09.2016;2016;09;04;Keskiviikko;0;3;3
93;14.09.2016;2016;09;05;Keskiviikko;3;2;5
93;14.09.2016;2016;09;06;Keskiviikko;25;11;36
93;14.09.2016;2016;09;07;Keskiviikko;27;27;54
93;14.09.2016;2016;09;08;Keskiviikko;15;25;40
93;14.09.2016;2016;09;09;Keskiviikko;15;7;22
93;14.09.2016;2016;09;10;Keskiviikko;13;7;20
93;14.09.2016;2016;09;11;Keskiviikko;14;6;20
93;14.09.2016;2016;09;12;Keskiviikko;10;12;22
93;14.09.2016;2016;09;13;Keskiviikko;13;11;24
93;14.09.2016;2016;09;14;Keskiviikko;21;16;37
93;14.09.2016;2016;09;15;Keskiviikko;20;27;47
93;14.09.2016;2016;09;16;Keskiviikko;38;36;74
93;14.09.2016;2016;09;17;Keskiviikko;28;28;56
93;14.09.2016;2016;09;18;Keskiviikko;19;25;44
93;14.09.2016;2016;09;19;Keskiviikko;13;23;36
93;14.09.2016;2016;09;20;Keskiviikko;8;10;18
93;14.09.2016;2016;09;21;Keskiviikko;4;4;8
93;14.09.2016;2016;09;22;Keskiviikko;2;3;5
93;14.09.2016;2016;09;23;Keskiviikko;0;0;0
93;15.09.2016;2016;09;00;Torstai;0;0;0
93;15.09.2016;2016;09;01;Torstai;0;0;0
93;15.09.2016;2016;09;02;Torstai;0;0;0
93;15.09.2016;2016;09;03;Torstai;0;0;0
93;15.09.2016;2016;09;04;Torstai;0;2;2
93;15.09.2016;2016;09;05;Torstai;2;1;3
93;15.09.2016;2016;09;06;Torstai;15;9;24
93;15.09.2016;2016;09;07;Torstai;26;16;42
93;15.09.2016;2016;09;08;Torstai;8;23;31
93;15.09.2016;2016;09;09;Torstai;13;5;18
93;15.09.2016;2016;09;10;Torstai;8;7;15
93;15.09.2016;2016;09;11;Torstai;6;7;13
93;15.09.2016;2016;09;12;Torstai;9;8;17
93;15.09.2016;2016;09;13;Torstai;16;7;23
93;15.09.2016;2016;09;14;Torstai;6;14;20
93;15.09.2016;2016;09;15;Torstai;19;30;49
93;15.09.2016;2016;09;16;Torstai;37;25;62
93;15.09.2016;2016;09;17;Torstai;14;14;28
93;15.09.2016;2016;09;18;Torstai;15;15;30
93;15.09.2016;2016;09;19;Torstai;10;17;27
93;15.09.2016;2016;09;20;Torstai;10;15;25
93;15.09.2016;2016;09;21;Torstai;2;9;11
93;15.09.2016;2016;09;22;Torstai;1;4;5
93;15.09.2016;2016;09;23;Torstai;1;1;2
93;16.09.2016;2016;09;00;Perjantai;0;0;0
93;16.09.2016;2016;09;01;Perjantai;0;0;0
93;16.09.2016;2016;09;02;Perjantai;0;0;0
93;16.09.2016;2016;09;03;Perjantai;1;0;1
93;16.09.2016;2016;09;04;Perjantai;0;1;1
93;16.09.2016;2016;09;05;Perjantai;3;4;7
93;16.09.2016;2016;09;06;Perjantai;16;9;25
93;16.09.2016;2016;09;07;Perjantai;21;21;42
93;16.09.2016;2016;09;08;Perjantai;7;14;21
93;16.09.2016;2016;09;09;Perjantai;10;7;17
93;16.09.2016;2016;09;10;Perjantai;13;7;20
93;16.09.2016;2016;09;11;Perjantai;6;12;18
93;16.09.2016;2016;09;12;Perjantai;9;5;14
93;16.09.2016;2016;09;13;Perjantai;12;16;28
93;16.09.2016;2016;09;14;Perjantai;16;17;33
93;16.09.2016;2016;09;15;Perjantai;24;27;51
93;16.09.2016;2016;09;16;Perjantai;23;27;50
93;16.09.2016;2016;09;17;Perjantai;19;20;39
93;16.09.2016;2016;09;18;Perjantai;14;24;38
93;16.09.2016;2016;09;19;Perjantai;9;10;19
93;16.09.2016;2016;09;20;Perjantai;11;11;22
93;16.09.2016;2016;09;21;Perjantai;1;6;7
93;16.09.2016;2016;09;22;Perjantai;2;4;6
93;16.09.2016;2016;09;23;Perjantai;2;1;3
93;17.09.2016;2016;09;00;Lauantai;2;1;3
93;17.09.2016;2016;09;01;Lauantai;3;1;4
93;17.09.2016;2016;09;02;Lauantai;2;0;2
93;17.09.2016;2016;09;03;Lauantai;0;0;0
93;17.09.2016;2016;09;04;Lauantai;0;0;0
93;17.09.2016;2016;09;05;Lauantai;1;1;2
93;17.09.2016;2016;09;06;Lauantai;2;0;2
93;17.09.2016;2016;09;07;Lauantai;3;2;5
93;17.09.2016;2016;09;08;Lauantai;2;3;5
93;17.09.2016;2016;09;09;Lauantai;7;5;12
93;17.09.2016;2016;09;10;Lauantai;13;7;20
93;17.09.2016;2016;09;11;Lauantai;11;7;18
93;17.09.2016;2016;09;12;Lauantai;8;12;20
93;17.09.2016;2016;09;13;Lauantai;20;20;40
93;17.09.2016;2016;09;14;Lauantai;22;19;41
93;17.09.2016;2016;09;15;Lauantai;13;27;40
93;17.09.2016;2016;09;16;Lauantai;16;24;40
93;17.09.2016;2016;09;17;Lauantai;11;14;25
93;17.09.2016;2016;09;18;Lauantai;14;13;27
93;17.09.2016;2016;09;19;Lauantai;16;9;25
93;17.09.2016;2016;09;20;Lauantai;2;2;4
93;17.09.2016;2016;09;21;Lauantai;1;7;8
93;17.09.2016;2016;09;22;Lauantai;2;8;10
93;17.09.2016;2016;09;23;Lauantai;1;0;1
93;18.09.2016;2016;09;00;Sunnuntai;0;1;1
93;18.09.2016;2016;09;01;Sunnuntai;0;0;0
93;18.09.2016;2016;09;02;Sunnuntai;2;1;3
93;18.09.2016;2016;09;03;Sunnuntai;0;2;2
93;18.09.2016;2016;09;04;Sunnuntai;0;0;0
93;18.09.2016;2016;09;05;Sunnuntai;1;1;2
93;18.09.2016;2016;09;06;Sunnuntai;0;0;0
93;18.09.2016;2016;09;07;Sunnuntai;5;3;8
93;18.09.2016;2016;09;08;Sunnuntai;4;1;5
93;18.09.2016;2016;09;09;Sunnuntai;5;9;14
93;18.09.2016;2016;09;10;Sunnuntai;4;7;11
93;18.09.2016;2016;09;11;Sunnuntai;31;25;56
93;18.09.2016;2016;09;12;Sunnuntai;36;27;63
93;18.09.2016;2016;09;13;Sunnuntai;15;21;36
93;18.09.2016;2016;09;14;Sunnuntai;20;22;42
93;18.09.2016;2016;09;15;Sunnuntai;8;15;23
93;18.09.2016;2016;09;16;Sunnuntai;10;18;28
93;18.09.2016;2016;09;17;Sunnuntai;25;18;43
93;18.09.2016;2016;09;18;Sunnuntai;13;16;29
93;18.09.2016;2016;09;19;Sunnuntai;12;15;27
93;18.09.2016;2016;09;20;Sunnuntai;8;3;11
93;18.09.2016;2016;09;21;Sunnuntai;2;3;5
93;18.09.2016;2016;09;22;Sunnuntai;1;2;3
93;18.09.2016;2016;09;23;Sunnuntai;0;0;0
93;19.09.2016;2016;09;00;Maanantai;0;0;0
93;19.09.2016;2016;09;01;Maanantai;0;0;0
93;19.09.2016;2016;09;02;Maanantai;0;0;0
93;19.09.2016;2016;09;03;Maanantai;0;0;0
93;19.09.2016;2016;09;04;Maanantai;0;3;3
93;19.09.2016;2016;09;05;Maanantai;2;2;4
93;19.09.2016;2016;09;06;Maanantai;11;8;19
93;19.09.2016;2016;09;07;Maanantai;29;26;55
93;19.09.2016;2016;09;08;Maanantai;10;20;30
93;19.09.2016;2016;09;09;Maanantai;10;7;17
93;19.09.2016;2016;09;10;Maanantai;14;8;22
93;19.09.2016;2016;09;11;Maanantai;8;10;18
93;19.09.2016;2016;09;12;Maanantai;15;13;28
93;19.09.2016;2016;09;13;Maanantai;18;13;31
93;19.09.2016;2016;09;14;Maanantai;19;22;41
93;19.09.2016;2016;09;15;Maanantai;25;18;43
93;19.09.2016;2016;09;16;Maanantai;45;38;83
93;19.09.2016;2016;09;17;Maanantai;29;27;56
93;19.09.2016;2016;09;18;Maanantai;13;23;36
93;19.09.2016;2016;09;19;Maanantai;18;14;32
93;19.09.2016;2016;09;20;Maanantai;9;11;20
93;19.09.2016;2016;09;21;Maanantai;6;6;12
93;19.09.2016;2016;09;22;Maanantai;0;2;2
93;19.09.2016;2016;09;23;Maanantai;0;1;1
93;20.09.2016;2016;09;00;Tiistai;0;0;0
93;20.09.2016;2016;09;01;Tiistai;0;0;0
93;20.09.2016;2016;09;02;Tiistai;0;0;0
93;20.09.2016;2016;09;03;Tiistai;0;0;0
93;20.09.2016;2016;09;04;Tiistai;0;3;3
93;20.09.2016;2016;09;05;Tiistai;4;1;5
93;20.09.2016;2016;09;06;Tiistai;18;7;25
93;20.09.2016;2016;09;07;Tiistai;27;28;55
93;20.09.2016;2016;09;08;Tiistai;10;20;30
93;20.09.2016;2016;09;09;Tiistai;12;6;18
93;20.09.2016;2016;09;10;Tiistai;14;10;24
93;20.09.2016;2016;09;11;Tiistai;9;8;17
93;20.09.2016;2016;09;12;Tiistai;8;1;9
93;20.09.2016;2016;09;13;Tiistai;6;5;11
93;20.09.2016;2016;09;14;Tiistai;13;6;19
93;20.09.2016;2016;09;15;Tiistai;19;19;38
93;20.09.2016;2016;09;16;Tiistai;33;34;67
93;20.09.2016;2016;09;17;Tiistai;16;24;40
93;20.09.2016;2016;09;18;Tiistai;15;19;34
93;20.09.2016;2016;09;19;Tiistai;13;22;35
93;20.09.2016;2016;09;20;Tiistai;8;13;21
93;20.09.2016;2016;09;21;Tiistai;1;1;2
93;20.09.2016;2016;09;22;Tiistai;2;3;5
93;20.09.2016;2016;09;23;Tiistai;0;0;0
93;21.09.2016;2016;09;00;Keskiviikko;0;0;0
93;21.09.2016;2016;09;01;Keskiviikko;0;0;0
93;21.09.2016;2016;09;02;Keskiviikko;0;1;1
93;21.09.2016;2016;09;03;Keskiviikko;0;0;0
93;21.09.2016;2016;09;04;Keskiviikko;0;3;3
93;21.09.2016;2016;09;05;Keskiviikko;3;3;6
93;21.09.2016;2016;09;06;Keskiviikko;19;9;28
93;21.09.2016;2016;09;07;Keskiviikko;24;23;47
93;21.09.2016;2016;09;08;Keskiviikko;11;18;29
93;21.09.2016;2016;09;09;Keskiviikko;18;5;23
93;21.09.2016;2016;09;10;Keskiviikko;14;7;21
93;21.09.2016;2016;09;11;Keskiviikko;7;13;20
93;21.09.2016;2016;09;12;Keskiviikko;12;10;22
93;21.09.2016;2016;09;13;Keskiviikko;17;11;28
93;21.09.2016;2016;09;14;Keskiviikko;14;17;31
93;21.09.2016;2016;09;15;Keskiviikko;23;25;48
93;21.09.2016;2016;09;16;Keskiviikko;30;38;68
93;21.09.2016;2016;09;17;Keskiviikko;23;26;49
93;21.09.2016;2016;09;18;Keskiviikko;9;27;36
93;21.09.2016;2016;09;19;Keskiviikko;10;12;22
93;21.09.2016;2016;09;20;Keskiviikko;10;14;24
93;21.09.2016;2016;09;21;Keskiviikko;3;6;9
93;21.09.2016;2016;09;22;Keskiviikko;1;1;2
93;21.09.2016;2016;09;23;Keskiviikko;2;1;3
93;22.09.2016;2016;09;00;Torstai;1;0;1
93;22.09.2016;2016;09;01;Torstai;0;0;0
93;22.09.2016;2016;09;02;Torstai;0;0;0
93;22.09.2016;2016;09;03;Torstai;0;0;0
93;22.09.2016;2016;09;04;Torstai;0;2;2
93;22.09.2016;2016;09;05;Torstai;3;2;5
93;22.09.2016;2016;09;06;Torstai;18;8;26
93;22.09.2016;2016;09;07;Torstai;32;25;57
93;22.09.2016;2016;09;08;Torstai;11;15;26
93;22.09.2016;2016;09;09;Torstai;7;13;20
93;22.09.2016;2016;09;10;Torstai;9;10;19
93;22.09.2016;2016;09;11;Torstai;7;6;13
93;22.09.2016;2016;09;12;Torstai;8;7;15
93;22.09.2016;2016;09;13;Torstai;13;17;30
93;22.09.2016;2016;09;14;Torstai;16;11;27
93;22.09.2016;2016;09;15;Torstai;21;29;50
93;22.09.2016;2016;09;16;Torstai;38;27;65
93;22.09.2016;2016;09;17;Torstai;21;19;40
93;22.09.2016;2016;09;18;Torstai;8;24;32
93;22.09.2016;2016;09;19;Torstai;9;9;18
93;22.09.2016;2016;09;20;Torstai;4;14;18
93;22.09.2016;2016;09;21;Torstai;4;4;8
93;22.09.2016;2016;09;22;Torstai;1;2;3
93;22.09.2016;2016;09;23;Torstai;0;0;0
93;23.09.2016;2016;09;00;Perjantai;0;0;0
93;23.09.2016;2016;09;01;Perjantai;0;0;0
93;23.09.2016;2016;09;02;Perjantai;0;0;0
93;23.09.2016;2016;09;03;Perjantai;0;0;0
93;23.09.2016;2016;09;04;Perjantai;0;3;3
93;23.09.2016;2016;09;05;Perjantai;2;2;4
93;23.09.2016;2016;09;06;Perjantai;17;7;24
93;23.09.2016;2016;09;07;Perjantai;12;26;38
93;23.09.2016;2016;09;08;Perjantai;11;16;27
93;23.09.2016;2016;09;09;Perjantai;6;5;11
93;23.09.2016;2016;09;10;Perjantai;5;3;8
93;23.09.2016;2016;09;11;Perjantai;3;2;5
93;23.09.2016;2016;09;12;Perjantai;17;11;28
93;23.09.2016;2016;09;13;Perjantai;17;15;32
93;23.09.2016;2016;09;14;Perjantai;18;15;33
93;23.09.2016;2016;09;15;Perjantai;22;30;52
93;23.09.2016;2016;09;16;Perjantai;21;14;35
93;23.09.2016;2016;09;17;Perjantai;13;16;29
93;23.09.2016;2016;09;18;Perjantai;15;19;34
93;23.09.2016;2016;09;19;Perjantai;9;10;19
93;23.09.2016;2016;09;20;Perjantai;5;8;13
93;23.09.2016;2016;09;21;Perjantai;3;4;7
93;23.09.2016;2016;09;22;Perjantai;3;9;12
93;23.09.2016;2016;09;23;Perjantai;1;2;3
93;24.09.2016;2016;09;00;Lauantai;2;3;5
93;24.09.2016;2016;09;01;Lauantai;0;0;0
93;24.09.2016;2016;09;02;Lauantai;2;0;2
93;24.09.2016;2016;09;03;Lauantai;0;0;0
93;24.09.2016;2016;09;04;Lauantai;0;1;1
93;24.09.2016;2016;09;05;Lauantai;0;0;0
93;24.09.2016;2016;09;06;Lauantai;1;0;1
93;24.09.2016;2016;09;07;Lauantai;3;0;3
93;24.09.2016;2016;09;08;Lauantai;4;2;6
93;24.09.2016;2016;09;09;Lauantai;5;4;9
93;24.09.2016;2016;09;10;Lauantai;6;6;12
93;24.09.2016;2016;09;11;Lauantai;12;10;22
93;24.09.2016;2016;09;12;Lauantai;5;7;12
93;24.09.2016;2016;09;13;Lauantai;6;8;14
93;24.09.2016;2016;09;14;Lauantai;18;15;33
93;24.09.2016;2016;09;15;Lauantai;16;7;23
93;24.09.2016;2016;09;16;Lauantai;16;6;22
93;24.09.2016;2016;09;17;Lauantai;9;17;26
93;24.09.2016;2016;09;18;Lauantai;9;22;31
93;24.09.2016;2016;09;19;Lauantai;7;7;14
93;24.09.2016;2016;09;20;Lauantai;2;2;4
93;24.09.2016;2016;09;21;Lauantai;4;6;10
93;24.09.2016;2016;09;22;Lauantai;5;4;9
93;24.09.2016;2016;09;23;Lauantai;3;2;5
93;25.09.2016;2016;09;00;Sunnuntai;0;1;1
93;25.09.2016;2016;09;01;Sunnuntai;0;1;1
93;25.09.2016;2016;09;02;Sunnuntai;0;0;0
93;25.09.2016;2016;09;03;Sunnuntai;0;2;2
93;25.09.2016;2016;09;04;Sunnuntai;0;0;0
93;25.09.2016;2016;09;05;Sunnuntai;2;0;2
93;25.09.2016;2016;09;06;Sunnuntai;1;0;1
93;25.09.2016;2016;09;07;Sunnuntai;1;0;1
93;25.09.2016;2016;09;08;Sunnuntai;1;2;3
93;25.09.2016;2016;09;09;Sunnuntai;6;8;14
93;25.09.2016;2016;09;10;Sunnuntai;13;10;23
93;25.09.2016;2016;09;11;Sunnuntai;13;14;27
93;25.09.2016;2016;09;12;Sunnuntai;12;12;24
93;25.09.2016;2016;09;13;Sunnuntai;12;17;29
93;25.09.2016;2016;09;14;Sunnuntai;14;11;25
93;25.09.2016;2016;09;15;Sunnuntai;9;14;23
93;25.09.2016;2016;09;16;Sunnuntai;12;17;29
93;25.09.2016;2016;09;17;Sunnuntai;14;10;24
93;25.09.2016;2016;09;18;Sunnuntai;6;14;20
93;25.09.2016;2016;09;19;Sunnuntai;5;14;19
93;25.09.2016;2016;09;20;Sunnuntai;2;3;5
93;25.09.2016;2016;09;21;Sunnuntai;2;2;4
93;25.09.2016;2016;09;22;Sunnuntai;1;0;1
93;25.09.2016;2016;09;23;Sunnuntai;0;0;0
93;26.09.2016;2016;09;00;Maanantai;0;0;0
93;26.09.2016;2016;09;01;Maanantai;2;0;2
93;26.09.2016;2016;09;02;Maanantai;0;0;0
93;26.09.2016;2016;09;03;Maanantai;0;0;0
93;26.09.2016;2016;09;04;Maanantai;0;2;2
93;26.09.2016;2016;09;05;Maanantai;6;2;8
93;26.09.2016;2016;09;06;Maanantai;18;5;23
93;26.09.2016;2016;09;07;Maanantai;25;24;49
93;26.09.2016;2016;09;08;Maanantai;12;26;38
93;26.09.2016;2016;09;09;Maanantai;10;11;21
93;26.09.2016;2016;09;10;Maanantai;15;5;20
93;26.09.2016;2016;09;11;Maanantai;6;4;10
93;26.09.2016;2016;09;12;Maanantai;6;11;17
93;26.09.2016;2016;09;13;Maanantai;22;12;34
93;26.09.2016;2016;09;14;Maanantai;8;16;24
93;26.09.2016;2016;09;15;Maanantai;26;27;53
93;26.09.2016;2016;09;16;Maanantai;32;33;65
93;26.09.2016;2016;09;17;Maanantai;16;22;38
93;26.09.2016;2016;09;18;Maanantai;15;17;32
93;26.09.2016;2016;09;19;Maanantai;9;15;24
93;26.09.2016;2016;09;20;Maanantai;4;3;7
93;26.09.2016;2016;09;21;Maanantai;0;4;4
93;26.09.2016;2016;09;22;Maanantai;2;2;4
93;26.09.2016;2016;09;23;Maanantai;0;0;0
93;27.09.2016;2016;09;00;Tiistai;1;0;1
93;27.09.2016;2016;09;01;Tiistai;0;0;0
93;27.09.2016;2016;09;02;Tiistai;0;0;0
93;27.09.2016;2016;09;03;Tiistai;0;0;0
93;27.09.2016;2016;09;04;Tiistai;0;2;2
93;27.09.2016;2016;09;05;Tiistai;6;4;10
93;27.09.2016;2016;09;06;Tiistai;16;8;24
93;27.09.2016;2016;09;07;Tiistai;26;31;57
93;27.09.2016;2016;09;08;Tiistai;12;14;26
93;27.09.2016;2016;09;09;Tiistai;13;13;26
93;27.09.2016;2016;09;10;Tiistai;9;13;22
93;27.09.2016;2016;09;11;Tiistai;12;13;25
93;27.09.2016;2016;09;12;Tiistai;12;10;22
93;27.09.2016;2016;09;13;Tiistai;13;17;30
93;27.09.2016;2016;09;14;Tiistai;18;17;35
93;27.09.2016;2016;09;15;Tiistai;25;37;62
93;27.09.2016;2016;09;16;Tiistai;47;35;82
93;27.09.2016;2016;09;17;Tiistai;22;26;48
93;27.09.2016;2016;09;18;Tiistai;17;21;38
93;27.09.2016;2016;09;19;Tiistai;15;12;27
93;27.09.2016;2016;09;20;Tiistai;6;13;19
93;27.09.2016;2016;09;21;Tiistai;3;5;8
93;27.09.2016;2016;09;22;Tiistai;1;4;5
93;27.09.2016;2016;09;23;Tiistai;0;0;0
93;28.09.2016;2016;09;00;Keskiviikko;1;0;1
93;28.09.2016;2016;09;01;Keskiviikko;0;0;0
93;28.09.2016;2016;09;02;Keskiviikko;0;1;1
93;28.09.2016;2016;09;03;Keskiviikko;0;0;0
93;28.09.2016;2016;09;04;Keskiviikko;0;2;2
93;28.09.2016;2016;09;05;Keskiviikko;4;2;6
93;28.09.2016;2016;09;06;Keskiviikko;14;8;22
93;28.09.2016;2016;09;07;Keskiviikko;21;24;45
93;28.09.2016;2016;09;08;Keskiviikko;13;18;31
93;28.09.2016;2016;09;09;Keskiviikko;7;8;15
93;28.09.2016;2016;09;10;Keskiviikko;10;6;16
93;28.09.2016;2016;09;11;Keskiviikko;7;4;11
93;28.09.2016;2016;09;12;Keskiviikko;7;6;13
93;28.09.2016;2016;09;13;Keskiviikko;12;13;25
93;28.09.2016;2016;09;14;Keskiviikko;14;11;25
93;28.09.2016;2016;09;15;Keskiviikko;14;16;30
93;28.09.2016;2016;09;16;Keskiviikko;32;17;49
93;28.09.2016;2016;09;17;Keskiviikko;9;11;20
93;28.09.2016;2016;09;18;Keskiviikko;0;9;9
93;28.09.2016;2016;09;19;Keskiviikko;8;3;11
93;28.09.2016;2016;09;20;Keskiviikko;3;4;7
93;28.09.2016;2016;09;21;Keskiviikko;2;3;5
93;28.09.2016;2016;09;22;Keskiviikko;2;5;7
93;28.09.2016;2016;09;23;Keskiviikko;0;0;0
93;29.09.2016;2016;09;00;Torstai;0;0;0
93;29.09.2016;2016;09;01;Torstai;0;0;0
93;29.09.2016;2016;09;02;Torstai;0;0;0
93;29.09.2016;2016;09;03;Torstai;0;0;0
93;29.09.2016;2016;09;04;Torstai;0;2;2
93;29.09.2016;2016;09;05;Torstai;1;2;3
93;29.09.2016;2016;09;06;Torstai;14;7;21
93;29.09.2016;2016;09;07;Torstai;17;18;35
93;29.09.2016;2016;09;08;Torstai;9;16;25
93;29.09.2016;2016;09;09;Torstai;10;4;14
93;29.09.2016;2016;09;10;Torstai;8;13;21
93;29.09.2016;2016;09;11;Torstai;1;31;32
93;29.09.2016;2016;09;12;Torstai;28;5;33
93;29.09.2016;2016;09;13;Torstai;9;5;14
93;29.09.2016;2016;09;14;Torstai;6;16;22
93;29.09.2016;2016;09;15;Torstai;18;21;39
93;29.09.2016;2016;09;16;Torstai;31;11;42
93;29.09.2016;2016;09;17;Torstai;9;11;20
93;29.09.2016;2016;09;18;Torstai;4;16;20
93;29.09.2016;2016;09;19;Torstai;4;6;10
93;29.09.2016;2016;09;20;Torstai;5;1;6
93;29.09.2016;2016;09;21;Torstai;1;4;5
93;29.09.2016;2016;09;22;Torstai;1;0;1
93;29.09.2016;2016;09;23;Torstai;2;1;3
93;30.09.2016;2016;09;00;Perjantai;0;0;0
93;30.09.2016;2016;09;01;Perjantai;0;0;0
93;30.09.2016;2016;09;02;Perjantai;0;0;0
93;30.09.2016;2016;09;03;Perjantai;0;0;0
93;30.09.2016;2016;09;04;Perjantai;0;0;0
93;30.09.2016;2016;09;05;Perjantai;1;1;2
93;30.09.2016;2016;09;06;Perjantai;13;7;20
93;30.09.2016;2016;09;07;Perjantai;6;19;25
93;30.09.2016;2016;09;08;Perjantai;10;13;23
93;30.09.2016;2016;09;09;Perjantai;3;2;5
93;30.09.2016;2016;09;10;Perjantai;7;6;13
93;30.09.2016;2016;09;11;Perjantai;3;2;5
93;30.09.2016;2016;09;12;Perjantai;7;2;9
93;30.09.2016;2016;09;13;Perjantai;8;8;16
93;30.09.2016;2016;09;14;Perjantai;9;11;20
93;30.09.2016;2016;09;15;Perjantai;17;10;27
93;30.09.2016;2016;09;16;Perjantai;23;10;33
93;30.09.2016;2016;09;17;Perjantai;7;11;18
93;30.09.2016;2016;09;18;Perjantai;15;13;28
93;30.09.2016;2016;09;19;Perjantai;7;13;20
93;30.09.2016;2016;09;20;Perjantai;7;12;19
93;30.09.2016;2016;09;21;Perjantai;2;12;14
93;30.09.2016;2016;09;22;Perjantai;4;2;6
93;30.09.2016;2016;09;23;Perjantai;3;1;4
93;01.10.2016;2016;10;00;Lauantai;1;1;2
93;01.10.2016;2016;10;01;Lauantai;5;1;6
93;01.10.2016;2016;10;02;Lauantai;0;0;0
93;01.10.2016;2016;10;03;Lauantai;0;1;1
93;01.10.2016;2016;10;04;Lauantai;0;0;0
93;01.10.2016;2016;10;05;Lauantai;0;1;1
93;01.10.2016;2016;10;06;Lauantai;2;0;2
93;01.10.2016;2016;10;07;Lauantai;2;1;3
93;01.10.2016;2016;10;08;Lauantai;3;0;3
93;01.10.2016;2016;10;09;Lauantai;5;4;9
93;01.10.2016;2016;10;10;Lauantai;8;3;11
93;01.10.2016;2016;10;11;Lauantai;11;10;21
93;01.10.2016;2016;10;12;Lauantai;11;10;21
93;01.10.2016;2016;10;13;Lauantai;11;11;22
93;01.10.2016;2016;10;14;Lauantai;9;8;17
93;01.10.2016;2016;10;15;Lauantai;13;10;23
93;01.10.2016;2016;10;16;Lauantai;7;11;18
93;01.10.2016;2016;10;17;Lauantai;4;6;10
93;01.10.2016;2016;10;18;Lauantai;10;6;16
93;01.10.2016;2016;10;19;Lauantai;4;7;11
93;01.10.2016;2016;10;20;Lauantai;1;1;2
93;01.10.2016;2016;10;21;Lauantai;2;4;6
93;01.10.2016;2016;10;22;Lauantai;5;3;8
93;01.10.2016;2016;10;23;Lauantai;1;5;6
93;02.10.2016;2016;10;00;Sunnuntai;2;2;4
93;02.10.2016;2016;10;01;Sunnuntai;1;1;2
93;02.10.2016;2016;10;02;Sunnuntai;0;0;0
93;02.10.2016;2016;10;03;Sunnuntai;0;0;0
93;02.10.2016;2016;10;04;Sunnuntai;2;0;2
93;02.10.2016;2016;10;05;Sunnuntai;1;0;1
93;02.10.2016;2016;10;06;Sunnuntai;0;0;0
93;02.10.2016;2016;10;07;Sunnuntai;3;1;4
93;02.10.2016;2016;10;08;Sunnuntai;5;2;7
93;02.10.2016;2016;10;09;Sunnuntai;4;5;9
93;02.10.2016;2016;10;10;Sunnuntai;12;13;25
93;02.10.2016;2016;10;11;Sunnuntai;12;11;23
93;02.10.2016;2016;10;12;Sunnuntai;12;13;25
93;02.10.2016;2016;10;13;Sunnuntai;11;17;28
93;02.10.2016;2016;10;14;Sunnuntai;18;14;32
93;02.10.2016;2016;10;15;Sunnuntai;15;10;25
93;02.10.2016;2016;10;16;Sunnuntai;12;7;19
93;02.10.2016;2016;10;17;Sunnuntai;15;17;32
93;02.10.2016;2016;10;18;Sunnuntai;7;20;27
93;02.10.2016;2016;10;19;Sunnuntai;13;7;20
93;02.10.2016;2016;10;20;Sunnuntai;3;3;6
93;02.10.2016;2016;10;21;Sunnuntai;1;4;5
93;02.10.2016;2016;10;22;Sunnuntai;1;0;1
93;02.10.2016;2016;10;23;Sunnuntai;1;0;1
93;03.10.2016;2016;10;00;Maanantai;0;0;0
93;03.10.2016;2016;10;01;Maanantai;0;0;0
93;03.10.2016;2016;10;02;Maanantai;0;0;0
93;03.10.2016;2016;10;03;Maanantai;0;0;0
93;03.10.2016;2016;10;04;Maanantai;0;1;1
93;03.10.2016;2016;10;05;Maanantai;3;2;5
93;03.10.2016;2016;10;06;Maanantai;18;7;25
93;03.10.2016;2016;10;07;Maanantai;27;27;54
93;03.10.2016;2016;10;08;Maanantai;9;22;31
93;03.10.2016;2016;10;09;Maanantai;9;8;17
93;03.10.2016;2016;10;10;Maanantai;4;3;7
93;03.10.2016;2016;10;11;Maanantai;10;8;18
93;03.10.2016;2016;10;12;Maanantai;9;8;17
93;03.10.2016;2016;10;13;Maanantai;11;11;22
93;03.10.2016;2016;10;14;Maanantai;16;9;25
93;03.10.2016;2016;10;15;Maanantai;22;14;36
93;03.10.2016;2016;10;16;Maanantai;33;22;55
93;03.10.2016;2016;10;17;Maanantai;17;14;31
93;03.10.2016;2016;10;18;Maanantai;10;13;23
93;03.10.2016;2016;10;19;Maanantai;13;17;30
93;03.10.2016;2016;10;20;Maanantai;3;6;9
93;03.10.2016;2016;10;21;Maanantai;1;6;7
93;03.10.2016;2016;10;22;Maanantai;1;3;4
93;03.10.2016;2016;10;23;Maanantai;0;0;0
93;04.10.2016;2016;10;00;Tiistai;0;0;0
93;04.10.2016;2016;10;01;Tiistai;0;0;0
93;04.10.2016;2016;10;02;Tiistai;0;0;0
93;04.10.2016;2016;10;03;Tiistai;0;0;0
93;04.10.2016;2016;10;04;Tiistai;0;1;1
93;04.10.2016;2016;10;05;Tiistai;4;2;6
93;04.10.2016;2016;10;06;Tiistai;14;9;23
93;04.10.2016;2016;10;07;Tiistai;21;23;44
93;04.10.2016;2016;10;08;Tiistai;10;18;28
93;04.10.2016;2016;10;09;Tiistai;8;6;14
93;04.10.2016;2016;10;10;Tiistai;9;0;9
93;04.10.2016;2016;10;11;Tiistai;8;4;12
93;04.10.2016;2016;10;12;Tiistai;7;10;17
93;04.10.2016;2016;10;13;Tiistai;11;8;19
93;04.10.2016;2016;10;14;Tiistai;11;12;23
93;04.10.2016;2016;10;15;Tiistai;17;14;31
93;04.10.2016;2016;10;16;Tiistai;40;26;66
93;04.10.2016;2016;10;17;Tiistai;16;23;39
93;04.10.2016;2016;10;18;Tiistai;16;15;31
93;04.10.2016;2016;10;19;Tiistai;9;9;18
93;04.10.2016;2016;10;20;Tiistai;4;10;14
93;04.10.2016;2016;10;21;Tiistai;0;3;3
93;04.10.2016;2016;10;22;Tiistai;2;4;6
93;04.10.2016;2016;10;23;Tiistai;0;0;0
93;05.10.2016;2016;10;00;Keskiviikko;0;0;0
93;05.10.2016;2016;10;01;Keskiviikko;0;0;0
93;05.10.2016;2016;10;02;Keskiviikko;0;0;0
93;05.10.2016;2016;10;03;Keskiviikko;0;0;0
93;05.10.2016;2016;10;04;Keskiviikko;0;1;1
93;05.10.2016;2016;10;05;Keskiviikko;3;1;4
93;05.10.2016;2016;10;06;Keskiviikko;15;7;22
93;05.10.2016;2016;10;07;Keskiviikko;13;17;30
93;05.10.2016;2016;10;08;Keskiviikko;6;17;23
93;05.10.2016;2016;10;09;Keskiviikko;6;7;13
93;05.10.2016;2016;10;10;Keskiviikko;6;0;6
93;05.10.2016;2016;10;11;Keskiviikko;7;4;11
93;05.10.2016;2016;10;12;Keskiviikko;5;5;10
93;05.10.2016;2016;10;13;Keskiviikko;12;7;19
93;05.10.2016;2016;10;14;Keskiviikko;10;13;23
93;05.10.2016;2016;10;15;Keskiviikko;18;17;35
93;05.10.2016;2016;10;16;Keskiviikko;31;20;51
93;05.10.2016;2016;10;17;Keskiviikko;20;13;33
93;05.10.2016;2016;10;18;Keskiviikko;11;16;27
93;05.10.2016;2016;10;19;Keskiviikko;9;16;25
93;05.10.2016;2016;10;20;Keskiviikko;2;5;7
93;05.10.2016;2016;10;21;Keskiviikko;0;6;6
93;05.10.2016;2016;10;22;Keskiviikko;1;1;2
93;05.10.2016;2016;10;23;Keskiviikko;0;0;0
93;06.10.2016;2016;10;00;Torstai;0;0;0
93;06.10.2016;2016;10;01;Torstai;0;0;0
93;06.10.2016;2016;10;02;Torstai;0;0;0
93;06.10.2016;2016;10;03;Torstai;0;0;0
93;06.10.2016;2016;10;04;Torstai;0;1;1
93;06.10.2016;2016;10;05;Torstai;1;2;3
93;06.10.2016;2016;10;06;Torstai;22;5;27
93;06.10.2016;2016;10;07;Torstai;19;25;44
93;06.10.2016;2016;10;08;Torstai;7;15;22
93;06.10.2016;2016;10;09;Torstai;4;12;16
93;06.10.2016;2016;10;10;Torstai;10;7;17
93;06.10.2016;2016;10;11;Torstai;9;9;18
93;06.10.2016;2016;10;12;Torstai;8;3;11
93;06.10.2016;2016;10;13;Torstai;9;10;19
93;06.10.2016;2016;10;14;Torstai;10;11;21
93;06.10.2016;2016;10;15;Torstai;8;20;28
93;06.10.2016;2016;10;16;Torstai;41;20;61
93;06.10.2016;2016;10;17;Torstai;9;13;22
93;06.10.2016;2016;10;18;Torstai;9;14;23
93;06.10.2016;2016;10;19;Torstai;5;7;12
93;06.10.2016;2016;10;20;Torstai;4;1;5
93;06.10.2016;2016;10;21;Torstai;3;3;6
93;06.10.2016;2016;10;22;Torstai;2;2;4
93;06.10.2016;2016;10;23;Torstai;0;2;2
93;07.10.2016;2016;10;00;Perjantai;0;1;1
93;07.10.2016;2016;10;01;Perjantai;0;0;0
93;07.10.2016;2016;10;02;Perjantai;0;0;0
93;07.10.2016;2016;10;03;Perjantai;0;0;0
93;07.10.2016;2016;10;04;Perjantai;0;1;1
93;07.10.2016;2016;10;05;Perjantai;1;3;4
93;07.10.2016;2016;10;06;Perjantai;15;8;23
93;07.10.2016;2016;10;07;Perjantai;17;18;35
93;07.10.2016;2016;10;08;Perjantai;7;11;18
93;07.10.2016;2016;10;09;Perjantai;10;7;17
93;07.10.2016;2016;10;10;Perjantai;6;5;11
93;07.10.2016;2016;10;11;Perjantai;6;4;10
93;07.10.2016;2016;10;12;Perjantai;9;7;16
93;07.10.2016;2016;10;13;Perjantai;10;8;18
93;07.10.2016;2016;10;14;Perjantai;11;10;21
93;07.10.2016;2016;10;15;Perjantai;21;24;45
93;07.10.2016;2016;10;16;Perjantai;16;19;35
93;07.10.2016;2016;10;17;Perjantai;8;6;14
93;07.10.2016;2016;10;18;Perjantai;7;10;17
93;07.10.2016;2016;10;19;Perjantai;6;5;11
93;07.10.2016;2016;10;20;Perjantai;8;9;17
93;07.10.2016;2016;10;21;Perjantai;4;2;6
93;07.10.2016;2016;10;22;Perjantai;2;3;5
93;07.10.2016;2016;10;23;Perjantai;4;3;7
93;08.10.2016;2016;10;00;Lauantai;3;3;6
93;08.10.2016;2016;10;01;Lauantai;1;1;2
93;08.10.2016;2016;10;02;Lauantai;0;2;2
93;08.10.2016;2016;10;03;Lauantai;0;1;1
93;08.10.2016;2016;10;04;Lauantai;1;0;1
93;08.10.2016;2016;10;05;Lauantai;0;0;0
93;08.10.2016;2016;10;06;Lauantai;1;1;2
93;08.10.2016;2016;10;07;Lauantai;0;1;1
93;08.10.2016;2016;10;08;Lauantai;4;2;6
93;08.10.2016;2016;10;09;Lauantai;5;6;11
93;08.10.2016;2016;10;10;Lauantai;6;3;9
93;08.10.2016;2016;10;11;Lauantai;15;13;28
93;08.10.2016;2016;10;12;Lauantai;11;13;24
93;08.10.2016;2016;10;13;Lauantai;11;9;20
93;08.10.2016;2016;10;14;Lauantai;19;14;33
93;08.10.2016;2016;10;15;Lauantai;10;18;28
93;08.10.2016;2016;10;16;Lauantai;9;10;19
93;08.10.2016;2016;10;17;Lauantai;13;8;21
93;08.10.2016;2016;10;18;Lauantai;9;13;22
93;08.10.2016;2016;10;19;Lauantai;6;9;15
93;08.10.2016;2016;10;20;Lauantai;1;2;3
93;08.10.2016;2016;10;21;Lauantai;1;2;3
93;08.10.2016;2016;10;22;Lauantai;1;3;4
93;08.10.2016;2016;10;23;Lauantai;2;1;3
93;09.10.2016;2016;10;00;Sunnuntai;0;0;0
93;09.10.2016;2016;10;01;Sunnuntai;0;1;1
93;09.10.2016;2016;10;02;Sunnuntai;0;1;1
93;09.10.2016;2016;10;03;Sunnuntai;0;2;2
93;09.10.2016;2016;10;04;Sunnuntai;0;0;0
93;09.10.2016;2016;10;05;Sunnuntai;1;0;1
93;09.10.2016;2016;10;06;Sunnuntai;0;0;0
93;09.10.2016;2016;10;07;Sunnuntai;2;0;2
93;09.10.2016;2016;10;08;Sunnuntai;3;3;6
93;09.10.2016;2016;10;09;Sunnuntai;4;8;12
93;09.10.2016;2016;10;10;Sunnuntai;6;5;11
93;09.10.2016;2016;10;11;Sunnuntai;15;12;27
93;09.10.2016;2016;10;12;Sunnuntai;13;6;19
93;09.10.2016;2016;10;13;Sunnuntai;10;23;33
93;09.10.2016;2016;10;14;Sunnuntai;11;17;28
93;09.10.2016;2016;10;15;Sunnuntai;7;8;15
93;09.10.2016;2016;10;16;Sunnuntai;10;11;21
93;09.10.2016;2016;10;17;Sunnuntai;8;9;17
93;09.10.2016;2016;10;18;Sunnuntai;12;4;16
93;09.10.2016;2016;10;19;Sunnuntai;5;5;10
93;09.10.2016;2016;10;20;Sunnuntai;2;6;8
93;09.10.2016;2016;10;21;Sunnuntai;1;1;2
93;09.10.2016;2016;10;22;Sunnuntai;0;1;1
93;09.10.2016;2016;10;23;Sunnuntai;0;0;0
93;10.10.2016;2016;10;00;Maanantai;0;0;0
93;10.10.2016;2016;10;01;Maanantai;0;0;0
93;10.10.2016;2016;10;02;Maanantai;0;0;0
93;10.10.2016;2016;10;03;Maanantai;0;0;0
93;10.10.2016;2016;10;04;Maanantai;1;1;2
93;10.10.2016;2016;10;05;Maanantai;4;2;6
93;10.10.2016;2016;10;06;Maanantai;15;8;23
93;10.10.2016;2016;10;07;Maanantai;23;21;44
93;10.10.2016;2016;10;08;Maanantai;12;17;29
93;10.10.2016;2016;10;09;Maanantai;3;10;13
93;10.10.2016;2016;10;10;Maanantai;9;4;13
93;10.10.2016;2016;10;11;Maanantai;9;7;16
93;10.10.2016;2016;10;12;Maanantai;5;8;13
93;10.10.2016;2016;10;13;Maanantai;11;6;17
93;10.10.2016;2016;10;14;Maanantai;3;18;21
93;10.10.2016;2016;10;15;Maanantai;25;18;43
93;10.10.2016;2016;10;16;Maanantai;36;21;57
93;10.10.2016;2016;10;17;Maanantai;14;14;28
93;10.10.2016;2016;10;18;Maanantai;10;12;22
93;10.10.2016;2016;10;19;Maanantai;5;13;18
93;10.10.2016;2016;10;20;Maanantai;2;8;10
93;10.10.2016;2016;10;21;Maanantai;2;7;9
93;10.10.2016;2016;10;22;Maanantai;0;0;0
93;10.10.2016;2016;10;23;Maanantai;0;0;0
93;11.10.2016;2016;10;00;Tiistai;1;0;1
93;11.10.2016;2016;10;01;Tiistai;0;0;0
93;11.10.2016;2016;10;02;Tiistai;0;0;0
93;11.10.2016;2016;10;03;Tiistai;0;0;0
93;11.10.2016;2016;10;04;Tiistai;0;0;0
93;11.10.2016;2016;10;05;Tiistai;3;2;5
93;11.10.2016;2016;10;06;Tiistai;13;7;20
93;11.10.2016;2016;10;07;Tiistai;21;23;44
93;11.10.2016;2016;10;08;Tiistai;12;18;30
93;11.10.2016;2016;10;09;Tiistai;12;1;13
93;11.10.2016;2016;10;10;Tiistai;5;8;13
93;11.10.2016;2016;10;11;Tiistai;11;9;20
93;11.10.2016;2016;10;12;Tiistai;3;5;8
93;11.10.2016;2016;10;13;Tiistai;8;6;14
93;11.10.2016;2016;10;14;Tiistai;12;9;21
93;11.10.2016;2016;10;15;Tiistai;20;21;41
93;11.10.2016;2016;10;16;Tiistai;22;20;42
93;11.10.2016;2016;10;17;Tiistai;20;20;40
93;11.10.2016;2016;10;18;Tiistai;8;5;13
93;11.10.2016;2016;10;19;Tiistai;5;8;13
93;11.10.2016;2016;10;20;Tiistai;3;6;9
93;11.10.2016;2016;10;21;Tiistai;0;3;3
93;11.10.2016;2016;10;22;Tiistai;1;3;4
93;11.10.2016;2016;10;23;Tiistai;1;0;1
93;12.10.2016;2016;10;00;Keskiviikko;1;0;1
93;12.10.2016;2016;10;01;Keskiviikko;0;0;0
93;12.10.2016;2016;10;02;Keskiviikko;0;0;0
93;12.10.2016;2016;10;03;Keskiviikko;0;0;0
93;12.10.2016;2016;10;04;Keskiviikko;0;1;1
93;12.10.2016;2016;10;05;Keskiviikko;4;1;5
93;12.10.2016;2016;10;06;Keskiviikko;11;7;18
93;12.10.2016;2016;10;07;Keskiviikko;15;24;39
93;12.10.2016;2016;10;08;Keskiviikko;17;16;33
93;12.10.2016;2016;10;09;Keskiviikko;6;5;11
93;12.10.2016;2016;10;10;Keskiviikko;11;10;21
93;12.10.2016;2016;10;11;Keskiviikko;9;8;17
93;12.10.2016;2016;10;12;Keskiviikko;7;5;12
93;12.10.2016;2016;10;13;Keskiviikko;6;8;14
93;12.10.2016;2016;10;14;Keskiviikko;12;12;24
93;12.10.2016;2016;10;15;Keskiviikko;17;22;39
93;12.10.2016;2016;10;16;Keskiviikko;27;23;50
93;12.10.2016;2016;10;17;Keskiviikko;14;13;27
93;12.10.2016;2016;10;18;Keskiviikko;7;14;21
93;12.10.2016;2016;10;19;Keskiviikko;6;17;23
93;12.10.2016;2016;10;20;Keskiviikko;5;5;10
93;12.10.2016;2016;10;21;Keskiviikko;4;4;8
93;12.10.2016;2016;10;22;Keskiviikko;1;3;4
93;12.10.2016;2016;10;23;Keskiviikko;1;0;1
93;13.10.2016;2016;10;00;Torstai;0;0;0
93;13.10.2016;2016;10;01;Torstai;0;1;1
93;13.10.2016;2016;10;02;Torstai;0;0;0
93;13.10.2016;2016;10;03;Torstai;0;0;0
93;13.10.2016;2016;10;04;Torstai;0;0;0
93;13.10.2016;2016;10;05;Torstai;3;2;5
93;13.10.2016;2016;10;06;Torstai;11;5;16
93;13.10.2016;2016;10;07;Torstai;17;23;40
93;13.10.2016;2016;10;08;Torstai;6;12;18
93;13.10.2016;2016;10;09;Torstai;15;9;24
93;13.10.2016;2016;10;10;Torstai;9;5;14
93;13.10.2016;2016;10;11;Torstai;5;6;11
93;13.10.2016;2016;10;12;Torstai;13;8;21
93;13.10.2016;2016;10;13;Torstai;7;19;26
93;13.10.2016;2016;10;14;Torstai;7;10;17
93;13.10.2016;2016;10;15;Torstai;26;24;50
93;13.10.2016;2016;10;16;Torstai;29;15;44
93;13.10.2016;2016;10;17;Torstai;10;16;26
93;13.10.2016;2016;10;18;Torstai;7;18;25
93;13.10.2016;2016;10;19;Torstai;9;8;17
93;13.10.2016;2016;10;20;Torstai;7;2;9
93;13.10.2016;2016;10;21;Torstai;2;3;5
93;13.10.2016;2016;10;22;Torstai;1;1;2
93;13.10.2016;2016;10;23;Torstai;1;2;3
93;14.10.2016;2016;10;00;Perjantai;0;0;0
93;14.10.2016;2016;10;01;Perjantai;0;0;0
93;14.10.2016;2016;10;02;Perjantai;0;0;0
93;14.10.2016;2016;10;03;Perjantai;0;0;0
93;14.10.2016;2016;10;04;Perjantai;0;0;0
93;14.10.2016;2016;10;05;Perjantai;3;1;4
93;14.10.2016;2016;10;06;Perjantai;9;8;17
93;14.10.2016;2016;10;07;Perjantai;15;27;42
93;14.10.2016;2016;10;08;Perjantai;5;12;17
93;14.10.2016;2016;10;09;Perjantai;6;5;11
93;14.10.2016;2016;10;10;Perjantai;9;3;12
93;14.10.2016;2016;10;11;Perjantai;6;11;17
93;14.10.2016;2016;10;12;Perjantai;11;7;18
93;14.10.2016;2016;10;13;Perjantai;10;8;18
93;14.10.2016;2016;10;14;Perjantai;11;9;20
93;14.10.2016;2016;10;15;Perjantai;20;13;33
93;14.10.2016;2016;10;16;Perjantai;18;15;33
93;14.10.2016;2016;10;17;Perjantai;13;12;25
93;14.10.2016;2016;10;18;Perjantai;12;5;17
93;14.10.2016;2016;10;19;Perjantai;6;11;17
93;14.10.2016;2016;10;20;Perjantai;4;5;9
93;14.10.2016;2016;10;21;Perjantai;1;3;4
93;14.10.2016;2016;10;22;Perjantai;1;3;4
93;14.10.2016;2016;10;23;Perjantai;2;0;2
93;15.10.2016;2016;10;00;Lauantai;0;1;1
93;15.10.2016;2016;10;01;Lauantai;2;0;2
93;15.10.2016;2016;10;02;Lauantai;0;1;1
93;15.10.2016;2016;10;03;Lauantai;0;1;1
93;15.10.2016;2016;10;04;Lauantai;0;0;0
93;15.10.2016;2016;10;05;Lauantai;0;1;1
93;15.10.2016;2016;10;06;Lauantai;1;0;1
93;15.10.2016;2016;10;07;Lauantai;0;0;0
93;15.10.2016;2016;10;08;Lauantai;2;4;6
93;15.10.2016;2016;10;09;Lauantai;3;0;3
93;15.10.2016;2016;10;10;Lauantai;4;5;9
93;15.10.2016;2016;10;11;Lauantai;8;6;14
93;15.10.2016;2016;10;12;Lauantai;6;3;9
93;15.10.2016;2016;10;13;Lauantai;5;11;16
93;15.10.2016;2016;10;14;Lauantai;1;8;9
93;15.10.2016;2016;10;15;Lauantai;7;5;12
93;15.10.2016;2016;10;16;Lauantai;6;5;11
93;15.10.2016;2016;10;17;Lauantai;9;6;15
93;15.10.2016;2016;10;18;Lauantai;7;3;10
93;15.10.2016;2016;10;19;Lauantai;0;3;3
93;15.10.2016;2016;10;20;Lauantai;2;2;4
93;15.10.2016;2016;10;21;Lauantai;4;10;14
93;15.10.2016;2016;10;22;Lauantai;0;2;2
93;15.10.2016;2016;10;23;Lauantai;0;5;5
93;16.10.2016;2016;10;00;Sunnuntai;1;0;1
93;16.10.2016;2016;10;01;Sunnuntai;0;0;0
93;16.10.2016;2016;10;02;Sunnuntai;0;0;0
93;16.10.2016;2016;10;03;Sunnuntai;0;0;0
93;16.10.2016;2016;10;04;Sunnuntai;0;0;0
93;16.10.2016;2016;10;05;Sunnuntai;1;0;1
93;16.10.2016;2016;10;06;Sunnuntai;0;0;0
93;16.10.2016;2016;10;07;Sunnuntai;0;1;1
93;16.10.2016;2016;10;08;Sunnuntai;0;0;0
93;16.10.2016;2016;10;09;Sunnuntai;5;0;5
93;16.10.2016;2016;10;10;Sunnuntai;2;4;6
93;16.10.2016;2016;10;11;Sunnuntai;5;4;9
93;16.10.2016;2016;10;12;Sunnuntai;4;7;11
93;16.10.2016;2016;10;13;Sunnuntai;5;7;12
93;16.10.2016;2016;10;14;Sunnuntai;7;9;16
93;16.10.2016;2016;10;15;Sunnuntai;8;6;14
93;16.10.2016;2016;10;16;Sunnuntai;8;5;13
93;16.10.2016;2016;10;17;Sunnuntai;4;10;14
93;16.10.2016;2016;10;18;Sunnuntai;8;1;9
93;16.10.2016;2016;10;19;Sunnuntai;3;8;11
93;16.10.2016;2016;10;20;Sunnuntai;3;7;10
93;16.10.2016;2016;10;21;Sunnuntai;0;2;2
93;16.10.2016;2016;10;22;Sunnuntai;1;1;2
93;16.10.2016;2016;10;23;Sunnuntai;0;0;0
93;17.10.2016;2016;10;00;Maanantai;0;0;0
93;17.10.2016;2016;10;01;Maanantai;0;0;0
93;17.10.2016;2016;10;02;Maanantai;0;0;0
93;17.10.2016;2016;10;03;Maanantai;0;0;0
93;17.10.2016;2016;10;04;Maanantai;1;1;2
93;17.10.2016;2016;10;05;Maanantai;3;2;5
93;17.10.2016;2016;10;06;Maanantai;14;7;21
93;17.10.2016;2016;10;07;Maanantai;19;21;40
93;17.10.2016;2016;10;08;Maanantai;9;25;34
93;17.10.2016;2016;10;09;Maanantai;10;3;13
93;17.10.2016;2016;10;10;Maanantai;11;2;13
93;17.10.2016;2016;10;11;Maanantai;11;8;19
93;17.10.2016;2016;10;12;Maanantai;9;6;15
93;17.10.2016;2016;10;13;Maanantai;8;8;16
93;17.10.2016;2016;10;14;Maanantai;6;10;16
93;17.10.2016;2016;10;15;Maanantai;26;23;49
93;17.10.2016;2016;10;16;Maanantai;25;20;45
93;17.10.2016;2016;10;17;Maanantai;15;17;32
93;17.10.2016;2016;10;18;Maanantai;3;14;17
93;17.10.2016;2016;10;19;Maanantai;5;4;9
93;17.10.2016;2016;10;20;Maanantai;3;7;10
93;17.10.2016;2016;10;21;Maanantai;1;2;3
93;17.10.2016;2016;10;22;Maanantai;0;1;1
93;17.10.2016;2016;10;23;Maanantai;0;0;0
93;18.10.2016;2016;10;00;Tiistai;1;0;1
93;18.10.2016;2016;10;01;Tiistai;0;0;0
93;18.10.2016;2016;10;02;Tiistai;0;0;0
93;18.10.2016;2016;10;03;Tiistai;0;0;0
93;18.10.2016;2016;10;04;Tiistai;0;1;1
93;18.10.2016;2016;10;05;Tiistai;2;3;5
93;18.10.2016;2016;10;06;Tiistai;13;6;19
93;18.10.2016;2016;10;07;Tiistai;20;18;38
93;18.10.2016;2016;10;08;Tiistai;9;21;30
93;18.10.2016;2016;10;09;Tiistai;6;5;11
93;18.10.2016;2016;10;10;Tiistai;4;7;11
93;18.10.2016;2016;10;11;Tiistai;11;6;17
93;18.10.2016;2016;10;12;Tiistai;7;4;11
93;18.10.2016;2016;10;13;Tiistai;4;6;10
93;18.10.2016;2016;10;14;Tiistai;12;12;24
93;18.10.2016;2016;10;15;Tiistai;18;25;43
93;18.10.2016;2016;10;16;Tiistai;25;23;48
93;18.10.2016;2016;10;17;Tiistai;14;15;29
93;18.10.2016;2016;10;18;Tiistai;12;9;21
93;18.10.2016;2016;10;19;Tiistai;5;14;19
93;18.10.2016;2016;10;20;Tiistai;4;7;11
93;18.10.2016;2016;10;21;Tiistai;2;0;2
93;18.10.2016;2016;10;22;Tiistai;0;2;2
93;18.10.2016;2016;10;23;Tiistai;0;0;0
93;19.10.2016;2016;10;00;Keskiviikko;0;0;0
93;19.10.2016;2016;10;01;Keskiviikko;0;0;0
93;19.10.2016;2016;10;02;Keskiviikko;0;0;0
93;19.10.2016;2016;10;03;Keskiviikko;0;0;0
93;19.10.2016;2016;10;04;Keskiviikko;0;1;1
93;19.10.2016;2016;10;05;Keskiviikko;2;2;4
93;19.10.2016;2016;10;06;Keskiviikko;13;9;22
93;19.10.2016;2016;10;07;Keskiviikko;19;12;31
93;19.10.2016;2016;10;08;Keskiviikko;10;16;26
93;19.10.2016;2016;10;09;Keskiviikko;7;7;14
93;19.10.2016;2016;10;10;Keskiviikko;8;7;15
93;19.10.2016;2016;10;11;Keskiviikko;7;7;14
93;19.10.2016;2016;10;12;Keskiviikko;4;3;7
93;19.10.2016;2016;10;13;Keskiviikko;5;3;8
93;19.10.2016;2016;10;14;Keskiviikko;12;10;22
93;19.10.2016;2016;10;15;Keskiviikko;23;22;45
93;19.10.2016;2016;10;16;Keskiviikko;19;25;44
93;19.10.2016;2016;10;17;Keskiviikko;11;7;18
93;19.10.2016;2016;10;18;Keskiviikko;7;21;28
93;19.10.2016;2016;10;19;Keskiviikko;4;8;12
93;19.10.2016;2016;10;20;Keskiviikko;2;5;7
93;19.10.2016;2016;10;21;Keskiviikko;1;2;3
93;19.10.2016;2016;10;22;Keskiviikko;0;4;4
93;19.10.2016;2016;10;23;Keskiviikko;1;3;4
93;20.10.2016;2016;10;00;Torstai;0;1;1
93;20.10.2016;2016;10;01;Torstai;1;1;2
93;20.10.2016;2016;10;02;Torstai;0;0;0
93;20.10.2016;2016;10;03;Torstai;0;0;0
93;20.10.2016;2016;10;04;Torstai;1;1;2
93;20.10.2016;2016;10;05;Torstai;0;2;2
93;20.10.2016;2016;10;06;Torstai;13;7;20
93;20.10.2016;2016;10;07;Torstai;22;13;35
93;20.10.2016;2016;10;08;Torstai;11;18;29
93;20.10.2016;2016;10;09;Torstai;4;7;11
93;20.10.2016;2016;10;10;Torstai;8;6;14
93;20.10.2016;2016;10;11;Torstai;4;10;14
93;20.10.2016;2016;10;12;Torstai;40;6;46
93;20.10.2016;2016;10;13;Torstai;6;7;13
93;20.10.2016;2016;10;14;Torstai;7;10;17
93;20.10.2016;2016;10;15;Torstai;14;54;68
93;20.10.2016;2016;10;16;Torstai;21;18;39
93;20.10.2016;2016;10;17;Torstai;10;10;20
93;20.10.2016;2016;10;18;Torstai;6;7;13
93;20.10.2016;2016;10;19;Torstai;8;8;16
93;20.10.2016;2016;10;20;Torstai;4;8;12
93;20.10.2016;2016;10;21;Torstai;3;5;8
93;20.10.2016;2016;10;22;Torstai;0;1;1
93;20.10.2016;2016;10;23;Torstai;0;2;2
93;21.10.2016;2016;10;00;Perjantai;0;0;0
93;21.10.2016;2016;10;01;Perjantai;0;0;0
93;21.10.2016;2016;10;02;Perjantai;0;0;0
93;21.10.2016;2016;10;03;Perjantai;0;1;1
93;21.10.2016;2016;10;04;Perjantai;0;0;0
93;21.10.2016;2016;10;05;Perjantai;0;3;3
93;21.10.2016;2016;10;06;Perjantai;14;7;21
93;21.10.2016;2016;10;07;Perjantai;10;15;25
93;21.10.2016;2016;10;08;Perjantai;5;19;24
93;21.10.2016;2016;10;09;Perjantai;6;4;10
93;21.10.2016;2016;10;10;Perjantai;6;10;16
93;21.10.2016;2016;10;11;Perjantai;8;6;14
93;21.10.2016;2016;10;12;Perjantai;14;5;19
93;21.10.2016;2016;10;13;Perjantai;8;10;18
93;21.10.2016;2016;10;14;Perjantai;11;9;20
93;21.10.2016;2016;10;15;Perjantai;19;19;38
93;21.10.2016;2016;10;16;Perjantai;16;19;35
93;21.10.2016;2016;10;17;Perjantai;7;11;18
93;21.10.2016;2016;10;18;Perjantai;5;6;11
93;21.10.2016;2016;10;19;Perjantai;3;6;9
93;21.10.2016;2016;10;20;Perjantai;5;1;6
93;21.10.2016;2016;10;21;Perjantai;0;2;2
93;21.10.2016;2016;10;22;Perjantai;0;1;1
93;21.10.2016;2016;10;23;Perjantai;0;0;0
93;22.10.2016;2016;10;00;Lauantai;0;0;0
93;22.10.2016;2016;10;01;Lauantai;0;0;0
93;22.10.2016;2016;10;02;Lauantai;0;0;0
93;22.10.2016;2016;10;03;Lauantai;0;0;0
93;22.10.2016;2016;10;04;Lauantai;1;1;2
93;22.10.2016;2016;10;05;Lauantai;0;0;0
93;22.10.2016;2016;10;06;Lauantai;2;1;3
93;22.10.2016;2016;10;07;Lauantai;0;1;1
93;22.10.2016;2016;10;08;Lauantai;4;1;5
93;22.10.2016;2016;10;09;Lauantai;6;6;12
93;22.10.2016;2016;10;10;Lauantai;5;5;10
93;22.10.2016;2016;10;11;Lauantai;11;4;15
93;22.10.2016;2016;10;12;Lauantai;8;14;22
93;22.10.2016;2016;10;13;Lauantai;2;6;8
93;22.10.2016;2016;10;14;Lauantai;9;2;11
93;22.10.2016;2016;10;15;Lauantai;9;7;16
93;22.10.2016;2016;10;16;Lauantai;4;7;11
93;22.10.2016;2016;10;17;Lauantai;3;6;9
93;22.10.2016;2016;10;18;Lauantai;6;5;11
93;22.10.2016;2016;10;19;Lauantai;2;3;5
93;22.10.2016;2016;10;20;Lauantai;3;4;7
93;22.10.2016;2016;10;21;Lauantai;0;0;0
93;22.10.2016;2016;10;22;Lauantai;0;2;2
93;22.10.2016;2016;10;23;Lauantai;1;2;3
93;23.10.2016;2016;10;00;Sunnuntai;0;1;1
93;23.10.2016;2016;10;01;Sunnuntai;1;0;1
93;23.10.2016;2016;10;02;Sunnuntai;0;0;0
93;23.10.2016;2016;10;03;Sunnuntai;0;0;0
93;23.10.2016;2016;10;04;Sunnuntai;0;0;0
93;23.10.2016;2016;10;05;Sunnuntai;1;0;1
93;23.10.2016;2016;10;06;Sunnuntai;1;0;1
93;23.10.2016;2016;10;07;Sunnuntai;0;0;0
93;23.10.2016;2016;10;08;Sunnuntai;0;1;1
93;23.10.2016;2016;10;09;Sunnuntai;4;3;7
93;23.10.2016;2016;10;10;Sunnuntai;3;4;7
93;23.10.2016;2016;10;11;Sunnuntai;7;4;11
93;23.10.2016;2016;10;12;Sunnuntai;8;8;16
93;23.10.2016;2016;10;13;Sunnuntai;4;7;11
93;23.10.2016;2016;10;14;Sunnuntai;9;11;20
93;23.10.2016;2016;10;15;Sunnuntai;8;11;19
93;23.10.2016;2016;10;16;Sunnuntai;11;5;16
93;23.10.2016;2016;10;17;Sunnuntai;7;9;16
93;23.10.2016;2016;10;18;Sunnuntai;5;3;8
93;23.10.2016;2016;10;19;Sunnuntai;4;8;12
93;23.10.2016;2016;10;20;Sunnuntai;3;3;6
93;23.10.2016;2016;10;21;Sunnuntai;0;2;2
93;23.10.2016;2016;10;22;Sunnuntai;1;0;1
93;23.10.2016;2016;10;23;Sunnuntai;0;0;0
93;24.10.2016;2016;10;00;Maanantai;0;1;1
93;24.10.2016;2016;10;01;Maanantai;1;0;1
93;24.10.2016;2016;10;02;Maanantai;0;0;0
93;24.10.2016;2016;10;03;Maanantai;0;0;0
93;24.10.2016;2016;10;04;Maanantai;1;1;2
93;24.10.2016;2016;10;05;Maanantai;1;3;4
93;24.10.2016;2016;10;06;Maanantai;12;8;20
93;24.10.2016;2016;10;07;Maanantai;11;14;25
93;24.10.2016;2016;10;08;Maanantai;5;16;21
93;24.10.2016;2016;10;09;Maanantai;5;5;10
93;24.10.2016;2016;10;10;Maanantai;7;3;10
93;24.10.2016;2016;10;11;Maanantai;6;8;14
93;24.10.2016;2016;10;12;Maanantai;11;2;13
93;24.10.2016;2016;10;13;Maanantai;9;8;17
93;24.10.2016;2016;10;14;Maanantai;5;9;14
93;24.10.2016;2016;10;15;Maanantai;9;25;34
93;24.10.2016;2016;10;16;Maanantai;22;12;34
93;24.10.2016;2016;10;17;Maanantai;11;7;18
93;24.10.2016;2016;10;18;Maanantai;9;6;15
93;24.10.2016;2016;10;19;Maanantai;5;10;15
93;24.10.2016;2016;10;20;Maanantai;3;4;7
93;24.10.2016;2016;10;21;Maanantai;0;2;2
93;24.10.2016;2016;10;22;Maanantai;0;4;4
93;24.10.2016;2016;10;23;Maanantai;1;0;1
93;25.10.2016;2016;10;00;Tiistai;1;0;1
93;25.10.2016;2016;10;01;Tiistai;0;0;0
93;25.10.2016;2016;10;02;Tiistai;0;0;0
93;25.10.2016;2016;10;03;Tiistai;0;0;0
93;25.10.2016;2016;10;04;Tiistai;0;0;0
93;25.10.2016;2016;10;05;Tiistai;2;1;3
93;25.10.2016;2016;10;06;Tiistai;12;7;19
93;25.10.2016;2016;10;07;Tiistai;7;14;21
93;25.10.2016;2016;10;08;Tiistai;6;11;17
93;25.10.2016;2016;10;09;Tiistai;4;3;7
93;25.10.2016;2016;10;10;Tiistai;7;4;11
93;25.10.2016;2016;10;11;Tiistai;10;4;14
93;25.10.2016;2016;10;12;Tiistai;8;4;12
93;25.10.2016;2016;10;13;Tiistai;11;8;19
93;25.10.2016;2016;10;14;Tiistai;2;7;9
93;25.10.2016;2016;10;15;Tiistai;7;16;23
93;25.10.2016;2016;10;16;Tiistai;14;13;27
93;25.10.2016;2016;10;17;Tiistai;11;6;17
93;25.10.2016;2016;10;18;Tiistai;6;8;14
93;25.10.2016;2016;10;19;Tiistai;6;6;12
93;25.10.2016;2016;10;20;Tiistai;4;3;7
93;25.10.2016;2016;10;21;Tiistai;3;5;8
93;25.10.2016;2016;10;22;Tiistai;0;3;3
93;25.10.2016;2016;10;23;Tiistai;0;0;0
93;26.10.2016;2016;10;00;Keskiviikko;1;1;2
93;26.10.2016;2016;10;01;Keskiviikko;0;0;0
93;26.10.2016;2016;10;02;Keskiviikko;0;0;0
93;26.10.2016;2016;10;03;Keskiviikko;0;1;1
93;26.10.2016;2016;10;04;Keskiviikko;1;0;1
93;26.10.2016;2016;10;05;Keskiviikko;2;2;4
93;26.10.2016;2016;10;06;Keskiviikko;12;5;17
93;26.10.2016;2016;10;07;Keskiviikko;6;13;19
93;26.10.2016;2016;10;08;Keskiviikko;3;18;21
93;26.10.2016;2016;10;09;Keskiviikko;3;5;8
93;26.10.2016;2016;10;10;Keskiviikko;1;1;2
93;26.10.2016;2016;10;11;Keskiviikko;5;4;9
93;26.10.2016;2016;10;12;Keskiviikko;3;2;5
93;26.10.2016;2016;10;13;Keskiviikko;3;5;8
93;26.10.2016;2016;10;14;Keskiviikko;3;7;10
93;26.10.2016;2016;10;15;Keskiviikko;10;11;21
93;26.10.2016;2016;10;16;Keskiviikko;21;7;28
93;26.10.2016;2016;10;17;Keskiviikko;11;11;22
93;26.10.2016;2016;10;18;Keskiviikko;1;1;2
93;26.10.2016;2016;10;19;Keskiviikko;3;0;3
93;26.10.2016;2016;10;20;Keskiviikko;1;2;3
93;26.10.2016;2016;10;21;Keskiviikko;0;2;2
93;26.10.2016;2016;10;22;Keskiviikko;1;3;4
93;26.10.2016;2016;10;23;Keskiviikko;0;0;0
93;27.10.2016;2016;10;00;Torstai;0;1;1
93;27.10.2016;2016;10;01;Torstai;0;0;0
93;27.10.2016;2016;10;02;Torstai;0;0;0
93;27.10.2016;2016;10;03;Torstai;0;0;0
93;27.10.2016;2016;10;04;Torstai;0;0;0
93;27.10.2016;2016;10;05;Torstai;1;0;1
93;27.10.2016;2016;10;06;Torstai;12;4;16
93;27.10.2016;2016;10;07;Torstai;6;10;16
93;27.10.2016;2016;10;08;Torstai;5;16;21
93;27.10.2016;2016;10;09;Torstai;2;2;4
93;27.10.2016;2016;10;10;Torstai;4;2;6
93;27.10.2016;2016;10;11;Torstai;4;3;7
93;27.10.2016;2016;10;12;Torstai;7;4;11
93;27.10.2016;2016;10;13;Torstai;5;2;7
93;27.10.2016;2016;10;14;Torstai;3;5;8
93;27.10.2016;2016;10;15;Torstai;8;12;20
93;27.10.2016;2016;10;16;Torstai;23;10;33
93;27.10.2016;2016;10;17;Torstai;8;8;16
93;27.10.2016;2016;10;18;Torstai;3;1;4
93;27.10.2016;2016;10;19;Torstai;3;6;9
93;27.10.2016;2016;10;20;Torstai;3;3;6
93;27.10.2016;2016;10;21;Torstai;2;2;4
93;27.10.2016;2016;10;22;Torstai;2;0;2
93;27.10.2016;2016;10;23;Torstai;0;3;3
93;28.10.2016;2016;10;00;Perjantai;0;0;0
93;28.10.2016;2016;10;01;Perjantai;0;0;0
93;28.10.2016;2016;10;02;Perjantai;0;0;0
93;28.10.2016;2016;10;03;Perjantai;0;2;2
93;28.10.2016;2016;10;04;Perjantai;0;0;0
93;28.10.2016;2016;10;05;Perjantai;2;0;2
93;28.10.2016;2016;10;06;Perjantai;5;6;11
93;28.10.2016;2016;10;07;Perjantai;3;7;10
93;28.10.2016;2016;10;08;Perjantai;2;13;15
93;28.10.2016;2016;10;09;Perjantai;6;3;9
93;28.10.2016;2016;10;10;Perjantai;2;1;3
93;28.10.2016;2016;10;11;Perjantai;6;5;11
93;28.10.2016;2016;10;12;Perjantai;6;0;6
93;28.10.2016;2016;10;13;Perjantai;3;11;14
93;28.10.2016;2016;10;14;Perjantai;10;5;15
93;28.10.2016;2016;10;15;Perjantai;7;5;12
93;28.10.2016;2016;10;16;Perjantai;13;6;19
93;28.10.2016;2016;10;17;Perjantai;7;8;15
93;28.10.2016;2016;10;18;Perjantai;9;3;12
93;28.10.2016;2016;10;19;Perjantai;2;1;3
93;28.10.2016;2016;10;20;Perjantai;1;3;4
93;28.10.2016;2016;10;21;Perjantai;2;3;5
93;28.10.2016;2016;10;22;Perjantai;0;1;1
93;28.10.2016;2016;10;23;Perjantai;0;0;0
93;29.10.2016;2016;10;00;Lauantai;0;0;0
93;29.10.2016;2016;10;01;Lauantai;0;0;0
93;29.10.2016;2016;10;02;Lauantai;0;2;2
93;29.10.2016;2016;10;03;Lauantai;0;0;0
93;29.10.2016;2016;10;04;Lauantai;0;0;0
93;29.10.2016;2016;10;05;Lauantai;1;0;1
93;29.10.2016;2016;10;06;Lauantai;0;1;1
93;29.10.2016;2016;10;07;Lauantai;2;2;4
93;29.10.2016;2016;10;08;Lauantai;0;2;2
93;29.10.2016;2016;10;09;Lauantai;8;5;13
93;29.10.2016;2016;10;10;Lauantai;3;2;5
93;29.10.2016;2016;10;11;Lauantai;4;5;9
93;29.10.2016;2016;10;12;Lauantai;10;9;19
93;29.10.2016;2016;10;13;Lauantai;8;6;14
93;29.10.2016;2016;10;14;Lauantai;5;5;10
93;29.10.2016;2016;10;15;Lauantai;4;7;11
93;29.10.2016;2016;10;16;Lauantai;4;10;14
93;29.10.2016;2016;10;17;Lauantai;4;6;10
93;29.10.2016;2016;10;18;Lauantai;4;3;7
93;29.10.2016;2016;10;19;Lauantai;0;1;1
93;29.10.2016;2016;10;20;Lauantai;1;3;4
93;29.10.2016;2016;10;21;Lauantai;2;2;4
93;29.10.2016;2016;10;22;Lauantai;0;0;0
93;29.10.2016;2016;10;23;Lauantai;1;0;1
93;30.10.2016;2016;10;00;Sunnuntai;1;0;1
93;30.10.2016;2016;10;01;Sunnuntai;1;1;2
93;30.10.2016;2016;10;02;Sunnuntai;1;0;1
93;30.10.2016;2016;10;03;Sunnuntai;0;0;0
93;30.10.2016;2016;10;04;Sunnuntai;0;0;0
93;30.10.2016;2016;10;05;Sunnuntai;0;0;0
93;30.10.2016;2016;10;06;Sunnuntai;2;1;3
93;30.10.2016;2016;10;07;Sunnuntai;1;2;3
93;30.10.2016;2016;10;08;Sunnuntai;3;1;4
93;30.10.2016;2016;10;09;Sunnuntai;8;4;12
93;30.10.2016;2016;10;10;Sunnuntai;7;5;12
93;30.10.2016;2016;10;11;Sunnuntai;12;10;22
93;30.10.2016;2016;10;12;Sunnuntai;6;4;10
93;30.10.2016;2016;10;13;Sunnuntai;11;4;15
93;30.10.2016;2016;10;14;Sunnuntai;7;9;16
93;30.10.2016;2016;10;15;Sunnuntai;11;5;16
93;30.10.2016;2016;10;16;Sunnuntai;14;10;24
93;30.10.2016;2016;10;17;Sunnuntai;3;2;5
93;30.10.2016;2016;10;18;Sunnuntai;2;3;5
93;30.10.2016;2016;10;19;Sunnuntai;1;5;6
93;30.10.2016;2016;10;20;Sunnuntai;0;1;1
93;30.10.2016;2016;10;21;Sunnuntai;1;1;2
93;30.10.2016;2016;10;22;Sunnuntai;0;0;0
93;30.10.2016;2016;10;23;Sunnuntai;0;0;0
93;31.10.2016;2016;10;00;Maanantai;0;0;0
93;31.10.2016;2016;10;01;Maanantai;0;0;0
93;31.10.2016;2016;10;02;Maanantai;0;0;0
93;31.10.2016;2016;10;03;Maanantai;0;0;0
93;31.10.2016;2016;10;04;Maanantai;0;1;1
93;31.10.2016;2016;10;05;Maanantai;2;1;3
93;31.10.2016;2016;10;06;Maanantai;8;6;14
93;31.10.2016;2016;10;07;Maanantai;12;17;29
93;31.10.2016;2016;10;08;Maanantai;11;22;33
93;31.10.2016;2016;10;09;Maanantai;9;4;13
93;31.10.2016;2016;10;10;Maanantai;11;5;16
93;31.10.2016;2016;10;11;Maanantai;3;4;7
93;31.10.2016;2016;10;12;Maanantai;4;10;14
93;31.10.2016;2016;10;13;Maanantai;8;7;15
93;31.10.2016;2016;10;14;Maanantai;2;9;11
93;31.10.2016;2016;10;15;Maanantai;15;11;26
93;31.10.2016;2016;10;16;Maanantai;26;8;34
93;31.10.2016;2016;10;17;Maanantai;14;10;24
93;31.10.2016;2016;10;18;Maanantai;5;3;8
93;31.10.2016;2016;10;19;Maanantai;8;6;14
93;31.10.2016;2016;10;20;Maanantai;3;2;5
93;31.10.2016;2016;10;21;Maanantai;0;2;2
93;31.10.2016;2016;10;22;Maanantai;0;0;0
93;31.10.2016;2016;10;23;Maanantai;0;1;1
93;01.11.2016;2016;11;00;Tiistai;1;0;1
93;01.11.2016;2016;11;01;Tiistai;0;0;0
93;01.11.2016;2016;11;02;Tiistai;0;0;0
93;01.11.2016;2016;11;03;Tiistai;0;0;0
93;01.11.2016;2016;11;04;Tiistai;0;1;1
93;01.11.2016;2016;11;05;Tiistai;2;2;4
93;01.11.2016;2016;11;06;Tiistai;6;8;14
93;01.11.2016;2016;11;07;Tiistai;14;22;36
93;01.11.2016;2016;11;08;Tiistai;4;11;15
93;01.11.2016;2016;11;09;Tiistai;6;3;9
93;01.11.2016;2016;11;10;Tiistai;5;5;10
93;01.11.2016;2016;11;11;Tiistai;4;5;9
93;01.11.2016;2016;11;12;Tiistai;7;4;11
93;01.11.2016;2016;11;13;Tiistai;2;7;9
93;01.11.2016;2016;11;14;Tiistai;2;2;4
93;01.11.2016;2016;11;15;Tiistai;12;10;22
93;01.11.2016;2016;11;16;Tiistai;25;9;34
93;01.11.2016;2016;11;17;Tiistai;8;7;15
93;01.11.2016;2016;11;18;Tiistai;4;4;8
93;01.11.2016;2016;11;19;Tiistai;5;4;9
93;01.11.2016;2016;11;20;Tiistai;1;2;3
93;01.11.2016;2016;11;21;Tiistai;1;0;1
93;01.11.2016;2016;11;22;Tiistai;0;0;0
93;01.11.2016;2016;11;23;Tiistai;0;2;2
93;02.11.2016;2016;11;00;Keskiviikko;1;0;1
93;02.11.2016;2016;11;01;Keskiviikko;0;0;0
93;02.11.2016;2016;11;02;Keskiviikko;0;0;0
93;02.11.2016;2016;11;03;Keskiviikko;0;0;0
93;02.11.2016;2016;11;04;Keskiviikko;0;1;1
93;02.11.2016;2016;11;05;Keskiviikko;2;1;3
93;02.11.2016;2016;11;06;Keskiviikko;5;6;11
93;02.11.2016;2016;11;07;Keskiviikko;10;14;24
93;02.11.2016;2016;11;08;Keskiviikko;9;19;28
93;02.11.2016;2016;11;09;Keskiviikko;5;3;8
93;02.11.2016;2016;11;10;Keskiviikko;4;4;8
93;02.11.2016;2016;11;11;Keskiviikko;4;1;5
93;02.11.2016;2016;11;12;Keskiviikko;2;5;7
93;02.11.2016;2016;11;13;Keskiviikko;6;7;13
93;02.11.2016;2016;11;14;Keskiviikko;7;5;12
93;02.11.2016;2016;11;15;Keskiviikko;10;11;21
93;02.11.2016;2016;11;16;Keskiviikko;22;15;37
93;02.11.2016;2016;11;17;Keskiviikko;19;17;36
93;02.11.2016;2016;11;18;Keskiviikko;4;7;11
93;02.11.2016;2016;11;19;Keskiviikko;3;1;4
93;02.11.2016;2016;11;20;Keskiviikko;2;0;2
93;02.11.2016;2016;11;21;Keskiviikko;1;1;2
93;02.11.2016;2016;11;22;Keskiviikko;1;2;3
93;02.11.2016;2016;11;23;Keskiviikko;2;0;2
93;03.11.2016;2016;11;00;Torstai;0;1;1
93;03.11.2016;2016;11;01;Torstai;0;1;1
93;03.11.2016;2016;11;02;Torstai;0;0;0
93;03.11.2016;2016;11;03;Torstai;0;0;0
93;03.11.2016;2016;11;04;Torstai;0;0;0
93;03.11.2016;2016;11;05;Torstai;1;0;1
93;03.11.2016;2016;11;06;Torstai;7;5;12
93;03.11.2016;2016;11;07;Torstai;11;15;26
93;03.11.2016;2016;11;08;Torstai;5;16;21
93;03.11.2016;2016;11;09;Torstai;5;2;7
93;03.11.2016;2016;11;10;Torstai;6;5;11
93;03.11.2016;2016;11;11;Torstai;2;5;7
93;03.11.2016;2016;11;12;Torstai;3;2;5
93;03.11.2016;2016;11;13;Torstai;5;5;10
93;03.11.2016;2016;11;14;Torstai;6;4;10
93;03.11.2016;2016;11;15;Torstai;9;12;21
93;03.11.2016;2016;11;16;Torstai;20;12;32
93;03.11.2016;2016;11;17;Torstai;11;8;19
93;03.11.2016;2016;11;18;Torstai;3;5;8
93;03.11.2016;2016;11;19;Torstai;3;4;7
93;03.11.2016;2016;11;20;Torstai;2;1;3
93;03.11.2016;2016;11;21;Torstai;0;2;2
93;03.11.2016;2016;11;22;Torstai;1;0;1
93;03.11.2016;2016;11;23;Torstai;0;0;0
93;04.11.2016;2016;11;00;Perjantai;0;0;0
93;04.11.2016;2016;11;01;Perjantai;0;0;0
93;04.11.2016;2016;11;02;Perjantai;0;0;0
93;04.11.2016;2016;11;03;Perjantai;0;0;0
93;04.11.2016;2016;11;04;Perjantai;0;0;0
93;04.11.2016;2016;11;05;Perjantai;1;1;2
93;04.11.2016;2016;11;06;Perjantai;5;6;11
93;04.11.2016;2016;11;07;Perjantai;9;15;24
93;04.11.2016;2016;11;08;Perjantai;3;16;19
93;04.11.2016;2016;11;09;Perjantai;6;1;7
93;04.11.2016;2016;11;10;Perjantai;4;4;8
93;04.11.2016;2016;11;11;Perjantai;2;2;4
93;04.11.2016;2016;11;12;Perjantai;4;1;5
93;04.11.2016;2016;11;13;Perjantai;6;5;11
93;04.11.2016;2016;11;14;Perjantai;4;3;7
93;04.11.2016;2016;11;15;Perjantai;9;11;20
93;04.11.2016;2016;11;16;Perjantai;15;8;23
93;04.11.2016;2016;11;17;Perjantai;7;3;10
93;04.11.2016;2016;11;18;Perjantai;7;1;8
93;04.11.2016;2016;11;19;Perjantai;1;4;5
93;04.11.2016;2016;11;20;Perjantai;1;2;3
93;04.11.2016;2016;11;21;Perjantai;0;2;2
93;04.11.2016;2016;11;22;Perjantai;0;0;0
93;04.11.2016;2016;11;23;Perjantai;0;0;0
93;05.11.2016;2016;11;00;Lauantai;0;1;1
93;05.11.2016;2016;11;01;Lauantai;0;1;1
93;05.11.2016;2016;11;02;Lauantai;0;0;0
93;05.11.2016;2016;11;03;Lauantai;0;1;1
93;05.11.2016;2016;11;04;Lauantai;0;0;0
93;05.11.2016;2016;11;05;Lauantai;0;0;0
93;05.11.2016;2016;11;06;Lauantai;0;0;0
93;05.11.2016;2016;11;07;Lauantai;4;0;4
93;05.11.2016;2016;11;08;Lauantai;0;0;0
93;05.11.2016;2016;11;09;Lauantai;3;0;3
93;05.11.2016;2016;11;10;Lauantai;4;4;8
93;05.11.2016;2016;11;11;Lauantai;6;3;9
93;05.11.2016;2016;11;12;Lauantai;3;2;5
93;05.11.2016;2016;11;13;Lauantai;3;6;9
93;05.11.2016;2016;11;14;Lauantai;1;8;9
93;05.11.2016;2016;11;15;Lauantai;3;1;4
93;05.11.2016;2016;11;16;Lauantai;2;1;3
93;05.11.2016;2016;11;17;Lauantai;3;4;7
93;05.11.2016;2016;11;18;Lauantai;1;0;1
93;05.11.2016;2016;11;19;Lauantai;3;1;4
93;05.11.2016;2016;11;20;Lauantai;0;1;1
93;05.11.2016;2016;11;21;Lauantai;0;2;2
93;05.11.2016;2016;11;22;Lauantai;0;0;0
93;05.11.2016;2016;11;23;Lauantai;0;0;0
93;06.11.2016;2016;11;00;Sunnuntai;2;1;3
93;06.11.2016;2016;11;01;Sunnuntai;0;0;0
93;06.11.2016;2016;11;02;Sunnuntai;0;0;0
93;06.11.2016;2016;11;03;Sunnuntai;0;5;5
93;06.11.2016;2016;11;04;Sunnuntai;0;0;0
93;06.11.2016;2016;11;05;Sunnuntai;0;0;0
93;06.11.2016;2016;11;06;Sunnuntai;1;0;1
93;06.11.2016;2016;11;07;Sunnuntai;0;0;0
93;06.11.2016;2016;11;08;Sunnuntai;2;0;2
93;06.11.2016;2016;11;09;Sunnuntai;3;1;4
93;06.11.2016;2016;11;10;Sunnuntai;1;1;2
93;06.11.2016;2016;11;11;Sunnuntai;6;3;9
93;06.11.2016;2016;11;12;Sunnuntai;4;4;8
93;06.11.2016;2016;11;13;Sunnuntai;2;1;3
93;06.11.2016;2016;11;14;Sunnuntai;2;9;11
93;06.11.2016;2016;11;15;Sunnuntai;2;2;4
93;06.11.2016;2016;11;16;Sunnuntai;0;0;0
93;06.11.2016;2016;11;17;Sunnuntai;1;0;1
93;06.11.2016;2016;11;18;Sunnuntai;0;1;1
93;06.11.2016;2016;11;19;Sunnuntai;1;0;1
93;06.11.2016;2016;11;20;Sunnuntai;0;1;1
93;06.11.2016;2016;11;21;Sunnuntai;0;0;0
93;06.11.2016;2016;11;22;Sunnuntai;0;1;1
93;06.11.2016;2016;11;23;Sunnuntai;0;1;1
93;07.11.2016;2016;11;00;Maanantai;0;0;0
93;07.11.2016;2016;11;01;Maanantai;0;0;0
93;07.11.2016;2016;11;02;Maanantai;0;0;0
93;07.11.2016;2016;11;03;Maanantai;0;0;0
93;07.11.2016;2016;11;04;Maanantai;0;0;0
93;07.11.2016;2016;11;05;Maanantai;2;1;3
93;07.11.2016;2016;11;06;Maanantai;3;5;8
93;07.11.2016;2016;11;07;Maanantai;12;9;21
93;07.11.2016;2016;11;08;Maanantai;8;16;24
93;07.11.2016;2016;11;09;Maanantai;6;1;7
93;07.11.2016;2016;11;10;Maanantai;2;1;3
93;07.11.2016;2016;11;11;Maanantai;0;0;0
93;07.11.2016;2016;11;12;Maanantai;0;1;1
93;07.11.2016;2016;11;13;Maanantai;3;3;6
93;07.11.2016;2016;11;14;Maanantai;4;6;10
93;07.11.2016;2016;11;15;Maanantai;12;4;16
93;07.11.2016;2016;11;16;Maanantai;9;6;15
93;07.11.2016;2016;11;17;Maanantai;8;5;13
93;07.11.2016;2016;11;18;Maanantai;0;9;9
93;07.11.2016;2016;11;19;Maanantai;3;4;7
93;07.11.2016;2016;11;20;Maanantai;0;1;1
93;07.11.2016;2016;11;21;Maanantai;1;2;3
93;07.11.2016;2016;11;22;Maanantai;2;0;2
93;07.11.2016;2016;11;23;Maanantai;0;0;0
93;08.11.2016;2016;11;00;Tiistai;0;0;0
93;08.11.2016;2016;11;01;Tiistai;0;0;0
93;08.11.2016;2016;11;02;Tiistai;0;0;0
93;08.11.2016;2016;11;03;Tiistai;0;0;0
93;08.11.2016;2016;11;04;Tiistai;0;0;0
93;08.11.2016;2016;11;05;Tiistai;2;1;3
93;08.11.2016;2016;11;06;Tiistai;3;5;8
93;08.11.2016;2016;11;07;Tiistai;10;12;22
93;08.11.2016;2016;11;08;Tiistai;5;18;23
93;08.11.2016;2016;11;09;Tiistai;2;0;2
93;08.11.2016;2016;11;10;Tiistai;2;1;3
93;08.11.2016;2016;11;11;Tiistai;2;0;2
93;08.11.2016;2016;11;12;Tiistai;4;4;8
93;08.11.2016;2016;11;13;Tiistai;2;2;4
93;08.11.2016;2016;11;14;Tiistai;2;2;4
93;08.11.2016;2016;11;15;Tiistai;7;7;14
93;08.11.2016;2016;11;16;Tiistai;16;7;23
93;08.11.2016;2016;11;17;Tiistai;6;6;12
93;08.11.2016;2016;11;18;Tiistai;5;7;12
93;08.11.2016;2016;11;19;Tiistai;2;5;7
93;08.11.2016;2016;11;20;Tiistai;1;1;2
93;08.11.2016;2016;11;21;Tiistai;1;0;1
93;08.11.2016;2016;11;22;Tiistai;0;1;1
93;08.11.2016;2016;11;23;Tiistai;0;0;0
93;09.11.2016;2016;11;00;Keskiviikko;0;0;0
93;09.11.2016;2016;11;01;Keskiviikko;0;0;0
93;09.11.2016;2016;11;02;Keskiviikko;0;0;0
93;09.11.2016;2016;11;03;Keskiviikko;0;0;0
93;09.11.2016;2016;11;04;Keskiviikko;0;0;0
93;09.11.2016;2016;11;05;Keskiviikko;2;1;3
93;09.11.2016;2016;11;06;Keskiviikko;4;6;10
93;09.11.2016;2016;11;07;Keskiviikko;9;12;21
93;09.11.2016;2016;11;08;Keskiviikko;4;14;18
93;09.11.2016;2016;11;09;Keskiviikko;3;3;6
93;09.11.2016;2016;11;10;Keskiviikko;3;1;4
93;09.11.2016;2016;11;11;Keskiviikko;0;1;1
93;09.11.2016;2016;11;12;Keskiviikko;3;2;5
93;09.11.2016;2016;11;13;Keskiviikko;5;5;10
93;09.11.2016;2016;11;14;Keskiviikko;5;1;6
93;09.11.2016;2016;11;15;Keskiviikko;12;8;20
93;09.11.2016;2016;11;16;Keskiviikko;11;10;21
93;09.11.2016;2016;11;17;Keskiviikko;7;7;14
93;09.11.2016;2016;11;18;Keskiviikko;1;3;4
93;09.11.2016;2016;11;19;Keskiviikko;1;5;6
93;09.11.2016;2016;11;20;Keskiviikko;2;1;3
93;09.11.2016;2016;11;21;Keskiviikko;1;1;2
93;09.11.2016;2016;11;22;Keskiviikko;0;0;0
93;09.11.2016;2016;11;23;Keskiviikko;0;0;0
93;10.11.2016;2016;11;00;Torstai;0;0;0
93;10.11.2016;2016;11;01;Torstai;0;0;0
93;10.11.2016;2016;11;02;Torstai;0;0;0
93;10.11.2016;2016;11;03;Torstai;0;0;0
93;10.11.2016;2016;11;04;Torstai;0;0;0
93;10.11.2016;2016;11;05;Torstai;1;2;3
93;10.11.2016;2016;11;06;Torstai;6;8;14
93;10.11.2016;2016;11;07;Torstai;9;12;21
93;10.11.2016;2016;11;08;Torstai;2;12;14
93;10.11.2016;2016;11;09;Torstai;2;4;6
93;10.11.2016;2016;11;10;Torstai;4;2;6
93;10.11.2016;2016;11;11;Torstai;0;3;3
93;10.11.2016;2016;11;12;Torstai;2;1;3
93;10.11.2016;2016;11;13;Torstai;1;2;3
93;10.11.2016;2016;11;14;Torstai;6;5;11
93;10.11.2016;2016;11;15;Torstai;8;8;16
93;10.11.2016;2016;11;16;Torstai;14;7;21
93;10.11.2016;2016;11;17;Torstai;7;5;12
93;10.11.2016;2016;11;18;Torstai;3;1;4
93;10.11.2016;2016;11;19;Torstai;4;3;7
93;10.11.2016;2016;11;20;Torstai;2;1;3
93;10.11.2016;2016;11;21;Torstai;0;1;1
93;10.11.2016;2016;11;22;Torstai;0;0;0
93;10.11.2016;2016;11;23;Torstai;0;0;0
93;11.11.2016;2016;11;00;Perjantai;0;0;0
93;11.11.2016;2016;11;01;Perjantai;0;0;0
93;11.11.2016;2016;11;02;Perjantai;0;0;0
93;11.11.2016;2016;11;03;Perjantai;0;0;0
93;11.11.2016;2016;11;04;Perjantai;0;1;1
93;11.11.2016;2016;11;05;Perjantai;1;0;1
93;11.11.2016;2016;11;06;Perjantai;8;4;12
93;11.11.2016;2016;11;07;Perjantai;8;9;17
93;11.11.2016;2016;11;08;Perjantai;0;7;7
93;11.11.2016;2016;11;09;Perjantai;0;1;1
93;11.11.2016;2016;11;10;Perjantai;2;1;3
93;11.11.2016;2016;11;11;Perjantai;2;1;3
93;11.11.2016;2016;11;12;Perjantai;4;1;5
93;11.11.2016;2016;11;13;Perjantai;4;3;7
93;11.11.2016;2016;11;14;Perjantai;3;3;6
93;11.11.2016;2016;11;15;Perjantai;9;5;14
93;11.11.2016;2016;11;16;Perjantai;9;6;15
93;11.11.2016;2016;11;17;Perjantai;4;3;7
93;11.11.2016;2016;11;18;Perjantai;1;5;6
93;11.11.2016;2016;11;19;Perjantai;2;2;4
93;11.11.2016;2016;11;20;Perjantai;4;6;10
93;11.11.2016;2016;11;21;Perjantai;1;2;3
93;11.11.2016;2016;11;22;Perjantai;0;0;0
93;11.11.2016;2016;11;23;Perjantai;0;0;0
93;12.11.2016;2016;11;00;Lauantai;0;0;0
93;12.11.2016;2016;11;01;Lauantai;1;0;1
93;12.11.2016;2016;11;02;Lauantai;0;1;1
93;12.11.2016;2016;11;03;Lauantai;0;1;1
93;12.11.2016;2016;11;04;Lauantai;0;0;0
93;12.11.2016;2016;11;05;Lauantai;0;0;0
93;12.11.2016;2016;11;06;Lauantai;0;2;2
93;12.11.2016;2016;11;07;Lauantai;0;2;2
93;12.11.2016;2016;11;08;Lauantai;0;0;0
93;12.11.2016;2016;11;09;Lauantai;0;0;0
93;12.11.2016;2016;11;10;Lauantai;4;2;6
93;12.11.2016;2016;11;11;Lauantai;4;2;6
93;12.11.2016;2016;11;12;Lauantai;4;6;10
93;12.11.2016;2016;11;13;Lauantai;1;4;5
93;12.11.2016;2016;11;14;Lauantai;1;2;3
93;12.11.2016;2016;11;15;Lauantai;5;2;7
93;12.11.2016;2016;11;16;Lauantai;1;2;3
93;12.11.2016;2016;11;17;Lauantai;0;1;1
93;12.11.2016;2016;11;18;Lauantai;1;0;1
93;12.11.2016;2016;11;19;Lauantai;3;0;3
93;12.11.2016;2016;11;20;Lauantai;0;1;1
93;12.11.2016;2016;11;21;Lauantai;1;2;3
93;12.11.2016;2016;11;22;Lauantai;1;0;1
93;12.11.2016;2016;11;23;Lauantai;0;1;1
93;13.11.2016;2016;11;00;Sunnuntai;0;0;0
93;13.11.2016;2016;11;01;Sunnuntai;0;0;0
93;13.11.2016;2016;11;02;Sunnuntai;0;1;1
93;13.11.2016;2016;11;03;Sunnuntai;0;0;0
93;13.11.2016;2016;11;04;Sunnuntai;0;0;0
93;13.11.2016;2016;11;05;Sunnuntai;0;0;0
93;13.11.2016;2016;11;06;Sunnuntai;0;0;0
93;13.11.2016;2016;11;07;Sunnuntai;1;0;1
93;13.11.2016;2016;11;08;Sunnuntai;1;2;3
93;13.11.2016;2016;11;09;Sunnuntai;2;1;3
93;13.11.2016;2016;11;10;Sunnuntai;1;0;1
93;13.11.2016;2016;11;11;Sunnuntai;5;1;6
93;13.11.2016;2016;11;12;Sunnuntai;6;4;10
93;13.11.2016;2016;11;13;Sunnuntai;1;1;2
93;13.11.2016;2016;11;14;Sunnuntai;1;0;1
93;13.11.2016;2016;11;15;Sunnuntai;2;2;4
93;13.11.2016;2016;11;16;Sunnuntai;3;2;5
93;13.11.2016;2016;11;17;Sunnuntai;2;1;3
93;13.11.2016;2016;11;18;Sunnuntai;2;5;7
93;13.11.2016;2016;11;19;Sunnuntai;1;0;1
93;13.11.2016;2016;11;20;Sunnuntai;1;2;3
93;13.11.2016;2016;11;21;Sunnuntai;0;5;5
93;13.11.2016;2016;11;22;Sunnuntai;1;1;2
93;13.11.2016;2016;11;23;Sunnuntai;0;0;0
93;14.11.2016;2016;11;00;Maanantai;0;0;0
93;14.11.2016;2016;11;01;Maanantai;0;0;0
93;14.11.2016;2016;11;02;Maanantai;0;0;0
93;14.11.2016;2016;11;03;Maanantai;0;0;0
93;14.11.2016;2016;11;04;Maanantai;0;0;0
93;14.11.2016;2016;11;05;Maanantai;1;0;1
93;14.11.2016;2016;11;06;Maanantai;9;3;12
93;14.11.2016;2016;11;07;Maanantai;7;16;23
93;14.11.2016;2016;11;08;Maanantai;8;10;18
93;14.11.2016;2016;11;09;Maanantai;7;1;8
93;14.11.2016;2016;11;10;Maanantai;2;0;2
93;14.11.2016;2016;11;11;Maanantai;0;1;1
93;14.11.2016;2016;11;12;Maanantai;2;3;5
93;14.11.2016;2016;11;13;Maanantai;1;5;6
93;14.11.2016;2016;11;14;Maanantai;0;1;1
93;14.11.2016;2016;11;15;Maanantai;8;6;14
93;14.11.2016;2016;11;16;Maanantai;16;12;28
93;14.11.2016;2016;11;17;Maanantai;14;5;19
93;14.11.2016;2016;11;18;Maanantai;4;4;8
93;14.11.2016;2016;11;19;Maanantai;1;0;1
93;14.11.2016;2016;11;20;Maanantai;0;5;5
93;14.11.2016;2016;11;21;Maanantai;0;1;1
93;14.11.2016;2016;11;22;Maanantai;0;0;0
93;14.11.2016;2016;11;23;Maanantai;0;0;0
93;15.11.2016;2016;11;00;Tiistai;1;0;1
93;15.11.2016;2016;11;01;Tiistai;0;0;0
93;15.11.2016;2016;11;02;Tiistai;0;0;0
93;15.11.2016;2016;11;03;Tiistai;0;0;0
93;15.11.2016;2016;11;04;Tiistai;0;0;0
93;15.11.2016;2016;11;05;Tiistai;1;0;1
93;15.11.2016;2016;11;06;Tiistai;6;5;11
93;15.11.2016;2016;11;07;Tiistai;11;14;25
93;15.11.2016;2016;11;08;Tiistai;7;10;17
93;15.11.2016;2016;11;09;Tiistai;3;3;6
93;15.11.2016;2016;11;10;Tiistai;5;0;5
93;15.11.2016;2016;11;11;Tiistai;10;3;13
93;15.11.2016;2016;11;12;Tiistai;3;4;7
93;15.11.2016;2016;11;13;Tiistai;3;4;7
93;15.11.2016;2016;11;14;Tiistai;2;2;4
93;15.11.2016;2016;11;15;Tiistai;9;9;18
93;15.11.2016;2016;11;16;Tiistai;14;12;26
93;15.11.2016;2016;11;17;Tiistai;11;5;16
93;15.11.2016;2016;11;18;Tiistai;0;8;8
93;15.11.2016;2016;11;19;Tiistai;1;4;5
93;15.11.2016;2016;11;20;Tiistai;0;1;1
93;15.11.2016;2016;11;21;Tiistai;1;2;3
93;15.11.2016;2016;11;22;Tiistai;0;1;1
93;15.11.2016;2016;11;23;Tiistai;0;1;1
93;16.11.2016;2016;11;00;Keskiviikko;1;0;1
93;16.11.2016;2016;11;01;Keskiviikko;0;0;0
93;16.11.2016;2016;11;02;Keskiviikko;0;0;0
93;16.11.2016;2016;11;03;Keskiviikko;0;0;0
93;16.11.2016;2016;11;04;Keskiviikko;0;0;0
93;16.11.2016;2016;11;05;Keskiviikko;0;0;0
93;16.11.2016;2016;11;06;Keskiviikko;4;3;7
93;16.11.2016;2016;11;07;Keskiviikko;11;12;23
93;16.11.2016;2016;11;08;Keskiviikko;5;16;21
93;16.11.2016;2016;11;09;Keskiviikko;2;1;3
93;16.11.2016;2016;11;10;Keskiviikko;3;2;5
93;16.11.2016;2016;11;11;Keskiviikko;0;2;2
93;16.11.2016;2016;11;12;Keskiviikko;1;0;1
93;16.11.2016;2016;11;13;Keskiviikko;4;1;5
93;16.11.2016;2016;11;14;Keskiviikko;7;1;8
93;16.11.2016;2016;11;15;Keskiviikko;4;6;10
93;16.11.2016;2016;11;16;Keskiviikko;13;9;22
93;16.11.2016;2016;11;17;Keskiviikko;8;6;14
93;16.11.2016;2016;11;18;Keskiviikko;2;4;6
93;16.11.2016;2016;11;19;Keskiviikko;1;5;6
93;16.11.2016;2016;11;20;Keskiviikko;4;1;5
93;16.11.2016;2016;11;21;Keskiviikko;0;3;3
93;16.11.2016;2016;11;22;Keskiviikko;1;2;3
93;16.11.2016;2016;11;23;Keskiviikko;1;0;1
93;17.11.2016;2016;11;00;Torstai;0;0;0
93;17.11.2016;2016;11;01;Torstai;0;0;0
93;17.11.2016;2016;11;02;Torstai;0;0;0
93;17.11.2016;2016;11;03;Torstai;0;0;0
93;17.11.2016;2016;11;04;Torstai;0;0;0
93;17.11.2016;2016;11;05;Torstai;0;0;0
93;17.11.2016;2016;11;06;Torstai;5;2;7
93;17.11.2016;2016;11;07;Torstai;10;11;21
93;17.11.2016;2016;11;08;Torstai;3;10;13
93;17.11.2016;2016;11;09;Torstai;5;1;6
93;17.11.2016;2016;11;10;Torstai;7;0;7
93;17.11.2016;2016;11;11;Torstai;6;2;8
93;17.11.2016;2016;11;12;Torstai;4;5;9
93;17.11.2016;2016;11;13;Torstai;7;7;14
93;17.11.2016;2016;11;14;Torstai;2;5;7
93;17.11.2016;2016;11;15;Torstai;3;6;9
93;17.11.2016;2016;11;16;Torstai;9;10;19
93;17.11.2016;2016;11;17;Torstai;6;3;9
93;17.11.2016;2016;11;18;Torstai;3;3;6
93;17.11.2016;2016;11;19;Torstai;3;3;6
93;17.11.2016;2016;11;20;Torstai;4;4;8
93;17.11.2016;2016;11;21;Torstai;1;3;4
93;17.11.2016;2016;11;22;Torstai;3;1;4
93;17.11.2016;2016;11;23;Torstai;0;1;1
93;18.11.2016;2016;11;00;Perjantai;0;2;2
93;18.11.2016;2016;11;01;Perjantai;0;0;0
93;18.11.2016;2016;11;02;Perjantai;0;0;0
93;18.11.2016;2016;11;03;Perjantai;0;0;0
93;18.11.2016;2016;11;04;Perjantai;0;0;0
93;18.11.2016;2016;11;05;Perjantai;0;0;0
93;18.11.2016;2016;11;06;Perjantai;7;1;8
93;18.11.2016;2016;11;07;Perjantai;6;14;20
93;18.11.2016;2016;11;08;Perjantai;4;11;15
93;18.11.2016;2016;11;09;Perjantai;3;3;6
93;18.11.2016;2016;11;10;Perjantai;4;2;6
93;18.11.2016;2016;11;11;Perjantai;0;1;1
93;18.11.2016;2016;11;12;Perjantai;4;0;4
93;18.11.2016;2016;11;13;Perjantai;0;6;6
93;18.11.2016;2016;11;14;Perjantai;3;4;7
93;18.11.2016;2016;11;15;Perjantai;8;6;14
93;18.11.2016;2016;11;16;Perjantai;11;4;15
93;18.11.2016;2016;11;17;Perjantai;7;4;11
93;18.11.2016;2016;11;18;Perjantai;3;3;6
93;18.11.2016;2016;11;19;Perjantai;2;2;4
93;18.11.2016;2016;11;20;Perjantai;1;1;2
93;18.11.2016;2016;11;21;Perjantai;1;1;2
93;18.11.2016;2016;11;22;Perjantai;0;0;0
93;18.11.2016;2016;11;23;Perjantai;1;0;1
93;19.11.2016;2016;11;00;Lauantai;0;0;0
93;19.11.2016;2016;11;01;Lauantai;0;0;0
93;19.11.2016;2016;11;02;Lauantai;0;0;0
93;19.11.2016;2016;11;03;Lauantai;0;1;1
93;19.11.2016;2016;11;04;Lauantai;0;0;0
93;19.11.2016;2016;11;05;Lauantai;0;0;0
93;19.11.2016;2016;11;06;Lauantai;0;0;0
93;19.11.2016;2016;11;07;Lauantai;0;0;0
93;19.11.2016;2016;11;08;Lauantai;0;1;1
93;19.11.2016;2016;11;09;Lauantai;1;4;5
93;19.11.2016;2016;11;10;Lauantai;1;1;2
93;19.11.2016;2016;11;11;Lauantai;0;2;2
93;19.11.2016;2016;11;12;Lauantai;0;1;1
93;19.11.2016;2016;11;13;Lauantai;1;0;1
93;19.11.2016;2016;11;14;Lauantai;0;0;0
93;19.11.2016;2016;11;15;Lauantai;2;0;2
93;19.11.2016;2016;11;16;Lauantai;2;0;2
93;19.11.2016;2016;11;17;Lauantai;1;6;7
93;19.11.2016;2016;11;18;Lauantai;2;0;2
93;19.11.2016;2016;11;19;Lauantai;0;0;0
93;19.11.2016;2016;11;20;Lauantai;1;0;1
93;19.11.2016;2016;11;21;Lauantai;0;0;0
93;19.11.2016;2016;11;22;Lauantai;0;2;2
93;19.11.2016;2016;11;23;Lauantai;0;0;0
93;20.11.2016;2016;11;00;Sunnuntai;0;0;0
93;20.11.2016;2016;11;01;Sunnuntai;0;0;0
93;20.11.2016;2016;11;02;Sunnuntai;0;1;1
93;20.11.2016;2016;11;03;Sunnuntai;0;0;0
93;20.11.2016;2016;11;04;Sunnuntai;0;0;0
93;20.11.2016;2016;11;05;Sunnuntai;1;0;1
93;20.11.2016;2016;11;06;Sunnuntai;0;0;0
93;20.11.2016;2016;11;07;Sunnuntai;1;0;1
93;20.11.2016;2016;11;08;Sunnuntai;1;0;1
93;20.11.2016;2016;11;09;Sunnuntai;2;4;6
93;20.11.2016;2016;11;10;Sunnuntai;3;3;6
93;20.11.2016;2016;11;11;Sunnuntai;14;3;17
93;20.11.2016;2016;11;12;Sunnuntai;4;6;10
93;20.11.2016;2016;11;13;Sunnuntai;9;10;19
93;20.11.2016;2016;11;14;Sunnuntai;2;9;11
93;20.11.2016;2016;11;15;Sunnuntai;7;3;10
93;20.11.2016;2016;11;16;Sunnuntai;3;1;4
93;20.11.2016;2016;11;17;Sunnuntai;2;1;3
93;20.11.2016;2016;11;18;Sunnuntai;4;3;7
93;20.11.2016;2016;11;19;Sunnuntai;2;3;5
93;20.11.2016;2016;11;20;Sunnuntai;0;0;0
93;20.11.2016;2016;11;21;Sunnuntai;2;1;3
93;20.11.2016;2016;11;22;Sunnuntai;0;0;0
93;20.11.2016;2016;11;23;Sunnuntai;0;0;0
93;21.11.2016;2016;11;00;Maanantai;0;0;0
93;21.11.2016;2016;11;01;Maanantai;0;0;0
93;21.11.2016;2016;11;02;Maanantai;0;1;1
93;21.11.2016;2016;11;03;Maanantai;0;0;0
93;21.11.2016;2016;11;04;Maanantai;0;0;0
93;21.11.2016;2016;11;05;Maanantai;2;2;4
93;21.11.2016;2016;11;06;Maanantai;7;4;11
93;21.11.2016;2016;11;07;Maanantai;13;10;23
93;21.11.2016;2016;11;08;Maanantai;5;10;15
93;21.11.2016;2016;11;09;Maanantai;4;2;6
93;21.11.2016;2016;11;10;Maanantai;8;1;9
93;21.11.2016;2016;11;11;Maanantai;4;6;10
93;21.11.2016;2016;11;12;Maanantai;0;2;2
93;21.11.2016;2016;11;13;Maanantai;5;6;11
93;21.11.2016;2016;11;14;Maanantai;4;4;8
93;21.11.2016;2016;11;15;Maanantai;10;9;19
93;21.11.2016;2016;11;16;Maanantai;12;11;23
93;21.11.2016;2016;11;17;Maanantai;4;4;8
93;21.11.2016;2016;11;18;Maanantai;2;3;5
93;21.11.2016;2016;11;19;Maanantai;0;3;3
93;21.11.2016;2016;11;20;Maanantai;2;3;5
93;21.11.2016;2016;11;21;Maanantai;2;2;4
93;21.11.2016;2016;11;22;Maanantai;0;0;0
93;21.11.2016;2016;11;23;Maanantai;0;0;0
93;22.11.2016;2016;11;00;Tiistai;0;0;0
93;22.11.2016;2016;11;01;Tiistai;0;0;0
93;22.11.2016;2016;11;02;Tiistai;0;0;0
93;22.11.2016;2016;11;03;Tiistai;0;0;0
93;22.11.2016;2016;11;04;Tiistai;0;0;0
93;22.11.2016;2016;11;05;Tiistai;2;2;4
93;22.11.2016;2016;11;06;Tiistai;5;4;9
93;22.11.2016;2016;11;07;Tiistai;9;14;23
93;22.11.2016;2016;11;08;Tiistai;7;9;16
93;22.11.2016;2016;11;09;Tiistai;8;4;12
93;22.11.2016;2016;11;10;Tiistai;11;1;12
93;22.11.2016;2016;11;11;Tiistai;3;6;9
93;22.11.2016;2016;11;12;Tiistai;5;3;8
93;22.11.2016;2016;11;13;Tiistai;6;5;11
93;22.11.2016;2016;11;14;Tiistai;5;8;13
93;22.11.2016;2016;11;15;Tiistai;8;7;15
93;22.11.2016;2016;11;16;Tiistai;12;12;24
93;22.11.2016;2016;11;17;Tiistai;13;8;21
93;22.11.2016;2016;11;18;Tiistai;8;10;18
93;22.11.2016;2016;11;19;Tiistai;1;2;3
93;22.11.2016;2016;11;20;Tiistai;1;0;1
93;22.11.2016;2016;11;21;Tiistai;1;2;3
93;22.11.2016;2016;11;22;Tiistai;1;1;2
93;22.11.2016;2016;11;23;Tiistai;0;0;0
93;23.11.2016;2016;11;00;Keskiviikko;0;1;1
93;23.11.2016;2016;11;01;Keskiviikko;0;0;0
93;23.11.2016;2016;11;02;Keskiviikko;0;0;0
93;23.11.2016;2016;11;03;Keskiviikko;0;0;0
93;23.11.2016;2016;11;04;Keskiviikko;0;0;0
93;23.11.2016;2016;11;05;Keskiviikko;2;2;4
93;23.11.2016;2016;11;06;Keskiviikko;4;4;8
93;23.11.2016;2016;11;07;Keskiviikko;7;9;16
93;23.11.2016;2016;11;08;Keskiviikko;6;12;18
93;23.11.2016;2016;11;09;Keskiviikko;3;2;5
93;23.11.2016;2016;11;10;Keskiviikko;2;1;3
93;23.11.2016;2016;11;11;Keskiviikko;2;1;3
93;23.11.2016;2016;11;12;Keskiviikko;2;2;4
93;23.11.2016;2016;11;13;Keskiviikko;4;4;8
93;23.11.2016;2016;11;14;Keskiviikko;4;3;7
93;23.11.2016;2016;11;15;Keskiviikko;5;10;15
93;23.11.2016;2016;11;16;Keskiviikko;8;10;18
93;23.11.2016;2016;11;17;Keskiviikko;12;3;15
93;23.11.2016;2016;11;18;Keskiviikko;0;3;3
93;23.11.2016;2016;11;19;Keskiviikko;1;3;4
93;23.11.2016;2016;11;20;Keskiviikko;1;1;2
93;23.11.2016;2016;11;21;Keskiviikko;0;2;2
93;23.11.2016;2016;11;22;Keskiviikko;1;0;1
93;23.11.2016;2016;11;23;Keskiviikko;1;1;2
93;24.11.2016;2016;11;00;Torstai;0;0;0
93;24.11.2016;2016;11;01;Torstai;1;1;2
93;24.11.2016;2016;11;02;Torstai;0;1;1
93;24.11.2016;2016;11;03;Torstai;0;0;0
93;24.11.2016;2016;11;04;Torstai;0;1;1
93;24.11.2016;2016;11;05;Torstai;1;2;3
93;24.11.2016;2016;11;06;Torstai;6;6;12
93;24.11.2016;2016;11;07;Torstai;12;9;21
93;24.11.2016;2016;11;08;Torstai;4;13;17
93;24.11.2016;2016;11;09;Torstai;2;1;3
93;24.11.2016;2016;11;10;Torstai;4;6;10
93;24.11.2016;2016;11;11;Torstai;4;2;6
93;24.11.2016;2016;11;12;Torstai;4;2;6
93;24.11.2016;2016;11;13;Torstai;6;2;8
93;24.11.2016;2016;11;14;Torstai;6;4;10
93;24.11.2016;2016;11;15;Torstai;6;7;13
93;24.11.2016;2016;11;16;Torstai;10;14;24
93;24.11.2016;2016;11;17;Torstai;11;8;19
93;24.11.2016;2016;11;18;Torstai;5;4;9
93;24.11.2016;2016;11;19;Torstai;3;2;5
93;24.11.2016;2016;11;20;Torstai;2;2;4
93;24.11.2016;2016;11;21;Torstai;1;2;3
93;24.11.2016;2016;11;22;Torstai;1;0;1
93;24.11.2016;2016;11;23;Torstai;0;0;0
93;25.11.2016;2016;11;00;Perjantai;0;1;1
93;25.11.2016;2016;11;01;Perjantai;0;0;0
93;25.11.2016;2016;11;02;Perjantai;0;0;0
93;25.11.2016;2016;11;03;Perjantai;0;0;0
93;25.11.2016;2016;11;04;Perjantai;0;0;0
93;25.11.2016;2016;11;05;Perjantai;1;3;4
93;25.11.2016;2016;11;06;Perjantai;4;5;9
93;25.11.2016;2016;11;07;Perjantai;6;11;17
93;25.11.2016;2016;11;08;Perjantai;2;9;11
93;25.11.2016;2016;11;09;Perjantai;2;3;5
93;25.11.2016;2016;11;10;Perjantai;3;1;4
93;25.11.2016;2016;11;11;Perjantai;3;1;4
93;25.11.2016;2016;11;12;Perjantai;4;5;9
93;25.11.2016;2016;11;13;Perjantai;4;1;5
93;25.11.2016;2016;11;14;Perjantai;7;1;8
93;25.11.2016;2016;11;15;Perjantai;8;4;12
93;25.11.2016;2016;11;16;Perjantai;9;8;17
93;25.11.2016;2016;11;17;Perjantai;2;3;5
93;25.11.2016;2016;11;18;Perjantai;6;4;10
93;25.11.2016;2016;11;19;Perjantai;1;2;3
93;25.11.2016;2016;11;20;Perjantai;1;0;1
93;25.11.2016;2016;11;21;Perjantai;1;2;3
93;25.11.2016;2016;11;22;Perjantai;0;3;3
93;25.11.2016;2016;11;23;Perjantai;0;0;0
93;26.11.2016;2016;11;00;Lauantai;0;2;2
93;26.11.2016;2016;11;01;Lauantai;0;1;1
93;26.11.2016;2016;11;02;Lauantai;0;1;1
93;26.11.2016;2016;11;03;Lauantai;0;0;0
93;26.11.2016;2016;11;04;Lauantai;0;0;0
93;26.11.2016;2016;11;05;Lauantai;0;0;0
93;26.11.2016;2016;11;06;Lauantai;0;0;0
93;26.11.2016;2016;11;07;Lauantai;0;0;0
93;26.11.2016;2016;11;08;Lauantai;0;0;0
93;26.11.2016;2016;11;09;Lauantai;2;0;2
93;26.11.2016;2016;11;10;Lauantai;2;1;3
93;26.11.2016;2016;11;11;Lauantai;1;0;1
93;26.11.2016;2016;11;12;Lauantai;0;0;0
93;26.11.2016;2016;11;13;Lauantai;4;3;7
93;26.11.2016;2016;11;14;Lauantai;3;0;3
93;26.11.2016;2016;11;15;Lauantai;3;3;6
93;26.11.2016;2016;11;16;Lauantai;0;1;1
93;26.11.2016;2016;11;17;Lauantai;1;6;7
93;26.11.2016;2016;11;18;Lauantai;2;0;2
93;26.11.2016;2016;11;19;Lauantai;2;2;4
93;26.11.2016;2016;11;20;Lauantai;2;1;3
93;26.11.2016;2016;11;21;Lauantai;0;0;0
93;26.11.2016;2016;11;22;Lauantai;0;1;1
93;26.11.2016;2016;11;23;Lauantai;0;1;1
93;27.11.2016;2016;11;00;Sunnuntai;1;0;1
93;27.11.2016;2016;11;01;Sunnuntai;0;0;0
93;27.11.2016;2016;11;02;Sunnuntai;0;0;0
93;27.11.2016;2016;11;03;Sunnuntai;0;0;0
93;27.11.2016;2016;11;04;Sunnuntai;0;0;0
93;27.11.2016;2016;11;05;Sunnuntai;1;0;1
93;27.11.2016;2016;11;06;Sunnuntai;0;0;0
93;27.11.2016;2016;11;07;Sunnuntai;0;0;0
93;27.11.2016;2016;11;08;Sunnuntai;1;0;1
93;27.11.2016;2016;11;09;Sunnuntai;1;1;2
93;27.11.2016;2016;11;10;Sunnuntai;2;2;4
93;27.11.2016;2016;11;11;Sunnuntai;2;1;3
93;27.11.2016;2016;11;12;Sunnuntai;1;2;3
93;27.11.2016;2016;11;13;Sunnuntai;2;2;4
93;27.11.2016;2016;11;14;Sunnuntai;1;1;2
93;27.11.2016;2016;11;15;Sunnuntai;2;2;4
93;27.11.2016;2016;11;16;Sunnuntai;2;2;4
93;27.11.2016;2016;11;17;Sunnuntai;1;1;2
93;27.11.2016;2016;11;18;Sunnuntai;0;1;1
93;27.11.2016;2016;11;19;Sunnuntai;1;1;2
93;27.11.2016;2016;11;20;Sunnuntai;0;0;0
93;27.11.2016;2016;11;21;Sunnuntai;0;1;1
93;27.11.2016;2016;11;22;Sunnuntai;0;0;0
93;27.11.2016;2016;11;23;Sunnuntai;0;0;0
93;28.11.2016;2016;11;00;Maanantai;0;0;0
93;28.11.2016;2016;11;01;Maanantai;0;0;0
93;28.11.2016;2016;11;02;Maanantai;0;0;0
93;28.11.2016;2016;11;03;Maanantai;0;0;0
93;28.11.2016;2016;11;04;Maanantai;0;0;0
93;28.11.2016;2016;11;05;Maanantai;1;0;1
93;28.11.2016;2016;11;06;Maanantai;10;4;14
93;28.11.2016;2016;11;07;Maanantai;11;13;24
93;28.11.2016;2016;11;08;Maanantai;2;12;14
93;28.11.2016;2016;11;09;Maanantai;6;3;9
93;28.11.2016;2016;11;10;Maanantai;2;2;4
93;28.11.2016;2016;11;11;Maanantai;3;1;4
93;28.11.2016;2016;11;12;Maanantai;2;4;6
93;28.11.2016;2016;11;13;Maanantai;2;2;4
93;28.11.2016;2016;11;14;Maanantai;0;4;4
93;28.11.2016;2016;11;15;Maanantai;9;8;17
93;28.11.2016;2016;11;16;Maanantai;14;10;24
93;28.11.2016;2016;11;17;Maanantai;14;6;20
93;28.11.2016;2016;11;18;Maanantai;4;5;9
93;28.11.2016;2016;11;19;Maanantai;2;4;6
93;28.11.2016;2016;11;20;Maanantai;1;1;2
93;28.11.2016;2016;11;21;Maanantai;0;1;1
93;28.11.2016;2016;11;22;Maanantai;0;1;1
93;28.11.2016;2016;11;23;Maanantai;0;0;0
93;29.11.2016;2016;11;00;Tiistai;1;0;1
93;29.11.2016;2016;11;01;Tiistai;0;0;0
93;29.11.2016;2016;11;02;Tiistai;0;0;0
93;29.11.2016;2016;11;03;Tiistai;0;0;0
93;29.11.2016;2016;11;04;Tiistai;0;0;0
93;29.11.2016;2016;11;05;Tiistai;2;0;2
93;29.11.2016;2016;11;06;Tiistai;11;4;15
93;29.11.2016;2016;11;07;Tiistai;10;13;23
93;29.11.2016;2016;11;08;Tiistai;3;9;12
93;29.11.2016;2016;11;09;Tiistai;4;2;6
93;29.11.2016;2016;11;10;Tiistai;2;3;5
93;29.11.2016;2016;11;11;Tiistai;2;3;5
93;29.11.2016;2016;11;12;Tiistai;4;2;6
93;29.11.2016;2016;11;13;Tiistai;2;1;3
93;29.11.2016;2016;11;14;Tiistai;3;2;5
93;29.11.2016;2016;11;15;Tiistai;7;13;20
93;29.11.2016;2016;11;16;Tiistai;13;10;23
93;29.11.2016;2016;11;17;Tiistai;8;4;12
93;29.11.2016;2016;11;18;Tiistai;1;4;5
93;29.11.2016;2016;11;19;Tiistai;2;2;4
93;29.11.2016;2016;11;20;Tiistai;1;3;4
93;29.11.2016;2016;11;21;Tiistai;0;0;0
93;29.11.2016;2016;11;22;Tiistai;0;1;1
93;29.11.2016;2016;11;23;Tiistai;0;0;0
93;30.11.2016;2016;11;00;Keskiviikko;1;0;1
93;30.11.2016;2016;11;01;Keskiviikko;0;0;0
93;30.11.2016;2016;11;02;Keskiviikko;0;0;0
93;30.11.2016;2016;11;03;Keskiviikko;0;0;0
93;30.11.2016;2016;11;04;Keskiviikko;2;0;2
93;30.11.2016;2016;11;05;Keskiviikko;2;0;2
93;30.11.2016;2016;11;06;Keskiviikko;5;6;11
93;30.11.2016;2016;11;07;Keskiviikko;10;8;18
93;30.11.2016;2016;11;08;Keskiviikko;6;14;20
93;30.11.2016;2016;11;09;Keskiviikko;2;1;3
93;30.11.2016;2016;11;10;Keskiviikko;3;3;6
93;30.11.2016;2016;11;11;Keskiviikko;1;4;5
93;30.11.2016;2016;11;12;Keskiviikko;2;1;3
93;30.11.2016;2016;11;13;Keskiviikko;4;2;6
93;30.11.2016;2016;11;14;Keskiviikko;3;4;7
93;30.11.2016;2016;11;15;Keskiviikko;12;8;20
93;30.11.2016;2016;11;16;Keskiviikko;7;8;15
93;30.11.2016;2016;11;17;Keskiviikko;7;3;10
93;30.11.2016;2016;11;18;Keskiviikko;4;1;5
93;30.11.2016;2016;11;19;Keskiviikko;6;1;7
93;30.11.2016;2016;11;20;Keskiviikko;0;2;2
93;30.11.2016;2016;11;21;Keskiviikko;0;0;0
93;30.11.2016;2016;11;22;Keskiviikko;2;1;3
93;30.11.2016;2016;11;23;Keskiviikko;0;1;1
93;01.12.2016;2016;12;00;Torstai;0;1;1
93;01.12.2016;2016;12;01;Torstai;0;1;1
93;01.12.2016;2016;12;02;Torstai;0;0;0
93;01.12.2016;2016;12;03;Torstai;0;0;0
93;01.12.2016;2016;12;04;Torstai;0;0;0
93;01.12.2016;2016;12;05;Torstai;2;0;2
93;01.12.2016;2016;12;06;Torstai;6;4;10
93;01.12.2016;2016;12;07;Torstai;6;9;15
93;01.12.2016;2016;12;08;Torstai;3;13;16
93;01.12.2016;2016;12;09;Torstai;3;1;4
93;01.12.2016;2016;12;10;Torstai;5;0;5
93;01.12.2016;2016;12;11;Torstai;4;3;7
93;01.12.2016;2016;12;12;Torstai;1;2;3
93;01.12.2016;2016;12;13;Torstai;5;3;8
93;01.12.2016;2016;12;14;Torstai;3;2;5
93;01.12.2016;2016;12;15;Torstai;14;11;25
93;01.12.2016;2016;12;16;Torstai;11;6;17
93;01.12.2016;2016;12;17;Torstai;3;3;6
93;01.12.2016;2016;12;18;Torstai;3;4;7
93;01.12.2016;2016;12;19;Torstai;2;5;7
93;01.12.2016;2016;12;20;Torstai;2;1;3
93;01.12.2016;2016;12;21;Torstai;0;2;2
93;01.12.2016;2016;12;22;Torstai;1;0;1
93;01.12.2016;2016;12;23;Torstai;0;0;0
93;02.12.2016;2016;12;00;Perjantai;0;1;1
93;02.12.2016;2016;12;01;Perjantai;0;0;0
93;02.12.2016;2016;12;02;Perjantai;0;0;0
93;02.12.2016;2016;12;03;Perjantai;0;0;0
93;02.12.2016;2016;12;04;Perjantai;0;0;0
93;02.12.2016;2016;12;05;Perjantai;1;0;1
93;02.12.2016;2016;12;06;Perjantai;8;4;12
93;02.12.2016;2016;12;07;Perjantai;2;11;13
93;02.12.2016;2016;12;08;Perjantai;0;10;10
93;02.12.2016;2016;12;09;Perjantai;4;1;5
93;02.12.2016;2016;12;10;Perjantai;4;0;4
93;02.12.2016;2016;12;11;Perjantai;0;1;1
93;02.12.2016;2016;12;12;Perjantai;5;4;9
93;02.12.2016;2016;12;13;Perjantai;1;4;5
93;02.12.2016;2016;12;14;Perjantai;1;1;2
93;02.12.2016;2016;12;15;Perjantai;13;9;22
93;02.12.2016;2016;12;16;Perjantai;12;1;13
93;02.12.2016;2016;12;17;Perjantai;5;4;9
93;02.12.2016;2016;12;18;Perjantai;1;1;2
93;02.12.2016;2016;12;19;Perjantai;1;5;6
93;02.12.2016;2016;12;20;Perjantai;3;1;4
93;02.12.2016;2016;12;21;Perjantai;0;2;2
93;02.12.2016;2016;12;22;Perjantai;0;1;1
93;02.12.2016;2016;12;23;Perjantai;0;0;0
93;03.12.2016;2016;12;00;Lauantai;0;0;0
93;03.12.2016;2016;12;01;Lauantai;0;0;0
93;03.12.2016;2016;12;02;Lauantai;0;1;1
93;03.12.2016;2016;12;03;Lauantai;0;1;1
93;03.12.2016;2016;12;04;Lauantai;0;0;0
93;03.12.2016;2016;12;05;Lauantai;1;0;1
93;03.12.2016;2016;12;06;Lauantai;0;0;0
93;03.12.2016;2016;12;07;Lauantai;0;0;0
93;03.12.2016;2016;12;08;Lauantai;0;0;0
93;03.12.2016;2016;12;09;Lauantai;0;0;0
93;03.12.2016;2016;12;10;Lauantai;1;1;2
93;03.12.2016;2016;12;11;Lauantai;1;0;1
93;03.12.2016;2016;12;12;Lauantai;2;0;2
93;03.12.2016;2016;12;13;Lauantai;7;1;8
93;03.12.2016;2016;12;14;Lauantai;0;4;4
93;03.12.2016;2016;12;15;Lauantai;1;2;3
93;03.12.2016;2016;12;16;Lauantai;0;1;1
93;03.12.2016;2016;12;17;Lauantai;0;1;1
93;03.12.2016;2016;12;18;Lauantai;2;2;4
93;03.12.2016;2016;12;19;Lauantai;0;1;1
93;03.12.2016;2016;12;20;Lauantai;0;2;2
93;03.12.2016;2016;12;21;Lauantai;0;0;0
93;03.12.2016;2016;12;22;Lauantai;0;0;0
93;03.12.2016;2016;12;23;Lauantai;1;0;1
93;04.12.2016;2016;12;00;Sunnuntai;0;0;0
93;04.12.2016;2016;12;01;Sunnuntai;0;0;0
93;04.12.2016;2016;12;02;Sunnuntai;0;0;0
93;04.12.2016;2016;12;03;Sunnuntai;0;0;0
93;04.12.2016;2016;12;04;Sunnuntai;0;0;0
93;04.12.2016;2016;12;05;Sunnuntai;0;0;0
93;04.12.2016;2016;12;06;Sunnuntai;0;0;0
93;04.12.2016;2016;12;07;Sunnuntai;0;0;0
93;04.12.2016;2016;12;08;Sunnuntai;0;0;0
93;04.12.2016;2016;12;09;Sunnuntai;1;0;1
93;04.12.2016;2016;12;10;Sunnuntai;6;1;7
93;04.12.2016;2016;12;11;Sunnuntai;2;2;4
93;04.12.2016;2016;12;12;Sunnuntai;2;0;2
93;04.12.2016;2016;12;13;Sunnuntai;0;4;4
93;04.12.2016;2016;12;14;Sunnuntai;0;3;3
93;04.12.2016;2016;12;15;Sunnuntai;0;0;0
93;04.12.2016;2016;12;16;Sunnuntai;0;1;1
93;04.12.2016;2016;12;17;Sunnuntai;0;0;0
93;04.12.2016;2016;12;18;Sunnuntai;1;0;1
93;04.12.2016;2016;12;19;Sunnuntai;0;0;0
93;04.12.2016;2016;12;20;Sunnuntai;0;0;0
93;04.12.2016;2016;12;21;Sunnuntai;1;0;1
93;04.12.2016;2016;12;22;Sunnuntai;1;0;1
93;04.12.2016;2016;12;23;Sunnuntai;0;0;0
93;05.12.2016;2016;12;00;Maanantai;0;0;0
93;05.12.2016;2016;12;01;Maanantai;0;0;0
93;05.12.2016;2016;12;02;Maanantai;0;0;0
93;05.12.2016;2016;12;03;Maanantai;0;0;0
93;05.12.2016;2016;12;04;Maanantai;1;0;1
93;05.12.2016;2016;12;05;Maanantai;2;2;4
93;05.12.2016;2016;12;06;Maanantai;2;0;2
93;05.12.2016;2016;12;07;Maanantai;3;2;5
93;05.12.2016;2016;12;08;Maanantai;1;8;9
93;05.12.2016;2016;12;09;Maanantai;3;0;3
93;05.12.2016;2016;12;10;Maanantai;2;1;3
93;05.12.2016;2016;12;11;Maanantai;4;1;5
93;05.12.2016;2016;12;12;Maanantai;1;4;5
93;05.12.2016;2016;12;13;Maanantai;0;2;2
93;05.12.2016;2016;12;14;Maanantai;5;3;8
93;05.12.2016;2016;12;15;Maanantai;1;3;4
93;05.12.2016;2016;12;16;Maanantai;5;1;6
93;05.12.2016;2016;12;17;Maanantai;5;4;9
93;05.12.2016;2016;12;18;Maanantai;1;1;2
93;05.12.2016;2016;12;19;Maanantai;1;1;2
93;05.12.2016;2016;12;20;Maanantai;1;1;2
93;05.12.2016;2016;12;21;Maanantai;1;1;2
93;05.12.2016;2016;12;22;Maanantai;0;0;0
93;05.12.2016;2016;12;23;Maanantai;0;1;1
93;06.12.2016;2016;12;00;Tiistai;0;0;0
93;06.12.2016;2016;12;01;Tiistai;0;0;0
93;06.12.2016;2016;12;02;Tiistai;0;0;0
93;06.12.2016;2016;12;03;Tiistai;0;0;0
93;06.12.2016;2016;12;04;Tiistai;0;0;0
93;06.12.2016;2016;12;05;Tiistai;1;0;1
93;06.12.2016;2016;12;06;Tiistai;0;0;0
93;06.12.2016;2016;12;07;Tiistai;0;0;0
93;06.12.2016;2016;12;08;Tiistai;0;1;1
93;06.12.2016;2016;12;09;Tiistai;0;0;0
93;06.12.2016;2016;12;10;Tiistai;0;0;0
93;06.12.2016;2016;12;11;Tiistai;1;0;1
93;06.12.2016;2016;12;12;Tiistai;0;0;0
93;06.12.2016;2016;12;13;Tiistai;0;1;1
93;06.12.2016;2016;12;14;Tiistai;0;2;2
93;06.12.2016;2016;12;15;Tiistai;0;0;0
93;06.12.2016;2016;12;16;Tiistai;0;0;0
93;06.12.2016;2016;12;17;Tiistai;0;0;0
93;06.12.2016;2016;12;18;Tiistai;0;1;1
93;06.12.2016;2016;12;19;Tiistai;0;0;0
93;06.12.2016;2016;12;20;Tiistai;0;0;0
93;06.12.2016;2016;12;21;Tiistai;1;2;3
93;06.12.2016;2016;12;22;Tiistai;1;0;1
93;06.12.2016;2016;12;23;Tiistai;0;0;0
93;07.12.2016;2016;12;00;Keskiviikko;0;1;1
93;07.12.2016;2016;12;01;Keskiviikko;0;0;0
93;07.12.2016;2016;12;02;Keskiviikko;0;0;0
93;07.12.2016;2016;12;03;Keskiviikko;0;0;0
93;07.12.2016;2016;12;04;Keskiviikko;0;0;0
93;07.12.2016;2016;12;05;Keskiviikko;3;0;3
93;07.12.2016;2016;12;06;Keskiviikko;4;1;5
93;07.12.2016;2016;12;07;Keskiviikko;12;12;24
93;07.12.2016;2016;12;08;Keskiviikko;2;10;12
93;07.12.2016;2016;12;09;Keskiviikko;3;2;5
93;07.12.2016;2016;12;10;Keskiviikko;5;3;8
93;07.12.2016;2016;12;11;Keskiviikko;2;2;4
93;07.12.2016;2016;12;12;Keskiviikko;2;2;4
93;07.12.2016;2016;12;13;Keskiviikko;4;1;5
93;07.12.2016;2016;12;14;Keskiviikko;1;3;4
93;07.12.2016;2016;12;15;Keskiviikko;8;6;14
93;07.12.2016;2016;12;16;Keskiviikko;11;11;22
93;07.12.2016;2016;12;17;Keskiviikko;10;6;16
93;07.12.2016;2016;12;18;Keskiviikko;2;3;5
93;07.12.2016;2016;12;19;Keskiviikko;5;8;13
93;07.12.2016;2016;12;20;Keskiviikko;2;4;6
93;07.12.2016;2016;12;21;Keskiviikko;1;0;1
93;07.12.2016;2016;12;22;Keskiviikko;0;0;0
93;07.12.2016;2016;12;23;Keskiviikko;0;0;0
93;08.12.2016;2016;12;00;Torstai;0;0;0
93;08.12.2016;2016;12;01;Torstai;0;0;0
93;08.12.2016;2016;12;02;Torstai;0;0;0
93;08.12.2016;2016;12;03;Torstai;0;0;0
93;08.12.2016;2016;12;04;Torstai;0;1;1
93;08.12.2016;2016;12;05;Torstai;3;1;4
93;08.12.2016;2016;12;06;Torstai;10;5;15
93;08.12.2016;2016;12;07;Torstai;14;10;24
93;08.12.2016;2016;12;08;Torstai;5;14;19
93;08.12.2016;2016;12;09;Torstai;2;3;5
93;08.12.2016;2016;12;10;Torstai;2;2;4
93;08.12.2016;2016;12;11;Torstai;2;1;3
93;08.12.2016;2016;12;12;Torstai;3;1;4
93;08.12.2016;2016;12;13;Torstai;4;1;5
93;08.12.2016;2016;12;14;Torstai;1;9;10
93;08.12.2016;2016;12;15;Torstai;7;15;22
93;08.12.2016;2016;12;16;Torstai;14;3;17
93;08.12.2016;2016;12;17;Torstai;9;5;14
93;08.12.2016;2016;12;18;Torstai;2;2;4
93;08.12.2016;2016;12;19;Torstai;4;5;9
93;08.12.2016;2016;12;20;Torstai;2;1;3
93;08.12.2016;2016;12;21;Torstai;1;3;4
93;08.12.2016;2016;12;22;Torstai;2;0;2
93;08.12.2016;2016;12;23;Torstai;0;0;0
93;09.12.2016;2016;12;00;Perjantai;0;0;0
93;09.12.2016;2016;12;01;Perjantai;0;0;0
93;09.12.2016;2016;12;02;Perjantai;0;0;0
93;09.12.2016;2016;12;03;Perjantai;0;0;0
93;09.12.2016;2016;12;04;Perjantai;0;0;0
93;09.12.2016;2016;12;05;Perjantai;3;2;5
93;09.12.2016;2016;12;06;Perjantai;7;5;12
93;09.12.2016;2016;12;07;Perjantai;6;13;19
93;09.12.2016;2016;12;08;Perjantai;3;15;18
93;09.12.2016;2016;12;09;Perjantai;2;2;4
93;09.12.2016;2016;12;10;Perjantai;2;2;4
93;09.12.2016;2016;12;11;Perjantai;5;2;7
93;09.12.2016;2016;12;12;Perjantai;1;4;5
93;09.12.2016;2016;12;13;Perjantai;4;4;8
93;09.12.2016;2016;12;14;Perjantai;4;3;7
93;09.12.2016;2016;12;15;Perjantai;6;8;14
93;09.12.2016;2016;12;16;Perjantai;21;8;29
93;09.12.2016;2016;12;17;Perjantai;2;3;5
93;09.12.2016;2016;12;18;Perjantai;2;1;3
93;09.12.2016;2016;12;19;Perjantai;2;0;2
93;09.12.2016;2016;12;20;Perjantai;2;1;3
93;09.12.2016;2016;12;21;Perjantai;1;2;3
93;09.12.2016;2016;12;22;Perjantai;1;1;2
93;09.12.2016;2016;12;23;Perjantai;0;0;0
93;10.12.2016;2016;12;00;Lauantai;1;1;2
93;10.12.2016;2016;12;01;Lauantai;0;0;0
93;10.12.2016;2016;12;02;Lauantai;0;0;0
93;10.12.2016;2016;12;03;Lauantai;0;0;0
93;10.12.2016;2016;12;04;Lauantai;0;1;1
93;10.12.2016;2016;12;05;Lauantai;0;1;1
93;10.12.2016;2016;12;06;Lauantai;0;0;0
93;10.12.2016;2016;12;07;Lauantai;1;1;2
93;10.12.2016;2016;12;08;Lauantai;0;0;0
93;10.12.2016;2016;12;09;Lauantai;0;1;1
93;10.12.2016;2016;12;10;Lauantai;1;1;2
93;10.12.2016;2016;12;11;Lauantai;0;0;0
93;10.12.2016;2016;12;12;Lauantai;4;0;4
93;10.12.2016;2016;12;13;Lauantai;0;1;1
93;10.12.2016;2016;12;14;Lauantai;3;2;5
93;10.12.2016;2016;12;15;Lauantai;0;2;2
93;10.12.2016;2016;12;16;Lauantai;1;1;2
93;10.12.2016;2016;12;17;Lauantai;2;3;5
93;10.12.2016;2016;12;18;Lauantai;3;2;5
93;10.12.2016;2016;12;19;Lauantai;0;5;5
93;10.12.2016;2016;12;20;Lauantai;0;0;0
93;10.12.2016;2016;12;21;Lauantai;0;0;0
93;10.12.2016;2016;12;22;Lauantai;0;0;0
93;10.12.2016;2016;12;23;Lauantai;0;0;0
93;11.12.2016;2016;12;00;Sunnuntai;0;0;0
93;11.12.2016;2016;12;01;Sunnuntai;0;0;0
93;11.12.2016;2016;12;02;Sunnuntai;0;0;0
93;11.12.2016;2016;12;03;Sunnuntai;1;0;1
93;11.12.2016;2016;12;04;Sunnuntai;0;0;0
93;11.12.2016;2016;12;05;Sunnuntai;0;0;0
93;11.12.2016;2016;12;06;Sunnuntai;0;0;0
93;11.12.2016;2016;12;07;Sunnuntai;0;0;0
93;11.12.2016;2016;12;08;Sunnuntai;0;0;0
93;11.12.2016;2016;12;09;Sunnuntai;0;0;0
93;11.12.2016;2016;12;10;Sunnuntai;0;0;0
93;11.12.2016;2016;12;11;Sunnuntai;1;1;2
93;11.12.2016;2016;12;12;Sunnuntai;2;2;4
93;11.12.2016;2016;12;13;Sunnuntai;0;4;4
93;11.12.2016;2016;12;14;Sunnuntai;1;3;4
93;11.12.2016;2016;12;15;Sunnuntai;2;1;3
93;11.12.2016;2016;12;16;Sunnuntai;1;1;2
93;11.12.2016;2016;12;17;Sunnuntai;1;0;1
93;11.12.2016;2016;12;18;Sunnuntai;0;1;1
93;11.12.2016;2016;12;19;Sunnuntai;0;0;0
93;11.12.2016;2016;12;20;Sunnuntai;0;1;1
93;11.12.2016;2016;12;21;Sunnuntai;0;0;0
93;11.12.2016;2016;12;22;Sunnuntai;0;1;1
93;11.12.2016;2016;12;23;Sunnuntai;0;0;0
93;12.12.2016;2016;12;00;Maanantai;0;0;0
93;12.12.2016;2016;12;01;Maanantai;0;0;0
93;12.12.2016;2016;12;02;Maanantai;0;0;0
93;12.12.2016;2016;12;03;Maanantai;0;0;0
93;12.12.2016;2016;12;04;Maanantai;0;1;1
93;12.12.2016;2016;12;05;Maanantai;1;0;1
93;12.12.2016;2016;12;06;Maanantai;4;4;8
93;12.12.2016;2016;12;07;Maanantai;10;10;20
93;12.12.2016;2016;12;08;Maanantai;1;10;11
93;12.12.2016;2016;12;09;Maanantai;4;0;4
93;12.12.2016;2016;12;10;Maanantai;1;0;1
93;12.12.2016;2016;12;11;Maanantai;1;1;2
93;12.12.2016;2016;12;12;Maanantai;0;0;0
93;12.12.2016;2016;12;13;Maanantai;3;3;6
93;12.12.2016;2016;12;14;Maanantai;3;2;5
93;12.12.2016;2016;12;15;Maanantai;4;5;9
93;12.12.2016;2016;12;16;Maanantai;11;8;19
93;12.12.2016;2016;12;17;Maanantai;4;3;7
93;12.12.2016;2016;12;18;Maanantai;0;1;1
93;12.12.2016;2016;12;19;Maanantai;0;1;1
93;12.12.2016;2016;12;20;Maanantai;1;0;1
93;12.12.2016;2016;12;21;Maanantai;1;1;2
93;12.12.2016;2016;12;22;Maanantai;0;0;0
93;12.12.2016;2016;12;23;Maanantai;0;0;0
93;13.12.2016;2016;12;00;Tiistai;0;0;0
93;13.12.2016;2016;12;01;Tiistai;0;0;0
93;13.12.2016;2016;12;02;Tiistai;0;0;0
93;13.12.2016;2016;12;03;Tiistai;0;0;0
93;13.12.2016;2016;12;04;Tiistai;0;0;0
93;13.12.2016;2016;12;05;Tiistai;1;0;1
93;13.12.2016;2016;12;06;Tiistai;4;5;9
93;13.12.2016;2016;12;07;Tiistai;4;5;9
93;13.12.2016;2016;12;08;Tiistai;2;10;12
93;13.12.2016;2016;12;09;Tiistai;2;3;5
93;13.12.2016;2016;12;10;Tiistai;3;1;4
93;13.12.2016;2016;12;11;Tiistai;2;2;4
93;13.12.2016;2016;12;12;Tiistai;2;1;3
93;13.12.2016;2016;12;13;Tiistai;4;2;6
93;13.12.2016;2016;12;14;Tiistai;1;5;6
93;13.12.2016;2016;12;15;Tiistai;7;10;17
93;13.12.2016;2016;12;16;Tiistai;11;2;13
93;13.12.2016;2016;12;17;Tiistai;11;1;12
93;13.12.2016;2016;12;18;Tiistai;0;4;4
93;13.12.2016;2016;12;19;Tiistai;4;7;11
93;13.12.2016;2016;12;20;Tiistai;3;1;4
93;13.12.2016;2016;12;21;Tiistai;3;0;3
93;13.12.2016;2016;12;22;Tiistai;1;2;3
93;13.12.2016;2016;12;23;Tiistai;0;0;0
93;14.12.2016;2016;12;00;Keskiviikko;0;0;0
93;14.12.2016;2016;12;01;Keskiviikko;0;0;0
93;14.12.2016;2016;12;02;Keskiviikko;0;0;0
93;14.12.2016;2016;12;03;Keskiviikko;0;0;0
93;14.12.2016;2016;12;04;Keskiviikko;0;0;0
93;14.12.2016;2016;12;05;Keskiviikko;1;0;1
93;14.12.2016;2016;12;06;Keskiviikko;5;8;13
93;14.12.2016;2016;12;07;Keskiviikko;12;7;19
93;14.12.2016;2016;12;08;Keskiviikko;1;11;12
93;14.12.2016;2016;12;09;Keskiviikko;4;1;5
93;14.12.2016;2016;12;10;Keskiviikko;1;5;6
93;14.12.2016;2016;12;11;Keskiviikko;1;2;3
93;14.12.2016;2016;12;12;Keskiviikko;1;0;1
93;14.12.2016;2016;12;13;Keskiviikko;2;1;3
93;14.12.2016;2016;12;14;Keskiviikko;5;2;7
93;14.12.2016;2016;12;15;Keskiviikko;9;5;14
93;14.12.2016;2016;12;16;Keskiviikko;12;9;21
93;14.12.2016;2016;12;17;Keskiviikko;8;5;13
93;14.12.2016;2016;12;18;Keskiviikko;3;4;7
93;14.12.2016;2016;12;19;Keskiviikko;3;4;7
93;14.12.2016;2016;12;20;Keskiviikko;1;1;2
93;14.12.2016;2016;12;21;Keskiviikko;1;2;3
93;14.12.2016;2016;12;22;Keskiviikko;0;0;0
93;14.12.2016;2016;12;23;Keskiviikko;0;0;0
93;15.12.2016;2016;12;00;Torstai;0;0;0
93;15.12.2016;2016;12;01;Torstai;0;0;0
93;15.12.2016;2016;12;02;Torstai;0;0;0
93;15.12.2016;2016;12;03;Torstai;0;0;0
93;15.12.2016;2016;12;04;Torstai;0;0;0
93;15.12.2016;2016;12;05;Torstai;0;1;1
93;15.12.2016;2016;12;06;Torstai;9;5;14
93;15.12.2016;2016;12;07;Torstai;8;10;18
93;15.12.2016;2016;12;08;Torstai;3;10;13
93;15.12.2016;2016;12;09;Torstai;2;2;4
93;15.12.2016;2016;12;10;Torstai;6;0;6
93;15.12.2016;2016;12;11;Torstai;2;7;9
93;15.12.2016;2016;12;12;Torstai;7;1;8
93;15.12.2016;2016;12;13;Torstai;2;0;2
93;15.12.2016;2016;12;14;Torstai;2;4;6
93;15.12.2016;2016;12;15;Torstai;6;8;14
93;15.12.2016;2016;12;16;Torstai;12;10;22
93;15.12.2016;2016;12;17;Torstai;14;3;17
93;15.12.2016;2016;12;18;Torstai;3;1;4
93;15.12.2016;2016;12;19;Torstai;3;3;6
93;15.12.2016;2016;12;20;Torstai;2;2;4
93;15.12.2016;2016;12;21;Torstai;1;1;2
93;15.12.2016;2016;12;22;Torstai;0;0;0
93;15.12.2016;2016;12;23;Torstai;0;1;1
93;16.12.2016;2016;12;00;Perjantai;0;0;0
93;16.12.2016;2016;12;01;Perjantai;0;0;0
93;16.12.2016;2016;12;02;Perjantai;0;0;0
93;16.12.2016;2016;12;03;Perjantai;0;0;0
93;16.12.2016;2016;12;04;Perjantai;0;0;0
93;16.12.2016;2016;12;05;Perjantai;0;1;1
93;16.12.2016;2016;12;06;Perjantai;4;3;7
93;16.12.2016;2016;12;07;Perjantai;8;12;20
93;16.12.2016;2016;12;08;Perjantai;2;8;10
93;16.12.2016;2016;12;09;Perjantai;1;2;3
93;16.12.2016;2016;12;10;Perjantai;2;2;4
93;16.12.2016;2016;12;11;Perjantai;3;1;4
93;16.12.2016;2016;12;12;Perjantai;3;1;4
93;16.12.2016;2016;12;13;Perjantai;2;2;4
93;16.12.2016;2016;12;14;Perjantai;1;4;5
93;16.12.2016;2016;12;15;Perjantai;8;7;15
93;16.12.2016;2016;12;16;Perjantai;14;2;16
93;16.12.2016;2016;12;17;Perjantai;4;5;9
93;16.12.2016;2016;12;18;Perjantai;4;6;10
93;16.12.2016;2016;12;19;Perjantai;1;2;3
93;16.12.2016;2016;12;20;Perjantai;2;0;2
93;16.12.2016;2016;12;21;Perjantai;5;2;7
93;16.12.2016;2016;12;22;Perjantai;0;1;1
93;16.12.2016;2016;12;23;Perjantai;1;1;2
93;17.12.2016;2016;12;00;Lauantai;0;0;0
93;17.12.2016;2016;12;01;Lauantai;0;0;0
93;17.12.2016;2016;12;02;Lauantai;0;0;0
93;17.12.2016;2016;12;03;Lauantai;0;1;1
93;17.12.2016;2016;12;04;Lauantai;0;0;0
93;17.12.2016;2016;12;05;Lauantai;1;0;1
93;17.12.2016;2016;12;06;Lauantai;0;0;0
93;17.12.2016;2016;12;07;Lauantai;0;0;0
93;17.12.2016;2016;12;08;Lauantai;0;1;1
93;17.12.2016;2016;12;09;Lauantai;2;0;2
93;17.12.2016;2016;12;10;Lauantai;3;4;7
93;17.12.2016;2016;12;11;Lauantai;5;6;11
93;17.12.2016;2016;12;12;Lauantai;5;5;10
93;17.12.2016;2016;12;13;Lauantai;5;4;9
93;17.12.2016;2016;12;14;Lauantai;1;2;3
93;17.12.2016;2016;12;15;Lauantai;3;2;5
93;17.12.2016;2016;12;16;Lauantai;3;2;5
93;17.12.2016;2016;12;17;Lauantai;4;3;7
93;17.12.2016;2016;12;18;Lauantai;4;4;8
93;17.12.2016;2016;12;19;Lauantai;1;2;3
93;17.12.2016;2016;12;20;Lauantai;4;1;5
93;17.12.2016;2016;12;21;Lauantai;3;3;6
93;17.12.2016;2016;12;22;Lauantai;0;0;0
93;17.12.2016;2016;12;23;Lauantai;0;0;0
93;18.12.2016;2016;12;00;Sunnuntai;0;0;0
93;18.12.2016;2016;12;01;Sunnuntai;0;0;0
93;18.12.2016;2016;12;02;Sunnuntai;0;2;2
93;18.12.2016;2016;12;03;Sunnuntai;0;1;1
93;18.12.2016;2016;12;04;Sunnuntai;0;0;0
93;18.12.2016;2016;12;05;Sunnuntai;1;0;1
93;18.12.2016;2016;12;06;Sunnuntai;5;0;5
93;18.12.2016;2016;12;07;Sunnuntai;2;0;2
93;18.12.2016;2016;12;08;Sunnuntai;1;0;1
93;18.12.2016;2016;12;09;Sunnuntai;2;2;4
93;18.12.2016;2016;12;10;Sunnuntai;2;2;4
93;18.12.2016;2016;12;11;Sunnuntai;3;0;3
93;18.12.2016;2016;12;12;Sunnuntai;4;3;7
93;18.12.2016;2016;12;13;Sunnuntai;0;2;2
93;18.12.2016;2016;12;14;Sunnuntai;2;4;6
93;18.12.2016;2016;12;15;Sunnuntai;0;1;1
93;18.12.2016;2016;12;16;Sunnuntai;1;2;3
93;18.12.2016;2016;12;17;Sunnuntai;3;0;3
93;18.12.2016;2016;12;18;Sunnuntai;2;1;3
93;18.12.2016;2016;12;19;Sunnuntai;0;2;2
93;18.12.2016;2016;12;20;Sunnuntai;0;0;0
93;18.12.2016;2016;12;21;Sunnuntai;0;2;2
93;18.12.2016;2016;12;22;Sunnuntai;0;0;0
93;18.12.2016;2016;12;23;Sunnuntai;0;0;0
93;19.12.2016;2016;12;00;Maanantai;0;0;0
93;19.12.2016;2016;12;01;Maanantai;1;0;1
93;19.12.2016;2016;12;02;Maanantai;0;0;0
93;19.12.2016;2016;12;03;Maanantai;0;0;0
93;19.12.2016;2016;12;04;Maanantai;0;0;0
93;19.12.2016;2016;12;05;Maanantai;1;2;3
93;19.12.2016;2016;12;06;Maanantai;8;5;13
93;19.12.2016;2016;12;07;Maanantai;7;12;19
93;19.12.2016;2016;12;08;Maanantai;5;13;18
93;19.12.2016;2016;12;09;Maanantai;2;2;4
93;19.12.2016;2016;12;10;Maanantai;3;1;4
93;19.12.2016;2016;12;11;Maanantai;0;0;0
93;19.12.2016;2016;12;12;Maanantai;3;0;3
93;19.12.2016;2016;12;13;Maanantai;4;0;4
93;19.12.2016;2016;12;14;Maanantai;7;5;12
93;19.12.2016;2016;12;15;Maanantai;9;6;15
93;19.12.2016;2016;12;16;Maanantai;16;9;25
93;19.12.2016;2016;12;17;Maanantai;7;6;13
93;19.12.2016;2016;12;18;Maanantai;2;6;8
93;19.12.2016;2016;12;19;Maanantai;1;3;4
93;19.12.2016;2016;12;20;Maanantai;0;0;0
93;19.12.2016;2016;12;21;Maanantai;0;1;1
93;19.12.2016;2016;12;22;Maanantai;0;0;0
93;19.12.2016;2016;12;23;Maanantai;0;0;0
93;20.12.2016;2016;12;00;Tiistai;0;0;0
93;20.12.2016;2016;12;01;Tiistai;0;0;0
93;20.12.2016;2016;12;02;Tiistai;0;0;0
93;20.12.2016;2016;12;03;Tiistai;0;0;0
93;20.12.2016;2016;12;04;Tiistai;0;0;0
93;20.12.2016;2016;12;05;Tiistai;1;1;2
93;20.12.2016;2016;12;06;Tiistai;5;2;7
93;20.12.2016;2016;12;07;Tiistai;4;8;12
93;20.12.2016;2016;12;08;Tiistai;3;5;8
93;20.12.2016;2016;12;09;Tiistai;1;2;3
93;20.12.2016;2016;12;10;Tiistai;4;2;6
93;20.12.2016;2016;12;11;Tiistai;0;1;1
93;20.12.2016;2016;12;12;Tiistai;1;0;1
93;20.12.2016;2016;12;13;Tiistai;3;0;3
93;20.12.2016;2016;12;14;Tiistai;4;2;6
93;20.12.2016;2016;12;15;Tiistai;3;6;9
93;20.12.2016;2016;12;16;Tiistai;13;2;15
93;20.12.2016;2016;12;17;Tiistai;3;4;7
93;20.12.2016;2016;12;18;Tiistai;2;2;4
93;20.12.2016;2016;12;19;Tiistai;1;2;3
93;20.12.2016;2016;12;20;Tiistai;1;0;1
93;20.12.2016;2016;12;21;Tiistai;1;1;2
93;20.12.2016;2016;12;22;Tiistai;1;5;6
93;20.12.2016;2016;12;23;Tiistai;0;0;0
93;21.12.2016;2016;12;00;Keskiviikko;0;0;0
93;21.12.2016;2016;12;01;Keskiviikko;0;0;0
93;21.12.2016;2016;12;02;Keskiviikko;0;1;1
93;21.12.2016;2016;12;03;Keskiviikko;0;0;0
93;21.12.2016;2016;12;04;Keskiviikko;0;0;0
93;21.12.2016;2016;12;05;Keskiviikko;1;0;1
93;21.12.2016;2016;12;06;Keskiviikko;6;0;6
93;21.12.2016;2016;12;07;Keskiviikko;5;10;15
93;21.12.2016;2016;12;08;Keskiviikko;3;4;7
93;21.12.2016;2016;12;09;Keskiviikko;1;2;3
93;21.12.2016;2016;12;10;Keskiviikko;2;1;3
93;21.12.2016;2016;12;11;Keskiviikko;1;2;3
93;21.12.2016;2016;12;12;Keskiviikko;7;1;8
93;21.12.2016;2016;12;13;Keskiviikko;1;1;2
93;21.12.2016;2016;12;14;Keskiviikko;1;9;10
93;21.12.2016;2016;12;15;Keskiviikko;5;2;7
93;21.12.2016;2016;12;16;Keskiviikko;8;6;14
93;21.12.2016;2016;12;17;Keskiviikko;8;1;9
93;21.12.2016;2016;12;18;Keskiviikko;0;2;2
93;21.12.2016;2016;12;19;Keskiviikko;0;3;3
93;21.12.2016;2016;12;20;Keskiviikko;1;3;4
93;21.12.2016;2016;12;21;Keskiviikko;0;2;2
93;21.12.2016;2016;12;22;Keskiviikko;0;2;2
93;21.12.2016;2016;12;23;Keskiviikko;0;0;0
93;22.12.2016;2016;12;00;Torstai;0;0;0
93;22.12.2016;2016;12;01;Torstai;0;0;0
93;22.12.2016;2016;12;02;Torstai;0;0;0
93;22.12.2016;2016;12;03;Torstai;0;0;0
93;22.12.2016;2016;12;04;Torstai;0;0;0
93;22.12.2016;2016;12;05;Torstai;1;0;1
93;22.12.2016;2016;12;06;Torstai;2;0;2
93;22.12.2016;2016;12;07;Torstai;3;7;10
93;22.12.2016;2016;12;08;Torstai;1;5;6
93;22.12.2016;2016;12;09;Torstai;4;2;6
93;22.12.2016;2016;12;10;Torstai;0;2;2
93;22.12.2016;2016;12;11;Torstai;4;2;6
93;22.12.2016;2016;12;12;Torstai;1;0;1
93;22.12.2016;2016;12;13;Torstai;3;1;4
93;22.12.2016;2016;12;14;Torstai;2;1;3
93;22.12.2016;2016;12;15;Torstai;4;7;11
93;22.12.2016;2016;12;16;Torstai;11;6;17
93;22.12.2016;2016;12;17;Torstai;3;3;6
93;22.12.2016;2016;12;18;Torstai;1;6;7
93;22.12.2016;2016;12;19;Torstai;1;1;2
93;22.12.2016;2016;12;20;Torstai;3;0;3
93;22.12.2016;2016;12;21;Torstai;1;2;3
93;22.12.2016;2016;12;22;Torstai;1;1;2
93;22.12.2016;2016;12;23;Torstai;0;1;1
93;23.12.2016;2016;12;00;Perjantai;0;0;0
93;23.12.2016;2016;12;01;Perjantai;0;1;1
93;23.12.2016;2016;12;02;Perjantai;0;1;1
93;23.12.2016;2016;12;03;Perjantai;0;0;0
93;23.12.2016;2016;12;04;Perjantai;0;0;0
93;23.12.2016;2016;12;05;Perjantai;0;1;1
93;23.12.2016;2016;12;06;Perjantai;1;4;5
93;23.12.2016;2016;12;07;Perjantai;2;5;7
93;23.12.2016;2016;12;08;Perjantai;1;2;3
93;23.12.2016;2016;12;09;Perjantai;3;2;5
93;23.12.2016;2016;12;10;Perjantai;0;0;0
93;23.12.2016;2016;12;11;Perjantai;0;1;1
93;23.12.2016;2016;12;12;Perjantai;2;3;5
93;23.12.2016;2016;12;13;Perjantai;3;0;3
93;23.12.2016;2016;12;14;Perjantai;7;3;10
93;23.12.2016;2016;12;15;Perjantai;7;2;9
93;23.12.2016;2016;12;16;Perjantai;4;4;8
93;23.12.2016;2016;12;17;Perjantai;0;2;2
93;23.12.2016;2016;12;18;Perjantai;1;1;2
93;23.12.2016;2016;12;19;Perjantai;1;1;2
93;23.12.2016;2016;12;20;Perjantai;1;1;2
93;23.12.2016;2016;12;21;Perjantai;1;0;1
93;23.12.2016;2016;12;22;Perjantai;0;0;0
93;23.12.2016;2016;12;23;Perjantai;0;0;0
93;24.12.2016;2016;12;00;Lauantai;0;1;1
93;24.12.2016;2016;12;01;Lauantai;0;0;0
93;24.12.2016;2016;12;02;Lauantai;0;0;0
93;24.12.2016;2016;12;03;Lauantai;0;0;0
93;24.12.2016;2016;12;04;Lauantai;0;0;0
93;24.12.2016;2016;12;05;Lauantai;0;0;0
93;24.12.2016;2016;12;06;Lauantai;0;0;0
93;24.12.2016;2016;12;07;Lauantai;0;0;0
93;24.12.2016;2016;12;08;Lauantai;0;0;0
93;24.12.2016;2016;12;09;Lauantai;1;1;2
93;24.12.2016;2016;12;10;Lauantai;0;0;0
93;24.12.2016;2016;12;11;Lauantai;1;3;4
93;24.12.2016;2016;12;12;Lauantai;0;3;3
93;24.12.2016;2016;12;13;Lauantai;0;2;2
93;24.12.2016;2016;12;14;Lauantai;0;1;1
93;24.12.2016;2016;12;15;Lauantai;0;0;0
93;24.12.2016;2016;12;16;Lauantai;0;0;0
93;24.12.2016;2016;12;17;Lauantai;1;0;1
93;24.12.2016;2016;12;18;Lauantai;0;0;0
93;24.12.2016;2016;12;19;Lauantai;0;0;0
93;24.12.2016;2016;12;20;Lauantai;2;0;2
93;24.12.2016;2016;12;21;Lauantai;0;1;1
93;24.12.2016;2016;12;22;Lauantai;1;0;1
93;24.12.2016;2016;12;23;Lauantai;0;0;0
93;25.12.2016;2016;12;00;Sunnuntai;0;0;0
93;25.12.2016;2016;12;01;Sunnuntai;0;2;2
93;25.12.2016;2016;12;02;Sunnuntai;0;0;0
93;25.12.2016;2016;12;03;Sunnuntai;0;0;0
93;25.12.2016;2016;12;04;Sunnuntai;0;0;0
93;25.12.2016;2016;12;05;Sunnuntai;0;0;0
93;25.12.2016;2016;12;06;Sunnuntai;0;0;0
93;25.12.2016;2016;12;07;Sunnuntai;0;0;0
93;25.12.2016;2016;12;08;Sunnuntai;0;0;0
93;25.12.2016;2016;12;09;Sunnuntai;0;0;0
93;25.12.2016;2016;12;10;Sunnuntai;1;5;6
93;25.12.2016;2016;12;11;Sunnuntai;2;2;4
93;25.12.2016;2016;12;12;Sunnuntai;1;0;1
93;25.12.2016;2016;12;13;Sunnuntai;1;0;1
93;25.12.2016;2016;12;14;Sunnuntai;3;1;4
93;25.12.2016;2016;12;15;Sunnuntai;1;0;1
93;25.12.2016;2016;12;16;Sunnuntai;3;0;3
93;25.12.2016;2016;12;17;Sunnuntai;2;1;3
93;25.12.2016;2016;12;18;Sunnuntai;0;1;1
93;25.12.2016;2016;12;19;Sunnuntai;2;2;4
93;25.12.2016;2016;12;20;Sunnuntai;0;0;0
93;25.12.2016;2016;12;21;Sunnuntai;0;0;0
93;25.12.2016;2016;12;22;Sunnuntai;1;0;1
93;25.12.2016;2016;12;23;Sunnuntai;0;1;1
93;26.12.2016;2016;12;00;Maanantai;0;0;0
93;26.12.2016;2016;12;01;Maanantai;0;0;0
93;26.12.2016;2016;12;02;Maanantai;0;0;0
93;26.12.2016;2016;12;03;Maanantai;0;0;0
93;26.12.2016;2016;12;04;Maanantai;0;0;0
93;26.12.2016;2016;12;05;Maanantai;1;0;1
93;26.12.2016;2016;12;06;Maanantai;0;0;0
93;26.12.2016;2016;12;07;Maanantai;1;0;1
93;26.12.2016;2016;12;08;Maanantai;0;0;0
93;26.12.2016;2016;12;09;Maanantai;0;0;0
93;26.12.2016;2016;12;10;Maanantai;1;0;1
93;26.12.2016;2016;12;11;Maanantai;9;2;11
93;26.12.2016;2016;12;12;Maanantai;2;1;3
93;26.12.2016;2016;12;13;Maanantai;2;1;3
93;26.12.2016;2016;12;14;Maanantai;1;1;2
93;26.12.2016;2016;12;15;Maanantai;0;0;0
93;26.12.2016;2016;12;16;Maanantai;0;0;0
93;26.12.2016;2016;12;17;Maanantai;3;1;4
93;26.12.2016;2016;12;18;Maanantai;0;1;1
93;26.12.2016;2016;12;19;Maanantai;1;2;3
93;26.12.2016;2016;12;20;Maanantai;4;0;4
93;26.12.2016;2016;12;21;Maanantai;0;0;0
93;26.12.2016;2016;12;22;Maanantai;0;0;0
93;26.12.2016;2016;12;23;Maanantai;0;0;0
93;27.12.2016;2016;12;00;Tiistai;0;0;0
93;27.12.2016;2016;12;01;Tiistai;0;0;0
93;27.12.2016;2016;12;02;Tiistai;0;0;0
93;27.12.2016;2016;12;03;Tiistai;0;0;0
93;27.12.2016;2016;12;04;Tiistai;0;0;0
93;27.12.2016;2016;12;05;Tiistai;0;1;1
93;27.12.2016;2016;12;06;Tiistai;2;1;3
93;27.12.2016;2016;12;07;Tiistai;2;1;3
93;27.12.2016;2016;12;08;Tiistai;3;5;8
93;27.12.2016;2016;12;09;Tiistai;2;1;3
93;27.12.2016;2016;12;10;Tiistai;1;0;1
93;27.12.2016;2016;12;11;Tiistai;1;0;1
93;27.12.2016;2016;12;12;Tiistai;1;1;2
93;27.12.2016;2016;12;13;Tiistai;0;2;2
93;27.12.2016;2016;12;14;Tiistai;2;2;4
93;27.12.2016;2016;12;15;Tiistai;3;3;6
93;27.12.2016;2016;12;16;Tiistai;6;0;6
93;27.12.2016;2016;12;17;Tiistai;2;3;5
93;27.12.2016;2016;12;18;Tiistai;0;2;2
93;27.12.2016;2016;12;19;Tiistai;2;1;3
93;27.12.2016;2016;12;20;Tiistai;1;4;5
93;27.12.2016;2016;12;21;Tiistai;2;1;3
93;27.12.2016;2016;12;22;Tiistai;0;1;1
93;27.12.2016;2016;12;23;Tiistai;0;0;0
93;28.12.2016;2016;12;00;Keskiviikko;1;0;1
93;28.12.2016;2016;12;01;Keskiviikko;0;0;0
93;28.12.2016;2016;12;02;Keskiviikko;0;0;0
93;28.12.2016;2016;12;03;Keskiviikko;0;0;0
93;28.12.2016;2016;12;04;Keskiviikko;0;0;0
93;28.12.2016;2016;12;05;Keskiviikko;0;0;0
93;28.12.2016;2016;12;06;Keskiviikko;6;2;8
93;28.12.2016;2016;12;07;Keskiviikko;4;4;8
93;28.12.2016;2016;12;08;Keskiviikko;2;9;11
93;28.12.2016;2016;12;09;Keskiviikko;2;1;3
93;28.12.2016;2016;12;10;Keskiviikko;2;2;4
93;28.12.2016;2016;12;11;Keskiviikko;0;2;2
93;28.12.2016;2016;12;12;Keskiviikko;0;0;0
93;28.12.2016;2016;12;13;Keskiviikko;3;2;5
93;28.12.2016;2016;12;14;Keskiviikko;3;4;7
93;28.12.2016;2016;12;15;Keskiviikko;4;4;8
93;28.12.2016;2016;12;16;Keskiviikko;7;3;10
93;28.12.2016;2016;12;17;Keskiviikko;6;3;9
93;28.12.2016;2016;12;18;Keskiviikko;1;4;5
93;28.12.2016;2016;12;19;Keskiviikko;2;0;2
93;28.12.2016;2016;12;20;Keskiviikko;3;0;3
93;28.12.2016;2016;12;21;Keskiviikko;1;2;3
93;28.12.2016;2016;12;22;Keskiviikko;0;0;0
93;28.12.2016;2016;12;23;Keskiviikko;0;1;1
93;29.12.2016;2016;12;00;Torstai;1;0;1
93;29.12.2016;2016;12;01;Torstai;0;0;0
93;29.12.2016;2016;12;02;Torstai;0;2;2
93;29.12.2016;2016;12;03;Torstai;0;0;0
93;29.12.2016;2016;12;04;Torstai;0;0;0
93;29.12.2016;2016;12;05;Torstai;2;0;2
93;29.12.2016;2016;12;06;Torstai;4;1;5
93;29.12.2016;2016;12;07;Torstai;1;4;5
93;29.12.2016;2016;12;08;Torstai;2;7;9
93;29.12.2016;2016;12;09;Torstai;2;1;3
93;29.12.2016;2016;12;10;Torstai;2;1;3
93;29.12.2016;2016;12;11;Torstai;2;0;2
93;29.12.2016;2016;12;12;Torstai;2;4;6
93;29.12.2016;2016;12;13;Torstai;2;1;3
93;29.12.2016;2016;12;14;Torstai;4;2;6
93;29.12.2016;2016;12;15;Torstai;1;9;10
93;29.12.2016;2016;12;16;Torstai;8;4;12
93;29.12.2016;2016;12;17;Torstai;9;6;15
93;29.12.2016;2016;12;18;Torstai;1;1;2
93;29.12.2016;2016;12;19;Torstai;4;4;8
93;29.12.2016;2016;12;20;Torstai;2;1;3
93;29.12.2016;2016;12;21;Torstai;1;1;2
93;29.12.2016;2016;12;22;Torstai;2;1;3
93;29.12.2016;2016;12;23;Torstai;1;1;2
93;30.12.2016;2016;12;00;Perjantai;0;0;0
93;30.12.2016;2016;12;01;Perjantai;0;0;0
93;30.12.2016;2016;12;02;Perjantai;0;0;0
93;30.12.2016;2016;12;03;Perjantai;0;0;0
93;30.12.2016;2016;12;04;Perjantai;0;0;0
93;30.12.2016;2016;12;05;Perjantai;1;0;1
93;30.12.2016;2016;12;06;Perjantai;4;1;5
93;30.12.2016;2016;12;07;Perjantai;0;4;4
93;30.12.2016;2016;12;08;Perjantai;1;8;9
93;30.12.2016;2016;12;09;Perjantai;0;1;1
93;30.12.2016;2016;12;10;Perjantai;3;2;5
93;30.12.2016;2016;12;11;Perjantai;1;1;2
93;30.12.2016;2016;12;12;Perjantai;3;0;3
93;30.12.2016;2016;12;13;Perjantai;4;4;8
93;30.12.2016;2016;12;14;Perjantai;0;3;3
93;30.12.2016;2016;12;15;Perjantai;7;3;10
93;30.12.2016;2016;12;16;Perjantai;4;2;6
93;30.12.2016;2016;12;17;Perjantai;2;3;5
93;30.12.2016;2016;12;18;Perjantai;1;2;3
93;30.12.2016;2016;12;19;Perjantai;1;1;2
93;30.12.2016;2016;12;20;Perjantai;2;1;3
93;30.12.2016;2016;12;21;Perjantai;0;1;1
93;30.12.2016;2016;12;22;Perjantai;6;4;10
93;30.12.2016;2016;12;23;Perjantai;0;0;0
93;31.12.2016;2016;12;00;Lauantai;0;0;0
93;31.12.2016;2016;12;01;Lauantai;0;0;0
93;31.12.2016;2016;12;02;Lauantai;0;0;0
93;31.12.2016;2016;12;03;Lauantai;1;2;3
93;31.12.2016;2016;12;04;Lauantai;0;0;0
93;31.12.2016;2016;12;05;Lauantai;1;1;2
93;31.12.2016;2016;12;06;Lauantai;0;0;0
93;31.12.2016;2016;12;07;Lauantai;0;0;0
93;31.12.2016;2016;12;08;Lauantai;0;0;0
93;31.12.2016;2016;12;09;Lauantai;2;2;4
93;31.12.2016;2016;12;10;Lauantai;0;0;0
93;31.12.2016;2016;12;11;Lauantai;4;0;4
93;31.12.2016;2016;12;12;Lauantai;1;1;2
93;31.12.2016;2016;12;13;Lauantai;4;0;4
93;31.12.2016;2016;12;14;Lauantai;1;2;3
93;31.12.2016;2016;12;15;Lauantai;0;1;1
93;31.12.2016;2016;12;16;Lauantai;2;3;5
93;31.12.2016;2016;12;17;Lauantai;1;1;2
93;31.12.2016;2016;12;18;Lauantai;1;0;1
93;31.12.2016;2016;12;19;Lauantai;0;0;0
93;31.12.2016;2016;12;20;Lauantai;0;0;0
93;31.12.2016;2016;12;21;Lauantai;0;0;0
93;31.12.2016;2016;12;22;Lauantai;0;0;0
93;31.12.2016;2016;12;23;Lauantai;0;0;0
93;01.01.2017;2017;01;00;Sunnuntai;0;0;0
93;01.01.2017;2017;01;01;Sunnuntai;0;0;0
93;01.01.2017;2017;01;02;Sunnuntai;0;0;0
93;01.01.2017;2017;01;03;Sunnuntai;0;0;0
93;01.01.2017;2017;01;04;Sunnuntai;0;0;0
93;01.01.2017;2017;01;05;Sunnuntai;1;0;1
93;01.01.2017;2017;01;06;Sunnuntai;0;1;1
93;01.01.2017;2017;01;07;Sunnuntai;0;0;0
93;01.01.2017;2017;01;08;Sunnuntai;0;0;0
93;01.01.2017;2017;01;09;Sunnuntai;3;0;3
93;01.01.2017;2017;01;10;Sunnuntai;3;0;3
93;01.01.2017;2017;01;11;Sunnuntai;0;1;1
93;01.01.2017;2017;01;12;Sunnuntai;1;0;1
93;01.01.2017;2017;01;13;Sunnuntai;3;2;5
93;01.01.2017;2017;01;14;Sunnuntai;0;3;3
93;01.01.2017;2017;01;15;Sunnuntai;0;2;2
93;01.01.2017;2017;01;16;Sunnuntai;2;0;2
93;01.01.2017;2017;01;17;Sunnuntai;0;0;0
93;01.01.2017;2017;01;18;Sunnuntai;1;1;2
93;01.01.2017;2017;01;19;Sunnuntai;1;0;1
93;01.01.2017;2017;01;20;Sunnuntai;2;2;4
93;01.01.2017;2017;01;21;Sunnuntai;0;0;0
93;01.01.2017;2017;01;22;Sunnuntai;0;1;1
93;01.01.2017;2017;01;23;Sunnuntai;0;0;0
93;02.01.2017;2017;01;00;Maanantai;0;0;0
93;02.01.2017;2017;01;01;Maanantai;0;0;0
93;02.01.2017;2017;01;02;Maanantai;0;0;0
93;02.01.2017;2017;01;03;Maanantai;0;0;0
93;02.01.2017;2017;01;04;Maanantai;0;0;0
93;02.01.2017;2017;01;05;Maanantai;2;3;5
93;02.01.2017;2017;01;06;Maanantai;6;3;9
93;02.01.2017;2017;01;07;Maanantai;4;9;13
93;02.01.2017;2017;01;08;Maanantai;2;5;7
93;02.01.2017;2017;01;09;Maanantai;3;1;4
93;02.01.2017;2017;01;10;Maanantai;2;2;4
93;02.01.2017;2017;01;11;Maanantai;1;0;1
93;02.01.2017;2017;01;12;Maanantai;1;2;3
93;02.01.2017;2017;01;13;Maanantai;3;1;4
93;02.01.2017;2017;01;14;Maanantai;2;6;8
93;02.01.2017;2017;01;15;Maanantai;7;5;12
93;02.01.2017;2017;01;16;Maanantai;10;5;15
93;02.01.2017;2017;01;17;Maanantai;0;4;4
93;02.01.2017;2017;01;18;Maanantai;3;1;4
93;02.01.2017;2017;01;19;Maanantai;1;1;2
93;02.01.2017;2017;01;20;Maanantai;3;0;3
93;02.01.2017;2017;01;21;Maanantai;1;1;2
93;02.01.2017;2017;01;22;Maanantai;0;1;1
93;02.01.2017;2017;01;23;Maanantai;0;0;0
93;03.01.2017;2017;01;00;Tiistai;0;0;0
93;03.01.2017;2017;01;01;Tiistai;0;0;0
93;03.01.2017;2017;01;02;Tiistai;0;0;0
93;03.01.2017;2017;01;03;Tiistai;0;0;0
93;03.01.2017;2017;01;04;Tiistai;0;1;1
93;03.01.2017;2017;01;05;Tiistai;1;0;1
93;03.01.2017;2017;01;06;Tiistai;5;1;6
93;03.01.2017;2017;01;07;Tiistai;3;9;12
93;03.01.2017;2017;01;08;Tiistai;3;8;11
93;03.01.2017;2017;01;09;Tiistai;2;0;2
93;03.01.2017;2017;01;10;Tiistai;2;0;2
93;03.01.2017;2017;01;11;Tiistai;0;3;3
93;03.01.2017;2017;01;12;Tiistai;0;0;0
93;03.01.2017;2017;01;13;Tiistai;2;1;3
93;03.01.2017;2017;01;14;Tiistai;1;5;6
93;03.01.2017;2017;01;15;Tiistai;2;3;5
93;03.01.2017;2017;01;16;Tiistai;9;4;13
93;03.01.2017;2017;01;17;Tiistai;6;2;8
93;03.01.2017;2017;01;18;Tiistai;2;3;5
93;03.01.2017;2017;01;19;Tiistai;2;2;4
93;03.01.2017;2017;01;20;Tiistai;1;1;2
93;03.01.2017;2017;01;21;Tiistai;1;0;1
93;03.01.2017;2017;01;22;Tiistai;1;0;1
93;03.01.2017;2017;01;23;Tiistai;0;1;1
93;04.01.2017;2017;01;00;Keskiviikko;0;0;0
93;04.01.2017;2017;01;01;Keskiviikko;0;0;0
93;04.01.2017;2017;01;02;Keskiviikko;0;0;0
93;04.01.2017;2017;01;03;Keskiviikko;0;0;0
93;04.01.2017;2017;01;04;Keskiviikko;0;0;0
93;04.01.2017;2017;01;05;Keskiviikko;1;0;1
93;04.01.2017;2017;01;06;Keskiviikko;0;2;2
93;04.01.2017;2017;01;07;Keskiviikko;2;2;4
93;04.01.2017;2017;01;08;Keskiviikko;4;5;9
93;04.01.2017;2017;01;09;Keskiviikko;0;0;0
93;04.01.2017;2017;01;10;Keskiviikko;0;0;0
93;04.01.2017;2017;01;11;Keskiviikko;1;1;2
93;04.01.2017;2017;01;12;Keskiviikko;0;1;1
93;04.01.2017;2017;01;13;Keskiviikko;3;0;3
93;04.01.2017;2017;01;14;Keskiviikko;1;2;3
93;04.01.2017;2017;01;15;Keskiviikko;2;2;4
93;04.01.2017;2017;01;16;Keskiviikko;4;0;4
93;04.01.2017;2017;01;17;Keskiviikko;2;1;3
93;04.01.2017;2017;01;18;Keskiviikko;1;1;2
93;04.01.2017;2017;01;19;Keskiviikko;0;0;0
93;04.01.2017;2017;01;20;Keskiviikko;1;2;3
93;04.01.2017;2017;01;21;Keskiviikko;1;0;1
93;04.01.2017;2017;01;22;Keskiviikko;0;0;0
93;04.01.2017;2017;01;23;Keskiviikko;0;0;0
93;05.01.2017;2017;01;00;Torstai;0;0;0
93;05.01.2017;2017;01;01;Torstai;0;0;0
93;05.01.2017;2017;01;02;Torstai;0;0;0
93;05.01.2017;2017;01;03;Torstai;0;0;0
93;05.01.2017;2017;01;04;Torstai;0;0;0
93;05.01.2017;2017;01;05;Torstai;2;0;2
93;05.01.2017;2017;01;06;Torstai;0;0;0
93;05.01.2017;2017;01;07;Torstai;1;6;7
93;05.01.2017;2017;01;08;Torstai;0;1;1
93;05.01.2017;2017;01;09;Torstai;0;0;0
93;05.01.2017;2017;01;10;Torstai;0;0;0
93;05.01.2017;2017;01;11;Torstai;0;2;2
93;05.01.2017;2017;01;12;Torstai;0;0;0
93;05.01.2017;2017;01;13;Torstai;0;0;0
93;05.01.2017;2017;01;14;Torstai;1;2;3
93;05.01.2017;2017;01;15;Torstai;4;1;5
93;05.01.2017;2017;01;16;Torstai;2;2;4
93;05.01.2017;2017;01;17;Torstai;2;0;2
93;05.01.2017;2017;01;18;Torstai;0;0;0
93;05.01.2017;2017;01;19;Torstai;1;0;1
93;05.01.2017;2017;01;20;Torstai;1;0;1
93;05.01.2017;2017;01;21;Torstai;1;0;1
93;05.01.2017;2017;01;22;Torstai;0;0;0
93;05.01.2017;2017;01;23;Torstai;0;0;0
93;06.01.2017;2017;01;00;Perjantai;0;0;0
93;06.01.2017;2017;01;01;Perjantai;0;0;0
93;06.01.2017;2017;01;02;Perjantai;0;0;0
93;06.01.2017;2017;01;03;Perjantai;0;0;0
93;06.01.2017;2017;01;04;Perjantai;0;0;0
93;06.01.2017;2017;01;05;Perjantai;0;0;0
93;06.01.2017;2017;01;06;Perjantai;0;0;0
93;06.01.2017;2017;01;07;Perjantai;0;1;1
93;06.01.2017;2017;01;08;Perjantai;0;0;0
93;06.01.2017;2017;01;09;Perjantai;0;0;0
93;06.01.2017;2017;01;10;Perjantai;0;0;0
93;06.01.2017;2017;01;11;Perjantai;1;1;2
93;06.01.2017;2017;01;12;Perjantai;0;0;0
93;06.01.2017;2017;01;13;Perjantai;0;0;0
93;06.01.2017;2017;01;14;Perjantai;0;0;0
93;06.01.2017;2017;01;15;Perjantai;1;0;1
93;06.01.2017;2017;01;16;Perjantai;0;1;1
93;06.01.2017;2017;01;17;Perjantai;1;0;1
93;06.01.2017;2017;01;18;Perjantai;3;1;4
93;06.01.2017;2017;01;19;Perjantai;1;1;2
93;06.01.2017;2017;01;20;Perjantai;0;0;0
93;06.01.2017;2017;01;21;Perjantai;0;0;0
93;06.01.2017;2017;01;22;Perjantai;1;0;1
93;06.01.2017;2017;01;23;Perjantai;0;0;0
93;07.01.2017;2017;01;00;Lauantai;0;0;0
93;07.01.2017;2017;01;01;Lauantai;0;0;0
93;07.01.2017;2017;01;02;Lauantai;0;0;0
93;07.01.2017;2017;01;03;Lauantai;0;0;0
93;07.01.2017;2017;01;04;Lauantai;0;0;0
93;07.01.2017;2017;01;05;Lauantai;1;0;1
93;07.01.2017;2017;01;06;Lauantai;0;0;0
93;07.01.2017;2017;01;07;Lauantai;0;1;1
93;07.01.2017;2017;01;08;Lauantai;0;0;0
93;07.01.2017;2017;01;09;Lauantai;0;2;2
93;07.01.2017;2017;01;10;Lauantai;0;0;0
93;07.01.2017;2017;01;11;Lauantai;0;1;1
93;07.01.2017;2017;01;12;Lauantai;3;2;5
93;07.01.2017;2017;01;13;Lauantai;4;3;7
93;07.01.2017;2017;01;14;Lauantai;2;5;7
93;07.01.2017;2017;01;15;Lauantai;3;4;7
93;07.01.2017;2017;01;16;Lauantai;1;1;2
93;07.01.2017;2017;01;17;Lauantai;0;0;0
93;07.01.2017;2017;01;18;Lauantai;3;0;3
93;07.01.2017;2017;01;19;Lauantai;3;1;4
93;07.01.2017;2017;01;20;Lauantai;0;0;0
93;07.01.2017;2017;01;21;Lauantai;0;1;1
93;07.01.2017;2017;01;22;Lauantai;1;1;2
93;07.01.2017;2017;01;23;Lauantai;0;0;0
93;08.01.2017;2017;01;00;Sunnuntai;0;0;0
93;08.01.2017;2017;01;01;Sunnuntai;1;2;3
93;08.01.2017;2017;01;02;Sunnuntai;1;1;2
93;08.01.2017;2017;01;03;Sunnuntai;0;2;2
93;08.01.2017;2017;01;04;Sunnuntai;0;0;0
93;08.01.2017;2017;01;05;Sunnuntai;0;0;0
93;08.01.2017;2017;01;06;Sunnuntai;0;0;0
93;08.01.2017;2017;01;07;Sunnuntai;3;1;4
93;08.01.2017;2017;01;08;Sunnuntai;1;0;1
93;08.01.2017;2017;01;09;Sunnuntai;2;1;3
93;08.01.2017;2017;01;10;Sunnuntai;0;1;1
93;08.01.2017;2017;01;11;Sunnuntai;11;2;13
93;08.01.2017;2017;01;12;Sunnuntai;1;1;2
93;08.01.2017;2017;01;13;Sunnuntai;4;1;5
93;08.01.2017;2017;01;14;Sunnuntai;5;1;6
93;08.01.2017;2017;01;15;Sunnuntai;3;3;6
93;08.01.2017;2017;01;16;Sunnuntai;2;5;7
93;08.01.2017;2017;01;17;Sunnuntai;1;2;3
93;08.01.2017;2017;01;18;Sunnuntai;1;5;6
93;08.01.2017;2017;01;19;Sunnuntai;0;0;0
93;08.01.2017;2017;01;20;Sunnuntai;1;0;1
93;08.01.2017;2017;01;21;Sunnuntai;0;2;2
93;08.01.2017;2017;01;22;Sunnuntai;0;1;1
93;08.01.2017;2017;01;23;Sunnuntai;0;0;0
93;09.01.2017;2017;01;00;Maanantai;0;0;0
93;09.01.2017;2017;01;01;Maanantai;0;0;0
93;09.01.2017;2017;01;02;Maanantai;0;0;0
93;09.01.2017;2017;01;03;Maanantai;0;0;0
93;09.01.2017;2017;01;04;Maanantai;0;1;1
93;09.01.2017;2017;01;05;Maanantai;2;2;4
93;09.01.2017;2017;01;06;Maanantai;5;3;8
93;09.01.2017;2017;01;07;Maanantai;5;13;18
93;09.01.2017;2017;01;08;Maanantai;6;13;19
93;09.01.2017;2017;01;09;Maanantai;2;1;3
93;09.01.2017;2017;01;10;Maanantai;3;1;4
93;09.01.2017;2017;01;11;Maanantai;2;3;5
93;09.01.2017;2017;01;12;Maanantai;3;1;4
93;09.01.2017;2017;01;13;Maanantai;2;1;3
93;09.01.2017;2017;01;14;Maanantai;6;5;11
93;09.01.2017;2017;01;15;Maanantai;7;6;13
93;09.01.2017;2017;01;16;Maanantai;21;6;27
93;09.01.2017;2017;01;17;Maanantai;9;3;12
93;09.01.2017;2017;01;18;Maanantai;0;6;6
93;09.01.2017;2017;01;19;Maanantai;4;2;6
93;09.01.2017;2017;01;20;Maanantai;0;1;1
93;09.01.2017;2017;01;21;Maanantai;0;1;1
93;09.01.2017;2017;01;22;Maanantai;0;0;0
93;09.01.2017;2017;01;23;Maanantai;0;0;0
93;10.01.2017;2017;01;00;Tiistai;0;0;0
93;10.01.2017;2017;01;01;Tiistai;0;0;0
93;10.01.2017;2017;01;02;Tiistai;0;0;0
93;10.01.2017;2017;01;03;Tiistai;0;0;0
93;10.01.2017;2017;01;04;Tiistai;0;0;0
93;10.01.2017;2017;01;05;Tiistai;3;1;4
93;10.01.2017;2017;01;06;Tiistai;3;1;4
93;10.01.2017;2017;01;07;Tiistai;8;13;21
93;10.01.2017;2017;01;08;Tiistai;2;13;15
93;10.01.2017;2017;01;09;Tiistai;3;5;8
93;10.01.2017;2017;01;10;Tiistai;2;2;4
93;10.01.2017;2017;01;11;Tiistai;1;0;1
93;10.01.2017;2017;01;12;Tiistai;3;4;7
93;10.01.2017;2017;01;13;Tiistai;1;0;1
93;10.01.2017;2017;01;14;Tiistai;2;3;5
93;10.01.2017;2017;01;15;Tiistai;4;7;11
93;10.01.2017;2017;01;16;Tiistai;15;6;21
93;10.01.2017;2017;01;17;Tiistai;22;6;28
93;10.01.2017;2017;01;18;Tiistai;3;3;6
93;10.01.2017;2017;01;19;Tiistai;2;4;6
93;10.01.2017;2017;01;20;Tiistai;0;2;2
93;10.01.2017;2017;01;21;Tiistai;0;0;0
93;10.01.2017;2017;01;22;Tiistai;1;0;1
93;10.01.2017;2017;01;23;Tiistai;0;0;0
93;11.01.2017;2017;01;00;Keskiviikko;0;0;0
93;11.01.2017;2017;01;01;Keskiviikko;0;0;0
93;11.01.2017;2017;01;02;Keskiviikko;0;0;0
93;11.01.2017;2017;01;03;Keskiviikko;0;0;0
93;11.01.2017;2017;01;04;Keskiviikko;0;0;0
93;11.01.2017;2017;01;05;Keskiviikko;2;1;3
93;11.01.2017;2017;01;06;Keskiviikko;3;4;7
93;11.01.2017;2017;01;07;Keskiviikko;4;12;16
93;11.01.2017;2017;01;08;Keskiviikko;3;9;12
93;11.01.2017;2017;01;09;Keskiviikko;0;0;0
93;11.01.2017;2017;01;10;Keskiviikko;1;1;2
93;11.01.2017;2017;01;11;Keskiviikko;0;0;0
93;11.01.2017;2017;01;12;Keskiviikko;0;0;0
93;11.01.2017;2017;01;13;Keskiviikko;2;0;2
93;11.01.2017;2017;01;14;Keskiviikko;6;2;8
93;11.01.2017;2017;01;15;Keskiviikko;3;2;5
93;11.01.2017;2017;01;16;Keskiviikko;9;7;16
93;11.01.2017;2017;01;17;Keskiviikko;12;4;16
93;11.01.2017;2017;01;18;Keskiviikko;3;1;4
93;11.01.2017;2017;01;19;Keskiviikko;1;1;2
93;11.01.2017;2017;01;20;Keskiviikko;2;1;3
93;11.01.2017;2017;01;21;Keskiviikko;4;2;6
93;11.01.2017;2017;01;22;Keskiviikko;0;0;0
93;11.01.2017;2017;01;23;Keskiviikko;0;0;0
93;12.01.2017;2017;01;00;Torstai;0;0;0
93;12.01.2017;2017;01;01;Torstai;0;0;0
93;12.01.2017;2017;01;02;Torstai;0;0;0
93;12.01.2017;2017;01;03;Torstai;0;0;0
93;12.01.2017;2017;01;04;Torstai;0;1;1
93;12.01.2017;2017;01;05;Torstai;1;0;1
93;12.01.2017;2017;01;06;Torstai;6;3;9
93;12.01.2017;2017;01;07;Torstai;5;10;15
93;12.01.2017;2017;01;08;Torstai;1;9;10
93;12.01.2017;2017;01;09;Torstai;2;0;2
93;12.01.2017;2017;01;10;Torstai;0;0;0
93;12.01.2017;2017;01;11;Torstai;1;0;1
93;12.01.2017;2017;01;12;Torstai;1;0;1
93;12.01.2017;2017;01;13;Torstai;0;0;0
93;12.01.2017;2017;01;14;Torstai;1;2;3
93;12.01.2017;2017;01;15;Torstai;7;1;8
93;12.01.2017;2017;01;16;Torstai;6;2;8
93;12.01.2017;2017;01;17;Torstai;8;0;8
93;12.01.2017;2017;01;18;Torstai;0;0;0
93;12.01.2017;2017;01;19;Torstai;1;0;1
93;12.01.2017;2017;01;20;Torstai;1;2;3
93;12.01.2017;2017;01;21;Torstai;0;0;0
93;12.01.2017;2017;01;22;Torstai;0;1;1
93;12.01.2017;2017;01;23;Torstai;0;0;0
93;13.01.2017;2017;01;00;Perjantai;0;0;0
93;13.01.2017;2017;01;01;Perjantai;0;0;0
93;13.01.2017;2017;01;02;Perjantai;0;0;0
93;13.01.2017;2017;01;03;Perjantai;0;0;0
93;13.01.2017;2017;01;04;Perjantai;0;0;0
93;13.01.2017;2017;01;05;Perjantai;1;0;1
93;13.01.2017;2017;01;06;Perjantai;1;0;1
93;13.01.2017;2017;01;07;Perjantai;3;10;13
93;13.01.2017;2017;01;08;Perjantai;4;9;13
93;13.01.2017;2017;01;09;Perjantai;2;0;2
93;13.01.2017;2017;01;10;Perjantai;1;0;1
93;13.01.2017;2017;01;11;Perjantai;1;1;2
93;13.01.2017;2017;01;12;Perjantai;1;0;1
93;13.01.2017;2017;01;13;Perjantai;3;1;4
93;13.01.2017;2017;01;14;Perjantai;7;0;7
93;13.01.2017;2017;01;15;Perjantai;1;6;7
93;13.01.2017;2017;01;16;Perjantai;14;2;16
93;13.01.2017;2017;01;17;Perjantai;4;3;7
93;13.01.2017;2017;01;18;Perjantai;1;1;2
93;13.01.2017;2017;01;19;Perjantai;3;3;6
93;13.01.2017;2017;01;20;Perjantai;3;3;6
93;13.01.2017;2017;01;21;Perjantai;1;1;2
93;13.01.2017;2017;01;22;Perjantai;0;1;1
93;13.01.2017;2017;01;23;Perjantai;1;0;1
93;14.01.2017;2017;01;00;Lauantai;0;0;0
93;14.01.2017;2017;01;01;Lauantai;0;0;0
93;14.01.2017;2017;01;02;Lauantai;0;1;1
93;14.01.2017;2017;01;03;Lauantai;0;0;0
93;14.01.2017;2017;01;04;Lauantai;0;0;0
93;14.01.2017;2017;01;05;Lauantai;0;0;0
93;14.01.2017;2017;01;06;Lauantai;0;0;0
93;14.01.2017;2017;01;07;Lauantai;1;0;1
93;14.01.2017;2017;01;08;Lauantai;1;0;1
93;14.01.2017;2017;01;09;Lauantai;0;1;1
93;14.01.2017;2017;01;10;Lauantai;1;1;2
93;14.01.2017;2017;01;11;Lauantai;4;1;5
93;14.01.2017;2017;01;12;Lauantai;0;1;1
93;14.01.2017;2017;01;13;Lauantai;6;1;7
93;14.01.2017;2017;01;14;Lauantai;0;3;3
93;14.01.2017;2017;01;15;Lauantai;0;6;6
93;14.01.2017;2017;01;16;Lauantai;0;0;0
93;14.01.2017;2017;01;17;Lauantai;2;0;2
93;14.01.2017;2017;01;18;Lauantai;3;0;3
93;14.01.2017;2017;01;19;Lauantai;0;1;1
93;14.01.2017;2017;01;20;Lauantai;0;1;1
93;14.01.2017;2017;01;21;Lauantai;1;0;1
93;14.01.2017;2017;01;22;Lauantai;0;0;0
93;14.01.2017;2017;01;23;Lauantai;0;0;0
93;15.01.2017;2017;01;00;Sunnuntai;0;0;0
93;15.01.2017;2017;01;01;Sunnuntai;0;0;0
93;15.01.2017;2017;01;02;Sunnuntai;0;0;0
93;15.01.2017;2017;01;03;Sunnuntai;0;0;0
93;15.01.2017;2017;01;04;Sunnuntai;0;0;0
93;15.01.2017;2017;01;05;Sunnuntai;0;0;0
93;15.01.2017;2017;01;06;Sunnuntai;1;1;2
93;15.01.2017;2017;01;07;Sunnuntai;0;2;2
93;15.01.2017;2017;01;08;Sunnuntai;2;0;2
93;15.01.2017;2017;01;09;Sunnuntai;4;0;4
93;15.01.2017;2017;01;10;Sunnuntai;0;0;0
93;15.01.2017;2017;01;11;Sunnuntai;1;3;4
93;15.01.2017;2017;01;12;Sunnuntai;5;1;6
93;15.01.2017;2017;01;13;Sunnuntai;4;5;9
93;15.01.2017;2017;01;14;Sunnuntai;1;8;9
93;15.01.2017;2017;01;15;Sunnuntai;2;5;7
93;15.01.2017;2017;01;16;Sunnuntai;2;1;3
93;15.01.2017;2017;01;17;Sunnuntai;1;1;2
93;15.01.2017;2017;01;18;Sunnuntai;1;3;4
93;15.01.2017;2017;01;19;Sunnuntai;0;1;1
93;15.01.2017;2017;01;20;Sunnuntai;0;0;0
93;15.01.2017;2017;01;21;Sunnuntai;0;1;1
93;15.01.2017;2017;01;22;Sunnuntai;0;0;0
93;15.01.2017;2017;01;23;Sunnuntai;0;0;0
93;16.01.2017;2017;01;00;Maanantai;0;0;0
93;16.01.2017;2017;01;01;Maanantai;0;0;0
93;16.01.2017;2017;01;02;Maanantai;0;0;0
93;16.01.2017;2017;01;03;Maanantai;0;0;0
93;16.01.2017;2017;01;04;Maanantai;0;1;1
93;16.01.2017;2017;01;05;Maanantai;0;2;2
93;16.01.2017;2017;01;06;Maanantai;7;7;14
93;16.01.2017;2017;01;07;Maanantai;7;15;22
93;16.01.2017;2017;01;08;Maanantai;5;10;15
93;16.01.2017;2017;01;09;Maanantai;2;0;2
93;16.01.2017;2017;01;10;Maanantai;0;0;0
93;16.01.2017;2017;01;11;Maanantai;1;1;2
93;16.01.2017;2017;01;12;Maanantai;2;2;4
93;16.01.2017;2017;01;13;Maanantai;8;0;8
93;16.01.2017;2017;01;14;Maanantai;3;1;4
93;16.01.2017;2017;01;15;Maanantai;12;1;13
93;16.01.2017;2017;01;16;Maanantai;16;9;25
93;16.01.2017;2017;01;17;Maanantai;6;4;10
93;16.01.2017;2017;01;18;Maanantai;2;4;6
93;16.01.2017;2017;01;19;Maanantai;0;1;1
93;16.01.2017;2017;01;20;Maanantai;0;3;3
93;16.01.2017;2017;01;21;Maanantai;0;2;2
93;16.01.2017;2017;01;22;Maanantai;0;1;1
93;16.01.2017;2017;01;23;Maanantai;0;0;0
93;17.01.2017;2017;01;00;Tiistai;0;0;0
93;17.01.2017;2017;01;01;Tiistai;0;0;0
93;17.01.2017;2017;01;02;Tiistai;0;0;0
93;17.01.2017;2017;01;03;Tiistai;0;0;0
93;17.01.2017;2017;01;04;Tiistai;0;1;1
93;17.01.2017;2017;01;05;Tiistai;0;2;2
93;17.01.2017;2017;01;06;Tiistai;6;5;11
93;17.01.2017;2017;01;07;Tiistai;6;13;19
93;17.01.2017;2017;01;08;Tiistai;4;7;11
93;17.01.2017;2017;01;09;Tiistai;6;2;8
93;17.01.2017;2017;01;10;Tiistai;2;1;3
93;17.01.2017;2017;01;11;Tiistai;3;1;4
93;17.01.2017;2017;01;12;Tiistai;6;0;6
93;17.01.2017;2017;01;13;Tiistai;6;2;8
93;17.01.2017;2017;01;14;Tiistai;3;2;5
93;17.01.2017;2017;01;15;Tiistai;6;5;11
93;17.01.2017;2017;01;16;Tiistai;17;9;26
93;17.01.2017;2017;01;17;Tiistai;5;3;8
93;17.01.2017;2017;01;18;Tiistai;2;3;5
93;17.01.2017;2017;01;19;Tiistai;3;4;7
93;17.01.2017;2017;01;20;Tiistai;1;3;4
93;17.01.2017;2017;01;21;Tiistai;1;0;1
93;17.01.2017;2017;01;22;Tiistai;0;4;4
93;17.01.2017;2017;01;23;Tiistai;0;1;1
93;18.01.2017;2017;01;00;Keskiviikko;0;0;0
93;18.01.2017;2017;01;01;Keskiviikko;0;0;0
93;18.01.2017;2017;01;02;Keskiviikko;0;0;0
93;18.01.2017;2017;01;03;Keskiviikko;0;0;0
93;18.01.2017;2017;01;04;Keskiviikko;0;0;0
93;18.01.2017;2017;01;05;Keskiviikko;1;1;2
93;18.01.2017;2017;01;06;Keskiviikko;2;7;9
93;18.01.2017;2017;01;07;Keskiviikko;11;13;24
93;18.01.2017;2017;01;08;Keskiviikko;6;11;17
93;18.01.2017;2017;01;09;Keskiviikko;2;1;3
93;18.01.2017;2017;01;10;Keskiviikko;5;1;6
93;18.01.2017;2017;01;11;Keskiviikko;2;3;5
93;18.01.2017;2017;01;12;Keskiviikko;1;2;3
93;18.01.2017;2017;01;13;Keskiviikko;8;3;11
93;18.01.2017;2017;01;14;Keskiviikko;2;4;6
93;18.01.2017;2017;01;15;Keskiviikko;6;3;9
93;18.01.2017;2017;01;16;Keskiviikko;20;5;25
93;18.01.2017;2017;01;17;Keskiviikko;8;2;10
93;18.01.2017;2017;01;18;Keskiviikko;6;8;14
93;18.01.2017;2017;01;19;Keskiviikko;3;4;7
93;18.01.2017;2017;01;20;Keskiviikko;1;4;5
93;18.01.2017;2017;01;21;Keskiviikko;0;2;2
93;18.01.2017;2017;01;22;Keskiviikko;0;0;0
93;18.01.2017;2017;01;23;Keskiviikko;1;0;1
93;19.01.2017;2017;01;00;Torstai;0;0;0
93;19.01.2017;2017;01;01;Torstai;0;0;0
93;19.01.2017;2017;01;02;Torstai;0;0;0
93;19.01.2017;2017;01;03;Torstai;0;0;0
93;19.01.2017;2017;01;04;Torstai;0;1;1
93;19.01.2017;2017;01;05;Torstai;1;0;1
93;19.01.2017;2017;01;06;Torstai;2;2;4
93;19.01.2017;2017;01;07;Torstai;2;4;6
93;19.01.2017;2017;01;08;Torstai;5;7;12
93;19.01.2017;2017;01;09;Torstai;1;0;1
93;19.01.2017;2017;01;10;Torstai;3;1;4
93;19.01.2017;2017;01;11;Torstai;4;2;6
93;19.01.2017;2017;01;12;Torstai;4;1;5
93;19.01.2017;2017;01;13;Torstai;2;1;3
93;19.01.2017;2017;01;14;Torstai;2;1;3
93;19.01.2017;2017;01;15;Torstai;5;1;6
93;19.01.2017;2017;01;16;Torstai;6;1;7
93;19.01.2017;2017;01;17;Torstai;1;3;4
93;19.01.2017;2017;01;18;Torstai;0;4;4
93;19.01.2017;2017;01;19;Torstai;0;0;0
93;19.01.2017;2017;01;20;Torstai;2;1;3
93;19.01.2017;2017;01;21;Torstai;0;0;0
93;19.01.2017;2017;01;22;Torstai;0;1;1
93;19.01.2017;2017;01;23;Torstai;0;1;1
93;20.01.2017;2017;01;00;Perjantai;0;0;0
93;20.01.2017;2017;01;01;Perjantai;0;0;0
93;20.01.2017;2017;01;02;Perjantai;0;0;0
93;20.01.2017;2017;01;03;Perjantai;0;0;0
93;20.01.2017;2017;01;04;Perjantai;0;0;0
93;20.01.2017;2017;01;05;Perjantai;1;0;1
93;20.01.2017;2017;01;06;Perjantai;2;2;4
93;20.01.2017;2017;01;07;Perjantai;5;7;12
93;20.01.2017;2017;01;08;Perjantai;1;6;7
93;20.01.2017;2017;01;09;Perjantai;0;1;1
93;20.01.2017;2017;01;10;Perjantai;4;0;4
93;20.01.2017;2017;01;11;Perjantai;2;2;4
93;20.01.2017;2017;01;12;Perjantai;2;1;3
93;20.01.2017;2017;01;13;Perjantai;1;3;4
93;20.01.2017;2017;01;14;Perjantai;4;6;10
93;20.01.2017;2017;01;15;Perjantai;4;4;8
93;20.01.2017;2017;01;16;Perjantai;10;5;15
93;20.01.2017;2017;01;17;Perjantai;4;3;7
93;20.01.2017;2017;01;18;Perjantai;1;2;3
93;20.01.2017;2017;01;19;Perjantai;1;1;2
93;20.01.2017;2017;01;20;Perjantai;1;7;8
93;20.01.2017;2017;01;21;Perjantai;0;0;0
93;20.01.2017;2017;01;22;Perjantai;0;0;0
93;20.01.2017;2017;01;23;Perjantai;2;0;2
93;21.01.2017;2017;01;00;Lauantai;0;1;1
93;21.01.2017;2017;01;01;Lauantai;0;0;0
93;21.01.2017;2017;01;02;Lauantai;0;1;1
93;21.01.2017;2017;01;03;Lauantai;0;0;0
93;21.01.2017;2017;01;04;Lauantai;0;0;0
93;21.01.2017;2017;01;05;Lauantai;0;0;0
93;21.01.2017;2017;01;06;Lauantai;1;0;1
93;21.01.2017;2017;01;07;Lauantai;0;0;0
93;21.01.2017;2017;01;08;Lauantai;1;1;2
93;21.01.2017;2017;01;09;Lauantai;0;0;0
93;21.01.2017;2017;01;10;Lauantai;2;0;2
93;21.01.2017;2017;01;11;Lauantai;3;1;4
93;21.01.2017;2017;01;12;Lauantai;2;3;5
93;21.01.2017;2017;01;13;Lauantai;0;1;1
93;21.01.2017;2017;01;14;Lauantai;1;4;5
93;21.01.2017;2017;01;15;Lauantai;1;1;2
93;21.01.2017;2017;01;16;Lauantai;2;5;7
93;21.01.2017;2017;01;17;Lauantai;2;1;3
93;21.01.2017;2017;01;18;Lauantai;0;1;1
93;21.01.2017;2017;01;19;Lauantai;2;2;4
93;21.01.2017;2017;01;20;Lauantai;0;0;0
93;21.01.2017;2017;01;21;Lauantai;1;0;1
93;21.01.2017;2017;01;22;Lauantai;0;1;1
93;21.01.2017;2017;01;23;Lauantai;0;0;0
93;22.01.2017;2017;01;00;Sunnuntai;0;0;0
93;22.01.2017;2017;01;01;Sunnuntai;0;0;0
93;22.01.2017;2017;01;02;Sunnuntai;1;0;1
93;22.01.2017;2017;01;03;Sunnuntai;0;0;0
93;22.01.2017;2017;01;04;Sunnuntai;0;0;0
93;22.01.2017;2017;01;05;Sunnuntai;1;0;1
93;22.01.2017;2017;01;06;Sunnuntai;0;0;0
93;22.01.2017;2017;01;07;Sunnuntai;0;0;0
93;22.01.2017;2017;01;08;Sunnuntai;0;1;1
93;22.01.2017;2017;01;09;Sunnuntai;4;0;4
93;22.01.2017;2017;01;10;Sunnuntai;1;0;1
93;22.01.2017;2017;01;11;Sunnuntai;12;0;12
93;22.01.2017;2017;01;12;Sunnuntai;2;5;7
93;22.01.2017;2017;01;13;Sunnuntai;3;6;9
93;22.01.2017;2017;01;14;Sunnuntai;7;6;13
93;22.01.2017;2017;01;15;Sunnuntai;1;1;2
93;22.01.2017;2017;01;16;Sunnuntai;2;1;3
93;22.01.2017;2017;01;17;Sunnuntai;0;2;2
93;22.01.2017;2017;01;18;Sunnuntai;1;1;2
93;22.01.2017;2017;01;19;Sunnuntai;0;0;0
93;22.01.2017;2017;01;20;Sunnuntai;1;0;1
93;22.01.2017;2017;01;21;Sunnuntai;1;1;2
93;22.01.2017;2017;01;22;Sunnuntai;1;0;1
93;22.01.2017;2017;01;23;Sunnuntai;0;0;0
93;23.01.2017;2017;01;00;Maanantai;0;0;0
93;23.01.2017;2017;01;01;Maanantai;1;0;1
93;23.01.2017;2017;01;02;Maanantai;0;0;0
93;23.01.2017;2017;01;03;Maanantai;0;0;0
93;23.01.2017;2017;01;04;Maanantai;0;1;1
93;23.01.2017;2017;01;05;Maanantai;0;1;1
93;23.01.2017;2017;01;06;Maanantai;3;7;10
93;23.01.2017;2017;01;07;Maanantai;7;11;18
93;23.01.2017;2017;01;08;Maanantai;3;7;10
93;23.01.2017;2017;01;09;Maanantai;4;3;7
93;23.01.2017;2017;01;10;Maanantai;4;0;4
93;23.01.2017;2017;01;11;Maanantai;1;1;2
93;23.01.2017;2017;01;12;Maanantai;0;2;2
93;23.01.2017;2017;01;13;Maanantai;2;2;4
93;23.01.2017;2017;01;14;Maanantai;5;2;7
93;23.01.2017;2017;01;15;Maanantai;11;6;17
93;23.01.2017;2017;01;16;Maanantai;9;6;15
93;23.01.2017;2017;01;17;Maanantai;8;8;16
93;23.01.2017;2017;01;18;Maanantai;2;3;5
93;23.01.2017;2017;01;19;Maanantai;2;1;3
93;23.01.2017;2017;01;20;Maanantai;0;2;2
93;23.01.2017;2017;01;21;Maanantai;1;0;1
93;23.01.2017;2017;01;22;Maanantai;0;0;0
93;23.01.2017;2017;01;23;Maanantai;0;1;1
93;24.01.2017;2017;01;00;Tiistai;0;0;0
93;24.01.2017;2017;01;01;Tiistai;0;0;0
93;24.01.2017;2017;01;02;Tiistai;0;0;0
93;24.01.2017;2017;01;03;Tiistai;0;0;0
93;24.01.2017;2017;01;04;Tiistai;0;0;0
93;24.01.2017;2017;01;05;Tiistai;1;1;2
93;24.01.2017;2017;01;06;Tiistai;5;7;12
93;24.01.2017;2017;01;07;Tiistai;3;12;15
93;24.01.2017;2017;01;08;Tiistai;2;5;7
93;24.01.2017;2017;01;09;Tiistai;1;1;2
93;24.01.2017;2017;01;10;Tiistai;3;1;4
93;24.01.2017;2017;01;11;Tiistai;0;0;0
93;24.01.2017;2017;01;12;Tiistai;3;1;4
93;24.01.2017;2017;01;13;Tiistai;2;0;2
93;24.01.2017;2017;01;14;Tiistai;3;2;5
93;24.01.2017;2017;01;15;Tiistai;10;3;13
93;24.01.2017;2017;01;16;Tiistai;9;3;12
93;24.01.2017;2017;01;17;Tiistai;10;5;15
93;24.01.2017;2017;01;18;Tiistai;2;1;3
93;24.01.2017;2017;01;19;Tiistai;1;1;2
93;24.01.2017;2017;01;20;Tiistai;0;0;0
93;24.01.2017;2017;01;21;Tiistai;0;0;0
93;24.01.2017;2017;01;22;Tiistai;0;1;1
93;24.01.2017;2017;01;23;Tiistai;1;0;1
93;25.01.2017;2017;01;00;Keskiviikko;0;0;0
93;25.01.2017;2017;01;01;Keskiviikko;0;0;0
93;25.01.2017;2017;01;02;Keskiviikko;0;0;0
93;25.01.2017;2017;01;03;Keskiviikko;0;0;0
93;25.01.2017;2017;01;04;Keskiviikko;0;0;0
93;25.01.2017;2017;01;05;Keskiviikko;0;1;1
93;25.01.2017;2017;01;06;Keskiviikko;3;7;10
93;25.01.2017;2017;01;07;Keskiviikko;8;10;18
93;25.01.2017;2017;01;08;Keskiviikko;5;9;14
93;25.01.2017;2017;01;09;Keskiviikko;2;2;4
93;25.01.2017;2017;01;10;Keskiviikko;1;1;2
93;25.01.2017;2017;01;11;Keskiviikko;0;0;0
93;25.01.2017;2017;01;12;Keskiviikko;4;1;5
93;25.01.2017;2017;01;13;Keskiviikko;1;0;1
93;25.01.2017;2017;01;14;Keskiviikko;1;2;3
93;25.01.2017;2017;01;15;Keskiviikko;5;5;10
93;25.01.2017;2017;01;16;Keskiviikko;18;5;23
93;25.01.2017;2017;01;17;Keskiviikko;12;3;15
93;25.01.2017;2017;01;18;Keskiviikko;0;1;1
93;25.01.2017;2017;01;19;Keskiviikko;2;1;3
93;25.01.2017;2017;01;20;Keskiviikko;0;1;1
93;25.01.2017;2017;01;21;Keskiviikko;1;3;4
93;25.01.2017;2017;01;22;Keskiviikko;1;0;1
93;25.01.2017;2017;01;23;Keskiviikko;0;0;0
93;26.01.2017;2017;01;00;Torstai;0;0;0
93;26.01.2017;2017;01;01;Torstai;0;0;0
93;26.01.2017;2017;01;02;Torstai;0;0;0
93;26.01.2017;2017;01;03;Torstai;0;0;0
93;26.01.2017;2017;01;04;Torstai;0;0;0
93;26.01.2017;2017;01;05;Torstai;0;3;3
93;26.01.2017;2017;01;06;Torstai;6;3;9
93;26.01.2017;2017;01;07;Torstai;5;9;14
93;26.01.2017;2017;01;08;Torstai;6;10;16
93;26.01.2017;2017;01;09;Torstai;3;3;6
93;26.01.2017;2017;01;10;Torstai;2;1;3
93;26.01.2017;2017;01;11;Torstai;4;2;6
93;26.01.2017;2017;01;12;Torstai;4;1;5
93;26.01.2017;2017;01;13;Torstai;4;2;6
93;26.01.2017;2017;01;14;Torstai;3;6;9
93;26.01.2017;2017;01;15;Torstai;11;3;14
93;26.01.2017;2017;01;16;Torstai;9;4;13
93;26.01.2017;2017;01;17;Torstai;10;4;14
93;26.01.2017;2017;01;18;Torstai;3;2;5
93;26.01.2017;2017;01;19;Torstai;2;2;4
93;26.01.2017;2017;01;20;Torstai;2;3;5
93;26.01.2017;2017;01;21;Torstai;3;1;4
93;26.01.2017;2017;01;22;Torstai;0;2;2
93;26.01.2017;2017;01;23;Torstai;0;1;1
93;27.01.2017;2017;01;00;Perjantai;0;1;1
93;27.01.2017;2017;01;01;Perjantai;0;0;0
93;27.01.2017;2017;01;02;Perjantai;0;1;1
93;27.01.2017;2017;01;03;Perjantai;0;0;0
93;27.01.2017;2017;01;04;Perjantai;0;0;0
93;27.01.2017;2017;01;05;Perjantai;1;1;2
93;27.01.2017;2017;01;06;Perjantai;5;5;10
93;27.01.2017;2017;01;07;Perjantai;7;7;14
93;27.01.2017;2017;01;08;Perjantai;6;9;15
93;27.01.2017;2017;01;09;Perjantai;3;3;6
93;27.01.2017;2017;01;10;Perjantai;4;3;7
93;27.01.2017;2017;01;11;Perjantai;1;0;1
93;27.01.2017;2017;01;12;Perjantai;2;3;5
93;27.01.2017;2017;01;13;Perjantai;2;4;6
93;27.01.2017;2017;01;14;Perjantai;6;4;10
93;27.01.2017;2017;01;15;Perjantai;10;4;14
93;27.01.2017;2017;01;16;Perjantai;7;6;13
93;27.01.2017;2017;01;17;Perjantai;11;4;15
93;27.01.2017;2017;01;18;Perjantai;2;2;4
93;27.01.2017;2017;01;19;Perjantai;1;3;4
93;27.01.2017;2017;01;20;Perjantai;2;2;4
93;27.01.2017;2017;01;21;Perjantai;0;2;2
93;27.01.2017;2017;01;22;Perjantai;0;0;0
93;27.01.2017;2017;01;23;Perjantai;0;0;0
93;28.01.2017;2017;01;00;Lauantai;0;0;0
93;28.01.2017;2017;01;01;Lauantai;0;1;1
93;28.01.2017;2017;01;02;Lauantai;0;0;0
93;28.01.2017;2017;01;03;Lauantai;0;0;0
93;28.01.2017;2017;01;04;Lauantai;0;0;0
93;28.01.2017;2017;01;05;Lauantai;0;0;0
93;28.01.2017;2017;01;06;Lauantai;1;0;1
93;28.01.2017;2017;01;07;Lauantai;1;0;1
93;28.01.2017;2017;01;08;Lauantai;0;0;0
93;28.01.2017;2017;01;09;Lauantai;5;1;6
93;28.01.2017;2017;01;10;Lauantai;4;0;4
93;28.01.2017;2017;01;11;Lauantai;0;0;0
93;28.01.2017;2017;01;12;Lauantai;9;5;14
93;28.01.2017;2017;01;13;Lauantai;5;6;11
93;28.01.2017;2017;01;14;Lauantai;7;3;10
93;28.01.2017;2017;01;15;Lauantai;3;2;5
93;28.01.2017;2017;01;16;Lauantai;8;4;12
93;28.01.2017;2017;01;17;Lauantai;0;7;7
93;28.01.2017;2017;01;18;Lauantai;3;3;6
93;28.01.2017;2017;01;19;Lauantai;4;6;10
93;28.01.2017;2017;01;20;Lauantai;0;0;0
93;28.01.2017;2017;01;21;Lauantai;0;2;2
93;28.01.2017;2017;01;22;Lauantai;7;0;7
93;28.01.2017;2017;01;23;Lauantai;2;0;2
93;29.01.2017;2017;01;00;Sunnuntai;0;1;1
93;29.01.2017;2017;01;01;Sunnuntai;0;1;1
93;29.01.2017;2017;01;02;Sunnuntai;0;0;0
93;29.01.2017;2017;01;03;Sunnuntai;0;0;0
93;29.01.2017;2017;01;04;Sunnuntai;0;3;3
93;29.01.2017;2017;01;05;Sunnuntai;1;0;1
93;29.01.2017;2017;01;06;Sunnuntai;0;0;0
93;29.01.2017;2017;01;07;Sunnuntai;1;1;2
93;29.01.2017;2017;01;08;Sunnuntai;0;1;1
93;29.01.2017;2017;01;09;Sunnuntai;3;2;5
93;29.01.2017;2017;01;10;Sunnuntai;3;2;5
93;29.01.2017;2017;01;11;Sunnuntai;5;4;9
93;29.01.2017;2017;01;12;Sunnuntai;10;2;12
93;29.01.2017;2017;01;13;Sunnuntai;3;2;5
93;29.01.2017;2017;01;14;Sunnuntai;5;6;11
93;29.01.2017;2017;01;15;Sunnuntai;3;1;4
93;29.01.2017;2017;01;16;Sunnuntai;3;2;5
93;29.01.2017;2017;01;17;Sunnuntai;1;5;6
93;29.01.2017;2017;01;18;Sunnuntai;2;4;6
93;29.01.2017;2017;01;19;Sunnuntai;0;1;1
93;29.01.2017;2017;01;20;Sunnuntai;0;1;1
93;29.01.2017;2017;01;21;Sunnuntai;1;1;2
93;29.01.2017;2017;01;22;Sunnuntai;0;0;0
93;29.01.2017;2017;01;23;Sunnuntai;0;0;0
93;30.01.2017;2017;01;00;Maanantai;0;0;0
93;30.01.2017;2017;01;01;Maanantai;1;0;1
93;30.01.2017;2017;01;02;Maanantai;0;0;0
93;30.01.2017;2017;01;03;Maanantai;0;0;0
93;30.01.2017;2017;01;04;Maanantai;0;0;0
93;30.01.2017;2017;01;05;Maanantai;2;1;3
93;30.01.2017;2017;01;06;Maanantai;4;4;8
93;30.01.2017;2017;01;07;Maanantai;9;11;20
93;30.01.2017;2017;01;08;Maanantai;5;10;15
93;30.01.2017;2017;01;09;Maanantai;4;4;8
93;30.01.2017;2017;01;10;Maanantai;2;3;5
93;30.01.2017;2017;01;11;Maanantai;2;1;3
93;30.01.2017;2017;01;12;Maanantai;0;1;1
93;30.01.2017;2017;01;13;Maanantai;3;1;4
93;30.01.2017;2017;01;14;Maanantai;13;5;18
93;30.01.2017;2017;01;15;Maanantai;9;2;11
93;30.01.2017;2017;01;16;Maanantai;12;8;20
93;30.01.2017;2017;01;17;Maanantai;8;2;10
93;30.01.2017;2017;01;18;Maanantai;2;4;6
93;30.01.2017;2017;01;19;Maanantai;4;4;8
93;30.01.2017;2017;01;20;Maanantai;3;5;8
93;30.01.2017;2017;01;21;Maanantai;6;2;8
93;30.01.2017;2017;01;22;Maanantai;1;0;1
93;30.01.2017;2017;01;23;Maanantai;0;0;0
93;31.01.2017;2017;01;00;Tiistai;0;0;0
93;31.01.2017;2017;01;01;Tiistai;0;0;0
93;31.01.2017;2017;01;02;Tiistai;0;0;0
93;31.01.2017;2017;01;03;Tiistai;0;0;0
93;31.01.2017;2017;01;04;Tiistai;0;0;0
93;31.01.2017;2017;01;05;Tiistai;0;2;2
93;31.01.2017;2017;01;06;Tiistai;5;5;10
93;31.01.2017;2017;01;07;Tiistai;5;10;15
93;31.01.2017;2017;01;08;Tiistai;10;12;22
93;31.01.2017;2017;01;09;Tiistai;0;1;1
93;31.01.2017;2017;01;10;Tiistai;2;0;2
93;31.01.2017;2017;01;11;Tiistai;5;1;6
93;31.01.2017;2017;01;12;Tiistai;2;1;3
93;31.01.2017;2017;01;13;Tiistai;2;0;2
93;31.01.2017;2017;01;14;Tiistai;4;7;11
93;31.01.2017;2017;01;15;Tiistai;12;4;16
93;31.01.2017;2017;01;16;Tiistai;16;4;20
93;31.01.2017;2017;01;17;Tiistai;12;5;17
93;31.01.2017;2017;01;18;Tiistai;2;6;8
93;31.01.2017;2017;01;19;Tiistai;3;0;3
93;31.01.2017;2017;01;20;Tiistai;1;4;5
93;31.01.2017;2017;01;21;Tiistai;1;2;3
93;31.01.2017;2017;01;22;Tiistai;0;4;4
93;31.01.2017;2017;01;23;Tiistai;0;0;0
93;01.02.2017;2017;02;00;Keskiviikko;0;0;0
93;01.02.2017;2017;02;01;Keskiviikko;0;0;0
93;01.02.2017;2017;02;02;Keskiviikko;0;0;0
93;01.02.2017;2017;02;03;Keskiviikko;0;0;0
93;01.02.2017;2017;02;04;Keskiviikko;0;0;0
93;01.02.2017;2017;02;05;Keskiviikko;0;1;1
93;01.02.2017;2017;02;06;Keskiviikko;3;6;9
93;01.02.2017;2017;02;07;Keskiviikko;5;10;15
93;01.02.2017;2017;02;08;Keskiviikko;2;8;10
93;01.02.2017;2017;02;09;Keskiviikko;2;2;4
93;01.02.2017;2017;02;10;Keskiviikko;5;0;5
93;01.02.2017;2017;02;11;Keskiviikko;0;0;0
93;01.02.2017;2017;02;12;Keskiviikko;4;2;6
93;01.02.2017;2017;02;13;Keskiviikko;8;0;8
93;01.02.2017;2017;02;14;Keskiviikko;2;6;8
93;01.02.2017;2017;02;15;Keskiviikko;9;2;11
93;01.02.2017;2017;02;16;Keskiviikko;8;5;13
93;01.02.2017;2017;02;17;Keskiviikko;15;6;21
93;01.02.2017;2017;02;18;Keskiviikko;2;2;4
93;01.02.2017;2017;02;19;Keskiviikko;3;2;5
93;01.02.2017;2017;02;20;Keskiviikko;0;1;1
93;01.02.2017;2017;02;21;Keskiviikko;1;1;2
93;01.02.2017;2017;02;22;Keskiviikko;1;2;3
93;01.02.2017;2017;02;23;Keskiviikko;0;0;0
93;02.02.2017;2017;02;00;Torstai;0;0;0
93;02.02.2017;2017;02;01;Torstai;1;0;1
93;02.02.2017;2017;02;02;Torstai;0;0;0
93;02.02.2017;2017;02;03;Torstai;0;0;0
93;02.02.2017;2017;02;04;Torstai;0;0;0
93;02.02.2017;2017;02;05;Torstai;1;1;2
93;02.02.2017;2017;02;06;Torstai;2;7;9
93;02.02.2017;2017;02;07;Torstai;11;9;20
93;02.02.2017;2017;02;08;Torstai;10;12;22
93;02.02.2017;2017;02;09;Torstai;0;2;2
93;02.02.2017;2017;02;10;Torstai;1;0;1
93;02.02.2017;2017;02;11;Torstai;3;4;7
93;02.02.2017;2017;02;12;Torstai;2;0;2
93;02.02.2017;2017;02;13;Torstai;3;1;4
93;02.02.2017;2017;02;14;Torstai;3;2;5
93;02.02.2017;2017;02;15;Torstai;7;4;11
93;02.02.2017;2017;02;16;Torstai;12;4;16
93;02.02.2017;2017;02;17;Torstai;7;4;11
93;02.02.2017;2017;02;18;Torstai;1;5;6
93;02.02.2017;2017;02;19;Torstai;3;0;3
93;02.02.2017;2017;02;20;Torstai;0;2;2
93;02.02.2017;2017;02;21;Torstai;0;0;0
93;02.02.2017;2017;02;22;Torstai;0;0;0
93;02.02.2017;2017;02;23;Torstai;0;0;0
93;03.02.2017;2017;02;00;Perjantai;0;0;0
93;03.02.2017;2017;02;01;Perjantai;0;0;0
93;03.02.2017;2017;02;02;Perjantai;0;0;0
93;03.02.2017;2017;02;03;Perjantai;0;0;0
93;03.02.2017;2017;02;04;Perjantai;0;0;0
93;03.02.2017;2017;02;05;Perjantai;1;1;2
93;03.02.2017;2017;02;06;Perjantai;3;2;5
93;03.02.2017;2017;02;07;Perjantai;1;10;11
93;03.02.2017;2017;02;08;Perjantai;1;5;6
93;03.02.2017;2017;02;09;Perjantai;4;2;6
93;03.02.2017;2017;02;10;Perjantai;0;1;1
93;03.02.2017;2017;02;11;Perjantai;1;0;1
93;03.02.2017;2017;02;12;Perjantai;4;0;4
93;03.02.2017;2017;02;13;Perjantai;9;0;9
93;03.02.2017;2017;02;14;Perjantai;5;4;9
93;03.02.2017;2017;02;15;Perjantai;7;1;8
93;03.02.2017;2017;02;16;Perjantai;7;2;9
93;03.02.2017;2017;02;17;Perjantai;14;1;15
93;03.02.2017;2017;02;18;Perjantai;4;1;5
93;03.02.2017;2017;02;19;Perjantai;1;4;5
93;03.02.2017;2017;02;20;Perjantai;1;2;3
93;03.02.2017;2017;02;21;Perjantai;0;0;0
93;03.02.2017;2017;02;22;Perjantai;0;8;8
93;03.02.2017;2017;02;23;Perjantai;0;0;0
93;04.02.2017;2017;02;00;Lauantai;0;0;0
93;04.02.2017;2017;02;01;Lauantai;0;0;0
93;04.02.2017;2017;02;02;Lauantai;0;0;0
93;04.02.2017;2017;02;03;Lauantai;0;0;0
93;04.02.2017;2017;02;04;Lauantai;0;0;0
93;04.02.2017;2017;02;05;Lauantai;0;1;1
93;04.02.2017;2017;02;06;Lauantai;2;1;3
93;04.02.2017;2017;02;07;Lauantai;1;0;1
93;04.02.2017;2017;02;08;Lauantai;0;0;0
93;04.02.2017;2017;02;09;Lauantai;2;1;3
93;04.02.2017;2017;02;10;Lauantai;3;2;5
93;04.02.2017;2017;02;11;Lauantai;1;1;2
93;04.02.2017;2017;02;12;Lauantai;3;1;4
93;04.02.2017;2017;02;13;Lauantai;5;4;9
93;04.02.2017;2017;02;14;Lauantai;7;5;12
93;04.02.2017;2017;02;15;Lauantai;2;1;3
93;04.02.2017;2017;02;16;Lauantai;2;1;3
93;04.02.2017;2017;02;17;Lauantai;1;1;2
93;04.02.2017;2017;02;18;Lauantai;2;1;3
93;04.02.2017;2017;02;19;Lauantai;2;3;5
93;04.02.2017;2017;02;20;Lauantai;1;2;3
93;04.02.2017;2017;02;21;Lauantai;0;0;0
93;04.02.2017;2017;02;22;Lauantai;1;0;1
93;04.02.2017;2017;02;23;Lauantai;1;0;1
93;05.02.2017;2017;02;00;Sunnuntai;0;0;0
93;05.02.2017;2017;02;01;Sunnuntai;0;0;0
93;05.02.2017;2017;02;02;Sunnuntai;0;0;0
93;05.02.2017;2017;02;03;Sunnuntai;0;0;0
93;05.02.2017;2017;02;04;Sunnuntai;0;0;0
93;05.02.2017;2017;02;05;Sunnuntai;2;0;2
93;05.02.2017;2017;02;06;Sunnuntai;0;0;0
93;05.02.2017;2017;02;07;Sunnuntai;1;0;1
93;05.02.2017;2017;02;08;Sunnuntai;1;1;2
93;05.02.2017;2017;02;09;Sunnuntai;5;1;6
93;05.02.2017;2017;02;10;Sunnuntai;1;0;1
93;05.02.2017;2017;02;11;Sunnuntai;10;1;11
93;05.02.2017;2017;02;12;Sunnuntai;2;1;3
93;05.02.2017;2017;02;13;Sunnuntai;4;0;4
93;05.02.2017;2017;02;14;Sunnuntai;4;3;7
93;05.02.2017;2017;02;15;Sunnuntai;0;0;0
93;05.02.2017;2017;02;16;Sunnuntai;5;0;5
93;05.02.2017;2017;02;17;Sunnuntai;0;2;2
93;05.02.2017;2017;02;18;Sunnuntai;3;3;6
93;05.02.2017;2017;02;19;Sunnuntai;0;2;2
93;05.02.2017;2017;02;20;Sunnuntai;1;1;2
93;05.02.2017;2017;02;21;Sunnuntai;0;0;0
93;05.02.2017;2017;02;22;Sunnuntai;0;0;0
93;05.02.2017;2017;02;23;Sunnuntai;0;1;1
93;06.02.2017;2017;02;00;Maanantai;2;0;2
93;06.02.2017;2017;02;01;Maanantai;1;0;1
93;06.02.2017;2017;02;02;Maanantai;0;0;0
93;06.02.2017;2017;02;03;Maanantai;0;0;0
93;06.02.2017;2017;02;04;Maanantai;0;2;2
93;06.02.2017;2017;02;05;Maanantai;2;1;3
93;06.02.2017;2017;02;06;Maanantai;4;5;9
93;06.02.2017;2017;02;07;Maanantai;7;10;17
93;06.02.2017;2017;02;08;Maanantai;4;4;8
93;06.02.2017;2017;02;09;Maanantai;5;1;6
93;06.02.2017;2017;02;10;Maanantai;2;0;2
93;06.02.2017;2017;02;11;Maanantai;3;2;5
93;06.02.2017;2017;02;12;Maanantai;1;0;1
93;06.02.2017;2017;02;13;Maanantai;2;2;4
93;06.02.2017;2017;02;14;Maanantai;6;0;6
93;06.02.2017;2017;02;15;Maanantai;7;1;8
93;06.02.2017;2017;02;16;Maanantai;8;8;16
93;06.02.2017;2017;02;17;Maanantai;8;4;12
93;06.02.2017;2017;02;18;Maanantai;1;6;7
93;06.02.2017;2017;02;19;Maanantai;2;1;3
93;06.02.2017;2017;02;20;Maanantai;2;4;6
93;06.02.2017;2017;02;21;Maanantai;0;0;0
93;06.02.2017;2017;02;22;Maanantai;0;0;0
93;06.02.2017;2017;02;23;Maanantai;0;0;0
93;07.02.2017;2017;02;00;Tiistai;0;0;0
93;07.02.2017;2017;02;01;Tiistai;0;0;0
93;07.02.2017;2017;02;02;Tiistai;0;0;0
93;07.02.2017;2017;02;03;Tiistai;0;0;0
93;07.02.2017;2017;02;04;Tiistai;0;0;0
93;07.02.2017;2017;02;05;Tiistai;2;1;3
93;07.02.2017;2017;02;06;Tiistai;8;2;10
93;07.02.2017;2017;02;07;Tiistai;6;11;17
93;07.02.2017;2017;02;08;Tiistai;7;9;16
93;07.02.2017;2017;02;09;Tiistai;3;1;4
93;07.02.2017;2017;02;10;Tiistai;4;0;4
93;07.02.2017;2017;02;11;Tiistai;2;0;2
93;07.02.2017;2017;02;12;Tiistai;4;4;8
93;07.02.2017;2017;02;13;Tiistai;2;0;2
93;07.02.2017;2017;02;14;Tiistai;2;3;5
93;07.02.2017;2017;02;15;Tiistai;9;6;15
93;07.02.2017;2017;02;16;Tiistai;19;4;23
93;07.02.2017;2017;02;17;Tiistai;4;2;6
93;07.02.2017;2017;02;18;Tiistai;2;4;6
93;07.02.2017;2017;02;19;Tiistai;1;1;2
93;07.02.2017;2017;02;20;Tiistai;1;0;1
93;07.02.2017;2017;02;21;Tiistai;1;1;2
93;07.02.2017;2017;02;22;Tiistai;0;0;0
93;07.02.2017;2017;02;23;Tiistai;0;0;0
93;08.02.2017;2017;02;00;Keskiviikko;0;1;1
93;08.02.2017;2017;02;01;Keskiviikko;0;0;0
93;08.02.2017;2017;02;02;Keskiviikko;0;0;0
93;08.02.2017;2017;02;03;Keskiviikko;0;0;0
93;08.02.2017;2017;02;04;Keskiviikko;0;0;0
93;08.02.2017;2017;02;05;Keskiviikko;2;0;2
93;08.02.2017;2017;02;06;Keskiviikko;4;2;6
93;08.02.2017;2017;02;07;Keskiviikko;2;11;13
93;08.02.2017;2017;02;08;Keskiviikko;4;5;9
93;08.02.2017;2017;02;09;Keskiviikko;1;1;2
93;08.02.2017;2017;02;10;Keskiviikko;1;0;1
93;08.02.2017;2017;02;11;Keskiviikko;0;0;0
93;08.02.2017;2017;02;12;Keskiviikko;2;0;2
93;08.02.2017;2017;02;13;Keskiviikko;3;0;3
93;08.02.2017;2017;02;14;Keskiviikko;3;2;5
93;08.02.2017;2017;02;15;Keskiviikko;5;5;10
93;08.02.2017;2017;02;16;Keskiviikko;5;5;10
93;08.02.2017;2017;02;17;Keskiviikko;7;2;9
93;08.02.2017;2017;02;18;Keskiviikko;1;1;2
93;08.02.2017;2017;02;19;Keskiviikko;1;2;3
93;08.02.2017;2017;02;20;Keskiviikko;0;1;1
93;08.02.2017;2017;02;21;Keskiviikko;1;2;3
93;08.02.2017;2017;02;22;Keskiviikko;0;0;0
93;08.02.2017;2017;02;23;Keskiviikko;0;1;1
93;09.02.2017;2017;02;00;Torstai;1;0;1
93;09.02.2017;2017;02;01;Torstai;0;0;0
93;09.02.2017;2017;02;02;Torstai;0;0;0
93;09.02.2017;2017;02;03;Torstai;0;0;0
93;09.02.2017;2017;02;04;Torstai;0;0;0
93;09.02.2017;2017;02;05;Torstai;1;0;1
93;09.02.2017;2017;02;06;Torstai;4;2;6
93;09.02.2017;2017;02;07;Torstai;1;4;5
93;09.02.2017;2017;02;08;Torstai;5;3;8
93;09.02.2017;2017;02;09;Torstai;3;1;4
93;09.02.2017;2017;02;10;Torstai;0;1;1
93;09.02.2017;2017;02;11;Torstai;3;2;5
93;09.02.2017;2017;02;12;Torstai;2;1;3
93;09.02.2017;2017;02;13;Torstai;2;0;2
93;09.02.2017;2017;02;14;Torstai;2;3;5
93;09.02.2017;2017;02;15;Torstai;4;1;5
93;09.02.2017;2017;02;16;Torstai;5;4;9
93;09.02.2017;2017;02;17;Torstai;4;2;6
93;09.02.2017;2017;02;18;Torstai;3;1;4
93;09.02.2017;2017;02;19;Torstai;2;1;3
93;09.02.2017;2017;02;20;Torstai;3;2;5
93;09.02.2017;2017;02;21;Torstai;0;1;1
93;09.02.2017;2017;02;22;Torstai;0;1;1
93;09.02.2017;2017;02;23;Torstai;0;1;1
93;10.02.2017;2017;02;00;Perjantai;0;0;0
93;10.02.2017;2017;02;01;Perjantai;0;0;0
93;10.02.2017;2017;02;02;Perjantai;0;0;0
93;10.02.2017;2017;02;03;Perjantai;0;0;0
93;10.02.2017;2017;02;04;Perjantai;0;0;0
93;10.02.2017;2017;02;05;Perjantai;1;0;1
93;10.02.2017;2017;02;06;Perjantai;5;3;8
93;10.02.2017;2017;02;07;Perjantai;3;9;12
93;10.02.2017;2017;02;08;Perjantai;6;10;16
93;10.02.2017;2017;02;09;Perjantai;3;1;4
93;10.02.2017;2017;02;10;Perjantai;3;1;4
93;10.02.2017;2017;02;11;Perjantai;1;1;2
93;10.02.2017;2017;02;12;Perjantai;4;2;6
93;10.02.2017;2017;02;13;Perjantai;3;4;7
93;10.02.2017;2017;02;14;Perjantai;7;2;9
93;10.02.2017;2017;02;15;Perjantai;5;4;9
93;10.02.2017;2017;02;16;Perjantai;14;3;17
93;10.02.2017;2017;02;17;Perjantai;5;2;7
93;10.02.2017;2017;02;18;Perjantai;1;3;4
93;10.02.2017;2017;02;19;Perjantai;6;0;6
93;10.02.2017;2017;02;20;Perjantai;4;5;9
93;10.02.2017;2017;02;21;Perjantai;1;2;3
93;10.02.2017;2017;02;22;Perjantai;1;1;2
93;10.02.2017;2017;02;23;Perjantai;1;0;1
93;11.02.2017;2017;02;00;Lauantai;0;0;0
93;11.02.2017;2017;02;01;Lauantai;0;0;0
93;11.02.2017;2017;02;02;Lauantai;0;1;1
93;11.02.2017;2017;02;03;Lauantai;0;0;0
93;11.02.2017;2017;02;04;Lauantai;0;0;0
93;11.02.2017;2017;02;05;Lauantai;0;0;0
93;11.02.2017;2017;02;06;Lauantai;0;0;0
93;11.02.2017;2017;02;07;Lauantai;0;0;0
93;11.02.2017;2017;02;08;Lauantai;0;2;2
93;11.02.2017;2017;02;09;Lauantai;2;0;2
93;11.02.2017;2017;02;10;Lauantai;2;3;5
93;11.02.2017;2017;02;11;Lauantai;6;5;11
93;11.02.2017;2017;02;12;Lauantai;2;3;5
93;11.02.2017;2017;02;13;Lauantai;2;3;5
93;11.02.2017;2017;02;14;Lauantai;2;3;5
93;11.02.2017;2017;02;15;Lauantai;2;4;6
93;11.02.2017;2017;02;16;Lauantai;3;1;4
93;11.02.2017;2017;02;17;Lauantai;2;2;4
93;11.02.2017;2017;02;18;Lauantai;1;0;1
93;11.02.2017;2017;02;19;Lauantai;1;1;2
93;11.02.2017;2017;02;20;Lauantai;1;0;1
93;11.02.2017;2017;02;21;Lauantai;1;1;2
93;11.02.2017;2017;02;22;Lauantai;1;0;1
93;11.02.2017;2017;02;23;Lauantai;0;0;0
93;12.02.2017;2017;02;00;Sunnuntai;0;0;0
93;12.02.2017;2017;02;01;Sunnuntai;0;0;0
93;12.02.2017;2017;02;02;Sunnuntai;0;0;0
93;12.02.2017;2017;02;03;Sunnuntai;0;0;0
93;12.02.2017;2017;02;04;Sunnuntai;0;0;0
93;12.02.2017;2017;02;05;Sunnuntai;0;1;1
93;12.02.2017;2017;02;06;Sunnuntai;1;0;1
93;12.02.2017;2017;02;07;Sunnuntai;0;0;0
93;12.02.2017;2017;02;08;Sunnuntai;0;1;1
93;12.02.2017;2017;02;09;Sunnuntai;2;2;4
93;12.02.2017;2017;02;10;Sunnuntai;3;0;3
93;12.02.2017;2017;02;11;Sunnuntai;4;1;5
93;12.02.2017;2017;02;12;Sunnuntai;6;1;7
93;12.02.2017;2017;02;13;Sunnuntai;1;2;3
93;12.02.2017;2017;02;14;Sunnuntai;2;3;5
93;12.02.2017;2017;02;15;Sunnuntai;2;3;5
93;12.02.2017;2017;02;16;Sunnuntai;4;0;4
93;12.02.2017;2017;02;17;Sunnuntai;2;0;2
93;12.02.2017;2017;02;18;Sunnuntai;0;0;0
93;12.02.2017;2017;02;19;Sunnuntai;4;1;5
93;12.02.2017;2017;02;20;Sunnuntai;1;1;2
93;12.02.2017;2017;02;21;Sunnuntai;0;1;1
93;12.02.2017;2017;02;22;Sunnuntai;2;1;3
93;12.02.2017;2017;02;23;Sunnuntai;0;0;0
93;13.02.2017;2017;02;00;Maanantai;0;0;0
93;13.02.2017;2017;02;01;Maanantai;0;0;0
93;13.02.2017;2017;02;02;Maanantai;0;0;0
93;13.02.2017;2017;02;03;Maanantai;0;0;0
93;13.02.2017;2017;02;04;Maanantai;0;0;0
93;13.02.2017;2017;02;05;Maanantai;3;1;4
93;13.02.2017;2017;02;06;Maanantai;4;8;12
93;13.02.2017;2017;02;07;Maanantai;8;9;17
93;13.02.2017;2017;02;08;Maanantai;4;9;13
93;13.02.2017;2017;02;09;Maanantai;3;3;6
93;13.02.2017;2017;02;10;Maanantai;2;0;2
93;13.02.2017;2017;02;11;Maanantai;3;1;4
93;13.02.2017;2017;02;12;Maanantai;2;2;4
93;13.02.2017;2017;02;13;Maanantai;5;1;6
93;13.02.2017;2017;02;14;Maanantai;6;8;14
93;13.02.2017;2017;02;15;Maanantai;9;9;18
93;13.02.2017;2017;02;16;Maanantai;9;7;16
93;13.02.2017;2017;02;17;Maanantai;7;4;11
93;13.02.2017;2017;02;18;Maanantai;2;3;5
93;13.02.2017;2017;02;19;Maanantai;2;3;5
93;13.02.2017;2017;02;20;Maanantai;1;1;2
93;13.02.2017;2017;02;21;Maanantai;1;1;2
93;13.02.2017;2017;02;22;Maanantai;0;0;0
93;13.02.2017;2017;02;23;Maanantai;0;0;0
93;14.02.2017;2017;02;00;Tiistai;0;0;0
93;14.02.2017;2017;02;01;Tiistai;0;0;0
93;14.02.2017;2017;02;02;Tiistai;0;0;0
93;14.02.2017;2017;02;03;Tiistai;0;0;0
93;14.02.2017;2017;02;04;Tiistai;0;0;0
93;14.02.2017;2017;02;05;Tiistai;2;1;3
93;14.02.2017;2017;02;06;Tiistai;6;5;11
93;14.02.2017;2017;02;07;Tiistai;7;11;18
93;14.02.2017;2017;02;08;Tiistai;5;7;12
93;14.02.2017;2017;02;09;Tiistai;2;5;7
93;14.02.2017;2017;02;10;Tiistai;6;7;13
93;14.02.2017;2017;02;11;Tiistai;4;0;4
93;14.02.2017;2017;02;12;Tiistai;2;3;5
93;14.02.2017;2017;02;13;Tiistai;4;0;4
93;14.02.2017;2017;02;14;Tiistai;4;4;8
93;14.02.2017;2017;02;15;Tiistai;5;4;9
93;14.02.2017;2017;02;16;Tiistai;11;4;15
93;14.02.2017;2017;02;17;Tiistai;7;4;11
93;14.02.2017;2017;02;18;Tiistai;4;6;10
93;14.02.2017;2017;02;19;Tiistai;5;2;7
93;14.02.2017;2017;02;20;Tiistai;4;2;6
93;14.02.2017;2017;02;21;Tiistai;1;0;1
93;14.02.2017;2017;02;22;Tiistai;0;0;0
93;14.02.2017;2017;02;23;Tiistai;0;1;1
93;15.02.2017;2017;02;00;Keskiviikko;0;0;0
93;15.02.2017;2017;02;01;Keskiviikko;0;0;0
93;15.02.2017;2017;02;02;Keskiviikko;0;0;0
93;15.02.2017;2017;02;03;Keskiviikko;0;0;0
93;15.02.2017;2017;02;04;Keskiviikko;0;0;0
93;15.02.2017;2017;02;05;Keskiviikko;2;3;5
93;15.02.2017;2017;02;06;Keskiviikko;2;8;10
93;15.02.2017;2017;02;07;Keskiviikko;8;17;25
93;15.02.2017;2017;02;08;Keskiviikko;4;3;7
93;15.02.2017;2017;02;09;Keskiviikko;1;0;1
93;15.02.2017;2017;02;10;Keskiviikko;3;1;4
93;15.02.2017;2017;02;11;Keskiviikko;3;1;4
93;15.02.2017;2017;02;12;Keskiviikko;3;1;4
93;15.02.2017;2017;02;13;Keskiviikko;1;0;1
93;15.02.2017;2017;02;14;Keskiviikko;5;1;6
93;15.02.2017;2017;02;15;Keskiviikko;6;4;10
93;15.02.2017;2017;02;16;Keskiviikko;12;9;21
93;15.02.2017;2017;02;17;Keskiviikko;7;3;10
93;15.02.2017;2017;02;18;Keskiviikko;7;6;13
93;15.02.2017;2017;02;19;Keskiviikko;3;0;3
93;15.02.2017;2017;02;20;Keskiviikko;1;2;3
93;15.02.2017;2017;02;21;Keskiviikko;0;1;1
93;15.02.2017;2017;02;22;Keskiviikko;1;0;1
93;15.02.2017;2017;02;23;Keskiviikko;0;0;0
93;16.02.2017;2017;02;00;Torstai;0;0;0
93;16.02.2017;2017;02;01;Torstai;0;0;0
93;16.02.2017;2017;02;02;Torstai;0;0;0
93;16.02.2017;2017;02;03;Torstai;0;0;0
93;16.02.2017;2017;02;04;Torstai;0;0;0
93;16.02.2017;2017;02;05;Torstai;5;1;6
93;16.02.2017;2017;02;06;Torstai;3;6;9
93;16.02.2017;2017;02;07;Torstai;8;11;19
93;16.02.2017;2017;02;08;Torstai;6;14;20
93;16.02.2017;2017;02;09;Torstai;4;1;5
93;16.02.2017;2017;02;10;Torstai;6;2;8
93;16.02.2017;2017;02;11;Torstai;2;0;2
93;16.02.2017;2017;02;12;Torstai;3;4;7
93;16.02.2017;2017;02;13;Torstai;2;3;5
93;16.02.2017;2017;02;14;Torstai;3;5;8
93;16.02.2017;2017;02;15;Torstai;9;4;13
93;16.02.2017;2017;02;16;Torstai;17;8;25
93;16.02.2017;2017;02;17;Torstai;11;4;15
93;16.02.2017;2017;02;18;Torstai;6;4;10
93;16.02.2017;2017;02;19;Torstai;4;3;7
93;16.02.2017;2017;02;20;Torstai;1;2;3
93;16.02.2017;2017;02;21;Torstai;3;0;3
93;16.02.2017;2017;02;22;Torstai;1;1;2
93;16.02.2017;2017;02;23;Torstai;0;0;0
93;17.02.2017;2017;02;00;Perjantai;0;0;0
93;17.02.2017;2017;02;01;Perjantai;0;0;0
93;17.02.2017;2017;02;02;Perjantai;0;0;0
93;17.02.2017;2017;02;03;Perjantai;0;0;0
93;17.02.2017;2017;02;04;Perjantai;0;0;0
93;17.02.2017;2017;02;05;Perjantai;2;2;4
93;17.02.2017;2017;02;06;Perjantai;4;7;11
93;17.02.2017;2017;02;07;Perjantai;4;13;17
93;17.02.2017;2017;02;08;Perjantai;0;10;10
93;17.02.2017;2017;02;09;Perjantai;0;5;5
93;17.02.2017;2017;02;10;Perjantai;1;0;1
93;17.02.2017;2017;02;11;Perjantai;1;2;3
93;17.02.2017;2017;02;12;Perjantai;2;1;3
93;17.02.2017;2017;02;13;Perjantai;4;2;6
93;17.02.2017;2017;02;14;Perjantai;6;3;9
93;17.02.2017;2017;02;15;Perjantai;16;6;22
93;17.02.2017;2017;02;16;Perjantai;14;4;18
93;17.02.2017;2017;02;17;Perjantai;12;1;13
93;17.02.2017;2017;02;18;Perjantai;2;3;5
93;17.02.2017;2017;02;19;Perjantai;5;2;7
93;17.02.2017;2017;02;20;Perjantai;4;3;7
93;17.02.2017;2017;02;21;Perjantai;0;1;1
93;17.02.2017;2017;02;22;Perjantai;0;0;0
93;17.02.2017;2017;02;23;Perjantai;0;1;1
93;18.02.2017;2017;02;00;Lauantai;1;0;1
93;18.02.2017;2017;02;01;Lauantai;0;0;0
93;18.02.2017;2017;02;02;Lauantai;0;0;0
93;18.02.2017;2017;02;03;Lauantai;0;1;1
93;18.02.2017;2017;02;04;Lauantai;0;0;0
93;18.02.2017;2017;02;05;Lauantai;0;0;0
93;18.02.2017;2017;02;06;Lauantai;0;1;1
93;18.02.2017;2017;02;07;Lauantai;0;0;0
93;18.02.2017;2017;02;08;Lauantai;0;0;0
93;18.02.2017;2017;02;09;Lauantai;0;0;0
93;18.02.2017;2017;02;10;Lauantai;2;2;4
93;18.02.2017;2017;02;11;Lauantai;5;0;5
93;18.02.2017;2017;02;12;Lauantai;5;2;7
93;18.02.2017;2017;02;13;Lauantai;2;5;7
93;18.02.2017;2017;02;14;Lauantai;3;0;3
93;18.02.2017;2017;02;15;Lauantai;5;3;8
93;18.02.2017;2017;02;16;Lauantai;1;0;1
93;18.02.2017;2017;02;17;Lauantai;10;1;11
93;18.02.2017;2017;02;18;Lauantai;1;0;1
93;18.02.2017;2017;02;19;Lauantai;2;2;4
93;18.02.2017;2017;02;20;Lauantai;2;1;3
93;18.02.2017;2017;02;21;Lauantai;0;1;1
93;18.02.2017;2017;02;22;Lauantai;0;0;0
93;18.02.2017;2017;02;23;Lauantai;3;0;3
93;19.02.2017;2017;02;00;Sunnuntai;0;1;1
93;19.02.2017;2017;02;01;Sunnuntai;0;0;0
93;19.02.2017;2017;02;02;Sunnuntai;0;0;0
93;19.02.2017;2017;02;03;Sunnuntai;0;0;0
93;19.02.2017;2017;02;04;Sunnuntai;0;0;0
93;19.02.2017;2017;02;05;Sunnuntai;0;0;0
93;19.02.2017;2017;02;06;Sunnuntai;0;0;0
93;19.02.2017;2017;02;07;Sunnuntai;2;0;2
93;19.02.2017;2017;02;08;Sunnuntai;0;0;0
93;19.02.2017;2017;02;09;Sunnuntai;1;0;1
93;19.02.2017;2017;02;10;Sunnuntai;6;2;8
93;19.02.2017;2017;02;11;Sunnuntai;3;2;5
93;19.02.2017;2017;02;12;Sunnuntai;7;2;9
93;19.02.2017;2017;02;13;Sunnuntai;4;4;8
93;19.02.2017;2017;02;14;Sunnuntai;2;2;4
93;19.02.2017;2017;02;15;Sunnuntai;4;6;10
93;19.02.2017;2017;02;16;Sunnuntai;2;1;3
93;19.02.2017;2017;02;17;Sunnuntai;3;4;7
93;19.02.2017;2017;02;18;Sunnuntai;1;0;1
93;19.02.2017;2017;02;19;Sunnuntai;1;0;1
93;19.02.2017;2017;02;20;Sunnuntai;1;0;1
93;19.02.2017;2017;02;21;Sunnuntai;0;1;1
93;19.02.2017;2017;02;22;Sunnuntai;0;0;0
93;19.02.2017;2017;02;23;Sunnuntai;1;1;2
93;20.02.2017;2017;02;00;Maanantai;0;0;0
93;20.02.2017;2017;02;01;Maanantai;0;0;0
93;20.02.2017;2017;02;02;Maanantai;0;0;0
93;20.02.2017;2017;02;03;Maanantai;0;0;0
93;20.02.2017;2017;02;04;Maanantai;0;0;0
93;20.02.2017;2017;02;05;Maanantai;1;0;1
93;20.02.2017;2017;02;06;Maanantai;4;4;8
93;20.02.2017;2017;02;07;Maanantai;4;7;11
93;20.02.2017;2017;02;08;Maanantai;6;13;19
93;20.02.2017;2017;02;09;Maanantai;3;0;3
93;20.02.2017;2017;02;10;Maanantai;2;1;3
93;20.02.2017;2017;02;11;Maanantai;3;1;4
93;20.02.2017;2017;02;12;Maanantai;0;1;1
93;20.02.2017;2017;02;13;Maanantai;4;5;9
93;20.02.2017;2017;02;14;Maanantai;2;3;5
93;20.02.2017;2017;02;15;Maanantai;13;3;16
93;20.02.2017;2017;02;16;Maanantai;15;3;18
93;20.02.2017;2017;02;17;Maanantai;5;3;8
93;20.02.2017;2017;02;18;Maanantai;6;2;8
93;20.02.2017;2017;02;19;Maanantai;2;3;5
93;20.02.2017;2017;02;20;Maanantai;0;3;3
93;20.02.2017;2017;02;21;Maanantai;0;2;2
93;20.02.2017;2017;02;22;Maanantai;0;1;1
93;20.02.2017;2017;02;23;Maanantai;0;0;0
93;21.02.2017;2017;02;00;Tiistai;0;0;0
93;21.02.2017;2017;02;01;Tiistai;0;0;0
93;21.02.2017;2017;02;02;Tiistai;0;0;0
93;21.02.2017;2017;02;03;Tiistai;0;0;0
93;21.02.2017;2017;02;04;Tiistai;0;0;0
93;21.02.2017;2017;02;05;Tiistai;2;1;3
93;21.02.2017;2017;02;06;Tiistai;4;4;8
93;21.02.2017;2017;02;07;Tiistai;5;11;16
93;21.02.2017;2017;02;08;Tiistai;2;10;12
93;21.02.2017;2017;02;09;Tiistai;1;1;2
93;21.02.2017;2017;02;10;Tiistai;0;0;0
93;21.02.2017;2017;02;11;Tiistai;2;0;2
93;21.02.2017;2017;02;12;Tiistai;2;1;3
93;21.02.2017;2017;02;13;Tiistai;8;2;10
93;21.02.2017;2017;02;14;Tiistai;3;0;3
93;21.02.2017;2017;02;15;Tiistai;11;7;18
93;21.02.2017;2017;02;16;Tiistai;17;7;24
93;21.02.2017;2017;02;17;Tiistai;9;2;11
93;21.02.2017;2017;02;18;Tiistai;3;2;5
93;21.02.2017;2017;02;19;Tiistai;1;2;3
93;21.02.2017;2017;02;20;Tiistai;0;3;3
93;21.02.2017;2017;02;21;Tiistai;0;0;0
93;21.02.2017;2017;02;22;Tiistai;0;1;1
93;21.02.2017;2017;02;23;Tiistai;0;0;0
93;22.02.2017;2017;02;00;Keskiviikko;0;0;0
93;22.02.2017;2017;02;01;Keskiviikko;0;1;1
93;22.02.2017;2017;02;02;Keskiviikko;0;0;0
93;22.02.2017;2017;02;03;Keskiviikko;0;0;0
93;22.02.2017;2017;02;04;Keskiviikko;0;0;0
93;22.02.2017;2017;02;05;Keskiviikko;1;0;1
93;22.02.2017;2017;02;06;Keskiviikko;3;3;6
93;22.02.2017;2017;02;07;Keskiviikko;6;10;16
93;22.02.2017;2017;02;08;Keskiviikko;3;11;14
93;22.02.2017;2017;02;09;Keskiviikko;1;0;1
93;22.02.2017;2017;02;10;Keskiviikko;2;0;2
93;22.02.2017;2017;02;11;Keskiviikko;2;1;3
93;22.02.2017;2017;02;12;Keskiviikko;4;0;4
93;22.02.2017;2017;02;13;Keskiviikko;1;1;2
93;22.02.2017;2017;02;14;Keskiviikko;5;1;6
93;22.02.2017;2017;02;15;Keskiviikko;2;5;7
93;22.02.2017;2017;02;16;Keskiviikko;16;5;21
93;22.02.2017;2017;02;17;Keskiviikko;14;10;24
93;22.02.2017;2017;02;18;Keskiviikko;2;2;4
93;22.02.2017;2017;02;19;Keskiviikko;2;1;3
93;22.02.2017;2017;02;20;Keskiviikko;3;1;4
93;22.02.2017;2017;02;21;Keskiviikko;0;1;1
93;22.02.2017;2017;02;22;Keskiviikko;0;0;0
93;22.02.2017;2017;02;23;Keskiviikko;0;0;0
93;23.02.2017;2017;02;00;Torstai;0;1;1
93;23.02.2017;2017;02;01;Torstai;0;0;0
93;23.02.2017;2017;02;02;Torstai;0;0;0
93;23.02.2017;2017;02;03;Torstai;0;0;0
93;23.02.2017;2017;02;04;Torstai;0;0;0
93;23.02.2017;2017;02;05;Torstai;1;0;1
93;23.02.2017;2017;02;06;Torstai;1;4;5
93;23.02.2017;2017;02;07;Torstai;5;4;9
93;23.02.2017;2017;02;08;Torstai;3;8;11
93;23.02.2017;2017;02;09;Torstai;1;1;2
93;23.02.2017;2017;02;10;Torstai;1;1;2
93;23.02.2017;2017;02;11;Torstai;3;0;3
93;23.02.2017;2017;02;12;Torstai;1;0;1
93;23.02.2017;2017;02;13;Torstai;3;1;4
93;23.02.2017;2017;02;14;Torstai;2;2;4
93;23.02.2017;2017;02;15;Torstai;7;1;8
93;23.02.2017;2017;02;16;Torstai;3;2;5
93;23.02.2017;2017;02;17;Torstai;16;6;22
93;23.02.2017;2017;02;18;Torstai;3;0;3
93;23.02.2017;2017;02;19;Torstai;2;1;3
93;23.02.2017;2017;02;20;Torstai;0;3;3
93;23.02.2017;2017;02;21;Torstai;0;0;0
93;23.02.2017;2017;02;22;Torstai;0;2;2
93;23.02.2017;2017;02;23;Torstai;0;1;1
93;24.02.2017;2017;02;00;Perjantai;0;1;1
93;24.02.2017;2017;02;01;Perjantai;0;0;0
93;24.02.2017;2017;02;02;Perjantai;0;0;0
93;24.02.2017;2017;02;03;Perjantai;0;0;0
93;24.02.2017;2017;02;04;Perjantai;0;0;0
93;24.02.2017;2017;02;05;Perjantai;0;1;1
93;24.02.2017;2017;02;06;Perjantai;3;4;7
93;24.02.2017;2017;02;07;Perjantai;2;6;8
93;24.02.2017;2017;02;08;Perjantai;6;10;16
93;24.02.2017;2017;02;09;Perjantai;0;1;1
93;24.02.2017;2017;02;10;Perjantai;0;3;3
93;24.02.2017;2017;02;11;Perjantai;1;0;1
93;24.02.2017;2017;02;12;Perjantai;3;1;4
93;24.02.2017;2017;02;13;Perjantai;6;2;8
93;24.02.2017;2017;02;14;Perjantai;3;1;4
93;24.02.2017;2017;02;15;Perjantai;7;6;13
93;24.02.2017;2017;02;16;Perjantai;11;5;16
93;24.02.2017;2017;02;17;Perjantai;5;3;8
93;24.02.2017;2017;02;18;Perjantai;1;0;1
93;24.02.2017;2017;02;19;Perjantai;6;2;8
93;24.02.2017;2017;02;20;Perjantai;0;4;4
93;24.02.2017;2017;02;21;Perjantai;2;2;4
93;24.02.2017;2017;02;22;Perjantai;0;2;2
93;24.02.2017;2017;02;23;Perjantai;0;1;1
93;25.02.2017;2017;02;00;Lauantai;0;0;0
93;25.02.2017;2017;02;01;Lauantai;0;0;0
93;25.02.2017;2017;02;02;Lauantai;0;0;0
93;25.02.2017;2017;02;03;Lauantai;0;0;0
93;25.02.2017;2017;02;04;Lauantai;0;0;0
93;25.02.2017;2017;02;05;Lauantai;0;0;0
93;25.02.2017;2017;02;06;Lauantai;2;0;2
93;25.02.2017;2017;02;07;Lauantai;0;0;0
93;25.02.2017;2017;02;08;Lauantai;1;2;3
93;25.02.2017;2017;02;09;Lauantai;4;0;4
93;25.02.2017;2017;02;10;Lauantai;1;1;2
93;25.02.2017;2017;02;11;Lauantai;3;2;5
93;25.02.2017;2017;02;12;Lauantai;4;3;7
93;25.02.2017;2017;02;13;Lauantai;0;3;3
93;25.02.2017;2017;02;14;Lauantai;2;4;6
93;25.02.2017;2017;02;15;Lauantai;2;5;7
93;25.02.2017;2017;02;16;Lauantai;2;0;2
93;25.02.2017;2017;02;17;Lauantai;1;0;1
93;25.02.2017;2017;02;18;Lauantai;1;0;1
93;25.02.2017;2017;02;19;Lauantai;0;4;4
93;25.02.2017;2017;02;20;Lauantai;0;0;0
93;25.02.2017;2017;02;21;Lauantai;0;0;0
93;25.02.2017;2017;02;22;Lauantai;2;0;2
93;25.02.2017;2017;02;23;Lauantai;1;0;1
93;26.02.2017;2017;02;00;Sunnuntai;0;0;0
93;26.02.2017;2017;02;01;Sunnuntai;0;0;0
93;26.02.2017;2017;02;02;Sunnuntai;0;0;0
93;26.02.2017;2017;02;03;Sunnuntai;0;0;0
93;26.02.2017;2017;02;04;Sunnuntai;0;0;0
93;26.02.2017;2017;02;05;Sunnuntai;1;0;1
93;26.02.2017;2017;02;06;Sunnuntai;1;0;1
93;26.02.2017;2017;02;07;Sunnuntai;1;0;1
93;26.02.2017;2017;02;08;Sunnuntai;0;0;0
93;26.02.2017;2017;02;09;Sunnuntai;4;0;4
93;26.02.2017;2017;02;10;Sunnuntai;2;1;3
93;26.02.2017;2017;02;11;Sunnuntai;0;0;0
93;26.02.2017;2017;02;12;Sunnuntai;3;1;4
93;26.02.2017;2017;02;13;Sunnuntai;1;6;7
93;26.02.2017;2017;02;14;Sunnuntai;5;4;9
93;26.02.2017;2017;02;15;Sunnuntai;2;5;7
93;26.02.2017;2017;02;16;Sunnuntai;4;1;5
93;26.02.2017;2017;02;17;Sunnuntai;1;1;2
93;26.02.2017;2017;02;18;Sunnuntai;0;0;0
93;26.02.2017;2017;02;19;Sunnuntai;0;1;1
93;26.02.2017;2017;02;20;Sunnuntai;2;1;3
93;26.02.2017;2017;02;21;Sunnuntai;0;0;0
93;26.02.2017;2017;02;22;Sunnuntai;0;0;0
93;26.02.2017;2017;02;23;Sunnuntai;1;0;1
93;27.02.2017;2017;02;00;Maanantai;0;0;0
93;27.02.2017;2017;02;01;Maanantai;0;0;0
93;27.02.2017;2017;02;02;Maanantai;0;0;0
93;27.02.2017;2017;02;03;Maanantai;0;0;0
93;27.02.2017;2017;02;04;Maanantai;0;0;0
93;27.02.2017;2017;02;05;Maanantai;0;1;1
93;27.02.2017;2017;02;06;Maanantai;3;4;7
93;27.02.2017;2017;02;07;Maanantai;6;4;10
93;27.02.2017;2017;02;08;Maanantai;2;5;7
93;27.02.2017;2017;02;09;Maanantai;1;0;1
93;27.02.2017;2017;02;10;Maanantai;0;0;0
93;27.02.2017;2017;02;11;Maanantai;0;1;1
93;27.02.2017;2017;02;12;Maanantai;1;0;1
93;27.02.2017;2017;02;13;Maanantai;5;2;7
93;27.02.2017;2017;02;14;Maanantai;2;1;3
93;27.02.2017;2017;02;15;Maanantai;7;6;13
93;27.02.2017;2017;02;16;Maanantai;6;5;11
93;27.02.2017;2017;02;17;Maanantai;5;3;8
93;27.02.2017;2017;02;18;Maanantai;2;3;5
93;27.02.2017;2017;02;19;Maanantai;0;0;0
93;27.02.2017;2017;02;20;Maanantai;0;0;0
93;27.02.2017;2017;02;21;Maanantai;0;3;3
93;27.02.2017;2017;02;22;Maanantai;0;1;1
93;27.02.2017;2017;02;23;Maanantai;0;0;0
93;28.02.2017;2017;02;00;Tiistai;0;0;0
93;28.02.2017;2017;02;01;Tiistai;0;0;0
93;28.02.2017;2017;02;02;Tiistai;0;0;0
93;28.02.2017;2017;02;03;Tiistai;0;0;0
93;28.02.2017;2017;02;04;Tiistai;1;0;1
93;28.02.2017;2017;02;05;Tiistai;1;2;3
93;28.02.2017;2017;02;06;Tiistai;9;7;16
93;28.02.2017;2017;02;07;Tiistai;6;12;18
93;28.02.2017;2017;02;08;Tiistai;8;9;17
93;28.02.2017;2017;02;09;Tiistai;4;3;7
93;28.02.2017;2017;02;10;Tiistai;1;1;2
93;28.02.2017;2017;02;11;Tiistai;2;1;3
93;28.02.2017;2017;02;12;Tiistai;0;3;3
93;28.02.2017;2017;02;13;Tiistai;4;1;5
93;28.02.2017;2017;02;14;Tiistai;5;3;8
93;28.02.2017;2017;02;15;Tiistai;10;5;15
93;28.02.2017;2017;02;16;Tiistai;10;10;20
93;28.02.2017;2017;02;17;Tiistai;11;2;13
93;28.02.2017;2017;02;18;Tiistai;2;5;7
93;28.02.2017;2017;02;19;Tiistai;2;3;5
93;28.02.2017;2017;02;20;Tiistai;4;3;7
93;28.02.2017;2017;02;21;Tiistai;0;3;3
93;28.02.2017;2017;02;22;Tiistai;0;1;1
93;28.02.2017;2017;02;23;Tiistai;0;1;1
93;01.03.2017;2017;03;00;Keskiviikko;0;0;0
93;01.03.2017;2017;03;01;Keskiviikko;0;0;0
93;01.03.2017;2017;03;02;Keskiviikko;0;0;0
93;01.03.2017;2017;03;03;Keskiviikko;0;0;0
93;01.03.2017;2017;03;04;Keskiviikko;0;0;0
93;01.03.2017;2017;03;05;Keskiviikko;2;2;4
93;01.03.2017;2017;03;06;Keskiviikko;3;4;7
93;01.03.2017;2017;03;07;Keskiviikko;11;9;20
93;01.03.2017;2017;03;08;Keskiviikko;2;8;10
93;01.03.2017;2017;03;09;Keskiviikko;3;2;5
93;01.03.2017;2017;03;10;Keskiviikko;1;0;1
93;01.03.2017;2017;03;11;Keskiviikko;1;0;1
93;01.03.2017;2017;03;12;Keskiviikko;2;1;3
93;01.03.2017;2017;03;13;Keskiviikko;2;2;4
93;01.03.2017;2017;03;14;Keskiviikko;2;2;4
93;01.03.2017;2017;03;15;Keskiviikko;6;3;9
93;01.03.2017;2017;03;16;Keskiviikko;9;4;13
93;01.03.2017;2017;03;17;Keskiviikko;10;5;15
93;01.03.2017;2017;03;18;Keskiviikko;0;4;4
93;01.03.2017;2017;03;19;Keskiviikko;0;2;2
93;01.03.2017;2017;03;20;Keskiviikko;1;1;2
93;01.03.2017;2017;03;21;Keskiviikko;1;1;2
93;01.03.2017;2017;03;22;Keskiviikko;0;1;1
93;01.03.2017;2017;03;23;Keskiviikko;0;0;0
93;02.03.2017;2017;03;00;Torstai;0;0;0
93;02.03.2017;2017;03;01;Torstai;0;0;0
93;02.03.2017;2017;03;02;Torstai;0;0;0
93;02.03.2017;2017;03;03;Torstai;0;0;0
93;02.03.2017;2017;03;04;Torstai;2;0;2
93;02.03.2017;2017;03;05;Torstai;2;0;2
93;02.03.2017;2017;03;06;Torstai;5;4;9
93;02.03.2017;2017;03;07;Torstai;4;12;16
93;02.03.2017;2017;03;08;Torstai;2;5;7
93;02.03.2017;2017;03;09;Torstai;2;3;5
93;02.03.2017;2017;03;10;Torstai;7;0;7
93;02.03.2017;2017;03;11;Torstai;3;1;4
93;02.03.2017;2017;03;12;Torstai;5;2;7
93;02.03.2017;2017;03;13;Torstai;3;1;4
93;02.03.2017;2017;03;14;Torstai;3;2;5
93;02.03.2017;2017;03;15;Torstai;9;4;13
93;02.03.2017;2017;03;16;Torstai;9;5;14
93;02.03.2017;2017;03;17;Torstai;5;1;6
93;02.03.2017;2017;03;18;Torstai;0;1;1
93;02.03.2017;2017;03;19;Torstai;1;2;3
93;02.03.2017;2017;03;20;Torstai;1;3;4
93;02.03.2017;2017;03;21;Torstai;0;0;0
93;02.03.2017;2017;03;22;Torstai;1;1;2
93;02.03.2017;2017;03;23;Torstai;0;1;1
93;03.03.2017;2017;03;00;Perjantai;0;0;0
93;03.03.2017;2017;03;01;Perjantai;0;0;0
93;03.03.2017;2017;03;02;Perjantai;0;0;0
93;03.03.2017;2017;03;03;Perjantai;0;0;0
93;03.03.2017;2017;03;04;Perjantai;0;0;0
93;03.03.2017;2017;03;05;Perjantai;0;1;1
93;03.03.2017;2017;03;06;Perjantai;3;1;4
93;03.03.2017;2017;03;07;Perjantai;1;9;10
93;03.03.2017;2017;03;08;Perjantai;1;14;15
93;03.03.2017;2017;03;09;Perjantai;1;1;2
93;03.03.2017;2017;03;10;Perjantai;2;1;3
93;03.03.2017;2017;03;11;Perjantai;4;1;5
93;03.03.2017;2017;03;12;Perjantai;2;1;3
93;03.03.2017;2017;03;13;Perjantai;4;1;5
93;03.03.2017;2017;03;14;Perjantai;1;3;4
93;03.03.2017;2017;03;15;Perjantai;5;5;10
93;03.03.2017;2017;03;16;Perjantai;15;4;19
93;03.03.2017;2017;03;17;Perjantai;4;0;4
93;03.03.2017;2017;03;18;Perjantai;2;5;7
93;03.03.2017;2017;03;19;Perjantai;1;0;1
93;03.03.2017;2017;03;20;Perjantai;0;3;3
93;03.03.2017;2017;03;21;Perjantai;0;2;2
93;03.03.2017;2017;03;22;Perjantai;0;0;0
93;03.03.2017;2017;03;23;Perjantai;1;0;1
93;04.03.2017;2017;03;00;Lauantai;0;0;0
93;04.03.2017;2017;03;01;Lauantai;0;0;0
93;04.03.2017;2017;03;02;Lauantai;0;0;0
93;04.03.2017;2017;03;03;Lauantai;0;1;1
93;04.03.2017;2017;03;04;Lauantai;0;0;0
93;04.03.2017;2017;03;05;Lauantai;0;0;0
93;04.03.2017;2017;03;06;Lauantai;0;0;0
93;04.03.2017;2017;03;07;Lauantai;0;0;0
93;04.03.2017;2017;03;08;Lauantai;0;1;1
93;04.03.2017;2017;03;09;Lauantai;0;2;2
93;04.03.2017;2017;03;10;Lauantai;2;4;6
93;04.03.2017;2017;03;11;Lauantai;4;3;7
93;04.03.2017;2017;03;12;Lauantai;1;2;3
93;04.03.2017;2017;03;13;Lauantai;4;2;6
93;04.03.2017;2017;03;14;Lauantai;5;4;9
93;04.03.2017;2017;03;15;Lauantai;0;5;5
93;04.03.2017;2017;03;16;Lauantai;3;1;4
93;04.03.2017;2017;03;17;Lauantai;1;2;3
93;04.03.2017;2017;03;18;Lauantai;3;0;3
93;04.03.2017;2017;03;19;Lauantai;1;3;4
93;04.03.2017;2017;03;20;Lauantai;0;1;1
93;04.03.2017;2017;03;21;Lauantai;1;1;2
93;04.03.2017;2017;03;22;Lauantai;0;0;0
93;04.03.2017;2017;03;23;Lauantai;0;0;0
93;05.03.2017;2017;03;00;Sunnuntai;0;1;1
93;05.03.2017;2017;03;01;Sunnuntai;0;0;0
93;05.03.2017;2017;03;02;Sunnuntai;0;0;0
93;05.03.2017;2017;03;03;Sunnuntai;0;0;0
93;05.03.2017;2017;03;04;Sunnuntai;0;0;0
93;05.03.2017;2017;03;05;Sunnuntai;1;0;1
93;05.03.2017;2017;03;06;Sunnuntai;0;0;0
93;05.03.2017;2017;03;07;Sunnuntai;0;0;0
93;05.03.2017;2017;03;08;Sunnuntai;0;1;1
93;05.03.2017;2017;03;09;Sunnuntai;0;1;1
93;05.03.2017;2017;03;10;Sunnuntai;0;0;0
93;05.03.2017;2017;03;11;Sunnuntai;1;1;2
93;05.03.2017;2017;03;12;Sunnuntai;4;1;5
93;05.03.2017;2017;03;13;Sunnuntai;5;4;9
93;05.03.2017;2017;03;14;Sunnuntai;0;4;4
93;05.03.2017;2017;03;15;Sunnuntai;0;1;1
93;05.03.2017;2017;03;16;Sunnuntai;3;0;3
93;05.03.2017;2017;03;17;Sunnuntai;2;1;3
93;05.03.2017;2017;03;18;Sunnuntai;2;1;3
93;05.03.2017;2017;03;19;Sunnuntai;0;0;0
93;05.03.2017;2017;03;20;Sunnuntai;1;1;2
93;05.03.2017;2017;03;21;Sunnuntai;0;0;0
93;05.03.2017;2017;03;22;Sunnuntai;0;0;0
93;05.03.2017;2017;03;23;Sunnuntai;0;0;0
93;06.03.2017;2017;03;00;Maanantai;0;0;0
93;06.03.2017;2017;03;01;Maanantai;1;0;1
93;06.03.2017;2017;03;02;Maanantai;0;0;0
93;06.03.2017;2017;03;03;Maanantai;0;0;0
93;06.03.2017;2017;03;04;Maanantai;0;0;0
93;06.03.2017;2017;03;05;Maanantai;1;1;2
93;06.03.2017;2017;03;06;Maanantai;2;4;6
93;06.03.2017;2017;03;07;Maanantai;5;7;12
93;06.03.2017;2017;03;08;Maanantai;4;4;8
93;06.03.2017;2017;03;09;Maanantai;0;2;2
93;06.03.2017;2017;03;10;Maanantai;1;1;2
93;06.03.2017;2017;03;11;Maanantai;0;2;2
93;06.03.2017;2017;03;12;Maanantai;1;4;5
93;06.03.2017;2017;03;13;Maanantai;3;4;7
93;06.03.2017;2017;03;14;Maanantai;5;2;7
93;06.03.2017;2017;03;15;Maanantai;4;3;7
93;06.03.2017;2017;03;16;Maanantai;8;4;12
93;06.03.2017;2017;03;17;Maanantai;6;5;11
93;06.03.2017;2017;03;18;Maanantai;3;2;5
93;06.03.2017;2017;03;19;Maanantai;0;0;0
93;06.03.2017;2017;03;20;Maanantai;0;0;0
93;06.03.2017;2017;03;21;Maanantai;0;1;1
93;06.03.2017;2017;03;22;Maanantai;1;0;1
93;06.03.2017;2017;03;23;Maanantai;0;0;0
93;07.03.2017;2017;03;00;Tiistai;1;0;1
93;07.03.2017;2017;03;01;Tiistai;0;0;0
93;07.03.2017;2017;03;02;Tiistai;0;0;0
93;07.03.2017;2017;03;03;Tiistai;0;0;0
93;07.03.2017;2017;03;04;Tiistai;0;0;0
93;07.03.2017;2017;03;05;Tiistai;0;0;0
93;07.03.2017;2017;03;06;Tiistai;3;5;8
93;07.03.2017;2017;03;07;Tiistai;2;5;7
93;07.03.2017;2017;03;08;Tiistai;2;6;8
93;07.03.2017;2017;03;09;Tiistai;0;0;0
93;07.03.2017;2017;03;10;Tiistai;1;0;1
93;07.03.2017;2017;03;11;Tiistai;3;3;6
93;07.03.2017;2017;03;12;Tiistai;2;1;3
93;07.03.2017;2017;03;13;Tiistai;6;2;8
93;07.03.2017;2017;03;14;Tiistai;4;3;7
93;07.03.2017;2017;03;15;Tiistai;5;4;9
93;07.03.2017;2017;03;16;Tiistai;6;2;8
93;07.03.2017;2017;03;17;Tiistai;7;3;10
93;07.03.2017;2017;03;18;Tiistai;1;2;3
93;07.03.2017;2017;03;19;Tiistai;2;1;3
93;07.03.2017;2017;03;20;Tiistai;1;2;3
93;07.03.2017;2017;03;21;Tiistai;0;0;0
93;07.03.2017;2017;03;22;Tiistai;1;1;2
93;07.03.2017;2017;03;23;Tiistai;0;0;0
93;08.03.2017;2017;03;00;Keskiviikko;1;0;1
93;08.03.2017;2017;03;01;Keskiviikko;0;0;0
93;08.03.2017;2017;03;02;Keskiviikko;0;0;0
93;08.03.2017;2017;03;03;Keskiviikko;0;0;0
93;08.03.2017;2017;03;04;Keskiviikko;0;0;0
93;08.03.2017;2017;03;05;Keskiviikko;0;2;2
93;08.03.2017;2017;03;06;Keskiviikko;4;2;6
93;08.03.2017;2017;03;07;Keskiviikko;4;6;10
93;08.03.2017;2017;03;08;Keskiviikko;3;5;8
93;08.03.2017;2017;03;09;Keskiviikko;1;1;2
93;08.03.2017;2017;03;10;Keskiviikko;0;2;2
93;08.03.2017;2017;03;11;Keskiviikko;2;0;2
93;08.03.2017;2017;03;12;Keskiviikko;2;3;5
93;08.03.2017;2017;03;13;Keskiviikko;6;0;6
93;08.03.2017;2017;03;14;Keskiviikko;1;3;4
93;08.03.2017;2017;03;15;Keskiviikko;3;1;4
93;08.03.2017;2017;03;16;Keskiviikko;6;6;12
93;08.03.2017;2017;03;17;Keskiviikko;7;6;13
93;08.03.2017;2017;03;18;Keskiviikko;4;3;7
93;08.03.2017;2017;03;19;Keskiviikko;1;0;1
93;08.03.2017;2017;03;20;Keskiviikko;0;2;2
93;08.03.2017;2017;03;21;Keskiviikko;0;1;1
93;08.03.2017;2017;03;22;Keskiviikko;1;0;1
93;08.03.2017;2017;03;23;Keskiviikko;0;0;0
93;09.03.2017;2017;03;00;Torstai;0;0;0
93;09.03.2017;2017;03;01;Torstai;0;0;0
93;09.03.2017;2017;03;02;Torstai;0;0;0
93;09.03.2017;2017;03;03;Torstai;0;0;0
93;09.03.2017;2017;03;04;Torstai;0;0;0
93;09.03.2017;2017;03;05;Torstai;2;2;4
93;09.03.2017;2017;03;06;Torstai;6;1;7
93;09.03.2017;2017;03;07;Torstai;3;4;7
93;09.03.2017;2017;03;08;Torstai;3;2;5
93;09.03.2017;2017;03;09;Torstai;2;2;4
93;09.03.2017;2017;03;10;Torstai;0;0;0
93;09.03.2017;2017;03;11;Torstai;1;0;1
93;09.03.2017;2017;03;12;Torstai;1;1;2
93;09.03.2017;2017;03;13;Torstai;7;3;10
93;09.03.2017;2017;03;14;Torstai;3;1;4
93;09.03.2017;2017;03;15;Torstai;6;5;11
93;09.03.2017;2017;03;16;Torstai;11;5;16
93;09.03.2017;2017;03;17;Torstai;5;3;8
93;09.03.2017;2017;03;18;Torstai;0;1;1
93;09.03.2017;2017;03;19;Torstai;3;1;4
93;09.03.2017;2017;03;20;Torstai;0;1;1
93;09.03.2017;2017;03;21;Torstai;1;0;1
93;09.03.2017;2017;03;22;Torstai;0;1;1
93;09.03.2017;2017;03;23;Torstai;0;1;1
93;10.03.2017;2017;03;00;Perjantai;0;0;0
93;10.03.2017;2017;03;01;Perjantai;0;0;0
93;10.03.2017;2017;03;02;Perjantai;0;0;0
93;10.03.2017;2017;03;03;Perjantai;0;0;0
93;10.03.2017;2017;03;04;Perjantai;0;0;0
93;10.03.2017;2017;03;05;Perjantai;0;2;2
93;10.03.2017;2017;03;06;Perjantai;2;2;4
93;10.03.2017;2017;03;07;Perjantai;2;7;9
93;10.03.2017;2017;03;08;Perjantai;1;2;3
93;10.03.2017;2017;03;09;Perjantai;1;0;1
93;10.03.2017;2017;03;10;Perjantai;1;0;1
93;10.03.2017;2017;03;11;Perjantai;1;0;1
93;10.03.2017;2017;03;12;Perjantai;0;0;0
93;10.03.2017;2017;03;13;Perjantai;6;3;9
93;10.03.2017;2017;03;14;Perjantai;5;2;7
93;10.03.2017;2017;03;15;Perjantai;2;5;7
93;10.03.2017;2017;03;16;Perjantai;9;4;13
93;10.03.2017;2017;03;17;Perjantai;3;1;4
93;10.03.2017;2017;03;18;Perjantai;1;0;1
93;10.03.2017;2017;03;19;Perjantai;0;2;2
93;10.03.2017;2017;03;20;Perjantai;0;1;1
93;10.03.2017;2017;03;21;Perjantai;0;1;1
93;10.03.2017;2017;03;22;Perjantai;0;0;0
93;10.03.2017;2017;03;23;Perjantai;0;0;0
93;11.03.2017;2017;03;00;Lauantai;0;1;1
93;11.03.2017;2017;03;01;Lauantai;0;0;0
93;11.03.2017;2017;03;02;Lauantai;0;0;0
93;11.03.2017;2017;03;03;Lauantai;0;0;0
93;11.03.2017;2017;03;04;Lauantai;0;0;0
93;11.03.2017;2017;03;05;Lauantai;0;0;0
93;11.03.2017;2017;03;06;Lauantai;0;0;0
93;11.03.2017;2017;03;07;Lauantai;2;1;3
93;11.03.2017;2017;03;08;Lauantai;1;1;2
93;11.03.2017;2017;03;09;Lauantai;0;1;1
93;11.03.2017;2017;03;10;Lauantai;2;1;3
93;11.03.2017;2017;03;11;Lauantai;3;6;9
93;11.03.2017;2017;03;12;Lauantai;3;1;4
93;11.03.2017;2017;03;13;Lauantai;3;3;6
93;11.03.2017;2017;03;14;Lauantai;5;6;11
93;11.03.2017;2017;03;15;Lauantai;1;4;5
93;11.03.2017;2017;03;16;Lauantai;2;2;4
93;11.03.2017;2017;03;17;Lauantai;1;2;3
93;11.03.2017;2017;03;18;Lauantai;2;0;2
93;11.03.2017;2017;03;19;Lauantai;2;0;2
93;11.03.2017;2017;03;20;Lauantai;0;1;1
93;11.03.2017;2017;03;21;Lauantai;0;0;0
93;11.03.2017;2017;03;22;Lauantai;0;0;0
93;11.03.2017;2017;03;23;Lauantai;0;0;0
93;12.03.2017;2017;03;00;Sunnuntai;0;0;0
93;12.03.2017;2017;03;01;Sunnuntai;0;0;0
93;12.03.2017;2017;03;02;Sunnuntai;0;0;0
93;12.03.2017;2017;03;03;Sunnuntai;0;0;0
93;12.03.2017;2017;03;04;Sunnuntai;0;0;0
93;12.03.2017;2017;03;05;Sunnuntai;1;0;1
93;12.03.2017;2017;03;06;Sunnuntai;0;0;0
93;12.03.2017;2017;03;07;Sunnuntai;1;0;1
93;12.03.2017;2017;03;08;Sunnuntai;0;0;0
93;12.03.2017;2017;03;09;Sunnuntai;2;1;3
93;12.03.2017;2017;03;10;Sunnuntai;0;1;1
93;12.03.2017;2017;03;11;Sunnuntai;1;0;1
93;12.03.2017;2017;03;12;Sunnuntai;6;4;10
93;12.03.2017;2017;03;13;Sunnuntai;7;2;9
93;12.03.2017;2017;03;14;Sunnuntai;6;2;8
93;12.03.2017;2017;03;15;Sunnuntai;2;2;4
93;12.03.2017;2017;03;16;Sunnuntai;3;6;9
93;12.03.2017;2017;03;17;Sunnuntai;0;1;1
93;12.03.2017;2017;03;18;Sunnuntai;1;2;3
93;12.03.2017;2017;03;19;Sunnuntai;0;0;0
93;12.03.2017;2017;03;20;Sunnuntai;2;0;2
93;12.03.2017;2017;03;21;Sunnuntai;0;0;0
93;12.03.2017;2017;03;22;Sunnuntai;0;3;3
93;12.03.2017;2017;03;23;Sunnuntai;0;0;0
93;13.03.2017;2017;03;00;Maanantai;0;0;0
93;13.03.2017;2017;03;01;Maanantai;0;0;0
93;13.03.2017;2017;03;02;Maanantai;0;0;0
93;13.03.2017;2017;03;03;Maanantai;0;0;0
93;13.03.2017;2017;03;04;Maanantai;0;0;0
93;13.03.2017;2017;03;05;Maanantai;1;0;1
93;13.03.2017;2017;03;06;Maanantai;6;6;12
93;13.03.2017;2017;03;07;Maanantai;9;12;21
93;13.03.2017;2017;03;08;Maanantai;4;11;15
93;13.03.2017;2017;03;09;Maanantai;6;4;10
93;13.03.2017;2017;03;10;Maanantai;0;2;2
93;13.03.2017;2017;03;11;Maanantai;0;3;3
93;13.03.2017;2017;03;12;Maanantai;4;2;6
93;13.03.2017;2017;03;13;Maanantai;2;2;4
93;13.03.2017;2017;03;14;Maanantai;2;9;11
93;13.03.2017;2017;03;15;Maanantai;18;3;21
93;13.03.2017;2017;03;16;Maanantai;16;11;27
93;13.03.2017;2017;03;17;Maanantai;9;0;9
93;13.03.2017;2017;03;18;Maanantai;7;5;12
93;13.03.2017;2017;03;19;Maanantai;3;0;3
93;13.03.2017;2017;03;20;Maanantai;0;3;3
93;13.03.2017;2017;03;21;Maanantai;0;3;3
93;13.03.2017;2017;03;22;Maanantai;0;1;1
93;13.03.2017;2017;03;23;Maanantai;0;0;0
93;14.03.2017;2017;03;00;Tiistai;0;0;0
93;14.03.2017;2017;03;01;Tiistai;0;0;0
93;14.03.2017;2017;03;02;Tiistai;0;0;0
93;14.03.2017;2017;03;03;Tiistai;0;1;1
93;14.03.2017;2017;03;04;Tiistai;0;0;0
93;14.03.2017;2017;03;05;Tiistai;4;1;5
93;14.03.2017;2017;03;06;Tiistai;4;3;7
93;14.03.2017;2017;03;07;Tiistai;9;10;19
93;14.03.2017;2017;03;08;Tiistai;2;7;9
93;14.03.2017;2017;03;09;Tiistai;2;2;4
93;14.03.2017;2017;03;10;Tiistai;3;0;3
93;14.03.2017;2017;03;11;Tiistai;2;1;3
93;14.03.2017;2017;03;12;Tiistai;4;2;6
93;14.03.2017;2017;03;13;Tiistai;3;2;5
93;14.03.2017;2017;03;14;Tiistai;8;6;14
93;14.03.2017;2017;03;15;Tiistai;9;4;13
93;14.03.2017;2017;03;16;Tiistai;10;6;16
93;14.03.2017;2017;03;17;Tiistai;7;2;9
93;14.03.2017;2017;03;18;Tiistai;3;4;7
93;14.03.2017;2017;03;19;Tiistai;4;1;5
93;14.03.2017;2017;03;20;Tiistai;3;2;5
93;14.03.2017;2017;03;21;Tiistai;0;0;0
93;14.03.2017;2017;03;22;Tiistai;0;0;0
93;14.03.2017;2017;03;23;Tiistai;0;0;0
93;15.03.2017;2017;03;00;Keskiviikko;0;0;0
93;15.03.2017;2017;03;01;Keskiviikko;0;0;0
93;15.03.2017;2017;03;02;Keskiviikko;0;0;0
93;15.03.2017;2017;03;03;Keskiviikko;0;0;0
93;15.03.2017;2017;03;04;Keskiviikko;0;0;0
93;15.03.2017;2017;03;05;Keskiviikko;3;1;4
93;15.03.2017;2017;03;06;Keskiviikko;5;4;9
93;15.03.2017;2017;03;07;Keskiviikko;6;12;18
93;15.03.2017;2017;03;08;Keskiviikko;4;9;13
93;15.03.2017;2017;03;09;Keskiviikko;1;0;1
93;15.03.2017;2017;03;10;Keskiviikko;1;0;1
93;15.03.2017;2017;03;11;Keskiviikko;1;4;5
93;15.03.2017;2017;03;12;Keskiviikko;0;0;0
93;15.03.2017;2017;03;13;Keskiviikko;2;1;3
93;15.03.2017;2017;03;14;Keskiviikko;1;1;2
93;15.03.2017;2017;03;15;Keskiviikko;2;5;7
93;15.03.2017;2017;03;16;Keskiviikko;12;8;20
93;15.03.2017;2017;03;17;Keskiviikko;8;2;10
93;15.03.2017;2017;03;18;Keskiviikko;1;2;3
93;15.03.2017;2017;03;19;Keskiviikko;0;2;2
93;15.03.2017;2017;03;20;Keskiviikko;1;0;1
93;15.03.2017;2017;03;21;Keskiviikko;0;0;0
93;15.03.2017;2017;03;22;Keskiviikko;0;0;0
93;15.03.2017;2017;03;23;Keskiviikko;0;0;0
93;16.03.2017;2017;03;00;Torstai;0;0;0
93;16.03.2017;2017;03;01;Torstai;0;0;0
93;16.03.2017;2017;03;02;Torstai;0;0;0
93;16.03.2017;2017;03;03;Torstai;0;0;0
93;16.03.2017;2017;03;04;Torstai;0;0;0
93;16.03.2017;2017;03;05;Torstai;3;2;5
93;16.03.2017;2017;03;06;Torstai;2;1;3
93;16.03.2017;2017;03;07;Torstai;4;7;11
93;16.03.2017;2017;03;08;Torstai;2;8;10
93;16.03.2017;2017;03;09;Torstai;4;3;7
93;16.03.2017;2017;03;10;Torstai;5;2;7
93;16.03.2017;2017;03;11;Torstai;5;2;7
93;16.03.2017;2017;03;12;Torstai;5;6;11
93;16.03.2017;2017;03;13;Torstai;0;6;6
93;16.03.2017;2017;03;14;Torstai;8;4;12
93;16.03.2017;2017;03;15;Torstai;10;6;16
93;16.03.2017;2017;03;16;Torstai;15;7;22
93;16.03.2017;2017;03;17;Torstai;7;3;10
93;16.03.2017;2017;03;18;Torstai;4;8;12
93;16.03.2017;2017;03;19;Torstai;3;4;7
93;16.03.2017;2017;03;20;Torstai;1;2;3
93;16.03.2017;2017;03;21;Torstai;1;8;9
93;16.03.2017;2017;03;22;Torstai;0;1;1
93;16.03.2017;2017;03;23;Torstai;1;0;1
93;17.03.2017;2017;03;00;Perjantai;0;0;0
93;17.03.2017;2017;03;01;Perjantai;0;0;0
93;17.03.2017;2017;03;02;Perjantai;0;0;0
93;17.03.2017;2017;03;03;Perjantai;0;0;0
93;17.03.2017;2017;03;04;Perjantai;0;0;0
93;17.03.2017;2017;03;05;Perjantai;1;1;2
93;17.03.2017;2017;03;06;Perjantai;3;0;3
93;17.03.2017;2017;03;07;Perjantai;3;5;8
93;17.03.2017;2017;03;08;Perjantai;3;2;5
93;17.03.2017;2017;03;09;Perjantai;1;4;5
93;17.03.2017;2017;03;10;Perjantai;1;0;1
93;17.03.2017;2017;03;11;Perjantai;2;0;2
93;17.03.2017;2017;03;12;Perjantai;1;2;3
93;17.03.2017;2017;03;13;Perjantai;1;1;2
93;17.03.2017;2017;03;14;Perjantai;1;0;1
93;17.03.2017;2017;03;15;Perjantai;4;5;9
93;17.03.2017;2017;03;16;Perjantai;2;2;4
93;17.03.2017;2017;03;17;Perjantai;2;1;3
93;17.03.2017;2017;03;18;Perjantai;0;2;2
93;17.03.2017;2017;03;19;Perjantai;0;0;0
93;17.03.2017;2017;03;20;Perjantai;0;1;1
93;17.03.2017;2017;03;21;Perjantai;0;0;0
93;17.03.2017;2017;03;22;Perjantai;0;0;0
93;17.03.2017;2017;03;23;Perjantai;1;0;1
93;18.03.2017;2017;03;00;Lauantai;0;0;0
93;18.03.2017;2017;03;01;Lauantai;0;0;0
93;18.03.2017;2017;03;02;Lauantai;0;1;1
93;18.03.2017;2017;03;03;Lauantai;0;0;0
93;18.03.2017;2017;03;04;Lauantai;0;0;0
93;18.03.2017;2017;03;05;Lauantai;0;1;1
93;18.03.2017;2017;03;06;Lauantai;1;0;1
93;18.03.2017;2017;03;07;Lauantai;0;1;1
93;18.03.2017;2017;03;08;Lauantai;1;1;2
93;18.03.2017;2017;03;09;Lauantai;2;2;4
93;18.03.2017;2017;03;10;Lauantai;3;0;3
93;18.03.2017;2017;03;11;Lauantai;6;2;8
93;18.03.2017;2017;03;12;Lauantai;1;2;3
93;18.03.2017;2017;03;13;Lauantai;2;3;5
93;18.03.2017;2017;03;14;Lauantai;2;0;2
93;18.03.2017;2017;03;15;Lauantai;0;1;1
93;18.03.2017;2017;03;16;Lauantai;4;2;6
93;18.03.2017;2017;03;17;Lauantai;2;1;3
93;18.03.2017;2017;03;18;Lauantai;0;0;0
93;18.03.2017;2017;03;19;Lauantai;2;0;2
93;18.03.2017;2017;03;20;Lauantai;0;1;1
93;18.03.2017;2017;03;21;Lauantai;0;0;0
93;18.03.2017;2017;03;22;Lauantai;0;0;0
93;18.03.2017;2017;03;23;Lauantai;0;0;0
93;19.03.2017;2017;03;00;Sunnuntai;0;0;0
93;19.03.2017;2017;03;01;Sunnuntai;0;1;1
93;19.03.2017;2017;03;02;Sunnuntai;0;0;0
93;19.03.2017;2017;03;03;Sunnuntai;0;0;0
93;19.03.2017;2017;03;04;Sunnuntai;0;0;0
93;19.03.2017;2017;03;05;Sunnuntai;0;0;0
93;19.03.2017;2017;03;06;Sunnuntai;1;0;1
93;19.03.2017;2017;03;07;Sunnuntai;2;0;2
93;19.03.2017;2017;03;08;Sunnuntai;1;0;1
93;19.03.2017;2017;03;09;Sunnuntai;3;3;6
93;19.03.2017;2017;03;10;Sunnuntai;1;2;3
93;19.03.2017;2017;03;11;Sunnuntai;2;2;4
93;19.03.2017;2017;03;12;Sunnuntai;2;4;6
93;19.03.2017;2017;03;13;Sunnuntai;7;5;12
93;19.03.2017;2017;03;14;Sunnuntai;3;1;4
93;19.03.2017;2017;03;15;Sunnuntai;12;2;14
93;19.03.2017;2017;03;16;Sunnuntai;2;3;5
93;19.03.2017;2017;03;17;Sunnuntai;2;2;4
93;19.03.2017;2017;03;18;Sunnuntai;3;0;3
93;19.03.2017;2017;03;19;Sunnuntai;2;1;3
93;19.03.2017;2017;03;20;Sunnuntai;0;0;0
93;19.03.2017;2017;03;21;Sunnuntai;0;1;1
93;19.03.2017;2017;03;22;Sunnuntai;0;1;1
93;19.03.2017;2017;03;23;Sunnuntai;0;0;0
93;20.03.2017;2017;03;00;Maanantai;0;0;0
93;20.03.2017;2017;03;01;Maanantai;0;0;0
93;20.03.2017;2017;03;02;Maanantai;0;0;0
93;20.03.2017;2017;03;03;Maanantai;0;0;0
93;20.03.2017;2017;03;04;Maanantai;0;0;0
93;20.03.2017;2017;03;05;Maanantai;2;2;4
93;20.03.2017;2017;03;06;Maanantai;6;3;9
93;20.03.2017;2017;03;07;Maanantai;6;11;17
93;20.03.2017;2017;03;08;Maanantai;7;8;15
93;20.03.2017;2017;03;09;Maanantai;3;2;5
93;20.03.2017;2017;03;10;Maanantai;0;1;1
93;20.03.2017;2017;03;11;Maanantai;0;0;0
93;20.03.2017;2017;03;12;Maanantai;0;1;1
93;20.03.2017;2017;03;13;Maanantai;4;2;6
93;20.03.2017;2017;03;14;Maanantai;6;4;10
93;20.03.2017;2017;03;15;Maanantai;7;6;13
93;20.03.2017;2017;03;16;Maanantai;13;10;23
93;20.03.2017;2017;03;17;Maanantai;9;3;12
93;20.03.2017;2017;03;18;Maanantai;2;3;5
93;20.03.2017;2017;03;19;Maanantai;1;2;3
93;20.03.2017;2017;03;20;Maanantai;3;4;7
93;20.03.2017;2017;03;21;Maanantai;1;0;1
93;20.03.2017;2017;03;22;Maanantai;1;1;2
93;20.03.2017;2017;03;23;Maanantai;0;0;0
93;21.03.2017;2017;03;00;Tiistai;0;0;0
93;21.03.2017;2017;03;01;Tiistai;0;0;0
93;21.03.2017;2017;03;02;Tiistai;0;0;0
93;21.03.2017;2017;03;03;Tiistai;0;0;0
93;21.03.2017;2017;03;04;Tiistai;0;0;0
93;21.03.2017;2017;03;05;Tiistai;3;2;5
93;21.03.2017;2017;03;06;Tiistai;4;3;7
93;21.03.2017;2017;03;07;Tiistai;9;16;25
93;21.03.2017;2017;03;08;Tiistai;0;10;10
93;21.03.2017;2017;03;09;Tiistai;3;0;3
93;21.03.2017;2017;03;10;Tiistai;0;1;1
93;21.03.2017;2017;03;11;Tiistai;4;0;4
93;21.03.2017;2017;03;12;Tiistai;0;1;1
93;21.03.2017;2017;03;13;Tiistai;0;2;2
93;21.03.2017;2017;03;14;Tiistai;4;7;11
93;21.03.2017;2017;03;15;Tiistai;11;7;18
93;21.03.2017;2017;03;16;Tiistai;17;8;25
93;21.03.2017;2017;03;17;Tiistai;4;5;9
93;21.03.2017;2017;03;18;Tiistai;4;5;9
93;21.03.2017;2017;03;19;Tiistai;2;3;5
93;21.03.2017;2017;03;20;Tiistai;2;0;2
93;21.03.2017;2017;03;21;Tiistai;0;1;1
93;21.03.2017;2017;03;22;Tiistai;0;0;0
93;21.03.2017;2017;03;23;Tiistai;0;0;0
93;22.03.2017;2017;03;00;Keskiviikko;0;0;0
93;22.03.2017;2017;03;01;Keskiviikko;0;0;0
93;22.03.2017;2017;03;02;Keskiviikko;0;0;0
93;22.03.2017;2017;03;03;Keskiviikko;0;0;0
93;22.03.2017;2017;03;04;Keskiviikko;1;0;1
93;22.03.2017;2017;03;05;Keskiviikko;1;1;2
93;22.03.2017;2017;03;06;Keskiviikko;4;7;11
93;22.03.2017;2017;03;07;Keskiviikko;8;10;18
93;22.03.2017;2017;03;08;Keskiviikko;2;7;9
93;22.03.2017;2017;03;09;Keskiviikko;3;0;3
93;22.03.2017;2017;03;10;Keskiviikko;2;1;3
93;22.03.2017;2017;03;11;Keskiviikko;2;2;4
93;22.03.2017;2017;03;12;Keskiviikko;2;5;7
93;22.03.2017;2017;03;13;Keskiviikko;4;2;6
93;22.03.2017;2017;03;14;Keskiviikko;7;3;10
93;22.03.2017;2017;03;15;Keskiviikko;10;4;14
93;22.03.2017;2017;03;16;Keskiviikko;11;7;18
93;22.03.2017;2017;03;17;Keskiviikko;10;6;16
93;22.03.2017;2017;03;18;Keskiviikko;3;2;5
93;22.03.2017;2017;03;19;Keskiviikko;0;3;3
93;22.03.2017;2017;03;20;Keskiviikko;1;1;2
93;22.03.2017;2017;03;21;Keskiviikko;1;0;1
93;22.03.2017;2017;03;22;Keskiviikko;0;0;0
93;22.03.2017;2017;03;23;Keskiviikko;3;0;3
93;23.03.2017;2017;03;00;Torstai;0;0;0
93;23.03.2017;2017;03;01;Torstai;0;0;0
93;23.03.2017;2017;03;02;Torstai;0;0;0
93;23.03.2017;2017;03;03;Torstai;0;0;0
93;23.03.2017;2017;03;04;Torstai;0;0;0
93;23.03.2017;2017;03;05;Torstai;2;1;3
93;23.03.2017;2017;03;06;Torstai;5;5;10
93;23.03.2017;2017;03;07;Torstai;13;13;26
93;23.03.2017;2017;03;08;Torstai;6;9;15
93;23.03.2017;2017;03;09;Torstai;1;3;4
93;23.03.2017;2017;03;10;Torstai;1;2;3
93;23.03.2017;2017;03;11;Torstai;4;2;6
93;23.03.2017;2017;03;12;Torstai;5;2;7
93;23.03.2017;2017;03;13;Torstai;4;5;9
93;23.03.2017;2017;03;14;Torstai;5;6;11
93;23.03.2017;2017;03;15;Torstai;7;11;18
93;23.03.2017;2017;03;16;Torstai;18;5;23
93;23.03.2017;2017;03;17;Torstai;3;4;7
93;23.03.2017;2017;03;18;Torstai;3;2;5
93;23.03.2017;2017;03;19;Torstai;7;5;12
93;23.03.2017;2017;03;20;Torstai;1;1;2
93;23.03.2017;2017;03;21;Torstai;0;1;1
93;23.03.2017;2017;03;22;Torstai;0;1;1
93;23.03.2017;2017;03;23;Torstai;0;0;0
93;24.03.2017;2017;03;00;Perjantai;0;0;0
93;24.03.2017;2017;03;01;Perjantai;0;0;0
93;24.03.2017;2017;03;02;Perjantai;0;0;0
93;24.03.2017;2017;03;03;Perjantai;0;0;0
93;24.03.2017;2017;03;04;Perjantai;0;0;0
93;24.03.2017;2017;03;05;Perjantai;1;1;2
93;24.03.2017;2017;03;06;Perjantai;5;7;12
93;24.03.2017;2017;03;07;Perjantai;4;9;13
93;24.03.2017;2017;03;08;Perjantai;4;9;13
93;24.03.2017;2017;03;09;Perjantai;1;1;2
93;24.03.2017;2017;03;10;Perjantai;2;2;4
93;24.03.2017;2017;03;11;Perjantai;6;2;8
93;24.03.2017;2017;03;12;Perjantai;5;4;9
93;24.03.2017;2017;03;13;Perjantai;4;4;8
93;24.03.2017;2017;03;14;Perjantai;8;4;12
93;24.03.2017;2017;03;15;Perjantai;13;7;20
93;24.03.2017;2017;03;16;Perjantai;9;7;16
93;24.03.2017;2017;03;17;Perjantai;8;4;12
93;24.03.2017;2017;03;18;Perjantai;5;2;7
93;24.03.2017;2017;03;19;Perjantai;3;2;5
93;24.03.2017;2017;03;20;Perjantai;1;4;5
93;24.03.2017;2017;03;21;Perjantai;0;0;0
93;24.03.2017;2017;03;22;Perjantai;3;1;4
93;24.03.2017;2017;03;23;Perjantai;1;0;1
93;25.03.2017;2017;03;00;Lauantai;0;1;1
93;25.03.2017;2017;03;01;Lauantai;0;1;1
93;25.03.2017;2017;03;02;Lauantai;0;0;0
93;25.03.2017;2017;03;03;Lauantai;0;0;0
93;25.03.2017;2017;03;04;Lauantai;0;0;0
93;25.03.2017;2017;03;05;Lauantai;1;0;1
93;25.03.2017;2017;03;06;Lauantai;0;0;0
93;25.03.2017;2017;03;07;Lauantai;0;0;0
93;25.03.2017;2017;03;08;Lauantai;1;3;4
93;25.03.2017;2017;03;09;Lauantai;2;0;2
93;25.03.2017;2017;03;10;Lauantai;3;1;4
93;25.03.2017;2017;03;11;Lauantai;1;6;7
93;25.03.2017;2017;03;12;Lauantai;4;5;9
93;25.03.2017;2017;03;13;Lauantai;5;3;8
93;25.03.2017;2017;03;14;Lauantai;8;9;17
93;25.03.2017;2017;03;15;Lauantai;6;6;12
93;25.03.2017;2017;03;16;Lauantai;3;4;7
93;25.03.2017;2017;03;17;Lauantai;5;4;9
93;25.03.2017;2017;03;18;Lauantai;4;5;9
93;25.03.2017;2017;03;19;Lauantai;2;2;4
93;25.03.2017;2017;03;20;Lauantai;1;0;1
93;25.03.2017;2017;03;21;Lauantai;0;2;2
93;25.03.2017;2017;03;22;Lauantai;2;1;3
93;25.03.2017;2017;03;23;Lauantai;1;0;1
93;26.03.2017;2017;03;00;Sunnuntai;0;0;0
93;26.03.2017;2017;03;01;Sunnuntai;0;0;0
93;26.03.2017;2017;03;02;Sunnuntai;0;0;0
93;26.03.2017;2017;03;03;Sunnuntai;0;0;0
93;26.03.2017;2017;03;04;Sunnuntai;0;0;0
93;26.03.2017;2017;03;05;Sunnuntai;0;0;0
93;26.03.2017;2017;03;06;Sunnuntai;0;0;0
93;26.03.2017;2017;03;07;Sunnuntai;2;0;2
93;26.03.2017;2017;03;08;Sunnuntai;1;1;2
93;26.03.2017;2017;03;09;Sunnuntai;2;4;6
93;26.03.2017;2017;03;10;Sunnuntai;1;1;2
93;26.03.2017;2017;03;11;Sunnuntai;4;3;7
93;26.03.2017;2017;03;12;Sunnuntai;4;6;10
93;26.03.2017;2017;03;13;Sunnuntai;5;3;8
93;26.03.2017;2017;03;14;Sunnuntai;4;3;7
93;26.03.2017;2017;03;15;Sunnuntai;2;3;5
93;26.03.2017;2017;03;16;Sunnuntai;3;3;6
93;26.03.2017;2017;03;17;Sunnuntai;9;5;14
93;26.03.2017;2017;03;18;Sunnuntai;3;2;5
93;26.03.2017;2017;03;19;Sunnuntai;1;4;5
93;26.03.2017;2017;03;20;Sunnuntai;0;0;0
93;26.03.2017;2017;03;21;Sunnuntai;0;2;2
93;26.03.2017;2017;03;22;Sunnuntai;0;0;0
93;26.03.2017;2017;03;23;Sunnuntai;0;0;0
93;27.03.2017;2017;03;00;Maanantai;0;0;0
93;27.03.2017;2017;03;01;Maanantai;0;0;0
93;27.03.2017;2017;03;02;Maanantai;0;0;0
93;27.03.2017;2017;03;03;Maanantai;0;0;0
93;27.03.2017;2017;03;04;Maanantai;0;0;0
93;27.03.2017;2017;03;05;Maanantai;1;2;3
93;27.03.2017;2017;03;06;Maanantai;10;4;14
93;27.03.2017;2017;03;07;Maanantai;3;10;13
93;27.03.2017;2017;03;08;Maanantai;6;11;17
93;27.03.2017;2017;03;09;Maanantai;3;3;6
93;27.03.2017;2017;03;10;Maanantai;1;3;4
93;27.03.2017;2017;03;11;Maanantai;3;0;3
93;27.03.2017;2017;03;12;Maanantai;3;1;4
93;27.03.2017;2017;03;13;Maanantai;2;6;8
93;27.03.2017;2017;03;14;Maanantai;4;5;9
93;27.03.2017;2017;03;15;Maanantai;6;7;13
93;27.03.2017;2017;03;16;Maanantai;13;8;21
93;27.03.2017;2017;03;17;Maanantai;7;3;10
93;27.03.2017;2017;03;18;Maanantai;4;3;7
93;27.03.2017;2017;03;19;Maanantai;2;3;5
93;27.03.2017;2017;03;20;Maanantai;3;3;6
93;27.03.2017;2017;03;21;Maanantai;0;2;2
93;27.03.2017;2017;03;22;Maanantai;2;0;2
93;27.03.2017;2017;03;23;Maanantai;0;0;0
93;28.03.2017;2017;03;00;Tiistai;0;0;0
93;28.03.2017;2017;03;01;Tiistai;0;0;0
93;28.03.2017;2017;03;02;Tiistai;0;0;0
93;28.03.2017;2017;03;03;Tiistai;0;0;0
93;28.03.2017;2017;03;04;Tiistai;1;0;1
93;28.03.2017;2017;03;05;Tiistai;2;1;3
93;28.03.2017;2017;03;06;Tiistai;9;3;12
93;28.03.2017;2017;03;07;Tiistai;5;12;17
93;28.03.2017;2017;03;08;Tiistai;2;7;9
93;28.03.2017;2017;03;09;Tiistai;0;2;2
93;28.03.2017;2017;03;10;Tiistai;2;1;3
93;28.03.2017;2017;03;11;Tiistai;2;1;3
93;28.03.2017;2017;03;12;Tiistai;5;0;5
93;28.03.2017;2017;03;13;Tiistai;2;1;3
93;28.03.2017;2017;03;14;Tiistai;3;7;10
93;28.03.2017;2017;03;15;Tiistai;8;12;20
93;28.03.2017;2017;03;16;Tiistai;19;4;23
93;28.03.2017;2017;03;17;Tiistai;4;7;11
93;28.03.2017;2017;03;18;Tiistai;5;4;9
93;28.03.2017;2017;03;19;Tiistai;5;4;9
93;28.03.2017;2017;03;20;Tiistai;2;2;4
93;28.03.2017;2017;03;21;Tiistai;2;1;3
93;28.03.2017;2017;03;22;Tiistai;1;2;3
93;28.03.2017;2017;03;23;Tiistai;0;0;0
93;29.03.2017;2017;03;00;Keskiviikko;0;0;0
93;29.03.2017;2017;03;01;Keskiviikko;0;0;0
93;29.03.2017;2017;03;02;Keskiviikko;0;0;0
93;29.03.2017;2017;03;03;Keskiviikko;0;0;0
93;29.03.2017;2017;03;04;Keskiviikko;0;0;0
93;29.03.2017;2017;03;05;Keskiviikko;2;0;2
93;29.03.2017;2017;03;06;Keskiviikko;8;5;13
93;29.03.2017;2017;03;07;Keskiviikko;6;12;18
93;29.03.2017;2017;03;08;Keskiviikko;1;5;6
93;29.03.2017;2017;03;09;Keskiviikko;2;0;2
93;29.03.2017;2017;03;10;Keskiviikko;3;1;4
93;29.03.2017;2017;03;11;Keskiviikko;1;0;1
93;29.03.2017;2017;03;12;Keskiviikko;4;1;5
93;29.03.2017;2017;03;13;Keskiviikko;5;3;8
93;29.03.2017;2017;03;14;Keskiviikko;6;5;11
93;29.03.2017;2017;03;15;Keskiviikko;4;13;17
93;29.03.2017;2017;03;16;Keskiviikko;10;6;16
93;29.03.2017;2017;03;17;Keskiviikko;7;4;11
93;29.03.2017;2017;03;18;Keskiviikko;4;5;9
93;29.03.2017;2017;03;19;Keskiviikko;2;5;7
93;29.03.2017;2017;03;20;Keskiviikko;4;3;7
93;29.03.2017;2017;03;21;Keskiviikko;0;3;3
93;29.03.2017;2017;03;22;Keskiviikko;2;1;3
93;29.03.2017;2017;03;23;Keskiviikko;1;0;1
93;30.03.2017;2017;03;00;Torstai;0;0;0
93;30.03.2017;2017;03;01;Torstai;0;0;0
93;30.03.2017;2017;03;02;Torstai;0;0;0
93;30.03.2017;2017;03;03;Torstai;0;0;0
93;30.03.2017;2017;03;04;Torstai;0;0;0
93;30.03.2017;2017;03;05;Torstai;0;1;1
93;30.03.2017;2017;03;06;Torstai;7;5;12
93;30.03.2017;2017;03;07;Torstai;5;8;13
93;30.03.2017;2017;03;08;Torstai;1;11;12
93;30.03.2017;2017;03;09;Torstai;3;1;4
93;30.03.2017;2017;03;10;Torstai;4;0;4
93;30.03.2017;2017;03;11;Torstai;1;2;3
93;30.03.2017;2017;03;12;Torstai;5;3;8
93;30.03.2017;2017;03;13;Torstai;5;5;10
93;30.03.2017;2017;03;14;Torstai;4;3;7
93;30.03.2017;2017;03;15;Torstai;5;8;13
93;30.03.2017;2017;03;16;Torstai;18;10;28
93;30.03.2017;2017;03;17;Torstai;4;9;13
93;30.03.2017;2017;03;18;Torstai;6;5;11
93;30.03.2017;2017;03;19;Torstai;1;6;7
93;30.03.2017;2017;03;20;Torstai;3;3;6
93;30.03.2017;2017;03;21;Torstai;0;1;1
93;30.03.2017;2017;03;22;Torstai;1;0;1
93;30.03.2017;2017;03;23;Torstai;0;1;1
93;31.03.2017;2017;03;00;Perjantai;0;0;0
93;31.03.2017;2017;03;01;Perjantai;0;0;0
93;31.03.2017;2017;03;02;Perjantai;0;0;0
93;31.03.2017;2017;03;03;Perjantai;0;0;0
93;31.03.2017;2017;03;04;Perjantai;1;0;1
93;31.03.2017;2017;03;05;Perjantai;1;1;2
93;31.03.2017;2017;03;06;Perjantai;4;2;6
93;31.03.2017;2017;03;07;Perjantai;10;9;19
93;31.03.2017;2017;03;08;Perjantai;6;11;17
93;31.03.2017;2017;03;09;Perjantai;3;1;4
93;31.03.2017;2017;03;10;Perjantai;2;1;3
93;31.03.2017;2017;03;11;Perjantai;2;2;4
93;31.03.2017;2017;03;12;Perjantai;5;2;7
93;31.03.2017;2017;03;13;Perjantai;5;4;9
93;31.03.2017;2017;03;14;Perjantai;8;7;15
93;31.03.2017;2017;03;15;Perjantai;4;10;14
93;31.03.2017;2017;03;16;Perjantai;13;11;24
93;31.03.2017;2017;03;17;Perjantai;5;3;8
93;31.03.2017;2017;03;18;Perjantai;3;4;7
93;31.03.2017;2017;03;19;Perjantai;5;7;12
93;31.03.2017;2017;03;20;Perjantai;0;5;5
93;31.03.2017;2017;03;21;Perjantai;2;2;4
93;31.03.2017;2017;03;22;Perjantai;1;0;1
93;31.03.2017;2017;03;23;Perjantai;0;0;0
93;01.04.2017;2017;04;00;Lauantai;0;1;1
93;01.04.2017;2017;04;01;Lauantai;0;0;0
93;01.04.2017;2017;04;02;Lauantai;0;0;0
93;01.04.2017;2017;04;03;Lauantai;0;0;0
93;01.04.2017;2017;04;04;Lauantai;0;1;1
93;01.04.2017;2017;04;05;Lauantai;0;1;1
93;01.04.2017;2017;04;06;Lauantai;1;0;1
93;01.04.2017;2017;04;07;Lauantai;1;2;3
93;01.04.2017;2017;04;08;Lauantai;1;1;2
93;01.04.2017;2017;04;09;Lauantai;2;1;3
93;01.04.2017;2017;04;10;Lauantai;3;1;4
93;01.04.2017;2017;04;11;Lauantai;3;3;6
93;01.04.2017;2017;04;12;Lauantai;4;1;5
93;01.04.2017;2017;04;13;Lauantai;2;2;4
93;01.04.2017;2017;04;14;Lauantai;1;9;10
93;01.04.2017;2017;04;15;Lauantai;1;3;4
93;01.04.2017;2017;04;16;Lauantai;1;0;1
93;01.04.2017;2017;04;17;Lauantai;0;1;1
93;01.04.2017;2017;04;18;Lauantai;1;2;3
93;01.04.2017;2017;04;19;Lauantai;0;0;0
93;01.04.2017;2017;04;20;Lauantai;0;1;1
93;01.04.2017;2017;04;21;Lauantai;0;0;0
93;01.04.2017;2017;04;22;Lauantai;0;0;0
93;01.04.2017;2017;04;23;Lauantai;2;0;2
93;02.04.2017;2017;04;00;Sunnuntai;0;0;0
93;02.04.2017;2017;04;01;Sunnuntai;0;0;0
93;02.04.2017;2017;04;02;Sunnuntai;0;0;0
93;02.04.2017;2017;04;03;Sunnuntai;0;0;0
93;02.04.2017;2017;04;04;Sunnuntai;0;0;0
93;02.04.2017;2017;04;05;Sunnuntai;1;0;1
93;02.04.2017;2017;04;06;Sunnuntai;0;0;0
93;02.04.2017;2017;04;07;Sunnuntai;0;1;1
93;02.04.2017;2017;04;08;Sunnuntai;1;1;2
93;02.04.2017;2017;04;09;Sunnuntai;6;2;8
93;02.04.2017;2017;04;10;Sunnuntai;1;1;2
93;02.04.2017;2017;04;11;Sunnuntai;1;3;4
93;02.04.2017;2017;04;12;Sunnuntai;5;1;6
93;02.04.2017;2017;04;13;Sunnuntai;7;6;13
93;02.04.2017;2017;04;14;Sunnuntai;4;4;8
93;02.04.2017;2017;04;15;Sunnuntai;1;5;6
93;02.04.2017;2017;04;16;Sunnuntai;0;3;3
93;02.04.2017;2017;04;17;Sunnuntai;2;2;4
93;02.04.2017;2017;04;18;Sunnuntai;0;1;1
93;02.04.2017;2017;04;19;Sunnuntai;3;1;4
93;02.04.2017;2017;04;20;Sunnuntai;0;2;2
93;02.04.2017;2017;04;21;Sunnuntai;0;1;1
93;02.04.2017;2017;04;22;Sunnuntai;0;1;1
93;02.04.2017;2017;04;23;Sunnuntai;0;0;0
93;03.04.2017;2017;04;00;Maanantai;0;0;0
93;03.04.2017;2017;04;01;Maanantai;0;0;0
93;03.04.2017;2017;04;02;Maanantai;0;0;0
93;03.04.2017;2017;04;03;Maanantai;0;0;0
93;03.04.2017;2017;04;04;Maanantai;1;0;1
93;03.04.2017;2017;04;05;Maanantai;2;2;4
93;03.04.2017;2017;04;06;Maanantai;6;7;13
93;03.04.2017;2017;04;07;Maanantai;7;20;27
93;03.04.2017;2017;04;08;Maanantai;4;10;14
93;03.04.2017;2017;04;09;Maanantai;7;3;10
93;03.04.2017;2017;04;10;Maanantai;5;3;8
93;03.04.2017;2017;04;11;Maanantai;5;1;6
93;03.04.2017;2017;04;12;Maanantai;2;3;5
93;03.04.2017;2017;04;13;Maanantai;4;4;8
93;03.04.2017;2017;04;14;Maanantai;7;3;10
93;03.04.2017;2017;04;15;Maanantai;9;10;19
93;03.04.2017;2017;04;16;Maanantai;21;11;32
93;03.04.2017;2017;04;17;Maanantai;10;10;20
93;03.04.2017;2017;04;18;Maanantai;4;4;8
93;03.04.2017;2017;04;19;Maanantai;2;5;7
93;03.04.2017;2017;04;20;Maanantai;1;1;2
93;03.04.2017;2017;04;21;Maanantai;0;1;1
93;03.04.2017;2017;04;22;Maanantai;0;1;1
93;03.04.2017;2017;04;23;Maanantai;0;0;0
93;04.04.2017;2017;04;00;Tiistai;0;0;0
93;04.04.2017;2017;04;01;Tiistai;0;0;0
93;04.04.2017;2017;04;02;Tiistai;0;0;0
93;04.04.2017;2017;04;03;Tiistai;0;0;0
93;04.04.2017;2017;04;04;Tiistai;0;0;0
93;04.04.2017;2017;04;05;Tiistai;2;3;5
93;04.04.2017;2017;04;06;Tiistai;11;7;18
93;04.04.2017;2017;04;07;Tiistai;8;17;25
93;04.04.2017;2017;04;08;Tiistai;7;9;16
93;04.04.2017;2017;04;09;Tiistai;4;2;6
93;04.04.2017;2017;04;10;Tiistai;10;2;12
93;04.04.2017;2017;04;11;Tiistai;4;2;6
93;04.04.2017;2017;04;12;Tiistai;10;5;15
93;04.04.2017;2017;04;13;Tiistai;6;6;12
93;04.04.2017;2017;04;14;Tiistai;8;6;14
93;04.04.2017;2017;04;15;Tiistai;14;15;29
93;04.04.2017;2017;04;16;Tiistai;24;12;36
93;04.04.2017;2017;04;17;Tiistai;13;3;16
93;04.04.2017;2017;04;18;Tiistai;8;9;17
93;04.04.2017;2017;04;19;Tiistai;5;6;11
93;04.04.2017;2017;04;20;Tiistai;5;6;11
93;04.04.2017;2017;04;21;Tiistai;2;5;7
93;04.04.2017;2017;04;22;Tiistai;0;2;2
93;04.04.2017;2017;04;23;Tiistai;0;1;1
93;05.04.2017;2017;04;00;Keskiviikko;0;0;0
93;05.04.2017;2017;04;01;Keskiviikko;0;0;0
93;05.04.2017;2017;04;02;Keskiviikko;0;0;0
93;05.04.2017;2017;04;03;Keskiviikko;0;0;0
93;05.04.2017;2017;04;04;Keskiviikko;1;0;1
93;05.04.2017;2017;04;05;Keskiviikko;1;2;3
93;05.04.2017;2017;04;06;Keskiviikko;8;8;16
93;05.04.2017;2017;04;07;Keskiviikko;7;18;25
93;05.04.2017;2017;04;08;Keskiviikko;5;13;18
93;05.04.2017;2017;04;09;Keskiviikko;4;4;8
93;05.04.2017;2017;04;10;Keskiviikko;7;3;10
93;05.04.2017;2017;04;11;Keskiviikko;9;2;11
93;05.04.2017;2017;04;12;Keskiviikko;6;6;12
93;05.04.2017;2017;04;13;Keskiviikko;8;4;12
93;05.04.2017;2017;04;14;Keskiviikko;7;8;15
93;05.04.2017;2017;04;15;Keskiviikko;18;8;26
93;05.04.2017;2017;04;16;Keskiviikko;23;24;47
93;05.04.2017;2017;04;17;Keskiviikko;12;22;34
93;05.04.2017;2017;04;18;Keskiviikko;8;19;27
93;05.04.2017;2017;04;19;Keskiviikko;9;5;14
93;05.04.2017;2017;04;20;Keskiviikko;2;3;5
93;05.04.2017;2017;04;21;Keskiviikko;1;4;5
93;05.04.2017;2017;04;22;Keskiviikko;1;4;5
93;05.04.2017;2017;04;23;Keskiviikko;0;0;0
93;06.04.2017;2017;04;00;Torstai;0;0;0
93;06.04.2017;2017;04;01;Torstai;0;0;0
93;06.04.2017;2017;04;02;Torstai;0;0;0
93;06.04.2017;2017;04;03;Torstai;0;0;0
93;06.04.2017;2017;04;04;Torstai;0;0;0
93;06.04.2017;2017;04;05;Torstai;4;1;5
93;06.04.2017;2017;04;06;Torstai;7;10;17
93;06.04.2017;2017;04;07;Torstai;11;14;25
93;06.04.2017;2017;04;08;Torstai;8;11;19
93;06.04.2017;2017;04;09;Torstai;3;4;7
93;06.04.2017;2017;04;10;Torstai;4;3;7
93;06.04.2017;2017;04;11;Torstai;4;9;13
93;06.04.2017;2017;04;12;Torstai;2;2;4
93;06.04.2017;2017;04;13;Torstai;4;2;6
93;06.04.2017;2017;04;14;Torstai;9;6;15
93;06.04.2017;2017;04;15;Torstai;12;17;29
93;06.04.2017;2017;04;16;Torstai;16;7;23
93;06.04.2017;2017;04;17;Torstai;5;10;15
93;06.04.2017;2017;04;18;Torstai;10;8;18
93;06.04.2017;2017;04;19;Torstai;8;3;11
93;06.04.2017;2017;04;20;Torstai;5;5;10
93;06.04.2017;2017;04;21;Torstai;1;3;4
93;06.04.2017;2017;04;22;Torstai;1;1;2
93;06.04.2017;2017;04;23;Torstai;0;1;1
93;07.04.2017;2017;04;00;Perjantai;0;0;0
93;07.04.2017;2017;04;01;Perjantai;0;0;0
93;07.04.2017;2017;04;02;Perjantai;0;0;0
93;07.04.2017;2017;04;03;Perjantai;0;0;0
93;07.04.2017;2017;04;04;Perjantai;0;0;0
93;07.04.2017;2017;04;05;Perjantai;2;2;4
93;07.04.2017;2017;04;06;Perjantai;4;5;9
93;07.04.2017;2017;04;07;Perjantai;6;18;24
93;07.04.2017;2017;04;08;Perjantai;9;15;24
93;07.04.2017;2017;04;09;Perjantai;3;1;4
93;07.04.2017;2017;04;10;Perjantai;11;4;15
93;07.04.2017;2017;04;11;Perjantai;7;3;10
93;07.04.2017;2017;04;12;Perjantai;11;5;16
93;07.04.2017;2017;04;13;Perjantai;6;6;12
93;07.04.2017;2017;04;14;Perjantai;7;10;17
93;07.04.2017;2017;04;15;Perjantai;12;10;22
93;07.04.2017;2017;04;16;Perjantai;20;9;29
93;07.04.2017;2017;04;17;Perjantai;10;9;19
93;07.04.2017;2017;04;18;Perjantai;3;5;8
93;07.04.2017;2017;04;19;Perjantai;2;0;2
93;07.04.2017;2017;04;20;Perjantai;3;2;5
93;07.04.2017;2017;04;21;Perjantai;0;3;3
93;07.04.2017;2017;04;22;Perjantai;1;0;1
93;07.04.2017;2017;04;23;Perjantai;1;0;1
93;08.04.2017;2017;04;00;Lauantai;0;1;1
93;08.04.2017;2017;04;01;Lauantai;0;1;1
93;08.04.2017;2017;04;02;Lauantai;1;0;1
93;08.04.2017;2017;04;03;Lauantai;0;0;0
93;08.04.2017;2017;04;04;Lauantai;0;0;0
93;08.04.2017;2017;04;05;Lauantai;0;0;0
93;08.04.2017;2017;04;06;Lauantai;2;0;2
93;08.04.2017;2017;04;07;Lauantai;1;0;1
93;08.04.2017;2017;04;08;Lauantai;3;1;4
93;08.04.2017;2017;04;09;Lauantai;6;4;10
93;08.04.2017;2017;04;10;Lauantai;7;3;10
93;08.04.2017;2017;04;11;Lauantai;6;8;14
93;08.04.2017;2017;04;12;Lauantai;9;10;19
93;08.04.2017;2017;04;13;Lauantai;8;3;11
93;08.04.2017;2017;04;14;Lauantai;7;6;13
93;08.04.2017;2017;04;15;Lauantai;3;12;15
93;08.04.2017;2017;04;16;Lauantai;7;13;20
93;08.04.2017;2017;04;17;Lauantai;7;7;14
93;08.04.2017;2017;04;18;Lauantai;7;7;14
93;08.04.2017;2017;04;19;Lauantai;2;7;9
93;08.04.2017;2017;04;20;Lauantai;4;1;5
93;08.04.2017;2017;04;21;Lauantai;1;2;3
93;08.04.2017;2017;04;22;Lauantai;1;0;1
93;08.04.2017;2017;04;23;Lauantai;0;0;0
93;09.04.2017;2017;04;00;Sunnuntai;0;1;1
93;09.04.2017;2017;04;01;Sunnuntai;2;0;2
93;09.04.2017;2017;04;02;Sunnuntai;0;2;2
93;09.04.2017;2017;04;03;Sunnuntai;0;0;0
93;09.04.2017;2017;04;04;Sunnuntai;0;0;0
93;09.04.2017;2017;04;05;Sunnuntai;1;0;1
93;09.04.2017;2017;04;06;Sunnuntai;1;0;1
93;09.04.2017;2017;04;07;Sunnuntai;2;1;3
93;09.04.2017;2017;04;08;Sunnuntai;1;2;3
93;09.04.2017;2017;04;09;Sunnuntai;4;3;7
93;09.04.2017;2017;04;10;Sunnuntai;8;4;12
93;09.04.2017;2017;04;11;Sunnuntai;3;2;5
93;09.04.2017;2017;04;12;Sunnuntai;5;3;8
93;09.04.2017;2017;04;13;Sunnuntai;1;4;5
93;09.04.2017;2017;04;14;Sunnuntai;4;6;10
93;09.04.2017;2017;04;15;Sunnuntai;3;7;10
93;09.04.2017;2017;04;16;Sunnuntai;5;4;9
93;09.04.2017;2017;04;17;Sunnuntai;8;7;15
93;09.04.2017;2017;04;18;Sunnuntai;6;7;13
93;09.04.2017;2017;04;19;Sunnuntai;3;5;8
93;09.04.2017;2017;04;20;Sunnuntai;1;5;6
93;09.04.2017;2017;04;21;Sunnuntai;0;0;0
93;09.04.2017;2017;04;22;Sunnuntai;0;0;0
93;09.04.2017;2017;04;23;Sunnuntai;0;0;0
93;10.04.2017;2017;04;00;Maanantai;0;0;0
93;10.04.2017;2017;04;01;Maanantai;0;1;1
93;10.04.2017;2017;04;02;Maanantai;0;0;0
93;10.04.2017;2017;04;03;Maanantai;0;0;0
93;10.04.2017;2017;04;04;Maanantai;1;0;1
93;10.04.2017;2017;04;05;Maanantai;3;1;4
93;10.04.2017;2017;04;06;Maanantai;6;5;11
93;10.04.2017;2017;04;07;Maanantai;4;16;20
93;10.04.2017;2017;04;08;Maanantai;4;13;17
93;10.04.2017;2017;04;09;Maanantai;1;3;4
93;10.04.2017;2017;04;10;Maanantai;2;4;6
93;10.04.2017;2017;04;11;Maanantai;2;3;5
93;10.04.2017;2017;04;12;Maanantai;4;0;4
93;10.04.2017;2017;04;13;Maanantai;0;4;4
93;10.04.2017;2017;04;14;Maanantai;5;7;12
93;10.04.2017;2017;04;15;Maanantai;11;8;19
93;10.04.2017;2017;04;16;Maanantai;17;7;24
93;10.04.2017;2017;04;17;Maanantai;5;2;7
93;10.04.2017;2017;04;18;Maanantai;0;1;1
93;10.04.2017;2017;04;19;Maanantai;1;1;2
93;10.04.2017;2017;04;20;Maanantai;1;0;1
93;10.04.2017;2017;04;21;Maanantai;2;1;3
93;10.04.2017;2017;04;22;Maanantai;0;1;1
93;10.04.2017;2017;04;23;Maanantai;1;0;1
93;11.04.2017;2017;04;00;Tiistai;1;0;1
93;11.04.2017;2017;04;01;Tiistai;0;0;0
93;11.04.2017;2017;04;02;Tiistai;0;0;0
93;11.04.2017;2017;04;03;Tiistai;0;0;0
93;11.04.2017;2017;04;04;Tiistai;0;0;0
93;11.04.2017;2017;04;05;Tiistai;4;1;5
93;11.04.2017;2017;04;06;Tiistai;6;7;13
93;11.04.2017;2017;04;07;Tiistai;5;11;16
93;11.04.2017;2017;04;08;Tiistai;5;8;13
93;11.04.2017;2017;04;09;Tiistai;0;2;2
93;11.04.2017;2017;04;10;Tiistai;0;0;0
93;11.04.2017;2017;04;11;Tiistai;1;0;1
93;11.04.2017;2017;04;12;Tiistai;0;0;0
93;11.04.2017;2017;04;13;Tiistai;0;1;1
93;11.04.2017;2017;04;14;Tiistai;6;5;11
93;11.04.2017;2017;04;15;Tiistai;9;7;16
93;11.04.2017;2017;04;16;Tiistai;11;8;19
93;11.04.2017;2017;04;17;Tiistai;6;4;10
93;11.04.2017;2017;04;18;Tiistai;1;2;3
93;11.04.2017;2017;04;19;Tiistai;6;5;11
93;11.04.2017;2017;04;20;Tiistai;2;5;7
93;11.04.2017;2017;04;21;Tiistai;2;1;3
93;11.04.2017;2017;04;22;Tiistai;0;0;0
93;11.04.2017;2017;04;23;Tiistai;0;1;1
93;12.04.2017;2017;04;00;Keskiviikko;1;0;1
93;12.04.2017;2017;04;01;Keskiviikko;0;0;0
93;12.04.2017;2017;04;02;Keskiviikko;0;0;0
93;12.04.2017;2017;04;03;Keskiviikko;0;0;0
93;12.04.2017;2017;04;04;Keskiviikko;0;0;0
93;12.04.2017;2017;04;05;Keskiviikko;4;2;6
93;12.04.2017;2017;04;06;Keskiviikko;2;6;8
93;12.04.2017;2017;04;07;Keskiviikko;13;13;26
93;12.04.2017;2017;04;08;Keskiviikko;7;6;13
93;12.04.2017;2017;04;09;Keskiviikko;6;4;10
93;12.04.2017;2017;04;10;Keskiviikko;5;4;9
93;12.04.2017;2017;04;11;Keskiviikko;3;3;6
93;12.04.2017;2017;04;12;Keskiviikko;3;3;6
93;12.04.2017;2017;04;13;Keskiviikko;7;7;14
93;12.04.2017;2017;04;14;Keskiviikko;8;12;20
93;12.04.2017;2017;04;15;Keskiviikko;5;7;12
93;12.04.2017;2017;04;16;Keskiviikko;14;15;29
93;12.04.2017;2017;04;17;Keskiviikko;7;9;16
93;12.04.2017;2017;04;18;Keskiviikko;11;7;18
93;12.04.2017;2017;04;19;Keskiviikko;5;6;11
93;12.04.2017;2017;04;20;Keskiviikko;9;5;14
93;12.04.2017;2017;04;21;Keskiviikko;1;1;2
93;12.04.2017;2017;04;22;Keskiviikko;3;2;5
93;12.04.2017;2017;04;23;Keskiviikko;0;1;1
93;13.04.2017;2017;04;00;Torstai;0;1;1
93;13.04.2017;2017;04;01;Torstai;0;0;0
93;13.04.2017;2017;04;02;Torstai;0;0;0
93;13.04.2017;2017;04;03;Torstai;0;0;0
93;13.04.2017;2017;04;04;Torstai;1;0;1
93;13.04.2017;2017;04;05;Torstai;2;0;2
93;13.04.2017;2017;04;06;Torstai;4;8;12
93;13.04.2017;2017;04;07;Torstai;11;8;19
93;13.04.2017;2017;04;08;Torstai;4;11;15
93;13.04.2017;2017;04;09;Torstai;2;2;4
93;13.04.2017;2017;04;10;Torstai;1;1;2
93;13.04.2017;2017;04;11;Torstai;2;4;6
93;13.04.2017;2017;04;12;Torstai;3;5;8
93;13.04.2017;2017;04;13;Torstai;3;6;9
93;13.04.2017;2017;04;14;Torstai;4;13;17
93;13.04.2017;2017;04;15;Torstai;11;11;22
93;13.04.2017;2017;04;16;Torstai;10;5;15
93;13.04.2017;2017;04;17;Torstai;5;3;8
93;13.04.2017;2017;04;18;Torstai;0;5;5
93;13.04.2017;2017;04;19;Torstai;7;3;10
93;13.04.2017;2017;04;20;Torstai;7;3;10
93;13.04.2017;2017;04;21;Torstai;0;1;1
93;13.04.2017;2017;04;22;Torstai;1;2;3
93;13.04.2017;2017;04;23;Torstai;0;1;1
93;14.04.2017;2017;04;00;Perjantai;1;0;1
93;14.04.2017;2017;04;01;Perjantai;0;0;0
93;14.04.2017;2017;04;02;Perjantai;0;0;0
93;14.04.2017;2017;04;03;Perjantai;0;0;0
93;14.04.2017;2017;04;04;Perjantai;0;0;0
93;14.04.2017;2017;04;05;Perjantai;0;0;0
93;14.04.2017;2017;04;06;Perjantai;0;0;0
93;14.04.2017;2017;04;07;Perjantai;0;0;0
93;14.04.2017;2017;04;08;Perjantai;0;1;1
93;14.04.2017;2017;04;09;Perjantai;2;3;5
93;14.04.2017;2017;04;10;Perjantai;5;6;11
93;14.04.2017;2017;04;11;Perjantai;5;5;10
93;14.04.2017;2017;04;12;Perjantai;7;4;11
93;14.04.2017;2017;04;13;Perjantai;4;12;16
93;14.04.2017;2017;04;14;Perjantai;8;5;13
93;14.04.2017;2017;04;15;Perjantai;5;4;9
93;14.04.2017;2017;04;16;Perjantai;5;4;9
93;14.04.2017;2017;04;17;Perjantai;6;7;13
93;14.04.2017;2017;04;18;Perjantai;6;5;11
93;14.04.2017;2017;04;19;Perjantai;9;2;11
93;14.04.2017;2017;04;20;Perjantai;3;3;6
93;14.04.2017;2017;04;21;Perjantai;1;4;5
93;14.04.2017;2017;04;22;Perjantai;1;0;1
93;14.04.2017;2017;04;23;Perjantai;0;1;1
93;15.04.2017;2017;04;00;Lauantai;0;0;0
93;15.04.2017;2017;04;01;Lauantai;0;1;1
93;15.04.2017;2017;04;02;Lauantai;0;1;1
93;15.04.2017;2017;04;03;Lauantai;0;0;0
93;15.04.2017;2017;04;04;Lauantai;0;0;0
93;15.04.2017;2017;04;05;Lauantai;0;1;1
93;15.04.2017;2017;04;06;Lauantai;1;1;2
93;15.04.2017;2017;04;07;Lauantai;0;0;0
93;15.04.2017;2017;04;08;Lauantai;1;0;1
93;15.04.2017;2017;04;09;Lauantai;0;1;1
93;15.04.2017;2017;04;10;Lauantai;2;0;2
93;15.04.2017;2017;04;11;Lauantai;4;3;7
93;15.04.2017;2017;04;12;Lauantai;7;5;12
93;15.04.2017;2017;04;13;Lauantai;2;3;5
93;15.04.2017;2017;04;14;Lauantai;3;2;5
93;15.04.2017;2017;04;15;Lauantai;1;4;5
93;15.04.2017;2017;04;16;Lauantai;5;4;9
93;15.04.2017;2017;04;17;Lauantai;4;4;8
93;15.04.2017;2017;04;18;Lauantai;4;7;11
93;15.04.2017;2017;04;19;Lauantai;9;3;12
93;15.04.2017;2017;04;20;Lauantai;3;2;5
93;15.04.2017;2017;04;21;Lauantai;0;1;1
93;15.04.2017;2017;04;22;Lauantai;1;0;1
93;15.04.2017;2017;04;23;Lauantai;0;0;0
93;16.04.2017;2017;04;00;Sunnuntai;0;0;0
93;16.04.2017;2017;04;01;Sunnuntai;0;0;0
93;16.04.2017;2017;04;02;Sunnuntai;0;0;0
93;16.04.2017;2017;04;03;Sunnuntai;0;0;0
93;16.04.2017;2017;04;04;Sunnuntai;0;0;0
93;16.04.2017;2017;04;05;Sunnuntai;0;0;0
93;16.04.2017;2017;04;06;Sunnuntai;2;1;3
93;16.04.2017;2017;04;07;Sunnuntai;0;1;1
93;16.04.2017;2017;04;08;Sunnuntai;2;1;3
93;16.04.2017;2017;04;09;Sunnuntai;1;1;2
93;16.04.2017;2017;04;10;Sunnuntai;2;5;7
93;16.04.2017;2017;04;11;Sunnuntai;9;4;13
93;16.04.2017;2017;04;12;Sunnuntai;14;5;19
93;16.04.2017;2017;04;13;Sunnuntai;15;9;24
93;16.04.2017;2017;04;14;Sunnuntai;9;13;22
93;16.04.2017;2017;04;15;Sunnuntai;10;9;19
93;16.04.2017;2017;04;16;Sunnuntai;5;6;11
93;16.04.2017;2017;04;17;Sunnuntai;4;7;11
93;16.04.2017;2017;04;18;Sunnuntai;3;7;10
93;16.04.2017;2017;04;19;Sunnuntai;3;9;12
93;16.04.2017;2017;04;20;Sunnuntai;6;2;8
93;16.04.2017;2017;04;21;Sunnuntai;1;0;1
93;16.04.2017;2017;04;22;Sunnuntai;1;0;1
93;16.04.2017;2017;04;23;Sunnuntai;0;0;0
93;17.04.2017;2017;04;00;Maanantai;0;0;0
93;17.04.2017;2017;04;01;Maanantai;1;0;1
93;17.04.2017;2017;04;02;Maanantai;0;0;0
93;17.04.2017;2017;04;03;Maanantai;0;0;0
93;17.04.2017;2017;04;04;Maanantai;0;1;1
93;17.04.2017;2017;04;05;Maanantai;0;0;0
93;17.04.2017;2017;04;06;Maanantai;2;0;2
93;17.04.2017;2017;04;07;Maanantai;3;0;3
93;17.04.2017;2017;04;08;Maanantai;0;2;2
93;17.04.2017;2017;04;09;Maanantai;5;4;9
93;17.04.2017;2017;04;10;Maanantai;4;13;17
93;17.04.2017;2017;04;11;Maanantai;14;3;17
93;17.04.2017;2017;04;12;Maanantai;15;10;25
93;17.04.2017;2017;04;13;Maanantai;12;7;19
93;17.04.2017;2017;04;14;Maanantai;10;15;25
93;17.04.2017;2017;04;15;Maanantai;17;12;29
93;17.04.2017;2017;04;16;Maanantai;8;7;15
93;17.04.2017;2017;04;17;Maanantai;6;10;16
93;17.04.2017;2017;04;18;Maanantai;5;11;16
93;17.04.2017;2017;04;19;Maanantai;7;9;16
93;17.04.2017;2017;04;20;Maanantai;2;3;5
93;17.04.2017;2017;04;21;Maanantai;2;3;5
93;17.04.2017;2017;04;22;Maanantai;2;0;2
93;17.04.2017;2017;04;23;Maanantai;0;0;0
93;18.04.2017;2017;04;00;Tiistai;0;0;0
93;18.04.2017;2017;04;01;Tiistai;0;0;0
93;18.04.2017;2017;04;02;Tiistai;0;0;0
93;18.04.2017;2017;04;03;Tiistai;0;0;0
93;18.04.2017;2017;04;04;Tiistai;1;0;1
93;18.04.2017;2017;04;05;Tiistai;3;1;4
93;18.04.2017;2017;04;06;Tiistai;7;8;15
93;18.04.2017;2017;04;07;Tiistai;10;19;29
93;18.04.2017;2017;04;08;Tiistai;6;13;19
93;18.04.2017;2017;04;09;Tiistai;8;2;10
93;18.04.2017;2017;04;10;Tiistai;7;3;10
93;18.04.2017;2017;04;11;Tiistai;2;4;6
93;18.04.2017;2017;04;12;Tiistai;8;5;13
93;18.04.2017;2017;04;13;Tiistai;4;5;9
93;18.04.2017;2017;04;14;Tiistai;9;16;25
93;18.04.2017;2017;04;15;Tiistai;12;17;29
93;18.04.2017;2017;04;16;Tiistai;24;9;33
93;18.04.2017;2017;04;17;Tiistai;16;10;26
93;18.04.2017;2017;04;18;Tiistai;10;10;20
93;18.04.2017;2017;04;19;Tiistai;11;6;17
93;18.04.2017;2017;04;20;Tiistai;4;7;11
93;18.04.2017;2017;04;21;Tiistai;1;4;5
93;18.04.2017;2017;04;22;Tiistai;1;2;3
93;18.04.2017;2017;04;23;Tiistai;0;0;0
93;19.04.2017;2017;04;00;Keskiviikko;0;0;0
93;19.04.2017;2017;04;01;Keskiviikko;0;0;0
93;19.04.2017;2017;04;02;Keskiviikko;0;0;0
93;19.04.2017;2017;04;03;Keskiviikko;0;0;0
93;19.04.2017;2017;04;04;Keskiviikko;1;0;1
93;19.04.2017;2017;04;05;Keskiviikko;2;2;4
93;19.04.2017;2017;04;06;Keskiviikko;14;9;23
93;19.04.2017;2017;04;07;Keskiviikko;11;16;27
93;19.04.2017;2017;04;08;Keskiviikko;8;12;20
93;19.04.2017;2017;04;09;Keskiviikko;8;7;15
93;19.04.2017;2017;04;10;Keskiviikko;7;5;12
93;19.04.2017;2017;04;11;Keskiviikko;9;1;10
93;19.04.2017;2017;04;12;Keskiviikko;3;5;8
93;19.04.2017;2017;04;13;Keskiviikko;6;9;15
93;19.04.2017;2017;04;14;Keskiviikko;8;10;18
93;19.04.2017;2017;04;15;Keskiviikko;7;9;16
93;19.04.2017;2017;04;16;Keskiviikko;24;24;48
93;19.04.2017;2017;04;17;Keskiviikko;14;11;25
93;19.04.2017;2017;04;18;Keskiviikko;10;8;18
93;19.04.2017;2017;04;19;Keskiviikko;8;6;14
93;19.04.2017;2017;04;20;Keskiviikko;2;5;7
93;19.04.2017;2017;04;21;Keskiviikko;1;4;5
93;19.04.2017;2017;04;22;Keskiviikko;0;0;0
93;19.04.2017;2017;04;23;Keskiviikko;0;1;1
93;20.04.2017;2017;04;00;Torstai;0;0;0
93;20.04.2017;2017;04;01;Torstai;0;0;0
93;20.04.2017;2017;04;02;Torstai;0;0;0
93;20.04.2017;2017;04;03;Torstai;0;0;0
93;20.04.2017;2017;04;04;Torstai;0;1;1
93;20.04.2017;2017;04;05;Torstai;2;2;4
93;20.04.2017;2017;04;06;Torstai;11;7;18
93;20.04.2017;2017;04;07;Torstai;10;13;23
93;20.04.2017;2017;04;08;Torstai;9;10;19
93;20.04.2017;2017;04;09;Torstai;4;4;8
93;20.04.2017;2017;04;10;Torstai;5;1;6
93;20.04.2017;2017;04;11;Torstai;4;6;10
93;20.04.2017;2017;04;12;Torstai;2;8;10
93;20.04.2017;2017;04;13;Torstai;4;4;8
93;20.04.2017;2017;04;14;Torstai;4;7;11
93;20.04.2017;2017;04;15;Torstai;9;7;16
93;20.04.2017;2017;04;16;Torstai;14;6;20
93;20.04.2017;2017;04;17;Torstai;5;3;8
93;20.04.2017;2017;04;18;Torstai;1;0;1
93;20.04.2017;2017;04;19;Torstai;1;2;3
93;20.04.2017;2017;04;20;Torstai;1;4;5
93;20.04.2017;2017;04;21;Torstai;0;0;0
93;20.04.2017;2017;04;22;Torstai;0;0;0
93;20.04.2017;2017;04;23;Torstai;0;1;1
93;21.04.2017;2017;04;00;Perjantai;0;0;0
93;21.04.2017;2017;04;01;Perjantai;0;0;0
93;21.04.2017;2017;04;02;Perjantai;0;0;0
93;21.04.2017;2017;04;03;Perjantai;0;0;0
93;21.04.2017;2017;04;04;Perjantai;0;0;0
93;21.04.2017;2017;04;05;Perjantai;3;2;5
93;21.04.2017;2017;04;06;Perjantai;5;10;15
93;21.04.2017;2017;04;07;Perjantai;12;9;21
93;21.04.2017;2017;04;08;Perjantai;11;13;24
93;21.04.2017;2017;04;09;Perjantai;3;5;8
93;21.04.2017;2017;04;10;Perjantai;7;4;11
93;21.04.2017;2017;04;11;Perjantai;5;4;9
93;21.04.2017;2017;04;12;Perjantai;3;9;12
93;21.04.2017;2017;04;13;Perjantai;7;14;21
93;21.04.2017;2017;04;14;Perjantai;14;18;32
93;21.04.2017;2017;04;15;Perjantai;20;10;30
93;21.04.2017;2017;04;16;Perjantai;17;13;30
93;21.04.2017;2017;04;17;Perjantai;12;10;22
93;21.04.2017;2017;04;18;Perjantai;2;5;7
93;21.04.2017;2017;04;19;Perjantai;7;8;15
93;21.04.2017;2017;04;20;Perjantai;0;0;0
93;21.04.2017;2017;04;21;Perjantai;1;3;4
93;21.04.2017;2017;04;22;Perjantai;0;2;2
93;21.04.2017;2017;04;23;Perjantai;1;0;1
93;22.04.2017;2017;04;00;Lauantai;0;1;1
93;22.04.2017;2017;04;01;Lauantai;0;1;1
93;22.04.2017;2017;04;02;Lauantai;0;1;1
93;22.04.2017;2017;04;03;Lauantai;0;0;0
93;22.04.2017;2017;04;04;Lauantai;0;0;0
93;22.04.2017;2017;04;05;Lauantai;0;0;0
93;22.04.2017;2017;04;06;Lauantai;1;0;1
93;22.04.2017;2017;04;07;Lauantai;0;1;1
93;22.04.2017;2017;04;08;Lauantai;0;0;0
93;22.04.2017;2017;04;09;Lauantai;4;2;6
93;22.04.2017;2017;04;10;Lauantai;13;5;18
93;22.04.2017;2017;04;11;Lauantai;10;11;21
93;22.04.2017;2017;04;12;Lauantai;25;16;41
93;22.04.2017;2017;04;13;Lauantai;9;15;24
93;22.04.2017;2017;04;14;Lauantai;5;12;17
93;22.04.2017;2017;04;15;Lauantai;12;11;23
93;22.04.2017;2017;04;16;Lauantai;9;6;15
93;22.04.2017;2017;04;17;Lauantai;7;8;15
93;22.04.2017;2017;04;18;Lauantai;12;8;20
93;22.04.2017;2017;04;19;Lauantai;7;9;16
93;22.04.2017;2017;04;20;Lauantai;1;3;4
93;22.04.2017;2017;04;21;Lauantai;2;6;8
93;22.04.2017;2017;04;22;Lauantai;0;2;2
93;22.04.2017;2017;04;23;Lauantai;0;1;1
93;23.04.2017;2017;04;00;Sunnuntai;0;1;1
93;23.04.2017;2017;04;01;Sunnuntai;0;0;0
93;23.04.2017;2017;04;02;Sunnuntai;0;1;1
93;23.04.2017;2017;04;03;Sunnuntai;0;0;0
93;23.04.2017;2017;04;04;Sunnuntai;0;0;0
93;23.04.2017;2017;04;05;Sunnuntai;1;0;1
93;23.04.2017;2017;04;06;Sunnuntai;0;0;0
93;23.04.2017;2017;04;07;Sunnuntai;1;0;1
93;23.04.2017;2017;04;08;Sunnuntai;2;3;5
93;23.04.2017;2017;04;09;Sunnuntai;3;4;7
93;23.04.2017;2017;04;10;Sunnuntai;10;7;17
93;23.04.2017;2017;04;11;Sunnuntai;9;6;15
93;23.04.2017;2017;04;12;Sunnuntai;12;15;27
93;23.04.2017;2017;04;13;Sunnuntai;15;17;32
93;23.04.2017;2017;04;14;Sunnuntai;15;13;28
93;23.04.2017;2017;04;15;Sunnuntai;17;12;29
93;23.04.2017;2017;04;16;Sunnuntai;11;10;21
93;23.04.2017;2017;04;17;Sunnuntai;6;6;12
93;23.04.2017;2017;04;18;Sunnuntai;8;9;17
93;23.04.2017;2017;04;19;Sunnuntai;6;5;11
93;23.04.2017;2017;04;20;Sunnuntai;1;4;5
93;23.04.2017;2017;04;21;Sunnuntai;0;5;5
93;23.04.2017;2017;04;22;Sunnuntai;0;1;1
93;23.04.2017;2017;04;23;Sunnuntai;1;0;1
93;24.04.2017;2017;04;00;Maanantai;0;0;0
93;24.04.2017;2017;04;01;Maanantai;0;1;1
93;24.04.2017;2017;04;02;Maanantai;0;0;0
93;24.04.2017;2017;04;03;Maanantai;0;0;0
93;24.04.2017;2017;04;04;Maanantai;0;0;0
93;24.04.2017;2017;04;05;Maanantai;4;3;7
93;24.04.2017;2017;04;06;Maanantai;10;9;19
93;24.04.2017;2017;04;07;Maanantai;20;19;39
93;24.04.2017;2017;04;08;Maanantai;8;12;20
93;24.04.2017;2017;04;09;Maanantai;8;5;13
93;24.04.2017;2017;04;10;Maanantai;6;8;14
93;24.04.2017;2017;04;11;Maanantai;3;11;14
93;24.04.2017;2017;04;12;Maanantai;10;5;15
93;24.04.2017;2017;04;13;Maanantai;6;9;15
93;24.04.2017;2017;04;14;Maanantai;21;12;33
93;24.04.2017;2017;04;15;Maanantai;15;15;30
93;24.04.2017;2017;04;16;Maanantai;26;29;55
93;24.04.2017;2017;04;17;Maanantai;9;12;21
93;24.04.2017;2017;04;18;Maanantai;9;5;14
93;24.04.2017;2017;04;19;Maanantai;5;3;8
93;24.04.2017;2017;04;20;Maanantai;9;6;15
93;24.04.2017;2017;04;21;Maanantai;1;3;4
93;24.04.2017;2017;04;22;Maanantai;0;4;4
93;24.04.2017;2017;04;23;Maanantai;2;1;3
93;25.04.2017;2017;04;00;Tiistai;0;0;0
93;25.04.2017;2017;04;01;Tiistai;0;0;0
93;25.04.2017;2017;04;02;Tiistai;0;0;0
93;25.04.2017;2017;04;03;Tiistai;1;0;1
93;25.04.2017;2017;04;04;Tiistai;0;0;0
93;25.04.2017;2017;04;05;Tiistai;1;4;5
93;25.04.2017;2017;04;06;Tiistai;16;10;26
93;25.04.2017;2017;04;07;Tiistai;16;17;33
93;25.04.2017;2017;04;08;Tiistai;10;11;21
93;25.04.2017;2017;04;09;Tiistai;8;4;12
93;25.04.2017;2017;04;10;Tiistai;14;3;17
93;25.04.2017;2017;04;11;Tiistai;15;11;26
93;25.04.2017;2017;04;12;Tiistai;10;5;15
93;25.04.2017;2017;04;13;Tiistai;13;13;26
93;25.04.2017;2017;04;14;Tiistai;16;18;34
93;25.04.2017;2017;04;15;Tiistai;18;24;42
93;25.04.2017;2017;04;16;Tiistai;23;26;49
93;25.04.2017;2017;04;17;Tiistai;15;11;26
93;25.04.2017;2017;04;18;Tiistai;14;12;26
93;25.04.2017;2017;04;19;Tiistai;5;9;14
93;25.04.2017;2017;04;20;Tiistai;9;7;16
93;25.04.2017;2017;04;21;Tiistai;3;6;9
93;25.04.2017;2017;04;22;Tiistai;4;4;8
93;25.04.2017;2017;04;23;Tiistai;0;1;1
93;26.04.2017;2017;04;00;Keskiviikko;0;0;0
93;26.04.2017;2017;04;01;Keskiviikko;0;0;0
93;26.04.2017;2017;04;02;Keskiviikko;0;1;1
93;26.04.2017;2017;04;03;Keskiviikko;1;0;1
93;26.04.2017;2017;04;04;Keskiviikko;0;0;0
93;26.04.2017;2017;04;05;Keskiviikko;0;3;3
93;26.04.2017;2017;04;06;Keskiviikko;5;6;11
93;26.04.2017;2017;04;07;Keskiviikko;15;17;32
93;26.04.2017;2017;04;08;Keskiviikko;2;7;9
93;26.04.2017;2017;04;09;Keskiviikko;3;1;4
93;26.04.2017;2017;04;10;Keskiviikko;1;3;4
93;26.04.2017;2017;04;11;Keskiviikko;2;2;4
93;26.04.2017;2017;04;12;Keskiviikko;1;2;3
93;26.04.2017;2017;04;13;Keskiviikko;0;2;2
93;26.04.2017;2017;04;14;Keskiviikko;7;5;12
93;26.04.2017;2017;04;15;Keskiviikko;4;2;6
93;26.04.2017;2017;04;16;Keskiviikko;17;6;23
93;26.04.2017;2017;04;17;Keskiviikko;2;4;6
93;26.04.2017;2017;04;18;Keskiviikko;2;2;4
93;26.04.2017;2017;04;19;Keskiviikko;0;4;4
93;26.04.2017;2017;04;20;Keskiviikko;3;1;4
93;26.04.2017;2017;04;21;Keskiviikko;0;2;2
93;26.04.2017;2017;04;22;Keskiviikko;2;2;4
93;26.04.2017;2017;04;23;Keskiviikko;0;0;0
93;27.04.2017;2017;04;00;Torstai;0;0;0
93;27.04.2017;2017;04;01;Torstai;0;0;0
93;27.04.2017;2017;04;02;Torstai;0;0;0
93;27.04.2017;2017;04;03;Torstai;0;0;0
93;27.04.2017;2017;04;04;Torstai;0;0;0
93;27.04.2017;2017;04;05;Torstai;2;2;4
93;27.04.2017;2017;04;06;Torstai;5;4;9
93;27.04.2017;2017;04;07;Torstai;8;9;17
93;27.04.2017;2017;04;08;Torstai;7;11;18
93;27.04.2017;2017;04;09;Torstai;2;5;7
93;27.04.2017;2017;04;10;Torstai;2;1;3
93;27.04.2017;2017;04;11;Torstai;1;1;2
93;27.04.2017;2017;04;12;Torstai;5;2;7
93;27.04.2017;2017;04;13;Torstai;5;9;14
93;27.04.2017;2017;04;14;Torstai;6;7;13
93;27.04.2017;2017;04;15;Torstai;10;17;27
93;27.04.2017;2017;04;16;Torstai;20;10;30
93;27.04.2017;2017;04;17;Torstai;6;8;14
93;27.04.2017;2017;04;18;Torstai;7;9;16
93;27.04.2017;2017;04;19;Torstai;12;9;21
93;27.04.2017;2017;04;20;Torstai;7;8;15
93;27.04.2017;2017;04;21;Torstai;1;5;6
93;27.04.2017;2017;04;22;Torstai;1;1;2
93;27.04.2017;2017;04;23;Torstai;0;1;1
93;28.04.2017;2017;04;00;Perjantai;0;0;0
93;28.04.2017;2017;04;01;Perjantai;0;0;0
93;28.04.2017;2017;04;02;Perjantai;0;0;0
93;28.04.2017;2017;04;03;Perjantai;0;0;0
93;28.04.2017;2017;04;04;Perjantai;0;0;0
93;28.04.2017;2017;04;05;Perjantai;1;2;3
93;28.04.2017;2017;04;06;Perjantai;8;8;16
93;28.04.2017;2017;04;07;Perjantai;13;18;31
93;28.04.2017;2017;04;08;Perjantai;9;19;28
93;28.04.2017;2017;04;09;Perjantai;3;4;7
93;28.04.2017;2017;04;10;Perjantai;11;5;16
93;28.04.2017;2017;04;11;Perjantai;9;10;19
93;28.04.2017;2017;04;12;Perjantai;14;5;19
93;28.04.2017;2017;04;13;Perjantai;7;2;9
93;28.04.2017;2017;04;14;Perjantai;13;13;26
93;28.04.2017;2017;04;15;Perjantai;17;14;31
93;28.04.2017;2017;04;16;Perjantai;19;13;32
93;28.04.2017;2017;04;17;Perjantai;9;3;12
93;28.04.2017;2017;04;18;Perjantai;13;15;28
93;28.04.2017;2017;04;19;Perjantai;7;11;18
93;28.04.2017;2017;04;20;Perjantai;8;8;16
93;28.04.2017;2017;04;21;Perjantai;2;3;5
93;28.04.2017;2017;04;22;Perjantai;1;1;2
93;28.04.2017;2017;04;23;Perjantai;0;0;0
93;29.04.2017;2017;04;00;Lauantai;0;1;1
93;29.04.2017;2017;04;01;Lauantai;0;0;0
93;29.04.2017;2017;04;02;Lauantai;0;0;0
93;29.04.2017;2017;04;03;Lauantai;0;1;1
93;29.04.2017;2017;04;04;Lauantai;0;1;1
93;29.04.2017;2017;04;05;Lauantai;0;0;0
93;29.04.2017;2017;04;06;Lauantai;0;0;0
93;29.04.2017;2017;04;07;Lauantai;0;2;2
93;29.04.2017;2017;04;08;Lauantai;2;5;7
93;29.04.2017;2017;04;09;Lauantai;9;4;13
93;29.04.2017;2017;04;10;Lauantai;12;7;19
93;29.04.2017;2017;04;11;Lauantai;11;10;21
93;29.04.2017;2017;04;12;Lauantai;11;15;26
93;29.04.2017;2017;04;13;Lauantai;19;11;30
93;29.04.2017;2017;04;14;Lauantai;13;16;29
93;29.04.2017;2017;04;15;Lauantai;12;24;36
93;29.04.2017;2017;04;16;Lauantai;6;10;16
93;29.04.2017;2017;04;17;Lauantai;10;12;22
93;29.04.2017;2017;04;18;Lauantai;10;8;18
93;29.04.2017;2017;04;19;Lauantai;5;8;13
93;29.04.2017;2017;04;20;Lauantai;8;11;19
93;29.04.2017;2017;04;21;Lauantai;7;1;8
93;29.04.2017;2017;04;22;Lauantai;6;2;8
93;29.04.2017;2017;04;23;Lauantai;2;1;3
93;30.04.2017;2017;04;00;Sunnuntai;0;3;3
93;30.04.2017;2017;04;01;Sunnuntai;0;0;0
93;30.04.2017;2017;04;02;Sunnuntai;0;1;1
93;30.04.2017;2017;04;03;Sunnuntai;0;0;0
93;30.04.2017;2017;04;04;Sunnuntai;0;0;0
93;30.04.2017;2017;04;05;Sunnuntai;0;0;0
93;30.04.2017;2017;04;06;Sunnuntai;0;1;1
93;30.04.2017;2017;04;07;Sunnuntai;0;0;0
93;30.04.2017;2017;04;08;Sunnuntai;0;0;0
93;30.04.2017;2017;04;09;Sunnuntai;3;0;3
93;30.04.2017;2017;04;10;Sunnuntai;0;4;4
93;30.04.2017;2017;04;11;Sunnuntai;6;4;10
93;30.04.2017;2017;04;12;Sunnuntai;2;3;5
93;30.04.2017;2017;04;13;Sunnuntai;6;5;11
93;30.04.2017;2017;04;14;Sunnuntai;3;2;5
93;30.04.2017;2017;04;15;Sunnuntai;4;4;8
93;30.04.2017;2017;04;16;Sunnuntai;5;5;10
93;30.04.2017;2017;04;17;Sunnuntai;4;1;5
93;30.04.2017;2017;04;18;Sunnuntai;0;5;5
93;30.04.2017;2017;04;19;Sunnuntai;2;8;10
93;30.04.2017;2017;04;20;Sunnuntai;4;5;9
93;30.04.2017;2017;04;21;Sunnuntai;4;2;6
93;30.04.2017;2017;04;22;Sunnuntai;0;0;0
93;30.04.2017;2017;04;23;Sunnuntai;0;0;0
93;01.05.2017;2017;05;00;Maanantai;0;0;0
93;01.05.2017;2017;05;01;Maanantai;0;1;1
93;01.05.2017;2017;05;02;Maanantai;1;0;1
93;01.05.2017;2017;05;03;Maanantai;0;0;0
93;01.05.2017;2017;05;04;Maanantai;0;0;0
93;01.05.2017;2017;05;05;Maanantai;2;0;2
93;01.05.2017;2017;05;06;Maanantai;0;2;2
93;01.05.2017;2017;05;07;Maanantai;3;0;3
93;01.05.2017;2017;05;08;Maanantai;3;2;5
93;01.05.2017;2017;05;09;Maanantai;6;10;16
93;01.05.2017;2017;05;10;Maanantai;19;9;28
93;01.05.2017;2017;05;11;Maanantai;17;11;28
93;01.05.2017;2017;05;12;Maanantai;40;9;49
93;01.05.2017;2017;05;13;Maanantai;29;28;57
93;01.05.2017;2017;05;14;Maanantai;21;26;47
93;01.05.2017;2017;05;15;Maanantai;4;14;18
93;01.05.2017;2017;05;16;Maanantai;12;14;26
93;01.05.2017;2017;05;17;Maanantai;9;12;21
93;01.05.2017;2017;05;18;Maanantai;17;18;35
93;01.05.2017;2017;05;19;Maanantai;13;10;23
93;01.05.2017;2017;05;20;Maanantai;11;2;13
93;01.05.2017;2017;05;21;Maanantai;3;4;7
93;01.05.2017;2017;05;22;Maanantai;1;0;1
93;01.05.2017;2017;05;23;Maanantai;0;1;1
93;02.05.2017;2017;05;00;Tiistai;0;0;0
93;02.05.2017;2017;05;01;Tiistai;0;0;0
93;02.05.2017;2017;05;02;Tiistai;0;0;0
93;02.05.2017;2017;05;03;Tiistai;0;1;1
93;02.05.2017;2017;05;04;Tiistai;2;0;2
93;02.05.2017;2017;05;05;Tiistai;4;3;7
93;02.05.2017;2017;05;06;Tiistai;14;10;24
93;02.05.2017;2017;05;07;Tiistai;21;22;43
93;02.05.2017;2017;05;08;Tiistai;13;23;36
93;02.05.2017;2017;05;09;Tiistai;10;7;17
93;02.05.2017;2017;05;10;Tiistai;11;10;21
93;02.05.2017;2017;05;11;Tiistai;8;6;14
93;02.05.2017;2017;05;12;Tiistai;13;9;22
93;02.05.2017;2017;05;13;Tiistai;9;6;15
93;02.05.2017;2017;05;14;Tiistai;21;15;36
93;02.05.2017;2017;05;15;Tiistai;13;23;36
93;02.05.2017;2017;05;16;Tiistai;29;38;67
93;02.05.2017;2017;05;17;Tiistai;21;21;42
93;02.05.2017;2017;05;18;Tiistai;16;12;28
93;02.05.2017;2017;05;19;Tiistai;14;13;27
93;02.05.2017;2017;05;20;Tiistai;10;8;18
93;02.05.2017;2017;05;21;Tiistai;3;5;8
93;02.05.2017;2017;05;22;Tiistai;0;2;2
93;02.05.2017;2017;05;23;Tiistai;0;1;1
93;03.05.2017;2017;05;00;Keskiviikko;0;0;0
93;03.05.2017;2017;05;01;Keskiviikko;0;0;0
93;03.05.2017;2017;05;02;Keskiviikko;0;0;0
93;03.05.2017;2017;05;03;Keskiviikko;0;0;0
93;03.05.2017;2017;05;04;Keskiviikko;1;0;1
93;03.05.2017;2017;05;05;Keskiviikko;4;4;8
93;03.05.2017;2017;05;06;Keskiviikko;16;12;28
93;03.05.2017;2017;05;07;Keskiviikko;25;32;57
93;03.05.2017;2017;05;08;Keskiviikko;17;21;38
93;03.05.2017;2017;05;09;Keskiviikko;6;10;16
93;03.05.2017;2017;05;10;Keskiviikko;7;4;11
93;03.05.2017;2017;05;11;Keskiviikko;16;4;20
93;03.05.2017;2017;05;12;Keskiviikko;9;8;17
93;03.05.2017;2017;05;13;Keskiviikko;7;11;18
93;03.05.2017;2017;05;14;Keskiviikko;15;8;23
93;03.05.2017;2017;05;15;Keskiviikko;22;22;44
93;03.05.2017;2017;05;16;Keskiviikko;29;42;71
93;03.05.2017;2017;05;17;Keskiviikko;20;18;38
93;03.05.2017;2017;05;18;Keskiviikko;11;16;27
93;03.05.2017;2017;05;19;Keskiviikko;10;8;18
93;03.05.2017;2017;05;20;Keskiviikko;3;14;17
93;03.05.2017;2017;05;21;Keskiviikko;6;9;15
93;03.05.2017;2017;05;22;Keskiviikko;0;6;6
93;03.05.2017;2017;05;23;Keskiviikko;0;0;0
93;04.05.2017;2017;05;00;Torstai;0;1;1
93;04.05.2017;2017;05;01;Torstai;0;0;0
93;04.05.2017;2017;05;02;Torstai;0;0;0
93;04.05.2017;2017;05;03;Torstai;0;0;0
93;04.05.2017;2017;05;04;Torstai;1;0;1
93;04.05.2017;2017;05;05;Torstai;3;4;7
93;04.05.2017;2017;05;06;Torstai;19;13;32
93;04.05.2017;2017;05;07;Torstai;19;29;48
93;04.05.2017;2017;05;08;Torstai;24;19;43
93;04.05.2017;2017;05;09;Torstai;8;8;16
93;04.05.2017;2017;05;10;Torstai;9;6;15
93;04.05.2017;2017;05;11;Torstai;11;8;19
93;04.05.2017;2017;05;12;Torstai;13;8;21
93;04.05.2017;2017;05;13;Torstai;10;9;19
93;04.05.2017;2017;05;14;Torstai;13;18;31
93;04.05.2017;2017;05;15;Torstai;27;25;52
93;04.05.2017;2017;05;16;Torstai;21;37;58
93;04.05.2017;2017;05;17;Torstai;29;18;47
93;04.05.2017;2017;05;18;Torstai;5;16;21
93;04.05.2017;2017;05;19;Torstai;19;17;36
93;04.05.2017;2017;05;20;Torstai;13;13;26
93;04.05.2017;2017;05;21;Torstai;3;7;10
93;04.05.2017;2017;05;22;Torstai;0;4;4
93;04.05.2017;2017;05;23;Torstai;1;1;2
93;05.05.2017;2017;05;00;Perjantai;0;0;0
93;05.05.2017;2017;05;01;Perjantai;0;0;0
93;05.05.2017;2017;05;02;Perjantai;0;0;0
93;05.05.2017;2017;05;03;Perjantai;1;0;1
93;05.05.2017;2017;05;04;Perjantai;1;0;1
93;05.05.2017;2017;05;05;Perjantai;2;3;5
93;05.05.2017;2017;05;06;Perjantai;14;10;24
93;05.05.2017;2017;05;07;Perjantai;28;33;61
93;05.05.2017;2017;05;08;Perjantai;15;22;37
93;05.05.2017;2017;05;09;Perjantai;5;11;16
93;05.05.2017;2017;05;10;Perjantai;11;5;16
93;05.05.2017;2017;05;11;Perjantai;11;4;15
93;05.05.2017;2017;05;12;Perjantai;9;13;22
93;05.05.2017;2017;05;13;Perjantai;16;12;28
93;05.05.2017;2017;05;14;Perjantai;28;22;50
93;05.05.2017;2017;05;15;Perjantai;41;43;84
93;05.05.2017;2017;05;16;Perjantai;28;28;56
93;05.05.2017;2017;05;17;Perjantai;21;24;45
93;05.05.2017;2017;05;18;Perjantai;20;19;39
93;05.05.2017;2017;05;19;Perjantai;16;21;37
93;05.05.2017;2017;05;20;Perjantai;12;17;29
93;05.05.2017;2017;05;21;Perjantai;4;13;17
93;05.05.2017;2017;05;22;Perjantai;3;0;3
93;05.05.2017;2017;05;23;Perjantai;0;2;2
93;06.05.2017;2017;05;00;Lauantai;2;4;6
93;06.05.2017;2017;05;01;Lauantai;0;1;1
93;06.05.2017;2017;05;02;Lauantai;0;3;3
93;06.05.2017;2017;05;03;Lauantai;0;1;1
93;06.05.2017;2017;05;04;Lauantai;0;1;1
93;06.05.2017;2017;05;05;Lauantai;0;0;0
93;06.05.2017;2017;05;06;Lauantai;2;2;4
93;06.05.2017;2017;05;07;Lauantai;1;3;4
93;06.05.2017;2017;05;08;Lauantai;2;3;5
93;06.05.2017;2017;05;09;Lauantai;5;1;6
93;06.05.2017;2017;05;10;Lauantai;6;11;17
93;06.05.2017;2017;05;11;Lauantai;6;9;15
93;06.05.2017;2017;05;12;Lauantai;30;4;34
93;06.05.2017;2017;05;13;Lauantai;10;11;21
93;06.05.2017;2017;05;14;Lauantai;9;14;23
93;06.05.2017;2017;05;15;Lauantai;12;5;17
93;06.05.2017;2017;05;16;Lauantai;6;11;17
93;06.05.2017;2017;05;17;Lauantai;8;7;15
93;06.05.2017;2017;05;18;Lauantai;7;17;24
93;06.05.2017;2017;05;19;Lauantai;8;9;17
93;06.05.2017;2017;05;20;Lauantai;2;3;5
93;06.05.2017;2017;05;21;Lauantai;7;4;11
93;06.05.2017;2017;05;22;Lauantai;1;0;1
93;06.05.2017;2017;05;23;Lauantai;4;4;8
93;07.05.2017;2017;05;00;Sunnuntai;0;0;0
93;07.05.2017;2017;05;01;Sunnuntai;0;1;1
93;07.05.2017;2017;05;02;Sunnuntai;0;0;0
93;07.05.2017;2017;05;03;Sunnuntai;0;2;2
93;07.05.2017;2017;05;04;Sunnuntai;0;0;0
93;07.05.2017;2017;05;05;Sunnuntai;1;0;1
93;07.05.2017;2017;05;06;Sunnuntai;0;3;3
93;07.05.2017;2017;05;07;Sunnuntai;0;0;0
93;07.05.2017;2017;05;08;Sunnuntai;2;6;8
93;07.05.2017;2017;05;09;Sunnuntai;12;10;22
93;07.05.2017;2017;05;10;Sunnuntai;11;23;34
93;07.05.2017;2017;05;11;Sunnuntai;24;16;40
93;07.05.2017;2017;05;12;Sunnuntai;31;12;43
93;07.05.2017;2017;05;13;Sunnuntai;16;21;37
93;07.05.2017;2017;05;14;Sunnuntai;8;18;26
93;07.05.2017;2017;05;15;Sunnuntai;15;19;34
93;07.05.2017;2017;05;16;Sunnuntai;14;13;27
93;07.05.2017;2017;05;17;Sunnuntai;3;15;18
93;07.05.2017;2017;05;18;Sunnuntai;6;9;15
93;07.05.2017;2017;05;19;Sunnuntai;7;7;14
93;07.05.2017;2017;05;20;Sunnuntai;9;6;15
93;07.05.2017;2017;05;21;Sunnuntai;2;5;7
93;07.05.2017;2017;05;22;Sunnuntai;1;2;3
93;07.05.2017;2017;05;23;Sunnuntai;0;0;0
93;08.05.2017;2017;05;00;Maanantai;0;0;0
93;08.05.2017;2017;05;01;Maanantai;0;0;0
93;08.05.2017;2017;05;02;Maanantai;0;0;0
93;08.05.2017;2017;05;03;Maanantai;0;0;0
93;08.05.2017;2017;05;04;Maanantai;2;0;2
93;08.05.2017;2017;05;05;Maanantai;3;3;6
93;08.05.2017;2017;05;06;Maanantai;14;10;24
93;08.05.2017;2017;05;07;Maanantai;32;29;61
93;08.05.2017;2017;05;08;Maanantai;15;18;33
93;08.05.2017;2017;05;09;Maanantai;3;5;8
93;08.05.2017;2017;05;10;Maanantai;4;9;13
93;08.05.2017;2017;05;11;Maanantai;6;6;12
93;08.05.2017;2017;05;12;Maanantai;3;7;10
93;08.05.2017;2017;05;13;Maanantai;6;9;15
93;08.05.2017;2017;05;14;Maanantai;10;13;23
93;08.05.2017;2017;05;15;Maanantai;15;21;36
93;08.05.2017;2017;05;16;Maanantai;27;25;52
93;08.05.2017;2017;05;17;Maanantai;12;11;23
93;08.05.2017;2017;05;18;Maanantai;10;8;18
93;08.05.2017;2017;05;19;Maanantai;6;6;12
93;08.05.2017;2017;05;20;Maanantai;3;5;8
93;08.05.2017;2017;05;21;Maanantai;0;5;5
93;08.05.2017;2017;05;22;Maanantai;0;0;0
93;08.05.2017;2017;05;23;Maanantai;0;0;0
93;09.05.2017;2017;05;00;Tiistai;1;0;1
93;09.05.2017;2017;05;01;Tiistai;0;0;0
93;09.05.2017;2017;05;02;Tiistai;0;0;0
93;09.05.2017;2017;05;03;Tiistai;0;0;0
93;09.05.2017;2017;05;04;Tiistai;1;0;1
93;09.05.2017;2017;05;05;Tiistai;3;3;6
93;09.05.2017;2017;05;06;Tiistai;17;8;25
93;09.05.2017;2017;05;07;Tiistai;19;24;43
93;09.05.2017;2017;05;08;Tiistai;9;27;36
93;09.05.2017;2017;05;09;Tiistai;7;6;13
93;09.05.2017;2017;05;10;Tiistai;5;7;12
93;09.05.2017;2017;05;11;Tiistai;8;5;13
93;09.05.2017;2017;05;12;Tiistai;4;7;11
93;09.05.2017;2017;05;13;Tiistai;4;7;11
93;09.05.2017;2017;05;14;Tiistai;10;14;24
93;09.05.2017;2017;05;15;Tiistai;19;20;39
93;09.05.2017;2017;05;16;Tiistai;22;31;53
93;09.05.2017;2017;05;17;Tiistai;10;6;16
93;09.05.2017;2017;05;18;Tiistai;12;17;29
93;09.05.2017;2017;05;19;Tiistai;6;15;21
93;09.05.2017;2017;05;20;Tiistai;6;10;16
93;09.05.2017;2017;05;21;Tiistai;4;3;7
93;09.05.2017;2017;05;22;Tiistai;4;2;6
93;09.05.2017;2017;05;23;Tiistai;0;0;0
93;10.05.2017;2017;05;00;Keskiviikko;1;0;1
93;10.05.2017;2017;05;01;Keskiviikko;0;0;0
93;10.05.2017;2017;05;02;Keskiviikko;0;0;0
93;10.05.2017;2017;05;03;Keskiviikko;0;0;0
93;10.05.2017;2017;05;04;Keskiviikko;0;0;0
93;10.05.2017;2017;05;05;Keskiviikko;4;2;6
93;10.05.2017;2017;05;06;Keskiviikko;9;11;20
93;10.05.2017;2017;05;07;Keskiviikko;20;21;41
93;10.05.2017;2017;05;08;Keskiviikko;13;24;37
93;10.05.2017;2017;05;09;Keskiviikko;6;7;13
93;10.05.2017;2017;05;10;Keskiviikko;8;1;9
93;10.05.2017;2017;05;11;Keskiviikko;9;6;15
93;10.05.2017;2017;05;12;Keskiviikko;5;2;7
93;10.05.2017;2017;05;13;Keskiviikko;3;10;13
93;10.05.2017;2017;05;14;Keskiviikko;11;15;26
93;10.05.2017;2017;05;15;Keskiviikko;13;14;27
93;10.05.2017;2017;05;16;Keskiviikko;20;22;42
93;10.05.2017;2017;05;17;Keskiviikko;16;11;27
93;10.05.2017;2017;05;18;Keskiviikko;8;11;19
93;10.05.2017;2017;05;19;Keskiviikko;7;4;11
93;10.05.2017;2017;05;20;Keskiviikko;5;12;17
93;10.05.2017;2017;05;21;Keskiviikko;1;2;3
93;10.05.2017;2017;05;22;Keskiviikko;3;0;3
93;10.05.2017;2017;05;23;Keskiviikko;0;1;1
93;11.05.2017;2017;05;00;Torstai;0;0;0
93;11.05.2017;2017;05;01;Torstai;0;0;0
93;11.05.2017;2017;05;02;Torstai;0;0;0
93;11.05.2017;2017;05;03;Torstai;0;0;0
93;11.05.2017;2017;05;04;Torstai;1;0;1
93;11.05.2017;2017;05;05;Torstai;2;3;5
93;11.05.2017;2017;05;06;Torstai;12;11;23
93;11.05.2017;2017;05;07;Torstai;16;22;38
93;11.05.2017;2017;05;08;Torstai;16;24;40
93;11.05.2017;2017;05;09;Torstai;7;6;13
93;11.05.2017;2017;05;10;Torstai;5;5;10
93;11.05.2017;2017;05;11;Torstai;4;2;6
93;11.05.2017;2017;05;12;Torstai;6;4;10
93;11.05.2017;2017;05;13;Torstai;5;6;11
93;11.05.2017;2017;05;14;Torstai;8;8;16
93;11.05.2017;2017;05;15;Torstai;14;18;32
93;11.05.2017;2017;05;16;Torstai;34;24;58
93;11.05.2017;2017;05;17;Torstai;14;11;25
93;11.05.2017;2017;05;18;Torstai;7;14;21
93;11.05.2017;2017;05;19;Torstai;13;17;30
93;11.05.2017;2017;05;20;Torstai;5;8;13
93;11.05.2017;2017;05;21;Torstai;3;5;8
93;11.05.2017;2017;05;22;Torstai;1;2;3
93;11.05.2017;2017;05;23;Torstai;2;1;3
93;12.05.2017;2017;05;00;Perjantai;0;0;0
93;12.05.2017;2017;05;01;Perjantai;0;0;0
93;12.05.2017;2017;05;02;Perjantai;0;0;0
93;12.05.2017;2017;05;03;Perjantai;0;0;0
93;12.05.2017;2017;05;04;Perjantai;1;0;1
93;12.05.2017;2017;05;05;Perjantai;5;2;7
93;12.05.2017;2017;05;06;Perjantai;17;8;25
93;12.05.2017;2017;05;07;Perjantai;19;25;44
93;12.05.2017;2017;05;08;Perjantai;8;19;27
93;12.05.2017;2017;05;09;Perjantai;10;5;15
93;12.05.2017;2017;05;10;Perjantai;8;8;16
93;12.05.2017;2017;05;11;Perjantai;9;6;15
93;12.05.2017;2017;05;12;Perjantai;3;8;11
93;12.05.2017;2017;05;13;Perjantai;10;7;17
93;12.05.2017;2017;05;14;Perjantai;15;19;34
93;12.05.2017;2017;05;15;Perjantai;17;25;42
93;12.05.2017;2017;05;16;Perjantai;25;13;38
93;12.05.2017;2017;05;17;Perjantai;15;6;21
93;12.05.2017;2017;05;18;Perjantai;11;18;29
93;12.05.2017;2017;05;19;Perjantai;9;10;19
93;12.05.2017;2017;05;20;Perjantai;6;12;18
93;12.05.2017;2017;05;21;Perjantai;4;2;6
93;12.05.2017;2017;05;22;Perjantai;2;4;6
93;12.05.2017;2017;05;23;Perjantai;2;0;2
93;13.05.2017;2017;05;00;Lauantai;1;2;3
93;13.05.2017;2017;05;01;Lauantai;0;2;2
93;13.05.2017;2017;05;02;Lauantai;0;0;0
93;13.05.2017;2017;05;03;Lauantai;1;0;1
93;13.05.2017;2017;05;04;Lauantai;0;0;0
93;13.05.2017;2017;05;05;Lauantai;0;1;1
93;13.05.2017;2017;05;06;Lauantai;0;1;1
93;13.05.2017;2017;05;07;Lauantai;1;1;2
93;13.05.2017;2017;05;08;Lauantai;1;2;3
93;13.05.2017;2017;05;09;Lauantai;8;6;14
93;13.05.2017;2017;05;10;Lauantai;7;12;19
93;13.05.2017;2017;05;11;Lauantai;8;7;15
93;13.05.2017;2017;05;12;Lauantai;16;8;24
93;13.05.2017;2017;05;13;Lauantai;16;20;36
93;13.05.2017;2017;05;14;Lauantai;16;15;31
93;13.05.2017;2017;05;15;Lauantai;8;10;18
93;13.05.2017;2017;05;16;Lauantai;17;20;37
93;13.05.2017;2017;05;17;Lauantai;16;10;26
93;13.05.2017;2017;05;18;Lauantai;14;14;28
93;13.05.2017;2017;05;19;Lauantai;7;11;18
93;13.05.2017;2017;05;20;Lauantai;10;8;18
93;13.05.2017;2017;05;21;Lauantai;4;8;12
93;13.05.2017;2017;05;22;Lauantai;3;6;9
93;13.05.2017;2017;05;23;Lauantai;4;2;6
93;14.05.2017;2017;05;00;Sunnuntai;2;1;3
93;14.05.2017;2017;05;01;Sunnuntai;0;2;2
93;14.05.2017;2017;05;02;Sunnuntai;0;0;0
93;14.05.2017;2017;05;03;Sunnuntai;0;0;0
93;14.05.2017;2017;05;04;Sunnuntai;0;0;0
93;14.05.2017;2017;05;05;Sunnuntai;1;0;1
93;14.05.2017;2017;05;06;Sunnuntai;1;2;3
93;14.05.2017;2017;05;07;Sunnuntai;4;0;4
93;14.05.2017;2017;05;08;Sunnuntai;2;4;6
93;14.05.2017;2017;05;09;Sunnuntai;6;0;6
93;14.05.2017;2017;05;10;Sunnuntai;0;5;5
93;14.05.2017;2017;05;11;Sunnuntai;3;1;4
93;14.05.2017;2017;05;12;Sunnuntai;3;1;4
93;14.05.2017;2017;05;13;Sunnuntai;1;1;2
93;14.05.2017;2017;05;14;Sunnuntai;0;0;0
93;14.05.2017;2017;05;15;Sunnuntai;6;1;7
93;14.05.2017;2017;05;16;Sunnuntai;2;0;2
93;14.05.2017;2017;05;17;Sunnuntai;2;2;4
93;14.05.2017;2017;05;18;Sunnuntai;1;4;5
93;14.05.2017;2017;05;19;Sunnuntai;1;5;6
93;14.05.2017;2017;05;20;Sunnuntai;0;4;4
93;14.05.2017;2017;05;21;Sunnuntai;2;3;5
93;14.05.2017;2017;05;22;Sunnuntai;0;2;2
93;14.05.2017;2017;05;23;Sunnuntai;0;0;0
93;15.05.2017;2017;05;00;Maanantai;0;1;1
93;15.05.2017;2017;05;01;Maanantai;0;0;0
93;15.05.2017;2017;05;02;Maanantai;0;0;0
93;15.05.2017;2017;05;03;Maanantai;0;0;0
93;15.05.2017;2017;05;04;Maanantai;1;1;2
93;15.05.2017;2017;05;05;Maanantai;5;3;8
93;15.05.2017;2017;05;06;Maanantai;13;7;20
93;15.05.2017;2017;05;07;Maanantai;20;29;49
93;15.05.2017;2017;05;08;Maanantai;15;22;37
93;15.05.2017;2017;05;09;Maanantai;7;11;18
93;15.05.2017;2017;05;10;Maanantai;8;5;13
93;15.05.2017;2017;05;11;Maanantai;3;3;6
93;15.05.2017;2017;05;12;Maanantai;8;7;15
93;15.05.2017;2017;05;13;Maanantai;11;7;18
93;15.05.2017;2017;05;14;Maanantai;16;11;27
93;15.05.2017;2017;05;15;Maanantai;27;20;47
93;15.05.2017;2017;05;16;Maanantai;33;31;64
93;15.05.2017;2017;05;17;Maanantai;26;32;58
93;15.05.2017;2017;05;18;Maanantai;21;25;46
93;15.05.2017;2017;05;19;Maanantai;13;17;30
93;15.05.2017;2017;05;20;Maanantai;12;11;23
93;15.05.2017;2017;05;21;Maanantai;4;6;10
93;15.05.2017;2017;05;22;Maanantai;1;2;3
93;15.05.2017;2017;05;23;Maanantai;0;1;1
93;16.05.2017;2017;05;00;Tiistai;0;0;0
93;16.05.2017;2017;05;01;Tiistai;0;0;0
93;16.05.2017;2017;05;02;Tiistai;0;0;0
93;16.05.2017;2017;05;03;Tiistai;1;0;1
93;16.05.2017;2017;05;04;Tiistai;2;1;3
93;16.05.2017;2017;05;05;Tiistai;5;3;8
93;16.05.2017;2017;05;06;Tiistai;18;11;29
93;16.05.2017;2017;05;07;Tiistai;20;30;50
93;16.05.2017;2017;05;08;Tiistai;13;22;35
93;16.05.2017;2017;05;09;Tiistai;13;10;23
93;16.05.2017;2017;05;10;Tiistai;12;5;17
93;16.05.2017;2017;05;11;Tiistai;4;7;11
93;16.05.2017;2017;05;12;Tiistai;15;13;28
93;16.05.2017;2017;05;13;Tiistai;9;14;23
93;16.05.2017;2017;05;14;Tiistai;16;14;30
93;16.05.2017;2017;05;15;Tiistai;22;16;38
93;16.05.2017;2017;05;16;Tiistai;43;34;77
93;16.05.2017;2017;05;17;Tiistai;25;29;54
93;16.05.2017;2017;05;18;Tiistai;27;29;56
93;16.05.2017;2017;05;19;Tiistai;25;31;56
93;16.05.2017;2017;05;20;Tiistai;10;22;32
93;16.05.2017;2017;05;21;Tiistai;7;5;12
93;16.05.2017;2017;05;22;Tiistai;1;4;5
93;16.05.2017;2017;05;23;Tiistai;0;1;1
93;17.05.2017;2017;05;00;Keskiviikko;0;1;1
93;17.05.2017;2017;05;01;Keskiviikko;0;0;0
93;17.05.2017;2017;05;02;Keskiviikko;0;1;1
93;17.05.2017;2017;05;03;Keskiviikko;0;0;0
93;17.05.2017;2017;05;04;Keskiviikko;3;1;4
93;17.05.2017;2017;05;05;Keskiviikko;3;2;5
93;17.05.2017;2017;05;06;Keskiviikko;11;9;20
93;17.05.2017;2017;05;07;Keskiviikko;19;13;32
93;17.05.2017;2017;05;08;Keskiviikko;5;13;18
93;17.05.2017;2017;05;09;Keskiviikko;5;3;8
93;17.05.2017;2017;05;10;Keskiviikko;2;2;4
93;17.05.2017;2017;05;11;Keskiviikko;3;0;3
93;17.05.2017;2017;05;12;Keskiviikko;4;2;6
93;17.05.2017;2017;05;13;Keskiviikko;1;6;7
93;17.05.2017;2017;05;14;Keskiviikko;7;4;11
93;17.05.2017;2017;05;15;Keskiviikko;8;7;15
93;17.05.2017;2017;05;16;Keskiviikko;17;15;32
93;17.05.2017;2017;05;17;Keskiviikko;15;13;28
93;17.05.2017;2017;05;18;Keskiviikko;5;3;8
93;17.05.2017;2017;05;19;Keskiviikko;1;5;6
93;17.05.2017;2017;05;20;Keskiviikko;3;3;6
93;17.05.2017;2017;05;21;Keskiviikko;2;2;4
93;17.05.2017;2017;05;22;Keskiviikko;1;1;2
93;17.05.2017;2017;05;23;Keskiviikko;1;0;1
93;18.05.2017;2017;05;00;Torstai;0;0;0
93;18.05.2017;2017;05;01;Torstai;0;0;0
93;18.05.2017;2017;05;02;Torstai;0;0;0
93;18.05.2017;2017;05;03;Torstai;0;0;0
93;18.05.2017;2017;05;04;Torstai;1;1;2
93;18.05.2017;2017;05;05;Torstai;4;4;8
93;18.05.2017;2017;05;06;Torstai;16;8;24
93;18.05.2017;2017;05;07;Torstai;29;30;59
93;18.05.2017;2017;05;08;Torstai;19;19;38
93;18.05.2017;2017;05;09;Torstai;4;7;11
93;18.05.2017;2017;05;10;Torstai;12;7;19
93;18.05.2017;2017;05;11;Torstai;5;3;8
93;18.05.2017;2017;05;12;Torstai;10;7;17
93;18.05.2017;2017;05;13;Torstai;41;19;60
93;18.05.2017;2017;05;14;Torstai;11;20;31
93;18.05.2017;2017;05;15;Torstai;30;23;53
93;18.05.2017;2017;05;16;Torstai;40;73;113
93;18.05.2017;2017;05;17;Torstai;24;20;44
93;18.05.2017;2017;05;18;Torstai;6;14;20
93;18.05.2017;2017;05;19;Torstai;11;16;27
93;18.05.2017;2017;05;20;Torstai;11;17;28
93;18.05.2017;2017;05;21;Torstai;5;7;12
93;18.05.2017;2017;05;22;Torstai;1;7;8
93;18.05.2017;2017;05;23;Torstai;0;0;0
93;19.05.2017;2017;05;00;Perjantai;0;1;1
93;19.05.2017;2017;05;01;Perjantai;0;0;0
93;19.05.2017;2017;05;02;Perjantai;0;0;0
93;19.05.2017;2017;05;03;Perjantai;0;0;0
93;19.05.2017;2017;05;04;Perjantai;0;0;0
93;19.05.2017;2017;05;05;Perjantai;1;1;2
93;19.05.2017;2017;05;06;Perjantai;6;4;10
93;19.05.2017;2017;05;07;Perjantai;5;7;12
93;19.05.2017;2017;05;08;Perjantai;4;8;12
93;19.05.2017;2017;05;09;Perjantai;2;1;3
93;19.05.2017;2017;05;10;Perjantai;5;1;6
93;19.05.2017;2017;05;11;Perjantai;4;3;7
93;19.05.2017;2017;05;12;Perjantai;4;6;10
93;19.05.2017;2017;05;13;Perjantai;9;9;18
93;19.05.2017;2017;05;14;Perjantai;10;10;20
93;19.05.2017;2017;05;15;Perjantai;10;12;22
93;19.05.2017;2017;05;16;Perjantai;9;11;20
93;19.05.2017;2017;05;17;Perjantai;8;12;20
93;19.05.2017;2017;05;18;Perjantai;13;12;25
93;19.05.2017;2017;05;19;Perjantai;10;15;25
93;19.05.2017;2017;05;20;Perjantai;9;7;16
93;19.05.2017;2017;05;21;Perjantai;2;3;5
93;19.05.2017;2017;05;22;Perjantai;1;0;1
93;19.05.2017;2017;05;23;Perjantai;0;2;2
93;20.05.2017;2017;05;00;Lauantai;3;0;3
93;20.05.2017;2017;05;01;Lauantai;0;2;2
93;20.05.2017;2017;05;02;Lauantai;0;1;1
93;20.05.2017;2017;05;03;Lauantai;0;0;0
93;20.05.2017;2017;05;04;Lauantai;0;2;2
93;20.05.2017;2017;05;05;Lauantai;1;0;1
93;20.05.2017;2017;05;06;Lauantai;2;1;3
93;20.05.2017;2017;05;07;Lauantai;1;3;4
93;20.05.2017;2017;05;08;Lauantai;2;7;9
93;20.05.2017;2017;05;09;Lauantai;13;9;22
93;20.05.2017;2017;05;10;Lauantai;17;14;31
93;20.05.2017;2017;05;11;Lauantai;23;13;36
93;20.05.2017;2017;05;12;Lauantai;22;28;50
93;20.05.2017;2017;05;13;Lauantai;16;25;41
93;20.05.2017;2017;05;14;Lauantai;23;20;43
93;20.05.2017;2017;05;15;Lauantai;16;14;30
93;20.05.2017;2017;05;16;Lauantai;10;25;35
93;20.05.2017;2017;05;17;Lauantai;14;17;31
93;20.05.2017;2017;05;18;Lauantai;11;20;31
93;20.05.2017;2017;05;19;Lauantai;23;13;36
93;20.05.2017;2017;05;20;Lauantai;5;9;14
93;20.05.2017;2017;05;21;Lauantai;1;7;8
93;20.05.2017;2017;05;22;Lauantai;2;10;12
93;20.05.2017;2017;05;23;Lauantai;2;2;4
93;21.05.2017;2017;05;00;Sunnuntai;0;1;1
93;21.05.2017;2017;05;01;Sunnuntai;0;0;0
93;21.05.2017;2017;05;02;Sunnuntai;0;0;0
93;21.05.2017;2017;05;03;Sunnuntai;0;0;0
93;21.05.2017;2017;05;04;Sunnuntai;0;2;2
93;21.05.2017;2017;05;05;Sunnuntai;0;0;0
93;21.05.2017;2017;05;06;Sunnuntai;3;2;5
93;21.05.2017;2017;05;07;Sunnuntai;3;1;4
93;21.05.2017;2017;05;08;Sunnuntai;7;2;9
93;21.05.2017;2017;05;09;Sunnuntai;10;17;27
93;21.05.2017;2017;05;10;Sunnuntai;11;13;24
93;21.05.2017;2017;05;11;Sunnuntai;23;18;41
93;21.05.2017;2017;05;12;Sunnuntai;20;23;43
93;21.05.2017;2017;05;13;Sunnuntai;29;24;53
93;21.05.2017;2017;05;14;Sunnuntai;26;29;55
93;21.05.2017;2017;05;15;Sunnuntai;37;23;60
93;21.05.2017;2017;05;16;Sunnuntai;26;35;61
93;21.05.2017;2017;05;17;Sunnuntai;18;26;44
93;21.05.2017;2017;05;18;Sunnuntai;9;25;34
93;21.05.2017;2017;05;19;Sunnuntai;19;15;34
93;21.05.2017;2017;05;20;Sunnuntai;17;10;27
93;21.05.2017;2017;05;21;Sunnuntai;8;6;14
93;21.05.2017;2017;05;22;Sunnuntai;1;2;3
93;21.05.2017;2017;05;23;Sunnuntai;1;1;2
93;22.05.2017;2017;05;00;Maanantai;0;0;0
93;22.05.2017;2017;05;01;Maanantai;0;0;0
93;22.05.2017;2017;05;02;Maanantai;0;0;0
93;22.05.2017;2017;05;03;Maanantai;0;0;0
93;22.05.2017;2017;05;04;Maanantai;0;2;2
93;22.05.2017;2017;05;05;Maanantai;4;2;6
93;22.05.2017;2017;05;06;Maanantai;28;13;41
93;22.05.2017;2017;05;07;Maanantai;30;37;67
93;22.05.2017;2017;05;08;Maanantai;10;27;37
93;22.05.2017;2017;05;09;Maanantai;10;9;19
93;22.05.2017;2017;05;10;Maanantai;16;4;20
93;22.05.2017;2017;05;11;Maanantai;9;12;21
93;22.05.2017;2017;05;12;Maanantai;14;11;25
93;22.05.2017;2017;05;13;Maanantai;10;13;23
93;22.05.2017;2017;05;14;Maanantai;19;30;49
93;22.05.2017;2017;05;15;Maanantai;32;32;64
93;22.05.2017;2017;05;16;Maanantai;40;37;77
93;22.05.2017;2017;05;17;Maanantai;26;25;51
93;22.05.2017;2017;05;18;Maanantai;25;30;55
93;22.05.2017;2017;05;19;Maanantai;19;25;44
93;22.05.2017;2017;05;20;Maanantai;19;16;35
93;22.05.2017;2017;05;21;Maanantai;11;13;24
93;22.05.2017;2017;05;22;Maanantai;2;2;4
93;22.05.2017;2017;05;23;Maanantai;1;1;2
93;23.05.2017;2017;05;00;Tiistai;1;1;2
93;23.05.2017;2017;05;01;Tiistai;0;0;0
93;23.05.2017;2017;05;02;Tiistai;0;0;0
93;23.05.2017;2017;05;03;Tiistai;0;0;0
93;23.05.2017;2017;05;04;Tiistai;1;0;1
93;23.05.2017;2017;05;05;Tiistai;7;6;13
93;23.05.2017;2017;05;06;Tiistai;26;15;41
93;23.05.2017;2017;05;07;Tiistai;23;42;65
93;23.05.2017;2017;05;08;Tiistai;25;107;132
93;23.05.2017;2017;05;09;Tiistai;10;12;22
93;23.05.2017;2017;05;10;Tiistai;18;10;28
93;23.05.2017;2017;05;11;Tiistai;102;11;113
93;23.05.2017;2017;05;12;Tiistai;10;8;18
93;23.05.2017;2017;05;13;Tiistai;13;14;27
93;23.05.2017;2017;05;14;Tiistai;19;16;35
93;23.05.2017;2017;05;15;Tiistai;23;38;61
93;23.05.2017;2017;05;16;Tiistai;44;48;92
93;23.05.2017;2017;05;17;Tiistai;28;21;49
93;23.05.2017;2017;05;18;Tiistai;21;30;51
93;23.05.2017;2017;05;19;Tiistai;23;21;44
93;23.05.2017;2017;05;20;Tiistai;12;21;33
93;23.05.2017;2017;05;21;Tiistai;10;12;22
93;23.05.2017;2017;05;22;Tiistai;3;4;7
93;23.05.2017;2017;05;23;Tiistai;1;2;3
93;24.05.2017;2017;05;00;Keskiviikko;1;1;2
93;24.05.2017;2017;05;01;Keskiviikko;0;0;0
93;24.05.2017;2017;05;02;Keskiviikko;0;0;0
93;24.05.2017;2017;05;03;Keskiviikko;0;0;0
93;24.05.2017;2017;05;04;Keskiviikko;1;0;1
93;24.05.2017;2017;05;05;Keskiviikko;8;5;13
93;24.05.2017;2017;05;06;Keskiviikko;24;18;42
93;24.05.2017;2017;05;07;Keskiviikko;29;33;62
93;24.05.2017;2017;05;08;Keskiviikko;24;23;47
93;24.05.2017;2017;05;09;Keskiviikko;12;10;22
93;24.05.2017;2017;05;10;Keskiviikko;9;11;20
93;24.05.2017;2017;05;11;Keskiviikko;13;12;25
93;24.05.2017;2017;05;12;Keskiviikko;12;15;27
93;24.05.2017;2017;05;13;Keskiviikko;21;16;37
93;24.05.2017;2017;05;14;Keskiviikko;11;17;28
93;24.05.2017;2017;05;15;Keskiviikko;35;34;69
93;24.05.2017;2017;05;16;Keskiviikko;46;49;95
93;24.05.2017;2017;05;17;Keskiviikko;35;31;66
93;24.05.2017;2017;05;18;Keskiviikko;21;45;66
93;24.05.2017;2017;05;19;Keskiviikko;24;24;48
93;24.05.2017;2017;05;20;Keskiviikko;21;19;40
93;24.05.2017;2017;05;21;Keskiviikko;4;8;12
93;24.05.2017;2017;05;22;Keskiviikko;6;7;13
93;24.05.2017;2017;05;23;Keskiviikko;3;6;9
93;25.05.2017;2017;05;00;Torstai;0;2;2
93;25.05.2017;2017;05;01;Torstai;0;0;0
93;25.05.2017;2017;05;02;Torstai;0;1;1
93;25.05.2017;2017;05;03;Torstai;0;0;0
93;25.05.2017;2017;05;04;Torstai;1;2;3
93;25.05.2017;2017;05;05;Torstai;1;2;3
93;25.05.2017;2017;05;06;Torstai;3;6;9
93;25.05.2017;2017;05;07;Torstai;5;8;13
93;25.05.2017;2017;05;08;Torstai;6;4;10
93;25.05.2017;2017;05;09;Torstai;4;14;18
93;25.05.2017;2017;05;10;Torstai;29;13;42
93;25.05.2017;2017;05;11;Torstai;42;16;58
93;25.05.2017;2017;05;12;Torstai;15;22;37
93;25.05.2017;2017;05;13;Torstai;11;25;36
93;25.05.2017;2017;05;14;Torstai;12;13;25
93;25.05.2017;2017;05;15;Torstai;22;17;39
93;25.05.2017;2017;05;16;Torstai;32;27;59
93;25.05.2017;2017;05;17;Torstai;19;21;40
93;25.05.2017;2017;05;18;Torstai;15;15;30
93;25.05.2017;2017;05;19;Torstai;9;12;21
93;25.05.2017;2017;05;20;Torstai;7;8;15
93;25.05.2017;2017;05;21;Torstai;9;8;17
93;25.05.2017;2017;05;22;Torstai;6;6;12
93;25.05.2017;2017;05;23;Torstai;0;3;3
93;26.05.2017;2017;05;00;Perjantai;2;0;2
93;26.05.2017;2017;05;01;Perjantai;0;0;0
93;26.05.2017;2017;05;02;Perjantai;1;0;1
93;26.05.2017;2017;05;03;Perjantai;0;0;0
93;26.05.2017;2017;05;04;Perjantai;0;0;0
93;26.05.2017;2017;05;05;Perjantai;6;4;10
93;26.05.2017;2017;05;06;Perjantai;13;6;19
93;26.05.2017;2017;05;07;Perjantai;20;26;46
93;26.05.2017;2017;05;08;Perjantai;15;17;32
93;26.05.2017;2017;05;09;Perjantai;5;4;9
93;26.05.2017;2017;05;10;Perjantai;13;10;23
93;26.05.2017;2017;05;11;Perjantai;15;5;20
93;26.05.2017;2017;05;12;Perjantai;6;12;18
93;26.05.2017;2017;05;13;Perjantai;17;11;28
93;26.05.2017;2017;05;14;Perjantai;17;17;34
93;26.05.2017;2017;05;15;Perjantai;23;27;50
93;26.05.2017;2017;05;16;Perjantai;24;29;53
93;26.05.2017;2017;05;17;Perjantai;13;19;32
93;26.05.2017;2017;05;18;Perjantai;8;15;23
93;26.05.2017;2017;05;19;Perjantai;10;16;26
93;26.05.2017;2017;05;20;Perjantai;9;10;19
93;26.05.2017;2017;05;21;Perjantai;7;7;14
93;26.05.2017;2017;05;22;Perjantai;3;2;5
93;26.05.2017;2017;05;23;Perjantai;1;2;3
93;27.05.2017;2017;05;00;Lauantai;0;1;1
93;27.05.2017;2017;05;01;Lauantai;1;2;3
93;27.05.2017;2017;05;02;Lauantai;1;1;2
93;27.05.2017;2017;05;03;Lauantai;0;0;0
93;27.05.2017;2017;05;04;Lauantai;0;0;0
93;27.05.2017;2017;05;05;Lauantai;2;0;2
93;27.05.2017;2017;05;06;Lauantai;1;1;2
93;27.05.2017;2017;05;07;Lauantai;2;1;3
93;27.05.2017;2017;05;08;Lauantai;3;5;8
93;27.05.2017;2017;05;09;Lauantai;8;5;13
93;27.05.2017;2017;05;10;Lauantai;7;8;15
93;27.05.2017;2017;05;11;Lauantai;15;6;21
93;27.05.2017;2017;05;12;Lauantai;15;10;25
93;27.05.2017;2017;05;13;Lauantai;11;17;28
93;27.05.2017;2017;05;14;Lauantai;15;16;31
93;27.05.2017;2017;05;15;Lauantai;10;7;17
93;27.05.2017;2017;05;16;Lauantai;5;12;17
93;27.05.2017;2017;05;17;Lauantai;5;6;11
93;27.05.2017;2017;05;18;Lauantai;6;8;14
93;27.05.2017;2017;05;19;Lauantai;10;3;13
93;27.05.2017;2017;05;20;Lauantai;4;6;10
93;27.05.2017;2017;05;21;Lauantai;1;4;5
93;27.05.2017;2017;05;22;Lauantai;0;4;4
93;27.05.2017;2017;05;23;Lauantai;1;1;2
93;28.05.2017;2017;05;00;Sunnuntai;0;0;0
93;28.05.2017;2017;05;01;Sunnuntai;0;1;1
93;28.05.2017;2017;05;02;Sunnuntai;0;0;0
93;28.05.2017;2017;05;03;Sunnuntai;0;0;0
93;28.05.2017;2017;05;04;Sunnuntai;0;0;0
93;28.05.2017;2017;05;05;Sunnuntai;1;0;1
93;28.05.2017;2017;05;06;Sunnuntai;3;1;4
93;28.05.2017;2017;05;07;Sunnuntai;1;0;1
93;28.05.2017;2017;05;08;Sunnuntai;0;3;3
93;28.05.2017;2017;05;09;Sunnuntai;6;7;13
93;28.05.2017;2017;05;10;Sunnuntai;13;7;20
93;28.05.2017;2017;05;11;Sunnuntai;2;1;3
93;28.05.2017;2017;05;12;Sunnuntai;1;1;2
93;28.05.2017;2017;05;13;Sunnuntai;2;2;4
93;28.05.2017;2017;05;14;Sunnuntai;2;0;2
93;28.05.2017;2017;05;15;Sunnuntai;0;2;2
93;28.05.2017;2017;05;16;Sunnuntai;4;5;9
93;28.05.2017;2017;05;17;Sunnuntai;5;3;8
93;28.05.2017;2017;05;18;Sunnuntai;8;8;16
93;28.05.2017;2017;05;19;Sunnuntai;6;7;13
93;28.05.2017;2017;05;20;Sunnuntai;11;5;16
93;28.05.2017;2017;05;21;Sunnuntai;1;1;2
93;28.05.2017;2017;05;22;Sunnuntai;1;0;1
93;28.05.2017;2017;05;23;Sunnuntai;0;0;0
93;29.05.2017;2017;05;00;Maanantai;0;0;0
93;29.05.2017;2017;05;01;Maanantai;0;0;0
93;29.05.2017;2017;05;02;Maanantai;0;0;0
93;29.05.2017;2017;05;03;Maanantai;0;0;0
93;29.05.2017;2017;05;04;Maanantai;1;0;1
93;29.05.2017;2017;05;05;Maanantai;2;4;6
93;29.05.2017;2017;05;06;Maanantai;14;9;23
93;29.05.2017;2017;05;07;Maanantai;21;30;51
93;29.05.2017;2017;05;08;Maanantai;15;119;134
93;29.05.2017;2017;05;09;Maanantai;10;3;13
93;29.05.2017;2017;05;10;Maanantai;28;9;37
93;29.05.2017;2017;05;11;Maanantai;102;5;107
93;29.05.2017;2017;05;12;Maanantai;11;11;22
93;29.05.2017;2017;05;13;Maanantai;18;32;50
93;29.05.2017;2017;05;14;Maanantai;11;9;20
93;29.05.2017;2017;05;15;Maanantai;23;23;46
93;29.05.2017;2017;05;16;Maanantai;34;33;67
93;29.05.2017;2017;05;17;Maanantai;15;18;33
93;29.05.2017;2017;05;18;Maanantai;21;22;43
93;29.05.2017;2017;05;19;Maanantai;15;22;37
93;29.05.2017;2017;05;20;Maanantai;8;12;20
93;29.05.2017;2017;05;21;Maanantai;4;11;15
93;29.05.2017;2017;05;22;Maanantai;0;3;3
93;29.05.2017;2017;05;23;Maanantai;1;2;3
93;30.05.2017;2017;05;00;Tiistai;0;2;2
93;30.05.2017;2017;05;01;Tiistai;0;1;1
93;30.05.2017;2017;05;02;Tiistai;0;0;0
93;30.05.2017;2017;05;03;Tiistai;0;0;0
93;30.05.2017;2017;05;04;Tiistai;0;2;2
93;30.05.2017;2017;05;05;Tiistai;5;5;10
93;30.05.2017;2017;05;06;Tiistai;17;8;25
93;30.05.2017;2017;05;07;Tiistai;31;35;66
93;30.05.2017;2017;05;08;Tiistai;23;25;48
93;30.05.2017;2017;05;09;Tiistai;160;14;174
93;30.05.2017;2017;05;10;Tiistai;64;8;72
93;30.05.2017;2017;05;11;Tiistai;6;13;19
93;30.05.2017;2017;05;12;Tiistai;18;100;118
93;30.05.2017;2017;05;13;Tiistai;16;107;123
93;30.05.2017;2017;05;14;Tiistai;20;67;87
93;30.05.2017;2017;05;15;Tiistai;39;25;64
93;30.05.2017;2017;05;16;Tiistai;34;46;80
93;30.05.2017;2017;05;17;Tiistai;31;30;61
93;30.05.2017;2017;05;18;Tiistai;14;34;48
93;30.05.2017;2017;05;19;Tiistai;24;29;53
93;30.05.2017;2017;05;20;Tiistai;15;17;32
93;30.05.2017;2017;05;21;Tiistai;10;10;20
93;30.05.2017;2017;05;22;Tiistai;4;8;12
93;30.05.2017;2017;05;23;Tiistai;1;1;2
93;31.05.2017;2017;05;00;Keskiviikko;0;2;2
93;31.05.2017;2017;05;01;Keskiviikko;0;0;0
93;31.05.2017;2017;05;02;Keskiviikko;0;0;0
93;31.05.2017;2017;05;03;Keskiviikko;0;0;0
93;31.05.2017;2017;05;04;Keskiviikko;0;0;0
93;31.05.2017;2017;05;05;Keskiviikko;4;4;8
93;31.05.2017;2017;05;06;Keskiviikko;22;9;31
93;31.05.2017;2017;05;07;Keskiviikko;24;49;73
93;31.05.2017;2017;05;08;Keskiviikko;27;15;42
93;31.05.2017;2017;05;09;Keskiviikko;2;7;9
93;31.05.2017;2017;05;10;Keskiviikko;2;2;4
93;31.05.2017;2017;05;11;Keskiviikko;2;5;7
93;31.05.2017;2017;05;12;Keskiviikko;11;2;13
93;31.05.2017;2017;05;13;Keskiviikko;11;9;20
93;31.05.2017;2017;05;14;Keskiviikko;12;16;28
93;31.05.2017;2017;05;15;Keskiviikko;12;23;35
93;31.05.2017;2017;05;16;Keskiviikko;31;30;61
93;31.05.2017;2017;05;17;Keskiviikko;19;15;34
93;31.05.2017;2017;05;18;Keskiviikko;11;22;33
93;31.05.2017;2017;05;19;Keskiviikko;21;16;37
93;31.05.2017;2017;05;20;Keskiviikko;5;14;19
93;31.05.2017;2017;05;21;Keskiviikko;4;7;11
93;31.05.2017;2017;05;22;Keskiviikko;3;5;8
93;31.05.2017;2017;05;23;Keskiviikko;4;1;5
93;01.06.2017;2017;06;00;Torstai;0;1;1
93;01.06.2017;2017;06;01;Torstai;0;0;0
93;01.06.2017;2017;06;02;Torstai;0;0;0
93;01.06.2017;2017;06;03;Torstai;0;0;0
93;01.06.2017;2017;06;04;Torstai;1;0;1
93;01.06.2017;2017;06;05;Torstai;4;5;9
93;01.06.2017;2017;06;06;Torstai;17;11;28
93;01.06.2017;2017;06;07;Torstai;34;41;75
93;01.06.2017;2017;06;08;Torstai;15;22;37
93;01.06.2017;2017;06;09;Torstai;15;10;25
93;01.06.2017;2017;06;10;Torstai;11;3;14
93;01.06.2017;2017;06;11;Torstai;8;7;15
93;01.06.2017;2017;06;12;Torstai;3;8;11
93;01.06.2017;2017;06;13;Torstai;13;6;19
93;01.06.2017;2017;06;14;Torstai;10;6;16
93;01.06.2017;2017;06;15;Torstai;20;17;37
93;01.06.2017;2017;06;16;Torstai;21;26;47
93;01.06.2017;2017;06;17;Torstai;8;17;25
93;01.06.2017;2017;06;18;Torstai;12;12;24
93;01.06.2017;2017;06;19;Torstai;6;10;16
93;01.06.2017;2017;06;20;Torstai;5;4;9
93;01.06.2017;2017;06;21;Torstai;5;5;10
93;01.06.2017;2017;06;22;Torstai;1;6;7
93;01.06.2017;2017;06;23;Torstai;0;1;1
93;02.06.2017;2017;06;00;Perjantai;0;1;1
93;02.06.2017;2017;06;01;Perjantai;4;0;4
93;02.06.2017;2017;06;02;Perjantai;0;0;0
93;02.06.2017;2017;06;03;Perjantai;0;0;0
93;02.06.2017;2017;06;04;Perjantai;0;1;1
93;02.06.2017;2017;06;05;Perjantai;2;1;3
93;02.06.2017;2017;06;06;Perjantai;5;6;11
93;02.06.2017;2017;06;07;Perjantai;4;10;14
93;02.06.2017;2017;06;08;Perjantai;6;15;21
93;02.06.2017;2017;06;09;Perjantai;3;1;4
93;02.06.2017;2017;06;10;Perjantai;7;5;12
93;02.06.2017;2017;06;11;Perjantai;7;0;7
93;02.06.2017;2017;06;12;Perjantai;9;7;16
93;02.06.2017;2017;06;13;Perjantai;6;6;12
93;02.06.2017;2017;06;14;Perjantai;6;7;13
93;02.06.2017;2017;06;15;Perjantai;10;8;18
93;02.06.2017;2017;06;16;Perjantai;16;9;25
93;02.06.2017;2017;06;17;Perjantai;7;7;14
93;02.06.2017;2017;06;18;Perjantai;9;9;18
93;02.06.2017;2017;06;19;Perjantai;8;5;13
93;02.06.2017;2017;06;20;Perjantai;1;6;7
93;02.06.2017;2017;06;21;Perjantai;1;5;6
93;02.06.2017;2017;06;22;Perjantai;0;2;2
93;02.06.2017;2017;06;23;Perjantai;1;0;1
93;03.06.2017;2017;06;00;Lauantai;0;0;0
93;03.06.2017;2017;06;01;Lauantai;1;0;1
93;03.06.2017;2017;06;02;Lauantai;0;0;0
93;03.06.2017;2017;06;03;Lauantai;0;1;1
93;03.06.2017;2017;06;04;Lauantai;0;0;0
93;03.06.2017;2017;06;05;Lauantai;1;0;1
93;03.06.2017;2017;06;06;Lauantai;2;0;2
93;03.06.2017;2017;06;07;Lauantai;3;3;6
93;03.06.2017;2017;06;08;Lauantai;5;5;10
93;03.06.2017;2017;06;09;Lauantai;6;4;10
93;03.06.2017;2017;06;10;Lauantai;3;3;6
93;03.06.2017;2017;06;11;Lauantai;2;9;11
93;03.06.2017;2017;06;12;Lauantai;2;11;13
93;03.06.2017;2017;06;13;Lauantai;4;5;9
93;03.06.2017;2017;06;14;Lauantai;9;6;15
93;03.06.2017;2017;06;15;Lauantai;11;10;21
93;03.06.2017;2017;06;16;Lauantai;14;6;20
93;03.06.2017;2017;06;17;Lauantai;3;11;14
93;03.06.2017;2017;06;18;Lauantai;13;9;22
93;03.06.2017;2017;06;19;Lauantai;8;6;14
93;03.06.2017;2017;06;20;Lauantai;7;7;14
93;03.06.2017;2017;06;21;Lauantai;3;7;10
93;03.06.2017;2017;06;22;Lauantai;5;2;7
93;03.06.2017;2017;06;23;Lauantai;1;2;3
93;04.06.2017;2017;06;00;Sunnuntai;4;0;4
93;04.06.2017;2017;06;01;Sunnuntai;2;0;2
93;04.06.2017;2017;06;02;Sunnuntai;3;1;4
93;04.06.2017;2017;06;03;Sunnuntai;1;3;4
93;04.06.2017;2017;06;04;Sunnuntai;0;1;1
93;04.06.2017;2017;06;05;Sunnuntai;1;0;1
93;04.06.2017;2017;06;06;Sunnuntai;1;2;3
93;04.06.2017;2017;06;07;Sunnuntai;2;0;2
93;04.06.2017;2017;06;08;Sunnuntai;5;10;15
93;04.06.2017;2017;06;09;Sunnuntai;9;6;15
93;04.06.2017;2017;06;10;Sunnuntai;7;15;22
93;04.06.2017;2017;06;11;Sunnuntai;15;19;34
93;04.06.2017;2017;06;12;Sunnuntai;21;17;38
93;04.06.2017;2017;06;13;Sunnuntai;23;21;44
93;04.06.2017;2017;06;14;Sunnuntai;10;16;26
93;04.06.2017;2017;06;15;Sunnuntai;22;17;39
93;04.06.2017;2017;06;16;Sunnuntai;16;10;26
93;04.06.2017;2017;06;17;Sunnuntai;14;16;30
93;04.06.2017;2017;06;18;Sunnuntai;12;12;24
93;04.06.2017;2017;06;19;Sunnuntai;12;18;30
93;04.06.2017;2017;06;20;Sunnuntai;12;6;18
93;04.06.2017;2017;06;21;Sunnuntai;5;8;13
93;04.06.2017;2017;06;22;Sunnuntai;2;2;4
93;04.06.2017;2017;06;23;Sunnuntai;0;2;2
93;05.06.2017;2017;06;00;Maanantai;2;1;3
93;05.06.2017;2017;06;01;Maanantai;1;0;1
93;05.06.2017;2017;06;02;Maanantai;0;0;0
93;05.06.2017;2017;06;03;Maanantai;0;0;0
93;05.06.2017;2017;06;04;Maanantai;1;0;1
93;05.06.2017;2017;06;05;Maanantai;8;4;12
93;05.06.2017;2017;06;06;Maanantai;34;14;48
93;05.06.2017;2017;06;07;Maanantai;22;38;60
93;05.06.2017;2017;06;08;Maanantai;21;23;44
93;05.06.2017;2017;06;09;Maanantai;16;13;29
93;05.06.2017;2017;06;10;Maanantai;12;14;26
93;05.06.2017;2017;06;11;Maanantai;21;11;32
93;05.06.2017;2017;06;12;Maanantai;14;10;24
93;05.06.2017;2017;06;13;Maanantai;20;13;33
93;05.06.2017;2017;06;14;Maanantai;16;17;33
93;05.06.2017;2017;06;15;Maanantai;34;34;68
93;05.06.2017;2017;06;16;Maanantai;50;44;94
93;05.06.2017;2017;06;17;Maanantai;28;32;60
93;05.06.2017;2017;06;18;Maanantai;17;38;55
93;05.06.2017;2017;06;19;Maanantai;17;11;28
93;05.06.2017;2017;06;20;Maanantai;9;13;22
93;05.06.2017;2017;06;21;Maanantai;6;4;10
93;05.06.2017;2017;06;22;Maanantai;4;4;8
93;05.06.2017;2017;06;23;Maanantai;0;0;0
93;06.06.2017;2017;06;00;Tiistai;1;2;3
93;06.06.2017;2017;06;01;Tiistai;0;1;1
93;06.06.2017;2017;06;02;Tiistai;0;0;0
93;06.06.2017;2017;06;03;Tiistai;1;0;1
93;06.06.2017;2017;06;04;Tiistai;1;1;2
93;06.06.2017;2017;06;05;Tiistai;6;2;8
93;06.06.2017;2017;06;06;Tiistai;15;8;23
93;06.06.2017;2017;06;07;Tiistai;16;20;36
93;06.06.2017;2017;06;08;Tiistai;8;18;26
93;06.06.2017;2017;06;09;Tiistai;7;6;13
93;06.06.2017;2017;06;10;Tiistai;5;7;12
93;06.06.2017;2017;06;11;Tiistai;11;5;16
93;06.06.2017;2017;06;12;Tiistai;18;8;26
93;06.06.2017;2017;06;13;Tiistai;14;12;26
93;06.06.2017;2017;06;14;Tiistai;8;12;20
93;06.06.2017;2017;06;15;Tiistai;11;24;35
93;06.06.2017;2017;06;16;Tiistai;43;44;87
93;06.06.2017;2017;06;17;Tiistai;30;37;67
93;06.06.2017;2017;06;18;Tiistai;25;24;49
93;06.06.2017;2017;06;19;Tiistai;32;27;59
93;06.06.2017;2017;06;20;Tiistai;26;33;59
93;06.06.2017;2017;06;21;Tiistai;11;9;20
93;06.06.2017;2017;06;22;Tiistai;6;4;10
93;06.06.2017;2017;06;23;Tiistai;6;6;12
93;07.06.2017;2017;06;00;Keskiviikko;3;0;3
93;07.06.2017;2017;06;01;Keskiviikko;0;6;6
93;07.06.2017;2017;06;02;Keskiviikko;3;1;4
93;07.06.2017;2017;06;03;Keskiviikko;0;0;0
93;07.06.2017;2017;06;04;Keskiviikko;1;0;1
93;07.06.2017;2017;06;05;Keskiviikko;10;4;14
93;07.06.2017;2017;06;06;Keskiviikko;35;11;46
93;07.06.2017;2017;06;07;Keskiviikko;44;60;104
93;07.06.2017;2017;06;08;Keskiviikko;27;30;57
93;07.06.2017;2017;06;09;Keskiviikko;14;15;29
93;07.06.2017;2017;06;10;Keskiviikko;18;15;33
93;07.06.2017;2017;06;11;Keskiviikko;15;13;28
93;07.06.2017;2017;06;12;Keskiviikko;20;12;32
93;07.06.2017;2017;06;13;Keskiviikko;36;25;61
93;07.06.2017;2017;06;14;Keskiviikko;31;29;60
93;07.06.2017;2017;06;15;Keskiviikko;41;50;91
93;07.06.2017;2017;06;16;Keskiviikko;57;78;135
93;07.06.2017;2017;06;17;Keskiviikko;47;43;90
93;07.06.2017;2017;06;18;Keskiviikko;34;47;81
93;07.06.2017;2017;06;19;Keskiviikko;40;42;82
93;07.06.2017;2017;06;20;Keskiviikko;17;23;40
93;07.06.2017;2017;06;21;Keskiviikko;15;22;37
93;07.06.2017;2017;06;22;Keskiviikko;9;5;14
93;07.06.2017;2017;06;23;Keskiviikko;1;2;3
93;08.06.2017;2017;06;00;Torstai;2;1;3
93;08.06.2017;2017;06;01;Torstai;0;2;2
93;08.06.2017;2017;06;02;Torstai;1;3;4
93;08.06.2017;2017;06;03;Torstai;0;0;0
93;08.06.2017;2017;06;04;Torstai;0;0;0
93;08.06.2017;2017;06;05;Torstai;8;6;14
93;08.06.2017;2017;06;06;Torstai;30;20;50
93;08.06.2017;2017;06;07;Torstai;46;44;90
93;08.06.2017;2017;06;08;Torstai;21;35;56
93;08.06.2017;2017;06;09;Torstai;19;10;29
93;08.06.2017;2017;06;10;Torstai;13;13;26
93;08.06.2017;2017;06;11;Torstai;19;12;31
93;08.06.2017;2017;06;12;Torstai;21;26;47
93;08.06.2017;2017;06;13;Torstai;24;19;43
93;08.06.2017;2017;06;14;Torstai;36;42;78
93;08.06.2017;2017;06;15;Torstai;46;45;91
93;08.06.2017;2017;06;16;Torstai;59;66;125
93;08.06.2017;2017;06;17;Torstai;33;35;68
93;08.06.2017;2017;06;18;Torstai;33;35;68
93;08.06.2017;2017;06;19;Torstai;23;35;58
93;08.06.2017;2017;06;20;Torstai;15;28;43
93;08.06.2017;2017;06;21;Torstai;9;15;24
93;08.06.2017;2017;06;22;Torstai;7;8;15
93;08.06.2017;2017;06;23;Torstai;3;6;9
93;09.06.2017;2017;06;00;Perjantai;3;6;9
93;09.06.2017;2017;06;01;Perjantai;0;0;0
93;09.06.2017;2017;06;02;Perjantai;0;0;0
93;09.06.2017;2017;06;03;Perjantai;1;0;1
93;09.06.2017;2017;06;04;Perjantai;0;1;1
93;09.06.2017;2017;06;05;Perjantai;8;4;12
93;09.06.2017;2017;06;06;Perjantai;19;18;37
93;09.06.2017;2017;06;07;Perjantai;31;30;61
93;09.06.2017;2017;06;08;Perjantai;30;28;58
93;09.06.2017;2017;06;09;Perjantai;10;9;19
93;09.06.2017;2017;06;10;Perjantai;11;16;27
93;09.06.2017;2017;06;11;Perjantai;18;17;35
93;09.06.2017;2017;06;12;Perjantai;26;19;45
93;09.06.2017;2017;06;13;Perjantai;15;20;35
93;09.06.2017;2017;06;14;Perjantai;35;40;75
93;09.06.2017;2017;06;15;Perjantai;43;38;81
93;09.06.2017;2017;06;16;Perjantai;40;45;85
93;09.06.2017;2017;06;17;Perjantai;26;31;57
93;09.06.2017;2017;06;18;Perjantai;19;39;58
93;09.06.2017;2017;06;19;Perjantai;25;23;48
93;09.06.2017;2017;06;20;Perjantai;9;15;24
93;09.06.2017;2017;06;21;Perjantai;6;12;18
93;09.06.2017;2017;06;22;Perjantai;9;5;14
93;09.06.2017;2017;06;23;Perjantai;6;7;13
93;10.06.2017;2017;06;00;Lauantai;2;5;7
93;10.06.2017;2017;06;01;Lauantai;1;7;8
93;10.06.2017;2017;06;02;Lauantai;0;3;3
93;10.06.2017;2017;06;03;Lauantai;3;2;5
93;10.06.2017;2017;06;04;Lauantai;0;0;0
93;10.06.2017;2017;06;05;Lauantai;2;6;8
93;10.06.2017;2017;06;06;Lauantai;2;0;2
93;10.06.2017;2017;06;07;Lauantai;2;5;7
93;10.06.2017;2017;06;08;Lauantai;10;10;20
93;10.06.2017;2017;06;09;Lauantai;13;20;33
93;10.06.2017;2017;06;10;Lauantai;11;14;25
93;10.06.2017;2017;06;11;Lauantai;25;21;46
93;10.06.2017;2017;06;12;Lauantai;23;33;56
93;10.06.2017;2017;06;13;Lauantai;32;31;63
93;10.06.2017;2017;06;14;Lauantai;21;32;53
93;10.06.2017;2017;06;15;Lauantai;26;39;65
93;10.06.2017;2017;06;16;Lauantai;23;25;48
93;10.06.2017;2017;06;17;Lauantai;21;24;45
93;10.06.2017;2017;06;18;Lauantai;16;16;32
93;10.06.2017;2017;06;19;Lauantai;22;18;40
93;10.06.2017;2017;06;20;Lauantai;16;4;20
93;10.06.2017;2017;06;21;Lauantai;4;10;14
93;10.06.2017;2017;06;22;Lauantai;1;2;3
93;10.06.2017;2017;06;23;Lauantai;4;8;12
93;11.06.2017;2017;06;00;Sunnuntai;2;1;3
93;11.06.2017;2017;06;01;Sunnuntai;1;3;4
93;11.06.2017;2017;06;02;Sunnuntai;1;0;1
93;11.06.2017;2017;06;03;Sunnuntai;1;1;2
93;11.06.2017;2017;06;04;Sunnuntai;0;1;1
93;11.06.2017;2017;06;05;Sunnuntai;3;0;3
93;11.06.2017;2017;06;06;Sunnuntai;5;1;6
93;11.06.2017;2017;06;07;Sunnuntai;3;1;4
93;11.06.2017;2017;06;08;Sunnuntai;5;7;12
93;11.06.2017;2017;06;09;Sunnuntai;7;12;19
93;11.06.2017;2017;06;10;Sunnuntai;24;14;38
93;11.06.2017;2017;06;11;Sunnuntai;23;27;50
93;11.06.2017;2017;06;12;Sunnuntai;25;28;53
93;11.06.2017;2017;06;13;Sunnuntai;29;30;59
93;11.06.2017;2017;06;14;Sunnuntai;24;27;51
93;11.06.2017;2017;06;15;Sunnuntai;27;37;64
93;11.06.2017;2017;06;16;Sunnuntai;27;34;61
93;11.06.2017;2017;06;17;Sunnuntai;32;15;47
93;11.06.2017;2017;06;18;Sunnuntai;24;18;42
93;11.06.2017;2017;06;19;Sunnuntai;25;28;53
93;11.06.2017;2017;06;20;Sunnuntai;10;29;39
93;11.06.2017;2017;06;21;Sunnuntai;11;7;18
93;11.06.2017;2017;06;22;Sunnuntai;4;6;10
93;11.06.2017;2017;06;23;Sunnuntai;3;1;4
93;12.06.2017;2017;06;00;Maanantai;4;0;4
93;12.06.2017;2017;06;01;Maanantai;3;0;3
93;12.06.2017;2017;06;02;Maanantai;0;0;0
93;12.06.2017;2017;06;03;Maanantai;0;0;0
93;12.06.2017;2017;06;04;Maanantai;0;0;0
93;12.06.2017;2017;06;05;Maanantai;4;4;8
93;12.06.2017;2017;06;06;Maanantai;21;18;39
93;12.06.2017;2017;06;07;Maanantai;25;41;66
93;12.06.2017;2017;06;08;Maanantai;5;19;24
93;12.06.2017;2017;06;09;Maanantai;1;4;5
93;12.06.2017;2017;06;10;Maanantai;4;2;6
93;12.06.2017;2017;06;11;Maanantai;9;2;11
93;12.06.2017;2017;06;12;Maanantai;6;5;11
93;12.06.2017;2017;06;13;Maanantai;14;10;24
93;12.06.2017;2017;06;14;Maanantai;15;14;29
93;12.06.2017;2017;06;15;Maanantai;28;21;49
93;12.06.2017;2017;06;16;Maanantai;47;39;86
93;12.06.2017;2017;06;17;Maanantai;20;15;35
93;12.06.2017;2017;06;18;Maanantai;17;19;36
93;12.06.2017;2017;06;19;Maanantai;17;16;33
93;12.06.2017;2017;06;20;Maanantai;13;11;24
93;12.06.2017;2017;06;21;Maanantai;8;11;19
93;12.06.2017;2017;06;22;Maanantai;7;10;17
93;12.06.2017;2017;06;23;Maanantai;2;3;5
93;13.06.2017;2017;06;00;Tiistai;0;2;2
93;13.06.2017;2017;06;01;Tiistai;0;1;1
93;13.06.2017;2017;06;02;Tiistai;1;0;1
93;13.06.2017;2017;06;03;Tiistai;0;0;0
93;13.06.2017;2017;06;04;Tiistai;1;0;1
93;13.06.2017;2017;06;05;Tiistai;10;6;16
93;13.06.2017;2017;06;06;Tiistai;35;16;51
93;13.06.2017;2017;06;07;Tiistai;41;46;87
93;13.06.2017;2017;06;08;Tiistai;26;27;53
93;13.06.2017;2017;06;09;Tiistai;12;9;21
93;13.06.2017;2017;06;10;Tiistai;15;12;27
93;13.06.2017;2017;06;11;Tiistai;16;9;25
93;13.06.2017;2017;06;12;Tiistai;12;16;28
93;13.06.2017;2017;06;13;Tiistai;25;10;35
93;13.06.2017;2017;06;14;Tiistai;19;30;49
93;13.06.2017;2017;06;15;Tiistai;33;33;66
93;13.06.2017;2017;06;16;Tiistai;41;73;114
93;13.06.2017;2017;06;17;Tiistai;36;44;80
93;13.06.2017;2017;06;18;Tiistai;28;27;55
93;13.06.2017;2017;06;19;Tiistai;23;25;48
93;13.06.2017;2017;06;20;Tiistai;17;18;35
93;13.06.2017;2017;06;21;Tiistai;10;23;33
93;13.06.2017;2017;06;22;Tiistai;6;7;13
93;13.06.2017;2017;06;23;Tiistai;2;2;4
93;14.06.2017;2017;06;00;Keskiviikko;2;4;6
93;14.06.2017;2017;06;01;Keskiviikko;2;0;2
93;14.06.2017;2017;06;02;Keskiviikko;2;0;2
93;14.06.2017;2017;06;03;Keskiviikko;0;1;1
93;14.06.2017;2017;06;04;Keskiviikko;0;0;0
93;14.06.2017;2017;06;05;Keskiviikko;10;6;16
93;14.06.2017;2017;06;06;Keskiviikko;37;12;49
93;14.06.2017;2017;06;07;Keskiviikko;34;50;84
93;14.06.2017;2017;06;08;Keskiviikko;22;26;48
93;14.06.2017;2017;06;09;Keskiviikko;16;21;37
93;14.06.2017;2017;06;10;Keskiviikko;16;14;30
93;14.06.2017;2017;06;11;Keskiviikko;30;17;47
93;14.06.2017;2017;06;12;Keskiviikko;18;30;48
93;14.06.2017;2017;06;13;Keskiviikko;25;17;42
93;14.06.2017;2017;06;14;Keskiviikko;26;33;59
93;14.06.2017;2017;06;15;Keskiviikko;47;49;96
93;14.06.2017;2017;06;16;Keskiviikko;52;50;102
93;14.06.2017;2017;06;17;Keskiviikko;40;43;83
93;14.06.2017;2017;06;18;Keskiviikko;27;36;63
93;14.06.2017;2017;06;19;Keskiviikko;28;34;62
93;14.06.2017;2017;06;20;Keskiviikko;10;20;30
93;14.06.2017;2017;06;21;Keskiviikko;5;21;26
93;14.06.2017;2017;06;22;Keskiviikko;13;11;24
93;14.06.2017;2017;06;23;Keskiviikko;1;1;2
93;15.06.2017;2017;06;00;Torstai;0;1;1
93;15.06.2017;2017;06;01;Torstai;0;0;0
93;15.06.2017;2017;06;02;Torstai;1;5;6
93;15.06.2017;2017;06;03;Torstai;0;0;0
93;15.06.2017;2017;06;04;Torstai;0;0;0
93;15.06.2017;2017;06;05;Torstai;9;5;14
93;15.06.2017;2017;06;06;Torstai;37;16;53
93;15.06.2017;2017;06;07;Torstai;35;51;86
93;15.06.2017;2017;06;08;Torstai;28;26;54
93;15.06.2017;2017;06;09;Torstai;16;6;22
93;15.06.2017;2017;06;10;Torstai;15;19;34
93;15.06.2017;2017;06;11;Torstai;10;18;28
93;15.06.2017;2017;06;12;Torstai;29;24;53
93;15.06.2017;2017;06;13;Torstai;25;21;46
93;15.06.2017;2017;06;14;Torstai;28;35;63
93;15.06.2017;2017;06;15;Torstai;59;56;115
93;15.06.2017;2017;06;16;Torstai;62;59;121
93;15.06.2017;2017;06;17;Torstai;37;47;84
93;15.06.2017;2017;06;18;Torstai;31;41;72
93;15.06.2017;2017;06;19;Torstai;41;41;82
93;15.06.2017;2017;06;20;Torstai;32;27;59
93;15.06.2017;2017;06;21;Torstai;10;28;38
93;15.06.2017;2017;06;22;Torstai;5;9;14
93;15.06.2017;2017;06;23;Torstai;4;4;8
93;16.06.2017;2017;06;00;Perjantai;1;2;3
93;16.06.2017;2017;06;01;Perjantai;0;0;0
93;16.06.2017;2017;06;02;Perjantai;0;0;0
93;16.06.2017;2017;06;03;Perjantai;0;1;1
93;16.06.2017;2017;06;04;Perjantai;2;1;3
93;16.06.2017;2017;06;05;Perjantai;9;6;15
93;16.06.2017;2017;06;06;Perjantai;28;21;49
93;16.06.2017;2017;06;07;Perjantai;22;33;55
93;16.06.2017;2017;06;08;Perjantai;21;34;55
93;16.06.2017;2017;06;09;Perjantai;9;6;15
93;16.06.2017;2017;06;10;Perjantai;18;8;26
93;16.06.2017;2017;06;11;Perjantai;17;22;39
93;16.06.2017;2017;06;12;Perjantai;20;19;39
93;16.06.2017;2017;06;13;Perjantai;20;29;49
93;16.06.2017;2017;06;14;Perjantai;38;36;74
93;16.06.2017;2017;06;15;Perjantai;63;42;105
93;16.06.2017;2017;06;16;Perjantai;39;34;73
93;16.06.2017;2017;06;17;Perjantai;27;35;62
93;16.06.2017;2017;06;18;Perjantai;34;25;59
93;16.06.2017;2017;06;19;Perjantai;17;30;47
93;16.06.2017;2017;06;20;Perjantai;20;27;47
93;16.06.2017;2017;06;21;Perjantai;9;19;28
93;16.06.2017;2017;06;22;Perjantai;10;11;21
93;16.06.2017;2017;06;23;Perjantai;5;7;12
93;17.06.2017;2017;06;00;Lauantai;1;7;8
93;17.06.2017;2017;06;01;Lauantai;2;4;6
93;17.06.2017;2017;06;02;Lauantai;0;2;2
93;17.06.2017;2017;06;03;Lauantai;0;1;1
93;17.06.2017;2017;06;04;Lauantai;2;3;5
93;17.06.2017;2017;06;05;Lauantai;2;1;3
93;17.06.2017;2017;06;06;Lauantai;5;6;11
93;17.06.2017;2017;06;07;Lauantai;4;1;5
93;17.06.2017;2017;06;08;Lauantai;5;10;15
93;17.06.2017;2017;06;09;Lauantai;16;9;25
93;17.06.2017;2017;06;10;Lauantai;21;18;39
93;17.06.2017;2017;06;11;Lauantai;27;23;50
93;17.06.2017;2017;06;12;Lauantai;36;36;72
93;17.06.2017;2017;06;13;Lauantai;25;27;52
93;17.06.2017;2017;06;14;Lauantai;35;25;60
93;17.06.2017;2017;06;15;Lauantai;31;45;76
93;17.06.2017;2017;06;16;Lauantai;39;31;70
93;17.06.2017;2017;06;17;Lauantai;32;20;52
93;17.06.2017;2017;06;18;Lauantai;28;21;49
93;17.06.2017;2017;06;19;Lauantai;23;24;47
93;17.06.2017;2017;06;20;Lauantai;3;9;12
93;17.06.2017;2017;06;21;Lauantai;12;10;22
93;17.06.2017;2017;06;22;Lauantai;7;16;23
93;17.06.2017;2017;06;23;Lauantai;0;1;1
93;18.06.2017;2017;06;00;Sunnuntai;5;10;15
93;18.06.2017;2017;06;01;Sunnuntai;3;4;7
93;18.06.2017;2017;06;02;Sunnuntai;4;1;5
93;18.06.2017;2017;06;03;Sunnuntai;1;4;5
93;18.06.2017;2017;06;04;Sunnuntai;0;1;1
93;18.06.2017;2017;06;05;Sunnuntai;0;0;0
93;18.06.2017;2017;06;06;Sunnuntai;1;0;1
93;18.06.2017;2017;06;07;Sunnuntai;0;0;0
93;18.06.2017;2017;06;08;Sunnuntai;1;5;6
93;18.06.2017;2017;06;09;Sunnuntai;4;4;8
93;18.06.2017;2017;06;10;Sunnuntai;7;2;9
93;18.06.2017;2017;06;11;Sunnuntai;9;5;14
93;18.06.2017;2017;06;12;Sunnuntai;7;2;9
93;18.06.2017;2017;06;13;Sunnuntai;13;11;24
93;18.06.2017;2017;06;14;Sunnuntai;18;13;31
93;18.06.2017;2017;06;15;Sunnuntai;12;19;31
93;18.06.2017;2017;06;16;Sunnuntai;15;12;27
93;18.06.2017;2017;06;17;Sunnuntai;14;19;33
93;18.06.2017;2017;06;18;Sunnuntai;16;20;36
93;18.06.2017;2017;06;19;Sunnuntai;18;12;30
93;18.06.2017;2017;06;20;Sunnuntai;11;6;17
93;18.06.2017;2017;06;21;Sunnuntai;2;5;7
93;18.06.2017;2017;06;22;Sunnuntai;4;1;5
93;18.06.2017;2017;06;23;Sunnuntai;5;7;12
93;19.06.2017;2017;06;00;Maanantai;0;0;0
93;19.06.2017;2017;06;01;Maanantai;5;1;6
93;19.06.2017;2017;06;02;Maanantai;0;3;3
93;19.06.2017;2017;06;03;Maanantai;0;0;0
93;19.06.2017;2017;06;04;Maanantai;1;1;2
93;19.06.2017;2017;06;05;Maanantai;5;5;10
93;19.06.2017;2017;06;06;Maanantai;18;18;36
93;19.06.2017;2017;06;07;Maanantai;35;28;63
93;19.06.2017;2017;06;08;Maanantai;14;26;40
93;19.06.2017;2017;06;09;Maanantai;13;8;21
93;19.06.2017;2017;06;10;Maanantai;10;9;19
93;19.06.2017;2017;06;11;Maanantai;11;6;17
93;19.06.2017;2017;06;12;Maanantai;22;10;32
93;19.06.2017;2017;06;13;Maanantai;25;12;37
93;19.06.2017;2017;06;14;Maanantai;23;20;43
93;19.06.2017;2017;06;15;Maanantai;30;45;75
93;19.06.2017;2017;06;16;Maanantai;49;50;99
93;19.06.2017;2017;06;17;Maanantai;34;31;65
93;19.06.2017;2017;06;18;Maanantai;17;38;55
93;19.06.2017;2017;06;19;Maanantai;23;32;55
93;19.06.2017;2017;06;20;Maanantai;17;29;46
93;19.06.2017;2017;06;21;Maanantai;9;12;21
93;19.06.2017;2017;06;22;Maanantai;8;10;18
93;19.06.2017;2017;06;23;Maanantai;5;1;6
93;20.06.2017;2017;06;00;Tiistai;1;4;5
93;20.06.2017;2017;06;01;Tiistai;2;0;2
93;20.06.2017;2017;06;02;Tiistai;1;1;2
93;20.06.2017;2017;06;03;Tiistai;0;1;1
93;20.06.2017;2017;06;04;Tiistai;1;0;1
93;20.06.2017;2017;06;05;Tiistai;3;5;8
93;20.06.2017;2017;06;06;Tiistai;28;17;45
93;20.06.2017;2017;06;07;Tiistai;31;24;55
93;20.06.2017;2017;06;08;Tiistai;21;29;50
93;20.06.2017;2017;06;09;Tiistai;20;17;37
93;20.06.2017;2017;06;10;Tiistai;20;13;33
93;20.06.2017;2017;06;11;Tiistai;21;11;32
93;20.06.2017;2017;06;12;Tiistai;18;23;41
93;20.06.2017;2017;06;13;Tiistai;12;16;28
93;20.06.2017;2017;06;14;Tiistai;20;27;47
93;20.06.2017;2017;06;15;Tiistai;35;37;72
93;20.06.2017;2017;06;16;Tiistai;39;43;82
93;20.06.2017;2017;06;17;Tiistai;48;40;88
93;20.06.2017;2017;06;18;Tiistai;32;27;59
93;20.06.2017;2017;06;19;Tiistai;31;33;64
93;20.06.2017;2017;06;20;Tiistai;20;21;41
93;20.06.2017;2017;06;21;Tiistai;7;21;28
93;20.06.2017;2017;06;22;Tiistai;7;5;12
93;20.06.2017;2017;06;23;Tiistai;4;4;8
93;21.06.2017;2017;06;00;Keskiviikko;2;3;5
93;21.06.2017;2017;06;01;Keskiviikko;2;0;2
93;21.06.2017;2017;06;02;Keskiviikko;1;1;2
93;21.06.2017;2017;06;03;Keskiviikko;1;0;1
93;21.06.2017;2017;06;04;Keskiviikko;3;1;4
93;21.06.2017;2017;06;05;Keskiviikko;3;5;8
93;21.06.2017;2017;06;06;Keskiviikko;16;14;30
93;21.06.2017;2017;06;07;Keskiviikko;28;39;67
93;21.06.2017;2017;06;08;Keskiviikko;13;28;41
93;21.06.2017;2017;06;09;Keskiviikko;14;7;21
93;21.06.2017;2017;06;10;Keskiviikko;10;25;35
93;21.06.2017;2017;06;11;Keskiviikko;24;9;33
93;21.06.2017;2017;06;12;Keskiviikko;16;13;29
93;21.06.2017;2017;06;13;Keskiviikko;13;10;23
93;21.06.2017;2017;06;14;Keskiviikko;8;10;18
93;21.06.2017;2017;06;15;Keskiviikko;24;23;47
93;21.06.2017;2017;06;16;Keskiviikko;29;24;53
93;21.06.2017;2017;06;17;Keskiviikko;19;41;60
93;21.06.2017;2017;06;18;Keskiviikko;17;18;35
93;21.06.2017;2017;06;19;Keskiviikko;26;14;40
93;21.06.2017;2017;06;20;Keskiviikko;9;8;17
93;21.06.2017;2017;06;21;Keskiviikko;8;10;18
93;21.06.2017;2017;06;22;Keskiviikko;4;2;6
93;21.06.2017;2017;06;23;Keskiviikko;0;3;3
93;22.06.2017;2017;06;00;Torstai;0;2;2
93;22.06.2017;2017;06;01;Torstai;1;2;3
93;22.06.2017;2017;06;02;Torstai;0;0;0
93;22.06.2017;2017;06;03;Torstai;0;0;0
93;22.06.2017;2017;06;04;Torstai;3;1;4
93;22.06.2017;2017;06;05;Torstai;3;1;4
93;22.06.2017;2017;06;06;Torstai;10;10;20
93;22.06.2017;2017;06;07;Torstai;12;26;38
93;22.06.2017;2017;06;08;Torstai;10;7;17
93;22.06.2017;2017;06;09;Torstai;8;7;15
93;22.06.2017;2017;06;10;Torstai;11;5;16
93;22.06.2017;2017;06;11;Torstai;10;2;12
93;22.06.2017;2017;06;12;Torstai;8;9;17
93;22.06.2017;2017;06;13;Torstai;8;18;26
93;22.06.2017;2017;06;14;Torstai;15;12;27
93;22.06.2017;2017;06;15;Torstai;23;18;41
93;22.06.2017;2017;06;16;Torstai;20;12;32
93;22.06.2017;2017;06;17;Torstai;19;8;27
93;22.06.2017;2017;06;18;Torstai;10;9;19
93;22.06.2017;2017;06;19;Torstai;15;18;33
93;22.06.2017;2017;06;20;Torstai;2;7;9
93;22.06.2017;2017;06;21;Torstai;0;9;9
93;22.06.2017;2017;06;22;Torstai;6;1;7
93;22.06.2017;2017;06;23;Torstai;1;2;3
93;23.06.2017;2017;06;00;Perjantai;0;2;2
93;23.06.2017;2017;06;01;Perjantai;1;5;6
93;23.06.2017;2017;06;02;Perjantai;3;1;4
93;23.06.2017;2017;06;03;Perjantai;0;1;1
93;23.06.2017;2017;06;04;Perjantai;0;1;1
93;23.06.2017;2017;06;05;Perjantai;1;0;1
93;23.06.2017;2017;06;06;Perjantai;2;0;2
93;23.06.2017;2017;06;07;Perjantai;1;2;3
93;23.06.2017;2017;06;08;Perjantai;3;1;4
93;23.06.2017;2017;06;09;Perjantai;4;3;7
93;23.06.2017;2017;06;10;Perjantai;5;13;18
93;23.06.2017;2017;06;11;Perjantai;7;9;16
93;23.06.2017;2017;06;12;Perjantai;15;12;27
93;23.06.2017;2017;06;13;Perjantai;19;21;40
93;23.06.2017;2017;06;14;Perjantai;12;18;30
93;23.06.2017;2017;06;15;Perjantai;13;25;38
93;23.06.2017;2017;06;16;Perjantai;16;17;33
93;23.06.2017;2017;06;17;Perjantai;12;9;21
93;23.06.2017;2017;06;18;Perjantai;8;8;16
93;23.06.2017;2017;06;19;Perjantai;7;10;17
93;23.06.2017;2017;06;20;Perjantai;9;14;23
93;23.06.2017;2017;06;21;Perjantai;9;4;13
93;23.06.2017;2017;06;22;Perjantai;10;10;20
93;23.06.2017;2017;06;23;Perjantai;7;10;17
93;24.06.2017;2017;06;00;Lauantai;6;2;8
93;24.06.2017;2017;06;01;Lauantai;5;1;6
93;24.06.2017;2017;06;02;Lauantai;4;5;9
93;24.06.2017;2017;06;03;Lauantai;4;2;6
93;24.06.2017;2017;06;04;Lauantai;1;0;1
93;24.06.2017;2017;06;05;Lauantai;1;1;2
93;24.06.2017;2017;06;06;Lauantai;1;2;3
93;24.06.2017;2017;06;07;Lauantai;4;0;4
93;24.06.2017;2017;06;08;Lauantai;2;3;5
93;24.06.2017;2017;06;09;Lauantai;10;15;25
93;24.06.2017;2017;06;10;Lauantai;8;11;19
93;24.06.2017;2017;06;11;Lauantai;15;4;19
93;24.06.2017;2017;06;12;Lauantai;27;19;46
93;24.06.2017;2017;06;13;Lauantai;24;27;51
93;24.06.2017;2017;06;14;Lauantai;22;34;56
93;24.06.2017;2017;06;15;Lauantai;17;29;46
93;24.06.2017;2017;06;16;Lauantai;10;20;30
93;24.06.2017;2017;06;17;Lauantai;12;30;42
93;24.06.2017;2017;06;18;Lauantai;25;13;38
93;24.06.2017;2017;06;19;Lauantai;8;18;26
93;24.06.2017;2017;06;20;Lauantai;8;7;15
93;24.06.2017;2017;06;21;Lauantai;6;5;11
93;24.06.2017;2017;06;22;Lauantai;10;3;13
93;24.06.2017;2017;06;23;Lauantai;5;3;8
93;25.06.2017;2017;06;00;Sunnuntai;0;2;2
93;25.06.2017;2017;06;01;Sunnuntai;5;0;5
93;25.06.2017;2017;06;02;Sunnuntai;3;3;6
93;25.06.2017;2017;06;03;Sunnuntai;3;2;5
93;25.06.2017;2017;06;04;Sunnuntai;2;1;3
93;25.06.2017;2017;06;05;Sunnuntai;2;0;2
93;25.06.2017;2017;06;06;Sunnuntai;3;2;5
93;25.06.2017;2017;06;07;Sunnuntai;3;3;6
93;25.06.2017;2017;06;08;Sunnuntai;5;6;11
93;25.06.2017;2017;06;09;Sunnuntai;7;7;14
93;25.06.2017;2017;06;10;Sunnuntai;8;7;15
93;25.06.2017;2017;06;11;Sunnuntai;9;3;12
93;25.06.2017;2017;06;12;Sunnuntai;6;4;10
93;25.06.2017;2017;06;13;Sunnuntai;4;7;11
93;25.06.2017;2017;06;14;Sunnuntai;3;8;11
93;25.06.2017;2017;06;15;Sunnuntai;7;4;11
93;25.06.2017;2017;06;16;Sunnuntai;4;5;9
93;25.06.2017;2017;06;17;Sunnuntai;5;1;6
93;25.06.2017;2017;06;18;Sunnuntai;7;10;17
93;25.06.2017;2017;06;19;Sunnuntai;14;18;32
93;25.06.2017;2017;06;20;Sunnuntai;10;9;19
93;25.06.2017;2017;06;21;Sunnuntai;5;1;6
93;25.06.2017;2017;06;22;Sunnuntai;2;0;2
93;25.06.2017;2017;06;23;Sunnuntai;1;0;1
93;26.06.2017;2017;06;00;Maanantai;0;3;3
93;26.06.2017;2017;06;01;Maanantai;0;0;0
93;26.06.2017;2017;06;02;Maanantai;0;1;1
93;26.06.2017;2017;06;03;Maanantai;0;0;0
93;26.06.2017;2017;06;04;Maanantai;0;0;0
93;26.06.2017;2017;06;05;Maanantai;1;3;4
93;26.06.2017;2017;06;06;Maanantai;11;5;16
93;26.06.2017;2017;06;07;Maanantai;12;20;32
93;26.06.2017;2017;06;08;Maanantai;7;12;19
93;26.06.2017;2017;06;09;Maanantai;7;5;12
93;26.06.2017;2017;06;10;Maanantai;2;2;4
93;26.06.2017;2017;06;11;Maanantai;1;1;2
93;26.06.2017;2017;06;12;Maanantai;6;6;12
93;26.06.2017;2017;06;13;Maanantai;9;5;14
93;26.06.2017;2017;06;14;Maanantai;11;20;31
93;26.06.2017;2017;06;15;Maanantai;20;24;44
93;26.06.2017;2017;06;16;Maanantai;36;35;71
93;26.06.2017;2017;06;17;Maanantai;29;15;44
93;26.06.2017;2017;06;18;Maanantai;22;29;51
93;26.06.2017;2017;06;19;Maanantai;21;30;51
93;26.06.2017;2017;06;20;Maanantai;20;20;40
93;26.06.2017;2017;06;21;Maanantai;14;21;35
93;26.06.2017;2017;06;22;Maanantai;11;10;21
93;26.06.2017;2017;06;23;Maanantai;1;0;1
93;27.06.2017;2017;06;00;Tiistai;2;1;3
93;27.06.2017;2017;06;01;Tiistai;3;0;3
93;27.06.2017;2017;06;02;Tiistai;1;0;1
93;27.06.2017;2017;06;03;Tiistai;0;1;1
93;27.06.2017;2017;06;04;Tiistai;0;0;0
93;27.06.2017;2017;06;05;Tiistai;7;6;13
93;27.06.2017;2017;06;06;Tiistai;14;13;27
93;27.06.2017;2017;06;07;Tiistai;31;29;60
93;27.06.2017;2017;06;08;Tiistai;19;23;42
93;27.06.2017;2017;06;09;Tiistai;17;10;27
93;27.06.2017;2017;06;10;Tiistai;12;10;22
93;27.06.2017;2017;06;11;Tiistai;13;7;20
93;27.06.2017;2017;06;12;Tiistai;21;14;35
93;27.06.2017;2017;06;13;Tiistai;27;14;41
93;27.06.2017;2017;06;14;Tiistai;16;17;33
93;27.06.2017;2017;06;15;Tiistai;27;31;58
93;27.06.2017;2017;06;16;Tiistai;42;43;85
93;27.06.2017;2017;06;17;Tiistai;26;20;46
93;27.06.2017;2017;06;18;Tiistai;19;27;46
93;27.06.2017;2017;06;19;Tiistai;16;20;36
93;27.06.2017;2017;06;20;Tiistai;7;20;27
93;27.06.2017;2017;06;21;Tiistai;5;15;20
93;27.06.2017;2017;06;22;Tiistai;5;7;12
93;27.06.2017;2017;06;23;Tiistai;5;1;6
93;28.06.2017;2017;06;00;Keskiviikko;4;1;5
93;28.06.2017;2017;06;01;Keskiviikko;0;0;0
93;28.06.2017;2017;06;02;Keskiviikko;2;0;2
93;28.06.2017;2017;06;03;Keskiviikko;0;1;1
93;28.06.2017;2017;06;04;Keskiviikko;0;0;0
93;28.06.2017;2017;06;05;Keskiviikko;6;3;9
93;28.06.2017;2017;06;06;Keskiviikko;24;11;35
93;28.06.2017;2017;06;07;Keskiviikko;18;37;55
93;28.06.2017;2017;06;08;Keskiviikko;15;22;37
93;28.06.2017;2017;06;09;Keskiviikko;16;8;24
93;28.06.2017;2017;06;10;Keskiviikko;5;6;11
93;28.06.2017;2017;06;11;Keskiviikko;5;5;10
93;28.06.2017;2017;06;12;Keskiviikko;8;5;13
93;28.06.2017;2017;06;13;Keskiviikko;9;9;18
93;28.06.2017;2017;06;14;Keskiviikko;7;17;24
93;28.06.2017;2017;06;15;Keskiviikko;18;27;45
93;28.06.2017;2017;06;16;Keskiviikko;36;29;65
93;28.06.2017;2017;06;17;Keskiviikko;21;13;34
93;28.06.2017;2017;06;18;Keskiviikko;22;45;67
93;28.06.2017;2017;06;19;Keskiviikko;31;14;45
93;28.06.2017;2017;06;20;Keskiviikko;10;11;21
93;28.06.2017;2017;06;21;Keskiviikko;8;11;19
93;28.06.2017;2017;06;22;Keskiviikko;9;6;15
93;28.06.2017;2017;06;23;Keskiviikko;4;3;7
93;29.06.2017;2017;06;00;Torstai;7;4;11
93;29.06.2017;2017;06;01;Torstai;4;4;8
93;29.06.2017;2017;06;02;Torstai;0;0;0
93;29.06.2017;2017;06;03;Torstai;0;2;2
93;29.06.2017;2017;06;04;Torstai;1;1;2
93;29.06.2017;2017;06;05;Torstai;6;5;11
93;29.06.2017;2017;06;06;Torstai;17;15;32
93;29.06.2017;2017;06;07;Torstai;17;31;48
93;29.06.2017;2017;06;08;Torstai;22;21;43
93;29.06.2017;2017;06;09;Torstai;15;12;27
93;29.06.2017;2017;06;10;Torstai;14;13;27
93;29.06.2017;2017;06;11;Torstai;16;20;36
93;29.06.2017;2017;06;12;Torstai;22;14;36
93;29.06.2017;2017;06;13;Torstai;24;14;38
93;29.06.2017;2017;06;14;Torstai;28;27;55
93;29.06.2017;2017;06;15;Torstai;22;41;63
93;29.06.2017;2017;06;16;Torstai;39;41;80
93;29.06.2017;2017;06;17;Torstai;28;36;64
93;29.06.2017;2017;06;18;Torstai;24;30;54
93;29.06.2017;2017;06;19;Torstai;30;21;51
93;29.06.2017;2017;06;20;Torstai;19;34;53
93;29.06.2017;2017;06;21;Torstai;7;10;17
93;29.06.2017;2017;06;22;Torstai;3;6;9
93;29.06.2017;2017;06;23;Torstai;5;4;9
93;30.06.2017;2017;06;00;Perjantai;2;0;2
93;30.06.2017;2017;06;01;Perjantai;2;0;2
93;30.06.2017;2017;06;02;Perjantai;1;0;1
93;30.06.2017;2017;06;03;Perjantai;0;0;0
93;30.06.2017;2017;06;04;Perjantai;1;0;1
93;30.06.2017;2017;06;05;Perjantai;4;6;10
93;30.06.2017;2017;06;06;Perjantai;21;11;32
93;30.06.2017;2017;06;07;Perjantai;23;35;58
93;30.06.2017;2017;06;08;Perjantai;15;17;32
93;30.06.2017;2017;06;09;Perjantai;16;18;34
93;30.06.2017;2017;06;10;Perjantai;17;17;34
93;30.06.2017;2017;06;11;Perjantai;28;19;47
93;30.06.2017;2017;06;12;Perjantai;20;24;44
93;30.06.2017;2017;06;13;Perjantai;26;30;56
93;30.06.2017;2017;06;14;Perjantai;21;30;51
93;30.06.2017;2017;06;15;Perjantai;49;47;96
93;30.06.2017;2017;06;16;Perjantai;38;36;74
93;30.06.2017;2017;06;17;Perjantai;26;38;64
93;30.06.2017;2017;06;18;Perjantai;22;32;54
93;30.06.2017;2017;06;19;Perjantai;22;35;57
93;30.06.2017;2017;06;20;Perjantai;15;22;37
93;30.06.2017;2017;06;21;Perjantai;11;17;28
93;30.06.2017;2017;06;22;Perjantai;7;5;12
93;30.06.2017;2017;06;23;Perjantai;1;10;11
93;01.07.2017;2017;07;00;Lauantai;4;1;5
93;01.07.2017;2017;07;01;Lauantai;0;2;2
93;01.07.2017;2017;07;02;Lauantai;0;2;2
93;01.07.2017;2017;07;03;Lauantai;3;2;5
93;01.07.2017;2017;07;04;Lauantai;0;1;1
93;01.07.2017;2017;07;05;Lauantai;1;2;3
93;01.07.2017;2017;07;06;Lauantai;0;2;2
93;01.07.2017;2017;07;07;Lauantai;7;2;9
93;01.07.2017;2017;07;08;Lauantai;4;6;10
93;01.07.2017;2017;07;09;Lauantai;18;23;41
93;01.07.2017;2017;07;10;Lauantai;25;21;46
93;01.07.2017;2017;07;11;Lauantai;16;26;42
93;01.07.2017;2017;07;12;Lauantai;31;27;58
93;01.07.2017;2017;07;13;Lauantai;46;41;87
93;01.07.2017;2017;07;14;Lauantai;30;33;63
93;01.07.2017;2017;07;15;Lauantai;33;32;65
93;01.07.2017;2017;07;16;Lauantai;24;42;66
93;01.07.2017;2017;07;17;Lauantai;17;32;49
93;01.07.2017;2017;07;18;Lauantai;30;39;69
93;01.07.2017;2017;07;19;Lauantai;26;32;58
93;01.07.2017;2017;07;20;Lauantai;21;19;40
93;01.07.2017;2017;07;21;Lauantai;11;12;23
93;01.07.2017;2017;07;22;Lauantai;6;6;12
93;01.07.2017;2017;07;23;Lauantai;10;7;17
93;02.07.2017;2017;07;00;Sunnuntai;6;9;15
93;02.07.2017;2017;07;01;Sunnuntai;3;1;4
93;02.07.2017;2017;07;02;Sunnuntai;0;0;0
93;02.07.2017;2017;07;03;Sunnuntai;0;7;7
93;02.07.2017;2017;07;04;Sunnuntai;0;0;0
93;02.07.2017;2017;07;05;Sunnuntai;1;2;3
93;02.07.2017;2017;07;06;Sunnuntai;1;1;2
93;02.07.2017;2017;07;07;Sunnuntai;4;3;7
93;02.07.2017;2017;07;08;Sunnuntai;9;13;22
93;02.07.2017;2017;07;09;Sunnuntai;15;13;28
93;02.07.2017;2017;07;10;Sunnuntai;17;26;43
93;02.07.2017;2017;07;11;Sunnuntai;42;33;75
93;02.07.2017;2017;07;12;Sunnuntai;34;27;61
93;02.07.2017;2017;07;13;Sunnuntai;40;39;79
93;02.07.2017;2017;07;14;Sunnuntai;39;34;73
93;02.07.2017;2017;07;15;Sunnuntai;38;27;65
93;02.07.2017;2017;07;16;Sunnuntai;31;34;65
93;02.07.2017;2017;07;17;Sunnuntai;24;39;63
93;02.07.2017;2017;07;18;Sunnuntai;25;33;58
93;02.07.2017;2017;07;19;Sunnuntai;17;41;58
93;02.07.2017;2017;07;20;Sunnuntai;26;25;51
93;02.07.2017;2017;07;21;Sunnuntai;15;14;29
93;02.07.2017;2017;07;22;Sunnuntai;3;9;12
93;02.07.2017;2017;07;23;Sunnuntai;2;2;4
93;03.07.2017;2017;07;00;Maanantai;0;0;0
93;03.07.2017;2017;07;01;Maanantai;1;0;1
93;03.07.2017;2017;07;02;Maanantai;0;0;0
93;03.07.2017;2017;07;03;Maanantai;0;0;0
93;03.07.2017;2017;07;04;Maanantai;3;4;7
93;03.07.2017;2017;07;05;Maanantai;8;6;14
93;03.07.2017;2017;07;06;Maanantai;29;11;40
93;03.07.2017;2017;07;07;Maanantai;27;21;48
93;03.07.2017;2017;07;08;Maanantai;25;29;54
93;03.07.2017;2017;07;09;Maanantai;20;9;29
93;03.07.2017;2017;07;10;Maanantai;19;8;27
93;03.07.2017;2017;07;11;Maanantai;15;20;35
93;03.07.2017;2017;07;12;Maanantai;31;24;55
93;03.07.2017;2017;07;13;Maanantai;25;19;44
93;03.07.2017;2017;07;14;Maanantai;24;36;60
93;03.07.2017;2017;07;15;Maanantai;28;42;70
93;03.07.2017;2017;07;16;Maanantai;36;38;74
93;03.07.2017;2017;07;17;Maanantai;29;45;74
93;03.07.2017;2017;07;18;Maanantai;23;31;54
93;03.07.2017;2017;07;19;Maanantai;15;24;39
93;03.07.2017;2017;07;20;Maanantai;13;22;35
93;03.07.2017;2017;07;21;Maanantai;6;8;14
93;03.07.2017;2017;07;22;Maanantai;8;11;19
93;03.07.2017;2017;07;23;Maanantai;5;1;6
93;04.07.2017;2017;07;00;Tiistai;1;1;2
93;04.07.2017;2017;07;01;Tiistai;2;2;4
93;04.07.2017;2017;07;02;Tiistai;1;0;1
93;04.07.2017;2017;07;03;Tiistai;1;1;2
93;04.07.2017;2017;07;04;Tiistai;1;0;1
93;04.07.2017;2017;07;05;Tiistai;8;7;15
93;04.07.2017;2017;07;06;Tiistai;22;7;29
93;04.07.2017;2017;07;07;Tiistai;16;22;38
93;04.07.2017;2017;07;08;Tiistai;17;22;39
93;04.07.2017;2017;07;09;Tiistai;16;11;27
93;04.07.2017;2017;07;10;Tiistai;18;17;35
93;04.07.2017;2017;07;11;Tiistai;14;14;28
93;04.07.2017;2017;07;12;Tiistai;10;9;19
93;04.07.2017;2017;07;13;Tiistai;5;10;15
93;04.07.2017;2017;07;14;Tiistai;12;9;21
93;04.07.2017;2017;07;15;Tiistai;13;27;40
93;04.07.2017;2017;07;16;Tiistai;39;29;68
93;04.07.2017;2017;07;17;Tiistai;14;24;38
93;04.07.2017;2017;07;18;Tiistai;11;22;33
93;04.07.2017;2017;07;19;Tiistai;10;9;19
93;04.07.2017;2017;07;20;Tiistai;13;14;27
93;04.07.2017;2017;07;21;Tiistai;3;19;22
93;04.07.2017;2017;07;22;Tiistai;7;5;12
93;04.07.2017;2017;07;23;Tiistai;2;1;3
93;05.07.2017;2017;07;00;Keskiviikko;1;0;1
93;05.07.2017;2017;07;01;Keskiviikko;1;0;1
93;05.07.2017;2017;07;02;Keskiviikko;0;2;2
93;05.07.2017;2017;07;03;Keskiviikko;0;1;1
93;05.07.2017;2017;07;04;Keskiviikko;1;0;1
93;05.07.2017;2017;07;05;Keskiviikko;5;6;11
93;05.07.2017;2017;07;06;Keskiviikko;21;6;27
93;05.07.2017;2017;07;07;Keskiviikko;23;21;44
93;05.07.2017;2017;07;08;Keskiviikko;15;17;32
93;05.07.2017;2017;07;09;Keskiviikko;6;11;17
93;05.07.2017;2017;07;10;Keskiviikko;5;5;10
93;05.07.2017;2017;07;11;Keskiviikko;9;11;20
93;05.07.2017;2017;07;12;Keskiviikko;17;11;28
93;05.07.2017;2017;07;13;Keskiviikko;14;17;31
93;05.07.2017;2017;07;14;Keskiviikko;14;11;25
93;05.07.2017;2017;07;15;Keskiviikko;19;24;43
93;05.07.2017;2017;07;16;Keskiviikko;25;31;56
93;05.07.2017;2017;07;17;Keskiviikko;16;16;32
93;05.07.2017;2017;07;18;Keskiviikko;9;11;20
93;05.07.2017;2017;07;19;Keskiviikko;6;12;18
93;05.07.2017;2017;07;20;Keskiviikko;2;12;14
93;05.07.2017;2017;07;21;Keskiviikko;6;8;14
93;05.07.2017;2017;07;22;Keskiviikko;4;5;9
93;05.07.2017;2017;07;23;Keskiviikko;3;1;4
93;06.07.2017;2017;07;00;Torstai;0;2;2
93;06.07.2017;2017;07;01;Torstai;3;0;3
93;06.07.2017;2017;07;02;Torstai;1;0;1
93;06.07.2017;2017;07;03;Torstai;1;2;3
93;06.07.2017;2017;07;04;Torstai;1;0;1
93;06.07.2017;2017;07;05;Torstai;2;4;6
93;06.07.2017;2017;07;06;Torstai;12;10;22
93;06.07.2017;2017;07;07;Torstai;7;15;22
93;06.07.2017;2017;07;08;Torstai;6;12;18
93;06.07.2017;2017;07;09;Torstai;5;6;11
93;06.07.2017;2017;07;10;Torstai;4;5;9
93;06.07.2017;2017;07;11;Torstai;3;0;3
93;06.07.2017;2017;07;12;Torstai;7;2;9
93;06.07.2017;2017;07;13;Torstai;5;4;9
93;06.07.2017;2017;07;14;Torstai;15;12;27
93;06.07.2017;2017;07;15;Torstai;23;21;44
93;06.07.2017;2017;07;16;Torstai;15;15;30
93;06.07.2017;2017;07;17;Torstai;25;17;42
93;06.07.2017;2017;07;18;Torstai;9;21;30
93;06.07.2017;2017;07;19;Torstai;15;6;21
93;06.07.2017;2017;07;20;Torstai;12;9;21
93;06.07.2017;2017;07;21;Torstai;3;6;9
93;06.07.2017;2017;07;22;Torstai;5;5;10
93;06.07.2017;2017;07;23;Torstai;0;4;4
93;07.07.2017;2017;07;00;Perjantai;0;0;0
93;07.07.2017;2017;07;01;Perjantai;0;1;1
93;07.07.2017;2017;07;02;Perjantai;0;1;1
93;07.07.2017;2017;07;03;Perjantai;0;0;0
93;07.07.2017;2017;07;04;Perjantai;1;1;2
93;07.07.2017;2017;07;05;Perjantai;4;6;10
93;07.07.2017;2017;07;06;Perjantai;18;11;29
93;07.07.2017;2017;07;07;Perjantai;13;23;36
93;07.07.2017;2017;07;08;Perjantai;16;17;33
93;07.07.2017;2017;07;09;Perjantai;11;6;17
93;07.07.2017;2017;07;10;Perjantai;13;13;26
93;07.07.2017;2017;07;11;Perjantai;31;20;51
93;07.07.2017;2017;07;12;Perjantai;10;24;34
93;07.07.2017;2017;07;13;Perjantai;26;18;44
93;07.07.2017;2017;07;14;Perjantai;40;25;65
93;07.07.2017;2017;07;15;Perjantai;32;45;77
93;07.07.2017;2017;07;16;Perjantai;35;31;66
93;07.07.2017;2017;07;17;Perjantai;22;28;50
93;07.07.2017;2017;07;18;Perjantai;20;30;50
93;07.07.2017;2017;07;19;Perjantai;20;16;36
93;07.07.2017;2017;07;20;Perjantai;24;29;53
93;07.07.2017;2017;07;21;Perjantai;13;14;27
93;07.07.2017;2017;07;22;Perjantai;9;13;22
93;07.07.2017;2017;07;23;Perjantai;2;8;10
93;08.07.2017;2017;07;00;Lauantai;6;2;8
93;08.07.2017;2017;07;01;Lauantai;3;3;6
93;08.07.2017;2017;07;02;Lauantai;0;1;1
93;08.07.2017;2017;07;03;Lauantai;1;2;3
93;08.07.2017;2017;07;04;Lauantai;0;1;1
93;08.07.2017;2017;07;05;Lauantai;4;0;4
93;08.07.2017;2017;07;06;Lauantai;1;1;2
93;08.07.2017;2017;07;07;Lauantai;2;2;4
93;08.07.2017;2017;07;08;Lauantai;9;5;14
93;08.07.2017;2017;07;09;Lauantai;12;16;28
93;08.07.2017;2017;07;10;Lauantai;31;32;63
93;08.07.2017;2017;07;11;Lauantai;37;27;64
93;08.07.2017;2017;07;12;Lauantai;28;22;50
93;08.07.2017;2017;07;13;Lauantai;30;44;74
93;08.07.2017;2017;07;14;Lauantai;29;35;64
93;08.07.2017;2017;07;15;Lauantai;26;29;55
93;08.07.2017;2017;07;16;Lauantai;28;28;56
93;08.07.2017;2017;07;17;Lauantai;27;29;56
93;08.07.2017;2017;07;18;Lauantai;26;26;52
93;08.07.2017;2017;07;19;Lauantai;25;22;47
93;08.07.2017;2017;07;20;Lauantai;10;23;33
93;08.07.2017;2017;07;21;Lauantai;11;25;36
93;08.07.2017;2017;07;22;Lauantai;9;4;13
93;08.07.2017;2017;07;23;Lauantai;4;7;11
93;09.07.2017;2017;07;00;Sunnuntai;2;3;5
93;09.07.2017;2017;07;01;Sunnuntai;1;3;4
93;09.07.2017;2017;07;02;Sunnuntai;1;0;1
93;09.07.2017;2017;07;03;Sunnuntai;6;1;7
93;09.07.2017;2017;07;04;Sunnuntai;0;10;10
93;09.07.2017;2017;07;05;Sunnuntai;4;2;6
93;09.07.2017;2017;07;06;Sunnuntai;3;1;4
93;09.07.2017;2017;07;07;Sunnuntai;5;5;10
93;09.07.2017;2017;07;08;Sunnuntai;9;5;14
93;09.07.2017;2017;07;09;Sunnuntai;17;19;36
93;09.07.2017;2017;07;10;Sunnuntai;19;39;58
93;09.07.2017;2017;07;11;Sunnuntai;33;30;63
93;09.07.2017;2017;07;12;Sunnuntai;38;38;76
93;09.07.2017;2017;07;13;Sunnuntai;63;26;89
93;09.07.2017;2017;07;14;Sunnuntai;32;34;66
93;09.07.2017;2017;07;15;Sunnuntai;30;45;75
93;09.07.2017;2017;07;16;Sunnuntai;28;44;72
93;09.07.2017;2017;07;17;Sunnuntai;15;38;53
93;09.07.2017;2017;07;18;Sunnuntai;31;27;58
93;09.07.2017;2017;07;19;Sunnuntai;35;22;57
93;09.07.2017;2017;07;20;Sunnuntai;23;37;60
93;09.07.2017;2017;07;21;Sunnuntai;15;13;28
93;09.07.2017;2017;07;22;Sunnuntai;7;10;17
93;09.07.2017;2017;07;23;Sunnuntai;2;0;2
93;10.07.2017;2017;07;00;Maanantai;2;1;3
93;10.07.2017;2017;07;01;Maanantai;0;1;1
93;10.07.2017;2017;07;02;Maanantai;1;0;1
93;10.07.2017;2017;07;03;Maanantai;0;0;0
93;10.07.2017;2017;07;04;Maanantai;0;1;1
93;10.07.2017;2017;07;05;Maanantai;4;5;9
93;10.07.2017;2017;07;06;Maanantai;30;8;38
93;10.07.2017;2017;07;07;Maanantai;26;27;53
93;10.07.2017;2017;07;08;Maanantai;23;19;42
93;10.07.2017;2017;07;09;Maanantai;27;19;46
93;10.07.2017;2017;07;10;Maanantai;15;25;40
93;10.07.2017;2017;07;11;Maanantai;26;21;47
93;10.07.2017;2017;07;12;Maanantai;21;30;51
93;10.07.2017;2017;07;13;Maanantai;21;28;49
93;10.07.2017;2017;07;14;Maanantai;32;35;67
93;10.07.2017;2017;07;15;Maanantai;29;42;71
93;10.07.2017;2017;07;16;Maanantai;45;53;98
93;10.07.2017;2017;07;17;Maanantai;30;31;61
93;10.07.2017;2017;07;18;Maanantai;19;20;39
93;10.07.2017;2017;07;19;Maanantai;19;37;56
93;10.07.2017;2017;07;20;Maanantai;14;18;32
93;10.07.2017;2017;07;21;Maanantai;12;17;29
93;10.07.2017;2017;07;22;Maanantai;5;13;18
93;10.07.2017;2017;07;23;Maanantai;5;2;7
93;11.07.2017;2017;07;00;Tiistai;1;1;2
93;11.07.2017;2017;07;01;Tiistai;0;3;3
93;11.07.2017;2017;07;02;Tiistai;2;1;3
93;11.07.2017;2017;07;03;Tiistai;0;0;0
93;11.07.2017;2017;07;04;Tiistai;1;0;1
93;11.07.2017;2017;07;05;Tiistai;7;6;13
93;11.07.2017;2017;07;06;Tiistai;35;9;44
93;11.07.2017;2017;07;07;Tiistai;36;25;61
93;11.07.2017;2017;07;08;Tiistai;16;14;30
93;11.07.2017;2017;07;09;Tiistai;22;24;46
93;11.07.2017;2017;07;10;Tiistai;27;18;45
93;11.07.2017;2017;07;11;Tiistai;31;16;47
93;11.07.2017;2017;07;12;Tiistai;27;37;64
93;11.07.2017;2017;07;13;Tiistai;30;29;59
93;11.07.2017;2017;07;14;Tiistai;20;31;51
93;11.07.2017;2017;07;15;Tiistai;33;53;86
93;11.07.2017;2017;07;16;Tiistai;48;45;93
93;11.07.2017;2017;07;17;Tiistai;52;41;93
93;11.07.2017;2017;07;18;Tiistai;26;32;58
93;11.07.2017;2017;07;19;Tiistai;28;38;66
93;11.07.2017;2017;07;20;Tiistai;18;26;44
93;11.07.2017;2017;07;21;Tiistai;3;6;9
93;11.07.2017;2017;07;22;Tiistai;5;3;8
93;11.07.2017;2017;07;23;Tiistai;2;0;2
93;12.07.2017;2017;07;00;Keskiviikko;2;4;6
93;12.07.2017;2017;07;01;Keskiviikko;0;0;0
93;12.07.2017;2017;07;02;Keskiviikko;0;2;2
93;12.07.2017;2017;07;03;Keskiviikko;0;0;0
93;12.07.2017;2017;07;04;Keskiviikko;0;0;0
93;12.07.2017;2017;07;05;Keskiviikko;4;4;8
93;12.07.2017;2017;07;06;Keskiviikko;10;6;16
93;12.07.2017;2017;07;07;Keskiviikko;8;16;24
93;12.07.2017;2017;07;08;Keskiviikko;7;12;19
93;12.07.2017;2017;07;09;Keskiviikko;7;2;9
93;12.07.2017;2017;07;10;Keskiviikko;6;0;6
93;12.07.2017;2017;07;11;Keskiviikko;5;4;9
93;12.07.2017;2017;07;12;Keskiviikko;12;6;18
93;12.07.2017;2017;07;13;Keskiviikko;6;9;15
93;12.07.2017;2017;07;14;Keskiviikko;6;11;17
93;12.07.2017;2017;07;15;Keskiviikko;8;13;21
93;12.07.2017;2017;07;16;Keskiviikko;16;9;25
93;12.07.2017;2017;07;17;Keskiviikko;11;10;21
93;12.07.2017;2017;07;18;Keskiviikko;4;19;23
93;12.07.2017;2017;07;19;Keskiviikko;4;2;6
93;12.07.2017;2017;07;20;Keskiviikko;3;4;7
93;12.07.2017;2017;07;21;Keskiviikko;4;9;13
93;12.07.2017;2017;07;22;Keskiviikko;3;4;7
93;12.07.2017;2017;07;23;Keskiviikko;1;0;1
93;13.07.2017;2017;07;00;Torstai;0;0;0
93;13.07.2017;2017;07;01;Torstai;1;0;1
93;13.07.2017;2017;07;02;Torstai;1;1;2
93;13.07.2017;2017;07;03;Torstai;0;0;0
93;13.07.2017;2017;07;04;Torstai;1;1;2
93;13.07.2017;2017;07;05;Torstai;2;3;5
93;13.07.2017;2017;07;06;Torstai;20;6;26
93;13.07.2017;2017;07;07;Torstai;11;16;27
93;13.07.2017;2017;07;08;Torstai;11;15;26
93;13.07.2017;2017;07;09;Torstai;17;7;24
93;13.07.2017;2017;07;10;Torstai;10;21;31
93;13.07.2017;2017;07;11;Torstai;14;12;26
93;13.07.2017;2017;07;12;Torstai;29;8;37
93;13.07.2017;2017;07;13;Torstai;28;13;41
93;13.07.2017;2017;07;14;Torstai;26;39;65
93;13.07.2017;2017;07;15;Torstai;24;36;60
93;13.07.2017;2017;07;16;Torstai;21;23;44
93;13.07.2017;2017;07;17;Torstai;29;32;61
93;13.07.2017;2017;07;18;Torstai;11;14;25
93;13.07.2017;2017;07;19;Torstai;8;10;18
93;13.07.2017;2017;07;20;Torstai;11;9;20
93;13.07.2017;2017;07;21;Torstai;3;14;17
93;13.07.2017;2017;07;22;Torstai;3;4;7
93;13.07.2017;2017;07;23;Torstai;2;1;3
93;14.07.2017;2017;07;00;Perjantai;0;4;4
93;14.07.2017;2017;07;01;Perjantai;2;2;4
93;14.07.2017;2017;07;02;Perjantai;1;1;2
93;14.07.2017;2017;07;03;Perjantai;0;0;0
93;14.07.2017;2017;07;04;Perjantai;0;2;2
93;14.07.2017;2017;07;05;Perjantai;3;5;8
93;14.07.2017;2017;07;06;Perjantai;10;3;13
93;14.07.2017;2017;07;07;Perjantai;4;8;12
93;14.07.2017;2017;07;08;Perjantai;4;10;14
93;14.07.2017;2017;07;09;Perjantai;1;3;4
93;14.07.2017;2017;07;10;Perjantai;1;2;3
93;14.07.2017;2017;07;11;Perjantai;1;2;3
93;14.07.2017;2017;07;12;Perjantai;3;2;5
93;14.07.2017;2017;07;13;Perjantai;7;5;12
93;14.07.2017;2017;07;14;Perjantai;13;14;27
93;14.07.2017;2017;07;15;Perjantai;20;14;34
93;14.07.2017;2017;07;16;Perjantai;16;23;39
93;14.07.2017;2017;07;17;Perjantai;16;11;27
93;14.07.2017;2017;07;18;Perjantai;15;15;30
93;14.07.2017;2017;07;19;Perjantai;14;12;26
93;14.07.2017;2017;07;20;Perjantai;8;15;23
93;14.07.2017;2017;07;21;Perjantai;5;6;11
93;14.07.2017;2017;07;22;Perjantai;3;7;10
93;14.07.2017;2017;07;23;Perjantai;5;4;9
93;15.07.2017;2017;07;00;Lauantai;2;3;5
93;15.07.2017;2017;07;01;Lauantai;3;2;5
93;15.07.2017;2017;07;02;Lauantai;2;2;4
93;15.07.2017;2017;07;03;Lauantai;0;4;4
93;15.07.2017;2017;07;04;Lauantai;1;1;2
93;15.07.2017;2017;07;05;Lauantai;0;1;1
93;15.07.2017;2017;07;06;Lauantai;1;0;1
93;15.07.2017;2017;07;07;Lauantai;3;9;12
93;15.07.2017;2017;07;08;Lauantai;5;2;7
93;15.07.2017;2017;07;09;Lauantai;6;8;14
93;15.07.2017;2017;07;10;Lauantai;23;19;42
93;15.07.2017;2017;07;11;Lauantai;18;29;47
93;15.07.2017;2017;07;12;Lauantai;26;22;48
93;15.07.2017;2017;07;13;Lauantai;19;21;40
93;15.07.2017;2017;07;14;Lauantai;26;17;43
93;15.07.2017;2017;07;15;Lauantai;26;16;42
93;15.07.2017;2017;07;16;Lauantai;29;29;58
93;15.07.2017;2017;07;17;Lauantai;15;26;41
93;15.07.2017;2017;07;18;Lauantai;16;19;35
93;15.07.2017;2017;07;19;Lauantai;19;25;44
93;15.07.2017;2017;07;20;Lauantai;22;20;42
93;15.07.2017;2017;07;21;Lauantai;9;7;16
93;15.07.2017;2017;07;22;Lauantai;7;9;16
93;15.07.2017;2017;07;23;Lauantai;5;7;12
93;16.07.2017;2017;07;00;Sunnuntai;5;6;11
93;16.07.2017;2017;07;01;Sunnuntai;2;5;7
93;16.07.2017;2017;07;02;Sunnuntai;1;6;7
93;16.07.2017;2017;07;03;Sunnuntai;2;2;4
93;16.07.2017;2017;07;04;Sunnuntai;1;0;1
93;16.07.2017;2017;07;05;Sunnuntai;2;0;2
93;16.07.2017;2017;07;06;Sunnuntai;1;4;5
93;16.07.2017;2017;07;07;Sunnuntai;3;1;4
93;16.07.2017;2017;07;08;Sunnuntai;5;5;10
93;16.07.2017;2017;07;09;Sunnuntai;14;9;23
93;16.07.2017;2017;07;10;Sunnuntai;25;24;49
93;16.07.2017;2017;07;11;Sunnuntai;23;34;57
93;16.07.2017;2017;07;12;Sunnuntai;50;36;86
93;16.07.2017;2017;07;13;Sunnuntai;34;34;68
93;16.07.2017;2017;07;14;Sunnuntai;41;31;72
93;16.07.2017;2017;07;15;Sunnuntai;15;32;47
93;16.07.2017;2017;07;16;Sunnuntai;23;51;74
93;16.07.2017;2017;07;17;Sunnuntai;19;46;65
93;16.07.2017;2017;07;18;Sunnuntai;34;28;62
93;16.07.2017;2017;07;19;Sunnuntai;49;27;76
93;16.07.2017;2017;07;20;Sunnuntai;30;15;45
93;16.07.2017;2017;07;21;Sunnuntai;4;29;33
93;16.07.2017;2017;07;22;Sunnuntai;7;8;15
93;16.07.2017;2017;07;23;Sunnuntai;0;4;4
93;17.07.2017;2017;07;00;Maanantai;3;1;4
93;17.07.2017;2017;07;01;Maanantai;2;0;2
93;17.07.2017;2017;07;02;Maanantai;0;0;0
93;17.07.2017;2017;07;03;Maanantai;0;0;0
93;17.07.2017;2017;07;04;Maanantai;0;2;2
93;17.07.2017;2017;07;05;Maanantai;4;5;9
93;17.07.2017;2017;07;06;Maanantai;27;7;34
93;17.07.2017;2017;07;07;Maanantai;24;28;52
93;17.07.2017;2017;07;08;Maanantai;19;16;35
93;17.07.2017;2017;07;09;Maanantai;12;20;32
93;17.07.2017;2017;07;10;Maanantai;16;16;32
93;17.07.2017;2017;07;11;Maanantai;20;18;38
93;17.07.2017;2017;07;12;Maanantai;24;15;39
93;17.07.2017;2017;07;13;Maanantai;17;30;47
93;17.07.2017;2017;07;14;Maanantai;24;31;55
93;17.07.2017;2017;07;15;Maanantai;19;31;50
93;17.07.2017;2017;07;16;Maanantai;38;44;82
93;17.07.2017;2017;07;17;Maanantai;24;42;66
93;17.07.2017;2017;07;18;Maanantai;35;33;68
93;17.07.2017;2017;07;19;Maanantai;32;25;57
93;17.07.2017;2017;07;20;Maanantai;21;33;54
93;17.07.2017;2017;07;21;Maanantai;8;11;19
93;17.07.2017;2017;07;22;Maanantai;6;8;14
93;17.07.2017;2017;07;23;Maanantai;5;2;7
93;18.07.2017;2017;07;00;Tiistai;1;0;1
93;18.07.2017;2017;07;01;Tiistai;2;4;6
93;18.07.2017;2017;07;02;Tiistai;1;2;3
93;18.07.2017;2017;07;03;Tiistai;0;0;0
93;18.07.2017;2017;07;04;Tiistai;1;0;1
93;18.07.2017;2017;07;05;Tiistai;2;2;4
93;18.07.2017;2017;07;06;Tiistai;4;5;9
93;18.07.2017;2017;07;07;Tiistai;4;12;16
93;18.07.2017;2017;07;08;Tiistai;1;5;6
93;18.07.2017;2017;07;09;Tiistai;1;3;4
93;18.07.2017;2017;07;10;Tiistai;5;0;5
93;18.07.2017;2017;07;11;Tiistai;4;3;7
93;18.07.2017;2017;07;12;Tiistai;4;3;7
93;18.07.2017;2017;07;13;Tiistai;8;7;15
93;18.07.2017;2017;07;14;Tiistai;12;7;19
93;18.07.2017;2017;07;15;Tiistai;9;8;17
93;18.07.2017;2017;07;16;Tiistai;22;15;37
93;18.07.2017;2017;07;17;Tiistai;7;4;11
93;18.07.2017;2017;07;18;Tiistai;15;5;20
93;18.07.2017;2017;07;19;Tiistai;4;7;11
93;18.07.2017;2017;07;20;Tiistai;4;6;10
93;18.07.2017;2017;07;21;Tiistai;4;7;11
93;18.07.2017;2017;07;22;Tiistai;1;2;3
93;18.07.2017;2017;07;23;Tiistai;1;0;1
93;19.07.2017;2017;07;00;Keskiviikko;0;0;0
93;19.07.2017;2017;07;01;Keskiviikko;1;0;1
93;19.07.2017;2017;07;02;Keskiviikko;0;0;0
93;19.07.2017;2017;07;03;Keskiviikko;0;1;1
93;19.07.2017;2017;07;04;Keskiviikko;2;0;2
93;19.07.2017;2017;07;05;Keskiviikko;7;4;11
93;19.07.2017;2017;07;06;Keskiviikko;14;4;18
93;19.07.2017;2017;07;07;Keskiviikko;15;20;35
93;19.07.2017;2017;07;08;Keskiviikko;11;11;22
93;19.07.2017;2017;07;09;Keskiviikko;8;6;14
93;19.07.2017;2017;07;10;Keskiviikko;14;8;22
93;19.07.2017;2017;07;11;Keskiviikko;15;8;23
93;19.07.2017;2017;07;12;Keskiviikko;8;16;24
93;19.07.2017;2017;07;13;Keskiviikko;15;18;33
93;19.07.2017;2017;07;14;Keskiviikko;12;23;35
93;19.07.2017;2017;07;15;Keskiviikko;15;18;33
93;19.07.2017;2017;07;16;Keskiviikko;28;24;52
93;19.07.2017;2017;07;17;Keskiviikko;25;11;36
93;19.07.2017;2017;07;18;Keskiviikko;13;26;39
93;19.07.2017;2017;07;19;Keskiviikko;13;14;27
93;19.07.2017;2017;07;20;Keskiviikko;9;19;28
93;19.07.2017;2017;07;21;Keskiviikko;11;21;32
93;19.07.2017;2017;07;22;Keskiviikko;8;3;11
93;19.07.2017;2017;07;23;Keskiviikko;2;5;7
93;20.07.2017;2017;07;00;Torstai;5;1;6
93;20.07.2017;2017;07;01;Torstai;1;0;1
93;20.07.2017;2017;07;02;Torstai;0;0;0
93;20.07.2017;2017;07;03;Torstai;0;3;3
93;20.07.2017;2017;07;04;Torstai;0;1;1
93;20.07.2017;2017;07;05;Torstai;5;4;9
93;20.07.2017;2017;07;06;Torstai;15;4;19
93;20.07.2017;2017;07;07;Torstai;24;34;58
93;20.07.2017;2017;07;08;Torstai;13;13;26
93;20.07.2017;2017;07;09;Torstai;13;14;27
93;20.07.2017;2017;07;10;Torstai;10;14;24
93;20.07.2017;2017;07;11;Torstai;10;15;25
93;20.07.2017;2017;07;12;Torstai;13;13;26
93;20.07.2017;2017;07;13;Torstai;21;13;34
93;20.07.2017;2017;07;14;Torstai;18;24;42
93;20.07.2017;2017;07;15;Torstai;26;27;53
93;20.07.2017;2017;07;16;Torstai;32;42;74
93;20.07.2017;2017;07;17;Torstai;24;27;51
93;20.07.2017;2017;07;18;Torstai;25;19;44
93;20.07.2017;2017;07;19;Torstai;24;27;51
93;20.07.2017;2017;07;20;Torstai;23;27;50
93;20.07.2017;2017;07;21;Torstai;9;7;16
93;20.07.2017;2017;07;22;Torstai;4;12;16
93;20.07.2017;2017;07;23;Torstai;1;2;3
93;21.07.2017;2017;07;00;Perjantai;2;0;2
93;21.07.2017;2017;07;01;Perjantai;0;1;1
93;21.07.2017;2017;07;02;Perjantai;0;2;2
93;21.07.2017;2017;07;03;Perjantai;0;0;0
93;21.07.2017;2017;07;04;Perjantai;1;1;2
93;21.07.2017;2017;07;05;Perjantai;4;5;9
93;21.07.2017;2017;07;06;Perjantai;13;7;20
93;21.07.2017;2017;07;07;Perjantai;12;18;30
93;21.07.2017;2017;07;08;Perjantai;8;5;13
93;21.07.2017;2017;07;09;Perjantai;14;7;21
93;21.07.2017;2017;07;10;Perjantai;20;15;35
93;21.07.2017;2017;07;11;Perjantai;10;11;21
93;21.07.2017;2017;07;12;Perjantai;18;19;37
93;21.07.2017;2017;07;13;Perjantai;13;20;33
93;21.07.2017;2017;07;14;Perjantai;24;23;47
93;21.07.2017;2017;07;15;Perjantai;22;26;48
93;21.07.2017;2017;07;16;Perjantai;27;13;40
93;21.07.2017;2017;07;17;Perjantai;15;17;32
93;21.07.2017;2017;07;18;Perjantai;12;23;35
93;21.07.2017;2017;07;19;Perjantai;14;17;31
93;21.07.2017;2017;07;20;Perjantai;11;8;19
93;21.07.2017;2017;07;21;Perjantai;6;14;20
93;21.07.2017;2017;07;22;Perjantai;5;3;8
93;21.07.2017;2017;07;23;Perjantai;2;4;6
93;22.07.2017;2017;07;00;Lauantai;4;0;4
93;22.07.2017;2017;07;01;Lauantai;2;0;2
93;22.07.2017;2017;07;02;Lauantai;3;5;8
93;22.07.2017;2017;07;03;Lauantai;0;1;1
93;22.07.2017;2017;07;04;Lauantai;0;4;4
93;22.07.2017;2017;07;05;Lauantai;1;0;1
93;22.07.2017;2017;07;06;Lauantai;1;1;2
93;22.07.2017;2017;07;07;Lauantai;1;1;2
93;22.07.2017;2017;07;08;Lauantai;3;10;13
93;22.07.2017;2017;07;09;Lauantai;6;6;12
93;22.07.2017;2017;07;10;Lauantai;20;18;38
93;22.07.2017;2017;07;11;Lauantai;13;12;25
93;22.07.2017;2017;07;12;Lauantai;25;24;49
93;22.07.2017;2017;07;13;Lauantai;19;17;36
93;22.07.2017;2017;07;14;Lauantai;21;31;52
93;22.07.2017;2017;07;15;Lauantai;14;16;30
93;22.07.2017;2017;07;16;Lauantai;21;22;43
93;22.07.2017;2017;07;17;Lauantai;12;14;26
93;22.07.2017;2017;07;18;Lauantai;12;17;29
93;22.07.2017;2017;07;19;Lauantai;14;18;32
93;22.07.2017;2017;07;20;Lauantai;14;7;21
93;22.07.2017;2017;07;21;Lauantai;5;6;11
93;22.07.2017;2017;07;22;Lauantai;3;7;10
93;22.07.2017;2017;07;23;Lauantai;1;2;3
93;23.07.2017;2017;07;00;Sunnuntai;4;2;6
93;23.07.2017;2017;07;01;Sunnuntai;2;1;3
93;23.07.2017;2017;07;02;Sunnuntai;2;1;3
93;23.07.2017;2017;07;03;Sunnuntai;0;2;2
93;23.07.2017;2017;07;04;Sunnuntai;1;2;3
93;23.07.2017;2017;07;05;Sunnuntai;1;1;2
93;23.07.2017;2017;07;06;Sunnuntai;2;1;3
93;23.07.2017;2017;07;07;Sunnuntai;5;2;7
93;23.07.2017;2017;07;08;Sunnuntai;3;3;6
93;23.07.2017;2017;07;09;Sunnuntai;4;14;18
93;23.07.2017;2017;07;10;Sunnuntai;18;19;37
93;23.07.2017;2017;07;11;Sunnuntai;33;30;63
93;23.07.2017;2017;07;12;Sunnuntai;21;29;50
93;23.07.2017;2017;07;13;Sunnuntai;29;19;48
93;23.07.2017;2017;07;14;Sunnuntai;25;18;43
93;23.07.2017;2017;07;15;Sunnuntai;11;24;35
93;23.07.2017;2017;07;16;Sunnuntai;9;10;19
93;23.07.2017;2017;07;17;Sunnuntai;11;8;19
93;23.07.2017;2017;07;18;Sunnuntai;3;12;15
93;23.07.2017;2017;07;19;Sunnuntai;4;3;7
93;23.07.2017;2017;07;20;Sunnuntai;5;4;9
93;23.07.2017;2017;07;21;Sunnuntai;3;7;10
93;23.07.2017;2017;07;22;Sunnuntai;1;4;5
93;23.07.2017;2017;07;23;Sunnuntai;4;1;5
93;24.07.2017;2017;07;00;Maanantai;1;0;1
93;24.07.2017;2017;07;01;Maanantai;0;0;0
93;24.07.2017;2017;07;02;Maanantai;3;0;3
93;24.07.2017;2017;07;03;Maanantai;0;1;1
93;24.07.2017;2017;07;04;Maanantai;1;1;2
93;24.07.2017;2017;07;05;Maanantai;7;7;14
93;24.07.2017;2017;07;06;Maanantai;19;5;24
93;24.07.2017;2017;07;07;Maanantai;21;31;52
93;24.07.2017;2017;07;08;Maanantai;16;13;29
93;24.07.2017;2017;07;09;Maanantai;16;14;30
93;24.07.2017;2017;07;10;Maanantai;14;21;35
93;24.07.2017;2017;07;11;Maanantai;19;14;33
93;24.07.2017;2017;07;12;Maanantai;19;22;41
93;24.07.2017;2017;07;13;Maanantai;24;16;40
93;24.07.2017;2017;07;14;Maanantai;20;28;48
93;24.07.2017;2017;07;15;Maanantai;26;33;59
93;24.07.2017;2017;07;16;Maanantai;45;31;76
93;24.07.2017;2017;07;17;Maanantai;32;38;70
93;24.07.2017;2017;07;18;Maanantai;17;23;40
93;24.07.2017;2017;07;19;Maanantai;19;31;50
93;24.07.2017;2017;07;20;Maanantai;20;19;39
93;24.07.2017;2017;07;21;Maanantai;12;21;33
93;24.07.2017;2017;07;22;Maanantai;5;7;12
93;24.07.2017;2017;07;23;Maanantai;5;3;8
93;25.07.2017;2017;07;00;Tiistai;2;0;2
93;25.07.2017;2017;07;01;Tiistai;0;1;1
93;25.07.2017;2017;07;02;Tiistai;1;1;2
93;25.07.2017;2017;07;03;Tiistai;1;0;1
93;25.07.2017;2017;07;04;Tiistai;0;0;0
93;25.07.2017;2017;07;05;Tiistai;7;5;12
93;25.07.2017;2017;07;06;Tiistai;20;14;34
93;25.07.2017;2017;07;07;Tiistai;23;36;59
93;25.07.2017;2017;07;08;Tiistai;16;18;34
93;25.07.2017;2017;07;09;Tiistai;23;20;43
93;25.07.2017;2017;07;10;Tiistai;12;17;29
93;25.07.2017;2017;07;11;Tiistai;21;11;32
93;25.07.2017;2017;07;12;Tiistai;22;23;45
93;25.07.2017;2017;07;13;Tiistai;27;30;57
93;25.07.2017;2017;07;14;Tiistai;38;29;67
93;25.07.2017;2017;07;15;Tiistai;31;51;82
93;25.07.2017;2017;07;16;Tiistai;63;43;106
93;25.07.2017;2017;07;17;Tiistai;30;50;80
93;25.07.2017;2017;07;18;Tiistai;27;56;83
93;25.07.2017;2017;07;19;Tiistai;46;43;89
93;25.07.2017;2017;07;20;Tiistai;27;33;60
93;25.07.2017;2017;07;21;Tiistai;25;24;49
93;25.07.2017;2017;07;22;Tiistai;3;3;6
93;25.07.2017;2017;07;23;Tiistai;4;12;16
93;26.07.2017;2017;07;00;Keskiviikko;1;0;1
93;26.07.2017;2017;07;01;Keskiviikko;0;3;3
93;26.07.2017;2017;07;02;Keskiviikko;1;3;4
93;26.07.2017;2017;07;03;Keskiviikko;0;1;1
93;26.07.2017;2017;07;04;Keskiviikko;2;2;4
93;26.07.2017;2017;07;05;Keskiviikko;7;9;16
93;26.07.2017;2017;07;06;Keskiviikko;19;17;36
93;26.07.2017;2017;07;07;Keskiviikko;23;27;50
93;26.07.2017;2017;07;08;Keskiviikko;14;17;31
93;26.07.2017;2017;07;09;Keskiviikko;19;24;43
93;26.07.2017;2017;07;10;Keskiviikko;15;25;40
93;26.07.2017;2017;07;11;Keskiviikko;29;33;62
93;26.07.2017;2017;07;12;Keskiviikko;21;30;51
93;26.07.2017;2017;07;13;Keskiviikko;39;37;76
93;26.07.2017;2017;07;14;Keskiviikko;49;31;80
93;26.07.2017;2017;07;15;Keskiviikko;41;52;93
93;26.07.2017;2017;07;16;Keskiviikko;68;46;114
93;26.07.2017;2017;07;17;Keskiviikko;40;38;78
93;26.07.2017;2017;07;18;Keskiviikko;50;51;101
93;26.07.2017;2017;07;19;Keskiviikko;37;45;82
93;26.07.2017;2017;07;20;Keskiviikko;21;53;74
93;26.07.2017;2017;07;21;Keskiviikko;13;21;34
93;26.07.2017;2017;07;22;Keskiviikko;3;12;15
93;26.07.2017;2017;07;23;Keskiviikko;3;4;7
93;27.07.2017;2017;07;00;Torstai;2;5;7
93;27.07.2017;2017;07;01;Torstai;0;5;5
93;27.07.2017;2017;07;02;Torstai;0;1;1
93;27.07.2017;2017;07;03;Torstai;0;0;0
93;27.07.2017;2017;07;04;Torstai;1;1;2
93;27.07.2017;2017;07;05;Torstai;2;6;8
93;27.07.2017;2017;07;06;Torstai;26;10;36
93;27.07.2017;2017;07;07;Torstai;19;31;50
93;27.07.2017;2017;07;08;Torstai;19;24;43
93;27.07.2017;2017;07;09;Torstai;27;11;38
93;27.07.2017;2017;07;10;Torstai;16;21;37
93;27.07.2017;2017;07;11;Torstai;26;15;41
93;27.07.2017;2017;07;12;Torstai;38;33;71
93;27.07.2017;2017;07;13;Torstai;31;33;64
93;27.07.2017;2017;07;14;Torstai;35;26;61
93;27.07.2017;2017;07;15;Torstai;43;56;99
93;27.07.2017;2017;07;16;Torstai;45;34;79
93;27.07.2017;2017;07;17;Torstai;37;44;81
93;27.07.2017;2017;07;18;Torstai;24;41;65
93;27.07.2017;2017;07;19;Torstai;33;43;76
93;27.07.2017;2017;07;20;Torstai;31;22;53
93;27.07.2017;2017;07;21;Torstai;21;21;42
93;27.07.2017;2017;07;22;Torstai;4;14;18
93;27.07.2017;2017;07;23;Torstai;2;8;10
93;28.07.2017;2017;07;00;Perjantai;0;2;2
93;28.07.2017;2017;07;01;Perjantai;1;0;1
93;28.07.2017;2017;07;02;Perjantai;1;3;4
93;28.07.2017;2017;07;03;Perjantai;0;0;0
93;28.07.2017;2017;07;04;Perjantai;0;0;0
93;28.07.2017;2017;07;05;Perjantai;4;6;10
93;28.07.2017;2017;07;06;Perjantai;15;10;25
93;28.07.2017;2017;07;07;Perjantai;14;24;38
93;28.07.2017;2017;07;08;Perjantai;15;14;29
93;28.07.2017;2017;07;09;Perjantai;16;17;33
93;28.07.2017;2017;07;10;Perjantai;28;17;45
93;28.07.2017;2017;07;11;Perjantai;31;16;47
93;28.07.2017;2017;07;12;Perjantai;31;19;50
93;28.07.2017;2017;07;13;Perjantai;21;28;49
93;28.07.2017;2017;07;14;Perjantai;36;22;58
93;28.07.2017;2017;07;15;Perjantai;21;37;58
93;28.07.2017;2017;07;16;Perjantai;60;39;99
93;28.07.2017;2017;07;17;Perjantai;35;23;58
93;28.07.2017;2017;07;18;Perjantai;25;37;62
93;28.07.2017;2017;07;19;Perjantai;29;26;55
93;28.07.2017;2017;07;20;Perjantai;18;26;44
93;28.07.2017;2017;07;21;Perjantai;12;18;30
93;28.07.2017;2017;07;22;Perjantai;7;7;14
93;28.07.2017;2017;07;23;Perjantai;4;13;17
93;29.07.2017;2017;07;00;Lauantai;3;11;14
93;29.07.2017;2017;07;01;Lauantai;5;21;26
93;29.07.2017;2017;07;02;Lauantai;1;13;14
93;29.07.2017;2017;07;03;Lauantai;0;19;19
93;29.07.2017;2017;07;04;Lauantai;1;8;9
93;29.07.2017;2017;07;05;Lauantai;1;1;2
93;29.07.2017;2017;07;06;Lauantai;1;2;3
93;29.07.2017;2017;07;07;Lauantai;5;7;12
93;29.07.2017;2017;07;08;Lauantai;4;4;8
93;29.07.2017;2017;07;09;Lauantai;6;6;12
93;29.07.2017;2017;07;10;Lauantai;6;9;15
93;29.07.2017;2017;07;11;Lauantai;6;8;14
93;29.07.2017;2017;07;12;Lauantai;12;8;20
93;29.07.2017;2017;07;13;Lauantai;4;8;12
93;29.07.2017;2017;07;14;Lauantai;11;10;21
93;29.07.2017;2017;07;15;Lauantai;6;3;9
93;29.07.2017;2017;07;16;Lauantai;10;11;21
93;29.07.2017;2017;07;17;Lauantai;10;13;23
93;29.07.2017;2017;07;18;Lauantai;18;8;26
93;29.07.2017;2017;07;19;Lauantai;14;20;34
93;29.07.2017;2017;07;20;Lauantai;10;10;20
93;29.07.2017;2017;07;21;Lauantai;4;8;12
93;29.07.2017;2017;07;22;Lauantai;3;6;9
93;29.07.2017;2017;07;23;Lauantai;4;4;8
93;30.07.2017;2017;07;00;Sunnuntai;3;5;8
93;30.07.2017;2017;07;01;Sunnuntai;0;9;9
93;30.07.2017;2017;07;02;Sunnuntai;3;5;8
93;30.07.2017;2017;07;03;Sunnuntai;0;6;6
93;30.07.2017;2017;07;04;Sunnuntai;0;11;11
93;30.07.2017;2017;07;05;Sunnuntai;0;0;0
93;30.07.2017;2017;07;06;Sunnuntai;4;2;6
93;30.07.2017;2017;07;07;Sunnuntai;6;1;7
93;30.07.2017;2017;07;08;Sunnuntai;3;8;11
93;30.07.2017;2017;07;09;Sunnuntai;10;15;25
93;30.07.2017;2017;07;10;Sunnuntai;20;34;54
93;30.07.2017;2017;07;11;Sunnuntai;43;24;67
93;30.07.2017;2017;07;12;Sunnuntai;36;26;62
93;30.07.2017;2017;07;13;Sunnuntai;45;48;93
93;30.07.2017;2017;07;14;Sunnuntai;40;33;73
93;30.07.2017;2017;07;15;Sunnuntai;30;51;81
93;30.07.2017;2017;07;16;Sunnuntai;26;60;86
93;30.07.2017;2017;07;17;Sunnuntai;32;36;68
93;30.07.2017;2017;07;18;Sunnuntai;31;44;75
93;30.07.2017;2017;07;19;Sunnuntai;30;26;56
93;30.07.2017;2017;07;20;Sunnuntai;14;15;29
93;30.07.2017;2017;07;21;Sunnuntai;12;14;26
93;30.07.2017;2017;07;22;Sunnuntai;9;6;15
93;30.07.2017;2017;07;23;Sunnuntai;0;3;3
93;31.07.2017;2017;07;00;Maanantai;0;1;1
93;31.07.2017;2017;07;01;Maanantai;2;0;2
93;31.07.2017;2017;07;02;Maanantai;2;2;4
93;31.07.2017;2017;07;03;Maanantai;1;0;1
93;31.07.2017;2017;07;04;Maanantai;1;0;1
93;31.07.2017;2017;07;05;Maanantai;9;7;16
93;31.07.2017;2017;07;06;Maanantai;18;12;30
93;31.07.2017;2017;07;07;Maanantai;29;41;70
93;31.07.2017;2017;07;08;Maanantai;19;14;33
93;31.07.2017;2017;07;09;Maanantai;15;9;24
93;31.07.2017;2017;07;10;Maanantai;9;4;13
93;31.07.2017;2017;07;11;Maanantai;11;14;25
93;31.07.2017;2017;07;12;Maanantai;17;20;37
93;31.07.2017;2017;07;13;Maanantai;21;13;34
93;31.07.2017;2017;07;14;Maanantai;14;27;41
93;31.07.2017;2017;07;15;Maanantai;46;46;92
93;31.07.2017;2017;07;16;Maanantai;60;53;113
93;31.07.2017;2017;07;17;Maanantai;32;39;71
93;31.07.2017;2017;07;18;Maanantai;35;39;74
93;31.07.2017;2017;07;19;Maanantai;18;20;38
93;31.07.2017;2017;07;20;Maanantai;7;26;33
93;31.07.2017;2017;07;21;Maanantai;11;14;25
93;31.07.2017;2017;07;22;Maanantai;2;11;13
93;31.07.2017;2017;07;23;Maanantai;0;6;6
93;01.08.2017;2017;08;00;Tiistai;2;2;4
93;01.08.2017;2017;08;01;Tiistai;2;1;3
93;01.08.2017;2017;08;02;Tiistai;0;0;0
93;01.08.2017;2017;08;03;Tiistai;0;0;0
93;01.08.2017;2017;08;04;Tiistai;4;0;4
93;01.08.2017;2017;08;05;Tiistai;3;8;11
93;01.08.2017;2017;08;06;Tiistai;18;7;25
93;01.08.2017;2017;08;07;Tiistai;24;29;53
93;01.08.2017;2017;08;08;Tiistai;26;22;48
93;01.08.2017;2017;08;09;Tiistai;17;7;24
93;01.08.2017;2017;08;10;Tiistai;12;13;25
93;01.08.2017;2017;08;11;Tiistai;23;13;36
93;01.08.2017;2017;08;12;Tiistai;15;20;35
93;01.08.2017;2017;08;13;Tiistai;26;21;47
93;01.08.2017;2017;08;14;Tiistai;26;22;48
93;01.08.2017;2017;08;15;Tiistai;30;44;74
93;01.08.2017;2017;08;16;Tiistai;51;49;100
93;01.08.2017;2017;08;17;Tiistai;33;30;63
93;01.08.2017;2017;08;18;Tiistai;24;43;67
93;01.08.2017;2017;08;19;Tiistai;22;23;45
93;01.08.2017;2017;08;20;Tiistai;19;25;44
93;01.08.2017;2017;08;21;Tiistai;11;17;28
93;01.08.2017;2017;08;22;Tiistai;6;11;17
93;01.08.2017;2017;08;23;Tiistai;3;2;5
93;02.08.2017;2017;08;00;Keskiviikko;2;4;6
93;02.08.2017;2017;08;01;Keskiviikko;0;0;0
93;02.08.2017;2017;08;02;Keskiviikko;2;0;2
93;02.08.2017;2017;08;03;Keskiviikko;0;0;0
93;02.08.2017;2017;08;04;Keskiviikko;1;1;2
93;02.08.2017;2017;08;05;Keskiviikko;3;8;11
93;02.08.2017;2017;08;06;Keskiviikko;21;14;35
93;02.08.2017;2017;08;07;Keskiviikko;23;33;56
93;02.08.2017;2017;08;08;Keskiviikko;26;31;57
93;02.08.2017;2017;08;09;Keskiviikko;20;16;36
93;02.08.2017;2017;08;10;Keskiviikko;14;18;32
93;02.08.2017;2017;08;11;Keskiviikko;30;31;61
93;02.08.2017;2017;08;12;Keskiviikko;18;19;37
93;02.08.2017;2017;08;13;Keskiviikko;36;26;62
93;02.08.2017;2017;08;14;Keskiviikko;26;27;53
93;02.08.2017;2017;08;15;Keskiviikko;48;49;97
93;02.08.2017;2017;08;16;Keskiviikko;51;37;88
93;02.08.2017;2017;08;17;Keskiviikko;30;30;60
93;02.08.2017;2017;08;18;Keskiviikko;26;32;58
93;02.08.2017;2017;08;19;Keskiviikko;25;27;52
93;02.08.2017;2017;08;20;Keskiviikko;22;20;42
93;02.08.2017;2017;08;21;Keskiviikko;14;16;30
93;02.08.2017;2017;08;22;Keskiviikko;5;8;13
93;02.08.2017;2017;08;23;Keskiviikko;1;4;5
93;03.08.2017;2017;08;00;Torstai;1;4;5
93;03.08.2017;2017;08;01;Torstai;2;0;2
93;03.08.2017;2017;08;02;Torstai;4;1;5
93;03.08.2017;2017;08;03;Torstai;0;2;2
93;03.08.2017;2017;08;04;Torstai;1;0;1
93;03.08.2017;2017;08;05;Torstai;6;6;12
93;03.08.2017;2017;08;06;Torstai;9;12;21
93;03.08.2017;2017;08;07;Torstai;17;36;53
93;03.08.2017;2017;08;08;Torstai;16;22;38
93;03.08.2017;2017;08;09;Torstai;18;12;30
93;03.08.2017;2017;08;10;Torstai;13;10;23
93;03.08.2017;2017;08;11;Torstai;14;19;33
93;03.08.2017;2017;08;12;Torstai;30;23;53
93;03.08.2017;2017;08;13;Torstai;18;18;36
93;03.08.2017;2017;08;14;Torstai;21;23;44
93;03.08.2017;2017;08;15;Torstai;35;44;79
93;03.08.2017;2017;08;16;Torstai;56;31;87
93;03.08.2017;2017;08;17;Torstai;43;28;71
93;03.08.2017;2017;08;18;Torstai;26;44;70
93;03.08.2017;2017;08;19;Torstai;36;34;70
93;03.08.2017;2017;08;20;Torstai;12;21;33
93;03.08.2017;2017;08;21;Torstai;11;20;31
93;03.08.2017;2017;08;22;Torstai;7;6;13
93;03.08.2017;2017;08;23;Torstai;1;1;2
93;04.08.2017;2017;08;00;Perjantai;0;0;0
93;04.08.2017;2017;08;01;Perjantai;0;1;1
93;04.08.2017;2017;08;02;Perjantai;1;1;2
93;04.08.2017;2017;08;03;Perjantai;0;1;1
93;04.08.2017;2017;08;04;Perjantai;0;0;0
93;04.08.2017;2017;08;05;Perjantai;6;8;14
93;04.08.2017;2017;08;06;Perjantai;11;11;22
93;04.08.2017;2017;08;07;Perjantai;22;31;53
93;04.08.2017;2017;08;08;Perjantai;16;24;40
93;04.08.2017;2017;08;09;Perjantai;16;11;27
93;04.08.2017;2017;08;10;Perjantai;10;13;23
93;04.08.2017;2017;08;11;Perjantai;21;14;35
93;04.08.2017;2017;08;12;Perjantai;30;25;55
93;04.08.2017;2017;08;13;Perjantai;21;23;44
93;04.08.2017;2017;08;14;Perjantai;34;26;60
93;04.08.2017;2017;08;15;Perjantai;40;34;74
93;04.08.2017;2017;08;16;Perjantai;46;37;83
93;04.08.2017;2017;08;17;Perjantai;28;30;58
93;04.08.2017;2017;08;18;Perjantai;17;20;37
93;04.08.2017;2017;08;19;Perjantai;27;34;61
93;04.08.2017;2017;08;20;Perjantai;9;21;30
93;04.08.2017;2017;08;21;Perjantai;12;12;24
93;04.08.2017;2017;08;22;Perjantai;6;10;16
93;04.08.2017;2017;08;23;Perjantai;2;7;9
93;05.08.2017;2017;08;00;Lauantai;1;1;2
93;05.08.2017;2017;08;01;Lauantai;0;1;1
93;05.08.2017;2017;08;02;Lauantai;1;3;4
93;05.08.2017;2017;08;03;Lauantai;1;0;1
93;05.08.2017;2017;08;04;Lauantai;0;2;2
93;05.08.2017;2017;08;05;Lauantai;0;3;3
93;05.08.2017;2017;08;06;Lauantai;1;6;7
93;05.08.2017;2017;08;07;Lauantai;6;4;10
93;05.08.2017;2017;08;08;Lauantai;5;8;13
93;05.08.2017;2017;08;09;Lauantai;9;6;15
93;05.08.2017;2017;08;10;Lauantai;14;8;22
93;05.08.2017;2017;08;11;Lauantai;11;5;16
93;05.08.2017;2017;08;12;Lauantai;13;10;23
93;05.08.2017;2017;08;13;Lauantai;20;13;33
93;05.08.2017;2017;08;14;Lauantai;13;13;26
93;05.08.2017;2017;08;15;Lauantai;14;16;30
93;05.08.2017;2017;08;16;Lauantai;15;17;32
93;05.08.2017;2017;08;17;Lauantai;6;9;15
93;05.08.2017;2017;08;18;Lauantai;9;3;12
93;05.08.2017;2017;08;19;Lauantai;4;5;9
93;05.08.2017;2017;08;20;Lauantai;8;7;15
93;05.08.2017;2017;08;21;Lauantai;2;4;6
93;05.08.2017;2017;08;22;Lauantai;2;1;3
93;05.08.2017;2017;08;23;Lauantai;0;3;3
93;06.08.2017;2017;08;00;Sunnuntai;2;1;3
93;06.08.2017;2017;08;01;Sunnuntai;0;2;2
93;06.08.2017;2017;08;02;Sunnuntai;0;2;2
93;06.08.2017;2017;08;03;Sunnuntai;0;0;0
93;06.08.2017;2017;08;04;Sunnuntai;1;1;2
93;06.08.2017;2017;08;05;Sunnuntai;0;2;2
93;06.08.2017;2017;08;06;Sunnuntai;1;2;3
93;06.08.2017;2017;08;07;Sunnuntai;4;3;7
93;06.08.2017;2017;08;08;Sunnuntai;4;2;6
93;06.08.2017;2017;08;09;Sunnuntai;7;7;14
93;06.08.2017;2017;08;10;Sunnuntai;8;16;24
93;06.08.2017;2017;08;11;Sunnuntai;18;10;28
93;06.08.2017;2017;08;12;Sunnuntai;22;14;36
93;06.08.2017;2017;08;13;Sunnuntai;20;16;36
93;06.08.2017;2017;08;14;Sunnuntai;9;17;26
93;06.08.2017;2017;08;15;Sunnuntai;6;18;24
93;06.08.2017;2017;08;16;Sunnuntai;21;15;36
93;06.08.2017;2017;08;17;Sunnuntai;5;11;16
93;06.08.2017;2017;08;18;Sunnuntai;17;11;28
93;06.08.2017;2017;08;19;Sunnuntai;17;12;29
93;06.08.2017;2017;08;20;Sunnuntai;4;8;12
93;06.08.2017;2017;08;21;Sunnuntai;9;9;18
93;06.08.2017;2017;08;22;Sunnuntai;1;2;3
93;06.08.2017;2017;08;23;Sunnuntai;4;2;6
93;07.08.2017;2017;08;00;Maanantai;0;0;0
93;07.08.2017;2017;08;01;Maanantai;1;4;5
93;07.08.2017;2017;08;02;Maanantai;0;2;2
93;07.08.2017;2017;08;03;Maanantai;0;1;1
93;07.08.2017;2017;08;04;Maanantai;0;0;0
93;07.08.2017;2017;08;05;Maanantai;4;6;10
93;07.08.2017;2017;08;06;Maanantai;18;9;27
93;07.08.2017;2017;08;07;Maanantai;21;38;59
93;07.08.2017;2017;08;08;Maanantai;16;32;48
93;07.08.2017;2017;08;09;Maanantai;11;9;20
93;07.08.2017;2017;08;10;Maanantai;14;9;23
93;07.08.2017;2017;08;11;Maanantai;6;19;25
93;07.08.2017;2017;08;12;Maanantai;21;10;31
93;07.08.2017;2017;08;13;Maanantai;21;9;30
93;07.08.2017;2017;08;14;Maanantai;23;23;46
93;07.08.2017;2017;08;15;Maanantai;41;28;69
93;07.08.2017;2017;08;16;Maanantai;54;56;110
93;07.08.2017;2017;08;17;Maanantai;28;35;63
93;07.08.2017;2017;08;18;Maanantai;23;43;66
93;07.08.2017;2017;08;19;Maanantai;28;35;63
93;07.08.2017;2017;08;20;Maanantai;15;44;59
93;07.08.2017;2017;08;21;Maanantai;7;7;14
93;07.08.2017;2017;08;22;Maanantai;5;8;13
93;07.08.2017;2017;08;23;Maanantai;6;3;9
93;08.08.2017;2017;08;00;Tiistai;3;0;3
93;08.08.2017;2017;08;01;Tiistai;0;0;0
93;08.08.2017;2017;08;02;Tiistai;0;0;0
93;08.08.2017;2017;08;03;Tiistai;0;2;2
93;08.08.2017;2017;08;04;Tiistai;0;0;0
93;08.08.2017;2017;08;05;Tiistai;5;4;9
93;08.08.2017;2017;08;06;Tiistai;20;13;33
93;08.08.2017;2017;08;07;Tiistai;30;44;74
93;08.08.2017;2017;08;08;Tiistai;25;43;68
93;08.08.2017;2017;08;09;Tiistai;22;12;34
93;08.08.2017;2017;08;10;Tiistai;23;13;36
93;08.08.2017;2017;08;11;Tiistai;16;20;36
93;08.08.2017;2017;08;12;Tiistai;11;15;26
93;08.08.2017;2017;08;13;Tiistai;33;17;50
93;08.08.2017;2017;08;14;Tiistai;18;18;36
93;08.08.2017;2017;08;15;Tiistai;43;37;80
93;08.08.2017;2017;08;16;Tiistai;72;50;122
93;08.08.2017;2017;08;17;Tiistai;27;38;65
93;08.08.2017;2017;08;18;Tiistai;14;36;50
93;08.08.2017;2017;08;19;Tiistai;11;9;20
93;08.08.2017;2017;08;20;Tiistai;4;6;10
93;08.08.2017;2017;08;21;Tiistai;8;7;15
93;08.08.2017;2017;08;22;Tiistai;2;7;9
93;08.08.2017;2017;08;23;Tiistai;1;2;3
93;09.08.2017;2017;08;00;Keskiviikko;3;1;4
93;09.08.2017;2017;08;01;Keskiviikko;0;1;1
93;09.08.2017;2017;08;02;Keskiviikko;0;0;0
93;09.08.2017;2017;08;03;Keskiviikko;0;1;1
93;09.08.2017;2017;08;04;Keskiviikko;0;0;0
93;09.08.2017;2017;08;05;Keskiviikko;7;5;12
93;09.08.2017;2017;08;06;Keskiviikko;20;18;38
93;09.08.2017;2017;08;07;Keskiviikko;23;39;62
93;09.08.2017;2017;08;08;Keskiviikko;26;28;54
93;09.08.2017;2017;08;09;Keskiviikko;13;10;23
93;09.08.2017;2017;08;10;Keskiviikko;11;10;21
93;09.08.2017;2017;08;11;Keskiviikko;17;10;27
93;09.08.2017;2017;08;12;Keskiviikko;19;11;30
93;09.08.2017;2017;08;13;Keskiviikko;28;29;57
93;09.08.2017;2017;08;14;Keskiviikko;30;28;58
93;09.08.2017;2017;08;15;Keskiviikko;37;42;79
93;09.08.2017;2017;08;16;Keskiviikko;66;41;107
93;09.08.2017;2017;08;17;Keskiviikko;35;37;72
93;09.08.2017;2017;08;18;Keskiviikko;38;39;77
93;09.08.2017;2017;08;19;Keskiviikko;17;40;57
93;09.08.2017;2017;08;20;Keskiviikko;22;17;39
93;09.08.2017;2017;08;21;Keskiviikko;17;20;37
93;09.08.2017;2017;08;22;Keskiviikko;4;4;8
93;09.08.2017;2017;08;23;Keskiviikko;1;4;5
93;10.08.2017;2017;08;00;Torstai;1;2;3
93;10.08.2017;2017;08;01;Torstai;0;1;1
93;10.08.2017;2017;08;02;Torstai;0;0;0
93;10.08.2017;2017;08;03;Torstai;0;0;0
93;10.08.2017;2017;08;04;Torstai;0;0;0
93;10.08.2017;2017;08;05;Torstai;3;5;8
93;10.08.2017;2017;08;06;Torstai;9;9;18
93;10.08.2017;2017;08;07;Torstai;22;31;53
93;10.08.2017;2017;08;08;Torstai;15;23;38
93;10.08.2017;2017;08;09;Torstai;23;12;35
93;10.08.2017;2017;08;10;Torstai;12;14;26
93;10.08.2017;2017;08;11;Torstai;13;3;16
93;10.08.2017;2017;08;12;Torstai;8;4;12
93;10.08.2017;2017;08;13;Torstai;5;2;7
93;10.08.2017;2017;08;14;Torstai;10;9;19
93;10.08.2017;2017;08;15;Torstai;21;12;33
93;10.08.2017;2017;08;16;Torstai;25;15;40
93;10.08.2017;2017;08;17;Torstai;14;10;24
93;10.08.2017;2017;08;18;Torstai;14;19;33
93;10.08.2017;2017;08;19;Torstai;13;10;23
93;10.08.2017;2017;08;20;Torstai;4;4;8
93;10.08.2017;2017;08;21;Torstai;1;4;5
93;10.08.2017;2017;08;22;Torstai;1;4;5
93;10.08.2017;2017;08;23;Torstai;0;2;2
93;11.08.2017;2017;08;00;Perjantai;1;0;1
93;11.08.2017;2017;08;01;Perjantai;0;0;0
93;11.08.2017;2017;08;02;Perjantai;0;0;0
93;11.08.2017;2017;08;03;Perjantai;0;0;0
93;11.08.2017;2017;08;04;Perjantai;1;0;1
93;11.08.2017;2017;08;05;Perjantai;6;4;10
93;11.08.2017;2017;08;06;Perjantai;18;16;34
93;11.08.2017;2017;08;07;Perjantai;27;48;75
93;11.08.2017;2017;08;08;Perjantai;15;28;43
93;11.08.2017;2017;08;09;Perjantai;27;9;36
93;11.08.2017;2017;08;10;Perjantai;25;12;37
93;11.08.2017;2017;08;11;Perjantai;14;10;24
93;11.08.2017;2017;08;12;Perjantai;22;14;36
93;11.08.2017;2017;08;13;Perjantai;21;28;49
93;11.08.2017;2017;08;14;Perjantai;29;27;56
93;11.08.2017;2017;08;15;Perjantai;42;44;86
93;11.08.2017;2017;08;16;Perjantai;35;29;64
93;11.08.2017;2017;08;17;Perjantai;21;20;41
93;11.08.2017;2017;08;18;Perjantai;21;18;39
93;11.08.2017;2017;08;19;Perjantai;12;15;27
93;11.08.2017;2017;08;20;Perjantai;10;19;29
93;11.08.2017;2017;08;21;Perjantai;13;10;23
93;11.08.2017;2017;08;22;Perjantai;7;7;14
93;11.08.2017;2017;08;23;Perjantai;4;6;10
93;12.08.2017;2017;08;00;Lauantai;2;7;9
93;12.08.2017;2017;08;01;Lauantai;3;1;4
93;12.08.2017;2017;08;02;Lauantai;1;1;2
93;12.08.2017;2017;08;03;Lauantai;0;4;4
93;12.08.2017;2017;08;04;Lauantai;0;0;0
93;12.08.2017;2017;08;05;Lauantai;1;0;1
93;12.08.2017;2017;08;06;Lauantai;4;0;4
93;12.08.2017;2017;08;07;Lauantai;3;3;6
93;12.08.2017;2017;08;08;Lauantai;5;6;11
93;12.08.2017;2017;08;09;Lauantai;12;10;22
93;12.08.2017;2017;08;10;Lauantai;19;20;39
93;12.08.2017;2017;08;11;Lauantai;18;24;42
93;12.08.2017;2017;08;12;Lauantai;33;19;52
93;12.08.2017;2017;08;13;Lauantai;16;31;47
93;12.08.2017;2017;08;14;Lauantai;21;29;50
93;12.08.2017;2017;08;15;Lauantai;31;32;63
93;12.08.2017;2017;08;16;Lauantai;22;14;36
93;12.08.2017;2017;08;17;Lauantai;28;29;57
93;12.08.2017;2017;08;18;Lauantai;23;26;49
93;12.08.2017;2017;08;19;Lauantai;4;5;9
93;12.08.2017;2017;08;20;Lauantai;5;18;23
93;12.08.2017;2017;08;21;Lauantai;4;9;13
93;12.08.2017;2017;08;22;Lauantai;3;14;17
93;12.08.2017;2017;08;23;Lauantai;5;10;15
93;13.08.2017;2017;08;00;Sunnuntai;0;3;3
93;13.08.2017;2017;08;01;Sunnuntai;0;1;1
93;13.08.2017;2017;08;02;Sunnuntai;1;2;3
93;13.08.2017;2017;08;03;Sunnuntai;1;0;1
93;13.08.2017;2017;08;04;Sunnuntai;0;0;0
93;13.08.2017;2017;08;05;Sunnuntai;1;0;1
93;13.08.2017;2017;08;06;Sunnuntai;0;0;0
93;13.08.2017;2017;08;07;Sunnuntai;5;0;5
93;13.08.2017;2017;08;08;Sunnuntai;1;5;6
93;13.08.2017;2017;08;09;Sunnuntai;0;1;1
93;13.08.2017;2017;08;10;Sunnuntai;8;5;13
93;13.08.2017;2017;08;11;Sunnuntai;4;0;4
93;13.08.2017;2017;08;12;Sunnuntai;4;5;9
93;13.08.2017;2017;08;13;Sunnuntai;9;7;16
93;13.08.2017;2017;08;14;Sunnuntai;6;7;13
93;13.08.2017;2017;08;15;Sunnuntai;4;6;10
93;13.08.2017;2017;08;16;Sunnuntai;7;11;18
93;13.08.2017;2017;08;17;Sunnuntai;7;6;13
93;13.08.2017;2017;08;18;Sunnuntai;8;9;17
93;13.08.2017;2017;08;19;Sunnuntai;11;13;24
93;13.08.2017;2017;08;20;Sunnuntai;9;10;19
93;13.08.2017;2017;08;21;Sunnuntai;0;5;5
93;13.08.2017;2017;08;22;Sunnuntai;2;1;3
93;13.08.2017;2017;08;23;Sunnuntai;0;1;1
93;14.08.2017;2017;08;00;Maanantai;0;0;0
93;14.08.2017;2017;08;01;Maanantai;2;0;2
93;14.08.2017;2017;08;02;Maanantai;0;0;0
93;14.08.2017;2017;08;03;Maanantai;0;0;0
93;14.08.2017;2017;08;04;Maanantai;1;0;1
93;14.08.2017;2017;08;05;Maanantai;3;6;9
93;14.08.2017;2017;08;06;Maanantai;26;14;40
93;14.08.2017;2017;08;07;Maanantai;37;55;92
93;14.08.2017;2017;08;08;Maanantai;24;24;48
93;14.08.2017;2017;08;09;Maanantai;10;12;22
93;14.08.2017;2017;08;10;Maanantai;11;13;24
93;14.08.2017;2017;08;11;Maanantai;9;5;14
93;14.08.2017;2017;08;12;Maanantai;12;10;22
93;14.08.2017;2017;08;13;Maanantai;11;12;23
93;14.08.2017;2017;08;14;Maanantai;15;14;29
93;14.08.2017;2017;08;15;Maanantai;33;39;72
93;14.08.2017;2017;08;16;Maanantai;59;29;88
93;14.08.2017;2017;08;17;Maanantai;17;27;44
93;14.08.2017;2017;08;18;Maanantai;16;27;43
93;14.08.2017;2017;08;19;Maanantai;19;21;40
93;14.08.2017;2017;08;20;Maanantai;9;11;20
93;14.08.2017;2017;08;21;Maanantai;6;11;17
93;14.08.2017;2017;08;22;Maanantai;2;5;7
93;14.08.2017;2017;08;23;Maanantai;0;3;3
93;15.08.2017;2017;08;00;Tiistai;0;4;4
93;15.08.2017;2017;08;01;Tiistai;1;0;1
93;15.08.2017;2017;08;02;Tiistai;0;0;0
93;15.08.2017;2017;08;03;Tiistai;0;0;0
93;15.08.2017;2017;08;04;Tiistai;0;0;0
93;15.08.2017;2017;08;05;Tiistai;4;3;7
93;15.08.2017;2017;08;06;Tiistai;25;19;44
93;15.08.2017;2017;08;07;Tiistai;36;61;97
93;15.08.2017;2017;08;08;Tiistai;20;36;56
93;15.08.2017;2017;08;09;Tiistai;16;14;30
93;15.08.2017;2017;08;10;Tiistai;12;7;19
93;15.08.2017;2017;08;11;Tiistai;14;15;29
93;15.08.2017;2017;08;12;Tiistai;16;15;31
93;15.08.2017;2017;08;13;Tiistai;20;19;39
93;15.08.2017;2017;08;14;Tiistai;17;5;22
93;15.08.2017;2017;08;15;Tiistai;52;49;101
93;15.08.2017;2017;08;16;Tiistai;54;40;94
93;15.08.2017;2017;08;17;Tiistai;29;32;61
93;15.08.2017;2017;08;18;Tiistai;24;39;63
93;15.08.2017;2017;08;19;Tiistai;27;26;53
93;15.08.2017;2017;08;20;Tiistai;21;22;43
93;15.08.2017;2017;08;21;Tiistai;12;13;25
93;15.08.2017;2017;08;22;Tiistai;0;4;4
93;15.08.2017;2017;08;23;Tiistai;0;2;2
93;16.08.2017;2017;08;00;Keskiviikko;0;0;0
93;16.08.2017;2017;08;01;Keskiviikko;0;0;0
93;16.08.2017;2017;08;02;Keskiviikko;0;0;0
93;16.08.2017;2017;08;03;Keskiviikko;0;0;0
93;16.08.2017;2017;08;04;Keskiviikko;1;1;2
93;16.08.2017;2017;08;05;Keskiviikko;4;4;8
93;16.08.2017;2017;08;06;Keskiviikko;23;17;40
93;16.08.2017;2017;08;07;Keskiviikko;35;54;89
93;16.08.2017;2017;08;08;Keskiviikko;21;32;53
93;16.08.2017;2017;08;09;Keskiviikko;10;14;24
93;16.08.2017;2017;08;10;Keskiviikko;16;14;30
93;16.08.2017;2017;08;11;Keskiviikko;10;15;25
93;16.08.2017;2017;08;12;Keskiviikko;25;18;43
93;16.08.2017;2017;08;13;Keskiviikko;6;12;18
93;16.08.2017;2017;08;14;Keskiviikko;27;23;50
93;16.08.2017;2017;08;15;Keskiviikko;33;42;75
93;16.08.2017;2017;08;16;Keskiviikko;67;48;115
93;16.08.2017;2017;08;17;Keskiviikko;32;27;59
93;16.08.2017;2017;08;18;Keskiviikko;34;30;64
93;16.08.2017;2017;08;19;Keskiviikko;30;35;65
93;16.08.2017;2017;08;20;Keskiviikko;17;31;48
93;16.08.2017;2017;08;21;Keskiviikko;8;11;19
93;16.08.2017;2017;08;22;Keskiviikko;1;8;9
93;16.08.2017;2017;08;23;Keskiviikko;2;1;3
93;17.08.2017;2017;08;00;Torstai;0;0;0
93;17.08.2017;2017;08;01;Torstai;0;0;0
93;17.08.2017;2017;08;02;Torstai;2;3;5
93;17.08.2017;2017;08;03;Torstai;0;0;0
93;17.08.2017;2017;08;04;Torstai;0;0;0
93;17.08.2017;2017;08;05;Torstai;4;4;8
93;17.08.2017;2017;08;06;Torstai;21;16;37
93;17.08.2017;2017;08;07;Torstai;35;53;88
93;17.08.2017;2017;08;08;Torstai;16;33;49
93;17.08.2017;2017;08;09;Torstai;11;9;20
93;17.08.2017;2017;08;10;Torstai;14;5;19
93;17.08.2017;2017;08;11;Torstai;8;9;17
93;17.08.2017;2017;08;12;Torstai;21;13;34
93;17.08.2017;2017;08;13;Torstai;13;18;31
93;17.08.2017;2017;08;14;Torstai;25;26;51
93;17.08.2017;2017;08;15;Torstai;39;28;67
93;17.08.2017;2017;08;16;Torstai;58;52;110
93;17.08.2017;2017;08;17;Torstai;42;25;67
93;17.08.2017;2017;08;18;Torstai;25;39;64
93;17.08.2017;2017;08;19;Torstai;25;30;55
93;17.08.2017;2017;08;20;Torstai;18;22;40
93;17.08.2017;2017;08;21;Torstai;10;13;23
93;17.08.2017;2017;08;22;Torstai;1;6;7
93;17.08.2017;2017;08;23;Torstai;1;4;5
93;18.08.2017;2017;08;00;Perjantai;0;6;6
93;18.08.2017;2017;08;01;Perjantai;0;0;0
93;18.08.2017;2017;08;02;Perjantai;0;1;1
93;18.08.2017;2017;08;03;Perjantai;0;0;0
93;18.08.2017;2017;08;04;Perjantai;0;0;0
93;18.08.2017;2017;08;05;Perjantai;5;3;8
93;18.08.2017;2017;08;06;Perjantai;23;10;33
93;18.08.2017;2017;08;07;Perjantai;29;34;63
93;18.08.2017;2017;08;08;Perjantai;8;28;36
93;18.08.2017;2017;08;09;Perjantai;21;9;30
93;18.08.2017;2017;08;10;Perjantai;17;23;40
93;18.08.2017;2017;08;11;Perjantai;15;21;36
93;18.08.2017;2017;08;12;Perjantai;6;18;24
93;18.08.2017;2017;08;13;Perjantai;29;16;45
93;18.08.2017;2017;08;14;Perjantai;17;24;41
93;18.08.2017;2017;08;15;Perjantai;22;32;54
93;18.08.2017;2017;08;16;Perjantai;23;26;49
93;18.08.2017;2017;08;17;Perjantai;20;13;33
93;18.08.2017;2017;08;18;Perjantai;15;12;27
93;18.08.2017;2017;08;19;Perjantai;11;16;27
93;18.08.2017;2017;08;20;Perjantai;10;13;23
93;18.08.2017;2017;08;21;Perjantai;1;10;11
93;18.08.2017;2017;08;22;Perjantai;1;1;2
93;18.08.2017;2017;08;23;Perjantai;3;1;4
93;19.08.2017;2017;08;00;Lauantai;0;2;2
93;19.08.2017;2017;08;01;Lauantai;1;3;4
93;19.08.2017;2017;08;02;Lauantai;0;2;2
93;19.08.2017;2017;08;03;Lauantai;0;0;0
93;19.08.2017;2017;08;04;Lauantai;0;0;0
93;19.08.2017;2017;08;05;Lauantai;2;1;3
93;19.08.2017;2017;08;06;Lauantai;1;0;1
93;19.08.2017;2017;08;07;Lauantai;1;4;5
93;19.08.2017;2017;08;08;Lauantai;5;4;9
93;19.08.2017;2017;08;09;Lauantai;9;12;21
93;19.08.2017;2017;08;10;Lauantai;15;18;33
93;19.08.2017;2017;08;11;Lauantai;13;10;23
93;19.08.2017;2017;08;12;Lauantai;25;23;48
93;19.08.2017;2017;08;13;Lauantai;19;34;53
93;19.08.2017;2017;08;14;Lauantai;17;15;32
93;19.08.2017;2017;08;15;Lauantai;17;17;34
93;19.08.2017;2017;08;16;Lauantai;17;14;31
93;19.08.2017;2017;08;17;Lauantai;14;31;45
93;19.08.2017;2017;08;18;Lauantai;20;9;29
93;19.08.2017;2017;08;19;Lauantai;8;9;17
93;19.08.2017;2017;08;20;Lauantai;5;4;9
93;19.08.2017;2017;08;21;Lauantai;4;2;6
93;19.08.2017;2017;08;22;Lauantai;1;2;3
93;19.08.2017;2017;08;23;Lauantai;2;0;2
93;20.08.2017;2017;08;00;Sunnuntai;2;0;2
93;20.08.2017;2017;08;01;Sunnuntai;0;1;1
93;20.08.2017;2017;08;02;Sunnuntai;1;0;1
93;20.08.2017;2017;08;03;Sunnuntai;2;2;4
93;20.08.2017;2017;08;04;Sunnuntai;0;1;1
93;20.08.2017;2017;08;05;Sunnuntai;2;0;2
93;20.08.2017;2017;08;06;Sunnuntai;2;0;2
93;20.08.2017;2017;08;07;Sunnuntai;7;1;8
93;20.08.2017;2017;08;08;Sunnuntai;3;3;6
93;20.08.2017;2017;08;09;Sunnuntai;7;8;15
93;20.08.2017;2017;08;10;Sunnuntai;11;8;19
93;20.08.2017;2017;08;11;Sunnuntai;14;18;32
93;20.08.2017;2017;08;12;Sunnuntai;19;19;38
93;20.08.2017;2017;08;13;Sunnuntai;17;10;27
93;20.08.2017;2017;08;14;Sunnuntai;17;14;31
93;20.08.2017;2017;08;15;Sunnuntai;14;17;31
93;20.08.2017;2017;08;16;Sunnuntai;14;6;20
93;20.08.2017;2017;08;17;Sunnuntai;17;12;29
93;20.08.2017;2017;08;18;Sunnuntai;8;13;21
93;20.08.2017;2017;08;19;Sunnuntai;7;19;26
93;20.08.2017;2017;08;20;Sunnuntai;10;8;18
93;20.08.2017;2017;08;21;Sunnuntai;9;5;14
93;20.08.2017;2017;08;22;Sunnuntai;2;2;4
93;20.08.2017;2017;08;23;Sunnuntai;0;0;0
93;21.08.2017;2017;08;00;Maanantai;0;1;1
93;21.08.2017;2017;08;01;Maanantai;0;0;0
93;21.08.2017;2017;08;02;Maanantai;0;0;0
93;21.08.2017;2017;08;03;Maanantai;0;1;1
93;21.08.2017;2017;08;04;Maanantai;1;0;1
93;21.08.2017;2017;08;05;Maanantai;7;4;11
93;21.08.2017;2017;08;06;Maanantai;17;17;34
93;21.08.2017;2017;08;07;Maanantai;33;42;75
93;21.08.2017;2017;08;08;Maanantai;19;20;39
93;21.08.2017;2017;08;09;Maanantai;13;10;23
93;21.08.2017;2017;08;10;Maanantai;5;7;12
93;21.08.2017;2017;08;11;Maanantai;8;12;20
93;21.08.2017;2017;08;12;Maanantai;9;8;17
93;21.08.2017;2017;08;13;Maanantai;13;7;20
93;21.08.2017;2017;08;14;Maanantai;13;11;24
93;21.08.2017;2017;08;15;Maanantai;34;47;81
93;21.08.2017;2017;08;16;Maanantai;43;31;74
93;21.08.2017;2017;08;17;Maanantai;29;29;58
93;21.08.2017;2017;08;18;Maanantai;14;22;36
93;21.08.2017;2017;08;19;Maanantai;12;10;22
93;21.08.2017;2017;08;20;Maanantai;8;11;19
93;21.08.2017;2017;08;21;Maanantai;2;5;7
93;21.08.2017;2017;08;22;Maanantai;0;3;3
93;21.08.2017;2017;08;23;Maanantai;0;1;1
93;22.08.2017;2017;08;00;Tiistai;1;0;1
93;22.08.2017;2017;08;01;Tiistai;0;0;0
93;22.08.2017;2017;08;02;Tiistai;0;0;0
93;22.08.2017;2017;08;03;Tiistai;0;0;0
93;22.08.2017;2017;08;04;Tiistai;0;1;1
93;22.08.2017;2017;08;05;Tiistai;4;3;7
93;22.08.2017;2017;08;06;Tiistai;18;9;27
93;22.08.2017;2017;08;07;Tiistai;30;42;72
93;22.08.2017;2017;08;08;Tiistai;22;24;46
93;22.08.2017;2017;08;09;Tiistai;17;11;28
93;22.08.2017;2017;08;10;Tiistai;10;10;20
93;22.08.2017;2017;08;11;Tiistai;9;14;23
93;22.08.2017;2017;08;12;Tiistai;12;6;18
93;22.08.2017;2017;08;13;Tiistai;10;7;17
93;22.08.2017;2017;08;14;Tiistai;12;15;27
93;22.08.2017;2017;08;15;Tiistai;23;25;48
93;22.08.2017;2017;08;16;Tiistai;39;38;77
93;22.08.2017;2017;08;17;Tiistai;16;25;41
93;22.08.2017;2017;08;18;Tiistai;16;26;42
93;22.08.2017;2017;08;19;Tiistai;19;12;31
93;22.08.2017;2017;08;20;Tiistai;10;12;22
93;22.08.2017;2017;08;21;Tiistai;2;2;4
93;22.08.2017;2017;08;22;Tiistai;5;2;7
93;22.08.2017;2017;08;23;Tiistai;0;1;1
93;23.08.2017;2017;08;00;Keskiviikko;0;0;0
93;23.08.2017;2017;08;01;Keskiviikko;1;0;1
93;23.08.2017;2017;08;02;Keskiviikko;0;0;0
93;23.08.2017;2017;08;03;Keskiviikko;0;0;0
93;23.08.2017;2017;08;04;Keskiviikko;1;0;1
93;23.08.2017;2017;08;05;Keskiviikko;5;3;8
93;23.08.2017;2017;08;06;Keskiviikko;23;16;39
93;23.08.2017;2017;08;07;Keskiviikko;28;34;62
93;23.08.2017;2017;08;08;Keskiviikko;21;23;44
93;23.08.2017;2017;08;09;Keskiviikko;9;9;18
93;23.08.2017;2017;08;10;Keskiviikko;9;6;15
93;23.08.2017;2017;08;11;Keskiviikko;11;11;22
93;23.08.2017;2017;08;12;Keskiviikko;12;8;20
93;23.08.2017;2017;08;13;Keskiviikko;10;12;22
93;23.08.2017;2017;08;14;Keskiviikko;20;19;39
93;23.08.2017;2017;08;15;Keskiviikko;25;25;50
93;23.08.2017;2017;08;16;Keskiviikko;39;47;86
93;23.08.2017;2017;08;17;Keskiviikko;23;18;41
93;23.08.2017;2017;08;18;Keskiviikko;17;18;35
93;23.08.2017;2017;08;19;Keskiviikko;11;16;27
93;23.08.2017;2017;08;20;Keskiviikko;6;10;16
93;23.08.2017;2017;08;21;Keskiviikko;5;4;9
93;23.08.2017;2017;08;22;Keskiviikko;0;7;7
93;23.08.2017;2017;08;23;Keskiviikko;0;2;2
93;24.08.2017;2017;08;00;Torstai;0;0;0
93;24.08.2017;2017;08;01;Torstai;0;0;0
93;24.08.2017;2017;08;02;Torstai;0;0;0
93;24.08.2017;2017;08;03;Torstai;0;1;1
93;24.08.2017;2017;08;04;Torstai;0;0;0
93;24.08.2017;2017;08;05;Torstai;5;5;10
93;24.08.2017;2017;08;06;Torstai;17;17;34
93;24.08.2017;2017;08;07;Torstai;31;39;70
93;24.08.2017;2017;08;08;Torstai;16;25;41
93;24.08.2017;2017;08;09;Torstai;11;14;25
93;24.08.2017;2017;08;10;Torstai;7;9;16
93;24.08.2017;2017;08;11;Torstai;9;9;18
93;24.08.2017;2017;08;12;Torstai;14;8;22
93;24.08.2017;2017;08;13;Torstai;13;18;31
93;24.08.2017;2017;08;14;Torstai;14;18;32
93;24.08.2017;2017;08;15;Torstai;32;29;61
93;24.08.2017;2017;08;16;Torstai;48;40;88
93;24.08.2017;2017;08;17;Torstai;15;25;40
93;24.08.2017;2017;08;18;Torstai;18;17;35
93;24.08.2017;2017;08;19;Torstai;23;19;42
93;24.08.2017;2017;08;20;Torstai;17;12;29
93;24.08.2017;2017;08;21;Torstai;1;12;13
93;24.08.2017;2017;08;22;Torstai;2;2;4
93;24.08.2017;2017;08;23;Torstai;0;1;1
93;25.08.2017;2017;08;00;Perjantai;0;0;0
93;25.08.2017;2017;08;01;Perjantai;0;2;2
93;25.08.2017;2017;08;02;Perjantai;2;0;2
93;25.08.2017;2017;08;03;Perjantai;0;0;0
93;25.08.2017;2017;08;04;Perjantai;0;2;2
93;25.08.2017;2017;08;05;Perjantai;4;3;7
93;25.08.2017;2017;08;06;Perjantai;15;10;25
93;25.08.2017;2017;08;07;Perjantai;12;27;39
93;25.08.2017;2017;08;08;Perjantai;4;15;19
93;25.08.2017;2017;08;09;Perjantai;10;5;15
93;25.08.2017;2017;08;10;Perjantai;3;4;7
93;25.08.2017;2017;08;11;Perjantai;4;7;11
93;25.08.2017;2017;08;12;Perjantai;5;3;8
93;25.08.2017;2017;08;13;Perjantai;5;5;10
93;25.08.2017;2017;08;14;Perjantai;4;16;20
93;25.08.2017;2017;08;15;Perjantai;16;18;34
93;25.08.2017;2017;08;16;Perjantai;23;12;35
93;25.08.2017;2017;08;17;Perjantai;5;2;7
93;25.08.2017;2017;08;18;Perjantai;10;6;16
93;25.08.2017;2017;08;19;Perjantai;2;5;7
93;25.08.2017;2017;08;20;Perjantai;2;4;6
93;25.08.2017;2017;08;21;Perjantai;1;5;6
93;25.08.2017;2017;08;22;Perjantai;1;2;3
93;25.08.2017;2017;08;23;Perjantai;1;1;2
93;26.08.2017;2017;08;00;Lauantai;2;2;4
93;26.08.2017;2017;08;01;Lauantai;2;0;2
93;26.08.2017;2017;08;02;Lauantai;0;0;0
93;26.08.2017;2017;08;03;Lauantai;0;0;0
93;26.08.2017;2017;08;04;Lauantai;0;0;0
93;26.08.2017;2017;08;05;Lauantai;0;1;1
93;26.08.2017;2017;08;06;Lauantai;2;1;3
93;26.08.2017;2017;08;07;Lauantai;2;1;3
93;26.08.2017;2017;08;08;Lauantai;3;2;5
93;26.08.2017;2017;08;09;Lauantai;0;0;0
93;26.08.2017;2017;08;10;Lauantai;1;2;3
93;26.08.2017;2017;08;11;Lauantai;3;2;5
93;26.08.2017;2017;08;12;Lauantai;10;2;12
93;26.08.2017;2017;08;13;Lauantai;8;7;15
93;26.08.2017;2017;08;14;Lauantai;6;9;15
93;26.08.2017;2017;08;15;Lauantai;10;12;22
93;26.08.2017;2017;08;16;Lauantai;7;16;23
93;26.08.2017;2017;08;17;Lauantai;13;14;27
93;26.08.2017;2017;08;18;Lauantai;7;11;18
93;26.08.2017;2017;08;19;Lauantai;12;7;19
93;26.08.2017;2017;08;20;Lauantai;3;13;16
93;26.08.2017;2017;08;21;Lauantai;4;5;9
93;26.08.2017;2017;08;22;Lauantai;4;5;9
93;26.08.2017;2017;08;23;Lauantai;2;2;4
93;27.08.2017;2017;08;00;Sunnuntai;4;1;5
93;27.08.2017;2017;08;01;Sunnuntai;2;2;4
93;27.08.2017;2017;08;02;Sunnuntai;0;0;0
93;27.08.2017;2017;08;03;Sunnuntai;0;2;2
93;27.08.2017;2017;08;04;Sunnuntai;0;1;1
93;27.08.2017;2017;08;05;Sunnuntai;1;0;1
93;27.08.2017;2017;08;06;Sunnuntai;0;0;0
93;27.08.2017;2017;08;07;Sunnuntai;3;0;3
93;27.08.2017;2017;08;08;Sunnuntai;2;2;4
93;27.08.2017;2017;08;09;Sunnuntai;5;6;11
93;27.08.2017;2017;08;10;Sunnuntai;8;11;19
93;27.08.2017;2017;08;11;Sunnuntai;17;5;22
93;27.08.2017;2017;08;12;Sunnuntai;7;8;15
93;27.08.2017;2017;08;13;Sunnuntai;10;18;28
93;27.08.2017;2017;08;14;Sunnuntai;15;10;25
93;27.08.2017;2017;08;15;Sunnuntai;10;19;29
93;27.08.2017;2017;08;16;Sunnuntai;17;10;27
93;27.08.2017;2017;08;17;Sunnuntai;15;13;28
93;27.08.2017;2017;08;18;Sunnuntai;8;16;24
93;27.08.2017;2017;08;19;Sunnuntai;13;11;24
93;27.08.2017;2017;08;20;Sunnuntai;12;2;14
93;27.08.2017;2017;08;21;Sunnuntai;4;5;9
93;27.08.2017;2017;08;22;Sunnuntai;1;1;2
93;27.08.2017;2017;08;23;Sunnuntai;0;0;0
93;28.08.2017;2017;08;00;Maanantai;0;0;0
93;28.08.2017;2017;08;01;Maanantai;0;0;0
93;28.08.2017;2017;08;02;Maanantai;0;0;0
93;28.08.2017;2017;08;03;Maanantai;0;0;0
93;28.08.2017;2017;08;04;Maanantai;0;1;1
93;28.08.2017;2017;08;05;Maanantai;5;5;10
93;28.08.2017;2017;08;06;Maanantai;22;10;32
93;28.08.2017;2017;08;07;Maanantai;28;45;73
93;28.08.2017;2017;08;08;Maanantai;20;23;43
93;28.08.2017;2017;08;09;Maanantai;13;10;23
93;28.08.2017;2017;08;10;Maanantai;12;11;23
93;28.08.2017;2017;08;11;Maanantai;9;8;17
93;28.08.2017;2017;08;12;Maanantai;7;10;17
93;28.08.2017;2017;08;13;Maanantai;10;14;24
93;28.08.2017;2017;08;14;Maanantai;31;20;51
93;28.08.2017;2017;08;15;Maanantai;34;36;70
93;28.08.2017;2017;08;16;Maanantai;52;47;99
93;28.08.2017;2017;08;17;Maanantai;29;29;58
93;28.08.2017;2017;08;18;Maanantai;21;23;44
93;28.08.2017;2017;08;19;Maanantai;20;27;47
93;28.08.2017;2017;08;20;Maanantai;15;9;24
93;28.08.2017;2017;08;21;Maanantai;7;7;14
93;28.08.2017;2017;08;22;Maanantai;3;2;5
93;28.08.2017;2017;08;23;Maanantai;0;0;0
93;29.08.2017;2017;08;00;Tiistai;0;0;0
93;29.08.2017;2017;08;01;Tiistai;0;0;0
93;29.08.2017;2017;08;02;Tiistai;0;0;0
93;29.08.2017;2017;08;03;Tiistai;0;0;0
93;29.08.2017;2017;08;04;Tiistai;0;1;1
93;29.08.2017;2017;08;05;Tiistai;2;4;6
93;29.08.2017;2017;08;06;Tiistai;15;8;23
93;29.08.2017;2017;08;07;Tiistai;22;45;67
93;29.08.2017;2017;08;08;Tiistai;15;27;42
93;29.08.2017;2017;08;09;Tiistai;21;4;25
93;29.08.2017;2017;08;10;Tiistai;10;8;18
93;29.08.2017;2017;08;11;Tiistai;13;10;23
93;29.08.2017;2017;08;12;Tiistai;12;5;17
93;29.08.2017;2017;08;13;Tiistai;12;14;26
93;29.08.2017;2017;08;14;Tiistai;9;5;14
93;29.08.2017;2017;08;15;Tiistai;16;14;30
93;29.08.2017;2017;08;16;Tiistai;34;15;49
93;29.08.2017;2017;08;17;Tiistai;8;9;17
93;29.08.2017;2017;08;18;Tiistai;8;9;17
93;29.08.2017;2017;08;19;Tiistai;3;4;7
93;29.08.2017;2017;08;20;Tiistai;5;7;12
93;29.08.2017;2017;08;21;Tiistai;4;5;9
93;29.08.2017;2017;08;22;Tiistai;0;2;2
93;29.08.2017;2017;08;23;Tiistai;0;2;2
93;30.08.2017;2017;08;00;Keskiviikko;0;0;0
93;30.08.2017;2017;08;01;Keskiviikko;0;0;0
93;30.08.2017;2017;08;02;Keskiviikko;0;0;0
93;30.08.2017;2017;08;03;Keskiviikko;0;0;0
93;30.08.2017;2017;08;04;Keskiviikko;0;0;0
93;30.08.2017;2017;08;05;Keskiviikko;1;2;3
93;30.08.2017;2017;08;06;Keskiviikko;6;5;11
93;30.08.2017;2017;08;07;Keskiviikko;9;14;23
93;30.08.2017;2017;08;08;Keskiviikko;11;15;26
93;30.08.2017;2017;08;09;Keskiviikko;7;3;10
93;30.08.2017;2017;08;10;Keskiviikko;1;1;2
93;30.08.2017;2017;08;11;Keskiviikko;1;2;3
93;30.08.2017;2017;08;12;Keskiviikko;2;1;3
93;30.08.2017;2017;08;13;Keskiviikko;7;5;12
93;30.08.2017;2017;08;14;Keskiviikko;9;8;17
93;30.08.2017;2017;08;15;Keskiviikko;15;16;31
93;30.08.2017;2017;08;16;Keskiviikko;25;19;44
93;30.08.2017;2017;08;17;Keskiviikko;22;16;38
93;30.08.2017;2017;08;18;Keskiviikko;12;27;39
93;30.08.2017;2017;08;19;Keskiviikko;20;15;35
93;30.08.2017;2017;08;20;Keskiviikko;16;16;32
93;30.08.2017;2017;08;21;Keskiviikko;4;7;11
93;30.08.2017;2017;08;22;Keskiviikko;2;1;3
93;30.08.2017;2017;08;23;Keskiviikko;1;1;2
93;31.08.2017;2017;08;00;Torstai;0;0;0
93;31.08.2017;2017;08;01;Torstai;0;0;0
93;31.08.2017;2017;08;02;Torstai;0;0;0
93;31.08.2017;2017;08;03;Torstai;0;0;0
93;31.08.2017;2017;08;04;Torstai;1;0;1
93;31.08.2017;2017;08;05;Torstai;3;2;5
93;31.08.2017;2017;08;06;Torstai;15;13;28
93;31.08.2017;2017;08;07;Torstai;34;38;72
93;31.08.2017;2017;08;08;Torstai;16;22;38
93;31.08.2017;2017;08;09;Torstai;17;6;23
93;31.08.2017;2017;08;10;Torstai;11;8;19
93;31.08.2017;2017;08;11;Torstai;9;15;24
93;31.08.2017;2017;08;12;Torstai;9;5;14
93;31.08.2017;2017;08;13;Torstai;5;11;16
93;31.08.2017;2017;08;14;Torstai;14;11;25
93;31.08.2017;2017;08;15;Torstai;22;28;50
93;31.08.2017;2017;08;16;Torstai;48;40;88
93;31.08.2017;2017;08;17;Torstai;23;23;46
93;31.08.2017;2017;08;18;Torstai;12;29;41
93;31.08.2017;2017;08;19;Torstai;12;15;27
93;31.08.2017;2017;08;20;Torstai;15;14;29
93;31.08.2017;2017;08;21;Torstai;5;9;14
93;31.08.2017;2017;08;22;Torstai;5;1;6
93;31.08.2017;2017;08;23;Torstai;1;1;2
93;01.09.2017;2017;09;00;Perjantai;0;0;0
93;01.09.2017;2017;09;01;Perjantai;0;0;0
93;01.09.2017;2017;09;02;Perjantai;0;0;0
93;01.09.2017;2017;09;03;Perjantai;0;0;0
93;01.09.2017;2017;09;04;Perjantai;0;1;1
93;01.09.2017;2017;09;05;Perjantai;0;3;3
93;01.09.2017;2017;09;06;Perjantai;6;2;8
93;01.09.2017;2017;09;07;Perjantai;6;13;19
93;01.09.2017;2017;09;08;Perjantai;4;7;11
93;01.09.2017;2017;09;09;Perjantai;2;2;4
93;01.09.2017;2017;09;10;Perjantai;4;2;6
93;01.09.2017;2017;09;11;Perjantai;3;3;6
93;01.09.2017;2017;09;12;Perjantai;5;2;7
93;01.09.2017;2017;09;13;Perjantai;3;0;3
93;01.09.2017;2017;09;14;Perjantai;5;5;10
93;01.09.2017;2017;09;15;Perjantai;6;7;13
93;01.09.2017;2017;09;16;Perjantai;16;4;20
93;01.09.2017;2017;09;17;Perjantai;5;5;10
93;01.09.2017;2017;09;18;Perjantai;3;6;9
93;01.09.2017;2017;09;19;Perjantai;8;4;12
93;01.09.2017;2017;09;20;Perjantai;10;10;20
93;01.09.2017;2017;09;21;Perjantai;2;6;8
93;01.09.2017;2017;09;22;Perjantai;2;3;5
93;01.09.2017;2017;09;23;Perjantai;1;2;3
93;02.09.2017;2017;09;00;Lauantai;0;1;1
93;02.09.2017;2017;09;01;Lauantai;0;4;4
93;02.09.2017;2017;09;02;Lauantai;0;0;0
93;02.09.2017;2017;09;03;Lauantai;0;0;0
93;02.09.2017;2017;09;04;Lauantai;0;0;0
93;02.09.2017;2017;09;05;Lauantai;1;0;1
93;02.09.2017;2017;09;06;Lauantai;0;0;0
93;02.09.2017;2017;09;07;Lauantai;1;1;2
93;02.09.2017;2017;09;08;Lauantai;2;5;7
93;02.09.2017;2017;09;09;Lauantai;3;9;12
93;02.09.2017;2017;09;10;Lauantai;8;7;15
93;02.09.2017;2017;09;11;Lauantai;16;11;27
93;02.09.2017;2017;09;12;Lauantai;18;25;43
93;02.09.2017;2017;09;13;Lauantai;16;16;32
93;02.09.2017;2017;09;14;Lauantai;14;20;34
93;02.09.2017;2017;09;15;Lauantai;18;20;38
93;02.09.2017;2017;09;16;Lauantai;20;18;38
93;02.09.2017;2017;09;17;Lauantai;26;20;46
93;02.09.2017;2017;09;18;Lauantai;15;12;27
93;02.09.2017;2017;09;19;Lauantai;14;26;40
93;02.09.2017;2017;09;20;Lauantai;4;11;15
93;02.09.2017;2017;09;21;Lauantai;0;8;8
93;02.09.2017;2017;09;22;Lauantai;1;7;8
93;02.09.2017;2017;09;23;Lauantai;1;6;7
93;03.09.2017;2017;09;00;Sunnuntai;2;3;5
93;03.09.2017;2017;09;01;Sunnuntai;0;0;0
93;03.09.2017;2017;09;02;Sunnuntai;0;2;2
93;03.09.2017;2017;09;03;Sunnuntai;0;1;1
93;03.09.2017;2017;09;04;Sunnuntai;0;0;0
93;03.09.2017;2017;09;05;Sunnuntai;3;0;3
93;03.09.2017;2017;09;06;Sunnuntai;5;0;5
93;03.09.2017;2017;09;07;Sunnuntai;2;2;4
93;03.09.2017;2017;09;08;Sunnuntai;6;3;9
93;03.09.2017;2017;09;09;Sunnuntai;3;6;9
93;03.09.2017;2017;09;10;Sunnuntai;8;7;15
93;03.09.2017;2017;09;11;Sunnuntai;12;8;20
93;03.09.2017;2017;09;12;Sunnuntai;17;20;37
93;03.09.2017;2017;09;13;Sunnuntai;21;29;50
93;03.09.2017;2017;09;14;Sunnuntai;10;23;33
93;03.09.2017;2017;09;15;Sunnuntai;26;24;50
93;03.09.2017;2017;09;16;Sunnuntai;21;21;42
93;03.09.2017;2017;09;17;Sunnuntai;23;22;45
93;03.09.2017;2017;09;18;Sunnuntai;22;25;47
93;03.09.2017;2017;09;19;Sunnuntai;12;13;25
93;03.09.2017;2017;09;20;Sunnuntai;6;3;9
93;03.09.2017;2017;09;21;Sunnuntai;2;6;8
93;03.09.2017;2017;09;22;Sunnuntai;2;1;3
93;03.09.2017;2017;09;23;Sunnuntai;1;0;1
93;04.09.2017;2017;09;00;Maanantai;0;0;0
93;04.09.2017;2017;09;01;Maanantai;0;0;0
93;04.09.2017;2017;09;02;Maanantai;0;0;0
93;04.09.2017;2017;09;03;Maanantai;0;0;0
93;04.09.2017;2017;09;04;Maanantai;0;1;1
93;04.09.2017;2017;09;05;Maanantai;5;3;8
93;04.09.2017;2017;09;06;Maanantai;28;9;37
93;04.09.2017;2017;09;07;Maanantai;30;35;65
93;04.09.2017;2017;09;08;Maanantai;17;27;44
93;04.09.2017;2017;09;09;Maanantai;15;7;22
93;04.09.2017;2017;09;10;Maanantai;11;6;17
93;04.09.2017;2017;09;11;Maanantai;4;17;21
93;04.09.2017;2017;09;12;Maanantai;11;19;30
93;04.09.2017;2017;09;13;Maanantai;20;10;30
93;04.09.2017;2017;09;14;Maanantai;18;24;42
93;04.09.2017;2017;09;15;Maanantai;22;43;65
93;04.09.2017;2017;09;16;Maanantai;49;36;85
93;04.09.2017;2017;09;17;Maanantai;22;20;42
93;04.09.2017;2017;09;18;Maanantai;19;35;54
93;04.09.2017;2017;09;19;Maanantai;13;20;33
93;04.09.2017;2017;09;20;Maanantai;8;22;30
93;04.09.2017;2017;09;21;Maanantai;6;5;11
93;04.09.2017;2017;09;22;Maanantai;1;2;3
93;04.09.2017;2017;09;23;Maanantai;0;2;2
93;05.09.2017;2017;09;00;Tiistai;1;0;1
93;05.09.2017;2017;09;01;Tiistai;0;0;0
93;05.09.2017;2017;09;02;Tiistai;0;0;0
93;05.09.2017;2017;09;03;Tiistai;0;0;0
93;05.09.2017;2017;09;04;Tiistai;0;0;0
93;05.09.2017;2017;09;05;Tiistai;8;5;13
93;05.09.2017;2017;09;06;Tiistai;22;6;28
93;05.09.2017;2017;09;07;Tiistai;30;42;72
93;05.09.2017;2017;09;08;Tiistai;13;28;41
93;05.09.2017;2017;09;09;Tiistai;19;7;26
93;05.09.2017;2017;09;10;Tiistai;15;9;24
93;05.09.2017;2017;09;11;Tiistai;9;10;19
93;05.09.2017;2017;09;12;Tiistai;17;18;35
93;05.09.2017;2017;09;13;Tiistai;11;16;27
93;05.09.2017;2017;09;14;Tiistai;21;29;50
93;05.09.2017;2017;09;15;Tiistai;26;35;61
93;05.09.2017;2017;09;16;Tiistai;50;35;85
93;05.09.2017;2017;09;17;Tiistai;34;34;68
93;05.09.2017;2017;09;18;Tiistai;32;27;59
93;05.09.2017;2017;09;19;Tiistai;13;13;26
93;05.09.2017;2017;09;20;Tiistai;11;28;39
93;05.09.2017;2017;09;21;Tiistai;3;4;7
93;05.09.2017;2017;09;22;Tiistai;0;5;5
93;05.09.2017;2017;09;23;Tiistai;1;0;1
93;06.09.2017;2017;09;00;Keskiviikko;1;0;1
93;06.09.2017;2017;09;01;Keskiviikko;0;1;1
93;06.09.2017;2017;09;02;Keskiviikko;0;0;0
93;06.09.2017;2017;09;03;Keskiviikko;0;0;0
93;06.09.2017;2017;09;04;Keskiviikko;0;0;0
93;06.09.2017;2017;09;05;Keskiviikko;5;5;10
93;06.09.2017;2017;09;06;Keskiviikko;23;13;36
93;06.09.2017;2017;09;07;Keskiviikko;30;42;72
93;06.09.2017;2017;09;08;Keskiviikko;19;23;42
93;06.09.2017;2017;09;09;Keskiviikko;11;7;18
93;06.09.2017;2017;09;10;Keskiviikko;14;5;19
93;06.09.2017;2017;09;11;Keskiviikko;10;13;23
93;06.09.2017;2017;09;12;Keskiviikko;12;12;24
93;06.09.2017;2017;09;13;Keskiviikko;23;15;38
93;06.09.2017;2017;09;14;Keskiviikko;19;21;40
93;06.09.2017;2017;09;15;Keskiviikko;40;41;81
93;06.09.2017;2017;09;16;Keskiviikko;53;40;93
93;06.09.2017;2017;09;17;Keskiviikko;25;29;54
93;06.09.2017;2017;09;18;Keskiviikko;22;22;44
93;06.09.2017;2017;09;19;Keskiviikko;12;18;30
93;06.09.2017;2017;09;20;Keskiviikko;6;13;19
93;06.09.2017;2017;09;21;Keskiviikko;2;10;12
93;06.09.2017;2017;09;22;Keskiviikko;1;2;3
93;06.09.2017;2017;09;23;Keskiviikko;0;1;1
93;07.09.2017;2017;09;00;Torstai;1;0;1
93;07.09.2017;2017;09;01;Torstai;0;0;0
93;07.09.2017;2017;09;02;Torstai;0;0;0
93;07.09.2017;2017;09;03;Torstai;0;0;0
93;07.09.2017;2017;09;04;Torstai;0;0;0
93;07.09.2017;2017;09;05;Torstai;4;4;8
93;07.09.2017;2017;09;06;Torstai;15;10;25
93;07.09.2017;2017;09;07;Torstai;28;35;63
93;07.09.2017;2017;09;08;Torstai;18;23;41
93;07.09.2017;2017;09;09;Torstai;9;6;15
93;07.09.2017;2017;09;10;Torstai;4;6;10
93;07.09.2017;2017;09;11;Torstai;8;7;15
93;07.09.2017;2017;09;12;Torstai;14;8;22
93;07.09.2017;2017;09;13;Torstai;13;11;24
93;07.09.2017;2017;09;14;Torstai;12;15;27
93;07.09.2017;2017;09;15;Torstai;19;27;46
93;07.09.2017;2017;09;16;Torstai;40;25;65
93;07.09.2017;2017;09;17;Torstai;17;12;29
93;07.09.2017;2017;09;18;Torstai;12;21;33
93;07.09.2017;2017;09;19;Torstai;3;12;15
93;07.09.2017;2017;09;20;Torstai;5;7;12
93;07.09.2017;2017;09;21;Torstai;2;5;7
93;07.09.2017;2017;09;22;Torstai;2;1;3
93;07.09.2017;2017;09;23;Torstai;0;1;1
93;08.09.2017;2017;09;00;Perjantai;1;0;1
93;08.09.2017;2017;09;01;Perjantai;0;0;0
93;08.09.2017;2017;09;02;Perjantai;0;1;1
93;08.09.2017;2017;09;03;Perjantai;0;0;0
93;08.09.2017;2017;09;04;Perjantai;0;0;0
93;08.09.2017;2017;09;05;Perjantai;4;3;7
93;08.09.2017;2017;09;06;Perjantai;4;5;9
93;08.09.2017;2017;09;07;Perjantai;13;10;23
93;08.09.2017;2017;09;08;Perjantai;4;16;20
93;08.09.2017;2017;09;09;Perjantai;6;5;11
93;08.09.2017;2017;09;10;Perjantai;9;3;12
93;08.09.2017;2017;09;11;Perjantai;9;2;11
93;08.09.2017;2017;09;12;Perjantai;3;3;6
93;08.09.2017;2017;09;13;Perjantai;6;10;16
93;08.09.2017;2017;09;14;Perjantai;9;9;18
93;08.09.2017;2017;09;15;Perjantai;14;14;28
93;08.09.2017;2017;09;16;Perjantai;17;14;31
93;08.09.2017;2017;09;17;Perjantai;9;5;14
93;08.09.2017;2017;09;18;Perjantai;2;12;14
93;08.09.2017;2017;09;19;Perjantai;4;9;13
93;08.09.2017;2017;09;20;Perjantai;7;5;12
93;08.09.2017;2017;09;21;Perjantai;1;6;7
93;08.09.2017;2017;09;22;Perjantai;1;2;3
93;08.09.2017;2017;09;23;Perjantai;2;1;3
93;09.09.2017;2017;09;00;Lauantai;2;1;3
93;09.09.2017;2017;09;01;Lauantai;0;0;0
93;09.09.2017;2017;09;02;Lauantai;0;0;0
93;09.09.2017;2017;09;03;Lauantai;0;0;0
93;09.09.2017;2017;09;04;Lauantai;0;0;0
93;09.09.2017;2017;09;05;Lauantai;2;0;2
93;09.09.2017;2017;09;06;Lauantai;1;1;2
93;09.09.2017;2017;09;07;Lauantai;0;3;3
93;09.09.2017;2017;09;08;Lauantai;0;1;1
93;09.09.2017;2017;09;09;Lauantai;1;2;3
93;09.09.2017;2017;09;10;Lauantai;4;3;7
93;09.09.2017;2017;09;11;Lauantai;14;6;20
93;09.09.2017;2017;09;12;Lauantai;7;5;12
93;09.09.2017;2017;09;13;Lauantai;5;9;14
93;09.09.2017;2017;09;14;Lauantai;13;9;22
93;09.09.2017;2017;09;15;Lauantai;12;9;21
93;09.09.2017;2017;09;16;Lauantai;10;8;18
93;09.09.2017;2017;09;17;Lauantai;10;9;19
93;09.09.2017;2017;09;18;Lauantai;10;6;16
93;09.09.2017;2017;09;19;Lauantai;3;7;10
93;09.09.2017;2017;09;20;Lauantai;6;15;21
93;09.09.2017;2017;09;21;Lauantai;5;15;20
93;09.09.2017;2017;09;22;Lauantai;1;1;2
93;09.09.2017;2017;09;23;Lauantai;3;0;3
93;10.09.2017;2017;09;00;Sunnuntai;3;1;4
93;10.09.2017;2017;09;01;Sunnuntai;1;0;1
93;10.09.2017;2017;09;02;Sunnuntai;0;2;2
93;10.09.2017;2017;09;03;Sunnuntai;0;1;1
93;10.09.2017;2017;09;04;Sunnuntai;1;1;2
93;10.09.2017;2017;09;05;Sunnuntai;1;1;2
93;10.09.2017;2017;09;06;Sunnuntai;0;1;1
93;10.09.2017;2017;09;07;Sunnuntai;0;1;1
93;10.09.2017;2017;09;08;Sunnuntai;1;0;1
93;10.09.2017;2017;09;09;Sunnuntai;0;1;1
93;10.09.2017;2017;09;10;Sunnuntai;0;0;0
93;10.09.2017;2017;09;11;Sunnuntai;5;2;7
93;10.09.2017;2017;09;12;Sunnuntai;0;1;1
93;10.09.2017;2017;09;13;Sunnuntai;5;0;5
93;10.09.2017;2017;09;14;Sunnuntai;0;3;3
93;10.09.2017;2017;09;15;Sunnuntai;3;0;3
93;10.09.2017;2017;09;16;Sunnuntai;0;1;1
93;10.09.2017;2017;09;17;Sunnuntai;3;3;6
93;10.09.2017;2017;09;18;Sunnuntai;2;3;5
93;10.09.2017;2017;09;19;Sunnuntai;2;1;3
93;10.09.2017;2017;09;20;Sunnuntai;5;1;6
93;10.09.2017;2017;09;21;Sunnuntai;4;4;8
93;10.09.2017;2017;09;22;Sunnuntai;1;1;2
93;10.09.2017;2017;09;23;Sunnuntai;0;0;0
93;11.09.2017;2017;09;00;Maanantai;0;0;0
93;11.09.2017;2017;09;01;Maanantai;0;0;0
93;11.09.2017;2017;09;02;Maanantai;0;0;0
93;11.09.2017;2017;09;03;Maanantai;0;0;0
93;11.09.2017;2017;09;04;Maanantai;1;0;1
93;11.09.2017;2017;09;05;Maanantai;3;4;7
93;11.09.2017;2017;09;06;Maanantai;20;8;28
93;11.09.2017;2017;09;07;Maanantai;22;31;53
93;11.09.2017;2017;09;08;Maanantai;22;23;45
93;11.09.2017;2017;09;09;Maanantai;12;8;20
93;11.09.2017;2017;09;10;Maanantai;14;18;32
93;11.09.2017;2017;09;11;Maanantai;8;7;15
93;11.09.2017;2017;09;12;Maanantai;7;7;14
93;11.09.2017;2017;09;13;Maanantai;12;12;24
93;11.09.2017;2017;09;14;Maanantai;20;11;31
93;11.09.2017;2017;09;15;Maanantai;20;28;48
93;11.09.2017;2017;09;16;Maanantai;44;41;85
93;11.09.2017;2017;09;17;Maanantai;25;20;45
93;11.09.2017;2017;09;18;Maanantai;14;29;43
93;11.09.2017;2017;09;19;Maanantai;19;14;33
93;11.09.2017;2017;09;20;Maanantai;6;15;21
93;11.09.2017;2017;09;21;Maanantai;1;7;8
93;11.09.2017;2017;09;22;Maanantai;2;3;5
93;11.09.2017;2017;09;23;Maanantai;0;0;0
93;12.09.2017;2017;09;00;Tiistai;0;0;0
93;12.09.2017;2017;09;01;Tiistai;0;0;0
93;12.09.2017;2017;09;02;Tiistai;0;0;0
93;12.09.2017;2017;09;03;Tiistai;0;0;0
93;12.09.2017;2017;09;04;Tiistai;0;0;0
93;12.09.2017;2017;09;05;Tiistai;4;3;7
93;12.09.2017;2017;09;06;Tiistai;22;7;29
93;12.09.2017;2017;09;07;Tiistai;17;33;50
93;12.09.2017;2017;09;08;Tiistai;14;16;30
93;12.09.2017;2017;09;09;Tiistai;13;7;20
93;12.09.2017;2017;09;10;Tiistai;12;11;23
93;12.09.2017;2017;09;11;Tiistai;17;7;24
93;12.09.2017;2017;09;12;Tiistai;9;12;21
93;12.09.2017;2017;09;13;Tiistai;12;11;23
93;12.09.2017;2017;09;14;Tiistai;13;16;29
93;12.09.2017;2017;09;15;Tiistai;11;9;20
93;12.09.2017;2017;09;16;Tiistai;18;18;36
93;12.09.2017;2017;09;17;Tiistai;6;3;9
93;12.09.2017;2017;09;18;Tiistai;4;5;9
93;12.09.2017;2017;09;19;Tiistai;4;6;10
93;12.09.2017;2017;09;20;Tiistai;2;3;5
93;12.09.2017;2017;09;21;Tiistai;2;2;4
93;12.09.2017;2017;09;22;Tiistai;0;4;4
93;12.09.2017;2017;09;23;Tiistai;0;0;0
93;13.09.2017;2017;09;00;Keskiviikko;0;0;0
93;13.09.2017;2017;09;01;Keskiviikko;0;0;0
93;13.09.2017;2017;09;02;Keskiviikko;0;1;1
93;13.09.2017;2017;09;03;Keskiviikko;0;0;0
93;13.09.2017;2017;09;04;Keskiviikko;0;0;0
93;13.09.2017;2017;09;05;Keskiviikko;2;5;7
93;13.09.2017;2017;09;06;Keskiviikko;23;9;32
93;13.09.2017;2017;09;07;Keskiviikko;26;32;58
93;13.09.2017;2017;09;08;Keskiviikko;18;19;37
93;13.09.2017;2017;09;09;Keskiviikko;4;7;11
93;13.09.2017;2017;09;10;Keskiviikko;9;5;14
93;13.09.2017;2017;09;11;Keskiviikko;7;10;17
93;13.09.2017;2017;09;12;Keskiviikko;7;2;9
93;13.09.2017;2017;09;13;Keskiviikko;8;12;20
93;13.09.2017;2017;09;14;Keskiviikko;17;12;29
93;13.09.2017;2017;09;15;Keskiviikko;26;24;50
93;13.09.2017;2017;09;16;Keskiviikko;26;23;49
93;13.09.2017;2017;09;17;Keskiviikko;32;14;46
93;13.09.2017;2017;09;18;Keskiviikko;20;31;51
93;13.09.2017;2017;09;19;Keskiviikko;14;14;28
93;13.09.2017;2017;09;20;Keskiviikko;11;13;24
93;13.09.2017;2017;09;21;Keskiviikko;2;4;6
93;13.09.2017;2017;09;22;Keskiviikko;0;4;4
93;13.09.2017;2017;09;23;Keskiviikko;0;1;1
93;14.09.2017;2017;09;00;Torstai;0;0;0
93;14.09.2017;2017;09;01;Torstai;0;0;0
93;14.09.2017;2017;09;02;Torstai;0;0;0
93;14.09.2017;2017;09;03;Torstai;0;0;0
93;14.09.2017;2017;09;04;Torstai;1;0;1
93;14.09.2017;2017;09;05;Torstai;3;3;6
93;14.09.2017;2017;09;06;Torstai;18;12;30
93;14.09.2017;2017;09;07;Torstai;25;25;50
93;14.09.2017;2017;09;08;Torstai;16;22;38
93;14.09.2017;2017;09;09;Torstai;16;7;23
93;14.09.2017;2017;09;10;Torstai;4;8;12
93;14.09.2017;2017;09;11;Torstai;5;9;14
93;14.09.2017;2017;09;12;Torstai;9;6;15
93;14.09.2017;2017;09;13;Torstai;12;7;19
93;14.09.2017;2017;09;14;Torstai;11;16;27
93;14.09.2017;2017;09;15;Torstai;18;25;43
93;14.09.2017;2017;09;16;Torstai;33;31;64
93;14.09.2017;2017;09;17;Torstai;22;16;38
93;14.09.2017;2017;09;18;Torstai;9;19;28
93;14.09.2017;2017;09;19;Torstai;11;6;17
93;14.09.2017;2017;09;20;Torstai;11;13;24
93;14.09.2017;2017;09;21;Torstai;1;3;4
93;14.09.2017;2017;09;22;Torstai;4;6;10
93;14.09.2017;2017;09;23;Torstai;0;0;0
93;15.09.2017;2017;09;00;Perjantai;0;2;2
93;15.09.2017;2017;09;01;Perjantai;0;0;0
93;15.09.2017;2017;09;02;Perjantai;0;0;0
93;15.09.2017;2017;09;03;Perjantai;0;0;0
93;15.09.2017;2017;09;04;Perjantai;0;0;0
93;15.09.2017;2017;09;05;Perjantai;1;3;4
93;15.09.2017;2017;09;06;Perjantai;13;2;15
93;15.09.2017;2017;09;07;Perjantai;18;20;38
93;15.09.2017;2017;09;08;Perjantai;7;14;21
93;15.09.2017;2017;09;09;Perjantai;2;3;5
93;15.09.2017;2017;09;10;Perjantai;7;1;8
93;15.09.2017;2017;09;11;Perjantai;5;10;15
93;15.09.2017;2017;09;12;Perjantai;4;4;8
93;15.09.2017;2017;09;13;Perjantai;11;6;17
93;15.09.2017;2017;09;14;Perjantai;5;12;17
93;15.09.2017;2017;09;15;Perjantai;10;16;26
93;15.09.2017;2017;09;16;Perjantai;24;8;32
93;15.09.2017;2017;09;17;Perjantai;9;8;17
93;15.09.2017;2017;09;18;Perjantai;5;5;10
93;15.09.2017;2017;09;19;Perjantai;7;9;16
93;15.09.2017;2017;09;20;Perjantai;2;10;12
93;15.09.2017;2017;09;21;Perjantai;6;6;12
93;15.09.2017;2017;09;22;Perjantai;2;2;4
93;15.09.2017;2017;09;23;Perjantai;0;1;1
93;16.09.2017;2017;09;00;Lauantai;1;0;1
93;16.09.2017;2017;09;01;Lauantai;0;0;0
93;16.09.2017;2017;09;02;Lauantai;0;1;1
93;16.09.2017;2017;09;03;Lauantai;0;0;0
93;16.09.2017;2017;09;04;Lauantai;0;0;0
93;16.09.2017;2017;09;05;Lauantai;2;0;2
93;16.09.2017;2017;09;06;Lauantai;0;1;1
93;16.09.2017;2017;09;07;Lauantai;1;0;1
93;16.09.2017;2017;09;08;Lauantai;1;2;3
93;16.09.2017;2017;09;09;Lauantai;5;7;12
93;16.09.2017;2017;09;10;Lauantai;8;8;16
93;16.09.2017;2017;09;11;Lauantai;13;7;20
93;16.09.2017;2017;09;12;Lauantai;9;9;18
93;16.09.2017;2017;09;13;Lauantai;3;5;8
93;16.09.2017;2017;09;14;Lauantai;9;11;20
93;16.09.2017;2017;09;15;Lauantai;12;15;27
93;16.09.2017;2017;09;16;Lauantai;5;14;19
93;16.09.2017;2017;09;17;Lauantai;12;2;14
93;16.09.2017;2017;09;18;Lauantai;7;11;18
93;16.09.2017;2017;09;19;Lauantai;9;14;23
93;16.09.2017;2017;09;20;Lauantai;7;5;12
93;16.09.2017;2017;09;21;Lauantai;4;9;13
93;16.09.2017;2017;09;22;Lauantai;1;4;5
93;16.09.2017;2017;09;23;Lauantai;3;3;6
93;17.09.2017;2017;09;00;Sunnuntai;3;1;4
93;17.09.2017;2017;09;01;Sunnuntai;1;2;3
93;17.09.2017;2017;09;02;Sunnuntai;1;1;2
93;17.09.2017;2017;09;03;Sunnuntai;0;4;4
93;17.09.2017;2017;09;04;Sunnuntai;0;0;0
93;17.09.2017;2017;09;05;Sunnuntai;2;0;2
93;17.09.2017;2017;09;06;Sunnuntai;0;0;0
93;17.09.2017;2017;09;07;Sunnuntai;3;2;5
93;17.09.2017;2017;09;08;Sunnuntai;2;0;2
93;17.09.2017;2017;09;09;Sunnuntai;4;2;6
93;17.09.2017;2017;09;10;Sunnuntai;5;4;9
93;17.09.2017;2017;09;11;Sunnuntai;14;6;20
93;17.09.2017;2017;09;12;Sunnuntai;14;12;26
93;17.09.2017;2017;09;13;Sunnuntai;8;8;16
93;17.09.2017;2017;09;14;Sunnuntai;9;11;20
93;17.09.2017;2017;09;15;Sunnuntai;10;9;19
93;17.09.2017;2017;09;16;Sunnuntai;16;10;26
93;17.09.2017;2017;09;17;Sunnuntai;9;9;18
93;17.09.2017;2017;09;18;Sunnuntai;8;16;24
93;17.09.2017;2017;09;19;Sunnuntai;2;9;11
93;17.09.2017;2017;09;20;Sunnuntai;7;4;11
93;17.09.2017;2017;09;21;Sunnuntai;4;4;8
93;17.09.2017;2017;09;22;Sunnuntai;0;0;0
93;17.09.2017;2017;09;23;Sunnuntai;1;2;3
93;18.09.2017;2017;09;00;Maanantai;0;0;0
93;18.09.2017;2017;09;01;Maanantai;1;0;1
93;18.09.2017;2017;09;02;Maanantai;0;0;0
93;18.09.2017;2017;09;03;Maanantai;0;0;0
93;18.09.2017;2017;09;04;Maanantai;0;1;1
93;18.09.2017;2017;09;05;Maanantai;2;3;5
93;18.09.2017;2017;09;06;Maanantai;17;6;23
93;18.09.2017;2017;09;07;Maanantai;24;22;46
93;18.09.2017;2017;09;08;Maanantai;8;26;34
93;18.09.2017;2017;09;09;Maanantai;8;8;16
93;18.09.2017;2017;09;10;Maanantai;7;4;11
93;18.09.2017;2017;09;11;Maanantai;6;8;14
93;18.09.2017;2017;09;12;Maanantai;5;5;10
93;18.09.2017;2017;09;13;Maanantai;7;4;11
93;18.09.2017;2017;09;14;Maanantai;8;11;19
93;18.09.2017;2017;09;15;Maanantai;25;26;51
93;18.09.2017;2017;09;16;Maanantai;36;26;62
93;18.09.2017;2017;09;17;Maanantai;22;10;32
93;18.09.2017;2017;09;18;Maanantai;11;15;26
93;18.09.2017;2017;09;19;Maanantai;8;8;16
93;18.09.2017;2017;09;20;Maanantai;6;9;15
93;18.09.2017;2017;09;21;Maanantai;0;1;1
93;18.09.2017;2017;09;22;Maanantai;0;2;2
93;18.09.2017;2017;09;23;Maanantai;0;0;0
93;19.09.2017;2017;09;00;Tiistai;1;0;1
93;19.09.2017;2017;09;01;Tiistai;0;0;0
93;19.09.2017;2017;09;02;Tiistai;0;0;0
93;19.09.2017;2017;09;03;Tiistai;0;0;0
93;19.09.2017;2017;09;04;Tiistai;1;0;1
93;19.09.2017;2017;09;05;Tiistai;4;2;6
93;19.09.2017;2017;09;06;Tiistai;13;8;21
93;19.09.2017;2017;09;07;Tiistai;23;23;46
93;19.09.2017;2017;09;08;Tiistai;11;23;34
93;19.09.2017;2017;09;09;Tiistai;9;9;18
93;19.09.2017;2017;09;10;Tiistai;3;3;6
93;19.09.2017;2017;09;11;Tiistai;5;5;10
93;19.09.2017;2017;09;12;Tiistai;4;2;6
93;19.09.2017;2017;09;13;Tiistai;4;5;9
93;19.09.2017;2017;09;14;Tiistai;7;10;17
93;19.09.2017;2017;09;15;Tiistai;22;13;35
93;19.09.2017;2017;09;16;Tiistai;26;20;46
93;19.09.2017;2017;09;17;Tiistai;18;12;30
93;19.09.2017;2017;09;18;Tiistai;7;8;15
93;19.09.2017;2017;09;19;Tiistai;3;7;10
93;19.09.2017;2017;09;20;Tiistai;2;10;12
93;19.09.2017;2017;09;21;Tiistai;1;6;7
93;19.09.2017;2017;09;22;Tiistai;1;1;2
93;19.09.2017;2017;09;23;Tiistai;0;0;0
93;20.09.2017;2017;09;00;Keskiviikko;2;0;2
93;20.09.2017;2017;09;01;Keskiviikko;0;0;0
93;20.09.2017;2017;09;02;Keskiviikko;0;0;0
93;20.09.2017;2017;09;03;Keskiviikko;0;0;0
93;20.09.2017;2017;09;04;Keskiviikko;1;1;2
93;20.09.2017;2017;09;05;Keskiviikko;3;3;6
93;20.09.2017;2017;09;06;Keskiviikko;20;7;27
93;20.09.2017;2017;09;07;Keskiviikko;26;27;53
93;20.09.2017;2017;09;08;Keskiviikko;6;18;24
93;20.09.2017;2017;09;09;Keskiviikko;6;7;13
93;20.09.2017;2017;09;10;Keskiviikko;2;5;7
93;20.09.2017;2017;09;11;Keskiviikko;13;10;23
93;20.09.2017;2017;09;12;Keskiviikko;5;12;17
93;20.09.2017;2017;09;13;Keskiviikko;16;9;25
93;20.09.2017;2017;09;14;Keskiviikko;7;10;17
93;20.09.2017;2017;09;15;Keskiviikko;15;27;42
93;20.09.2017;2017;09;16;Keskiviikko;36;22;58
93;20.09.2017;2017;09;17;Keskiviikko;18;20;38
93;20.09.2017;2017;09;18;Keskiviikko;8;24;32
93;20.09.2017;2017;09;19;Keskiviikko;8;7;15
93;20.09.2017;2017;09;20;Keskiviikko;6;7;13
93;20.09.2017;2017;09;21;Keskiviikko;5;4;9
93;20.09.2017;2017;09;22;Keskiviikko;2;1;3
93;20.09.2017;2017;09;23;Keskiviikko;0;0;0
93;21.09.2017;2017;09;00;Torstai;1;0;1
93;21.09.2017;2017;09;01;Torstai;0;0;0
93;21.09.2017;2017;09;02;Torstai;0;0;0
93;21.09.2017;2017;09;03;Torstai;0;0;0
93;21.09.2017;2017;09;04;Torstai;0;0;0
93;21.09.2017;2017;09;05;Torstai;3;4;7
93;21.09.2017;2017;09;06;Torstai;19;9;28
93;21.09.2017;2017;09;07;Torstai;25;25;50
93;21.09.2017;2017;09;08;Torstai;8;14;22
93;21.09.2017;2017;09;09;Torstai;12;9;21
93;21.09.2017;2017;09;10;Torstai;11;7;18
93;21.09.2017;2017;09;11;Torstai;5;10;15
93;21.09.2017;2017;09;12;Torstai;9;6;15
93;21.09.2017;2017;09;13;Torstai;14;10;24
93;21.09.2017;2017;09;14;Torstai;22;13;35
93;21.09.2017;2017;09;15;Torstai;18;15;33
93;21.09.2017;2017;09;16;Torstai;28;29;57
93;21.09.2017;2017;09;17;Torstai;16;14;30
93;21.09.2017;2017;09;18;Torstai;12;10;22
93;21.09.2017;2017;09;19;Torstai;8;11;19
93;21.09.2017;2017;09;20;Torstai;8;15;23
93;21.09.2017;2017;09;21;Torstai;3;3;6
93;21.09.2017;2017;09;22;Torstai;3;6;9
93;21.09.2017;2017;09;23;Torstai;0;0;0
93;22.09.2017;2017;09;00;Perjantai;2;2;4
93;22.09.2017;2017;09;01;Perjantai;0;0;0
93;22.09.2017;2017;09;02;Perjantai;0;1;1
93;22.09.2017;2017;09;03;Perjantai;0;0;0
93;22.09.2017;2017;09;04;Perjantai;1;0;1
93;22.09.2017;2017;09;05;Perjantai;3;3;6
93;22.09.2017;2017;09;06;Perjantai;14;8;22
93;22.09.2017;2017;09;07;Perjantai;20;27;47
93;22.09.2017;2017;09;08;Perjantai;6;19;25
93;22.09.2017;2017;09;09;Perjantai;4;6;10
93;22.09.2017;2017;09;10;Perjantai;12;4;16
93;22.09.2017;2017;09;11;Perjantai;14;8;22
93;22.09.2017;2017;09;12;Perjantai;10;10;20
93;22.09.2017;2017;09;13;Perjantai;8;14;22
93;22.09.2017;2017;09;14;Perjantai;16;21;37
93;22.09.2017;2017;09;15;Perjantai;22;22;44
93;22.09.2017;2017;09;16;Perjantai;21;29;50
93;22.09.2017;2017;09;17;Perjantai;26;12;38
93;22.09.2017;2017;09;18;Perjantai;18;22;40
93;22.09.2017;2017;09;19;Perjantai;6;13;19
93;22.09.2017;2017;09;20;Perjantai;15;13;28
93;22.09.2017;2017;09;21;Perjantai;5;6;11
93;22.09.2017;2017;09;22;Perjantai;2;4;6
93;22.09.2017;2017;09;23;Perjantai;1;2;3
93;23.09.2017;2017;09;00;Lauantai;1;0;1
93;23.09.2017;2017;09;01;Lauantai;0;4;4
93;23.09.2017;2017;09;02;Lauantai;1;2;3
93;23.09.2017;2017;09;03;Lauantai;1;2;3
93;23.09.2017;2017;09;04;Lauantai;0;0;0
93;23.09.2017;2017;09;05;Lauantai;0;0;0
93;23.09.2017;2017;09;06;Lauantai;4;0;4
93;23.09.2017;2017;09;07;Lauantai;4;0;4
93;23.09.2017;2017;09;08;Lauantai;5;4;9
93;23.09.2017;2017;09;09;Lauantai;3;2;5
93;23.09.2017;2017;09;10;Lauantai;5;6;11
93;23.09.2017;2017;09;11;Lauantai;8;7;15
93;23.09.2017;2017;09;12;Lauantai;8;8;16
93;23.09.2017;2017;09;13;Lauantai;12;16;28
93;23.09.2017;2017;09;14;Lauantai;11;8;19
93;23.09.2017;2017;09;15;Lauantai;8;10;18
93;23.09.2017;2017;09;16;Lauantai;12;14;26
93;23.09.2017;2017;09;17;Lauantai;10;7;17
93;23.09.2017;2017;09;18;Lauantai;13;12;25
93;23.09.2017;2017;09;19;Lauantai;3;5;8
93;23.09.2017;2017;09;20;Lauantai;3;7;10
93;23.09.2017;2017;09;21;Lauantai;5;0;5
93;23.09.2017;2017;09;22;Lauantai;1;4;5
93;23.09.2017;2017;09;23;Lauantai;2;3;5
93;24.09.2017;2017;09;00;Sunnuntai;1;0;1
93;24.09.2017;2017;09;01;Sunnuntai;0;1;1
93;24.09.2017;2017;09;02;Sunnuntai;1;2;3
93;24.09.2017;2017;09;03;Sunnuntai;1;0;1
93;24.09.2017;2017;09;04;Sunnuntai;0;2;2
93;24.09.2017;2017;09;05;Sunnuntai;1;0;1
93;24.09.2017;2017;09;06;Sunnuntai;1;0;1
93;24.09.2017;2017;09;07;Sunnuntai;0;0;0
93;24.09.2017;2017;09;08;Sunnuntai;5;1;6
93;24.09.2017;2017;09;09;Sunnuntai;2;2;4
93;24.09.2017;2017;09;10;Sunnuntai;5;14;19
93;24.09.2017;2017;09;11;Sunnuntai;18;12;30
93;24.09.2017;2017;09;12;Sunnuntai;14;15;29
93;24.09.2017;2017;09;13;Sunnuntai;13;14;27
93;24.09.2017;2017;09;14;Sunnuntai;9;16;25
93;24.09.2017;2017;09;15;Sunnuntai;14;10;24
93;24.09.2017;2017;09;16;Sunnuntai;7;9;16
93;24.09.2017;2017;09;17;Sunnuntai;2;14;16
93;24.09.2017;2017;09;18;Sunnuntai;6;13;19
93;24.09.2017;2017;09;19;Sunnuntai;6;6;12
93;24.09.2017;2017;09;20;Sunnuntai;5;8;13
93;24.09.2017;2017;09;21;Sunnuntai;5;1;6
93;24.09.2017;2017;09;22;Sunnuntai;3;0;3
93;24.09.2017;2017;09;23;Sunnuntai;0;0;0
93;25.09.2017;2017;09;00;Maanantai;0;0;0
93;25.09.2017;2017;09;01;Maanantai;1;0;1
93;25.09.2017;2017;09;02;Maanantai;0;0;0
93;25.09.2017;2017;09;03;Maanantai;0;0;0
93;25.09.2017;2017;09;04;Maanantai;1;0;1
93;25.09.2017;2017;09;05;Maanantai;2;3;5
93;25.09.2017;2017;09;06;Maanantai;18;10;28
93;25.09.2017;2017;09;07;Maanantai;22;23;45
93;25.09.2017;2017;09;08;Maanantai;20;19;39
93;25.09.2017;2017;09;09;Maanantai;18;8;26
93;25.09.2017;2017;09;10;Maanantai;5;7;12
93;25.09.2017;2017;09;11;Maanantai;13;6;19
93;25.09.2017;2017;09;12;Maanantai;4;4;8
93;25.09.2017;2017;09;13;Maanantai;6;7;13
93;25.09.2017;2017;09;14;Maanantai;13;23;36
93;25.09.2017;2017;09;15;Maanantai;25;26;51
93;25.09.2017;2017;09;16;Maanantai;39;41;80
93;25.09.2017;2017;09;17;Maanantai;19;25;44
93;25.09.2017;2017;09;18;Maanantai;21;40;61
93;25.09.2017;2017;09;19;Maanantai;18;14;32
93;25.09.2017;2017;09;20;Maanantai;7;16;23
93;25.09.2017;2017;09;21;Maanantai;4;2;6
93;25.09.2017;2017;09;22;Maanantai;1;3;4
93;25.09.2017;2017;09;23;Maanantai;0;0;0
93;26.09.2017;2017;09;00;Tiistai;0;1;1
93;26.09.2017;2017;09;01;Tiistai;0;0;0
93;26.09.2017;2017;09;02;Tiistai;0;0;0
93;26.09.2017;2017;09;03;Tiistai;0;0;0
93;26.09.2017;2017;09;04;Tiistai;0;0;0
93;26.09.2017;2017;09;05;Tiistai;3;4;7
93;26.09.2017;2017;09;06;Tiistai;20;9;29
93;26.09.2017;2017;09;07;Tiistai;21;27;48
93;26.09.2017;2017;09;08;Tiistai;14;20;34
93;26.09.2017;2017;09;09;Tiistai;12;5;17
93;26.09.2017;2017;09;10;Tiistai;6;7;13
93;26.09.2017;2017;09;11;Tiistai;9;5;14
93;26.09.2017;2017;09;12;Tiistai;6;4;10
93;26.09.2017;2017;09;13;Tiistai;7;8;15
93;26.09.2017;2017;09;14;Tiistai;15;12;27
93;26.09.2017;2017;09;15;Tiistai;20;24;44
93;26.09.2017;2017;09;16;Tiistai;23;29;52
93;26.09.2017;2017;09;17;Tiistai;18;15;33
93;26.09.2017;2017;09;18;Tiistai;10;14;24
93;26.09.2017;2017;09;19;Tiistai;9;6;15
93;26.09.2017;2017;09;20;Tiistai;7;8;15
93;26.09.2017;2017;09;21;Tiistai;1;5;6
93;26.09.2017;2017;09;22;Tiistai;0;5;5
93;26.09.2017;2017;09;23;Tiistai;0;0;0
93;27.09.2017;2017;09;00;Keskiviikko;0;0;0
93;27.09.2017;2017;09;01;Keskiviikko;0;0;0
93;27.09.2017;2017;09;02;Keskiviikko;0;0;0
93;27.09.2017;2017;09;03;Keskiviikko;0;0;0
93;27.09.2017;2017;09;04;Keskiviikko;0;0;0
93;27.09.2017;2017;09;05;Keskiviikko;1;4;5
93;27.09.2017;2017;09;06;Keskiviikko;16;13;29
93;27.09.2017;2017;09;07;Keskiviikko;19;25;44
93;27.09.2017;2017;09;08;Keskiviikko;21;11;32
93;27.09.2017;2017;09;09;Keskiviikko;13;5;18
93;27.09.2017;2017;09;10;Keskiviikko;7;1;8
93;27.09.2017;2017;09;11;Keskiviikko;6;11;17
93;27.09.2017;2017;09;12;Keskiviikko;7;7;14
93;27.09.2017;2017;09;13;Keskiviikko;6;16;22
93;27.09.2017;2017;09;14;Keskiviikko;17;10;27
93;27.09.2017;2017;09;15;Keskiviikko;15;25;40
93;27.09.2017;2017;09;16;Keskiviikko;22;19;41
93;27.09.2017;2017;09;17;Keskiviikko;17;15;32
93;27.09.2017;2017;09;18;Keskiviikko;13;20;33
93;27.09.2017;2017;09;19;Keskiviikko;9;15;24
93;27.09.2017;2017;09;20;Keskiviikko;5;11;16
93;27.09.2017;2017;09;21;Keskiviikko;2;1;3
93;27.09.2017;2017;09;22;Keskiviikko;1;0;1
93;27.09.2017;2017;09;23;Keskiviikko;0;1;1
93;28.09.2017;2017;09;00;Torstai;0;0;0
93;28.09.2017;2017;09;01;Torstai;0;2;2
93;28.09.2017;2017;09;02;Torstai;0;0;0
93;28.09.2017;2017;09;03;Torstai;0;0;0
93;28.09.2017;2017;09;04;Torstai;0;0;0
93;28.09.2017;2017;09;05;Torstai;3;3;6
93;28.09.2017;2017;09;06;Torstai;16;9;25
93;28.09.2017;2017;09;07;Torstai;22;29;51
93;28.09.2017;2017;09;08;Torstai;13;15;28
93;28.09.2017;2017;09;09;Torstai;8;7;15
93;28.09.2017;2017;09;10;Torstai;8;5;13
93;28.09.2017;2017;09;11;Torstai;3;4;7
93;28.09.2017;2017;09;12;Torstai;4;4;8
93;28.09.2017;2017;09;13;Torstai;8;4;12
93;28.09.2017;2017;09;14;Torstai;14;6;20
93;28.09.2017;2017;09;15;Torstai;13;30;43
93;28.09.2017;2017;09;16;Torstai;29;19;48
93;28.09.2017;2017;09;17;Torstai;10;17;27
93;28.09.2017;2017;09;18;Torstai;5;7;12
93;28.09.2017;2017;09;19;Torstai;7;4;11
93;28.09.2017;2017;09;20;Torstai;7;20;27
93;28.09.2017;2017;09;21;Torstai;1;5;6
93;28.09.2017;2017;09;22;Torstai;2;3;5
93;28.09.2017;2017;09;23;Torstai;0;5;5
93;29.09.2017;2017;09;00;Perjantai;0;0;0
93;29.09.2017;2017;09;01;Perjantai;1;0;1
93;29.09.2017;2017;09;02;Perjantai;0;0;0
93;29.09.2017;2017;09;03;Perjantai;0;0;0
93;29.09.2017;2017;09;04;Perjantai;1;0;1
93;29.09.2017;2017;09;05;Perjantai;2;3;5
93;29.09.2017;2017;09;06;Perjantai;8;8;16
93;29.09.2017;2017;09;07;Perjantai;23;18;41
93;29.09.2017;2017;09;08;Perjantai;10;13;23
93;29.09.2017;2017;09;09;Perjantai;12;6;18
93;29.09.2017;2017;09;10;Perjantai;8;9;17
93;29.09.2017;2017;09;11;Perjantai;8;6;14
93;29.09.2017;2017;09;12;Perjantai;9;5;14
93;29.09.2017;2017;09;13;Perjantai;14;9;23
93;29.09.2017;2017;09;14;Perjantai;13;12;25
93;29.09.2017;2017;09;15;Perjantai;12;27;39
93;29.09.2017;2017;09;16;Perjantai;27;18;45
93;29.09.2017;2017;09;17;Perjantai;7;9;16
93;29.09.2017;2017;09;18;Perjantai;6;20;26
93;29.09.2017;2017;09;19;Perjantai;10;9;19
93;29.09.2017;2017;09;20;Perjantai;2;8;10
93;29.09.2017;2017;09;21;Perjantai;1;8;9
93;29.09.2017;2017;09;22;Perjantai;1;0;1
93;29.09.2017;2017;09;23;Perjantai;2;3;5
93;30.09.2017;2017;09;00;Lauantai;1;3;4
93;30.09.2017;2017;09;01;Lauantai;0;0;0
93;30.09.2017;2017;09;02;Lauantai;0;1;1
93;30.09.2017;2017;09;03;Lauantai;0;0;0
93;30.09.2017;2017;09;04;Lauantai;2;0;2
93;30.09.2017;2017;09;05;Lauantai;0;0;0
93;30.09.2017;2017;09;06;Lauantai;3;0;3
93;30.09.2017;2017;09;07;Lauantai;2;0;2
93;30.09.2017;2017;09;08;Lauantai;0;4;4
93;30.09.2017;2017;09;09;Lauantai;9;5;14
93;30.09.2017;2017;09;10;Lauantai;5;7;12
93;30.09.2017;2017;09;11;Lauantai;6;8;14
93;30.09.2017;2017;09;12;Lauantai;10;7;17
93;30.09.2017;2017;09;13;Lauantai;11;11;22
93;30.09.2017;2017;09;14;Lauantai;10;13;23
93;30.09.2017;2017;09;15;Lauantai;6;8;14
93;30.09.2017;2017;09;16;Lauantai;13;14;27
93;30.09.2017;2017;09;17;Lauantai;14;8;22
93;30.09.2017;2017;09;18;Lauantai;11;8;19
93;30.09.2017;2017;09;19;Lauantai;6;10;16
93;30.09.2017;2017;09;20;Lauantai;2;7;9
93;30.09.2017;2017;09;21;Lauantai;3;1;4
93;30.09.2017;2017;09;22;Lauantai;0;1;1
93;30.09.2017;2017;09;23;Lauantai;2;1;3
93;01.10.2017;2017;10;00;Sunnuntai;1;1;2
93;01.10.2017;2017;10;01;Sunnuntai;0;0;0
93;01.10.2017;2017;10;02;Sunnuntai;0;0;0
93;01.10.2017;2017;10;03;Sunnuntai;0;0;0
93;01.10.2017;2017;10;04;Sunnuntai;0;0;0
93;01.10.2017;2017;10;05;Sunnuntai;1;0;1
93;01.10.2017;2017;10;06;Sunnuntai;1;2;3
93;01.10.2017;2017;10;07;Sunnuntai;1;3;4
93;01.10.2017;2017;10;08;Sunnuntai;0;3;3
93;01.10.2017;2017;10;09;Sunnuntai;5;5;10
93;01.10.2017;2017;10;10;Sunnuntai;11;15;26
93;01.10.2017;2017;10;11;Sunnuntai;9;11;20
93;01.10.2017;2017;10;12;Sunnuntai;9;17;26
93;01.10.2017;2017;10;13;Sunnuntai;12;13;25
93;01.10.2017;2017;10;14;Sunnuntai;9;5;14
93;01.10.2017;2017;10;15;Sunnuntai;5;7;12
93;01.10.2017;2017;10;16;Sunnuntai;12;5;17
93;01.10.2017;2017;10;17;Sunnuntai;7;9;16
93;01.10.2017;2017;10;18;Sunnuntai;7;7;14
93;01.10.2017;2017;10;19;Sunnuntai;5;9;14
93;01.10.2017;2017;10;20;Sunnuntai;7;5;12
93;01.10.2017;2017;10;21;Sunnuntai;0;3;3
93;01.10.2017;2017;10;22;Sunnuntai;1;3;4
93;01.10.2017;2017;10;23;Sunnuntai;1;0;1
93;02.10.2017;2017;10;00;Maanantai;0;0;0
93;02.10.2017;2017;10;01;Maanantai;0;0;0
93;02.10.2017;2017;10;02;Maanantai;0;0;0
93;02.10.2017;2017;10;03;Maanantai;0;0;0
93;02.10.2017;2017;10;04;Maanantai;0;0;0
93;02.10.2017;2017;10;05;Maanantai;3;4;7
93;02.10.2017;2017;10;06;Maanantai;17;12;29
93;02.10.2017;2017;10;07;Maanantai;27;20;47
93;02.10.2017;2017;10;08;Maanantai;15;24;39
93;02.10.2017;2017;10;09;Maanantai;6;10;16
93;02.10.2017;2017;10;10;Maanantai;7;3;10
93;02.10.2017;2017;10;11;Maanantai;10;6;16
93;02.10.2017;2017;10;12;Maanantai;4;3;7
93;02.10.2017;2017;10;13;Maanantai;6;9;15
93;02.10.2017;2017;10;14;Maanantai;12;13;25
93;02.10.2017;2017;10;15;Maanantai;22;21;43
93;02.10.2017;2017;10;16;Maanantai;32;25;57
93;02.10.2017;2017;10;17;Maanantai;15;19;34
93;02.10.2017;2017;10;18;Maanantai;9;13;22
93;02.10.2017;2017;10;19;Maanantai;8;9;17
93;02.10.2017;2017;10;20;Maanantai;3;14;17
93;02.10.2017;2017;10;21;Maanantai;2;9;11
93;02.10.2017;2017;10;22;Maanantai;1;2;3
93;02.10.2017;2017;10;23;Maanantai;1;0;1
93;03.10.2017;2017;10;00;Tiistai;1;0;1
93;03.10.2017;2017;10;01;Tiistai;2;0;2
93;03.10.2017;2017;10;02;Tiistai;0;0;0
93;03.10.2017;2017;10;03;Tiistai;0;0;0
93;03.10.2017;2017;10;04;Tiistai;0;0;0
93;03.10.2017;2017;10;05;Tiistai;3;2;5
93;03.10.2017;2017;10;06;Tiistai;12;11;23
93;03.10.2017;2017;10;07;Tiistai;19;21;40
93;03.10.2017;2017;10;08;Tiistai;6;13;19
93;03.10.2017;2017;10;09;Tiistai;6;8;14
93;03.10.2017;2017;10;10;Tiistai;7;4;11
93;03.10.2017;2017;10;11;Tiistai;3;4;7
93;03.10.2017;2017;10;12;Tiistai;1;1;2
93;03.10.2017;2017;10;13;Tiistai;8;3;11
93;03.10.2017;2017;10;14;Tiistai;8;2;10
93;03.10.2017;2017;10;15;Tiistai;13;18;31
93;03.10.2017;2017;10;16;Tiistai;25;20;45
93;03.10.2017;2017;10;17;Tiistai;9;3;12
93;03.10.2017;2017;10;18;Tiistai;6;9;15
93;03.10.2017;2017;10;19;Tiistai;4;6;10
93;03.10.2017;2017;10;20;Tiistai;2;3;5
93;03.10.2017;2017;10;21;Tiistai;2;1;3
93;03.10.2017;2017;10;22;Tiistai;0;2;2
93;03.10.2017;2017;10;23;Tiistai;0;0;0
93;04.10.2017;2017;10;00;Keskiviikko;1;0;1
93;04.10.2017;2017;10;01;Keskiviikko;0;0;0
93;04.10.2017;2017;10;02;Keskiviikko;0;0;0
93;04.10.2017;2017;10;03;Keskiviikko;0;0;0
93;04.10.2017;2017;10;04;Keskiviikko;0;0;0
93;04.10.2017;2017;10;05;Keskiviikko;3;4;7
93;04.10.2017;2017;10;06;Keskiviikko;12;11;23
93;04.10.2017;2017;10;07;Keskiviikko;12;16;28
93;04.10.2017;2017;10;08;Keskiviikko;14;15;29
93;04.10.2017;2017;10;09;Keskiviikko;5;6;11
93;04.10.2017;2017;10;10;Keskiviikko;6;1;7
93;04.10.2017;2017;10;11;Keskiviikko;0;5;5
93;04.10.2017;2017;10;12;Keskiviikko;3;6;9
93;04.10.2017;2017;10;13;Keskiviikko;7;4;11
93;04.10.2017;2017;10;14;Keskiviikko;6;9;15
93;04.10.2017;2017;10;15;Keskiviikko;18;12;30
93;04.10.2017;2017;10;16;Keskiviikko;22;15;37
93;04.10.2017;2017;10;17;Keskiviikko;13;13;26
93;04.10.2017;2017;10;18;Keskiviikko;11;13;24
93;04.10.2017;2017;10;19;Keskiviikko;4;11;15
93;04.10.2017;2017;10;20;Keskiviikko;5;4;9
93;04.10.2017;2017;10;21;Keskiviikko;1;1;2
93;04.10.2017;2017;10;22;Keskiviikko;0;0;0
93;04.10.2017;2017;10;23;Keskiviikko;1;0;1
93;05.10.2017;2017;10;00;Torstai;1;0;1
93;05.10.2017;2017;10;01;Torstai;0;0;0
93;05.10.2017;2017;10;02;Torstai;0;0;0
93;05.10.2017;2017;10;03;Torstai;0;0;0
93;05.10.2017;2017;10;04;Torstai;0;0;0
93;05.10.2017;2017;10;05;Torstai;2;3;5
93;05.10.2017;2017;10;06;Torstai;9;11;20
93;05.10.2017;2017;10;07;Torstai;25;21;46
93;05.10.2017;2017;10;08;Torstai;7;13;20
93;05.10.2017;2017;10;09;Torstai;5;4;9
93;05.10.2017;2017;10;10;Torstai;4;4;8
93;05.10.2017;2017;10;11;Torstai;4;6;10
93;05.10.2017;2017;10;12;Torstai;9;3;12
93;05.10.2017;2017;10;13;Torstai;12;4;16
93;05.10.2017;2017;10;14;Torstai;12;11;23
93;05.10.2017;2017;10;15;Torstai;15;22;37
93;05.10.2017;2017;10;16;Torstai;22;19;41
93;05.10.2017;2017;10;17;Torstai;18;12;30
93;05.10.2017;2017;10;18;Torstai;5;10;15
93;05.10.2017;2017;10;19;Torstai;4;11;15
93;05.10.2017;2017;10;20;Torstai;3;7;10
93;05.10.2017;2017;10;21;Torstai;8;2;10
93;05.10.2017;2017;10;22;Torstai;2;4;6
93;05.10.2017;2017;10;23;Torstai;0;0;0
93;06.10.2017;2017;10;00;Perjantai;1;0;1
93;06.10.2017;2017;10;01;Perjantai;0;1;1
93;06.10.2017;2017;10;02;Perjantai;0;0;0
93;06.10.2017;2017;10;03;Perjantai;0;0;0
93;06.10.2017;2017;10;04;Perjantai;0;1;1
93;06.10.2017;2017;10;05;Perjantai;3;3;6
93;06.10.2017;2017;10;06;Perjantai;11;7;18
93;06.10.2017;2017;10;07;Perjantai;20;16;36
93;06.10.2017;2017;10;08;Perjantai;14;19;33
93;06.10.2017;2017;10;09;Perjantai;3;5;8
93;06.10.2017;2017;10;10;Perjantai;10;5;15
93;06.10.2017;2017;10;11;Perjantai;4;8;12
93;06.10.2017;2017;10;12;Perjantai;10;8;18
93;06.10.2017;2017;10;13;Perjantai;4;11;15
93;06.10.2017;2017;10;14;Perjantai;21;15;36
93;06.10.2017;2017;10;15;Perjantai;17;26;43
93;06.10.2017;2017;10;16;Perjantai;18;19;37
93;06.10.2017;2017;10;17;Perjantai;7;10;17
93;06.10.2017;2017;10;18;Perjantai;6;8;14
93;06.10.2017;2017;10;19;Perjantai;5;8;13
93;06.10.2017;2017;10;20;Perjantai;4;6;10
93;06.10.2017;2017;10;21;Perjantai;2;7;9
93;06.10.2017;2017;10;22;Perjantai;3;2;5
93;06.10.2017;2017;10;23;Perjantai;3;0;3
93;07.10.2017;2017;10;00;Lauantai;2;0;2
93;07.10.2017;2017;10;01;Lauantai;1;3;4
93;07.10.2017;2017;10;02;Lauantai;0;0;0
93;07.10.2017;2017;10;03;Lauantai;0;0;0
93;07.10.2017;2017;10;04;Lauantai;0;0;0
93;07.10.2017;2017;10;05;Lauantai;1;1;2
93;07.10.2017;2017;10;06;Lauantai;0;0;0
93;07.10.2017;2017;10;07;Lauantai;3;1;4
93;07.10.2017;2017;10;08;Lauantai;0;2;2
93;07.10.2017;2017;10;09;Lauantai;3;3;6
93;07.10.2017;2017;10;10;Lauantai;9;13;22
93;07.10.2017;2017;10;11;Lauantai;11;8;19
93;07.10.2017;2017;10;12;Lauantai;11;12;23
93;07.10.2017;2017;10;13;Lauantai;7;5;12
93;07.10.2017;2017;10;14;Lauantai;18;9;27
93;07.10.2017;2017;10;15;Lauantai;10;15;25
93;07.10.2017;2017;10;16;Lauantai;4;17;21
93;07.10.2017;2017;10;17;Lauantai;5;9;14
93;07.10.2017;2017;10;18;Lauantai;20;7;27
93;07.10.2017;2017;10;19;Lauantai;7;8;15
93;07.10.2017;2017;10;20;Lauantai;2;5;7
93;07.10.2017;2017;10;21;Lauantai;3;2;5
93;07.10.2017;2017;10;22;Lauantai;3;3;6
93;07.10.2017;2017;10;23;Lauantai;0;7;7
93;08.10.2017;2017;10;00;Sunnuntai;0;1;1
93;08.10.2017;2017;10;01;Sunnuntai;3;0;3
93;08.10.2017;2017;10;02;Sunnuntai;1;1;2
93;08.10.2017;2017;10;03;Sunnuntai;0;0;0
93;08.10.2017;2017;10;04;Sunnuntai;0;0;0
93;08.10.2017;2017;10;05;Sunnuntai;0;0;0
93;08.10.2017;2017;10;06;Sunnuntai;0;1;1
93;08.10.2017;2017;10;07;Sunnuntai;1;1;2
93;08.10.2017;2017;10;08;Sunnuntai;3;0;3
93;08.10.2017;2017;10;09;Sunnuntai;3;3;6
93;08.10.2017;2017;10;10;Sunnuntai;7;11;18
93;08.10.2017;2017;10;11;Sunnuntai;14;10;24
93;08.10.2017;2017;10;12;Sunnuntai;16;12;28
93;08.10.2017;2017;10;13;Sunnuntai;7;14;21
93;08.10.2017;2017;10;14;Sunnuntai;11;10;21
93;08.10.2017;2017;10;15;Sunnuntai;11;15;26
93;08.10.2017;2017;10;16;Sunnuntai;10;14;24
93;08.10.2017;2017;10;17;Sunnuntai;5;11;16
93;08.10.2017;2017;10;18;Sunnuntai;12;11;23
93;08.10.2017;2017;10;19;Sunnuntai;5;3;8
93;08.10.2017;2017;10;20;Sunnuntai;4;2;6
93;08.10.2017;2017;10;21;Sunnuntai;4;1;5
93;08.10.2017;2017;10;22;Sunnuntai;2;3;5
93;08.10.2017;2017;10;23;Sunnuntai;1;0;1
93;09.10.2017;2017;10;00;Maanantai;0;0;0
93;09.10.2017;2017;10;01;Maanantai;1;0;1
93;09.10.2017;2017;10;02;Maanantai;0;0;0
93;09.10.2017;2017;10;03;Maanantai;0;0;0
93;09.10.2017;2017;10;04;Maanantai;0;1;1
93;09.10.2017;2017;10;05;Maanantai;5;6;11
93;09.10.2017;2017;10;06;Maanantai;18;13;31
93;09.10.2017;2017;10;07;Maanantai;28;18;46
93;09.10.2017;2017;10;08;Maanantai;19;23;42
93;09.10.2017;2017;10;09;Maanantai;14;5;19
93;09.10.2017;2017;10;10;Maanantai;8;7;15
93;09.10.2017;2017;10;11;Maanantai;8;8;16
93;09.10.2017;2017;10;12;Maanantai;3;6;9
93;09.10.2017;2017;10;13;Maanantai;5;5;10
93;09.10.2017;2017;10;14;Maanantai;12;10;22
93;09.10.2017;2017;10;15;Maanantai;20;21;41
93;09.10.2017;2017;10;16;Maanantai;29;30;59
93;09.10.2017;2017;10;17;Maanantai;17;19;36
93;09.10.2017;2017;10;18;Maanantai;10;14;24
93;09.10.2017;2017;10;19;Maanantai;9;12;21
93;09.10.2017;2017;10;20;Maanantai;1;4;5
93;09.10.2017;2017;10;21;Maanantai;1;5;6
93;09.10.2017;2017;10;22;Maanantai;3;2;5
93;09.10.2017;2017;10;23;Maanantai;0;0;0
93;10.10.2017;2017;10;00;Tiistai;0;0;0
93;10.10.2017;2017;10;01;Tiistai;0;0;0
93;10.10.2017;2017;10;02;Tiistai;0;0;0
93;10.10.2017;2017;10;03;Tiistai;0;0;0
93;10.10.2017;2017;10;04;Tiistai;0;1;1
93;10.10.2017;2017;10;05;Tiistai;2;2;4
93;10.10.2017;2017;10;06;Tiistai;6;10;16
93;10.10.2017;2017;10;07;Tiistai;12;20;32
93;10.10.2017;2017;10;08;Tiistai;6;13;19
93;10.10.2017;2017;10;09;Tiistai;2;4;6
93;10.10.2017;2017;10;10;Tiistai;2;0;2
93;10.10.2017;2017;10;11;Tiistai;0;3;3
93;10.10.2017;2017;10;12;Tiistai;0;3;3
93;10.10.2017;2017;10;13;Tiistai;5;6;11
93;10.10.2017;2017;10;14;Tiistai;6;4;10
93;10.10.2017;2017;10;15;Tiistai;10;12;22
93;10.10.2017;2017;10;16;Tiistai;17;10;27
93;10.10.2017;2017;10;17;Tiistai;11;5;16
93;10.10.2017;2017;10;18;Tiistai;3;2;5
93;10.10.2017;2017;10;19;Tiistai;3;2;5
93;10.10.2017;2017;10;20;Tiistai;4;3;7
93;10.10.2017;2017;10;21;Tiistai;3;3;6
93;10.10.2017;2017;10;22;Tiistai;0;0;0
93;10.10.2017;2017;10;23;Tiistai;0;0;0
93;11.10.2017;2017;10;00;Keskiviikko;0;0;0
93;11.10.2017;2017;10;01;Keskiviikko;0;0;0
93;11.10.2017;2017;10;02;Keskiviikko;0;0;0
93;11.10.2017;2017;10;03;Keskiviikko;0;0;0
93;11.10.2017;2017;10;04;Keskiviikko;0;0;0
93;11.10.2017;2017;10;05;Keskiviikko;2;3;5
93;11.10.2017;2017;10;06;Keskiviikko;12;7;19
93;11.10.2017;2017;10;07;Keskiviikko;21;20;41
93;11.10.2017;2017;10;08;Keskiviikko;16;19;35
93;11.10.2017;2017;10;09;Keskiviikko;6;7;13
93;11.10.2017;2017;10;10;Keskiviikko;7;6;13
93;11.10.2017;2017;10;11;Keskiviikko;8;2;10
93;11.10.2017;2017;10;12;Keskiviikko;6;7;13
93;11.10.2017;2017;10;13;Keskiviikko;5;4;9
93;11.10.2017;2017;10;14;Keskiviikko;9;18;27
93;11.10.2017;2017;10;15;Keskiviikko;19;18;37
93;11.10.2017;2017;10;16;Keskiviikko;24;22;46
93;11.10.2017;2017;10;17;Keskiviikko;19;18;37
93;11.10.2017;2017;10;18;Keskiviikko;12;14;26
93;11.10.2017;2017;10;19;Keskiviikko;3;10;13
93;11.10.2017;2017;10;20;Keskiviikko;7;7;14
93;11.10.2017;2017;10;21;Keskiviikko;1;3;4
93;11.10.2017;2017;10;22;Keskiviikko;0;1;1
93;11.10.2017;2017;10;23;Keskiviikko;0;0;0
93;12.10.2017;2017;10;00;Torstai;0;0;0
93;12.10.2017;2017;10;01;Torstai;0;0;0
93;12.10.2017;2017;10;02;Torstai;0;0;0
93;12.10.2017;2017;10;03;Torstai;0;0;0
93;12.10.2017;2017;10;04;Torstai;0;1;1
93;12.10.2017;2017;10;05;Torstai;6;4;10
93;12.10.2017;2017;10;06;Torstai;14;7;21
93;12.10.2017;2017;10;07;Torstai;25;23;48
93;12.10.2017;2017;10;08;Torstai;10;17;27
93;12.10.2017;2017;10;09;Torstai;7;2;9
93;12.10.2017;2017;10;10;Torstai;9;6;15
93;12.10.2017;2017;10;11;Torstai;5;4;9
93;12.10.2017;2017;10;12;Torstai;5;10;15
93;12.10.2017;2017;10;13;Torstai;8;8;16
93;12.10.2017;2017;10;14;Torstai;12;12;24
93;12.10.2017;2017;10;15;Torstai;20;20;40
93;12.10.2017;2017;10;16;Torstai;29;21;50
93;12.10.2017;2017;10;17;Torstai;17;8;25
93;12.10.2017;2017;10;18;Torstai;6;11;17
93;12.10.2017;2017;10;19;Torstai;7;3;10
93;12.10.2017;2017;10;20;Torstai;2;5;7
93;12.10.2017;2017;10;21;Torstai;2;8;10
93;12.10.2017;2017;10;22;Torstai;2;0;2
93;12.10.2017;2017;10;23;Torstai;0;0;0
93;13.10.2017;2017;10;00;Perjantai;0;1;1
93;13.10.2017;2017;10;01;Perjantai;0;0;0
93;13.10.2017;2017;10;02;Perjantai;0;0;0
93;13.10.2017;2017;10;03;Perjantai;0;0;0
93;13.10.2017;2017;10;04;Perjantai;0;0;0
93;13.10.2017;2017;10;05;Perjantai;5;3;8
93;13.10.2017;2017;10;06;Perjantai;9;7;16
93;13.10.2017;2017;10;07;Perjantai;15;24;39
93;13.10.2017;2017;10;08;Perjantai;5;16;21
93;13.10.2017;2017;10;09;Perjantai;7;8;15
93;13.10.2017;2017;10;10;Perjantai;7;4;11
93;13.10.2017;2017;10;11;Perjantai;4;5;9
93;13.10.2017;2017;10;12;Perjantai;5;4;9
93;13.10.2017;2017;10;13;Perjantai;6;11;17
93;13.10.2017;2017;10;14;Perjantai;9;14;23
93;13.10.2017;2017;10;15;Perjantai;26;16;42
93;13.10.2017;2017;10;16;Perjantai;21;14;35
93;13.10.2017;2017;10;17;Perjantai;18;6;24
93;13.10.2017;2017;10;18;Perjantai;7;9;16
93;13.10.2017;2017;10;19;Perjantai;2;10;12
93;13.10.2017;2017;10;20;Perjantai;2;4;6
93;13.10.2017;2017;10;21;Perjantai;3;4;7
93;13.10.2017;2017;10;22;Perjantai;2;2;4
93;13.10.2017;2017;10;23;Perjantai;1;0;1
93;14.10.2017;2017;10;00;Lauantai;0;2;2
93;14.10.2017;2017;10;01;Lauantai;3;1;4
93;14.10.2017;2017;10;02;Lauantai;0;1;1
93;14.10.2017;2017;10;03;Lauantai;0;0;0
93;14.10.2017;2017;10;04;Lauantai;0;0;0
93;14.10.2017;2017;10;05;Lauantai;1;0;1
93;14.10.2017;2017;10;06;Lauantai;1;0;1
93;14.10.2017;2017;10;07;Lauantai;2;1;3
93;14.10.2017;2017;10;08;Lauantai;1;0;1
93;14.10.2017;2017;10;09;Lauantai;1;2;3
93;14.10.2017;2017;10;10;Lauantai;9;5;14
93;14.10.2017;2017;10;11;Lauantai;8;8;16
93;14.10.2017;2017;10;12;Lauantai;8;12;20
93;14.10.2017;2017;10;13;Lauantai;6;9;15
93;14.10.2017;2017;10;14;Lauantai;9;13;22
93;14.10.2017;2017;10;15;Lauantai;4;6;10
93;14.10.2017;2017;10;16;Lauantai;5;8;13
93;14.10.2017;2017;10;17;Lauantai;1;0;1
93;14.10.2017;2017;10;18;Lauantai;2;5;7
93;14.10.2017;2017;10;19;Lauantai;4;1;5
93;14.10.2017;2017;10;20;Lauantai;0;3;3
93;14.10.2017;2017;10;21;Lauantai;1;1;2
93;14.10.2017;2017;10;22;Lauantai;1;1;2
93;14.10.2017;2017;10;23;Lauantai;1;1;2
93;15.10.2017;2017;10;00;Sunnuntai;0;1;1
93;15.10.2017;2017;10;01;Sunnuntai;2;0;2
93;15.10.2017;2017;10;02;Sunnuntai;0;1;1
93;15.10.2017;2017;10;03;Sunnuntai;0;0;0
93;15.10.2017;2017;10;04;Sunnuntai;0;0;0
93;15.10.2017;2017;10;05;Sunnuntai;1;0;1
93;15.10.2017;2017;10;06;Sunnuntai;1;0;1
93;15.10.2017;2017;10;07;Sunnuntai;2;1;3
93;15.10.2017;2017;10;08;Sunnuntai;1;2;3
93;15.10.2017;2017;10;09;Sunnuntai;0;2;2
93;15.10.2017;2017;10;10;Sunnuntai;13;6;19
93;15.10.2017;2017;10;11;Sunnuntai;5;4;9
93;15.10.2017;2017;10;12;Sunnuntai;6;0;6
93;15.10.2017;2017;10;13;Sunnuntai;10;18;28
93;15.10.2017;2017;10;14;Sunnuntai;16;12;28
93;15.10.2017;2017;10;15;Sunnuntai;13;15;28
93;15.10.2017;2017;10;16;Sunnuntai;12;18;30
93;15.10.2017;2017;10;17;Sunnuntai;15;7;22
93;15.10.2017;2017;10;18;Sunnuntai;6;8;14
93;15.10.2017;2017;10;19;Sunnuntai;5;6;11
93;15.10.2017;2017;10;20;Sunnuntai;2;5;7
93;15.10.2017;2017;10;21;Sunnuntai;2;3;5
93;15.10.2017;2017;10;22;Sunnuntai;1;0;1
93;15.10.2017;2017;10;23;Sunnuntai;3;0;3
93;16.10.2017;2017;10;00;Maanantai;1;0;1
93;16.10.2017;2017;10;01;Maanantai;1;0;1
93;16.10.2017;2017;10;02;Maanantai;0;0;0
93;16.10.2017;2017;10;03;Maanantai;0;0;0
93;16.10.2017;2017;10;04;Maanantai;0;0;0
93;16.10.2017;2017;10;05;Maanantai;2;3;5
93;16.10.2017;2017;10;06;Maanantai;9;8;17
93;16.10.2017;2017;10;07;Maanantai;14;15;29
93;16.10.2017;2017;10;08;Maanantai;8;17;25
93;16.10.2017;2017;10;09;Maanantai;6;4;10
93;16.10.2017;2017;10;10;Maanantai;0;0;0
93;16.10.2017;2017;10;11;Maanantai;0;3;3
93;16.10.2017;2017;10;12;Maanantai;1;0;1
93;16.10.2017;2017;10;13;Maanantai;1;0;1
93;16.10.2017;2017;10;14;Maanantai;7;4;11
93;16.10.2017;2017;10;15;Maanantai;13;15;28
93;16.10.2017;2017;10;16;Maanantai;26;18;44
93;16.10.2017;2017;10;17;Maanantai;10;7;17
93;16.10.2017;2017;10;18;Maanantai;4;8;12
93;16.10.2017;2017;10;19;Maanantai;2;0;2
93;16.10.2017;2017;10;20;Maanantai;8;3;11
93;16.10.2017;2017;10;21;Maanantai;1;1;2
93;16.10.2017;2017;10;22;Maanantai;1;1;2
93;16.10.2017;2017;10;23;Maanantai;1;1;2
93;17.10.2017;2017;10;00;Tiistai;0;0;0
93;17.10.2017;2017;10;01;Tiistai;0;0;0
93;17.10.2017;2017;10;02;Tiistai;0;0;0
93;17.10.2017;2017;10;03;Tiistai;0;0;0
93;17.10.2017;2017;10;04;Tiistai;2;0;2
93;17.10.2017;2017;10;05;Tiistai;1;2;3
93;17.10.2017;2017;10;06;Tiistai;15;9;24
93;17.10.2017;2017;10;07;Tiistai;22;31;53
93;17.10.2017;2017;10;08;Tiistai;12;16;28
93;17.10.2017;2017;10;09;Tiistai;9;7;16
93;17.10.2017;2017;10;10;Tiistai;11;4;15
93;17.10.2017;2017;10;11;Tiistai;10;6;16
93;17.10.2017;2017;10;12;Tiistai;5;4;9
93;17.10.2017;2017;10;13;Tiistai;10;8;18
93;17.10.2017;2017;10;14;Tiistai;17;30;47
93;17.10.2017;2017;10;15;Tiistai;27;25;52
93;17.10.2017;2017;10;16;Tiistai;21;31;52
93;17.10.2017;2017;10;17;Tiistai;22;8;30
93;17.10.2017;2017;10;18;Tiistai;4;10;14
93;17.10.2017;2017;10;19;Tiistai;9;6;15
93;17.10.2017;2017;10;20;Tiistai;6;6;12
93;17.10.2017;2017;10;21;Tiistai;1;5;6
93;17.10.2017;2017;10;22;Tiistai;0;1;1
93;17.10.2017;2017;10;23;Tiistai;1;1;2
93;18.10.2017;2017;10;00;Keskiviikko;0;0;0
93;18.10.2017;2017;10;01;Keskiviikko;0;0;0
93;18.10.2017;2017;10;02;Keskiviikko;0;0;0
93;18.10.2017;2017;10;03;Keskiviikko;0;0;0
93;18.10.2017;2017;10;04;Keskiviikko;1;1;2
93;18.10.2017;2017;10;05;Keskiviikko;5;4;9
93;18.10.2017;2017;10;06;Keskiviikko;10;5;15
93;18.10.2017;2017;10;07;Keskiviikko;20;27;47
93;18.10.2017;2017;10;08;Keskiviikko;15;14;29
93;18.10.2017;2017;10;09;Keskiviikko;4;6;10
93;18.10.2017;2017;10;10;Keskiviikko;2;7;9
93;18.10.2017;2017;10;11;Keskiviikko;5;5;10
93;18.10.2017;2017;10;12;Keskiviikko;7;5;12
93;18.10.2017;2017;10;13;Keskiviikko;9;4;13
93;18.10.2017;2017;10;14;Keskiviikko;20;10;30
93;18.10.2017;2017;10;15;Keskiviikko;20;23;43
93;18.10.2017;2017;10;16;Keskiviikko;25;25;50
93;18.10.2017;2017;10;17;Keskiviikko;7;8;15
93;18.10.2017;2017;10;18;Keskiviikko;10;18;28
93;18.10.2017;2017;10;19;Keskiviikko;2;5;7
93;18.10.2017;2017;10;20;Keskiviikko;3;3;6
93;18.10.2017;2017;10;21;Keskiviikko;7;10;17
93;18.10.2017;2017;10;22;Keskiviikko;0;3;3
93;18.10.2017;2017;10;23;Keskiviikko;0;0;0
93;19.10.2017;2017;10;00;Torstai;0;0;0
93;19.10.2017;2017;10;01;Torstai;0;0;0
93;19.10.2017;2017;10;02;Torstai;0;0;0
93;19.10.2017;2017;10;03;Torstai;0;0;0
93;19.10.2017;2017;10;04;Torstai;3;1;4
93;19.10.2017;2017;10;05;Torstai;1;5;6
93;19.10.2017;2017;10;06;Torstai;7;11;18
93;19.10.2017;2017;10;07;Torstai;13;17;30
93;19.10.2017;2017;10;08;Torstai;9;10;19
93;19.10.2017;2017;10;09;Torstai;6;10;16
93;19.10.2017;2017;10;10;Torstai;3;1;4
93;19.10.2017;2017;10;11;Torstai;6;12;18
93;19.10.2017;2017;10;12;Torstai;7;3;10
93;19.10.2017;2017;10;13;Torstai;9;5;14
93;19.10.2017;2017;10;14;Torstai;7;13;20
93;19.10.2017;2017;10;15;Torstai;17;17;34
93;19.10.2017;2017;10;16;Torstai;23;14;37
93;19.10.2017;2017;10;17;Torstai;8;10;18
93;19.10.2017;2017;10;18;Torstai;3;8;11
93;19.10.2017;2017;10;19;Torstai;6;3;9
93;19.10.2017;2017;10;20;Torstai;3;4;7
93;19.10.2017;2017;10;21;Torstai;3;1;4
93;19.10.2017;2017;10;22;Torstai;2;1;3
93;19.10.2017;2017;10;23;Torstai;1;2;3
93;20.10.2017;2017;10;00;Perjantai;0;0;0
93;20.10.2017;2017;10;01;Perjantai;0;0;0
93;20.10.2017;2017;10;02;Perjantai;0;1;1
93;20.10.2017;2017;10;03;Perjantai;0;0;0
93;20.10.2017;2017;10;04;Perjantai;1;0;1
93;20.10.2017;2017;10;05;Perjantai;1;3;4
93;20.10.2017;2017;10;06;Perjantai;7;9;16
93;20.10.2017;2017;10;07;Perjantai;12;17;29
93;20.10.2017;2017;10;08;Perjantai;7;13;20
93;20.10.2017;2017;10;09;Perjantai;7;3;10
93;20.10.2017;2017;10;10;Perjantai;3;3;6
93;20.10.2017;2017;10;11;Perjantai;1;5;6
93;20.10.2017;2017;10;12;Perjantai;3;2;5
93;20.10.2017;2017;10;13;Perjantai;4;4;8
93;20.10.2017;2017;10;14;Perjantai;10;8;18
93;20.10.2017;2017;10;15;Perjantai;14;11;25
93;20.10.2017;2017;10;16;Perjantai;21;12;33
93;20.10.2017;2017;10;17;Perjantai;5;6;11
93;20.10.2017;2017;10;18;Perjantai;5;6;11
93;20.10.2017;2017;10;19;Perjantai;3;3;6
93;20.10.2017;2017;10;20;Perjantai;1;1;2
93;20.10.2017;2017;10;21;Perjantai;1;0;1
93;20.10.2017;2017;10;22;Perjantai;1;0;1
93;20.10.2017;2017;10;23;Perjantai;2;2;4
93;21.10.2017;2017;10;00;Lauantai;0;1;1
93;21.10.2017;2017;10;01;Lauantai;0;0;0
93;21.10.2017;2017;10;02;Lauantai;0;0;0
93;21.10.2017;2017;10;03;Lauantai;0;1;1
93;21.10.2017;2017;10;04;Lauantai;0;1;1
93;21.10.2017;2017;10;05;Lauantai;0;0;0
93;21.10.2017;2017;10;06;Lauantai;0;0;0
93;21.10.2017;2017;10;07;Lauantai;2;0;2
93;21.10.2017;2017;10;08;Lauantai;2;2;4
93;21.10.2017;2017;10;09;Lauantai;1;0;1
93;21.10.2017;2017;10;10;Lauantai;1;0;1
93;21.10.2017;2017;10;11;Lauantai;0;3;3
93;21.10.2017;2017;10;12;Lauantai;5;1;6
93;21.10.2017;2017;10;13;Lauantai;2;2;4
93;21.10.2017;2017;10;14;Lauantai;5;3;8
93;21.10.2017;2017;10;15;Lauantai;5;4;9
93;21.10.2017;2017;10;16;Lauantai;5;3;8
93;21.10.2017;2017;10;17;Lauantai;5;2;7
93;21.10.2017;2017;10;18;Lauantai;3;3;6
93;21.10.2017;2017;10;19;Lauantai;5;2;7
93;21.10.2017;2017;10;20;Lauantai;1;0;1
93;21.10.2017;2017;10;21;Lauantai;2;2;4
93;21.10.2017;2017;10;22;Lauantai;2;1;3
93;21.10.2017;2017;10;23;Lauantai;1;0;1
93;22.10.2017;2017;10;00;Sunnuntai;0;4;4
93;22.10.2017;2017;10;01;Sunnuntai;0;0;0
93;22.10.2017;2017;10;02;Sunnuntai;1;1;2
93;22.10.2017;2017;10;03;Sunnuntai;0;1;1
93;22.10.2017;2017;10;04;Sunnuntai;0;1;1
93;22.10.2017;2017;10;05;Sunnuntai;1;0;1
93;22.10.2017;2017;10;06;Sunnuntai;0;0;0
93;22.10.2017;2017;10;07;Sunnuntai;0;1;1
93;22.10.2017;2017;10;08;Sunnuntai;0;1;1
93;22.10.2017;2017;10;09;Sunnuntai;9;3;12
93;22.10.2017;2017;10;10;Sunnuntai;3;2;5
93;22.10.2017;2017;10;11;Sunnuntai;11;0;11
93;22.10.2017;2017;10;12;Sunnuntai;4;9;13
93;22.10.2017;2017;10;13;Sunnuntai;6;12;18
93;22.10.2017;2017;10;14;Sunnuntai;4;3;7
93;22.10.2017;2017;10;15;Sunnuntai;3;6;9
93;22.10.2017;2017;10;16;Sunnuntai;4;4;8
93;22.10.2017;2017;10;17;Sunnuntai;5;5;10
93;22.10.2017;2017;10;18;Sunnuntai;1;8;9
93;22.10.2017;2017;10;19;Sunnuntai;1;0;1
93;22.10.2017;2017;10;20;Sunnuntai;2;0;2
93;22.10.2017;2017;10;21;Sunnuntai;0;2;2
93;22.10.2017;2017;10;22;Sunnuntai;3;0;3
93;22.10.2017;2017;10;23;Sunnuntai;1;1;2
93;23.10.2017;2017;10;00;Maanantai;0;0;0
93;23.10.2017;2017;10;01;Maanantai;0;1;1
93;23.10.2017;2017;10;02;Maanantai;0;0;0
93;23.10.2017;2017;10;03;Maanantai;0;0;0
93;23.10.2017;2017;10;04;Maanantai;0;0;0
93;23.10.2017;2017;10;05;Maanantai;5;4;9
93;23.10.2017;2017;10;06;Maanantai;8;5;13
93;23.10.2017;2017;10;07;Maanantai;6;12;18
93;23.10.2017;2017;10;08;Maanantai;9;14;23
93;23.10.2017;2017;10;09;Maanantai;4;3;7
93;23.10.2017;2017;10;10;Maanantai;3;2;5
93;23.10.2017;2017;10;11;Maanantai;4;1;5
93;23.10.2017;2017;10;12;Maanantai;6;7;13
93;23.10.2017;2017;10;13;Maanantai;6;7;13
93;23.10.2017;2017;10;14;Maanantai;8;9;17
93;23.10.2017;2017;10;15;Maanantai;8;15;23
93;23.10.2017;2017;10;16;Maanantai;18;9;27
93;23.10.2017;2017;10;17;Maanantai;15;5;20
93;23.10.2017;2017;10;18;Maanantai;4;4;8
93;23.10.2017;2017;10;19;Maanantai;3;3;6
93;23.10.2017;2017;10;20;Maanantai;0;2;2
93;23.10.2017;2017;10;21;Maanantai;2;3;5
93;23.10.2017;2017;10;22;Maanantai;0;0;0
93;23.10.2017;2017;10;23;Maanantai;0;1;1
93;24.10.2017;2017;10;00;Tiistai;0;0;0
93;24.10.2017;2017;10;01;Tiistai;0;0;0
93;24.10.2017;2017;10;02;Tiistai;0;0;0
93;24.10.2017;2017;10;03;Tiistai;0;0;0
93;24.10.2017;2017;10;04;Tiistai;1;0;1
93;24.10.2017;2017;10;05;Tiistai;4;2;6
93;24.10.2017;2017;10;06;Tiistai;6;8;14
93;24.10.2017;2017;10;07;Tiistai;11;12;23
93;24.10.2017;2017;10;08;Tiistai;5;11;16
93;24.10.2017;2017;10;09;Tiistai;4;1;5
93;24.10.2017;2017;10;10;Tiistai;8;4;12
93;24.10.2017;2017;10;11;Tiistai;6;2;8
93;24.10.2017;2017;10;12;Tiistai;2;6;8
93;24.10.2017;2017;10;13;Tiistai;4;2;6
93;24.10.2017;2017;10;14;Tiistai;4;6;10
93;24.10.2017;2017;10;15;Tiistai;10;10;20
93;24.10.2017;2017;10;16;Tiistai;14;15;29
93;24.10.2017;2017;10;17;Tiistai;12;7;19
93;24.10.2017;2017;10;18;Tiistai;4;2;6
93;24.10.2017;2017;10;19;Tiistai;3;4;7
93;24.10.2017;2017;10;20;Tiistai;1;4;5
93;24.10.2017;2017;10;21;Tiistai;0;1;1
93;24.10.2017;2017;10;22;Tiistai;3;2;5
93;24.10.2017;2017;10;23;Tiistai;0;0;0
93;25.10.2017;2017;10;00;Keskiviikko;0;1;1
93;25.10.2017;2017;10;01;Keskiviikko;2;0;2
93;25.10.2017;2017;10;02;Keskiviikko;0;1;1
93;25.10.2017;2017;10;03;Keskiviikko;0;0;0
93;25.10.2017;2017;10;04;Keskiviikko;0;0;0
93;25.10.2017;2017;10;05;Keskiviikko;4;3;7
93;25.10.2017;2017;10;06;Keskiviikko;5;10;15
93;25.10.2017;2017;10;07;Keskiviikko;7;11;18
93;25.10.2017;2017;10;08;Keskiviikko;4;4;8
93;25.10.2017;2017;10;09;Keskiviikko;1;2;3
93;25.10.2017;2017;10;10;Keskiviikko;4;2;6
93;25.10.2017;2017;10;11;Keskiviikko;4;1;5
93;25.10.2017;2017;10;12;Keskiviikko;3;5;8
93;25.10.2017;2017;10;13;Keskiviikko;3;2;5
93;25.10.2017;2017;10;14;Keskiviikko;6;4;10
93;25.10.2017;2017;10;15;Keskiviikko;8;9;17
93;25.10.2017;2017;10;16;Keskiviikko;20;11;31
93;25.10.2017;2017;10;17;Keskiviikko;9;7;16
93;25.10.2017;2017;10;18;Keskiviikko;4;8;12
93;25.10.2017;2017;10;19;Keskiviikko;5;2;7
93;25.10.2017;2017;10;20;Keskiviikko;1;1;2
93;25.10.2017;2017;10;21;Keskiviikko;3;5;8
93;25.10.2017;2017;10;22;Keskiviikko;2;1;3
93;25.10.2017;2017;10;23;Keskiviikko;0;0;0
93;26.10.2017;2017;10;00;Torstai;0;0;0
93;26.10.2017;2017;10;01;Torstai;0;0;0
93;26.10.2017;2017;10;02;Torstai;0;0;0
93;26.10.2017;2017;10;03;Torstai;0;0;0
93;26.10.2017;2017;10;04;Torstai;0;0;0
93;26.10.2017;2017;10;05;Torstai;2;3;5
93;26.10.2017;2017;10;06;Torstai;7;8;15
93;26.10.2017;2017;10;07;Torstai;6;16;22
93;26.10.2017;2017;10;08;Torstai;5;7;12
93;26.10.2017;2017;10;09;Torstai;2;3;5
93;26.10.2017;2017;10;10;Torstai;4;1;5
93;26.10.2017;2017;10;11;Torstai;8;4;12
93;26.10.2017;2017;10;12;Torstai;5;5;10
93;26.10.2017;2017;10;13;Torstai;1;5;6
93;26.10.2017;2017;10;14;Torstai;7;9;16
93;26.10.2017;2017;10;15;Torstai;10;8;18
93;26.10.2017;2017;10;16;Torstai;13;12;25
93;26.10.2017;2017;10;17;Torstai;9;7;16
93;26.10.2017;2017;10;18;Torstai;6;3;9
93;26.10.2017;2017;10;19;Torstai;4;3;7
93;26.10.2017;2017;10;20;Torstai;1;2;3
93;26.10.2017;2017;10;21;Torstai;0;2;2
93;26.10.2017;2017;10;22;Torstai;0;0;0
93;26.10.2017;2017;10;23;Torstai;1;3;4
93;27.10.2017;2017;10;00;Perjantai;0;0;0
93;27.10.2017;2017;10;01;Perjantai;0;0;0
93;27.10.2017;2017;10;02;Perjantai;0;0;0
93;27.10.2017;2017;10;03;Perjantai;0;0;0
93;27.10.2017;2017;10;04;Perjantai;1;0;1
93;27.10.2017;2017;10;05;Perjantai;4;6;10
93;27.10.2017;2017;10;06;Perjantai;4;4;8
93;27.10.2017;2017;10;07;Perjantai;6;14;20
93;27.10.2017;2017;10;08;Perjantai;4;8;12
93;27.10.2017;2017;10;09;Perjantai;0;2;2
93;27.10.2017;2017;10;10;Perjantai;3;2;5
93;27.10.2017;2017;10;11;Perjantai;3;2;5
93;27.10.2017;2017;10;12;Perjantai;3;2;5
93;27.10.2017;2017;10;13;Perjantai;8;2;10
93;27.10.2017;2017;10;14;Perjantai;6;7;13
93;27.10.2017;2017;10;15;Perjantai;11;16;27
93;27.10.2017;2017;10;16;Perjantai;14;4;18
93;27.10.2017;2017;10;17;Perjantai;10;4;14
93;27.10.2017;2017;10;18;Perjantai;2;9;11
93;27.10.2017;2017;10;19;Perjantai;2;2;4
93;27.10.2017;2017;10;20;Perjantai;4;0;4
93;27.10.2017;2017;10;21;Perjantai;0;1;1
93;27.10.2017;2017;10;22;Perjantai;1;0;1
93;27.10.2017;2017;10;23;Perjantai;0;1;1
93;28.10.2017;2017;10;00;Lauantai;2;0;2
93;28.10.2017;2017;10;01;Lauantai;0;0;0
93;28.10.2017;2017;10;02;Lauantai;0;1;1
93;28.10.2017;2017;10;03;Lauantai;0;0;0
93;28.10.2017;2017;10;04;Lauantai;0;0;0
93;28.10.2017;2017;10;05;Lauantai;0;1;1
93;28.10.2017;2017;10;06;Lauantai;0;0;0
93;28.10.2017;2017;10;07;Lauantai;3;0;3
93;28.10.2017;2017;10;08;Lauantai;0;0;0
93;28.10.2017;2017;10;09;Lauantai;2;0;2
93;28.10.2017;2017;10;10;Lauantai;4;2;6
93;28.10.2017;2017;10;11;Lauantai;1;2;3
93;28.10.2017;2017;10;12;Lauantai;4;0;4
93;28.10.2017;2017;10;13;Lauantai;2;3;5
93;28.10.2017;2017;10;14;Lauantai;2;1;3
93;28.10.2017;2017;10;15;Lauantai;2;4;6
93;28.10.2017;2017;10;16;Lauantai;0;2;2
93;28.10.2017;2017;10;17;Lauantai;0;0;0
93;28.10.2017;2017;10;18;Lauantai;2;1;3
93;28.10.2017;2017;10;19;Lauantai;0;3;3
93;28.10.2017;2017;10;20;Lauantai;1;0;1
93;28.10.2017;2017;10;21;Lauantai;0;1;1
93;28.10.2017;2017;10;22;Lauantai;2;2;4
93;28.10.2017;2017;10;23;Lauantai;0;1;1
93;29.10.2017;2017;10;00;Sunnuntai;0;0;0
93;29.10.2017;2017;10;01;Sunnuntai;0;0;0
93;29.10.2017;2017;10;02;Sunnuntai;0;1;1
93;29.10.2017;2017;10;03;Sunnuntai;0;0;0
93;29.10.2017;2017;10;04;Sunnuntai;0;0;0
93;29.10.2017;2017;10;05;Sunnuntai;0;0;0
93;29.10.2017;2017;10;06;Sunnuntai;0;0;0
93;29.10.2017;2017;10;07;Sunnuntai;0;1;1
93;29.10.2017;2017;10;08;Sunnuntai;0;0;0
93;29.10.2017;2017;10;09;Sunnuntai;1;0;1
93;29.10.2017;2017;10;10;Sunnuntai;0;0;0
93;29.10.2017;2017;10;11;Sunnuntai;3;4;7
93;29.10.2017;2017;10;12;Sunnuntai;0;2;2
93;29.10.2017;2017;10;13;Sunnuntai;1;1;2
93;29.10.2017;2017;10;14;Sunnuntai;3;2;5
93;29.10.2017;2017;10;15;Sunnuntai;0;2;2
93;29.10.2017;2017;10;16;Sunnuntai;0;0;0
93;29.10.2017;2017;10;17;Sunnuntai;0;3;3
93;29.10.2017;2017;10;18;Sunnuntai;0;1;1
93;29.10.2017;2017;10;19;Sunnuntai;3;0;3
93;29.10.2017;2017;10;20;Sunnuntai;2;1;3
93;29.10.2017;2017;10;21;Sunnuntai;0;1;1
93;29.10.2017;2017;10;22;Sunnuntai;0;1;1
93;29.10.2017;2017;10;23;Sunnuntai;0;0;0
93;30.10.2017;2017;10;00;Maanantai;0;1;1
93;30.10.2017;2017;10;01;Maanantai;0;0;0
93;30.10.2017;2017;10;02;Maanantai;0;0;0
93;30.10.2017;2017;10;03;Maanantai;0;1;1
93;30.10.2017;2017;10;04;Maanantai;0;0;0
93;30.10.2017;2017;10;05;Maanantai;4;2;6
93;30.10.2017;2017;10;06;Maanantai;6;7;13
93;30.10.2017;2017;10;07;Maanantai;11;15;26
93;30.10.2017;2017;10;08;Maanantai;9;15;24
93;30.10.2017;2017;10;09;Maanantai;4;2;6
93;30.10.2017;2017;10;10;Maanantai;1;5;6
93;30.10.2017;2017;10;11;Maanantai;2;2;4
93;30.10.2017;2017;10;12;Maanantai;2;0;2
93;30.10.2017;2017;10;13;Maanantai;1;5;6
93;30.10.2017;2017;10;14;Maanantai;6;3;9
93;30.10.2017;2017;10;15;Maanantai;12;14;26
93;30.10.2017;2017;10;16;Maanantai;21;15;36
93;30.10.2017;2017;10;17;Maanantai;9;5;14
93;30.10.2017;2017;10;18;Maanantai;1;5;6
93;30.10.2017;2017;10;19;Maanantai;3;1;4
93;30.10.2017;2017;10;20;Maanantai;1;0;1
93;30.10.2017;2017;10;21;Maanantai;0;3;3
93;30.10.2017;2017;10;22;Maanantai;1;1;2
93;30.10.2017;2017;10;23;Maanantai;1;0;1
93;31.10.2017;2017;10;00;Tiistai;1;0;1
93;31.10.2017;2017;10;01;Tiistai;0;0;0
93;31.10.2017;2017;10;02;Tiistai;0;0;0
93;31.10.2017;2017;10;03;Tiistai;0;0;0
93;31.10.2017;2017;10;04;Tiistai;0;0;0
93;31.10.2017;2017;10;05;Tiistai;2;3;5
93;31.10.2017;2017;10;06;Tiistai;6;10;16
93;31.10.2017;2017;10;07;Tiistai;11;19;30
93;31.10.2017;2017;10;08;Tiistai;2;13;15
93;31.10.2017;2017;10;09;Tiistai;6;2;8
93;31.10.2017;2017;10;10;Tiistai;4;2;6
93;31.10.2017;2017;10;11;Tiistai;2;2;4
93;31.10.2017;2017;10;12;Tiistai;5;5;10
93;31.10.2017;2017;10;13;Tiistai;3;3;6
93;31.10.2017;2017;10;14;Tiistai;11;6;17
93;31.10.2017;2017;10;15;Tiistai;9;10;19
93;31.10.2017;2017;10;16;Tiistai;19;13;32
93;31.10.2017;2017;10;17;Tiistai;5;3;8
93;31.10.2017;2017;10;18;Tiistai;5;5;10
93;31.10.2017;2017;10;19;Tiistai;4;3;7
93;31.10.2017;2017;10;20;Tiistai;1;2;3
93;31.10.2017;2017;10;21;Tiistai;1;1;2
93;31.10.2017;2017;10;22;Tiistai;0;1;1
93;31.10.2017;2017;10;23;Tiistai;1;0;1
93;01.11.2017;2017;11;00;Keskiviikko;1;0;1
93;01.11.2017;2017;11;01;Keskiviikko;0;0;0
93;01.11.2017;2017;11;02;Keskiviikko;0;0;0
93;01.11.2017;2017;11;03;Keskiviikko;0;0;0
93;01.11.2017;2017;11;04;Keskiviikko;0;0;0
93;01.11.2017;2017;11;05;Keskiviikko;2;2;4
93;01.11.2017;2017;11;06;Keskiviikko;6;6;12
93;01.11.2017;2017;11;07;Keskiviikko;12;20;32
93;01.11.2017;2017;11;08;Keskiviikko;8;8;16
93;01.11.2017;2017;11;09;Keskiviikko;3;3;6
93;01.11.2017;2017;11;10;Keskiviikko;1;2;3
93;01.11.2017;2017;11;11;Keskiviikko;2;0;2
93;01.11.2017;2017;11;12;Keskiviikko;6;2;8
93;01.11.2017;2017;11;13;Keskiviikko;1;1;2
93;01.11.2017;2017;11;14;Keskiviikko;8;4;12
93;01.11.2017;2017;11;15;Keskiviikko;5;10;15
93;01.11.2017;2017;11;16;Keskiviikko;16;10;26
93;01.11.2017;2017;11;17;Keskiviikko;5;0;5
93;01.11.2017;2017;11;18;Keskiviikko;3;5;8
93;01.11.2017;2017;11;19;Keskiviikko;3;3;6
93;01.11.2017;2017;11;20;Keskiviikko;0;3;3
93;01.11.2017;2017;11;21;Keskiviikko;2;3;5
93;01.11.2017;2017;11;22;Keskiviikko;0;1;1
93;01.11.2017;2017;11;23;Keskiviikko;0;1;1
93;02.11.2017;2017;11;00;Torstai;0;0;0
93;02.11.2017;2017;11;01;Torstai;0;0;0
93;02.11.2017;2017;11;02;Torstai;0;0;0
93;02.11.2017;2017;11;03;Torstai;0;0;0
93;02.11.2017;2017;11;04;Torstai;0;0;0
93;02.11.2017;2017;11;05;Torstai;2;3;5
93;02.11.2017;2017;11;06;Torstai;7;8;15
93;02.11.2017;2017;11;07;Torstai;6;16;22
93;02.11.2017;2017;11;08;Torstai;5;7;12
93;02.11.2017;2017;11;09;Torstai;2;3;5
93;02.11.2017;2017;11;10;Torstai;4;1;5
93;02.11.2017;2017;11;11;Torstai;8;4;12
93;02.11.2017;2017;11;12;Torstai;5;5;10
93;02.11.2017;2017;11;13;Torstai;1;5;6
93;02.11.2017;2017;11;14;Torstai;7;9;16
93;02.11.2017;2017;11;15;Torstai;10;8;18
93;02.11.2017;2017;11;16;Torstai;13;12;25
93;02.11.2017;2017;11;17;Torstai;9;7;16
93;02.11.2017;2017;11;18;Torstai;6;3;9
93;02.11.2017;2017;11;19;Torstai;4;3;7
93;02.11.2017;2017;11;20;Torstai;1;2;3
93;02.11.2017;2017;11;21;Torstai;0;2;2
93;02.11.2017;2017;11;22;Torstai;0;0;0
93;02.11.2017;2017;11;23;Torstai;1;3;4
93;03.11.2017;2017;11;00;Perjantai;0;0;0
93;03.11.2017;2017;11;01;Perjantai;0;0;0
93;03.11.2017;2017;11;02;Perjantai;0;0;0
93;03.11.2017;2017;11;03;Perjantai;0;0;0
93;03.11.2017;2017;11;04;Perjantai;1;0;1
93;03.11.2017;2017;11;05;Perjantai;3;2;5
93;03.11.2017;2017;11;06;Perjantai;2;4;6
93;03.11.2017;2017;11;07;Perjantai;12;16;28
93;03.11.2017;2017;11;08;Perjantai;2;11;13
93;03.11.2017;2017;11;09;Perjantai;8;1;9
93;03.11.2017;2017;11;10;Perjantai;2;4;6
93;03.11.2017;2017;11;11;Perjantai;1;1;2
93;03.11.2017;2017;11;12;Perjantai;3;12;15
93;03.11.2017;2017;11;13;Perjantai;5;2;7
93;03.11.2017;2017;11;14;Perjantai;10;10;20
93;03.11.2017;2017;11;15;Perjantai;5;8;13
93;03.11.2017;2017;11;16;Perjantai;9;4;13
93;03.11.2017;2017;11;17;Perjantai;7;6;13
93;03.11.2017;2017;11;18;Perjantai;6;3;9
93;03.11.2017;2017;11;19;Perjantai;1;1;2
93;03.11.2017;2017;11;20;Perjantai;1;4;5
93;03.11.2017;2017;11;21;Perjantai;0;1;1
93;03.11.2017;2017;11;22;Perjantai;0;1;1
93;03.11.2017;2017;11;23;Perjantai;2;0;2
93;04.11.2017;2017;11;00;Lauantai;0;0;0
93;04.11.2017;2017;11;01;Lauantai;2;0;2
93;04.11.2017;2017;11;02;Lauantai;0;0;0
93;04.11.2017;2017;11;03;Lauantai;0;0;0
93;04.11.2017;2017;11;04;Lauantai;0;0;0
93;04.11.2017;2017;11;05;Lauantai;1;0;1
93;04.11.2017;2017;11;06;Lauantai;0;0;0
93;04.11.2017;2017;11;07;Lauantai;0;0;0
93;04.11.2017;2017;11;08;Lauantai;0;1;1
93;04.11.2017;2017;11;09;Lauantai;1;0;1
93;04.11.2017;2017;11;10;Lauantai;0;3;3
93;04.11.2017;2017;11;11;Lauantai;6;2;8
93;04.11.2017;2017;11;12;Lauantai;5;3;8
93;04.11.2017;2017;11;13;Lauantai;7;0;7
93;04.11.2017;2017;11;14;Lauantai;0;5;5
93;04.11.2017;2017;11;15;Lauantai;2;3;5
93;04.11.2017;2017;11;16;Lauantai;3;0;3
93;04.11.2017;2017;11;17;Lauantai;2;1;3
93;04.11.2017;2017;11;18;Lauantai;2;1;3
93;04.11.2017;2017;11;19;Lauantai;0;3;3
93;04.11.2017;2017;11;20;Lauantai;0;1;1
93;04.11.2017;2017;11;21;Lauantai;1;2;3
93;04.11.2017;2017;11;22;Lauantai;0;0;0
93;04.11.2017;2017;11;23;Lauantai;1;1;2
93;05.11.2017;2017;11;00;Sunnuntai;0;0;0
93;05.11.2017;2017;11;01;Sunnuntai;1;0;1
93;05.11.2017;2017;11;02;Sunnuntai;0;1;1
93;05.11.2017;2017;11;03;Sunnuntai;0;0;0
93;05.11.2017;2017;11;04;Sunnuntai;0;0;0
93;05.11.2017;2017;11;05;Sunnuntai;0;0;0
93;05.11.2017;2017;11;06;Sunnuntai;0;1;1
93;05.11.2017;2017;11;07;Sunnuntai;0;0;0
93;05.11.2017;2017;11;08;Sunnuntai;1;1;2
93;05.11.2017;2017;11;09;Sunnuntai;4;2;6
93;05.11.2017;2017;11;10;Sunnuntai;1;2;3
93;05.11.2017;2017;11;11;Sunnuntai;10;1;11
93;05.11.2017;2017;11;12;Sunnuntai;8;3;11
93;05.11.2017;2017;11;13;Sunnuntai;3;10;13
93;05.11.2017;2017;11;14;Sunnuntai;4;4;8
93;05.11.2017;2017;11;15;Sunnuntai;3;6;9
93;05.11.2017;2017;11;16;Sunnuntai;5;0;5
93;05.11.2017;2017;11;17;Sunnuntai;4;2;6
93;05.11.2017;2017;11;18;Sunnuntai;2;3;5
93;05.11.2017;2017;11;19;Sunnuntai;1;1;2
93;05.11.2017;2017;11;20;Sunnuntai;1;2;3
93;05.11.2017;2017;11;21;Sunnuntai;0;1;1
93;05.11.2017;2017;11;22;Sunnuntai;2;0;2
93;05.11.2017;2017;11;23;Sunnuntai;0;0;0
93;06.11.2017;2017;11;00;Maanantai;0;0;0
93;06.11.2017;2017;11;01;Maanantai;0;0;0
93;06.11.2017;2017;11;02;Maanantai;0;0;0
93;06.11.2017;2017;11;03;Maanantai;0;0;0
93;06.11.2017;2017;11;04;Maanantai;0;0;0
93;06.11.2017;2017;11;05;Maanantai;2;3;5
93;06.11.2017;2017;11;06;Maanantai;7;7;14
93;06.11.2017;2017;11;07;Maanantai;10;14;24
93;06.11.2017;2017;11;08;Maanantai;10;13;23
93;06.11.2017;2017;11;09;Maanantai;6;2;8
93;06.11.2017;2017;11;10;Maanantai;6;2;8
93;06.11.2017;2017;11;11;Maanantai;2;5;7
93;06.11.2017;2017;11;12;Maanantai;0;7;7
93;06.11.2017;2017;11;13;Maanantai;5;3;8
93;06.11.2017;2017;11;14;Maanantai;6;3;9
93;06.11.2017;2017;11;15;Maanantai;17;11;28
93;06.11.2017;2017;11;16;Maanantai;15;18;33
93;06.11.2017;2017;11;17;Maanantai;10;9;19
93;06.11.2017;2017;11;18;Maanantai;6;7;13
93;06.11.2017;2017;11;19;Maanantai;2;4;6
93;06.11.2017;2017;11;20;Maanantai;2;0;2
93;06.11.2017;2017;11;21;Maanantai;1;2;3
93;06.11.2017;2017;11;22;Maanantai;1;2;3
93;06.11.2017;2017;11;23;Maanantai;0;0;0
93;07.11.2017;2017;11;00;Tiistai;0;0;0
93;07.11.2017;2017;11;01;Tiistai;0;0;0
93;07.11.2017;2017;11;02;Tiistai;0;0;0
93;07.11.2017;2017;11;03;Tiistai;0;0;0
93;07.11.2017;2017;11;04;Tiistai;0;1;1
93;07.11.2017;2017;11;05;Tiistai;1;4;5
93;07.11.2017;2017;11;06;Tiistai;7;8;15
93;07.11.2017;2017;11;07;Tiistai;14;14;28
93;07.11.2017;2017;11;08;Tiistai;7;14;21
93;07.11.2017;2017;11;09;Tiistai;6;5;11
93;07.11.2017;2017;11;10;Tiistai;4;2;6
93;07.11.2017;2017;11;11;Tiistai;2;7;9
93;07.11.2017;2017;11;12;Tiistai;4;3;7
93;07.11.2017;2017;11;13;Tiistai;7;6;13
93;07.11.2017;2017;11;14;Tiistai;7;8;15
93;07.11.2017;2017;11;15;Tiistai;11;6;17
93;07.11.2017;2017;11;16;Tiistai;24;17;41
93;07.11.2017;2017;11;17;Tiistai;9;11;20
93;07.11.2017;2017;11;18;Tiistai;0;2;2
93;07.11.2017;2017;11;19;Tiistai;1;6;7
93;07.11.2017;2017;11;20;Tiistai;2;2;4
93;07.11.2017;2017;11;21;Tiistai;1;1;2
93;07.11.2017;2017;11;22;Tiistai;0;1;1
93;07.11.2017;2017;11;23;Tiistai;0;0;0
93;08.11.2017;2017;11;00;Keskiviikko;0;0;0
93;08.11.2017;2017;11;01;Keskiviikko;0;0;0
93;08.11.2017;2017;11;02;Keskiviikko;0;0;0
93;08.11.2017;2017;11;03;Keskiviikko;0;0;0
93;08.11.2017;2017;11;04;Keskiviikko;0;0;0
93;08.11.2017;2017;11;05;Keskiviikko;2;3;5
93;08.11.2017;2017;11;06;Keskiviikko;6;8;14
93;08.11.2017;2017;11;07;Keskiviikko;16;13;29
93;08.11.2017;2017;11;08;Keskiviikko;10;6;16
93;08.11.2017;2017;11;09;Keskiviikko;6;4;10
93;08.11.2017;2017;11;10;Keskiviikko;2;1;3
93;08.11.2017;2017;11;11;Keskiviikko;2;4;6
93;08.11.2017;2017;11;12;Keskiviikko;5;6;11
93;08.11.2017;2017;11;13;Keskiviikko;4;5;9
93;08.11.2017;2017;11;14;Keskiviikko;9;7;16
93;08.11.2017;2017;11;15;Keskiviikko;9;9;18
93;08.11.2017;2017;11;16;Keskiviikko;13;13;26
93;08.11.2017;2017;11;17;Keskiviikko;12;7;19
93;08.11.2017;2017;11;18;Keskiviikko;5;5;10
93;08.11.2017;2017;11;19;Keskiviikko;7;4;11
93;08.11.2017;2017;11;20;Keskiviikko;0;4;4
93;08.11.2017;2017;11;21;Keskiviikko;0;5;5
93;08.11.2017;2017;11;22;Keskiviikko;0;0;0
93;08.11.2017;2017;11;23;Keskiviikko;1;0;1
93;09.11.2017;2017;11;00;Torstai;0;0;0
93;09.11.2017;2017;11;01;Torstai;0;0;0
93;09.11.2017;2017;11;02;Torstai;0;0;0
93;09.11.2017;2017;11;03;Torstai;0;0;0
93;09.11.2017;2017;11;04;Torstai;1;0;1
93;09.11.2017;2017;11;05;Torstai;3;3;6
93;09.11.2017;2017;11;06;Torstai;6;10;16
93;09.11.2017;2017;11;07;Torstai;18;15;33
93;09.11.2017;2017;11;08;Torstai;8;17;25
93;09.11.2017;2017;11;09;Torstai;8;1;9
93;09.11.2017;2017;11;10;Torstai;5;3;8
93;09.11.2017;2017;11;11;Torstai;6;3;9
93;09.11.2017;2017;11;12;Torstai;4;11;15
93;09.11.2017;2017;11;13;Torstai;4;5;9
93;09.11.2017;2017;11;14;Torstai;2;7;9
93;09.11.2017;2017;11;15;Torstai;10;10;20
93;09.11.2017;2017;11;16;Torstai;22;17;39
93;09.11.2017;2017;11;17;Torstai;9;7;16
93;09.11.2017;2017;11;18;Torstai;5;3;8
93;09.11.2017;2017;11;19;Torstai;1;1;2
93;09.11.2017;2017;11;20;Torstai;2;1;3
93;09.11.2017;2017;11;21;Torstai;2;2;4
93;09.11.2017;2017;11;22;Torstai;1;0;1
93;09.11.2017;2017;11;23;Torstai;0;2;2
93;10.11.2017;2017;11;00;Perjantai;0;0;0
93;10.11.2017;2017;11;01;Perjantai;1;0;1
93;10.11.2017;2017;11;02;Perjantai;0;0;0
93;10.11.2017;2017;11;03;Perjantai;0;0;0
93;10.11.2017;2017;11;04;Perjantai;1;0;1
93;10.11.2017;2017;11;05;Perjantai;4;4;8
93;10.11.2017;2017;11;06;Perjantai;5;6;11
93;10.11.2017;2017;11;07;Perjantai;13;22;35
93;10.11.2017;2017;11;08;Perjantai;5;8;13
93;10.11.2017;2017;11;09;Perjantai;5;8;13
93;10.11.2017;2017;11;10;Perjantai;7;5;12
93;10.11.2017;2017;11;11;Perjantai;3;1;4
93;10.11.2017;2017;11;12;Perjantai;6;12;18
93;10.11.2017;2017;11;13;Perjantai;6;5;11
93;10.11.2017;2017;11;14;Perjantai;11;7;18
93;10.11.2017;2017;11;15;Perjantai;14;13;27
93;10.11.2017;2017;11;16;Perjantai;14;4;18
93;10.11.2017;2017;11;17;Perjantai;12;5;17
93;10.11.2017;2017;11;18;Perjantai;2;3;5
93;10.11.2017;2017;11;19;Perjantai;6;1;7
93;10.11.2017;2017;11;20;Perjantai;1;3;4
93;10.11.2017;2017;11;21;Perjantai;1;3;4
93;10.11.2017;2017;11;22;Perjantai;0;1;1
93;10.11.2017;2017;11;23;Perjantai;0;0;0
93;11.11.2017;2017;11;00;Lauantai;1;0;1
93;11.11.2017;2017;11;01;Lauantai;0;0;0
93;11.11.2017;2017;11;02;Lauantai;0;1;1
93;11.11.2017;2017;11;03;Lauantai;0;0;0
93;11.11.2017;2017;11;04;Lauantai;0;0;0
93;11.11.2017;2017;11;05;Lauantai;0;0;0
93;11.11.2017;2017;11;06;Lauantai;0;1;1
93;11.11.2017;2017;11;07;Lauantai;3;1;4
93;11.11.2017;2017;11;08;Lauantai;0;0;0
93;11.11.2017;2017;11;09;Lauantai;4;6;10
93;11.11.2017;2017;11;10;Lauantai;2;4;6
93;11.11.2017;2017;11;11;Lauantai;6;6;12
93;11.11.2017;2017;11;12;Lauantai;5;8;13
93;11.11.2017;2017;11;13;Lauantai;3;7;10
93;11.11.2017;2017;11;14;Lauantai;8;4;12
93;11.11.2017;2017;11;15;Lauantai;6;7;13
93;11.11.2017;2017;11;16;Lauantai;5;6;11
93;11.11.2017;2017;11;17;Lauantai;3;6;9
93;11.11.2017;2017;11;18;Lauantai;2;4;6
93;11.11.2017;2017;11;19;Lauantai;2;2;4
93;11.11.2017;2017;11;20;Lauantai;1;2;3
93;11.11.2017;2017;11;21;Lauantai;0;1;1
93;11.11.2017;2017;11;22;Lauantai;2;1;3
93;11.11.2017;2017;11;23;Lauantai;2;0;2
93;12.11.2017;2017;11;00;Sunnuntai;2;0;2
93;12.11.2017;2017;11;01;Sunnuntai;0;0;0
93;12.11.2017;2017;11;02;Sunnuntai;0;0;0
93;12.11.2017;2017;11;03;Sunnuntai;1;0;1
93;12.11.2017;2017;11;04;Sunnuntai;0;0;0
93;12.11.2017;2017;11;05;Sunnuntai;1;0;1
93;12.11.2017;2017;11;06;Sunnuntai;0;1;1
93;12.11.2017;2017;11;07;Sunnuntai;0;1;1
93;12.11.2017;2017;11;08;Sunnuntai;1;1;2
93;12.11.2017;2017;11;09;Sunnuntai;4;1;5
93;12.11.2017;2017;11;10;Sunnuntai;3;6;9
93;12.11.2017;2017;11;11;Sunnuntai;6;2;8
93;12.11.2017;2017;11;12;Sunnuntai;3;11;14
93;12.11.2017;2017;11;13;Sunnuntai;7;6;13
93;12.11.2017;2017;11;14;Sunnuntai;6;6;12
93;12.11.2017;2017;11;15;Sunnuntai;2;5;7
93;12.11.2017;2017;11;16;Sunnuntai;6;3;9
93;12.11.2017;2017;11;17;Sunnuntai;4;3;7
93;12.11.2017;2017;11;18;Sunnuntai;2;3;5
93;12.11.2017;2017;11;19;Sunnuntai;0;2;2
93;12.11.2017;2017;11;20;Sunnuntai;1;3;4
93;12.11.2017;2017;11;21;Sunnuntai;1;2;3
93;12.11.2017;2017;11;22;Sunnuntai;4;1;5
93;12.11.2017;2017;11;23;Sunnuntai;0;1;1
93;13.11.2017;2017;11;00;Maanantai;0;0;0
93;13.11.2017;2017;11;01;Maanantai;0;0;0
93;13.11.2017;2017;11;02;Maanantai;0;0;0
93;13.11.2017;2017;11;03;Maanantai;0;0;0
93;13.11.2017;2017;11;04;Maanantai;0;0;0
93;13.11.2017;2017;11;05;Maanantai;3;3;6
93;13.11.2017;2017;11;06;Maanantai;8;9;17
93;13.11.2017;2017;11;07;Maanantai;12;17;29
93;13.11.2017;2017;11;08;Maanantai;8;15;23
93;13.11.2017;2017;11;09;Maanantai;4;4;8
93;13.11.2017;2017;11;10;Maanantai;4;5;9
93;13.11.2017;2017;11;11;Maanantai;3;3;6
93;13.11.2017;2017;11;12;Maanantai;4;2;6
93;13.11.2017;2017;11;13;Maanantai;5;10;15
93;13.11.2017;2017;11;14;Maanantai;10;4;14
93;13.11.2017;2017;11;15;Maanantai;10;12;22
93;13.11.2017;2017;11;16;Maanantai;26;17;43
93;13.11.2017;2017;11;17;Maanantai;8;9;17
93;13.11.2017;2017;11;18;Maanantai;6;7;13
93;13.11.2017;2017;11;19;Maanantai;3;0;3
93;13.11.2017;2017;11;20;Maanantai;0;0;0
93;13.11.2017;2017;11;21;Maanantai;2;1;3
93;13.11.2017;2017;11;22;Maanantai;1;0;1
93;13.11.2017;2017;11;23;Maanantai;0;0;0
93;14.11.2017;2017;11;00;Tiistai;1;0;1
93;14.11.2017;2017;11;01;Tiistai;0;0;0
93;14.11.2017;2017;11;02;Tiistai;0;0;0
93;14.11.2017;2017;11;03;Tiistai;0;0;0
93;14.11.2017;2017;11;04;Tiistai;0;0;0
93;14.11.2017;2017;11;05;Tiistai;2;3;5
93;14.11.2017;2017;11;06;Tiistai;7;9;16
93;14.11.2017;2017;11;07;Tiistai;17;14;31
93;14.11.2017;2017;11;08;Tiistai;5;15;20
93;14.11.2017;2017;11;09;Tiistai;3;2;5
93;14.11.2017;2017;11;10;Tiistai;1;3;4
93;14.11.2017;2017;11;11;Tiistai;2;2;4
93;14.11.2017;2017;11;12;Tiistai;4;1;5
93;14.11.2017;2017;11;13;Tiistai;6;2;8
93;14.11.2017;2017;11;14;Tiistai;4;5;9
93;14.11.2017;2017;11;15;Tiistai;12;11;23
93;14.11.2017;2017;11;16;Tiistai;21;10;31
93;14.11.2017;2017;11;17;Tiistai;8;9;17
93;14.11.2017;2017;11;18;Tiistai;5;8;13
93;14.11.2017;2017;11;19;Tiistai;5;1;6
93;14.11.2017;2017;11;20;Tiistai;1;3;4
93;14.11.2017;2017;11;21;Tiistai;1;2;3
93;14.11.2017;2017;11;22;Tiistai;1;3;4
93;14.11.2017;2017;11;23;Tiistai;0;1;1
93;15.11.2017;2017;11;00;Keskiviikko;0;0;0
93;15.11.2017;2017;11;01;Keskiviikko;0;0;0
93;15.11.2017;2017;11;02;Keskiviikko;0;0;0
93;15.11.2017;2017;11;03;Keskiviikko;0;0;0
93;15.11.2017;2017;11;04;Keskiviikko;0;0;0
93;15.11.2017;2017;11;05;Keskiviikko;2;3;5
93;15.11.2017;2017;11;06;Keskiviikko;6;8;14
93;15.11.2017;2017;11;07;Keskiviikko;16;13;29
93;15.11.2017;2017;11;08;Keskiviikko;10;6;16
93;15.11.2017;2017;11;09;Keskiviikko;6;4;10
93;15.11.2017;2017;11;10;Keskiviikko;2;1;3
93;15.11.2017;2017;11;11;Keskiviikko;2;4;6
93;15.11.2017;2017;11;12;Keskiviikko;5;6;11
93;15.11.2017;2017;11;13;Keskiviikko;4;5;9
93;15.11.2017;2017;11;14;Keskiviikko;9;7;16
93;15.11.2017;2017;11;15;Keskiviikko;9;9;18
93;15.11.2017;2017;11;16;Keskiviikko;13;13;26
93;15.11.2017;2017;11;17;Keskiviikko;12;7;19
93;15.11.2017;2017;11;18;Keskiviikko;5;5;10
93;15.11.2017;2017;11;19;Keskiviikko;7;4;11
93;15.11.2017;2017;11;20;Keskiviikko;0;4;4
93;15.11.2017;2017;11;21;Keskiviikko;0;5;5
93;15.11.2017;2017;11;22;Keskiviikko;0;0;0
93;15.11.2017;2017;11;23;Keskiviikko;1;0;1
93;16.11.2017;2017;11;00;Torstai;0;0;0
93;16.11.2017;2017;11;01;Torstai;0;0;0
93;16.11.2017;2017;11;02;Torstai;0;0;0
93;16.11.2017;2017;11;03;Torstai;0;0;0
93;16.11.2017;2017;11;04;Torstai;1;0;1
93;16.11.2017;2017;11;05;Torstai;3;3;6
93;16.11.2017;2017;11;06;Torstai;6;10;16
93;16.11.2017;2017;11;07;Torstai;18;15;33
93;16.11.2017;2017;11;08;Torstai;8;17;25
93;16.11.2017;2017;11;09;Torstai;8;1;9
93;16.11.2017;2017;11;10;Torstai;5;3;8
93;16.11.2017;2017;11;11;Torstai;6;3;9
93;16.11.2017;2017;11;12;Torstai;4;11;15
93;16.11.2017;2017;11;13;Torstai;4;5;9
93;16.11.2017;2017;11;14;Torstai;2;7;9
93;16.11.2017;2017;11;15;Torstai;10;10;20
93;16.11.2017;2017;11;16;Torstai;22;17;39
93;16.11.2017;2017;11;17;Torstai;9;7;16
93;16.11.2017;2017;11;18;Torstai;5;3;8
93;16.11.2017;2017;11;19;Torstai;1;1;2
93;16.11.2017;2017;11;20;Torstai;2;1;3
93;16.11.2017;2017;11;21;Torstai;2;2;4
93;16.11.2017;2017;11;22;Torstai;1;0;1
93;16.11.2017;2017;11;23;Torstai;0;2;2
93;17.11.2017;2017;11;00;Perjantai;1;0;1
93;17.11.2017;2017;11;01;Perjantai;0;0;0
93;17.11.2017;2017;11;02;Perjantai;0;0;0
93;17.11.2017;2017;11;03;Perjantai;0;0;0
93;17.11.2017;2017;11;04;Perjantai;0;0;0
93;17.11.2017;2017;11;05;Perjantai;1;2;3
93;17.11.2017;2017;11;06;Perjantai;6;4;10
93;17.11.2017;2017;11;07;Perjantai;13;15;28
93;17.11.2017;2017;11;08;Perjantai;3;7;10
93;17.11.2017;2017;11;09;Perjantai;4;2;6
93;17.11.2017;2017;11;10;Perjantai;2;5;7
93;17.11.2017;2017;11;11;Perjantai;2;1;3
93;17.11.2017;2017;11;12;Perjantai;3;4;7
93;17.11.2017;2017;11;13;Perjantai;0;1;1
93;17.11.2017;2017;11;14;Perjantai;7;2;9
93;17.11.2017;2017;11;15;Perjantai;8;7;15
93;17.11.2017;2017;11;16;Perjantai;10;4;14
93;17.11.2017;2017;11;17;Perjantai;6;1;7
93;17.11.2017;2017;11;18;Perjantai;1;5;6
93;17.11.2017;2017;11;19;Perjantai;1;2;3
93;17.11.2017;2017;11;20;Perjantai;2;4;6
93;17.11.2017;2017;11;21;Perjantai;1;2;3
93;17.11.2017;2017;11;22;Perjantai;0;0;0
93;17.11.2017;2017;11;23;Perjantai;0;0;0
93;18.11.2017;2017;11;00;Lauantai;0;0;0
93;18.11.2017;2017;11;01;Lauantai;2;1;3
93;18.11.2017;2017;11;02;Lauantai;0;0;0
93;18.11.2017;2017;11;03;Lauantai;0;0;0
93;18.11.2017;2017;11;04;Lauantai;0;0;0
93;18.11.2017;2017;11;05;Lauantai;1;0;1
93;18.11.2017;2017;11;06;Lauantai;0;0;0
93;18.11.2017;2017;11;07;Lauantai;1;0;1
93;18.11.2017;2017;11;08;Lauantai;0;0;0
93;18.11.2017;2017;11;09;Lauantai;2;0;2
93;18.11.2017;2017;11;10;Lauantai;3;0;3
93;18.11.2017;2017;11;11;Lauantai;0;2;2
93;18.11.2017;2017;11;12;Lauantai;1;2;3
93;18.11.2017;2017;11;13;Lauantai;3;0;3
93;18.11.2017;2017;11;14;Lauantai;0;4;4
93;18.11.2017;2017;11;15;Lauantai;3;2;5
93;18.11.2017;2017;11;16;Lauantai;4;2;6
93;18.11.2017;2017;11;17;Lauantai;1;1;2
93;18.11.2017;2017;11;18;Lauantai;2;3;5
93;18.11.2017;2017;11;19;Lauantai;0;0;0
93;18.11.2017;2017;11;20;Lauantai;1;1;2
93;18.11.2017;2017;11;21;Lauantai;0;0;0
93;18.11.2017;2017;11;22;Lauantai;1;0;1
93;18.11.2017;2017;11;23;Lauantai;0;0;0
93;19.11.2017;2017;11;00;Sunnuntai;0;4;4
93;19.11.2017;2017;11;01;Sunnuntai;1;1;2
93;19.11.2017;2017;11;02;Sunnuntai;0;0;0
93;19.11.2017;2017;11;03;Sunnuntai;0;0;0
93;19.11.2017;2017;11;04;Sunnuntai;0;0;0
93;19.11.2017;2017;11;05;Sunnuntai;2;0;2
93;19.11.2017;2017;11;06;Sunnuntai;0;0;0
93;19.11.2017;2017;11;07;Sunnuntai;1;0;1
93;19.11.2017;2017;11;08;Sunnuntai;0;0;0
93;19.11.2017;2017;11;09;Sunnuntai;2;0;2
93;19.11.2017;2017;11;10;Sunnuntai;3;3;6
93;19.11.2017;2017;11;11;Sunnuntai;3;2;5
93;19.11.2017;2017;11;12;Sunnuntai;1;6;7
93;19.11.2017;2017;11;13;Sunnuntai;4;2;6
93;19.11.2017;2017;11;14;Sunnuntai;0;3;3
93;19.11.2017;2017;11;15;Sunnuntai;2;2;4
93;19.11.2017;2017;11;16;Sunnuntai;2;0;2
93;19.11.2017;2017;11;17;Sunnuntai;0;0;0
93;19.11.2017;2017;11;18;Sunnuntai;1;1;2
93;19.11.2017;2017;11;19;Sunnuntai;3;0;3
93;19.11.2017;2017;11;20;Sunnuntai;0;0;0
93;19.11.2017;2017;11;21;Sunnuntai;0;5;5
93;19.11.2017;2017;11;22;Sunnuntai;0;2;2
93;19.11.2017;2017;11;23;Sunnuntai;0;0;0
93;20.11.2017;2017;11;00;Maanantai;0;0;0
93;20.11.2017;2017;11;01;Maanantai;0;0;0
93;20.11.2017;2017;11;02;Maanantai;0;0;0
93;20.11.2017;2017;11;03;Maanantai;0;0;0
93;20.11.2017;2017;11;04;Maanantai;0;0;0
93;20.11.2017;2017;11;05;Maanantai;4;2;6
93;20.11.2017;2017;11;06;Maanantai;5;7;12
93;20.11.2017;2017;11;07;Maanantai;11;16;27
93;20.11.2017;2017;11;08;Maanantai;7;9;16
93;20.11.2017;2017;11;09;Maanantai;5;2;7
93;20.11.2017;2017;11;10;Maanantai;1;3;4
93;20.11.2017;2017;11;11;Maanantai;5;4;9
93;20.11.2017;2017;11;12;Maanantai;4;1;5
93;20.11.2017;2017;11;13;Maanantai;1;2;3
93;20.11.2017;2017;11;14;Maanantai;6;7;13
93;20.11.2017;2017;11;15;Maanantai;12;5;17
93;20.11.2017;2017;11;16;Maanantai;15;18;33
93;20.11.2017;2017;11;17;Maanantai;4;4;8
93;20.11.2017;2017;11;18;Maanantai;2;8;10
93;20.11.2017;2017;11;19;Maanantai;3;1;4
93;20.11.2017;2017;11;20;Maanantai;0;2;2
93;20.11.2017;2017;11;21;Maanantai;0;1;1
93;20.11.2017;2017;11;22;Maanantai;0;1;1
93;20.11.2017;2017;11;23;Maanantai;2;0;2
93;21.11.2017;2017;11;00;Tiistai;0;0;0
93;21.11.2017;2017;11;01;Tiistai;0;0;0
93;21.11.2017;2017;11;02;Tiistai;0;0;0
93;21.11.2017;2017;11;03;Tiistai;0;0;0
93;21.11.2017;2017;11;04;Tiistai;0;0;0
93;21.11.2017;2017;11;05;Tiistai;4;2;6
93;21.11.2017;2017;11;06;Tiistai;9;8;17
93;21.11.2017;2017;11;07;Tiistai;11;11;22
93;21.11.2017;2017;11;08;Tiistai;9;9;18
93;21.11.2017;2017;11;09;Tiistai;5;0;5
93;21.11.2017;2017;11;10;Tiistai;4;3;7
93;21.11.2017;2017;11;11;Tiistai;1;0;1
93;21.11.2017;2017;11;12;Tiistai;2;1;3
93;21.11.2017;2017;11;13;Tiistai;2;4;6
93;21.11.2017;2017;11;14;Tiistai;3;7;10
93;21.11.2017;2017;11;15;Tiistai;7;8;15
93;21.11.2017;2017;11;16;Tiistai;13;12;25
93;21.11.2017;2017;11;17;Tiistai;6;4;10
93;21.11.2017;2017;11;18;Tiistai;1;6;7
93;21.11.2017;2017;11;19;Tiistai;1;1;2
93;21.11.2017;2017;11;20;Tiistai;1;3;4
93;21.11.2017;2017;11;21;Tiistai;0;5;5
93;21.11.2017;2017;11;22;Tiistai;1;1;2
93;21.11.2017;2017;11;23;Tiistai;0;0;0
93;22.11.2017;2017;11;00;Keskiviikko;1;0;1
93;22.11.2017;2017;11;01;Keskiviikko;0;0;0
93;22.11.2017;2017;11;02;Keskiviikko;0;0;0
93;22.11.2017;2017;11;03;Keskiviikko;0;0;0
93;22.11.2017;2017;11;04;Keskiviikko;0;0;0
93;22.11.2017;2017;11;05;Keskiviikko;5;2;7
93;22.11.2017;2017;11;06;Keskiviikko;9;8;17
93;22.11.2017;2017;11;07;Keskiviikko;10;13;23
93;22.11.2017;2017;11;08;Keskiviikko;6;10;16
93;22.11.2017;2017;11;09;Keskiviikko;7;2;9
93;22.11.2017;2017;11;10;Keskiviikko;2;1;3
93;22.11.2017;2017;11;11;Keskiviikko;5;3;8
93;22.11.2017;2017;11;12;Keskiviikko;1;1;2
93;22.11.2017;2017;11;13;Keskiviikko;2;3;5
93;22.11.2017;2017;11;14;Keskiviikko;3;5;8
93;22.11.2017;2017;11;15;Keskiviikko;8;10;18
93;22.11.2017;2017;11;16;Keskiviikko;15;11;26
93;22.11.2017;2017;11;17;Keskiviikko;5;6;11
93;22.11.2017;2017;11;18;Keskiviikko;1;6;7
93;22.11.2017;2017;11;19;Keskiviikko;1;0;1
93;22.11.2017;2017;11;20;Keskiviikko;0;3;3
93;22.11.2017;2017;11;21;Keskiviikko;1;0;1
93;22.11.2017;2017;11;22;Keskiviikko;0;0;0
93;22.11.2017;2017;11;23;Keskiviikko;0;0;0
93;23.11.2017;2017;11;00;Torstai;0;0;0
93;23.11.2017;2017;11;01;Torstai;0;0;0
93;23.11.2017;2017;11;02;Torstai;0;0;0
93;23.11.2017;2017;11;03;Torstai;0;0;0
93;23.11.2017;2017;11;04;Torstai;0;0;0
93;23.11.2017;2017;11;05;Torstai;4;2;6
93;23.11.2017;2017;11;06;Torstai;4;3;7
93;23.11.2017;2017;11;07;Torstai;10;13;23
93;23.11.2017;2017;11;08;Torstai;7;9;16
93;23.11.2017;2017;11;09;Torstai;0;2;2
93;23.11.2017;2017;11;10;Torstai;8;0;8
93;23.11.2017;2017;11;11;Torstai;1;4;5
93;23.11.2017;2017;11;12;Torstai;1;1;2
93;23.11.2017;2017;11;13;Torstai;0;3;3
93;23.11.2017;2017;11;14;Torstai;5;5;10
93;23.11.2017;2017;11;15;Torstai;4;7;11
93;23.11.2017;2017;11;16;Torstai;10;6;16
93;23.11.2017;2017;11;17;Torstai;6;7;13
93;23.11.2017;2017;11;18;Torstai;1;0;1
93;23.11.2017;2017;11;19;Torstai;1;6;7
93;23.11.2017;2017;11;20;Torstai;1;0;1
93;23.11.2017;2017;11;21;Torstai;0;1;1
93;23.11.2017;2017;11;22;Torstai;0;0;0
93;23.11.2017;2017;11;23;Torstai;0;0;0
93;24.11.2017;2017;11;00;Perjantai;0;0;0
93;24.11.2017;2017;11;01;Perjantai;0;0;0
93;24.11.2017;2017;11;02;Perjantai;0;0;0
93;24.11.2017;2017;11;03;Perjantai;0;0;0
93;24.11.2017;2017;11;04;Perjantai;0;0;0
93;24.11.2017;2017;11;05;Perjantai;2;2;4
93;24.11.2017;2017;11;06;Perjantai;2;2;4
93;24.11.2017;2017;11;07;Perjantai;3;7;10
93;24.11.2017;2017;11;08;Perjantai;4;6;10
93;24.11.2017;2017;11;09;Perjantai;1;0;1
93;24.11.2017;2017;11;10;Perjantai;1;2;3
93;24.11.2017;2017;11;11;Perjantai;2;0;2
93;24.11.2017;2017;11;12;Perjantai;1;3;4
93;24.11.2017;2017;11;13;Perjantai;7;3;10
93;24.11.2017;2017;11;14;Perjantai;5;5;10
93;24.11.2017;2017;11;15;Perjantai;6;5;11
93;24.11.2017;2017;11;16;Perjantai;9;7;16
93;24.11.2017;2017;11;17;Perjantai;5;3;8
93;24.11.2017;2017;11;18;Perjantai;1;6;7
93;24.11.2017;2017;11;19;Perjantai;3;1;4
93;24.11.2017;2017;11;20;Perjantai;2;0;2
93;24.11.2017;2017;11;21;Perjantai;0;0;0
93;24.11.2017;2017;11;22;Perjantai;0;0;0
93;24.11.2017;2017;11;23;Perjantai;0;0;0
93;25.11.2017;2017;11;00;Lauantai;0;0;0
93;25.11.2017;2017;11;01;Lauantai;0;2;2
93;25.11.2017;2017;11;02;Lauantai;0;0;0
93;25.11.2017;2017;11;03;Lauantai;0;1;1
93;25.11.2017;2017;11;04;Lauantai;0;0;0
93;25.11.2017;2017;11;05;Lauantai;0;0;0
93;25.11.2017;2017;11;06;Lauantai;0;0;0
93;25.11.2017;2017;11;07;Lauantai;1;0;1
93;25.11.2017;2017;11;08;Lauantai;1;0;1
93;25.11.2017;2017;11;09;Lauantai;1;1;2
93;25.11.2017;2017;11;10;Lauantai;2;0;2
93;25.11.2017;2017;11;11;Lauantai;2;3;5
93;25.11.2017;2017;11;12;Lauantai;6;2;8
93;25.11.2017;2017;11;13;Lauantai;4;5;9
93;25.11.2017;2017;11;14;Lauantai;0;3;3
93;25.11.2017;2017;11;15;Lauantai;3;2;5
93;25.11.2017;2017;11;16;Lauantai;1;2;3
93;25.11.2017;2017;11;17;Lauantai;2;0;2
93;25.11.2017;2017;11;18;Lauantai;0;0;0
93;25.11.2017;2017;11;19;Lauantai;1;7;8
93;25.11.2017;2017;11;20;Lauantai;2;3;5
93;25.11.2017;2017;11;21;Lauantai;0;0;0
93;25.11.2017;2017;11;22;Lauantai;0;0;0
93;25.11.2017;2017;11;23;Lauantai;0;0;0
93;26.11.2017;2017;11;00;Sunnuntai;3;0;3
93;26.11.2017;2017;11;01;Sunnuntai;0;1;1
93;26.11.2017;2017;11;02;Sunnuntai;2;2;4
93;26.11.2017;2017;11;03;Sunnuntai;0;0;0
93;26.11.2017;2017;11;04;Sunnuntai;0;0;0
93;26.11.2017;2017;11;05;Sunnuntai;0;0;0
93;26.11.2017;2017;11;06;Sunnuntai;0;0;0
93;26.11.2017;2017;11;07;Sunnuntai;0;0;0
93;26.11.2017;2017;11;08;Sunnuntai;1;1;2
93;26.11.2017;2017;11;09;Sunnuntai;2;0;2
93;26.11.2017;2017;11;10;Sunnuntai;1;3;4
93;26.11.2017;2017;11;11;Sunnuntai;2;4;6
93;26.11.2017;2017;11;12;Sunnuntai;2;5;7
93;26.11.2017;2017;11;13;Sunnuntai;4;2;6
93;26.11.2017;2017;11;14;Sunnuntai;4;6;10
93;26.11.2017;2017;11;15;Sunnuntai;2;6;8
93;26.11.2017;2017;11;16;Sunnuntai;4;0;4
93;26.11.2017;2017;11;17;Sunnuntai;4;3;7
93;26.11.2017;2017;11;18;Sunnuntai;3;2;5
93;26.11.2017;2017;11;19;Sunnuntai;1;1;2
93;26.11.2017;2017;11;20;Sunnuntai;1;2;3
93;26.11.2017;2017;11;21;Sunnuntai;0;0;0
93;26.11.2017;2017;11;22;Sunnuntai;1;1;2
93;26.11.2017;2017;11;23;Sunnuntai;0;1;1
93;27.11.2017;2017;11;00;Maanantai;0;0;0
93;27.11.2017;2017;11;01;Maanantai;1;0;1
93;27.11.2017;2017;11;02;Maanantai;0;0;0
93;27.11.2017;2017;11;03;Maanantai;0;0;0
93;27.11.2017;2017;11;04;Maanantai;0;0;0
93;27.11.2017;2017;11;05;Maanantai;2;3;5
93;27.11.2017;2017;11;06;Maanantai;6;5;11
93;27.11.2017;2017;11;07;Maanantai;11;13;24
93;27.11.2017;2017;11;08;Maanantai;5;11;16
93;27.11.2017;2017;11;09;Maanantai;5;4;9
93;27.11.2017;2017;11;10;Maanantai;3;2;5
93;27.11.2017;2017;11;11;Maanantai;1;2;3
93;27.11.2017;2017;11;12;Maanantai;1;2;3
93;27.11.2017;2017;11;13;Maanantai;5;0;5
93;27.11.2017;2017;11;14;Maanantai;3;8;11
93;27.11.2017;2017;11;15;Maanantai;6;6;12
93;27.11.2017;2017;11;16;Maanantai;13;15;28
93;27.11.2017;2017;11;17;Maanantai;8;3;11
93;27.11.2017;2017;11;18;Maanantai;2;5;7
93;27.11.2017;2017;11;19;Maanantai;1;1;2
93;27.11.2017;2017;11;20;Maanantai;0;1;1
93;27.11.2017;2017;11;21;Maanantai;6;0;6
93;27.11.2017;2017;11;22;Maanantai;0;0;0
93;27.11.2017;2017;11;23;Maanantai;2;1;3
93;28.11.2017;2017;11;00;Tiistai;0;0;0
93;28.11.2017;2017;11;01;Tiistai;0;0;0
93;28.11.2017;2017;11;02;Tiistai;0;0;0
93;28.11.2017;2017;11;03;Tiistai;0;0;0
93;28.11.2017;2017;11;04;Tiistai;1;2;3
93;28.11.2017;2017;11;05;Tiistai;2;2;4
93;28.11.2017;2017;11;06;Tiistai;4;4;8
93;28.11.2017;2017;11;07;Tiistai;9;11;20
93;28.11.2017;2017;11;08;Tiistai;3;11;14
93;28.11.2017;2017;11;09;Tiistai;4;6;10
93;28.11.2017;2017;11;10;Tiistai;1;1;2
93;28.11.2017;2017;11;11;Tiistai;4;1;5
93;28.11.2017;2017;11;12;Tiistai;4;3;7
93;28.11.2017;2017;11;13;Tiistai;2;1;3
93;28.11.2017;2017;11;14;Tiistai;4;6;10
93;28.11.2017;2017;11;15;Tiistai;9;9;18
93;28.11.2017;2017;11;16;Tiistai;7;8;15
93;28.11.2017;2017;11;17;Tiistai;5;1;6
93;28.11.2017;2017;11;18;Tiistai;6;3;9
93;28.11.2017;2017;11;19;Tiistai;5;1;6
93;28.11.2017;2017;11;20;Tiistai;0;3;3
93;28.11.2017;2017;11;21;Tiistai;0;1;1
93;28.11.2017;2017;11;22;Tiistai;0;0;0
93;28.11.2017;2017;11;23;Tiistai;0;0;0
93;29.11.2017;2017;11;00;Keskiviikko;1;1;2
93;29.11.2017;2017;11;01;Keskiviikko;0;0;0
93;29.11.2017;2017;11;02;Keskiviikko;0;0;0
93;29.11.2017;2017;11;03;Keskiviikko;0;0;0
93;29.11.2017;2017;11;04;Keskiviikko;0;0;0
93;29.11.2017;2017;11;05;Keskiviikko;2;3;5
93;29.11.2017;2017;11;06;Keskiviikko;3;7;10
93;29.11.2017;2017;11;07;Keskiviikko;18;9;27
93;29.11.2017;2017;11;08;Keskiviikko;4;11;15
93;29.11.2017;2017;11;09;Keskiviikko;0;1;1
93;29.11.2017;2017;11;10;Keskiviikko;2;1;3
93;29.11.2017;2017;11;11;Keskiviikko;1;3;4
93;29.11.2017;2017;11;12;Keskiviikko;1;1;2
93;29.11.2017;2017;11;13;Keskiviikko;2;4;6
93;29.11.2017;2017;11;14;Keskiviikko;1;3;4
93;29.11.2017;2017;11;15;Keskiviikko;12;8;20
93;29.11.2017;2017;11;16;Keskiviikko;14;9;23
93;29.11.2017;2017;11;17;Keskiviikko;9;4;13
93;29.11.2017;2017;11;18;Keskiviikko;4;5;9
93;29.11.2017;2017;11;19;Keskiviikko;4;2;6
93;29.11.2017;2017;11;20;Keskiviikko;3;5;8
93;29.11.2017;2017;11;21;Keskiviikko;1;1;2
93;29.11.2017;2017;11;22;Keskiviikko;1;1;2
93;29.11.2017;2017;11;23;Keskiviikko;1;0;1
93;30.11.2017;2017;11;00;Torstai;1;0;1
93;30.11.2017;2017;11;01;Torstai;0;0;0
93;30.11.2017;2017;11;02;Torstai;0;0;0
93;30.11.2017;2017;11;03;Torstai;0;0;0
93;30.11.2017;2017;11;04;Torstai;0;0;0
93;30.11.2017;2017;11;05;Torstai;3;2;5
93;30.11.2017;2017;11;06;Torstai;4;7;11
93;30.11.2017;2017;11;07;Torstai;14;13;27
93;30.11.2017;2017;11;08;Torstai;6;9;15
93;30.11.2017;2017;11;09;Torstai;3;0;3
93;30.11.2017;2017;11;10;Torstai;0;5;5
93;30.11.2017;2017;11;11;Torstai;1;3;4
93;30.11.2017;2017;11;12;Torstai;6;0;6
93;30.11.2017;2017;11;13;Torstai;7;8;15
93;30.11.2017;2017;11;14;Torstai;6;4;10
93;30.11.2017;2017;11;15;Torstai;4;6;10
93;30.11.2017;2017;11;16;Torstai;15;9;24
93;30.11.2017;2017;11;17;Torstai;9;7;16
93;30.11.2017;2017;11;18;Torstai;3;6;9
93;30.11.2017;2017;11;19;Torstai;3;3;6
93;30.11.2017;2017;11;20;Torstai;4;5;9
93;30.11.2017;2017;11;21;Torstai;2;2;4
93;30.11.2017;2017;11;22;Torstai;1;0;1
93;30.11.2017;2017;11;23;Torstai;0;0;0
93;01.12.2017;2017;12;00;Perjantai;1;0;1
93;01.12.2017;2017;12;01;Perjantai;0;0;0
93;01.12.2017;2017;12;02;Perjantai;0;0;0
93;01.12.2017;2017;12;03;Perjantai;1;0;1
93;01.12.2017;2017;12;04;Perjantai;0;0;0
93;01.12.2017;2017;12;05;Perjantai;2;2;4
93;01.12.2017;2017;12;06;Perjantai;5;6;11
93;01.12.2017;2017;12;07;Perjantai;14;15;29
93;01.12.2017;2017;12;08;Perjantai;3;11;14
93;01.12.2017;2017;12;09;Perjantai;2;1;3
93;01.12.2017;2017;12;10;Perjantai;2;2;4
93;01.12.2017;2017;12;11;Perjantai;3;1;4
93;01.12.2017;2017;12;12;Perjantai;3;3;6
93;01.12.2017;2017;12;13;Perjantai;3;2;5
93;01.12.2017;2017;12;14;Perjantai;7;1;8
93;01.12.2017;2017;12;15;Perjantai;8;9;17
93;01.12.2017;2017;12;16;Perjantai;15;6;21
93;01.12.2017;2017;12;17;Perjantai;7;2;9
93;01.12.2017;2017;12;18;Perjantai;3;2;5
93;01.12.2017;2017;12;19;Perjantai;3;4;7
93;01.12.2017;2017;12;20;Perjantai;3;5;8
93;01.12.2017;2017;12;21;Perjantai;0;2;2
93;01.12.2017;2017;12;22;Perjantai;0;0;0
93;01.12.2017;2017;12;23;Perjantai;0;0;0
93;02.12.2017;2017;12;00;Lauantai;0;0;0
93;02.12.2017;2017;12;01;Lauantai;0;1;1
93;02.12.2017;2017;12;02;Lauantai;0;0;0
93;02.12.2017;2017;12;03;Lauantai;0;1;1
93;02.12.2017;2017;12;04;Lauantai;0;0;0
93;02.12.2017;2017;12;05;Lauantai;0;0;0
93;02.12.2017;2017;12;06;Lauantai;1;1;2
93;02.12.2017;2017;12;07;Lauantai;3;1;4
93;02.12.2017;2017;12;08;Lauantai;1;1;2
93;02.12.2017;2017;12;09;Lauantai;3;1;4
93;02.12.2017;2017;12;10;Lauantai;1;0;1
93;02.12.2017;2017;12;11;Lauantai;2;0;2
93;02.12.2017;2017;12;12;Lauantai;3;1;4
93;02.12.2017;2017;12;13;Lauantai;4;4;8
93;02.12.2017;2017;12;14;Lauantai;4;2;6
93;02.12.2017;2017;12;15;Lauantai;2;7;9
93;02.12.2017;2017;12;16;Lauantai;1;2;3
93;02.12.2017;2017;12;17;Lauantai;2;4;6
93;02.12.2017;2017;12;18;Lauantai;2;2;4
93;02.12.2017;2017;12;19;Lauantai;2;2;4
93;02.12.2017;2017;12;20;Lauantai;0;2;2
93;02.12.2017;2017;12;21;Lauantai;0;0;0
93;02.12.2017;2017;12;22;Lauantai;3;2;5
93;02.12.2017;2017;12;23;Lauantai;0;2;2
93;03.12.2017;2017;12;00;Sunnuntai;0;0;0
93;03.12.2017;2017;12;01;Sunnuntai;0;1;1
93;03.12.2017;2017;12;02;Sunnuntai;0;0;0
93;03.12.2017;2017;12;03;Sunnuntai;0;0;0
93;03.12.2017;2017;12;04;Sunnuntai;0;0;0
93;03.12.2017;2017;12;05;Sunnuntai;0;0;0
93;03.12.2017;2017;12;06;Sunnuntai;1;0;1
93;03.12.2017;2017;12;07;Sunnuntai;1;0;1
93;03.12.2017;2017;12;08;Sunnuntai;0;1;1
93;03.12.2017;2017;12;09;Sunnuntai;2;0;2
93;03.12.2017;2017;12;10;Sunnuntai;0;1;1
93;03.12.2017;2017;12;11;Sunnuntai;9;0;9
93;03.12.2017;2017;12;12;Sunnuntai;2;2;4
93;03.12.2017;2017;12;13;Sunnuntai;1;0;1
93;03.12.2017;2017;12;14;Sunnuntai;5;7;12
93;03.12.2017;2017;12;15;Sunnuntai;1;1;2
93;03.12.2017;2017;12;16;Sunnuntai;1;0;1
93;03.12.2017;2017;12;17;Sunnuntai;4;1;5
93;03.12.2017;2017;12;18;Sunnuntai;2;3;5
93;03.12.2017;2017;12;19;Sunnuntai;0;4;4
93;03.12.2017;2017;12;20;Sunnuntai;3;2;5
93;03.12.2017;2017;12;21;Sunnuntai;0;2;2
93;03.12.2017;2017;12;22;Sunnuntai;0;1;1
93;03.12.2017;2017;12;23;Sunnuntai;0;0;0
93;04.12.2017;2017;12;00;Maanantai;0;0;0
93;04.12.2017;2017;12;01;Maanantai;0;0;0
93;04.12.2017;2017;12;02;Maanantai;0;0;0
93;04.12.2017;2017;12;03;Maanantai;0;1;1
93;04.12.2017;2017;12;04;Maanantai;1;0;1
93;04.12.2017;2017;12;05;Maanantai;2;2;4
93;04.12.2017;2017;12;06;Maanantai;5;4;9
93;04.12.2017;2017;12;07;Maanantai;13;14;27
93;04.12.2017;2017;12;08;Maanantai;10;12;22
93;04.12.2017;2017;12;09;Maanantai;0;2;2
93;04.12.2017;2017;12;10;Maanantai;2;3;5
93;04.12.2017;2017;12;11;Maanantai;3;0;3
93;04.12.2017;2017;12;12;Maanantai;1;4;5
93;04.12.2017;2017;12;13;Maanantai;2;1;3
93;04.12.2017;2017;12;14;Maanantai;5;3;8
93;04.12.2017;2017;12;15;Maanantai;15;9;24
93;04.12.2017;2017;12;16;Maanantai;11;7;18
93;04.12.2017;2017;12;17;Maanantai;4;6;10
93;04.12.2017;2017;12;18;Maanantai;2;7;9
93;04.12.2017;2017;12;19;Maanantai;2;2;4
93;04.12.2017;2017;12;20;Maanantai;0;4;4
93;04.12.2017;2017;12;21;Maanantai;0;1;1
93;04.12.2017;2017;12;22;Maanantai;0;0;0
93;04.12.2017;2017;12;23;Maanantai;0;0;0
93;05.12.2017;2017;12;00;Tiistai;0;0;0
93;05.12.2017;2017;12;01;Tiistai;0;0;0
93;05.12.2017;2017;12;02;Tiistai;0;0;0
93;05.12.2017;2017;12;03;Tiistai;0;0;0
93;05.12.2017;2017;12;04;Tiistai;0;0;0
93;05.12.2017;2017;12;05;Tiistai;0;2;2
93;05.12.2017;2017;12;06;Tiistai;3;7;10
93;05.12.2017;2017;12;07;Tiistai;6;12;18
93;05.12.2017;2017;12;08;Tiistai;5;7;12
93;05.12.2017;2017;12;09;Tiistai;4;2;6
93;05.12.2017;2017;12;10;Tiistai;1;1;2
93;05.12.2017;2017;12;11;Tiistai;0;0;0
93;05.12.2017;2017;12;12;Tiistai;3;3;6
93;05.12.2017;2017;12;13;Tiistai;2;2;4
93;05.12.2017;2017;12;14;Tiistai;8;1;9
93;05.12.2017;2017;12;15;Tiistai;12;9;21
93;05.12.2017;2017;12;16;Tiistai;8;7;15
93;05.12.2017;2017;12;17;Tiistai;7;3;10
93;05.12.2017;2017;12;18;Tiistai;4;7;11
93;05.12.2017;2017;12;19;Tiistai;0;3;3
93;05.12.2017;2017;12;20;Tiistai;2;1;3
93;05.12.2017;2017;12;21;Tiistai;0;0;0
93;05.12.2017;2017;12;22;Tiistai;1;1;2
93;05.12.2017;2017;12;23;Tiistai;0;1;1
93;06.12.2017;2017;12;00;Keskiviikko;0;0;0
93;06.12.2017;2017;12;01;Keskiviikko;0;0;0
93;06.12.2017;2017;12;02;Keskiviikko;0;0;0
93;06.12.2017;2017;12;03;Keskiviikko;0;1;1
93;06.12.2017;2017;12;04;Keskiviikko;0;0;0
93;06.12.2017;2017;12;05;Keskiviikko;1;0;1
93;06.12.2017;2017;12;06;Keskiviikko;0;0;0
93;06.12.2017;2017;12;07;Keskiviikko;1;0;1
93;06.12.2017;2017;12;08;Keskiviikko;1;1;2
93;06.12.2017;2017;12;09;Keskiviikko;2;2;4
93;06.12.2017;2017;12;10;Keskiviikko;0;4;4
93;06.12.2017;2017;12;11;Keskiviikko;1;1;2
93;06.12.2017;2017;12;12;Keskiviikko;1;1;2
93;06.12.2017;2017;12;13;Keskiviikko;1;4;5
93;06.12.2017;2017;12;14;Keskiviikko;3;1;4
93;06.12.2017;2017;12;15;Keskiviikko;1;2;3
93;06.12.2017;2017;12;16;Keskiviikko;1;1;2
93;06.12.2017;2017;12;17;Keskiviikko;0;1;1
93;06.12.2017;2017;12;18;Keskiviikko;0;3;3
93;06.12.2017;2017;12;19;Keskiviikko;2;0;2
93;06.12.2017;2017;12;20;Keskiviikko;0;0;0
93;06.12.2017;2017;12;21;Keskiviikko;2;2;4
93;06.12.2017;2017;12;22;Keskiviikko;1;0;1
93;06.12.2017;2017;12;23;Keskiviikko;0;0;0
93;07.12.2017;2017;12;00;Torstai;0;0;0
93;07.12.2017;2017;12;01;Torstai;0;0;0
93;07.12.2017;2017;12;02;Torstai;0;0;0
93;07.12.2017;2017;12;03;Torstai;0;0;0
93;07.12.2017;2017;12;04;Torstai;1;0;1
93;07.12.2017;2017;12;05;Torstai;1;2;3
93;07.12.2017;2017;12;06;Torstai;9;6;15
93;07.12.2017;2017;12;07;Torstai;8;10;18
93;07.12.2017;2017;12;08;Torstai;7;9;16
93;07.12.2017;2017;12;09;Torstai;4;4;8
93;07.12.2017;2017;12;10;Torstai;4;5;9
93;07.12.2017;2017;12;11;Torstai;0;1;1
93;07.12.2017;2017;12;12;Torstai;1;3;4
93;07.12.2017;2017;12;13;Torstai;3;6;9
93;07.12.2017;2017;12;14;Torstai;8;2;10
93;07.12.2017;2017;12;15;Torstai;9;9;18
93;07.12.2017;2017;12;16;Torstai;15;12;27
93;07.12.2017;2017;12;17;Torstai;7;5;12
93;07.12.2017;2017;12;18;Torstai;4;5;9
93;07.12.2017;2017;12;19;Torstai;3;5;8
93;07.12.2017;2017;12;20;Torstai;1;0;1
93;07.12.2017;2017;12;21;Torstai;0;1;1
93;07.12.2017;2017;12;22;Torstai;1;3;4
93;07.12.2017;2017;12;23;Torstai;0;0;0
93;08.12.2017;2017;12;00;Perjantai;0;0;0
93;08.12.2017;2017;12;01;Perjantai;0;0;0
93;08.12.2017;2017;12;02;Perjantai;0;0;0
93;08.12.2017;2017;12;03;Perjantai;0;0;0
93;08.12.2017;2017;12;04;Perjantai;0;0;0
93;08.12.2017;2017;12;05;Perjantai;3;2;5
93;08.12.2017;2017;12;06;Perjantai;1;4;5
93;08.12.2017;2017;12;07;Perjantai;2;10;12
93;08.12.2017;2017;12;08;Perjantai;3;8;11
93;08.12.2017;2017;12;09;Perjantai;0;0;0
93;08.12.2017;2017;12;10;Perjantai;0;1;1
93;08.12.2017;2017;12;11;Perjantai;0;0;0
93;08.12.2017;2017;12;12;Perjantai;1;0;1
93;08.12.2017;2017;12;13;Perjantai;5;1;6
93;08.12.2017;2017;12;14;Perjantai;6;2;8
93;08.12.2017;2017;12;15;Perjantai;5;3;8
93;08.12.2017;2017;12;16;Perjantai;4;2;6
93;08.12.2017;2017;12;17;Perjantai;5;2;7
93;08.12.2017;2017;12;18;Perjantai;2;1;3
93;08.12.2017;2017;12;19;Perjantai;2;1;3
93;08.12.2017;2017;12;20;Perjantai;0;1;1
93;08.12.2017;2017;12;21;Perjantai;0;0;0
93;08.12.2017;2017;12;22;Perjantai;0;2;2
93;08.12.2017;2017;12;23;Perjantai;2;1;3
93;09.12.2017;2017;12;00;Lauantai;0;0;0
93;09.12.2017;2017;12;01;Lauantai;0;0;0
93;09.12.2017;2017;12;02;Lauantai;0;1;1
93;09.12.2017;2017;12;03;Lauantai;0;0;0
93;09.12.2017;2017;12;04;Lauantai;0;0;0
93;09.12.2017;2017;12;05;Lauantai;1;0;1
93;09.12.2017;2017;12;06;Lauantai;0;0;0
93;09.12.2017;2017;12;07;Lauantai;1;0;1
93;09.12.2017;2017;12;08;Lauantai;0;1;1
93;09.12.2017;2017;12;09;Lauantai;4;3;7
93;09.12.2017;2017;12;10;Lauantai;3;1;4
93;09.12.2017;2017;12;11;Lauantai;1;4;5
93;09.12.2017;2017;12;12;Lauantai;2;3;5
93;09.12.2017;2017;12;13;Lauantai;4;4;8
93;09.12.2017;2017;12;14;Lauantai;4;1;5
93;09.12.2017;2017;12;15;Lauantai;4;6;10
93;09.12.2017;2017;12;16;Lauantai;1;3;4
93;09.12.2017;2017;12;17;Lauantai;3;1;4
93;09.12.2017;2017;12;18;Lauantai;0;2;2
93;09.12.2017;2017;12;19;Lauantai;1;2;3
93;09.12.2017;2017;12;20;Lauantai;1;1;2
93;09.12.2017;2017;12;21;Lauantai;1;2;3
93;09.12.2017;2017;12;22;Lauantai;0;0;0
93;09.12.2017;2017;12;23;Lauantai;0;0;0
93;10.12.2017;2017;12;00;Sunnuntai;0;0;0
93;10.12.2017;2017;12;01;Sunnuntai;0;0;0
93;10.12.2017;2017;12;02;Sunnuntai;0;0;0
93;10.12.2017;2017;12;03;Sunnuntai;0;0;0
93;10.12.2017;2017;12;04;Sunnuntai;1;0;1
93;10.12.2017;2017;12;05;Sunnuntai;1;0;1
93;10.12.2017;2017;12;06;Sunnuntai;0;0;0
93;10.12.2017;2017;12;07;Sunnuntai;0;0;0
93;10.12.2017;2017;12;08;Sunnuntai;0;0;0
93;10.12.2017;2017;12;09;Sunnuntai;0;0;0
93;10.12.2017;2017;12;10;Sunnuntai;0;4;4
93;10.12.2017;2017;12;11;Sunnuntai;3;1;4
93;10.12.2017;2017;12;12;Sunnuntai;8;3;11
93;10.12.2017;2017;12;13;Sunnuntai;1;2;3
93;10.12.2017;2017;12;14;Sunnuntai;2;4;6
93;10.12.2017;2017;12;15;Sunnuntai;2;1;3
93;10.12.2017;2017;12;16;Sunnuntai;1;1;2
93;10.12.2017;2017;12;17;Sunnuntai;1;1;2
93;10.12.2017;2017;12;18;Sunnuntai;0;0;0
93;10.12.2017;2017;12;19;Sunnuntai;1;2;3
93;10.12.2017;2017;12;20;Sunnuntai;0;4;4
93;10.12.2017;2017;12;21;Sunnuntai;0;1;1
93;10.12.2017;2017;12;22;Sunnuntai;0;1;1
93;10.12.2017;2017;12;23;Sunnuntai;0;0;0
93;11.12.2017;2017;12;00;Maanantai;0;0;0
93;11.12.2017;2017;12;01;Maanantai;0;0;0
93;11.12.2017;2017;12;02;Maanantai;0;0;0
93;11.12.2017;2017;12;03;Maanantai;0;0;0
93;11.12.2017;2017;12;04;Maanantai;0;0;0
93;11.12.2017;2017;12;05;Maanantai;3;2;5
93;11.12.2017;2017;12;06;Maanantai;5;5;10
93;11.12.2017;2017;12;07;Maanantai;10;16;26
93;11.12.2017;2017;12;08;Maanantai;5;6;11
93;11.12.2017;2017;12;09;Maanantai;3;5;8
93;11.12.2017;2017;12;10;Maanantai;0;3;3
93;11.12.2017;2017;12;11;Maanantai;0;1;1
93;11.12.2017;2017;12;12;Maanantai;2;2;4
93;11.12.2017;2017;12;13;Maanantai;8;6;14
93;11.12.2017;2017;12;14;Maanantai;7;3;10
93;11.12.2017;2017;12;15;Maanantai;10;10;20
93;11.12.2017;2017;12;16;Maanantai;19;12;31
93;11.12.2017;2017;12;17;Maanantai;6;3;9
93;11.12.2017;2017;12;18;Maanantai;3;2;5
93;11.12.2017;2017;12;19;Maanantai;5;0;5
93;11.12.2017;2017;12;20;Maanantai;2;5;7
93;11.12.2017;2017;12;21;Maanantai;2;1;3
93;11.12.2017;2017;12;22;Maanantai;0;1;1
93;11.12.2017;2017;12;23;Maanantai;0;0;0
93;12.12.2017;2017;12;00;Tiistai;1;0;1
93;12.12.2017;2017;12;01;Tiistai;0;0;0
93;12.12.2017;2017;12;02;Tiistai;0;0;0
93;12.12.2017;2017;12;03;Tiistai;0;0;0
93;12.12.2017;2017;12;04;Tiistai;0;0;0
93;12.12.2017;2017;12;05;Tiistai;2;3;5
93;12.12.2017;2017;12;06;Tiistai;6;4;10
93;12.12.2017;2017;12;07;Tiistai;9;10;19
93;12.12.2017;2017;12;08;Tiistai;5;11;16
93;12.12.2017;2017;12;09;Tiistai;1;3;4
93;12.12.2017;2017;12;10;Tiistai;1;1;2
93;12.12.2017;2017;12;11;Tiistai;4;3;7
93;12.12.2017;2017;12;12;Tiistai;1;1;2
93;12.12.2017;2017;12;13;Tiistai;5;1;6
93;12.12.2017;2017;12;14;Tiistai;4;1;5
93;12.12.2017;2017;12;15;Tiistai;3;5;8
93;12.12.2017;2017;12;16;Tiistai;11;9;20
93;12.12.2017;2017;12;17;Tiistai;6;2;8
93;12.12.2017;2017;12;18;Tiistai;2;3;5
93;12.12.2017;2017;12;19;Tiistai;1;3;4
93;12.12.2017;2017;12;20;Tiistai;0;3;3
93;12.12.2017;2017;12;21;Tiistai;1;0;1
93;12.12.2017;2017;12;22;Tiistai;0;1;1
93;12.12.2017;2017;12;23;Tiistai;0;0;0
93;13.12.2017;2017;12;00;Keskiviikko;1;0;1
93;13.12.2017;2017;12;01;Keskiviikko;0;0;0
93;13.12.2017;2017;12;02;Keskiviikko;0;0;0
93;13.12.2017;2017;12;03;Keskiviikko;0;0;0
93;13.12.2017;2017;12;04;Keskiviikko;0;0;0
93;13.12.2017;2017;12;05;Keskiviikko;2;3;5
93;13.12.2017;2017;12;06;Keskiviikko;5;4;9
93;13.12.2017;2017;12;07;Keskiviikko;4;9;13
93;13.12.2017;2017;12;08;Keskiviikko;4;7;11
93;13.12.2017;2017;12;09;Keskiviikko;2;1;3
93;13.12.2017;2017;12;10;Keskiviikko;0;0;0
93;13.12.2017;2017;12;11;Keskiviikko;1;1;2
93;13.12.2017;2017;12;12;Keskiviikko;0;2;2
93;13.12.2017;2017;12;13;Keskiviikko;4;3;7
93;13.12.2017;2017;12;14;Keskiviikko;6;2;8
93;13.12.2017;2017;12;15;Keskiviikko;6;8;14
93;13.12.2017;2017;12;16;Keskiviikko;10;5;15
93;13.12.2017;2017;12;17;Keskiviikko;5;3;8
93;13.12.2017;2017;12;18;Keskiviikko;3;3;6
93;13.12.2017;2017;12;19;Keskiviikko;0;0;0
93;13.12.2017;2017;12;20;Keskiviikko;0;1;1
93;13.12.2017;2017;12;21;Keskiviikko;1;1;2
93;13.12.2017;2017;12;22;Keskiviikko;1;2;3
93;13.12.2017;2017;12;23;Keskiviikko;0;0;0
93;14.12.2017;2017;12;00;Torstai;0;0;0
93;14.12.2017;2017;12;01;Torstai;0;0;0
93;14.12.2017;2017;12;02;Torstai;0;0;0
93;14.12.2017;2017;12;03;Torstai;0;0;0
93;14.12.2017;2017;12;04;Torstai;0;0;0
93;14.12.2017;2017;12;05;Torstai;1;3;4
93;14.12.2017;2017;12;06;Torstai;5;3;8
93;14.12.2017;2017;12;07;Torstai;10;9;19
93;14.12.2017;2017;12;08;Torstai;3;7;10
93;14.12.2017;2017;12;09;Torstai;1;2;3
93;14.12.2017;2017;12;10;Torstai;2;2;4
93;14.12.2017;2017;12;11;Torstai;0;2;2
93;14.12.2017;2017;12;12;Torstai;2;1;3
93;14.12.2017;2017;12;13;Torstai;4;1;5
93;14.12.2017;2017;12;14;Torstai;8;6;14
93;14.12.2017;2017;12;15;Torstai;3;3;6
93;14.12.2017;2017;12;16;Torstai;9;7;16
93;14.12.2017;2017;12;17;Torstai;5;3;8
93;14.12.2017;2017;12;18;Torstai;2;2;4
93;14.12.2017;2017;12;19;Torstai;2;6;8
93;14.12.2017;2017;12;20;Torstai;2;4;6
93;14.12.2017;2017;12;21;Torstai;3;3;6
93;14.12.2017;2017;12;22;Torstai;1;0;1
93;14.12.2017;2017;12;23;Torstai;0;1;1
93;15.12.2017;2017;12;00;Perjantai;0;0;0
93;15.12.2017;2017;12;01;Perjantai;0;0;0
93;15.12.2017;2017;12;02;Perjantai;0;1;1
93;15.12.2017;2017;12;03;Perjantai;0;0;0
93;15.12.2017;2017;12;04;Perjantai;1;0;1
93;15.12.2017;2017;12;05;Perjantai;0;1;1
93;15.12.2017;2017;12;06;Perjantai;8;6;14
93;15.12.2017;2017;12;07;Perjantai;5;8;13
93;15.12.2017;2017;12;08;Perjantai;2;9;11
93;15.12.2017;2017;12;09;Perjantai;3;1;4
93;15.12.2017;2017;12;10;Perjantai;2;1;3
93;15.12.2017;2017;12;11;Perjantai;3;1;4
93;15.12.2017;2017;12;12;Perjantai;1;1;2
93;15.12.2017;2017;12;13;Perjantai;5;1;6
93;15.12.2017;2017;12;14;Perjantai;2;2;4
93;15.12.2017;2017;12;15;Perjantai;12;9;21
93;15.12.2017;2017;12;16;Perjantai;6;5;11
93;15.12.2017;2017;12;17;Perjantai;5;1;6
93;15.12.2017;2017;12;18;Perjantai;2;2;4
93;15.12.2017;2017;12;19;Perjantai;1;1;2
93;15.12.2017;2017;12;20;Perjantai;1;2;3
93;15.12.2017;2017;12;21;Perjantai;1;4;5
93;15.12.2017;2017;12;22;Perjantai;0;0;0
93;15.12.2017;2017;12;23;Perjantai;1;0;1
93;16.12.2017;2017;12;00;Lauantai;0;0;0
93;16.12.2017;2017;12;01;Lauantai;0;0;0
93;16.12.2017;2017;12;02;Lauantai;0;0;0
93;16.12.2017;2017;12;03;Lauantai;0;0;0
93;16.12.2017;2017;12;04;Lauantai;0;0;0
93;16.12.2017;2017;12;05;Lauantai;0;0;0
93;16.12.2017;2017;12;06;Lauantai;1;0;1
93;16.12.2017;2017;12;07;Lauantai;1;0;1
93;16.12.2017;2017;12;08;Lauantai;1;1;2
93;16.12.2017;2017;12;09;Lauantai;1;1;2
93;16.12.2017;2017;12;10;Lauantai;4;0;4
93;16.12.2017;2017;12;11;Lauantai;3;3;6
93;16.12.2017;2017;12;12;Lauantai;4;2;6
93;16.12.2017;2017;12;13;Lauantai;2;2;4
93;16.12.2017;2017;12;14;Lauantai;3;2;5
93;16.12.2017;2017;12;15;Lauantai;0;1;1
93;16.12.2017;2017;12;16;Lauantai;1;1;2
93;16.12.2017;2017;12;17;Lauantai;1;1;2
93;16.12.2017;2017;12;18;Lauantai;3;1;4
93;16.12.2017;2017;12;19;Lauantai;0;2;2
93;16.12.2017;2017;12;20;Lauantai;0;2;2
93;16.12.2017;2017;12;21;Lauantai;0;1;1
93;16.12.2017;2017;12;22;Lauantai;4;0;4
93;16.12.2017;2017;12;23;Lauantai;0;2;2
93;17.12.2017;2017;12;00;Sunnuntai;3;0;3
93;17.12.2017;2017;12;01;Sunnuntai;0;0;0
93;17.12.2017;2017;12;02;Sunnuntai;0;0;0
93;17.12.2017;2017;12;03;Sunnuntai;0;1;1
93;17.12.2017;2017;12;04;Sunnuntai;0;1;1
93;17.12.2017;2017;12;05;Sunnuntai;1;0;1
93;17.12.2017;2017;12;06;Sunnuntai;1;0;1
93;17.12.2017;2017;12;07;Sunnuntai;0;0;0
93;17.12.2017;2017;12;08;Sunnuntai;1;1;2
93;17.12.2017;2017;12;09;Sunnuntai;0;6;6
93;17.12.2017;2017;12;10;Sunnuntai;2;1;3
93;17.12.2017;2017;12;11;Sunnuntai;6;0;6
93;17.12.2017;2017;12;12;Sunnuntai;0;4;4
93;17.12.2017;2017;12;13;Sunnuntai;3;2;5
93;17.12.2017;2017;12;14;Sunnuntai;1;5;6
93;17.12.2017;2017;12;15;Sunnuntai;0;4;4
93;17.12.2017;2017;12;16;Sunnuntai;1;1;2
93;17.12.2017;2017;12;17;Sunnuntai;4;0;4
93;17.12.2017;2017;12;18;Sunnuntai;0;0;0
93;17.12.2017;2017;12;19;Sunnuntai;1;1;2
93;17.12.2017;2017;12;20;Sunnuntai;0;1;1
93;17.12.2017;2017;12;21;Sunnuntai;0;2;2
93;17.12.2017;2017;12;22;Sunnuntai;1;0;1
93;17.12.2017;2017;12;23;Sunnuntai;0;0;0
93;18.12.2017;2017;12;00;Maanantai;0;1;1
93;18.12.2017;2017;12;01;Maanantai;0;0;0
93;18.12.2017;2017;12;02;Maanantai;0;1;1
93;18.12.2017;2017;12;03;Maanantai;0;0;0
93;18.12.2017;2017;12;04;Maanantai;0;0;0
93;18.12.2017;2017;12;05;Maanantai;4;2;6
93;18.12.2017;2017;12;06;Maanantai;8;4;12
93;18.12.2017;2017;12;07;Maanantai;12;17;29
93;18.12.2017;2017;12;08;Maanantai;6;13;19
93;18.12.2017;2017;12;09;Maanantai;2;3;5
93;18.12.2017;2017;12;10;Maanantai;4;1;5
93;18.12.2017;2017;12;11;Maanantai;0;2;2
93;18.12.2017;2017;12;12;Maanantai;2;5;7
93;18.12.2017;2017;12;13;Maanantai;1;3;4
93;18.12.2017;2017;12;14;Maanantai;10;3;13
93;18.12.2017;2017;12;15;Maanantai;8;13;21
93;18.12.2017;2017;12;16;Maanantai;16;12;28
93;18.12.2017;2017;12;17;Maanantai;7;5;12
93;18.12.2017;2017;12;18;Maanantai;5;5;10
93;18.12.2017;2017;12;19;Maanantai;3;1;4
93;18.12.2017;2017;12;20;Maanantai;0;1;1
93;18.12.2017;2017;12;21;Maanantai;0;0;0
93;18.12.2017;2017;12;22;Maanantai;0;0;0
93;18.12.2017;2017;12;23;Maanantai;0;0;0
93;19.12.2017;2017;12;00;Tiistai;0;0;0
93;19.12.2017;2017;12;01;Tiistai;0;0;0
93;19.12.2017;2017;12;02;Tiistai;0;0;0
93;19.12.2017;2017;12;03;Tiistai;1;0;1
93;19.12.2017;2017;12;04;Tiistai;0;0;0
93;19.12.2017;2017;12;05;Tiistai;6;2;8
93;19.12.2017;2017;12;06;Tiistai;7;4;11
93;19.12.2017;2017;12;07;Tiistai;8;17;25
93;19.12.2017;2017;12;08;Tiistai;5;10;15
93;19.12.2017;2017;12;09;Tiistai;1;1;2
93;19.12.2017;2017;12;10;Tiistai;1;1;2
93;19.12.2017;2017;12;11;Tiistai;0;1;1
93;19.12.2017;2017;12;12;Tiistai;3;0;3
93;19.12.2017;2017;12;13;Tiistai;2;1;3
93;19.12.2017;2017;12;14;Tiistai;4;5;9
93;19.12.2017;2017;12;15;Tiistai;10;11;21
93;19.12.2017;2017;12;16;Tiistai;14;8;22
93;19.12.2017;2017;12;17;Tiistai;3;4;7
93;19.12.2017;2017;12;18;Tiistai;1;5;6
93;19.12.2017;2017;12;19;Tiistai;2;2;4
93;19.12.2017;2017;12;20;Tiistai;2;3;5
93;19.12.2017;2017;12;21;Tiistai;3;1;4
93;19.12.2017;2017;12;22;Tiistai;0;1;1
93;19.12.2017;2017;12;23;Tiistai;0;0;0
93;20.12.2017;2017;12;00;Keskiviikko;0;0;0
93;20.12.2017;2017;12;01;Keskiviikko;0;0;0
93;20.12.2017;2017;12;02;Keskiviikko;0;0;0
93;20.12.2017;2017;12;03;Keskiviikko;0;0;0
93;20.12.2017;2017;12;04;Keskiviikko;2;0;2
93;20.12.2017;2017;12;05;Keskiviikko;2;2;4
93;20.12.2017;2017;12;06;Keskiviikko;3;3;6
93;20.12.2017;2017;12;07;Keskiviikko;6;13;19
93;20.12.2017;2017;12;08;Keskiviikko;2;9;11
93;20.12.2017;2017;12;09;Keskiviikko;5;2;7
93;20.12.2017;2017;12;10;Keskiviikko;0;3;3
93;20.12.2017;2017;12;11;Keskiviikko;0;0;0
93;20.12.2017;2017;12;12;Keskiviikko;1;1;2
93;20.12.2017;2017;12;13;Keskiviikko;6;3;9
93;20.12.2017;2017;12;14;Keskiviikko;3;2;5
93;20.12.2017;2017;12;15;Keskiviikko;6;2;8
93;20.12.2017;2017;12;16;Keskiviikko;11;3;14
93;20.12.2017;2017;12;17;Keskiviikko;3;3;6
93;20.12.2017;2017;12;18;Keskiviikko;1;0;1
93;20.12.2017;2017;12;19;Keskiviikko;1;1;2
93;20.12.2017;2017;12;20;Keskiviikko;0;2;2
93;20.12.2017;2017;12;21;Keskiviikko;0;0;0
93;20.12.2017;2017;12;22;Keskiviikko;1;1;2
93;20.12.2017;2017;12;23;Keskiviikko;0;0;0
93;21.12.2017;2017;12;00;Torstai;0;0;0
93;21.12.2017;2017;12;01;Torstai;0;0;0
93;21.12.2017;2017;12;02;Torstai;0;0;0
93;21.12.2017;2017;12;03;Torstai;0;0;0
93;21.12.2017;2017;12;04;Torstai;1;0;1
93;21.12.2017;2017;12;05;Torstai;1;3;4
93;21.12.2017;2017;12;06;Torstai;4;4;8
93;21.12.2017;2017;12;07;Torstai;3;13;16
93;21.12.2017;2017;12;08;Torstai;7;7;14
93;21.12.2017;2017;12;09;Torstai;2;3;5
93;21.12.2017;2017;12;10;Torstai;1;1;2
93;21.12.2017;2017;12;11;Torstai;2;0;2
93;21.12.2017;2017;12;12;Torstai;2;2;4
93;21.12.2017;2017;12;13;Torstai;2;4;6
93;21.12.2017;2017;12;14;Torstai;4;3;7
93;21.12.2017;2017;12;15;Torstai;4;3;7
93;21.12.2017;2017;12;16;Torstai;14;4;18
93;21.12.2017;2017;12;17;Torstai;3;6;9
93;21.12.2017;2017;12;18;Torstai;7;3;10
93;21.12.2017;2017;12;19;Torstai;2;0;2
93;21.12.2017;2017;12;20;Torstai;1;3;4
93;21.12.2017;2017;12;21;Torstai;1;2;3
93;21.12.2017;2017;12;22;Torstai;0;0;0
93;21.12.2017;2017;12;23;Torstai;0;1;1
93;22.12.2017;2017;12;00;Perjantai;1;0;1
93;22.12.2017;2017;12;01;Perjantai;0;0;0
93;22.12.2017;2017;12;02;Perjantai;0;0;0
93;22.12.2017;2017;12;03;Perjantai;0;0;0
93;22.12.2017;2017;12;04;Perjantai;1;0;1
93;22.12.2017;2017;12;05;Perjantai;2;1;3
93;22.12.2017;2017;12;06;Perjantai;2;4;6
93;22.12.2017;2017;12;07;Perjantai;8;9;17
93;22.12.2017;2017;12;08;Perjantai;2;4;6
93;22.12.2017;2017;12;09;Perjantai;1;0;1
93;22.12.2017;2017;12;10;Perjantai;0;2;2
93;22.12.2017;2017;12;11;Perjantai;1;0;1
93;22.12.2017;2017;12;12;Perjantai;4;3;7
93;22.12.2017;2017;12;13;Perjantai;5;2;7
93;22.12.2017;2017;12;14;Perjantai;5;7;12
93;22.12.2017;2017;12;15;Perjantai;9;10;19
93;22.12.2017;2017;12;16;Perjantai;6;3;9
93;22.12.2017;2017;12;17;Perjantai;2;3;5
93;22.12.2017;2017;12;18;Perjantai;2;0;2
93;22.12.2017;2017;12;19;Perjantai;0;0;0
93;22.12.2017;2017;12;20;Perjantai;1;0;1
93;22.12.2017;2017;12;21;Perjantai;1;0;1
93;22.12.2017;2017;12;22;Perjantai;0;1;1
93;22.12.2017;2017;12;23;Perjantai;0;0;0
93;23.12.2017;2017;12;00;Lauantai;0;0;0
93;23.12.2017;2017;12;01;Lauantai;0;0;0
93;23.12.2017;2017;12;02;Lauantai;0;0;0
93;23.12.2017;2017;12;03;Lauantai;0;1;1
93;23.12.2017;2017;12;04;Lauantai;0;0;0
93;23.12.2017;2017;12;05;Lauantai;0;0;0
93;23.12.2017;2017;12;06;Lauantai;1;0;1
93;23.12.2017;2017;12;07;Lauantai;0;0;0
93;23.12.2017;2017;12;08;Lauantai;0;1;1
93;23.12.2017;2017;12;09;Lauantai;0;0;0
93;23.12.2017;2017;12;10;Lauantai;0;1;1
93;23.12.2017;2017;12;11;Lauantai;0;0;0
93;23.12.2017;2017;12;12;Lauantai;3;0;3
93;23.12.2017;2017;12;13;Lauantai;0;0;0
93;23.12.2017;2017;12;14;Lauantai;0;0;0
93;23.12.2017;2017;12;15;Lauantai;2;2;4
93;23.12.2017;2017;12;16;Lauantai;2;3;5
93;23.12.2017;2017;12;17;Lauantai;0;2;2
93;23.12.2017;2017;12;18;Lauantai;0;1;1
93;23.12.2017;2017;12;19;Lauantai;1;0;1
93;23.12.2017;2017;12;20;Lauantai;1;2;3
93;23.12.2017;2017;12;21;Lauantai;0;1;1
93;23.12.2017;2017;12;22;Lauantai;0;0;0
93;23.12.2017;2017;12;23;Lauantai;0;0;0
93;24.12.2017;2017;12;00;Sunnuntai;0;0;0
93;24.12.2017;2017;12;01;Sunnuntai;0;0;0
93;24.12.2017;2017;12;02;Sunnuntai;1;0;1
93;24.12.2017;2017;12;03;Sunnuntai;0;0;0
93;24.12.2017;2017;12;04;Sunnuntai;0;0;0
93;24.12.2017;2017;12;05;Sunnuntai;0;0;0
93;24.12.2017;2017;12;06;Sunnuntai;0;0;0
93;24.12.2017;2017;12;07;Sunnuntai;1;0;1
93;24.12.2017;2017;12;08;Sunnuntai;0;0;0
93;24.12.2017;2017;12;09;Sunnuntai;1;1;2
93;24.12.2017;2017;12;10;Sunnuntai;0;0;0
93;24.12.2017;2017;12;11;Sunnuntai;2;1;3
93;24.12.2017;2017;12;12;Sunnuntai;0;3;3
93;24.12.2017;2017;12;13;Sunnuntai;0;1;1
93;24.12.2017;2017;12;14;Sunnuntai;0;0;0
93;24.12.2017;2017;12;15;Sunnuntai;0;0;0
93;24.12.2017;2017;12;16;Sunnuntai;0;0;0
93;24.12.2017;2017;12;17;Sunnuntai;0;0;0
93;24.12.2017;2017;12;18;Sunnuntai;0;1;1
93;24.12.2017;2017;12;19;Sunnuntai;1;0;1
93;24.12.2017;2017;12;20;Sunnuntai;1;0;1
93;24.12.2017;2017;12;21;Sunnuntai;0;0;0
93;24.12.2017;2017;12;22;Sunnuntai;1;0;1
93;24.12.2017;2017;12;23;Sunnuntai;0;0;0
93;25.12.2017;2017;12;00;Maanantai;0;0;0
93;25.12.2017;2017;12;01;Maanantai;0;0;0
93;25.12.2017;2017;12;02;Maanantai;0;0;0
93;25.12.2017;2017;12;03;Maanantai;0;0;0
93;25.12.2017;2017;12;04;Maanantai;0;0;0
93;25.12.2017;2017;12;05;Maanantai;0;0;0
93;25.12.2017;2017;12;06;Maanantai;0;0;0
93;25.12.2017;2017;12;07;Maanantai;0;0;0
93;25.12.2017;2017;12;08;Maanantai;0;1;1
93;25.12.2017;2017;12;09;Maanantai;1;1;2
93;25.12.2017;2017;12;10;Maanantai;0;0;0
93;25.12.2017;2017;12;11;Maanantai;0;0;0
93;25.12.2017;2017;12;12;Maanantai;1;2;3
93;25.12.2017;2017;12;13;Maanantai;2;3;5
93;25.12.2017;2017;12;14;Maanantai;4;1;5
93;25.12.2017;2017;12;15;Maanantai;1;1;2
93;25.12.2017;2017;12;16;Maanantai;0;0;0
93;25.12.2017;2017;12;17;Maanantai;1;1;2
93;25.12.2017;2017;12;18;Maanantai;0;0;0
93;25.12.2017;2017;12;19;Maanantai;0;3;3
93;25.12.2017;2017;12;20;Maanantai;1;0;1
93;25.12.2017;2017;12;21;Maanantai;0;0;0
93;25.12.2017;2017;12;22;Maanantai;0;0;0
93;25.12.2017;2017;12;23;Maanantai;0;0;0
93;26.12.2017;2017;12;00;Tiistai;0;0;0
93;26.12.2017;2017;12;01;Tiistai;0;0;0
93;26.12.2017;2017;12;02;Tiistai;0;0;0
93;26.12.2017;2017;12;03;Tiistai;0;0;0
93;26.12.2017;2017;12;04;Tiistai;0;0;0
93;26.12.2017;2017;12;05;Tiistai;0;0;0
93;26.12.2017;2017;12;06;Tiistai;1;0;1
93;26.12.2017;2017;12;07;Tiistai;1;0;1
93;26.12.2017;2017;12;08;Tiistai;0;0;0
93;26.12.2017;2017;12;09;Tiistai;0;0;0
93;26.12.2017;2017;12;10;Tiistai;1;0;1
93;26.12.2017;2017;12;11;Tiistai;0;1;1
93;26.12.2017;2017;12;12;Tiistai;0;1;1
93;26.12.2017;2017;12;13;Tiistai;1;0;1
93;26.12.2017;2017;12;14;Tiistai;1;0;1
93;26.12.2017;2017;12;15;Tiistai;1;1;2
93;26.12.2017;2017;12;16;Tiistai;0;1;1
93;26.12.2017;2017;12;17;Tiistai;0;1;1
93;26.12.2017;2017;12;18;Tiistai;4;0;4
93;26.12.2017;2017;12;19;Tiistai;2;5;7
93;26.12.2017;2017;12;20;Tiistai;0;0;0
93;26.12.2017;2017;12;21;Tiistai;1;0;1
93;26.12.2017;2017;12;22;Tiistai;0;0;0
93;26.12.2017;2017;12;23;Tiistai;0;0;0
93;27.12.2017;2017;12;00;Keskiviikko;0;1;1
93;27.12.2017;2017;12;01;Keskiviikko;0;0;0
93;27.12.2017;2017;12;02;Keskiviikko;0;0;0
93;27.12.2017;2017;12;03;Keskiviikko;0;0;0
93;27.12.2017;2017;12;04;Keskiviikko;0;0;0
93;27.12.2017;2017;12;05;Keskiviikko;4;1;5
93;27.12.2017;2017;12;06;Keskiviikko;4;4;8
93;27.12.2017;2017;12;07;Keskiviikko;1;9;10
93;27.12.2017;2017;12;08;Keskiviikko;2;3;5
93;27.12.2017;2017;12;09;Keskiviikko;1;2;3
93;27.12.2017;2017;12;10;Keskiviikko;0;2;2
93;27.12.2017;2017;12;11;Keskiviikko;5;1;6
93;27.12.2017;2017;12;12;Keskiviikko;0;1;1
93;27.12.2017;2017;12;13;Keskiviikko;3;2;5
93;27.12.2017;2017;12;14;Keskiviikko;3;2;5
93;27.12.2017;2017;12;15;Keskiviikko;3;4;7
93;27.12.2017;2017;12;16;Keskiviikko;9;6;15
93;27.12.2017;2017;12;17;Keskiviikko;2;4;6
93;27.12.2017;2017;12;18;Keskiviikko;2;4;6
93;27.12.2017;2017;12;19;Keskiviikko;0;0;0
93;27.12.2017;2017;12;20;Keskiviikko;1;0;1
93;27.12.2017;2017;12;21;Keskiviikko;1;0;1
93;27.12.2017;2017;12;22;Keskiviikko;0;1;1
93;27.12.2017;2017;12;23;Keskiviikko;0;0;0
93;28.12.2017;2017;12;00;Torstai;1;0;1
93;28.12.2017;2017;12;01;Torstai;0;0;0
93;28.12.2017;2017;12;02;Torstai;0;0;0
93;28.12.2017;2017;12;03;Torstai;0;0;0
93;28.12.2017;2017;12;04;Torstai;0;0;0
93;28.12.2017;2017;12;05;Torstai;2;2;4
93;28.12.2017;2017;12;06;Torstai;6;5;11
93;28.12.2017;2017;12;07;Torstai;3;9;12
93;28.12.2017;2017;12;08;Torstai;3;5;8
93;28.12.2017;2017;12;09;Torstai;1;0;1
93;28.12.2017;2017;12;10;Torstai;1;3;4
93;28.12.2017;2017;12;11;Torstai;4;4;8
93;28.12.2017;2017;12;12;Torstai;1;0;1
93;28.12.2017;2017;12;13;Torstai;1;5;6
93;28.12.2017;2017;12;14;Torstai;4;0;4
93;28.12.2017;2017;12;15;Torstai;6;5;11
93;28.12.2017;2017;12;16;Torstai;9;6;15
93;28.12.2017;2017;12;17;Torstai;3;3;6
93;28.12.2017;2017;12;18;Torstai;3;1;4
93;28.12.2017;2017;12;19;Torstai;7;4;11
93;28.12.2017;2017;12;20;Torstai;0;1;1
93;28.12.2017;2017;12;21;Torstai;2;0;2
93;28.12.2017;2017;12;22;Torstai;0;2;2
93;28.12.2017;2017;12;23;Torstai;0;1;1
93;29.12.2017;2017;12;00;Perjantai;1;0;1
93;29.12.2017;2017;12;01;Perjantai;0;0;0
93;29.12.2017;2017;12;02;Perjantai;1;0;1
93;29.12.2017;2017;12;03;Perjantai;0;0;0
93;29.12.2017;2017;12;04;Perjantai;0;0;0
93;29.12.2017;2017;12;05;Perjantai;1;1;2
93;29.12.2017;2017;12;06;Perjantai;2;2;4
93;29.12.2017;2017;12;07;Perjantai;2;5;7
93;29.12.2017;2017;12;08;Perjantai;0;5;5
93;29.12.2017;2017;12;09;Perjantai;0;0;0
93;29.12.2017;2017;12;10;Perjantai;1;0;1
93;29.12.2017;2017;12;11;Perjantai;1;1;2
93;29.12.2017;2017;12;12;Perjantai;1;1;2
93;29.12.2017;2017;12;13;Perjantai;2;3;5
93;29.12.2017;2017;12;14;Perjantai;3;0;3
93;29.12.2017;2017;12;15;Perjantai;4;4;8
93;29.12.2017;2017;12;16;Perjantai;4;2;6
93;29.12.2017;2017;12;17;Perjantai;6;3;9
93;29.12.2017;2017;12;18;Perjantai;4;4;8
93;29.12.2017;2017;12;19;Perjantai;2;0;2
93;29.12.2017;2017;12;20;Perjantai;1;1;2
93;29.12.2017;2017;12;21;Perjantai;1;0;1
93;29.12.2017;2017;12;22;Perjantai;0;1;1
93;29.12.2017;2017;12;23;Perjantai;0;0;0
93;30.12.2017;2017;12;00;Lauantai;0;1;1
93;30.12.2017;2017;12;01;Lauantai;0;0;0
93;30.12.2017;2017;12;02;Lauantai;0;0;0
93;30.12.2017;2017;12;03;Lauantai;0;0;0
93;30.12.2017;2017;12;04;Lauantai;0;0;0
93;30.12.2017;2017;12;05;Lauantai;1;0;1
93;30.12.2017;2017;12;06;Lauantai;1;0;1
93;30.12.2017;2017;12;07;Lauantai;0;0;0
93;30.12.2017;2017;12;08;Lauantai;0;0;0
93;30.12.2017;2017;12;09;Lauantai;0;4;4
93;30.12.2017;2017;12;10;Lauantai;2;1;3
93;30.12.2017;2017;12;11;Lauantai;1;1;2
93;30.12.2017;2017;12;12;Lauantai;7;2;9
93;30.12.2017;2017;12;13;Lauantai;0;2;2
93;30.12.2017;2017;12;14;Lauantai;2;0;2
93;30.12.2017;2017;12;15;Lauantai;1;2;3
93;30.12.2017;2017;12;16;Lauantai;1;5;6
93;30.12.2017;2017;12;17;Lauantai;0;2;2
93;30.12.2017;2017;12;18;Lauantai;0;0;0
93;30.12.2017;2017;12;19;Lauantai;1;1;2
93;30.12.2017;2017;12;20;Lauantai;2;0;2
93;30.12.2017;2017;12;21;Lauantai;0;0;0
93;30.12.2017;2017;12;22;Lauantai;0;0;0
93;30.12.2017;2017;12;23;Lauantai;0;0;0
93;31.12.2017;2017;12;00;Sunnuntai;0;0;0
93;31.12.2017;2017;12;01;Sunnuntai;0;0;0
93;31.12.2017;2017;12;02;Sunnuntai;0;0;0
93;31.12.2017;2017;12;03;Sunnuntai;0;0;0
93;31.12.2017;2017;12;04;Sunnuntai;0;0;0
93;31.12.2017;2017;12;05;Sunnuntai;0;0;0
93;31.12.2017;2017;12;06;Sunnuntai;0;0;0
93;31.12.2017;2017;12;07;Sunnuntai;1;0;1
93;31.12.2017;2017;12;08;Sunnuntai;1;1;2
93;31.12.2017;2017;12;09;Sunnuntai;2;1;3
93;31.12.2017;2017;12;10;Sunnuntai;2;3;5
93;31.12.2017;2017;12;11;Sunnuntai;1;0;1
93;31.12.2017;2017;12;12;Sunnuntai;2;1;3
93;31.12.2017;2017;12;13;Sunnuntai;2;6;8
93;31.12.2017;2017;12;14;Sunnuntai;2;3;5
93;31.12.2017;2017;12;15;Sunnuntai;0;1;1
93;31.12.2017;2017;12;16;Sunnuntai;2;2;4
93;31.12.2017;2017;12;17;Sunnuntai;0;4;4
93;31.12.2017;2017;12;18;Sunnuntai;4;1;5
93;31.12.2017;2017;12;19;Sunnuntai;3;2;5
93;31.12.2017;2017;12;20;Sunnuntai;0;1;1
93;31.12.2017;2017;12;21;Sunnuntai;0;3;3
93;31.12.2017;2017;12;22;Sunnuntai;1;0;1
93;31.12.2017;2017;12;23;Sunnuntai;1;0;1
93;01.01.2018;2018;01;00;Maanantai;0;0;0
93;01.01.2018;2018;01;01;Maanantai;0;0;0
93;01.01.2018;2018;01;02;Maanantai;0;2;2
93;01.01.2018;2018;01;03;Maanantai;1;0;1
93;01.01.2018;2018;01;04;Maanantai;0;0;0
93;01.01.2018;2018;01;05;Maanantai;0;0;0
93;01.01.2018;2018;01;06;Maanantai;0;0;0
93;01.01.2018;2018;01;07;Maanantai;1;0;1
93;01.01.2018;2018;01;08;Maanantai;0;1;1
93;01.01.2018;2018;01;09;Maanantai;3;0;3
93;01.01.2018;2018;01;10;Maanantai;1;1;2
93;01.01.2018;2018;01;11;Maanantai;0;2;2
93;01.01.2018;2018;01;12;Maanantai;3;3;6
93;01.01.2018;2018;01;13;Maanantai;3;3;6
93;01.01.2018;2018;01;14;Maanantai;0;1;1
93;01.01.2018;2018;01;15;Maanantai;2;7;9
93;01.01.2018;2018;01;16;Maanantai;2;1;3
93;01.01.2018;2018;01;17;Maanantai;1;1;2
93;01.01.2018;2018;01;18;Maanantai;1;0;1
93;01.01.2018;2018;01;19;Maanantai;3;5;8
93;01.01.2018;2018;01;20;Maanantai;0;0;0
93;01.01.2018;2018;01;21;Maanantai;0;0;0
93;01.01.2018;2018;01;22;Maanantai;0;1;1
93;01.01.2018;2018;01;23;Maanantai;0;2;2
93;02.01.2018;2018;01;00;Tiistai;0;0;0
93;02.01.2018;2018;01;01;Tiistai;0;0;0
93;02.01.2018;2018;01;02;Tiistai;0;0;0
93;02.01.2018;2018;01;03;Tiistai;0;0;0
93;02.01.2018;2018;01;04;Tiistai;0;0;0
93;02.01.2018;2018;01;05;Tiistai;6;4;10
93;02.01.2018;2018;01;06;Tiistai;5;5;10
93;02.01.2018;2018;01;07;Tiistai;4;12;16
93;02.01.2018;2018;01;08;Tiistai;9;6;15
93;02.01.2018;2018;01;09;Tiistai;2;2;4
93;02.01.2018;2018;01;10;Tiistai;3;1;4
93;02.01.2018;2018;01;11;Tiistai;1;0;1
93;02.01.2018;2018;01;12;Tiistai;5;4;9
93;02.01.2018;2018;01;13;Tiistai;0;0;0
93;02.01.2018;2018;01;14;Tiistai;8;6;14
93;02.01.2018;2018;01;15;Tiistai;7;10;17
93;02.01.2018;2018;01;16;Tiistai;9;8;17
93;02.01.2018;2018;01;17;Tiistai;5;3;8
93;02.01.2018;2018;01;18;Tiistai;3;4;7
93;02.01.2018;2018;01;19;Tiistai;5;3;8
93;02.01.2018;2018;01;20;Tiistai;1;0;1
93;02.01.2018;2018;01;21;Tiistai;0;1;1
93;02.01.2018;2018;01;22;Tiistai;0;3;3
93;02.01.2018;2018;01;23;Tiistai;0;0;0
93;03.01.2018;2018;01;00;Keskiviikko;0;0;0
93;03.01.2018;2018;01;01;Keskiviikko;0;0;0
93;03.01.2018;2018;01;02;Keskiviikko;0;0;0
93;03.01.2018;2018;01;03;Keskiviikko;0;0;0
93;03.01.2018;2018;01;04;Keskiviikko;0;0;0
93;03.01.2018;2018;01;05;Keskiviikko;2;4;6
93;03.01.2018;2018;01;06;Keskiviikko;5;7;12
93;03.01.2018;2018;01;07;Keskiviikko;11;11;22
93;03.01.2018;2018;01;08;Keskiviikko;5;7;12
93;03.01.2018;2018;01;09;Keskiviikko;1;3;4
93;03.01.2018;2018;01;10;Keskiviikko;1;0;1
93;03.01.2018;2018;01;11;Keskiviikko;2;0;2
93;03.01.2018;2018;01;12;Keskiviikko;0;2;2
93;03.01.2018;2018;01;13;Keskiviikko;2;0;2
93;03.01.2018;2018;01;14;Keskiviikko;12;6;18
93;03.01.2018;2018;01;15;Keskiviikko;5;6;11
93;03.01.2018;2018;01;16;Keskiviikko;11;9;20
93;03.01.2018;2018;01;17;Keskiviikko;3;6;9
93;03.01.2018;2018;01;18;Keskiviikko;1;4;5
93;03.01.2018;2018;01;19;Keskiviikko;4;0;4
93;03.01.2018;2018;01;20;Keskiviikko;3;5;8
93;03.01.2018;2018;01;21;Keskiviikko;2;0;2
93;03.01.2018;2018;01;22;Keskiviikko;2;2;4
93;03.01.2018;2018;01;23;Keskiviikko;0;1;1
93;04.01.2018;2018;01;00;Torstai;1;0;1
93;04.01.2018;2018;01;01;Torstai;0;0;0
93;04.01.2018;2018;01;02;Torstai;0;0;0
93;04.01.2018;2018;01;03;Torstai;0;0;0
93;04.01.2018;2018;01;04;Torstai;0;0;0
93;04.01.2018;2018;01;05;Torstai;4;0;4
93;04.01.2018;2018;01;06;Torstai;11;0;11
93;04.01.2018;2018;01;07;Torstai;12;0;12
93;04.01.2018;2018;01;08;Torstai;8;0;8
93;04.01.2018;2018;01;09;Torstai;1;0;1
93;04.01.2018;2018;01;10;Torstai;4;0;4
93;04.01.2018;2018;01;11;Torstai;8;0;8
93;04.01.2018;2018;01;12;Torstai;1;0;1
93;04.01.2018;2018;01;13;Torstai;6;0;6
93;04.01.2018;2018;01;14;Torstai;4;0;4
93;04.01.2018;2018;01;15;Torstai;11;0;11
93;04.01.2018;2018;01;16;Torstai;15;0;15
93;04.01.2018;2018;01;17;Torstai;6;0;6
93;04.01.2018;2018;01;18;Torstai;4;0;4
93;04.01.2018;2018;01;19;Torstai;11;0;11
93;04.01.2018;2018;01;20;Torstai;1;0;1
93;04.01.2018;2018;01;21;Torstai;2;0;2
93;04.01.2018;2018;01;22;Torstai;2;0;2
93;04.01.2018;2018;01;23;Torstai;1;0;1
93;05.01.2018;2018;01;00;Perjantai;0;0;0
93;05.01.2018;2018;01;01;Perjantai;0;0;0
93;05.01.2018;2018;01;02;Perjantai;0;0;0
93;05.01.2018;2018;01;03;Perjantai;0;0;0
93;05.01.2018;2018;01;04;Perjantai;0;0;0
93;05.01.2018;2018;01;05;Perjantai;0;4;4
93;05.01.2018;2018;01;06;Perjantai;4;5;9
93;05.01.2018;2018;01;07;Perjantai;2;13;15
93;05.01.2018;2018;01;08;Perjantai;2;3;5
93;05.01.2018;2018;01;09;Perjantai;2;0;2
93;05.01.2018;2018;01;10;Perjantai;2;2;4
93;05.01.2018;2018;01;11;Perjantai;1;1;2
93;05.01.2018;2018;01;12;Perjantai;1;1;2
93;05.01.2018;2018;01;13;Perjantai;2;1;3
93;05.01.2018;2018;01;14;Perjantai;5;1;6
93;05.01.2018;2018;01;15;Perjantai;6;4;10
93;05.01.2018;2018;01;16;Perjantai;9;3;12
93;05.01.2018;2018;01;17;Perjantai;7;2;9
93;05.01.2018;2018;01;18;Perjantai;3;0;3
93;05.01.2018;2018;01;19;Perjantai;0;1;1
93;05.01.2018;2018;01;20;Perjantai;1;2;3
93;05.01.2018;2018;01;21;Perjantai;3;2;5
93;05.01.2018;2018;01;22;Perjantai;1;3;4
93;05.01.2018;2018;01;23;Perjantai;2;2;4
93;06.01.2018;2018;01;00;Lauantai;0;0;0
93;06.01.2018;2018;01;01;Lauantai;0;0;0
93;06.01.2018;2018;01;02;Lauantai;0;0;0
93;06.01.2018;2018;01;03;Lauantai;0;0;0
93;06.01.2018;2018;01;04;Lauantai;0;0;0
93;06.01.2018;2018;01;05;Lauantai;0;0;0
93;06.01.2018;2018;01;06;Lauantai;0;0;0
93;06.01.2018;2018;01;07;Lauantai;0;0;0
93;06.01.2018;2018;01;08;Lauantai;0;0;0
93;06.01.2018;2018;01;09;Lauantai;1;0;1
93;06.01.2018;2018;01;10;Lauantai;0;0;0
93;06.01.2018;2018;01;11;Lauantai;4;1;5
93;06.01.2018;2018;01;12;Lauantai;1;1;2
93;06.01.2018;2018;01;13;Lauantai;2;2;4
93;06.01.2018;2018;01;14;Lauantai;6;1;7
93;06.01.2018;2018;01;15;Lauantai;0;3;3
93;06.01.2018;2018;01;16;Lauantai;1;3;4
93;06.01.2018;2018;01;17;Lauantai;1;0;1
93;06.01.2018;2018;01;18;Lauantai;1;2;3
93;06.01.2018;2018;01;19;Lauantai;0;0;0
93;06.01.2018;2018;01;20;Lauantai;3;0;3
93;06.01.2018;2018;01;21;Lauantai;1;4;5
93;06.01.2018;2018;01;22;Lauantai;0;0;0
93;06.01.2018;2018;01;23;Lauantai;0;1;1
93;07.01.2018;2018;01;00;Sunnuntai;0;0;0
93;07.01.2018;2018;01;01;Sunnuntai;0;1;1
93;07.01.2018;2018;01;02;Sunnuntai;0;0;0
93;07.01.2018;2018;01;03;Sunnuntai;0;0;0
93;07.01.2018;2018;01;04;Sunnuntai;0;0;0
93;07.01.2018;2018;01;05;Sunnuntai;2;0;2
93;07.01.2018;2018;01;06;Sunnuntai;0;0;0
93;07.01.2018;2018;01;07;Sunnuntai;0;1;1
93;07.01.2018;2018;01;08;Sunnuntai;0;0;0
93;07.01.2018;2018;01;09;Sunnuntai;0;0;0
93;07.01.2018;2018;01;10;Sunnuntai;2;3;5
93;07.01.2018;2018;01;11;Sunnuntai;11;1;12
93;07.01.2018;2018;01;12;Sunnuntai;1;0;1
93;07.01.2018;2018;01;13;Sunnuntai;1;1;2
93;07.01.2018;2018;01;14;Sunnuntai;0;4;4
93;07.01.2018;2018;01;15;Sunnuntai;3;2;5
93;07.01.2018;2018;01;16;Sunnuntai;0;1;1
93;07.01.2018;2018;01;17;Sunnuntai;0;0;0
93;07.01.2018;2018;01;18;Sunnuntai;2;0;2
93;07.01.2018;2018;01;19;Sunnuntai;0;1;1
93;07.01.2018;2018;01;20;Sunnuntai;0;0;0
93;07.01.2018;2018;01;21;Sunnuntai;0;0;0
93;07.01.2018;2018;01;22;Sunnuntai;0;0;0
93;07.01.2018;2018;01;23;Sunnuntai;0;0;0
93;08.01.2018;2018;01;00;Maanantai;0;0;0
93;08.01.2018;2018;01;01;Maanantai;0;0;0
93;08.01.2018;2018;01;02;Maanantai;0;0;0
93;08.01.2018;2018;01;03;Maanantai;0;0;0
93;08.01.2018;2018;01;04;Maanantai;0;0;0
93;08.01.2018;2018;01;05;Maanantai;3;5;8
93;08.01.2018;2018;01;06;Maanantai;4;8;12
93;08.01.2018;2018;01;07;Maanantai;8;17;25
93;08.01.2018;2018;01;08;Maanantai;1;11;12
93;08.01.2018;2018;01;09;Maanantai;1;4;5
93;08.01.2018;2018;01;10;Maanantai;1;0;1
93;08.01.2018;2018;01;11;Maanantai;1;0;1
93;08.01.2018;2018;01;12;Maanantai;2;0;2
93;08.01.2018;2018;01;13;Maanantai;4;2;6
93;08.01.2018;2018;01;14;Maanantai;5;5;10
93;08.01.2018;2018;01;15;Maanantai;11;12;23
93;08.01.2018;2018;01;16;Maanantai;12;11;23
93;08.01.2018;2018;01;17;Maanantai;8;2;10
93;08.01.2018;2018;01;18;Maanantai;0;1;1
93;08.01.2018;2018;01;19;Maanantai;1;0;1
93;08.01.2018;2018;01;20;Maanantai;0;1;1
93;08.01.2018;2018;01;21;Maanantai;0;2;2
93;08.01.2018;2018;01;22;Maanantai;0;0;0
93;08.01.2018;2018;01;23;Maanantai;1;0;1
93;09.01.2018;2018;01;00;Tiistai;0;0;0
93;09.01.2018;2018;01;01;Tiistai;0;0;0
93;09.01.2018;2018;01;02;Tiistai;0;0;0
93;09.01.2018;2018;01;03;Tiistai;0;0;0
93;09.01.2018;2018;01;04;Tiistai;0;0;0
93;09.01.2018;2018;01;05;Tiistai;2;4;6
93;09.01.2018;2018;01;06;Tiistai;5;3;8
93;09.01.2018;2018;01;07;Tiistai;13;20;33
93;09.01.2018;2018;01;08;Tiistai;9;10;19
93;09.01.2018;2018;01;09;Tiistai;1;0;1
93;09.01.2018;2018;01;10;Tiistai;4;1;5
93;09.01.2018;2018;01;11;Tiistai;2;4;6
93;09.01.2018;2018;01;12;Tiistai;5;4;9
93;09.01.2018;2018;01;13;Tiistai;3;2;5
93;09.01.2018;2018;01;14;Tiistai;8;2;10
93;09.01.2018;2018;01;15;Tiistai;8;6;14
93;09.01.2018;2018;01;16;Tiistai;20;10;30
93;09.01.2018;2018;01;17;Tiistai;6;13;19
93;09.01.2018;2018;01;18;Tiistai;3;5;8
93;09.01.2018;2018;01;19;Tiistai;2;5;7
93;09.01.2018;2018;01;20;Tiistai;0;3;3
93;09.01.2018;2018;01;21;Tiistai;1;1;2
93;09.01.2018;2018;01;22;Tiistai;1;2;3
93;09.01.2018;2018;01;23;Tiistai;0;0;0
93;10.01.2018;2018;01;00;Keskiviikko;1;0;1
93;10.01.2018;2018;01;01;Keskiviikko;0;0;0
93;10.01.2018;2018;01;02;Keskiviikko;0;0;0
93;10.01.2018;2018;01;03;Keskiviikko;0;0;0
93;10.01.2018;2018;01;04;Keskiviikko;0;0;0
93;10.01.2018;2018;01;05;Keskiviikko;2;4;6
93;10.01.2018;2018;01;06;Keskiviikko;8;4;12
93;10.01.2018;2018;01;07;Keskiviikko;13;20;33
93;10.01.2018;2018;01;08;Keskiviikko;6;10;16
93;10.01.2018;2018;01;09;Keskiviikko;2;5;7
93;10.01.2018;2018;01;10;Keskiviikko;2;1;3
93;10.01.2018;2018;01;11;Keskiviikko;5;1;6
93;10.01.2018;2018;01;12;Keskiviikko;2;2;4
93;10.01.2018;2018;01;13;Keskiviikko;4;3;7
93;10.01.2018;2018;01;14;Keskiviikko;5;5;10
93;10.01.2018;2018;01;15;Keskiviikko;4;11;15
93;10.01.2018;2018;01;16;Keskiviikko;23;14;37
93;10.01.2018;2018;01;17;Keskiviikko;5;4;9
93;10.01.2018;2018;01;18;Keskiviikko;2;3;5
93;10.01.2018;2018;01;19;Keskiviikko;3;0;3
93;10.01.2018;2018;01;20;Keskiviikko;1;1;2
93;10.01.2018;2018;01;21;Keskiviikko;1;1;2
93;10.01.2018;2018;01;22;Keskiviikko;0;0;0
93;10.01.2018;2018;01;23;Keskiviikko;0;0;0
93;11.01.2018;2018;01;00;Torstai;1;0;1
93;11.01.2018;2018;01;01;Torstai;0;0;0
93;11.01.2018;2018;01;02;Torstai;0;0;0
93;11.01.2018;2018;01;03;Torstai;0;0;0
93;11.01.2018;2018;01;04;Torstai;0;0;0
93;11.01.2018;2018;01;05;Torstai;1;4;5
93;11.01.2018;2018;01;06;Torstai;5;3;8
93;11.01.2018;2018;01;07;Torstai;15;13;28
93;11.01.2018;2018;01;08;Torstai;6;14;20
93;11.01.2018;2018;01;09;Torstai;4;0;4
93;11.01.2018;2018;01;10;Torstai;0;2;2
93;11.01.2018;2018;01;11;Torstai;1;1;2
93;11.01.2018;2018;01;12;Torstai;4;1;5
93;11.01.2018;2018;01;13;Torstai;4;1;5
93;11.01.2018;2018;01;14;Torstai;8;1;9
93;11.01.2018;2018;01;15;Torstai;1;10;11
93;11.01.2018;2018;01;16;Torstai;18;12;30
93;11.01.2018;2018;01;17;Torstai;1;4;5
93;11.01.2018;2018;01;18;Torstai;2;4;6
93;11.01.2018;2018;01;19;Torstai;1;2;3
93;11.01.2018;2018;01;20;Torstai;1;1;2
93;11.01.2018;2018;01;21;Torstai;0;1;1
93;11.01.2018;2018;01;22;Torstai;1;2;3
93;11.01.2018;2018;01;23;Torstai;0;0;0
93;12.01.2018;2018;01;00;Perjantai;1;0;1
93;12.01.2018;2018;01;01;Perjantai;0;0;0
93;12.01.2018;2018;01;02;Perjantai;0;0;0
93;12.01.2018;2018;01;03;Perjantai;0;0;0
93;12.01.2018;2018;01;04;Perjantai;0;0;0
93;12.01.2018;2018;01;05;Perjantai;1;4;5
93;12.01.2018;2018;01;06;Perjantai;9;1;10
93;12.01.2018;2018;01;07;Perjantai;7;16;23
93;12.01.2018;2018;01;08;Perjantai;3;13;16
93;12.01.2018;2018;01;09;Perjantai;0;2;2
93;12.01.2018;2018;01;10;Perjantai;6;0;6
93;12.01.2018;2018;01;11;Perjantai;1;0;1
93;12.01.2018;2018;01;12;Perjantai;3;2;5
93;12.01.2018;2018;01;13;Perjantai;7;0;7
93;12.01.2018;2018;01;14;Perjantai;7;9;16
93;12.01.2018;2018;01;15;Perjantai;7;8;15
93;12.01.2018;2018;01;16;Perjantai;11;9;20
93;12.01.2018;2018;01;17;Perjantai;9;5;14
93;12.01.2018;2018;01;18;Perjantai;4;3;7
93;12.01.2018;2018;01;19;Perjantai;2;6;8
93;12.01.2018;2018;01;20;Perjantai;1;1;2
93;12.01.2018;2018;01;21;Perjantai;4;5;9
93;12.01.2018;2018;01;22;Perjantai;2;1;3
93;12.01.2018;2018;01;23;Perjantai;1;1;2
93;13.01.2018;2018;01;00;Lauantai;0;0;0
93;13.01.2018;2018;01;01;Lauantai;0;0;0
93;13.01.2018;2018;01;02;Lauantai;1;0;1
93;13.01.2018;2018;01;03;Lauantai;0;0;0
93;13.01.2018;2018;01;04;Lauantai;0;0;0
93;13.01.2018;2018;01;05;Lauantai;0;0;0
93;13.01.2018;2018;01;06;Lauantai;1;0;1
93;13.01.2018;2018;01;07;Lauantai;4;0;4
93;13.01.2018;2018;01;08;Lauantai;0;0;0
93;13.01.2018;2018;01;09;Lauantai;2;2;4
93;13.01.2018;2018;01;10;Lauantai;1;2;3
93;13.01.2018;2018;01;11;Lauantai;7;0;7
93;13.01.2018;2018;01;12;Lauantai;2;3;5
93;13.01.2018;2018;01;13;Lauantai;3;4;7
93;13.01.2018;2018;01;14;Lauantai;2;7;9
93;13.01.2018;2018;01;15;Lauantai;4;4;8
93;13.01.2018;2018;01;16;Lauantai;2;3;5
93;13.01.2018;2018;01;17;Lauantai;1;2;3
93;13.01.2018;2018;01;18;Lauantai;1;1;2
93;13.01.2018;2018;01;19;Lauantai;0;4;4
93;13.01.2018;2018;01;20;Lauantai;1;1;2
93;13.01.2018;2018;01;21;Lauantai;0;0;0
93;13.01.2018;2018;01;22;Lauantai;0;0;0
93;13.01.2018;2018;01;23;Lauantai;1;0;1
93;14.01.2018;2018;01;00;Sunnuntai;1;0;1
93;14.01.2018;2018;01;01;Sunnuntai;0;0;0
93;14.01.2018;2018;01;02;Sunnuntai;0;0;0
93;14.01.2018;2018;01;03;Sunnuntai;0;0;0
93;14.01.2018;2018;01;04;Sunnuntai;0;1;1
93;14.01.2018;2018;01;05;Sunnuntai;1;0;1
93;14.01.2018;2018;01;06;Sunnuntai;1;0;1
93;14.01.2018;2018;01;07;Sunnuntai;1;0;1
93;14.01.2018;2018;01;08;Sunnuntai;2;2;4
93;14.01.2018;2018;01;09;Sunnuntai;5;0;5
93;14.01.2018;2018;01;10;Sunnuntai;5;0;5
93;14.01.2018;2018;01;11;Sunnuntai;2;3;5
93;14.01.2018;2018;01;12;Sunnuntai;15;5;20
93;14.01.2018;2018;01;13;Sunnuntai;2;3;5
93;14.01.2018;2018;01;14;Sunnuntai;5;2;7
93;14.01.2018;2018;01;15;Sunnuntai;1;5;6
93;14.01.2018;2018;01;16;Sunnuntai;2;3;5
93;14.01.2018;2018;01;17;Sunnuntai;2;1;3
93;14.01.2018;2018;01;18;Sunnuntai;2;8;10
93;14.01.2018;2018;01;19;Sunnuntai;2;0;2
93;14.01.2018;2018;01;20;Sunnuntai;2;0;2
93;14.01.2018;2018;01;21;Sunnuntai;1;1;2
93;14.01.2018;2018;01;22;Sunnuntai;0;2;2
93;14.01.2018;2018;01;23;Sunnuntai;0;1;1
93;15.01.2018;2018;01;00;Maanantai;0;0;0
93;15.01.2018;2018;01;01;Maanantai;0;0;0
93;15.01.2018;2018;01;02;Maanantai;0;0;0
93;15.01.2018;2018;01;03;Maanantai;2;0;2
93;15.01.2018;2018;01;04;Maanantai;0;1;1
93;15.01.2018;2018;01;05;Maanantai;2;3;5
93;15.01.2018;2018;01;06;Maanantai;7;6;13
93;15.01.2018;2018;01;07;Maanantai;11;14;25
93;15.01.2018;2018;01;08;Maanantai;10;9;19
93;15.01.2018;2018;01;09;Maanantai;3;2;5
93;15.01.2018;2018;01;10;Maanantai;2;3;5
93;15.01.2018;2018;01;11;Maanantai;0;2;2
93;15.01.2018;2018;01;12;Maanantai;1;5;6
93;15.01.2018;2018;01;13;Maanantai;4;0;4
93;15.01.2018;2018;01;14;Maanantai;4;3;7
93;15.01.2018;2018;01;15;Maanantai;10;10;20
93;15.01.2018;2018;01;16;Maanantai;10;10;20
93;15.01.2018;2018;01;17;Maanantai;11;5;16
93;15.01.2018;2018;01;18;Maanantai;0;3;3
93;15.01.2018;2018;01;19;Maanantai;2;0;2
93;15.01.2018;2018;01;20;Maanantai;3;0;3
93;15.01.2018;2018;01;21;Maanantai;0;0;0
93;15.01.2018;2018;01;22;Maanantai;0;0;0
93;15.01.2018;2018;01;23;Maanantai;0;1;1
93;16.01.2018;2018;01;00;Tiistai;0;0;0
93;16.01.2018;2018;01;01;Tiistai;0;0;0
93;16.01.2018;2018;01;02;Tiistai;0;0;0
93;16.01.2018;2018;01;03;Tiistai;0;0;0
93;16.01.2018;2018;01;04;Tiistai;0;0;0
93;16.01.2018;2018;01;05;Tiistai;2;4;6
93;16.01.2018;2018;01;06;Tiistai;7;5;12
93;16.01.2018;2018;01;07;Tiistai;7;15;22
93;16.01.2018;2018;01;08;Tiistai;4;10;14
93;16.01.2018;2018;01;09;Tiistai;2;3;5
93;16.01.2018;2018;01;10;Tiistai;2;2;4
93;16.01.2018;2018;01;11;Tiistai;2;1;3
93;16.01.2018;2018;01;12;Tiistai;1;3;4
93;16.01.2018;2018;01;13;Tiistai;1;1;2
93;16.01.2018;2018;01;14;Tiistai;8;0;8
93;16.01.2018;2018;01;15;Tiistai;7;7;14
93;16.01.2018;2018;01;16;Tiistai;10;8;18
93;16.01.2018;2018;01;17;Tiistai;3;5;8
93;16.01.2018;2018;01;18;Tiistai;7;2;9
93;16.01.2018;2018;01;19;Tiistai;3;3;6
93;16.01.2018;2018;01;20;Tiistai;0;1;1
93;16.01.2018;2018;01;21;Tiistai;0;0;0
93;16.01.2018;2018;01;22;Tiistai;1;1;2
93;16.01.2018;2018;01;23;Tiistai;0;0;0
93;17.01.2018;2018;01;00;Keskiviikko;0;0;0
93;17.01.2018;2018;01;01;Keskiviikko;0;1;1
93;17.01.2018;2018;01;02;Keskiviikko;0;0;0
93;17.01.2018;2018;01;03;Keskiviikko;0;0;0
93;17.01.2018;2018;01;04;Keskiviikko;0;0;0
93;17.01.2018;2018;01;05;Keskiviikko;3;3;6
93;17.01.2018;2018;01;06;Keskiviikko;4;3;7
93;17.01.2018;2018;01;07;Keskiviikko;5;15;20
93;17.01.2018;2018;01;08;Keskiviikko;5;7;12
93;17.01.2018;2018;01;09;Keskiviikko;2;1;3
93;17.01.2018;2018;01;10;Keskiviikko;1;1;2
93;17.01.2018;2018;01;11;Keskiviikko;1;0;1
93;17.01.2018;2018;01;12;Keskiviikko;1;0;1
93;17.01.2018;2018;01;13;Keskiviikko;4;1;5
93;17.01.2018;2018;01;14;Keskiviikko;4;2;6
93;17.01.2018;2018;01;15;Keskiviikko;6;6;12
93;17.01.2018;2018;01;16;Keskiviikko;13;10;23
93;17.01.2018;2018;01;17;Keskiviikko;5;6;11
93;17.01.2018;2018;01;18;Keskiviikko;3;2;5
93;17.01.2018;2018;01;19;Keskiviikko;1;0;1
93;17.01.2018;2018;01;20;Keskiviikko;0;0;0
93;17.01.2018;2018;01;21;Keskiviikko;1;0;1
93;17.01.2018;2018;01;22;Keskiviikko;1;0;1
93;17.01.2018;2018;01;23;Keskiviikko;0;1;1
93;18.01.2018;2018;01;00;Torstai;0;0;0
93;18.01.2018;2018;01;01;Torstai;0;0;0
93;18.01.2018;2018;01;02;Torstai;0;0;0
93;18.01.2018;2018;01;03;Torstai;0;0;0
93;18.01.2018;2018;01;04;Torstai;0;0;0
93;18.01.2018;2018;01;05;Torstai;2;3;5
93;18.01.2018;2018;01;06;Torstai;4;4;8
93;18.01.2018;2018;01;07;Torstai;7;11;18
93;18.01.2018;2018;01;08;Torstai;1;7;8
93;18.01.2018;2018;01;09;Torstai;1;1;2
93;18.01.2018;2018;01;10;Torstai;2;2;4
93;18.01.2018;2018;01;11;Torstai;3;0;3
93;18.01.2018;2018;01;12;Torstai;1;1;2
93;18.01.2018;2018;01;13;Torstai;2;1;3
93;18.01.2018;2018;01;14;Torstai;4;4;8
93;18.01.2018;2018;01;15;Torstai;4;5;9
93;18.01.2018;2018;01;16;Torstai;13;9;22
93;18.01.2018;2018;01;17;Torstai;9;3;12
93;18.01.2018;2018;01;18;Torstai;1;3;4
93;18.01.2018;2018;01;19;Torstai;2;4;6
93;18.01.2018;2018;01;20;Torstai;1;1;2
93;18.01.2018;2018;01;21;Torstai;2;0;2
93;18.01.2018;2018;01;22;Torstai;0;2;2
93;18.01.2018;2018;01;23;Torstai;0;0;0
93;19.01.2018;2018;01;00;Perjantai;0;0;0
93;19.01.2018;2018;01;01;Perjantai;0;0;0
93;19.01.2018;2018;01;02;Perjantai;0;0;0
93;19.01.2018;2018;01;03;Perjantai;0;0;0
93;19.01.2018;2018;01;04;Perjantai;0;0;0
93;19.01.2018;2018;01;05;Perjantai;1;3;4
93;19.01.2018;2018;01;06;Perjantai;7;4;11
93;19.01.2018;2018;01;07;Perjantai;10;10;20
93;19.01.2018;2018;01;08;Perjantai;1;6;7
93;19.01.2018;2018;01;09;Perjantai;3;0;3
93;19.01.2018;2018;01;10;Perjantai;1;2;3
93;19.01.2018;2018;01;11;Perjantai;4;2;6
93;19.01.2018;2018;01;12;Perjantai;0;2;2
93;19.01.2018;2018;01;13;Perjantai;3;2;5
93;19.01.2018;2018;01;14;Perjantai;8;2;10
93;19.01.2018;2018;01;15;Perjantai;4;10;14
93;19.01.2018;2018;01;16;Perjantai;5;4;9
93;19.01.2018;2018;01;17;Perjantai;8;6;14
93;19.01.2018;2018;01;18;Perjantai;3;1;4
93;19.01.2018;2018;01;19;Perjantai;1;0;1
93;19.01.2018;2018;01;20;Perjantai;0;2;2
93;19.01.2018;2018;01;21;Perjantai;0;0;0
93;19.01.2018;2018;01;22;Perjantai;0;0;0
93;19.01.2018;2018;01;23;Perjantai;0;0;0
93;20.01.2018;2018;01;00;Lauantai;0;0;0
93;20.01.2018;2018;01;01;Lauantai;0;0;0
93;20.01.2018;2018;01;02;Lauantai;0;0;0
93;20.01.2018;2018;01;03;Lauantai;0;0;0
93;20.01.2018;2018;01;04;Lauantai;0;0;0
93;20.01.2018;2018;01;05;Lauantai;0;0;0
93;20.01.2018;2018;01;06;Lauantai;0;0;0
93;20.01.2018;2018;01;07;Lauantai;0;0;0
93;20.01.2018;2018;01;08;Lauantai;0;0;0
93;20.01.2018;2018;01;09;Lauantai;0;0;0
93;20.01.2018;2018;01;10;Lauantai;1;3;4
93;20.01.2018;2018;01;11;Lauantai;2;2;4
93;20.01.2018;2018;01;12;Lauantai;2;2;4
93;20.01.2018;2018;01;13;Lauantai;0;0;0
93;20.01.2018;2018;01;14;Lauantai;1;1;2
93;20.01.2018;2018;01;15;Lauantai;3;2;5
93;20.01.2018;2018;01;16;Lauantai;1;0;1
93;20.01.2018;2018;01;17;Lauantai;0;1;1
93;20.01.2018;2018;01;18;Lauantai;0;1;1
93;20.01.2018;2018;01;19;Lauantai;0;1;1
93;20.01.2018;2018;01;20;Lauantai;2;0;2
93;20.01.2018;2018;01;21;Lauantai;1;0;1
93;20.01.2018;2018;01;22;Lauantai;0;2;2
93;20.01.2018;2018;01;23;Lauantai;1;0;1
93;21.01.2018;2018;01;00;Sunnuntai;2;0;2
93;21.01.2018;2018;01;01;Sunnuntai;0;0;0
93;21.01.2018;2018;01;02;Sunnuntai;0;2;2
93;21.01.2018;2018;01;03;Sunnuntai;0;0;0
93;21.01.2018;2018;01;04;Sunnuntai;0;0;0
93;21.01.2018;2018;01;05;Sunnuntai;1;0;1
93;21.01.2018;2018;01;06;Sunnuntai;0;0;0
93;21.01.2018;2018;01;07;Sunnuntai;1;0;1
93;21.01.2018;2018;01;08;Sunnuntai;0;0;0
93;21.01.2018;2018;01;09;Sunnuntai;1;0;1
93;21.01.2018;2018;01;10;Sunnuntai;1;3;4
93;21.01.2018;2018;01;11;Sunnuntai;10;2;12
93;21.01.2018;2018;01;12;Sunnuntai;0;0;0
93;21.01.2018;2018;01;13;Sunnuntai;1;1;2
93;21.01.2018;2018;01;14;Sunnuntai;0;2;2
93;21.01.2018;2018;01;15;Sunnuntai;1;1;2
93;21.01.2018;2018;01;16;Sunnuntai;0;1;1
93;21.01.2018;2018;01;17;Sunnuntai;1;1;2
93;21.01.2018;2018;01;18;Sunnuntai;0;0;0
93;21.01.2018;2018;01;19;Sunnuntai;0;0;0
93;21.01.2018;2018;01;20;Sunnuntai;3;0;3
93;21.01.2018;2018;01;21;Sunnuntai;0;0;0
93;21.01.2018;2018;01;22;Sunnuntai;0;0;0
93;21.01.2018;2018;01;23;Sunnuntai;0;0;0
93;22.01.2018;2018;01;00;Maanantai;0;0;0
93;22.01.2018;2018;01;01;Maanantai;0;0;0
93;22.01.2018;2018;01;02;Maanantai;0;0;0
93;22.01.2018;2018;01;03;Maanantai;0;0;0
93;22.01.2018;2018;01;04;Maanantai;0;0;0
93;22.01.2018;2018;01;05;Maanantai;1;3;4
93;22.01.2018;2018;01;06;Maanantai;4;4;8
93;22.01.2018;2018;01;07;Maanantai;4;14;18
93;22.01.2018;2018;01;08;Maanantai;2;8;10
93;22.01.2018;2018;01;09;Maanantai;1;3;4
93;22.01.2018;2018;01;10;Maanantai;0;1;1
93;22.01.2018;2018;01;11;Maanantai;0;2;2
93;22.01.2018;2018;01;12;Maanantai;0;0;0
93;22.01.2018;2018;01;13;Maanantai;3;0;3
93;22.01.2018;2018;01;14;Maanantai;8;2;10
93;22.01.2018;2018;01;15;Maanantai;5;4;9
93;22.01.2018;2018;01;16;Maanantai;12;3;15
93;22.01.2018;2018;01;17;Maanantai;6;1;7
93;22.01.2018;2018;01;18;Maanantai;0;0;0
93;22.01.2018;2018;01;19;Maanantai;1;0;1
93;22.01.2018;2018;01;20;Maanantai;0;1;1
93;22.01.2018;2018;01;21;Maanantai;0;1;1
93;22.01.2018;2018;01;22;Maanantai;0;1;1
93;22.01.2018;2018;01;23;Maanantai;0;0;0
93;23.01.2018;2018;01;00;Tiistai;0;1;1
93;23.01.2018;2018;01;01;Tiistai;0;0;0
93;23.01.2018;2018;01;02;Tiistai;0;0;0
93;23.01.2018;2018;01;03;Tiistai;0;0;0
93;23.01.2018;2018;01;04;Tiistai;0;0;0
93;23.01.2018;2018;01;05;Tiistai;0;4;4
93;23.01.2018;2018;01;06;Tiistai;3;1;4
93;23.01.2018;2018;01;07;Tiistai;4;8;12
93;23.01.2018;2018;01;08;Tiistai;0;5;5
93;23.01.2018;2018;01;09;Tiistai;1;1;2
93;23.01.2018;2018;01;10;Tiistai;0;0;0
93;23.01.2018;2018;01;11;Tiistai;2;0;2
93;23.01.2018;2018;01;12;Tiistai;0;0;0
93;23.01.2018;2018;01;13;Tiistai;6;0;6
93;23.01.2018;2018;01;14;Tiistai;4;1;5
93;23.01.2018;2018;01;15;Tiistai;2;3;5
93;23.01.2018;2018;01;16;Tiistai;11;2;13
93;23.01.2018;2018;01;17;Tiistai;2;2;4
93;23.01.2018;2018;01;18;Tiistai;1;0;1
93;23.01.2018;2018;01;19;Tiistai;0;3;3
93;23.01.2018;2018;01;20;Tiistai;0;2;2
93;23.01.2018;2018;01;21;Tiistai;0;1;1
93;23.01.2018;2018;01;22;Tiistai;0;1;1
93;23.01.2018;2018;01;23;Tiistai;0;1;1
93;24.01.2018;2018;01;00;Keskiviikko;0;0;0
93;24.01.2018;2018;01;01;Keskiviikko;0;0;0
93;24.01.2018;2018;01;02;Keskiviikko;0;0;0
93;24.01.2018;2018;01;03;Keskiviikko;0;0;0
93;24.01.2018;2018;01;04;Keskiviikko;0;0;0
93;24.01.2018;2018;01;05;Keskiviikko;3;4;7
93;24.01.2018;2018;01;06;Keskiviikko;5;4;9
93;24.01.2018;2018;01;07;Keskiviikko;9;11;20
93;24.01.2018;2018;01;08;Keskiviikko;4;10;14
93;24.01.2018;2018;01;09;Keskiviikko;5;3;8
93;24.01.2018;2018;01;10;Keskiviikko;4;0;4
93;24.01.2018;2018;01;11;Keskiviikko;3;3;6
93;24.01.2018;2018;01;12;Keskiviikko;0;1;1
93;24.01.2018;2018;01;13;Keskiviikko;4;3;7
93;24.01.2018;2018;01;14;Keskiviikko;4;4;8
93;24.01.2018;2018;01;15;Keskiviikko;4;5;9
93;24.01.2018;2018;01;16;Keskiviikko;21;6;27
93;24.01.2018;2018;01;17;Keskiviikko;5;4;9
93;24.01.2018;2018;01;18;Keskiviikko;2;2;4
93;24.01.2018;2018;01;19;Keskiviikko;0;0;0
93;24.01.2018;2018;01;20;Keskiviikko;0;3;3
93;24.01.2018;2018;01;21;Keskiviikko;1;1;2
93;24.01.2018;2018;01;22;Keskiviikko;0;0;0
93;24.01.2018;2018;01;23;Keskiviikko;0;1;1
93;25.01.2018;2018;01;00;Torstai;2;1;3
93;25.01.2018;2018;01;01;Torstai;0;0;0
93;25.01.2018;2018;01;02;Torstai;0;0;0
93;25.01.2018;2018;01;03;Torstai;0;0;0
93;25.01.2018;2018;01;04;Torstai;0;0;0
93;25.01.2018;2018;01;05;Torstai;2;2;4
93;25.01.2018;2018;01;06;Torstai;5;4;9
93;25.01.2018;2018;01;07;Torstai;7;9;16
93;25.01.2018;2018;01;08;Torstai;3;10;13
93;25.01.2018;2018;01;09;Torstai;2;3;5
93;25.01.2018;2018;01;10;Torstai;0;5;5
93;25.01.2018;2018;01;11;Torstai;0;0;0
93;25.01.2018;2018;01;12;Torstai;1;1;2
93;25.01.2018;2018;01;13;Torstai;3;2;5
93;25.01.2018;2018;01;14;Torstai;3;3;6
93;25.01.2018;2018;01;15;Torstai;8;6;14
93;25.01.2018;2018;01;16;Torstai;9;5;14
93;25.01.2018;2018;01;17;Torstai;10;3;13
93;25.01.2018;2018;01;18;Torstai;0;3;3
93;25.01.2018;2018;01;19;Torstai;3;0;3
93;25.01.2018;2018;01;20;Torstai;0;1;1
93;25.01.2018;2018;01;21;Torstai;1;0;1
93;25.01.2018;2018;01;22;Torstai;0;1;1
93;25.01.2018;2018;01;23;Torstai;1;0;1
93;26.01.2018;2018;01;00;Perjantai;1;1;2
93;26.01.2018;2018;01;01;Perjantai;0;0;0
93;26.01.2018;2018;01;02;Perjantai;0;0;0
93;26.01.2018;2018;01;03;Perjantai;0;0;0
93;26.01.2018;2018;01;04;Perjantai;0;0;0
93;26.01.2018;2018;01;05;Perjantai;1;2;3
93;26.01.2018;2018;01;06;Perjantai;8;2;10
93;26.01.2018;2018;01;07;Perjantai;5;11;16
93;26.01.2018;2018;01;08;Perjantai;3;13;16
93;26.01.2018;2018;01;09;Perjantai;4;1;5
93;26.01.2018;2018;01;10;Perjantai;1;0;1
93;26.01.2018;2018;01;11;Perjantai;1;1;2
93;26.01.2018;2018;01;12;Perjantai;6;2;8
93;26.01.2018;2018;01;13;Perjantai;2;3;5
93;26.01.2018;2018;01;14;Perjantai;6;1;7
93;26.01.2018;2018;01;15;Perjantai;9;8;17
93;26.01.2018;2018;01;16;Perjantai;12;3;15
93;26.01.2018;2018;01;17;Perjantai;7;5;12
93;26.01.2018;2018;01;18;Perjantai;4;2;6
93;26.01.2018;2018;01;19;Perjantai;1;3;4
93;26.01.2018;2018;01;20;Perjantai;1;2;3
93;26.01.2018;2018;01;21;Perjantai;2;1;3
93;26.01.2018;2018;01;22;Perjantai;0;0;0
93;26.01.2018;2018;01;23;Perjantai;1;0;1
93;27.01.2018;2018;01;00;Lauantai;0;1;1
93;27.01.2018;2018;01;01;Lauantai;0;0;0
93;27.01.2018;2018;01;02;Lauantai;0;0;0
93;27.01.2018;2018;01;03;Lauantai;0;0;0
93;27.01.2018;2018;01;04;Lauantai;0;0;0
93;27.01.2018;2018;01;05;Lauantai;0;1;1
93;27.01.2018;2018;01;06;Lauantai;1;0;1
93;27.01.2018;2018;01;07;Lauantai;2;1;3
93;27.01.2018;2018;01;08;Lauantai;0;1;1
93;27.01.2018;2018;01;09;Lauantai;1;3;4
93;27.01.2018;2018;01;10;Lauantai;7;3;10
93;27.01.2018;2018;01;11;Lauantai;1;0;1
93;27.01.2018;2018;01;12;Lauantai;5;6;11
93;27.01.2018;2018;01;13;Lauantai;2;2;4
93;27.01.2018;2018;01;14;Lauantai;4;0;4
93;27.01.2018;2018;01;15;Lauantai;3;1;4
93;27.01.2018;2018;01;16;Lauantai;0;3;3
93;27.01.2018;2018;01;17;Lauantai;2;2;4
93;27.01.2018;2018;01;18;Lauantai;3;0;3
93;27.01.2018;2018;01;19;Lauantai;1;1;2
93;27.01.2018;2018;01;20;Lauantai;2;1;3
93;27.01.2018;2018;01;21;Lauantai;0;0;0
93;27.01.2018;2018;01;22;Lauantai;0;0;0
93;27.01.2018;2018;01;23;Lauantai;0;0;0
93;28.01.2018;2018;01;00;Sunnuntai;0;2;2
93;28.01.2018;2018;01;01;Sunnuntai;2;0;2
93;28.01.2018;2018;01;02;Sunnuntai;0;2;2
93;28.01.2018;2018;01;03;Sunnuntai;0;0;0
93;28.01.2018;2018;01;04;Sunnuntai;0;0;0
93;28.01.2018;2018;01;05;Sunnuntai;1;1;2
93;28.01.2018;2018;01;06;Sunnuntai;0;0;0
93;28.01.2018;2018;01;07;Sunnuntai;0;0;0
93;28.01.2018;2018;01;08;Sunnuntai;0;1;1
93;28.01.2018;2018;01;09;Sunnuntai;4;0;4
93;28.01.2018;2018;01;10;Sunnuntai;2;5;7
93;28.01.2018;2018;01;11;Sunnuntai;7;2;9
93;28.01.2018;2018;01;12;Sunnuntai;1;2;3
93;28.01.2018;2018;01;13;Sunnuntai;3;1;4
93;28.01.2018;2018;01;14;Sunnuntai;0;3;3
93;28.01.2018;2018;01;15;Sunnuntai;1;2;3
93;28.01.2018;2018;01;16;Sunnuntai;2;2;4
93;28.01.2018;2018;01;17;Sunnuntai;3;1;4
93;28.01.2018;2018;01;18;Sunnuntai;1;0;1
93;28.01.2018;2018;01;19;Sunnuntai;0;2;2
93;28.01.2018;2018;01;20;Sunnuntai;2;2;4
93;28.01.2018;2018;01;21;Sunnuntai;1;3;4
93;28.01.2018;2018;01;22;Sunnuntai;2;0;2
93;28.01.2018;2018;01;23;Sunnuntai;0;0;0
93;29.01.2018;2018;01;00;Maanantai;0;0;0
93;29.01.2018;2018;01;01;Maanantai;0;0;0
93;29.01.2018;2018;01;02;Maanantai;0;0;0
93;29.01.2018;2018;01;03;Maanantai;0;0;0
93;29.01.2018;2018;01;04;Maanantai;0;0;0
93;29.01.2018;2018;01;05;Maanantai;4;3;7
93;29.01.2018;2018;01;06;Maanantai;8;4;12
93;29.01.2018;2018;01;07;Maanantai;10;16;26
93;29.01.2018;2018;01;08;Maanantai;7;13;20
93;29.01.2018;2018;01;09;Maanantai;1;1;2
93;29.01.2018;2018;01;10;Maanantai;4;3;7
93;29.01.2018;2018;01;11;Maanantai;2;1;3
93;29.01.2018;2018;01;12;Maanantai;2;3;5
93;29.01.2018;2018;01;13;Maanantai;6;1;7
93;29.01.2018;2018;01;14;Maanantai;7;5;12
93;29.01.2018;2018;01;15;Maanantai;7;5;12
93;29.01.2018;2018;01;16;Maanantai;15;8;23
93;29.01.2018;2018;01;17;Maanantai;7;5;12
93;29.01.2018;2018;01;18;Maanantai;2;7;9
93;29.01.2018;2018;01;19;Maanantai;1;0;1
93;29.01.2018;2018;01;20;Maanantai;0;0;0
93;29.01.2018;2018;01;21;Maanantai;0;0;0
93;29.01.2018;2018;01;22;Maanantai;0;0;0
93;29.01.2018;2018;01;23;Maanantai;0;1;1
93;30.01.2018;2018;01;00;Tiistai;0;0;0
93;30.01.2018;2018;01;01;Tiistai;0;0;0
93;30.01.2018;2018;01;02;Tiistai;0;0;0
93;30.01.2018;2018;01;03;Tiistai;0;0;0
93;30.01.2018;2018;01;04;Tiistai;0;0;0
93;30.01.2018;2018;01;05;Tiistai;3;3;6
93;30.01.2018;2018;01;06;Tiistai;8;4;12
93;30.01.2018;2018;01;07;Tiistai;7;14;21
93;30.01.2018;2018;01;08;Tiistai;3;10;13
93;30.01.2018;2018;01;09;Tiistai;2;1;3
93;30.01.2018;2018;01;10;Tiistai;0;1;1
93;30.01.2018;2018;01;11;Tiistai;3;1;4
93;30.01.2018;2018;01;12;Tiistai;2;3;5
93;30.01.2018;2018;01;13;Tiistai;0;0;0
93;30.01.2018;2018;01;14;Tiistai;6;5;11
93;30.01.2018;2018;01;15;Tiistai;8;6;14
93;30.01.2018;2018;01;16;Tiistai;16;9;25
93;30.01.2018;2018;01;17;Tiistai;3;2;5
93;30.01.2018;2018;01;18;Tiistai;2;1;3
93;30.01.2018;2018;01;19;Tiistai;0;3;3
93;30.01.2018;2018;01;20;Tiistai;2;2;4
93;30.01.2018;2018;01;21;Tiistai;3;0;3
93;30.01.2018;2018;01;22;Tiistai;0;1;1
93;30.01.2018;2018;01;23;Tiistai;0;0;0
93;31.01.2018;2018;01;00;Keskiviikko;0;1;1
93;31.01.2018;2018;01;01;Keskiviikko;0;0;0
93;31.01.2018;2018;01;02;Keskiviikko;0;0;0
93;31.01.2018;2018;01;03;Keskiviikko;0;0;0
93;31.01.2018;2018;01;04;Keskiviikko;0;0;0
93;31.01.2018;2018;01;05;Keskiviikko;2;3;5
93;31.01.2018;2018;01;06;Keskiviikko;5;6;11
93;31.01.2018;2018;01;07;Keskiviikko;6;15;21
93;31.01.2018;2018;01;08;Keskiviikko;3;8;11
93;31.01.2018;2018;01;09;Keskiviikko;3;2;5
93;31.01.2018;2018;01;10;Keskiviikko;2;2;4
93;31.01.2018;2018;01;11;Keskiviikko;0;1;1
93;31.01.2018;2018;01;12;Keskiviikko;0;0;0
93;31.01.2018;2018;01;13;Keskiviikko;1;2;3
93;31.01.2018;2018;01;14;Keskiviikko;7;4;11
93;31.01.2018;2018;01;15;Keskiviikko;8;8;16
93;31.01.2018;2018;01;16;Keskiviikko;13;8;21
93;31.01.2018;2018;01;17;Keskiviikko;4;3;7
93;31.01.2018;2018;01;18;Keskiviikko;1;5;6
93;31.01.2018;2018;01;19;Keskiviikko;1;2;3
93;31.01.2018;2018;01;20;Keskiviikko;1;0;1
93;31.01.2018;2018;01;21;Keskiviikko;3;1;4
93;31.01.2018;2018;01;22;Keskiviikko;1;0;1
93;31.01.2018;2018;01;23;Keskiviikko;0;1;1
93;01.02.2018;2018;02;00;Torstai;0;0;0
93;01.02.2018;2018;02;01;Torstai;0;0;0
93;01.02.2018;2018;02;02;Torstai;0;0;0
93;01.02.2018;2018;02;03;Torstai;1;0;1
93;01.02.2018;2018;02;04;Torstai;0;0;0
93;01.02.2018;2018;02;05;Torstai;2;4;6
93;01.02.2018;2018;02;06;Torstai;2;5;7
93;01.02.2018;2018;02;07;Torstai;8;11;19
93;01.02.2018;2018;02;08;Torstai;1;8;9
93;01.02.2018;2018;02;09;Torstai;2;1;3
93;01.02.2018;2018;02;10;Torstai;2;0;2
93;01.02.2018;2018;02;11;Torstai;1;0;1
93;01.02.2018;2018;02;12;Torstai;0;0;0
93;01.02.2018;2018;02;13;Torstai;2;1;3
93;01.02.2018;2018;02;14;Torstai;5;3;8
93;01.02.2018;2018;02;15;Torstai;8;4;12
93;01.02.2018;2018;02;16;Torstai;6;8;14
93;01.02.2018;2018;02;17;Torstai;3;3;6
93;01.02.2018;2018;02;18;Torstai;2;0;2
93;01.02.2018;2018;02;19;Torstai;0;0;0
93;01.02.2018;2018;02;20;Torstai;1;2;3
93;01.02.2018;2018;02;21;Torstai;1;1;2
93;01.02.2018;2018;02;22;Torstai;0;0;0
93;01.02.2018;2018;02;23;Torstai;0;1;1
93;02.02.2018;2018;02;00;Perjantai;0;0;0
93;02.02.2018;2018;02;01;Perjantai;0;0;0
93;02.02.2018;2018;02;02;Perjantai;0;0;0
93;02.02.2018;2018;02;03;Perjantai;0;0;0
93;02.02.2018;2018;02;04;Perjantai;0;0;0
93;02.02.2018;2018;02;05;Perjantai;2;1;3
93;02.02.2018;2018;02;06;Perjantai;4;6;10
93;02.02.2018;2018;02;07;Perjantai;5;12;17
93;02.02.2018;2018;02;08;Perjantai;0;6;6
93;02.02.2018;2018;02;09;Perjantai;1;0;1
93;02.02.2018;2018;02;10;Perjantai;1;0;1
93;02.02.2018;2018;02;11;Perjantai;2;0;2
93;02.02.2018;2018;02;12;Perjantai;2;2;4
93;02.02.2018;2018;02;13;Perjantai;2;0;2
93;02.02.2018;2018;02;14;Perjantai;4;2;6
93;02.02.2018;2018;02;15;Perjantai;5;6;11
93;02.02.2018;2018;02;16;Perjantai;10;2;12
93;02.02.2018;2018;02;17;Perjantai;4;0;4
93;02.02.2018;2018;02;18;Perjantai;1;1;2
93;02.02.2018;2018;02;19;Perjantai;1;2;3
93;02.02.2018;2018;02;20;Perjantai;1;2;3
93;02.02.2018;2018;02;21;Perjantai;0;1;1
93;02.02.2018;2018;02;22;Perjantai;0;0;0
93;02.02.2018;2018;02;23;Perjantai;0;0;0
93;03.02.2018;2018;02;00;Lauantai;0;1;1
93;03.02.2018;2018;02;01;Lauantai;0;0;0
93;03.02.2018;2018;02;02;Lauantai;0;0;0
93;03.02.2018;2018;02;03;Lauantai;0;0;0
93;03.02.2018;2018;02;04;Lauantai;0;0;0
93;03.02.2018;2018;02;05;Lauantai;0;0;0
93;03.02.2018;2018;02;06;Lauantai;0;0;0
93;03.02.2018;2018;02;07;Lauantai;1;0;1
93;03.02.2018;2018;02;08;Lauantai;0;0;0
93;03.02.2018;2018;02;09;Lauantai;0;0;0
93;03.02.2018;2018;02;10;Lauantai;0;3;3
93;03.02.2018;2018;02;11;Lauantai;2;0;2
93;03.02.2018;2018;02;12;Lauantai;1;0;1
93;03.02.2018;2018;02;13;Lauantai;0;2;2
93;03.02.2018;2018;02;14;Lauantai;0;1;1
93;03.02.2018;2018;02;15;Lauantai;0;0;0
93;03.02.2018;2018;02;16;Lauantai;1;1;2
93;03.02.2018;2018;02;17;Lauantai;0;0;0
93;03.02.2018;2018;02;18;Lauantai;0;0;0
93;03.02.2018;2018;02;19;Lauantai;1;0;1
93;03.02.2018;2018;02;20;Lauantai;0;2;2
93;03.02.2018;2018;02;21;Lauantai;0;0;0
93;03.02.2018;2018;02;22;Lauantai;0;0;0
93;03.02.2018;2018;02;23;Lauantai;0;0;0
93;04.02.2018;2018;02;00;Sunnuntai;0;0;0
93;04.02.2018;2018;02;01;Sunnuntai;0;0;0
93;04.02.2018;2018;02;02;Sunnuntai;0;0;0
93;04.02.2018;2018;02;03;Sunnuntai;0;0;0
93;04.02.2018;2018;02;04;Sunnuntai;0;0;0
93;04.02.2018;2018;02;05;Sunnuntai;0;0;0
93;04.02.2018;2018;02;06;Sunnuntai;0;0;0
93;04.02.2018;2018;02;07;Sunnuntai;0;0;0
93;04.02.2018;2018;02;08;Sunnuntai;0;1;1
93;04.02.2018;2018;02;09;Sunnuntai;2;1;3
93;04.02.2018;2018;02;10;Sunnuntai;1;0;1
93;04.02.2018;2018;02;11;Sunnuntai;0;0;0
93;04.02.2018;2018;02;12;Sunnuntai;1;2;3
93;04.02.2018;2018;02;13;Sunnuntai;1;2;3
93;04.02.2018;2018;02;14;Sunnuntai;2;2;4
93;04.02.2018;2018;02;15;Sunnuntai;1;3;4
93;04.02.2018;2018;02;16;Sunnuntai;1;0;1
93;04.02.2018;2018;02;17;Sunnuntai;1;1;2
93;04.02.2018;2018;02;18;Sunnuntai;1;0;1
93;04.02.2018;2018;02;19;Sunnuntai;0;1;1
93;04.02.2018;2018;02;20;Sunnuntai;0;0;0
93;04.02.2018;2018;02;21;Sunnuntai;0;1;1
93;04.02.2018;2018;02;22;Sunnuntai;2;0;2
93;04.02.2018;2018;02;23;Sunnuntai;0;1;1
93;05.02.2018;2018;02;00;Maanantai;0;0;0
93;05.02.2018;2018;02;01;Maanantai;0;0;0
93;05.02.2018;2018;02;02;Maanantai;0;0;0
93;05.02.2018;2018;02;03;Maanantai;0;0;0
93;05.02.2018;2018;02;04;Maanantai;0;0;0
93;05.02.2018;2018;02;05;Maanantai;2;4;6
93;05.02.2018;2018;02;06;Maanantai;3;4;7
93;05.02.2018;2018;02;07;Maanantai;2;4;6
93;05.02.2018;2018;02;08;Maanantai;1;5;6
93;05.02.2018;2018;02;09;Maanantai;3;1;4
93;05.02.2018;2018;02;10;Maanantai;1;0;1
93;05.02.2018;2018;02;11;Maanantai;0;0;0
93;05.02.2018;2018;02;12;Maanantai;0;0;0
93;05.02.2018;2018;02;13;Maanantai;2;0;2
93;05.02.2018;2018;02;14;Maanantai;6;5;11
93;05.02.2018;2018;02;15;Maanantai;5;4;9
93;05.02.2018;2018;02;16;Maanantai;5;1;6
93;05.02.2018;2018;02;17;Maanantai;5;1;6
93;05.02.2018;2018;02;18;Maanantai;1;0;1
93;05.02.2018;2018;02;19;Maanantai;0;0;0
93;05.02.2018;2018;02;20;Maanantai;0;0;0
93;05.02.2018;2018;02;21;Maanantai;0;0;0
93;05.02.2018;2018;02;22;Maanantai;0;1;1
93;05.02.2018;2018;02;23;Maanantai;0;0;0
93;06.02.2018;2018;02;00;Tiistai;0;0;0
93;06.02.2018;2018;02;01;Tiistai;0;0;0
93;06.02.2018;2018;02;02;Tiistai;0;0;0
93;06.02.2018;2018;02;03;Tiistai;0;0;0
93;06.02.2018;2018;02;04;Tiistai;0;0;0
93;06.02.2018;2018;02;05;Tiistai;2;4;6
93;06.02.2018;2018;02;06;Tiistai;0;4;4
93;06.02.2018;2018;02;07;Tiistai;3;6;9
93;06.02.2018;2018;02;08;Tiistai;1;5;6
93;06.02.2018;2018;02;09;Tiistai;0;0;0
93;06.02.2018;2018;02;10;Tiistai;0;0;0
93;06.02.2018;2018;02;11;Tiistai;2;1;3
93;06.02.2018;2018;02;12;Tiistai;1;0;1
93;06.02.2018;2018;02;13;Tiistai;3;0;3
93;06.02.2018;2018;02;14;Tiistai;4;4;8
93;06.02.2018;2018;02;15;Tiistai;2;2;4
93;06.02.2018;2018;02;16;Tiistai;7;3;10
93;06.02.2018;2018;02;17;Tiistai;5;0;5
93;06.02.2018;2018;02;18;Tiistai;0;2;2
93;06.02.2018;2018;02;19;Tiistai;0;1;1
93;06.02.2018;2018;02;20;Tiistai;1;1;2
93;06.02.2018;2018;02;21;Tiistai;0;0;0
93;06.02.2018;2018;02;22;Tiistai;1;0;1
93;06.02.2018;2018;02;23;Tiistai;0;0;0
93;07.02.2018;2018;02;00;Keskiviikko;0;0;0
93;07.02.2018;2018;02;01;Keskiviikko;0;0;0
93;07.02.2018;2018;02;02;Keskiviikko;0;0;0
93;07.02.2018;2018;02;03;Keskiviikko;0;0;0
93;07.02.2018;2018;02;04;Keskiviikko;0;0;0
93;07.02.2018;2018;02;05;Keskiviikko;1;5;6
93;07.02.2018;2018;02;06;Keskiviikko;8;3;11
93;07.02.2018;2018;02;07;Keskiviikko;4;9;13
93;07.02.2018;2018;02;08;Keskiviikko;4;10;14
93;07.02.2018;2018;02;09;Keskiviikko;0;0;0
93;07.02.2018;2018;02;10;Keskiviikko;1;2;3
93;07.02.2018;2018;02;11;Keskiviikko;0;1;1
93;07.02.2018;2018;02;12;Keskiviikko;1;0;1
93;07.02.2018;2018;02;13;Keskiviikko;2;0;2
93;07.02.2018;2018;02;14;Keskiviikko;6;2;8
93;07.02.2018;2018;02;15;Keskiviikko;6;5;11
93;07.02.2018;2018;02;16;Keskiviikko;17;8;25
93;07.02.2018;2018;02;17;Keskiviikko;4;5;9
93;07.02.2018;2018;02;18;Keskiviikko;0;4;4
93;07.02.2018;2018;02;19;Keskiviikko;2;1;3
93;07.02.2018;2018;02;20;Keskiviikko;2;1;3
93;07.02.2018;2018;02;21;Keskiviikko;2;1;3
93;07.02.2018;2018;02;22;Keskiviikko;1;1;2
93;07.02.2018;2018;02;23;Keskiviikko;0;2;2
93;08.02.2018;2018;02;00;Torstai;0;0;0
93;08.02.2018;2018;02;01;Torstai;0;0;0
93;08.02.2018;2018;02;02;Torstai;0;0;0
93;08.02.2018;2018;02;03;Torstai;0;0;0
93;08.02.2018;2018;02;04;Torstai;0;0;0
93;08.02.2018;2018;02;05;Torstai;3;4;7
93;08.02.2018;2018;02;06;Torstai;3;3;6
93;08.02.2018;2018;02;07;Torstai;9;9;18
93;08.02.2018;2018;02;08;Torstai;3;6;9
93;08.02.2018;2018;02;09;Torstai;1;0;1
93;08.02.2018;2018;02;10;Torstai;0;0;0
93;08.02.2018;2018;02;11;Torstai;2;1;3
93;08.02.2018;2018;02;12;Torstai;0;1;1
93;08.02.2018;2018;02;13;Torstai;3;2;5
93;08.02.2018;2018;02;14;Torstai;4;2;6
93;08.02.2018;2018;02;15;Torstai;3;3;6
93;08.02.2018;2018;02;16;Torstai;12;9;21
93;08.02.2018;2018;02;17;Torstai;4;5;9
93;08.02.2018;2018;02;18;Torstai;1;2;3
93;08.02.2018;2018;02;19;Torstai;1;1;2
93;08.02.2018;2018;02;20;Torstai;2;1;3
93;08.02.2018;2018;02;21;Torstai;0;0;0
93;08.02.2018;2018;02;22;Torstai;0;1;1
93;08.02.2018;2018;02;23;Torstai;0;1;1
93;09.02.2018;2018;02;00;Perjantai;1;0;1
93;09.02.2018;2018;02;01;Perjantai;0;0;0
93;09.02.2018;2018;02;02;Perjantai;0;0;0
93;09.02.2018;2018;02;03;Perjantai;0;0;0
93;09.02.2018;2018;02;04;Perjantai;0;0;0
93;09.02.2018;2018;02;05;Perjantai;3;2;5
93;09.02.2018;2018;02;06;Perjantai;8;6;14
93;09.02.2018;2018;02;07;Perjantai;9;8;17
93;09.02.2018;2018;02;08;Perjantai;0;12;12
93;09.02.2018;2018;02;09;Perjantai;4;3;7
93;09.02.2018;2018;02;10;Perjantai;3;0;3
93;09.02.2018;2018;02;11;Perjantai;1;2;3
93;09.02.2018;2018;02;12;Perjantai;3;2;5
93;09.02.2018;2018;02;13;Perjantai;5;2;7
93;09.02.2018;2018;02;14;Perjantai;6;3;9
93;09.02.2018;2018;02;15;Perjantai;5;9;14
93;09.02.2018;2018;02;16;Perjantai;12;6;18
93;09.02.2018;2018;02;17;Perjantai;6;1;7
93;09.02.2018;2018;02;18;Perjantai;2;2;4
93;09.02.2018;2018;02;19;Perjantai;2;0;2
93;09.02.2018;2018;02;20;Perjantai;1;2;3
93;09.02.2018;2018;02;21;Perjantai;0;3;3
93;09.02.2018;2018;02;22;Perjantai;0;2;2
93;09.02.2018;2018;02;23;Perjantai;0;0;0
93;10.02.2018;2018;02;00;Lauantai;0;0;0
93;10.02.2018;2018;02;01;Lauantai;0;0;0
93;10.02.2018;2018;02;02;Lauantai;0;0;0
93;10.02.2018;2018;02;03;Lauantai;0;0;0
93;10.02.2018;2018;02;04;Lauantai;0;1;1
93;10.02.2018;2018;02;05;Lauantai;0;0;0
93;10.02.2018;2018;02;06;Lauantai;0;0;0
93;10.02.2018;2018;02;07;Lauantai;1;0;1
93;10.02.2018;2018;02;08;Lauantai;0;1;1
93;10.02.2018;2018;02;09;Lauantai;0;0;0
93;10.02.2018;2018;02;10;Lauantai;3;3;6
93;10.02.2018;2018;02;11;Lauantai;2;2;4
93;10.02.2018;2018;02;12;Lauantai;1;4;5
93;10.02.2018;2018;02;13;Lauantai;1;4;5
93;10.02.2018;2018;02;14;Lauantai;1;1;2
93;10.02.2018;2018;02;15;Lauantai;2;1;3
93;10.02.2018;2018;02;16;Lauantai;5;2;7
93;10.02.2018;2018;02;17;Lauantai;3;0;3
93;10.02.2018;2018;02;18;Lauantai;0;2;2
93;10.02.2018;2018;02;19;Lauantai;2;0;2
93;10.02.2018;2018;02;20;Lauantai;1;3;4
93;10.02.2018;2018;02;21;Lauantai;0;3;3
93;10.02.2018;2018;02;22;Lauantai;1;0;1
93;10.02.2018;2018;02;23;Lauantai;3;0;3
93;11.02.2018;2018;02;00;Sunnuntai;0;0;0
93;11.02.2018;2018;02;01;Sunnuntai;0;1;1
93;11.02.2018;2018;02;02;Sunnuntai;1;0;1
93;11.02.2018;2018;02;03;Sunnuntai;0;0;0
93;11.02.2018;2018;02;04;Sunnuntai;0;0;0
93;11.02.2018;2018;02;05;Sunnuntai;0;0;0
93;11.02.2018;2018;02;06;Sunnuntai;0;0;0
93;11.02.2018;2018;02;07;Sunnuntai;0;0;0
93;11.02.2018;2018;02;08;Sunnuntai;0;1;1
93;11.02.2018;2018;02;09;Sunnuntai;1;0;1
93;11.02.2018;2018;02;10;Sunnuntai;3;3;6
93;11.02.2018;2018;02;11;Sunnuntai;1;1;2
93;11.02.2018;2018;02;12;Sunnuntai;0;2;2
93;11.02.2018;2018;02;13;Sunnuntai;2;0;2
93;11.02.2018;2018;02;14;Sunnuntai;1;1;2
93;11.02.2018;2018;02;15;Sunnuntai;1;3;4
93;11.02.2018;2018;02;16;Sunnuntai;2;1;3
93;11.02.2018;2018;02;17;Sunnuntai;2;4;6
93;11.02.2018;2018;02;18;Sunnuntai;1;1;2
93;11.02.2018;2018;02;19;Sunnuntai;0;2;2
93;11.02.2018;2018;02;20;Sunnuntai;2;0;2
93;11.02.2018;2018;02;21;Sunnuntai;0;0;0
93;11.02.2018;2018;02;22;Sunnuntai;1;0;1
93;11.02.2018;2018;02;23;Sunnuntai;0;0;0
93;12.02.2018;2018;02;00;Maanantai;0;0;0
93;12.02.2018;2018;02;01;Maanantai;0;0;0
93;12.02.2018;2018;02;02;Maanantai;0;0;0
93;12.02.2018;2018;02;03;Maanantai;0;0;0
93;12.02.2018;2018;02;04;Maanantai;0;1;1
93;12.02.2018;2018;02;05;Maanantai;3;4;7
93;12.02.2018;2018;02;06;Maanantai;5;3;8
93;12.02.2018;2018;02;07;Maanantai;10;14;24
93;12.02.2018;2018;02;08;Maanantai;5;11;16
93;12.02.2018;2018;02;09;Maanantai;4;4;8
93;12.02.2018;2018;02;10;Maanantai;2;0;2
93;12.02.2018;2018;02;11;Maanantai;0;2;2
93;12.02.2018;2018;02;12;Maanantai;1;1;2
93;12.02.2018;2018;02;13;Maanantai;4;0;4
93;12.02.2018;2018;02;14;Maanantai;6;6;12
93;12.02.2018;2018;02;15;Maanantai;4;9;13
93;12.02.2018;2018;02;16;Maanantai;14;9;23
93;12.02.2018;2018;02;17;Maanantai;13;4;17
93;12.02.2018;2018;02;18;Maanantai;2;7;9
93;12.02.2018;2018;02;19;Maanantai;2;3;5
93;12.02.2018;2018;02;20;Maanantai;2;1;3
93;12.02.2018;2018;02;21;Maanantai;4;2;6
93;12.02.2018;2018;02;22;Maanantai;0;2;2
93;12.02.2018;2018;02;23;Maanantai;0;1;1
93;13.02.2018;2018;02;00;Tiistai;0;0;0
93;13.02.2018;2018;02;01;Tiistai;0;0;0
93;13.02.2018;2018;02;02;Tiistai;1;0;1
93;13.02.2018;2018;02;03;Tiistai;0;0;0
93;13.02.2018;2018;02;04;Tiistai;0;0;0
93;13.02.2018;2018;02;05;Tiistai;3;5;8
93;13.02.2018;2018;02;06;Tiistai;6;5;11
93;13.02.2018;2018;02;07;Tiistai;10;16;26
93;13.02.2018;2018;02;08;Tiistai;6;8;14
93;13.02.2018;2018;02;09;Tiistai;2;1;3
93;13.02.2018;2018;02;10;Tiistai;1;2;3
93;13.02.2018;2018;02;11;Tiistai;1;1;2
93;13.02.2018;2018;02;12;Tiistai;3;1;4
93;13.02.2018;2018;02;13;Tiistai;7;1;8
93;13.02.2018;2018;02;14;Tiistai;7;3;10
93;13.02.2018;2018;02;15;Tiistai;9;10;19
93;13.02.2018;2018;02;16;Tiistai;13;9;22
93;13.02.2018;2018;02;17;Tiistai;11;4;15
93;13.02.2018;2018;02;18;Tiistai;1;5;6
93;13.02.2018;2018;02;19;Tiistai;0;1;1
93;13.02.2018;2018;02;20;Tiistai;2;1;3
93;13.02.2018;2018;02;21;Tiistai;2;0;2
93;13.02.2018;2018;02;22;Tiistai;0;1;1
93;13.02.2018;2018;02;23;Tiistai;0;0;0
93;14.02.2018;2018;02;00;Keskiviikko;0;0;0
93;14.02.2018;2018;02;01;Keskiviikko;0;0;0
93;14.02.2018;2018;02;02;Keskiviikko;0;0;0
93;14.02.2018;2018;02;03;Keskiviikko;0;0;0
93;14.02.2018;2018;02;04;Keskiviikko;0;0;0
93;14.02.2018;2018;02;05;Keskiviikko;6;0;6
93;14.02.2018;2018;02;06;Keskiviikko;11;0;11
93;14.02.2018;2018;02;07;Keskiviikko;13;0;13
93;14.02.2018;2018;02;08;Keskiviikko;14;0;14
93;14.02.2018;2018;02;09;Keskiviikko;0;0;0
93;14.02.2018;2018;02;10;Keskiviikko;3;0;3
93;14.02.2018;2018;02;11;Keskiviikko;1;0;1
93;14.02.2018;2018;02;12;Keskiviikko;1;0;1
93;14.02.2018;2018;02;13;Keskiviikko;2;0;2
93;14.02.2018;2018;02;14;Keskiviikko;8;0;8
93;14.02.2018;2018;02;15;Keskiviikko;11;0;11
93;14.02.2018;2018;02;16;Keskiviikko;25;0;25
93;14.02.2018;2018;02;17;Keskiviikko;9;0;9
93;14.02.2018;2018;02;18;Keskiviikko;4;0;4
93;14.02.2018;2018;02;19;Keskiviikko;3;0;3
93;14.02.2018;2018;02;20;Keskiviikko;3;0;3
93;14.02.2018;2018;02;21;Keskiviikko;3;0;3
93;14.02.2018;2018;02;22;Keskiviikko;2;0;2
93;14.02.2018;2018;02;23;Keskiviikko;2;0;2
93;15.02.2018;2018;02;00;Torstai;0;0;0
93;15.02.2018;2018;02;01;Torstai;0;0;0
93;15.02.2018;2018;02;02;Torstai;0;0;0
93;15.02.2018;2018;02;03;Torstai;0;0;0
93;15.02.2018;2018;02;04;Torstai;0;0;0
93;15.02.2018;2018;02;05;Torstai;7;0;7
93;15.02.2018;2018;02;06;Torstai;6;0;6
93;15.02.2018;2018;02;07;Torstai;18;0;18
93;15.02.2018;2018;02;08;Torstai;9;0;9
93;15.02.2018;2018;02;09;Torstai;1;0;1
93;15.02.2018;2018;02;10;Torstai;0;0;0
93;15.02.2018;2018;02;11;Torstai;3;0;3
93;15.02.2018;2018;02;12;Torstai;1;0;1
93;15.02.2018;2018;02;13;Torstai;5;0;5
93;15.02.2018;2018;02;14;Torstai;6;0;6
93;15.02.2018;2018;02;15;Torstai;6;0;6
93;15.02.2018;2018;02;16;Torstai;21;0;21
93;15.02.2018;2018;02;17;Torstai;9;0;9
93;15.02.2018;2018;02;18;Torstai;3;0;3
93;15.02.2018;2018;02;19;Torstai;2;0;2
93;15.02.2018;2018;02;20;Torstai;3;0;3
93;15.02.2018;2018;02;21;Torstai;0;0;0
93;15.02.2018;2018;02;22;Torstai;1;0;1
93;15.02.2018;2018;02;23;Torstai;1;0;1
93;16.02.2018;2018;02;00;Perjantai;0;0;0
93;16.02.2018;2018;02;01;Perjantai;0;0;0
93;16.02.2018;2018;02;02;Perjantai;0;0;0
93;16.02.2018;2018;02;03;Perjantai;0;0;0
93;16.02.2018;2018;02;04;Perjantai;0;0;0
93;16.02.2018;2018;02;05;Perjantai;2;4;6
93;16.02.2018;2018;02;06;Perjantai;6;4;10
93;16.02.2018;2018;02;07;Perjantai;6;15;21
93;16.02.2018;2018;02;08;Perjantai;0;12;12
93;16.02.2018;2018;02;09;Perjantai;3;2;5
93;16.02.2018;2018;02;10;Perjantai;5;0;5
93;16.02.2018;2018;02;11;Perjantai;1;3;4
93;16.02.2018;2018;02;12;Perjantai;4;0;4
93;16.02.2018;2018;02;13;Perjantai;2;2;4
93;16.02.2018;2018;02;14;Perjantai;7;5;12
93;16.02.2018;2018;02;15;Perjantai;6;8;14
93;16.02.2018;2018;02;16;Perjantai;14;4;18
93;16.02.2018;2018;02;17;Perjantai;4;5;9
93;16.02.2018;2018;02;18;Perjantai;4;2;6
93;16.02.2018;2018;02;19;Perjantai;2;1;3
93;16.02.2018;2018;02;20;Perjantai;4;1;5
93;16.02.2018;2018;02;21;Perjantai;0;4;4
93;16.02.2018;2018;02;22;Perjantai;0;0;0
93;16.02.2018;2018;02;23;Perjantai;1;0;1
93;17.02.2018;2018;02;00;Lauantai;0;0;0
93;17.02.2018;2018;02;01;Lauantai;1;0;1
93;17.02.2018;2018;02;02;Lauantai;0;0;0
93;17.02.2018;2018;02;03;Lauantai;0;0;0
93;17.02.2018;2018;02;04;Lauantai;0;1;1
93;17.02.2018;2018;02;05;Lauantai;0;0;0
93;17.02.2018;2018;02;06;Lauantai;0;0;0
93;17.02.2018;2018;02;07;Lauantai;1;0;1
93;17.02.2018;2018;02;08;Lauantai;3;3;6
93;17.02.2018;2018;02;09;Lauantai;1;0;1
93;17.02.2018;2018;02;10;Lauantai;0;0;0
93;17.02.2018;2018;02;11;Lauantai;1;0;1
93;17.02.2018;2018;02;12;Lauantai;0;1;1
93;17.02.2018;2018;02;13;Lauantai;0;0;0
93;17.02.2018;2018;02;14;Lauantai;3;1;4
93;17.02.2018;2018;02;15;Lauantai;2;3;5
93;17.02.2018;2018;02;16;Lauantai;0;2;2
93;17.02.2018;2018;02;17;Lauantai;0;0;0
93;17.02.2018;2018;02;18;Lauantai;1;0;1
93;17.02.2018;2018;02;19;Lauantai;0;3;3
93;17.02.2018;2018;02;20;Lauantai;0;0;0
93;17.02.2018;2018;02;21;Lauantai;0;0;0
93;17.02.2018;2018;02;22;Lauantai;0;0;0
93;17.02.2018;2018;02;23;Lauantai;0;0;0
93;18.02.2018;2018;02;00;Sunnuntai;0;0;0
93;18.02.2018;2018;02;01;Sunnuntai;0;0;0
93;18.02.2018;2018;02;02;Sunnuntai;0;0;0
93;18.02.2018;2018;02;03;Sunnuntai;0;0;0
93;18.02.2018;2018;02;04;Sunnuntai;0;0;0
93;18.02.2018;2018;02;05;Sunnuntai;1;0;1
93;18.02.2018;2018;02;06;Sunnuntai;0;0;0
93;18.02.2018;2018;02;07;Sunnuntai;1;0;1
93;18.02.2018;2018;02;08;Sunnuntai;0;0;0
93;18.02.2018;2018;02;09;Sunnuntai;1;1;2
93;18.02.2018;2018;02;10;Sunnuntai;2;0;2
93;18.02.2018;2018;02;11;Sunnuntai;5;0;5
93;18.02.2018;2018;02;12;Sunnuntai;1;3;4
93;18.02.2018;2018;02;13;Sunnuntai;1;1;2
93;18.02.2018;2018;02;14;Sunnuntai;2;1;3
93;18.02.2018;2018;02;15;Sunnuntai;1;3;4
93;18.02.2018;2018;02;16;Sunnuntai;0;0;0
93;18.02.2018;2018;02;17;Sunnuntai;0;1;1
93;18.02.2018;2018;02;18;Sunnuntai;1;0;1
93;18.02.2018;2018;02;19;Sunnuntai;1;1;2
93;18.02.2018;2018;02;20;Sunnuntai;0;1;1
93;18.02.2018;2018;02;21;Sunnuntai;0;0;0
93;18.02.2018;2018;02;22;Sunnuntai;0;1;1
93;18.02.2018;2018;02;23;Sunnuntai;0;0;0
93;19.02.2018;2018;02;00;Maanantai;0;0;0
93;19.02.2018;2018;02;01;Maanantai;0;0;0
93;19.02.2018;2018;02;02;Maanantai;0;0;0
93;19.02.2018;2018;02;03;Maanantai;0;0;0
93;19.02.2018;2018;02;04;Maanantai;1;0;1
93;19.02.2018;2018;02;05;Maanantai;1;5;6
93;19.02.2018;2018;02;06;Maanantai;3;1;4
93;19.02.2018;2018;02;07;Maanantai;9;12;21
93;19.02.2018;2018;02;08;Maanantai;0;6;6
93;19.02.2018;2018;02;09;Maanantai;4;2;6
93;19.02.2018;2018;02;10;Maanantai;0;0;0
93;19.02.2018;2018;02;11;Maanantai;1;0;1
93;19.02.2018;2018;02;12;Maanantai;0;1;1
93;19.02.2018;2018;02;13;Maanantai;2;2;4
93;19.02.2018;2018;02;14;Maanantai;5;0;5
93;19.02.2018;2018;02;15;Maanantai;6;6;12
93;19.02.2018;2018;02;16;Maanantai;13;6;19
93;19.02.2018;2018;02;17;Maanantai;5;1;6
93;19.02.2018;2018;02;18;Maanantai;2;1;3
93;19.02.2018;2018;02;19;Maanantai;0;0;0
93;19.02.2018;2018;02;20;Maanantai;1;0;1
93;19.02.2018;2018;02;21;Maanantai;0;3;3
93;19.02.2018;2018;02;22;Maanantai;0;0;0
93;19.02.2018;2018;02;23;Maanantai;0;0;0
93;20.02.2018;2018;02;00;Tiistai;0;0;0
93;20.02.2018;2018;02;01;Tiistai;0;0;0
93;20.02.2018;2018;02;02;Tiistai;0;0;0
93;20.02.2018;2018;02;03;Tiistai;0;0;0
93;20.02.2018;2018;02;04;Tiistai;0;0;0
93;20.02.2018;2018;02;05;Tiistai;0;4;4
93;20.02.2018;2018;02;06;Tiistai;4;1;5
93;20.02.2018;2018;02;07;Tiistai;3;6;9
93;20.02.2018;2018;02;08;Tiistai;1;5;6
93;20.02.2018;2018;02;09;Tiistai;0;2;2
93;20.02.2018;2018;02;10;Tiistai;1;0;1
93;20.02.2018;2018;02;11;Tiistai;0;1;1
93;20.02.2018;2018;02;12;Tiistai;2;0;2
93;20.02.2018;2018;02;13;Tiistai;2;0;2
93;20.02.2018;2018;02;14;Tiistai;2;3;5
93;20.02.2018;2018;02;15;Tiistai;3;4;7
93;20.02.2018;2018;02;16;Tiistai;10;3;13
93;20.02.2018;2018;02;17;Tiistai;4;0;4
93;20.02.2018;2018;02;18;Tiistai;0;0;0
93;20.02.2018;2018;02;19;Tiistai;0;2;2
93;20.02.2018;2018;02;20;Tiistai;0;0;0
93;20.02.2018;2018;02;21;Tiistai;1;0;1
93;20.02.2018;2018;02;22;Tiistai;0;1;1
93;20.02.2018;2018;02;23;Tiistai;0;0;0
93;21.02.2018;2018;02;00;Keskiviikko;0;0;0
93;21.02.2018;2018;02;01;Keskiviikko;0;0;0
93;21.02.2018;2018;02;02;Keskiviikko;0;0;0
93;21.02.2018;2018;02;03;Keskiviikko;0;0;0
93;21.02.2018;2018;02;04;Keskiviikko;0;0;0
93;21.02.2018;2018;02;05;Keskiviikko;1;4;5
93;21.02.2018;2018;02;06;Keskiviikko;2;2;4
93;21.02.2018;2018;02;07;Keskiviikko;4;10;14
93;21.02.2018;2018;02;08;Keskiviikko;3;3;6
93;21.02.2018;2018;02;09;Keskiviikko;1;1;2
93;21.02.2018;2018;02;10;Keskiviikko;1;1;2
93;21.02.2018;2018;02;11;Keskiviikko;2;2;4
93;21.02.2018;2018;02;12;Keskiviikko;2;0;2
93;21.02.2018;2018;02;13;Keskiviikko;3;1;4
93;21.02.2018;2018;02;14;Keskiviikko;6;2;8
93;21.02.2018;2018;02;15;Keskiviikko;2;5;7
93;21.02.2018;2018;02;16;Keskiviikko;10;5;15
93;21.02.2018;2018;02;17;Keskiviikko;5;0;5
93;21.02.2018;2018;02;18;Keskiviikko;1;1;2
93;21.02.2018;2018;02;19;Keskiviikko;0;0;0
93;21.02.2018;2018;02;20;Keskiviikko;1;1;2
93;21.02.2018;2018;02;21;Keskiviikko;1;1;2
93;21.02.2018;2018;02;22;Keskiviikko;0;1;1
93;21.02.2018;2018;02;23;Keskiviikko;0;0;0
93;22.02.2018;2018;02;00;Torstai;0;0;0
93;22.02.2018;2018;02;01;Torstai;0;0;0
93;22.02.2018;2018;02;02;Torstai;0;0;0
93;22.02.2018;2018;02;03;Torstai;0;0;0
93;22.02.2018;2018;02;04;Torstai;0;0;0
93;22.02.2018;2018;02;05;Torstai;2;4;6
93;22.02.2018;2018;02;06;Torstai;2;5;7
93;22.02.2018;2018;02;07;Torstai;7;14;21
93;22.02.2018;2018;02;08;Torstai;2;5;7
93;22.02.2018;2018;02;09;Torstai;4;1;5
93;22.02.2018;2018;02;10;Torstai;1;0;1
93;22.02.2018;2018;02;11;Torstai;2;2;4
93;22.02.2018;2018;02;12;Torstai;0;1;1
93;22.02.2018;2018;02;13;Torstai;2;0;2
93;22.02.2018;2018;02;14;Torstai;5;1;6
93;22.02.2018;2018;02;15;Torstai;5;6;11
93;22.02.2018;2018;02;16;Torstai;13;4;17
93;22.02.2018;2018;02;17;Torstai;6;3;9
93;22.02.2018;2018;02;18;Torstai;2;1;3
93;22.02.2018;2018;02;19;Torstai;0;1;1
93;22.02.2018;2018;02;20;Torstai;0;1;1
93;22.02.2018;2018;02;21;Torstai;0;0;0
93;22.02.2018;2018;02;22;Torstai;0;0;0
93;22.02.2018;2018;02;23;Torstai;0;0;0
93;23.02.2018;2018;02;00;Perjantai;0;1;1
93;23.02.2018;2018;02;01;Perjantai;0;0;0
93;23.02.2018;2018;02;02;Perjantai;0;0;0
93;23.02.2018;2018;02;03;Perjantai;0;0;0
93;23.02.2018;2018;02;04;Perjantai;0;0;0
93;23.02.2018;2018;02;05;Perjantai;4;5;9
93;23.02.2018;2018;02;06;Perjantai;2;3;5
93;23.02.2018;2018;02;07;Perjantai;7;11;18
93;23.02.2018;2018;02;08;Perjantai;1;6;7
93;23.02.2018;2018;02;09;Perjantai;2;1;3
93;23.02.2018;2018;02;10;Perjantai;3;1;4
93;23.02.2018;2018;02;11;Perjantai;0;3;3
93;23.02.2018;2018;02;12;Perjantai;1;1;2
93;23.02.2018;2018;02;13;Perjantai;4;0;4
93;23.02.2018;2018;02;14;Perjantai;4;0;4
93;23.02.2018;2018;02;15;Perjantai;10;5;15
93;23.02.2018;2018;02;16;Perjantai;8;1;9
93;23.02.2018;2018;02;17;Perjantai;5;1;6
93;23.02.2018;2018;02;18;Perjantai;3;5;8
93;23.02.2018;2018;02;19;Perjantai;1;1;2
93;23.02.2018;2018;02;20;Perjantai;1;1;2
93;23.02.2018;2018;02;21;Perjantai;0;1;1
93;23.02.2018;2018;02;22;Perjantai;0;0;0
93;23.02.2018;2018;02;23;Perjantai;2;0;2
93;24.02.2018;2018;02;00;Lauantai;0;0;0
93;24.02.2018;2018;02;01;Lauantai;0;0;0
93;24.02.2018;2018;02;02;Lauantai;0;0;0
93;24.02.2018;2018;02;03;Lauantai;0;0;0
93;24.02.2018;2018;02;04;Lauantai;0;0;0
93;24.02.2018;2018;02;05;Lauantai;0;0;0
93;24.02.2018;2018;02;06;Lauantai;0;0;0
93;24.02.2018;2018;02;07;Lauantai;0;0;0
93;24.02.2018;2018;02;08;Lauantai;0;0;0
93;24.02.2018;2018;02;09;Lauantai;0;0;0
93;24.02.2018;2018;02;10;Lauantai;0;1;1
93;24.02.2018;2018;02;11;Lauantai;1;0;1
93;24.02.2018;2018;02;12;Lauantai;0;0;0
93;24.02.2018;2018;02;13;Lauantai;1;4;5
93;24.02.2018;2018;02;14;Lauantai;1;1;2
93;24.02.2018;2018;02;15;Lauantai;0;0;0
93;24.02.2018;2018;02;16;Lauantai;1;1;2
93;24.02.2018;2018;02;17;Lauantai;3;0;3
93;24.02.2018;2018;02;18;Lauantai;1;0;1
93;24.02.2018;2018;02;19;Lauantai;0;0;0
93;24.02.2018;2018;02;20;Lauantai;0;0;0
93;24.02.2018;2018;02;21;Lauantai;1;0;1
93;24.02.2018;2018;02;22;Lauantai;0;0;0
93;24.02.2018;2018;02;23;Lauantai;1;0;1
93;25.02.2018;2018;02;00;Sunnuntai;0;0;0
93;25.02.2018;2018;02;01;Sunnuntai;0;0;0
93;25.02.2018;2018;02;02;Sunnuntai;0;1;1
93;25.02.2018;2018;02;03;Sunnuntai;0;0;0
93;25.02.2018;2018;02;04;Sunnuntai;0;0;0
93;25.02.2018;2018;02;05;Sunnuntai;1;0;1
93;25.02.2018;2018;02;06;Sunnuntai;0;0;0
93;25.02.2018;2018;02;07;Sunnuntai;0;0;0
93;25.02.2018;2018;02;08;Sunnuntai;0;0;0
93;25.02.2018;2018;02;09;Sunnuntai;0;0;0
93;25.02.2018;2018;02;10;Sunnuntai;2;0;2
93;25.02.2018;2018;02;11;Sunnuntai;0;1;1
93;25.02.2018;2018;02;12;Sunnuntai;0;3;3
93;25.02.2018;2018;02;13;Sunnuntai;2;0;2
93;25.02.2018;2018;02;14;Sunnuntai;5;3;8
93;25.02.2018;2018;02;15;Sunnuntai;4;2;6
93;25.02.2018;2018;02;16;Sunnuntai;2;2;4
93;25.02.2018;2018;02;17;Sunnuntai;1;3;4
93;25.02.2018;2018;02;18;Sunnuntai;0;2;2
93;25.02.2018;2018;02;19;Sunnuntai;2;3;5
93;25.02.2018;2018;02;20;Sunnuntai;2;0;2
93;25.02.2018;2018;02;21;Sunnuntai;0;0;0
93;25.02.2018;2018;02;22;Sunnuntai;0;0;0
93;25.02.2018;2018;02;23;Sunnuntai;0;0;0
93;26.02.2018;2018;02;00;Maanantai;0;0;0
93;26.02.2018;2018;02;01;Maanantai;0;1;1
93;26.02.2018;2018;02;02;Maanantai;0;0;0
93;26.02.2018;2018;02;03;Maanantai;0;0;0
93;26.02.2018;2018;02;04;Maanantai;0;0;0
93;26.02.2018;2018;02;05;Maanantai;2;3;5
93;26.02.2018;2018;02;06;Maanantai;9;6;15
93;26.02.2018;2018;02;07;Maanantai;9;16;25
93;26.02.2018;2018;02;08;Maanantai;3;7;10
93;26.02.2018;2018;02;09;Maanantai;3;1;4
93;26.02.2018;2018;02;10;Maanantai;1;2;3
93;26.02.2018;2018;02;11;Maanantai;2;0;2
93;26.02.2018;2018;02;12;Maanantai;3;5;8
93;26.02.2018;2018;02;13;Maanantai;3;0;3
93;26.02.2018;2018;02;14;Maanantai;7;3;10
93;26.02.2018;2018;02;15;Maanantai;10;11;21
93;26.02.2018;2018;02;16;Maanantai;16;8;24
93;26.02.2018;2018;02;17;Maanantai;3;3;6
93;26.02.2018;2018;02;18;Maanantai;3;1;4
93;26.02.2018;2018;02;19;Maanantai;0;2;2
93;26.02.2018;2018;02;20;Maanantai;2;1;3
93;26.02.2018;2018;02;21;Maanantai;1;0;1
93;26.02.2018;2018;02;22;Maanantai;0;1;1
93;26.02.2018;2018;02;23;Maanantai;0;0;0
93;27.02.2018;2018;02;00;Tiistai;0;1;1
93;27.02.2018;2018;02;01;Tiistai;0;0;0
93;27.02.2018;2018;02;02;Tiistai;0;0;0
93;27.02.2018;2018;02;03;Tiistai;1;0;1
93;27.02.2018;2018;02;04;Tiistai;0;0;0
93;27.02.2018;2018;02;05;Tiistai;2;3;5
93;27.02.2018;2018;02;06;Tiistai;4;4;8
93;27.02.2018;2018;02;07;Tiistai;2;8;10
93;27.02.2018;2018;02;08;Tiistai;1;5;6
93;27.02.2018;2018;02;09;Tiistai;2;3;5
93;27.02.2018;2018;02;10;Tiistai;1;0;1
93;27.02.2018;2018;02;11;Tiistai;0;0;0
93;27.02.2018;2018;02;12;Tiistai;1;1;2
93;27.02.2018;2018;02;13;Tiistai;3;1;4
93;27.02.2018;2018;02;14;Tiistai;6;3;9
93;27.02.2018;2018;02;15;Tiistai;4;4;8
93;27.02.2018;2018;02;16;Tiistai;7;7;14
93;27.02.2018;2018;02;17;Tiistai;2;0;2
93;27.02.2018;2018;02;18;Tiistai;1;2;3
93;27.02.2018;2018;02;19;Tiistai;0;1;1
93;27.02.2018;2018;02;20;Tiistai;2;0;2
93;27.02.2018;2018;02;21;Tiistai;0;0;0
93;27.02.2018;2018;02;22;Tiistai;1;0;1
93;27.02.2018;2018;02;23;Tiistai;0;0;0
93;28.02.2018;2018;02;00;Keskiviikko;0;0;0
93;28.02.2018;2018;02;01;Keskiviikko;0;0;0
93;28.02.2018;2018;02;02;Keskiviikko;0;0;0
93;28.02.2018;2018;02;03;Keskiviikko;0;0;0
93;28.02.2018;2018;02;04;Keskiviikko;0;0;0
93;28.02.2018;2018;02;05;Keskiviikko;3;3;6
93;28.02.2018;2018;02;06;Keskiviikko;3;2;5
93;28.02.2018;2018;02;07;Keskiviikko;0;7;7
93;28.02.2018;2018;02;08;Keskiviikko;1;1;2
93;28.02.2018;2018;02;09;Keskiviikko;0;0;0
93;28.02.2018;2018;02;10;Keskiviikko;1;0;1
93;28.02.2018;2018;02;11;Keskiviikko;0;3;3
93;28.02.2018;2018;02;12;Keskiviikko;0;0;0
93;28.02.2018;2018;02;13;Keskiviikko;0;1;1
93;28.02.2018;2018;02;14;Keskiviikko;3;1;4
93;28.02.2018;2018;02;15;Keskiviikko;8;5;13
93;28.02.2018;2018;02;16;Keskiviikko;6;3;9
93;28.02.2018;2018;02;17;Keskiviikko;2;1;3
93;28.02.2018;2018;02;18;Keskiviikko;0;2;2
93;28.02.2018;2018;02;19;Keskiviikko;1;1;2
93;28.02.2018;2018;02;20;Keskiviikko;0;0;0
93;28.02.2018;2018;02;21;Keskiviikko;1;0;1
93;28.02.2018;2018;02;22;Keskiviikko;1;0;1
93;28.02.2018;2018;02;23;Keskiviikko;0;0;0
93;01.03.2018;2018;03;00;Torstai;0;0;0
93;01.03.2018;2018;03;01;Torstai;0;0;0
93;01.03.2018;2018;03;02;Torstai;0;0;0
93;01.03.2018;2018;03;03;Torstai;0;0;0
93;01.03.2018;2018;03;04;Torstai;0;0;0
93;01.03.2018;2018;03;05;Torstai;5;3;8
93;01.03.2018;2018;03;06;Torstai;5;4;9
93;01.03.2018;2018;03;07;Torstai;5;10;15
93;01.03.2018;2018;03;08;Torstai;0;5;5
93;01.03.2018;2018;03;09;Torstai;3;2;5
93;01.03.2018;2018;03;10;Torstai;0;1;1
93;01.03.2018;2018;03;11;Torstai;3;0;3
93;01.03.2018;2018;03;12;Torstai;2;0;2
93;01.03.2018;2018;03;13;Torstai;1;2;3
93;01.03.2018;2018;03;14;Torstai;5;7;12
93;01.03.2018;2018;03;15;Torstai;7;6;13
93;01.03.2018;2018;03;16;Torstai;11;7;18
93;01.03.2018;2018;03;17;Torstai;6;5;11
93;01.03.2018;2018;03;18;Torstai;2;3;5
93;01.03.2018;2018;03;19;Torstai;1;1;2
93;01.03.2018;2018;03;20;Torstai;1;0;1
93;01.03.2018;2018;03;21;Torstai;2;2;4
93;01.03.2018;2018;03;22;Torstai;0;0;0
93;01.03.2018;2018;03;23;Torstai;0;0;0
93;02.03.2018;2018;03;00;Perjantai;0;1;1
93;02.03.2018;2018;03;01;Perjantai;0;0;0
93;02.03.2018;2018;03;02;Perjantai;0;0;0
93;02.03.2018;2018;03;03;Perjantai;0;0;0
93;02.03.2018;2018;03;04;Perjantai;0;0;0
93;02.03.2018;2018;03;05;Perjantai;4;4;8
93;02.03.2018;2018;03;06;Perjantai;2;3;5
93;02.03.2018;2018;03;07;Perjantai;5;15;20
93;02.03.2018;2018;03;08;Perjantai;0;7;7
93;02.03.2018;2018;03;09;Perjantai;1;5;6
93;02.03.2018;2018;03;10;Perjantai;3;0;3
93;02.03.2018;2018;03;11;Perjantai;2;0;2
93;02.03.2018;2018;03;12;Perjantai;2;2;4
93;02.03.2018;2018;03;13;Perjantai;5;2;7
93;02.03.2018;2018;03;14;Perjantai;5;0;5
93;02.03.2018;2018;03;15;Perjantai;11;6;17
93;02.03.2018;2018;03;16;Perjantai;11;3;14
93;02.03.2018;2018;03;17;Perjantai;3;0;3
93;02.03.2018;2018;03;18;Perjantai;2;3;5
93;02.03.2018;2018;03;19;Perjantai;1;1;2
93;02.03.2018;2018;03;20;Perjantai;0;0;0
93;02.03.2018;2018;03;21;Perjantai;0;1;1
93;02.03.2018;2018;03;22;Perjantai;0;0;0
93;02.03.2018;2018;03;23;Perjantai;0;0;0
93;03.03.2018;2018;03;00;Lauantai;0;0;0
93;03.03.2018;2018;03;01;Lauantai;0;0;0
93;03.03.2018;2018;03;02;Lauantai;0;0;0
93;03.03.2018;2018;03;03;Lauantai;0;0;0
93;03.03.2018;2018;03;04;Lauantai;0;0;0
93;03.03.2018;2018;03;05;Lauantai;0;0;0
93;03.03.2018;2018;03;06;Lauantai;0;0;0
93;03.03.2018;2018;03;07;Lauantai;0;0;0
93;03.03.2018;2018;03;08;Lauantai;0;0;0
93;03.03.2018;2018;03;09;Lauantai;1;1;2
93;03.03.2018;2018;03;10;Lauantai;4;2;6
93;03.03.2018;2018;03;11;Lauantai;2;2;4
93;03.03.2018;2018;03;12;Lauantai;0;2;2
93;03.03.2018;2018;03;13;Lauantai;1;2;3
93;03.03.2018;2018;03;14;Lauantai;0;2;2
93;03.03.2018;2018;03;15;Lauantai;1;0;1
93;03.03.2018;2018;03;16;Lauantai;0;1;1
93;03.03.2018;2018;03;17;Lauantai;3;0;3
93;03.03.2018;2018;03;18;Lauantai;1;0;1
93;03.03.2018;2018;03;19;Lauantai;1;3;4
93;03.03.2018;2018;03;20;Lauantai;0;1;1
93;03.03.2018;2018;03;21;Lauantai;0;1;1
93;03.03.2018;2018;03;22;Lauantai;1;0;1
93;03.03.2018;2018;03;23;Lauantai;1;0;1
93;04.03.2018;2018;03;00;Sunnuntai;0;0;0
93;04.03.2018;2018;03;01;Sunnuntai;0;0;0
93;04.03.2018;2018;03;02;Sunnuntai;0;0;0
93;04.03.2018;2018;03;03;Sunnuntai;0;0;0
93;04.03.2018;2018;03;04;Sunnuntai;0;0;0
93;04.03.2018;2018;03;05;Sunnuntai;0;0;0
93;04.03.2018;2018;03;06;Sunnuntai;0;0;0
93;04.03.2018;2018;03;07;Sunnuntai;0;0;0
93;04.03.2018;2018;03;08;Sunnuntai;1;0;1
93;04.03.2018;2018;03;09;Sunnuntai;1;0;1
93;04.03.2018;2018;03;10;Sunnuntai;0;1;1
93;04.03.2018;2018;03;11;Sunnuntai;2;0;2
93;04.03.2018;2018;03;12;Sunnuntai;3;3;6
93;04.03.2018;2018;03;13;Sunnuntai;0;2;2
93;04.03.2018;2018;03;14;Sunnuntai;1;2;3
93;04.03.2018;2018;03;15;Sunnuntai;1;1;2
93;04.03.2018;2018;03;16;Sunnuntai;6;0;6
93;04.03.2018;2018;03;17;Sunnuntai;3;1;4
93;04.03.2018;2018;03;18;Sunnuntai;0;0;0
93;04.03.2018;2018;03;19;Sunnuntai;0;1;1
93;04.03.2018;2018;03;20;Sunnuntai;0;1;1
93;04.03.2018;2018;03;21;Sunnuntai;0;0;0
93;04.03.2018;2018;03;22;Sunnuntai;0;0;0
93;04.03.2018;2018;03;23;Sunnuntai;0;0;0
93;05.03.2018;2018;03;00;Maanantai;0;0;0
93;05.03.2018;2018;03;01;Maanantai;0;0;0
93;05.03.2018;2018;03;02;Maanantai;0;0;0
93;05.03.2018;2018;03;03;Maanantai;0;0;0
93;05.03.2018;2018;03;04;Maanantai;0;0;0
93;05.03.2018;2018;03;05;Maanantai;3;3;6
93;05.03.2018;2018;03;06;Maanantai;4;3;7
93;05.03.2018;2018;03;07;Maanantai;1;8;9
93;05.03.2018;2018;03;08;Maanantai;0;2;2
93;05.03.2018;2018;03;09;Maanantai;1;2;3
93;05.03.2018;2018;03;10;Maanantai;3;0;3
93;05.03.2018;2018;03;11;Maanantai;2;0;2
93;05.03.2018;2018;03;12;Maanantai;1;2;3
93;05.03.2018;2018;03;13;Maanantai;1;2;3
93;05.03.2018;2018;03;14;Maanantai;3;1;4
93;05.03.2018;2018;03;15;Maanantai;5;8;13
93;05.03.2018;2018;03;16;Maanantai;10;4;14
93;05.03.2018;2018;03;17;Maanantai;2;1;3
93;05.03.2018;2018;03;18;Maanantai;0;1;1
93;05.03.2018;2018;03;19;Maanantai;0;0;0
93;05.03.2018;2018;03;20;Maanantai;0;1;1
93;05.03.2018;2018;03;21;Maanantai;0;1;1
93;05.03.2018;2018;03;22;Maanantai;0;0;0
93;05.03.2018;2018;03;23;Maanantai;0;0;0
93;06.03.2018;2018;03;00;Tiistai;1;0;1
93;06.03.2018;2018;03;01;Tiistai;0;0;0
93;06.03.2018;2018;03;02;Tiistai;0;0;0
93;06.03.2018;2018;03;03;Tiistai;0;0;0
93;06.03.2018;2018;03;04;Tiistai;1;0;1
93;06.03.2018;2018;03;05;Tiistai;1;2;3
93;06.03.2018;2018;03;06;Tiistai;1;4;5
93;06.03.2018;2018;03;07;Tiistai;1;7;8
93;06.03.2018;2018;03;08;Tiistai;1;3;4
93;06.03.2018;2018;03;09;Tiistai;0;0;0
93;06.03.2018;2018;03;10;Tiistai;1;0;1
93;06.03.2018;2018;03;11;Tiistai;2;0;2
93;06.03.2018;2018;03;12;Tiistai;0;0;0
93;06.03.2018;2018;03;13;Tiistai;1;1;2
93;06.03.2018;2018;03;14;Tiistai;4;2;6
93;06.03.2018;2018;03;15;Tiistai;2;4;6
93;06.03.2018;2018;03;16;Tiistai;8;8;16
93;06.03.2018;2018;03;17;Tiistai;1;0;1
93;06.03.2018;2018;03;18;Tiistai;1;1;2
93;06.03.2018;2018;03;19;Tiistai;0;1;1
93;06.03.2018;2018;03;20;Tiistai;0;1;1
93;06.03.2018;2018;03;21;Tiistai;0;0;0
93;06.03.2018;2018;03;22;Tiistai;0;1;1
93;06.03.2018;2018;03;23;Tiistai;0;0;0
93;07.03.2018;2018;03;00;Keskiviikko;0;0;0
93;07.03.2018;2018;03;01;Keskiviikko;0;0;0
93;07.03.2018;2018;03;02;Keskiviikko;0;0;0
93;07.03.2018;2018;03;03;Keskiviikko;0;0;0
93;07.03.2018;2018;03;04;Keskiviikko;0;0;0
93;07.03.2018;2018;03;05;Keskiviikko;2;3;5
93;07.03.2018;2018;03;06;Keskiviikko;3;2;5
93;07.03.2018;2018;03;07;Keskiviikko;2;7;9
93;07.03.2018;2018;03;08;Keskiviikko;0;5;5
93;07.03.2018;2018;03;09;Keskiviikko;2;0;2
93;07.03.2018;2018;03;10;Keskiviikko;2;1;3
93;07.03.2018;2018;03;11;Keskiviikko;2;0;2
93;07.03.2018;2018;03;12;Keskiviikko;3;3;6
93;07.03.2018;2018;03;13;Keskiviikko;1;4;5
93;07.03.2018;2018;03;14;Keskiviikko;9;2;11
93;07.03.2018;2018;03;15;Keskiviikko;4;5;9
93;07.03.2018;2018;03;16;Keskiviikko;9;4;13
93;07.03.2018;2018;03;17;Keskiviikko;2;2;4
93;07.03.2018;2018;03;18;Keskiviikko;0;5;5
93;07.03.2018;2018;03;19;Keskiviikko;0;1;1
93;07.03.2018;2018;03;20;Keskiviikko;3;1;4
93;07.03.2018;2018;03;21;Keskiviikko;3;0;3
93;07.03.2018;2018;03;22;Keskiviikko;0;1;1
93;07.03.2018;2018;03;23;Keskiviikko;0;1;1
93;08.03.2018;2018;03;00;Torstai;0;0;0
93;08.03.2018;2018;03;01;Torstai;0;0;0
93;08.03.2018;2018;03;02;Torstai;0;0;0
93;08.03.2018;2018;03;03;Torstai;0;0;0
93;08.03.2018;2018;03;04;Torstai;0;0;0
93;08.03.2018;2018;03;05;Torstai;4;2;6
93;08.03.2018;2018;03;06;Torstai;5;5;10
93;08.03.2018;2018;03;07;Torstai;3;10;13
93;08.03.2018;2018;03;08;Torstai;4;6;10
93;08.03.2018;2018;03;09;Torstai;2;2;4
93;08.03.2018;2018;03;10;Torstai;0;4;4
93;08.03.2018;2018;03;11;Torstai;3;0;3
93;08.03.2018;2018;03;12;Torstai;1;1;2
93;08.03.2018;2018;03;13;Torstai;5;3;8
93;08.03.2018;2018;03;14;Torstai;4;3;7
93;08.03.2018;2018;03;15;Torstai;7;2;9
93;08.03.2018;2018;03;16;Torstai;13;12;25
93;08.03.2018;2018;03;17;Torstai;1;2;3
93;08.03.2018;2018;03;18;Torstai;1;2;3
93;08.03.2018;2018;03;19;Torstai;2;2;4
93;08.03.2018;2018;03;20;Torstai;0;0;0
93;08.03.2018;2018;03;21;Torstai;0;0;0
93;08.03.2018;2018;03;22;Torstai;0;0;0
93;08.03.2018;2018;03;23;Torstai;0;0;0
93;09.03.2018;2018;03;00;Perjantai;0;0;0
93;09.03.2018;2018;03;01;Perjantai;0;0;0
93;09.03.2018;2018;03;02;Perjantai;0;0;0
93;09.03.2018;2018;03;03;Perjantai;0;0;0
93;09.03.2018;2018;03;04;Perjantai;0;0;0
93;09.03.2018;2018;03;05;Perjantai;4;2;6
93;09.03.2018;2018;03;06;Perjantai;3;0;3
93;09.03.2018;2018;03;07;Perjantai;3;9;12
93;09.03.2018;2018;03;08;Perjantai;2;5;7
93;09.03.2018;2018;03;09;Perjantai;6;1;7
93;09.03.2018;2018;03;10;Perjantai;1;1;2
93;09.03.2018;2018;03;11;Perjantai;0;2;2
93;09.03.2018;2018;03;12;Perjantai;1;3;4
93;09.03.2018;2018;03;13;Perjantai;3;0;3
93;09.03.2018;2018;03;14;Perjantai;0;1;1
93;09.03.2018;2018;03;15;Perjantai;2;3;5
93;09.03.2018;2018;03;16;Perjantai;6;3;9
93;09.03.2018;2018;03;17;Perjantai;3;2;5
93;09.03.2018;2018;03;18;Perjantai;0;2;2
93;09.03.2018;2018;03;19;Perjantai;1;1;2
93;09.03.2018;2018;03;20;Perjantai;1;0;1
93;09.03.2018;2018;03;21;Perjantai;1;0;1
93;09.03.2018;2018;03;22;Perjantai;0;1;1
93;09.03.2018;2018;03;23;Perjantai;0;0;0
93;10.03.2018;2018;03;00;Lauantai;0;0;0
93;10.03.2018;2018;03;01;Lauantai;0;0;0
93;10.03.2018;2018;03;02;Lauantai;0;0;0
93;10.03.2018;2018;03;03;Lauantai;0;0;0
93;10.03.2018;2018;03;04;Lauantai;0;0;0
93;10.03.2018;2018;03;05;Lauantai;1;0;1
93;10.03.2018;2018;03;06;Lauantai;0;0;0
93;10.03.2018;2018;03;07;Lauantai;0;1;1
93;10.03.2018;2018;03;08;Lauantai;0;0;0
93;10.03.2018;2018;03;09;Lauantai;5;1;6
93;10.03.2018;2018;03;10;Lauantai;0;2;2
93;10.03.2018;2018;03;11;Lauantai;2;2;4
93;10.03.2018;2018;03;12;Lauantai;1;2;3
93;10.03.2018;2018;03;13;Lauantai;0;0;0
93;10.03.2018;2018;03;14;Lauantai;4;0;4
93;10.03.2018;2018;03;15;Lauantai;0;4;4
93;10.03.2018;2018;03;16;Lauantai;1;3;4
93;10.03.2018;2018;03;17;Lauantai;2;0;2
93;10.03.2018;2018;03;18;Lauantai;0;2;2
93;10.03.2018;2018;03;19;Lauantai;1;0;1
93;10.03.2018;2018;03;20;Lauantai;3;1;4
93;10.03.2018;2018;03;21;Lauantai;1;0;1
93;10.03.2018;2018;03;22;Lauantai;1;1;2
93;10.03.2018;2018;03;23;Lauantai;0;0;0
93;11.03.2018;2018;03;00;Sunnuntai;0;0;0
93;11.03.2018;2018;03;01;Sunnuntai;0;0;0
93;11.03.2018;2018;03;02;Sunnuntai;0;0;0
93;11.03.2018;2018;03;03;Sunnuntai;0;0;0
93;11.03.2018;2018;03;04;Sunnuntai;0;1;1
93;11.03.2018;2018;03;05;Sunnuntai;0;0;0
93;11.03.2018;2018;03;06;Sunnuntai;0;0;0
93;11.03.2018;2018;03;07;Sunnuntai;0;1;1
93;11.03.2018;2018;03;08;Sunnuntai;0;1;1
93;11.03.2018;2018;03;09;Sunnuntai;1;1;2
93;11.03.2018;2018;03;10;Sunnuntai;1;1;2
93;11.03.2018;2018;03;11;Sunnuntai;4;1;5
93;11.03.2018;2018;03;12;Sunnuntai;13;1;14
93;11.03.2018;2018;03;13;Sunnuntai;0;4;4
93;11.03.2018;2018;03;14;Sunnuntai;0;2;2
93;11.03.2018;2018;03;15;Sunnuntai;0;0;0
93;11.03.2018;2018;03;16;Sunnuntai;1;3;4
93;11.03.2018;2018;03;17;Sunnuntai;0;1;1
93;11.03.2018;2018;03;18;Sunnuntai;3;0;3
93;11.03.2018;2018;03;19;Sunnuntai;2;1;3
93;11.03.2018;2018;03;20;Sunnuntai;1;0;1
93;11.03.2018;2018;03;21;Sunnuntai;0;1;1
93;11.03.2018;2018;03;22;Sunnuntai;0;2;2
93;11.03.2018;2018;03;23;Sunnuntai;1;0;1
93;12.03.2018;2018;03;00;Maanantai;0;0;0
93;12.03.2018;2018;03;01;Maanantai;0;0;0
93;12.03.2018;2018;03;02;Maanantai;0;0;0
93;12.03.2018;2018;03;03;Maanantai;0;0;0
93;12.03.2018;2018;03;04;Maanantai;0;0;0
93;12.03.2018;2018;03;05;Maanantai;2;4;6
93;12.03.2018;2018;03;06;Maanantai;6;5;11
93;12.03.2018;2018;03;07;Maanantai;12;13;25
93;12.03.2018;2018;03;08;Maanantai;6;6;12
93;12.03.2018;2018;03;09;Maanantai;4;6;10
93;12.03.2018;2018;03;10;Maanantai;4;4;8
93;12.03.2018;2018;03;11;Maanantai;3;0;3
93;12.03.2018;2018;03;12;Maanantai;2;2;4
93;12.03.2018;2018;03;13;Maanantai;4;3;7
93;12.03.2018;2018;03;14;Maanantai;5;3;8
93;12.03.2018;2018;03;15;Maanantai;10;7;17
93;12.03.2018;2018;03;16;Maanantai;22;15;37
93;12.03.2018;2018;03;17;Maanantai;5;6;11
93;12.03.2018;2018;03;18;Maanantai;1;1;2
93;12.03.2018;2018;03;19;Maanantai;3;2;5
93;12.03.2018;2018;03;20;Maanantai;1;0;1
93;12.03.2018;2018;03;21;Maanantai;1;4;5
93;12.03.2018;2018;03;22;Maanantai;0;0;0
93;12.03.2018;2018;03;23;Maanantai;0;0;0
93;13.03.2018;2018;03;00;Tiistai;0;0;0
93;13.03.2018;2018;03;01;Tiistai;0;0;0
93;13.03.2018;2018;03;02;Tiistai;0;0;0
93;13.03.2018;2018;03;03;Tiistai;0;0;0
93;13.03.2018;2018;03;04;Tiistai;0;0;0
93;13.03.2018;2018;03;05;Tiistai;1;2;3
93;13.03.2018;2018;03;06;Tiistai;6;2;8
93;13.03.2018;2018;03;07;Tiistai;6;12;18
93;13.03.2018;2018;03;08;Tiistai;3;10;13
93;13.03.2018;2018;03;09;Tiistai;1;1;2
93;13.03.2018;2018;03;10;Tiistai;1;0;1
93;13.03.2018;2018;03;11;Tiistai;1;0;1
93;13.03.2018;2018;03;12;Tiistai;2;2;4
93;13.03.2018;2018;03;13;Tiistai;2;1;3
93;13.03.2018;2018;03;14;Tiistai;3;1;4
93;13.03.2018;2018;03;15;Tiistai;3;8;11
93;13.03.2018;2018;03;16;Tiistai;10;8;18
93;13.03.2018;2018;03;17;Tiistai;7;2;9
93;13.03.2018;2018;03;18;Tiistai;2;2;4
93;13.03.2018;2018;03;19;Tiistai;2;0;2
93;13.03.2018;2018;03;20;Tiistai;1;0;1
93;13.03.2018;2018;03;21;Tiistai;0;1;1
93;13.03.2018;2018;03;22;Tiistai;0;0;0
93;13.03.2018;2018;03;23;Tiistai;0;0;0
93;14.03.2018;2018;03;00;Keskiviikko;0;0;0
93;14.03.2018;2018;03;01;Keskiviikko;0;0;0
93;14.03.2018;2018;03;02;Keskiviikko;0;0;0
93;14.03.2018;2018;03;03;Keskiviikko;0;0;0
93;14.03.2018;2018;03;04;Keskiviikko;0;0;0
93;14.03.2018;2018;03;05;Keskiviikko;2;3;5
93;14.03.2018;2018;03;06;Keskiviikko;6;1;7
93;14.03.2018;2018;03;07;Keskiviikko;6;15;21
93;14.03.2018;2018;03;08;Keskiviikko;5;7;12
93;14.03.2018;2018;03;09;Keskiviikko;2;2;4
93;14.03.2018;2018;03;10;Keskiviikko;4;0;4
93;14.03.2018;2018;03;11;Keskiviikko;3;1;4
93;14.03.2018;2018;03;12;Keskiviikko;0;1;1
93;14.03.2018;2018;03;13;Keskiviikko;4;2;6
93;14.03.2018;2018;03;14;Keskiviikko;6;2;8
93;14.03.2018;2018;03;15;Keskiviikko;4;7;11
93;14.03.2018;2018;03;16;Keskiviikko;19;13;32
93;14.03.2018;2018;03;17;Keskiviikko;5;2;7
93;14.03.2018;2018;03;18;Keskiviikko;1;4;5
93;14.03.2018;2018;03;19;Keskiviikko;1;3;4
93;14.03.2018;2018;03;20;Keskiviikko;1;1;2
93;14.03.2018;2018;03;21;Keskiviikko;0;1;1
93;14.03.2018;2018;03;22;Keskiviikko;1;2;3
93;14.03.2018;2018;03;23;Keskiviikko;0;0;0
93;15.03.2018;2018;03;00;Torstai;0;0;0
93;15.03.2018;2018;03;01;Torstai;0;0;0
93;15.03.2018;2018;03;02;Torstai;0;0;0
93;15.03.2018;2018;03;03;Torstai;0;0;0
93;15.03.2018;2018;03;04;Torstai;0;0;0
93;15.03.2018;2018;03;05;Torstai;3;4;7
93;15.03.2018;2018;03;06;Torstai;7;1;8
93;15.03.2018;2018;03;07;Torstai;10;10;20
93;15.03.2018;2018;03;08;Torstai;4;9;13
93;15.03.2018;2018;03;09;Torstai;2;1;3
93;15.03.2018;2018;03;10;Torstai;0;1;1
93;15.03.2018;2018;03;11;Torstai;2;0;2
93;15.03.2018;2018;03;12;Torstai;1;1;2
93;15.03.2018;2018;03;13;Torstai;4;2;6
93;15.03.2018;2018;03;14;Torstai;6;4;10
93;15.03.2018;2018;03;15;Torstai;8;7;15
93;15.03.2018;2018;03;16;Torstai;12;13;25
93;15.03.2018;2018;03;17;Torstai;3;2;5
93;15.03.2018;2018;03;18;Torstai;0;0;0
93;15.03.2018;2018;03;19;Torstai;0;0;0
93;15.03.2018;2018;03;20;Torstai;2;2;4
93;15.03.2018;2018;03;21;Torstai;0;1;1
93;15.03.2018;2018;03;22;Torstai;0;0;0
93;15.03.2018;2018;03;23;Torstai;0;1;1
93;16.03.2018;2018;03;00;Perjantai;0;0;0
93;16.03.2018;2018;03;01;Perjantai;1;0;1
93;16.03.2018;2018;03;02;Perjantai;0;0;0
93;16.03.2018;2018;03;03;Perjantai;0;0;0
93;16.03.2018;2018;03;04;Perjantai;1;0;1
93;16.03.2018;2018;03;05;Perjantai;1;4;5
93;16.03.2018;2018;03;06;Perjantai;2;3;5
93;16.03.2018;2018;03;07;Perjantai;6;9;15
93;16.03.2018;2018;03;08;Perjantai;2;7;9
93;16.03.2018;2018;03;09;Perjantai;0;4;4
93;16.03.2018;2018;03;10;Perjantai;2;1;3
93;16.03.2018;2018;03;11;Perjantai;0;1;1
93;16.03.2018;2018;03;12;Perjantai;2;2;4
93;16.03.2018;2018;03;13;Perjantai;4;1;5
93;16.03.2018;2018;03;14;Perjantai;6;4;10
93;16.03.2018;2018;03;15;Perjantai;4;2;6
93;16.03.2018;2018;03;16;Perjantai;12;3;15
93;16.03.2018;2018;03;17;Perjantai;4;2;6
93;16.03.2018;2018;03;18;Perjantai;0;1;1
93;16.03.2018;2018;03;19;Perjantai;0;1;1
93;16.03.2018;2018;03;20;Perjantai;3;2;5
93;16.03.2018;2018;03;21;Perjantai;1;1;2
93;16.03.2018;2018;03;22;Perjantai;0;0;0
93;16.03.2018;2018;03;23;Perjantai;0;0;0
93;17.03.2018;2018;03;00;Lauantai;0;0;0
93;17.03.2018;2018;03;01;Lauantai;0;0;0
93;17.03.2018;2018;03;02;Lauantai;0;0;0
93;17.03.2018;2018;03;03;Lauantai;0;0;0
93;17.03.2018;2018;03;04;Lauantai;0;0;0
93;17.03.2018;2018;03;05;Lauantai;0;0;0
93;17.03.2018;2018;03;06;Lauantai;0;0;0
93;17.03.2018;2018;03;07;Lauantai;0;0;0
93;17.03.2018;2018;03;08;Lauantai;0;0;0
93;17.03.2018;2018;03;09;Lauantai;1;2;3
93;17.03.2018;2018;03;10;Lauantai;0;1;1
93;17.03.2018;2018;03;11;Lauantai;5;0;5
93;17.03.2018;2018;03;12;Lauantai;2;2;4
93;17.03.2018;2018;03;13;Lauantai;3;4;7
93;17.03.2018;2018;03;14;Lauantai;4;4;8
93;17.03.2018;2018;03;15;Lauantai;4;5;9
93;17.03.2018;2018;03;16;Lauantai;2;2;4
93;17.03.2018;2018;03;17;Lauantai;0;3;3
93;17.03.2018;2018;03;18;Lauantai;2;0;2
93;17.03.2018;2018;03;19;Lauantai;2;2;4
93;17.03.2018;2018;03;20;Lauantai;0;1;1
93;17.03.2018;2018;03;21;Lauantai;0;0;0
93;17.03.2018;2018;03;22;Lauantai;0;0;0
93;17.03.2018;2018;03;23;Lauantai;0;0;0
93;18.03.2018;2018;03;00;Sunnuntai;0;0;0
93;18.03.2018;2018;03;01;Sunnuntai;0;0;0
93;18.03.2018;2018;03;02;Sunnuntai;0;0;0
93;18.03.2018;2018;03;03;Sunnuntai;0;0;0
93;18.03.2018;2018;03;04;Sunnuntai;0;0;0
93;18.03.2018;2018;03;05;Sunnuntai;0;0;0
93;18.03.2018;2018;03;06;Sunnuntai;0;0;0
93;18.03.2018;2018;03;07;Sunnuntai;0;0;0
93;18.03.2018;2018;03;08;Sunnuntai;0;1;1
93;18.03.2018;2018;03;09;Sunnuntai;2;0;2
93;18.03.2018;2018;03;10;Sunnuntai;1;1;2
93;18.03.2018;2018;03;11;Sunnuntai;2;0;2
93;18.03.2018;2018;03;12;Sunnuntai;5;4;9
93;18.03.2018;2018;03;13;Sunnuntai;3;8;11
93;18.03.2018;2018;03;14;Sunnuntai;2;1;3
93;18.03.2018;2018;03;15;Sunnuntai;1;2;3
93;18.03.2018;2018;03;16;Sunnuntai;0;1;1
93;18.03.2018;2018;03;17;Sunnuntai;0;1;1
93;18.03.2018;2018;03;18;Sunnuntai;0;2;2
93;18.03.2018;2018;03;19;Sunnuntai;6;4;10
93;18.03.2018;2018;03;20;Sunnuntai;0;2;2
93;18.03.2018;2018;03;21;Sunnuntai;2;1;3
93;18.03.2018;2018;03;22;Sunnuntai;0;0;0
93;18.03.2018;2018;03;23;Sunnuntai;0;0;0
93;19.03.2018;2018;03;00;Maanantai;0;0;0
93;19.03.2018;2018;03;01;Maanantai;1;0;1
93;19.03.2018;2018;03;02;Maanantai;0;0;0
93;19.03.2018;2018;03;03;Maanantai;0;0;0
93;19.03.2018;2018;03;04;Maanantai;0;0;0
93;19.03.2018;2018;03;05;Maanantai;2;5;7
93;19.03.2018;2018;03;06;Maanantai;6;6;12
93;19.03.2018;2018;03;07;Maanantai;14;12;26
93;19.03.2018;2018;03;08;Maanantai;5;12;17
93;19.03.2018;2018;03;09;Maanantai;3;4;7
93;19.03.2018;2018;03;10;Maanantai;2;1;3
93;19.03.2018;2018;03;11;Maanantai;1;2;3
93;19.03.2018;2018;03;12;Maanantai;3;1;4
93;19.03.2018;2018;03;13;Maanantai;5;9;14
93;19.03.2018;2018;03;14;Maanantai;8;3;11
93;19.03.2018;2018;03;15;Maanantai;9;6;15
93;19.03.2018;2018;03;16;Maanantai;14;14;28
93;19.03.2018;2018;03;17;Maanantai;6;7;13
93;19.03.2018;2018;03;18;Maanantai;4;6;10
93;19.03.2018;2018;03;19;Maanantai;1;2;3
93;19.03.2018;2018;03;20;Maanantai;3;0;3
93;19.03.2018;2018;03;21;Maanantai;1;2;3
93;19.03.2018;2018;03;22;Maanantai;1;0;1
93;19.03.2018;2018;03;23;Maanantai;0;0;0
93;20.03.2018;2018;03;00;Tiistai;1;0;1
93;20.03.2018;2018;03;01;Tiistai;0;0;0
93;20.03.2018;2018;03;02;Tiistai;0;0;0
93;20.03.2018;2018;03;03;Tiistai;0;0;0
93;20.03.2018;2018;03;04;Tiistai;0;0;0
93;20.03.2018;2018;03;05;Tiistai;2;3;5
93;20.03.2018;2018;03;06;Tiistai;6;6;12
93;20.03.2018;2018;03;07;Tiistai;8;11;19
93;20.03.2018;2018;03;08;Tiistai;3;5;8
93;20.03.2018;2018;03;09;Tiistai;3;4;7
93;20.03.2018;2018;03;10;Tiistai;2;0;2
93;20.03.2018;2018;03;11;Tiistai;3;2;5
93;20.03.2018;2018;03;12;Tiistai;1;3;4
93;20.03.2018;2018;03;13;Tiistai;3;3;6
93;20.03.2018;2018;03;14;Tiistai;6;5;11
93;20.03.2018;2018;03;15;Tiistai;6;5;11
93;20.03.2018;2018;03;16;Tiistai;15;9;24
93;20.03.2018;2018;03;17;Tiistai;3;2;5
93;20.03.2018;2018;03;18;Tiistai;3;1;4
93;20.03.2018;2018;03;19;Tiistai;0;3;3
93;20.03.2018;2018;03;20;Tiistai;2;2;4
93;20.03.2018;2018;03;21;Tiistai;0;0;0
93;20.03.2018;2018;03;22;Tiistai;1;0;1
93;20.03.2018;2018;03;23;Tiistai;0;1;1
93;21.03.2018;2018;03;00;Keskiviikko;1;0;1
93;21.03.2018;2018;03;01;Keskiviikko;0;0;0
93;21.03.2018;2018;03;02;Keskiviikko;0;0;0
93;21.03.2018;2018;03;03;Keskiviikko;0;0;0
93;21.03.2018;2018;03;04;Keskiviikko;0;0;0
93;21.03.2018;2018;03;05;Keskiviikko;0;4;4
93;21.03.2018;2018;03;06;Keskiviikko;4;5;9
93;21.03.2018;2018;03;07;Keskiviikko;12;14;26
93;21.03.2018;2018;03;08;Keskiviikko;4;6;10
93;21.03.2018;2018;03;09;Keskiviikko;2;0;2
93;21.03.2018;2018;03;10;Keskiviikko;1;0;1
93;21.03.2018;2018;03;11;Keskiviikko;1;2;3
93;21.03.2018;2018;03;12;Keskiviikko;2;0;2
93;21.03.2018;2018;03;13;Keskiviikko;2;3;5
93;21.03.2018;2018;03;14;Keskiviikko;5;1;6
93;21.03.2018;2018;03;15;Keskiviikko;5;4;9
93;21.03.2018;2018;03;16;Keskiviikko;14;15;29
93;21.03.2018;2018;03;17;Keskiviikko;8;3;11
93;21.03.2018;2018;03;18;Keskiviikko;2;1;3
93;21.03.2018;2018;03;19;Keskiviikko;0;2;2
93;21.03.2018;2018;03;20;Keskiviikko;4;2;6
93;21.03.2018;2018;03;21;Keskiviikko;1;2;3
93;21.03.2018;2018;03;22;Keskiviikko;0;1;1
93;21.03.2018;2018;03;23;Keskiviikko;0;1;1
93;22.03.2018;2018;03;00;Torstai;1;0;1
93;22.03.2018;2018;03;01;Torstai;0;0;0
93;22.03.2018;2018;03;02;Torstai;0;0;0
93;22.03.2018;2018;03;03;Torstai;0;0;0
93;22.03.2018;2018;03;04;Torstai;0;0;0
93;22.03.2018;2018;03;05;Torstai;3;4;7
93;22.03.2018;2018;03;06;Torstai;4;5;9
93;22.03.2018;2018;03;07;Torstai;8;14;22
93;22.03.2018;2018;03;08;Torstai;4;5;9
93;22.03.2018;2018;03;09;Torstai;3;3;6
93;22.03.2018;2018;03;10;Torstai;0;1;1
93;22.03.2018;2018;03;11;Torstai;3;1;4
93;22.03.2018;2018;03;12;Torstai;2;5;7
93;22.03.2018;2018;03;13;Torstai;2;3;5
93;22.03.2018;2018;03;14;Torstai;7;3;10
93;22.03.2018;2018;03;15;Torstai;7;6;13
93;22.03.2018;2018;03;16;Torstai;14;8;22
93;22.03.2018;2018;03;17;Torstai;4;4;8
93;22.03.2018;2018;03;18;Torstai;2;2;4
93;22.03.2018;2018;03;19;Torstai;3;4;7
93;22.03.2018;2018;03;20;Torstai;1;2;3
93;22.03.2018;2018;03;21;Torstai;0;0;0
93;22.03.2018;2018;03;22;Torstai;0;1;1
93;22.03.2018;2018;03;23;Torstai;0;0;0
93;23.03.2018;2018;03;00;Perjantai;1;0;1
93;23.03.2018;2018;03;01;Perjantai;0;1;1
93;23.03.2018;2018;03;02;Perjantai;0;0;0
93;23.03.2018;2018;03;03;Perjantai;0;0;0
93;23.03.2018;2018;03;04;Perjantai;1;0;1
93;23.03.2018;2018;03;05;Perjantai;2;3;5
93;23.03.2018;2018;03;06;Perjantai;2;6;8
93;23.03.2018;2018;03;07;Perjantai;5;12;17
93;23.03.2018;2018;03;08;Perjantai;1;7;8
93;23.03.2018;2018;03;09;Perjantai;1;3;4
93;23.03.2018;2018;03;10;Perjantai;3;0;3
93;23.03.2018;2018;03;11;Perjantai;2;4;6
93;23.03.2018;2018;03;12;Perjantai;3;1;4
93;23.03.2018;2018;03;13;Perjantai;5;2;7
93;23.03.2018;2018;03;14;Perjantai;11;1;12
93;23.03.2018;2018;03;15;Perjantai;3;8;11
93;23.03.2018;2018;03;16;Perjantai;12;6;18
93;23.03.2018;2018;03;17;Perjantai;8;5;13
93;23.03.2018;2018;03;18;Perjantai;1;2;3
93;23.03.2018;2018;03;19;Perjantai;1;0;1
93;23.03.2018;2018;03;20;Perjantai;1;0;1
93;23.03.2018;2018;03;21;Perjantai;0;0;0
93;23.03.2018;2018;03;22;Perjantai;2;0;2
93;23.03.2018;2018;03;23;Perjantai;1;0;1
93;24.03.2018;2018;03;00;Lauantai;0;0;0
93;24.03.2018;2018;03;01;Lauantai;0;0;0
93;24.03.2018;2018;03;02;Lauantai;0;0;0
93;24.03.2018;2018;03;03;Lauantai;0;0;0
93;24.03.2018;2018;03;04;Lauantai;0;0;0
93;24.03.2018;2018;03;05;Lauantai;1;0;1
93;24.03.2018;2018;03;06;Lauantai;0;0;0
93;24.03.2018;2018;03;07;Lauantai;1;0;1
93;24.03.2018;2018;03;08;Lauantai;1;0;1
93;24.03.2018;2018;03;09;Lauantai;1;2;3
93;24.03.2018;2018;03;10;Lauantai;1;2;3
93;24.03.2018;2018;03;11;Lauantai;1;0;1
93;24.03.2018;2018;03;12;Lauantai;4;0;4
93;24.03.2018;2018;03;13;Lauantai;1;1;2
93;24.03.2018;2018;03;14;Lauantai;2;1;3
93;24.03.2018;2018;03;15;Lauantai;2;3;5
93;24.03.2018;2018;03;16;Lauantai;2;1;3
93;24.03.2018;2018;03;17;Lauantai;0;0;0
93;24.03.2018;2018;03;18;Lauantai;1;4;5
93;24.03.2018;2018;03;19;Lauantai;0;1;1
93;24.03.2018;2018;03;20;Lauantai;0;0;0
93;24.03.2018;2018;03;21;Lauantai;0;0;0
93;24.03.2018;2018;03;22;Lauantai;1;1;2
93;24.03.2018;2018;03;23;Lauantai;0;0;0
93;25.03.2018;2018;03;00;Sunnuntai;0;0;0
93;25.03.2018;2018;03;01;Sunnuntai;0;0;0
93;25.03.2018;2018;03;02;Sunnuntai;0;0;0
93;25.03.2018;2018;03;03;Sunnuntai;0;0;0
93;25.03.2018;2018;03;04;Sunnuntai;0;0;0
93;25.03.2018;2018;03;05;Sunnuntai;1;0;1
93;25.03.2018;2018;03;06;Sunnuntai;0;0;0
93;25.03.2018;2018;03;07;Sunnuntai;0;0;0
93;25.03.2018;2018;03;08;Sunnuntai;2;1;3
93;25.03.2018;2018;03;09;Sunnuntai;5;0;5
93;25.03.2018;2018;03;10;Sunnuntai;1;2;3
93;25.03.2018;2018;03;11;Sunnuntai;3;3;6
93;25.03.2018;2018;03;12;Sunnuntai;3;2;5
93;25.03.2018;2018;03;13;Sunnuntai;4;2;6
93;25.03.2018;2018;03;14;Sunnuntai;6;1;7
93;25.03.2018;2018;03;15;Sunnuntai;1;5;6
93;25.03.2018;2018;03;16;Sunnuntai;2;6;8
93;25.03.2018;2018;03;17;Sunnuntai;2;2;4
93;25.03.2018;2018;03;18;Sunnuntai;1;4;5
93;25.03.2018;2018;03;19;Sunnuntai;0;1;1
93;25.03.2018;2018;03;20;Sunnuntai;1;2;3
93;25.03.2018;2018;03;21;Sunnuntai;0;1;1
93;25.03.2018;2018;03;22;Sunnuntai;0;2;2
93;25.03.2018;2018;03;23;Sunnuntai;0;0;0
93;26.03.2018;2018;03;00;Maanantai;0;0;0
93;26.03.2018;2018;03;01;Maanantai;0;0;0
93;26.03.2018;2018;03;02;Maanantai;0;0;0
93;26.03.2018;2018;03;03;Maanantai;0;0;0
93;26.03.2018;2018;03;04;Maanantai;0;1;1
93;26.03.2018;2018;03;05;Maanantai;1;2;3
93;26.03.2018;2018;03;06;Maanantai;4;4;8
93;26.03.2018;2018;03;07;Maanantai;10;9;19
93;26.03.2018;2018;03;08;Maanantai;5;9;14
93;26.03.2018;2018;03;09;Maanantai;1;2;3
93;26.03.2018;2018;03;10;Maanantai;3;1;4
93;26.03.2018;2018;03;11;Maanantai;0;2;2
93;26.03.2018;2018;03;12;Maanantai;3;3;6
93;26.03.2018;2018;03;13;Maanantai;4;0;4
93;26.03.2018;2018;03;14;Maanantai;7;7;14
93;26.03.2018;2018;03;15;Maanantai;5;6;11
93;26.03.2018;2018;03;16;Maanantai;17;8;25
93;26.03.2018;2018;03;17;Maanantai;3;3;6
93;26.03.2018;2018;03;18;Maanantai;0;1;1
93;26.03.2018;2018;03;19;Maanantai;2;0;2
93;26.03.2018;2018;03;20;Maanantai;0;2;2
93;26.03.2018;2018;03;21;Maanantai;0;1;1
93;26.03.2018;2018;03;22;Maanantai;0;0;0
93;26.03.2018;2018;03;23;Maanantai;0;0;0
93;27.03.2018;2018;03;00;Tiistai;0;0;0
93;27.03.2018;2018;03;01;Tiistai;0;0;0
93;27.03.2018;2018;03;02;Tiistai;0;0;0
93;27.03.2018;2018;03;03;Tiistai;0;0;0
93;27.03.2018;2018;03;04;Tiistai;0;0;0
93;27.03.2018;2018;03;05;Tiistai;1;4;5
93;27.03.2018;2018;03;06;Tiistai;2;5;7
93;27.03.2018;2018;03;07;Tiistai;5;8;13
93;27.03.2018;2018;03;08;Tiistai;6;10;16
93;27.03.2018;2018;03;09;Tiistai;1;4;5
93;27.03.2018;2018;03;10;Tiistai;0;1;1
93;27.03.2018;2018;03;11;Tiistai;2;0;2
93;27.03.2018;2018;03;12;Tiistai;3;0;3
93;27.03.2018;2018;03;13;Tiistai;8;4;12
93;27.03.2018;2018;03;14;Tiistai;7;2;9
93;27.03.2018;2018;03;15;Tiistai;4;4;8
93;27.03.2018;2018;03;16;Tiistai;10;7;17
93;27.03.2018;2018;03;17;Tiistai;6;4;10
93;27.03.2018;2018;03;18;Tiistai;1;1;2
93;27.03.2018;2018;03;19;Tiistai;3;1;4
93;27.03.2018;2018;03;20;Tiistai;0;0;0
93;27.03.2018;2018;03;21;Tiistai;0;0;0
93;27.03.2018;2018;03;22;Tiistai;2;3;5
93;27.03.2018;2018;03;23;Tiistai;0;0;0
93;28.03.2018;2018;03;00;Keskiviikko;0;0;0
93;28.03.2018;2018;03;01;Keskiviikko;0;0;0
93;28.03.2018;2018;03;02;Keskiviikko;0;0;0
93;28.03.2018;2018;03;03;Keskiviikko;0;0;0
93;28.03.2018;2018;03;04;Keskiviikko;1;1;2
93;28.03.2018;2018;03;05;Keskiviikko;2;4;6
93;28.03.2018;2018;03;06;Keskiviikko;2;3;5
93;28.03.2018;2018;03;07;Keskiviikko;9;12;21
93;28.03.2018;2018;03;08;Keskiviikko;5;11;16
93;28.03.2018;2018;03;09;Keskiviikko;0;3;3
93;28.03.2018;2018;03;10;Keskiviikko;1;0;1
93;28.03.2018;2018;03;11;Keskiviikko;5;0;5
93;28.03.2018;2018;03;12;Keskiviikko;1;1;2
93;28.03.2018;2018;03;13;Keskiviikko;3;4;7
93;28.03.2018;2018;03;14;Keskiviikko;11;4;15
93;28.03.2018;2018;03;15;Keskiviikko;6;6;12
93;28.03.2018;2018;03;16;Keskiviikko;16;8;24
93;28.03.2018;2018;03;17;Keskiviikko;10;4;14
93;28.03.2018;2018;03;18;Keskiviikko;3;6;9
93;28.03.2018;2018;03;19;Keskiviikko;1;0;1
93;28.03.2018;2018;03;20;Keskiviikko;0;1;1
93;28.03.2018;2018;03;21;Keskiviikko;1;0;1
93;28.03.2018;2018;03;22;Keskiviikko;1;1;2
93;28.03.2018;2018;03;23;Keskiviikko;1;0;1
93;29.03.2018;2018;03;00;Torstai;0;0;0
93;29.03.2018;2018;03;01;Torstai;0;1;1
93;29.03.2018;2018;03;02;Torstai;1;1;2
93;29.03.2018;2018;03;03;Torstai;0;0;0
93;29.03.2018;2018;03;04;Torstai;0;0;0
93;29.03.2018;2018;03;05;Torstai;2;4;6
93;29.03.2018;2018;03;06;Torstai;7;4;11
93;29.03.2018;2018;03;07;Torstai;7;9;16
93;29.03.2018;2018;03;08;Torstai;3;6;9
93;29.03.2018;2018;03;09;Torstai;1;4;5
93;29.03.2018;2018;03;10;Torstai;3;2;5
93;29.03.2018;2018;03;11;Torstai;3;0;3
93;29.03.2018;2018;03;12;Torstai;4;5;9
93;29.03.2018;2018;03;13;Torstai;4;3;7
93;29.03.2018;2018;03;14;Torstai;8;4;12
93;29.03.2018;2018;03;15;Torstai;4;5;9
93;29.03.2018;2018;03;16;Torstai;8;11;19
93;29.03.2018;2018;03;17;Torstai;9;3;12
93;29.03.2018;2018;03;18;Torstai;0;1;1
93;29.03.2018;2018;03;19;Torstai;4;2;6
93;29.03.2018;2018;03;20;Torstai;3;2;5
93;29.03.2018;2018;03;21;Torstai;1;0;1
93;29.03.2018;2018;03;22;Torstai;0;4;4
93;29.03.2018;2018;03;23;Torstai;0;0;0
93;30.03.2018;2018;03;00;Perjantai;0;0;0
93;30.03.2018;2018;03;01;Perjantai;0;0;0
93;30.03.2018;2018;03;02;Perjantai;0;0;0
93;30.03.2018;2018;03;03;Perjantai;0;0;0
93;30.03.2018;2018;03;04;Perjantai;0;0;0
93;30.03.2018;2018;03;05;Perjantai;0;0;0
93;30.03.2018;2018;03;06;Perjantai;1;0;1
93;30.03.2018;2018;03;07;Perjantai;0;0;0
93;30.03.2018;2018;03;08;Perjantai;0;1;1
93;30.03.2018;2018;03;09;Perjantai;0;0;0
93;30.03.2018;2018;03;10;Perjantai;1;2;3
93;30.03.2018;2018;03;11;Perjantai;4;1;5
93;30.03.2018;2018;03;12;Perjantai;2;4;6
93;30.03.2018;2018;03;13;Perjantai;3;3;6
93;30.03.2018;2018;03;14;Perjantai;6;7;13
93;30.03.2018;2018;03;15;Perjantai;5;5;10
93;30.03.2018;2018;03;16;Perjantai;3;2;5
93;30.03.2018;2018;03;17;Perjantai;2;1;3
93;30.03.2018;2018;03;18;Perjantai;1;2;3
93;30.03.2018;2018;03;19;Perjantai;1;1;2
93;30.03.2018;2018;03;20;Perjantai;0;1;1
93;30.03.2018;2018;03;21;Perjantai;1;0;1
93;30.03.2018;2018;03;22;Perjantai;0;2;2
93;30.03.2018;2018;03;23;Perjantai;0;1;1
93;31.03.2018;2018;03;00;Lauantai;0;0;0
93;31.03.2018;2018;03;01;Lauantai;0;0;0
93;31.03.2018;2018;03;02;Lauantai;0;0;0
93;31.03.2018;2018;03;03;Lauantai;0;0;0
93;31.03.2018;2018;03;04;Lauantai;0;0;0
93;31.03.2018;2018;03;05;Lauantai;0;0;0
93;31.03.2018;2018;03;06;Lauantai;2;0;2
93;31.03.2018;2018;03;07;Lauantai;0;0;0
93;31.03.2018;2018;03;08;Lauantai;0;0;0
93;31.03.2018;2018;03;09;Lauantai;2;2;4
93;31.03.2018;2018;03;10;Lauantai;1;6;7
93;31.03.2018;2018;03;11;Lauantai;5;1;6
93;31.03.2018;2018;03;12;Lauantai;7;1;8
93;31.03.2018;2018;03;13;Lauantai;1;4;5
93;31.03.2018;2018;03;14;Lauantai;1;2;3
93;31.03.2018;2018;03;15;Lauantai;3;4;7
93;31.03.2018;2018;03;16;Lauantai;3;1;4
93;31.03.2018;2018;03;17;Lauantai;2;0;2
93;31.03.2018;2018;03;18;Lauantai;1;3;4
93;31.03.2018;2018;03;19;Lauantai;1;4;5
93;31.03.2018;2018;03;20;Lauantai;1;0;1
93;31.03.2018;2018;03;21;Lauantai;2;2;4
93;31.03.2018;2018;03;22;Lauantai;0;0;0
93;31.03.2018;2018;03;23;Lauantai;1;0;1
93;01.04.2018;2018;04;00;Sunnuntai;0;0;0
93;01.04.2018;2018;04;01;Sunnuntai;0;0;0
93;01.04.2018;2018;04;02;Sunnuntai;0;0;0
93;01.04.2018;2018;04;03;Sunnuntai;0;0;0
93;01.04.2018;2018;04;04;Sunnuntai;0;0;0
93;01.04.2018;2018;04;05;Sunnuntai;0;1;1
93;01.04.2018;2018;04;06;Sunnuntai;1;0;1
93;01.04.2018;2018;04;07;Sunnuntai;0;0;0
93;01.04.2018;2018;04;08;Sunnuntai;0;0;0
93;01.04.2018;2018;04;09;Sunnuntai;2;1;3
93;01.04.2018;2018;04;10;Sunnuntai;0;4;4
93;01.04.2018;2018;04;11;Sunnuntai;2;3;5
93;01.04.2018;2018;04;12;Sunnuntai;3;3;6
93;01.04.2018;2018;04;13;Sunnuntai;2;5;7
93;01.04.2018;2018;04;14;Sunnuntai;2;7;9
93;01.04.2018;2018;04;15;Sunnuntai;2;0;2
93;01.04.2018;2018;04;16;Sunnuntai;4;2;6
93;01.04.2018;2018;04;17;Sunnuntai;0;0;0
93;01.04.2018;2018;04;18;Sunnuntai;2;3;5
93;01.04.2018;2018;04;19;Sunnuntai;3;1;4
93;01.04.2018;2018;04;20;Sunnuntai;0;0;0
93;01.04.2018;2018;04;21;Sunnuntai;1;0;1
93;01.04.2018;2018;04;22;Sunnuntai;1;0;1
93;01.04.2018;2018;04;23;Sunnuntai;0;0;0
93;02.04.2018;2018;04;00;Maanantai;0;0;0
93;02.04.2018;2018;04;01;Maanantai;0;0;0
93;02.04.2018;2018;04;02;Maanantai;0;0;0
93;02.04.2018;2018;04;03;Maanantai;0;0;0
93;02.04.2018;2018;04;04;Maanantai;0;0;0
93;02.04.2018;2018;04;05;Maanantai;1;0;1
93;02.04.2018;2018;04;06;Maanantai;0;0;0
93;02.04.2018;2018;04;07;Maanantai;1;0;1
93;02.04.2018;2018;04;08;Maanantai;0;0;0
93;02.04.2018;2018;04;09;Maanantai;3;3;6
93;02.04.2018;2018;04;10;Maanantai;2;0;2
93;02.04.2018;2018;04;11;Maanantai;3;1;4
93;02.04.2018;2018;04;12;Maanantai;1;2;3
93;02.04.2018;2018;04;13;Maanantai;1;2;3
93;02.04.2018;2018;04;14;Maanantai;3;0;3
93;02.04.2018;2018;04;15;Maanantai;4;3;7
93;02.04.2018;2018;04;16;Maanantai;2;0;2
93;02.04.2018;2018;04;17;Maanantai;4;1;5
93;02.04.2018;2018;04;18;Maanantai;0;2;2
93;02.04.2018;2018;04;19;Maanantai;2;2;4
93;02.04.2018;2018;04;20;Maanantai;1;3;4
93;02.04.2018;2018;04;21;Maanantai;0;0;0
93;02.04.2018;2018;04;22;Maanantai;0;0;0
93;02.04.2018;2018;04;23;Maanantai;0;0;0
93;03.04.2018;2018;04;00;Tiistai;0;0;0
93;03.04.2018;2018;04;01;Tiistai;1;0;1
93;03.04.2018;2018;04;02;Tiistai;0;0;0
93;03.04.2018;2018;04;03;Tiistai;0;0;0
93;03.04.2018;2018;04;04;Tiistai;0;0;0
93;03.04.2018;2018;04;05;Tiistai;1;3;4
93;03.04.2018;2018;04;06;Tiistai;2;6;8
93;03.04.2018;2018;04;07;Tiistai;7;10;17
93;03.04.2018;2018;04;08;Tiistai;4;8;12
93;03.04.2018;2018;04;09;Tiistai;0;3;3
93;03.04.2018;2018;04;10;Tiistai;1;1;2
93;03.04.2018;2018;04;11;Tiistai;5;1;6
93;03.04.2018;2018;04;12;Tiistai;2;3;5
93;03.04.2018;2018;04;13;Tiistai;5;4;9
93;03.04.2018;2018;04;14;Tiistai;10;3;13
93;03.04.2018;2018;04;15;Tiistai;7;5;12
93;03.04.2018;2018;04;16;Tiistai;11;8;19
93;03.04.2018;2018;04;17;Tiistai;8;2;10
93;03.04.2018;2018;04;18;Tiistai;1;4;5
93;03.04.2018;2018;04;19;Tiistai;0;0;0
93;03.04.2018;2018;04;20;Tiistai;2;1;3
93;03.04.2018;2018;04;21;Tiistai;4;3;7
93;03.04.2018;2018;04;22;Tiistai;0;2;2
93;03.04.2018;2018;04;23;Tiistai;0;0;0
93;04.04.2018;2018;04;00;Keskiviikko;1;0;1
93;04.04.2018;2018;04;01;Keskiviikko;0;0;0
93;04.04.2018;2018;04;02;Keskiviikko;0;0;0
93;04.04.2018;2018;04;03;Keskiviikko;2;0;2
93;04.04.2018;2018;04;04;Keskiviikko;0;0;0
93;04.04.2018;2018;04;05;Keskiviikko;1;4;5
93;04.04.2018;2018;04;06;Keskiviikko;4;8;12
93;04.04.2018;2018;04;07;Keskiviikko;10;10;20
93;04.04.2018;2018;04;08;Keskiviikko;2;6;8
93;04.04.2018;2018;04;09;Keskiviikko;1;3;4
93;04.04.2018;2018;04;10;Keskiviikko;2;1;3
93;04.04.2018;2018;04;11;Keskiviikko;2;3;5
93;04.04.2018;2018;04;12;Keskiviikko;0;1;1
93;04.04.2018;2018;04;13;Keskiviikko;4;3;7
93;04.04.2018;2018;04;14;Keskiviikko;8;2;10
93;04.04.2018;2018;04;15;Keskiviikko;12;6;18
93;04.04.2018;2018;04;16;Keskiviikko;11;9;20
93;04.04.2018;2018;04;17;Keskiviikko;7;7;14
93;04.04.2018;2018;04;18;Keskiviikko;2;2;4
93;04.04.2018;2018;04;19;Keskiviikko;1;0;1
93;04.04.2018;2018;04;20;Keskiviikko;4;5;9
93;04.04.2018;2018;04;21;Keskiviikko;1;1;2
93;04.04.2018;2018;04;22;Keskiviikko;0;1;1
93;04.04.2018;2018;04;23;Keskiviikko;0;0;0
93;05.04.2018;2018;04;00;Torstai;1;1;2
93;05.04.2018;2018;04;01;Torstai;0;0;0
93;05.04.2018;2018;04;02;Torstai;0;0;0
93;05.04.2018;2018;04;03;Torstai;0;0;0
93;05.04.2018;2018;04;04;Torstai;0;0;0
93;05.04.2018;2018;04;05;Torstai;2;4;6
93;05.04.2018;2018;04;06;Torstai;3;5;8
93;05.04.2018;2018;04;07;Torstai;11;14;25
93;05.04.2018;2018;04;08;Torstai;3;9;12
93;05.04.2018;2018;04;09;Torstai;1;2;3
93;05.04.2018;2018;04;10;Torstai;8;4;12
93;05.04.2018;2018;04;11;Torstai;5;2;7
93;05.04.2018;2018;04;12;Torstai;6;3;9
93;05.04.2018;2018;04;13;Torstai;0;5;5
93;05.04.2018;2018;04;14;Torstai;11;3;14
93;05.04.2018;2018;04;15;Torstai;7;5;12
93;05.04.2018;2018;04;16;Torstai;12;8;20
93;05.04.2018;2018;04;17;Torstai;8;3;11
93;05.04.2018;2018;04;18;Torstai;1;4;5
93;05.04.2018;2018;04;19;Torstai;1;3;4
93;05.04.2018;2018;04;20;Torstai;1;2;3
93;05.04.2018;2018;04;21;Torstai;2;0;2
93;05.04.2018;2018;04;22;Torstai;2;1;3
93;05.04.2018;2018;04;23;Torstai;0;1;1
93;06.04.2018;2018;04;00;Perjantai;0;0;0
93;06.04.2018;2018;04;01;Perjantai;0;0;0
93;06.04.2018;2018;04;02;Perjantai;0;0;0
93;06.04.2018;2018;04;03;Perjantai;0;0;0
93;06.04.2018;2018;04;04;Perjantai;0;0;0
93;06.04.2018;2018;04;05;Perjantai;0;3;3
93;06.04.2018;2018;04;06;Perjantai;1;3;4
93;06.04.2018;2018;04;07;Perjantai;4;9;13
93;06.04.2018;2018;04;08;Perjantai;3;5;8
93;06.04.2018;2018;04;09;Perjantai;1;0;1
93;06.04.2018;2018;04;10;Perjantai;4;0;4
93;06.04.2018;2018;04;11;Perjantai;1;3;4
93;06.04.2018;2018;04;12;Perjantai;1;0;1
93;06.04.2018;2018;04;13;Perjantai;1;2;3
93;06.04.2018;2018;04;14;Perjantai;6;0;6
93;06.04.2018;2018;04;15;Perjantai;4;3;7
93;06.04.2018;2018;04;16;Perjantai;11;5;16
93;06.04.2018;2018;04;17;Perjantai;3;0;3
93;06.04.2018;2018;04;18;Perjantai;2;3;5
93;06.04.2018;2018;04;19;Perjantai;2;1;3
93;06.04.2018;2018;04;20;Perjantai;3;3;6
93;06.04.2018;2018;04;21;Perjantai;0;0;0
93;06.04.2018;2018;04;22;Perjantai;0;2;2
93;06.04.2018;2018;04;23;Perjantai;0;0;0
93;07.04.2018;2018;04;00;Lauantai;0;0;0
93;07.04.2018;2018;04;01;Lauantai;0;0;0
93;07.04.2018;2018;04;02;Lauantai;0;0;0
93;07.04.2018;2018;04;03;Lauantai;0;0;0
93;07.04.2018;2018;04;04;Lauantai;0;0;0
93;07.04.2018;2018;04;05;Lauantai;0;0;0
93;07.04.2018;2018;04;06;Lauantai;1;0;1
93;07.04.2018;2018;04;07;Lauantai;0;0;0
93;07.04.2018;2018;04;08;Lauantai;2;1;3
93;07.04.2018;2018;04;09;Lauantai;2;0;2
93;07.04.2018;2018;04;10;Lauantai;6;2;8
93;07.04.2018;2018;04;11;Lauantai;2;4;6
93;07.04.2018;2018;04;12;Lauantai;4;4;8
93;07.04.2018;2018;04;13;Lauantai;0;6;6
93;07.04.2018;2018;04;14;Lauantai;6;5;11
93;07.04.2018;2018;04;15;Lauantai;11;5;16
93;07.04.2018;2018;04;16;Lauantai;3;5;8
93;07.04.2018;2018;04;17;Lauantai;1;1;2
93;07.04.2018;2018;04;18;Lauantai;1;2;3
93;07.04.2018;2018;04;19;Lauantai;3;4;7
93;07.04.2018;2018;04;20;Lauantai;2;1;3
93;07.04.2018;2018;04;21;Lauantai;0;0;0
93;07.04.2018;2018;04;22;Lauantai;0;1;1
93;07.04.2018;2018;04;23;Lauantai;0;1;1
93;08.04.2018;2018;04;00;Sunnuntai;0;0;0
93;08.04.2018;2018;04;01;Sunnuntai;0;0;0
93;08.04.2018;2018;04;02;Sunnuntai;0;0;0
93;08.04.2018;2018;04;03;Sunnuntai;0;0;0
93;08.04.2018;2018;04;04;Sunnuntai;0;0;0
93;08.04.2018;2018;04;05;Sunnuntai;2;0;2
93;08.04.2018;2018;04;06;Sunnuntai;0;0;0
93;08.04.2018;2018;04;07;Sunnuntai;0;0;0
93;08.04.2018;2018;04;08;Sunnuntai;0;1;1
93;08.04.2018;2018;04;09;Sunnuntai;1;0;1
93;08.04.2018;2018;04;10;Sunnuntai;2;3;5
93;08.04.2018;2018;04;11;Sunnuntai;3;4;7
93;08.04.2018;2018;04;12;Sunnuntai;2;3;5
93;08.04.2018;2018;04;13;Sunnuntai;4;2;6
93;08.04.2018;2018;04;14;Sunnuntai;5;7;12
93;08.04.2018;2018;04;15;Sunnuntai;8;6;14
93;08.04.2018;2018;04;16;Sunnuntai;6;0;6
93;08.04.2018;2018;04;17;Sunnuntai;7;5;12
93;08.04.2018;2018;04;18;Sunnuntai;5;7;12
93;08.04.2018;2018;04;19;Sunnuntai;3;1;4
93;08.04.2018;2018;04;20;Sunnuntai;1;5;6
93;08.04.2018;2018;04;21;Sunnuntai;0;1;1
93;08.04.2018;2018;04;22;Sunnuntai;0;0;0
93;08.04.2018;2018;04;23;Sunnuntai;0;0;0
93;09.04.2018;2018;04;00;Maanantai;0;0;0
93;09.04.2018;2018;04;01;Maanantai;0;0;0
93;09.04.2018;2018;04;02;Maanantai;0;0;0
93;09.04.2018;2018;04;03;Maanantai;0;0;0
93;09.04.2018;2018;04;04;Maanantai;0;0;0
93;09.04.2018;2018;04;05;Maanantai;6;4;10
93;09.04.2018;2018;04;06;Maanantai;9;9;18
93;09.04.2018;2018;04;07;Maanantai;6;7;13
93;09.04.2018;2018;04;08;Maanantai;4;13;17
93;09.04.2018;2018;04;09;Maanantai;3;3;6
93;09.04.2018;2018;04;10;Maanantai;1;2;3
93;09.04.2018;2018;04;11;Maanantai;0;0;0
93;09.04.2018;2018;04;12;Maanantai;3;4;7
93;09.04.2018;2018;04;13;Maanantai;3;0;3
93;09.04.2018;2018;04;14;Maanantai;6;2;8
93;09.04.2018;2018;04;15;Maanantai;12;11;23
93;09.04.2018;2018;04;16;Maanantai;10;8;18
93;09.04.2018;2018;04;17;Maanantai;13;9;22
93;09.04.2018;2018;04;18;Maanantai;3;6;9
93;09.04.2018;2018;04;19;Maanantai;4;3;7
93;09.04.2018;2018;04;20;Maanantai;1;2;3
93;09.04.2018;2018;04;21;Maanantai;1;0;1
93;09.04.2018;2018;04;22;Maanantai;0;1;1
93;09.04.2018;2018;04;23;Maanantai;0;0;0
93;10.04.2018;2018;04;00;Tiistai;0;0;0
93;10.04.2018;2018;04;01;Tiistai;0;0;0
93;10.04.2018;2018;04;02;Tiistai;0;0;0
93;10.04.2018;2018;04;03;Tiistai;0;0;0
93;10.04.2018;2018;04;04;Tiistai;1;0;1
93;10.04.2018;2018;04;05;Tiistai;3;5;8
93;10.04.2018;2018;04;06;Tiistai;7;5;12
93;10.04.2018;2018;04;07;Tiistai;7;13;20
93;10.04.2018;2018;04;08;Tiistai;5;11;16
93;10.04.2018;2018;04;09;Tiistai;4;4;8
93;10.04.2018;2018;04;10;Tiistai;5;3;8
93;10.04.2018;2018;04;11;Tiistai;3;5;8
93;10.04.2018;2018;04;12;Tiistai;3;1;4
93;10.04.2018;2018;04;13;Tiistai;1;2;3
93;10.04.2018;2018;04;14;Tiistai;7;7;14
93;10.04.2018;2018;04;15;Tiistai;13;11;24
93;10.04.2018;2018;04;16;Tiistai;16;12;28
93;10.04.2018;2018;04;17;Tiistai;11;9;20
93;10.04.2018;2018;04;18;Tiistai;3;9;12
93;10.04.2018;2018;04;19;Tiistai;8;4;12
93;10.04.2018;2018;04;20;Tiistai;0;3;3
93;10.04.2018;2018;04;21;Tiistai;0;2;2
93;10.04.2018;2018;04;22;Tiistai;0;0;0
93;10.04.2018;2018;04;23;Tiistai;0;1;1
93;11.04.2018;2018;04;00;Keskiviikko;1;0;1
93;11.04.2018;2018;04;01;Keskiviikko;0;0;0
93;11.04.2018;2018;04;02;Keskiviikko;0;0;0
93;11.04.2018;2018;04;03;Keskiviikko;0;0;0
93;11.04.2018;2018;04;04;Keskiviikko;0;0;0
93;11.04.2018;2018;04;05;Keskiviikko;5;6;11
93;11.04.2018;2018;04;06;Keskiviikko;5;6;11
93;11.04.2018;2018;04;07;Keskiviikko;9;11;20
93;11.04.2018;2018;04;08;Keskiviikko;4;12;16
93;11.04.2018;2018;04;09;Keskiviikko;5;3;8
93;11.04.2018;2018;04;10;Keskiviikko;4;4;8
93;11.04.2018;2018;04;11;Keskiviikko;3;4;7
93;11.04.2018;2018;04;12;Keskiviikko;4;4;8
93;11.04.2018;2018;04;13;Keskiviikko;1;3;4
93;11.04.2018;2018;04;14;Keskiviikko;7;4;11
93;11.04.2018;2018;04;15;Keskiviikko;11;5;16
93;11.04.2018;2018;04;16;Keskiviikko;21;15;36
93;11.04.2018;2018;04;17;Keskiviikko;13;7;20
93;11.04.2018;2018;04;18;Keskiviikko;2;3;5
93;11.04.2018;2018;04;19;Keskiviikko;3;5;8
93;11.04.2018;2018;04;20;Keskiviikko;0;4;4
93;11.04.2018;2018;04;21;Keskiviikko;0;1;1
93;11.04.2018;2018;04;22;Keskiviikko;0;0;0
93;11.04.2018;2018;04;23;Keskiviikko;0;0;0
93;12.04.2018;2018;04;00;Torstai;0;0;0
93;12.04.2018;2018;04;01;Torstai;0;0;0
93;12.04.2018;2018;04;02;Torstai;0;0;0
93;12.04.2018;2018;04;03;Torstai;0;0;0
93;12.04.2018;2018;04;04;Torstai;0;0;0
93;12.04.2018;2018;04;05;Torstai;4;5;9
93;12.04.2018;2018;04;06;Torstai;8;7;15
93;12.04.2018;2018;04;07;Torstai;8;18;26
93;12.04.2018;2018;04;08;Torstai;5;11;16
93;12.04.2018;2018;04;09;Torstai;5;4;9
93;12.04.2018;2018;04;10;Torstai;1;3;4
93;12.04.2018;2018;04;11;Torstai;6;5;11
93;12.04.2018;2018;04;12;Torstai;6;5;11
93;12.04.2018;2018;04;13;Torstai;4;4;8
93;12.04.2018;2018;04;14;Torstai;8;4;12
93;12.04.2018;2018;04;15;Torstai;17;8;25
93;12.04.2018;2018;04;16;Torstai;17;15;32
93;12.04.2018;2018;04;17;Torstai;15;7;22
93;12.04.2018;2018;04;18;Torstai;7;9;16
93;12.04.2018;2018;04;19;Torstai;3;6;9
93;12.04.2018;2018;04;20;Torstai;4;6;10
93;12.04.2018;2018;04;21;Torstai;1;3;4
93;12.04.2018;2018;04;22;Torstai;0;0;0
93;12.04.2018;2018;04;23;Torstai;0;0;0
93;13.04.2018;2018;04;00;Perjantai;0;1;1
93;13.04.2018;2018;04;01;Perjantai;0;0;0
93;13.04.2018;2018;04;02;Perjantai;0;0;0
93;13.04.2018;2018;04;03;Perjantai;0;0;0
93;13.04.2018;2018;04;04;Perjantai;0;0;0
93;13.04.2018;2018;04;05;Perjantai;2;5;7
93;13.04.2018;2018;04;06;Perjantai;11;5;16
93;13.04.2018;2018;04;07;Perjantai;11;14;25
93;13.04.2018;2018;04;08;Perjantai;7;8;15
93;13.04.2018;2018;04;09;Perjantai;3;1;4
93;13.04.2018;2018;04;10;Perjantai;5;2;7
93;13.04.2018;2018;04;11;Perjantai;5;4;9
93;13.04.2018;2018;04;12;Perjantai;11;4;15
93;13.04.2018;2018;04;13;Perjantai;4;8;12
93;13.04.2018;2018;04;14;Perjantai;15;2;17
93;13.04.2018;2018;04;15;Perjantai;15;14;29
93;13.04.2018;2018;04;16;Perjantai;11;12;23
93;13.04.2018;2018;04;17;Perjantai;8;13;21
93;13.04.2018;2018;04;18;Perjantai;10;8;18
93;13.04.2018;2018;04;19;Perjantai;6;5;11
93;13.04.2018;2018;04;20;Perjantai;2;3;5
93;13.04.2018;2018;04;21;Perjantai;0;2;2
93;13.04.2018;2018;04;22;Perjantai;1;3;4
93;13.04.2018;2018;04;23;Perjantai;1;0;1
93;14.04.2018;2018;04;00;Lauantai;0;0;0
93;14.04.2018;2018;04;01;Lauantai;0;1;1
93;14.04.2018;2018;04;02;Lauantai;0;1;1
93;14.04.2018;2018;04;03;Lauantai;0;0;0
93;14.04.2018;2018;04;04;Lauantai;0;0;0
93;14.04.2018;2018;04;05;Lauantai;0;0;0
93;14.04.2018;2018;04;06;Lauantai;0;1;1
93;14.04.2018;2018;04;07;Lauantai;6;0;6
93;14.04.2018;2018;04;08;Lauantai;2;1;3
93;14.04.2018;2018;04;09;Lauantai;5;2;7
93;14.04.2018;2018;04;10;Lauantai;1;7;8
93;14.04.2018;2018;04;11;Lauantai;10;8;18
93;14.04.2018;2018;04;12;Lauantai;13;4;17
93;14.04.2018;2018;04;13;Lauantai;6;10;16
93;14.04.2018;2018;04;14;Lauantai;11;9;20
93;14.04.2018;2018;04;15;Lauantai;15;13;28
93;14.04.2018;2018;04;16;Lauantai;4;5;9
93;14.04.2018;2018;04;17;Lauantai;12;7;19
93;14.04.2018;2018;04;18;Lauantai;2;10;12
93;14.04.2018;2018;04;19;Lauantai;2;8;10
93;14.04.2018;2018;04;20;Lauantai;4;6;10
93;14.04.2018;2018;04;21;Lauantai;2;3;5
93;14.04.2018;2018;04;22;Lauantai;0;2;2
93;14.04.2018;2018;04;23;Lauantai;0;1;1
93;15.04.2018;2018;04;00;Sunnuntai;0;0;0
93;15.04.2018;2018;04;01;Sunnuntai;0;0;0
93;15.04.2018;2018;04;02;Sunnuntai;0;0;0
93;15.04.2018;2018;04;03;Sunnuntai;0;0;0
93;15.04.2018;2018;04;04;Sunnuntai;0;0;0
93;15.04.2018;2018;04;05;Sunnuntai;0;1;1
93;15.04.2018;2018;04;06;Sunnuntai;2;2;4
93;15.04.2018;2018;04;07;Sunnuntai;5;1;6
93;15.04.2018;2018;04;08;Sunnuntai;7;1;8
93;15.04.2018;2018;04;09;Sunnuntai;3;6;9
93;15.04.2018;2018;04;10;Sunnuntai;11;6;17
93;15.04.2018;2018;04;11;Sunnuntai;24;8;32
93;15.04.2018;2018;04;12;Sunnuntai;19;25;44
93;15.04.2018;2018;04;13;Sunnuntai;16;27;43
93;15.04.2018;2018;04;14;Sunnuntai;22;33;55
93;15.04.2018;2018;04;15;Sunnuntai;25;25;50
93;15.04.2018;2018;04;16;Sunnuntai;15;17;32
93;15.04.2018;2018;04;17;Sunnuntai;19;14;33
93;15.04.2018;2018;04;18;Sunnuntai;9;19;28
93;15.04.2018;2018;04;19;Sunnuntai;8;11;19
93;15.04.2018;2018;04;20;Sunnuntai;9;6;15
93;15.04.2018;2018;04;21;Sunnuntai;0;2;2
93;15.04.2018;2018;04;22;Sunnuntai;3;2;5
93;15.04.2018;2018;04;23;Sunnuntai;0;1;1
93;16.04.2018;2018;04;00;Maanantai;0;0;0
93;16.04.2018;2018;04;01;Maanantai;0;0;0
93;16.04.2018;2018;04;02;Maanantai;0;0;0
93;16.04.2018;2018;04;03;Maanantai;0;0;0
93;16.04.2018;2018;04;04;Maanantai;0;0;0
93;16.04.2018;2018;04;05;Maanantai;2;4;6
93;16.04.2018;2018;04;06;Maanantai;10;8;18
93;16.04.2018;2018;04;07;Maanantai;20;14;34
93;16.04.2018;2018;04;08;Maanantai;7;17;24
93;16.04.2018;2018;04;09;Maanantai;10;1;11
93;16.04.2018;2018;04;10;Maanantai;3;7;10
93;16.04.2018;2018;04;11;Maanantai;10;4;14
93;16.04.2018;2018;04;12;Maanantai;6;12;18
93;16.04.2018;2018;04;13;Maanantai;14;9;23
93;16.04.2018;2018;04;14;Maanantai;18;14;32
93;16.04.2018;2018;04;15;Maanantai;22;22;44
93;16.04.2018;2018;04;16;Maanantai;17;27;44
93;16.04.2018;2018;04;17;Maanantai;22;13;35
93;16.04.2018;2018;04;18;Maanantai;13;10;23
93;16.04.2018;2018;04;19;Maanantai;14;14;28
93;16.04.2018;2018;04;20;Maanantai;6;12;18
93;16.04.2018;2018;04;21;Maanantai;5;4;9
93;16.04.2018;2018;04;22;Maanantai;0;1;1
93;16.04.2018;2018;04;23;Maanantai;0;0;0
93;17.04.2018;2018;04;00;Tiistai;0;0;0
93;17.04.2018;2018;04;01;Tiistai;0;0;0
93;17.04.2018;2018;04;02;Tiistai;1;0;1
93;17.04.2018;2018;04;03;Tiistai;0;0;0
93;17.04.2018;2018;04;04;Tiistai;0;0;0
93;17.04.2018;2018;04;05;Tiistai;3;4;7
93;17.04.2018;2018;04;06;Tiistai;12;10;22
93;17.04.2018;2018;04;07;Tiistai;18;22;40
93;17.04.2018;2018;04;08;Tiistai;8;10;18
93;17.04.2018;2018;04;09;Tiistai;6;7;13
93;17.04.2018;2018;04;10;Tiistai;9;5;14
93;17.04.2018;2018;04;11;Tiistai;11;7;18
93;17.04.2018;2018;04;12;Tiistai;8;11;19
93;17.04.2018;2018;04;13;Tiistai;12;6;18
93;17.04.2018;2018;04;14;Tiistai;13;8;21
93;17.04.2018;2018;04;15;Tiistai;14;25;39
93;17.04.2018;2018;04;16;Tiistai;24;26;50
93;17.04.2018;2018;04;17;Tiistai;17;22;39
93;17.04.2018;2018;04;18;Tiistai;11;11;22
93;17.04.2018;2018;04;19;Tiistai;10;16;26
93;17.04.2018;2018;04;20;Tiistai;5;3;8
93;17.04.2018;2018;04;21;Tiistai;2;3;5
93;17.04.2018;2018;04;22;Tiistai;1;1;2
93;17.04.2018;2018;04;23;Tiistai;0;2;2
93;18.04.2018;2018;04;00;Keskiviikko;1;0;1
93;18.04.2018;2018;04;01;Keskiviikko;0;0;0
93;18.04.2018;2018;04;02;Keskiviikko;0;0;0
93;18.04.2018;2018;04;03;Keskiviikko;0;0;0
93;18.04.2018;2018;04;04;Keskiviikko;1;0;1
93;18.04.2018;2018;04;05;Keskiviikko;5;3;8
93;18.04.2018;2018;04;06;Keskiviikko;21;10;31
93;18.04.2018;2018;04;07;Keskiviikko;22;23;45
93;18.04.2018;2018;04;08;Keskiviikko;13;12;25
93;18.04.2018;2018;04;09;Keskiviikko;5;7;12
93;18.04.2018;2018;04;10;Keskiviikko;10;10;20
93;18.04.2018;2018;04;11;Keskiviikko;5;7;12
93;18.04.2018;2018;04;12;Keskiviikko;12;8;20
93;18.04.2018;2018;04;13;Keskiviikko;9;20;29
93;18.04.2018;2018;04;14;Keskiviikko;19;19;38
93;18.04.2018;2018;04;15;Keskiviikko;17;29;46
93;18.04.2018;2018;04;16;Keskiviikko;31;35;66
93;18.04.2018;2018;04;17;Keskiviikko;20;20;40
93;18.04.2018;2018;04;18;Keskiviikko;19;29;48
93;18.04.2018;2018;04;19;Keskiviikko;21;18;39
93;18.04.2018;2018;04;20;Keskiviikko;12;7;19
93;18.04.2018;2018;04;21;Keskiviikko;1;2;3
93;18.04.2018;2018;04;22;Keskiviikko;0;1;1
93;18.04.2018;2018;04;23;Keskiviikko;0;0;0
93;19.04.2018;2018;04;00;Torstai;1;0;1
93;19.04.2018;2018;04;01;Torstai;0;0;0
93;19.04.2018;2018;04;02;Torstai;0;0;0
93;19.04.2018;2018;04;03;Torstai;0;0;0
93;19.04.2018;2018;04;04;Torstai;0;0;0
93;19.04.2018;2018;04;05;Torstai;3;7;10
93;19.04.2018;2018;04;06;Torstai;16;8;24
93;19.04.2018;2018;04;07;Torstai;25;22;47
93;19.04.2018;2018;04;08;Torstai;11;10;21
93;19.04.2018;2018;04;09;Torstai;7;11;18
93;19.04.2018;2018;04;10;Torstai;8;3;11
93;19.04.2018;2018;04;11;Torstai;7;5;12
93;19.04.2018;2018;04;12;Torstai;12;8;20
93;19.04.2018;2018;04;13;Torstai;8;12;20
93;19.04.2018;2018;04;14;Torstai;5;11;16
93;19.04.2018;2018;04;15;Torstai;19;27;46
93;19.04.2018;2018;04;16;Torstai;25;27;52
93;19.04.2018;2018;04;17;Torstai;21;15;36
93;19.04.2018;2018;04;18;Torstai;12;11;23
93;19.04.2018;2018;04;19;Torstai;8;10;18
93;19.04.2018;2018;04;20;Torstai;3;5;8
93;19.04.2018;2018;04;21;Torstai;3;4;7
93;19.04.2018;2018;04;22;Torstai;3;3;6
93;19.04.2018;2018;04;23;Torstai;0;0;0
93;20.04.2018;2018;04;00;Perjantai;0;1;1
93;20.04.2018;2018;04;01;Perjantai;0;0;0
93;20.04.2018;2018;04;02;Perjantai;0;0;0
93;20.04.2018;2018;04;03;Perjantai;0;1;1
93;20.04.2018;2018;04;04;Perjantai;0;0;0
93;20.04.2018;2018;04;05;Perjantai;1;5;6
93;20.04.2018;2018;04;06;Perjantai;10;4;14
93;20.04.2018;2018;04;07;Perjantai;7;18;25
93;20.04.2018;2018;04;08;Perjantai;2;4;6
93;20.04.2018;2018;04;09;Perjantai;4;1;5
93;20.04.2018;2018;04;10;Perjantai;2;2;4
93;20.04.2018;2018;04;11;Perjantai;4;0;4
93;20.04.2018;2018;04;12;Perjantai;2;1;3
93;20.04.2018;2018;04;13;Perjantai;3;4;7
93;20.04.2018;2018;04;14;Perjantai;11;3;14
93;20.04.2018;2018;04;15;Perjantai;7;17;24
93;20.04.2018;2018;04;16;Perjantai;15;10;25
93;20.04.2018;2018;04;17;Perjantai;8;3;11
93;20.04.2018;2018;04;18;Perjantai;8;9;17
93;20.04.2018;2018;04;19;Perjantai;12;8;20
93;20.04.2018;2018;04;20;Perjantai;3;9;12
93;20.04.2018;2018;04;21;Perjantai;1;4;5
93;20.04.2018;2018;04;22;Perjantai;5;4;9
93;20.04.2018;2018;04;23;Perjantai;2;2;4
93;21.04.2018;2018;04;00;Lauantai;0;1;1
93;21.04.2018;2018;04;01;Lauantai;1;1;2
93;21.04.2018;2018;04;02;Lauantai;0;0;0
93;21.04.2018;2018;04;03;Lauantai;0;0;0
93;21.04.2018;2018;04;04;Lauantai;0;0;0
93;21.04.2018;2018;04;05;Lauantai;0;0;0
93;21.04.2018;2018;04;06;Lauantai;0;0;0
93;21.04.2018;2018;04;07;Lauantai;3;0;3
93;21.04.2018;2018;04;08;Lauantai;6;5;11
93;21.04.2018;2018;04;09;Lauantai;2;4;6
93;21.04.2018;2018;04;10;Lauantai;8;6;14
93;21.04.2018;2018;04;11;Lauantai;9;3;12
93;21.04.2018;2018;04;12;Lauantai;6;7;13
93;21.04.2018;2018;04;13;Lauantai;9;6;15
93;21.04.2018;2018;04;14;Lauantai;10;7;17
93;21.04.2018;2018;04;15;Lauantai;10;17;27
93;21.04.2018;2018;04;16;Lauantai;11;13;24
93;21.04.2018;2018;04;17;Lauantai;15;21;36
93;21.04.2018;2018;04;18;Lauantai;12;16;28
93;21.04.2018;2018;04;19;Lauantai;2;4;6
93;21.04.2018;2018;04;20;Lauantai;8;10;18
93;21.04.2018;2018;04;21;Lauantai;4;6;10
93;21.04.2018;2018;04;22;Lauantai;3;7;10
93;21.04.2018;2018;04;23;Lauantai;1;1;2
93;22.04.2018;2018;04;00;Sunnuntai;1;2;3
93;22.04.2018;2018;04;01;Sunnuntai;0;0;0
93;22.04.2018;2018;04;02;Sunnuntai;0;1;1
93;22.04.2018;2018;04;03;Sunnuntai;0;0;0
93;22.04.2018;2018;04;04;Sunnuntai;0;0;0
93;22.04.2018;2018;04;05;Sunnuntai;0;1;1
93;22.04.2018;2018;04;06;Sunnuntai;0;0;0
93;22.04.2018;2018;04;07;Sunnuntai;3;1;4
93;22.04.2018;2018;04;08;Sunnuntai;3;2;5
93;22.04.2018;2018;04;09;Sunnuntai;10;11;21
93;22.04.2018;2018;04;10;Sunnuntai;13;11;24
93;22.04.2018;2018;04;11;Sunnuntai;15;20;35
93;22.04.2018;2018;04;12;Sunnuntai;40;25;65
93;22.04.2018;2018;04;13;Sunnuntai;31;19;50
93;22.04.2018;2018;04;14;Sunnuntai;35;19;54
93;22.04.2018;2018;04;15;Sunnuntai;12;13;25
93;22.04.2018;2018;04;16;Sunnuntai;23;17;40
93;22.04.2018;2018;04;17;Sunnuntai;10;18;28
93;22.04.2018;2018;04;18;Sunnuntai;15;21;36
93;22.04.2018;2018;04;19;Sunnuntai;13;9;22
93;22.04.2018;2018;04;20;Sunnuntai;6;7;13
93;22.04.2018;2018;04;21;Sunnuntai;2;4;6
93;22.04.2018;2018;04;22;Sunnuntai;5;2;7
93;22.04.2018;2018;04;23;Sunnuntai;0;0;0
93;23.04.2018;2018;04;00;Maanantai;0;0;0
93;23.04.2018;2018;04;01;Maanantai;0;0;0
93;23.04.2018;2018;04;02;Maanantai;0;0;0
93;23.04.2018;2018;04;03;Maanantai;0;0;0
93;23.04.2018;2018;04;04;Maanantai;0;0;0
93;23.04.2018;2018;04;05;Maanantai;4;6;10
93;23.04.2018;2018;04;06;Maanantai;14;10;24
93;23.04.2018;2018;04;07;Maanantai;24;21;45
93;23.04.2018;2018;04;08;Maanantai;10;22;32
93;23.04.2018;2018;04;09;Maanantai;9;4;13
93;23.04.2018;2018;04;10;Maanantai;8;6;14
93;23.04.2018;2018;04;11;Maanantai;10;2;12
93;23.04.2018;2018;04;12;Maanantai;9;7;16
93;23.04.2018;2018;04;13;Maanantai;15;11;26
93;23.04.2018;2018;04;14;Maanantai;26;11;37
93;23.04.2018;2018;04;15;Maanantai;20;29;49
93;23.04.2018;2018;04;16;Maanantai;31;31;62
93;23.04.2018;2018;04;17;Maanantai;19;22;41
93;23.04.2018;2018;04;18;Maanantai;17;23;40
93;23.04.2018;2018;04;19;Maanantai;11;11;22
93;23.04.2018;2018;04;20;Maanantai;5;14;19
93;23.04.2018;2018;04;21;Maanantai;1;4;5
93;23.04.2018;2018;04;22;Maanantai;1;4;5
93;23.04.2018;2018;04;23;Maanantai;0;1;1
93;24.04.2018;2018;04;00;Tiistai;0;0;0
93;24.04.2018;2018;04;01;Tiistai;0;0;0
93;24.04.2018;2018;04;02;Tiistai;0;0;0
93;24.04.2018;2018;04;03;Tiistai;0;0;0
93;24.04.2018;2018;04;04;Tiistai;0;0;0
93;24.04.2018;2018;04;05;Tiistai;2;3;5
93;24.04.2018;2018;04;06;Tiistai;8;8;16
93;24.04.2018;2018;04;07;Tiistai;27;31;58
93;24.04.2018;2018;04;08;Tiistai;11;15;26
93;24.04.2018;2018;04;09;Tiistai;4;5;9
93;24.04.2018;2018;04;10;Tiistai;5;1;6
93;24.04.2018;2018;04;11;Tiistai;6;5;11
93;24.04.2018;2018;04;12;Tiistai;4;6;10
93;24.04.2018;2018;04;13;Tiistai;7;2;9
93;24.04.2018;2018;04;14;Tiistai;13;6;19
93;24.04.2018;2018;04;15;Tiistai;14;14;28
93;24.04.2018;2018;04;16;Tiistai;27;29;56
93;24.04.2018;2018;04;17;Tiistai;10;11;21
93;24.04.2018;2018;04;18;Tiistai;4;7;11
93;24.04.2018;2018;04;19;Tiistai;7;4;11
93;24.04.2018;2018;04;20;Tiistai;2;4;6
93;24.04.2018;2018;04;21;Tiistai;1;2;3
93;24.04.2018;2018;04;22;Tiistai;0;3;3
93;24.04.2018;2018;04;23;Tiistai;1;0;1
93;25.04.2018;2018;04;00;Keskiviikko;0;0;0
93;25.04.2018;2018;04;01;Keskiviikko;0;0;0
93;25.04.2018;2018;04;02;Keskiviikko;0;0;0
93;25.04.2018;2018;04;03;Keskiviikko;0;0;0
93;25.04.2018;2018;04;04;Keskiviikko;0;0;0
93;25.04.2018;2018;04;05;Keskiviikko;2;4;6
93;25.04.2018;2018;04;06;Keskiviikko;20;9;29
93;25.04.2018;2018;04;07;Keskiviikko;18;25;43
93;25.04.2018;2018;04;08;Keskiviikko;6;14;20
93;25.04.2018;2018;04;09;Keskiviikko;3;6;9
93;25.04.2018;2018;04;10;Keskiviikko;7;5;12
93;25.04.2018;2018;04;11;Keskiviikko;8;5;13
93;25.04.2018;2018;04;12;Keskiviikko;6;9;15
93;25.04.2018;2018;04;13;Keskiviikko;4;5;9
93;25.04.2018;2018;04;14;Keskiviikko;17;8;25
93;25.04.2018;2018;04;15;Keskiviikko;16;22;38
93;25.04.2018;2018;04;16;Keskiviikko;41;27;68
93;25.04.2018;2018;04;17;Keskiviikko;20;29;49
93;25.04.2018;2018;04;18;Keskiviikko;10;13;23
93;25.04.2018;2018;04;19;Keskiviikko;3;10;13
93;25.04.2018;2018;04;20;Keskiviikko;9;4;13
93;25.04.2018;2018;04;21;Keskiviikko;9;2;11
93;25.04.2018;2018;04;22;Keskiviikko;1;1;2
93;25.04.2018;2018;04;23;Keskiviikko;0;0;0
93;26.04.2018;2018;04;00;Torstai;0;1;1
93;26.04.2018;2018;04;01;Torstai;0;0;0
93;26.04.2018;2018;04;02;Torstai;0;0;0
93;26.04.2018;2018;04;03;Torstai;0;0;0
93;26.04.2018;2018;04;04;Torstai;0;0;0
93;26.04.2018;2018;04;05;Torstai;5;4;9
93;26.04.2018;2018;04;06;Torstai;15;8;23
93;26.04.2018;2018;04;07;Torstai;19;30;49
93;26.04.2018;2018;04;08;Torstai;8;16;24
93;26.04.2018;2018;04;09;Torstai;12;3;15
93;26.04.2018;2018;04;10;Torstai;4;2;6
93;26.04.2018;2018;04;11;Torstai;8;10;18
93;26.04.2018;2018;04;12;Torstai;12;4;16
93;26.04.2018;2018;04;13;Torstai;7;6;13
93;26.04.2018;2018;04;14;Torstai;10;9;19
93;26.04.2018;2018;04;15;Torstai;18;23;41
93;26.04.2018;2018;04;16;Torstai;33;28;61
93;26.04.2018;2018;04;17;Torstai;20;15;35
93;26.04.2018;2018;04;18;Torstai;9;19;28
93;26.04.2018;2018;04;19;Torstai;12;10;22
93;26.04.2018;2018;04;20;Torstai;3;6;9
93;26.04.2018;2018;04;21;Torstai;5;8;13
93;26.04.2018;2018;04;22;Torstai;3;1;4
93;26.04.2018;2018;04;23;Torstai;1;1;2
93;27.04.2018;2018;04;00;Perjantai;0;2;2
93;27.04.2018;2018;04;01;Perjantai;0;0;0
93;27.04.2018;2018;04;02;Perjantai;0;0;0
93;27.04.2018;2018;04;03;Perjantai;0;0;0
93;27.04.2018;2018;04;04;Perjantai;0;0;0
93;27.04.2018;2018;04;05;Perjantai;2;6;8
93;27.04.2018;2018;04;06;Perjantai;13;6;19
93;27.04.2018;2018;04;07;Perjantai;15;27;42
93;27.04.2018;2018;04;08;Perjantai;11;17;28
93;27.04.2018;2018;04;09;Perjantai;7;2;9
93;27.04.2018;2018;04;10;Perjantai;16;3;19
93;27.04.2018;2018;04;11;Perjantai;14;7;21
93;27.04.2018;2018;04;12;Perjantai;10;8;18
93;27.04.2018;2018;04;13;Perjantai;10;10;20
93;27.04.2018;2018;04;14;Perjantai;12;24;36
93;27.04.2018;2018;04;15;Perjantai;29;17;46
93;27.04.2018;2018;04;16;Perjantai;24;28;52
93;27.04.2018;2018;04;17;Perjantai;26;22;48
93;27.04.2018;2018;04;18;Perjantai;17;15;32
93;27.04.2018;2018;04;19;Perjantai;14;14;28
93;27.04.2018;2018;04;20;Perjantai;8;17;25
93;27.04.2018;2018;04;21;Perjantai;3;7;10
93;27.04.2018;2018;04;22;Perjantai;4;5;9
93;27.04.2018;2018;04;23;Perjantai;1;0;1
93;28.04.2018;2018;04;00;Lauantai;0;0;0
93;28.04.2018;2018;04;01;Lauantai;0;3;3
93;28.04.2018;2018;04;02;Lauantai;0;1;1
93;28.04.2018;2018;04;03;Lauantai;1;0;1
93;28.04.2018;2018;04;04;Lauantai;0;0;0
93;28.04.2018;2018;04;05;Lauantai;1;1;2
93;28.04.2018;2018;04;06;Lauantai;0;1;1
93;28.04.2018;2018;04;07;Lauantai;5;5;10
93;28.04.2018;2018;04;08;Lauantai;3;1;4
93;28.04.2018;2018;04;09;Lauantai;12;3;15
93;28.04.2018;2018;04;10;Lauantai;8;14;22
93;28.04.2018;2018;04;11;Lauantai;12;17;29
93;28.04.2018;2018;04;12;Lauantai;25;18;43
93;28.04.2018;2018;04;13;Lauantai;18;18;36
93;28.04.2018;2018;04;14;Lauantai;13;16;29
93;28.04.2018;2018;04;15;Lauantai;13;20;33
93;28.04.2018;2018;04;16;Lauantai;19;15;34
93;28.04.2018;2018;04;17;Lauantai;23;6;29
93;28.04.2018;2018;04;18;Lauantai;19;25;44
93;28.04.2018;2018;04;19;Lauantai;16;16;32
93;28.04.2018;2018;04;20;Lauantai;3;5;8
93;28.04.2018;2018;04;21;Lauantai;10;9;19
93;28.04.2018;2018;04;22;Lauantai;1;11;12
93;28.04.2018;2018;04;23;Lauantai;1;7;8
93;29.04.2018;2018;04;00;Sunnuntai;1;1;2
93;29.04.2018;2018;04;01;Sunnuntai;1;0;1
93;29.04.2018;2018;04;02;Sunnuntai;0;2;2
93;29.04.2018;2018;04;03;Sunnuntai;0;1;1
93;29.04.2018;2018;04;04;Sunnuntai;1;0;1
93;29.04.2018;2018;04;05;Sunnuntai;1;1;2
93;29.04.2018;2018;04;06;Sunnuntai;2;0;2
93;29.04.2018;2018;04;07;Sunnuntai;3;4;7
93;29.04.2018;2018;04;08;Sunnuntai;3;5;8
93;29.04.2018;2018;04;09;Sunnuntai;17;7;24
93;29.04.2018;2018;04;10;Sunnuntai;15;12;27
93;29.04.2018;2018;04;11;Sunnuntai;14;10;24
93;29.04.2018;2018;04;12;Sunnuntai;18;17;35
93;29.04.2018;2018;04;13;Sunnuntai;17;12;29
93;29.04.2018;2018;04;14;Sunnuntai;12;25;37
93;29.04.2018;2018;04;15;Sunnuntai;12;19;31
93;29.04.2018;2018;04;16;Sunnuntai;11;19;30
93;29.04.2018;2018;04;17;Sunnuntai;16;22;38
93;29.04.2018;2018;04;18;Sunnuntai;13;19;32
93;29.04.2018;2018;04;19;Sunnuntai;6;10;16
93;29.04.2018;2018;04;20;Sunnuntai;10;12;22
93;29.04.2018;2018;04;21;Sunnuntai;5;7;12
93;29.04.2018;2018;04;22;Sunnuntai;2;0;2
93;29.04.2018;2018;04;23;Sunnuntai;3;1;4
93;30.04.2018;2018;04;00;Maanantai;0;0;0
93;30.04.2018;2018;04;01;Maanantai;0;1;1
93;30.04.2018;2018;04;02;Maanantai;0;0;0
93;30.04.2018;2018;04;03;Maanantai;0;0;0
93;30.04.2018;2018;04;04;Maanantai;0;0;0
93;30.04.2018;2018;04;05;Maanantai;4;4;8
93;30.04.2018;2018;04;06;Maanantai;9;11;20
93;30.04.2018;2018;04;07;Maanantai;14;21;35
93;30.04.2018;2018;04;08;Maanantai;10;17;27
93;30.04.2018;2018;04;09;Maanantai;10;4;14
93;30.04.2018;2018;04;10;Maanantai;6;7;13
93;30.04.2018;2018;04;11;Maanantai;6;12;18
93;30.04.2018;2018;04;12;Maanantai;15;13;28
93;30.04.2018;2018;04;13;Maanantai;12;13;25
93;30.04.2018;2018;04;14;Maanantai;25;18;43
93;30.04.2018;2018;04;15;Maanantai;27;21;48
93;30.04.2018;2018;04;16;Maanantai;19;27;46
93;30.04.2018;2018;04;17;Maanantai;13;19;32
93;30.04.2018;2018;04;18;Maanantai;3;7;10
93;30.04.2018;2018;04;19;Maanantai;5;4;9
93;30.04.2018;2018;04;20;Maanantai;5;7;12
93;30.04.2018;2018;04;21;Maanantai;1;4;5
93;30.04.2018;2018;04;22;Maanantai;0;5;5
93;30.04.2018;2018;04;23;Maanantai;0;2;2
93;01.05.2018;2018;05;00;Tiistai;1;0;1
93;01.05.2018;2018;05;01;Tiistai;1;1;2
93;01.05.2018;2018;05;02;Tiistai;0;2;2
93;01.05.2018;2018;05;03;Tiistai;0;0;0
93;01.05.2018;2018;05;04;Tiistai;0;0;0
93;01.05.2018;2018;05;05;Tiistai;2;0;2
93;01.05.2018;2018;05;06;Tiistai;0;1;1
93;01.05.2018;2018;05;07;Tiistai;4;3;7
93;01.05.2018;2018;05;08;Tiistai;2;3;5
93;01.05.2018;2018;05;09;Tiistai;13;6;19
93;01.05.2018;2018;05;10;Tiistai;8;14;22
93;01.05.2018;2018;05;11;Tiistai;18;11;29
93;01.05.2018;2018;05;12;Tiistai;56;9;65
93;01.05.2018;2018;05;13;Tiistai;19;37;56
93;01.05.2018;2018;05;14;Tiistai;15;34;49
93;01.05.2018;2018;05;15;Tiistai;14;24;38
93;01.05.2018;2018;05;16;Tiistai;9;20;29
93;01.05.2018;2018;05;17;Tiistai;11;18;29
93;01.05.2018;2018;05;18;Tiistai;11;39;50
93;01.05.2018;2018;05;19;Tiistai;6;23;29
93;01.05.2018;2018;05;20;Tiistai;8;2;10
93;01.05.2018;2018;05;21;Tiistai;10;4;14
93;01.05.2018;2018;05;22;Tiistai;1;1;2
93;01.05.2018;2018;05;23;Tiistai;0;0;0
93;02.05.2018;2018;05;00;Keskiviikko;0;0;0
93;02.05.2018;2018;05;01;Keskiviikko;0;0;0
93;02.05.2018;2018;05;02;Keskiviikko;0;0;0
93;02.05.2018;2018;05;03;Keskiviikko;0;0;0
93;02.05.2018;2018;05;04;Keskiviikko;1;1;2
93;02.05.2018;2018;05;05;Keskiviikko;4;5;9
93;02.05.2018;2018;05;06;Keskiviikko;6;11;17
93;02.05.2018;2018;05;07;Keskiviikko;13;18;31
93;02.05.2018;2018;05;08;Keskiviikko;7;11;18
93;02.05.2018;2018;05;09;Keskiviikko;6;7;13
93;02.05.2018;2018;05;10;Keskiviikko;2;2;4
93;02.05.2018;2018;05;11;Keskiviikko;6;2;8
93;02.05.2018;2018;05;12;Keskiviikko;5;2;7
93;02.05.2018;2018;05;13;Keskiviikko;4;6;10
93;02.05.2018;2018;05;14;Keskiviikko;6;8;14
93;02.05.2018;2018;05;15;Keskiviikko;20;12;32
93;02.05.2018;2018;05;16;Keskiviikko;21;19;40
93;02.05.2018;2018;05;17;Keskiviikko;14;5;19
93;02.05.2018;2018;05;18;Keskiviikko;9;7;16
93;02.05.2018;2018;05;19;Keskiviikko;2;4;6
93;02.05.2018;2018;05;20;Keskiviikko;1;6;7
93;02.05.2018;2018;05;21;Keskiviikko;1;2;3
93;02.05.2018;2018;05;22;Keskiviikko;0;2;2
93;02.05.2018;2018;05;23;Keskiviikko;0;0;0
93;03.05.2018;2018;05;00;Torstai;0;0;0
93;03.05.2018;2018;05;01;Torstai;0;0;0
93;03.05.2018;2018;05;02;Torstai;0;0;0
93;03.05.2018;2018;05;03;Torstai;0;0;0
93;03.05.2018;2018;05;04;Torstai;1;0;1
93;03.05.2018;2018;05;05;Torstai;5;6;11
93;03.05.2018;2018;05;06;Torstai;13;10;23
93;03.05.2018;2018;05;07;Torstai;22;29;51
93;03.05.2018;2018;05;08;Torstai;12;14;26
93;03.05.2018;2018;05;09;Torstai;9;8;17
93;03.05.2018;2018;05;10;Torstai;6;7;13
93;03.05.2018;2018;05;11;Torstai;10;5;15
93;03.05.2018;2018;05;12;Torstai;15;8;23
93;03.05.2018;2018;05;13;Torstai;37;9;46
93;03.05.2018;2018;05;14;Torstai;14;7;21
93;03.05.2018;2018;05;15;Torstai;13;28;41
93;03.05.2018;2018;05;16;Torstai;31;29;60
93;03.05.2018;2018;05;17;Torstai;15;21;36
93;03.05.2018;2018;05;18;Torstai;11;18;29
93;03.05.2018;2018;05;19;Torstai;11;6;17
93;03.05.2018;2018;05;20;Torstai;3;18;21
93;03.05.2018;2018;05;21;Torstai;3;5;8
93;03.05.2018;2018;05;22;Torstai;1;7;8
93;03.05.2018;2018;05;23;Torstai;0;0;0
93;04.05.2018;2018;05;00;Perjantai;0;0;0
93;04.05.2018;2018;05;01;Perjantai;0;0;0
93;04.05.2018;2018;05;02;Perjantai;1;0;1
93;04.05.2018;2018;05;03;Perjantai;0;0;0
93;04.05.2018;2018;05;04;Perjantai;0;0;0
93;04.05.2018;2018;05;05;Perjantai;0;5;5
93;04.05.2018;2018;05;06;Perjantai;5;5;10
93;04.05.2018;2018;05;07;Perjantai;14;14;28
93;04.05.2018;2018;05;08;Perjantai;0;8;8
93;04.05.2018;2018;05;09;Perjantai;2;1;3
93;04.05.2018;2018;05;10;Perjantai;1;0;1
93;04.05.2018;2018;05;11;Perjantai;2;0;2
93;04.05.2018;2018;05;12;Perjantai;3;2;5
93;04.05.2018;2018;05;13;Perjantai;2;2;4
93;04.05.2018;2018;05;14;Perjantai;9;2;11
93;04.05.2018;2018;05;15;Perjantai;9;11;20
93;04.05.2018;2018;05;16;Perjantai;14;8;22
93;04.05.2018;2018;05;17;Perjantai;3;4;7
93;04.05.2018;2018;05;18;Perjantai;5;9;14
93;04.05.2018;2018;05;19;Perjantai;4;4;8
93;04.05.2018;2018;05;20;Perjantai;3;3;6
93;04.05.2018;2018;05;21;Perjantai;3;4;7
93;04.05.2018;2018;05;22;Perjantai;0;2;2
93;04.05.2018;2018;05;23;Perjantai;2;0;2
93;05.05.2018;2018;05;00;Lauantai;0;0;0
93;05.05.2018;2018;05;01;Lauantai;0;1;1
93;05.05.2018;2018;05;02;Lauantai;0;0;0
93;05.05.2018;2018;05;03;Lauantai;1;0;1
93;05.05.2018;2018;05;04;Lauantai;0;1;1
93;05.05.2018;2018;05;05;Lauantai;0;0;0
93;05.05.2018;2018;05;06;Lauantai;1;0;1
93;05.05.2018;2018;05;07;Lauantai;0;1;1
93;05.05.2018;2018;05;08;Lauantai;1;2;3
93;05.05.2018;2018;05;09;Lauantai;10;4;14
93;05.05.2018;2018;05;10;Lauantai;10;10;20
93;05.05.2018;2018;05;11;Lauantai;9;3;12
93;05.05.2018;2018;05;12;Lauantai;20;13;33
93;05.05.2018;2018;05;13;Lauantai;27;20;47
93;05.05.2018;2018;05;14;Lauantai;18;20;38
93;05.05.2018;2018;05;15;Lauantai;15;23;38
93;05.05.2018;2018;05;16;Lauantai;16;23;39
93;05.05.2018;2018;05;17;Lauantai;21;22;43
93;05.05.2018;2018;05;18;Lauantai;18;17;35
93;05.05.2018;2018;05;19;Lauantai;10;15;25
93;05.05.2018;2018;05;20;Lauantai;9;6;15
93;05.05.2018;2018;05;21;Lauantai;7;16;23
93;05.05.2018;2018;05;22;Lauantai;2;6;8
93;05.05.2018;2018;05;23;Lauantai;1;1;2
93;06.05.2018;2018;05;00;Sunnuntai;3;0;3
93;06.05.2018;2018;05;01;Sunnuntai;3;2;5
93;06.05.2018;2018;05;02;Sunnuntai;0;0;0
93;06.05.2018;2018;05;03;Sunnuntai;0;1;1
93;06.05.2018;2018;05;04;Sunnuntai;0;0;0
93;06.05.2018;2018;05;05;Sunnuntai;2;0;2
93;06.05.2018;2018;05;06;Sunnuntai;3;0;3
93;06.05.2018;2018;05;07;Sunnuntai;4;4;8
93;06.05.2018;2018;05;08;Sunnuntai;14;3;17
93;06.05.2018;2018;05;09;Sunnuntai;14;6;20
93;06.05.2018;2018;05;10;Sunnuntai;19;32;51
93;06.05.2018;2018;05;11;Sunnuntai;37;45;82
93;06.05.2018;2018;05;12;Sunnuntai;39;23;62
93;06.05.2018;2018;05;13;Sunnuntai;19;16;35
93;06.05.2018;2018;05;14;Sunnuntai;11;14;25
93;06.05.2018;2018;05;15;Sunnuntai;33;16;49
93;06.05.2018;2018;05;16;Sunnuntai;22;26;48
93;06.05.2018;2018;05;17;Sunnuntai;20;21;41
93;06.05.2018;2018;05;18;Sunnuntai;11;25;36
93;06.05.2018;2018;05;19;Sunnuntai;19;13;32
93;06.05.2018;2018;05;20;Sunnuntai;7;6;13
93;06.05.2018;2018;05;21;Sunnuntai;4;8;12
93;06.05.2018;2018;05;22;Sunnuntai;0;1;1
93;06.05.2018;2018;05;23;Sunnuntai;2;0;2
93;07.05.2018;2018;05;00;Maanantai;0;0;0
93;07.05.2018;2018;05;01;Maanantai;0;0;0
93;07.05.2018;2018;05;02;Maanantai;0;0;0
93;07.05.2018;2018;05;03;Maanantai;0;0;0
93;07.05.2018;2018;05;04;Maanantai;1;0;1
93;07.05.2018;2018;05;05;Maanantai;6;5;11
93;07.05.2018;2018;05;06;Maanantai;12;15;27
93;07.05.2018;2018;05;07;Maanantai;24;22;46
93;07.05.2018;2018;05;08;Maanantai;17;23;40
93;07.05.2018;2018;05;09;Maanantai;13;10;23
93;07.05.2018;2018;05;10;Maanantai;11;3;14
93;07.05.2018;2018;05;11;Maanantai;4;4;8
93;07.05.2018;2018;05;12;Maanantai;9;4;13
93;07.05.2018;2018;05;13;Maanantai;4;3;7
93;07.05.2018;2018;05;14;Maanantai;17;18;35
93;07.05.2018;2018;05;15;Maanantai;23;17;40
93;07.05.2018;2018;05;16;Maanantai;28;23;51
93;07.05.2018;2018;05;17;Maanantai;11;10;21
93;07.05.2018;2018;05;18;Maanantai;4;9;13
93;07.05.2018;2018;05;19;Maanantai;6;10;16
93;07.05.2018;2018;05;20;Maanantai;7;14;21
93;07.05.2018;2018;05;21;Maanantai;6;6;12
93;07.05.2018;2018;05;22;Maanantai;3;0;3
93;07.05.2018;2018;05;23;Maanantai;0;1;1
93;08.05.2018;2018;05;00;Tiistai;1;0;1
93;08.05.2018;2018;05;01;Tiistai;0;0;0
93;08.05.2018;2018;05;02;Tiistai;0;0;0
93;08.05.2018;2018;05;03;Tiistai;0;0;0
93;08.05.2018;2018;05;04;Tiistai;2;0;2
93;08.05.2018;2018;05;05;Tiistai;8;5;13
93;08.05.2018;2018;05;06;Tiistai;17;14;31
93;08.05.2018;2018;05;07;Tiistai;41;35;76
93;08.05.2018;2018;05;08;Tiistai;9;24;33
93;08.05.2018;2018;05;09;Tiistai;18;8;26
93;08.05.2018;2018;05;10;Tiistai;13;7;20
93;08.05.2018;2018;05;11;Tiistai;11;9;20
93;08.05.2018;2018;05;12;Tiistai;9;13;22
93;08.05.2018;2018;05;13;Tiistai;23;12;35
93;08.05.2018;2018;05;14;Tiistai;17;15;32
93;08.05.2018;2018;05;15;Tiistai;24;45;69
93;08.05.2018;2018;05;16;Tiistai;39;50;89
93;08.05.2018;2018;05;17;Tiistai;23;30;53
93;08.05.2018;2018;05;18;Tiistai;22;35;57
93;08.05.2018;2018;05;19;Tiistai;29;20;49
93;08.05.2018;2018;05;20;Tiistai;13;18;31
93;08.05.2018;2018;05;21;Tiistai;4;7;11
93;08.05.2018;2018;05;22;Tiistai;2;3;5
93;08.05.2018;2018;05;23;Tiistai;1;0;1
93;09.05.2018;2018;05;00;Keskiviikko;1;0;1
93;09.05.2018;2018;05;01;Keskiviikko;0;0;0
93;09.05.2018;2018;05;02;Keskiviikko;0;0;0
93;09.05.2018;2018;05;03;Keskiviikko;0;0;0
93;09.05.2018;2018;05;04;Keskiviikko;0;0;0
93;09.05.2018;2018;05;05;Keskiviikko;5;6;11
93;09.05.2018;2018;05;06;Keskiviikko;20;20;40
93;09.05.2018;2018;05;07;Keskiviikko;36;31;67
93;09.05.2018;2018;05;08;Keskiviikko;23;25;48
93;09.05.2018;2018;05;09;Keskiviikko;10;11;21
93;09.05.2018;2018;05;10;Keskiviikko;11;9;20
93;09.05.2018;2018;05;11;Keskiviikko;9;8;17
93;09.05.2018;2018;05;12;Keskiviikko;16;13;29
93;09.05.2018;2018;05;13;Keskiviikko;11;6;17
93;09.05.2018;2018;05;14;Keskiviikko;24;26;50
93;09.05.2018;2018;05;15;Keskiviikko;32;34;66
93;09.05.2018;2018;05;16;Keskiviikko;46;44;90
93;09.05.2018;2018;05;17;Keskiviikko;26;23;49
93;09.05.2018;2018;05;18;Keskiviikko;26;24;50
93;09.05.2018;2018;05;19;Keskiviikko;11;29;40
93;09.05.2018;2018;05;20;Keskiviikko;11;10;21
93;09.05.2018;2018;05;21;Keskiviikko;10;12;22
93;09.05.2018;2018;05;22;Keskiviikko;7;4;11
93;09.05.2018;2018;05;23;Keskiviikko;1;2;3
93;10.05.2018;2018;05;00;Torstai;1;4;5
93;10.05.2018;2018;05;01;Torstai;0;2;2
93;10.05.2018;2018;05;02;Torstai;0;0;0
93;10.05.2018;2018;05;03;Torstai;2;1;3
93;10.05.2018;2018;05;04;Torstai;3;0;3
93;10.05.2018;2018;05;05;Torstai;5;2;7
93;10.05.2018;2018;05;06;Torstai;1;3;4
93;10.05.2018;2018;05;07;Torstai;7;7;14
93;10.05.2018;2018;05;08;Torstai;8;8;16
93;10.05.2018;2018;05;09;Torstai;19;13;32
93;10.05.2018;2018;05;10;Torstai;16;26;42
93;10.05.2018;2018;05;11;Torstai;31;25;56
93;10.05.2018;2018;05;12;Torstai;45;32;77
93;10.05.2018;2018;05;13;Torstai;36;34;70
93;10.05.2018;2018;05;14;Torstai;33;34;67
93;10.05.2018;2018;05;15;Torstai;31;47;78
93;10.05.2018;2018;05;16;Torstai;37;36;73
93;10.05.2018;2018;05;17;Torstai;25;44;69
93;10.05.2018;2018;05;18;Torstai;42;28;70
93;10.05.2018;2018;05;19;Torstai;21;21;42
93;10.05.2018;2018;05;20;Torstai;20;18;38
93;10.05.2018;2018;05;21;Torstai;7;11;18
93;10.05.2018;2018;05;22;Torstai;4;4;8
93;10.05.2018;2018;05;23;Torstai;2;3;5
93;11.05.2018;2018;05;00;Perjantai;4;0;4
93;11.05.2018;2018;05;01;Perjantai;0;0;0
93;11.05.2018;2018;05;02;Perjantai;0;0;0
93;11.05.2018;2018;05;03;Perjantai;0;1;1
93;11.05.2018;2018;05;04;Perjantai;2;0;2
93;11.05.2018;2018;05;05;Perjantai;7;3;10
93;11.05.2018;2018;05;06;Perjantai;14;14;28
93;11.05.2018;2018;05;07;Perjantai;23;35;58
93;11.05.2018;2018;05;08;Perjantai;19;24;43
93;11.05.2018;2018;05;09;Perjantai;15;18;33
93;11.05.2018;2018;05;10;Perjantai;14;5;19
93;11.05.2018;2018;05;11;Perjantai;22;16;38
93;11.05.2018;2018;05;12;Perjantai;23;14;37
93;11.05.2018;2018;05;13;Perjantai;21;16;37
93;11.05.2018;2018;05;14;Perjantai;27;36;63
93;11.05.2018;2018;05;15;Perjantai;33;53;86
93;11.05.2018;2018;05;16;Perjantai;54;23;77
93;11.05.2018;2018;05;17;Perjantai;37;31;68
93;11.05.2018;2018;05;18;Perjantai;27;38;65
93;11.05.2018;2018;05;19;Perjantai;19;24;43
93;11.05.2018;2018;05;20;Perjantai;16;17;33
93;11.05.2018;2018;05;21;Perjantai;10;16;26
93;11.05.2018;2018;05;22;Perjantai;5;8;13
93;11.05.2018;2018;05;23;Perjantai;1;3;4
93;12.05.2018;2018;05;00;Lauantai;0;6;6
93;12.05.2018;2018;05;01;Lauantai;5;0;5
93;12.05.2018;2018;05;02;Lauantai;0;0;0
93;12.05.2018;2018;05;03;Lauantai;0;0;0
93;12.05.2018;2018;05;04;Lauantai;0;1;1
93;12.05.2018;2018;05;05;Lauantai;0;0;0
93;12.05.2018;2018;05;06;Lauantai;4;4;8
93;12.05.2018;2018;05;07;Lauantai;5;2;7
93;12.05.2018;2018;05;08;Lauantai;6;10;16
93;12.05.2018;2018;05;09;Lauantai;23;14;37
93;12.05.2018;2018;05;10;Lauantai;29;51;80
93;12.05.2018;2018;05;11;Lauantai;24;36;60
93;12.05.2018;2018;05;12;Lauantai;26;30;56
93;12.05.2018;2018;05;13;Lauantai;54;24;78
93;12.05.2018;2018;05;14;Lauantai;26;26;52
93;12.05.2018;2018;05;15;Lauantai;32;30;62
93;12.05.2018;2018;05;16;Lauantai;27;28;55
93;12.05.2018;2018;05;17;Lauantai;49;21;70
93;12.05.2018;2018;05;18;Lauantai;16;42;58
93;12.05.2018;2018;05;19;Lauantai;19;26;45
93;12.05.2018;2018;05;20;Lauantai;15;15;30
93;12.05.2018;2018;05;21;Lauantai;4;7;11
93;12.05.2018;2018;05;22;Lauantai;6;18;24
93;12.05.2018;2018;05;23;Lauantai;4;3;7
93;13.05.2018;2018;05;00;Sunnuntai;4;6;10
93;13.05.2018;2018;05;01;Sunnuntai;2;1;3
93;13.05.2018;2018;05;02;Sunnuntai;5;3;8
93;13.05.2018;2018;05;03;Sunnuntai;0;0;0
93;13.05.2018;2018;05;04;Sunnuntai;0;1;1
93;13.05.2018;2018;05;05;Sunnuntai;0;1;1
93;13.05.2018;2018;05;06;Sunnuntai;2;1;3
93;13.05.2018;2018;05;07;Sunnuntai;3;3;6
93;13.05.2018;2018;05;08;Sunnuntai;6;8;14
93;13.05.2018;2018;05;09;Sunnuntai;11;11;22
93;13.05.2018;2018;05;10;Sunnuntai;23;24;47
93;13.05.2018;2018;05;11;Sunnuntai;25;40;65
93;13.05.2018;2018;05;12;Sunnuntai;44;34;78
93;13.05.2018;2018;05;13;Sunnuntai;16;43;59
93;13.05.2018;2018;05;14;Sunnuntai;34;26;60
93;13.05.2018;2018;05;15;Sunnuntai;40;35;75
93;13.05.2018;2018;05;16;Sunnuntai;27;34;61
93;13.05.2018;2018;05;17;Sunnuntai;32;32;64
93;13.05.2018;2018;05;18;Sunnuntai;27;39;66
93;13.05.2018;2018;05;19;Sunnuntai;28;26;54
93;13.05.2018;2018;05;20;Sunnuntai;22;12;34
93;13.05.2018;2018;05;21;Sunnuntai;12;12;24
93;13.05.2018;2018;05;22;Sunnuntai;2;7;9
93;13.05.2018;2018;05;23;Sunnuntai;1;2;3
93;14.05.2018;2018;05;00;Maanantai;3;0;3
93;14.05.2018;2018;05;01;Maanantai;0;0;0
93;14.05.2018;2018;05;02;Maanantai;1;0;1
93;14.05.2018;2018;05;03;Maanantai;0;0;0
93;14.05.2018;2018;05;04;Maanantai;0;0;0
93;14.05.2018;2018;05;05;Maanantai;8;8;16
93;14.05.2018;2018;05;06;Maanantai;27;21;48
93;14.05.2018;2018;05;07;Maanantai;45;38;83
93;14.05.2018;2018;05;08;Maanantai;27;33;60
93;14.05.2018;2018;05;09;Maanantai;23;11;34
93;14.05.2018;2018;05;10;Maanantai;19;12;31
93;14.05.2018;2018;05;11;Maanantai;15;14;29
93;14.05.2018;2018;05;12;Maanantai;35;17;52
93;14.05.2018;2018;05;13;Maanantai;25;26;51
93;14.05.2018;2018;05;14;Maanantai;36;32;68
93;14.05.2018;2018;05;15;Maanantai;38;41;79
93;14.05.2018;2018;05;16;Maanantai;40;55;95
93;14.05.2018;2018;05;17;Maanantai;44;49;93
93;14.05.2018;2018;05;18;Maanantai;14;26;40
93;14.05.2018;2018;05;19;Maanantai;23;35;58
93;14.05.2018;2018;05;20;Maanantai;20;16;36
93;14.05.2018;2018;05;21;Maanantai;21;15;36
93;14.05.2018;2018;05;22;Maanantai;4;8;12
93;14.05.2018;2018;05;23;Maanantai;1;4;5
93;15.05.2018;2018;05;00;Tiistai;0;1;1
93;15.05.2018;2018;05;01;Tiistai;0;1;1
93;15.05.2018;2018;05;02;Tiistai;1;0;1
93;15.05.2018;2018;05;03;Tiistai;0;0;0
93;15.05.2018;2018;05;04;Tiistai;1;1;2
93;15.05.2018;2018;05;05;Tiistai;6;10;16
93;15.05.2018;2018;05;06;Tiistai;31;21;52
93;15.05.2018;2018;05;07;Tiistai;67;53;120
93;15.05.2018;2018;05;08;Tiistai;25;28;53
93;15.05.2018;2018;05;09;Tiistai;17;14;31
93;15.05.2018;2018;05;10;Tiistai;13;9;22
93;15.05.2018;2018;05;11;Tiistai;15;12;27
93;15.05.2018;2018;05;12;Tiistai;16;22;38
93;15.05.2018;2018;05;13;Tiistai;20;21;41
93;15.05.2018;2018;05;14;Tiistai;32;22;54
93;15.05.2018;2018;05;15;Tiistai;34;51;85
93;15.05.2018;2018;05;16;Tiistai;62;79;141
93;15.05.2018;2018;05;17;Tiistai;24;36;60
93;15.05.2018;2018;05;18;Tiistai;37;39;76
93;15.05.2018;2018;05;19;Tiistai;38;16;54
93;15.05.2018;2018;05;20;Tiistai;17;25;42
93;15.05.2018;2018;05;21;Tiistai;13;14;27
93;15.05.2018;2018;05;22;Tiistai;9;3;12
93;15.05.2018;2018;05;23;Tiistai;0;1;1
93;16.05.2018;2018;05;00;Keskiviikko;0;0;0
93;16.05.2018;2018;05;01;Keskiviikko;1;0;1
93;16.05.2018;2018;05;02;Keskiviikko;0;0;0
93;16.05.2018;2018;05;03;Keskiviikko;0;0;0
93;16.05.2018;2018;05;04;Keskiviikko;1;1;2
93;16.05.2018;2018;05;05;Keskiviikko;5;9;14
93;16.05.2018;2018;05;06;Keskiviikko;26;16;42
93;16.05.2018;2018;05;07;Keskiviikko;52;56;108
93;16.05.2018;2018;05;08;Keskiviikko;29;27;56
93;16.05.2018;2018;05;09;Keskiviikko;13;15;28
93;16.05.2018;2018;05;10;Keskiviikko;29;13;42
93;16.05.2018;2018;05;11;Keskiviikko;22;13;35
93;16.05.2018;2018;05;12;Keskiviikko;20;21;41
93;16.05.2018;2018;05;13;Keskiviikko;18;23;41
93;16.05.2018;2018;05;14;Keskiviikko;23;26;49
93;16.05.2018;2018;05;15;Keskiviikko;51;43;94
93;16.05.2018;2018;05;16;Keskiviikko;55;79;134
93;16.05.2018;2018;05;17;Keskiviikko;48;47;95
93;16.05.2018;2018;05;18;Keskiviikko;27;60;87
93;16.05.2018;2018;05;19;Keskiviikko;31;40;71
93;16.05.2018;2018;05;20;Keskiviikko;42;32;74
93;16.05.2018;2018;05;21;Keskiviikko;20;19;39
93;16.05.2018;2018;05;22;Keskiviikko;5;3;8
93;16.05.2018;2018;05;23;Keskiviikko;1;1;2
93;17.05.2018;2018;05;00;Torstai;1;1;2
93;17.05.2018;2018;05;01;Torstai;0;0;0
93;17.05.2018;2018;05;02;Torstai;0;0;0
93;17.05.2018;2018;05;03;Torstai;0;0;0
93;17.05.2018;2018;05;04;Torstai;1;0;1
93;17.05.2018;2018;05;05;Torstai;2;10;12
93;17.05.2018;2018;05;06;Torstai;22;21;43
93;17.05.2018;2018;05;07;Torstai;50;67;117
93;17.05.2018;2018;05;08;Torstai;31;23;54
93;17.05.2018;2018;05;09;Torstai;15;11;26
93;17.05.2018;2018;05;10;Torstai;21;13;34
93;17.05.2018;2018;05;11;Torstai;4;11;15
93;17.05.2018;2018;05;12;Torstai;12;9;21
93;17.05.2018;2018;05;13;Torstai;13;15;28
93;17.05.2018;2018;05;14;Torstai;19;17;36
93;17.05.2018;2018;05;15;Torstai;29;38;67
93;17.05.2018;2018;05;16;Torstai;60;51;111
93;17.05.2018;2018;05;17;Torstai;20;21;41
93;17.05.2018;2018;05;18;Torstai;15;25;40
93;17.05.2018;2018;05;19;Torstai;18;20;38
93;17.05.2018;2018;05;20;Torstai;11;16;27
93;17.05.2018;2018;05;21;Torstai;6;10;16
93;17.05.2018;2018;05;22;Torstai;6;3;9
93;17.05.2018;2018;05;23;Torstai;0;2;2
93;18.05.2018;2018;05;00;Perjantai;0;2;2
93;18.05.2018;2018;05;01;Perjantai;0;0;0
93;18.05.2018;2018;05;02;Perjantai;0;0;0
93;18.05.2018;2018;05;03;Perjantai;0;0;0
93;18.05.2018;2018;05;04;Perjantai;1;0;1
93;18.05.2018;2018;05;05;Perjantai;3;8;11
93;18.05.2018;2018;05;06;Perjantai;17;14;31
93;18.05.2018;2018;05;07;Perjantai;29;33;62
93;18.05.2018;2018;05;08;Perjantai;13;21;34
93;18.05.2018;2018;05;09;Perjantai;8;13;21
93;18.05.2018;2018;05;10;Perjantai;13;10;23
93;18.05.2018;2018;05;11;Perjantai;7;9;16
93;18.05.2018;2018;05;12;Perjantai;15;7;22
93;18.05.2018;2018;05;13;Perjantai;10;14;24
93;18.05.2018;2018;05;14;Perjantai;24;16;40
93;18.05.2018;2018;05;15;Perjantai;24;28;52
93;18.05.2018;2018;05;16;Perjantai;35;28;63
93;18.05.2018;2018;05;17;Perjantai;19;13;32
93;18.05.2018;2018;05;18;Perjantai;11;18;29
93;18.05.2018;2018;05;19;Perjantai;8;11;19
93;18.05.2018;2018;05;20;Perjantai;5;8;13
93;18.05.2018;2018;05;21;Perjantai;6;18;24
93;18.05.2018;2018;05;22;Perjantai;6;5;11
93;18.05.2018;2018;05;23;Perjantai;5;5;10
93;19.05.2018;2018;05;00;Lauantai;0;4;4
93;19.05.2018;2018;05;01;Lauantai;0;0;0
93;19.05.2018;2018;05;02;Lauantai;4;2;6
93;19.05.2018;2018;05;03;Lauantai;4;0;4
93;19.05.2018;2018;05;04;Lauantai;1;2;3
93;19.05.2018;2018;05;05;Lauantai;0;2;2
93;19.05.2018;2018;05;06;Lauantai;2;0;2
93;19.05.2018;2018;05;07;Lauantai;4;4;8
93;19.05.2018;2018;05;08;Lauantai;6;7;13
93;19.05.2018;2018;05;09;Lauantai;9;9;18
93;19.05.2018;2018;05;10;Lauantai;16;36;52
93;19.05.2018;2018;05;11;Lauantai;22;18;40
93;19.05.2018;2018;05;12;Lauantai;30;25;55
93;19.05.2018;2018;05;13;Lauantai;20;24;44
93;19.05.2018;2018;05;14;Lauantai;45;11;56
93;19.05.2018;2018;05;15;Lauantai;15;22;37
93;19.05.2018;2018;05;16;Lauantai;14;15;29
93;19.05.2018;2018;05;17;Lauantai;21;12;33
93;19.05.2018;2018;05;18;Lauantai;18;26;44
93;19.05.2018;2018;05;19;Lauantai;20;15;35
93;19.05.2018;2018;05;20;Lauantai;11;13;24
93;19.05.2018;2018;05;21;Lauantai;5;12;17
93;19.05.2018;2018;05;22;Lauantai;6;7;13
93;19.05.2018;2018;05;23;Lauantai;1;2;3
93;20.05.2018;2018;05;00;Sunnuntai;1;1;2
93;20.05.2018;2018;05;01;Sunnuntai;0;2;2
93;20.05.2018;2018;05;02;Sunnuntai;0;0;0
93;20.05.2018;2018;05;03;Sunnuntai;0;0;0
93;20.05.2018;2018;05;04;Sunnuntai;0;0;0
93;20.05.2018;2018;05;05;Sunnuntai;5;0;5
93;20.05.2018;2018;05;06;Sunnuntai;7;1;8
93;20.05.2018;2018;05;07;Sunnuntai;3;3;6
93;20.05.2018;2018;05;08;Sunnuntai;9;5;14
93;20.05.2018;2018;05;09;Sunnuntai;15;14;29
93;20.05.2018;2018;05;10;Sunnuntai;21;14;35
93;20.05.2018;2018;05;11;Sunnuntai;16;27;43
93;20.05.2018;2018;05;12;Sunnuntai;39;15;54
93;20.05.2018;2018;05;13;Sunnuntai;20;28;48
93;20.05.2018;2018;05;14;Sunnuntai;18;33;51
93;20.05.2018;2018;05;15;Sunnuntai;28;30;58
93;20.05.2018;2018;05;16;Sunnuntai;21;27;48
93;20.05.2018;2018;05;17;Sunnuntai;11;26;37
93;20.05.2018;2018;05;18;Sunnuntai;23;33;56
93;20.05.2018;2018;05;19;Sunnuntai;21;21;42
93;20.05.2018;2018;05;20;Sunnuntai;12;9;21
93;20.05.2018;2018;05;21;Sunnuntai;8;8;16
93;20.05.2018;2018;05;22;Sunnuntai;2;5;7
93;20.05.2018;2018;05;23;Sunnuntai;0;0;0
93;21.05.2018;2018;05;00;Maanantai;0;0;0
93;21.05.2018;2018;05;01;Maanantai;0;0;0
93;21.05.2018;2018;05;02;Maanantai;0;0;0
93;21.05.2018;2018;05;03;Maanantai;0;0;0
93;21.05.2018;2018;05;04;Maanantai;1;0;1
93;21.05.2018;2018;05;05;Maanantai;11;5;16
93;21.05.2018;2018;05;06;Maanantai;25;18;43
93;21.05.2018;2018;05;07;Maanantai;45;57;102
93;21.05.2018;2018;05;08;Maanantai;28;42;70
93;21.05.2018;2018;05;09;Maanantai;14;10;24
93;21.05.2018;2018;05;10;Maanantai;12;10;22
93;21.05.2018;2018;05;11;Maanantai;17;10;27
93;21.05.2018;2018;05;12;Maanantai;18;14;32
93;21.05.2018;2018;05;13;Maanantai;20;18;38
93;21.05.2018;2018;05;14;Maanantai;31;23;54
93;21.05.2018;2018;05;15;Maanantai;37;33;70
93;21.05.2018;2018;05;16;Maanantai;48;61;109
93;21.05.2018;2018;05;17;Maanantai;46;25;71
93;21.05.2018;2018;05;18;Maanantai;31;38;69
93;21.05.2018;2018;05;19;Maanantai;31;28;59
93;21.05.2018;2018;05;20;Maanantai;13;31;44
93;21.05.2018;2018;05;21;Maanantai;10;25;35
93;21.05.2018;2018;05;22;Maanantai;12;6;18
93;21.05.2018;2018;05;23;Maanantai;0;0;0
93;22.05.2018;2018;05;00;Tiistai;2;0;2
93;22.05.2018;2018;05;01;Tiistai;0;1;1
93;22.05.2018;2018;05;02;Tiistai;1;0;1
93;22.05.2018;2018;05;03;Tiistai;0;1;1
93;22.05.2018;2018;05;04;Tiistai;1;1;2
93;22.05.2018;2018;05;05;Tiistai;10;4;14
93;22.05.2018;2018;05;06;Tiistai;34;23;57
93;22.05.2018;2018;05;07;Tiistai;53;62;115
93;22.05.2018;2018;05;08;Tiistai;33;34;67
93;22.05.2018;2018;05;09;Tiistai;18;15;33
93;22.05.2018;2018;05;10;Tiistai;31;17;48
93;22.05.2018;2018;05;11;Tiistai;22;10;32
93;22.05.2018;2018;05;12;Tiistai;26;17;43
93;22.05.2018;2018;05;13;Tiistai;30;25;55
93;22.05.2018;2018;05;14;Tiistai;25;25;50
93;22.05.2018;2018;05;15;Tiistai;49;44;93
93;22.05.2018;2018;05;16;Tiistai;64;85;149
93;22.05.2018;2018;05;17;Tiistai;32;59;91
93;22.05.2018;2018;05;18;Tiistai;20;32;52
93;22.05.2018;2018;05;19;Tiistai;31;36;67
93;22.05.2018;2018;05;20;Tiistai;30;29;59
93;22.05.2018;2018;05;21;Tiistai;12;16;28
93;22.05.2018;2018;05;22;Tiistai;8;7;15
93;22.05.2018;2018;05;23;Tiistai;3;2;5
93;23.05.2018;2018;05;00;Keskiviikko;2;0;2
93;23.05.2018;2018;05;01;Keskiviikko;0;0;0
93;23.05.2018;2018;05;02;Keskiviikko;1;0;1
93;23.05.2018;2018;05;03;Keskiviikko;0;0;0
93;23.05.2018;2018;05;04;Keskiviikko;0;0;0
93;23.05.2018;2018;05;05;Keskiviikko;4;7;11
93;23.05.2018;2018;05;06;Keskiviikko;18;18;36
93;23.05.2018;2018;05;07;Keskiviikko;49;50;99
93;23.05.2018;2018;05;08;Keskiviikko;152;21;173
93;23.05.2018;2018;05;09;Keskiviikko;14;4;18
93;23.05.2018;2018;05;10;Keskiviikko;13;127;140
93;23.05.2018;2018;05;11;Keskiviikko;12;9;21
93;23.05.2018;2018;05;12;Keskiviikko;8;12;20
93;23.05.2018;2018;05;13;Keskiviikko;9;13;22
93;23.05.2018;2018;05;14;Keskiviikko;19;18;37
93;23.05.2018;2018;05;15;Keskiviikko;22;37;59
93;23.05.2018;2018;05;16;Keskiviikko;47;41;88
93;23.05.2018;2018;05;17;Keskiviikko;20;24;44
93;23.05.2018;2018;05;18;Keskiviikko;8;13;21
93;23.05.2018;2018;05;19;Keskiviikko;10;12;22
93;23.05.2018;2018;05;20;Keskiviikko;10;16;26
93;23.05.2018;2018;05;21;Keskiviikko;18;11;29
93;23.05.2018;2018;05;22;Keskiviikko;2;0;2
93;23.05.2018;2018;05;23;Keskiviikko;2;6;8
93;24.05.2018;2018;05;00;Torstai;3;0;3
93;24.05.2018;2018;05;01;Torstai;0;0;0
93;24.05.2018;2018;05;02;Torstai;0;0;0
93;24.05.2018;2018;05;03;Torstai;1;0;1
93;24.05.2018;2018;05;04;Torstai;0;0;0
93;24.05.2018;2018;05;05;Torstai;5;4;9
93;24.05.2018;2018;05;06;Torstai;16;20;36
93;24.05.2018;2018;05;07;Torstai;40;49;89
93;24.05.2018;2018;05;08;Torstai;42;26;68
93;24.05.2018;2018;05;09;Torstai;20;8;28
93;24.05.2018;2018;05;10;Torstai;11;11;22
93;24.05.2018;2018;05;11;Torstai;14;14;28
93;24.05.2018;2018;05;12;Torstai;12;11;23
93;24.05.2018;2018;05;13;Torstai;14;11;25
93;24.05.2018;2018;05;14;Torstai;15;19;34
93;24.05.2018;2018;05;15;Torstai;35;28;63
93;24.05.2018;2018;05;16;Torstai;37;43;80
93;24.05.2018;2018;05;17;Torstai;23;29;52
93;24.05.2018;2018;05;18;Torstai;16;18;34
93;24.05.2018;2018;05;19;Torstai;18;18;36
93;24.05.2018;2018;05;20;Torstai;5;14;19
93;24.05.2018;2018;05;21;Torstai;5;9;14
93;24.05.2018;2018;05;22;Torstai;5;1;6
93;24.05.2018;2018;05;23;Torstai;0;4;4
93;25.05.2018;2018;05;00;Perjantai;0;1;1
93;25.05.2018;2018;05;01;Perjantai;0;1;1
93;25.05.2018;2018;05;02;Perjantai;0;0;0
93;25.05.2018;2018;05;03;Perjantai;1;0;1
93;25.05.2018;2018;05;04;Perjantai;0;0;0
93;25.05.2018;2018;05;05;Perjantai;3;6;9
93;25.05.2018;2018;05;06;Perjantai;22;21;43
93;25.05.2018;2018;05;07;Perjantai;30;40;70
93;25.05.2018;2018;05;08;Perjantai;23;25;48
93;25.05.2018;2018;05;09;Perjantai;12;11;23
93;25.05.2018;2018;05;10;Perjantai;16;12;28
93;25.05.2018;2018;05;11;Perjantai;10;7;17
93;25.05.2018;2018;05;12;Perjantai;13;13;26
93;25.05.2018;2018;05;13;Perjantai;21;23;44
93;25.05.2018;2018;05;14;Perjantai;37;30;67
93;25.05.2018;2018;05;15;Perjantai;39;41;80
93;25.05.2018;2018;05;16;Perjantai;47;39;86
93;25.05.2018;2018;05;17;Perjantai;24;34;58
93;25.05.2018;2018;05;18;Perjantai;22;37;59
93;25.05.2018;2018;05;19;Perjantai;22;24;46
93;25.05.2018;2018;05;20;Perjantai;10;20;30
93;25.05.2018;2018;05;21;Perjantai;7;12;19
93;25.05.2018;2018;05;22;Perjantai;0;12;12
93;25.05.2018;2018;05;23;Perjantai;2;2;4
93;26.05.2018;2018;05;00;Lauantai;3;3;6
93;26.05.2018;2018;05;01;Lauantai;1;3;4
93;26.05.2018;2018;05;02;Lauantai;0;5;5
93;26.05.2018;2018;05;03;Lauantai;0;0;0
93;26.05.2018;2018;05;04;Lauantai;0;1;1
93;26.05.2018;2018;05;05;Lauantai;4;2;6
93;26.05.2018;2018;05;06;Lauantai;2;4;6
93;26.05.2018;2018;05;07;Lauantai;5;0;5
93;26.05.2018;2018;05;08;Lauantai;12;7;19
93;26.05.2018;2018;05;09;Lauantai;22;5;27
93;26.05.2018;2018;05;10;Lauantai;9;18;27
93;26.05.2018;2018;05;11;Lauantai;11;12;23
93;26.05.2018;2018;05;12;Lauantai;25;19;44
93;26.05.2018;2018;05;13;Lauantai;28;18;46
93;26.05.2018;2018;05;14;Lauantai;17;24;41
93;26.05.2018;2018;05;15;Lauantai;7;24;31
93;26.05.2018;2018;05;16;Lauantai;14;21;35
93;26.05.2018;2018;05;17;Lauantai;20;18;38
93;26.05.2018;2018;05;18;Lauantai;15;24;39
93;26.05.2018;2018;05;19;Lauantai;6;13;19
93;26.05.2018;2018;05;20;Lauantai;6;7;13
93;26.05.2018;2018;05;21;Lauantai;3;16;19
93;26.05.2018;2018;05;22;Lauantai;5;7;12
93;26.05.2018;2018;05;23;Lauantai;2;8;10
93;27.05.2018;2018;05;00;Sunnuntai;6;5;11
93;27.05.2018;2018;05;01;Sunnuntai;4;1;5
93;27.05.2018;2018;05;02;Sunnuntai;1;1;2
93;27.05.2018;2018;05;03;Sunnuntai;0;2;2
93;27.05.2018;2018;05;04;Sunnuntai;0;0;0
93;27.05.2018;2018;05;05;Sunnuntai;0;0;0
93;27.05.2018;2018;05;06;Sunnuntai;4;1;5
93;27.05.2018;2018;05;07;Sunnuntai;3;2;5
93;27.05.2018;2018;05;08;Sunnuntai;10;8;18
93;27.05.2018;2018;05;09;Sunnuntai;14;13;27
93;27.05.2018;2018;05;10;Sunnuntai;15;21;36
93;27.05.2018;2018;05;11;Sunnuntai;27;28;55
93;27.05.2018;2018;05;12;Sunnuntai;22;16;38
93;27.05.2018;2018;05;13;Sunnuntai;15;26;41
93;27.05.2018;2018;05;14;Sunnuntai;28;24;52
93;27.05.2018;2018;05;15;Sunnuntai;19;17;36
93;27.05.2018;2018;05;16;Sunnuntai;10;19;29
93;27.05.2018;2018;05;17;Sunnuntai;16;17;33
93;27.05.2018;2018;05;18;Sunnuntai;19;28;47
93;27.05.2018;2018;05;19;Sunnuntai;38;9;47
93;27.05.2018;2018;05;20;Sunnuntai;12;18;30
93;27.05.2018;2018;05;21;Sunnuntai;5;7;12
93;27.05.2018;2018;05;22;Sunnuntai;2;6;8
93;27.05.2018;2018;05;23;Sunnuntai;1;1;2
93;28.05.2018;2018;05;00;Maanantai;0;1;1
93;28.05.2018;2018;05;01;Maanantai;0;0;0
93;28.05.2018;2018;05;02;Maanantai;0;0;0
93;28.05.2018;2018;05;03;Maanantai;0;0;0
93;28.05.2018;2018;05;04;Maanantai;0;0;0
93;28.05.2018;2018;05;05;Maanantai;6;6;12
93;28.05.2018;2018;05;06;Maanantai;27;25;52
93;28.05.2018;2018;05;07;Maanantai;36;51;87
93;28.05.2018;2018;05;08;Maanantai;22;27;49
93;28.05.2018;2018;05;09;Maanantai;14;8;22
93;28.05.2018;2018;05;10;Maanantai;8;11;19
93;28.05.2018;2018;05;11;Maanantai;14;8;22
93;28.05.2018;2018;05;12;Maanantai;20;17;37
93;28.05.2018;2018;05;13;Maanantai;14;17;31
93;28.05.2018;2018;05;14;Maanantai;32;20;52
93;28.05.2018;2018;05;15;Maanantai;42;40;82
93;28.05.2018;2018;05;16;Maanantai;58;55;113
93;28.05.2018;2018;05;17;Maanantai;22;41;63
93;28.05.2018;2018;05;18;Maanantai;24;30;54
93;28.05.2018;2018;05;19;Maanantai;12;18;30
93;28.05.2018;2018;05;20;Maanantai;20;18;38
93;28.05.2018;2018;05;21;Maanantai;12;9;21
93;28.05.2018;2018;05;22;Maanantai;5;3;8
93;28.05.2018;2018;05;23;Maanantai;1;0;1
93;29.05.2018;2018;05;00;Tiistai;1;0;1
93;29.05.2018;2018;05;01;Tiistai;0;0;0
93;29.05.2018;2018;05;02;Tiistai;0;0;0
93;29.05.2018;2018;05;03;Tiistai;1;0;1
93;29.05.2018;2018;05;04;Tiistai;1;0;1
93;29.05.2018;2018;05;05;Tiistai;7;5;12
93;29.05.2018;2018;05;06;Tiistai;34;14;48
93;29.05.2018;2018;05;07;Tiistai;34;61;95
93;29.05.2018;2018;05;08;Tiistai;23;26;49
93;29.05.2018;2018;05;09;Tiistai;16;12;28
93;29.05.2018;2018;05;10;Tiistai;14;15;29
93;29.05.2018;2018;05;11;Tiistai;10;8;18
93;29.05.2018;2018;05;12;Tiistai;18;13;31
93;29.05.2018;2018;05;13;Tiistai;17;24;41
93;29.05.2018;2018;05;14;Tiistai;25;18;43
93;29.05.2018;2018;05;15;Tiistai;38;39;77
93;29.05.2018;2018;05;16;Tiistai;54;67;121
93;29.05.2018;2018;05;17;Tiistai;27;40;67
93;29.05.2018;2018;05;18;Tiistai;18;22;40
93;29.05.2018;2018;05;19;Tiistai;27;23;50
93;29.05.2018;2018;05;20;Tiistai;14;12;26
93;29.05.2018;2018;05;21;Tiistai;14;16;30
93;29.05.2018;2018;05;22;Tiistai;6;6;12
93;29.05.2018;2018;05;23;Tiistai;1;2;3
93;30.05.2018;2018;05;00;Keskiviikko;0;1;1
93;30.05.2018;2018;05;01;Keskiviikko;1;1;2
93;30.05.2018;2018;05;02;Keskiviikko;1;0;1
93;30.05.2018;2018;05;03;Keskiviikko;0;0;0
93;30.05.2018;2018;05;04;Keskiviikko;0;1;1
93;30.05.2018;2018;05;05;Keskiviikko;8;6;14
93;30.05.2018;2018;05;06;Keskiviikko;25;18;43
93;30.05.2018;2018;05;07;Keskiviikko;30;44;74
93;30.05.2018;2018;05;08;Keskiviikko;20;22;42
93;30.05.2018;2018;05;09;Keskiviikko;152;37;189
93;30.05.2018;2018;05;10;Keskiviikko;8;6;14
93;30.05.2018;2018;05;11;Keskiviikko;7;36;43
93;30.05.2018;2018;05;12;Keskiviikko;10;148;158
93;30.05.2018;2018;05;13;Keskiviikko;19;14;33
93;30.05.2018;2018;05;14;Keskiviikko;44;16;60
93;30.05.2018;2018;05;15;Keskiviikko;24;26;50
93;30.05.2018;2018;05;16;Keskiviikko;45;39;84
93;30.05.2018;2018;05;17;Keskiviikko;25;28;53
93;30.05.2018;2018;05;18;Keskiviikko;12;26;38
93;30.05.2018;2018;05;19;Keskiviikko;9;14;23
93;30.05.2018;2018;05;20;Keskiviikko;13;16;29
93;30.05.2018;2018;05;21;Keskiviikko;9;9;18
93;30.05.2018;2018;05;22;Keskiviikko;6;4;10
93;30.05.2018;2018;05;23;Keskiviikko;1;3;4
93;31.05.2018;2018;05;00;Torstai;1;1;2
93;31.05.2018;2018;05;01;Torstai;0;0;0
93;31.05.2018;2018;05;02;Torstai;0;2;2
93;31.05.2018;2018;05;03;Torstai;1;0;1
93;31.05.2018;2018;05;04;Torstai;1;0;1
93;31.05.2018;2018;05;05;Torstai;6;4;10
93;31.05.2018;2018;05;06;Torstai;33;17;50
93;31.05.2018;2018;05;07;Torstai;35;37;72
93;31.05.2018;2018;05;08;Torstai;21;29;50
93;31.05.2018;2018;05;09;Torstai;8;9;17
93;31.05.2018;2018;05;10;Torstai;18;11;29
93;31.05.2018;2018;05;11;Torstai;11;8;19
93;31.05.2018;2018;05;12;Torstai;14;13;27
93;31.05.2018;2018;05;13;Torstai;14;22;36
93;31.05.2018;2018;05;14;Torstai;29;16;45
93;31.05.2018;2018;05;15;Torstai;32;48;80
93;31.05.2018;2018;05;16;Torstai;43;43;86
93;31.05.2018;2018;05;17;Torstai;37;41;78
93;31.05.2018;2018;05;18;Torstai;21;22;43
93;31.05.2018;2018;05;19;Torstai;15;28;43
93;31.05.2018;2018;05;20;Torstai;20;22;42
93;31.05.2018;2018;05;21;Torstai;8;10;18
93;31.05.2018;2018;05;22;Torstai;1;2;3
93;31.05.2018;2018;05;23;Torstai;0;0;0
93;01.06.2018;2018;06;00;Perjantai;1;0;1
93;01.06.2018;2018;06;01;Perjantai;1;0;1
93;01.06.2018;2018;06;02;Perjantai;0;0;0
93;01.06.2018;2018;06;03;Perjantai;1;0;1
93;01.06.2018;2018;06;04;Perjantai;0;0;0
93;01.06.2018;2018;06;05;Perjantai;9;0;9
93;01.06.2018;2018;06;06;Perjantai;43;0;43
93;01.06.2018;2018;06;07;Perjantai;70;0;70
93;01.06.2018;2018;06;08;Perjantai;48;0;48
93;01.06.2018;2018;06;09;Perjantai;23;0;23
93;01.06.2018;2018;06;10;Perjantai;28;0;28
93;01.06.2018;2018;06;11;Perjantai;17;0;17
93;01.06.2018;2018;06;12;Perjantai;26;0;26
93;01.06.2018;2018;06;13;Perjantai;44;0;44
93;01.06.2018;2018;06;14;Perjantai;67;0;67
93;01.06.2018;2018;06;15;Perjantai;80;0;80
93;01.06.2018;2018;06;16;Perjantai;86;0;86
93;01.06.2018;2018;06;17;Perjantai;58;0;58
93;01.06.2018;2018;06;18;Perjantai;59;0;59
93;01.06.2018;2018;06;19;Perjantai;46;0;46
93;01.06.2018;2018;06;20;Perjantai;30;0;30
93;01.06.2018;2018;06;21;Perjantai;19;0;19
93;01.06.2018;2018;06;22;Perjantai;12;0;12
93;01.06.2018;2018;06;23;Perjantai;4;0;4
93;02.06.2018;2018;06;00;Lauantai;3;5;8
93;02.06.2018;2018;06;01;Lauantai;3;2;5
93;02.06.2018;2018;06;02;Lauantai;0;3;3
93;02.06.2018;2018;06;03;Lauantai;0;0;0
93;02.06.2018;2018;06;04;Lauantai;0;1;1
93;02.06.2018;2018;06;05;Lauantai;0;0;0
93;02.06.2018;2018;06;06;Lauantai;4;1;5
93;02.06.2018;2018;06;07;Lauantai;5;1;6
93;02.06.2018;2018;06;08;Lauantai;7;17;24
93;02.06.2018;2018;06;09;Lauantai;14;13;27
93;02.06.2018;2018;06;10;Lauantai;21;15;36
93;02.06.2018;2018;06;11;Lauantai;18;23;41
93;02.06.2018;2018;06;12;Lauantai;34;28;62
93;02.06.2018;2018;06;13;Lauantai;34;23;57
93;02.06.2018;2018;06;14;Lauantai;26;31;57
93;02.06.2018;2018;06;15;Lauantai;21;43;64
93;02.06.2018;2018;06;16;Lauantai;18;18;36
93;02.06.2018;2018;06;17;Lauantai;17;22;39
93;02.06.2018;2018;06;18;Lauantai;22;19;41
93;02.06.2018;2018;06;19;Lauantai;15;21;36
93;02.06.2018;2018;06;20;Lauantai;8;20;28
93;02.06.2018;2018;06;21;Lauantai;15;9;24
93;02.06.2018;2018;06;22;Lauantai;8;8;16
93;02.06.2018;2018;06;23;Lauantai;2;13;15
93;03.06.2018;2018;06;00;Sunnuntai;5;4;9
93;03.06.2018;2018;06;01;Sunnuntai;3;3;6
93;03.06.2018;2018;06;02;Sunnuntai;4;5;9
93;03.06.2018;2018;06;03;Sunnuntai;0;8;8
93;03.06.2018;2018;06;04;Sunnuntai;1;6;7
93;03.06.2018;2018;06;05;Sunnuntai;0;0;0
93;03.06.2018;2018;06;06;Sunnuntai;2;2;4
93;03.06.2018;2018;06;07;Sunnuntai;1;1;2
93;03.06.2018;2018;06;08;Sunnuntai;4;6;10
93;03.06.2018;2018;06;09;Sunnuntai;10;6;16
93;03.06.2018;2018;06;10;Sunnuntai;23;26;49
93;03.06.2018;2018;06;11;Sunnuntai;32;17;49
93;03.06.2018;2018;06;12;Sunnuntai;18;17;35
93;03.06.2018;2018;06;13;Sunnuntai;32;34;66
93;03.06.2018;2018;06;14;Sunnuntai;32;31;63
93;03.06.2018;2018;06;15;Sunnuntai;26;17;43
93;03.06.2018;2018;06;16;Sunnuntai;16;31;47
93;03.06.2018;2018;06;17;Sunnuntai;13;22;35
93;03.06.2018;2018;06;18;Sunnuntai;11;23;34
93;03.06.2018;2018;06;19;Sunnuntai;8;12;20
93;03.06.2018;2018;06;20;Sunnuntai;10;9;19
93;03.06.2018;2018;06;21;Sunnuntai;4;5;9
93;03.06.2018;2018;06;22;Sunnuntai;3;1;4
93;03.06.2018;2018;06;23;Sunnuntai;1;1;2
93;04.06.2018;2018;06;00;Maanantai;1;0;1
93;04.06.2018;2018;06;01;Maanantai;1;0;1
93;04.06.2018;2018;06;02;Maanantai;2;0;2
93;04.06.2018;2018;06;03;Maanantai;0;0;0
93;04.06.2018;2018;06;04;Maanantai;0;1;1
93;04.06.2018;2018;06;05;Maanantai;6;4;10
93;04.06.2018;2018;06;06;Maanantai;11;12;23
93;04.06.2018;2018;06;07;Maanantai;10;25;35
93;04.06.2018;2018;06;08;Maanantai;9;19;28
93;04.06.2018;2018;06;09;Maanantai;4;6;10
93;04.06.2018;2018;06;10;Maanantai;5;7;12
93;04.06.2018;2018;06;11;Maanantai;5;7;12
93;04.06.2018;2018;06;12;Maanantai;5;1;6
93;04.06.2018;2018;06;13;Maanantai;8;7;15
93;04.06.2018;2018;06;14;Maanantai;5;4;9
93;04.06.2018;2018;06;15;Maanantai;20;18;38
93;04.06.2018;2018;06;16;Maanantai;31;19;50
93;04.06.2018;2018;06;17;Maanantai;9;13;22
93;04.06.2018;2018;06;18;Maanantai;4;8;12
93;04.06.2018;2018;06;19;Maanantai;6;4;10
93;04.06.2018;2018;06;20;Maanantai;2;3;5
93;04.06.2018;2018;06;21;Maanantai;0;3;3
93;04.06.2018;2018;06;22;Maanantai;3;1;4
93;04.06.2018;2018;06;23;Maanantai;3;2;5
93;05.06.2018;2018;06;00;Tiistai;0;0;0
93;05.06.2018;2018;06;01;Tiistai;0;0;0
93;05.06.2018;2018;06;02;Tiistai;0;0;0
93;05.06.2018;2018;06;03;Tiistai;0;0;0
93;05.06.2018;2018;06;04;Tiistai;0;1;1
93;05.06.2018;2018;06;05;Tiistai;2;4;6
93;05.06.2018;2018;06;06;Tiistai;10;10;20
93;05.06.2018;2018;06;07;Tiistai;12;25;37
93;05.06.2018;2018;06;08;Tiistai;15;15;30
93;05.06.2018;2018;06;09;Tiistai;7;10;17
93;05.06.2018;2018;06;10;Tiistai;9;3;12
93;05.06.2018;2018;06;11;Tiistai;7;5;12
93;05.06.2018;2018;06;12;Tiistai;1;7;8
93;05.06.2018;2018;06;13;Tiistai;5;5;10
93;05.06.2018;2018;06;14;Tiistai;20;10;30
93;05.06.2018;2018;06;15;Tiistai;21;13;34
93;05.06.2018;2018;06;16;Tiistai;26;27;53
93;05.06.2018;2018;06;17;Tiistai;13;15;28
93;05.06.2018;2018;06;18;Tiistai;9;14;23
93;05.06.2018;2018;06;19;Tiistai;8;19;27
93;05.06.2018;2018;06;20;Tiistai;11;7;18
93;05.06.2018;2018;06;21;Tiistai;4;6;10
93;05.06.2018;2018;06;22;Tiistai;4;2;6
93;05.06.2018;2018;06;23;Tiistai;1;1;2
93;06.06.2018;2018;06;00;Keskiviikko;1;2;3
93;06.06.2018;2018;06;01;Keskiviikko;0;1;1
93;06.06.2018;2018;06;02;Keskiviikko;0;0;0
93;06.06.2018;2018;06;03;Keskiviikko;1;0;1
93;06.06.2018;2018;06;04;Keskiviikko;1;0;1
93;06.06.2018;2018;06;05;Keskiviikko;5;5;10
93;06.06.2018;2018;06;06;Keskiviikko;21;14;35
93;06.06.2018;2018;06;07;Keskiviikko;15;32;47
93;06.06.2018;2018;06;08;Keskiviikko;17;30;47
93;06.06.2018;2018;06;09;Keskiviikko;13;4;17
93;06.06.2018;2018;06;10;Keskiviikko;11;11;22
93;06.06.2018;2018;06;11;Keskiviikko;8;7;15
93;06.06.2018;2018;06;12;Keskiviikko;12;5;17
93;06.06.2018;2018;06;13;Keskiviikko;7;5;12
93;06.06.2018;2018;06;14;Keskiviikko;11;12;23
93;06.06.2018;2018;06;15;Keskiviikko;24;27;51
93;06.06.2018;2018;06;16;Keskiviikko;40;38;78
93;06.06.2018;2018;06;17;Keskiviikko;26;23;49
93;06.06.2018;2018;06;18;Keskiviikko;13;43;56
93;06.06.2018;2018;06;19;Keskiviikko;28;7;35
93;06.06.2018;2018;06;20;Keskiviikko;6;16;22
93;06.06.2018;2018;06;21;Keskiviikko;5;5;10
93;06.06.2018;2018;06;22;Keskiviikko;4;3;7
93;06.06.2018;2018;06;23;Keskiviikko;2;3;5
93;07.06.2018;2018;06;00;Torstai;0;0;0
93;07.06.2018;2018;06;01;Torstai;0;1;1
93;07.06.2018;2018;06;02;Torstai;0;0;0
93;07.06.2018;2018;06;03;Torstai;0;0;0
93;07.06.2018;2018;06;04;Torstai;0;0;0
93;07.06.2018;2018;06;05;Torstai;4;4;8
93;07.06.2018;2018;06;06;Torstai;11;12;23
93;07.06.2018;2018;06;07;Torstai;12;17;29
93;07.06.2018;2018;06;08;Torstai;2;13;15
93;07.06.2018;2018;06;09;Torstai;3;3;6
93;07.06.2018;2018;06;10;Torstai;0;3;3
93;07.06.2018;2018;06;11;Torstai;2;0;2
93;07.06.2018;2018;06;12;Torstai;2;3;5
93;07.06.2018;2018;06;13;Torstai;5;3;8
93;07.06.2018;2018;06;14;Torstai;8;4;12
93;07.06.2018;2018;06;15;Torstai;13;12;25
93;07.06.2018;2018;06;16;Torstai;14;16;30
93;07.06.2018;2018;06;17;Torstai;13;10;23
93;07.06.2018;2018;06;18;Torstai;5;12;17
93;07.06.2018;2018;06;19;Torstai;10;11;21
93;07.06.2018;2018;06;20;Torstai;7;12;19
93;07.06.2018;2018;06;21;Torstai;2;5;7
93;07.06.2018;2018;06;22;Torstai;0;3;3
93;07.06.2018;2018;06;23;Torstai;1;0;1
93;08.06.2018;2018;06;00;Perjantai;0;0;0
93;08.06.2018;2018;06;01;Perjantai;0;0;0
93;08.06.2018;2018;06;02;Perjantai;0;0;0
93;08.06.2018;2018;06;03;Perjantai;0;0;0
93;08.06.2018;2018;06;04;Perjantai;1;0;1
93;08.06.2018;2018;06;05;Perjantai;4;8;12
93;08.06.2018;2018;06;06;Perjantai;15;15;30
93;08.06.2018;2018;06;07;Perjantai;19;25;44
93;08.06.2018;2018;06;08;Perjantai;13;28;41
93;08.06.2018;2018;06;09;Perjantai;10;12;22
93;08.06.2018;2018;06;10;Perjantai;7;10;17
93;08.06.2018;2018;06;11;Perjantai;15;11;26
93;08.06.2018;2018;06;12;Perjantai;14;8;22
93;08.06.2018;2018;06;13;Perjantai;13;12;25
93;08.06.2018;2018;06;14;Perjantai;29;24;53
93;08.06.2018;2018;06;15;Perjantai;36;25;61
93;08.06.2018;2018;06;16;Perjantai;35;35;70
93;08.06.2018;2018;06;17;Perjantai;15;33;48
93;08.06.2018;2018;06;18;Perjantai;16;16;32
93;08.06.2018;2018;06;19;Perjantai;13;14;27
93;08.06.2018;2018;06;20;Perjantai;10;11;21
93;08.06.2018;2018;06;21;Perjantai;2;9;11
93;08.06.2018;2018;06;22;Perjantai;8;7;15
93;08.06.2018;2018;06;23;Perjantai;2;3;5
93;09.06.2018;2018;06;00;Lauantai;1;3;4
93;09.06.2018;2018;06;01;Lauantai;2;3;5
93;09.06.2018;2018;06;02;Lauantai;1;0;1
93;09.06.2018;2018;06;03;Lauantai;0;1;1
93;09.06.2018;2018;06;04;Lauantai;1;4;5
93;09.06.2018;2018;06;05;Lauantai;0;0;0
93;09.06.2018;2018;06;06;Lauantai;2;0;2
93;09.06.2018;2018;06;07;Lauantai;0;1;1
93;09.06.2018;2018;06;08;Lauantai;6;19;25
93;09.06.2018;2018;06;09;Lauantai;15;6;21
93;09.06.2018;2018;06;10;Lauantai;9;22;31
93;09.06.2018;2018;06;11;Lauantai;15;10;25
93;09.06.2018;2018;06;12;Lauantai;22;17;39
93;09.06.2018;2018;06;13;Lauantai;5;16;21
93;09.06.2018;2018;06;14;Lauantai;15;20;35
93;09.06.2018;2018;06;15;Lauantai;11;8;19
93;09.06.2018;2018;06;16;Lauantai;11;14;25
93;09.06.2018;2018;06;17;Lauantai;8;12;20
93;09.06.2018;2018;06;18;Lauantai;16;16;32
93;09.06.2018;2018;06;19;Lauantai;9;12;21
93;09.06.2018;2018;06;20;Lauantai;8;10;18
93;09.06.2018;2018;06;21;Lauantai;14;5;19
93;09.06.2018;2018;06;22;Lauantai;2;7;9
93;09.06.2018;2018;06;23;Lauantai;3;4;7
93;10.06.2018;2018;06;00;Sunnuntai;3;6;9
93;10.06.2018;2018;06;01;Sunnuntai;1;1;2
93;10.06.2018;2018;06;02;Sunnuntai;3;1;4
93;10.06.2018;2018;06;03;Sunnuntai;0;0;0
93;10.06.2018;2018;06;04;Sunnuntai;1;0;1
93;10.06.2018;2018;06;05;Sunnuntai;3;0;3
93;10.06.2018;2018;06;06;Sunnuntai;1;0;1
93;10.06.2018;2018;06;07;Sunnuntai;3;2;5
93;10.06.2018;2018;06;08;Sunnuntai;7;4;11
93;10.06.2018;2018;06;09;Sunnuntai;6;8;14
93;10.06.2018;2018;06;10;Sunnuntai;13;11;24
93;10.06.2018;2018;06;11;Sunnuntai;18;12;30
93;10.06.2018;2018;06;12;Sunnuntai;19;31;50
93;10.06.2018;2018;06;13;Sunnuntai;25;30;55
93;10.06.2018;2018;06;14;Sunnuntai;21;21;42
93;10.06.2018;2018;06;15;Sunnuntai;23;22;45
93;10.06.2018;2018;06;16;Sunnuntai;13;22;35
93;10.06.2018;2018;06;17;Sunnuntai;17;18;35
93;10.06.2018;2018;06;18;Sunnuntai;18;30;48
93;10.06.2018;2018;06;19;Sunnuntai;26;25;51
93;10.06.2018;2018;06;20;Sunnuntai;19;16;35
93;10.06.2018;2018;06;21;Sunnuntai;6;9;15
93;10.06.2018;2018;06;22;Sunnuntai;4;3;7
93;10.06.2018;2018;06;23;Sunnuntai;0;3;3
93;11.06.2018;2018;06;00;Maanantai;1;0;1
93;11.06.2018;2018;06;01;Maanantai;0;0;0
93;11.06.2018;2018;06;02;Maanantai;3;1;4
93;11.06.2018;2018;06;03;Maanantai;0;0;0
93;11.06.2018;2018;06;04;Maanantai;1;2;3
93;11.06.2018;2018;06;05;Maanantai;6;5;11
93;11.06.2018;2018;06;06;Maanantai;25;17;42
93;11.06.2018;2018;06;07;Maanantai;34;33;67
93;11.06.2018;2018;06;08;Maanantai;26;21;47
93;11.06.2018;2018;06;09;Maanantai;16;13;29
93;11.06.2018;2018;06;10;Maanantai;22;3;25
93;11.06.2018;2018;06;11;Maanantai;11;6;17
93;11.06.2018;2018;06;12;Maanantai;12;7;19
93;11.06.2018;2018;06;13;Maanantai;14;14;28
93;11.06.2018;2018;06;14;Maanantai;21;13;34
93;11.06.2018;2018;06;15;Maanantai;19;40;59
93;11.06.2018;2018;06;16;Maanantai;43;61;104
93;11.06.2018;2018;06;17;Maanantai;27;47;74
93;11.06.2018;2018;06;18;Maanantai;18;28;46
93;11.06.2018;2018;06;19;Maanantai;15;14;29
93;11.06.2018;2018;06;20;Maanantai;20;20;40
93;11.06.2018;2018;06;21;Maanantai;12;6;18
93;11.06.2018;2018;06;22;Maanantai;5;8;13
93;11.06.2018;2018;06;23;Maanantai;1;2;3
93;12.06.2018;2018;06;00;Tiistai;1;1;2
93;12.06.2018;2018;06;01;Tiistai;0;2;2
93;12.06.2018;2018;06;02;Tiistai;0;1;1
93;12.06.2018;2018;06;03;Tiistai;0;0;0
93;12.06.2018;2018;06;04;Tiistai;2;0;2
93;12.06.2018;2018;06;05;Tiistai;8;7;15
93;12.06.2018;2018;06;06;Tiistai;28;13;41
93;12.06.2018;2018;06;07;Tiistai;34;34;68
93;12.06.2018;2018;06;08;Tiistai;21;30;51
93;12.06.2018;2018;06;09;Tiistai;7;5;12
93;12.06.2018;2018;06;10;Tiistai;15;4;19
93;12.06.2018;2018;06;11;Tiistai;6;9;15
93;12.06.2018;2018;06;12;Tiistai;14;12;26
93;12.06.2018;2018;06;13;Tiistai;14;6;20
93;12.06.2018;2018;06;14;Tiistai;22;16;38
93;12.06.2018;2018;06;15;Tiistai;21;35;56
93;12.06.2018;2018;06;16;Tiistai;29;51;80
93;12.06.2018;2018;06;17;Tiistai;23;36;59
93;12.06.2018;2018;06;18;Tiistai;12;26;38
93;12.06.2018;2018;06;19;Tiistai;15;21;36
93;12.06.2018;2018;06;20;Tiistai;11;14;25
93;12.06.2018;2018;06;21;Tiistai;8;9;17
93;12.06.2018;2018;06;22;Tiistai;2;8;10
93;12.06.2018;2018;06;23;Tiistai;0;2;2
93;13.06.2018;2018;06;00;Keskiviikko;0;4;4
93;13.06.2018;2018;06;01;Keskiviikko;1;0;1
93;13.06.2018;2018;06;02;Keskiviikko;0;0;0
93;13.06.2018;2018;06;03;Keskiviikko;1;0;1
93;13.06.2018;2018;06;04;Keskiviikko;2;0;2
93;13.06.2018;2018;06;05;Keskiviikko;5;7;12
93;13.06.2018;2018;06;06;Keskiviikko;23;13;36
93;13.06.2018;2018;06;07;Keskiviikko;28;39;67
93;13.06.2018;2018;06;08;Keskiviikko;23;30;53
93;13.06.2018;2018;06;09;Keskiviikko;14;13;27
93;13.06.2018;2018;06;10;Keskiviikko;14;1;15
93;13.06.2018;2018;06;11;Keskiviikko;17;9;26
93;13.06.2018;2018;06;12;Keskiviikko;19;14;33
93;13.06.2018;2018;06;13;Keskiviikko;13;25;38
93;13.06.2018;2018;06;14;Keskiviikko;22;8;30
93;13.06.2018;2018;06;15;Keskiviikko;34;47;81
93;13.06.2018;2018;06;16;Keskiviikko;56;48;104
93;13.06.2018;2018;06;17;Keskiviikko;23;31;54
93;13.06.2018;2018;06;18;Keskiviikko;24;20;44
93;13.06.2018;2018;06;19;Keskiviikko;19;18;37
93;13.06.2018;2018;06;20;Keskiviikko;14;20;34
93;13.06.2018;2018;06;21;Keskiviikko;8;11;19
93;13.06.2018;2018;06;22;Keskiviikko;6;3;9
93;13.06.2018;2018;06;23;Keskiviikko;1;9;10
93;14.06.2018;2018;06;00;Torstai;0;0;0
93;14.06.2018;2018;06;01;Torstai;0;0;0
93;14.06.2018;2018;06;02;Torstai;0;0;0
93;14.06.2018;2018;06;03;Torstai;0;0;0
93;14.06.2018;2018;06;04;Torstai;2;0;2
93;14.06.2018;2018;06;05;Torstai;5;8;13
93;14.06.2018;2018;06;06;Torstai;22;16;38
93;14.06.2018;2018;06;07;Torstai;44;46;90
93;14.06.2018;2018;06;08;Torstai;23;22;45
93;14.06.2018;2018;06;09;Torstai;7;17;24
93;14.06.2018;2018;06;10;Torstai;13;8;21
93;14.06.2018;2018;06;11;Torstai;18;14;32
93;14.06.2018;2018;06;12;Torstai;22;18;40
93;14.06.2018;2018;06;13;Torstai;30;22;52
93;14.06.2018;2018;06;14;Torstai;33;23;56
93;14.06.2018;2018;06;15;Torstai;26;40;66
93;14.06.2018;2018;06;16;Torstai;47;74;121
93;14.06.2018;2018;06;17;Torstai;34;49;83
93;14.06.2018;2018;06;18;Torstai;26;24;50
93;14.06.2018;2018;06;19;Torstai;19;31;50
93;14.06.2018;2018;06;20;Torstai;13;8;21
93;14.06.2018;2018;06;21;Torstai;7;7;14
93;14.06.2018;2018;06;22;Torstai;8;7;15
93;14.06.2018;2018;06;23;Torstai;0;5;5
93;15.06.2018;2018;06;00;Perjantai;3;2;5
93;15.06.2018;2018;06;01;Perjantai;0;0;0
93;15.06.2018;2018;06;02;Perjantai;0;0;0
93;15.06.2018;2018;06;03;Perjantai;2;0;2
93;15.06.2018;2018;06;04;Perjantai;2;2;4
93;15.06.2018;2018;06;05;Perjantai;8;7;15
93;15.06.2018;2018;06;06;Perjantai;21;15;36
93;15.06.2018;2018;06;07;Perjantai;23;29;52
93;15.06.2018;2018;06;08;Perjantai;14;15;29
93;15.06.2018;2018;06;09;Perjantai;22;7;29
93;15.06.2018;2018;06;10;Perjantai;11;7;18
93;15.06.2018;2018;06;11;Perjantai;5;13;18
93;15.06.2018;2018;06;12;Perjantai;14;10;24
93;15.06.2018;2018;06;13;Perjantai;20;13;33
93;15.06.2018;2018;06;14;Perjantai;19;25;44
93;15.06.2018;2018;06;15;Perjantai;36;25;61
93;15.06.2018;2018;06;16;Perjantai;33;36;69
93;15.06.2018;2018;06;17;Perjantai;23;21;44
93;15.06.2018;2018;06;18;Perjantai;7;28;35
93;15.06.2018;2018;06;19;Perjantai;14;18;32
93;15.06.2018;2018;06;20;Perjantai;15;7;22
93;15.06.2018;2018;06;21;Perjantai;10;6;16
93;15.06.2018;2018;06;22;Perjantai;5;5;10
93;15.06.2018;2018;06;23;Perjantai;7;6;13
93;16.06.2018;2018;06;00;Lauantai;1;4;5
93;16.06.2018;2018;06;01;Lauantai;5;0;5
93;16.06.2018;2018;06;02;Lauantai;0;3;3
93;16.06.2018;2018;06;03;Lauantai;0;1;1
93;16.06.2018;2018;06;04;Lauantai;0;1;1
93;16.06.2018;2018;06;05;Lauantai;1;2;3
93;16.06.2018;2018;06;06;Lauantai;3;1;4
93;16.06.2018;2018;06;07;Lauantai;4;1;5
93;16.06.2018;2018;06;08;Lauantai;8;9;17
93;16.06.2018;2018;06;09;Lauantai;19;19;38
93;16.06.2018;2018;06;10;Lauantai;14;24;38
93;16.06.2018;2018;06;11;Lauantai;22;22;44
93;16.06.2018;2018;06;12;Lauantai;26;26;52
93;16.06.2018;2018;06;13;Lauantai;27;33;60
93;16.06.2018;2018;06;14;Lauantai;31;31;62
93;16.06.2018;2018;06;15;Lauantai;37;28;65
93;16.06.2018;2018;06;16;Lauantai;16;39;55
93;16.06.2018;2018;06;17;Lauantai;27;24;51
93;16.06.2018;2018;06;18;Lauantai;25;17;42
93;16.06.2018;2018;06;19;Lauantai;17;21;38
93;16.06.2018;2018;06;20;Lauantai;4;14;18
93;16.06.2018;2018;06;21;Lauantai;12;18;30
93;16.06.2018;2018;06;22;Lauantai;2;9;11
93;16.06.2018;2018;06;23;Lauantai;6;3;9
93;17.06.2018;2018;06;00;Sunnuntai;0;12;12
93;17.06.2018;2018;06;01;Sunnuntai;3;4;7
93;17.06.2018;2018;06;02;Sunnuntai;4;4;8
93;17.06.2018;2018;06;03;Sunnuntai;1;2;3
93;17.06.2018;2018;06;04;Sunnuntai;0;2;2
93;17.06.2018;2018;06;05;Sunnuntai;1;1;2
93;17.06.2018;2018;06;06;Sunnuntai;4;2;6
93;17.06.2018;2018;06;07;Sunnuntai;4;3;7
93;17.06.2018;2018;06;08;Sunnuntai;6;4;10
93;17.06.2018;2018;06;09;Sunnuntai;14;17;31
93;17.06.2018;2018;06;10;Sunnuntai;25;27;52
93;17.06.2018;2018;06;11;Sunnuntai;44;41;85
93;17.06.2018;2018;06;12;Sunnuntai;57;33;90
93;17.06.2018;2018;06;13;Sunnuntai;48;34;82
93;17.06.2018;2018;06;14;Sunnuntai;44;46;90
93;17.06.2018;2018;06;15;Sunnuntai;43;42;85
93;17.06.2018;2018;06;16;Sunnuntai;30;33;63
93;17.06.2018;2018;06;17;Sunnuntai;31;27;58
93;17.06.2018;2018;06;18;Sunnuntai;24;37;61
93;17.06.2018;2018;06;19;Sunnuntai;29;26;55
93;17.06.2018;2018;06;20;Sunnuntai;17;30;47
93;17.06.2018;2018;06;21;Sunnuntai;9;15;24
93;17.06.2018;2018;06;22;Sunnuntai;7;2;9
93;17.06.2018;2018;06;23;Sunnuntai;1;3;4
93;18.06.2018;2018;06;00;Maanantai;1;1;2
93;18.06.2018;2018;06;01;Maanantai;1;0;1
93;18.06.2018;2018;06;02;Maanantai;0;0;0
93;18.06.2018;2018;06;03;Maanantai;1;0;1
93;18.06.2018;2018;06;04;Maanantai;1;1;2
93;18.06.2018;2018;06;05;Maanantai;6;6;12
93;18.06.2018;2018;06;06;Maanantai;15;12;27
93;18.06.2018;2018;06;07;Maanantai;24;30;54
93;18.06.2018;2018;06;08;Maanantai;20;27;47
93;18.06.2018;2018;06;09;Maanantai;8;7;15
93;18.06.2018;2018;06;10;Maanantai;8;5;13
93;18.06.2018;2018;06;11;Maanantai;3;5;8
93;18.06.2018;2018;06;12;Maanantai;8;9;17
93;18.06.2018;2018;06;13;Maanantai;6;6;12
93;18.06.2018;2018;06;14;Maanantai;20;18;38
93;18.06.2018;2018;06;15;Maanantai;29;28;57
93;18.06.2018;2018;06;16;Maanantai;37;22;59
93;18.06.2018;2018;06;17;Maanantai;16;19;35
93;18.06.2018;2018;06;18;Maanantai;15;22;37
93;18.06.2018;2018;06;19;Maanantai;12;8;20
93;18.06.2018;2018;06;20;Maanantai;12;10;22
93;18.06.2018;2018;06;21;Maanantai;5;7;12
93;18.06.2018;2018;06;22;Maanantai;2;3;5
93;18.06.2018;2018;06;23;Maanantai;0;2;2
93;19.06.2018;2018;06;00;Tiistai;2;0;2
93;19.06.2018;2018;06;01;Tiistai;1;1;2
93;19.06.2018;2018;06;02;Tiistai;0;0;0
93;19.06.2018;2018;06;03;Tiistai;0;0;0
93;19.06.2018;2018;06;04;Tiistai;1;0;1
93;19.06.2018;2018;06;05;Tiistai;4;5;9
93;19.06.2018;2018;06;06;Tiistai;13;16;29
93;19.06.2018;2018;06;07;Tiistai;23;19;42
93;19.06.2018;2018;06;08;Tiistai;12;23;35
93;19.06.2018;2018;06;09;Tiistai;5;17;22
93;19.06.2018;2018;06;10;Tiistai;10;4;14
93;19.06.2018;2018;06;11;Tiistai;6;4;10
93;19.06.2018;2018;06;12;Tiistai;3;1;4
93;19.06.2018;2018;06;13;Tiistai;4;1;5
93;19.06.2018;2018;06;14;Tiistai;9;10;19
93;19.06.2018;2018;06;15;Tiistai;16;12;28
93;19.06.2018;2018;06;16;Tiistai;25;12;37
93;19.06.2018;2018;06;17;Tiistai;12;5;17
93;19.06.2018;2018;06;18;Tiistai;8;9;17
93;19.06.2018;2018;06;19;Tiistai;3;12;15
93;19.06.2018;2018;06;20;Tiistai;3;3;6
93;19.06.2018;2018;06;21;Tiistai;1;2;3
93;19.06.2018;2018;06;22;Tiistai;3;1;4
93;19.06.2018;2018;06;23;Tiistai;0;0;0
93;20.06.2018;2018;06;00;Keskiviikko;0;0;0
93;20.06.2018;2018;06;01;Keskiviikko;0;0;0
93;20.06.2018;2018;06;02;Keskiviikko;1;0;1
93;20.06.2018;2018;06;03;Keskiviikko;0;0;0
93;20.06.2018;2018;06;04;Keskiviikko;0;1;1
93;20.06.2018;2018;06;05;Keskiviikko;4;7;11
93;20.06.2018;2018;06;06;Keskiviikko;9;15;24
93;20.06.2018;2018;06;07;Keskiviikko;20;31;51
93;20.06.2018;2018;06;08;Keskiviikko;9;16;25
93;20.06.2018;2018;06;09;Keskiviikko;4;11;15
93;20.06.2018;2018;06;10;Keskiviikko;11;11;22
93;20.06.2018;2018;06;11;Keskiviikko;11;9;20
93;20.06.2018;2018;06;12;Keskiviikko;10;4;14
93;20.06.2018;2018;06;13;Keskiviikko;22;5;27
93;20.06.2018;2018;06;14;Keskiviikko;15;15;30
93;20.06.2018;2018;06;15;Keskiviikko;19;30;49
93;20.06.2018;2018;06;16;Keskiviikko;43;26;69
93;20.06.2018;2018;06;17;Keskiviikko;21;17;38
93;20.06.2018;2018;06;18;Keskiviikko;15;13;28
93;20.06.2018;2018;06;19;Keskiviikko;10;12;22
93;20.06.2018;2018;06;20;Keskiviikko;5;18;23
93;20.06.2018;2018;06;21;Keskiviikko;6;7;13
93;20.06.2018;2018;06;22;Keskiviikko;6;11;17
93;20.06.2018;2018;06;23;Keskiviikko;2;1;3
93;21.06.2018;2018;06;00;Torstai;2;1;3
93;21.06.2018;2018;06;01;Torstai;0;2;2
93;21.06.2018;2018;06;02;Torstai;0;0;0
93;21.06.2018;2018;06;03;Torstai;0;0;0
93;21.06.2018;2018;06;04;Torstai;0;0;0
93;21.06.2018;2018;06;05;Torstai;7;7;14
93;21.06.2018;2018;06;06;Torstai;18;11;29
93;21.06.2018;2018;06;07;Torstai;20;26;46
93;21.06.2018;2018;06;08;Torstai;17;31;48
93;21.06.2018;2018;06;09;Torstai;17;14;31
93;21.06.2018;2018;06;10;Torstai;10;7;17
93;21.06.2018;2018;06;11;Torstai;14;16;30
93;21.06.2018;2018;06;12;Torstai;13;15;28
93;21.06.2018;2018;06;13;Torstai;24;15;39
93;21.06.2018;2018;06;14;Torstai;22;35;57
93;21.06.2018;2018;06;15;Torstai;45;24;69
93;21.06.2018;2018;06;16;Torstai;27;33;60
93;21.06.2018;2018;06;17;Torstai;18;11;29
93;21.06.2018;2018;06;18;Torstai;15;19;34
93;21.06.2018;2018;06;19;Torstai;16;15;31
93;21.06.2018;2018;06;20;Torstai;8;11;19
93;21.06.2018;2018;06;21;Torstai;7;11;18
93;21.06.2018;2018;06;22;Torstai;6;5;11
93;21.06.2018;2018;06;23;Torstai;3;3;6
93;22.06.2018;2018;06;00;Perjantai;5;3;8
93;22.06.2018;2018;06;01;Perjantai;0;0;0
93;22.06.2018;2018;06;02;Perjantai;0;0;0
93;22.06.2018;2018;06;03;Perjantai;0;1;1
93;22.06.2018;2018;06;04;Perjantai;0;1;1
93;22.06.2018;2018;06;05;Perjantai;0;0;0
93;22.06.2018;2018;06;06;Perjantai;0;0;0
93;22.06.2018;2018;06;07;Perjantai;3;0;3
93;22.06.2018;2018;06;08;Perjantai;1;1;2
93;22.06.2018;2018;06;09;Perjantai;0;0;0
93;22.06.2018;2018;06;10;Perjantai;1;2;3
93;22.06.2018;2018;06;11;Perjantai;1;1;2
93;22.06.2018;2018;06;12;Perjantai;1;1;2
93;22.06.2018;2018;06;13;Perjantai;3;5;8
93;22.06.2018;2018;06;14;Perjantai;2;7;9
93;22.06.2018;2018;06;15;Perjantai;0;1;1
93;22.06.2018;2018;06;16;Perjantai;3;6;9
93;22.06.2018;2018;06;17;Perjantai;2;2;4
93;22.06.2018;2018;06;18;Perjantai;2;1;3
93;22.06.2018;2018;06;19;Perjantai;1;1;2
93;22.06.2018;2018;06;20;Perjantai;1;2;3
93;22.06.2018;2018;06;21;Perjantai;3;7;10
93;22.06.2018;2018;06;22;Perjantai;1;4;5
93;22.06.2018;2018;06;23;Perjantai;8;4;12
93;23.06.2018;2018;06;00;Lauantai;1;5;6
93;23.06.2018;2018;06;01;Lauantai;1;5;6
93;23.06.2018;2018;06;02;Lauantai;0;0;0
93;23.06.2018;2018;06;03;Lauantai;0;0;0
93;23.06.2018;2018;06;04;Lauantai;4;2;6
93;23.06.2018;2018;06;05;Lauantai;0;0;0
93;23.06.2018;2018;06;06;Lauantai;1;1;2
93;23.06.2018;2018;06;07;Lauantai;0;0;0
93;23.06.2018;2018;06;08;Lauantai;5;3;8
93;23.06.2018;2018;06;09;Lauantai;2;2;4
93;23.06.2018;2018;06;10;Lauantai;2;8;10
93;23.06.2018;2018;06;11;Lauantai;3;1;4
93;23.06.2018;2018;06;12;Lauantai;2;1;3
93;23.06.2018;2018;06;13;Lauantai;6;2;8
93;23.06.2018;2018;06;14;Lauantai;2;6;8
93;23.06.2018;2018;06;15;Lauantai;12;13;25
93;23.06.2018;2018;06;16;Lauantai;6;4;10
93;23.06.2018;2018;06;17;Lauantai;6;7;13
93;23.06.2018;2018;06;18;Lauantai;9;7;16
93;23.06.2018;2018;06;19;Lauantai;9;4;13
93;23.06.2018;2018;06;20;Lauantai;7;7;14
93;23.06.2018;2018;06;21;Lauantai;2;5;7
93;23.06.2018;2018;06;22;Lauantai;5;3;8
93;23.06.2018;2018;06;23;Lauantai;0;0;0
93;24.06.2018;2018;06;00;Sunnuntai;1;2;3
93;24.06.2018;2018;06;01;Sunnuntai;2;0;2
93;24.06.2018;2018;06;02;Sunnuntai;0;0;0
93;24.06.2018;2018;06;03;Sunnuntai;0;2;2
93;24.06.2018;2018;06;04;Sunnuntai;2;1;3
93;24.06.2018;2018;06;05;Sunnuntai;0;2;2
93;24.06.2018;2018;06;06;Sunnuntai;2;3;5
93;24.06.2018;2018;06;07;Sunnuntai;3;2;5
93;24.06.2018;2018;06;08;Sunnuntai;6;7;13
93;24.06.2018;2018;06;09;Sunnuntai;13;12;25
93;24.06.2018;2018;06;10;Sunnuntai;25;20;45
93;24.06.2018;2018;06;11;Sunnuntai;30;31;61
93;24.06.2018;2018;06;12;Sunnuntai;33;42;75
93;24.06.2018;2018;06;13;Sunnuntai;35;41;76
93;24.06.2018;2018;06;14;Sunnuntai;24;47;71
93;24.06.2018;2018;06;15;Sunnuntai;33;36;69
93;24.06.2018;2018;06;16;Sunnuntai;27;33;60
93;24.06.2018;2018;06;17;Sunnuntai;36;27;63
93;24.06.2018;2018;06;18;Sunnuntai;10;21;31
93;24.06.2018;2018;06;19;Sunnuntai;19;35;54
93;24.06.2018;2018;06;20;Sunnuntai;24;16;40
93;24.06.2018;2018;06;21;Sunnuntai;11;10;21
93;24.06.2018;2018;06;22;Sunnuntai;7;6;13
93;24.06.2018;2018;06;23;Sunnuntai;1;3;4
93;25.06.2018;2018;06;00;Maanantai;1;0;1
93;25.06.2018;2018;06;01;Maanantai;0;0;0
93;25.06.2018;2018;06;02;Maanantai;1;1;2
93;25.06.2018;2018;06;03;Maanantai;0;0;0
93;25.06.2018;2018;06;04;Maanantai;1;0;1
93;25.06.2018;2018;06;05;Maanantai;5;9;14
93;25.06.2018;2018;06;06;Maanantai;27;20;47
93;25.06.2018;2018;06;07;Maanantai;33;47;80
93;25.06.2018;2018;06;08;Maanantai;23;38;61
93;25.06.2018;2018;06;09;Maanantai;18;9;27
93;25.06.2018;2018;06;10;Maanantai;21;6;27
93;25.06.2018;2018;06;11;Maanantai;20;20;40
93;25.06.2018;2018;06;12;Maanantai;24;23;47
93;25.06.2018;2018;06;13;Maanantai;29;31;60
93;25.06.2018;2018;06;14;Maanantai;40;34;74
93;25.06.2018;2018;06;15;Maanantai;43;54;97
93;25.06.2018;2018;06;16;Maanantai;50;59;109
93;25.06.2018;2018;06;17;Maanantai;49;29;78
93;25.06.2018;2018;06;18;Maanantai;32;44;76
93;25.06.2018;2018;06;19;Maanantai;32;30;62
93;25.06.2018;2018;06;20;Maanantai;26;28;54
93;25.06.2018;2018;06;21;Maanantai;5;14;19
93;25.06.2018;2018;06;22;Maanantai;4;5;9
93;25.06.2018;2018;06;23;Maanantai;0;5;5
93;26.06.2018;2018;06;00;Tiistai;3;3;6
93;26.06.2018;2018;06;01;Tiistai;1;2;3
93;26.06.2018;2018;06;02;Tiistai;0;0;0
93;26.06.2018;2018;06;03;Tiistai;1;1;2
93;26.06.2018;2018;06;04;Tiistai;2;0;2
93;26.06.2018;2018;06;05;Tiistai;4;5;9
93;26.06.2018;2018;06;06;Tiistai;25;25;50
93;26.06.2018;2018;06;07;Tiistai;38;41;79
93;26.06.2018;2018;06;08;Tiistai;17;41;58
93;26.06.2018;2018;06;09;Tiistai;14;13;27
93;26.06.2018;2018;06;10;Tiistai;12;9;21
93;26.06.2018;2018;06;11;Tiistai;25;20;45
93;26.06.2018;2018;06;12;Tiistai;16;6;22
93;26.06.2018;2018;06;13;Tiistai;15;21;36
93;26.06.2018;2018;06;14;Tiistai;24;26;50
93;26.06.2018;2018;06;15;Tiistai;46;33;79
93;26.06.2018;2018;06;16;Tiistai;56;47;103
93;26.06.2018;2018;06;17;Tiistai;27;26;53
93;26.06.2018;2018;06;18;Tiistai;23;30;53
93;26.06.2018;2018;06;19;Tiistai;31;23;54
93;26.06.2018;2018;06;20;Tiistai;14;23;37
93;26.06.2018;2018;06;21;Tiistai;2;11;13
93;26.06.2018;2018;06;22;Tiistai;6;4;10
93;26.06.2018;2018;06;23;Tiistai;4;2;6
93;27.06.2018;2018;06;00;Keskiviikko;4;0;4
93;27.06.2018;2018;06;01;Keskiviikko;1;4;5
93;27.06.2018;2018;06;02;Keskiviikko;0;1;1
93;27.06.2018;2018;06;03;Keskiviikko;1;2;3
93;27.06.2018;2018;06;04;Keskiviikko;3;0;3
93;27.06.2018;2018;06;05;Keskiviikko;1;11;12
93;27.06.2018;2018;06;06;Keskiviikko;24;18;42
93;27.06.2018;2018;06;07;Keskiviikko;40;39;79
93;27.06.2018;2018;06;08;Keskiviikko;17;31;48
93;27.06.2018;2018;06;09;Keskiviikko;8;13;21
93;27.06.2018;2018;06;10;Keskiviikko;13;6;19
93;27.06.2018;2018;06;11;Keskiviikko;20;10;30
93;27.06.2018;2018;06;12;Keskiviikko;16;24;40
93;27.06.2018;2018;06;13;Keskiviikko;20;23;43
93;27.06.2018;2018;06;14;Keskiviikko;32;22;54
93;27.06.2018;2018;06;15;Keskiviikko;45;42;87
93;27.06.2018;2018;06;16;Keskiviikko;52;50;102
93;27.06.2018;2018;06;17;Keskiviikko;36;27;63
93;27.06.2018;2018;06;18;Keskiviikko;17;26;43
93;27.06.2018;2018;06;19;Keskiviikko;17;27;44
93;27.06.2018;2018;06;20;Keskiviikko;11;20;31
93;27.06.2018;2018;06;21;Keskiviikko;9;15;24
93;27.06.2018;2018;06;22;Keskiviikko;8;9;17
93;27.06.2018;2018;06;23;Keskiviikko;1;4;5
93;28.06.2018;2018;06;00;Torstai;0;0;0
93;28.06.2018;2018;06;01;Torstai;0;1;1
93;28.06.2018;2018;06;02;Torstai;0;0;0
93;28.06.2018;2018;06;03;Torstai;0;2;2
93;28.06.2018;2018;06;04;Torstai;2;0;2
93;28.06.2018;2018;06;05;Torstai;1;5;6
93;28.06.2018;2018;06;06;Torstai;6;12;18
93;28.06.2018;2018;06;07;Torstai;20;24;44
93;28.06.2018;2018;06;08;Torstai;6;14;20
93;28.06.2018;2018;06;09;Torstai;2;1;3
93;28.06.2018;2018;06;10;Torstai;3;1;4
93;28.06.2018;2018;06;11;Torstai;0;1;1
93;28.06.2018;2018;06;12;Torstai;5;3;8
93;28.06.2018;2018;06;13;Torstai;4;1;5
93;28.06.2018;2018;06;14;Torstai;7;6;13
93;28.06.2018;2018;06;15;Torstai;17;4;21
93;28.06.2018;2018;06;16;Torstai;17;12;29
93;28.06.2018;2018;06;17;Torstai;4;9;13
93;28.06.2018;2018;06;18;Torstai;3;4;7
93;28.06.2018;2018;06;19;Torstai;3;6;9
93;28.06.2018;2018;06;20;Torstai;6;4;10
93;28.06.2018;2018;06;21;Torstai;1;5;6
93;28.06.2018;2018;06;22;Torstai;3;0;3
93;28.06.2018;2018;06;23;Torstai;0;2;2
93;29.06.2018;2018;06;00;Perjantai;0;0;0
93;29.06.2018;2018;06;01;Perjantai;0;0;0
93;29.06.2018;2018;06;02;Perjantai;1;0;1
93;29.06.2018;2018;06;03;Perjantai;2;0;2
93;29.06.2018;2018;06;04;Perjantai;2;0;2
93;29.06.2018;2018;06;05;Perjantai;6;7;13
93;29.06.2018;2018;06;06;Perjantai;11;9;20
93;29.06.2018;2018;06;07;Perjantai;16;20;36
93;29.06.2018;2018;06;08;Perjantai;25;20;45
93;29.06.2018;2018;06;09;Perjantai;8;13;21
93;29.06.2018;2018;06;10;Perjantai;3;5;8
93;29.06.2018;2018;06;11;Perjantai;17;15;32
93;29.06.2018;2018;06;12;Perjantai;13;11;24
93;29.06.2018;2018;06;13;Perjantai;8;16;24
93;29.06.2018;2018;06;14;Perjantai;16;23;39
93;29.06.2018;2018;06;15;Perjantai;21;22;43
93;29.06.2018;2018;06;16;Perjantai;20;16;36
93;29.06.2018;2018;06;17;Perjantai;18;14;32
93;29.06.2018;2018;06;18;Perjantai;15;11;26
93;29.06.2018;2018;06;19;Perjantai;10;19;29
93;29.06.2018;2018;06;20;Perjantai;9;8;17
93;29.06.2018;2018;06;21;Perjantai;4;13;17
93;29.06.2018;2018;06;22;Perjantai;3;5;8
93;29.06.2018;2018;06;23;Perjantai;4;3;7
93;30.06.2018;2018;06;00;Lauantai;0;1;1
93;30.06.2018;2018;06;01;Lauantai;1;0;1
93;30.06.2018;2018;06;02;Lauantai;0;0;0
93;30.06.2018;2018;06;03;Lauantai;0;0;0
93;30.06.2018;2018;06;04;Lauantai;0;0;0
93;30.06.2018;2018;06;05;Lauantai;2;3;5
93;30.06.2018;2018;06;06;Lauantai;2;2;4
93;30.06.2018;2018;06;07;Lauantai;1;1;2
93;30.06.2018;2018;06;08;Lauantai;3;1;4
93;30.06.2018;2018;06;09;Lauantai;7;5;12
93;30.06.2018;2018;06;10;Lauantai;9;13;22
93;30.06.2018;2018;06;11;Lauantai;15;22;37
93;30.06.2018;2018;06;12;Lauantai;13;21;34
93;30.06.2018;2018;06;13;Lauantai;17;19;36
93;30.06.2018;2018;06;14;Lauantai;20;24;44
93;30.06.2018;2018;06;15;Lauantai;12;21;33
93;30.06.2018;2018;06;16;Lauantai;20;13;33
93;30.06.2018;2018;06;17;Lauantai;13;16;29
93;30.06.2018;2018;06;18;Lauantai;10;10;20
93;30.06.2018;2018;06;19;Lauantai;15;11;26
93;30.06.2018;2018;06;20;Lauantai;6;14;20
93;30.06.2018;2018;06;21;Lauantai;11;6;17
93;30.06.2018;2018;06;22;Lauantai;5;12;17
93;30.06.2018;2018;06;23;Lauantai;3;2;5
93;01.07.2018;2018;07;00;Sunnuntai;2;4;6
93;01.07.2018;2018;07;01;Sunnuntai;2;1;3
93;01.07.2018;2018;07;02;Sunnuntai;3;0;3
93;01.07.2018;2018;07;03;Sunnuntai;1;0;1
93;01.07.2018;2018;07;04;Sunnuntai;0;2;2
93;01.07.2018;2018;07;05;Sunnuntai;0;0;0
93;01.07.2018;2018;07;06;Sunnuntai;2;2;4
93;01.07.2018;2018;07;07;Sunnuntai;4;4;8
93;01.07.2018;2018;07;08;Sunnuntai;9;11;20
93;01.07.2018;2018;07;09;Sunnuntai;14;6;20
93;01.07.2018;2018;07;10;Sunnuntai;22;15;37
93;01.07.2018;2018;07;11;Sunnuntai;38;19;57
93;01.07.2018;2018;07;12;Sunnuntai;41;25;66
93;01.07.2018;2018;07;13;Sunnuntai;30;30;60
93;01.07.2018;2018;07;14;Sunnuntai;40;44;84
93;01.07.2018;2018;07;15;Sunnuntai;33;34;67
93;01.07.2018;2018;07;16;Sunnuntai;44;41;85
93;01.07.2018;2018;07;17;Sunnuntai;24;30;54
93;01.07.2018;2018;07;18;Sunnuntai;16;23;39
93;01.07.2018;2018;07;19;Sunnuntai;17;19;36
93;01.07.2018;2018;07;20;Sunnuntai;22;19;41
93;01.07.2018;2018;07;21;Sunnuntai;15;11;26
93;01.07.2018;2018;07;22;Sunnuntai;8;8;16
93;01.07.2018;2018;07;23;Sunnuntai;2;1;3
93;02.07.2018;2018;07;00;Maanantai;0;0;0
93;02.07.2018;2018;07;01;Maanantai;2;0;2
93;02.07.2018;2018;07;02;Maanantai;0;0;0
93;02.07.2018;2018;07;03;Maanantai;0;2;2
93;02.07.2018;2018;07;04;Maanantai;0;0;0
93;02.07.2018;2018;07;05;Maanantai;2;7;9
93;02.07.2018;2018;07;06;Maanantai;27;10;37
93;02.07.2018;2018;07;07;Maanantai;29;32;61
93;02.07.2018;2018;07;08;Maanantai;20;27;47
93;02.07.2018;2018;07;09;Maanantai;16;16;32
93;02.07.2018;2018;07;10;Maanantai;12;11;23
93;02.07.2018;2018;07;11;Maanantai;21;33;54
93;02.07.2018;2018;07;12;Maanantai;22;28;50
93;02.07.2018;2018;07;13;Maanantai;30;22;52
93;02.07.2018;2018;07;14;Maanantai;43;23;66
93;02.07.2018;2018;07;15;Maanantai;33;47;80
93;02.07.2018;2018;07;16;Maanantai;46;56;102
93;02.07.2018;2018;07;17;Maanantai;40;35;75
93;02.07.2018;2018;07;18;Maanantai;23;31;54
93;02.07.2018;2018;07;19;Maanantai;31;33;64
93;02.07.2018;2018;07;20;Maanantai;24;41;65
93;02.07.2018;2018;07;21;Maanantai;12;18;30
93;02.07.2018;2018;07;22;Maanantai;8;6;14
93;02.07.2018;2018;07;23;Maanantai;2;5;7
93;03.07.2018;2018;07;00;Tiistai;1;3;4
93;03.07.2018;2018;07;01;Tiistai;0;0;0
93;03.07.2018;2018;07;02;Tiistai;1;0;1
93;03.07.2018;2018;07;03;Tiistai;0;0;0
93;03.07.2018;2018;07;04;Tiistai;0;0;0
93;03.07.2018;2018;07;05;Tiistai;4;7;11
93;03.07.2018;2018;07;06;Tiistai;31;16;47
93;03.07.2018;2018;07;07;Tiistai;25;31;56
93;03.07.2018;2018;07;08;Tiistai;16;32;48
93;03.07.2018;2018;07;09;Tiistai;13;19;32
93;03.07.2018;2018;07;10;Tiistai;26;11;37
93;03.07.2018;2018;07;11;Tiistai;18;15;33
93;03.07.2018;2018;07;12;Tiistai;25;8;33
93;03.07.2018;2018;07;13;Tiistai;19;24;43
93;03.07.2018;2018;07;14;Tiistai;33;24;57
93;03.07.2018;2018;07;15;Tiistai;32;37;69
93;03.07.2018;2018;07;16;Tiistai;49;52;101
93;03.07.2018;2018;07;17;Tiistai;27;38;65
93;03.07.2018;2018;07;18;Tiistai;22;41;63
93;03.07.2018;2018;07;19;Tiistai;36;23;59
93;03.07.2018;2018;07;20;Tiistai;19;12;31
93;03.07.2018;2018;07;21;Tiistai;11;13;24
93;03.07.2018;2018;07;22;Tiistai;3;4;7
93;03.07.2018;2018;07;23;Tiistai;0;4;4
93;04.07.2018;2018;07;00;Keskiviikko;3;0;3
93;04.07.2018;2018;07;01;Keskiviikko;1;0;1
93;04.07.2018;2018;07;02;Keskiviikko;0;0;0
93;04.07.2018;2018;07;03;Keskiviikko;0;0;0
93;04.07.2018;2018;07;04;Keskiviikko;0;0;0
93;04.07.2018;2018;07;05;Keskiviikko;0;8;8
93;04.07.2018;2018;07;06;Keskiviikko;7;9;16
93;04.07.2018;2018;07;07;Keskiviikko;5;5;10
93;04.07.2018;2018;07;08;Keskiviikko;4;8;12
93;04.07.2018;2018;07;09;Keskiviikko;3;3;6
93;04.07.2018;2018;07;10;Keskiviikko;2;6;8
93;04.07.2018;2018;07;11;Keskiviikko;2;1;3
93;04.07.2018;2018;07;12;Keskiviikko;2;2;4
93;04.07.2018;2018;07;13;Keskiviikko;6;3;9
93;04.07.2018;2018;07;14;Keskiviikko;8;3;11
93;04.07.2018;2018;07;15;Keskiviikko;12;11;23
93;04.07.2018;2018;07;16;Keskiviikko;19;12;31
93;04.07.2018;2018;07;17;Keskiviikko;19;29;48
93;04.07.2018;2018;07;18;Keskiviikko;20;33;53
93;04.07.2018;2018;07;19;Keskiviikko;28;29;57
93;04.07.2018;2018;07;20;Keskiviikko;32;26;58
93;04.07.2018;2018;07;21;Keskiviikko;16;14;30
93;04.07.2018;2018;07;22;Keskiviikko;3;17;20
93;04.07.2018;2018;07;23;Keskiviikko;3;4;7
93;05.07.2018;2018;07;00;Torstai;1;3;4
93;05.07.2018;2018;07;01;Torstai;1;0;1
93;05.07.2018;2018;07;02;Torstai;3;2;5
93;05.07.2018;2018;07;03;Torstai;2;0;2
93;05.07.2018;2018;07;04;Torstai;0;1;1
93;05.07.2018;2018;07;05;Torstai;5;5;10
93;05.07.2018;2018;07;06;Torstai;27;12;39
93;05.07.2018;2018;07;07;Torstai;28;33;61
93;05.07.2018;2018;07;08;Torstai;15;27;42
93;05.07.2018;2018;07;09;Torstai;12;15;27
93;05.07.2018;2018;07;10;Torstai;24;7;31
93;05.07.2018;2018;07;11;Torstai;18;26;44
93;05.07.2018;2018;07;12;Torstai;17;25;42
93;05.07.2018;2018;07;13;Torstai;31;27;58
93;05.07.2018;2018;07;14;Torstai;26;25;51
93;05.07.2018;2018;07;15;Torstai;25;31;56
93;05.07.2018;2018;07;16;Torstai;32;41;73
93;05.07.2018;2018;07;17;Torstai;16;19;35
93;05.07.2018;2018;07;18;Torstai;9;16;25
93;05.07.2018;2018;07;19;Torstai;10;14;24
93;05.07.2018;2018;07;20;Torstai;6;8;14
93;05.07.2018;2018;07;21;Torstai;1;14;15
93;05.07.2018;2018;07;22;Torstai;6;4;10
93;05.07.2018;2018;07;23;Torstai;1;0;1
93;06.07.2018;2018;07;00;Perjantai;2;0;2
93;06.07.2018;2018;07;01;Perjantai;1;1;2
93;06.07.2018;2018;07;02;Perjantai;0;1;1
93;06.07.2018;2018;07;03;Perjantai;0;0;0
93;06.07.2018;2018;07;04;Perjantai;0;1;1
93;06.07.2018;2018;07;05;Perjantai;8;8;16
93;06.07.2018;2018;07;06;Perjantai;26;8;34
93;06.07.2018;2018;07;07;Perjantai;20;33;53
93;06.07.2018;2018;07;08;Perjantai;13;24;37
93;06.07.2018;2018;07;09;Perjantai;16;12;28
93;06.07.2018;2018;07;10;Perjantai;11;16;27
93;06.07.2018;2018;07;11;Perjantai;21;14;35
93;06.07.2018;2018;07;12;Perjantai;18;23;41
93;06.07.2018;2018;07;13;Perjantai;22;21;43
93;06.07.2018;2018;07;14;Perjantai;45;37;82
93;06.07.2018;2018;07;15;Perjantai;32;39;71
93;06.07.2018;2018;07;16;Perjantai;38;45;83
93;06.07.2018;2018;07;17;Perjantai;28;24;52
93;06.07.2018;2018;07;18;Perjantai;20;41;61
93;06.07.2018;2018;07;19;Perjantai;25;33;58
93;06.07.2018;2018;07;20;Perjantai;18;22;40
93;06.07.2018;2018;07;21;Perjantai;8;10;18
93;06.07.2018;2018;07;22;Perjantai;3;9;12
93;06.07.2018;2018;07;23;Perjantai;6;8;14
93;07.07.2018;2018;07;00;Lauantai;4;3;7
93;07.07.2018;2018;07;01;Lauantai;1;8;9
93;07.07.2018;2018;07;02;Lauantai;0;5;5
93;07.07.2018;2018;07;03;Lauantai;0;1;1
93;07.07.2018;2018;07;04;Lauantai;2;0;2
93;07.07.2018;2018;07;05;Lauantai;4;1;5
93;07.07.2018;2018;07;06;Lauantai;2;1;3
93;07.07.2018;2018;07;07;Lauantai;9;1;10
93;07.07.2018;2018;07;08;Lauantai;4;12;16
93;07.07.2018;2018;07;09;Lauantai;9;9;18
93;07.07.2018;2018;07;10;Lauantai;28;12;40
93;07.07.2018;2018;07;11;Lauantai;35;18;53
93;07.07.2018;2018;07;12;Lauantai;32;32;64
93;07.07.2018;2018;07;13;Lauantai;30;40;70
93;07.07.2018;2018;07;14;Lauantai;28;31;59
93;07.07.2018;2018;07;15;Lauantai;24;35;59
93;07.07.2018;2018;07;16;Lauantai;17;19;36
93;07.07.2018;2018;07;17;Lauantai;20;31;51
93;07.07.2018;2018;07;18;Lauantai;19;21;40
93;07.07.2018;2018;07;19;Lauantai;17;28;45
93;07.07.2018;2018;07;20;Lauantai;17;23;40
93;07.07.2018;2018;07;21;Lauantai;7;9;16
93;07.07.2018;2018;07;22;Lauantai;3;8;11
93;07.07.2018;2018;07;23;Lauantai;6;11;17
93;08.07.2018;2018;07;00;Sunnuntai;3;5;8
93;08.07.2018;2018;07;01;Sunnuntai;0;1;1
93;08.07.2018;2018;07;02;Sunnuntai;0;3;3
93;08.07.2018;2018;07;03;Sunnuntai;1;2;3
93;08.07.2018;2018;07;04;Sunnuntai;0;1;1
93;08.07.2018;2018;07;05;Sunnuntai;0;1;1
93;08.07.2018;2018;07;06;Sunnuntai;2;1;3
93;08.07.2018;2018;07;07;Sunnuntai;2;2;4
93;08.07.2018;2018;07;08;Sunnuntai;4;5;9
93;08.07.2018;2018;07;09;Sunnuntai;11;7;18
93;08.07.2018;2018;07;10;Sunnuntai;21;20;41
93;08.07.2018;2018;07;11;Sunnuntai;15;19;34
93;08.07.2018;2018;07;12;Sunnuntai;50;26;76
93;08.07.2018;2018;07;13;Sunnuntai;39;26;65
93;08.07.2018;2018;07;14;Sunnuntai;44;36;80
93;08.07.2018;2018;07;15;Sunnuntai;29;31;60
93;08.07.2018;2018;07;16;Sunnuntai;21;58;79
93;08.07.2018;2018;07;17;Sunnuntai;29;41;70
93;08.07.2018;2018;07;18;Sunnuntai;36;28;64
93;08.07.2018;2018;07;19;Sunnuntai;30;32;62
93;08.07.2018;2018;07;20;Sunnuntai;22;29;51
93;08.07.2018;2018;07;21;Sunnuntai;18;12;30
93;08.07.2018;2018;07;22;Sunnuntai;9;1;10
93;08.07.2018;2018;07;23;Sunnuntai;4;5;9
93;09.07.2018;2018;07;00;Maanantai;5;4;9
93;09.07.2018;2018;07;01;Maanantai;1;0;1
93;09.07.2018;2018;07;02;Maanantai;0;0;0
93;09.07.2018;2018;07;03;Maanantai;0;0;0
93;09.07.2018;2018;07;04;Maanantai;2;0;2
93;09.07.2018;2018;07;05;Maanantai;9;7;16
93;09.07.2018;2018;07;06;Maanantai;23;10;33
93;09.07.2018;2018;07;07;Maanantai;24;27;51
93;09.07.2018;2018;07;08;Maanantai;27;25;52
93;09.07.2018;2018;07;09;Maanantai;20;7;27
93;09.07.2018;2018;07;10;Maanantai;23;18;41
93;09.07.2018;2018;07;11;Maanantai;28;33;61
93;09.07.2018;2018;07;12;Maanantai;30;26;56
93;09.07.2018;2018;07;13;Maanantai;40;31;71
93;09.07.2018;2018;07;14;Maanantai;31;40;71
93;09.07.2018;2018;07;15;Maanantai;40;52;92
93;09.07.2018;2018;07;16;Maanantai;46;51;97
93;09.07.2018;2018;07;17;Maanantai;26;50;76
93;09.07.2018;2018;07;18;Maanantai;36;39;75
93;09.07.2018;2018;07;19;Maanantai;25;55;80
93;09.07.2018;2018;07;20;Maanantai;27;36;63
93;09.07.2018;2018;07;21;Maanantai;10;17;27
93;09.07.2018;2018;07;22;Maanantai;6;9;15
93;09.07.2018;2018;07;23;Maanantai;7;3;10
93;10.07.2018;2018;07;00;Tiistai;2;4;6
93;10.07.2018;2018;07;01;Tiistai;0;0;0
93;10.07.2018;2018;07;02;Tiistai;0;1;1
93;10.07.2018;2018;07;03;Tiistai;0;0;0
93;10.07.2018;2018;07;04;Tiistai;1;1;2
93;10.07.2018;2018;07;05;Tiistai;8;4;12
93;10.07.2018;2018;07;06;Tiistai;28;14;42
93;10.07.2018;2018;07;07;Tiistai;29;37;66
93;10.07.2018;2018;07;08;Tiistai;21;25;46
93;10.07.2018;2018;07;09;Tiistai;21;24;45
93;10.07.2018;2018;07;10;Tiistai;19;23;42
93;10.07.2018;2018;07;11;Tiistai;39;27;66
93;10.07.2018;2018;07;12;Tiistai;26;36;62
93;10.07.2018;2018;07;13;Tiistai;28;39;67
93;10.07.2018;2018;07;14;Tiistai;36;42;78
93;10.07.2018;2018;07;15;Tiistai;48;47;95
93;10.07.2018;2018;07;16;Tiistai;57;61;118
93;10.07.2018;2018;07;17;Tiistai;49;48;97
93;10.07.2018;2018;07;18;Tiistai;35;36;71
93;10.07.2018;2018;07;19;Tiistai;34;37;71
93;10.07.2018;2018;07;20;Tiistai;23;35;58
93;10.07.2018;2018;07;21;Tiistai;11;33;44
93;10.07.2018;2018;07;22;Tiistai;9;5;14
93;10.07.2018;2018;07;23;Tiistai;3;4;7
93;11.07.2018;2018;07;00;Keskiviikko;4;8;12
93;11.07.2018;2018;07;01;Keskiviikko;1;4;5
93;11.07.2018;2018;07;02;Keskiviikko;2;1;3
93;11.07.2018;2018;07;03;Keskiviikko;2;1;3
93;11.07.2018;2018;07;04;Keskiviikko;0;2;2
93;11.07.2018;2018;07;05;Keskiviikko;1;6;7
93;11.07.2018;2018;07;06;Keskiviikko;23;15;38
93;11.07.2018;2018;07;07;Keskiviikko;25;33;58
93;11.07.2018;2018;07;08;Keskiviikko;24;24;48
93;11.07.2018;2018;07;09;Keskiviikko;20;13;33
93;11.07.2018;2018;07;10;Keskiviikko;33;19;52
93;11.07.2018;2018;07;11;Keskiviikko;29;25;54
93;11.07.2018;2018;07;12;Keskiviikko;27;31;58
93;11.07.2018;2018;07;13;Keskiviikko;37;35;72
93;11.07.2018;2018;07;14;Keskiviikko;38;25;63
93;11.07.2018;2018;07;15;Keskiviikko;41;55;96
93;11.07.2018;2018;07;16;Keskiviikko;43;47;90
93;11.07.2018;2018;07;17;Keskiviikko;43;57;100
93;11.07.2018;2018;07;18;Keskiviikko;32;41;73
93;11.07.2018;2018;07;19;Keskiviikko;34;36;70
93;11.07.2018;2018;07;20;Keskiviikko;38;27;65
93;11.07.2018;2018;07;21;Keskiviikko;11;18;29
93;11.07.2018;2018;07;22;Keskiviikko;12;15;27
93;11.07.2018;2018;07;23;Keskiviikko;2;4;6
93;12.07.2018;2018;07;00;Torstai;3;6;9
93;12.07.2018;2018;07;01;Torstai;0;3;3
93;12.07.2018;2018;07;02;Torstai;0;1;1
93;12.07.2018;2018;07;03;Torstai;0;0;0
93;12.07.2018;2018;07;04;Torstai;1;1;2
93;12.07.2018;2018;07;05;Torstai;3;6;9
93;12.07.2018;2018;07;06;Torstai;22;12;34
93;12.07.2018;2018;07;07;Torstai;16;35;51
93;12.07.2018;2018;07;08;Torstai;28;26;54
93;12.07.2018;2018;07;09;Torstai;8;13;21
93;12.07.2018;2018;07;10;Torstai;35;17;52
93;12.07.2018;2018;07;11;Torstai;23;22;45
93;12.07.2018;2018;07;12;Torstai;30;18;48
93;12.07.2018;2018;07;13;Torstai;35;34;69
93;12.07.2018;2018;07;14;Torstai;44;35;79
93;12.07.2018;2018;07;15;Torstai;42;36;78
93;12.07.2018;2018;07;16;Torstai;45;55;100
93;12.07.2018;2018;07;17;Torstai;34;43;77
93;12.07.2018;2018;07;18;Torstai;24;41;65
93;12.07.2018;2018;07;19;Torstai;42;38;80
93;12.07.2018;2018;07;20;Torstai;22;29;51
93;12.07.2018;2018;07;21;Torstai;14;20;34
93;12.07.2018;2018;07;22;Torstai;10;15;25
93;12.07.2018;2018;07;23;Torstai;2;5;7
93;13.07.2018;2018;07;00;Perjantai;6;7;13
93;13.07.2018;2018;07;01;Perjantai;0;6;6
93;13.07.2018;2018;07;02;Perjantai;0;3;3
93;13.07.2018;2018;07;03;Perjantai;0;1;1
93;13.07.2018;2018;07;04;Perjantai;2;0;2
93;13.07.2018;2018;07;05;Perjantai;5;6;11
93;13.07.2018;2018;07;06;Perjantai;16;7;23
93;13.07.2018;2018;07;07;Perjantai;20;26;46
93;13.07.2018;2018;07;08;Perjantai;14;21;35
93;13.07.2018;2018;07;09;Perjantai;10;23;33
93;13.07.2018;2018;07;10;Perjantai;22;15;37
93;13.07.2018;2018;07;11;Perjantai;21;17;38
93;13.07.2018;2018;07;12;Perjantai;35;41;76
93;13.07.2018;2018;07;13;Perjantai;23;31;54
93;13.07.2018;2018;07;14;Perjantai;46;27;73
93;13.07.2018;2018;07;15;Perjantai;43;47;90
93;13.07.2018;2018;07;16;Perjantai;39;38;77
93;13.07.2018;2018;07;17;Perjantai;44;36;80
93;13.07.2018;2018;07;18;Perjantai;21;16;37
93;13.07.2018;2018;07;19;Perjantai;33;44;77
93;13.07.2018;2018;07;20;Perjantai;35;29;64
93;13.07.2018;2018;07;21;Perjantai;16;15;31
93;13.07.2018;2018;07;22;Perjantai;5;19;24
93;13.07.2018;2018;07;23;Perjantai;5;8;13
93;14.07.2018;2018;07;00;Lauantai;3;9;12
93;14.07.2018;2018;07;01;Lauantai;1;4;5
93;14.07.2018;2018;07;02;Lauantai;0;9;9
93;14.07.2018;2018;07;03;Lauantai;0;7;7
93;14.07.2018;2018;07;04;Lauantai;1;6;7
93;14.07.2018;2018;07;05;Lauantai;3;2;5
93;14.07.2018;2018;07;06;Lauantai;2;1;3
93;14.07.2018;2018;07;07;Lauantai;2;1;3
93;14.07.2018;2018;07;08;Lauantai;3;7;10
93;14.07.2018;2018;07;09;Lauantai;12;10;22
93;14.07.2018;2018;07;10;Lauantai;17;27;44
93;14.07.2018;2018;07;11;Lauantai;18;16;34
93;14.07.2018;2018;07;12;Lauantai;16;15;31
93;14.07.2018;2018;07;13;Lauantai;30;34;64
93;14.07.2018;2018;07;14;Lauantai;17;14;31
93;14.07.2018;2018;07;15;Lauantai;37;14;51
93;14.07.2018;2018;07;16;Lauantai;19;24;43
93;14.07.2018;2018;07;17;Lauantai;16;16;32
93;14.07.2018;2018;07;18;Lauantai;34;22;56
93;14.07.2018;2018;07;19;Lauantai;53;15;68
93;14.07.2018;2018;07;20;Lauantai;11;20;31
93;14.07.2018;2018;07;21;Lauantai;9;13;22
93;14.07.2018;2018;07;22;Lauantai;13;9;22
93;14.07.2018;2018;07;23;Lauantai;3;8;11
93;15.07.2018;2018;07;00;Sunnuntai;9;8;17
93;15.07.2018;2018;07;01;Sunnuntai;0;6;6
93;15.07.2018;2018;07;02;Sunnuntai;0;2;2
93;15.07.2018;2018;07;03;Sunnuntai;3;8;11
93;15.07.2018;2018;07;04;Sunnuntai;0;5;5
93;15.07.2018;2018;07;05;Sunnuntai;3;3;6
93;15.07.2018;2018;07;06;Sunnuntai;1;5;6
93;15.07.2018;2018;07;07;Sunnuntai;3;5;8
93;15.07.2018;2018;07;08;Sunnuntai;10;6;16
93;15.07.2018;2018;07;09;Sunnuntai;11;11;22
93;15.07.2018;2018;07;10;Sunnuntai;24;22;46
93;15.07.2018;2018;07;11;Sunnuntai;37;23;60
93;15.07.2018;2018;07;12;Sunnuntai;49;52;101
93;15.07.2018;2018;07;13;Sunnuntai;38;54;92
93;15.07.2018;2018;07;14;Sunnuntai;50;33;83
93;15.07.2018;2018;07;15;Sunnuntai;19;48;67
93;15.07.2018;2018;07;16;Sunnuntai;36;31;67
93;15.07.2018;2018;07;17;Sunnuntai;38;47;85
93;15.07.2018;2018;07;18;Sunnuntai;15;35;50
93;15.07.2018;2018;07;19;Sunnuntai;24;41;65
93;15.07.2018;2018;07;20;Sunnuntai;33;25;58
93;15.07.2018;2018;07;21;Sunnuntai;21;19;40
93;15.07.2018;2018;07;22;Sunnuntai;6;6;12
93;15.07.2018;2018;07;23;Sunnuntai;1;4;5
93;16.07.2018;2018;07;00;Maanantai;3;4;7
93;16.07.2018;2018;07;01;Maanantai;4;3;7
93;16.07.2018;2018;07;02;Maanantai;0;0;0
93;16.07.2018;2018;07;03;Maanantai;0;1;1
93;16.07.2018;2018;07;04;Maanantai;0;0;0
93;16.07.2018;2018;07;05;Maanantai;10;9;19
93;16.07.2018;2018;07;06;Maanantai;23;10;33
93;16.07.2018;2018;07;07;Maanantai;34;27;61
93;16.07.2018;2018;07;08;Maanantai;22;29;51
93;16.07.2018;2018;07;09;Maanantai;28;14;42
93;16.07.2018;2018;07;10;Maanantai;28;29;57
93;16.07.2018;2018;07;11;Maanantai;25;21;46
93;16.07.2018;2018;07;12;Maanantai;34;20;54
93;16.07.2018;2018;07;13;Maanantai;30;35;65
93;16.07.2018;2018;07;14;Maanantai;17;47;64
93;16.07.2018;2018;07;15;Maanantai;36;50;86
93;16.07.2018;2018;07;16;Maanantai;46;48;94
93;16.07.2018;2018;07;17;Maanantai;38;44;82
93;16.07.2018;2018;07;18;Maanantai;39;36;75
93;16.07.2018;2018;07;19;Maanantai;35;37;72
93;16.07.2018;2018;07;20;Maanantai;27;32;59
93;16.07.2018;2018;07;21;Maanantai;12;29;41
93;16.07.2018;2018;07;22;Maanantai;6;10;16
93;16.07.2018;2018;07;23;Maanantai;2;12;14
93;17.07.2018;2018;07;00;Tiistai;4;1;5
93;17.07.2018;2018;07;01;Tiistai;0;0;0
93;17.07.2018;2018;07;02;Tiistai;0;2;2
93;17.07.2018;2018;07;03;Tiistai;0;2;2
93;17.07.2018;2018;07;04;Tiistai;2;0;2
93;17.07.2018;2018;07;05;Tiistai;5;4;9
93;17.07.2018;2018;07;06;Tiistai;25;15;40
93;17.07.2018;2018;07;07;Tiistai;28;45;73
93;17.07.2018;2018;07;08;Tiistai;25;29;54
93;17.07.2018;2018;07;09;Tiistai;26;28;54
93;17.07.2018;2018;07;10;Tiistai;25;21;46
93;17.07.2018;2018;07;11;Tiistai;17;28;45
93;17.07.2018;2018;07;12;Tiistai;32;26;58
93;17.07.2018;2018;07;13;Tiistai;34;21;55
93;17.07.2018;2018;07;14;Tiistai;29;37;66
93;17.07.2018;2018;07;15;Tiistai;55;46;101
93;17.07.2018;2018;07;16;Tiistai;71;50;121
93;17.07.2018;2018;07;17;Tiistai;34;38;72
93;17.07.2018;2018;07;18;Tiistai;33;21;54
93;17.07.2018;2018;07;19;Tiistai;38;37;75
93;17.07.2018;2018;07;20;Tiistai;24;31;55
93;17.07.2018;2018;07;21;Tiistai;14;26;40
93;17.07.2018;2018;07;22;Tiistai;14;13;27
93;17.07.2018;2018;07;23;Tiistai;2;12;14
93;18.07.2018;2018;07;00;Keskiviikko;4;8;12
93;18.07.2018;2018;07;01;Keskiviikko;3;3;6
93;18.07.2018;2018;07;02;Keskiviikko;0;5;5
93;18.07.2018;2018;07;03;Keskiviikko;2;4;6
93;18.07.2018;2018;07;04;Keskiviikko;1;0;1
93;18.07.2018;2018;07;05;Keskiviikko;6;8;14
93;18.07.2018;2018;07;06;Keskiviikko;29;13;42
93;18.07.2018;2018;07;07;Keskiviikko;28;33;61
93;18.07.2018;2018;07;08;Keskiviikko;19;18;37
93;18.07.2018;2018;07;09;Keskiviikko;16;16;32
93;18.07.2018;2018;07;10;Keskiviikko;21;19;40
93;18.07.2018;2018;07;11;Keskiviikko;22;20;42
93;18.07.2018;2018;07;12;Keskiviikko;25;18;43
93;18.07.2018;2018;07;13;Keskiviikko;12;20;32
93;18.07.2018;2018;07;14;Keskiviikko;31;25;56
93;18.07.2018;2018;07;15;Keskiviikko;31;44;75
93;18.07.2018;2018;07;16;Keskiviikko;48;41;89
93;18.07.2018;2018;07;17;Keskiviikko;22;42;64
93;18.07.2018;2018;07;18;Keskiviikko;31;27;58
93;18.07.2018;2018;07;19;Keskiviikko;18;28;46
93;18.07.2018;2018;07;20;Keskiviikko;32;27;59
93;18.07.2018;2018;07;21;Keskiviikko;23;39;62
93;18.07.2018;2018;07;22;Keskiviikko;7;11;18
93;18.07.2018;2018;07;23;Keskiviikko;7;6;13
93;19.07.2018;2018;07;00;Torstai;8;4;12
93;19.07.2018;2018;07;01;Torstai;4;0;4
93;19.07.2018;2018;07;02;Torstai;0;0;0
93;19.07.2018;2018;07;03;Torstai;0;2;2
93;19.07.2018;2018;07;04;Torstai;0;0;0
93;19.07.2018;2018;07;05;Torstai;8;7;15
93;19.07.2018;2018;07;06;Torstai;26;10;36
93;19.07.2018;2018;07;07;Torstai;19;30;49
93;19.07.2018;2018;07;08;Torstai;17;26;43
93;19.07.2018;2018;07;09;Torstai;17;16;33
93;19.07.2018;2018;07;10;Torstai;25;12;37
93;19.07.2018;2018;07;11;Torstai;30;27;57
93;19.07.2018;2018;07;12;Torstai;27;13;40
93;19.07.2018;2018;07;13;Torstai;17;15;32
93;19.07.2018;2018;07;14;Torstai;23;22;45
93;19.07.2018;2018;07;15;Torstai;43;33;76
93;19.07.2018;2018;07;16;Torstai;51;43;94
93;19.07.2018;2018;07;17;Torstai;40;38;78
93;19.07.2018;2018;07;18;Torstai;15;35;50
93;19.07.2018;2018;07;19;Torstai;27;27;54
93;19.07.2018;2018;07;20;Torstai;21;28;49
93;19.07.2018;2018;07;21;Torstai;20;37;57
93;19.07.2018;2018;07;22;Torstai;11;12;23
93;19.07.2018;2018;07;23;Torstai;11;5;16
93;20.07.2018;2018;07;00;Perjantai;2;1;3
93;20.07.2018;2018;07;01;Perjantai;1;2;3
93;20.07.2018;2018;07;02;Perjantai;0;1;1
93;20.07.2018;2018;07;03;Perjantai;0;3;3
93;20.07.2018;2018;07;04;Perjantai;1;3;4
93;20.07.2018;2018;07;05;Perjantai;3;5;8
93;20.07.2018;2018;07;06;Perjantai;23;11;34
93;20.07.2018;2018;07;07;Perjantai;20;22;42
93;20.07.2018;2018;07;08;Perjantai;20;22;42
93;20.07.2018;2018;07;09;Perjantai;16;17;33
93;20.07.2018;2018;07;10;Perjantai;22;18;40
93;20.07.2018;2018;07;11;Perjantai;21;23;44
93;20.07.2018;2018;07;12;Perjantai;26;9;35
93;20.07.2018;2018;07;13;Perjantai;15;22;37
93;20.07.2018;2018;07;14;Perjantai;29;21;50
93;20.07.2018;2018;07;15;Perjantai;31;32;63
93;20.07.2018;2018;07;16;Perjantai;44;36;80
93;20.07.2018;2018;07;17;Perjantai;35;28;63
93;20.07.2018;2018;07;18;Perjantai;16;31;47
93;20.07.2018;2018;07;19;Perjantai;21;27;48
93;20.07.2018;2018;07;20;Perjantai;22;21;43
93;20.07.2018;2018;07;21;Perjantai;7;29;36
93;20.07.2018;2018;07;22;Perjantai;6;20;26
93;20.07.2018;2018;07;23;Perjantai;6;9;15
93;21.07.2018;2018;07;00;Lauantai;3;3;6
93;21.07.2018;2018;07;01;Lauantai;2;6;8
93;21.07.2018;2018;07;02;Lauantai;3;1;4
93;21.07.2018;2018;07;03;Lauantai;5;2;7
93;21.07.2018;2018;07;04;Lauantai;1;3;4
93;21.07.2018;2018;07;05;Lauantai;3;3;6
93;21.07.2018;2018;07;06;Lauantai;4;5;9
93;21.07.2018;2018;07;07;Lauantai;3;3;6
93;21.07.2018;2018;07;08;Lauantai;14;8;22
93;21.07.2018;2018;07;09;Lauantai;10;10;20
93;21.07.2018;2018;07;10;Lauantai;8;8;16
93;21.07.2018;2018;07;11;Lauantai;16;15;31
93;21.07.2018;2018;07;12;Lauantai;12;12;24
93;21.07.2018;2018;07;13;Lauantai;11;11;22
93;21.07.2018;2018;07;14;Lauantai;9;12;21
93;21.07.2018;2018;07;15;Lauantai;10;17;27
93;21.07.2018;2018;07;16;Lauantai;15;13;28
93;21.07.2018;2018;07;17;Lauantai;14;16;30
93;21.07.2018;2018;07;18;Lauantai;17;12;29
93;21.07.2018;2018;07;19;Lauantai;23;9;32
93;21.07.2018;2018;07;20;Lauantai;6;15;21
93;21.07.2018;2018;07;21;Lauantai;11;9;20
93;21.07.2018;2018;07;22;Lauantai;8;7;15
93;21.07.2018;2018;07;23;Lauantai;8;9;17
93;22.07.2018;2018;07;00;Sunnuntai;1;8;9
93;22.07.2018;2018;07;01;Sunnuntai;7;5;12
93;22.07.2018;2018;07;02;Sunnuntai;2;0;2
93;22.07.2018;2018;07;03;Sunnuntai;2;2;4
93;22.07.2018;2018;07;04;Sunnuntai;0;0;0
93;22.07.2018;2018;07;05;Sunnuntai;2;1;3
93;22.07.2018;2018;07;06;Sunnuntai;1;2;3
93;22.07.2018;2018;07;07;Sunnuntai;1;3;4
93;22.07.2018;2018;07;08;Sunnuntai;8;11;19
93;22.07.2018;2018;07;09;Sunnuntai;8;6;14
93;22.07.2018;2018;07;10;Sunnuntai;11;5;16
93;22.07.2018;2018;07;11;Sunnuntai;21;29;50
93;22.07.2018;2018;07;12;Sunnuntai;29;25;54
93;22.07.2018;2018;07;13;Sunnuntai;20;26;46
93;22.07.2018;2018;07;14;Sunnuntai;11;15;26
93;22.07.2018;2018;07;15;Sunnuntai;20;16;36
93;22.07.2018;2018;07;16;Sunnuntai;11;19;30
93;22.07.2018;2018;07;17;Sunnuntai;16;11;27
93;22.07.2018;2018;07;18;Sunnuntai;13;13;26
93;22.07.2018;2018;07;19;Sunnuntai;6;16;22
93;22.07.2018;2018;07;20;Sunnuntai;12;11;23
93;22.07.2018;2018;07;21;Sunnuntai;10;9;19
93;22.07.2018;2018;07;22;Sunnuntai;8;6;14
93;22.07.2018;2018;07;23;Sunnuntai;2;4;6
93;23.07.2018;2018;07;00;Maanantai;2;1;3
93;23.07.2018;2018;07;01;Maanantai;2;0;2
93;23.07.2018;2018;07;02;Maanantai;0;2;2
93;23.07.2018;2018;07;03;Maanantai;3;0;3
93;23.07.2018;2018;07;04;Maanantai;2;1;3
93;23.07.2018;2018;07;05;Maanantai;1;9;10
93;23.07.2018;2018;07;06;Maanantai;21;12;33
93;23.07.2018;2018;07;07;Maanantai;30;21;51
93;23.07.2018;2018;07;08;Maanantai;14;22;36
93;23.07.2018;2018;07;09;Maanantai;14;21;35
93;23.07.2018;2018;07;10;Maanantai;14;9;23
93;23.07.2018;2018;07;11;Maanantai;17;16;33
93;23.07.2018;2018;07;12;Maanantai;23;21;44
93;23.07.2018;2018;07;13;Maanantai;23;24;47
93;23.07.2018;2018;07;14;Maanantai;43;21;64
93;23.07.2018;2018;07;15;Maanantai;44;36;80
93;23.07.2018;2018;07;16;Maanantai;39;66;105
93;23.07.2018;2018;07;17;Maanantai;51;36;87
93;23.07.2018;2018;07;18;Maanantai;40;31;71
93;23.07.2018;2018;07;19;Maanantai;50;38;88
93;23.07.2018;2018;07;20;Maanantai;36;66;102
93;23.07.2018;2018;07;21;Maanantai;19;50;69
93;23.07.2018;2018;07;22;Maanantai;16;9;25
93;23.07.2018;2018;07;23;Maanantai;4;3;7
93;24.07.2018;2018;07;00;Tiistai;4;5;9
93;24.07.2018;2018;07;01;Tiistai;0;3;3
93;24.07.2018;2018;07;02;Tiistai;1;2;3
93;24.07.2018;2018;07;03;Tiistai;0;0;0
93;24.07.2018;2018;07;04;Tiistai;3;1;4
93;24.07.2018;2018;07;05;Tiistai;5;8;13
93;24.07.2018;2018;07;06;Tiistai;21;9;30
93;24.07.2018;2018;07;07;Tiistai;42;24;66
93;24.07.2018;2018;07;08;Tiistai;17;30;47
93;24.07.2018;2018;07;09;Tiistai;14;19;33
93;24.07.2018;2018;07;10;Tiistai;29;23;52
93;24.07.2018;2018;07;11;Tiistai;27;23;50
93;24.07.2018;2018;07;12;Tiistai;22;22;44
93;24.07.2018;2018;07;13;Tiistai;24;37;61
93;24.07.2018;2018;07;14;Tiistai;39;25;64
93;24.07.2018;2018;07;15;Tiistai;38;40;78
93;24.07.2018;2018;07;16;Tiistai;40;56;96
93;24.07.2018;2018;07;17;Tiistai;48;51;99
93;24.07.2018;2018;07;18;Tiistai;42;49;91
93;24.07.2018;2018;07;19;Tiistai;22;39;61
93;24.07.2018;2018;07;20;Tiistai;36;50;86
93;24.07.2018;2018;07;21;Tiistai;20;28;48
93;24.07.2018;2018;07;22;Tiistai;13;14;27
93;24.07.2018;2018;07;23;Tiistai;6;4;10
93;25.07.2018;2018;07;00;Keskiviikko;0;4;4
93;25.07.2018;2018;07;01;Keskiviikko;1;1;2
93;25.07.2018;2018;07;02;Keskiviikko;1;0;1
93;25.07.2018;2018;07;03;Keskiviikko;0;0;0
93;25.07.2018;2018;07;04;Keskiviikko;2;0;2
93;25.07.2018;2018;07;05;Keskiviikko;2;8;10
93;25.07.2018;2018;07;06;Keskiviikko;26;14;40
93;25.07.2018;2018;07;07;Keskiviikko;28;21;49
93;25.07.2018;2018;07;08;Keskiviikko;18;19;37
93;25.07.2018;2018;07;09;Keskiviikko;11;24;35
93;25.07.2018;2018;07;10;Keskiviikko;30;22;52
93;25.07.2018;2018;07;11;Keskiviikko;33;25;58
93;25.07.2018;2018;07;12;Keskiviikko;35;22;57
93;25.07.2018;2018;07;13;Keskiviikko;33;20;53
93;25.07.2018;2018;07;14;Keskiviikko;28;29;57
93;25.07.2018;2018;07;15;Keskiviikko;26;49;75
93;25.07.2018;2018;07;16;Keskiviikko;36;61;97
93;25.07.2018;2018;07;17;Keskiviikko;22;43;65
93;25.07.2018;2018;07;18;Keskiviikko;31;35;66
93;25.07.2018;2018;07;19;Keskiviikko;23;38;61
93;25.07.2018;2018;07;20;Keskiviikko;36;31;67
93;25.07.2018;2018;07;21;Keskiviikko;20;22;42
93;25.07.2018;2018;07;22;Keskiviikko;7;11;18
93;25.07.2018;2018;07;23;Keskiviikko;2;5;7
93;26.07.2018;2018;07;00;Torstai;3;1;4
93;26.07.2018;2018;07;01;Torstai;0;1;1
93;26.07.2018;2018;07;02;Torstai;0;2;2
93;26.07.2018;2018;07;03;Torstai;0;2;2
93;26.07.2018;2018;07;04;Torstai;3;1;4
93;26.07.2018;2018;07;05;Torstai;3;11;14
93;26.07.2018;2018;07;06;Torstai;19;10;29
93;26.07.2018;2018;07;07;Torstai;27;18;45
93;26.07.2018;2018;07;08;Torstai;20;28;48
93;26.07.2018;2018;07;09;Torstai;15;16;31
93;26.07.2018;2018;07;10;Torstai;17;19;36
93;26.07.2018;2018;07;11;Torstai;27;24;51
93;26.07.2018;2018;07;12;Torstai;30;17;47
93;26.07.2018;2018;07;13;Torstai;26;34;60
93;26.07.2018;2018;07;14;Torstai;31;32;63
93;26.07.2018;2018;07;15;Torstai;23;36;59
93;26.07.2018;2018;07;16;Torstai;36;38;74
93;26.07.2018;2018;07;17;Torstai;29;51;80
93;26.07.2018;2018;07;18;Torstai;39;25;64
93;26.07.2018;2018;07;19;Torstai;39;25;64
93;26.07.2018;2018;07;20;Torstai;21;21;42
93;26.07.2018;2018;07;21;Torstai;12;18;30
93;26.07.2018;2018;07;22;Torstai;7;10;17
93;26.07.2018;2018;07;23;Torstai;4;6;10
93;27.07.2018;2018;07;00;Perjantai;6;1;7
93;27.07.2018;2018;07;01;Perjantai;1;3;4
93;27.07.2018;2018;07;02;Perjantai;1;1;2
93;27.07.2018;2018;07;03;Perjantai;2;3;5
93;27.07.2018;2018;07;04;Perjantai;1;1;2
93;27.07.2018;2018;07;05;Perjantai;7;7;14
93;27.07.2018;2018;07;06;Perjantai;13;12;25
93;27.07.2018;2018;07;07;Perjantai;23;21;44
93;27.07.2018;2018;07;08;Perjantai;12;13;25
93;27.07.2018;2018;07;09;Perjantai;13;15;28
93;27.07.2018;2018;07;10;Perjantai;14;16;30
93;27.07.2018;2018;07;11;Perjantai;30;14;44
93;27.07.2018;2018;07;12;Perjantai;21;17;38
93;27.07.2018;2018;07;13;Perjantai;25;28;53
93;27.07.2018;2018;07;14;Perjantai;58;24;82
93;27.07.2018;2018;07;15;Perjantai;45;33;78
93;27.07.2018;2018;07;16;Perjantai;54;31;85
93;27.07.2018;2018;07;17;Perjantai;27;33;60
93;27.07.2018;2018;07;18;Perjantai;29;20;49
93;27.07.2018;2018;07;19;Perjantai;26;38;64
93;27.07.2018;2018;07;20;Perjantai;25;29;54
93;27.07.2018;2018;07;21;Perjantai;10;20;30
93;27.07.2018;2018;07;22;Perjantai;5;10;15
93;27.07.2018;2018;07;23;Perjantai;9;14;23
93;28.07.2018;2018;07;00;Lauantai;9;8;17
93;28.07.2018;2018;07;01;Lauantai;0;18;18
93;28.07.2018;2018;07;02;Lauantai;0;6;6
93;28.07.2018;2018;07;03;Lauantai;0;5;5
93;28.07.2018;2018;07;04;Lauantai;2;6;8
93;28.07.2018;2018;07;05;Lauantai;0;3;3
93;28.07.2018;2018;07;06;Lauantai;1;4;5
93;28.07.2018;2018;07;07;Lauantai;2;5;7
93;28.07.2018;2018;07;08;Lauantai;9;6;15
93;28.07.2018;2018;07;09;Lauantai;13;11;24
93;28.07.2018;2018;07;10;Lauantai;14;16;30
93;28.07.2018;2018;07;11;Lauantai;33;24;57
93;28.07.2018;2018;07;12;Lauantai;38;23;61
93;28.07.2018;2018;07;13;Lauantai;24;24;48
93;28.07.2018;2018;07;14;Lauantai;24;24;48
93;28.07.2018;2018;07;15;Lauantai;35;20;55
93;28.07.2018;2018;07;16;Lauantai;25;29;54
93;28.07.2018;2018;07;17;Lauantai;23;23;46
93;28.07.2018;2018;07;18;Lauantai;23;30;53
93;28.07.2018;2018;07;19;Lauantai;32;25;57
93;28.07.2018;2018;07;20;Lauantai;17;23;40
93;28.07.2018;2018;07;21;Lauantai;14;14;28
93;28.07.2018;2018;07;22;Lauantai;6;10;16
93;28.07.2018;2018;07;23;Lauantai;5;14;19
93;29.07.2018;2018;07;00;Sunnuntai;2;3;5
93;29.07.2018;2018;07;01;Sunnuntai;3;16;19
93;29.07.2018;2018;07;02;Sunnuntai;0;23;23
93;29.07.2018;2018;07;03;Sunnuntai;1;3;4
93;29.07.2018;2018;07;04;Sunnuntai;2;9;11
93;29.07.2018;2018;07;05;Sunnuntai;1;0;1
93;29.07.2018;2018;07;06;Sunnuntai;0;5;5
93;29.07.2018;2018;07;07;Sunnuntai;6;4;10
93;29.07.2018;2018;07;08;Sunnuntai;6;4;10
93;29.07.2018;2018;07;09;Sunnuntai;16;12;28
93;29.07.2018;2018;07;10;Sunnuntai;11;28;39
93;29.07.2018;2018;07;11;Sunnuntai;22;24;46
93;29.07.2018;2018;07;12;Sunnuntai;38;18;56
93;29.07.2018;2018;07;13;Sunnuntai;22;35;57
93;29.07.2018;2018;07;14;Sunnuntai;18;32;50
93;29.07.2018;2018;07;15;Sunnuntai;24;20;44
93;29.07.2018;2018;07;16;Sunnuntai;19;28;47
93;29.07.2018;2018;07;17;Sunnuntai;20;21;41
93;29.07.2018;2018;07;18;Sunnuntai;20;44;64
93;29.07.2018;2018;07;19;Sunnuntai;39;26;65
93;29.07.2018;2018;07;20;Sunnuntai;19;17;36
93;29.07.2018;2018;07;21;Sunnuntai;10;16;26
93;29.07.2018;2018;07;22;Sunnuntai;11;5;16
93;29.07.2018;2018;07;23;Sunnuntai;2;2;4
93;30.07.2018;2018;07;00;Maanantai;3;5;8
93;30.07.2018;2018;07;01;Maanantai;0;1;1
93;30.07.2018;2018;07;02;Maanantai;1;1;2
93;30.07.2018;2018;07;03;Maanantai;0;1;1
93;30.07.2018;2018;07;04;Maanantai;1;0;1
93;30.07.2018;2018;07;05;Maanantai;3;5;8
93;30.07.2018;2018;07;06;Maanantai;20;17;37
93;30.07.2018;2018;07;07;Maanantai;34;31;65
93;30.07.2018;2018;07;08;Maanantai;19;33;52
93;30.07.2018;2018;07;09;Maanantai;16;23;39
93;30.07.2018;2018;07;10;Maanantai;20;16;36
93;30.07.2018;2018;07;11;Maanantai;22;15;37
93;30.07.2018;2018;07;12;Maanantai;27;20;47
93;30.07.2018;2018;07;13;Maanantai;14;22;36
93;30.07.2018;2018;07;14;Maanantai;25;16;41
93;30.07.2018;2018;07;15;Maanantai;33;40;73
93;30.07.2018;2018;07;16;Maanantai;51;56;107
93;30.07.2018;2018;07;17;Maanantai;29;44;73
93;30.07.2018;2018;07;18;Maanantai;25;41;66
93;30.07.2018;2018;07;19;Maanantai;41;38;79
93;30.07.2018;2018;07;20;Maanantai;21;41;62
93;30.07.2018;2018;07;21;Maanantai;16;19;35
93;30.07.2018;2018;07;22;Maanantai;14;9;23
93;30.07.2018;2018;07;23;Maanantai;9;1;10
93;31.07.2018;2018;07;00;Tiistai;3;2;5
93;31.07.2018;2018;07;01;Tiistai;0;4;4
93;31.07.2018;2018;07;02;Tiistai;0;1;1
93;31.07.2018;2018;07;03;Tiistai;0;1;1
93;31.07.2018;2018;07;04;Tiistai;1;0;1
93;31.07.2018;2018;07;05;Tiistai;4;4;8
93;31.07.2018;2018;07;06;Tiistai;20;19;39
93;31.07.2018;2018;07;07;Tiistai;39;32;71
93;31.07.2018;2018;07;08;Tiistai;26;31;57
93;31.07.2018;2018;07;09;Tiistai;14;20;34
93;31.07.2018;2018;07;10;Tiistai;14;17;31
93;31.07.2018;2018;07;11;Tiistai;25;15;40
93;31.07.2018;2018;07;12;Tiistai;24;25;49
93;31.07.2018;2018;07;13;Tiistai;21;23;44
93;31.07.2018;2018;07;14;Tiistai;31;20;51
93;31.07.2018;2018;07;15;Tiistai;36;39;75
93;31.07.2018;2018;07;16;Tiistai;53;45;98
93;31.07.2018;2018;07;17;Tiistai;27;53;80
93;31.07.2018;2018;07;18;Tiistai;39;36;75
93;31.07.2018;2018;07;19;Tiistai;38;36;74
93;31.07.2018;2018;07;20;Tiistai;17;27;44
93;31.07.2018;2018;07;21;Tiistai;16;23;39
93;31.07.2018;2018;07;22;Tiistai;15;13;28
93;31.07.2018;2018;07;23;Tiistai;3;5;8
93;01.08.2018;2018;08;00;Keskiviikko;2;0;2
93;01.08.2018;2018;08;01;Keskiviikko;1;0;1
93;01.08.2018;2018;08;02;Keskiviikko;0;1;1
93;01.08.2018;2018;08;03;Keskiviikko;0;1;1
93;01.08.2018;2018;08;04;Keskiviikko;1;1;2
93;01.08.2018;2018;08;05;Keskiviikko;6;6;12
93;01.08.2018;2018;08;06;Keskiviikko;23;13;36
93;01.08.2018;2018;08;07;Keskiviikko;32;30;62
93;01.08.2018;2018;08;08;Keskiviikko;19;26;45
93;01.08.2018;2018;08;09;Keskiviikko;10;20;30
93;01.08.2018;2018;08;10;Keskiviikko;26;18;44
93;01.08.2018;2018;08;11;Keskiviikko;22;15;37
93;01.08.2018;2018;08;12;Keskiviikko;25;23;48
93;01.08.2018;2018;08;13;Keskiviikko;23;25;48
93;01.08.2018;2018;08;14;Keskiviikko;28;15;43
93;01.08.2018;2018;08;15;Keskiviikko;31;29;60
93;01.08.2018;2018;08;16;Keskiviikko;40;41;81
93;01.08.2018;2018;08;17;Keskiviikko;15;36;51
93;01.08.2018;2018;08;18;Keskiviikko;36;25;61
93;01.08.2018;2018;08;19;Keskiviikko;21;35;56
93;01.08.2018;2018;08;20;Keskiviikko;23;39;62
93;01.08.2018;2018;08;21;Keskiviikko;25;12;37
93;01.08.2018;2018;08;22;Keskiviikko;9;5;14
93;01.08.2018;2018;08;23;Keskiviikko;0;4;4
93;02.08.2018;2018;08;00;Torstai;2;4;6
93;02.08.2018;2018;08;01;Torstai;0;5;5
93;02.08.2018;2018;08;02;Torstai;0;0;0
93;02.08.2018;2018;08;03;Torstai;1;1;2
93;02.08.2018;2018;08;04;Torstai;2;1;3
93;02.08.2018;2018;08;05;Torstai;9;8;17
93;02.08.2018;2018;08;06;Torstai;22;13;35
93;02.08.2018;2018;08;07;Torstai;33;34;67
93;02.08.2018;2018;08;08;Torstai;18;28;46
93;02.08.2018;2018;08;09;Torstai;11;19;30
93;02.08.2018;2018;08;10;Torstai;21;20;41
93;02.08.2018;2018;08;11;Torstai;19;8;27
93;02.08.2018;2018;08;12;Torstai;20;21;41
93;02.08.2018;2018;08;13;Torstai;15;18;33
93;02.08.2018;2018;08;14;Torstai;18;31;49
93;02.08.2018;2018;08;15;Torstai;48;33;81
93;02.08.2018;2018;08;16;Torstai;39;49;88
93;02.08.2018;2018;08;17;Torstai;37;54;91
93;02.08.2018;2018;08;18;Torstai;22;33;55
93;02.08.2018;2018;08;19;Torstai;22;27;49
93;02.08.2018;2018;08;20;Torstai;24;23;47
93;02.08.2018;2018;08;21;Torstai;27;23;50
93;02.08.2018;2018;08;22;Torstai;11;9;20
93;02.08.2018;2018;08;23;Torstai;2;3;5
93;03.08.2018;2018;08;00;Perjantai;2;0;2
93;03.08.2018;2018;08;01;Perjantai;2;2;4
93;03.08.2018;2018;08;02;Perjantai;0;1;1
93;03.08.2018;2018;08;03;Perjantai;0;4;4
93;03.08.2018;2018;08;04;Perjantai;1;0;1
93;03.08.2018;2018;08;05;Perjantai;3;4;7
93;03.08.2018;2018;08;06;Perjantai;9;5;14
93;03.08.2018;2018;08;07;Perjantai;9;16;25
93;03.08.2018;2018;08;08;Perjantai;8;9;17
93;03.08.2018;2018;08;09;Perjantai;4;4;8
93;03.08.2018;2018;08;10;Perjantai;3;1;4
93;03.08.2018;2018;08;11;Perjantai;1;1;2
93;03.08.2018;2018;08;12;Perjantai;1;3;4
93;03.08.2018;2018;08;13;Perjantai;10;8;18
93;03.08.2018;2018;08;14;Perjantai;12;14;26
93;03.08.2018;2018;08;15;Perjantai;29;20;49
93;03.08.2018;2018;08;16;Perjantai;17;19;36
93;03.08.2018;2018;08;17;Perjantai;13;18;31
93;03.08.2018;2018;08;18;Perjantai;21;20;41
93;03.08.2018;2018;08;19;Perjantai;20;23;43
93;03.08.2018;2018;08;20;Perjantai;14;17;31
93;03.08.2018;2018;08;21;Perjantai;5;11;16
93;03.08.2018;2018;08;22;Perjantai;11;9;20
93;03.08.2018;2018;08;23;Perjantai;5;2;7
93;04.08.2018;2018;08;00;Lauantai;2;0;2
93;04.08.2018;2018;08;01;Lauantai;0;0;0
93;04.08.2018;2018;08;02;Lauantai;1;1;2
93;04.08.2018;2018;08;03;Lauantai;3;2;5
93;04.08.2018;2018;08;04;Lauantai;0;3;3
93;04.08.2018;2018;08;05;Lauantai;0;0;0
93;04.08.2018;2018;08;06;Lauantai;0;0;0
93;04.08.2018;2018;08;07;Lauantai;4;4;8
93;04.08.2018;2018;08;08;Lauantai;7;6;13
93;04.08.2018;2018;08;09;Lauantai;11;7;18
93;04.08.2018;2018;08;10;Lauantai;17;17;34
93;04.08.2018;2018;08;11;Lauantai;15;19;34
93;04.08.2018;2018;08;12;Lauantai;37;34;71
93;04.08.2018;2018;08;13;Lauantai;40;17;57
93;04.08.2018;2018;08;14;Lauantai;18;18;36
93;04.08.2018;2018;08;15;Lauantai;23;24;47
93;04.08.2018;2018;08;16;Lauantai;18;17;35
93;04.08.2018;2018;08;17;Lauantai;24;25;49
93;04.08.2018;2018;08;18;Lauantai;38;24;62
93;04.08.2018;2018;08;19;Lauantai;25;20;45
93;04.08.2018;2018;08;20;Lauantai;21;25;46
93;04.08.2018;2018;08;21;Lauantai;17;16;33
93;04.08.2018;2018;08;22;Lauantai;1;5;6
93;04.08.2018;2018;08;23;Lauantai;5;1;6
93;05.08.2018;2018;08;00;Sunnuntai;4;6;10
93;05.08.2018;2018;08;01;Sunnuntai;5;5;10
93;05.08.2018;2018;08;02;Sunnuntai;3;5;8
93;05.08.2018;2018;08;03;Sunnuntai;0;0;0
93;05.08.2018;2018;08;04;Sunnuntai;0;2;2
93;05.08.2018;2018;08;05;Sunnuntai;1;0;1
93;05.08.2018;2018;08;06;Sunnuntai;0;2;2
93;05.08.2018;2018;08;07;Sunnuntai;5;6;11
93;05.08.2018;2018;08;08;Sunnuntai;10;6;16
93;05.08.2018;2018;08;09;Sunnuntai;16;48;64
93;05.08.2018;2018;08;10;Sunnuntai;15;22;37
93;05.08.2018;2018;08;11;Sunnuntai;29;28;57
93;05.08.2018;2018;08;12;Sunnuntai;31;31;62
93;05.08.2018;2018;08;13;Sunnuntai;20;11;31
93;05.08.2018;2018;08;14;Sunnuntai;16;22;38
93;05.08.2018;2018;08;15;Sunnuntai;14;11;25
93;05.08.2018;2018;08;16;Sunnuntai;42;42;84
93;05.08.2018;2018;08;17;Sunnuntai;22;30;52
93;05.08.2018;2018;08;18;Sunnuntai;24;37;61
93;05.08.2018;2018;08;19;Sunnuntai;19;28;47
93;05.08.2018;2018;08;20;Sunnuntai;22;29;51
93;05.08.2018;2018;08;21;Sunnuntai;16;5;21
93;05.08.2018;2018;08;22;Sunnuntai;3;6;9
93;05.08.2018;2018;08;23;Sunnuntai;4;7;11
93;06.08.2018;2018;08;00;Maanantai;1;0;1
93;06.08.2018;2018;08;01;Maanantai;0;3;3
93;06.08.2018;2018;08;02;Maanantai;1;0;1
93;06.08.2018;2018;08;03;Maanantai;2;2;4
93;06.08.2018;2018;08;04;Maanantai;4;1;5
93;06.08.2018;2018;08;05;Maanantai;3;7;10
93;06.08.2018;2018;08;06;Maanantai;9;12;21
93;06.08.2018;2018;08;07;Maanantai;17;30;47
93;06.08.2018;2018;08;08;Maanantai;15;16;31
93;06.08.2018;2018;08;09;Maanantai;7;9;16
93;06.08.2018;2018;08;10;Maanantai;2;2;4
93;06.08.2018;2018;08;11;Maanantai;1;4;5
93;06.08.2018;2018;08;12;Maanantai;1;6;7
93;06.08.2018;2018;08;13;Maanantai;4;6;10
93;06.08.2018;2018;08;14;Maanantai;7;3;10
93;06.08.2018;2018;08;15;Maanantai;17;10;27
93;06.08.2018;2018;08;16;Maanantai;31;21;52
93;06.08.2018;2018;08;17;Maanantai;16;19;35
93;06.08.2018;2018;08;18;Maanantai;8;14;22
93;06.08.2018;2018;08;19;Maanantai;17;15;32
93;06.08.2018;2018;08;20;Maanantai;13;21;34
93;06.08.2018;2018;08;21;Maanantai;6;7;13
93;06.08.2018;2018;08;22;Maanantai;7;1;8
93;06.08.2018;2018;08;23;Maanantai;3;3;6
93;07.08.2018;2018;08;00;Tiistai;5;0;5
93;07.08.2018;2018;08;01;Tiistai;4;0;4
93;07.08.2018;2018;08;02;Tiistai;1;0;1
93;07.08.2018;2018;08;03;Tiistai;1;0;1
93;07.08.2018;2018;08;04;Tiistai;1;0;1
93;07.08.2018;2018;08;05;Tiistai;8;0;8
93;07.08.2018;2018;08;06;Tiistai;39;0;39
93;07.08.2018;2018;08;07;Tiistai;71;0;71
93;07.08.2018;2018;08;08;Tiistai;57;0;57
93;07.08.2018;2018;08;09;Tiistai;34;0;34
93;07.08.2018;2018;08;10;Tiistai;31;0;31
93;07.08.2018;2018;08;11;Tiistai;40;0;40
93;07.08.2018;2018;08;12;Tiistai;49;0;49
93;07.08.2018;2018;08;13;Tiistai;44;0;44
93;07.08.2018;2018;08;14;Tiistai;51;0;51
93;07.08.2018;2018;08;15;Tiistai;75;0;75
93;07.08.2018;2018;08;16;Tiistai;98;0;98
93;07.08.2018;2018;08;17;Tiistai;80;0;80
93;07.08.2018;2018;08;18;Tiistai;75;0;75
93;07.08.2018;2018;08;19;Tiistai;74;0;74
93;07.08.2018;2018;08;20;Tiistai;44;0;44
93;07.08.2018;2018;08;21;Tiistai;39;0;39
93;07.08.2018;2018;08;22;Tiistai;28;0;28
93;07.08.2018;2018;08;23;Tiistai;8;0;8
93;08.08.2018;2018;08;00;Keskiviikko;2;1;3
93;08.08.2018;2018;08;01;Keskiviikko;0;0;0
93;08.08.2018;2018;08;02;Keskiviikko;0;2;2
93;08.08.2018;2018;08;03;Keskiviikko;0;0;0
93;08.08.2018;2018;08;04;Keskiviikko;1;2;3
93;08.08.2018;2018;08;05;Keskiviikko;3;7;10
93;08.08.2018;2018;08;06;Keskiviikko;20;22;42
93;08.08.2018;2018;08;07;Keskiviikko;37;45;82
93;08.08.2018;2018;08;08;Keskiviikko;37;43;80
93;08.08.2018;2018;08;09;Keskiviikko;12;9;21
93;08.08.2018;2018;08;10;Keskiviikko;14;17;31
93;08.08.2018;2018;08;11;Keskiviikko;10;12;22
93;08.08.2018;2018;08;12;Keskiviikko;22;19;41
93;08.08.2018;2018;08;13;Keskiviikko;23;17;40
93;08.08.2018;2018;08;14;Keskiviikko;22;30;52
93;08.08.2018;2018;08;15;Keskiviikko;47;58;105
93;08.08.2018;2018;08;16;Keskiviikko;59;53;112
93;08.08.2018;2018;08;17;Keskiviikko;41;36;77
93;08.08.2018;2018;08;18;Keskiviikko;32;34;66
93;08.08.2018;2018;08;19;Keskiviikko;24;45;69
93;08.08.2018;2018;08;20;Keskiviikko;19;21;40
93;08.08.2018;2018;08;21;Keskiviikko;10;21;31
93;08.08.2018;2018;08;22;Keskiviikko;5;8;13
93;08.08.2018;2018;08;23;Keskiviikko;0;2;2
93;09.08.2018;2018;08;00;Torstai;0;0;0
93;09.08.2018;2018;08;01;Torstai;0;0;0
93;09.08.2018;2018;08;02;Torstai;0;0;0
93;09.08.2018;2018;08;03;Torstai;0;0;0
93;09.08.2018;2018;08;04;Torstai;0;0;0
93;09.08.2018;2018;08;05;Torstai;6;7;13
93;09.08.2018;2018;08;06;Torstai;12;15;27
93;09.08.2018;2018;08;07;Torstai;36;35;71
93;09.08.2018;2018;08;08;Torstai;11;27;38
93;09.08.2018;2018;08;09;Torstai;17;10;27
93;09.08.2018;2018;08;10;Torstai;7;10;17
93;09.08.2018;2018;08;11;Torstai;9;3;12
93;09.08.2018;2018;08;12;Torstai;14;11;25
93;09.08.2018;2018;08;13;Torstai;13;14;27
93;09.08.2018;2018;08;14;Torstai;27;17;44
93;09.08.2018;2018;08;15;Torstai;29;28;57
93;09.08.2018;2018;08;16;Torstai;38;46;84
93;09.08.2018;2018;08;17;Torstai;20;27;47
93;09.08.2018;2018;08;18;Torstai;23;20;43
93;09.08.2018;2018;08;19;Torstai;20;17;37
93;09.08.2018;2018;08;20;Torstai;17;12;29
93;09.08.2018;2018;08;21;Torstai;8;25;33
93;09.08.2018;2018;08;22;Torstai;7;7;14
93;09.08.2018;2018;08;23;Torstai;1;4;5
93;10.08.2018;2018;08;00;Perjantai;1;0;1
93;10.08.2018;2018;08;01;Perjantai;0;1;1
93;10.08.2018;2018;08;02;Perjantai;0;0;0
93;10.08.2018;2018;08;03;Perjantai;0;0;0
93;10.08.2018;2018;08;04;Perjantai;1;0;1
93;10.08.2018;2018;08;05;Perjantai;4;7;11
93;10.08.2018;2018;08;06;Perjantai;14;13;27
93;10.08.2018;2018;08;07;Perjantai;31;35;66
93;10.08.2018;2018;08;08;Perjantai;21;38;59
93;10.08.2018;2018;08;09;Perjantai;14;13;27
93;10.08.2018;2018;08;10;Perjantai;22;14;36
93;10.08.2018;2018;08;11;Perjantai;17;22;39
93;10.08.2018;2018;08;12;Perjantai;17;26;43
93;10.08.2018;2018;08;13;Perjantai;14;24;38
93;10.08.2018;2018;08;14;Perjantai;24;34;58
93;10.08.2018;2018;08;15;Perjantai;42;34;76
93;10.08.2018;2018;08;16;Perjantai;43;40;83
93;10.08.2018;2018;08;17;Perjantai;28;34;62
93;10.08.2018;2018;08;18;Perjantai;26;35;61
93;10.08.2018;2018;08;19;Perjantai;14;13;27
93;10.08.2018;2018;08;20;Perjantai;5;8;13
93;10.08.2018;2018;08;21;Perjantai;3;8;11
93;10.08.2018;2018;08;22;Perjantai;2;1;3
93;10.08.2018;2018;08;23;Perjantai;1;2;3
93;11.08.2018;2018;08;00;Lauantai;1;3;4
93;11.08.2018;2018;08;01;Lauantai;1;0;1
93;11.08.2018;2018;08;02;Lauantai;0;0;0
93;11.08.2018;2018;08;03;Lauantai;0;0;0
93;11.08.2018;2018;08;04;Lauantai;0;1;1
93;11.08.2018;2018;08;05;Lauantai;1;2;3
93;11.08.2018;2018;08;06;Lauantai;2;1;3
93;11.08.2018;2018;08;07;Lauantai;1;2;3
93;11.08.2018;2018;08;08;Lauantai;9;2;11
93;11.08.2018;2018;08;09;Lauantai;4;6;10
93;11.08.2018;2018;08;10;Lauantai;25;15;40
93;11.08.2018;2018;08;11;Lauantai;13;15;28
93;11.08.2018;2018;08;12;Lauantai;19;29;48
93;11.08.2018;2018;08;13;Lauantai;10;15;25
93;11.08.2018;2018;08;14;Lauantai;9;10;19
93;11.08.2018;2018;08;15;Lauantai;11;17;28
93;11.08.2018;2018;08;16;Lauantai;11;8;19
93;11.08.2018;2018;08;17;Lauantai;21;13;34
93;11.08.2018;2018;08;18;Lauantai;7;15;22
93;11.08.2018;2018;08;19;Lauantai;5;5;10
93;11.08.2018;2018;08;20;Lauantai;7;11;18
93;11.08.2018;2018;08;21;Lauantai;1;2;3
93;11.08.2018;2018;08;22;Lauantai;2;4;6
93;11.08.2018;2018;08;23;Lauantai;11;4;15
93;12.08.2018;2018;08;00;Sunnuntai;3;4;7
93;12.08.2018;2018;08;01;Sunnuntai;3;4;7
93;12.08.2018;2018;08;02;Sunnuntai;4;0;4
93;12.08.2018;2018;08;03;Sunnuntai;8;0;8
93;12.08.2018;2018;08;04;Sunnuntai;0;2;2
93;12.08.2018;2018;08;05;Sunnuntai;0;3;3
93;12.08.2018;2018;08;06;Sunnuntai;2;1;3
93;12.08.2018;2018;08;07;Sunnuntai;7;4;11
93;12.08.2018;2018;08;08;Sunnuntai;8;1;9
93;12.08.2018;2018;08;09;Sunnuntai;14;8;22
93;12.08.2018;2018;08;10;Sunnuntai;19;15;34
93;12.08.2018;2018;08;11;Sunnuntai;21;17;38
93;12.08.2018;2018;08;12;Sunnuntai;14;24;38
93;12.08.2018;2018;08;13;Sunnuntai;30;28;58
93;12.08.2018;2018;08;14;Sunnuntai;16;37;53
93;12.08.2018;2018;08;15;Sunnuntai;29;24;53
93;12.08.2018;2018;08;16;Sunnuntai;25;22;47
93;12.08.2018;2018;08;17;Sunnuntai;14;23;37
93;12.08.2018;2018;08;18;Sunnuntai;31;23;54
93;12.08.2018;2018;08;19;Sunnuntai;22;14;36
93;12.08.2018;2018;08;20;Sunnuntai;17;14;31
93;12.08.2018;2018;08;21;Sunnuntai;9;14;23
93;12.08.2018;2018;08;22;Sunnuntai;3;3;6
93;12.08.2018;2018;08;23;Sunnuntai;1;4;5
93;13.08.2018;2018;08;00;Maanantai;1;0;1
93;13.08.2018;2018;08;01;Maanantai;0;0;0
93;13.08.2018;2018;08;02;Maanantai;0;1;1
93;13.08.2018;2018;08;03;Maanantai;0;0;0
93;13.08.2018;2018;08;04;Maanantai;1;0;1
93;13.08.2018;2018;08;05;Maanantai;2;4;6
93;13.08.2018;2018;08;06;Maanantai;11;11;22
93;13.08.2018;2018;08;07;Maanantai;20;22;42
93;13.08.2018;2018;08;08;Maanantai;12;28;40
93;13.08.2018;2018;08;09;Maanantai;5;7;12
93;13.08.2018;2018;08;10;Maanantai;3;2;5
93;13.08.2018;2018;08;11;Maanantai;6;3;9
93;13.08.2018;2018;08;12;Maanantai;5;6;11
93;13.08.2018;2018;08;13;Maanantai;5;6;11
93;13.08.2018;2018;08;14;Maanantai;15;8;23
93;13.08.2018;2018;08;15;Maanantai;18;15;33
93;13.08.2018;2018;08;16;Maanantai;30;25;55
93;13.08.2018;2018;08;17;Maanantai;23;16;39
93;13.08.2018;2018;08;18;Maanantai;7;10;17
93;13.08.2018;2018;08;19;Maanantai;11;18;29
93;13.08.2018;2018;08;20;Maanantai;11;8;19
93;13.08.2018;2018;08;21;Maanantai;5;9;14
93;13.08.2018;2018;08;22;Maanantai;3;1;4
93;13.08.2018;2018;08;23;Maanantai;0;0;0
93;14.08.2018;2018;08;00;Tiistai;0;0;0
93;14.08.2018;2018;08;01;Tiistai;0;0;0
93;14.08.2018;2018;08;02;Tiistai;0;0;0
93;14.08.2018;2018;08;03;Tiistai;0;0;0
93;14.08.2018;2018;08;04;Tiistai;1;0;1
93;14.08.2018;2018;08;05;Tiistai;5;5;10
93;14.08.2018;2018;08;06;Tiistai;22;15;37
93;14.08.2018;2018;08;07;Tiistai;42;49;91
93;14.08.2018;2018;08;08;Tiistai;23;35;58
93;14.08.2018;2018;08;09;Tiistai;14;16;30
93;14.08.2018;2018;08;10;Tiistai;8;7;15
93;14.08.2018;2018;08;11;Tiistai;8;8;16
93;14.08.2018;2018;08;12;Tiistai;17;6;23
93;14.08.2018;2018;08;13;Tiistai;20;9;29
93;14.08.2018;2018;08;14;Tiistai;17;20;37
93;14.08.2018;2018;08;15;Tiistai;34;43;77
93;14.08.2018;2018;08;16;Tiistai;40;47;87
93;14.08.2018;2018;08;17;Tiistai;32;29;61
93;14.08.2018;2018;08;18;Tiistai;26;29;55
93;14.08.2018;2018;08;19;Tiistai;22;32;54
93;14.08.2018;2018;08;20;Tiistai;14;19;33
93;14.08.2018;2018;08;21;Tiistai;5;10;15
93;14.08.2018;2018;08;22;Tiistai;3;6;9
93;14.08.2018;2018;08;23;Tiistai;1;1;2
93;15.08.2018;2018;08;00;Keskiviikko;0;0;0
93;15.08.2018;2018;08;01;Keskiviikko;0;0;0
93;15.08.2018;2018;08;02;Keskiviikko;0;0;0
93;15.08.2018;2018;08;03;Keskiviikko;0;0;0
93;15.08.2018;2018;08;04;Keskiviikko;0;0;0
93;15.08.2018;2018;08;05;Keskiviikko;6;7;13
93;15.08.2018;2018;08;06;Keskiviikko;21;14;35
93;15.08.2018;2018;08;07;Keskiviikko;36;44;80
93;15.08.2018;2018;08;08;Keskiviikko;23;40;63
93;15.08.2018;2018;08;09;Keskiviikko;12;18;30
93;15.08.2018;2018;08;10;Keskiviikko;13;6;19
93;15.08.2018;2018;08;11;Keskiviikko;16;15;31
93;15.08.2018;2018;08;12;Keskiviikko;9;9;18
93;15.08.2018;2018;08;13;Keskiviikko;12;14;26
93;15.08.2018;2018;08;14;Keskiviikko;25;20;45
93;15.08.2018;2018;08;15;Keskiviikko;35;38;73
93;15.08.2018;2018;08;16;Keskiviikko;57;64;121
93;15.08.2018;2018;08;17;Keskiviikko;41;36;77
93;15.08.2018;2018;08;18;Keskiviikko;19;33;52
93;15.08.2018;2018;08;19;Keskiviikko;19;23;42
93;15.08.2018;2018;08;20;Keskiviikko;12;20;32
93;15.08.2018;2018;08;21;Keskiviikko;10;11;21
93;15.08.2018;2018;08;22;Keskiviikko;4;4;8
93;15.08.2018;2018;08;23;Keskiviikko;1;2;3
93;16.08.2018;2018;08;00;Torstai;0;2;2
93;16.08.2018;2018;08;01;Torstai;0;0;0
93;16.08.2018;2018;08;02;Torstai;0;0;0
93;16.08.2018;2018;08;03;Torstai;0;0;0
93;16.08.2018;2018;08;04;Torstai;0;1;1
93;16.08.2018;2018;08;05;Torstai;4;7;11
93;16.08.2018;2018;08;06;Torstai;17;15;32
93;16.08.2018;2018;08;07;Torstai;41;46;87
93;16.08.2018;2018;08;08;Torstai;23;41;64
93;16.08.2018;2018;08;09;Torstai;16;11;27
93;16.08.2018;2018;08;10;Torstai;12;5;17
93;16.08.2018;2018;08;11;Torstai;17;14;31
93;16.08.2018;2018;08;12;Torstai;20;10;30
93;16.08.2018;2018;08;13;Torstai;14;15;29
93;16.08.2018;2018;08;14;Torstai;23;23;46
93;16.08.2018;2018;08;15;Torstai;37;39;76
93;16.08.2018;2018;08;16;Torstai;49;61;110
93;16.08.2018;2018;08;17;Torstai;27;30;57
93;16.08.2018;2018;08;18;Torstai;25;20;45
93;16.08.2018;2018;08;19;Torstai;24;25;49
93;16.08.2018;2018;08;20;Torstai;6;21;27
93;16.08.2018;2018;08;21;Torstai;6;15;21
93;16.08.2018;2018;08;22;Torstai;4;2;6
93;16.08.2018;2018;08;23;Torstai;1;1;2
93;17.08.2018;2018;08;00;Perjantai;0;0;0
93;17.08.2018;2018;08;01;Perjantai;0;1;1
93;17.08.2018;2018;08;02;Perjantai;0;0;0
93;17.08.2018;2018;08;03;Perjantai;0;0;0
93;17.08.2018;2018;08;04;Perjantai;1;0;1
93;17.08.2018;2018;08;05;Perjantai;2;6;8
93;17.08.2018;2018;08;06;Perjantai;16;8;24
93;17.08.2018;2018;08;07;Perjantai;30;43;73
93;17.08.2018;2018;08;08;Perjantai;20;31;51
93;17.08.2018;2018;08;09;Perjantai;11;7;18
93;17.08.2018;2018;08;10;Perjantai;3;6;9
93;17.08.2018;2018;08;11;Perjantai;13;15;28
93;17.08.2018;2018;08;12;Perjantai;10;7;17
93;17.08.2018;2018;08;13;Perjantai;15;13;28
93;17.08.2018;2018;08;14;Perjantai;15;18;33
93;17.08.2018;2018;08;15;Perjantai;27;34;61
93;17.08.2018;2018;08;16;Perjantai;41;35;76
93;17.08.2018;2018;08;17;Perjantai;20;24;44
93;17.08.2018;2018;08;18;Perjantai;17;12;29
93;17.08.2018;2018;08;19;Perjantai;7;16;23
93;17.08.2018;2018;08;20;Perjantai;7;8;15
93;17.08.2018;2018;08;21;Perjantai;6;8;14
93;17.08.2018;2018;08;22;Perjantai;2;3;5
93;17.08.2018;2018;08;23;Perjantai;0;4;4
93;18.08.2018;2018;08;00;Lauantai;3;0;3
93;18.08.2018;2018;08;01;Lauantai;0;1;1
93;18.08.2018;2018;08;02;Lauantai;0;0;0
93;18.08.2018;2018;08;03;Lauantai;0;1;1
93;18.08.2018;2018;08;04;Lauantai;0;0;0
93;18.08.2018;2018;08;05;Lauantai;1;0;1
93;18.08.2018;2018;08;06;Lauantai;1;1;2
93;18.08.2018;2018;08;07;Lauantai;2;0;2
93;18.08.2018;2018;08;08;Lauantai;1;3;4
93;18.08.2018;2018;08;09;Lauantai;5;4;9
93;18.08.2018;2018;08;10;Lauantai;7;13;20
93;18.08.2018;2018;08;11;Lauantai;12;14;26
93;18.08.2018;2018;08;12;Lauantai;20;16;36
93;18.08.2018;2018;08;13;Lauantai;20;26;46
93;18.08.2018;2018;08;14;Lauantai;38;13;51
93;18.08.2018;2018;08;15;Lauantai;23;25;48
93;18.08.2018;2018;08;16;Lauantai;15;15;30
93;18.08.2018;2018;08;17;Lauantai;28;13;41
93;18.08.2018;2018;08;18;Lauantai;24;30;54
93;18.08.2018;2018;08;19;Lauantai;19;15;34
93;18.08.2018;2018;08;20;Lauantai;10;10;20
93;18.08.2018;2018;08;21;Lauantai;2;12;14
93;18.08.2018;2018;08;22;Lauantai;9;6;15
93;18.08.2018;2018;08;23;Lauantai;4;8;12
93;19.08.2018;2018;08;00;Sunnuntai;4;12;16
93;19.08.2018;2018;08;01;Sunnuntai;0;4;4
93;19.08.2018;2018;08;02;Sunnuntai;2;5;7
93;19.08.2018;2018;08;03;Sunnuntai;0;1;1
93;19.08.2018;2018;08;04;Sunnuntai;0;0;0
93;19.08.2018;2018;08;05;Sunnuntai;0;0;0
93;19.08.2018;2018;08;06;Sunnuntai;1;2;3
93;19.08.2018;2018;08;07;Sunnuntai;3;2;5
93;19.08.2018;2018;08;08;Sunnuntai;3;2;5
93;19.08.2018;2018;08;09;Sunnuntai;4;7;11
93;19.08.2018;2018;08;10;Sunnuntai;15;14;29
93;19.08.2018;2018;08;11;Sunnuntai;15;8;23
93;19.08.2018;2018;08;12;Sunnuntai;11;27;38
93;19.08.2018;2018;08;13;Sunnuntai;17;16;33
93;19.08.2018;2018;08;14;Sunnuntai;17;14;31
93;19.08.2018;2018;08;15;Sunnuntai;15;10;25
93;19.08.2018;2018;08;16;Sunnuntai;17;16;33
93;19.08.2018;2018;08;17;Sunnuntai;12;9;21
93;19.08.2018;2018;08;18;Sunnuntai;7;15;22
93;19.08.2018;2018;08;19;Sunnuntai;11;11;22
93;19.08.2018;2018;08;20;Sunnuntai;12;8;20
93;19.08.2018;2018;08;21;Sunnuntai;3;8;11
93;19.08.2018;2018;08;22;Sunnuntai;12;5;17
93;19.08.2018;2018;08;23;Sunnuntai;0;0;0
93;20.08.2018;2018;08;00;Maanantai;0;1;1
93;20.08.2018;2018;08;01;Maanantai;0;0;0
93;20.08.2018;2018;08;02;Maanantai;0;0;0
93;20.08.2018;2018;08;03;Maanantai;0;0;0
93;20.08.2018;2018;08;04;Maanantai;1;0;1
93;20.08.2018;2018;08;05;Maanantai;6;4;10
93;20.08.2018;2018;08;06;Maanantai;23;17;40
93;20.08.2018;2018;08;07;Maanantai;37;42;79
93;20.08.2018;2018;08;08;Maanantai;23;39;62
93;20.08.2018;2018;08;09;Maanantai;13;10;23
93;20.08.2018;2018;08;10;Maanantai;8;8;16
93;20.08.2018;2018;08;11;Maanantai;5;10;15
93;20.08.2018;2018;08;12;Maanantai;16;7;23
93;20.08.2018;2018;08;13;Maanantai;12;8;20
93;20.08.2018;2018;08;14;Maanantai;22;16;38
93;20.08.2018;2018;08;15;Maanantai;28;34;62
93;20.08.2018;2018;08;16;Maanantai;53;48;101
93;20.08.2018;2018;08;17;Maanantai;26;32;58
93;20.08.2018;2018;08;18;Maanantai;22;22;44
93;20.08.2018;2018;08;19;Maanantai;13;23;36
93;20.08.2018;2018;08;20;Maanantai;18;24;42
93;20.08.2018;2018;08;21;Maanantai;7;6;13
93;20.08.2018;2018;08;22;Maanantai;0;6;6
93;20.08.2018;2018;08;23;Maanantai;1;1;2
93;21.08.2018;2018;08;00;Tiistai;0;0;0
93;21.08.2018;2018;08;01;Tiistai;0;0;0
93;21.08.2018;2018;08;02;Tiistai;0;0;0
93;21.08.2018;2018;08;03;Tiistai;0;0;0
93;21.08.2018;2018;08;04;Tiistai;1;0;1
93;21.08.2018;2018;08;05;Tiistai;2;5;7
93;21.08.2018;2018;08;06;Tiistai;24;17;41
93;21.08.2018;2018;08;07;Tiistai;41;48;89
93;21.08.2018;2018;08;08;Tiistai;23;34;57
93;21.08.2018;2018;08;09;Tiistai;12;11;23
93;21.08.2018;2018;08;10;Tiistai;10;8;18
93;21.08.2018;2018;08;11;Tiistai;14;8;22
93;21.08.2018;2018;08;12;Tiistai;16;10;26
93;21.08.2018;2018;08;13;Tiistai;13;13;26
93;21.08.2018;2018;08;14;Tiistai;17;18;35
93;21.08.2018;2018;08;15;Tiistai;36;37;73
93;21.08.2018;2018;08;16;Tiistai;43;45;88
93;21.08.2018;2018;08;17;Tiistai;30;34;64
93;21.08.2018;2018;08;18;Tiistai;26;36;62
93;21.08.2018;2018;08;19;Tiistai;6;14;20
93;21.08.2018;2018;08;20;Tiistai;14;20;34
93;21.08.2018;2018;08;21;Tiistai;9;9;18
93;21.08.2018;2018;08;22;Tiistai;2;4;6
93;21.08.2018;2018;08;23;Tiistai;0;1;1
93;22.08.2018;2018;08;00;Keskiviikko;0;2;2
93;22.08.2018;2018;08;01;Keskiviikko;0;0;0
93;22.08.2018;2018;08;02;Keskiviikko;0;0;0
93;22.08.2018;2018;08;03;Keskiviikko;0;0;0
93;22.08.2018;2018;08;04;Keskiviikko;0;0;0
93;22.08.2018;2018;08;05;Keskiviikko;3;8;11
93;22.08.2018;2018;08;06;Keskiviikko;24;17;41
93;22.08.2018;2018;08;07;Keskiviikko;35;43;78
93;22.08.2018;2018;08;08;Keskiviikko;31;36;67
93;22.08.2018;2018;08;09;Keskiviikko;12;15;27
93;22.08.2018;2018;08;10;Keskiviikko;9;5;14
93;22.08.2018;2018;08;11;Keskiviikko;14;9;23
93;22.08.2018;2018;08;12;Keskiviikko;14;16;30
93;22.08.2018;2018;08;13;Keskiviikko;5;10;15
93;22.08.2018;2018;08;14;Keskiviikko;22;13;35
93;22.08.2018;2018;08;15;Keskiviikko;36;30;66
93;22.08.2018;2018;08;16;Keskiviikko;45;56;101
93;22.08.2018;2018;08;17;Keskiviikko;27;23;50
93;22.08.2018;2018;08;18;Keskiviikko;14;22;36
93;22.08.2018;2018;08;19;Keskiviikko;11;12;23
93;22.08.2018;2018;08;20;Keskiviikko;4;6;10
93;22.08.2018;2018;08;21;Keskiviikko;2;6;8
93;22.08.2018;2018;08;22;Keskiviikko;0;1;1
93;22.08.2018;2018;08;23;Keskiviikko;1;0;1
93;23.08.2018;2018;08;00;Torstai;0;0;0
93;23.08.2018;2018;08;01;Torstai;0;0;0
93;23.08.2018;2018;08;02;Torstai;0;1;1
93;23.08.2018;2018;08;03;Torstai;0;0;0
93;23.08.2018;2018;08;04;Torstai;1;0;1
93;23.08.2018;2018;08;05;Torstai;4;4;8
93;23.08.2018;2018;08;06;Torstai;14;10;24
93;23.08.2018;2018;08;07;Torstai;15;20;35
93;23.08.2018;2018;08;08;Torstai;5;19;24
93;23.08.2018;2018;08;09;Torstai;4;1;5
93;23.08.2018;2018;08;10;Torstai;1;2;3
93;23.08.2018;2018;08;11;Torstai;2;1;3
93;23.08.2018;2018;08;12;Torstai;5;1;6
93;23.08.2018;2018;08;13;Torstai;5;3;8
93;23.08.2018;2018;08;14;Torstai;9;5;14
93;23.08.2018;2018;08;15;Torstai;21;23;44
93;23.08.2018;2018;08;16;Torstai;26;22;48
93;23.08.2018;2018;08;17;Torstai;22;17;39
93;23.08.2018;2018;08;18;Torstai;11;19;30
93;23.08.2018;2018;08;19;Torstai;20;14;34
93;23.08.2018;2018;08;20;Torstai;15;9;24
93;23.08.2018;2018;08;21;Torstai;1;13;14
93;23.08.2018;2018;08;22;Torstai;0;3;3
93;23.08.2018;2018;08;23;Torstai;1;0;1
93;24.08.2018;2018;08;00;Perjantai;0;0;0
93;24.08.2018;2018;08;01;Perjantai;0;0;0
93;24.08.2018;2018;08;02;Perjantai;0;0;0
93;24.08.2018;2018;08;03;Perjantai;0;0;0
93;24.08.2018;2018;08;04;Perjantai;0;0;0
93;24.08.2018;2018;08;05;Perjantai;1;3;4
93;24.08.2018;2018;08;06;Perjantai;10;16;26
93;24.08.2018;2018;08;07;Perjantai;21;27;48
93;24.08.2018;2018;08;08;Perjantai;8;17;25
93;24.08.2018;2018;08;09;Perjantai;7;7;14
93;24.08.2018;2018;08;10;Perjantai;0;18;18
93;24.08.2018;2018;08;11;Perjantai;1;2;3
93;24.08.2018;2018;08;12;Perjantai;4;3;7
93;24.08.2018;2018;08;13;Perjantai;6;3;9
93;24.08.2018;2018;08;14;Perjantai;12;8;20
93;24.08.2018;2018;08;15;Perjantai;16;18;34
93;24.08.2018;2018;08;16;Perjantai;29;14;43
93;24.08.2018;2018;08;17;Perjantai;14;14;28
93;24.08.2018;2018;08;18;Perjantai;8;6;14
93;24.08.2018;2018;08;19;Perjantai;10;9;19
93;24.08.2018;2018;08;20;Perjantai;2;5;7
93;24.08.2018;2018;08;21;Perjantai;1;7;8
93;24.08.2018;2018;08;22;Perjantai;0;0;0
93;24.08.2018;2018;08;23;Perjantai;0;1;1
93;25.08.2018;2018;08;00;Lauantai;1;2;3
93;25.08.2018;2018;08;01;Lauantai;1;0;1
93;25.08.2018;2018;08;02;Lauantai;0;0;0
93;25.08.2018;2018;08;03;Lauantai;0;0;0
93;25.08.2018;2018;08;04;Lauantai;0;1;1
93;25.08.2018;2018;08;05;Lauantai;1;0;1
93;25.08.2018;2018;08;06;Lauantai;1;2;3
93;25.08.2018;2018;08;07;Lauantai;2;0;2
93;25.08.2018;2018;08;08;Lauantai;4;3;7
93;25.08.2018;2018;08;09;Lauantai;4;3;7
93;25.08.2018;2018;08;10;Lauantai;3;16;19
93;25.08.2018;2018;08;11;Lauantai;8;6;14
93;25.08.2018;2018;08;12;Lauantai;13;17;30
93;25.08.2018;2018;08;13;Lauantai;25;13;38
93;25.08.2018;2018;08;14;Lauantai;14;13;27
93;25.08.2018;2018;08;15;Lauantai;13;17;30
93;25.08.2018;2018;08;16;Lauantai;8;13;21
93;25.08.2018;2018;08;17;Lauantai;24;19;43
93;25.08.2018;2018;08;18;Lauantai;19;21;40
93;25.08.2018;2018;08;19;Lauantai;8;12;20
93;25.08.2018;2018;08;20;Lauantai;12;14;26
93;25.08.2018;2018;08;21;Lauantai;9;6;15
93;25.08.2018;2018;08;22;Lauantai;2;2;4
93;25.08.2018;2018;08;23;Lauantai;1;3;4
93;26.08.2018;2018;08;00;Sunnuntai;3;1;4
93;26.08.2018;2018;08;01;Sunnuntai;1;0;1
93;26.08.2018;2018;08;02;Sunnuntai;0;0;0
93;26.08.2018;2018;08;03;Sunnuntai;0;0;0
93;26.08.2018;2018;08;04;Sunnuntai;0;0;0
93;26.08.2018;2018;08;05;Sunnuntai;1;2;3
93;26.08.2018;2018;08;06;Sunnuntai;1;3;4
93;26.08.2018;2018;08;07;Sunnuntai;2;3;5
93;26.08.2018;2018;08;08;Sunnuntai;6;4;10
93;26.08.2018;2018;08;09;Sunnuntai;9;13;22
93;26.08.2018;2018;08;10;Sunnuntai;22;18;40
93;26.08.2018;2018;08;11;Sunnuntai;28;20;48
93;26.08.2018;2018;08;12;Sunnuntai;28;28;56
93;26.08.2018;2018;08;13;Sunnuntai;17;21;38
93;26.08.2018;2018;08;14;Sunnuntai;21;15;36
93;26.08.2018;2018;08;15;Sunnuntai;13;7;20
93;26.08.2018;2018;08;16;Sunnuntai;6;6;12
93;26.08.2018;2018;08;17;Sunnuntai;7;5;12
93;26.08.2018;2018;08;18;Sunnuntai;7;12;19
93;26.08.2018;2018;08;19;Sunnuntai;7;15;22
93;26.08.2018;2018;08;20;Sunnuntai;4;2;6
93;26.08.2018;2018;08;21;Sunnuntai;0;4;4
93;26.08.2018;2018;08;22;Sunnuntai;0;0;0
93;26.08.2018;2018;08;23;Sunnuntai;0;1;1
93;27.08.2018;2018;08;00;Maanantai;0;0;0
93;27.08.2018;2018;08;01;Maanantai;0;0;0
93;27.08.2018;2018;08;02;Maanantai;0;0;0
93;27.08.2018;2018;08;03;Maanantai;0;0;0
93;27.08.2018;2018;08;04;Maanantai;2;0;2
93;27.08.2018;2018;08;05;Maanantai;4;2;6
93;27.08.2018;2018;08;06;Maanantai;24;16;40
93;27.08.2018;2018;08;07;Maanantai;24;33;57
93;27.08.2018;2018;08;08;Maanantai;15;32;47
93;27.08.2018;2018;08;09;Maanantai;8;11;19
93;27.08.2018;2018;08;10;Maanantai;3;2;5
93;27.08.2018;2018;08;11;Maanantai;6;10;16
93;27.08.2018;2018;08;12;Maanantai;8;9;17
93;27.08.2018;2018;08;13;Maanantai;9;8;17
93;27.08.2018;2018;08;14;Maanantai;10;10;20
93;27.08.2018;2018;08;15;Maanantai;30;26;56
93;27.08.2018;2018;08;16;Maanantai;38;41;79
93;27.08.2018;2018;08;17;Maanantai;29;30;59
93;27.08.2018;2018;08;18;Maanantai;17;23;40
93;27.08.2018;2018;08;19;Maanantai;12;21;33
93;27.08.2018;2018;08;20;Maanantai;6;12;18
93;27.08.2018;2018;08;21;Maanantai;3;5;8
93;27.08.2018;2018;08;22;Maanantai;2;2;4
93;27.08.2018;2018;08;23;Maanantai;0;0;0
93;28.08.2018;2018;08;00;Tiistai;0;0;0
93;28.08.2018;2018;08;01;Tiistai;0;0;0
93;28.08.2018;2018;08;02;Tiistai;0;0;0
93;28.08.2018;2018;08;03;Tiistai;0;0;0
93;28.08.2018;2018;08;04;Tiistai;1;0;1
93;28.08.2018;2018;08;05;Tiistai;8;4;12
93;28.08.2018;2018;08;06;Tiistai;23;16;39
93;28.08.2018;2018;08;07;Tiistai;30;48;78
93;28.08.2018;2018;08;08;Tiistai;24;19;43
93;28.08.2018;2018;08;09;Tiistai;9;8;17
93;28.08.2018;2018;08;10;Tiistai;8;7;15
93;28.08.2018;2018;08;11;Tiistai;16;13;29
93;28.08.2018;2018;08;12;Tiistai;13;11;24
93;28.08.2018;2018;08;13;Tiistai;21;11;32
93;28.08.2018;2018;08;14;Tiistai;37;29;66
93;28.08.2018;2018;08;15;Tiistai;30;39;69
93;28.08.2018;2018;08;16;Tiistai;36;41;77
93;28.08.2018;2018;08;17;Tiistai;25;35;60
93;28.08.2018;2018;08;18;Tiistai;21;32;53
93;28.08.2018;2018;08;19;Tiistai;17;13;30
93;28.08.2018;2018;08;20;Tiistai;14;7;21
93;28.08.2018;2018;08;21;Tiistai;10;18;28
93;28.08.2018;2018;08;22;Tiistai;3;1;4
93;28.08.2018;2018;08;23;Tiistai;1;0;1
93;29.08.2018;2018;08;00;Keskiviikko;0;0;0
93;29.08.2018;2018;08;01;Keskiviikko;0;0;0
93;29.08.2018;2018;08;02;Keskiviikko;0;0;0
93;29.08.2018;2018;08;03;Keskiviikko;0;0;0
93;29.08.2018;2018;08;04;Keskiviikko;3;0;3
93;29.08.2018;2018;08;05;Keskiviikko;5;2;7
93;29.08.2018;2018;08;06;Keskiviikko;24;17;41
93;29.08.2018;2018;08;07;Keskiviikko;33;49;82
93;29.08.2018;2018;08;08;Keskiviikko;22;29;51
93;29.08.2018;2018;08;09;Keskiviikko;19;13;32
93;29.08.2018;2018;08;10;Keskiviikko;7;10;17
93;29.08.2018;2018;08;11;Keskiviikko;15;8;23
93;29.08.2018;2018;08;12;Keskiviikko;14;12;26
93;29.08.2018;2018;08;13;Keskiviikko;21;13;34
93;29.08.2018;2018;08;14;Keskiviikko;17;24;41
93;29.08.2018;2018;08;15;Keskiviikko;36;39;75
93;29.08.2018;2018;08;16;Keskiviikko;44;44;88
93;29.08.2018;2018;08;17;Keskiviikko;38;48;86
93;29.08.2018;2018;08;18;Keskiviikko;22;31;53
93;29.08.2018;2018;08;19;Keskiviikko;28;21;49
93;29.08.2018;2018;08;20;Keskiviikko;13;17;30
93;29.08.2018;2018;08;21;Keskiviikko;11;6;17
93;29.08.2018;2018;08;22;Keskiviikko;1;0;1
93;29.08.2018;2018;08;23;Keskiviikko;2;0;2
93;30.08.2018;2018;08;00;Torstai;0;1;1
93;30.08.2018;2018;08;01;Torstai;0;0;0
93;30.08.2018;2018;08;02;Torstai;0;0;0
93;30.08.2018;2018;08;03;Torstai;0;0;0
93;30.08.2018;2018;08;04;Torstai;0;0;0
93;30.08.2018;2018;08;05;Torstai;2;3;5
93;30.08.2018;2018;08;06;Torstai;24;16;40
93;30.08.2018;2018;08;07;Torstai;34;43;77
93;30.08.2018;2018;08;08;Torstai;22;21;43
93;30.08.2018;2018;08;09;Torstai;15;11;26
93;30.08.2018;2018;08;10;Torstai;17;9;26
93;30.08.2018;2018;08;11;Torstai;7;11;18
93;30.08.2018;2018;08;12;Torstai;19;14;33
93;30.08.2018;2018;08;13;Torstai;8;16;24
93;30.08.2018;2018;08;14;Torstai;15;18;33
93;30.08.2018;2018;08;15;Torstai;30;37;67
93;30.08.2018;2018;08;16;Torstai;36;29;65
93;30.08.2018;2018;08;17;Torstai;25;19;44
93;30.08.2018;2018;08;18;Torstai;6;18;24
93;30.08.2018;2018;08;19;Torstai;17;8;25
93;30.08.2018;2018;08;20;Torstai;2;5;7
93;30.08.2018;2018;08;21;Torstai;6;6;12
93;30.08.2018;2018;08;22;Torstai;0;2;2
93;30.08.2018;2018;08;23;Torstai;2;1;3
93;31.08.2018;2018;08;00;Perjantai;0;0;0
93;31.08.2018;2018;08;01;Perjantai;0;0;0
93;31.08.2018;2018;08;02;Perjantai;0;1;1
93;31.08.2018;2018;08;03;Perjantai;0;0;0
93;31.08.2018;2018;08;04;Perjantai;1;0;1
93;31.08.2018;2018;08;05;Perjantai;2;3;5
93;31.08.2018;2018;08;06;Perjantai;20;8;28
93;31.08.2018;2018;08;07;Perjantai;26;36;62
93;31.08.2018;2018;08;08;Perjantai;30;17;47
93;31.08.2018;2018;08;09;Perjantai;5;9;14
93;31.08.2018;2018;08;10;Perjantai;10;3;13
93;31.08.2018;2018;08;11;Perjantai;11;14;25
93;31.08.2018;2018;08;12;Perjantai;13;11;24
93;31.08.2018;2018;08;13;Perjantai;8;15;23
93;31.08.2018;2018;08;14;Perjantai;16;18;34
93;31.08.2018;2018;08;15;Perjantai;25;25;50
93;31.08.2018;2018;08;16;Perjantai;29;29;58
93;31.08.2018;2018;08;17;Perjantai;19;20;39
93;31.08.2018;2018;08;18;Perjantai;17;22;39
93;31.08.2018;2018;08;19;Perjantai;13;25;38
93;31.08.2018;2018;08;20;Perjantai;16;8;24
93;31.08.2018;2018;08;21;Perjantai;8;11;19
93;31.08.2018;2018;08;22;Perjantai;1;5;6
93;31.08.2018;2018;08;23;Perjantai;0;4;4
93;01.09.2018;2018;09;00;Lauantai;1;5;6
93;01.09.2018;2018;09;01;Lauantai;0;3;3
93;01.09.2018;2018;09;02;Lauantai;1;0;1
93;01.09.2018;2018;09;03;Lauantai;0;1;1
93;01.09.2018;2018;09;04;Lauantai;0;0;0
93;01.09.2018;2018;09;05;Lauantai;0;0;0
93;01.09.2018;2018;09;06;Lauantai;0;0;0
93;01.09.2018;2018;09;07;Lauantai;1;1;2
93;01.09.2018;2018;09;08;Lauantai;3;5;8
93;01.09.2018;2018;09;09;Lauantai;10;8;18
93;01.09.2018;2018;09;10;Lauantai;14;14;28
93;01.09.2018;2018;09;11;Lauantai;11;17;28
93;01.09.2018;2018;09;12;Lauantai;15;23;38
93;01.09.2018;2018;09;13;Lauantai;34;31;65
93;01.09.2018;2018;09;14;Lauantai;18;29;47
93;01.09.2018;2018;09;15;Lauantai;30;17;47
93;01.09.2018;2018;09;16;Lauantai;18;20;38
93;01.09.2018;2018;09;17;Lauantai;22;17;39
93;01.09.2018;2018;09;18;Lauantai;4;13;17
93;01.09.2018;2018;09;19;Lauantai;21;16;37
93;01.09.2018;2018;09;20;Lauantai;13;7;20
93;01.09.2018;2018;09;21;Lauantai;7;12;19
93;01.09.2018;2018;09;22;Lauantai;4;8;12
93;01.09.2018;2018;09;23;Lauantai;3;10;13
93;02.09.2018;2018;09;00;Sunnuntai;0;3;3
93;02.09.2018;2018;09;01;Sunnuntai;1;0;1
93;02.09.2018;2018;09;02;Sunnuntai;0;0;0
93;02.09.2018;2018;09;03;Sunnuntai;1;0;1
93;02.09.2018;2018;09;04;Sunnuntai;1;0;1
93;02.09.2018;2018;09;05;Sunnuntai;0;0;0
93;02.09.2018;2018;09;06;Sunnuntai;1;3;4
93;02.09.2018;2018;09;07;Sunnuntai;1;6;7
93;02.09.2018;2018;09;08;Sunnuntai;3;3;6
93;02.09.2018;2018;09;09;Sunnuntai;9;5;14
93;02.09.2018;2018;09;10;Sunnuntai;13;10;23
93;02.09.2018;2018;09;11;Sunnuntai;26;16;42
93;02.09.2018;2018;09;12;Sunnuntai;26;19;45
93;02.09.2018;2018;09;13;Sunnuntai;30;27;57
93;02.09.2018;2018;09;14;Sunnuntai;33;16;49
93;02.09.2018;2018;09;15;Sunnuntai;24;29;53
93;02.09.2018;2018;09;16;Sunnuntai;18;15;33
93;02.09.2018;2018;09;17;Sunnuntai;5;17;22
93;02.09.2018;2018;09;18;Sunnuntai;15;24;39
93;02.09.2018;2018;09;19;Sunnuntai;20;17;37
93;02.09.2018;2018;09;20;Sunnuntai;18;13;31
93;02.09.2018;2018;09;21;Sunnuntai;7;3;10
93;02.09.2018;2018;09;22;Sunnuntai;2;6;8
93;02.09.2018;2018;09;23;Sunnuntai;0;0;0
93;03.09.2018;2018;09;00;Maanantai;0;0;0
93;03.09.2018;2018;09;01;Maanantai;1;2;3
93;03.09.2018;2018;09;02;Maanantai;0;0;0
93;03.09.2018;2018;09;03;Maanantai;0;0;0
93;03.09.2018;2018;09;04;Maanantai;0;0;0
93;03.09.2018;2018;09;05;Maanantai;5;4;9
93;03.09.2018;2018;09;06;Maanantai;28;14;42
93;03.09.2018;2018;09;07;Maanantai;38;50;88
93;03.09.2018;2018;09;08;Maanantai;28;29;57
93;03.09.2018;2018;09;09;Maanantai;12;9;21
93;03.09.2018;2018;09;10;Maanantai;15;6;21
93;03.09.2018;2018;09;11;Maanantai;8;13;21
93;03.09.2018;2018;09;12;Maanantai;13;9;22
93;03.09.2018;2018;09;13;Maanantai;16;11;27
93;03.09.2018;2018;09;14;Maanantai;21;20;41
93;03.09.2018;2018;09;15;Maanantai;36;34;70
93;03.09.2018;2018;09;16;Maanantai;50;46;96
93;03.09.2018;2018;09;17;Maanantai;31;38;69
93;03.09.2018;2018;09;18;Maanantai;26;32;58
93;03.09.2018;2018;09;19;Maanantai;18;37;55
93;03.09.2018;2018;09;20;Maanantai;14;13;27
93;03.09.2018;2018;09;21;Maanantai;4;9;13
93;03.09.2018;2018;09;22;Maanantai;1;4;5
93;03.09.2018;2018;09;23;Maanantai;0;1;1
93;04.09.2018;2018;09;00;Tiistai;1;0;1
93;04.09.2018;2018;09;01;Tiistai;0;0;0
93;04.09.2018;2018;09;02;Tiistai;0;2;2
93;04.09.2018;2018;09;03;Tiistai;0;0;0
93;04.09.2018;2018;09;04;Tiistai;1;0;1
93;04.09.2018;2018;09;05;Tiistai;2;5;7
93;04.09.2018;2018;09;06;Tiistai;31;16;47
93;04.09.2018;2018;09;07;Tiistai;50;54;104
93;04.09.2018;2018;09;08;Tiistai;19;37;56
93;04.09.2018;2018;09;09;Tiistai;35;34;69
93;04.09.2018;2018;09;10;Tiistai;35;28;63
93;04.09.2018;2018;09;11;Tiistai;35;19;54
93;04.09.2018;2018;09;12;Tiistai;10;40;50
93;04.09.2018;2018;09;13;Tiistai;49;34;83
93;04.09.2018;2018;09;14;Tiistai;39;27;66
93;04.09.2018;2018;09;15;Tiistai;35;45;80
93;04.09.2018;2018;09;16;Tiistai;44;47;91
93;04.09.2018;2018;09;17;Tiistai;25;35;60
93;04.09.2018;2018;09;18;Tiistai;21;31;52
93;04.09.2018;2018;09;19;Tiistai;23;25;48
93;04.09.2018;2018;09;20;Tiistai;13;14;27
93;04.09.2018;2018;09;21;Tiistai;1;9;10
93;04.09.2018;2018;09;22;Tiistai;3;2;5
93;04.09.2018;2018;09;23;Tiistai;1;0;1
93;05.09.2018;2018;09;00;Keskiviikko;0;0;0
93;05.09.2018;2018;09;01;Keskiviikko;0;1;1
93;05.09.2018;2018;09;02;Keskiviikko;0;0;0
93;05.09.2018;2018;09;03;Keskiviikko;0;0;0
93;05.09.2018;2018;09;04;Keskiviikko;1;0;1
93;05.09.2018;2018;09;05;Keskiviikko;3;4;7
93;05.09.2018;2018;09;06;Keskiviikko;24;19;43
93;05.09.2018;2018;09;07;Keskiviikko;33;35;68
93;05.09.2018;2018;09;08;Keskiviikko;15;24;39
93;05.09.2018;2018;09;09;Keskiviikko;13;8;21
93;05.09.2018;2018;09;10;Keskiviikko;10;4;14
93;05.09.2018;2018;09;11;Keskiviikko;11;7;18
93;05.09.2018;2018;09;12;Keskiviikko;5;11;16
93;05.09.2018;2018;09;13;Keskiviikko;14;15;29
93;05.09.2018;2018;09;14;Keskiviikko;16;18;34
93;05.09.2018;2018;09;15;Keskiviikko;29;35;64
93;05.09.2018;2018;09;16;Keskiviikko;40;44;84
93;05.09.2018;2018;09;17;Keskiviikko;21;31;52
93;05.09.2018;2018;09;18;Keskiviikko;11;18;29
93;05.09.2018;2018;09;19;Keskiviikko;23;19;42
93;05.09.2018;2018;09;20;Keskiviikko;14;19;33
93;05.09.2018;2018;09;21;Keskiviikko;4;5;9
93;05.09.2018;2018;09;22;Keskiviikko;4;1;5
93;05.09.2018;2018;09;23;Keskiviikko;1;1;2
93;06.09.2018;2018;09;00;Torstai;0;1;1
93;06.09.2018;2018;09;01;Torstai;0;0;0
93;06.09.2018;2018;09;02;Torstai;0;0;0
93;06.09.2018;2018;09;03;Torstai;0;0;0
93;06.09.2018;2018;09;04;Torstai;0;0;0
93;06.09.2018;2018;09;05;Torstai;2;4;6
93;06.09.2018;2018;09;06;Torstai;19;13;32
93;06.09.2018;2018;09;07;Torstai;24;35;59
93;06.09.2018;2018;09;08;Torstai;12;22;34
93;06.09.2018;2018;09;09;Torstai;9;9;18
93;06.09.2018;2018;09;10;Torstai;7;4;11
93;06.09.2018;2018;09;11;Torstai;4;4;8
93;06.09.2018;2018;09;12;Torstai;2;9;11
93;06.09.2018;2018;09;13;Torstai;14;13;27
93;06.09.2018;2018;09;14;Torstai;19;14;33
93;06.09.2018;2018;09;15;Torstai;27;30;57
93;06.09.2018;2018;09;16;Torstai;36;33;69
93;06.09.2018;2018;09;17;Torstai;26;17;43
93;06.09.2018;2018;09;18;Torstai;12;19;31
93;06.09.2018;2018;09;19;Torstai;8;14;22
93;06.09.2018;2018;09;20;Torstai;4;12;16
93;06.09.2018;2018;09;21;Torstai;4;3;7
93;06.09.2018;2018;09;22;Torstai;0;2;2
93;06.09.2018;2018;09;23;Torstai;1;0;1
93;07.09.2018;2018;09;00;Perjantai;0;2;2
93;07.09.2018;2018;09;01;Perjantai;0;0;0
93;07.09.2018;2018;09;02;Perjantai;0;0;0
93;07.09.2018;2018;09;03;Perjantai;0;0;0
93;07.09.2018;2018;09;04;Perjantai;0;1;1
93;07.09.2018;2018;09;05;Perjantai;3;5;8
93;07.09.2018;2018;09;06;Perjantai;26;14;40
93;07.09.2018;2018;09;07;Perjantai;27;26;53
93;07.09.2018;2018;09;08;Perjantai;16;20;36
93;07.09.2018;2018;09;09;Perjantai;10;8;18
93;07.09.2018;2018;09;10;Perjantai;7;6;13
93;07.09.2018;2018;09;11;Perjantai;9;10;19
93;07.09.2018;2018;09;12;Perjantai;14;15;29
93;07.09.2018;2018;09;13;Perjantai;18;15;33
93;07.09.2018;2018;09;14;Perjantai;15;28;43
93;07.09.2018;2018;09;15;Perjantai;31;27;58
93;07.09.2018;2018;09;16;Perjantai;22;37;59
93;07.09.2018;2018;09;17;Perjantai;23;15;38
93;07.09.2018;2018;09;18;Perjantai;18;24;42
93;07.09.2018;2018;09;19;Perjantai;28;14;42
93;07.09.2018;2018;09;20;Perjantai;11;10;21
93;07.09.2018;2018;09;21;Perjantai;3;6;9
93;07.09.2018;2018;09;22;Perjantai;1;3;4
93;07.09.2018;2018;09;23;Perjantai;1;4;5
93;08.09.2018;2018;09;00;Lauantai;1;1;2
93;08.09.2018;2018;09;01;Lauantai;0;1;1
93;08.09.2018;2018;09;02;Lauantai;0;1;1
93;08.09.2018;2018;09;03;Lauantai;0;0;0
93;08.09.2018;2018;09;04;Lauantai;0;1;1
93;08.09.2018;2018;09;05;Lauantai;1;0;1
93;08.09.2018;2018;09;06;Lauantai;3;4;7
93;08.09.2018;2018;09;07;Lauantai;3;6;9
93;08.09.2018;2018;09;08;Lauantai;5;1;6
93;08.09.2018;2018;09;09;Lauantai;9;5;14
93;08.09.2018;2018;09;10;Lauantai;8;21;29
93;08.09.2018;2018;09;11;Lauantai;16;10;26
93;08.09.2018;2018;09;12;Lauantai;16;10;26
93;08.09.2018;2018;09;13;Lauantai;14;15;29
93;08.09.2018;2018;09;14;Lauantai;18;12;30
93;08.09.2018;2018;09;15;Lauantai;10;20;30
93;08.09.2018;2018;09;16;Lauantai;20;24;44
93;08.09.2018;2018;09;17;Lauantai;11;10;21
93;08.09.2018;2018;09;18;Lauantai;13;8;21
93;08.09.2018;2018;09;19;Lauantai;13;18;31
93;08.09.2018;2018;09;20;Lauantai;5;11;16
93;08.09.2018;2018;09;21;Lauantai;3;5;8
93;08.09.2018;2018;09;22;Lauantai;4;5;9
93;08.09.2018;2018;09;23;Lauantai;0;3;3
93;09.09.2018;2018;09;00;Sunnuntai;0;0;0
93;09.09.2018;2018;09;01;Sunnuntai;3;0;3
93;09.09.2018;2018;09;02;Sunnuntai;0;0;0
93;09.09.2018;2018;09;03;Sunnuntai;0;0;0
93;09.09.2018;2018;09;04;Sunnuntai;0;0;0
93;09.09.2018;2018;09;05;Sunnuntai;0;0;0
93;09.09.2018;2018;09;06;Sunnuntai;2;0;2
93;09.09.2018;2018;09;07;Sunnuntai;1;4;5
93;09.09.2018;2018;09;08;Sunnuntai;2;10;12
93;09.09.2018;2018;09;09;Sunnuntai;7;4;11
93;09.09.2018;2018;09;10;Sunnuntai;18;6;24
93;09.09.2018;2018;09;11;Sunnuntai;19;19;38
93;09.09.2018;2018;09;12;Sunnuntai;20;26;46
93;09.09.2018;2018;09;13;Sunnuntai;24;26;50
93;09.09.2018;2018;09;14;Sunnuntai;24;26;50
93;09.09.2018;2018;09;15;Sunnuntai;17;20;37
93;09.09.2018;2018;09;16;Sunnuntai;28;26;54
93;09.09.2018;2018;09;17;Sunnuntai;24;21;45
93;09.09.2018;2018;09;18;Sunnuntai;22;17;39
93;09.09.2018;2018;09;19;Sunnuntai;10;13;23
93;09.09.2018;2018;09;20;Sunnuntai;8;9;17
93;09.09.2018;2018;09;21;Sunnuntai;6;5;11
93;09.09.2018;2018;09;22;Sunnuntai;1;1;2
93;09.09.2018;2018;09;23;Sunnuntai;0;1;1
93;10.09.2018;2018;09;00;Maanantai;2;0;2
93;10.09.2018;2018;09;01;Maanantai;0;0;0
93;10.09.2018;2018;09;02;Maanantai;0;0;0
93;10.09.2018;2018;09;03;Maanantai;0;0;0
93;10.09.2018;2018;09;04;Maanantai;0;0;0
93;10.09.2018;2018;09;05;Maanantai;5;3;8
93;10.09.2018;2018;09;06;Maanantai;30;17;47
93;10.09.2018;2018;09;07;Maanantai;38;33;71
93;10.09.2018;2018;09;08;Maanantai;19;29;48
93;10.09.2018;2018;09;09;Maanantai;11;8;19
93;10.09.2018;2018;09;10;Maanantai;10;3;13
93;10.09.2018;2018;09;11;Maanantai;6;9;15
93;10.09.2018;2018;09;12;Maanantai;19;10;29
93;10.09.2018;2018;09;13;Maanantai;12;9;21
93;10.09.2018;2018;09;14;Maanantai;18;15;33
93;10.09.2018;2018;09;15;Maanantai;30;38;68
93;10.09.2018;2018;09;16;Maanantai;37;45;82
93;10.09.2018;2018;09;17;Maanantai;34;38;72
93;10.09.2018;2018;09;18;Maanantai;25;27;52
93;10.09.2018;2018;09;19;Maanantai;13;24;37
93;10.09.2018;2018;09;20;Maanantai;5;18;23
93;10.09.2018;2018;09;21;Maanantai;7;9;16
93;10.09.2018;2018;09;22;Maanantai;4;4;8
93;10.09.2018;2018;09;23;Maanantai;0;0;0
93;11.09.2018;2018;09;00;Tiistai;3;1;4
93;11.09.2018;2018;09;01;Tiistai;0;0;0
93;11.09.2018;2018;09;02;Tiistai;0;0;0
93;11.09.2018;2018;09;03;Tiistai;0;1;1
93;11.09.2018;2018;09;04;Tiistai;0;0;0
93;11.09.2018;2018;09;05;Tiistai;2;3;5
93;11.09.2018;2018;09;06;Tiistai;21;13;34
93;11.09.2018;2018;09;07;Tiistai;33;31;64
93;11.09.2018;2018;09;08;Tiistai;9;23;32
93;11.09.2018;2018;09;09;Tiistai;7;4;11
93;11.09.2018;2018;09;10;Tiistai;5;6;11
93;11.09.2018;2018;09;11;Tiistai;5;7;12
93;11.09.2018;2018;09;12;Tiistai;9;11;20
93;11.09.2018;2018;09;13;Tiistai;9;7;16
93;11.09.2018;2018;09;14;Tiistai;11;13;24
93;11.09.2018;2018;09;15;Tiistai;17;21;38
93;11.09.2018;2018;09;16;Tiistai;34;28;62
93;11.09.2018;2018;09;17;Tiistai;10;14;24
93;11.09.2018;2018;09;18;Tiistai;3;8;11
93;11.09.2018;2018;09;19;Tiistai;2;3;5
93;11.09.2018;2018;09;20;Tiistai;3;4;7
93;11.09.2018;2018;09;21;Tiistai;1;4;5
93;11.09.2018;2018;09;22;Tiistai;6;1;7
93;11.09.2018;2018;09;23;Tiistai;1;0;1
93;12.09.2018;2018;09;00;Keskiviikko;0;0;0
93;12.09.2018;2018;09;01;Keskiviikko;0;0;0
93;12.09.2018;2018;09;02;Keskiviikko;0;0;0
93;12.09.2018;2018;09;03;Keskiviikko;0;0;0
93;12.09.2018;2018;09;04;Keskiviikko;0;1;1
93;12.09.2018;2018;09;05;Keskiviikko;2;3;5
93;12.09.2018;2018;09;06;Keskiviikko;10;7;17
93;12.09.2018;2018;09;07;Keskiviikko;20;24;44
93;12.09.2018;2018;09;08;Keskiviikko;13;20;33
93;12.09.2018;2018;09;09;Keskiviikko;3;4;7
93;12.09.2018;2018;09;10;Keskiviikko;6;2;8
93;12.09.2018;2018;09;11;Keskiviikko;7;3;10
93;12.09.2018;2018;09;12;Keskiviikko;7;4;11
93;12.09.2018;2018;09;13;Keskiviikko;5;6;11
93;12.09.2018;2018;09;14;Keskiviikko;6;2;8
93;12.09.2018;2018;09;15;Keskiviikko;17;21;38
93;12.09.2018;2018;09;16;Keskiviikko;21;14;35
93;12.09.2018;2018;09;17;Keskiviikko;13;7;20
93;12.09.2018;2018;09;18;Keskiviikko;6;7;13
93;12.09.2018;2018;09;19;Keskiviikko;5;3;8
93;12.09.2018;2018;09;20;Keskiviikko;2;8;10
93;12.09.2018;2018;09;21;Keskiviikko;4;6;10
93;12.09.2018;2018;09;22;Keskiviikko;3;1;4
93;12.09.2018;2018;09;23;Keskiviikko;1;0;1
93;13.09.2018;2018;09;00;Torstai;0;0;0
93;13.09.2018;2018;09;01;Torstai;0;0;0
93;13.09.2018;2018;09;02;Torstai;0;0;0
93;13.09.2018;2018;09;03;Torstai;0;0;0
93;13.09.2018;2018;09;04;Torstai;0;0;0
93;13.09.2018;2018;09;05;Torstai;7;5;12
93;13.09.2018;2018;09;06;Torstai;23;12;35
93;13.09.2018;2018;09;07;Torstai;23;33;56
93;13.09.2018;2018;09;08;Torstai;18;14;32
93;13.09.2018;2018;09;09;Torstai;11;9;20
93;13.09.2018;2018;09;10;Torstai;14;2;16
93;13.09.2018;2018;09;11;Torstai;7;6;13
93;13.09.2018;2018;09;12;Torstai;5;4;9
93;13.09.2018;2018;09;13;Torstai;4;15;19
93;13.09.2018;2018;09;14;Torstai;14;14;28
93;13.09.2018;2018;09;15;Torstai;22;32;54
93;13.09.2018;2018;09;16;Torstai;38;40;78
93;13.09.2018;2018;09;17;Torstai;22;16;38
93;13.09.2018;2018;09;18;Torstai;19;23;42
93;13.09.2018;2018;09;19;Torstai;16;14;30
93;13.09.2018;2018;09;20;Torstai;20;11;31
93;13.09.2018;2018;09;21;Torstai;2;5;7
93;13.09.2018;2018;09;22;Torstai;2;1;3
93;13.09.2018;2018;09;23;Torstai;0;0;0
93;14.09.2018;2018;09;00;Perjantai;1;0;1
93;14.09.2018;2018;09;01;Perjantai;0;0;0
93;14.09.2018;2018;09;02;Perjantai;0;0;0
93;14.09.2018;2018;09;03;Perjantai;0;0;0
93;14.09.2018;2018;09;04;Perjantai;0;3;3
93;14.09.2018;2018;09;05;Perjantai;2;4;6
93;14.09.2018;2018;09;06;Perjantai;19;13;32
93;14.09.2018;2018;09;07;Perjantai;28;31;59
93;14.09.2018;2018;09;08;Perjantai;14;23;37
93;14.09.2018;2018;09;09;Perjantai;9;3;12
93;14.09.2018;2018;09;10;Perjantai;12;7;19
93;14.09.2018;2018;09;11;Perjantai;13;6;19
93;14.09.2018;2018;09;12;Perjantai;6;11;17
93;14.09.2018;2018;09;13;Perjantai;16;8;24
93;14.09.2018;2018;09;14;Perjantai;14;21;35
93;14.09.2018;2018;09;15;Perjantai;26;20;46
93;14.09.2018;2018;09;16;Perjantai;21;28;49
93;14.09.2018;2018;09;17;Perjantai;13;11;24
93;14.09.2018;2018;09;18;Perjantai;8;5;13
93;14.09.2018;2018;09;19;Perjantai;8;7;15
93;14.09.2018;2018;09;20;Perjantai;5;10;15
93;14.09.2018;2018;09;21;Perjantai;2;5;7
93;14.09.2018;2018;09;22;Perjantai;2;4;6
93;14.09.2018;2018;09;23;Perjantai;1;2;3
93;15.09.2018;2018;09;00;Lauantai;2;2;4
93;15.09.2018;2018;09;01;Lauantai;2;2;4
93;15.09.2018;2018;09;02;Lauantai;0;1;1
93;15.09.2018;2018;09;03;Lauantai;0;1;1
93;15.09.2018;2018;09;04;Lauantai;0;0;0
93;15.09.2018;2018;09;05;Lauantai;1;0;1
93;15.09.2018;2018;09;06;Lauantai;0;1;1
93;15.09.2018;2018;09;07;Lauantai;1;2;3
93;15.09.2018;2018;09;08;Lauantai;4;2;6
93;15.09.2018;2018;09;09;Lauantai;6;1;7
93;15.09.2018;2018;09;10;Lauantai;5;11;16
93;15.09.2018;2018;09;11;Lauantai;10;7;17
93;15.09.2018;2018;09;12;Lauantai;3;8;11
93;15.09.2018;2018;09;13;Lauantai;2;3;5
93;15.09.2018;2018;09;14;Lauantai;7;2;9
93;15.09.2018;2018;09;15;Lauantai;3;6;9
93;15.09.2018;2018;09;16;Lauantai;3;5;8
93;15.09.2018;2018;09;17;Lauantai;4;2;6
93;15.09.2018;2018;09;18;Lauantai;3;6;9
93;15.09.2018;2018;09;19;Lauantai;3;0;3
93;15.09.2018;2018;09;20;Lauantai;8;3;11
93;15.09.2018;2018;09;21;Lauantai;1;3;4
93;15.09.2018;2018;09;22;Lauantai;3;4;7
93;15.09.2018;2018;09;23;Lauantai;6;1;7
93;16.09.2018;2018;09;00;Sunnuntai;1;2;3
93;16.09.2018;2018;09;01;Sunnuntai;1;0;1
93;16.09.2018;2018;09;02;Sunnuntai;0;0;0
93;16.09.2018;2018;09;03;Sunnuntai;0;1;1
93;16.09.2018;2018;09;04;Sunnuntai;0;0;0
93;16.09.2018;2018;09;05;Sunnuntai;1;0;1
93;16.09.2018;2018;09;06;Sunnuntai;2;0;2
93;16.09.2018;2018;09;07;Sunnuntai;1;4;5
93;16.09.2018;2018;09;08;Sunnuntai;1;1;2
93;16.09.2018;2018;09;09;Sunnuntai;11;2;13
93;16.09.2018;2018;09;10;Sunnuntai;10;11;21
93;16.09.2018;2018;09;11;Sunnuntai;12;17;29
93;16.09.2018;2018;09;12;Sunnuntai;22;16;38
93;16.09.2018;2018;09;13;Sunnuntai;23;14;37
93;16.09.2018;2018;09;14;Sunnuntai;16;16;32
93;16.09.2018;2018;09;15;Sunnuntai;10;11;21
93;16.09.2018;2018;09;16;Sunnuntai;10;14;24
93;16.09.2018;2018;09;17;Sunnuntai;9;10;19
93;16.09.2018;2018;09;18;Sunnuntai;4;12;16
93;16.09.2018;2018;09;19;Sunnuntai;5;6;11
93;16.09.2018;2018;09;20;Sunnuntai;7;2;9
93;16.09.2018;2018;09;21;Sunnuntai;4;5;9
93;16.09.2018;2018;09;22;Sunnuntai;0;2;2
93;16.09.2018;2018;09;23;Sunnuntai;0;1;1
93;17.09.2018;2018;09;00;Maanantai;0;0;0
93;17.09.2018;2018;09;01;Maanantai;0;0;0
93;17.09.2018;2018;09;02;Maanantai;0;0;0
93;17.09.2018;2018;09;03;Maanantai;0;0;0
93;17.09.2018;2018;09;04;Maanantai;0;0;0
93;17.09.2018;2018;09;05;Maanantai;6;3;9
93;17.09.2018;2018;09;06;Maanantai;16;11;27
93;17.09.2018;2018;09;07;Maanantai;24;32;56
93;17.09.2018;2018;09;08;Maanantai;19;27;46
93;17.09.2018;2018;09;09;Maanantai;11;10;21
93;17.09.2018;2018;09;10;Maanantai;11;2;13
93;17.09.2018;2018;09;11;Maanantai;9;14;23
93;17.09.2018;2018;09;12;Maanantai;6;8;14
93;17.09.2018;2018;09;13;Maanantai;12;7;19
93;17.09.2018;2018;09;14;Maanantai;20;14;34
93;17.09.2018;2018;09;15;Maanantai;18;23;41
93;17.09.2018;2018;09;16;Maanantai;37;32;69
93;17.09.2018;2018;09;17;Maanantai;17;25;42
93;17.09.2018;2018;09;18;Maanantai;14;7;21
93;17.09.2018;2018;09;19;Maanantai;6;9;15
93;17.09.2018;2018;09;20;Maanantai;7;6;13
93;17.09.2018;2018;09;21;Maanantai;1;2;3
93;17.09.2018;2018;09;22;Maanantai;0;1;1
93;17.09.2018;2018;09;23;Maanantai;0;1;1
93;18.09.2018;2018;09;00;Tiistai;0;0;0
93;18.09.2018;2018;09;01;Tiistai;0;0;0
93;18.09.2018;2018;09;02;Tiistai;0;0;0
93;18.09.2018;2018;09;03;Tiistai;0;0;0
93;18.09.2018;2018;09;04;Tiistai;0;0;0
93;18.09.2018;2018;09;05;Tiistai;6;6;12
93;18.09.2018;2018;09;06;Tiistai;24;15;39
93;18.09.2018;2018;09;07;Tiistai;31;39;70
93;18.09.2018;2018;09;08;Tiistai;14;16;30
93;18.09.2018;2018;09;09;Tiistai;14;7;21
93;18.09.2018;2018;09;10;Tiistai;12;8;20
93;18.09.2018;2018;09;11;Tiistai;7;13;20
93;18.09.2018;2018;09;12;Tiistai;9;12;21
93;18.09.2018;2018;09;13;Tiistai;18;16;34
93;18.09.2018;2018;09;14;Tiistai;14;16;30
93;18.09.2018;2018;09;15;Tiistai;29;31;60
93;18.09.2018;2018;09;16;Tiistai;31;32;63
93;18.09.2018;2018;09;17;Tiistai;24;22;46
93;18.09.2018;2018;09;18;Tiistai;17;18;35
93;18.09.2018;2018;09;19;Tiistai;22;17;39
93;18.09.2018;2018;09;20;Tiistai;10;10;20
93;18.09.2018;2018;09;21;Tiistai;6;4;10
93;18.09.2018;2018;09;22;Tiistai;2;5;7
93;18.09.2018;2018;09;23;Tiistai;0;0;0
93;19.09.2018;2018;09;00;Keskiviikko;1;0;1
93;19.09.2018;2018;09;01;Keskiviikko;0;0;0
93;19.09.2018;2018;09;02;Keskiviikko;0;0;0
93;19.09.2018;2018;09;03;Keskiviikko;0;0;0
93;19.09.2018;2018;09;04;Keskiviikko;1;0;1
93;19.09.2018;2018;09;05;Keskiviikko;1;7;8
93;19.09.2018;2018;09;06;Keskiviikko;11;16;27
93;19.09.2018;2018;09;07;Keskiviikko;16;25;41
93;19.09.2018;2018;09;08;Keskiviikko;16;14;30
93;19.09.2018;2018;09;09;Keskiviikko;7;8;15
93;19.09.2018;2018;09;10;Keskiviikko;8;3;11
93;19.09.2018;2018;09;11;Keskiviikko;4;5;9
93;19.09.2018;2018;09;12;Keskiviikko;2;3;5
93;19.09.2018;2018;09;13;Keskiviikko;4;5;9
93;19.09.2018;2018;09;14;Keskiviikko;12;4;16
93;19.09.2018;2018;09;15;Keskiviikko;32;17;49
93;19.09.2018;2018;09;16;Keskiviikko;22;15;37
93;19.09.2018;2018;09;17;Keskiviikko;12;10;22
93;19.09.2018;2018;09;18;Keskiviikko;5;13;18
93;19.09.2018;2018;09;19;Keskiviikko;4;7;11
93;19.09.2018;2018;09;20;Keskiviikko;6;7;13
93;19.09.2018;2018;09;21;Keskiviikko;1;2;3
93;19.09.2018;2018;09;22;Keskiviikko;2;1;3
93;19.09.2018;2018;09;23;Keskiviikko;0;0;0
93;20.09.2018;2018;09;00;Torstai;1;2;3
93;20.09.2018;2018;09;01;Torstai;2;0;2
93;20.09.2018;2018;09;02;Torstai;0;0;0
93;20.09.2018;2018;09;03;Torstai;0;0;0
93;20.09.2018;2018;09;04;Torstai;1;1;2
93;20.09.2018;2018;09;05;Torstai;1;7;8
93;20.09.2018;2018;09;06;Torstai;14;13;27
93;20.09.2018;2018;09;07;Torstai;27;34;61
93;20.09.2018;2018;09;08;Torstai;14;15;29
93;20.09.2018;2018;09;09;Torstai;10;8;18
93;20.09.2018;2018;09;10;Torstai;9;4;13
93;20.09.2018;2018;09;11;Torstai;4;5;9
93;20.09.2018;2018;09;12;Torstai;7;7;14
93;20.09.2018;2018;09;13;Torstai;5;2;7
93;20.09.2018;2018;09;14;Torstai;9;12;21
93;20.09.2018;2018;09;15;Torstai;23;10;33
93;20.09.2018;2018;09;16;Torstai;30;27;57
93;20.09.2018;2018;09;17;Torstai;15;20;35
93;20.09.2018;2018;09;18;Torstai;9;11;20
93;20.09.2018;2018;09;19;Torstai;10;7;17
93;20.09.2018;2018;09;20;Torstai;3;5;8
93;20.09.2018;2018;09;21;Torstai;1;6;7
93;20.09.2018;2018;09;22;Torstai;1;1;2
93;20.09.2018;2018;09;23;Torstai;0;0;0
93;21.09.2018;2018;09;00;Perjantai;0;0;0
93;21.09.2018;2018;09;01;Perjantai;0;0;0
93;21.09.2018;2018;09;02;Perjantai;0;1;1
93;21.09.2018;2018;09;03;Perjantai;0;0;0
93;21.09.2018;2018;09;04;Perjantai;0;0;0
93;21.09.2018;2018;09;05;Perjantai;5;3;8
93;21.09.2018;2018;09;06;Perjantai;10;9;19
93;21.09.2018;2018;09;07;Perjantai;10;31;41
93;21.09.2018;2018;09;08;Perjantai;14;23;37
93;21.09.2018;2018;09;09;Perjantai;7;3;10
93;21.09.2018;2018;09;10;Perjantai;9;6;15
93;21.09.2018;2018;09;11;Perjantai;9;7;16
93;21.09.2018;2018;09;12;Perjantai;5;5;10
93;21.09.2018;2018;09;13;Perjantai;11;10;21
93;21.09.2018;2018;09;14;Perjantai;18;10;28
93;21.09.2018;2018;09;15;Perjantai;25;15;40
93;21.09.2018;2018;09;16;Perjantai;28;20;48
93;21.09.2018;2018;09;17;Perjantai;7;17;24
93;21.09.2018;2018;09;18;Perjantai;6;9;15
93;21.09.2018;2018;09;19;Perjantai;4;2;6
93;21.09.2018;2018;09;20;Perjantai;2;2;4
93;21.09.2018;2018;09;21;Perjantai;2;2;4
93;21.09.2018;2018;09;22;Perjantai;1;3;4
93;21.09.2018;2018;09;23;Perjantai;1;0;1
93;22.09.2018;2018;09;00;Lauantai;3;1;4
93;22.09.2018;2018;09;01;Lauantai;0;0;0
93;22.09.2018;2018;09;02;Lauantai;0;0;0
93;22.09.2018;2018;09;03;Lauantai;0;0;0
93;22.09.2018;2018;09;04;Lauantai;0;0;0
93;22.09.2018;2018;09;05;Lauantai;0;0;0
93;22.09.2018;2018;09;06;Lauantai;1;0;1
93;22.09.2018;2018;09;07;Lauantai;1;1;2
93;22.09.2018;2018;09;08;Lauantai;3;2;5
93;22.09.2018;2018;09;09;Lauantai;0;0;0
93;22.09.2018;2018;09;10;Lauantai;0;0;0
93;22.09.2018;2018;09;11;Lauantai;2;2;4
93;22.09.2018;2018;09;12;Lauantai;7;2;9
93;22.09.2018;2018;09;13;Lauantai;5;8;13
93;22.09.2018;2018;09;14;Lauantai;4;8;12
93;22.09.2018;2018;09;15;Lauantai;6;2;8
93;22.09.2018;2018;09;16;Lauantai;3;3;6
93;22.09.2018;2018;09;17;Lauantai;4;9;13
93;22.09.2018;2018;09;18;Lauantai;8;6;14
93;22.09.2018;2018;09;19;Lauantai;5;3;8
93;22.09.2018;2018;09;20;Lauantai;9;3;12
93;22.09.2018;2018;09;21;Lauantai;2;0;2
93;22.09.2018;2018;09;22;Lauantai;0;2;2
93;22.09.2018;2018;09;23;Lauantai;0;2;2
93;23.09.2018;2018;09;00;Sunnuntai;1;2;3
93;23.09.2018;2018;09;01;Sunnuntai;0;0;0
93;23.09.2018;2018;09;02;Sunnuntai;0;1;1
93;23.09.2018;2018;09;03;Sunnuntai;0;0;0
93;23.09.2018;2018;09;04;Sunnuntai;0;0;0
93;23.09.2018;2018;09;05;Sunnuntai;0;0;0
93;23.09.2018;2018;09;06;Sunnuntai;0;0;0
93;23.09.2018;2018;09;07;Sunnuntai;0;1;1
93;23.09.2018;2018;09;08;Sunnuntai;2;4;6
93;23.09.2018;2018;09;09;Sunnuntai;10;5;15
93;23.09.2018;2018;09;10;Sunnuntai;7;6;13
93;23.09.2018;2018;09;11;Sunnuntai;7;7;14
93;23.09.2018;2018;09;12;Sunnuntai;7;13;20
93;23.09.2018;2018;09;13;Sunnuntai;11;14;25
93;23.09.2018;2018;09;14;Sunnuntai;14;14;28
93;23.09.2018;2018;09;15;Sunnuntai;13;8;21
93;23.09.2018;2018;09;16;Sunnuntai;9;13;22
93;23.09.2018;2018;09;17;Sunnuntai;20;3;23
93;23.09.2018;2018;09;18;Sunnuntai;5;11;16
93;23.09.2018;2018;09;19;Sunnuntai;10;4;14
93;23.09.2018;2018;09;20;Sunnuntai;3;7;10
93;23.09.2018;2018;09;21;Sunnuntai;0;2;2
93;23.09.2018;2018;09;22;Sunnuntai;1;0;1
93;23.09.2018;2018;09;23;Sunnuntai;1;0;1
93;24.09.2018;2018;09;00;Maanantai;0;1;1
93;24.09.2018;2018;09;01;Maanantai;0;0;0
93;24.09.2018;2018;09;02;Maanantai;0;0;0
93;24.09.2018;2018;09;03;Maanantai;0;0;0
93;24.09.2018;2018;09;04;Maanantai;1;0;1
93;24.09.2018;2018;09;05;Maanantai;3;3;6
93;24.09.2018;2018;09;06;Maanantai;18;9;27
93;24.09.2018;2018;09;07;Maanantai;22;24;46
93;24.09.2018;2018;09;08;Maanantai;18;23;41
93;24.09.2018;2018;09;09;Maanantai;9;3;12
93;24.09.2018;2018;09;10;Maanantai;9;2;11
93;24.09.2018;2018;09;11;Maanantai;3;6;9
93;24.09.2018;2018;09;12;Maanantai;5;4;9
93;24.09.2018;2018;09;13;Maanantai;4;18;22
93;24.09.2018;2018;09;14;Maanantai;19;14;33
93;24.09.2018;2018;09;15;Maanantai;22;24;46
93;24.09.2018;2018;09;16;Maanantai;26;19;45
93;24.09.2018;2018;09;17;Maanantai;16;14;30
93;24.09.2018;2018;09;18;Maanantai;3;10;13
93;24.09.2018;2018;09;19;Maanantai;10;6;16
93;24.09.2018;2018;09;20;Maanantai;1;5;6
93;24.09.2018;2018;09;21;Maanantai;2;4;6
93;24.09.2018;2018;09;22;Maanantai;2;3;5
93;24.09.2018;2018;09;23;Maanantai;0;2;2
93;25.09.2018;2018;09;00;Tiistai;0;0;0
93;25.09.2018;2018;09;01;Tiistai;0;0;0
93;25.09.2018;2018;09;02;Tiistai;0;0;0
93;25.09.2018;2018;09;03;Tiistai;0;0;0
93;25.09.2018;2018;09;04;Tiistai;0;0;0
93;25.09.2018;2018;09;05;Tiistai;8;0;8
93;25.09.2018;2018;09;06;Tiistai;26;0;26
93;25.09.2018;2018;09;07;Tiistai;48;0;48
93;25.09.2018;2018;09;08;Tiistai;21;0;21
93;25.09.2018;2018;09;09;Tiistai;14;0;14
93;25.09.2018;2018;09;10;Tiistai;14;0;14
93;25.09.2018;2018;09;11;Tiistai;14;0;14
93;25.09.2018;2018;09;12;Tiistai;14;0;14
93;25.09.2018;2018;09;13;Tiistai;23;0;23
93;25.09.2018;2018;09;14;Tiistai;21;0;21
93;25.09.2018;2018;09;15;Tiistai;41;0;41
93;25.09.2018;2018;09;16;Tiistai;42;0;42
93;25.09.2018;2018;09;17;Tiistai;32;0;32
93;25.09.2018;2018;09;18;Tiistai;23;0;23
93;25.09.2018;2018;09;19;Tiistai;26;0;26
93;25.09.2018;2018;09;20;Tiistai;14;0;14
93;25.09.2018;2018;09;21;Tiistai;7;0;7
93;25.09.2018;2018;09;22;Tiistai;5;0;5
93;25.09.2018;2018;09;23;Tiistai;0;0;0
93;26.09.2018;2018;09;00;Keskiviikko;1;0;1
93;26.09.2018;2018;09;01;Keskiviikko;0;0;0
93;26.09.2018;2018;09;02;Keskiviikko;0;0;0
93;26.09.2018;2018;09;03;Keskiviikko;0;0;0
93;26.09.2018;2018;09;04;Keskiviikko;0;0;0
93;26.09.2018;2018;09;05;Keskiviikko;2;3;5
93;26.09.2018;2018;09;06;Keskiviikko;9;12;21
93;26.09.2018;2018;09;07;Keskiviikko;9;22;31
93;26.09.2018;2018;09;08;Keskiviikko;5;11;16
93;26.09.2018;2018;09;09;Keskiviikko;6;4;10
93;26.09.2018;2018;09;10;Keskiviikko;4;0;4
93;26.09.2018;2018;09;11;Keskiviikko;0;1;1
93;26.09.2018;2018;09;12;Keskiviikko;0;1;1
93;26.09.2018;2018;09;13;Keskiviikko;2;3;5
93;26.09.2018;2018;09;14;Keskiviikko;6;4;10
93;26.09.2018;2018;09;15;Keskiviikko;18;9;27
93;26.09.2018;2018;09;16;Keskiviikko;13;8;21
93;26.09.2018;2018;09;17;Keskiviikko;10;6;16
93;26.09.2018;2018;09;18;Keskiviikko;4;6;10
93;26.09.2018;2018;09;19;Keskiviikko;6;2;8
93;26.09.2018;2018;09;20;Keskiviikko;3;3;6
93;26.09.2018;2018;09;21;Keskiviikko;1;4;5
93;26.09.2018;2018;09;22;Keskiviikko;3;0;3
93;26.09.2018;2018;09;23;Keskiviikko;1;0;1
93;27.09.2018;2018;09;00;Torstai;0;0;0
93;27.09.2018;2018;09;01;Torstai;0;0;0
93;27.09.2018;2018;09;02;Torstai;0;0;0
93;27.09.2018;2018;09;03;Torstai;0;0;0
93;27.09.2018;2018;09;04;Torstai;0;0;0
93;27.09.2018;2018;09;05;Torstai;1;4;5
93;27.09.2018;2018;09;06;Torstai;3;8;11
93;27.09.2018;2018;09;07;Torstai;9;24;33
93;27.09.2018;2018;09;08;Torstai;5;6;11
93;27.09.2018;2018;09;09;Torstai;4;2;6
93;27.09.2018;2018;09;10;Torstai;3;2;5
93;27.09.2018;2018;09;11;Torstai;2;0;2
93;27.09.2018;2018;09;12;Torstai;3;2;5
93;27.09.2018;2018;09;13;Torstai;5;6;11
93;27.09.2018;2018;09;14;Torstai;10;5;15
93;27.09.2018;2018;09;15;Torstai;16;11;27
93;27.09.2018;2018;09;16;Torstai;13;5;18
93;27.09.2018;2018;09;17;Torstai;14;15;29
93;27.09.2018;2018;09;18;Torstai;9;4;13
93;27.09.2018;2018;09;19;Torstai;2;9;11
93;27.09.2018;2018;09;20;Torstai;4;5;9
93;27.09.2018;2018;09;21;Torstai;3;3;6
93;27.09.2018;2018;09;22;Torstai;0;1;1
93;27.09.2018;2018;09;23;Torstai;1;1;2
93;28.09.2018;2018;09;00;Perjantai;0;0;0
93;28.09.2018;2018;09;01;Perjantai;0;1;1
93;28.09.2018;2018;09;02;Perjantai;0;0;0
93;28.09.2018;2018;09;03;Perjantai;1;0;1
93;28.09.2018;2018;09;04;Perjantai;0;1;1
93;28.09.2018;2018;09;05;Perjantai;2;3;5
93;28.09.2018;2018;09;06;Perjantai;11;10;21
93;28.09.2018;2018;09;07;Perjantai;13;30;43
93;28.09.2018;2018;09;08;Perjantai;11;15;26
93;28.09.2018;2018;09;09;Perjantai;9;10;19
93;28.09.2018;2018;09;10;Perjantai;2;2;4
93;28.09.2018;2018;09;11;Perjantai;7;6;13
93;28.09.2018;2018;09;12;Perjantai;10;8;18
93;28.09.2018;2018;09;13;Perjantai;9;10;19
93;28.09.2018;2018;09;14;Perjantai;14;11;25
93;28.09.2018;2018;09;15;Perjantai;18;20;38
93;28.09.2018;2018;09;16;Perjantai;16;18;34
93;28.09.2018;2018;09;17;Perjantai;14;10;24
93;28.09.2018;2018;09;18;Perjantai;9;15;24
93;28.09.2018;2018;09;19;Perjantai;7;4;11
93;28.09.2018;2018;09;20;Perjantai;3;6;9
93;28.09.2018;2018;09;21;Perjantai;2;2;4
93;28.09.2018;2018;09;22;Perjantai;6;4;10
93;28.09.2018;2018;09;23;Perjantai;1;0;1
93;29.09.2018;2018;09;00;Lauantai;0;0;0
93;29.09.2018;2018;09;01;Lauantai;2;0;2
93;29.09.2018;2018;09;02;Lauantai;0;0;0
93;29.09.2018;2018;09;03;Lauantai;0;0;0
93;29.09.2018;2018;09;04;Lauantai;0;0;0
93;29.09.2018;2018;09;05;Lauantai;1;0;1
93;29.09.2018;2018;09;06;Lauantai;2;0;2
93;29.09.2018;2018;09;07;Lauantai;1;1;2
93;29.09.2018;2018;09;08;Lauantai;1;0;1
93;29.09.2018;2018;09;09;Lauantai;6;4;10
93;29.09.2018;2018;09;10;Lauantai;6;5;11
93;29.09.2018;2018;09;11;Lauantai;6;11;17
93;29.09.2018;2018;09;12;Lauantai;7;0;7
93;29.09.2018;2018;09;13;Lauantai;7;4;11
93;29.09.2018;2018;09;14;Lauantai;5;14;19
93;29.09.2018;2018;09;15;Lauantai;11;12;23
93;29.09.2018;2018;09;16;Lauantai;9;7;16
93;29.09.2018;2018;09;17;Lauantai;6;8;14
93;29.09.2018;2018;09;18;Lauantai;6;5;11
93;29.09.2018;2018;09;19;Lauantai;8;9;17
93;29.09.2018;2018;09;20;Lauantai;2;6;8
93;29.09.2018;2018;09;21;Lauantai;2;12;14
93;29.09.2018;2018;09;22;Lauantai;2;0;2
93;29.09.2018;2018;09;23;Lauantai;0;0;0
93;30.09.2018;2018;09;00;Sunnuntai;1;1;2
93;30.09.2018;2018;09;01;Sunnuntai;1;0;1
93;30.09.2018;2018;09;02;Sunnuntai;0;0;0
93;30.09.2018;2018;09;03;Sunnuntai;2;0;2
93;30.09.2018;2018;09;04;Sunnuntai;0;1;1
93;30.09.2018;2018;09;05;Sunnuntai;0;0;0
93;30.09.2018;2018;09;06;Sunnuntai;1;0;1
93;30.09.2018;2018;09;07;Sunnuntai;0;1;1
93;30.09.2018;2018;09;08;Sunnuntai;1;1;2
93;30.09.2018;2018;09;09;Sunnuntai;6;2;8
93;30.09.2018;2018;09;10;Sunnuntai;5;3;8
93;30.09.2018;2018;09;11;Sunnuntai;4;8;12
93;30.09.2018;2018;09;12;Sunnuntai;9;9;18
93;30.09.2018;2018;09;13;Sunnuntai;12;14;26
93;30.09.2018;2018;09;14;Sunnuntai;12;13;25
93;30.09.2018;2018;09;15;Sunnuntai;15;9;24
93;30.09.2018;2018;09;16;Sunnuntai;10;5;15
93;30.09.2018;2018;09;17;Sunnuntai;6;8;14
93;30.09.2018;2018;09;18;Sunnuntai;3;9;12
93;30.09.2018;2018;09;19;Sunnuntai;10;6;16
93;30.09.2018;2018;09;20;Sunnuntai;5;3;8
93;30.09.2018;2018;09;21;Sunnuntai;0;0;0
93;30.09.2018;2018;09;22;Sunnuntai;2;3;5
93;30.09.2018;2018;09;23;Sunnuntai;1;0;1