MittausID;Pvm;Vuosi;Kuukausi;Tunti;Viikonpäivä;PP_1;PP_2;PP_YHT;JK_1;JK_2;JK_YHT
292;02.11.2015;2015;11;00;Maanantai;0;0;0;0;0;0
292;02.11.2015;2015;11;01;Maanantai;0;1;1;0;0;0
292;02.11.2015;2015;11;02;Maanantai;0;2;2;0;0;0
292;02.11.2015;2015;11;03;Maanantai;0;0;0;0;1;1
292;02.11.2015;2015;11;04;Maanantai;1;2;3;0;0;0
292;02.11.2015;2015;11;05;Maanantai;9;5;14;1;2;3
292;02.11.2015;2015;11;06;Maanantai;20;11;31;2;2;4
292;02.11.2015;2015;11;07;Maanantai;68;26;94;19;11;30
292;02.11.2015;2015;11;08;Maanantai;45;25;70;9;8;17
292;02.11.2015;2015;11;09;Maanantai;75;23;98;11;9;20
292;02.11.2015;2015;11;10;Maanantai;33;24;57;9;13;22
292;02.11.2015;2015;11;11;Maanantai;30;31;61;12;4;16
292;02.11.2015;2015;11;12;Maanantai;26;32;58;13;15;28
292;02.11.2015;2015;11;13;Maanantai;27;41;68;20;19;39
292;02.11.2015;2015;11;14;Maanantai;34;62;96;14;15;29
292;02.11.2015;2015;11;15;Maanantai;29;76;105;23;19;42
292;02.11.2015;2015;11;16;Maanantai;34;71;105;13;15;28
292;02.11.2015;2015;11;17;Maanantai;31;29;60;12;17;29
292;02.11.2015;2015;11;18;Maanantai;32;22;54;18;12;30
292;02.11.2015;2015;11;19;Maanantai;24;28;52;12;7;19
292;02.11.2015;2015;11;20;Maanantai;21;12;33;6;3;9
292;02.11.2015;2015;11;21;Maanantai;4;10;14;2;2;4
292;02.11.2015;2015;11;22;Maanantai;2;3;5;2;1;3
292;02.11.2015;2015;11;23;Maanantai;0;4;4;1;0;1
292;03.11.2015;2015;11;00;Tiistai;3;0;3;1;0;1
292;03.11.2015;2015;11;01;Tiistai;0;0;0;0;0;0
292;03.11.2015;2015;11;02;Tiistai;0;2;2;0;0;0
292;03.11.2015;2015;11;03;Tiistai;0;1;1;0;0;0
292;03.11.2015;2015;11;04;Tiistai;2;3;5;0;1;1
292;03.11.2015;2015;11;05;Tiistai;8;4;12;1;0;1
292;03.11.2015;2015;11;06;Tiistai;15;15;30;2;3;5
292;03.11.2015;2015;11;07;Tiistai;80;27;107;15;7;22
292;03.11.2015;2015;11;08;Tiistai;89;32;121;19;10;29
292;03.11.2015;2015;11;09;Tiistai;27;15;42;8;15;23
292;03.11.2015;2015;11;10;Tiistai;34;27;61;10;21;31
292;03.11.2015;2015;11;11;Tiistai;19;36;55;15;8;23
292;03.11.2015;2015;11;12;Tiistai;35;42;77;12;12;24
292;03.11.2015;2015;11;13;Tiistai;41;56;97;20;13;33
292;03.11.2015;2015;11;14;Tiistai;34;110;144;11;18;29
292;03.11.2015;2015;11;15;Tiistai;44;66;110;11;18;29
292;03.11.2015;2015;11;16;Tiistai;39;63;102;20;9;29
292;03.11.2015;2015;11;17;Tiistai;33;25;58;11;10;21
292;03.11.2015;2015;11;18;Tiistai;21;24;45;16;14;30
292;03.11.2015;2015;11;19;Tiistai;25;21;46;9;11;20
292;03.11.2015;2015;11;20;Tiistai;23;14;37;9;12;21
292;03.11.2015;2015;11;21;Tiistai;15;13;28;2;2;4
292;03.11.2015;2015;11;22;Tiistai;4;7;11;0;1;1
292;03.11.2015;2015;11;23;Tiistai;1;4;5;2;1;3
292;04.11.2015;2015;11;00;Keskiviikko;2;0;2;0;0;0
292;04.11.2015;2015;11;01;Keskiviikko;1;0;1;0;0;0
292;04.11.2015;2015;11;02;Keskiviikko;0;0;0;0;0;0
292;04.11.2015;2015;11;03;Keskiviikko;0;1;1;0;0;0
292;04.11.2015;2015;11;04;Keskiviikko;2;0;2;0;1;1
292;04.11.2015;2015;11;05;Keskiviikko;13;5;18;1;0;1
292;04.11.2015;2015;11;06;Keskiviikko;18;13;31;5;0;5
292;04.11.2015;2015;11;07;Keskiviikko;86;23;109;19;0;19
292;04.11.2015;2015;11;08;Keskiviikko;75;19;94;12;9;21
292;04.11.2015;2015;11;09;Keskiviikko;47;22;69;13;11;24
292;04.11.2015;2015;11;10;Keskiviikko;29;27;56;6;7;13
292;04.11.2015;2015;11;11;Keskiviikko;38;35;73;10;10;20
292;04.11.2015;2015;11;12;Keskiviikko;32;33;65;18;10;28
292;04.11.2015;2015;11;13;Keskiviikko;39;93;132;13;17;30
292;04.11.2015;2015;11;14;Keskiviikko;42;84;126;18;14;32
292;04.11.2015;2015;11;15;Keskiviikko;37;50;87;13;16;29
292;04.11.2015;2015;11;16;Keskiviikko;52;74;126;9;17;26
292;04.11.2015;2015;11;17;Keskiviikko;38;27;65;14;9;23
292;04.11.2015;2015;11;18;Keskiviikko;28;24;52;11;11;22
292;04.11.2015;2015;11;19;Keskiviikko;19;18;37;6;4;10
292;04.11.2015;2015;11;20;Keskiviikko;17;19;36;4;8;12
292;04.11.2015;2015;11;21;Keskiviikko;7;13;20;4;3;7
292;04.11.2015;2015;11;22;Keskiviikko;3;6;9;0;0;0
292;04.11.2015;2015;11;23;Keskiviikko;3;3;6;1;0;1
292;05.11.2015;2015;11;00;Torstai;1;3;4;1;2;3
292;05.11.2015;2015;11;01;Torstai;0;1;1;0;0;0
292;05.11.2015;2015;11;02;Torstai;0;0;0;0;0;0
292;05.11.2015;2015;11;03;Torstai;1;0;1;0;0;0
292;05.11.2015;2015;11;04;Torstai;1;0;1;1;0;1
292;05.11.2015;2015;11;05;Torstai;10;7;17;3;0;3
292;05.11.2015;2015;11;06;Torstai;17;14;31;1;4;5
292;05.11.2015;2015;11;07;Torstai;72;25;97;13;8;21
292;05.11.2015;2015;11;08;Torstai;58;27;85;16;8;24
292;05.11.2015;2015;11;09;Torstai;59;20;79;13;10;23
292;05.11.2015;2015;11;10;Torstai;24;20;44;8;6;14
292;05.11.2015;2015;11;11;Torstai;23;20;43;13;9;22
292;05.11.2015;2015;11;12;Torstai;23;35;58;7;10;17
292;05.11.2015;2015;11;13;Torstai;21;50;71;11;15;26
292;05.11.2015;2015;11;14;Torstai;42;44;86;25;11;36
292;05.11.2015;2015;11;15;Torstai;37;67;104;21;17;38
292;05.11.2015;2015;11;16;Torstai;34;75;109;15;13;28
292;05.11.2015;2015;11;17;Torstai;22;22;44;12;14;26
292;05.11.2015;2015;11;18;Torstai;28;23;51;7;23;30
292;05.11.2015;2015;11;19;Torstai;20;14;34;9;7;16
292;05.11.2015;2015;11;20;Torstai;14;19;33;8;9;17
292;05.11.2015;2015;11;21;Torstai;5;8;13;3;1;4
292;05.11.2015;2015;11;22;Torstai;6;9;15;2;1;3
292;05.11.2015;2015;11;23;Torstai;0;0;0;1;0;1
292;06.11.2015;2015;11;00;Perjantai;0;0;0;0;0;0
292;06.11.2015;2015;11;01;Perjantai;0;0;0;0;0;0
292;06.11.2015;2015;11;02;Perjantai;0;0;0;0;0;0
292;06.11.2015;2015;11;03;Perjantai;0;0;0;0;0;0
292;06.11.2015;2015;11;04;Perjantai;1;1;2;0;0;0
292;06.11.2015;2015;11;05;Perjantai;10;4;14;0;0;0
292;06.11.2015;2015;11;06;Perjantai;15;7;22;6;3;9
292;06.11.2015;2015;11;07;Perjantai;67;20;87;15;7;22
292;06.11.2015;2015;11;08;Perjantai;73;21;94;12;5;17
292;06.11.2015;2015;11;09;Perjantai;45;16;61;10;1;11
292;06.11.2015;2015;11;10;Perjantai;27;12;39;7;4;11
292;06.11.2015;2015;11;11;Perjantai;24;20;44;7;4;11
292;06.11.2015;2015;11;12;Perjantai;27;28;55;18;6;24
292;06.11.2015;2015;11;13;Perjantai;28;85;113;2;18;20
292;06.11.2015;2015;11;14;Perjantai;39;61;100;9;15;24
292;06.11.2015;2015;11;15;Perjantai;17;42;59;14;23;37
292;06.11.2015;2015;11;16;Perjantai;32;34;66;18;15;33
292;06.11.2015;2015;11;17;Perjantai;19;30;49;7;4;11
292;06.11.2015;2015;11;18;Perjantai;16;18;34;9;6;15
292;06.11.2015;2015;11;19;Perjantai;16;12;28;9;7;16
292;06.11.2015;2015;11;20;Perjantai;9;11;20;6;6;12
292;06.11.2015;2015;11;21;Perjantai;8;11;19;4;1;5
292;06.11.2015;2015;11;22;Perjantai;2;8;10;2;0;2
292;06.11.2015;2015;11;23;Perjantai;3;0;3;1;1;2
292;07.11.2015;2015;11;00;Lauantai;5;4;9;0;0;0
292;07.11.2015;2015;11;01;Lauantai;1;3;4;6;3;9
292;07.11.2015;2015;11;02;Lauantai;0;2;2;0;3;3
292;07.11.2015;2015;11;03;Lauantai;0;2;2;0;1;1
292;07.11.2015;2015;11;04;Lauantai;0;0;0;0;0;0
292;07.11.2015;2015;11;05;Lauantai;0;0;0;0;0;0
292;07.11.2015;2015;11;06;Lauantai;4;1;5;3;1;4
292;07.11.2015;2015;11;07;Lauantai;3;2;5;2;3;5
292;07.11.2015;2015;11;08;Lauantai;1;4;5;4;4;8
292;07.11.2015;2015;11;09;Lauantai;6;8;14;7;7;14
292;07.11.2015;2015;11;10;Lauantai;11;8;19;5;4;9
292;07.11.2015;2015;11;11;Lauantai;14;15;29;11;6;17
292;07.11.2015;2015;11;12;Lauantai;20;19;39;7;10;17
292;07.11.2015;2015;11;13;Lauantai;23;12;35;5;8;13
292;07.11.2015;2015;11;14;Lauantai;33;21;54;10;11;21
292;07.11.2015;2015;11;15;Lauantai;13;21;34;14;9;23
292;07.11.2015;2015;11;16;Lauantai;29;7;36;19;3;22
292;07.11.2015;2015;11;17;Lauantai;21;17;38;6;9;15
292;07.11.2015;2015;11;18;Lauantai;4;6;10;5;9;14
292;07.11.2015;2015;11;19;Lauantai;10;10;20;7;5;12
292;07.11.2015;2015;11;20;Lauantai;11;7;18;2;5;7
292;07.11.2015;2015;11;21;Lauantai;9;9;18;3;8;11
292;07.11.2015;2015;11;22;Lauantai;1;2;3;3;1;4
292;07.11.2015;2015;11;23;Lauantai;6;2;8;3;4;7
292;08.11.2015;2015;11;00;Sunnuntai;0;3;3;1;2;3
292;08.11.2015;2015;11;01;Sunnuntai;0;1;1;0;0;0
292;08.11.2015;2015;11;02;Sunnuntai;0;0;0;1;6;7
292;08.11.2015;2015;11;03;Sunnuntai;0;1;1;0;0;0
292;08.11.2015;2015;11;04;Sunnuntai;2;0;2;1;0;1
292;08.11.2015;2015;11;05;Sunnuntai;1;0;1;0;1;1
292;08.11.2015;2015;11;06;Sunnuntai;4;2;6;1;0;1
292;08.11.2015;2015;11;07;Sunnuntai;0;3;3;2;1;3
292;08.11.2015;2015;11;08;Sunnuntai;2;4;6;0;1;1
292;08.11.2015;2015;11;09;Sunnuntai;10;7;17;11;11;22
292;08.11.2015;2015;11;10;Sunnuntai;8;10;18;17;11;28
292;08.11.2015;2015;11;11;Sunnuntai;19;17;36;14;18;32
292;08.11.2015;2015;11;12;Sunnuntai;19;18;37;15;13;28
292;08.11.2015;2015;11;13;Sunnuntai;18;13;31;8;11;19
292;08.11.2015;2015;11;14;Sunnuntai;15;18;33;14;16;30
292;08.11.2015;2015;11;15;Sunnuntai;23;10;33;13;7;20
292;08.11.2015;2015;11;16;Sunnuntai;14;19;33;7;12;19
292;08.11.2015;2015;11;17;Sunnuntai;12;20;32;6;4;10
292;08.11.2015;2015;11;18;Sunnuntai;15;16;31;4;6;10
292;08.11.2015;2015;11;19;Sunnuntai;15;9;24;14;6;20
292;08.11.2015;2015;11;20;Sunnuntai;12;8;20;4;7;11
292;08.11.2015;2015;11;21;Sunnuntai;4;7;11;1;1;2
292;08.11.2015;2015;11;22;Sunnuntai;2;1;3;0;0;0
292;08.11.2015;2015;11;23;Sunnuntai;0;2;2;0;0;0
292;09.11.2015;2015;11;00;Maanantai;0;0;0;0;1;1
292;09.11.2015;2015;11;01;Maanantai;0;0;0;0;0;0
292;09.11.2015;2015;11;02;Maanantai;0;1;1;0;1;1
292;09.11.2015;2015;11;03;Maanantai;0;0;0;1;0;1
292;09.11.2015;2015;11;04;Maanantai;2;2;4;0;1;1
292;09.11.2015;2015;11;05;Maanantai;5;5;10;3;0;3
292;09.11.2015;2015;11;06;Maanantai;20;16;36;2;3;5
292;09.11.2015;2015;11;07;Maanantai;73;26;99;13;7;20
292;09.11.2015;2015;11;08;Maanantai;51;20;71;9;7;16
292;09.11.2015;2015;11;09;Maanantai;61;13;74;15;5;20
292;09.11.2015;2015;11;10;Maanantai;19;18;37;9;2;11
292;09.11.2015;2015;11;11;Maanantai;31;23;54;5;4;9
292;09.11.2015;2015;11;12;Maanantai;23;26;49;11;4;15
292;09.11.2015;2015;11;13;Maanantai;32;54;86;7;8;15
292;09.11.2015;2015;11;14;Maanantai;38;70;108;13;15;28
292;09.11.2015;2015;11;15;Maanantai;39;63;102;16;19;35
292;09.11.2015;2015;11;16;Maanantai;41;68;109;9;8;17
292;09.11.2015;2015;11;17;Maanantai;36;30;66;10;13;23
292;09.11.2015;2015;11;18;Maanantai;33;23;56;15;21;36
292;09.11.2015;2015;11;19;Maanantai;29;27;56;7;11;18
292;09.11.2015;2015;11;20;Maanantai;23;28;51;10;6;16
292;09.11.2015;2015;11;21;Maanantai;10;15;25;2;2;4
292;09.11.2015;2015;11;22;Maanantai;9;6;15;1;1;2
292;09.11.2015;2015;11;23;Maanantai;0;3;3;0;1;1
292;10.11.2015;2015;11;00;Tiistai;4;1;5;0;0;0
292;10.11.2015;2015;11;01;Tiistai;0;0;0;0;1;1
292;10.11.2015;2015;11;02;Tiistai;1;1;2;0;0;0
292;10.11.2015;2015;11;03;Tiistai;0;1;1;0;0;0
292;10.11.2015;2015;11;04;Tiistai;1;0;1;0;0;0
292;10.11.2015;2015;11;05;Tiistai;8;1;9;1;1;2
292;10.11.2015;2015;11;06;Tiistai;21;10;31;2;2;4
292;10.11.2015;2015;11;07;Tiistai;56;25;81;10;6;16
292;10.11.2015;2015;11;08;Tiistai;58;14;72;14;10;24
292;10.11.2015;2015;11;09;Tiistai;19;8;27;4;3;7
292;10.11.2015;2015;11;10;Tiistai;19;13;32;3;4;7
292;10.11.2015;2015;11;11;Tiistai;6;20;26;6;3;9
292;10.11.2015;2015;11;12;Tiistai;14;8;22;4;11;15
292;10.11.2015;2015;11;13;Tiistai;18;28;46;10;1;11
292;10.11.2015;2015;11;14;Tiistai;29;76;105;5;7;12
292;10.11.2015;2015;11;15;Tiistai;18;35;53;8;6;14
292;10.11.2015;2015;11;16;Tiistai;23;26;49;5;8;13
292;10.11.2015;2015;11;17;Tiistai;22;13;35;6;9;15
292;10.11.2015;2015;11;18;Tiistai;21;14;35;5;7;12
292;10.11.2015;2015;11;19;Tiistai;15;12;27;6;8;14
292;10.11.2015;2015;11;20;Tiistai;12;15;27;15;7;22
292;10.11.2015;2015;11;21;Tiistai;8;5;13;2;0;2
292;10.11.2015;2015;11;22;Tiistai;3;6;9;1;1;2
292;10.11.2015;2015;11;23;Tiistai;0;0;0;1;0;1
292;11.11.2015;2015;11;00;Keskiviikko;0;0;0;0;1;1
292;11.11.2015;2015;11;01;Keskiviikko;0;0;0;0;1;1
292;11.11.2015;2015;11;02;Keskiviikko;0;2;2;0;0;0
292;11.11.2015;2015;11;03;Keskiviikko;0;0;0;0;0;0
292;11.11.2015;2015;11;04;Keskiviikko;1;1;2;0;0;0
292;11.11.2015;2015;11;05;Keskiviikko;5;4;9;1;0;1
292;11.11.2015;2015;11;06;Keskiviikko;20;15;35;3;3;6
292;11.11.2015;2015;11;07;Keskiviikko;74;21;95;19;6;25
292;11.11.2015;2015;11;08;Keskiviikko;68;10;78;15;8;23
292;11.11.2015;2015;11;09;Keskiviikko;26;21;47;6;6;12
292;11.11.2015;2015;11;10;Keskiviikko;18;26;44;7;12;19
292;11.11.2015;2015;11;11;Keskiviikko;27;21;48;11;7;18
292;11.11.2015;2015;11;12;Keskiviikko;25;27;52;12;8;20
292;11.11.2015;2015;11;13;Keskiviikko;31;71;102;14;14;28
292;11.11.2015;2015;11;14;Keskiviikko;40;49;89;12;13;25
292;11.11.2015;2015;11;15;Keskiviikko;37;52;89;18;10;28
292;11.11.2015;2015;11;16;Keskiviikko;36;60;96;8;14;22
292;11.11.2015;2015;11;17;Keskiviikko;35;24;59;12;14;26
292;11.11.2015;2015;11;18;Keskiviikko;23;27;50;16;9;25
292;11.11.2015;2015;11;19;Keskiviikko;22;20;42;10;8;18
292;11.11.2015;2015;11;20;Keskiviikko;17;13;30;4;5;9
292;11.11.2015;2015;11;21;Keskiviikko;6;6;12;4;4;8
292;11.11.2015;2015;11;22;Keskiviikko;1;5;6;2;0;2
292;11.11.2015;2015;11;23;Keskiviikko;3;1;4;1;1;2
292;12.11.2015;2015;11;00;Torstai;2;0;2;0;2;2
292;12.11.2015;2015;11;01;Torstai;0;0;0;0;0;0
292;12.11.2015;2015;11;02;Torstai;0;0;0;0;0;0
292;12.11.2015;2015;11;03;Torstai;1;0;1;0;0;0
292;12.11.2015;2015;11;04;Torstai;3;0;3;0;0;0
292;12.11.2015;2015;11;05;Torstai;9;5;14;0;1;1
292;12.11.2015;2015;11;06;Torstai;22;13;35;1;2;3
292;12.11.2015;2015;11;07;Torstai;57;20;77;9;6;15
292;12.11.2015;2015;11;08;Torstai;41;21;62;12;9;21
292;12.11.2015;2015;11;09;Torstai;53;15;68;5;11;16
292;12.11.2015;2015;11;10;Torstai;23;9;32;3;2;5
292;12.11.2015;2015;11;11;Torstai;20;14;34;7;4;11
292;12.11.2015;2015;11;12;Torstai;17;19;36;7;2;9
292;12.11.2015;2015;11;13;Torstai;24;49;73;13;6;19
292;12.11.2015;2015;11;14;Torstai;34;38;72;10;14;24
292;12.11.2015;2015;11;15;Torstai;33;68;101;15;12;27
292;12.11.2015;2015;11;16;Torstai;32;57;89;3;18;21
292;12.11.2015;2015;11;17;Torstai;16;20;36;7;7;14
292;12.11.2015;2015;11;18;Torstai;16;20;36;4;11;15
292;12.11.2015;2015;11;19;Torstai;16;14;30;6;3;9
292;12.11.2015;2015;11;20;Torstai;17;14;31;0;3;3
292;12.11.2015;2015;11;21;Torstai;8;6;14;3;3;6
292;12.11.2015;2015;11;22;Torstai;5;2;7;2;1;3
292;12.11.2015;2015;11;23;Torstai;1;0;1;0;1;1
292;13.11.2015;2015;11;00;Perjantai;3;1;4;0;0;0
292;13.11.2015;2015;11;01;Perjantai;0;1;1;0;0;0
292;13.11.2015;2015;11;02;Perjantai;0;0;0;0;0;0
292;13.11.2015;2015;11;03;Perjantai;0;0;0;0;0;0
292;13.11.2015;2015;11;04;Perjantai;1;0;1;0;0;0
292;13.11.2015;2015;11;05;Perjantai;9;7;16;1;1;2
292;13.11.2015;2015;11;06;Perjantai;16;7;23;0;2;2
292;13.11.2015;2015;11;07;Perjantai;48;28;76;19;8;27
292;13.11.2015;2015;11;08;Perjantai;59;12;71;23;10;33
292;13.11.2015;2015;11;09;Perjantai;42;20;62;20;9;29
292;13.11.2015;2015;11;10;Perjantai;21;17;38;6;17;23
292;13.11.2015;2015;11;11;Perjantai;22;22;44;11;14;25
292;13.11.2015;2015;11;12;Perjantai;41;37;78;21;12;33
292;13.11.2015;2015;11;13;Perjantai;26;80;106;10;20;30
292;13.11.2015;2015;11;14;Perjantai;33;71;104;9;14;23
292;13.11.2015;2015;11;15;Perjantai;27;55;82;15;22;37
292;13.11.2015;2015;11;16;Perjantai;31;49;80;18;14;32
292;13.11.2015;2015;11;17;Perjantai;30;36;66;14;15;29
292;13.11.2015;2015;11;18;Perjantai;31;29;60;7;10;17
292;13.11.2015;2015;11;19;Perjantai;39;21;60;6;9;15
292;13.11.2015;2015;11;20;Perjantai;31;6;37;11;3;14
292;13.11.2015;2015;11;21;Perjantai;14;6;20;4;5;9
292;13.11.2015;2015;11;22;Perjantai;6;7;13;2;2;4
292;13.11.2015;2015;11;23;Perjantai;7;4;11;10;0;10
292;14.11.2015;2015;11;00;Lauantai;2;2;4;1;2;3
292;14.11.2015;2015;11;01;Lauantai;5;7;12;1;2;3
292;14.11.2015;2015;11;02;Lauantai;1;3;4;2;7;9
292;14.11.2015;2015;11;03;Lauantai;1;1;2;0;1;1
292;14.11.2015;2015;11;04;Lauantai;1;2;3;1;0;1
292;14.11.2015;2015;11;05;Lauantai;0;1;1;0;0;0
292;14.11.2015;2015;11;06;Lauantai;3;2;5;0;0;0
292;14.11.2015;2015;11;07;Lauantai;0;2;2;2;1;3
292;14.11.2015;2015;11;08;Lauantai;1;7;8;3;2;5
292;14.11.2015;2015;11;09;Lauantai;7;12;19;7;4;11
292;14.11.2015;2015;11;10;Lauantai;15;7;22;6;2;8
292;14.11.2015;2015;11;11;Lauantai;17;12;29;11;9;20
292;14.11.2015;2015;11;12;Lauantai;14;21;35;2;6;8
292;14.11.2015;2015;11;13;Lauantai;19;18;37;4;7;11
292;14.11.2015;2015;11;14;Lauantai;17;17;34;7;4;11
292;14.11.2015;2015;11;15;Lauantai;19;12;31;8;7;15
292;14.11.2015;2015;11;16;Lauantai;27;9;36;10;8;18
292;14.11.2015;2015;11;17;Lauantai;18;15;33;11;6;17
292;14.11.2015;2015;11;18;Lauantai;10;10;20;9;13;22
292;14.11.2015;2015;11;19;Lauantai;12;14;26;2;4;6
292;14.11.2015;2015;11;20;Lauantai;13;14;27;7;3;10
292;14.11.2015;2015;11;21;Lauantai;5;9;14;4;5;9
292;14.11.2015;2015;11;22;Lauantai;3;3;6;3;3;6
292;14.11.2015;2015;11;23;Lauantai;1;2;3;3;0;3
292;15.11.2015;2015;11;00;Sunnuntai;6;2;8;3;1;4
292;15.11.2015;2015;11;01;Sunnuntai;3;1;4;1;1;2
292;15.11.2015;2015;11;02;Sunnuntai;0;1;1;0;0;0
292;15.11.2015;2015;11;03;Sunnuntai;1;2;3;0;6;6
292;15.11.2015;2015;11;04;Sunnuntai;0;0;0;0;0;0
292;15.11.2015;2015;11;05;Sunnuntai;2;1;3;1;0;1
292;15.11.2015;2015;11;06;Sunnuntai;3;1;4;2;2;4
292;15.11.2015;2015;11;07;Sunnuntai;0;1;1;3;1;4
292;15.11.2015;2015;11;08;Sunnuntai;4;3;7;1;3;4
292;15.11.2015;2015;11;09;Sunnuntai;18;11;29;6;3;9
292;15.11.2015;2015;11;10;Sunnuntai;6;10;16;9;12;21
292;15.11.2015;2015;11;11;Sunnuntai;11;22;33;14;12;26
292;15.11.2015;2015;11;12;Sunnuntai;22;16;38;11;7;18
292;15.11.2015;2015;11;13;Sunnuntai;21;17;38;10;9;19
292;15.11.2015;2015;11;14;Sunnuntai;17;29;46;11;8;19
292;15.11.2015;2015;11;15;Sunnuntai;19;11;30;11;8;19
292;15.11.2015;2015;11;16;Sunnuntai;19;18;37;7;12;19
292;15.11.2015;2015;11;17;Sunnuntai;19;12;31;7;9;16
292;15.11.2015;2015;11;18;Sunnuntai;7;5;12;14;8;22
292;15.11.2015;2015;11;19;Sunnuntai;10;10;20;7;12;19
292;15.11.2015;2015;11;20;Sunnuntai;7;7;14;7;4;11
292;15.11.2015;2015;11;21;Sunnuntai;3;7;10;5;8;13
292;15.11.2015;2015;11;22;Sunnuntai;3;1;4;1;3;4
292;15.11.2015;2015;11;23;Sunnuntai;0;0;0;0;2;2
292;16.11.2015;2015;11;00;Maanantai;1;0;1;0;0;0
292;16.11.2015;2015;11;01;Maanantai;0;2;2;1;0;1
292;16.11.2015;2015;11;02;Maanantai;0;0;0;1;0;1
292;16.11.2015;2015;11;03;Maanantai;0;0;0;0;2;2
292;16.11.2015;2015;11;04;Maanantai;2;0;2;0;2;2
292;16.11.2015;2015;11;05;Maanantai;8;3;11;2;2;4
292;16.11.2015;2015;11;06;Maanantai;19;15;34;3;4;7
292;16.11.2015;2015;11;07;Maanantai;58;22;80;21;15;36
292;16.11.2015;2015;11;08;Maanantai;44;26;70;13;8;21
292;16.11.2015;2015;11;09;Maanantai;56;12;68;20;16;36
292;16.11.2015;2015;11;10;Maanantai;21;16;37;10;6;16
292;16.11.2015;2015;11;11;Maanantai;20;13;33;9;10;19
292;16.11.2015;2015;11;12;Maanantai;21;22;43;12;16;28
292;16.11.2015;2015;11;13;Maanantai;23;48;71;22;10;32
292;16.11.2015;2015;11;14;Maanantai;22;67;89;13;15;28
292;16.11.2015;2015;11;15;Maanantai;31;56;87;14;17;31
292;16.11.2015;2015;11;16;Maanantai;32;67;99;10;18;28
292;16.11.2015;2015;11;17;Maanantai;27;32;59;6;6;12
292;16.11.2015;2015;11;18;Maanantai;38;23;61;19;22;41
292;16.11.2015;2015;11;19;Maanantai;21;15;36;9;6;15
292;16.11.2015;2015;11;20;Maanantai;20;11;31;6;6;12
292;16.11.2015;2015;11;21;Maanantai;7;19;26;6;0;6
292;16.11.2015;2015;11;22;Maanantai;3;2;5;0;0;0
292;16.11.2015;2015;11;23;Maanantai;0;1;1;0;0;0
292;17.11.2015;2015;11;00;Tiistai;2;0;2;0;0;0
292;17.11.2015;2015;11;01;Tiistai;0;0;0;0;0;0
292;17.11.2015;2015;11;02;Tiistai;0;1;1;0;0;0
292;17.11.2015;2015;11;03;Tiistai;0;0;0;0;1;1
292;17.11.2015;2015;11;04;Tiistai;2;1;3;0;0;0
292;17.11.2015;2015;11;05;Tiistai;9;5;14;2;1;3
292;17.11.2015;2015;11;06;Tiistai;20;15;35;0;2;2
292;17.11.2015;2015;11;07;Tiistai;77;25;102;13;9;22
292;17.11.2015;2015;11;08;Tiistai;70;19;89;22;7;29
292;17.11.2015;2015;11;09;Tiistai;20;18;38;8;5;13
292;17.11.2015;2015;11;10;Tiistai;20;18;38;5;7;12
292;17.11.2015;2015;11;11;Tiistai;23;19;42;8;3;11
292;17.11.2015;2015;11;12;Tiistai;16;19;35;8;6;14
292;17.11.2015;2015;11;13;Tiistai;24;39;63;12;9;21
292;17.11.2015;2015;11;14;Tiistai;18;65;83;14;15;29
292;17.11.2015;2015;11;15;Tiistai;28;45;73;14;25;39
292;17.11.2015;2015;11;16;Tiistai;23;35;58;9;11;20
292;17.11.2015;2015;11;17;Tiistai;29;18;47;11;7;18
292;17.11.2015;2015;11;18;Tiistai;20;16;36;10;10;20
292;17.11.2015;2015;11;19;Tiistai;14;13;27;14;8;22
292;17.11.2015;2015;11;20;Tiistai;17;10;27;6;10;16
292;17.11.2015;2015;11;21;Tiistai;7;7;14;4;3;7
292;17.11.2015;2015;11;22;Tiistai;2;5;7;1;1;2
292;17.11.2015;2015;11;23;Tiistai;1;1;2;1;0;1
292;18.11.2015;2015;11;00;Keskiviikko;0;0;0;2;1;3
292;18.11.2015;2015;11;01;Keskiviikko;0;0;0;0;2;2
292;18.11.2015;2015;11;02;Keskiviikko;0;0;0;0;0;0
292;18.11.2015;2015;11;03;Keskiviikko;0;2;2;0;0;0
292;18.11.2015;2015;11;04;Keskiviikko;2;1;3;0;0;0
292;18.11.2015;2015;11;05;Keskiviikko;7;5;12;1;1;2
292;18.11.2015;2015;11;06;Keskiviikko;21;14;35;4;7;11
292;18.11.2015;2015;11;07;Keskiviikko;80;24;104;17;12;29
292;18.11.2015;2015;11;08;Keskiviikko;51;23;74;42;21;63
292;18.11.2015;2015;11;09;Keskiviikko;29;15;44;6;6;12
292;18.11.2015;2015;11;10;Keskiviikko;24;17;41;9;13;22
292;18.11.2015;2015;11;11;Keskiviikko;23;23;46;11;7;18
292;18.11.2015;2015;11;12;Keskiviikko;28;29;57;7;10;17
292;18.11.2015;2015;11;13;Keskiviikko;34;75;109;13;14;27
292;18.11.2015;2015;11;14;Keskiviikko;23;55;78;14;11;25
292;18.11.2015;2015;11;15;Keskiviikko;41;39;80;15;18;33
292;18.11.2015;2015;11;16;Keskiviikko;41;53;94;9;16;25
292;18.11.2015;2015;11;17;Keskiviikko;33;35;68;9;11;20
292;18.11.2015;2015;11;18;Keskiviikko;36;30;66;8;14;22
292;18.11.2015;2015;11;19;Keskiviikko;15;18;33;12;8;20
292;18.11.2015;2015;11;20;Keskiviikko;8;14;22;6;3;9
292;18.11.2015;2015;11;21;Keskiviikko;7;7;14;3;4;7
292;18.11.2015;2015;11;22;Keskiviikko;3;4;7;1;3;4
292;18.11.2015;2015;11;23;Keskiviikko;2;2;4;2;2;4
292;19.11.2015;2015;11;00;Torstai;0;0;0;1;0;1
292;19.11.2015;2015;11;01;Torstai;0;0;0;0;0;0
292;19.11.2015;2015;11;02;Torstai;0;0;0;1;0;1
292;19.11.2015;2015;11;03;Torstai;0;0;0;0;1;1
292;19.11.2015;2015;11;04;Torstai;2;0;2;0;0;0
292;19.11.2015;2015;11;05;Torstai;7;5;12;2;2;4
292;19.11.2015;2015;11;06;Torstai;15;15;30;4;3;7
292;19.11.2015;2015;11;07;Torstai;65;18;83;16;8;24
292;19.11.2015;2015;11;08;Torstai;38;19;57;15;12;27
292;19.11.2015;2015;11;09;Torstai;62;22;84;9;8;17
292;19.11.2015;2015;11;10;Torstai;35;26;61;9;7;16
292;19.11.2015;2015;11;11;Torstai;36;25;61;12;10;22
292;19.11.2015;2015;11;12;Torstai;22;29;51;8;9;17
292;19.11.2015;2015;11;13;Torstai;37;59;96;17;14;31
292;19.11.2015;2015;11;14;Torstai;42;49;91;9;12;21
292;19.11.2015;2015;11;15;Torstai;43;65;108;14;25;39
292;19.11.2015;2015;11;16;Torstai;27;59;86;13;31;44
292;19.11.2015;2015;11;17;Torstai;25;27;52;11;17;28
292;19.11.2015;2015;11;18;Torstai;32;23;55;12;10;22
292;19.11.2015;2015;11;19;Torstai;15;19;34;14;11;25
292;19.11.2015;2015;11;20;Torstai;16;19;35;4;4;8
292;19.11.2015;2015;11;21;Torstai;8;11;19;5;3;8
292;19.11.2015;2015;11;22;Torstai;1;5;6;1;1;2
292;19.11.2015;2015;11;23;Torstai;0;0;0;0;1;1
292;20.11.2015;2015;11;00;Perjantai;1;0;1;0;0;0
292;20.11.2015;2015;11;01;Perjantai;0;0;0;0;0;0
292;20.11.2015;2015;11;02;Perjantai;0;0;0;0;0;0
292;20.11.2015;2015;11;03;Perjantai;0;0;0;0;0;0
292;20.11.2015;2015;11;04;Perjantai;2;0;2;1;0;1
292;20.11.2015;2015;11;05;Perjantai;12;2;14;2;2;4
292;20.11.2015;2015;11;06;Perjantai;16;8;24;4;3;7
292;20.11.2015;2015;11;07;Perjantai;60;26;86;16;12;28
292;20.11.2015;2015;11;08;Perjantai;68;18;86;10;13;23
292;20.11.2015;2015;11;09;Perjantai;35;9;44;8;5;13
292;20.11.2015;2015;11;10;Perjantai;13;10;23;10;6;16
292;20.11.2015;2015;11;11;Perjantai;8;10;18;4;10;14
292;20.11.2015;2015;11;12;Perjantai;14;31;45;21;13;34
292;20.11.2015;2015;11;13;Perjantai;23;76;99;10;24;34
292;20.11.2015;2015;11;14;Perjantai;29;57;86;9;27;36
292;20.11.2015;2015;11;15;Perjantai;34;50;84;11;16;27
292;20.11.2015;2015;11;16;Perjantai;52;30;82;11;17;28
292;20.11.2015;2015;11;17;Perjantai;15;27;42;17;11;28
292;20.11.2015;2015;11;18;Perjantai;13;17;30;17;11;28
292;20.11.2015;2015;11;19;Perjantai;24;15;39;10;9;19
292;20.11.2015;2015;11;20;Perjantai;11;14;25;9;6;15
292;20.11.2015;2015;11;21;Perjantai;11;6;17;3;4;7
292;20.11.2015;2015;11;22;Perjantai;8;8;16;4;2;6
292;20.11.2015;2015;11;23;Perjantai;6;3;9;4;1;5
292;21.11.2015;2015;11;00;Lauantai;2;7;9;4;3;7
292;21.11.2015;2015;11;01;Lauantai;2;1;3;3;4;7
292;21.11.2015;2015;11;02;Lauantai;0;2;2;0;5;5
292;21.11.2015;2015;11;03;Lauantai;0;0;0;0;1;1
292;21.11.2015;2015;11;04;Lauantai;0;2;2;0;0;0
292;21.11.2015;2015;11;05;Lauantai;0;0;0;5;0;5
292;21.11.2015;2015;11;06;Lauantai;3;1;4;1;1;2
292;21.11.2015;2015;11;07;Lauantai;2;3;5;1;3;4
292;21.11.2015;2015;11;08;Lauantai;3;5;8;1;1;2
292;21.11.2015;2015;11;09;Lauantai;8;10;18;7;7;14
292;21.11.2015;2015;11;10;Lauantai;8;12;20;6;4;10
292;21.11.2015;2015;11;11;Lauantai;13;6;19;12;7;19
292;21.11.2015;2015;11;12;Lauantai;14;15;29;12;7;19
292;21.11.2015;2015;11;13;Lauantai;17;11;28;8;13;21
292;21.11.2015;2015;11;14;Lauantai;18;15;33;13;15;28
292;21.11.2015;2015;11;15;Lauantai;8;15;23;16;14;30
292;21.11.2015;2015;11;16;Lauantai;31;15;46;15;11;26
292;21.11.2015;2015;11;17;Lauantai;10;11;21;18;16;34
292;21.11.2015;2015;11;18;Lauantai;13;14;27;18;16;34
292;21.11.2015;2015;11;19;Lauantai;10;14;24;7;8;15
292;21.11.2015;2015;11;20;Lauantai;10;7;17;4;3;7
292;21.11.2015;2015;11;21;Lauantai;4;9;13;0;3;3
292;21.11.2015;2015;11;22;Lauantai;3;2;5;3;0;3
292;21.11.2015;2015;11;23;Lauantai;3;5;8;0;1;1
292;22.11.2015;2015;11;00;Sunnuntai;6;3;9;2;2;4
292;22.11.2015;2015;11;01;Sunnuntai;0;2;2;3;2;5
292;22.11.2015;2015;11;02;Sunnuntai;0;0;0;0;3;3
292;22.11.2015;2015;11;03;Sunnuntai;0;1;1;0;1;1
292;22.11.2015;2015;11;04;Sunnuntai;2;0;2;0;0;0
292;22.11.2015;2015;11;05;Sunnuntai;0;0;0;1;0;1
292;22.11.2015;2015;11;06;Sunnuntai;4;1;5;0;1;1
292;22.11.2015;2015;11;07;Sunnuntai;1;1;2;0;0;0
292;22.11.2015;2015;11;08;Sunnuntai;1;1;2;4;2;6
292;22.11.2015;2015;11;09;Sunnuntai;24;3;27;12;10;22
292;22.11.2015;2015;11;10;Sunnuntai;6;6;12;10;8;18
292;22.11.2015;2015;11;11;Sunnuntai;7;25;32;14;11;25
292;22.11.2015;2015;11;12;Sunnuntai;15;16;31;17;11;28
292;22.11.2015;2015;11;13;Sunnuntai;15;10;25;8;15;23
292;22.11.2015;2015;11;14;Sunnuntai;14;21;35;22;17;39
292;22.11.2015;2015;11;15;Sunnuntai;9;10;19;20;12;32
292;22.11.2015;2015;11;16;Sunnuntai;5;13;18;12;12;24
292;22.11.2015;2015;11;17;Sunnuntai;12;7;19;15;8;23
292;22.11.2015;2015;11;18;Sunnuntai;14;12;26;7;5;12
292;22.11.2015;2015;11;19;Sunnuntai;10;4;14;4;7;11
292;22.11.2015;2015;11;20;Sunnuntai;2;3;5;7;7;14
292;22.11.2015;2015;11;21;Sunnuntai;3;6;9;4;2;6
292;22.11.2015;2015;11;22;Sunnuntai;5;1;6;2;1;3
292;22.11.2015;2015;11;23;Sunnuntai;0;0;0;0;0;0
292;23.11.2015;2015;11;00;Maanantai;0;0;0;0;1;1
292;23.11.2015;2015;11;01;Maanantai;0;0;0;0;0;0
292;23.11.2015;2015;11;02;Maanantai;0;1;1;0;0;0
292;23.11.2015;2015;11;03;Maanantai;0;1;1;0;1;1
292;23.11.2015;2015;11;04;Maanantai;4;0;4;1;0;1
292;23.11.2015;2015;11;05;Maanantai;8;3;11;0;0;0
292;23.11.2015;2015;11;06;Maanantai;15;17;32;5;5;10
292;23.11.2015;2015;11;07;Maanantai;61;22;83;12;12;24
292;23.11.2015;2015;11;08;Maanantai;47;22;69;16;12;28
292;23.11.2015;2015;11;09;Maanantai;50;14;64;16;14;30
292;23.11.2015;2015;11;10;Maanantai;14;8;22;16;9;25
292;23.11.2015;2015;11;11;Maanantai;21;13;34;6;7;13
292;23.11.2015;2015;11;12;Maanantai;12;20;32;7;16;23
292;23.11.2015;2015;11;13;Maanantai;20;51;71;21;17;38
292;23.11.2015;2015;11;14;Maanantai;23;52;75;17;24;41
292;23.11.2015;2015;11;15;Maanantai;35;58;93;20;23;43
292;23.11.2015;2015;11;16;Maanantai;20;46;66;7;17;24
292;23.11.2015;2015;11;17;Maanantai;19;16;35;12;11;23
292;23.11.2015;2015;11;18;Maanantai;20;9;29;10;18;28
292;23.11.2015;2015;11;19;Maanantai;19;6;25;15;14;29
292;23.11.2015;2015;11;20;Maanantai;8;7;15;4;7;11
292;23.11.2015;2015;11;21;Maanantai;5;7;12;5;4;9
292;23.11.2015;2015;11;22;Maanantai;6;3;9;2;2;4
292;23.11.2015;2015;11;23;Maanantai;0;1;1;1;3;4
292;24.11.2015;2015;11;00;Tiistai;0;1;1;0;2;2
292;24.11.2015;2015;11;01;Tiistai;0;0;0;0;0;0
292;24.11.2015;2015;11;02;Tiistai;1;2;3;0;0;0
292;24.11.2015;2015;11;03;Tiistai;0;0;0;0;0;0
292;24.11.2015;2015;11;04;Tiistai;3;0;3;2;0;2
292;24.11.2015;2015;11;05;Tiistai;8;4;12;1;0;1
292;24.11.2015;2015;11;06;Tiistai;16;19;35;1;3;4
292;24.11.2015;2015;11;07;Tiistai;69;20;89;10;10;20
292;24.11.2015;2015;11;08;Tiistai;72;20;92;13;15;28
292;24.11.2015;2015;11;09;Tiistai;25;14;39;11;12;23
292;24.11.2015;2015;11;10;Tiistai;19;16;35;13;4;17
292;24.11.2015;2015;11;11;Tiistai;13;10;23;16;14;30
292;24.11.2015;2015;11;12;Tiistai;26;18;44;13;17;30
292;24.11.2015;2015;11;13;Tiistai;23;40;63;20;12;32
292;24.11.2015;2015;11;14;Tiistai;23;67;90;24;17;41
292;24.11.2015;2015;11;15;Tiistai;26;50;76;15;20;35
292;24.11.2015;2015;11;16;Tiistai;21;43;64;9;18;27
292;24.11.2015;2015;11;17;Tiistai;20;12;32;13;10;23
292;24.11.2015;2015;11;18;Tiistai;18;15;33;15;15;30
292;24.11.2015;2015;11;19;Tiistai;11;17;28;12;12;24
292;24.11.2015;2015;11;20;Tiistai;17;10;27;10;8;18
292;24.11.2015;2015;11;21;Tiistai;4;8;12;1;1;2
292;24.11.2015;2015;11;22;Tiistai;4;6;10;0;1;1
292;24.11.2015;2015;11;23;Tiistai;0;1;1;1;0;1
292;25.11.2015;2015;11;00;Keskiviikko;2;1;3;0;0;0
292;25.11.2015;2015;11;01;Keskiviikko;0;0;0;0;0;0
292;25.11.2015;2015;11;02;Keskiviikko;0;0;0;1;0;1
292;25.11.2015;2015;11;03;Keskiviikko;1;1;2;0;0;0
292;25.11.2015;2015;11;04;Keskiviikko;2;0;2;1;1;2
292;25.11.2015;2015;11;05;Keskiviikko;8;2;10;1;4;5
292;25.11.2015;2015;11;06;Keskiviikko;15;10;25;4;2;6
292;25.11.2015;2015;11;07;Keskiviikko;60;17;77;20;10;30
292;25.11.2015;2015;11;08;Keskiviikko;37;16;53;15;13;28
292;25.11.2015;2015;11;09;Keskiviikko;8;7;15;5;4;9
292;25.11.2015;2015;11;10;Keskiviikko;18;29;47;7;8;15
292;25.11.2015;2015;11;11;Keskiviikko;12;26;38;10;11;21
292;25.11.2015;2015;11;12;Keskiviikko;9;16;25;20;5;25
292;25.11.2015;2015;11;13;Keskiviikko;16;52;68;12;8;20
292;25.11.2015;2015;11;14;Keskiviikko;27;21;48;8;8;16
292;25.11.2015;2015;11;15;Keskiviikko;22;41;63;11;20;31
292;25.11.2015;2015;11;16;Keskiviikko;26;30;56;18;15;33
292;25.11.2015;2015;11;17;Keskiviikko;16;21;37;13;6;19
292;25.11.2015;2015;11;18;Keskiviikko;9;14;23;10;4;14
292;25.11.2015;2015;11;19;Keskiviikko;2;16;18;8;11;19
292;25.11.2015;2015;11;20;Keskiviikko;13;6;19;9;3;12
292;25.11.2015;2015;11;21;Keskiviikko;4;7;11;4;1;5
292;25.11.2015;2015;11;22;Keskiviikko;1;0;1;2;2;4
292;25.11.2015;2015;11;23;Keskiviikko;3;0;3;0;0;0
292;26.11.2015;2015;11;00;Torstai;1;0;1;0;0;0
292;26.11.2015;2015;11;01;Torstai;1;0;1;0;1;1
292;26.11.2015;2015;11;02;Torstai;0;0;0;0;0;0
292;26.11.2015;2015;11;03;Torstai;1;0;1;1;2;3
292;26.11.2015;2015;11;04;Torstai;2;0;2;0;0;0
292;26.11.2015;2015;11;05;Torstai;4;1;5;2;2;4
292;26.11.2015;2015;11;06;Torstai;12;15;27;3;2;5
292;26.11.2015;2015;11;07;Torstai;65;17;82;20;13;33
292;26.11.2015;2015;11;08;Torstai;53;25;78;9;11;20
292;26.11.2015;2015;11;09;Torstai;25;27;52;11;7;18
292;26.11.2015;2015;11;10;Torstai;17;31;48;2;9;11
292;26.11.2015;2015;11;11;Torstai;17;33;50;15;10;25
292;26.11.2015;2015;11;12;Torstai;16;30;46;14;12;26
292;26.11.2015;2015;11;13;Torstai;24;31;55;22;10;32
292;26.11.2015;2015;11;14;Torstai;37;41;78;7;16;23
292;26.11.2015;2015;11;15;Torstai;23;53;76;12;11;23
292;26.11.2015;2015;11;16;Torstai;28;27;55;9;15;24
292;26.11.2015;2015;11;17;Torstai;15;18;33;6;3;9
292;26.11.2015;2015;11;18;Torstai;16;20;36;4;9;13
292;26.11.2015;2015;11;19;Torstai;11;11;22;7;8;15
292;26.11.2015;2015;11;20;Torstai;14;15;29;5;4;9
292;26.11.2015;2015;11;21;Torstai;11;8;19;3;4;7
292;26.11.2015;2015;11;22;Torstai;4;3;7;5;3;8
292;26.11.2015;2015;11;23;Torstai;1;0;1;0;1;1
292;27.11.2015;2015;11;00;Perjantai;0;1;1;0;1;1
292;27.11.2015;2015;11;01;Perjantai;0;0;0;0;0;0
292;27.11.2015;2015;11;02;Perjantai;0;0;0;0;0;0
292;27.11.2015;2015;11;03;Perjantai;0;1;1;0;0;0
292;27.11.2015;2015;11;04;Perjantai;3;0;3;0;0;0
292;27.11.2015;2015;11;05;Perjantai;5;2;7;3;1;4
292;27.11.2015;2015;11;06;Perjantai;12;8;20;6;2;8
292;27.11.2015;2015;11;07;Perjantai;47;20;67;11;11;22
292;27.11.2015;2015;11;08;Perjantai;47;20;67;9;11;20
292;27.11.2015;2015;11;09;Perjantai;12;22;34;10;10;20
292;27.11.2015;2015;11;10;Perjantai;15;24;39;6;4;10
292;27.11.2015;2015;11;11;Perjantai;10;23;33;8;10;18
292;27.11.2015;2015;11;12;Perjantai;24;36;60;20;12;32
292;27.11.2015;2015;11;13;Perjantai;24;40;64;16;19;35
292;27.11.2015;2015;11;14;Perjantai;24;40;64;6;14;20
292;27.11.2015;2015;11;15;Perjantai;27;35;62;15;14;29
292;27.11.2015;2015;11;16;Perjantai;42;29;71;8;10;18
292;27.11.2015;2015;11;17;Perjantai;21;24;45;9;7;16
292;27.11.2015;2015;11;18;Perjantai;12;18;30;7;6;13
292;27.11.2015;2015;11;19;Perjantai;20;10;30;10;8;18
292;27.11.2015;2015;11;20;Perjantai;21;9;30;8;4;12
292;27.11.2015;2015;11;21;Perjantai;19;4;23;4;4;8
292;27.11.2015;2015;11;22;Perjantai;1;3;4;2;0;2
292;27.11.2015;2015;11;23;Perjantai;4;2;6;2;0;2
292;28.11.2015;2015;11;00;Lauantai;4;5;9;5;3;8
292;28.11.2015;2015;11;01;Lauantai;5;0;5;3;4;7
292;28.11.2015;2015;11;02;Lauantai;2;2;4;4;7;11
292;28.11.2015;2015;11;03;Lauantai;0;4;4;2;1;3
292;28.11.2015;2015;11;04;Lauantai;1;0;1;1;2;3
292;28.11.2015;2015;11;05;Lauantai;0;2;2;2;0;2
292;28.11.2015;2015;11;06;Lauantai;3;1;4;3;2;5
292;28.11.2015;2015;11;07;Lauantai;5;1;6;2;2;4
292;28.11.2015;2015;11;08;Lauantai;4;8;12;5;2;7
292;28.11.2015;2015;11;09;Lauantai;5;13;18;2;3;5
292;28.11.2015;2015;11;10;Lauantai;8;8;16;8;5;13
292;28.11.2015;2015;11;11;Lauantai;8;4;12;1;2;3
292;28.11.2015;2015;11;12;Lauantai;6;5;11;1;2;3
292;28.11.2015;2015;11;13;Lauantai;15;13;28;4;4;8
292;28.11.2015;2015;11;14;Lauantai;26;20;46;19;57;76
292;28.11.2015;2015;11;15;Lauantai;21;22;43;58;5;63
292;28.11.2015;2015;11;16;Lauantai;7;9;16;12;6;18
292;28.11.2015;2015;11;17;Lauantai;10;5;15;1;6;7
292;28.11.2015;2015;11;18;Lauantai;6;6;12;11;7;18
292;28.11.2015;2015;11;19;Lauantai;9;7;16;3;2;5
292;28.11.2015;2015;11;20;Lauantai;14;3;17;5;10;15
292;28.11.2015;2015;11;21;Lauantai;10;6;16;4;2;6
292;28.11.2015;2015;11;22;Lauantai;2;3;5;1;2;3
292;28.11.2015;2015;11;23;Lauantai;4;4;8;2;1;3
292;29.11.2015;2015;11;00;Sunnuntai;2;1;3;0;0;0
292;29.11.2015;2015;11;01;Sunnuntai;4;2;6;4;5;9
292;29.11.2015;2015;11;02;Sunnuntai;1;5;6;0;3;3
292;29.11.2015;2015;11;03;Sunnuntai;0;1;1;0;6;6
292;29.11.2015;2015;11;04;Sunnuntai;0;0;0;0;0;0
292;29.11.2015;2015;11;05;Sunnuntai;0;0;0;0;0;0
292;29.11.2015;2015;11;06;Sunnuntai;3;2;5;1;1;2
292;29.11.2015;2015;11;07;Sunnuntai;1;2;3;1;2;3
292;29.11.2015;2015;11;08;Sunnuntai;2;4;6;3;1;4
292;29.11.2015;2015;11;09;Sunnuntai;21;7;28;8;9;17
292;29.11.2015;2015;11;10;Sunnuntai;11;10;21;10;8;18
292;29.11.2015;2015;11;11;Sunnuntai;12;15;27;11;16;27
292;29.11.2015;2015;11;12;Sunnuntai;22;30;52;12;17;29
292;29.11.2015;2015;11;13;Sunnuntai;12;20;32;17;17;34
292;29.11.2015;2015;11;14;Sunnuntai;24;29;53;14;12;26
292;29.11.2015;2015;11;15;Sunnuntai;26;10;36;19;7;26
292;29.11.2015;2015;11;16;Sunnuntai;9;14;23;15;11;26
292;29.11.2015;2015;11;17;Sunnuntai;11;15;26;11;18;29
292;29.11.2015;2015;11;18;Sunnuntai;7;11;18;8;14;22
292;29.11.2015;2015;11;19;Sunnuntai;14;6;20;10;10;20
292;29.11.2015;2015;11;20;Sunnuntai;13;8;21;5;4;9
292;29.11.2015;2015;11;21;Sunnuntai;2;5;7;3;2;5
292;29.11.2015;2015;11;22;Sunnuntai;4;4;8;1;0;1
292;29.11.2015;2015;11;23;Sunnuntai;0;0;0;0;0;0
292;30.11.2015;2015;11;00;Maanantai;1;1;2;0;0;0
292;30.11.2015;2015;11;01;Maanantai;0;0;0;0;0;0
292;30.11.2015;2015;11;02;Maanantai;1;0;1;0;0;0
292;30.11.2015;2015;11;03;Maanantai;0;1;1;0;0;0
292;30.11.2015;2015;11;04;Maanantai;2;1;3;1;1;2
292;30.11.2015;2015;11;05;Maanantai;8;5;13;1;0;1
292;30.11.2015;2015;11;06;Maanantai;15;9;24;3;2;5
292;30.11.2015;2015;11;07;Maanantai;74;27;101;21;13;34
292;30.11.2015;2015;11;08;Maanantai;60;18;78;14;8;22
292;30.11.2015;2015;11;09;Maanantai;10;19;29;8;18;26
292;30.11.2015;2015;11;10;Maanantai;9;23;32;15;10;25
292;30.11.2015;2015;11;11;Maanantai;26;36;62;10;11;21
292;30.11.2015;2015;11;12;Maanantai;22;27;49;6;14;20
292;30.11.2015;2015;11;13;Maanantai;25;47;72;18;14;32
292;30.11.2015;2015;11;14;Maanantai;27;36;63;17;11;28
292;30.11.2015;2015;11;15;Maanantai;25;29;54;10;11;21
292;30.11.2015;2015;11;16;Maanantai;25;33;58;9;17;26
292;30.11.2015;2015;11;17;Maanantai;18;19;37;10;9;19
292;30.11.2015;2015;11;18;Maanantai;19;8;27;7;12;19
292;30.11.2015;2015;11;19;Maanantai;12;17;29;8;4;12
292;30.11.2015;2015;11;20;Maanantai;5;8;13;4;0;4
292;30.11.2015;2015;11;21;Maanantai;8;10;18;4;7;11
292;30.11.2015;2015;11;22;Maanantai;2;2;4;1;2;3
292;30.11.2015;2015;11;23;Maanantai;0;0;0;0;1;1
292;01.12.2015;2015;12;00;Tiistai;0;1;1;1;2;3
292;01.12.2015;2015;12;01;Tiistai;1;0;1;0;0;0
292;01.12.2015;2015;12;02;Tiistai;0;1;1;0;0;0
292;01.12.2015;2015;12;03;Tiistai;1;0;1;1;0;1
292;01.12.2015;2015;12;04;Tiistai;3;0;3;0;0;0
292;01.12.2015;2015;12;05;Tiistai;7;6;13;1;0;1
292;01.12.2015;2015;12;06;Tiistai;13;15;28;3;3;6
292;01.12.2015;2015;12;07;Tiistai;63;20;83;9;11;20
292;01.12.2015;2015;12;08;Tiistai;49;16;65;13;10;23
292;01.12.2015;2015;12;09;Tiistai;10;21;31;10;11;21
292;01.12.2015;2015;12;10;Tiistai;36;22;58;4;6;10
292;01.12.2015;2015;12;11;Tiistai;24;31;55;9;15;24
292;01.12.2015;2015;12;12;Tiistai;22;34;56;10;12;22
292;01.12.2015;2015;12;13;Tiistai;20;41;61;17;10;27
292;01.12.2015;2015;12;14;Tiistai;22;34;56;15;15;30
292;01.12.2015;2015;12;15;Tiistai;31;46;77;16;16;32
292;01.12.2015;2015;12;16;Tiistai;27;36;63;10;12;22
292;01.12.2015;2015;12;17;Tiistai;22;23;45;9;5;14
292;01.12.2015;2015;12;18;Tiistai;13;13;26;12;12;24
292;01.12.2015;2015;12;19;Tiistai;17;18;35;10;10;20
292;01.12.2015;2015;12;20;Tiistai;15;14;29;9;3;12
292;01.12.2015;2015;12;21;Tiistai;9;3;12;3;2;5
292;01.12.2015;2015;12;22;Tiistai;1;3;4;1;2;3
292;01.12.2015;2015;12;23;Tiistai;0;0;0;1;0;1
292;02.12.2015;2015;12;00;Keskiviikko;0;1;1;2;0;2
292;02.12.2015;2015;12;01;Keskiviikko;0;0;0;0;0;0
292;02.12.2015;2015;12;02;Keskiviikko;0;0;0;0;0;0
292;02.12.2015;2015;12;03;Keskiviikko;0;0;0;0;0;0
292;02.12.2015;2015;12;04;Keskiviikko;2;0;2;2;0;2
292;02.12.2015;2015;12;05;Keskiviikko;9;7;16;1;1;2
292;02.12.2015;2015;12;06;Keskiviikko;12;13;25;4;5;9
292;02.12.2015;2015;12;07;Keskiviikko;76;23;99;24;16;40
292;02.12.2015;2015;12;08;Keskiviikko;37;22;59;13;14;27
292;02.12.2015;2015;12;09;Keskiviikko;13;15;28;8;9;17
292;02.12.2015;2015;12;10;Keskiviikko;14;25;39;7;15;22
292;02.12.2015;2015;12;11;Keskiviikko;11;24;35;15;7;22
292;02.12.2015;2015;12;12;Keskiviikko;17;24;41;11;10;21
292;02.12.2015;2015;12;13;Keskiviikko;23;53;76;20;24;44
292;02.12.2015;2015;12;14;Keskiviikko;28;32;60;15;15;30
292;02.12.2015;2015;12;15;Keskiviikko;33;41;74;15;10;25
292;02.12.2015;2015;12;16;Keskiviikko;28;27;55;9;11;20
292;02.12.2015;2015;12;17;Keskiviikko;24;27;51;11;9;20
292;02.12.2015;2015;12;18;Keskiviikko;13;13;26;6;20;26
292;02.12.2015;2015;12;19;Keskiviikko;17;15;32;8;7;15
292;02.12.2015;2015;12;20;Keskiviikko;12;8;20;6;5;11
292;02.12.2015;2015;12;21;Keskiviikko;8;8;16;4;2;6
292;02.12.2015;2015;12;22;Keskiviikko;2;5;7;1;1;2
292;02.12.2015;2015;12;23;Keskiviikko;0;0;0;0;0;0
292;03.12.2015;2015;12;00;Torstai;1;0;1;0;0;0
292;03.12.2015;2015;12;01;Torstai;0;0;0;0;0;0
292;03.12.2015;2015;12;02;Torstai;0;0;0;0;0;0
292;03.12.2015;2015;12;03;Torstai;0;1;1;1;0;1
292;03.12.2015;2015;12;04;Torstai;2;0;2;0;0;0
292;03.12.2015;2015;12;05;Torstai;6;4;10;1;1;2
292;03.12.2015;2015;12;06;Torstai;13;12;25;2;1;3
292;03.12.2015;2015;12;07;Torstai;63;18;81;14;9;23
292;03.12.2015;2015;12;08;Torstai;33;19;52;12;14;26
292;03.12.2015;2015;12;09;Torstai;35;13;48;8;9;17
292;03.12.2015;2015;12;10;Torstai;11;4;15;4;2;6
292;03.12.2015;2015;12;11;Torstai;20;7;27;8;6;14
292;03.12.2015;2015;12;12;Torstai;5;16;21;20;16;36
292;03.12.2015;2015;12;13;Torstai;11;28;39;13;13;26
292;03.12.2015;2015;12;14;Torstai;27;29;56;16;20;36
292;03.12.2015;2015;12;15;Torstai;20;42;62;20;18;38
292;03.12.2015;2015;12;16;Torstai;29;63;92;13;30;43
292;03.12.2015;2015;12;17;Torstai;21;24;45;8;9;17
292;03.12.2015;2015;12;18;Torstai;12;16;28;9;10;19
292;03.12.2015;2015;12;19;Torstai;17;13;30;13;9;22
292;03.12.2015;2015;12;20;Torstai;20;15;35;10;8;18
292;03.12.2015;2015;12;21;Torstai;9;7;16;2;2;4
292;03.12.2015;2015;12;22;Torstai;1;6;7;1;1;2
292;03.12.2015;2015;12;23;Torstai;2;0;2;0;0;0
292;04.12.2015;2015;12;00;Perjantai;0;1;1;1;0;1
292;04.12.2015;2015;12;01;Perjantai;0;0;0;0;1;1
292;04.12.2015;2015;12;02;Perjantai;0;0;0;0;0;0
292;04.12.2015;2015;12;03;Perjantai;0;0;0;0;0;0
292;04.12.2015;2015;12;04;Perjantai;2;0;2;1;0;1
292;04.12.2015;2015;12;05;Perjantai;9;5;14;2;1;3
292;04.12.2015;2015;12;06;Perjantai;12;8;20;1;4;5
292;04.12.2015;2015;12;07;Perjantai;46;22;68;14;12;26
292;04.12.2015;2015;12;08;Perjantai;46;13;59;17;17;34
292;04.12.2015;2015;12;09;Perjantai;35;11;46;14;9;23
292;04.12.2015;2015;12;10;Perjantai;21;15;36;7;10;17
292;04.12.2015;2015;12;11;Perjantai;8;9;17;14;11;25
292;04.12.2015;2015;12;12;Perjantai;29;32;61;24;10;34
292;04.12.2015;2015;12;13;Perjantai;27;60;87;11;18;29
292;04.12.2015;2015;12;14;Perjantai;27;47;74;11;13;24
292;04.12.2015;2015;12;15;Perjantai;22;31;53;13;5;18
292;04.12.2015;2015;12;16;Perjantai;22;19;41;11;8;19
292;04.12.2015;2015;12;17;Perjantai;19;12;31;4;1;5
292;04.12.2015;2015;12;18;Perjantai;16;16;32;7;4;11
292;04.12.2015;2015;12;19;Perjantai;13;9;22;6;8;14
292;04.12.2015;2015;12;20;Perjantai;12;8;20;7;6;13
292;04.12.2015;2015;12;21;Perjantai;12;7;19;6;4;10
292;04.12.2015;2015;12;22;Perjantai;10;5;15;4;4;8
292;04.12.2015;2015;12;23;Perjantai;2;0;2;4;1;5
292;05.12.2015;2015;12;00;Lauantai;1;3;4;2;3;5
292;05.12.2015;2015;12;01;Lauantai;1;0;1;2;1;3
292;05.12.2015;2015;12;02;Lauantai;0;0;0;0;4;4
292;05.12.2015;2015;12;03;Lauantai;0;2;2;1;2;3
292;05.12.2015;2015;12;04;Lauantai;1;0;1;2;0;2
292;05.12.2015;2015;12;05;Lauantai;0;1;1;1;0;1
292;05.12.2015;2015;12;06;Lauantai;4;3;7;1;3;4
292;05.12.2015;2015;12;07;Lauantai;1;3;4;7;1;8
292;05.12.2015;2015;12;08;Lauantai;4;4;8;2;1;3
292;05.12.2015;2015;12;09;Lauantai;4;5;9;4;4;8
292;05.12.2015;2015;12;10;Lauantai;3;5;8;7;2;9
292;05.12.2015;2015;12;11;Lauantai;8;16;24;11;5;16
292;05.12.2015;2015;12;12;Lauantai;16;10;26;3;5;8
292;05.12.2015;2015;12;13;Lauantai;17;7;24;3;8;11
292;05.12.2015;2015;12;14;Lauantai;19;22;41;15;4;19
292;05.12.2015;2015;12;15;Lauantai;16;9;25;15;4;19
292;05.12.2015;2015;12;16;Lauantai;21;10;31;4;0;4
292;05.12.2015;2015;12;17;Lauantai;23;13;36;12;4;16
292;05.12.2015;2015;12;18;Lauantai;8;6;14;7;4;11
292;05.12.2015;2015;12;19;Lauantai;11;9;20;6;3;9
292;05.12.2015;2015;12;20;Lauantai;6;16;22;0;1;1
292;05.12.2015;2015;12;21;Lauantai;7;16;23;1;5;6
292;05.12.2015;2015;12;22;Lauantai;7;1;8;3;1;4
292;05.12.2015;2015;12;23;Lauantai;3;1;4;1;1;2
292;06.12.2015;2015;12;00;Sunnuntai;4;1;5;5;0;5
292;06.12.2015;2015;12;01;Sunnuntai;0;1;1;4;3;7
292;06.12.2015;2015;12;02;Sunnuntai;3;1;4;8;7;15
292;06.12.2015;2015;12;03;Sunnuntai;1;1;2;0;2;2
292;06.12.2015;2015;12;04;Sunnuntai;0;0;0;0;1;1
292;06.12.2015;2015;12;05;Sunnuntai;0;0;0;1;0;1
292;06.12.2015;2015;12;06;Sunnuntai;2;2;4;2;0;2
292;06.12.2015;2015;12;07;Sunnuntai;1;3;4;0;0;0
292;06.12.2015;2015;12;08;Sunnuntai;1;2;3;5;2;7
292;06.12.2015;2015;12;09;Sunnuntai;4;3;7;15;3;18
292;06.12.2015;2015;12;10;Sunnuntai;6;3;9;7;17;24
292;06.12.2015;2015;12;11;Sunnuntai;8;7;15;15;8;23
292;06.12.2015;2015;12;12;Sunnuntai;6;8;14;11;6;17
292;06.12.2015;2015;12;13;Sunnuntai;12;5;17;8;9;17
292;06.12.2015;2015;12;14;Sunnuntai;9;10;19;11;8;19
292;06.12.2015;2015;12;15;Sunnuntai;6;5;11;10;9;19
292;06.12.2015;2015;12;16;Sunnuntai;9;12;21;8;5;13
292;06.12.2015;2015;12;17;Sunnuntai;13;7;20;10;5;15
292;06.12.2015;2015;12;18;Sunnuntai;6;4;10;12;9;21
292;06.12.2015;2015;12;19;Sunnuntai;7;5;12;11;4;15
292;06.12.2015;2015;12;20;Sunnuntai;4;6;10;9;7;16
292;06.12.2015;2015;12;21;Sunnuntai;2;1;3;1;1;2
292;06.12.2015;2015;12;22;Sunnuntai;1;4;5;3;2;5
292;06.12.2015;2015;12;23;Sunnuntai;0;1;1;0;0;0
292;07.12.2015;2015;12;00;Maanantai;0;0;0;1;0;1
292;07.12.2015;2015;12;01;Maanantai;0;3;3;1;0;1
292;07.12.2015;2015;12;02;Maanantai;0;0;0;0;0;0
292;07.12.2015;2015;12;03;Maanantai;0;0;0;0;0;0
292;07.12.2015;2015;12;04;Maanantai;2;0;2;1;1;2
292;07.12.2015;2015;12;05;Maanantai;4;3;7;1;1;2
292;07.12.2015;2015;12;06;Maanantai;13;11;24;4;3;7
292;07.12.2015;2015;12;07;Maanantai;50;27;77;12;4;16
292;07.12.2015;2015;12;08;Maanantai;34;28;62;4;4;8
292;07.12.2015;2015;12;09;Maanantai;26;15;41;3;0;3
292;07.12.2015;2015;12;10;Maanantai;10;9;19;8;3;11
292;07.12.2015;2015;12;11;Maanantai;21;12;33;5;1;6
292;07.12.2015;2015;12;12;Maanantai;18;13;31;13;8;21
292;07.12.2015;2015;12;13;Maanantai;13;22;35;20;5;25
292;07.12.2015;2015;12;14;Maanantai;16;58;74;13;14;27
292;07.12.2015;2015;12;15;Maanantai;24;53;77;13;14;27
292;07.12.2015;2015;12;16;Maanantai;29;47;76;10;16;26
292;07.12.2015;2015;12;17;Maanantai;14;26;40;19;16;35
292;07.12.2015;2015;12;18;Maanantai;24;7;31;7;16;23
292;07.12.2015;2015;12;19;Maanantai;8;11;19;18;17;35
292;07.12.2015;2015;12;20;Maanantai;12;15;27;5;5;10
292;07.12.2015;2015;12;21;Maanantai;13;7;20;2;1;3
292;07.12.2015;2015;12;22;Maanantai;2;3;5;1;2;3
292;07.12.2015;2015;12;23;Maanantai;0;2;2;0;0;0
292;08.12.2015;2015;12;00;Tiistai;0;1;1;0;0;0
292;08.12.2015;2015;12;01;Tiistai;0;0;0;0;0;0
292;08.12.2015;2015;12;02;Tiistai;0;1;1;0;0;0
292;08.12.2015;2015;12;03;Tiistai;0;0;0;0;0;0
292;08.12.2015;2015;12;04;Tiistai;2;0;2;1;0;1
292;08.12.2015;2015;12;05;Tiistai;4;1;5;1;0;1
292;08.12.2015;2015;12;06;Tiistai;11;8;19;2;8;10
292;08.12.2015;2015;12;07;Tiistai;47;20;67;18;14;32
292;08.12.2015;2015;12;08;Tiistai;48;16;64;19;15;34
292;08.12.2015;2015;12;09;Tiistai;21;17;38;8;8;16
292;08.12.2015;2015;12;10;Tiistai;18;6;24;11;8;19
292;08.12.2015;2015;12;11;Tiistai;16;24;40;13;16;29
292;08.12.2015;2015;12;12;Tiistai;6;12;18;10;11;21
292;08.12.2015;2015;12;13;Tiistai;17;30;47;18;17;35
292;08.12.2015;2015;12;14;Tiistai;27;47;74;16;23;39
292;08.12.2015;2015;12;15;Tiistai;18;42;60;12;16;28
292;08.12.2015;2015;12;16;Tiistai;25;31;56;19;13;32
292;08.12.2015;2015;12;17;Tiistai;13;22;35;8;13;21
292;08.12.2015;2015;12;18;Tiistai;29;9;38;15;15;30
292;08.12.2015;2015;12;19;Tiistai;10;24;34;11;6;17
292;08.12.2015;2015;12;20;Tiistai;15;8;23;7;4;11
292;08.12.2015;2015;12;21;Tiistai;3;4;7;6;4;10
292;08.12.2015;2015;12;22;Tiistai;2;4;6;0;1;1
292;08.12.2015;2015;12;23;Tiistai;0;0;0;1;1;2
292;09.12.2015;2015;12;00;Keskiviikko;0;1;1;0;0;0
292;09.12.2015;2015;12;01;Keskiviikko;0;0;0;1;0;1
292;09.12.2015;2015;12;02;Keskiviikko;0;4;4;0;0;0
292;09.12.2015;2015;12;03;Keskiviikko;0;0;0;0;0;0
292;09.12.2015;2015;12;04;Keskiviikko;1;0;1;1;0;1
292;09.12.2015;2015;12;05;Keskiviikko;3;2;5;2;1;3
292;09.12.2015;2015;12;06;Keskiviikko;8;11;19;3;2;5
292;09.12.2015;2015;12;07;Keskiviikko;51;18;69;16;12;28
292;09.12.2015;2015;12;08;Keskiviikko;45;16;61;11;13;24
292;09.12.2015;2015;12;09;Keskiviikko;29;6;35;8;11;19
292;09.12.2015;2015;12;10;Keskiviikko;13;11;24;10;8;18
292;09.12.2015;2015;12;11;Keskiviikko;10;16;26;10;4;14
292;09.12.2015;2015;12;12;Keskiviikko;15;9;24;13;8;21
292;09.12.2015;2015;12;13;Keskiviikko;11;54;65;13;19;32
292;09.12.2015;2015;12;14;Keskiviikko;14;49;63;9;9;18
292;09.12.2015;2015;12;15;Keskiviikko;18;24;42;13;11;24
292;09.12.2015;2015;12;16;Keskiviikko;29;26;55;7;14;21
292;09.12.2015;2015;12;17;Keskiviikko;4;9;13;6;5;11
292;09.12.2015;2015;12;18;Keskiviikko;4;19;23;9;7;16
292;09.12.2015;2015;12;19;Keskiviikko;6;9;15;8;8;16
292;09.12.2015;2015;12;20;Keskiviikko;7;2;9;6;3;9
292;09.12.2015;2015;12;21;Keskiviikko;10;2;12;2;6;8
292;09.12.2015;2015;12;22;Keskiviikko;2;1;3;2;1;3
292;09.12.2015;2015;12;23;Keskiviikko;0;0;0;0;0;0
292;10.12.2015;2015;12;00;Torstai;0;0;0;0;1;1
292;10.12.2015;2015;12;01;Torstai;0;0;0;1;0;1
292;10.12.2015;2015;12;02;Torstai;0;0;0;0;1;1
292;10.12.2015;2015;12;03;Torstai;0;0;0;0;0;0
292;10.12.2015;2015;12;04;Torstai;1;0;1;1;1;2
292;10.12.2015;2015;12;05;Torstai;4;5;9;3;0;3
292;10.12.2015;2015;12;06;Torstai;9;9;18;2;8;10
292;10.12.2015;2015;12;07;Torstai;36;10;46;14;18;32
292;10.12.2015;2015;12;08;Torstai;24;17;41;12;12;24
292;10.12.2015;2015;12;09;Torstai;33;11;44;11;8;19
292;10.12.2015;2015;12;10;Torstai;10;12;22;5;7;12
292;10.12.2015;2015;12;11;Torstai;16;12;28;11;7;18
292;10.12.2015;2015;12;12;Torstai;13;9;22;11;11;22
292;10.12.2015;2015;12;13;Torstai;9;20;29;19;6;25
292;10.12.2015;2015;12;14;Torstai;10;16;26;13;12;25
292;10.12.2015;2015;12;15;Torstai;17;32;49;8;16;24
292;10.12.2015;2015;12;16;Torstai;18;42;60;10;18;28
292;10.12.2015;2015;12;17;Torstai;16;11;27;17;13;30
292;10.12.2015;2015;12;18;Torstai;24;10;34;12;11;23
292;10.12.2015;2015;12;19;Torstai;6;16;22;10;11;21
292;10.12.2015;2015;12;20;Torstai;8;23;31;8;7;15
292;10.12.2015;2015;12;21;Torstai;9;5;14;2;1;3
292;10.12.2015;2015;12;22;Torstai;1;5;6;1;1;2
292;10.12.2015;2015;12;23;Torstai;0;0;0;2;1;3
292;11.12.2015;2015;12;00;Perjantai;0;0;0;1;1;2
292;11.12.2015;2015;12;01;Perjantai;0;0;0;0;2;2
292;11.12.2015;2015;12;02;Perjantai;0;0;0;0;1;1
292;11.12.2015;2015;12;03;Perjantai;0;0;0;0;1;1
292;11.12.2015;2015;12;04;Perjantai;1;0;1;1;2;3
292;11.12.2015;2015;12;05;Perjantai;7;2;9;3;0;3
292;11.12.2015;2015;12;06;Perjantai;5;4;9;2;7;9
292;11.12.2015;2015;12;07;Perjantai;40;16;56;14;18;32
292;11.12.2015;2015;12;08;Perjantai;52;12;64;12;17;29
292;11.12.2015;2015;12;09;Perjantai;20;5;25;11;4;15
292;11.12.2015;2015;12;10;Perjantai;10;7;17;8;12;20
292;11.12.2015;2015;12;11;Perjantai;15;16;31;7;7;14
292;11.12.2015;2015;12;12;Perjantai;19;26;45;25;14;39
292;11.12.2015;2015;12;13;Perjantai;15;43;58;7;20;27
292;11.12.2015;2015;12;14;Perjantai;14;32;46;15;15;30
292;11.12.2015;2015;12;15;Perjantai;21;23;44;20;18;38
292;11.12.2015;2015;12;16;Perjantai;18;20;38;8;8;16
292;11.12.2015;2015;12;17;Perjantai;12;22;34;7;8;15
292;11.12.2015;2015;12;18;Perjantai;11;12;23;16;14;30
292;11.12.2015;2015;12;19;Perjantai;23;12;35;11;5;16
292;11.12.2015;2015;12;20;Perjantai;18;11;29;7;3;10
292;11.12.2015;2015;12;21;Perjantai;11;6;17;4;1;5
292;11.12.2015;2015;12;22;Perjantai;6;14;20;5;7;12
292;11.12.2015;2015;12;23;Perjantai;2;5;7;5;1;6
292;12.12.2015;2015;12;00;Lauantai;6;2;8;5;3;8
292;12.12.2015;2015;12;01;Lauantai;0;0;0;0;2;2
292;12.12.2015;2015;12;02;Lauantai;0;3;3;0;6;6
292;12.12.2015;2015;12;03;Lauantai;0;0;0;0;1;1
292;12.12.2015;2015;12;04;Lauantai;2;0;2;1;0;1
292;12.12.2015;2015;12;05;Lauantai;1;0;1;1;0;1
292;12.12.2015;2015;12;06;Lauantai;6;1;7;2;2;4
292;12.12.2015;2015;12;07;Lauantai;1;1;2;1;2;3
292;12.12.2015;2015;12;08;Lauantai;2;4;6;0;0;0
292;12.12.2015;2015;12;09;Lauantai;8;10;18;9;6;15
292;12.12.2015;2015;12;10;Lauantai;17;10;27;16;10;26
292;12.12.2015;2015;12;11;Lauantai;7;14;21;8;5;13
292;12.12.2015;2015;12;12;Lauantai;13;9;22;11;6;17
292;12.12.2015;2015;12;13;Lauantai;14;11;25;11;12;23
292;12.12.2015;2015;12;14;Lauantai;15;14;29;13;8;21
292;12.12.2015;2015;12;15;Lauantai;14;8;22;9;8;17
292;12.12.2015;2015;12;16;Lauantai;7;13;20;11;11;22
292;12.12.2015;2015;12;17;Lauantai;17;12;29;10;5;15
292;12.12.2015;2015;12;18;Lauantai;7;11;18;11;10;21
292;12.12.2015;2015;12;19;Lauantai;17;11;28;7;9;16
292;12.12.2015;2015;12;20;Lauantai;7;7;14;11;5;16
292;12.12.2015;2015;12;21;Lauantai;2;3;5;1;2;3
292;12.12.2015;2015;12;22;Lauantai;3;3;6;1;1;2
292;12.12.2015;2015;12;23;Lauantai;3;1;4;3;3;6
292;13.12.2015;2015;12;00;Sunnuntai;3;0;3;2;0;2
292;13.12.2015;2015;12;01;Sunnuntai;3;2;5;0;2;2
292;13.12.2015;2015;12;02;Sunnuntai;1;0;1;1;2;3
292;13.12.2015;2015;12;03;Sunnuntai;1;1;2;2;0;2
292;13.12.2015;2015;12;04;Sunnuntai;1;0;1;2;1;3
292;13.12.2015;2015;12;05;Sunnuntai;0;1;1;2;1;3
292;13.12.2015;2015;12;06;Sunnuntai;8;3;11;1;1;2
292;13.12.2015;2015;12;07;Sunnuntai;0;0;0;2;2;4
292;13.12.2015;2015;12;08;Sunnuntai;2;0;2;3;2;5
292;13.12.2015;2015;12;09;Sunnuntai;16;2;18;5;3;8
292;13.12.2015;2015;12;10;Sunnuntai;3;5;8;7;14;21
292;13.12.2015;2015;12;11;Sunnuntai;4;11;15;12;13;25
292;13.12.2015;2015;12;12;Sunnuntai;8;7;15;14;17;31
292;13.12.2015;2015;12;13;Sunnuntai;7;10;17;9;8;17
292;13.12.2015;2015;12;14;Sunnuntai;10;13;23;14;13;27
292;13.12.2015;2015;12;15;Sunnuntai;11;10;21;7;9;16
292;13.12.2015;2015;12;16;Sunnuntai;6;9;15;10;11;21
292;13.12.2015;2015;12;17;Sunnuntai;9;7;16;19;8;27
292;13.12.2015;2015;12;18;Sunnuntai;5;7;12;7;11;18
292;13.12.2015;2015;12;19;Sunnuntai;5;2;7;5;10;15
292;13.12.2015;2015;12;20;Sunnuntai;3;4;7;6;5;11
292;13.12.2015;2015;12;21;Sunnuntai;4;5;9;3;2;5
292;13.12.2015;2015;12;22;Sunnuntai;1;5;6;0;1;1
292;13.12.2015;2015;12;23;Sunnuntai;0;0;0;1;1;2
292;14.12.2015;2015;12;00;Maanantai;0;1;1;1;0;1
292;14.12.2015;2015;12;01;Maanantai;0;0;0;0;0;0
292;14.12.2015;2015;12;02;Maanantai;1;0;1;0;0;0
292;14.12.2015;2015;12;03;Maanantai;1;0;1;0;0;0
292;14.12.2015;2015;12;04;Maanantai;4;0;4;1;1;2
292;14.12.2015;2015;12;05;Maanantai;6;5;11;1;1;2
292;14.12.2015;2015;12;06;Maanantai;11;16;27;6;1;7
292;14.12.2015;2015;12;07;Maanantai;53;18;71;14;15;29
292;14.12.2015;2015;12;08;Maanantai;28;20;48;17;11;28
292;14.12.2015;2015;12;09;Maanantai;34;12;46;12;8;20
292;14.12.2015;2015;12;10;Maanantai;15;4;19;14;9;23
292;14.12.2015;2015;12;11;Maanantai;22;9;31;7;11;18
292;14.12.2015;2015;12;12;Maanantai;12;20;32;10;10;20
292;14.12.2015;2015;12;13;Maanantai;14;28;42;20;17;37
292;14.12.2015;2015;12;14;Maanantai;20;52;72;18;20;38
292;14.12.2015;2015;12;15;Maanantai;21;44;65;19;9;28
292;14.12.2015;2015;12;16;Maanantai;27;41;68;11;19;30
292;14.12.2015;2015;12;17;Maanantai;16;25;41;8;8;16
292;14.12.2015;2015;12;18;Maanantai;9;13;22;15;6;21
292;14.12.2015;2015;12;19;Maanantai;7;9;16;8;7;15
292;14.12.2015;2015;12;20;Maanantai;8;4;12;6;4;10
292;14.12.2015;2015;12;21;Maanantai;5;8;13;1;4;5
292;14.12.2015;2015;12;22;Maanantai;4;2;6;2;1;3
292;14.12.2015;2015;12;23;Maanantai;1;0;1;0;0;0
292;15.12.2015;2015;12;00;Tiistai;0;0;0;0;1;1
292;15.12.2015;2015;12;01;Tiistai;0;1;1;0;0;0
292;15.12.2015;2015;12;02;Tiistai;0;1;1;0;0;0
292;15.12.2015;2015;12;03;Tiistai;1;0;1;1;0;1
292;15.12.2015;2015;12;04;Tiistai;3;0;3;0;0;0
292;15.12.2015;2015;12;05;Tiistai;6;4;10;0;1;1
292;15.12.2015;2015;12;06;Tiistai;8;11;19;3;3;6
292;15.12.2015;2015;12;07;Tiistai;52;18;70;10;9;19
292;15.12.2015;2015;12;08;Tiistai;53;14;67;20;9;29
292;15.12.2015;2015;12;09;Tiistai;27;9;36;11;7;18
292;15.12.2015;2015;12;10;Tiistai;7;5;12;7;5;12
292;15.12.2015;2015;12;11;Tiistai;16;16;32;18;14;32
292;15.12.2015;2015;12;12;Tiistai;6;8;14;13;9;22
292;15.12.2015;2015;12;13;Tiistai;14;31;45;13;10;23
292;15.12.2015;2015;12;14;Tiistai;20;64;84;20;14;34
292;15.12.2015;2015;12;15;Tiistai;15;36;51;14;27;41
292;15.12.2015;2015;12;16;Tiistai;19;33;52;18;12;30
292;15.12.2015;2015;12;17;Tiistai;14;12;26;12;11;23
292;15.12.2015;2015;12;18;Tiistai;12;16;28;11;14;25
292;15.12.2015;2015;12;19;Tiistai;10;7;17;7;2;9
292;15.12.2015;2015;12;20;Tiistai;6;4;10;8;7;15
292;15.12.2015;2015;12;21;Tiistai;5;5;10;2;2;4
292;15.12.2015;2015;12;22;Tiistai;5;7;12;0;2;2
292;15.12.2015;2015;12;23;Tiistai;0;0;0;1;0;1
292;16.12.2015;2015;12;00;Keskiviikko;0;0;0;0;0;0
292;16.12.2015;2015;12;01;Keskiviikko;0;0;0;0;0;0
292;16.12.2015;2015;12;02;Keskiviikko;1;0;1;0;0;0
292;16.12.2015;2015;12;03;Keskiviikko;0;0;0;0;0;0
292;16.12.2015;2015;12;04;Keskiviikko;3;0;3;1;0;1
292;16.12.2015;2015;12;05;Keskiviikko;10;5;15;1;2;3
292;16.12.2015;2015;12;06;Keskiviikko;9;10;19;2;5;7
292;16.12.2015;2015;12;07;Keskiviikko;59;18;77;19;9;28
292;16.12.2015;2015;12;08;Keskiviikko;37;11;48;11;11;22
292;16.12.2015;2015;12;09;Keskiviikko;30;9;39;12;8;20
292;16.12.2015;2015;12;10;Keskiviikko;7;8;15;7;8;15
292;16.12.2015;2015;12;11;Keskiviikko;7;13;20;10;13;23
292;16.12.2015;2015;12;12;Keskiviikko;9;17;26;11;13;24
292;16.12.2015;2015;12;13;Keskiviikko;21;58;79;26;16;42
292;16.12.2015;2015;12;14;Keskiviikko;21;29;50;10;20;30
292;16.12.2015;2015;12;15;Keskiviikko;27;33;60;14;14;28
292;16.12.2015;2015;12;16;Keskiviikko;6;29;35;17;10;27
292;16.12.2015;2015;12;17;Keskiviikko;13;19;32;11;10;21
292;16.12.2015;2015;12;18;Keskiviikko;12;7;19;7;7;14
292;16.12.2015;2015;12;19;Keskiviikko;9;7;16;6;10;16
292;16.12.2015;2015;12;20;Keskiviikko;11;3;14;7;5;12
292;16.12.2015;2015;12;21;Keskiviikko;3;6;9;3;2;5
292;16.12.2015;2015;12;22;Keskiviikko;1;3;4;2;0;2
292;16.12.2015;2015;12;23;Keskiviikko;0;1;1;0;0;0
292;17.12.2015;2015;12;00;Torstai;0;0;0;0;0;0
292;17.12.2015;2015;12;01;Torstai;0;0;0;0;0;0
292;17.12.2015;2015;12;02;Torstai;0;0;0;0;1;1
292;17.12.2015;2015;12;03;Torstai;0;0;0;2;0;2
292;17.12.2015;2015;12;04;Torstai;3;0;3;0;0;0
292;17.12.2015;2015;12;05;Torstai;9;6;15;1;0;1
292;17.12.2015;2015;12;06;Torstai;11;7;18;3;3;6
292;17.12.2015;2015;12;07;Torstai;38;10;48;18;12;30
292;17.12.2015;2015;12;08;Torstai;36;15;51;17;11;28
292;17.12.2015;2015;12;09;Torstai;37;4;41;15;2;17
292;17.12.2015;2015;12;10;Torstai;9;6;15;8;2;10
292;17.12.2015;2015;12;11;Torstai;19;9;28;3;7;10
292;17.12.2015;2015;12;12;Torstai;15;17;32;16;9;25
292;17.12.2015;2015;12;13;Torstai;21;43;64;15;21;36
292;17.12.2015;2015;12;14;Torstai;20;22;42;9;10;19
292;17.12.2015;2015;12;15;Torstai;16;42;58;11;11;22
292;17.12.2015;2015;12;16;Torstai;11;41;52;11;5;16
292;17.12.2015;2015;12;17;Torstai;18;20;38;9;8;17
292;17.12.2015;2015;12;18;Torstai;19;8;27;5;7;12
292;17.12.2015;2015;12;19;Torstai;14;9;23;7;4;11
292;17.12.2015;2015;12;20;Torstai;18;8;26;5;4;9
292;17.12.2015;2015;12;21;Torstai;7;8;15;7;4;11
292;17.12.2015;2015;12;22;Torstai;4;7;11;0;1;1
292;17.12.2015;2015;12;23;Torstai;0;0;0;0;0;0
292;18.12.2015;2015;12;00;Perjantai;0;0;0;1;0;1
292;18.12.2015;2015;12;01;Perjantai;0;0;0;1;1;2
292;18.12.2015;2015;12;02;Perjantai;0;0;0;0;0;0
292;18.12.2015;2015;12;03;Perjantai;0;0;0;0;0;0
292;18.12.2015;2015;12;04;Perjantai;1;1;2;1;0;1
292;18.12.2015;2015;12;05;Perjantai;9;3;12;2;1;3
292;18.12.2015;2015;12;06;Perjantai;12;7;19;3;0;3
292;18.12.2015;2015;12;07;Perjantai;28;11;39;8;5;13
292;18.12.2015;2015;12;08;Perjantai;52;17;69;26;3;29
292;18.12.2015;2015;12;09;Perjantai;37;4;41;11;4;15
292;18.12.2015;2015;12;10;Perjantai;12;6;18;5;0;5
292;18.12.2015;2015;12;11;Perjantai;10;13;23;8;1;9
292;18.12.2015;2015;12;12;Perjantai;17;15;32;16;1;17
292;18.12.2015;2015;12;13;Perjantai;26;52;78;20;6;26
292;18.12.2015;2015;12;14;Perjantai;27;53;80;9;8;17
292;18.12.2015;2015;12;15;Perjantai;21;21;42;11;5;16
292;18.12.2015;2015;12;16;Perjantai;15;13;28;11;4;15
292;18.12.2015;2015;12;17;Perjantai;16;12;28;2;2;4
292;18.12.2015;2015;12;18;Perjantai;6;3;9;4;0;4
292;18.12.2015;2015;12;19;Perjantai;7;3;10;6;2;8
292;18.12.2015;2015;12;20;Perjantai;6;2;8;4;0;4
292;18.12.2015;2015;12;21;Perjantai;3;3;6;2;0;2
292;18.12.2015;2015;12;22;Perjantai;6;2;8;4;0;4
292;18.12.2015;2015;12;23;Perjantai;4;2;6;3;0;3
292;19.12.2015;2015;12;00;Lauantai;3;6;9;2;1;3
292;19.12.2015;2015;12;01;Lauantai;0;0;0;1;0;1
292;19.12.2015;2015;12;02;Lauantai;1;1;2;0;1;1
292;19.12.2015;2015;12;03;Lauantai;0;0;0;0;0;0
292;19.12.2015;2015;12;04;Lauantai;1;0;1;1;0;1
292;19.12.2015;2015;12;05;Lauantai;2;0;2;0;0;0
292;19.12.2015;2015;12;06;Lauantai;1;1;2;1;0;1
292;19.12.2015;2015;12;07;Lauantai;2;0;2;0;0;0
292;19.12.2015;2015;12;08;Lauantai;2;3;5;5;2;7
292;19.12.2015;2015;12;09;Lauantai;7;5;12;3;2;5
292;19.12.2015;2015;12;10;Lauantai;11;11;22;14;2;16
292;19.12.2015;2015;12;11;Lauantai;7;6;13;7;4;11
292;19.12.2015;2015;12;12;Lauantai;10;13;23;8;6;14
292;19.12.2015;2015;12;13;Lauantai;12;7;19;8;8;16
292;19.12.2015;2015;12;14;Lauantai;6;5;11;7;6;13
292;19.12.2015;2015;12;15;Lauantai;16;12;28;10;7;17
292;19.12.2015;2015;12;16;Lauantai;11;10;21;8;9;17
292;19.12.2015;2015;12;17;Lauantai;31;19;50;10;12;22
292;19.12.2015;2015;12;18;Lauantai;7;6;13;9;7;16
292;19.12.2015;2015;12;19;Lauantai;6;4;10;3;8;11
292;19.12.2015;2015;12;20;Lauantai;5;6;11;2;1;3
292;19.12.2015;2015;12;21;Lauantai;7;10;17;2;1;3
292;19.12.2015;2015;12;22;Lauantai;4;0;4;2;3;5
292;19.12.2015;2015;12;23;Lauantai;4;4;8;2;2;4
292;20.12.2015;2015;12;00;Sunnuntai;2;0;2;4;0;4
292;20.12.2015;2015;12;01;Sunnuntai;1;0;1;0;3;3
292;20.12.2015;2015;12;02;Sunnuntai;0;2;2;0;3;3
292;20.12.2015;2015;12;03;Sunnuntai;1;0;1;0;1;1
292;20.12.2015;2015;12;04;Sunnuntai;1;0;1;0;0;0
292;20.12.2015;2015;12;05;Sunnuntai;0;0;0;1;0;1
292;20.12.2015;2015;12;06;Sunnuntai;1;0;1;2;1;3
292;20.12.2015;2015;12;07;Sunnuntai;0;1;1;3;1;4
292;20.12.2015;2015;12;08;Sunnuntai;0;2;2;7;4;11
292;20.12.2015;2015;12;09;Sunnuntai;10;5;15;7;6;13
292;20.12.2015;2015;12;10;Sunnuntai;1;0;1;1;4;5
292;20.12.2015;2015;12;11;Sunnuntai;3;9;12;6;7;13
292;20.12.2015;2015;12;12;Sunnuntai;4;10;14;3;13;16
292;20.12.2015;2015;12;13;Sunnuntai;10;3;13;6;6;12
292;20.12.2015;2015;12;14;Sunnuntai;12;9;21;10;7;17
292;20.12.2015;2015;12;15;Sunnuntai;15;6;21;8;6;14
292;20.12.2015;2015;12;16;Sunnuntai;11;13;24;5;5;10
292;20.12.2015;2015;12;17;Sunnuntai;8;1;9;3;3;6
292;20.12.2015;2015;12;18;Sunnuntai;5;3;8;4;3;7
292;20.12.2015;2015;12;19;Sunnuntai;7;8;15;13;8;21
292;20.12.2015;2015;12;20;Sunnuntai;5;3;8;4;1;5
292;20.12.2015;2015;12;21;Sunnuntai;5;3;8;3;1;4
292;20.12.2015;2015;12;22;Sunnuntai;5;4;9;0;0;0
292;20.12.2015;2015;12;23;Sunnuntai;0;0;0;0;2;2
292;21.12.2015;2015;12;00;Maanantai;0;0;0;0;0;0
292;21.12.2015;2015;12;01;Maanantai;0;0;0;0;0;0
292;21.12.2015;2015;12;02;Maanantai;0;0;0;0;0;0
292;21.12.2015;2015;12;03;Maanantai;0;2;2;0;0;0
292;21.12.2015;2015;12;04;Maanantai;2;1;3;1;0;1
292;21.12.2015;2015;12;05;Maanantai;6;2;8;0;1;1
292;21.12.2015;2015;12;06;Maanantai;6;8;14;1;3;4
292;21.12.2015;2015;12;07;Maanantai;10;6;16;8;4;12
292;21.12.2015;2015;12;08;Maanantai;18;12;30;3;1;4
292;21.12.2015;2015;12;09;Maanantai;13;4;17;0;4;4
292;21.12.2015;2015;12;10;Maanantai;8;4;12;5;3;8
292;21.12.2015;2015;12;11;Maanantai;9;7;16;9;3;12
292;21.12.2015;2015;12;12;Maanantai;6;12;18;9;6;15
292;21.12.2015;2015;12;13;Maanantai;15;25;40;17;7;24
292;21.12.2015;2015;12;14;Maanantai;13;14;27;17;8;25
292;21.12.2015;2015;12;15;Maanantai;21;14;35;12;6;18
292;21.12.2015;2015;12;16;Maanantai;25;16;41;11;6;17
292;21.12.2015;2015;12;17;Maanantai;8;14;22;9;3;12
292;21.12.2015;2015;12;18;Maanantai;14;6;20;5;6;11
292;21.12.2015;2015;12;19;Maanantai;9;4;13;10;6;16
292;21.12.2015;2015;12;20;Maanantai;10;10;20;5;4;9
292;21.12.2015;2015;12;21;Maanantai;7;2;9;0;3;3
292;21.12.2015;2015;12;22;Maanantai;4;4;8;3;0;3
292;21.12.2015;2015;12;23;Maanantai;0;3;3;0;0;0
292;22.12.2015;2015;12;00;Tiistai;1;0;1;1;0;1
292;22.12.2015;2015;12;01;Tiistai;1;0;1;0;0;0
292;22.12.2015;2015;12;02;Tiistai;0;1;1;0;0;0
292;22.12.2015;2015;12;03;Tiistai;1;0;1;0;0;0
292;22.12.2015;2015;12;04;Tiistai;2;1;3;2;0;2
292;22.12.2015;2015;12;05;Tiistai;5;1;6;1;1;2
292;22.12.2015;2015;12;06;Tiistai;8;6;14;0;1;1
292;22.12.2015;2015;12;07;Tiistai;14;6;20;5;1;6
292;22.12.2015;2015;12;08;Tiistai;20;11;31;12;4;16
292;22.12.2015;2015;12;09;Tiistai;10;9;19;5;5;10
292;22.12.2015;2015;12;10;Tiistai;14;18;32;4;4;8
292;22.12.2015;2015;12;11;Tiistai;10;12;22;7;7;14
292;22.12.2015;2015;12;12;Tiistai;20;11;31;9;2;11
292;22.12.2015;2015;12;13;Tiistai;16;18;34;8;7;15
292;22.12.2015;2015;12;14;Tiistai;14;18;32;12;3;15
292;22.12.2015;2015;12;15;Tiistai;22;20;42;6;8;14
292;22.12.2015;2015;12;16;Tiistai;15;13;28;8;4;12
292;22.12.2015;2015;12;17;Tiistai;15;13;28;9;4;13
292;22.12.2015;2015;12;18;Tiistai;7;6;13;5;9;14
292;22.12.2015;2015;12;19;Tiistai;9;12;21;7;8;15
292;22.12.2015;2015;12;20;Tiistai;10;5;15;8;3;11
292;22.12.2015;2015;12;21;Tiistai;7;2;9;2;1;3
292;22.12.2015;2015;12;22;Tiistai;2;6;8;1;0;1
292;22.12.2015;2015;12;23;Tiistai;1;1;2;2;0;2
292;23.12.2015;2015;12;00;Keskiviikko;1;0;1;2;0;2
292;23.12.2015;2015;12;01;Keskiviikko;2;0;2;1;1;2
292;23.12.2015;2015;12;02;Keskiviikko;0;0;0;1;0;1
292;23.12.2015;2015;12;03;Keskiviikko;0;0;0;0;1;1
292;23.12.2015;2015;12;04;Keskiviikko;3;0;3;1;0;1
292;23.12.2015;2015;12;05;Keskiviikko;3;2;5;1;2;3
292;23.12.2015;2015;12;06;Keskiviikko;5;3;8;0;3;3
292;23.12.2015;2015;12;07;Keskiviikko;8;5;13;4;2;6
292;23.12.2015;2015;12;08;Keskiviikko;6;8;14;4;5;9
292;23.12.2015;2015;12;09;Keskiviikko;3;7;10;6;5;11
292;23.12.2015;2015;12;10;Keskiviikko;10;3;13;4;10;14
292;23.12.2015;2015;12;11;Keskiviikko;4;9;13;13;8;21
292;23.12.2015;2015;12;12;Keskiviikko;6;9;15;19;7;26
292;23.12.2015;2015;12;13;Keskiviikko;9;17;26;10;11;21
292;23.12.2015;2015;12;14;Keskiviikko;11;12;23;12;10;22
292;23.12.2015;2015;12;15;Keskiviikko;15;19;34;14;13;27
292;23.12.2015;2015;12;16;Keskiviikko;12;3;15;6;9;15
292;23.12.2015;2015;12;17;Keskiviikko;9;6;15;7;7;14
292;23.12.2015;2015;12;18;Keskiviikko;4;6;10;5;5;10
292;23.12.2015;2015;12;19;Keskiviikko;10;6;16;10;6;16
292;23.12.2015;2015;12;20;Keskiviikko;5;1;6;9;8;17
292;23.12.2015;2015;12;21;Keskiviikko;3;5;8;2;2;4
292;23.12.2015;2015;12;22;Keskiviikko;2;1;3;0;2;2
292;23.12.2015;2015;12;23;Keskiviikko;4;1;5;2;3;5
292;24.12.2015;2015;12;00;Torstai;0;0;0;0;1;1
292;24.12.2015;2015;12;01;Torstai;1;0;1;0;0;0
292;24.12.2015;2015;12;02;Torstai;0;0;0;0;0;0
292;24.12.2015;2015;12;03;Torstai;0;0;0;0;0;0
292;24.12.2015;2015;12;04;Torstai;0;1;1;0;0;0
292;24.12.2015;2015;12;05;Torstai;0;0;0;2;0;2
292;24.12.2015;2015;12;06;Torstai;1;0;1;0;3;3
292;24.12.2015;2015;12;07;Torstai;0;0;0;6;4;10
292;24.12.2015;2015;12;08;Torstai;2;1;3;9;5;14
292;24.12.2015;2015;12;09;Torstai;2;3;5;4;5;9
292;24.12.2015;2015;12;10;Torstai;7;7;14;10;9;19
292;24.12.2015;2015;12;11;Torstai;6;3;9;6;10;16
292;24.12.2015;2015;12;12;Torstai;7;4;11;8;6;14
292;24.12.2015;2015;12;13;Torstai;4;2;6;10;11;21
292;24.12.2015;2015;12;14;Torstai;5;4;9;12;6;18
292;24.12.2015;2015;12;15;Torstai;1;0;1;9;10;19
292;24.12.2015;2015;12;16;Torstai;5;0;5;7;4;11
292;24.12.2015;2015;12;17;Torstai;1;3;4;3;11;14
292;24.12.2015;2015;12;18;Torstai;3;1;4;5;6;11
292;24.12.2015;2015;12;19;Torstai;1;2;3;3;2;5
292;24.12.2015;2015;12;20;Torstai;3;8;11;6;6;12
292;24.12.2015;2015;12;21;Torstai;2;0;2;0;2;2
292;24.12.2015;2015;12;22;Torstai;2;0;2;2;1;3
292;24.12.2015;2015;12;23;Torstai;1;1;2;4;2;6
292;25.12.2015;2015;12;00;Perjantai;1;1;2;1;0;1
292;25.12.2015;2015;12;01;Perjantai;0;0;0;0;2;2
292;25.12.2015;2015;12;02;Perjantai;0;0;0;0;1;1
292;25.12.2015;2015;12;03;Perjantai;0;0;0;1;3;4
292;25.12.2015;2015;12;04;Perjantai;1;0;1;1;0;1
292;25.12.2015;2015;12;05;Perjantai;0;0;0;1;0;1
292;25.12.2015;2015;12;06;Perjantai;3;1;4;0;3;3
292;25.12.2015;2015;12;07;Perjantai;0;0;0;3;1;4
292;25.12.2015;2015;12;08;Perjantai;1;1;2;3;3;6
292;25.12.2015;2015;12;09;Perjantai;0;0;0;3;1;4
292;25.12.2015;2015;12;10;Perjantai;6;0;6;6;4;10
292;25.12.2015;2015;12;11;Perjantai;3;1;4;7;4;11
292;25.12.2015;2015;12;12;Perjantai;2;5;7;5;7;12
292;25.12.2015;2015;12;13;Perjantai;3;4;7;11;5;16
292;25.12.2015;2015;12;14;Perjantai;4;4;8;13;7;20
292;25.12.2015;2015;12;15;Perjantai;8;4;12;11;8;19
292;25.12.2015;2015;12;16;Perjantai;1;6;7;6;12;18
292;25.12.2015;2015;12;17;Perjantai;0;3;3;7;3;10
292;25.12.2015;2015;12;18;Perjantai;2;2;4;13;6;19
292;25.12.2015;2015;12;19;Perjantai;1;3;4;4;5;9
292;25.12.2015;2015;12;20;Perjantai;1;3;4;8;1;9
292;25.12.2015;2015;12;21;Perjantai;1;1;2;1;4;5
292;25.12.2015;2015;12;22;Perjantai;1;3;4;2;2;4
292;25.12.2015;2015;12;23;Perjantai;2;2;4;6;0;6
292;26.12.2015;2015;12;00;Lauantai;1;0;1;0;0;0
292;26.12.2015;2015;12;01;Lauantai;0;1;1;0;0;0
292;26.12.2015;2015;12;02;Lauantai;0;2;2;1;1;2
292;26.12.2015;2015;12;03;Lauantai;0;1;1;0;2;2
292;26.12.2015;2015;12;04;Lauantai;0;0;0;0;0;0
292;26.12.2015;2015;12;05;Lauantai;1;0;1;1;0;1
292;26.12.2015;2015;12;06;Lauantai;0;1;1;1;1;2
292;26.12.2015;2015;12;07;Lauantai;0;0;0;0;2;2
292;26.12.2015;2015;12;08;Lauantai;0;2;2;5;3;8
292;26.12.2015;2015;12;09;Lauantai;0;1;1;9;5;14
292;26.12.2015;2015;12;10;Lauantai;3;1;4;9;9;18
292;26.12.2015;2015;12;11;Lauantai;6;5;11;17;13;30
292;26.12.2015;2015;12;12;Lauantai;7;3;10;13;16;29
292;26.12.2015;2015;12;13;Lauantai;7;7;14;21;15;36
292;26.12.2015;2015;12;14;Lauantai;2;5;7;13;14;27
292;26.12.2015;2015;12;15;Lauantai;8;1;9;10;11;21
292;26.12.2015;2015;12;16;Lauantai;6;2;8;10;7;17
292;26.12.2015;2015;12;17;Lauantai;0;6;6;5;12;17
292;26.12.2015;2015;12;18;Lauantai;8;2;10;5;10;15
292;26.12.2015;2015;12;19;Lauantai;3;4;7;6;4;10
292;26.12.2015;2015;12;20;Lauantai;3;6;9;2;5;7
292;26.12.2015;2015;12;21;Lauantai;2;6;8;0;1;1
292;26.12.2015;2015;12;22;Lauantai;2;1;3;2;1;3
292;26.12.2015;2015;12;23;Lauantai;2;1;3;6;4;10
292;27.12.2015;2015;12;00;Sunnuntai;1;1;2;3;0;3
292;27.12.2015;2015;12;01;Sunnuntai;0;1;1;2;0;2
292;27.12.2015;2015;12;02;Sunnuntai;0;2;2;0;5;5
292;27.12.2015;2015;12;03;Sunnuntai;0;1;1;0;8;8
292;27.12.2015;2015;12;04;Sunnuntai;1;1;2;2;1;3
292;27.12.2015;2015;12;05;Sunnuntai;0;0;0;1;1;2
292;27.12.2015;2015;12;06;Sunnuntai;1;1;2;1;0;1
292;27.12.2015;2015;12;07;Sunnuntai;0;0;0;0;2;2
292;27.12.2015;2015;12;08;Sunnuntai;0;0;0;1;1;2
292;27.12.2015;2015;12;09;Sunnuntai;6;3;9;6;4;10
292;27.12.2015;2015;12;10;Sunnuntai;2;2;4;5;9;14
292;27.12.2015;2015;12;11;Sunnuntai;5;6;11;16;11;27
292;27.12.2015;2015;12;12;Sunnuntai;6;4;10;10;9;19
292;27.12.2015;2015;12;13;Sunnuntai;5;4;9;11;13;24
292;27.12.2015;2015;12;14;Sunnuntai;1;9;10;13;14;27
292;27.12.2015;2015;12;15;Sunnuntai;8;2;10;10;4;14
292;27.12.2015;2015;12;16;Sunnuntai;5;4;9;13;10;23
292;27.12.2015;2015;12;17;Sunnuntai;4;4;8;14;10;24
292;27.12.2015;2015;12;18;Sunnuntai;7;5;12;19;11;30
292;27.12.2015;2015;12;19;Sunnuntai;5;0;5;13;8;21
292;27.12.2015;2015;12;20;Sunnuntai;5;4;9;4;7;11
292;27.12.2015;2015;12;21;Sunnuntai;1;3;4;2;1;3
292;27.12.2015;2015;12;22;Sunnuntai;1;5;6;3;1;4
292;27.12.2015;2015;12;23;Sunnuntai;1;1;2;0;1;1
292;28.12.2015;2015;12;00;Maanantai;2;1;3;1;0;1
292;28.12.2015;2015;12;01;Maanantai;0;2;2;0;1;1
292;28.12.2015;2015;12;02;Maanantai;1;0;1;1;0;1
292;28.12.2015;2015;12;03;Maanantai;0;0;0;0;1;1
292;28.12.2015;2015;12;04;Maanantai;1;0;1;2;0;2
292;28.12.2015;2015;12;05;Maanantai;4;2;6;2;1;3
292;28.12.2015;2015;12;06;Maanantai;6;7;13;1;2;3
292;28.12.2015;2015;12;07;Maanantai;7;4;11;10;11;21
292;28.12.2015;2015;12;08;Maanantai;4;3;7;6;3;9
292;28.12.2015;2015;12;09;Maanantai;4;6;10;5;8;13
292;28.12.2015;2015;12;10;Maanantai;10;4;14;11;7;18
292;28.12.2015;2015;12;11;Maanantai;5;14;19;6;17;23
292;28.12.2015;2015;12;12;Maanantai;12;15;27;16;15;31
292;28.12.2015;2015;12;13;Maanantai;5;13;18;13;10;23
292;28.12.2015;2015;12;14;Maanantai;12;21;33;10;10;20
292;28.12.2015;2015;12;15;Maanantai;26;21;47;16;12;28
292;28.12.2015;2015;12;16;Maanantai;18;13;31;11;9;20
292;28.12.2015;2015;12;17;Maanantai;15;4;19;15;5;20
292;28.12.2015;2015;12;18;Maanantai;8;4;12;8;5;13
292;28.12.2015;2015;12;19;Maanantai;5;3;8;7;6;13
292;28.12.2015;2015;12;20;Maanantai;5;5;10;4;4;8
292;28.12.2015;2015;12;21;Maanantai;6;2;8;4;4;8
292;28.12.2015;2015;12;22;Maanantai;2;3;5;4;1;5
292;28.12.2015;2015;12;23;Maanantai;0;2;2;2;0;2
292;29.12.2015;2015;12;00;Tiistai;0;0;0;2;0;2
292;29.12.2015;2015;12;01;Tiistai;0;1;1;0;2;2
292;29.12.2015;2015;12;02;Tiistai;0;0;0;0;0;0
292;29.12.2015;2015;12;03;Tiistai;0;2;2;0;0;0
292;29.12.2015;2015;12;04;Tiistai;2;0;2;1;1;2
292;29.12.2015;2015;12;05;Tiistai;4;3;7;2;0;2
292;29.12.2015;2015;12;06;Tiistai;1;1;2;1;5;6
292;29.12.2015;2015;12;07;Tiistai;8;8;16;11;6;17
292;29.12.2015;2015;12;08;Tiistai;8;3;11;5;2;7
292;29.12.2015;2015;12;09;Tiistai;4;1;5;5;4;9
292;29.12.2015;2015;12;10;Tiistai;3;6;9;6;9;15
292;29.12.2015;2015;12;11;Tiistai;10;9;19;8;11;19
292;29.12.2015;2015;12;12;Tiistai;6;8;14;9;15;24
292;29.12.2015;2015;12;13;Tiistai;7;6;13;11;10;21
292;29.12.2015;2015;12;14;Tiistai;14;7;21;11;7;18
292;29.12.2015;2015;12;15;Tiistai;10;9;19;8;11;19
292;29.12.2015;2015;12;16;Tiistai;12;10;22;6;3;9
292;29.12.2015;2015;12;17;Tiistai;10;2;12;8;4;12
292;29.12.2015;2015;12;18;Tiistai;4;7;11;13;6;19
292;29.12.2015;2015;12;19;Tiistai;2;6;8;10;12;22
292;29.12.2015;2015;12;20;Tiistai;9;3;12;7;2;9
292;29.12.2015;2015;12;21;Tiistai;0;3;3;1;3;4
292;29.12.2015;2015;12;22;Tiistai;1;1;2;2;1;3
292;29.12.2015;2015;12;23;Tiistai;3;1;4;0;0;0
292;30.12.2015;2015;12;00;Keskiviikko;2;0;2;0;1;1
292;30.12.2015;2015;12;01;Keskiviikko;0;0;0;0;3;3
292;30.12.2015;2015;12;02;Keskiviikko;0;0;0;0;0;0
292;30.12.2015;2015;12;03;Keskiviikko;1;0;1;0;0;0
292;30.12.2015;2015;12;04;Keskiviikko;2;0;2;1;0;1
292;30.12.2015;2015;12;05;Keskiviikko;4;2;6;2;2;4
292;30.12.2015;2015;12;06;Keskiviikko;2;3;5;1;2;3
292;30.12.2015;2015;12;07;Keskiviikko;9;11;20;7;4;11
292;30.12.2015;2015;12;08;Keskiviikko;2;7;9;7;5;12
292;30.12.2015;2015;12;09;Keskiviikko;6;5;11;4;4;8
292;30.12.2015;2015;12;10;Keskiviikko;9;10;19;13;6;19
292;30.12.2015;2015;12;11;Keskiviikko;12;16;28;19;7;26
292;30.12.2015;2015;12;12;Keskiviikko;16;12;28;8;6;14
292;30.12.2015;2015;12;13;Keskiviikko;19;10;29;13;3;16
292;30.12.2015;2015;12;14;Keskiviikko;20;16;36;2;4;6
292;30.12.2015;2015;12;15;Keskiviikko;26;16;42;12;4;16
292;30.12.2015;2015;12;16;Keskiviikko;24;13;37;8;11;19
292;30.12.2015;2015;12;17;Keskiviikko;8;8;16;10;7;17
292;30.12.2015;2015;12;18;Keskiviikko;13;9;22;8;5;13
292;30.12.2015;2015;12;19;Keskiviikko;8;8;16;12;3;15
292;30.12.2015;2015;12;20;Keskiviikko;11;3;14;9;9;18
292;30.12.2015;2015;12;21;Keskiviikko;6;4;10;8;6;14
292;30.12.2015;2015;12;22;Keskiviikko;6;5;11;2;0;2
292;30.12.2015;2015;12;23;Keskiviikko;3;2;5;1;2;3
292;31.12.2015;2015;12;00;Torstai;2;2;4;3;0;3
292;31.12.2015;2015;12;01;Torstai;0;2;2;1;0;1
292;31.12.2015;2015;12;02;Torstai;0;0;0;1;0;1
292;31.12.2015;2015;12;03;Torstai;0;0;0;1;0;1
292;31.12.2015;2015;12;04;Torstai;3;0;3;0;0;0
292;31.12.2015;2015;12;05;Torstai;1;1;2;2;0;2
292;31.12.2015;2015;12;06;Torstai;8;3;11;0;0;0
292;31.12.2015;2015;12;07;Torstai;6;4;10;5;1;6
292;31.12.2015;2015;12;08;Torstai;8;5;13;6;1;7
292;31.12.2015;2015;12;09;Torstai;7;6;13;3;1;4
292;31.12.2015;2015;12;10;Torstai;15;7;22;5;2;7
292;31.12.2015;2015;12;11;Torstai;14;9;23;9;3;12
292;31.12.2015;2015;12;12;Torstai;14;10;24;13;7;20
292;31.12.2015;2015;12;13;Torstai;20;8;28;15;2;17
292;31.12.2015;2015;12;14;Torstai;22;20;42;8;5;13
292;31.12.2015;2015;12;15;Torstai;15;13;28;10;3;13
292;31.12.2015;2015;12;16;Torstai;9;7;16;9;11;20
292;31.12.2015;2015;12;17;Torstai;6;10;16;1;3;4
292;31.12.2015;2015;12;18;Torstai;14;12;26;2;3;5
292;31.12.2015;2015;12;19;Torstai;9;4;13;2;1;3
292;31.12.2015;2015;12;20;Torstai;2;6;8;3;3;6
292;31.12.2015;2015;12;21;Torstai;6;8;14;1;1;2
292;31.12.2015;2015;12;22;Torstai;1;4;5;4;0;4
292;31.12.2015;2015;12;23;Torstai;4;2;6;7;3;10
292;01.01.2016;2016;01;00;Perjantai;5;8;13;13;3;16
292;01.01.2016;2016;01;01;Perjantai;5;2;7;2;2;4
292;01.01.2016;2016;01;02;Perjantai;8;2;10;5;3;8
292;01.01.2016;2016;01;03;Perjantai;2;2;4;1;7;8
292;01.01.2016;2016;01;04;Perjantai;5;0;5;1;0;1
292;01.01.2016;2016;01;05;Perjantai;0;1;1;2;1;3
292;01.01.2016;2016;01;06;Perjantai;4;2;6;1;1;2
292;01.01.2016;2016;01;07;Perjantai;0;0;0;1;0;1
292;01.01.2016;2016;01;08;Perjantai;1;0;1;2;1;3
292;01.01.2016;2016;01;09;Perjantai;2;0;2;2;0;2
292;01.01.2016;2016;01;10;Perjantai;3;1;4;8;4;12
292;01.01.2016;2016;01;11;Perjantai;4;2;6;7;7;14
292;01.01.2016;2016;01;12;Perjantai;6;1;7;12;2;14
292;01.01.2016;2016;01;13;Perjantai;7;3;10;9;9;18
292;01.01.2016;2016;01;14;Perjantai;11;4;15;17;5;22
292;01.01.2016;2016;01;15;Perjantai;10;11;21;14;8;22
292;01.01.2016;2016;01;16;Perjantai;14;6;20;12;3;15
292;01.01.2016;2016;01;17;Perjantai;7;4;11;8;8;16
292;01.01.2016;2016;01;18;Perjantai;5;6;11;8;4;12
292;01.01.2016;2016;01;19;Perjantai;4;3;7;5;4;9
292;01.01.2016;2016;01;20;Perjantai;3;3;6;3;3;6
292;01.01.2016;2016;01;21;Perjantai;2;1;3;3;0;3
292;01.01.2016;2016;01;22;Perjantai;0;0;0;0;2;2
292;01.01.2016;2016;01;23;Perjantai;3;1;4;2;0;2
292;02.01.2016;2016;01;00;Lauantai;1;0;1;0;0;0
292;02.01.2016;2016;01;01;Lauantai;2;0;2;0;1;1
292;02.01.2016;2016;01;02;Lauantai;0;0;0;0;0;0
292;02.01.2016;2016;01;03;Lauantai;0;0;0;0;0;0
292;02.01.2016;2016;01;04;Lauantai;0;0;0;0;0;0
292;02.01.2016;2016;01;05;Lauantai;0;0;0;0;0;0
292;02.01.2016;2016;01;06;Lauantai;3;1;4;2;0;2
292;02.01.2016;2016;01;07;Lauantai;2;1;3;2;1;3
292;02.01.2016;2016;01;08;Lauantai;2;0;2;0;0;0
292;02.01.2016;2016;01;09;Lauantai;2;1;3;4;1;5
292;02.01.2016;2016;01;10;Lauantai;6;3;9;4;2;6
292;02.01.2016;2016;01;11;Lauantai;8;5;13;8;1;9
292;02.01.2016;2016;01;12;Lauantai;4;3;7;9;3;12
292;02.01.2016;2016;01;13;Lauantai;10;6;16;10;3;13
292;02.01.2016;2016;01;14;Lauantai;7;5;12;15;6;21
292;02.01.2016;2016;01;15;Lauantai;7;4;11;9;1;10
292;02.01.2016;2016;01;16;Lauantai;7;7;14;11;1;12
292;02.01.2016;2016;01;17;Lauantai;8;3;11;10;4;14
292;02.01.2016;2016;01;18;Lauantai;5;3;8;7;3;10
292;02.01.2016;2016;01;19;Lauantai;2;2;4;4;1;5
292;02.01.2016;2016;01;20;Lauantai;1;4;5;1;0;1
292;02.01.2016;2016;01;21;Lauantai;3;0;3;1;1;2
292;02.01.2016;2016;01;22;Lauantai;3;3;6;4;0;4
292;02.01.2016;2016;01;23;Lauantai;2;1;3;2;0;2
292;03.01.2016;2016;01;00;Sunnuntai;1;0;1;0;0;0
292;03.01.2016;2016;01;01;Sunnuntai;2;1;3;0;0;0
292;03.01.2016;2016;01;02;Sunnuntai;1;0;1;0;1;1
292;03.01.2016;2016;01;03;Sunnuntai;0;0;0;0;0;0
292;03.01.2016;2016;01;04;Sunnuntai;1;0;1;0;0;0
292;03.01.2016;2016;01;05;Sunnuntai;0;0;0;1;0;1
292;03.01.2016;2016;01;06;Sunnuntai;2;2;4;0;0;0
292;03.01.2016;2016;01;07;Sunnuntai;1;0;1;0;0;0
292;03.01.2016;2016;01;08;Sunnuntai;2;1;3;0;0;0
292;03.01.2016;2016;01;09;Sunnuntai;6;2;8;2;1;3
292;03.01.2016;2016;01;10;Sunnuntai;4;2;6;3;0;3
292;03.01.2016;2016;01;11;Sunnuntai;8;7;15;3;0;3
292;03.01.2016;2016;01;12;Sunnuntai;8;7;15;4;1;5
292;03.01.2016;2016;01;13;Sunnuntai;6;6;12;4;2;6
292;03.01.2016;2016;01;14;Sunnuntai;12;9;21;6;4;10
292;03.01.2016;2016;01;15;Sunnuntai;13;5;18;13;3;16
292;03.01.2016;2016;01;16;Sunnuntai;10;6;16;3;3;6
292;03.01.2016;2016;01;17;Sunnuntai;7;13;20;9;2;11
292;03.01.2016;2016;01;18;Sunnuntai;4;3;7;4;0;4
292;03.01.2016;2016;01;19;Sunnuntai;5;2;7;5;0;5
292;03.01.2016;2016;01;20;Sunnuntai;3;1;4;3;0;3
292;03.01.2016;2016;01;21;Sunnuntai;3;2;5;2;2;4
292;03.01.2016;2016;01;22;Sunnuntai;2;3;5;1;0;1
292;03.01.2016;2016;01;23;Sunnuntai;0;1;1;0;0;0
292;04.01.2016;2016;01;00;Maanantai;0;0;0;1;0;1
292;04.01.2016;2016;01;01;Maanantai;0;0;0;0;1;1
292;04.01.2016;2016;01;02;Maanantai;1;1;2;1;0;1
292;04.01.2016;2016;01;03;Maanantai;1;0;1;0;1;1
292;04.01.2016;2016;01;04;Maanantai;2;1;3;2;0;2
292;04.01.2016;2016;01;05;Maanantai;3;3;6;2;1;3
292;04.01.2016;2016;01;06;Maanantai;5;5;10;1;2;3
292;04.01.2016;2016;01;07;Maanantai;13;10;23;8;9;17
292;04.01.2016;2016;01;08;Maanantai;5;5;10;6;3;9
292;04.01.2016;2016;01;09;Maanantai;6;6;12;5;8;13
292;04.01.2016;2016;01;10;Maanantai;4;3;7;9;5;14
292;04.01.2016;2016;01;11;Maanantai;10;7;17;6;14;20
292;04.01.2016;2016;01;12;Maanantai;6;6;12;14;13;27
292;04.01.2016;2016;01;13;Maanantai;10;11;21;10;7;17
292;04.01.2016;2016;01;14;Maanantai;19;14;33;7;7;14
292;04.01.2016;2016;01;15;Maanantai;12;11;23;13;9;22
292;04.01.2016;2016;01;16;Maanantai;10;9;19;9;7;16
292;04.01.2016;2016;01;17;Maanantai;6;5;11;13;4;17
292;04.01.2016;2016;01;18;Maanantai;7;6;13;6;4;10
292;04.01.2016;2016;01;19;Maanantai;3;4;7;6;5;11
292;04.01.2016;2016;01;20;Maanantai;4;4;8;4;4;8
292;04.01.2016;2016;01;21;Maanantai;5;4;9;4;4;8
292;04.01.2016;2016;01;22;Maanantai;3;1;4;4;1;5
292;04.01.2016;2016;01;23;Maanantai;1;1;2;2;0;2
292;05.01.2016;2016;01;00;Tiistai;0;0;0;2;0;2
292;05.01.2016;2016;01;01;Tiistai;0;0;0;0;2;2
292;05.01.2016;2016;01;02;Tiistai;0;0;0;0;0;0
292;05.01.2016;2016;01;03;Tiistai;0;0;0;0;0;0
292;05.01.2016;2016;01;04;Tiistai;2;1;3;1;1;2
292;05.01.2016;2016;01;05;Tiistai;4;3;7;2;0;2
292;05.01.2016;2016;01;06;Tiistai;6;5;11;1;5;6
292;05.01.2016;2016;01;07;Tiistai;11;8;19;9;5;14
292;05.01.2016;2016;01;08;Tiistai;5;4;9;5;2;7
292;05.01.2016;2016;01;09;Tiistai;6;6;12;5;4;9
292;05.01.2016;2016;01;10;Tiistai;7;6;13;6;9;15
292;05.01.2016;2016;01;11;Tiistai;7;6;13;6;9;15
292;05.01.2016;2016;01;12;Tiistai;6;5;11;8;13;21
292;05.01.2016;2016;01;13;Tiistai;12;12;24;9;8;17
292;05.01.2016;2016;01;14;Tiistai;13;14;27;9;6;15
292;05.01.2016;2016;01;15;Tiistai;16;11;27;7;9;16
292;05.01.2016;2016;01;16;Tiistai;15;14;29;6;3;9
292;05.01.2016;2016;01;17;Tiistai;8;5;13;7;3;10
292;05.01.2016;2016;01;18;Tiistai;5;5;10;10;5;15
292;05.01.2016;2016;01;19;Tiistai;5;4;9;8;9;17
292;05.01.2016;2016;01;20;Tiistai;3;2;5;5;2;7
292;05.01.2016;2016;01;21;Tiistai;2;1;3;1;3;4
292;05.01.2016;2016;01;22;Tiistai;0;0;0;2;1;3
292;05.01.2016;2016;01;23;Tiistai;1;1;2;0;0;0
292;06.01.2016;2016;01;00;Keskiviikko;1;0;1;3;0;3
292;06.01.2016;2016;01;01;Keskiviikko;1;0;1;1;0;1
292;06.01.2016;2016;01;02;Keskiviikko;1;1;2;0;1;1
292;06.01.2016;2016;01;03;Keskiviikko;0;0;0;0;0;0
292;06.01.2016;2016;01;04;Keskiviikko;0;0;0;0;0;0
292;06.01.2016;2016;01;05;Keskiviikko;0;0;0;0;0;0
292;06.01.2016;2016;01;06;Keskiviikko;0;0;0;0;0;0
292;06.01.2016;2016;01;07;Keskiviikko;1;0;1;0;0;0
292;06.01.2016;2016;01;08;Keskiviikko;1;0;1;0;0;0
292;06.01.2016;2016;01;09;Keskiviikko;2;1;3;1;0;1
292;06.01.2016;2016;01;10;Keskiviikko;1;0;1;1;0;1
292;06.01.2016;2016;01;11;Keskiviikko;1;1;2;0;0;0
292;06.01.2016;2016;01;12;Keskiviikko;2;1;3;1;0;1
292;06.01.2016;2016;01;13;Keskiviikko;2;2;4;4;0;4
292;06.01.2016;2016;01;14;Keskiviikko;4;4;8;0;2;2
292;06.01.2016;2016;01;15;Keskiviikko;3;2;5;1;0;1
292;06.01.2016;2016;01;16;Keskiviikko;1;1;2;0;0;0
292;06.01.2016;2016;01;17;Keskiviikko;1;0;1;1;0;1
292;06.01.2016;2016;01;18;Keskiviikko;2;2;4;1;0;1
292;06.01.2016;2016;01;19;Keskiviikko;0;0;0;1;0;1
292;06.01.2016;2016;01;20;Keskiviikko;2;1;3;1;1;2
292;06.01.2016;2016;01;21;Keskiviikko;0;0;0;0;0;0
292;06.01.2016;2016;01;22;Keskiviikko;2;3;5;0;0;0
292;06.01.2016;2016;01;23;Keskiviikko;0;0;0;0;0;0
292;07.01.2016;2016;01;00;Torstai;0;0;0;0;1;1
292;07.01.2016;2016;01;01;Torstai;0;0;0;0;3;3
292;07.01.2016;2016;01;02;Torstai;0;0;0;0;0;0
292;07.01.2016;2016;01;03;Torstai;0;0;0;0;0;0
292;07.01.2016;2016;01;04;Torstai;1;0;1;1;0;1
292;07.01.2016;2016;01;05;Torstai;3;2;5;2;2;4
292;07.01.2016;2016;01;06;Torstai;4;3;7;1;2;3
292;07.01.2016;2016;01;07;Torstai;15;11;26;7;4;11
292;07.01.2016;2016;01;08;Torstai;9;8;17;7;5;12
292;07.01.2016;2016;01;09;Torstai;11;7;18;4;4;8
292;07.01.2016;2016;01;10;Torstai;4;3;7;13;6;19
292;07.01.2016;2016;01;11;Torstai;6;4;10;19;7;26
292;07.01.2016;2016;01;12;Torstai;3;3;6;8;6;14
292;07.01.2016;2016;01;13;Torstai;7;7;14;13;3;16
292;07.01.2016;2016;01;14;Torstai;9;8;17;2;4;6
292;07.01.2016;2016;01;15;Torstai;9;10;19;12;4;16
292;07.01.2016;2016;01;16;Torstai;17;14;31;8;11;19
292;07.01.2016;2016;01;17;Torstai;3;3;6;10;7;17
292;07.01.2016;2016;01;18;Torstai;9;8;17;8;5;13
292;07.01.2016;2016;01;19;Torstai;2;2;4;12;3;15
292;07.01.2016;2016;01;20;Torstai;4;4;8;9;9;18
292;07.01.2016;2016;01;21;Torstai;1;1;2;8;6;14
292;07.01.2016;2016;01;22;Torstai;2;1;3;2;0;2
292;07.01.2016;2016;01;23;Torstai;0;0;0;1;2;3
292;08.01.2016;2016;01;00;Perjantai;0;0;0;3;0;3
292;08.01.2016;2016;01;01;Perjantai;0;0;0;1;0;1
292;08.01.2016;2016;01;02;Perjantai;0;0;0;1;0;1
292;08.01.2016;2016;01;03;Perjantai;0;0;0;1;0;1
292;08.01.2016;2016;01;04;Perjantai;2;1;3;0;0;0
292;08.01.2016;2016;01;05;Perjantai;4;3;7;2;0;2
292;08.01.2016;2016;01;06;Perjantai;4;3;7;0;0;0
292;08.01.2016;2016;01;07;Perjantai;15;12;27;5;1;6
292;08.01.2016;2016;01;08;Perjantai;15;12;27;6;1;7
292;08.01.2016;2016;01;09;Perjantai;9;7;16;3;1;4
292;08.01.2016;2016;01;10;Perjantai;5;3;8;5;2;7
292;08.01.2016;2016;01;11;Perjantai;7;6;13;9;3;12
292;08.01.2016;2016;01;12;Perjantai;6;7;13;13;7;20
292;08.01.2016;2016;01;13;Perjantai;17;14;31;15;2;17
292;08.01.2016;2016;01;14;Perjantai;13;14;27;8;5;13
292;08.01.2016;2016;01;15;Perjantai;11;11;22;10;3;13
292;08.01.2016;2016;01;16;Perjantai;16;16;32;9;11;20
292;08.01.2016;2016;01;17;Perjantai;6;6;12;1;3;4
292;08.01.2016;2016;01;18;Perjantai;7;6;13;2;3;5
292;08.01.2016;2016;01;19;Perjantai;5;4;9;2;1;3
292;08.01.2016;2016;01;20;Perjantai;3;2;5;3;3;6
292;08.01.2016;2016;01;21;Perjantai;4;4;8;1;1;2
292;08.01.2016;2016;01;22;Perjantai;4;4;8;4;0;4
292;08.01.2016;2016;01;23;Perjantai;2;0;2;7;3;10
292;09.01.2016;2016;01;00;Lauantai;1;1;2;1;0;1
292;09.01.2016;2016;01;01;Lauantai;1;1;2;0;2;2
292;09.01.2016;2016;01;02;Lauantai;1;1;2;0;1;1
292;09.01.2016;2016;01;03;Lauantai;0;0;0;1;3;4
292;09.01.2016;2016;01;04;Lauantai;1;0;1;1;0;1
292;09.01.2016;2016;01;05;Lauantai;1;0;1;1;0;1
292;09.01.2016;2016;01;06;Lauantai;4;3;7;0;3;3
292;09.01.2016;2016;01;07;Lauantai;1;1;2;3;1;4
292;09.01.2016;2016;01;08;Lauantai;2;1;3;3;3;6
292;09.01.2016;2016;01;09;Lauantai;2;1;3;3;1;4
292;09.01.2016;2016;01;10;Lauantai;2;1;3;6;4;10
292;09.01.2016;2016;01;11;Lauantai;2;1;3;7;4;11
292;09.01.2016;2016;01;12;Lauantai;7;7;14;5;7;12
292;09.01.2016;2016;01;13;Lauantai;10;9;19;11;5;16
292;09.01.2016;2016;01;14;Lauantai;7;6;13;13;7;20
292;09.01.2016;2016;01;15;Lauantai;7;7;14;11;8;19
292;09.01.2016;2016;01;16;Lauantai;8;8;16;6;12;18
292;09.01.2016;2016;01;17;Lauantai;7;7;14;7;3;10
292;09.01.2016;2016;01;18;Lauantai;5;5;10;13;6;19
292;09.01.2016;2016;01;19;Lauantai;6;5;11;4;5;9
292;09.01.2016;2016;01;20;Lauantai;2;1;3;8;1;9
292;09.01.2016;2016;01;21;Lauantai;1;0;1;1;4;5
292;09.01.2016;2016;01;22;Lauantai;1;0;1;2;2;4
292;09.01.2016;2016;01;23;Lauantai;1;0;1;6;0;6
292;10.01.2016;2016;01;00;Sunnuntai;0;0;0;0;0;0
292;10.01.2016;2016;01;01;Sunnuntai;0;0;0;0;0;0
292;10.01.2016;2016;01;02;Sunnuntai;0;0;0;0;1;1
292;10.01.2016;2016;01;03;Sunnuntai;1;1;2;0;0;0
292;10.01.2016;2016;01;04;Sunnuntai;0;0;0;0;0;0
292;10.01.2016;2016;01;05;Sunnuntai;0;0;0;1;0;1
292;10.01.2016;2016;01;06;Sunnuntai;1;0;1;0;0;0
292;10.01.2016;2016;01;07;Sunnuntai;1;1;2;0;0;0
292;10.01.2016;2016;01;08;Sunnuntai;0;0;0;0;0;0
292;10.01.2016;2016;01;09;Sunnuntai;7;6;13;2;1;3
292;10.01.2016;2016;01;10;Sunnuntai;4;4;8;3;0;3
292;10.01.2016;2016;01;11;Sunnuntai;11;10;21;3;0;3
292;10.01.2016;2016;01;12;Sunnuntai;10;9;19;4;1;5
292;10.01.2016;2016;01;13;Sunnuntai;8;5;13;4;2;6
292;10.01.2016;2016;01;14;Sunnuntai;11;11;22;6;4;10
292;10.01.2016;2016;01;15;Sunnuntai;7;6;13;13;3;16
292;10.01.2016;2016;01;16;Sunnuntai;10;8;18;3;3;6
292;10.01.2016;2016;01;17;Sunnuntai;6;6;12;9;2;11
292;10.01.2016;2016;01;18;Sunnuntai;5;5;10;4;0;4
292;10.01.2016;2016;01;19;Sunnuntai;1;1;2;5;0;5
292;10.01.2016;2016;01;20;Sunnuntai;3;2;5;3;0;3
292;10.01.2016;2016;01;21;Sunnuntai;4;3;7;2;2;4
292;10.01.2016;2016;01;22;Sunnuntai;2;1;3;1;0;1
292;10.01.2016;2016;01;23;Sunnuntai;0;0;0;0;0;0
292;11.01.2016;2016;01;00;Maanantai;1;0;1;0;0;0
292;11.01.2016;2016;01;01;Maanantai;0;0;0;1;1;2
292;11.01.2016;2016;01;02;Maanantai;0;0;0;0;0;0
292;11.01.2016;2016;01;03;Maanantai;0;0;0;1;1;2
292;11.01.2016;2016;01;04;Maanantai;1;1;2;0;0;0
292;11.01.2016;2016;01;05;Maanantai;4;4;8;1;1;2
292;11.01.2016;2016;01;06;Maanantai;10;9;19;2;2;4
292;11.01.2016;2016;01;07;Maanantai;31;29;60;9;9;18
292;11.01.2016;2016;01;08;Maanantai;17;14;31;3;3;6
292;11.01.2016;2016;01;09;Maanantai;11;8;19;8;8;16
292;11.01.2016;2016;01;10;Maanantai;11;10;21;5;5;10
292;11.01.2016;2016;01;11;Maanantai;9;7;16;14;14;28
292;11.01.2016;2016;01;12;Maanantai;10;10;20;13;13;26
292;11.01.2016;2016;01;13;Maanantai;16;15;31;7;7;14
292;11.01.2016;2016;01;14;Maanantai;22;21;43;7;7;14
292;11.01.2016;2016;01;15;Maanantai;20;17;37;9;9;18
292;11.01.2016;2016;01;16;Maanantai;24;23;47;7;7;14
292;11.01.2016;2016;01;17;Maanantai;9;9;18;4;4;8
292;11.01.2016;2016;01;18;Maanantai;7;7;14;4;4;8
292;11.01.2016;2016;01;19;Maanantai;6;6;12;5;5;10
292;11.01.2016;2016;01;20;Maanantai;8;7;15;4;4;8
292;11.01.2016;2016;01;21;Maanantai;6;5;11;4;4;8
292;11.01.2016;2016;01;22;Maanantai;2;2;4;1;1;2
292;11.01.2016;2016;01;23;Maanantai;0;0;0;0;0;0
292;12.01.2016;2016;01;00;Tiistai;0;0;0;2;0;2
292;12.01.2016;2016;01;01;Tiistai;0;0;0;0;2;2
292;12.01.2016;2016;01;02;Tiistai;0;0;0;0;0;0
292;12.01.2016;2016;01;03;Tiistai;0;0;0;0;0;0
292;12.01.2016;2016;01;04;Tiistai;1;1;2;1;1;2
292;12.01.2016;2016;01;05;Tiistai;6;6;12;2;0;2
292;12.01.2016;2016;01;06;Tiistai;7;7;14;1;5;6
292;12.01.2016;2016;01;07;Tiistai;24;24;48;9;5;14
292;12.01.2016;2016;01;08;Tiistai;26;26;52;5;2;7
292;12.01.2016;2016;01;09;Tiistai;13;13;26;5;4;9
292;12.01.2016;2016;01;10;Tiistai;8;7;15;6;9;15
292;12.01.2016;2016;01;11;Tiistai;9;8;17;6;9;15
292;12.01.2016;2016;01;12;Tiistai;12;11;23;8;13;21
292;12.01.2016;2016;01;13;Tiistai;20;19;39;9;8;17
292;12.01.2016;2016;01;14;Tiistai;18;16;34;9;6;15
292;12.01.2016;2016;01;15;Tiistai;19;19;38;7;9;16
292;12.01.2016;2016;01;16;Tiistai;23;22;45;6;3;9
292;12.01.2016;2016;01;17;Tiistai;8;8;16;7;3;10
292;12.01.2016;2016;01;18;Tiistai;5;5;10;10;5;15
292;12.01.2016;2016;01;19;Tiistai;6;6;12;8;9;17
292;12.01.2016;2016;01;20;Tiistai;8;8;16;5;2;7
292;12.01.2016;2016;01;21;Tiistai;2;2;4;1;3;4
292;12.01.2016;2016;01;22;Tiistai;4;3;7;2;1;3
292;12.01.2016;2016;01;23;Tiistai;1;1;2;0;0;0
292;13.01.2016;2016;01;00;Keskiviikko;0;0;0;1;0;1
292;13.01.2016;2016;01;01;Keskiviikko;0;0;0;0;1;1
292;13.01.2016;2016;01;02;Keskiviikko;0;0;0;1;0;1
292;13.01.2016;2016;01;03;Keskiviikko;0;0;0;0;1;1
292;13.01.2016;2016;01;04;Keskiviikko;1;1;2;2;0;2
292;13.01.2016;2016;01;05;Keskiviikko;7;6;13;2;1;3
292;13.01.2016;2016;01;06;Keskiviikko;8;8;16;1;2;3
292;13.01.2016;2016;01;07;Keskiviikko;29;28;57;8;9;17
292;13.01.2016;2016;01;08;Keskiviikko;14;13;27;6;3;9
292;13.01.2016;2016;01;09;Keskiviikko;14;14;28;5;8;13
292;13.01.2016;2016;01;10;Keskiviikko;4;3;7;9;5;14
292;13.01.2016;2016;01;11;Keskiviikko;9;9;18;6;14;20
292;13.01.2016;2016;01;12;Keskiviikko;11;11;22;14;13;27
292;13.01.2016;2016;01;13;Keskiviikko;27;26;53;10;7;17
292;13.01.2016;2016;01;14;Keskiviikko;20;19;39;7;7;14
292;13.01.2016;2016;01;15;Keskiviikko;20;20;40;13;9;22
292;13.01.2016;2016;01;16;Keskiviikko;18;17;35;9;7;16
292;13.01.2016;2016;01;17;Keskiviikko;14;13;27;13;4;17
292;13.01.2016;2016;01;18;Keskiviikko;5;4;9;6;4;10
292;13.01.2016;2016;01;19;Keskiviikko;5;5;10;6;5;11
292;13.01.2016;2016;01;20;Keskiviikko;5;4;9;4;4;8
292;13.01.2016;2016;01;21;Keskiviikko;2;2;4;4;4;8
292;13.01.2016;2016;01;22;Keskiviikko;4;3;7;4;1;5
292;13.01.2016;2016;01;23;Keskiviikko;0;0;0;2;0;2
292;14.01.2016;2016;01;00;Torstai;0;0;0;0;0;0
292;14.01.2016;2016;01;01;Torstai;0;0;0;0;2;2
292;14.01.2016;2016;01;02;Torstai;0;0;0;0;0;0
292;14.01.2016;2016;01;03;Torstai;0;0;0;0;0;0
292;14.01.2016;2016;01;04;Torstai;2;1;3;1;1;2
292;14.01.2016;2016;01;05;Torstai;5;4;9;2;0;2
292;14.01.2016;2016;01;06;Torstai;7;7;14;1;5;6
292;14.01.2016;2016;01;07;Torstai;27;27;54;7;5;12
292;14.01.2016;2016;01;08;Torstai;24;22;46;7;2;9
292;14.01.2016;2016;01;09;Torstai;20;20;40;4;4;8
292;14.01.2016;2016;01;10;Torstai;11;11;22;13;9;22
292;14.01.2016;2016;01;11;Torstai;10;9;19;19;9;28
292;14.01.2016;2016;01;12;Torstai;13;12;25;8;13;21
292;14.01.2016;2016;01;13;Torstai;18;18;36;13;8;21
292;14.01.2016;2016;01;14;Torstai;18;17;35;2;6;8
292;14.01.2016;2016;01;15;Torstai;29;28;57;12;9;21
292;14.01.2016;2016;01;16;Torstai;22;21;43;8;3;11
292;14.01.2016;2016;01;17;Torstai;14;13;27;10;3;13
292;14.01.2016;2016;01;18;Torstai;12;11;23;8;5;13
292;14.01.2016;2016;01;19;Torstai;13;12;25;12;9;21
292;14.01.2016;2016;01;20;Torstai;13;13;26;9;2;11
292;14.01.2016;2016;01;21;Torstai;6;6;12;8;3;11
292;14.01.2016;2016;01;22;Torstai;3;2;5;2;1;3
292;14.01.2016;2016;01;23;Torstai;1;1;2;1;0;1
292;15.01.2016;2016;01;00;Perjantai;0;0;0;3;0;3
292;15.01.2016;2016;01;01;Perjantai;0;0;0;1;2;3
292;15.01.2016;2016;01;02;Perjantai;0;0;0;1;0;1
292;15.01.2016;2016;01;03;Perjantai;0;0;0;1;0;1
292;15.01.2016;2016;01;04;Perjantai;1;0;1;0;1;1
292;15.01.2016;2016;01;05;Perjantai;5;5;10;2;0;2
292;15.01.2016;2016;01;06;Perjantai;8;8;16;0;5;5
292;15.01.2016;2016;01;07;Perjantai;22;20;42;5;5;10
292;15.01.2016;2016;01;08;Perjantai;22;22;44;6;2;8
292;15.01.2016;2016;01;09;Perjantai;13;11;24;3;4;7
292;15.01.2016;2016;01;10;Perjantai;5;3;8;5;9;14
292;15.01.2016;2016;01;11;Perjantai;7;5;12;9;9;18
292;15.01.2016;2016;01;12;Perjantai;13;11;24;13;13;26
292;15.01.2016;2016;01;13;Perjantai;21;20;41;15;8;23
292;15.01.2016;2016;01;14;Perjantai;22;21;43;8;6;14
292;15.01.2016;2016;01;15;Perjantai;14;13;27;10;9;19
292;15.01.2016;2016;01;16;Perjantai;17;17;34;9;3;12
292;15.01.2016;2016;01;17;Perjantai;10;10;20;1;3;4
292;15.01.2016;2016;01;18;Perjantai;10;10;20;2;5;7
292;15.01.2016;2016;01;19;Perjantai;6;5;11;2;9;11
292;15.01.2016;2016;01;20;Perjantai;10;10;20;3;2;5
292;15.01.2016;2016;01;21;Perjantai;3;2;5;1;3;4
292;15.01.2016;2016;01;22;Perjantai;3;3;6;4;1;5
292;15.01.2016;2016;01;23;Perjantai;3;2;5;7;0;7
292;16.01.2016;2016;01;00;Lauantai;1;0;1;1;0;1
292;16.01.2016;2016;01;01;Lauantai;1;1;2;0;2;2
292;16.01.2016;2016;01;02;Lauantai;0;0;0;0;1;1
292;16.01.2016;2016;01;03;Lauantai;0;0;0;1;3;4
292;16.01.2016;2016;01;04;Lauantai;0;0;0;1;0;1
292;16.01.2016;2016;01;05;Lauantai;1;0;1;1;0;1
292;16.01.2016;2016;01;06;Lauantai;2;1;3;0;3;3
292;16.01.2016;2016;01;07;Lauantai;2;2;4;3;1;4
292;16.01.2016;2016;01;08;Lauantai;2;2;4;3;3;6
292;16.01.2016;2016;01;09;Lauantai;2;2;4;3;1;4
292;16.01.2016;2016;01;10;Lauantai;1;0;1;6;4;10
292;16.01.2016;2016;01;11;Lauantai;6;6;12;7;4;11
292;16.01.2016;2016;01;12;Lauantai;8;8;16;5;7;12
292;16.01.2016;2016;01;13;Lauantai;8;7;15;11;5;16
292;16.01.2016;2016;01;14;Lauantai;10;10;20;13;7;20
292;16.01.2016;2016;01;15;Lauantai;12;11;23;11;8;19
292;16.01.2016;2016;01;16;Lauantai;7;4;11;6;12;18
292;16.01.2016;2016;01;17;Lauantai;10;9;19;7;3;10
292;16.01.2016;2016;01;18;Lauantai;7;5;12;13;6;19
292;16.01.2016;2016;01;19;Lauantai;5;4;9;4;5;9
292;16.01.2016;2016;01;20;Lauantai;3;3;6;8;1;9
292;16.01.2016;2016;01;21;Lauantai;2;2;4;1;4;5
292;16.01.2016;2016;01;22;Lauantai;3;2;5;2;2;4
292;16.01.2016;2016;01;23;Lauantai;3;3;6;6;0;6
292;17.01.2016;2016;01;00;Sunnuntai;1;0;1;0;0;0
292;17.01.2016;2016;01;01;Sunnuntai;3;2;5;0;0;0
292;17.01.2016;2016;01;02;Sunnuntai;2;2;4;0;1;1
292;17.01.2016;2016;01;03;Sunnuntai;0;0;0;0;0;0
292;17.01.2016;2016;01;04;Sunnuntai;1;0;1;0;0;0
292;17.01.2016;2016;01;05;Sunnuntai;1;0;1;1;0;1
292;17.01.2016;2016;01;06;Sunnuntai;1;0;1;0;0;0
292;17.01.2016;2016;01;07;Sunnuntai;1;1;2;0;0;0
292;17.01.2016;2016;01;08;Sunnuntai;1;0;1;0;0;0
292;17.01.2016;2016;01;09;Sunnuntai;2;1;3;2;1;3
292;17.01.2016;2016;01;10;Sunnuntai;0;0;0;3;0;3
292;17.01.2016;2016;01;11;Sunnuntai;1;0;1;3;0;3
292;17.01.2016;2016;01;12;Sunnuntai;1;0;1;4;1;5
292;17.01.2016;2016;01;13;Sunnuntai;3;2;5;4;2;6
292;17.01.2016;2016;01;14;Sunnuntai;2;1;3;6;4;10
292;17.01.2016;2016;01;15;Sunnuntai;4;3;7;13;3;16
292;17.01.2016;2016;01;16;Sunnuntai;3;3;6;3;3;6
292;17.01.2016;2016;01;17;Sunnuntai;3;2;5;9;2;11
292;17.01.2016;2016;01;18;Sunnuntai;3;3;6;4;0;4
292;17.01.2016;2016;01;19;Sunnuntai;4;3;7;5;0;5
292;17.01.2016;2016;01;20;Sunnuntai;4;3;7;3;0;3
292;17.01.2016;2016;01;21;Sunnuntai;3;3;6;2;2;4
292;17.01.2016;2016;01;22;Sunnuntai;1;0;1;1;0;1
292;17.01.2016;2016;01;23;Sunnuntai;0;0;0;0;0;0
292;18.01.2016;2016;01;00;Maanantai;0;0;0;0;0;0
292;18.01.2016;2016;01;01;Maanantai;1;0;1;2;2;4
292;18.01.2016;2016;01;02;Maanantai;0;0;0;0;0;0
292;18.01.2016;2016;01;03;Maanantai;0;0;0;0;0;0
292;18.01.2016;2016;01;04;Maanantai;1;1;2;0;1;1
292;18.01.2016;2016;01;05;Maanantai;3;3;6;2;3;5
292;18.01.2016;2016;01;06;Maanantai;8;7;15;1;6;7
292;18.01.2016;2016;01;07;Maanantai;21;21;42;22;14;36
292;18.01.2016;2016;01;08;Maanantai;15;14;29;14;15;29
292;18.01.2016;2016;01;09;Maanantai;8;8;16;14;8;22
292;18.01.2016;2016;01;10;Maanantai;4;4;8;9;11;20
292;18.01.2016;2016;01;11;Maanantai;6;5;11;10;18;28
292;18.01.2016;2016;01;12;Maanantai;8;7;15;10;12;22
292;18.01.2016;2016;01;13;Maanantai;10;10;20;22;25;47
292;18.01.2016;2016;01;14;Maanantai;18;16;34;22;48;70
292;18.01.2016;2016;01;15;Maanantai;18;17;35;27;17;44
292;18.01.2016;2016;01;16;Maanantai;15;14;29;8;28;36
292;18.01.2016;2016;01;17;Maanantai;5;5;10;10;11;21
292;18.01.2016;2016;01;18;Maanantai;5;4;9;18;10;28
292;18.01.2016;2016;01;19;Maanantai;5;4;9;24;9;33
292;18.01.2016;2016;01;20;Maanantai;4;4;8;8;10;18
292;18.01.2016;2016;01;21;Maanantai;2;4;6;5;2;7
292;18.01.2016;2016;01;22;Maanantai;1;1;2;4;1;5
292;18.01.2016;2016;01;23;Maanantai;1;0;1;0;0;0
292;19.01.2016;2016;01;00;Tiistai;0;0;0;1;1;2
292;19.01.2016;2016;01;01;Tiistai;0;0;0;1;1;2
292;19.01.2016;2016;01;02;Tiistai;0;0;0;0;0;0
292;19.01.2016;2016;01;03;Tiistai;0;0;0;0;0;0
292;19.01.2016;2016;01;04;Tiistai;1;1;2;1;0;1
292;19.01.2016;2016;01;05;Tiistai;4;4;8;1;0;1
292;19.01.2016;2016;01;06;Tiistai;4;4;8;4;5;9
292;19.01.2016;2016;01;07;Tiistai;13;11;24;19;12;31
292;19.01.2016;2016;01;08;Tiistai;11;11;22;25;10;35
292;19.01.2016;2016;01;09;Tiistai;8;8;16;11;8;19
292;19.01.2016;2016;01;10;Tiistai;5;4;9;12;12;24
292;19.01.2016;2016;01;11;Tiistai;2;2;4;11;9;20
292;19.01.2016;2016;01;12;Tiistai;4;2;6;7;11;18
292;19.01.2016;2016;01;13;Tiistai;7;6;13;19;30;49
292;19.01.2016;2016;01;14;Tiistai;13;13;26;15;24;39
292;19.01.2016;2016;01;15;Tiistai;10;10;20;23;21;44
292;19.01.2016;2016;01;16;Tiistai;12;12;24;10;10;20
292;19.01.2016;2016;01;17;Tiistai;5;5;10;16;15;31
292;19.01.2016;2016;01;18;Tiistai;8;6;14;15;6;21
292;19.01.2016;2016;01;19;Tiistai;5;5;10;14;14;28
292;19.01.2016;2016;01;20;Tiistai;4;3;7;6;7;13
292;19.01.2016;2016;01;21;Tiistai;3;3;6;2;3;5
292;19.01.2016;2016;01;22;Tiistai;1;1;2;0;4;4
292;19.01.2016;2016;01;23;Tiistai;1;0;1;1;0;1
292;20.01.2016;2016;01;00;Keskiviikko;0;0;0;1;1;2
292;20.01.2016;2016;01;01;Keskiviikko;0;0;0;1;1;2
292;20.01.2016;2016;01;02;Keskiviikko;0;0;0;0;0;0
292;20.01.2016;2016;01;03;Keskiviikko;0;0;0;0;0;0
292;20.01.2016;2016;01;04;Keskiviikko;1;0;1;1;0;1
292;20.01.2016;2016;01;05;Keskiviikko;5;4;9;1;0;1
292;20.01.2016;2016;01;06;Keskiviikko;6;6;12;4;5;9
292;20.01.2016;2016;01;07;Keskiviikko;16;14;30;19;12;31
292;20.01.2016;2016;01;08;Keskiviikko;15;15;30;25;10;35
292;20.01.2016;2016;01;09;Keskiviikko;7;6;13;11;8;19
292;20.01.2016;2016;01;10;Keskiviikko;3;3;6;12;12;24
292;20.01.2016;2016;01;11;Keskiviikko;7;6;13;11;9;20
292;20.01.2016;2016;01;12;Keskiviikko;8;7;15;7;11;18
292;20.01.2016;2016;01;13;Keskiviikko;11;11;22;19;30;49
292;20.01.2016;2016;01;14;Keskiviikko;19;16;35;13;20;33
292;20.01.2016;2016;01;15;Keskiviikko;15;14;29;13;18;31
292;20.01.2016;2016;01;16;Keskiviikko;9;8;17;19;17;36
292;20.01.2016;2016;01;17;Keskiviikko;8;8;16;14;16;30
292;20.01.2016;2016;01;18;Keskiviikko;5;5;10;10;9;19
292;20.01.2016;2016;01;19;Keskiviikko;2;2;4;21;12;33
292;20.01.2016;2016;01;20;Keskiviikko;2;1;3;6;11;17
292;20.01.2016;2016;01;21;Keskiviikko;5;4;9;4;2;6
292;20.01.2016;2016;01;22;Keskiviikko;1;1;2;0;0;0
292;20.01.2016;2016;01;23;Keskiviikko;1;0;1;1;0;1
292;21.01.2016;2016;01;00;Torstai;0;0;0;0;1;1
292;21.01.2016;2016;01;01;Torstai;0;0;0;1;0;1
292;21.01.2016;2016;01;02;Torstai;0;0;0;0;0;0
292;21.01.2016;2016;01;03;Torstai;0;0;0;0;0;0
292;21.01.2016;2016;01;04;Torstai;0;0;0;1;0;1
292;21.01.2016;2016;01;05;Torstai;5;4;9;3;1;4
292;21.01.2016;2016;01;06;Torstai;7;7;14;3;3;6
292;21.01.2016;2016;01;07;Torstai;12;12;24;25;13;38
292;21.01.2016;2016;01;08;Torstai;8;8;16;17;17;34
292;21.01.2016;2016;01;09;Torstai;8;7;15;14;13;27
292;21.01.2016;2016;01;10;Torstai;1;1;2;5;2;7
292;21.01.2016;2016;01;11;Torstai;2;1;3;15;5;20
292;21.01.2016;2016;01;12;Torstai;5;3;8;17;14;31
292;21.01.2016;2016;01;13;Torstai;7;6;13;20;11;31
292;21.01.2016;2016;01;14;Torstai;12;12;24;18;23;41
292;21.01.2016;2016;01;15;Torstai;16;16;32;19;20;39
292;21.01.2016;2016;01;16;Torstai;11;11;22;10;24;34
292;21.01.2016;2016;01;17;Torstai;4;4;8;10;15;25
292;21.01.2016;2016;01;18;Torstai;5;4;9;8;8;16
292;21.01.2016;2016;01;19;Torstai;1;1;2;12;8;20
292;21.01.2016;2016;01;20;Torstai;3;3;6;9;8;17
292;21.01.2016;2016;01;21;Torstai;4;4;8;6;4;10
292;21.01.2016;2016;01;22;Torstai;3;2;5;2;2;4
292;21.01.2016;2016;01;23;Torstai;1;0;1;1;0;1
292;22.01.2016;2016;01;00;Perjantai;0;0;0;0;0;0
292;22.01.2016;2016;01;01;Perjantai;0;0;0;0;0;0
292;22.01.2016;2016;01;02;Perjantai;0;0;0;0;0;0
292;22.01.2016;2016;01;03;Perjantai;0;0;0;0;0;0
292;22.01.2016;2016;01;04;Perjantai;1;1;2;2;1;3
292;22.01.2016;2016;01;05;Perjantai;5;4;9;2;2;4
292;22.01.2016;2016;01;06;Perjantai;7;6;13;3;5;8
292;22.01.2016;2016;01;07;Perjantai;20;19;39;15;16;31
292;22.01.2016;2016;01;08;Perjantai;18;17;35;17;12;29
292;22.01.2016;2016;01;09;Perjantai;18;18;36;6;6;12
292;22.01.2016;2016;01;10;Perjantai;10;10;20;9;5;14
292;22.01.2016;2016;01;11;Perjantai;11;10;21;10;15;25
292;22.01.2016;2016;01;12;Perjantai;7;6;13;21;8;29
292;22.01.2016;2016;01;13;Perjantai;28;28;56;18;29;47
292;22.01.2016;2016;01;14;Perjantai;25;25;50;10;21;31
292;22.01.2016;2016;01;15;Perjantai;22;21;43;19;13;32
292;22.01.2016;2016;01;16;Perjantai;13;12;25;12;6;18
292;22.01.2016;2016;01;17;Perjantai;11;10;21;12;8;20
292;22.01.2016;2016;01;18;Perjantai;7;7;14;12;14;26
292;22.01.2016;2016;01;19;Perjantai;4;3;7;10;5;15
292;22.01.2016;2016;01;20;Perjantai;7;7;14;7;3;10
292;22.01.2016;2016;01;21;Perjantai;4;3;7;4;6;10
292;22.01.2016;2016;01;22;Perjantai;3;2;5;6;4;10
292;22.01.2016;2016;01;23;Perjantai;2;2;4;7;2;9
292;23.01.2016;2016;01;00;Lauantai;1;1;2;3;1;4
292;23.01.2016;2016;01;01;Lauantai;0;0;0;2;2;4
292;23.01.2016;2016;01;02;Lauantai;1;0;1;1;4;5
292;23.01.2016;2016;01;03;Lauantai;0;0;0;0;4;4
292;23.01.2016;2016;01;04;Lauantai;1;1;2;0;0;0
292;23.01.2016;2016;01;05;Lauantai;2;1;3;0;1;1
292;23.01.2016;2016;01;06;Lauantai;4;3;7;1;0;1
292;23.01.2016;2016;01;07;Lauantai;2;2;4;1;4;5
292;23.01.2016;2016;01;08;Lauantai;4;4;8;2;2;4
292;23.01.2016;2016;01;09;Lauantai;5;3;8;4;6;10
292;23.01.2016;2016;01;10;Lauantai;6;6;12;2;6;8
292;23.01.2016;2016;01;11;Lauantai;7;7;14;8;8;16
292;23.01.2016;2016;01;12;Lauantai;14;14;28;10;14;24
292;23.01.2016;2016;01;13;Lauantai;11;10;21;9;6;15
292;23.01.2016;2016;01;14;Lauantai;13;13;26;25;25;50
292;23.01.2016;2016;01;15;Lauantai;15;15;30;27;16;43
292;23.01.2016;2016;01;16;Lauantai;13;13;26;19;11;30
292;23.01.2016;2016;01;17;Lauantai;7;6;13;11;5;16
292;23.01.2016;2016;01;18;Lauantai;8;7;15;9;8;17
292;23.01.2016;2016;01;19;Lauantai;3;2;5;8;7;15
292;23.01.2016;2016;01;20;Lauantai;3;2;5;7;5;12
292;23.01.2016;2016;01;21;Lauantai;4;3;7;1;4;5
292;23.01.2016;2016;01;22;Lauantai;1;1;2;3;1;4
292;23.01.2016;2016;01;23;Lauantai;1;1;2;2;1;3
292;24.01.2016;2016;01;00;Sunnuntai;2;1;3;1;0;1
292;24.01.2016;2016;01;01;Sunnuntai;0;0;0;1;1;2
292;24.01.2016;2016;01;02;Sunnuntai;2;1;3;0;0;0
292;24.01.2016;2016;01;03;Sunnuntai;1;0;1;0;2;2
292;24.01.2016;2016;01;04;Sunnuntai;1;0;1;0;0;0
292;24.01.2016;2016;01;05;Sunnuntai;1;1;2;1;0;1
292;24.01.2016;2016;01;06;Sunnuntai;3;2;5;0;1;1
292;24.01.2016;2016;01;07;Sunnuntai;1;0;1;2;3;5
292;24.01.2016;2016;01;08;Sunnuntai;1;1;2;1;2;3
292;24.01.2016;2016;01;09;Sunnuntai;9;8;17;8;7;15
292;24.01.2016;2016;01;10;Sunnuntai;7;6;13;5;11;16
292;24.01.2016;2016;01;11;Sunnuntai;21;19;40;8;21;29
292;24.01.2016;2016;01;12;Sunnuntai;9;8;17;16;9;25
292;24.01.2016;2016;01;13;Sunnuntai;11;10;21;19;14;33
292;24.01.2016;2016;01;14;Sunnuntai;19;17;36;17;19;36
292;24.01.2016;2016;01;15;Sunnuntai;10;9;19;15;21;36
292;24.01.2016;2016;01;16;Sunnuntai;14;14;28;16;16;32
292;24.01.2016;2016;01;17;Sunnuntai;9;8;17;15;12;27
292;24.01.2016;2016;01;18;Sunnuntai;7;6;13;8;9;17
292;24.01.2016;2016;01;19;Sunnuntai;11;11;22;10;9;19
292;24.01.2016;2016;01;20;Sunnuntai;2;2;4;10;4;14
292;24.01.2016;2016;01;21;Sunnuntai;4;4;8;3;6;9
292;24.01.2016;2016;01;22;Sunnuntai;1;1;2;0;1;1
292;24.01.2016;2016;01;23;Sunnuntai;0;0;0;1;2;3
292;25.01.2016;2016;01;00;Maanantai;1;1;2;0;0;0
292;25.01.2016;2016;01;01;Maanantai;1;1;2;2;2;4
292;25.01.2016;2016;01;02;Maanantai;0;0;0;0;0;0
292;25.01.2016;2016;01;03;Maanantai;0;0;0;0;0;0
292;25.01.2016;2016;01;04;Maanantai;2;1;3;0;1;1
292;25.01.2016;2016;01;05;Maanantai;7;7;14;2;3;5
292;25.01.2016;2016;01;06;Maanantai;7;6;13;1;6;7
292;25.01.2016;2016;01;07;Maanantai;30;30;60;22;14;36
292;25.01.2016;2016;01;08;Maanantai;21;21;42;14;15;29
292;25.01.2016;2016;01;09;Maanantai;17;16;33;14;8;22
292;25.01.2016;2016;01;10;Maanantai;13;12;25;9;11;20
292;25.01.2016;2016;01;11;Maanantai;12;11;23;10;18;28
292;25.01.2016;2016;01;12;Maanantai;20;19;39;10;12;22
292;25.01.2016;2016;01;13;Maanantai;21;20;41;22;25;47
292;25.01.2016;2016;01;14;Maanantai;31;31;62;22;48;70
292;25.01.2016;2016;01;15;Maanantai;28;28;56;27;17;44
292;25.01.2016;2016;01;16;Maanantai;28;28;56;8;28;36
292;25.01.2016;2016;01;17;Maanantai;12;12;24;10;11;21
292;25.01.2016;2016;01;18;Maanantai;13;13;26;18;10;28
292;25.01.2016;2016;01;19;Maanantai;8;7;15;24;9;33
292;25.01.2016;2016;01;20;Maanantai;6;6;12;8;10;18
292;25.01.2016;2016;01;21;Maanantai;6;5;11;5;2;7
292;25.01.2016;2016;01;22;Maanantai;1;1;2;4;1;5
292;25.01.2016;2016;01;23;Maanantai;1;1;2;0;0;0
292;26.01.2016;2016;01;00;Tiistai;0;0;0;1;1;2
292;26.01.2016;2016;01;01;Tiistai;0;0;0;1;1;2
292;26.01.2016;2016;01;02;Tiistai;1;0;1;0;0;0
292;26.01.2016;2016;01;03;Tiistai;0;0;0;0;0;0
292;26.01.2016;2016;01;04;Tiistai;2;1;3;1;0;1
292;26.01.2016;2016;01;05;Tiistai;5;5;10;1;0;1
292;26.01.2016;2016;01;06;Tiistai;9;9;18;4;5;9
292;26.01.2016;2016;01;07;Tiistai;29;28;57;19;12;31
292;26.01.2016;2016;01;08;Tiistai;23;22;45;25;10;35
292;26.01.2016;2016;01;09;Tiistai;11;11;22;11;8;19
292;26.01.2016;2016;01;10;Tiistai;8;8;16;12;12;24
292;26.01.2016;2016;01;11;Tiistai;7;7;14;11;9;20
292;26.01.2016;2016;01;12;Tiistai;6;6;12;7;11;18
292;26.01.2016;2016;01;13;Tiistai;17;17;34;19;30;49
292;26.01.2016;2016;01;14;Tiistai;21;21;42;15;24;39
292;26.01.2016;2016;01;15;Tiistai;21;21;42;23;21;44
292;26.01.2016;2016;01;16;Tiistai;15;14;29;10;10;20
292;26.01.2016;2016;01;17;Tiistai;12;11;23;16;15;31
292;26.01.2016;2016;01;18;Tiistai;11;11;22;15;6;21
292;26.01.2016;2016;01;19;Tiistai;12;11;23;14;14;28
292;26.01.2016;2016;01;20;Tiistai;6;6;12;6;7;13
292;26.01.2016;2016;01;21;Tiistai;4;3;7;2;3;5
292;26.01.2016;2016;01;22;Tiistai;4;3;7;0;4;4
292;26.01.2016;2016;01;23;Tiistai;1;0;1;1;0;1
292;27.01.2016;2016;01;00;Keskiviikko;0;0;0;1;1;2
292;27.01.2016;2016;01;01;Keskiviikko;0;0;0;1;1;2
292;27.01.2016;2016;01;02;Keskiviikko;1;0;1;0;0;0
292;27.01.2016;2016;01;03;Keskiviikko;0;0;0;0;0;0
292;27.01.2016;2016;01;04;Keskiviikko;1;1;2;1;0;1
292;27.01.2016;2016;01;05;Keskiviikko;6;6;12;1;0;1
292;27.01.2016;2016;01;06;Keskiviikko;10;9;19;4;5;9
292;27.01.2016;2016;01;07;Keskiviikko;31;30;61;19;12;31
292;27.01.2016;2016;01;08;Keskiviikko;21;21;42;25;10;35
292;27.01.2016;2016;01;09;Keskiviikko;16;16;32;11;8;19
292;27.01.2016;2016;01;10;Keskiviikko;11;10;21;12;12;24
292;27.01.2016;2016;01;11;Keskiviikko;12;12;24;11;9;20
292;27.01.2016;2016;01;12;Keskiviikko;13;12;25;7;11;18
292;27.01.2016;2016;01;13;Keskiviikko;28;27;55;19;30;49
292;27.01.2016;2016;01;14;Keskiviikko;15;34;49;13;20;33
292;27.01.2016;2016;01;15;Keskiviikko;24;18;42;13;18;31
292;27.01.2016;2016;01;16;Keskiviikko;30;29;59;19;17;36
292;27.01.2016;2016;01;17;Keskiviikko;32;19;51;14;16;30
292;27.01.2016;2016;01;18;Keskiviikko;15;9;24;10;9;19
292;27.01.2016;2016;01;19;Keskiviikko;12;27;39;21;12;33
292;27.01.2016;2016;01;20;Keskiviikko;6;7;13;6;11;17
292;27.01.2016;2016;01;21;Keskiviikko;3;4;7;4;2;6
292;27.01.2016;2016;01;22;Keskiviikko;3;5;8;0;0;0
292;27.01.2016;2016;01;23;Keskiviikko;0;0;0;1;0;1
292;28.01.2016;2016;01;00;Torstai;0;0;0;0;1;1
292;28.01.2016;2016;01;01;Torstai;0;0;0;1;0;1
292;28.01.2016;2016;01;02;Torstai;0;0;0;0;0;0
292;28.01.2016;2016;01;03;Torstai;0;2;2;0;0;0
292;28.01.2016;2016;01;04;Torstai;2;0;2;1;0;1
292;28.01.2016;2016;01;05;Torstai;7;3;10;3;1;4
292;28.01.2016;2016;01;06;Torstai;8;9;17;3;3;6
292;28.01.2016;2016;01;07;Torstai;42;10;52;25;13;38
292;28.01.2016;2016;01;08;Torstai;19;16;35;17;17;34
292;28.01.2016;2016;01;09;Torstai;41;8;49;14;13;27
292;28.01.2016;2016;01;10;Torstai;12;8;20;5;2;7
292;28.01.2016;2016;01;11;Torstai;10;11;21;15;5;20
292;28.01.2016;2016;01;12;Torstai;10;15;25;17;14;31
292;28.01.2016;2016;01;13;Torstai;12;16;28;20;11;31
292;28.01.2016;2016;01;14;Torstai;20;27;47;18;23;41
292;28.01.2016;2016;01;15;Torstai;24;45;69;19;20;39
292;28.01.2016;2016;01;16;Torstai;14;43;57;10;24;34
292;28.01.2016;2016;01;17;Torstai;14;12;26;10;15;25
292;28.01.2016;2016;01;18;Torstai;15;12;27;8;8;16
292;28.01.2016;2016;01;19;Torstai;10;12;22;12;8;20
292;28.01.2016;2016;01;20;Torstai;5;6;11;9;8;17
292;28.01.2016;2016;01;21;Torstai;4;5;9;6;4;10
292;28.01.2016;2016;01;22;Torstai;2;3;5;2;2;4
292;28.01.2016;2016;01;23;Torstai;0;0;0;1;0;1
292;29.01.2016;2016;01;00;Perjantai;0;0;0;0;0;0
292;29.01.2016;2016;01;01;Perjantai;0;0;0;0;0;0
292;29.01.2016;2016;01;02;Perjantai;0;0;0;0;0;0
292;29.01.2016;2016;01;03;Perjantai;0;0;0;0;0;0
292;29.01.2016;2016;01;04;Perjantai;0;0;0;2;1;3
292;29.01.2016;2016;01;05;Perjantai;7;3;10;2;2;4
292;29.01.2016;2016;01;06;Perjantai;7;5;12;3;5;8
292;29.01.2016;2016;01;07;Perjantai;35;12;47;15;16;31
292;29.01.2016;2016;01;08;Perjantai;34;14;48;17;12;29
292;29.01.2016;2016;01;09;Perjantai;24;11;35;6;6;12
292;29.01.2016;2016;01;10;Perjantai;12;10;22;9;5;14
292;29.01.2016;2016;01;11;Perjantai;10;10;20;10;15;25
292;29.01.2016;2016;01;12;Perjantai;6;17;23;21;8;29
292;29.01.2016;2016;01;13;Perjantai;20;39;59;18;29;47
292;29.01.2016;2016;01;14;Perjantai;19;52;71;10;21;31
292;29.01.2016;2016;01;15;Perjantai;20;19;39;19;13;32
292;29.01.2016;2016;01;16;Perjantai;17;17;34;12;6;18
292;29.01.2016;2016;01;17;Perjantai;16;7;23;12;8;20
292;29.01.2016;2016;01;18;Perjantai;8;11;19;12;14;26
292;29.01.2016;2016;01;19;Perjantai;10;8;18;10;5;15
292;29.01.2016;2016;01;20;Perjantai;9;10;19;7;3;10
292;29.01.2016;2016;01;21;Perjantai;2;7;9;4;6;10
292;29.01.2016;2016;01;22;Perjantai;8;1;9;6;4;10
292;29.01.2016;2016;01;23;Perjantai;3;1;4;7;2;9
292;30.01.2016;2016;01;00;Lauantai;3;1;4;3;1;4
292;30.01.2016;2016;01;01;Lauantai;0;0;0;2;2;4
292;30.01.2016;2016;01;02;Lauantai;1;0;1;1;4;5
292;30.01.2016;2016;01;03;Lauantai;0;0;0;0;4;4
292;30.01.2016;2016;01;04;Lauantai;0;0;0;0;0;0
292;30.01.2016;2016;01;05;Lauantai;0;1;1;0;1;1
292;30.01.2016;2016;01;06;Lauantai;4;1;5;1;0;1
292;30.01.2016;2016;01;07;Lauantai;1;3;4;1;4;5
292;30.01.2016;2016;01;08;Lauantai;4;1;5;2;2;4
292;30.01.2016;2016;01;09;Lauantai;3;3;6;4;6;10
292;30.01.2016;2016;01;10;Lauantai;3;9;12;2;6;8
292;30.01.2016;2016;01;11;Lauantai;5;13;18;8;8;16
292;30.01.2016;2016;01;12;Lauantai;20;15;35;10;14;24
292;30.01.2016;2016;01;13;Lauantai;16;18;34;9;6;15
292;30.01.2016;2016;01;14;Lauantai;23;15;38;25;25;50
292;30.01.2016;2016;01;15;Lauantai;10;6;16;27;16;43
292;30.01.2016;2016;01;16;Lauantai;12;9;21;19;11;30
292;30.01.2016;2016;01;17;Lauantai;8;4;12;11;5;16
292;30.01.2016;2016;01;18;Lauantai;4;4;8;9;8;17
292;30.01.2016;2016;01;19;Lauantai;5;3;8;8;7;15
292;30.01.2016;2016;01;20;Lauantai;4;5;9;7;5;12
292;30.01.2016;2016;01;21;Lauantai;3;9;12;1;4;5
292;30.01.2016;2016;01;22;Lauantai;3;3;6;3;1;4
292;30.01.2016;2016;01;23;Lauantai;4;2;6;2;1;3
292;31.01.2016;2016;01;00;Sunnuntai;0;0;0;1;0;1
292;31.01.2016;2016;01;01;Sunnuntai;0;0;0;1;1;2
292;31.01.2016;2016;01;02;Sunnuntai;0;1;1;0;0;0
292;31.01.2016;2016;01;03;Sunnuntai;0;0;0;0;2;2
292;31.01.2016;2016;01;04;Sunnuntai;0;0;0;0;0;0
292;31.01.2016;2016;01;05;Sunnuntai;0;1;1;1;0;1
292;31.01.2016;2016;01;06;Sunnuntai;3;2;5;0;1;1
292;31.01.2016;2016;01;07;Sunnuntai;0;0;0;2;3;5
292;31.01.2016;2016;01;08;Sunnuntai;4;4;8;1;2;3
292;31.01.2016;2016;01;09;Sunnuntai;2;1;3;8;7;15
292;31.01.2016;2016;01;10;Sunnuntai;1;3;4;5;11;16
292;31.01.2016;2016;01;11;Sunnuntai;8;6;14;8;21;29
292;31.01.2016;2016;01;12;Sunnuntai;10;14;24;16;9;25
292;31.01.2016;2016;01;13;Sunnuntai;15;4;19;19;14;33
292;31.01.2016;2016;01;14;Sunnuntai;10;15;25;17;19;36
292;31.01.2016;2016;01;15;Sunnuntai;9;7;16;15;21;36
292;31.01.2016;2016;01;16;Sunnuntai;10;8;18;16;16;32
292;31.01.2016;2016;01;17;Sunnuntai;9;5;14;15;12;27
292;31.01.2016;2016;01;18;Sunnuntai;11;12;23;8;9;17
292;31.01.2016;2016;01;19;Sunnuntai;6;1;7;10;9;19
292;31.01.2016;2016;01;20;Sunnuntai;3;7;10;10;4;14
292;31.01.2016;2016;01;21;Sunnuntai;4;5;9;3;6;9
292;31.01.2016;2016;01;22;Sunnuntai;0;4;4;0;1;1
292;31.01.2016;2016;01;23;Sunnuntai;2;1;3;1;2;3
292;01.02.2016;2016;02;00;Maanantai;3;0;3;0;0;0
292;01.02.2016;2016;02;01;Maanantai;2;2;4;2;2;4
292;01.02.2016;2016;02;02;Maanantai;0;0;0;0;0;0
292;01.02.2016;2016;02;03;Maanantai;0;0;0;0;0;0
292;01.02.2016;2016;02;04;Maanantai;2;1;3;0;1;1
292;01.02.2016;2016;02;05;Maanantai;5;3;8;2;3;5
292;01.02.2016;2016;02;06;Maanantai;14;6;20;1;6;7
292;01.02.2016;2016;02;07;Maanantai;50;18;68;22;14;36
292;01.02.2016;2016;02;08;Maanantai;35;17;52;14;15;29
292;01.02.2016;2016;02;09;Maanantai;26;12;38;14;8;22
292;01.02.2016;2016;02;10;Maanantai;11;3;14;9;11;20
292;01.02.2016;2016;02;11;Maanantai;15;13;28;10;18;28
292;01.02.2016;2016;02;12;Maanantai;14;10;24;10;12;22
292;01.02.2016;2016;02;13;Maanantai;11;29;40;22;25;47
292;01.02.2016;2016;02;14;Maanantai;19;44;63;22;48;70
292;01.02.2016;2016;02;15;Maanantai;23;42;65;27;17;44
292;01.02.2016;2016;02;16;Maanantai;24;24;48;8;28;36
292;01.02.2016;2016;02;17;Maanantai;14;10;24;10;11;21
292;01.02.2016;2016;02;18;Maanantai;10;7;17;18;10;28
292;01.02.2016;2016;02;19;Maanantai;9;4;13;24;9;33
292;01.02.2016;2016;02;20;Maanantai;6;9;15;8;10;18
292;01.02.2016;2016;02;21;Maanantai;2;12;14;5;2;7
292;01.02.2016;2016;02;22;Maanantai;1;0;1;4;1;5
292;01.02.2016;2016;02;23;Maanantai;2;1;3;0;0;0
292;02.02.2016;2016;02;00;Tiistai;0;1;1;1;1;2
292;02.02.2016;2016;02;01;Tiistai;1;0;1;1;1;2
292;02.02.2016;2016;02;02;Tiistai;0;0;0;0;0;0
292;02.02.2016;2016;02;03;Tiistai;0;1;1;0;0;0
292;02.02.2016;2016;02;04;Tiistai;3;0;3;1;0;1
292;02.02.2016;2016;02;05;Tiistai;6;5;11;1;0;1
292;02.02.2016;2016;02;06;Tiistai;15;7;22;4;5;9
292;02.02.2016;2016;02;07;Tiistai;36;12;48;19;12;31
292;02.02.2016;2016;02;08;Tiistai;47;10;57;25;10;35
292;02.02.2016;2016;02;09;Tiistai;12;13;25;11;8;19
292;02.02.2016;2016;02;10;Tiistai;12;7;19;12;12;24
292;02.02.2016;2016;02;11;Tiistai;8;5;13;11;9;20
292;02.02.2016;2016;02;12;Tiistai;16;10;26;7;11;18
292;02.02.2016;2016;02;13;Tiistai;17;45;62;19;30;49
292;02.02.2016;2016;02;14;Tiistai;12;44;56;15;24;39
292;02.02.2016;2016;02;15;Tiistai;22;27;49;23;21;44
292;02.02.2016;2016;02;16;Tiistai;22;26;48;10;10;20
292;02.02.2016;2016;02;17;Tiistai;12;14;26;16;15;31
292;02.02.2016;2016;02;18;Tiistai;7;5;12;15;6;21
292;02.02.2016;2016;02;19;Tiistai;7;10;17;14;14;28
292;02.02.2016;2016;02;20;Tiistai;9;2;11;6;7;13
292;02.02.2016;2016;02;21;Tiistai;3;5;8;2;3;5
292;02.02.2016;2016;02;22;Tiistai;0;2;2;0;4;4
292;02.02.2016;2016;02;23;Tiistai;1;0;1;1;0;1
292;03.02.2016;2016;02;00;Keskiviikko;0;0;0;1;0;1
292;03.02.2016;2016;02;01;Keskiviikko;0;0;0;0;1;1
292;03.02.2016;2016;02;02;Keskiviikko;0;0;0;0;0;0
292;03.02.2016;2016;02;03;Keskiviikko;0;0;0;0;0;0
292;03.02.2016;2016;02;04;Keskiviikko;4;0;4;1;0;1
292;03.02.2016;2016;02;05;Keskiviikko;3;4;7;1;3;4
292;03.02.2016;2016;02;06;Keskiviikko;13;3;16;4;4;8
292;03.02.2016;2016;02;07;Keskiviikko;51;18;69;32;13;45
292;03.02.2016;2016;02;08;Keskiviikko;26;14;40;14;10;24
292;03.02.2016;2016;02;09;Keskiviikko;8;7;15;15;14;29
292;03.02.2016;2016;02;10;Keskiviikko;8;16;24;6;11;17
292;03.02.2016;2016;02;11;Keskiviikko;15;18;33;10;12;22
292;03.02.2016;2016;02;12;Keskiviikko;8;21;29;14;21;35
292;03.02.2016;2016;02;13;Keskiviikko;15;44;59;20;14;34
292;03.02.2016;2016;02;14;Keskiviikko;15;27;42;22;21;43
292;03.02.2016;2016;02;15;Keskiviikko;13;32;45;22;19;41
292;03.02.2016;2016;02;16;Keskiviikko;26;28;54;10;12;22
292;03.02.2016;2016;02;17;Keskiviikko;22;10;32;21;14;35
292;03.02.2016;2016;02;18;Keskiviikko;14;10;24;15;14;29
292;03.02.2016;2016;02;19;Keskiviikko;12;7;19;11;13;24
292;03.02.2016;2016;02;20;Keskiviikko;4;9;13;8;10;18
292;03.02.2016;2016;02;21;Keskiviikko;3;7;10;4;1;5
292;03.02.2016;2016;02;22;Keskiviikko;2;0;2;1;1;2
292;03.02.2016;2016;02;23;Keskiviikko;1;0;1;0;0;0
292;04.02.2016;2016;02;00;Torstai;1;1;2;0;0;0
292;04.02.2016;2016;02;01;Torstai;0;0;0;0;0;0
292;04.02.2016;2016;02;02;Torstai;0;0;0;0;0;0
292;04.02.2016;2016;02;03;Torstai;0;0;0;0;0;0
292;04.02.2016;2016;02;04;Torstai;0;0;0;2;0;2
292;04.02.2016;2016;02;05;Torstai;5;3;8;3;2;5
292;04.02.2016;2016;02;06;Torstai;15;12;27;7;3;10
292;04.02.2016;2016;02;07;Torstai;56;15;71;21;14;35
292;04.02.2016;2016;02;08;Torstai;28;15;43;17;12;29
292;04.02.2016;2016;02;09;Torstai;18;17;35;9;8;17
292;04.02.2016;2016;02;10;Torstai;16;17;33;11;7;18
292;04.02.2016;2016;02;11;Torstai;14;19;33;10;12;22
292;04.02.2016;2016;02;12;Torstai;11;22;33;12;9;21
292;04.02.2016;2016;02;13;Torstai;17;29;46;14;25;39
292;04.02.2016;2016;02;14;Torstai;20;35;55;22;18;40
292;04.02.2016;2016;02;15;Torstai;21;23;44;20;21;41
292;04.02.2016;2016;02;16;Torstai;25;28;53;11;22;33
292;04.02.2016;2016;02;17;Torstai;12;15;27;12;9;21
292;04.02.2016;2016;02;18;Torstai;10;11;21;9;6;15
292;04.02.2016;2016;02;19;Torstai;14;7;21;8;11;19
292;04.02.2016;2016;02;20;Torstai;8;10;18;6;4;10
292;04.02.2016;2016;02;21;Torstai;6;3;9;3;2;5
292;04.02.2016;2016;02;22;Torstai;1;3;4;1;2;3
292;04.02.2016;2016;02;23;Torstai;0;0;0;2;1;3
292;05.02.2016;2016;02;00;Perjantai;0;0;0;0;0;0
292;05.02.2016;2016;02;01;Perjantai;0;0;0;0;0;0
292;05.02.2016;2016;02;02;Perjantai;0;0;0;0;0;0
292;05.02.2016;2016;02;03;Perjantai;0;1;1;0;0;0
292;05.02.2016;2016;02;04;Perjantai;2;0;2;0;0;0
292;05.02.2016;2016;02;05;Perjantai;7;4;11;0;0;0
292;05.02.2016;2016;02;06;Perjantai;11;6;17;5;4;9
292;05.02.2016;2016;02;07;Perjantai;42;16;58;24;11;35
292;05.02.2016;2016;02;08;Perjantai;29;8;37;14;14;28
292;05.02.2016;2016;02;09;Perjantai;10;12;22;12;15;27
292;05.02.2016;2016;02;10;Perjantai;10;15;25;3;8;11
292;05.02.2016;2016;02;11;Perjantai;8;19;27;8;7;15
292;05.02.2016;2016;02;12;Perjantai;14;14;28;12;7;19
292;05.02.2016;2016;02;13;Perjantai;12;21;33;13;15;28
292;05.02.2016;2016;02;14;Perjantai;15;30;45;8;10;18
292;05.02.2016;2016;02;15;Perjantai;12;23;35;11;19;30
292;05.02.2016;2016;02;16;Perjantai;9;11;20;8;7;15
292;05.02.2016;2016;02;17;Perjantai;13;7;20;13;8;21
292;05.02.2016;2016;02;18;Perjantai;10;5;15;6;5;11
292;05.02.2016;2016;02;19;Perjantai;10;5;15;8;8;16
292;05.02.2016;2016;02;20;Perjantai;5;4;9;4;4;8
292;05.02.2016;2016;02;21;Perjantai;5;4;9;8;3;11
292;05.02.2016;2016;02;22;Perjantai;0;5;5;2;3;5
292;05.02.2016;2016;02;23;Perjantai;1;0;1;4;0;4
292;06.02.2016;2016;02;00;Lauantai;0;2;2;1;1;2
292;06.02.2016;2016;02;01;Lauantai;0;0;0;0;1;1
292;06.02.2016;2016;02;02;Lauantai;0;0;0;2;0;2
292;06.02.2016;2016;02;03;Lauantai;0;0;0;1;0;1
292;06.02.2016;2016;02;04;Lauantai;0;0;0;0;0;0
292;06.02.2016;2016;02;05;Lauantai;2;1;3;2;2;4
292;06.02.2016;2016;02;06;Lauantai;5;0;5;1;2;3
292;06.02.2016;2016;02;07;Lauantai;1;4;5;2;2;4
292;06.02.2016;2016;02;08;Lauantai;4;3;7;1;1;2
292;06.02.2016;2016;02;09;Lauantai;6;10;16;5;8;13
292;06.02.2016;2016;02;10;Lauantai;13;8;21;11;6;17
292;06.02.2016;2016;02;11;Lauantai;11;17;28;8;8;16
292;06.02.2016;2016;02;12;Lauantai;16;11;27;11;12;23
292;06.02.2016;2016;02;13;Lauantai;13;13;26;17;7;24
292;06.02.2016;2016;02;14;Lauantai;24;10;34;13;9;22
292;06.02.2016;2016;02;15;Lauantai;6;7;13;21;13;34
292;06.02.2016;2016;02;16;Lauantai;11;14;25;15;3;18
292;06.02.2016;2016;02;17;Lauantai;16;10;26;8;4;12
292;06.02.2016;2016;02;18;Lauantai;4;2;6;11;4;15
292;06.02.2016;2016;02;19;Lauantai;3;3;6;0;3;3
292;06.02.2016;2016;02;20;Lauantai;3;1;4;3;1;4
292;06.02.2016;2016;02;21;Lauantai;4;1;5;3;1;4
292;06.02.2016;2016;02;22;Lauantai;1;2;3;1;1;2
292;06.02.2016;2016;02;23;Lauantai;1;0;1;5;0;5
292;07.02.2016;2016;02;00;Sunnuntai;0;0;0;3;3;6
292;07.02.2016;2016;02;01;Sunnuntai;1;0;1;1;0;1
292;07.02.2016;2016;02;02;Sunnuntai;0;0;0;0;3;3
292;07.02.2016;2016;02;03;Sunnuntai;0;0;0;0;7;7
292;07.02.2016;2016;02;04;Sunnuntai;0;0;0;0;0;0
292;07.02.2016;2016;02;05;Sunnuntai;1;0;1;0;0;0
292;07.02.2016;2016;02;06;Sunnuntai;3;0;3;9;2;11
292;07.02.2016;2016;02;07;Sunnuntai;0;1;1;0;0;0
292;07.02.2016;2016;02;08;Sunnuntai;0;1;1;4;0;4
292;07.02.2016;2016;02;09;Sunnuntai;6;1;7;7;5;12
292;07.02.2016;2016;02;10;Sunnuntai;1;2;3;4;2;6
292;07.02.2016;2016;02;11;Sunnuntai;11;13;24;12;9;21
292;07.02.2016;2016;02;12;Sunnuntai;15;9;24;17;9;26
292;07.02.2016;2016;02;13;Sunnuntai;9;9;18;12;11;23
292;07.02.2016;2016;02;14;Sunnuntai;12;12;24;5;8;13
292;07.02.2016;2016;02;15;Sunnuntai;6;11;17;11;3;14
292;07.02.2016;2016;02;16;Sunnuntai;11;7;18;7;6;13
292;07.02.2016;2016;02;17;Sunnuntai;5;4;9;10;3;13
292;07.02.2016;2016;02;18;Sunnuntai;7;6;13;4;3;7
292;07.02.2016;2016;02;19;Sunnuntai;4;4;8;4;4;8
292;07.02.2016;2016;02;20;Sunnuntai;2;2;4;4;0;4
292;07.02.2016;2016;02;21;Sunnuntai;5;5;10;1;3;4
292;07.02.2016;2016;02;22;Sunnuntai;1;5;6;1;0;1
292;07.02.2016;2016;02;23;Sunnuntai;1;0;1;0;0;0
292;08.02.2016;2016;02;00;Maanantai;0;0;0;0;0;0
292;08.02.2016;2016;02;01;Maanantai;0;0;0;0;0;0
292;08.02.2016;2016;02;02;Maanantai;0;0;0;0;0;0
292;08.02.2016;2016;02;03;Maanantai;0;0;0;0;0;0
292;08.02.2016;2016;02;04;Maanantai;0;3;3;4;0;4
292;08.02.2016;2016;02;05;Maanantai;4;1;5;3;0;3
292;08.02.2016;2016;02;06;Maanantai;11;7;18;5;3;8
292;08.02.2016;2016;02;07;Maanantai;45;12;57;22;16;38
292;08.02.2016;2016;02;08;Maanantai;31;7;38;14;8;22
292;08.02.2016;2016;02;09;Maanantai;5;6;11;7;14;21
292;08.02.2016;2016;02;10;Maanantai;4;17;21;11;5;16
292;08.02.2016;2016;02;11;Maanantai;7;18;25;11;17;28
292;08.02.2016;2016;02;12;Maanantai;7;12;19;10;11;21
292;08.02.2016;2016;02;13;Maanantai;5;20;25;18;13;31
292;08.02.2016;2016;02;14;Maanantai;8;16;24;15;15;30
292;08.02.2016;2016;02;15;Maanantai;10;10;20;15;15;30
292;08.02.2016;2016;02;16;Maanantai;5;18;23;7;17;24
292;08.02.2016;2016;02;17;Maanantai;15;7;22;16;6;22
292;08.02.2016;2016;02;18;Maanantai;10;9;19;12;13;25
292;08.02.2016;2016;02;19;Maanantai;7;8;15;12;15;27
292;08.02.2016;2016;02;20;Maanantai;8;6;14;11;12;23
292;08.02.2016;2016;02;21;Maanantai;7;10;17;3;4;7
292;08.02.2016;2016;02;22;Maanantai;2;0;2;2;2;4
292;08.02.2016;2016;02;23;Maanantai;0;0;0;1;1;2
292;09.02.2016;2016;02;00;Tiistai;0;0;0;3;0;3
292;09.02.2016;2016;02;01;Tiistai;0;0;0;0;2;2
292;09.02.2016;2016;02;02;Tiistai;0;0;0;0;0;0
292;09.02.2016;2016;02;03;Tiistai;0;0;0;0;0;0
292;09.02.2016;2016;02;04;Tiistai;2;0;2;2;0;2
292;09.02.2016;2016;02;05;Tiistai;4;3;7;4;1;5
292;09.02.2016;2016;02;06;Tiistai;7;7;14;6;2;8
292;09.02.2016;2016;02;07;Tiistai;33;11;44;12;10;22
292;09.02.2016;2016;02;08;Tiistai;29;8;37;19;14;33
292;09.02.2016;2016;02;09;Tiistai;4;7;11;9;8;17
292;09.02.2016;2016;02;10;Tiistai;12;11;23;13;14;27
292;09.02.2016;2016;02;11;Tiistai;2;7;9;8;8;16
292;09.02.2016;2016;02;12;Tiistai;5;12;17;6;11;17
292;09.02.2016;2016;02;13;Tiistai;6;19;25;14;10;24
292;09.02.2016;2016;02;14;Tiistai;7;21;28;16;11;27
292;09.02.2016;2016;02;15;Tiistai;15;18;33;6;14;20
292;09.02.2016;2016;02;16;Tiistai;15;11;26;12;17;29
292;09.02.2016;2016;02;17;Tiistai;3;7;10;11;4;15
292;09.02.2016;2016;02;18;Tiistai;5;3;8;10;7;17
292;09.02.2016;2016;02;19;Tiistai;4;4;8;7;3;10
292;09.02.2016;2016;02;20;Tiistai;7;3;10;3;1;4
292;09.02.2016;2016;02;21;Tiistai;3;1;4;1;6;7
292;09.02.2016;2016;02;22;Tiistai;1;5;6;0;1;1
292;09.02.2016;2016;02;23;Tiistai;0;0;0;0;0;0
292;10.02.2016;2016;02;00;Keskiviikko;0;0;0;0;0;0
292;10.02.2016;2016;02;01;Keskiviikko;0;0;0;0;0;0
292;10.02.2016;2016;02;02;Keskiviikko;0;0;0;0;0;0
292;10.02.2016;2016;02;03;Keskiviikko;0;0;0;0;0;0
292;10.02.2016;2016;02;04;Keskiviikko;0;0;0;2;0;2
292;10.02.2016;2016;02;05;Keskiviikko;8;3;11;3;0;3
292;10.02.2016;2016;02;06;Keskiviikko;7;6;13;6;5;11
292;10.02.2016;2016;02;07;Keskiviikko;43;14;57;24;10;34
292;10.02.2016;2016;02;08;Keskiviikko;31;9;40;14;13;27
292;10.02.2016;2016;02;09;Keskiviikko;3;4;7;10;13;23
292;10.02.2016;2016;02;10;Keskiviikko;4;13;17;8;6;14
292;10.02.2016;2016;02;11;Keskiviikko;12;12;24;14;11;25
292;10.02.2016;2016;02;12;Keskiviikko;10;12;22;12;10;22
292;10.02.2016;2016;02;13;Keskiviikko;21;50;71;10;21;31
292;10.02.2016;2016;02;14;Keskiviikko;18;24;42;16;12;28
292;10.02.2016;2016;02;15;Keskiviikko;24;24;48;14;15;29
292;10.02.2016;2016;02;16;Keskiviikko;21;21;42;7;16;23
292;10.02.2016;2016;02;17;Keskiviikko;12;21;33;13;14;27
292;10.02.2016;2016;02;18;Keskiviikko;16;8;24;12;5;17
292;10.02.2016;2016;02;19;Keskiviikko;10;2;12;9;4;13
292;10.02.2016;2016;02;20;Keskiviikko;5;4;9;10;10;20
292;10.02.2016;2016;02;21;Keskiviikko;3;8;11;4;1;5
292;10.02.2016;2016;02;22;Keskiviikko;1;7;8;4;3;7
292;10.02.2016;2016;02;23;Keskiviikko;0;0;0;0;0;0
292;11.02.2016;2016;02;00;Torstai;0;0;0;0;0;0
292;11.02.2016;2016;02;01;Torstai;0;0;0;0;0;0
292;11.02.2016;2016;02;02;Torstai;0;0;0;0;0;0
292;11.02.2016;2016;02;03;Torstai;0;0;0;1;0;1
292;11.02.2016;2016;02;04;Torstai;1;0;1;1;0;1
292;11.02.2016;2016;02;05;Torstai;5;3;8;2;1;3
292;11.02.2016;2016;02;06;Torstai;8;7;15;5;7;12
292;11.02.2016;2016;02;07;Torstai;23;13;36;25;9;34
292;11.02.2016;2016;02;08;Torstai;17;8;25;16;14;30
292;11.02.2016;2016;02;09;Torstai;28;19;47;20;6;26
292;11.02.2016;2016;02;10;Torstai;6;5;11;13;10;23
292;11.02.2016;2016;02;11;Torstai;14;7;21;19;12;31
292;11.02.2016;2016;02;12;Torstai;8;20;28;9;13;22
292;11.02.2016;2016;02;13;Torstai;6;24;30;24;11;35
292;11.02.2016;2016;02;14;Torstai;15;17;32;13;17;30
292;11.02.2016;2016;02;15;Torstai;18;29;47;13;21;34
292;11.02.2016;2016;02;16;Torstai;15;29;44;13;23;36
292;11.02.2016;2016;02;17;Torstai;12;10;22;6;15;21
292;11.02.2016;2016;02;18;Torstai;9;12;21;9;13;22
292;11.02.2016;2016;02;19;Torstai;6;6;12;8;6;14
292;11.02.2016;2016;02;20;Torstai;6;2;8;7;10;17
292;11.02.2016;2016;02;21;Torstai;5;3;8;2;2;4
292;11.02.2016;2016;02;22;Torstai;2;2;4;1;0;1
292;11.02.2016;2016;02;23;Torstai;0;1;1;0;0;0
292;12.02.2016;2016;02;00;Perjantai;0;0;0;1;0;1
292;12.02.2016;2016;02;01;Perjantai;0;0;0;0;1;1
292;12.02.2016;2016;02;02;Perjantai;0;0;0;0;1;1
292;12.02.2016;2016;02;03;Perjantai;0;0;0;0;0;0
292;12.02.2016;2016;02;04;Perjantai;2;0;2;0;0;0
292;12.02.2016;2016;02;05;Perjantai;6;4;10;1;1;2
292;12.02.2016;2016;02;06;Perjantai;13;4;17;5;2;7
292;12.02.2016;2016;02;07;Perjantai;29;10;39;19;8;27
292;12.02.2016;2016;02;08;Perjantai;41;6;47;24;10;34
292;12.02.2016;2016;02;09;Perjantai;14;7;21;10;6;16
292;12.02.2016;2016;02;10;Perjantai;9;3;12;5;3;8
292;12.02.2016;2016;02;11;Perjantai;6;10;16;9;8;17
292;12.02.2016;2016;02;12;Perjantai;8;8;16;16;8;24
292;12.02.2016;2016;02;13;Perjantai;9;41;50;13;15;28
292;12.02.2016;2016;02;14;Perjantai;11;24;35;11;14;25
292;12.02.2016;2016;02;15;Perjantai;9;13;22;5;15;20
292;12.02.2016;2016;02;16;Perjantai;7;10;17;14;7;21
292;12.02.2016;2016;02;17;Perjantai;7;3;10;10;6;16
292;12.02.2016;2016;02;18;Perjantai;3;3;6;8;7;15
292;12.02.2016;2016;02;19;Perjantai;4;2;6;12;5;17
292;12.02.2016;2016;02;20;Perjantai;2;3;5;9;6;15
292;12.02.2016;2016;02;21;Perjantai;4;6;10;7;6;13
292;12.02.2016;2016;02;22;Perjantai;0;1;1;6;1;7
292;12.02.2016;2016;02;23;Perjantai;1;2;3;3;0;3
292;13.02.2016;2016;02;00;Lauantai;1;0;1;5;0;5
292;13.02.2016;2016;02;01;Lauantai;0;1;1;2;1;3
292;13.02.2016;2016;02;02;Lauantai;0;2;2;0;2;2
292;13.02.2016;2016;02;03;Lauantai;0;0;0;0;3;3
292;13.02.2016;2016;02;04;Lauantai;1;0;1;0;1;1
292;13.02.2016;2016;02;05;Lauantai;0;1;1;2;0;2
292;13.02.2016;2016;02;06;Lauantai;4;0;4;1;1;2
292;13.02.2016;2016;02;07;Lauantai;2;0;2;1;6;7
292;13.02.2016;2016;02;08;Lauantai;3;1;4;1;2;3
292;13.02.2016;2016;02;09;Lauantai;2;2;4;6;6;12
292;13.02.2016;2016;02;10;Lauantai;4;3;7;11;11;22
292;13.02.2016;2016;02;11;Lauantai;5;10;15;17;13;30
292;13.02.2016;2016;02;12;Lauantai;14;11;25;11;5;16
292;13.02.2016;2016;02;13;Lauantai;7;6;13;13;13;26
292;13.02.2016;2016;02;14;Lauantai;13;7;20;9;12;21
292;13.02.2016;2016;02;15;Lauantai;12;10;22;14;16;30
292;13.02.2016;2016;02;16;Lauantai;6;9;15;10;6;16
292;13.02.2016;2016;02;17;Lauantai;8;7;15;15;3;18
292;13.02.2016;2016;02;18;Lauantai;4;8;12;15;12;27
292;13.02.2016;2016;02;19;Lauantai;4;2;6;11;9;20
292;13.02.2016;2016;02;20;Lauantai;4;9;13;1;4;5
292;13.02.2016;2016;02;21;Lauantai;3;6;9;5;4;9
292;13.02.2016;2016;02;22;Lauantai;2;2;4;2;4;6
292;13.02.2016;2016;02;23;Lauantai;3;2;5;3;0;3
292;14.02.2016;2016;02;00;Sunnuntai;0;2;2;2;1;3
292;14.02.2016;2016;02;01;Sunnuntai;2;0;2;4;4;8
292;14.02.2016;2016;02;02;Sunnuntai;0;1;1;1;1;2
292;14.02.2016;2016;02;03;Sunnuntai;0;1;1;3;5;8
292;14.02.2016;2016;02;04;Sunnuntai;0;0;0;0;0;0
292;14.02.2016;2016;02;05;Sunnuntai;1;0;1;2;0;2
292;14.02.2016;2016;02;06;Sunnuntai;2;0;2;3;0;3
292;14.02.2016;2016;02;07;Sunnuntai;0;1;1;4;2;6
292;14.02.2016;2016;02;08;Sunnuntai;1;0;1;0;4;4
292;14.02.2016;2016;02;09;Sunnuntai;4;3;7;8;5;13
292;14.02.2016;2016;02;10;Sunnuntai;2;2;4;7;8;15
292;14.02.2016;2016;02;11;Sunnuntai;10;8;18;15;13;28
292;14.02.2016;2016;02;12;Sunnuntai;6;10;16;20;10;30
292;14.02.2016;2016;02;13;Sunnuntai;8;12;20;7;15;22
292;14.02.2016;2016;02;14;Sunnuntai;17;11;28;22;8;30
292;14.02.2016;2016;02;15;Sunnuntai;12;7;19;9;10;19
292;14.02.2016;2016;02;16;Sunnuntai;3;11;14;12;10;22
292;14.02.2016;2016;02;17;Sunnuntai;12;6;18;7;7;14
292;14.02.2016;2016;02;18;Sunnuntai;8;2;10;11;7;18
292;14.02.2016;2016;02;19;Sunnuntai;7;1;8;5;7;12
292;14.02.2016;2016;02;20;Sunnuntai;6;2;8;9;7;16
292;14.02.2016;2016;02;21;Sunnuntai;2;1;3;2;6;8
292;14.02.2016;2016;02;22;Sunnuntai;2;0;2;1;1;2
292;14.02.2016;2016;02;23;Sunnuntai;0;0;0;0;1;1
292;15.02.2016;2016;02;00;Maanantai;0;0;0;0;0;0
292;15.02.2016;2016;02;01;Maanantai;0;0;0;0;0;0
292;15.02.2016;2016;02;02;Maanantai;1;2;3;0;0;0
292;15.02.2016;2016;02;03;Maanantai;0;0;0;0;0;0
292;15.02.2016;2016;02;04;Maanantai;3;0;3;1;1;2
292;15.02.2016;2016;02;05;Maanantai;5;2;7;2;2;4
292;15.02.2016;2016;02;06;Maanantai;11;6;17;4;7;11
292;15.02.2016;2016;02;07;Maanantai;33;8;41;30;12;42
292;15.02.2016;2016;02;08;Maanantai;28;9;37;24;10;34
292;15.02.2016;2016;02;09;Maanantai;20;17;37;14;14;28
292;15.02.2016;2016;02;10;Maanantai;11;9;20;10;9;19
292;15.02.2016;2016;02;11;Maanantai;11;9;20;10;14;24
292;15.02.2016;2016;02;12;Maanantai;17;15;32;6;7;13
292;15.02.2016;2016;02;13;Maanantai;15;33;48;20;17;37
292;15.02.2016;2016;02;14;Maanantai;19;38;57;20;16;36
292;15.02.2016;2016;02;15;Maanantai;18;27;45;12;17;29
292;15.02.2016;2016;02;16;Maanantai;16;32;48;11;27;38
292;15.02.2016;2016;02;17;Maanantai;8;7;15;15;15;30
292;15.02.2016;2016;02;18;Maanantai;7;10;17;14;15;29
292;15.02.2016;2016;02;19;Maanantai;6;8;14;14;6;20
292;15.02.2016;2016;02;20;Maanantai;5;5;10;12;12;24
292;15.02.2016;2016;02;21;Maanantai;3;7;10;5;4;9
292;15.02.2016;2016;02;22;Maanantai;1;2;3;1;0;1
292;15.02.2016;2016;02;23;Maanantai;1;1;2;0;0;0
292;16.02.2016;2016;02;00;Tiistai;0;0;0;1;0;1
292;16.02.2016;2016;02;01;Tiistai;1;0;1;0;0;0
292;16.02.2016;2016;02;02;Tiistai;0;0;0;0;1;1
292;16.02.2016;2016;02;03;Tiistai;0;0;0;1;1;2
292;16.02.2016;2016;02;04;Tiistai;3;0;3;0;0;0
292;16.02.2016;2016;02;05;Tiistai;4;2;6;3;4;7
292;16.02.2016;2016;02;06;Tiistai;8;3;11;3;9;12
292;16.02.2016;2016;02;07;Tiistai;37;17;54;24;14;38
292;16.02.2016;2016;02;08;Tiistai;31;8;39;25;19;44
292;16.02.2016;2016;02;09;Tiistai;10;7;17;10;11;21
292;16.02.2016;2016;02;10;Tiistai;12;5;17;12;7;19
292;16.02.2016;2016;02;11;Tiistai;7;9;16;15;17;32
292;16.02.2016;2016;02;12;Tiistai;6;10;16;21;20;41
292;16.02.2016;2016;02;13;Tiistai;9;19;28;21;30;51
292;16.02.2016;2016;02;14;Tiistai;17;40;57;21;29;50
292;16.02.2016;2016;02;15;Tiistai;14;24;38;22;26;48
292;16.02.2016;2016;02;16;Tiistai;16;26;42;10;17;27
292;16.02.2016;2016;02;17;Tiistai;11;9;20;19;14;33
292;16.02.2016;2016;02;18;Tiistai;6;5;11;15;15;30
292;16.02.2016;2016;02;19;Tiistai;5;6;11;13;8;21
292;16.02.2016;2016;02;20;Tiistai;13;6;19;5;5;10
292;16.02.2016;2016;02;21;Tiistai;1;3;4;0;4;4
292;16.02.2016;2016;02;22;Tiistai;1;4;5;3;1;4
292;16.02.2016;2016;02;23;Tiistai;0;0;0;0;0;0
292;17.02.2016;2016;02;00;Keskiviikko;0;0;0;0;1;1
292;17.02.2016;2016;02;01;Keskiviikko;0;0;0;1;0;1
292;17.02.2016;2016;02;02;Keskiviikko;0;0;0;0;0;0
292;17.02.2016;2016;02;03;Keskiviikko;0;0;0;0;0;0
292;17.02.2016;2016;02;04;Keskiviikko;3;0;3;1;0;1
292;17.02.2016;2016;02;05;Keskiviikko;8;4;12;2;2;4
292;17.02.2016;2016;02;06;Keskiviikko;10;8;18;8;5;13
292;17.02.2016;2016;02;07;Keskiviikko;50;12;62;29;13;42
292;17.02.2016;2016;02;08;Keskiviikko;32;14;46;15;15;30
292;17.02.2016;2016;02;09;Keskiviikko;21;13;34;10;10;20
292;17.02.2016;2016;02;10;Keskiviikko;11;4;15;9;7;16
292;17.02.2016;2016;02;11;Keskiviikko;16;9;25;13;15;28
292;17.02.2016;2016;02;12;Keskiviikko;15;18;33;11;6;17
292;17.02.2016;2016;02;13;Keskiviikko;20;38;58;13;22;35
292;17.02.2016;2016;02;14;Keskiviikko;17;32;49;17;27;44
292;17.02.2016;2016;02;15;Keskiviikko;14;28;42;20;21;41
292;17.02.2016;2016;02;16;Keskiviikko;20;26;46;13;17;30
292;17.02.2016;2016;02;17;Keskiviikko;16;8;24;15;12;27
292;17.02.2016;2016;02;18;Keskiviikko;8;10;18;18;23;41
292;17.02.2016;2016;02;19;Keskiviikko;2;7;9;12;10;22
292;17.02.2016;2016;02;20;Keskiviikko;11;8;19;7;1;8
292;17.02.2016;2016;02;21;Keskiviikko;5;9;14;3;3;6
292;17.02.2016;2016;02;22;Keskiviikko;1;3;4;2;3;5
292;17.02.2016;2016;02;23;Keskiviikko;0;1;1;0;2;2
292;18.02.2016;2016;02;00;Torstai;0;0;0;1;0;1
292;18.02.2016;2016;02;01;Torstai;0;0;0;0;0;0
292;18.02.2016;2016;02;02;Torstai;0;0;0;0;0;0
292;18.02.2016;2016;02;03;Torstai;0;0;0;2;0;2
292;18.02.2016;2016;02;04;Torstai;2;0;2;0;1;1
292;18.02.2016;2016;02;05;Torstai;6;6;12;0;0;0
292;18.02.2016;2016;02;06;Torstai;12;10;22;4;5;9
292;18.02.2016;2016;02;07;Torstai;40;18;58;22;14;36
292;18.02.2016;2016;02;08;Torstai;21;11;32;12;16;28
292;18.02.2016;2016;02;09;Torstai;40;10;50;23;15;38
292;18.02.2016;2016;02;10;Torstai;7;7;14;12;8;20
292;18.02.2016;2016;02;11;Torstai;9;6;15;6;11;17
292;18.02.2016;2016;02;12;Torstai;14;16;30;8;11;19
292;18.02.2016;2016;02;13;Torstai;17;31;48;18;17;35
292;18.02.2016;2016;02;14;Torstai;16;18;34;21;18;39
292;18.02.2016;2016;02;15;Torstai;18;39;57;21;33;54
292;18.02.2016;2016;02;16;Torstai;25;30;55;10;30;40
292;18.02.2016;2016;02;17;Torstai;10;11;21;16;10;26
292;18.02.2016;2016;02;18;Torstai;9;14;23;9;14;23
292;18.02.2016;2016;02;19;Torstai;8;4;12;10;12;22
292;18.02.2016;2016;02;20;Torstai;8;11;19;13;8;21
292;18.02.2016;2016;02;21;Torstai;7;2;9;4;8;12
292;18.02.2016;2016;02;22;Torstai;2;7;9;2;2;4
292;18.02.2016;2016;02;23;Torstai;1;0;1;0;0;0
292;19.02.2016;2016;02;00;Perjantai;0;1;1;0;0;0
292;19.02.2016;2016;02;01;Perjantai;1;1;2;0;0;0
292;19.02.2016;2016;02;02;Perjantai;0;0;0;0;0;0
292;19.02.2016;2016;02;03;Perjantai;0;0;0;0;0;0
292;19.02.2016;2016;02;04;Perjantai;0;0;0;0;1;1
292;19.02.2016;2016;02;05;Perjantai;7;2;9;0;3;3
292;19.02.2016;2016;02;06;Perjantai;8;2;10;3;6;9
292;19.02.2016;2016;02;07;Perjantai;31;8;39;22;12;34
292;19.02.2016;2016;02;08;Perjantai;32;9;41;11;21;32
292;19.02.2016;2016;02;09;Perjantai;18;9;27;14;10;24
292;19.02.2016;2016;02;10;Perjantai;15;11;26;11;13;24
292;19.02.2016;2016;02;11;Perjantai;8;9;17;12;11;23
292;19.02.2016;2016;02;12;Perjantai;18;11;29;24;21;45
292;19.02.2016;2016;02;13;Perjantai;11;36;47;14;21;35
292;19.02.2016;2016;02;14;Perjantai;14;28;42;18;21;39
292;19.02.2016;2016;02;15;Perjantai;7;18;25;16;15;31
292;19.02.2016;2016;02;16;Perjantai;11;14;25;12;22;34
292;19.02.2016;2016;02;17;Perjantai;11;16;27;11;15;26
292;19.02.2016;2016;02;18;Perjantai;11;4;15;14;9;23
292;19.02.2016;2016;02;19;Perjantai;12;8;20;14;9;23
292;19.02.2016;2016;02;20;Perjantai;7;1;8;5;3;8
292;19.02.2016;2016;02;21;Perjantai;3;3;6;3;3;6
292;19.02.2016;2016;02;22;Perjantai;3;7;10;5;2;7
292;19.02.2016;2016;02;23;Perjantai;3;3;6;2;2;4
292;20.02.2016;2016;02;00;Lauantai;3;1;4;3;0;3
292;20.02.2016;2016;02;01;Lauantai;0;2;2;4;2;6
292;20.02.2016;2016;02;02;Lauantai;0;0;0;2;7;9
292;20.02.2016;2016;02;03;Lauantai;2;0;2;2;4;6
292;20.02.2016;2016;02;04;Lauantai;0;0;0;0;0;0
292;20.02.2016;2016;02;05;Lauantai;0;1;1;2;1;3
292;20.02.2016;2016;02;06;Lauantai;2;2;4;0;3;3
292;20.02.2016;2016;02;07;Lauantai;2;1;3;1;4;5
292;20.02.2016;2016;02;08;Lauantai;4;2;6;2;7;9
292;20.02.2016;2016;02;09;Lauantai;1;6;7;4;5;9
292;20.02.2016;2016;02;10;Lauantai;5;8;13;13;8;21
292;20.02.2016;2016;02;11;Lauantai;12;14;26;14;13;27
292;20.02.2016;2016;02;12;Lauantai;10;14;24;17;14;31
292;20.02.2016;2016;02;13;Lauantai;20;15;35;18;12;30
292;20.02.2016;2016;02;14;Lauantai;16;9;25;13;16;29
292;20.02.2016;2016;02;15;Lauantai;12;12;24;14;8;22
292;20.02.2016;2016;02;16;Lauantai;6;5;11;17;7;24
292;20.02.2016;2016;02;17;Lauantai;14;5;19;13;5;18
292;20.02.2016;2016;02;18;Lauantai;6;8;14;17;10;27
292;20.02.2016;2016;02;19;Lauantai;2;7;9;4;7;11
292;20.02.2016;2016;02;20;Lauantai;3;7;10;9;6;15
292;20.02.2016;2016;02;21;Lauantai;3;4;7;0;3;3
292;20.02.2016;2016;02;22;Lauantai;2;1;3;4;0;4
292;20.02.2016;2016;02;23;Lauantai;2;1;3;3;0;3
292;21.02.2016;2016;02;00;Sunnuntai;1;3;4;5;1;6
292;21.02.2016;2016;02;01;Sunnuntai;3;0;3;2;2;4
292;21.02.2016;2016;02;02;Sunnuntai;0;1;1;0;4;4
292;21.02.2016;2016;02;03;Sunnuntai;1;3;4;0;1;1
292;21.02.2016;2016;02;04;Sunnuntai;2;3;5;10;12;22
292;21.02.2016;2016;02;05;Sunnuntai;0;0;0;2;1;3
292;21.02.2016;2016;02;06;Sunnuntai;2;0;2;3;2;5
292;21.02.2016;2016;02;07;Sunnuntai;1;2;3;1;2;3
292;21.02.2016;2016;02;08;Sunnuntai;1;2;3;5;4;9
292;21.02.2016;2016;02;09;Sunnuntai;3;0;3;7;2;9
292;21.02.2016;2016;02;10;Sunnuntai;0;2;2;6;4;10
292;21.02.2016;2016;02;11;Sunnuntai;9;2;11;17;10;27
292;21.02.2016;2016;02;12;Sunnuntai;4;3;7;11;8;19
292;21.02.2016;2016;02;13;Sunnuntai;5;2;7;9;10;19
292;21.02.2016;2016;02;14;Sunnuntai;11;11;22;12;12;24
292;21.02.2016;2016;02;15;Sunnuntai;8;4;12;11;5;16
292;21.02.2016;2016;02;16;Sunnuntai;11;9;20;11;13;24
292;21.02.2016;2016;02;17;Sunnuntai;5;10;15;14;14;28
292;21.02.2016;2016;02;18;Sunnuntai;6;5;11;16;18;34
292;21.02.2016;2016;02;19;Sunnuntai;5;4;9;8;15;23
292;21.02.2016;2016;02;20;Sunnuntai;4;4;8;12;5;17
292;21.02.2016;2016;02;21;Sunnuntai;2;6;8;2;7;9
292;21.02.2016;2016;02;22;Sunnuntai;0;2;2;0;1;1
292;21.02.2016;2016;02;23;Sunnuntai;0;0;0;0;0;0
292;22.02.2016;2016;02;00;Maanantai;1;0;1;0;1;1
292;22.02.2016;2016;02;01;Maanantai;0;1;1;0;0;0
292;22.02.2016;2016;02;02;Maanantai;0;0;0;0;0;0
292;22.02.2016;2016;02;03;Maanantai;0;0;0;0;0;0
292;22.02.2016;2016;02;04;Maanantai;2;0;2;1;0;1
292;22.02.2016;2016;02;05;Maanantai;5;5;10;2;2;4
292;22.02.2016;2016;02;06;Maanantai;11;4;15;8;4;12
292;22.02.2016;2016;02;07;Maanantai;43;14;57;23;19;42
292;22.02.2016;2016;02;08;Maanantai;35;12;47;18;17;35
292;22.02.2016;2016;02;09;Maanantai;32;14;46;13;10;23
292;22.02.2016;2016;02;10;Maanantai;12;4;16;13;7;20
292;22.02.2016;2016;02;11;Maanantai;11;12;23;22;8;30
292;22.02.2016;2016;02;12;Maanantai;7;12;19;15;24;39
292;22.02.2016;2016;02;13;Maanantai;9;31;40;14;24;38
292;22.02.2016;2016;02;14;Maanantai;13;24;37;21;25;46
292;22.02.2016;2016;02;15;Maanantai;28;28;56;25;17;42
292;22.02.2016;2016;02;16;Maanantai;23;31;54;9;31;40
292;22.02.2016;2016;02;17;Maanantai;14;7;21;16;3;19
292;22.02.2016;2016;02;18;Maanantai;14;11;25;16;23;39
292;22.02.2016;2016;02;19;Maanantai;12;4;16;14;13;27
292;22.02.2016;2016;02;20;Maanantai;6;8;14;6;5;11
292;22.02.2016;2016;02;21;Maanantai;2;7;9;3;11;14
292;22.02.2016;2016;02;22;Maanantai;0;1;1;0;1;1
292;22.02.2016;2016;02;23;Maanantai;0;1;1;0;0;0
292;23.02.2016;2016;02;00;Tiistai;0;0;0;0;0;0
292;23.02.2016;2016;02;01;Tiistai;1;0;1;0;0;0
292;23.02.2016;2016;02;02;Tiistai;0;0;0;0;0;0
292;23.02.2016;2016;02;03;Tiistai;0;0;0;1;0;1
292;23.02.2016;2016;02;04;Tiistai;3;3;6;2;1;3
292;23.02.2016;2016;02;05;Tiistai;6;4;10;3;3;6
292;23.02.2016;2016;02;06;Tiistai;9;9;18;5;9;14
292;23.02.2016;2016;02;07;Tiistai;39;17;56;15;14;29
292;23.02.2016;2016;02;08;Tiistai;48;10;58;16;24;40
292;23.02.2016;2016;02;09;Tiistai;12;7;19;19;11;30
292;23.02.2016;2016;02;10;Tiistai;12;4;16;11;15;26
292;23.02.2016;2016;02;11;Tiistai;9;7;16;13;13;26
292;23.02.2016;2016;02;12;Tiistai;16;12;28;10;23;33
292;23.02.2016;2016;02;13;Tiistai;9;20;29;15;13;28
292;23.02.2016;2016;02;14;Tiistai;21;38;59;24;16;40
292;23.02.2016;2016;02;15;Tiistai;24;36;60;17;25;42
292;23.02.2016;2016;02;16;Tiistai;17;23;40;22;23;45
292;23.02.2016;2016;02;17;Tiistai;13;13;26;9;13;22
292;23.02.2016;2016;02;18;Tiistai;8;16;24;14;10;24
292;23.02.2016;2016;02;19;Tiistai;14;3;17;14;6;20
292;23.02.2016;2016;02;20;Tiistai;11;8;19;7;9;16
292;23.02.2016;2016;02;21;Tiistai;2;5;7;2;3;5
292;23.02.2016;2016;02;22;Tiistai;0;4;4;1;0;1
292;23.02.2016;2016;02;23;Tiistai;0;1;1;2;0;2
292;24.02.2016;2016;02;00;Keskiviikko;0;0;0;0;0;0
292;24.02.2016;2016;02;01;Keskiviikko;0;0;0;0;0;0
292;24.02.2016;2016;02;02;Keskiviikko;0;0;0;1;0;1
292;24.02.2016;2016;02;03;Keskiviikko;2;0;2;1;0;1
292;24.02.2016;2016;02;04;Keskiviikko;3;0;3;0;1;1
292;24.02.2016;2016;02;05;Keskiviikko;6;6;12;3;1;4
292;24.02.2016;2016;02;06;Keskiviikko;10;9;19;3;7;10
292;24.02.2016;2016;02;07;Keskiviikko;42;20;62;25;12;37
292;24.02.2016;2016;02;08;Keskiviikko;36;11;47;20;14;34
292;24.02.2016;2016;02;09;Keskiviikko;18;9;27;11;19;30
292;24.02.2016;2016;02;10;Keskiviikko;12;10;22;14;7;21
292;24.02.2016;2016;02;11;Keskiviikko;12;6;18;14;14;28
292;24.02.2016;2016;02;12;Keskiviikko;11;14;25;15;12;27
292;24.02.2016;2016;02;13;Keskiviikko;18;31;49;30;18;48
292;24.02.2016;2016;02;14;Keskiviikko;18;62;80;16;20;36
292;24.02.2016;2016;02;15;Keskiviikko;20;29;49;14;20;34
292;24.02.2016;2016;02;16;Keskiviikko;28;29;57;26;11;37
292;24.02.2016;2016;02;17;Keskiviikko;18;14;32;9;17;26
292;24.02.2016;2016;02;18;Keskiviikko;6;11;17;10;12;22
292;24.02.2016;2016;02;19;Keskiviikko;8;17;25;8;12;20
292;24.02.2016;2016;02;20;Keskiviikko;8;4;12;6;7;13
292;24.02.2016;2016;02;21;Keskiviikko;2;7;9;2;4;6
292;24.02.2016;2016;02;22;Keskiviikko;5;4;9;2;4;6
292;24.02.2016;2016;02;23;Keskiviikko;0;0;0;0;0;0
292;25.02.2016;2016;02;00;Torstai;0;0;0;0;0;0
292;25.02.2016;2016;02;01;Torstai;0;0;0;0;0;0
292;25.02.2016;2016;02;02;Torstai;0;0;0;0;0;0
292;25.02.2016;2016;02;03;Torstai;1;0;1;1;0;1
292;25.02.2016;2016;02;04;Torstai;2;0;2;0;1;1
292;25.02.2016;2016;02;05;Torstai;8;3;11;4;1;5
292;25.02.2016;2016;02;06;Torstai;7;6;13;5;6;11
292;25.02.2016;2016;02;07;Torstai;37;18;55;15;17;32
292;25.02.2016;2016;02;08;Torstai;23;14;37;15;17;32
292;25.02.2016;2016;02;09;Torstai;35;8;43;19;12;31
292;25.02.2016;2016;02;10;Torstai;12;5;17;10;8;18
292;25.02.2016;2016;02;11;Torstai;14;7;21;11;4;15
292;25.02.2016;2016;02;12;Torstai;11;14;25;9;15;24
292;25.02.2016;2016;02;13;Torstai;10;27;37;30;18;48
292;25.02.2016;2016;02;14;Torstai;20;28;48;15;18;33
292;25.02.2016;2016;02;15;Torstai;21;40;61;20;10;30
292;25.02.2016;2016;02;16;Torstai;18;35;53;8;32;40
292;25.02.2016;2016;02;17;Torstai;11;7;18;11;15;26
292;25.02.2016;2016;02;18;Torstai;10;10;20;16;9;25
292;25.02.2016;2016;02;19;Torstai;6;3;9;6;10;16
292;25.02.2016;2016;02;20;Torstai;6;8;14;13;8;21
292;25.02.2016;2016;02;21;Torstai;5;6;11;3;1;4
292;25.02.2016;2016;02;22;Torstai;0;3;3;0;0;0
292;25.02.2016;2016;02;23;Torstai;0;0;0;2;1;3
292;26.02.2016;2016;02;00;Perjantai;0;0;0;0;0;0
292;26.02.2016;2016;02;01;Perjantai;0;0;0;0;0;0
292;26.02.2016;2016;02;02;Perjantai;0;0;0;0;0;0
292;26.02.2016;2016;02;03;Perjantai;1;0;1;0;0;0
292;26.02.2016;2016;02;04;Perjantai;1;0;1;1;0;1
292;26.02.2016;2016;02;05;Perjantai;10;6;16;0;1;1
292;26.02.2016;2016;02;06;Perjantai;11;2;13;2;4;6
292;26.02.2016;2016;02;07;Perjantai;26;17;43;20;11;31
292;26.02.2016;2016;02;08;Perjantai;28;18;46;21;17;38
292;26.02.2016;2016;02;09;Perjantai;15;5;20;9;14;23
292;26.02.2016;2016;02;10;Perjantai;7;6;13;10;3;13
292;26.02.2016;2016;02;11;Perjantai;7;11;18;18;12;30
292;26.02.2016;2016;02;12;Perjantai;11;10;21;16;5;21
292;26.02.2016;2016;02;13;Perjantai;18;38;56;19;18;37
292;26.02.2016;2016;02;14;Perjantai;17;40;57;16;15;31
292;26.02.2016;2016;02;15;Perjantai;13;19;32;13;21;34
292;26.02.2016;2016;02;16;Perjantai;11;17;28;13;15;28
292;26.02.2016;2016;02;17;Perjantai;12;15;27;8;14;22
292;26.02.2016;2016;02;18;Perjantai;12;7;19;7;7;14
292;26.02.2016;2016;02;19;Perjantai;9;2;11;13;14;27
292;26.02.2016;2016;02;20;Perjantai;9;11;20;5;5;10
292;26.02.2016;2016;02;21;Perjantai;9;2;11;3;3;6
292;26.02.2016;2016;02;22;Perjantai;2;4;6;2;1;3
292;26.02.2016;2016;02;23;Perjantai;2;1;3;8;2;10
292;27.02.2016;2016;02;00;Lauantai;0;0;0;2;1;3
292;27.02.2016;2016;02;01;Lauantai;0;1;1;2;0;2
292;27.02.2016;2016;02;02;Lauantai;1;0;1;2;3;5
292;27.02.2016;2016;02;03;Lauantai;0;0;0;1;1;2
292;27.02.2016;2016;02;04;Lauantai;0;1;1;0;0;0
292;27.02.2016;2016;02;05;Lauantai;0;0;0;1;0;1
292;27.02.2016;2016;02;06;Lauantai;3;1;4;3;3;6
292;27.02.2016;2016;02;07;Lauantai;1;2;3;1;5;6
292;27.02.2016;2016;02;08;Lauantai;1;3;4;3;4;7
292;27.02.2016;2016;02;09;Lauantai;0;2;2;10;7;17
292;27.02.2016;2016;02;10;Lauantai;9;8;17;3;12;15
292;27.02.2016;2016;02;11;Lauantai;5;6;11;11;13;24
292;27.02.2016;2016;02;12;Lauantai;10;13;23;14;13;27
292;27.02.2016;2016;02;13;Lauantai;13;7;20;20;10;30
292;27.02.2016;2016;02;14;Lauantai;12;7;19;10;8;18
292;27.02.2016;2016;02;15;Lauantai;4;5;9;11;14;25
292;27.02.2016;2016;02;16;Lauantai;8;4;12;10;14;24
292;27.02.2016;2016;02;17;Lauantai;9;8;17;8;13;21
292;27.02.2016;2016;02;18;Lauantai;7;12;19;10;11;21
292;27.02.2016;2016;02;19;Lauantai;8;3;11;5;6;11
292;27.02.2016;2016;02;20;Lauantai;7;0;7;0;6;6
292;27.02.2016;2016;02;21;Lauantai;2;3;5;0;1;1
292;27.02.2016;2016;02;22;Lauantai;3;3;6;4;2;6
292;27.02.2016;2016;02;23;Lauantai;3;0;3;4;1;5
292;28.02.2016;2016;02;00;Sunnuntai;1;4;5;3;3;6
292;28.02.2016;2016;02;01;Sunnuntai;0;1;1;1;1;2
292;28.02.2016;2016;02;02;Sunnuntai;0;2;2;2;6;8
292;28.02.2016;2016;02;03;Sunnuntai;1;0;1;0;3;3
292;28.02.2016;2016;02;04;Sunnuntai;0;0;0;0;0;0
292;28.02.2016;2016;02;05;Sunnuntai;0;0;0;2;0;2
292;28.02.2016;2016;02;06;Sunnuntai;3;0;3;1;2;3
292;28.02.2016;2016;02;07;Sunnuntai;0;0;0;1;2;3
292;28.02.2016;2016;02;08;Sunnuntai;0;1;1;5;2;7
292;28.02.2016;2016;02;09;Sunnuntai;5;6;11;6;4;10
292;28.02.2016;2016;02;10;Sunnuntai;2;3;5;17;18;35
292;28.02.2016;2016;02;11;Sunnuntai;3;10;13;11;14;25
292;28.02.2016;2016;02;12;Sunnuntai;7;13;20;15;13;28
292;28.02.2016;2016;02;13;Sunnuntai;14;7;21;30;24;54
292;28.02.2016;2016;02;14;Sunnuntai;15;4;19;8;12;20
292;28.02.2016;2016;02;15;Sunnuntai;9;10;19;14;19;33
292;28.02.2016;2016;02;16;Sunnuntai;4;4;8;17;8;25
292;28.02.2016;2016;02;17;Sunnuntai;5;9;14;5;11;16
292;28.02.2016;2016;02;18;Sunnuntai;7;4;11;15;5;20
292;28.02.2016;2016;02;19;Sunnuntai;5;5;10;5;7;12
292;28.02.2016;2016;02;20;Sunnuntai;3;3;6;5;3;8
292;28.02.2016;2016;02;21;Sunnuntai;1;6;7;1;2;3
292;28.02.2016;2016;02;22;Sunnuntai;1;3;4;0;4;4
292;28.02.2016;2016;02;23;Sunnuntai;1;0;1;1;0;1
292;29.02.2016;2016;02;00;Maanantai;0;0;0;0;0;0
292;29.02.2016;2016;02;01;Maanantai;0;0;0;0;0;0
292;29.02.2016;2016;02;02;Maanantai;0;0;0;0;0;0
292;29.02.2016;2016;02;03;Maanantai;0;0;0;0;0;0
292;29.02.2016;2016;02;04;Maanantai;1;0;1;1;0;1
292;29.02.2016;2016;02;05;Maanantai;7;4;11;2;1;3
292;29.02.2016;2016;02;06;Maanantai;7;3;10;2;7;9
292;29.02.2016;2016;02;07;Maanantai;27;14;41;18;18;36
292;29.02.2016;2016;02;08;Maanantai;26;12;38;24;13;37
292;29.02.2016;2016;02;09;Maanantai;10;8;18;11;9;20
292;29.02.2016;2016;02;10;Maanantai;9;7;16;8;10;18
292;29.02.2016;2016;02;11;Maanantai;8;11;19;23;11;34
292;29.02.2016;2016;02;12;Maanantai;8;16;24;11;18;29
292;29.02.2016;2016;02;13;Maanantai;13;21;34;23;23;46
292;29.02.2016;2016;02;14;Maanantai;13;23;36;25;32;57
292;29.02.2016;2016;02;15;Maanantai;13;20;33;16;32;48
292;29.02.2016;2016;02;16;Maanantai;23;15;38;8;18;26
292;29.02.2016;2016;02;17;Maanantai;13;13;26;17;14;31
292;29.02.2016;2016;02;18;Maanantai;15;10;25;28;17;45
292;29.02.2016;2016;02;19;Maanantai;3;7;10;8;10;18
292;29.02.2016;2016;02;20;Maanantai;5;14;19;14;9;23
292;29.02.2016;2016;02;21;Maanantai;2;5;7;7;10;17
292;29.02.2016;2016;02;22;Maanantai;2;3;5;1;2;3
292;29.02.2016;2016;02;23;Maanantai;3;1;4;1;0;1
292;01.03.2016;2016;03;00;Tiistai;0;0;0;0;1;1
292;01.03.2016;2016;03;01;Tiistai;0;0;0;1;0;1
292;01.03.2016;2016;03;02;Tiistai;0;1;1;0;0;0
292;01.03.2016;2016;03;03;Tiistai;0;0;0;0;0;0
292;01.03.2016;2016;03;04;Tiistai;2;0;2;1;0;1
292;01.03.2016;2016;03;05;Tiistai;6;4;10;1;2;3
292;01.03.2016;2016;03;06;Tiistai;9;6;15;5;4;9
292;01.03.2016;2016;03;07;Tiistai;44;15;59;18;16;34
292;01.03.2016;2016;03;08;Tiistai;42;10;52;25;15;40
292;01.03.2016;2016;03;09;Tiistai;11;14;25;17;19;36
292;01.03.2016;2016;03;10;Tiistai;15;7;22;13;17;30
292;01.03.2016;2016;03;11;Tiistai;12;15;27;15;8;23
292;01.03.2016;2016;03;12;Tiistai;21;16;37;22;21;43
292;01.03.2016;2016;03;13;Tiistai;13;27;40;22;24;46
292;01.03.2016;2016;03;14;Tiistai;23;58;81;12;33;45
292;01.03.2016;2016;03;15;Tiistai;21;40;61;13;27;40
292;01.03.2016;2016;03;16;Tiistai;27;17;44;23;33;56
292;01.03.2016;2016;03;17;Tiistai;14;10;24;22;19;41
292;01.03.2016;2016;03;18;Tiistai;4;15;19;15;19;34
292;01.03.2016;2016;03;19;Tiistai;11;9;20;8;8;16
292;01.03.2016;2016;03;20;Tiistai;8;5;13;4;5;9
292;01.03.2016;2016;03;21;Tiistai;0;11;11;6;3;9
292;01.03.2016;2016;03;22;Tiistai;3;7;10;1;1;2
292;01.03.2016;2016;03;23;Tiistai;0;0;0;0;0;0
292;02.03.2016;2016;03;00;Keskiviikko;0;0;0;0;0;0
292;02.03.2016;2016;03;01;Keskiviikko;0;0;0;0;0;0
292;02.03.2016;2016;03;02;Keskiviikko;0;0;0;0;1;1
292;02.03.2016;2016;03;03;Keskiviikko;1;0;1;0;1;1
292;02.03.2016;2016;03;04;Keskiviikko;3;0;3;1;0;1
292;02.03.2016;2016;03;05;Keskiviikko;4;6;10;1;2;3
292;02.03.2016;2016;03;06;Keskiviikko;16;6;22;3;7;10
292;02.03.2016;2016;03;07;Keskiviikko;45;20;65;29;15;44
292;02.03.2016;2016;03;08;Keskiviikko;30;11;41;14;16;30
292;02.03.2016;2016;03;09;Keskiviikko;15;8;23;5;12;17
292;02.03.2016;2016;03;10;Keskiviikko;9;14;23;17;13;30
292;02.03.2016;2016;03;11;Keskiviikko;11;2;13;10;23;33
292;02.03.2016;2016;03;12;Keskiviikko;11;15;26;19;7;26
292;02.03.2016;2016;03;13;Keskiviikko;16;36;52;20;22;42
292;02.03.2016;2016;03;14;Keskiviikko;17;35;52;31;23;54
292;02.03.2016;2016;03;15;Keskiviikko;23;26;49;10;23;33
292;02.03.2016;2016;03;16;Keskiviikko;19;29;48;19;18;37
292;02.03.2016;2016;03;17;Keskiviikko;10;20;30;10;13;23
292;02.03.2016;2016;03;18;Keskiviikko;14;8;22;9;12;21
292;02.03.2016;2016;03;19;Keskiviikko;9;8;17;6;7;13
292;02.03.2016;2016;03;20;Keskiviikko;4;4;8;8;6;14
292;02.03.2016;2016;03;21;Keskiviikko;3;4;7;1;3;4
292;02.03.2016;2016;03;22;Keskiviikko;2;6;8;0;2;2
292;02.03.2016;2016;03;23;Keskiviikko;0;1;1;2;0;2
292;03.03.2016;2016;03;00;Torstai;1;0;1;1;0;1
292;03.03.2016;2016;03;01;Torstai;1;0;1;0;1;1
292;03.03.2016;2016;03;02;Torstai;2;0;2;1;1;2
292;03.03.2016;2016;03;03;Torstai;1;0;1;0;0;0
292;03.03.2016;2016;03;04;Torstai;3;0;3;3;0;3
292;03.03.2016;2016;03;05;Torstai;3;5;8;3;0;3
292;03.03.2016;2016;03;06;Torstai;13;8;21;3;8;11
292;03.03.2016;2016;03;07;Torstai;43;18;61;15;13;28
292;03.03.2016;2016;03;08;Torstai;25;11;36;14;16;30
292;03.03.2016;2016;03;09;Torstai;34;7;41;20;10;30
292;03.03.2016;2016;03;10;Torstai;14;13;27;8;12;20
292;03.03.2016;2016;03;11;Torstai;11;6;17;14;11;25
292;03.03.2016;2016;03;12;Torstai;13;23;36;18;17;35
292;03.03.2016;2016;03;13;Torstai;18;24;42;15;19;34
292;03.03.2016;2016;03;14;Torstai;17;16;33;17;21;38
292;03.03.2016;2016;03;15;Torstai;28;42;70;17;24;41
292;03.03.2016;2016;03;16;Torstai;25;29;54;17;26;43
292;03.03.2016;2016;03;17;Torstai;9;18;27;21;20;41
292;03.03.2016;2016;03;18;Torstai;13;16;29;21;9;30
292;03.03.2016;2016;03;19;Torstai;8;6;14;4;11;15
292;03.03.2016;2016;03;20;Torstai;10;8;18;5;7;12
292;03.03.2016;2016;03;21;Torstai;4;15;19;2;5;7
292;03.03.2016;2016;03;22;Torstai;1;5;6;1;1;2
292;03.03.2016;2016;03;23;Torstai;0;0;0;0;0;0
292;04.03.2016;2016;03;00;Perjantai;0;1;1;0;0;0
292;04.03.2016;2016;03;01;Perjantai;0;1;1;0;0;0
292;04.03.2016;2016;03;02;Perjantai;0;0;0;0;0;0
292;04.03.2016;2016;03;03;Perjantai;0;0;0;1;0;1
292;04.03.2016;2016;03;04;Perjantai;4;0;4;2;0;2
292;04.03.2016;2016;03;05;Perjantai;5;3;8;2;2;4
292;04.03.2016;2016;03;06;Perjantai;13;1;14;2;6;8
292;04.03.2016;2016;03;07;Perjantai;34;19;53;16;12;28
292;04.03.2016;2016;03;08;Perjantai;33;11;44;32;12;44
292;04.03.2016;2016;03;09;Perjantai;24;5;29;14;14;28
292;04.03.2016;2016;03;10;Perjantai;11;14;25;10;7;17
292;04.03.2016;2016;03;11;Perjantai;10;9;19;5;13;18
292;04.03.2016;2016;03;12;Perjantai;15;11;26;16;9;25
292;04.03.2016;2016;03;13;Perjantai;17;42;59;17;31;48
292;04.03.2016;2016;03;14;Perjantai;17;39;56;16;14;30
292;04.03.2016;2016;03;15;Perjantai;12;23;35;17;20;37
292;04.03.2016;2016;03;16;Perjantai;16;20;36;14;16;30
292;04.03.2016;2016;03;17;Perjantai;9;15;24;15;9;24
292;04.03.2016;2016;03;18;Perjantai;10;15;25;5;10;15
292;04.03.2016;2016;03;19;Perjantai;6;9;15;7;13;20
292;04.03.2016;2016;03;20;Perjantai;13;1;14;8;4;12
292;04.03.2016;2016;03;21;Perjantai;8;5;13;3;3;6
292;04.03.2016;2016;03;22;Perjantai;3;4;7;4;3;7
292;04.03.2016;2016;03;23;Perjantai;2;4;6;5;2;7
292;05.03.2016;2016;03;00;Lauantai;2;0;2;4;3;7
292;05.03.2016;2016;03;01;Lauantai;1;0;1;0;2;2
292;05.03.2016;2016;03;02;Lauantai;0;1;1;0;8;8
292;05.03.2016;2016;03;03;Lauantai;1;2;3;0;3;3
292;05.03.2016;2016;03;04;Lauantai;0;0;0;0;0;0
292;05.03.2016;2016;03;05;Lauantai;1;1;2;3;3;6
292;05.03.2016;2016;03;06;Lauantai;2;0;2;1;3;4
292;05.03.2016;2016;03;07;Lauantai;0;1;1;3;6;9
292;05.03.2016;2016;03;08;Lauantai;2;4;6;6;2;8
292;05.03.2016;2016;03;09;Lauantai;4;3;7;4;11;15
292;05.03.2016;2016;03;10;Lauantai;1;6;7;9;10;19
292;05.03.2016;2016;03;11;Lauantai;8;4;12;17;12;29
292;05.03.2016;2016;03;12;Lauantai;9;7;16;14;8;22
292;05.03.2016;2016;03;13;Lauantai;7;6;13;10;13;23
292;05.03.2016;2016;03;14;Lauantai;18;11;29;10;9;19
292;05.03.2016;2016;03;15;Lauantai;8;13;21;23;17;40
292;05.03.2016;2016;03;16;Lauantai;8;5;13;12;10;22
292;05.03.2016;2016;03;17;Lauantai;6;16;22;12;9;21
292;05.03.2016;2016;03;18;Lauantai;8;4;12;10;9;19
292;05.03.2016;2016;03;19;Lauantai;6;8;14;14;10;24
292;05.03.2016;2016;03;20;Lauantai;4;3;7;3;8;11
292;05.03.2016;2016;03;21;Lauantai;6;2;8;2;2;4
292;05.03.2016;2016;03;22;Lauantai;0;5;5;5;2;7
292;05.03.2016;2016;03;23;Lauantai;0;1;1;3;0;3
292;06.03.2016;2016;03;00;Sunnuntai;1;0;1;2;0;2
292;06.03.2016;2016;03;01;Sunnuntai;3;2;5;1;1;2
292;06.03.2016;2016;03;02;Sunnuntai;1;1;2;1;4;5
292;06.03.2016;2016;03;03;Sunnuntai;2;2;4;2;4;6
292;06.03.2016;2016;03;04;Sunnuntai;0;0;0;0;0;0
292;06.03.2016;2016;03;05;Sunnuntai;1;2;3;2;0;2
292;06.03.2016;2016;03;06;Sunnuntai;6;0;6;1;3;4
292;06.03.2016;2016;03;07;Sunnuntai;0;0;0;1;3;4
292;06.03.2016;2016;03;08;Sunnuntai;1;2;3;3;3;6
292;06.03.2016;2016;03;09;Sunnuntai;4;6;10;5;4;9
292;06.03.2016;2016;03;10;Sunnuntai;3;4;7;7;9;16
292;06.03.2016;2016;03;11;Sunnuntai;8;6;14;13;16;29
292;06.03.2016;2016;03;12;Sunnuntai;4;7;11;18;8;26
292;06.03.2016;2016;03;13;Sunnuntai;9;11;20;12;10;22
292;06.03.2016;2016;03;14;Sunnuntai;16;14;30;7;11;18
292;06.03.2016;2016;03;15;Sunnuntai;5;4;9;15;16;31
292;06.03.2016;2016;03;16;Sunnuntai;8;11;19;13;8;21
292;06.03.2016;2016;03;17;Sunnuntai;10;5;15;14;11;25
292;06.03.2016;2016;03;18;Sunnuntai;11;14;25;13;12;25
292;06.03.2016;2016;03;19;Sunnuntai;6;8;14;9;9;18
292;06.03.2016;2016;03;20;Sunnuntai;9;4;13;5;3;8
292;06.03.2016;2016;03;21;Sunnuntai;11;4;15;4;5;9
292;06.03.2016;2016;03;22;Sunnuntai;1;1;2;0;1;1
292;06.03.2016;2016;03;23;Sunnuntai;0;0;0;1;0;1
292;07.03.2016;2016;03;00;Maanantai;1;1;2;2;0;2
292;07.03.2016;2016;03;01;Maanantai;1;0;1;0;1;1
292;07.03.2016;2016;03;02;Maanantai;0;3;3;1;0;1
292;07.03.2016;2016;03;03;Maanantai;0;0;0;2;0;2
292;07.03.2016;2016;03;04;Maanantai;2;0;2;0;0;0
292;07.03.2016;2016;03;05;Maanantai;5;3;8;4;3;7
292;07.03.2016;2016;03;06;Maanantai;8;5;13;2;3;5
292;07.03.2016;2016;03;07;Maanantai;14;15;29;15;17;32
292;07.03.2016;2016;03;08;Maanantai;13;8;21;11;12;23
292;07.03.2016;2016;03;09;Maanantai;9;8;17;1;10;11
292;07.03.2016;2016;03;10;Maanantai;8;8;16;11;11;22
292;07.03.2016;2016;03;11;Maanantai;9;18;27;9;10;19
292;07.03.2016;2016;03;12;Maanantai;12;6;18;7;8;15
292;07.03.2016;2016;03;13;Maanantai;7;11;18;13;11;24
292;07.03.2016;2016;03;14;Maanantai;22;19;41;16;11;27
292;07.03.2016;2016;03;15;Maanantai;14;14;28;15;10;25
292;07.03.2016;2016;03;16;Maanantai;12;15;27;10;9;19
292;07.03.2016;2016;03;17;Maanantai;13;11;24;18;11;29
292;07.03.2016;2016;03;18;Maanantai;7;7;14;18;19;37
292;07.03.2016;2016;03;19;Maanantai;7;7;14;6;11;17
292;07.03.2016;2016;03;20;Maanantai;6;2;8;9;7;16
292;07.03.2016;2016;03;21;Maanantai;3;4;7;6;2;8
292;07.03.2016;2016;03;22;Maanantai;1;3;4;1;4;5
292;07.03.2016;2016;03;23;Maanantai;0;3;3;2;2;4
292;08.03.2016;2016;03;00;Tiistai;1;0;1;0;1;1
292;08.03.2016;2016;03;01;Tiistai;1;1;2;0;0;0
292;08.03.2016;2016;03;02;Tiistai;1;0;1;1;0;1
292;08.03.2016;2016;03;03;Tiistai;1;0;1;0;0;0
292;08.03.2016;2016;03;04;Tiistai;1;0;1;1;0;1
292;08.03.2016;2016;03;05;Tiistai;4;4;8;2;1;3
292;08.03.2016;2016;03;06;Tiistai;7;9;16;2;2;4
292;08.03.2016;2016;03;07;Tiistai;15;9;24;5;15;20
292;08.03.2016;2016;03;08;Tiistai;12;10;22;8;11;19
292;08.03.2016;2016;03;09;Tiistai;6;12;18;6;12;18
292;08.03.2016;2016;03;10;Tiistai;5;11;16;5;13;18
292;08.03.2016;2016;03;11;Tiistai;10;10;20;18;15;33
292;08.03.2016;2016;03;12;Tiistai;9;8;17;9;16;25
292;08.03.2016;2016;03;13;Tiistai;19;8;27;12;6;18
292;08.03.2016;2016;03;14;Tiistai;10;20;30;12;15;27
292;08.03.2016;2016;03;15;Tiistai;15;12;27;28;20;48
292;08.03.2016;2016;03;16;Tiistai;13;15;28;13;21;34
292;08.03.2016;2016;03;17;Tiistai;5;9;14;15;18;33
292;08.03.2016;2016;03;18;Tiistai;17;12;29;13;11;24
292;08.03.2016;2016;03;19;Tiistai;2;2;4;16;7;23
292;08.03.2016;2016;03;20;Tiistai;11;1;12;10;5;15
292;08.03.2016;2016;03;21;Tiistai;4;3;7;8;5;13
292;08.03.2016;2016;03;22;Tiistai;2;2;4;2;0;2
292;08.03.2016;2016;03;23;Tiistai;0;1;1;0;2;2
292;09.03.2016;2016;03;00;Keskiviikko;0;1;1;0;0;0
292;09.03.2016;2016;03;01;Keskiviikko;0;0;0;0;1;1
292;09.03.2016;2016;03;02;Keskiviikko;2;0;2;0;2;2
292;09.03.2016;2016;03;03;Keskiviikko;4;1;5;5;0;5
292;09.03.2016;2016;03;04;Keskiviikko;1;0;1;2;1;3
292;09.03.2016;2016;03;05;Keskiviikko;5;4;9;4;1;5
292;09.03.2016;2016;03;06;Keskiviikko;11;6;17;4;3;7
292;09.03.2016;2016;03;07;Keskiviikko;12;14;26;7;14;21
292;09.03.2016;2016;03;08;Keskiviikko;12;8;20;5;10;15
292;09.03.2016;2016;03;09;Keskiviikko;5;7;12;6;11;17
292;09.03.2016;2016;03;10;Keskiviikko;8;5;13;12;17;29
292;09.03.2016;2016;03;11;Keskiviikko;8;11;19;16;14;30
292;09.03.2016;2016;03;12;Keskiviikko;13;10;23;13;12;25
292;09.03.2016;2016;03;13;Keskiviikko;17;17;34;12;6;18
292;09.03.2016;2016;03;14;Keskiviikko;6;12;18;13;14;27
292;09.03.2016;2016;03;15;Keskiviikko;17;11;28;20;14;34
292;09.03.2016;2016;03;16;Keskiviikko;21;17;38;17;22;39
292;09.03.2016;2016;03;17;Keskiviikko;17;9;26;11;20;31
292;09.03.2016;2016;03;18;Keskiviikko;8;8;16;23;7;30
292;09.03.2016;2016;03;19;Keskiviikko;8;2;10;11;8;19
292;09.03.2016;2016;03;20;Keskiviikko;5;6;11;11;9;20
292;09.03.2016;2016;03;21;Keskiviikko;4;5;9;2;3;5
292;09.03.2016;2016;03;22;Keskiviikko;1;2;3;1;1;2
292;09.03.2016;2016;03;23;Keskiviikko;1;5;6;0;2;2
292;10.03.2016;2016;03;00;Torstai;0;1;1;0;2;2
292;10.03.2016;2016;03;01;Torstai;1;1;2;0;1;1
292;10.03.2016;2016;03;02;Torstai;1;0;1;0;0;0
292;10.03.2016;2016;03;03;Torstai;0;0;0;0;0;0
292;10.03.2016;2016;03;04;Torstai;2;0;2;2;0;2
292;10.03.2016;2016;03;05;Torstai;4;3;7;3;3;6
292;10.03.2016;2016;03;06;Torstai;7;1;8;3;8;11
292;10.03.2016;2016;03;07;Torstai;10;11;21;13;9;22
292;10.03.2016;2016;03;08;Torstai;8;8;16;8;11;19
292;10.03.2016;2016;03;09;Torstai;6;12;18;4;9;13
292;10.03.2016;2016;03;10;Torstai;5;6;11;9;8;17
292;10.03.2016;2016;03;11;Torstai;3;17;20;9;10;19
292;10.03.2016;2016;03;12;Torstai;9;4;13;13;12;25
292;10.03.2016;2016;03;13;Torstai;7;12;19;14;11;25
292;10.03.2016;2016;03;14;Torstai;14;9;23;17;19;36
292;10.03.2016;2016;03;15;Torstai;23;17;40;25;16;41
292;10.03.2016;2016;03;16;Torstai;17;12;29;11;20;31
292;10.03.2016;2016;03;17;Torstai;10;10;20;7;9;16
292;10.03.2016;2016;03;18;Torstai;12;3;15;12;11;23
292;10.03.2016;2016;03;19;Torstai;10;5;15;4;8;12
292;10.03.2016;2016;03;20;Torstai;5;4;9;6;5;11
292;10.03.2016;2016;03;21;Torstai;4;10;14;8;2;10
292;10.03.2016;2016;03;22;Torstai;5;1;6;3;2;5
292;10.03.2016;2016;03;23;Torstai;4;3;7;2;1;3
292;11.03.2016;2016;03;00;Perjantai;0;0;0;1;0;1
292;11.03.2016;2016;03;01;Perjantai;1;1;2;0;2;2
292;11.03.2016;2016;03;02;Perjantai;1;0;1;0;1;1
292;11.03.2016;2016;03;03;Perjantai;0;0;0;0;0;0
292;11.03.2016;2016;03;04;Perjantai;0;0;0;1;0;1
292;11.03.2016;2016;03;05;Perjantai;3;2;5;3;1;4
292;11.03.2016;2016;03;06;Perjantai;8;2;10;1;2;3
292;11.03.2016;2016;03;07;Perjantai;11;9;20;10;12;22
292;11.03.2016;2016;03;08;Perjantai;7;8;15;5;8;13
292;11.03.2016;2016;03;09;Perjantai;6;7;13;3;11;14
292;11.03.2016;2016;03;10;Perjantai;12;7;19;10;12;22
292;11.03.2016;2016;03;11;Perjantai;3;16;19;7;11;18
292;11.03.2016;2016;03;12;Perjantai;9;9;18;12;7;19
292;11.03.2016;2016;03;13;Perjantai;17;10;27;8;6;14
292;11.03.2016;2016;03;14;Perjantai;8;6;14;11;12;23
292;11.03.2016;2016;03;15;Perjantai;20;11;31;20;15;35
292;11.03.2016;2016;03;16;Perjantai;17;11;28;13;13;26
292;11.03.2016;2016;03;17;Perjantai;7;4;11;10;7;17
292;11.03.2016;2016;03;18;Perjantai;4;8;12;5;15;20
292;11.03.2016;2016;03;19;Perjantai;8;1;9;11;7;18
292;11.03.2016;2016;03;20;Perjantai;6;5;11;7;9;16
292;11.03.2016;2016;03;21;Perjantai;1;1;2;3;3;6
292;11.03.2016;2016;03;22;Perjantai;2;1;3;2;0;2
292;11.03.2016;2016;03;23;Perjantai;2;3;5;4;3;7
292;12.03.2016;2016;03;00;Lauantai;1;1;2;4;0;4
292;12.03.2016;2016;03;01;Lauantai;2;2;4;1;3;4
292;12.03.2016;2016;03;02;Lauantai;1;0;1;1;6;7
292;12.03.2016;2016;03;03;Lauantai;1;1;2;2;10;12
292;12.03.2016;2016;03;04;Lauantai;1;0;1;1;0;1
292;12.03.2016;2016;03;05;Lauantai;0;0;0;1;4;5
292;12.03.2016;2016;03;06;Lauantai;0;0;0;1;2;3
292;12.03.2016;2016;03;07;Lauantai;3;6;9;4;6;10
292;12.03.2016;2016;03;08;Lauantai;6;4;10;3;10;13
292;12.03.2016;2016;03;09;Lauantai;4;5;9;1;3;4
292;12.03.2016;2016;03;10;Lauantai;8;3;11;6;14;20
292;12.03.2016;2016;03;11;Lauantai;7;7;14;14;10;24
292;12.03.2016;2016;03;12;Lauantai;10;6;16;13;14;27
292;12.03.2016;2016;03;13;Lauantai;5;8;13;9;6;15
292;12.03.2016;2016;03;14;Lauantai;14;10;24;10;17;27
292;12.03.2016;2016;03;15;Lauantai;7;7;14;16;18;34
292;12.03.2016;2016;03;16;Lauantai;5;10;15;11;8;19
292;12.03.2016;2016;03;17;Lauantai;10;7;17;6;6;12
292;12.03.2016;2016;03;18;Lauantai;13;5;18;15;13;28
292;12.03.2016;2016;03;19;Lauantai;5;5;10;7;7;14
292;12.03.2016;2016;03;20;Lauantai;1;3;4;2;9;11
292;12.03.2016;2016;03;21;Lauantai;0;3;3;0;0;0
292;12.03.2016;2016;03;22;Lauantai;1;2;3;5;0;5
292;12.03.2016;2016;03;23;Lauantai;4;2;6;1;1;2
292;13.03.2016;2016;03;00;Sunnuntai;1;2;3;3;1;4
292;13.03.2016;2016;03;01;Sunnuntai;3;0;3;6;3;9
292;13.03.2016;2016;03;02;Sunnuntai;0;2;2;0;3;3
292;13.03.2016;2016;03;03;Sunnuntai;0;0;0;0;0;0
292;13.03.2016;2016;03;04;Sunnuntai;1;0;1;0;0;0
292;13.03.2016;2016;03;05;Sunnuntai;0;0;0;6;0;6
292;13.03.2016;2016;03;06;Sunnuntai;2;1;3;1;3;4
292;13.03.2016;2016;03;07;Sunnuntai;1;2;3;2;1;3
292;13.03.2016;2016;03;08;Sunnuntai;3;2;5;5;7;12
292;13.03.2016;2016;03;09;Sunnuntai;5;4;9;5;1;6
292;13.03.2016;2016;03;10;Sunnuntai;3;4;7;7;8;15
292;13.03.2016;2016;03;11;Sunnuntai;4;7;11;16;11;27
292;13.03.2016;2016;03;12;Sunnuntai;16;13;29;10;9;19
292;13.03.2016;2016;03;13;Sunnuntai;8;11;19;12;13;25
292;13.03.2016;2016;03;14;Sunnuntai;8;5;13;6;5;11
292;13.03.2016;2016;03;15;Sunnuntai;6;8;14;17;11;28
292;13.03.2016;2016;03;16;Sunnuntai;5;3;8;9;13;22
292;13.03.2016;2016;03;17;Sunnuntai;15;4;19;12;14;26
292;13.03.2016;2016;03;18;Sunnuntai;8;4;12;7;5;12
292;13.03.2016;2016;03;19;Sunnuntai;5;5;10;6;10;16
292;13.03.2016;2016;03;20;Sunnuntai;4;11;15;5;0;5
292;13.03.2016;2016;03;21;Sunnuntai;3;4;7;4;5;9
292;13.03.2016;2016;03;22;Sunnuntai;2;3;5;3;3;6
292;13.03.2016;2016;03;23;Sunnuntai;2;0;2;1;3;4
292;14.03.2016;2016;03;00;Maanantai;0;1;1;0;0;0
292;14.03.2016;2016;03;01;Maanantai;0;0;0;0;0;0
292;14.03.2016;2016;03;02;Maanantai;0;0;0;0;0;0
292;14.03.2016;2016;03;03;Maanantai;0;0;0;1;0;1
292;14.03.2016;2016;03;04;Maanantai;0;1;1;1;0;1
292;14.03.2016;2016;03;05;Maanantai;4;3;7;5;3;8
292;14.03.2016;2016;03;06;Maanantai;13;7;20;1;5;6
292;14.03.2016;2016;03;07;Maanantai;58;15;73;22;21;43
292;14.03.2016;2016;03;08;Maanantai;35;13;48;20;11;31
292;14.03.2016;2016;03;09;Maanantai;31;15;46;14;13;27
292;14.03.2016;2016;03;10;Maanantai;22;8;30;8;15;23
292;14.03.2016;2016;03;11;Maanantai;14;11;25;18;15;33
292;14.03.2016;2016;03;12;Maanantai;12;19;31;23;24;47
292;14.03.2016;2016;03;13;Maanantai;17;34;51;21;22;43
292;14.03.2016;2016;03;14;Maanantai;22;40;62;17;27;44
292;14.03.2016;2016;03;15;Maanantai;30;35;65;24;24;48
292;14.03.2016;2016;03;16;Maanantai;29;39;68;15;34;49
292;14.03.2016;2016;03;17;Maanantai;16;12;28;12;16;28
292;14.03.2016;2016;03;18;Maanantai;19;19;38;19;19;38
292;14.03.2016;2016;03;19;Maanantai;13;14;27;15;10;25
292;14.03.2016;2016;03;20;Maanantai;10;12;22;5;6;11
292;14.03.2016;2016;03;21;Maanantai;5;14;19;5;4;9
292;14.03.2016;2016;03;22;Maanantai;1;2;3;3;2;5
292;14.03.2016;2016;03;23;Maanantai;0;0;0;0;1;1
292;15.03.2016;2016;03;00;Tiistai;1;0;1;2;1;3
292;15.03.2016;2016;03;01;Tiistai;1;0;1;0;0;0
292;15.03.2016;2016;03;02;Tiistai;0;1;1;0;2;2
292;15.03.2016;2016;03;03;Tiistai;1;0;1;0;0;0
292;15.03.2016;2016;03;04;Tiistai;1;1;2;1;0;1
292;15.03.2016;2016;03;05;Tiistai;3;5;8;3;3;6
292;15.03.2016;2016;03;06;Tiistai;15;11;26;7;2;9
292;15.03.2016;2016;03;07;Tiistai;47;19;66;17;18;35
292;15.03.2016;2016;03;08;Tiistai;45;17;62;17;7;24
292;15.03.2016;2016;03;09;Tiistai;11;10;21;11;17;28
292;15.03.2016;2016;03;10;Tiistai;20;16;36;14;16;30
292;15.03.2016;2016;03;11;Tiistai;11;20;31;20;20;40
292;15.03.2016;2016;03;12;Tiistai;19;14;33;17;26;43
292;15.03.2016;2016;03;13;Tiistai;21;45;66;20;28;48
292;15.03.2016;2016;03;14;Tiistai;21;40;61;39;38;77
292;15.03.2016;2016;03;15;Tiistai;22;23;45;22;32;54
292;15.03.2016;2016;03;16;Tiistai;25;30;55;32;27;59
292;15.03.2016;2016;03;17;Tiistai;18;21;39;50;49;99
292;15.03.2016;2016;03;18;Tiistai;11;12;23;43;39;82
292;15.03.2016;2016;03;19;Tiistai;10;7;17;11;15;26
292;15.03.2016;2016;03;20;Tiistai;10;4;14;9;11;20
292;15.03.2016;2016;03;21;Tiistai;7;9;16;2;5;7
292;15.03.2016;2016;03;22;Tiistai;1;4;5;2;1;3
292;15.03.2016;2016;03;23;Tiistai;1;1;2;0;1;1
292;16.03.2016;2016;03;00;Keskiviikko;2;0;2;0;3;3
292;16.03.2016;2016;03;01;Keskiviikko;0;0;0;2;0;2
292;16.03.2016;2016;03;02;Keskiviikko;0;0;0;0;0;0
292;16.03.2016;2016;03;03;Keskiviikko;1;0;1;1;0;1
292;16.03.2016;2016;03;04;Keskiviikko;0;0;0;0;0;0
292;16.03.2016;2016;03;05;Keskiviikko;5;1;6;3;2;5
292;16.03.2016;2016;03;06;Keskiviikko;15;4;19;4;7;11
292;16.03.2016;2016;03;07;Keskiviikko;55;18;73;33;18;51
292;16.03.2016;2016;03;08;Keskiviikko;37;21;58;15;17;32
292;16.03.2016;2016;03;09;Keskiviikko;12;8;20;11;12;23
292;16.03.2016;2016;03;10;Keskiviikko;10;10;20;16;11;27
292;16.03.2016;2016;03;11;Keskiviikko;14;16;30;17;12;29
292;16.03.2016;2016;03;12;Keskiviikko;11;11;22;16;9;25
292;16.03.2016;2016;03;13;Keskiviikko;17;46;63;15;28;43
292;16.03.2016;2016;03;14;Keskiviikko;26;43;69;16;22;38
292;16.03.2016;2016;03;15;Keskiviikko;24;30;54;19;28;47
292;16.03.2016;2016;03;16;Keskiviikko;33;40;73;27;20;47
292;16.03.2016;2016;03;17;Keskiviikko;23;26;49;10;11;21
292;16.03.2016;2016;03;18;Keskiviikko;15;18;33;8;16;24
292;16.03.2016;2016;03;19;Keskiviikko;15;12;27;14;18;32
292;16.03.2016;2016;03;20;Keskiviikko;7;7;14;10;8;18
292;16.03.2016;2016;03;21;Keskiviikko;5;8;13;0;5;5
292;16.03.2016;2016;03;22;Keskiviikko;1;8;9;0;1;1
292;16.03.2016;2016;03;23;Keskiviikko;0;0;0;2;0;2
292;17.03.2016;2016;03;00;Torstai;0;0;0;0;1;1
292;17.03.2016;2016;03;01;Torstai;0;1;1;0;0;0
292;17.03.2016;2016;03;02;Torstai;0;0;0;0;1;1
292;17.03.2016;2016;03;03;Torstai;1;0;1;0;0;0
292;17.03.2016;2016;03;04;Torstai;1;0;1;0;0;0
292;17.03.2016;2016;03;05;Torstai;4;4;8;6;5;11
292;17.03.2016;2016;03;06;Torstai;18;7;25;1;5;6
292;17.03.2016;2016;03;07;Torstai;38;14;52;31;20;51
292;17.03.2016;2016;03;08;Torstai;25;16;41;20;17;37
292;17.03.2016;2016;03;09;Torstai;32;12;44;15;10;25
292;17.03.2016;2016;03;10;Torstai;9;9;18;6;17;23
292;17.03.2016;2016;03;11;Torstai;13;15;28;14;13;27
292;17.03.2016;2016;03;12;Torstai;12;15;27;16;16;32
292;17.03.2016;2016;03;13;Torstai;10;29;39;28;14;42
292;17.03.2016;2016;03;14;Torstai;17;32;49;15;25;40
292;17.03.2016;2016;03;15;Torstai;16;48;64;18;32;50
292;17.03.2016;2016;03;16;Torstai;23;36;59;13;34;47
292;17.03.2016;2016;03;17;Torstai;10;10;20;10;13;23
292;17.03.2016;2016;03;18;Torstai;17;10;27;15;11;26
292;17.03.2016;2016;03;19;Torstai;9;6;15;7;14;21
292;17.03.2016;2016;03;20;Torstai;10;9;19;11;5;16
292;17.03.2016;2016;03;21;Torstai;6;8;14;6;1;7
292;17.03.2016;2016;03;22;Torstai;2;7;9;0;0;0
292;17.03.2016;2016;03;23;Torstai;0;0;0;0;1;1
292;18.03.2016;2016;03;00;Perjantai;1;0;1;0;1;1
292;18.03.2016;2016;03;01;Perjantai;0;0;0;0;0;0
292;18.03.2016;2016;03;02;Perjantai;0;0;0;0;0;0
292;18.03.2016;2016;03;03;Perjantai;0;0;0;0;0;0
292;18.03.2016;2016;03;04;Perjantai;3;0;3;0;0;0
292;18.03.2016;2016;03;05;Perjantai;5;3;8;2;2;4
292;18.03.2016;2016;03;06;Perjantai;14;6;20;4;6;10
292;18.03.2016;2016;03;07;Perjantai;41;13;54;24;14;38
292;18.03.2016;2016;03;08;Perjantai;50;10;60;20;22;42
292;18.03.2016;2016;03;09;Perjantai;21;9;30;21;11;32
292;18.03.2016;2016;03;10;Perjantai;7;9;16;7;14;21
292;18.03.2016;2016;03;11;Perjantai;13;10;23;8;8;16
292;18.03.2016;2016;03;12;Perjantai;12;10;22;19;13;32
292;18.03.2016;2016;03;13;Perjantai;11;39;50;26;35;61
292;18.03.2016;2016;03;14;Perjantai;12;47;59;19;33;52
292;18.03.2016;2016;03;15;Perjantai;13;24;37;20;23;43
292;18.03.2016;2016;03;16;Perjantai;15;19;34;15;13;28
292;18.03.2016;2016;03;17;Perjantai;20;11;31;9;11;20
292;18.03.2016;2016;03;18;Perjantai;6;10;16;10;10;20
292;18.03.2016;2016;03;19;Perjantai;17;12;29;10;4;14
292;18.03.2016;2016;03;20;Perjantai;7;3;10;3;5;8
292;18.03.2016;2016;03;21;Perjantai;7;9;16;4;1;5
292;18.03.2016;2016;03;22;Perjantai;4;8;12;3;2;5
292;18.03.2016;2016;03;23;Perjantai;3;1;4;3;0;3
292;19.03.2016;2016;03;00;Lauantai;1;0;1;0;2;2
292;19.03.2016;2016;03;01;Lauantai;0;0;0;0;2;2
292;19.03.2016;2016;03;02;Lauantai;1;0;1;0;1;1
292;19.03.2016;2016;03;03;Lauantai;0;1;1;0;2;2
292;19.03.2016;2016;03;04;Lauantai;1;0;1;0;0;0
292;19.03.2016;2016;03;05;Lauantai;1;0;1;3;0;3
292;19.03.2016;2016;03;06;Lauantai;2;3;5;0;2;2
292;19.03.2016;2016;03;07;Lauantai;4;2;6;6;1;7
292;19.03.2016;2016;03;08;Lauantai;3;3;6;4;4;8
292;19.03.2016;2016;03;09;Lauantai;1;9;10;2;9;11
292;19.03.2016;2016;03;10;Lauantai;5;6;11;7;8;15
292;19.03.2016;2016;03;11;Lauantai;1;11;12;17;22;39
292;19.03.2016;2016;03;12;Lauantai;10;10;20;25;13;38
292;19.03.2016;2016;03;13;Lauantai;19;14;33;10;12;22
292;19.03.2016;2016;03;14;Lauantai;11;12;23;18;18;36
292;19.03.2016;2016;03;15;Lauantai;19;8;27;17;23;40
292;19.03.2016;2016;03;16;Lauantai;12;6;18;15;13;28
292;19.03.2016;2016;03;17;Lauantai;9;9;18;13;12;25
292;19.03.2016;2016;03;18;Lauantai;16;17;33;15;10;25
292;19.03.2016;2016;03;19;Lauantai;9;8;17;8;6;14
292;19.03.2016;2016;03;20;Lauantai;4;6;10;6;8;14
292;19.03.2016;2016;03;21;Lauantai;4;4;8;0;2;2
292;19.03.2016;2016;03;22;Lauantai;1;3;4;1;1;2
292;19.03.2016;2016;03;23;Lauantai;3;4;7;2;1;3
292;20.03.2016;2016;03;00;Sunnuntai;0;2;2;0;1;1
292;20.03.2016;2016;03;01;Sunnuntai;2;0;2;0;0;0
292;20.03.2016;2016;03;02;Sunnuntai;0;3;3;1;4;5
292;20.03.2016;2016;03;03;Sunnuntai;0;1;1;0;1;1
292;20.03.2016;2016;03;04;Sunnuntai;1;2;3;0;0;0
292;20.03.2016;2016;03;05;Sunnuntai;1;1;2;4;0;4
292;20.03.2016;2016;03;06;Sunnuntai;5;0;5;1;3;4
292;20.03.2016;2016;03;07;Sunnuntai;0;2;2;3;2;5
292;20.03.2016;2016;03;08;Sunnuntai;3;1;4;5;6;11
292;20.03.2016;2016;03;09;Sunnuntai;3;1;4;7;11;18
292;20.03.2016;2016;03;10;Sunnuntai;4;2;6;8;8;16
292;20.03.2016;2016;03;11;Sunnuntai;14;12;26;11;15;26
292;20.03.2016;2016;03;12;Sunnuntai;7;9;16;26;18;44
292;20.03.2016;2016;03;13;Sunnuntai;6;7;13;13;24;37
292;20.03.2016;2016;03;14;Sunnuntai;17;13;30;18;22;40
292;20.03.2016;2016;03;15;Sunnuntai;21;11;32;19;19;38
292;20.03.2016;2016;03;16;Sunnuntai;8;17;25;20;12;32
292;20.03.2016;2016;03;17;Sunnuntai;7;10;17;10;10;20
292;20.03.2016;2016;03;18;Sunnuntai;15;5;20;13;7;20
292;20.03.2016;2016;03;19;Sunnuntai;10;7;17;5;16;21
292;20.03.2016;2016;03;20;Sunnuntai;2;3;5;3;3;6
292;20.03.2016;2016;03;21;Sunnuntai;0;4;4;3;1;4
292;20.03.2016;2016;03;22;Sunnuntai;2;4;6;0;4;4
292;20.03.2016;2016;03;23;Sunnuntai;0;2;2;1;0;1
292;21.03.2016;2016;03;00;Maanantai;0;0;0;0;0;0
292;21.03.2016;2016;03;01;Maanantai;0;1;1;0;0;0
292;21.03.2016;2016;03;02;Maanantai;0;0;0;0;0;0
292;21.03.2016;2016;03;03;Maanantai;0;0;0;0;0;0
292;21.03.2016;2016;03;04;Maanantai;1;0;1;1;0;1
292;21.03.2016;2016;03;05;Maanantai;5;1;6;1;1;2
292;21.03.2016;2016;03;06;Maanantai;10;3;13;8;6;14
292;21.03.2016;2016;03;07;Maanantai;59;13;72;22;14;36
292;21.03.2016;2016;03;08;Maanantai;17;16;33;15;14;29
292;21.03.2016;2016;03;09;Maanantai;24;9;33;12;17;29
292;21.03.2016;2016;03;10;Maanantai;16;10;26;14;5;19
292;21.03.2016;2016;03;11;Maanantai;13;14;27;14;15;29
292;21.03.2016;2016;03;12;Maanantai;11;14;25;16;9;25
292;21.03.2016;2016;03;13;Maanantai;10;50;60;11;28;39
292;21.03.2016;2016;03;14;Maanantai;18;26;44;26;19;45
292;21.03.2016;2016;03;15;Maanantai;20;35;55;19;24;43
292;21.03.2016;2016;03;16;Maanantai;19;37;56;18;31;49
292;21.03.2016;2016;03;17;Maanantai;17;19;36;19;18;37
292;21.03.2016;2016;03;18;Maanantai;12;4;16;11;15;26
292;21.03.2016;2016;03;19;Maanantai;11;8;19;6;10;16
292;21.03.2016;2016;03;20;Maanantai;8;4;12;6;8;14
292;21.03.2016;2016;03;21;Maanantai;4;11;15;5;3;8
292;21.03.2016;2016;03;22;Maanantai;2;4;6;2;3;5
292;21.03.2016;2016;03;23;Maanantai;1;0;1;1;1;2
292;22.03.2016;2016;03;00;Tiistai;0;0;0;2;0;2
292;22.03.2016;2016;03;01;Tiistai;1;0;1;0;1;1
292;22.03.2016;2016;03;02;Tiistai;0;0;0;0;0;0
292;22.03.2016;2016;03;03;Tiistai;0;0;0;0;0;0
292;22.03.2016;2016;03;04;Tiistai;1;0;1;1;0;1
292;22.03.2016;2016;03;05;Tiistai;7;0;7;1;3;4
292;22.03.2016;2016;03;06;Tiistai;11;4;15;2;2;4
292;22.03.2016;2016;03;07;Tiistai;48;19;67;32;16;48
292;22.03.2016;2016;03;08;Tiistai;32;11;43;19;16;35
292;22.03.2016;2016;03;09;Tiistai;6;10;16;6;10;16
292;22.03.2016;2016;03;10;Tiistai;10;10;20;5;7;12
292;22.03.2016;2016;03;11;Tiistai;11;14;25;14;11;25
292;22.03.2016;2016;03;12;Tiistai;15;7;22;11;15;26
292;22.03.2016;2016;03;13;Tiistai;12;37;49;18;31;49
292;22.03.2016;2016;03;14;Tiistai;20;49;69;23;29;52
292;22.03.2016;2016;03;15;Tiistai;24;26;50;19;25;44
292;22.03.2016;2016;03;16;Tiistai;25;25;50;21;28;49
292;22.03.2016;2016;03;17;Tiistai;13;17;30;10;17;27
292;22.03.2016;2016;03;18;Tiistai;10;8;18;10;13;23
292;22.03.2016;2016;03;19;Tiistai;16;5;21;10;7;17
292;22.03.2016;2016;03;20;Tiistai;4;10;14;8;10;18
292;22.03.2016;2016;03;21;Tiistai;5;5;10;2;5;7
292;22.03.2016;2016;03;22;Tiistai;3;3;6;1;0;1
292;22.03.2016;2016;03;23;Tiistai;0;0;0;0;0;0
292;23.03.2016;2016;03;00;Keskiviikko;0;1;1;1;0;1
292;23.03.2016;2016;03;01;Keskiviikko;0;0;0;0;0;0
292;23.03.2016;2016;03;02;Keskiviikko;0;0;0;0;1;1
292;23.03.2016;2016;03;03;Keskiviikko;0;0;0;0;0;0
292;23.03.2016;2016;03;04;Keskiviikko;0;0;0;2;0;2
292;23.03.2016;2016;03;05;Keskiviikko;8;2;10;2;1;3
292;23.03.2016;2016;03;06;Keskiviikko;12;8;20;8;9;17
292;23.03.2016;2016;03;07;Keskiviikko;23;17;40;28;15;43
292;23.03.2016;2016;03;08;Keskiviikko;43;15;58;26;12;38
292;23.03.2016;2016;03;09;Keskiviikko;24;16;40;7;16;23
292;23.03.2016;2016;03;10;Keskiviikko;8;6;14;11;6;17
292;23.03.2016;2016;03;11;Keskiviikko;11;10;21;11;10;21
292;23.03.2016;2016;03;12;Keskiviikko;9;12;21;18;9;27
292;23.03.2016;2016;03;13;Keskiviikko;12;40;52;22;16;38
292;23.03.2016;2016;03;14;Keskiviikko;20;33;53;19;28;47
292;23.03.2016;2016;03;15;Keskiviikko;24;22;46;17;15;32
292;23.03.2016;2016;03;16;Keskiviikko;26;23;49;12;17;29
292;23.03.2016;2016;03;17;Keskiviikko;12;22;34;6;16;22
292;23.03.2016;2016;03;18;Keskiviikko;15;10;25;12;10;22
292;23.03.2016;2016;03;19;Keskiviikko;12;9;21;17;10;27
292;23.03.2016;2016;03;20;Keskiviikko;9;8;17;6;6;12
292;23.03.2016;2016;03;21;Keskiviikko;4;8;12;6;4;10
292;23.03.2016;2016;03;22;Keskiviikko;2;7;9;2;2;4
292;23.03.2016;2016;03;23;Keskiviikko;0;0;0;1;0;1
292;24.03.2016;2016;03;00;Torstai;0;0;0;0;0;0
292;24.03.2016;2016;03;01;Torstai;0;0;0;0;0;0
292;24.03.2016;2016;03;02;Torstai;0;0;0;0;0;0
292;24.03.2016;2016;03;03;Torstai;0;0;0;1;0;1
292;24.03.2016;2016;03;04;Torstai;2;0;2;0;0;0
292;24.03.2016;2016;03;05;Torstai;7;1;8;3;2;5
292;24.03.2016;2016;03;06;Torstai;10;10;20;5;5;10
292;24.03.2016;2016;03;07;Torstai;18;13;31;10;9;19
292;24.03.2016;2016;03;08;Torstai;46;14;60;25;18;43
292;24.03.2016;2016;03;09;Torstai;41;13;54;13;16;29
292;24.03.2016;2016;03;10;Torstai;13;5;18;11;4;15
292;24.03.2016;2016;03;11;Torstai;8;17;25;15;14;29
292;24.03.2016;2016;03;12;Torstai;13;10;23;21;18;39
292;24.03.2016;2016;03;13;Torstai;18;47;65;19;26;45
292;24.03.2016;2016;03;14;Torstai;18;17;35;13;22;35
292;24.03.2016;2016;03;15;Torstai;13;27;40;11;19;30
292;24.03.2016;2016;03;16;Torstai;12;27;39;16;14;30
292;24.03.2016;2016;03;17;Torstai;7;12;19;12;11;23
292;24.03.2016;2016;03;18;Torstai;9;8;17;8;7;15
292;24.03.2016;2016;03;19;Torstai;8;9;17;6;8;14
292;24.03.2016;2016;03;20;Torstai;7;6;13;3;4;7
292;24.03.2016;2016;03;21;Torstai;3;5;8;6;4;10
292;24.03.2016;2016;03;22;Torstai;1;5;6;1;2;3
292;24.03.2016;2016;03;23;Torstai;2;0;2;4;0;4
292;25.03.2016;2016;03;00;Perjantai;0;1;1;2;2;4
292;25.03.2016;2016;03;01;Perjantai;0;0;0;0;1;1
292;25.03.2016;2016;03;02;Perjantai;0;0;0;0;8;8
292;25.03.2016;2016;03;03;Perjantai;0;0;0;0;0;0
292;25.03.2016;2016;03;04;Perjantai;0;0;0;0;0;0
292;25.03.2016;2016;03;05;Perjantai;1;2;3;4;0;4
292;25.03.2016;2016;03;06;Perjantai;2;0;2;1;4;5
292;25.03.2016;2016;03;07;Perjantai;0;1;1;4;1;5
292;25.03.2016;2016;03;08;Perjantai;1;2;3;5;8;13
292;25.03.2016;2016;03;09;Perjantai;2;0;2;3;6;9
292;25.03.2016;2016;03;10;Perjantai;3;4;7;3;7;10
292;25.03.2016;2016;03;11;Perjantai;3;1;4;8;4;12
292;25.03.2016;2016;03;12;Perjantai;4;6;10;9;13;22
292;25.03.2016;2016;03;13;Perjantai;2;6;8;6;11;17
292;25.03.2016;2016;03;14;Perjantai;8;3;11;11;9;20
292;25.03.2016;2016;03;15;Perjantai;9;8;17;12;7;19
292;25.03.2016;2016;03;16;Perjantai;6;3;9;9;15;24
292;25.03.2016;2016;03;17;Perjantai;7;6;13;7;8;15
292;25.03.2016;2016;03;18;Perjantai;4;5;9;7;4;11
292;25.03.2016;2016;03;19;Perjantai;9;5;14;9;9;18
292;25.03.2016;2016;03;20;Perjantai;2;4;6;4;2;6
292;25.03.2016;2016;03;21;Perjantai;1;1;2;0;3;3
292;25.03.2016;2016;03;22;Perjantai;3;2;5;2;5;7
292;25.03.2016;2016;03;23;Perjantai;3;4;7;1;3;4
292;26.03.2016;2016;03;00;Lauantai;2;0;2;1;2;3
292;26.03.2016;2016;03;01;Lauantai;1;1;2;1;3;4
292;26.03.2016;2016;03;02;Lauantai;1;0;1;1;5;6
292;26.03.2016;2016;03;03;Lauantai;0;1;1;1;6;7
292;26.03.2016;2016;03;04;Lauantai;1;1;2;1;0;1
292;26.03.2016;2016;03;05;Lauantai;0;0;0;2;1;3
292;26.03.2016;2016;03;06;Lauantai;3;1;4;2;3;5
292;26.03.2016;2016;03;07;Lauantai;1;3;4;1;4;5
292;26.03.2016;2016;03;08;Lauantai;3;4;7;3;10;13
292;26.03.2016;2016;03;09;Lauantai;10;8;18;8;10;18
292;26.03.2016;2016;03;10;Lauantai;5;4;9;11;17;28
292;26.03.2016;2016;03;11;Lauantai;7;9;16;15;11;26
292;26.03.2016;2016;03;12;Lauantai;7;8;15;14;10;24
292;26.03.2016;2016;03;13;Lauantai;11;10;21;8;10;18
292;26.03.2016;2016;03;14;Lauantai;14;10;24;10;12;22
292;26.03.2016;2016;03;15;Lauantai;11;10;21;12;10;22
292;26.03.2016;2016;03;16;Lauantai;11;8;19;8;15;23
292;26.03.2016;2016;03;17;Lauantai;12;10;22;8;4;12
292;26.03.2016;2016;03;18;Lauantai;3;4;7;15;3;18
292;26.03.2016;2016;03;19;Lauantai;6;9;15;4;10;14
292;26.03.2016;2016;03;20;Lauantai;6;6;12;9;7;16
292;26.03.2016;2016;03;21;Lauantai;9;2;11;4;2;6
292;26.03.2016;2016;03;22;Lauantai;2;5;7;4;0;4
292;26.03.2016;2016;03;23;Lauantai;3;1;4;5;1;6
292;27.03.2016;2016;03;00;Sunnuntai;2;2;4;1;5;6
292;27.03.2016;2016;03;01;Sunnuntai;1;5;6;1;2;3
292;27.03.2016;2016;03;02;Sunnuntai;0;0;0;0;0;0
292;27.03.2016;2016;03;03;Sunnuntai;0;4;4;0;9;9
292;27.03.2016;2016;03;04;Sunnuntai;0;1;1;0;3;3
292;27.03.2016;2016;03;05;Sunnuntai;0;0;0;2;0;2
292;27.03.2016;2016;03;06;Sunnuntai;4;1;5;1;2;3
292;27.03.2016;2016;03;07;Sunnuntai;2;2;4;1;2;3
292;27.03.2016;2016;03;08;Sunnuntai;2;4;6;2;1;3
292;27.03.2016;2016;03;09;Sunnuntai;2;1;3;6;12;18
292;27.03.2016;2016;03;10;Sunnuntai;4;4;8;5;5;10
292;27.03.2016;2016;03;11;Sunnuntai;4;7;11;15;5;20
292;27.03.2016;2016;03;12;Sunnuntai;6;12;18;16;16;32
292;27.03.2016;2016;03;13;Sunnuntai;12;15;27;18;17;35
292;27.03.2016;2016;03;14;Sunnuntai;23;11;34;19;20;39
292;27.03.2016;2016;03;15;Sunnuntai;20;17;37;20;15;35
292;27.03.2016;2016;03;16;Sunnuntai;9;8;17;17;22;39
292;27.03.2016;2016;03;17;Sunnuntai;18;16;34;22;16;38
292;27.03.2016;2016;03;18;Sunnuntai;12;10;22;30;22;52
292;27.03.2016;2016;03;19;Sunnuntai;12;20;32;15;15;30
292;27.03.2016;2016;03;20;Sunnuntai;11;10;21;18;19;37
292;27.03.2016;2016;03;21;Sunnuntai;6;9;15;12;11;23
292;27.03.2016;2016;03;22;Sunnuntai;3;5;8;4;3;7
292;27.03.2016;2016;03;23;Sunnuntai;3;0;3;1;2;3
292;28.03.2016;2016;03;00;Maanantai;0;1;1;1;2;3
292;28.03.2016;2016;03;01;Maanantai;0;0;0;1;2;3
292;28.03.2016;2016;03;02;Maanantai;0;2;2;0;1;1
292;28.03.2016;2016;03;03;Maanantai;0;0;0;0;1;1
292;28.03.2016;2016;03;04;Maanantai;0;0;0;0;0;0
292;28.03.2016;2016;03;05;Maanantai;0;1;1;4;0;4
292;28.03.2016;2016;03;06;Maanantai;4;2;6;3;2;5
292;28.03.2016;2016;03;07;Maanantai;0;2;2;0;2;2
292;28.03.2016;2016;03;08;Maanantai;5;3;8;2;2;4
292;28.03.2016;2016;03;09;Maanantai;1;0;1;5;8;13
292;28.03.2016;2016;03;10;Maanantai;3;4;7;15;15;30
292;28.03.2016;2016;03;11;Maanantai;4;11;15;10;20;30
292;28.03.2016;2016;03;12;Maanantai;20;7;27;21;17;38
292;28.03.2016;2016;03;13;Maanantai;18;17;35;18;14;32
292;28.03.2016;2016;03;14;Maanantai;16;16;32;28;29;57
292;28.03.2016;2016;03;15;Maanantai;26;18;44;41;31;72
292;28.03.2016;2016;03;16;Maanantai;25;14;39;36;24;60
292;28.03.2016;2016;03;17;Maanantai;19;23;42;30;22;52
292;28.03.2016;2016;03;18;Maanantai;17;17;34;13;22;35
292;28.03.2016;2016;03;19;Maanantai;18;5;23;12;10;22
292;28.03.2016;2016;03;20;Maanantai;12;17;29;13;16;29
292;28.03.2016;2016;03;21;Maanantai;7;10;17;4;11;15
292;28.03.2016;2016;03;22;Maanantai;3;2;5;3;4;7
292;28.03.2016;2016;03;23;Maanantai;0;0;0;1;3;4
292;29.03.2016;2016;03;00;Tiistai;0;0;0;0;1;1
292;29.03.2016;2016;03;01;Tiistai;0;1;1;0;0;0
292;29.03.2016;2016;03;02;Tiistai;0;0;0;0;0;0
292;29.03.2016;2016;03;03;Tiistai;0;0;0;0;0;0
292;29.03.2016;2016;03;04;Tiistai;1;0;1;2;1;3
292;29.03.2016;2016;03;05;Tiistai;5;5;10;2;2;4
292;29.03.2016;2016;03;06;Tiistai;10;7;17;11;2;13
292;29.03.2016;2016;03;07;Tiistai;22;5;27;19;19;38
292;29.03.2016;2016;03;08;Tiistai;23;7;30;21;20;41
292;29.03.2016;2016;03;09;Tiistai;6;10;16;16;21;37
292;29.03.2016;2016;03;10;Tiistai;11;9;20;19;13;32
292;29.03.2016;2016;03;11;Tiistai;23;13;36;23;29;52
292;29.03.2016;2016;03;12;Tiistai;20;25;45;36;26;62
292;29.03.2016;2016;03;13;Tiistai;29;33;62;36;32;68
292;29.03.2016;2016;03;14;Tiistai;25;63;88;44;33;77
292;29.03.2016;2016;03;15;Tiistai;30;34;64;34;33;67
292;29.03.2016;2016;03;16;Tiistai;27;38;65;32;33;65
292;29.03.2016;2016;03;17;Tiistai;28;23;51;28;35;63
292;29.03.2016;2016;03;18;Tiistai;24;20;44;44;32;76
292;29.03.2016;2016;03;19;Tiistai;17;18;35;25;17;42
292;29.03.2016;2016;03;20;Tiistai;14;20;34;19;24;43
292;29.03.2016;2016;03;21;Tiistai;11;6;17;8;12;20
292;29.03.2016;2016;03;22;Tiistai;2;5;7;2;3;5
292;29.03.2016;2016;03;23;Tiistai;0;3;3;0;0;0
292;30.03.2016;2016;03;00;Keskiviikko;0;1;1;0;1;1
292;30.03.2016;2016;03;01;Keskiviikko;0;0;0;0;0;0
292;30.03.2016;2016;03;02;Keskiviikko;0;0;0;0;0;0
292;30.03.2016;2016;03;03;Keskiviikko;0;0;0;0;0;0
292;30.03.2016;2016;03;04;Keskiviikko;0;2;2;0;0;0
292;30.03.2016;2016;03;05;Keskiviikko;5;4;9;1;3;4
292;30.03.2016;2016;03;06;Keskiviikko;13;9;22;6;6;12
292;30.03.2016;2016;03;07;Keskiviikko;66;24;90;19;16;35
292;30.03.2016;2016;03;08;Keskiviikko;38;16;54;18;20;38
292;30.03.2016;2016;03;09;Keskiviikko;23;15;38;12;18;30
292;30.03.2016;2016;03;10;Keskiviikko;17;4;21;10;9;19
292;30.03.2016;2016;03;11;Keskiviikko;9;6;15;12;12;24
292;30.03.2016;2016;03;12;Keskiviikko;10;14;24;17;16;33
292;30.03.2016;2016;03;13;Keskiviikko;13;31;44;25;41;66
292;30.03.2016;2016;03;14;Keskiviikko;21;43;64;26;38;64
292;30.03.2016;2016;03;15;Keskiviikko;32;43;75;21;34;55
292;30.03.2016;2016;03;16;Keskiviikko;47;63;110;41;20;61
292;30.03.2016;2016;03;17;Keskiviikko;34;32;66;14;12;26
292;30.03.2016;2016;03;18;Keskiviikko;17;36;53;10;12;22
292;30.03.2016;2016;03;19;Keskiviikko;25;16;41;10;6;16
292;30.03.2016;2016;03;20;Keskiviikko;8;10;18;8;8;16
292;30.03.2016;2016;03;21;Keskiviikko;9;8;17;5;5;10
292;30.03.2016;2016;03;22;Keskiviikko;2;7;9;2;0;2
292;30.03.2016;2016;03;23;Keskiviikko;0;1;1;0;0;0
292;31.03.2016;2016;03;00;Torstai;0;0;0;0;0;0
292;31.03.2016;2016;03;01;Torstai;0;1;1;0;0;0
292;31.03.2016;2016;03;02;Torstai;0;2;2;0;0;0
292;31.03.2016;2016;03;03;Torstai;1;0;1;0;0;0
292;31.03.2016;2016;03;04;Torstai;1;0;1;1;0;1
292;31.03.2016;2016;03;05;Torstai;7;7;14;0;1;1
292;31.03.2016;2016;03;06;Torstai;20;9;29;5;8;13
292;31.03.2016;2016;03;07;Torstai;45;24;69;22;18;40
292;31.03.2016;2016;03;08;Torstai;36;20;56;20;15;35
292;31.03.2016;2016;03;09;Torstai;29;10;39;20;12;32
292;31.03.2016;2016;03;10;Torstai;7;17;24;7;15;22
292;31.03.2016;2016;03;11;Torstai;22;10;32;14;9;23
292;31.03.2016;2016;03;12;Torstai;17;14;31;11;16;27
292;31.03.2016;2016;03;13;Torstai;25;39;64;17;14;31
292;31.03.2016;2016;03;14;Torstai;43;51;94;22;22;44
292;31.03.2016;2016;03;15;Torstai;35;64;99;16;22;38
292;31.03.2016;2016;03;16;Torstai;37;51;88;15;18;33
292;31.03.2016;2016;03;17;Torstai;34;28;62;13;9;22
292;31.03.2016;2016;03;18;Torstai;34;35;69;15;8;23
292;31.03.2016;2016;03;19;Torstai;17;22;39;14;10;24
292;31.03.2016;2016;03;20;Torstai;15;21;36;7;11;18
292;31.03.2016;2016;03;21;Torstai;5;10;15;4;5;9
292;31.03.2016;2016;03;22;Torstai;1;4;5;2;0;2
292;31.03.2016;2016;03;23;Torstai;0;0;0;1;0;1
292;01.04.2016;2016;04;00;Perjantai;0;0;0;0;2;2
292;01.04.2016;2016;04;01;Perjantai;0;2;2;0;0;0
292;01.04.2016;2016;04;02;Perjantai;0;0;0;0;0;0
292;01.04.2016;2016;04;03;Perjantai;0;1;1;0;0;0
292;01.04.2016;2016;04;04;Perjantai;2;0;2;1;0;1
292;01.04.2016;2016;04;05;Perjantai;9;5;14;2;0;2
292;01.04.2016;2016;04;06;Perjantai;19;5;24;3;6;9
292;01.04.2016;2016;04;07;Perjantai;40;26;66;21;12;33
292;01.04.2016;2016;04;08;Perjantai;60;24;84;14;15;29
292;01.04.2016;2016;04;09;Perjantai;30;18;48;17;8;25
292;01.04.2016;2016;04;10;Perjantai;14;14;28;8;14;22
292;01.04.2016;2016;04;11;Perjantai;18;27;45;11;12;23
292;01.04.2016;2016;04;12;Perjantai;28;43;71;21;15;36
292;01.04.2016;2016;04;13;Perjantai;26;71;97;19;16;35
292;01.04.2016;2016;04;14;Perjantai;36;60;96;18;18;36
292;01.04.2016;2016;04;15;Perjantai;33;49;82;13;18;31
292;01.04.2016;2016;04;16;Perjantai;34;24;58;13;13;26
292;01.04.2016;2016;04;17;Perjantai;27;33;60;14;15;29
292;01.04.2016;2016;04;18;Perjantai;22;19;41;16;10;26
292;01.04.2016;2016;04;19;Perjantai;16;13;29;6;7;13
292;01.04.2016;2016;04;20;Perjantai;13;13;26;11;4;15
292;01.04.2016;2016;04;21;Perjantai;11;11;22;4;3;7
292;01.04.2016;2016;04;22;Perjantai;3;2;5;2;5;7
292;01.04.2016;2016;04;23;Perjantai;1;3;4;2;1;3
292;02.04.2016;2016;04;00;Lauantai;0;2;2;0;2;2
292;02.04.2016;2016;04;01;Lauantai;1;3;4;1;0;1
292;02.04.2016;2016;04;02;Lauantai;1;1;2;2;2;4
292;02.04.2016;2016;04;03;Lauantai;0;1;1;0;1;1
292;02.04.2016;2016;04;04;Lauantai;1;0;1;0;0;0
292;02.04.2016;2016;04;05;Lauantai;2;2;4;2;1;3
292;02.04.2016;2016;04;06;Lauantai;6;0;6;2;2;4
292;02.04.2016;2016;04;07;Lauantai;0;4;4;0;1;1
292;02.04.2016;2016;04;08;Lauantai;4;10;14;1;6;7
292;02.04.2016;2016;04;09;Lauantai;11;14;25;2;7;9
292;02.04.2016;2016;04;10;Lauantai;20;22;42;8;11;19
292;02.04.2016;2016;04;11;Lauantai;13;27;40;14;15;29
292;02.04.2016;2016;04;12;Lauantai;17;29;46;9;13;22
292;02.04.2016;2016;04;13;Lauantai;34;26;60;11;11;22
292;02.04.2016;2016;04;14;Lauantai;26;13;39;11;8;19
292;02.04.2016;2016;04;15;Lauantai;26;19;45;16;7;23
292;02.04.2016;2016;04;16;Lauantai;19;16;35;16;5;21
292;02.04.2016;2016;04;17;Lauantai;14;12;26;9;9;18
292;02.04.2016;2016;04;18;Lauantai;14;11;25;11;11;22
292;02.04.2016;2016;04;19;Lauantai;14;15;29;6;8;14
292;02.04.2016;2016;04;20;Lauantai;13;17;30;8;10;18
292;02.04.2016;2016;04;21;Lauantai;5;0;5;10;5;15
292;02.04.2016;2016;04;22;Lauantai;9;3;12;1;1;2
292;02.04.2016;2016;04;23;Lauantai;0;2;2;0;1;1
292;03.04.2016;2016;04;00;Sunnuntai;2;2;4;2;0;2
292;03.04.2016;2016;04;01;Sunnuntai;2;1;3;0;2;2
292;03.04.2016;2016;04;02;Sunnuntai;0;4;4;1;3;4
292;03.04.2016;2016;04;03;Sunnuntai;0;1;1;0;2;2
292;03.04.2016;2016;04;04;Sunnuntai;0;1;1;0;0;0
292;03.04.2016;2016;04;05;Sunnuntai;0;0;0;1;2;3
292;03.04.2016;2016;04;06;Sunnuntai;4;0;4;1;0;1
292;03.04.2016;2016;04;07;Sunnuntai;0;1;1;1;1;2
292;03.04.2016;2016;04;08;Sunnuntai;2;5;7;6;3;9
292;03.04.2016;2016;04;09;Sunnuntai;10;5;15;7;10;17
292;03.04.2016;2016;04;10;Sunnuntai;18;12;30;5;10;15
292;03.04.2016;2016;04;11;Sunnuntai;30;29;59;12;16;28
292;03.04.2016;2016;04;12;Sunnuntai;47;39;86;15;19;34
292;03.04.2016;2016;04;13;Sunnuntai;39;42;81;16;25;41
292;03.04.2016;2016;04;14;Sunnuntai;40;41;81;6;13;19
292;03.04.2016;2016;04;15;Sunnuntai;38;36;74;16;8;24
292;03.04.2016;2016;04;16;Sunnuntai;45;34;79;23;17;40
292;03.04.2016;2016;04;17;Sunnuntai;53;41;94;25;14;39
292;03.04.2016;2016;04;18;Sunnuntai;44;41;85;17;19;36
292;03.04.2016;2016;04;19;Sunnuntai;27;37;64;17;18;35
292;03.04.2016;2016;04;20;Sunnuntai;15;21;36;5;8;13
292;03.04.2016;2016;04;21;Sunnuntai;5;13;18;2;4;6
292;03.04.2016;2016;04;22;Sunnuntai;2;5;7;2;1;3
292;03.04.2016;2016;04;23;Sunnuntai;0;3;3;0;0;0
292;04.04.2016;2016;04;00;Maanantai;0;0;0;0;0;0
292;04.04.2016;2016;04;01;Maanantai;0;0;0;0;0;0
292;04.04.2016;2016;04;02;Maanantai;0;1;1;0;0;0
292;04.04.2016;2016;04;03;Maanantai;0;0;0;0;0;0
292;04.04.2016;2016;04;04;Maanantai;1;0;1;2;0;2
292;04.04.2016;2016;04;05;Maanantai;8;4;12;1;3;4
292;04.04.2016;2016;04;06;Maanantai;19;12;31;6;1;7
292;04.04.2016;2016;04;07;Maanantai;61;23;84;20;12;32
292;04.04.2016;2016;04;08;Maanantai;47;24;71;13;11;24
292;04.04.2016;2016;04;09;Maanantai;39;20;59;13;15;28
292;04.04.2016;2016;04;10;Maanantai;30;20;50;17;8;25
292;04.04.2016;2016;04;11;Maanantai;30;30;60;6;17;23
292;04.04.2016;2016;04;12;Maanantai;26;32;58;15;10;25
292;04.04.2016;2016;04;13;Maanantai;22;60;82;12;17;29
292;04.04.2016;2016;04;14;Maanantai;36;51;87;7;12;19
292;04.04.2016;2016;04;15;Maanantai;43;73;116;22;21;43
292;04.04.2016;2016;04;16;Maanantai;45;73;118;16;28;44
292;04.04.2016;2016;04;17;Maanantai;47;35;82;20;15;35
292;04.04.2016;2016;04;18;Maanantai;43;30;73;22;27;49
292;04.04.2016;2016;04;19;Maanantai;33;27;60;13;12;25
292;04.04.2016;2016;04;20;Maanantai;16;19;35;12;6;18
292;04.04.2016;2016;04;21;Maanantai;5;11;16;4;6;10
292;04.04.2016;2016;04;22;Maanantai;1;2;3;1;3;4
292;04.04.2016;2016;04;23;Maanantai;1;2;3;1;1;2
292;05.04.2016;2016;04;00;Tiistai;0;0;0;0;0;0
292;05.04.2016;2016;04;01;Tiistai;0;0;0;0;0;0
292;05.04.2016;2016;04;02;Tiistai;0;1;1;0;0;0
292;05.04.2016;2016;04;03;Tiistai;0;0;0;0;0;0
292;05.04.2016;2016;04;04;Tiistai;1;0;1;1;0;1
292;05.04.2016;2016;04;05;Tiistai;10;4;14;0;1;1
292;05.04.2016;2016;04;06;Tiistai;15;15;30;3;1;4
292;05.04.2016;2016;04;07;Tiistai;42;27;69;12;5;17
292;05.04.2016;2016;04;08;Tiistai;49;18;67;17;7;24
292;05.04.2016;2016;04;09;Tiistai;16;21;37;15;9;24
292;05.04.2016;2016;04;10;Tiistai;12;31;43;6;11;17
292;05.04.2016;2016;04;11;Tiistai;16;25;41;13;7;20
292;05.04.2016;2016;04;12;Tiistai;18;20;38;9;13;22
292;05.04.2016;2016;04;13;Tiistai;12;33;45;12;13;25
292;05.04.2016;2016;04;14;Tiistai;20;27;47;13;6;19
292;05.04.2016;2016;04;15;Tiistai;29;18;47;8;11;19
292;05.04.2016;2016;04;16;Tiistai;23;29;52;10;10;20
292;05.04.2016;2016;04;17;Tiistai;25;19;44;7;11;18
292;05.04.2016;2016;04;18;Tiistai;17;20;37;12;13;25
292;05.04.2016;2016;04;19;Tiistai;15;13;28;11;6;17
292;05.04.2016;2016;04;20;Tiistai;17;15;32;9;6;15
292;05.04.2016;2016;04;21;Tiistai;10;8;18;7;2;9
292;05.04.2016;2016;04;22;Tiistai;4;3;7;1;3;4
292;05.04.2016;2016;04;23;Tiistai;4;3;7;0;0;0
292;06.04.2016;2016;04;00;Keskiviikko;0;0;0;0;0;0
292;06.04.2016;2016;04;01;Keskiviikko;0;0;0;0;1;1
292;06.04.2016;2016;04;02;Keskiviikko;0;0;0;0;0;0
292;06.04.2016;2016;04;03;Keskiviikko;0;0;0;0;0;0
292;06.04.2016;2016;04;04;Keskiviikko;1;0;1;1;0;1
292;06.04.2016;2016;04;05;Keskiviikko;7;3;10;1;0;1
292;06.04.2016;2016;04;06;Keskiviikko;17;15;32;3;6;9
292;06.04.2016;2016;04;07;Keskiviikko;62;23;85;14;10;24
292;06.04.2016;2016;04;08;Keskiviikko;49;17;66;10;10;20
292;06.04.2016;2016;04;09;Keskiviikko;10;19;29;23;7;30
292;06.04.2016;2016;04;10;Keskiviikko;16;25;41;7;15;22
292;06.04.2016;2016;04;11;Keskiviikko;19;25;44;9;11;20
292;06.04.2016;2016;04;12;Keskiviikko;29;22;51;18;18;36
292;06.04.2016;2016;04;13;Keskiviikko;17;56;73;12;23;35
292;06.04.2016;2016;04;14;Keskiviikko;24;22;46;19;18;37
292;06.04.2016;2016;04;15;Keskiviikko;31;41;72;17;9;26
292;06.04.2016;2016;04;16;Keskiviikko;29;31;60;8;11;19
292;06.04.2016;2016;04;17;Keskiviikko;13;19;32;5;9;14
292;06.04.2016;2016;04;18;Keskiviikko;21;20;41;4;1;5
292;06.04.2016;2016;04;19;Keskiviikko;8;7;15;3;3;6
292;06.04.2016;2016;04;20;Keskiviikko;9;11;20;4;1;5
292;06.04.2016;2016;04;21;Keskiviikko;6;12;18;2;0;2
292;06.04.2016;2016;04;22;Keskiviikko;1;6;7;3;2;5
292;06.04.2016;2016;04;23;Keskiviikko;0;2;2;0;3;3
292;07.04.2016;2016;04;00;Torstai;1;0;1;0;0;0
292;07.04.2016;2016;04;01;Torstai;1;0;1;0;0;0
292;07.04.2016;2016;04;02;Torstai;0;0;0;0;0;0
292;07.04.2016;2016;04;03;Torstai;0;0;0;1;0;1
292;07.04.2016;2016;04;04;Torstai;2;0;2;0;0;0
292;07.04.2016;2016;04;05;Torstai;6;5;11;2;0;2
292;07.04.2016;2016;04;06;Torstai;16;10;26;1;3;4
292;07.04.2016;2016;04;07;Torstai;66;28;94;14;12;26
292;07.04.2016;2016;04;08;Torstai;55;22;77;12;10;22
292;07.04.2016;2016;04;09;Torstai;27;27;54;9;11;20
292;07.04.2016;2016;04;10;Torstai;25;36;61;5;10;15
292;07.04.2016;2016;04;11;Torstai;11;23;34;13;11;24
292;07.04.2016;2016;04;12;Torstai;23;33;56;12;10;22
292;07.04.2016;2016;04;13;Torstai;26;36;62;14;22;36
292;07.04.2016;2016;04;14;Torstai;22;45;67;14;14;28
292;07.04.2016;2016;04;15;Torstai;39;51;90;13;14;27
292;07.04.2016;2016;04;16;Torstai;44;40;84;18;14;32
292;07.04.2016;2016;04;17;Torstai;30;31;61;13;11;24
292;07.04.2016;2016;04;18;Torstai;30;19;49;18;7;25
292;07.04.2016;2016;04;19;Torstai;14;22;36;10;22;32
292;07.04.2016;2016;04;20;Torstai;17;14;31;9;7;16
292;07.04.2016;2016;04;21;Torstai;7;7;14;7;1;8
292;07.04.2016;2016;04;22;Torstai;1;1;2;0;3;3
292;07.04.2016;2016;04;23;Torstai;0;1;1;0;0;0
292;08.04.2016;2016;04;00;Perjantai;0;0;0;2;4;6
292;08.04.2016;2016;04;01;Perjantai;0;1;1;0;0;0
292;08.04.2016;2016;04;02;Perjantai;0;0;0;0;0;0
292;08.04.2016;2016;04;03;Perjantai;0;1;1;1;0;1
292;08.04.2016;2016;04;04;Perjantai;2;0;2;0;0;0
292;08.04.2016;2016;04;05;Perjantai;7;5;12;3;1;4
292;08.04.2016;2016;04;06;Perjantai;14;11;25;5;2;7
292;08.04.2016;2016;04;07;Perjantai;54;32;86;15;11;26
292;08.04.2016;2016;04;08;Perjantai;59;22;81;11;9;20
292;08.04.2016;2016;04;09;Perjantai;21;20;41;9;9;18
292;08.04.2016;2016;04;10;Perjantai;16;31;47;5;6;11
292;08.04.2016;2016;04;11;Perjantai;21;22;43;6;10;16
292;08.04.2016;2016;04;12;Perjantai;22;32;54;13;9;22
292;08.04.2016;2016;04;13;Perjantai;34;54;88;9;16;25
292;08.04.2016;2016;04;14;Perjantai;37;62;99;16;16;32
292;08.04.2016;2016;04;15;Perjantai;45;45;90;13;12;25
292;08.04.2016;2016;04;16;Perjantai;40;26;66;13;11;24
292;08.04.2016;2016;04;17;Perjantai;24;26;50;13;13;26
292;08.04.2016;2016;04;18;Perjantai;31;20;51;5;14;19
292;08.04.2016;2016;04;19;Perjantai;30;25;55;10;9;19
292;08.04.2016;2016;04;20;Perjantai;22;13;35;8;8;16
292;08.04.2016;2016;04;21;Perjantai;9;19;28;5;8;13
292;08.04.2016;2016;04;22;Perjantai;4;8;12;7;2;9
292;08.04.2016;2016;04;23;Perjantai;1;6;7;4;1;5
292;09.04.2016;2016;04;00;Lauantai;2;0;2;2;1;3
292;09.04.2016;2016;04;01;Lauantai;3;1;4;2;3;5
292;09.04.2016;2016;04;02;Lauantai;1;3;4;0;2;2
292;09.04.2016;2016;04;03;Lauantai;0;1;1;0;3;3
292;09.04.2016;2016;04;04;Lauantai;0;1;1;1;0;1
292;09.04.2016;2016;04;05;Lauantai;1;0;1;2;3;5
292;09.04.2016;2016;04;06;Lauantai;6;2;8;1;4;5
292;09.04.2016;2016;04;07;Lauantai;3;6;9;6;3;9
292;09.04.2016;2016;04;08;Lauantai;10;13;23;6;6;12
292;09.04.2016;2016;04;09;Lauantai;15;22;37;13;12;25
292;09.04.2016;2016;04;10;Lauantai;25;39;64;4;9;13
292;09.04.2016;2016;04;11;Lauantai;42;32;74;13;20;33
292;09.04.2016;2016;04;12;Lauantai;45;39;84;22;12;34
292;09.04.2016;2016;04;13;Lauantai;36;45;81;13;18;31
292;09.04.2016;2016;04;14;Lauantai;34;39;73;13;6;19
292;09.04.2016;2016;04;15;Lauantai;42;30;72;17;9;26
292;09.04.2016;2016;04;16;Lauantai;42;23;65;14;12;26
292;09.04.2016;2016;04;17;Lauantai;29;24;53;14;9;23
292;09.04.2016;2016;04;18;Lauantai;28;24;52;20;10;30
292;09.04.2016;2016;04;19;Lauantai;16;22;38;11;6;17
292;09.04.2016;2016;04;20;Lauantai;18;16;34;7;11;18
292;09.04.2016;2016;04;21;Lauantai;12;17;29;5;11;16
292;09.04.2016;2016;04;22;Lauantai;0;10;10;1;1;2
292;09.04.2016;2016;04;23;Lauantai;1;3;4;7;1;8
292;10.04.2016;2016;04;00;Sunnuntai;1;1;2;6;0;6
292;10.04.2016;2016;04;01;Sunnuntai;1;2;3;2;0;2
292;10.04.2016;2016;04;02;Sunnuntai;2;1;3;3;3;6
292;10.04.2016;2016;04;03;Sunnuntai;1;2;3;0;0;0
292;10.04.2016;2016;04;04;Sunnuntai;0;1;1;1;0;1
292;10.04.2016;2016;04;05;Sunnuntai;0;0;0;1;2;3
292;10.04.2016;2016;04;06;Sunnuntai;5;2;7;0;0;0
292;10.04.2016;2016;04;07;Sunnuntai;3;3;6;3;2;5
292;10.04.2016;2016;04;08;Sunnuntai;4;5;9;5;3;8
292;10.04.2016;2016;04;09;Sunnuntai;13;7;20;12;9;21
292;10.04.2016;2016;04;10;Sunnuntai;26;13;39;18;15;33
292;10.04.2016;2016;04;11;Sunnuntai;33;39;72;17;24;41
292;10.04.2016;2016;04;12;Sunnuntai;35;54;89;17;19;36
292;10.04.2016;2016;04;13;Sunnuntai;34;36;70;15;16;31
292;10.04.2016;2016;04;14;Sunnuntai;55;36;91;18;14;32
292;10.04.2016;2016;04;15;Sunnuntai;45;29;74;18;13;31
292;10.04.2016;2016;04;16;Sunnuntai;44;41;85;21;10;31
292;10.04.2016;2016;04;17;Sunnuntai;35;34;69;14;20;34
292;10.04.2016;2016;04;18;Sunnuntai;30;26;56;19;14;33
292;10.04.2016;2016;04;19;Sunnuntai;21;33;54;9;14;23
292;10.04.2016;2016;04;20;Sunnuntai;17;15;32;8;2;10
292;10.04.2016;2016;04;21;Sunnuntai;9;8;17;9;7;16
292;10.04.2016;2016;04;22;Sunnuntai;1;4;5;1;1;2
292;10.04.2016;2016;04;23;Sunnuntai;2;1;3;0;2;2
292;11.04.2016;2016;04;00;Maanantai;2;1;3;0;1;1
292;11.04.2016;2016;04;01;Maanantai;0;3;3;0;0;0
292;11.04.2016;2016;04;02;Maanantai;0;0;0;1;0;1
292;11.04.2016;2016;04;03;Maanantai;0;0;0;0;0;0
292;11.04.2016;2016;04;04;Maanantai;0;2;2;2;0;2
292;11.04.2016;2016;04;05;Maanantai;8;3;11;0;1;1
292;11.04.2016;2016;04;06;Maanantai;25;15;40;2;3;5
292;11.04.2016;2016;04;07;Maanantai;75;25;100;15;17;32
292;11.04.2016;2016;04;08;Maanantai;59;25;84;8;9;17
292;11.04.2016;2016;04;09;Maanantai;17;28;45;10;5;15
292;11.04.2016;2016;04;10;Maanantai;30;27;57;7;3;10
292;11.04.2016;2016;04;11;Maanantai;31;38;69;16;13;29
292;11.04.2016;2016;04;12;Maanantai;36;49;85;16;15;31
292;11.04.2016;2016;04;13;Maanantai;32;43;75;16;17;33
292;11.04.2016;2016;04;14;Maanantai;33;55;88;8;20;28
292;11.04.2016;2016;04;15;Maanantai;50;74;124;20;14;34
292;11.04.2016;2016;04;16;Maanantai;60;58;118;25;24;49
292;11.04.2016;2016;04;17;Maanantai;36;38;74;15;14;29
292;11.04.2016;2016;04;18;Maanantai;42;40;82;21;21;42
292;11.04.2016;2016;04;19;Maanantai;33;23;56;15;12;27
292;11.04.2016;2016;04;20;Maanantai;16;30;46;10;14;24
292;11.04.2016;2016;04;21;Maanantai;10;14;24;3;2;5
292;11.04.2016;2016;04;22;Maanantai;2;3;5;1;1;2
292;11.04.2016;2016;04;23;Maanantai;1;1;2;0;0;0
292;12.04.2016;2016;04;00;Tiistai;0;0;0;0;1;1
292;12.04.2016;2016;04;01;Tiistai;0;0;0;0;0;0
292;12.04.2016;2016;04;02;Tiistai;0;1;1;1;0;1
292;12.04.2016;2016;04;03;Tiistai;0;0;0;1;0;1
292;12.04.2016;2016;04;04;Tiistai;3;1;4;1;0;1
292;12.04.2016;2016;04;05;Tiistai;5;5;10;2;3;5
292;12.04.2016;2016;04;06;Tiistai;29;11;40;5;7;12
292;12.04.2016;2016;04;07;Tiistai;59;34;93;24;15;39
292;12.04.2016;2016;04;08;Tiistai;63;18;81;19;9;28
292;12.04.2016;2016;04;09;Tiistai;16;22;38;14;9;23
292;12.04.2016;2016;04;10;Tiistai;33;36;69;9;11;20
292;12.04.2016;2016;04;11;Tiistai;19;46;65;9;15;24
292;12.04.2016;2016;04;12;Tiistai;31;39;70;26;4;30
292;12.04.2016;2016;04;13;Tiistai;38;50;88;26;20;46
292;12.04.2016;2016;04;14;Tiistai;55;75;130;9;23;32
292;12.04.2016;2016;04;15;Tiistai;50;66;116;17;17;34
292;12.04.2016;2016;04;16;Tiistai;64;56;120;24;29;53
292;12.04.2016;2016;04;17;Tiistai;47;50;97;13;15;28
292;12.04.2016;2016;04;18;Tiistai;29;37;66;12;21;33
292;12.04.2016;2016;04;19;Tiistai;25;24;49;9;8;17
292;12.04.2016;2016;04;20;Tiistai;18;16;34;9;5;14
292;12.04.2016;2016;04;21;Tiistai;3;13;16;5;2;7
292;12.04.2016;2016;04;22;Tiistai;1;3;4;2;0;2
292;12.04.2016;2016;04;23;Tiistai;1;1;2;1;1;2
292;13.04.2016;2016;04;00;Keskiviikko;1;0;1;0;0;0
292;13.04.2016;2016;04;01;Keskiviikko;1;1;2;0;0;0
292;13.04.2016;2016;04;02;Keskiviikko;1;1;2;0;0;0
292;13.04.2016;2016;04;03;Keskiviikko;0;0;0;0;0;0
292;13.04.2016;2016;04;04;Keskiviikko;2;0;2;2;0;2
292;13.04.2016;2016;04;05;Keskiviikko;7;7;14;1;1;2
292;13.04.2016;2016;04;06;Keskiviikko;20;14;34;4;6;10
292;13.04.2016;2016;04;07;Keskiviikko;86;29;115;22;15;37
292;13.04.2016;2016;04;08;Keskiviikko;62;33;95;18;5;23
292;13.04.2016;2016;04;09;Keskiviikko;33;36;69;16;13;29
292;13.04.2016;2016;04;10;Keskiviikko;30;24;54;11;11;22
292;13.04.2016;2016;04;11;Keskiviikko;23;23;46;11;15;26
292;13.04.2016;2016;04;12;Keskiviikko;38;21;59;8;8;16
292;13.04.2016;2016;04;13;Keskiviikko;25;98;123;10;17;27
292;13.04.2016;2016;04;14;Keskiviikko;28;55;83;7;8;15
292;13.04.2016;2016;04;15;Keskiviikko;38;52;90;9;13;22
292;13.04.2016;2016;04;16;Keskiviikko;45;49;94;10;18;28
292;13.04.2016;2016;04;17;Keskiviikko;36;18;54;9;10;19
292;13.04.2016;2016;04;18;Keskiviikko;17;22;39;11;15;26
292;13.04.2016;2016;04;19;Keskiviikko;31;18;49;4;6;10
292;13.04.2016;2016;04;20;Keskiviikko;19;23;42;5;4;9
292;13.04.2016;2016;04;21;Keskiviikko;10;10;20;3;4;7
292;13.04.2016;2016;04;22;Keskiviikko;1;7;8;2;1;3
292;13.04.2016;2016;04;23;Keskiviikko;0;0;0;2;1;3
292;14.04.2016;2016;04;00;Torstai;0;1;1;0;0;0
292;14.04.2016;2016;04;01;Torstai;0;0;0;1;0;1
292;14.04.2016;2016;04;02;Torstai;0;0;0;0;1;1
292;14.04.2016;2016;04;03;Torstai;0;0;0;3;0;3
292;14.04.2016;2016;04;04;Torstai;3;1;4;0;0;0
292;14.04.2016;2016;04;05;Torstai;7;5;12;1;2;3
292;14.04.2016;2016;04;06;Torstai;14;13;27;3;8;11
292;14.04.2016;2016;04;07;Torstai;68;22;90;14;13;27
292;14.04.2016;2016;04;08;Torstai;32;28;60;16;9;25
292;14.04.2016;2016;04;09;Torstai;55;20;75;13;11;24
292;14.04.2016;2016;04;10;Torstai;24;19;43;15;4;19
292;14.04.2016;2016;04;11;Torstai;20;25;45;15;7;22
292;14.04.2016;2016;04;12;Torstai;23;33;56;11;20;31
292;14.04.2016;2016;04;13;Torstai;44;54;98;13;17;30
292;14.04.2016;2016;04;14;Torstai;41;68;109;8;15;23
292;14.04.2016;2016;04;15;Torstai;46;66;112;18;22;40
292;14.04.2016;2016;04;16;Torstai;46;54;100;19;23;42
292;14.04.2016;2016;04;17;Torstai;35;44;79;13;11;24
292;14.04.2016;2016;04;18;Torstai;38;37;75;13;9;22
292;14.04.2016;2016;04;19;Torstai;21;19;40;20;23;43
292;14.04.2016;2016;04;20;Torstai;22;25;47;4;11;15
292;14.04.2016;2016;04;21;Torstai;11;17;28;3;1;4
292;14.04.2016;2016;04;22;Torstai;4;6;10;1;1;2
292;14.04.2016;2016;04;23;Torstai;3;1;4;1;0;1
292;15.04.2016;2016;04;00;Perjantai;0;0;0;0;0;0
292;15.04.2016;2016;04;01;Perjantai;0;1;1;0;0;0
292;15.04.2016;2016;04;02;Perjantai;0;0;0;0;0;0
292;15.04.2016;2016;04;03;Perjantai;0;0;0;1;0;1
292;15.04.2016;2016;04;04;Perjantai;4;0;4;0;0;0
292;15.04.2016;2016;04;05;Perjantai;7;7;14;3;3;6
292;15.04.2016;2016;04;06;Perjantai;15;6;21;1;4;5
292;15.04.2016;2016;04;07;Perjantai;58;25;83;15;10;25
292;15.04.2016;2016;04;08;Perjantai;58;19;77;14;12;26
292;15.04.2016;2016;04;09;Perjantai;36;18;54;5;6;11
292;15.04.2016;2016;04;10;Perjantai;24;18;42;8;6;14
292;15.04.2016;2016;04;11;Perjantai;11;31;42;10;13;23
292;15.04.2016;2016;04;12;Perjantai;35;44;79;11;10;21
292;15.04.2016;2016;04;13;Perjantai;50;84;134;20;23;43
292;15.04.2016;2016;04;14;Perjantai;41;77;118;11;13;24
292;15.04.2016;2016;04;15;Perjantai;41;48;89;13;16;29
292;15.04.2016;2016;04;16;Perjantai;46;40;86;8;10;18
292;15.04.2016;2016;04;17;Perjantai;39;25;64;11;15;26
292;15.04.2016;2016;04;18;Perjantai;49;42;91;12;13;25
292;15.04.2016;2016;04;19;Perjantai;30;31;61;7;10;17
292;15.04.2016;2016;04;20;Perjantai;26;27;53;9;7;16
292;15.04.2016;2016;04;21;Perjantai;22;17;39;4;7;11
292;15.04.2016;2016;04;22;Perjantai;8;6;14;6;4;10
292;15.04.2016;2016;04;23;Perjantai;4;1;5;0;2;2
292;16.04.2016;2016;04;00;Lauantai;2;1;3;1;0;1
292;16.04.2016;2016;04;01;Lauantai;2;2;4;3;2;5
292;16.04.2016;2016;04;02;Lauantai;2;3;5;0;3;3
292;16.04.2016;2016;04;03;Lauantai;0;1;1;0;2;2
292;16.04.2016;2016;04;04;Lauantai;0;2;2;0;0;0
292;16.04.2016;2016;04;05;Lauantai;1;0;1;0;0;0
292;16.04.2016;2016;04;06;Lauantai;8;2;10;1;1;2
292;16.04.2016;2016;04;07;Lauantai;4;7;11;0;1;1
292;16.04.2016;2016;04;08;Lauantai;11;8;19;5;2;7
292;16.04.2016;2016;04;09;Lauantai;17;19;36;7;7;14
292;16.04.2016;2016;04;10;Lauantai;25;21;46;5;7;12
292;16.04.2016;2016;04;11;Lauantai;23;28;51;12;22;34
292;16.04.2016;2016;04;12;Lauantai;27;33;60;10;18;28
292;16.04.2016;2016;04;13;Lauantai;45;45;90;11;2;13
292;16.04.2016;2016;04;14;Lauantai;46;52;98;11;12;23
292;16.04.2016;2016;04;15;Lauantai;23;23;46;10;4;14
292;16.04.2016;2016;04;16;Lauantai;16;12;28;10;8;18
292;16.04.2016;2016;04;17;Lauantai;17;21;38;5;5;10
292;16.04.2016;2016;04;18;Lauantai;23;21;44;9;10;19
292;16.04.2016;2016;04;19;Lauantai;21;20;41;9;6;15
292;16.04.2016;2016;04;20;Lauantai;21;8;29;10;5;15
292;16.04.2016;2016;04;21;Lauantai;9;9;18;3;4;7
292;16.04.2016;2016;04;22;Lauantai;4;6;10;6;1;7
292;16.04.2016;2016;04;23;Lauantai;2;2;4;3;0;3
292;17.04.2016;2016;04;00;Sunnuntai;0;3;3;2;1;3
292;17.04.2016;2016;04;01;Sunnuntai;1;1;2;0;3;3
292;17.04.2016;2016;04;02;Sunnuntai;0;1;1;3;5;8
292;17.04.2016;2016;04;03;Sunnuntai;0;2;2;0;3;3
292;17.04.2016;2016;04;04;Sunnuntai;0;2;2;0;0;0
292;17.04.2016;2016;04;05;Sunnuntai;0;3;3;0;0;0
292;17.04.2016;2016;04;06;Sunnuntai;4;5;9;0;0;0
292;17.04.2016;2016;04;07;Sunnuntai;5;2;7;1;1;2
292;17.04.2016;2016;04;08;Sunnuntai;1;4;5;3;1;4
292;17.04.2016;2016;04;09;Sunnuntai;5;3;8;5;3;8
292;17.04.2016;2016;04;10;Sunnuntai;12;5;17;1;4;5
292;17.04.2016;2016;04;11;Sunnuntai;13;17;30;10;4;14
292;17.04.2016;2016;04;12;Sunnuntai;20;23;43;10;11;21
292;17.04.2016;2016;04;13;Sunnuntai;18;20;38;12;10;22
292;17.04.2016;2016;04;14;Sunnuntai;20;25;45;8;11;19
292;17.04.2016;2016;04;15;Sunnuntai;24;16;40;15;8;23
292;17.04.2016;2016;04;16;Sunnuntai;23;26;49;8;15;23
292;17.04.2016;2016;04;17;Sunnuntai;24;27;51;8;9;17
292;17.04.2016;2016;04;18;Sunnuntai;23;9;32;7;10;17
292;17.04.2016;2016;04;19;Sunnuntai;14;15;29;10;12;22
292;17.04.2016;2016;04;20;Sunnuntai;12;6;18;6;3;9
292;17.04.2016;2016;04;21;Sunnuntai;7;7;14;3;2;5
292;17.04.2016;2016;04;22;Sunnuntai;2;4;6;1;1;2
292;17.04.2016;2016;04;23;Sunnuntai;0;1;1;3;0;3
292;18.04.2016;2016;04;00;Maanantai;1;0;1;0;0;0
292;18.04.2016;2016;04;01;Maanantai;0;1;1;1;4;5
292;18.04.2016;2016;04;02;Maanantai;0;0;0;0;0;0
292;18.04.2016;2016;04;03;Maanantai;0;0;0;1;0;1
292;18.04.2016;2016;04;04;Maanantai;5;0;5;0;0;0
292;18.04.2016;2016;04;05;Maanantai;10;5;15;1;1;2
292;18.04.2016;2016;04;06;Maanantai;18;17;35;3;3;6
292;18.04.2016;2016;04;07;Maanantai;64;29;93;14;12;26
292;18.04.2016;2016;04;08;Maanantai;32;21;53;11;9;20
292;18.04.2016;2016;04;09;Maanantai;45;28;73;12;7;19
292;18.04.2016;2016;04;10;Maanantai;25;14;39;10;5;15
292;18.04.2016;2016;04;11;Maanantai;29;29;58;5;12;17
292;18.04.2016;2016;04;12;Maanantai;28;26;54;8;6;14
292;18.04.2016;2016;04;13;Maanantai;28;58;86;12;13;25
292;18.04.2016;2016;04;14;Maanantai;44;55;99;9;16;25
292;18.04.2016;2016;04;15;Maanantai;45;56;101;20;20;40
292;18.04.2016;2016;04;16;Maanantai;44;62;106;17;20;37
292;18.04.2016;2016;04;17;Maanantai;36;36;72;13;10;23
292;18.04.2016;2016;04;18;Maanantai;41;38;79;19;14;33
292;18.04.2016;2016;04;19;Maanantai;23;26;49;6;10;16
292;18.04.2016;2016;04;20;Maanantai;17;25;42;7;8;15
292;18.04.2016;2016;04;21;Maanantai;11;20;31;3;2;5
292;18.04.2016;2016;04;22;Maanantai;0;3;3;2;2;4
292;18.04.2016;2016;04;23;Maanantai;0;0;0;0;0;0
292;19.04.2016;2016;04;00;Tiistai;0;0;0;0;0;0
292;19.04.2016;2016;04;01;Tiistai;0;0;0;0;0;0
292;19.04.2016;2016;04;02;Tiistai;2;0;2;0;0;0
292;19.04.2016;2016;04;03;Tiistai;0;2;2;0;0;0
292;19.04.2016;2016;04;04;Tiistai;3;0;3;1;0;1
292;19.04.2016;2016;04;05;Tiistai;11;6;17;0;0;0
292;19.04.2016;2016;04;06;Tiistai;21;14;35;2;3;5
292;19.04.2016;2016;04;07;Tiistai;63;34;97;16;9;25
292;19.04.2016;2016;04;08;Tiistai;67;27;94;10;10;20
292;19.04.2016;2016;04;09;Tiistai;35;29;64;11;11;22
292;19.04.2016;2016;04;10;Tiistai;33;20;53;4;9;13
292;19.04.2016;2016;04;11;Tiistai;20;30;50;7;6;13
292;19.04.2016;2016;04;12;Tiistai;26;33;59;9;11;20
292;19.04.2016;2016;04;13;Tiistai;26;37;63;7;12;19
292;19.04.2016;2016;04;14;Tiistai;34;95;129;12;16;28
292;19.04.2016;2016;04;15;Tiistai;43;53;96;18;14;32
292;19.04.2016;2016;04;16;Tiistai;44;40;84;9;15;24
292;19.04.2016;2016;04;17;Tiistai;21;28;49;10;6;16
292;19.04.2016;2016;04;18;Tiistai;20;17;37;6;2;8
292;19.04.2016;2016;04;19;Tiistai;17;6;23;3;4;7
292;19.04.2016;2016;04;20;Tiistai;15;16;31;2;3;5
292;19.04.2016;2016;04;21;Tiistai;5;4;9;2;1;3
292;19.04.2016;2016;04;22;Tiistai;1;2;3;0;0;0
292;19.04.2016;2016;04;23;Tiistai;2;0;2;0;0;0
292;20.04.2016;2016;04;00;Keskiviikko;0;0;0;2;0;2
292;20.04.2016;2016;04;01;Keskiviikko;0;0;0;0;0;0
292;20.04.2016;2016;04;02;Keskiviikko;0;0;0;0;0;0
292;20.04.2016;2016;04;03;Keskiviikko;1;0;1;0;0;0
292;20.04.2016;2016;04;04;Keskiviikko;2;0;2;1;0;1
292;20.04.2016;2016;04;05;Keskiviikko;6;6;12;3;0;3
292;20.04.2016;2016;04;06;Keskiviikko;19;15;34;0;4;4
292;20.04.2016;2016;04;07;Keskiviikko;71;29;100;19;8;27
292;20.04.2016;2016;04;08;Keskiviikko;54;25;79;11;6;17
292;20.04.2016;2016;04;09;Keskiviikko;22;16;38;8;11;19
292;20.04.2016;2016;04;10;Keskiviikko;19;19;38;10;5;15
292;20.04.2016;2016;04;11;Keskiviikko;21;27;48;11;9;20
292;20.04.2016;2016;04;12;Keskiviikko;31;22;53;13;8;21
292;20.04.2016;2016;04;13;Keskiviikko;13;83;96;14;20;34
292;20.04.2016;2016;04;14;Keskiviikko;40;58;98;14;11;25
292;20.04.2016;2016;04;15;Keskiviikko;44;53;97;7;13;20
292;20.04.2016;2016;04;16;Keskiviikko;45;45;90;11;12;23
292;20.04.2016;2016;04;17;Keskiviikko;21;24;45;7;15;22
292;20.04.2016;2016;04;18;Keskiviikko;26;33;59;7;8;15
292;20.04.2016;2016;04;19;Keskiviikko;24;15;39;17;7;24
292;20.04.2016;2016;04;20;Keskiviikko;16;19;35;5;3;8
292;20.04.2016;2016;04;21;Keskiviikko;12;12;24;4;4;8
292;20.04.2016;2016;04;22;Keskiviikko;2;2;4;4;2;6
292;20.04.2016;2016;04;23;Keskiviikko;1;0;1;1;0;1
292;21.04.2016;2016;04;00;Torstai;1;0;1;0;0;0
292;21.04.2016;2016;04;01;Torstai;0;0;0;1;2;3
292;21.04.2016;2016;04;02;Torstai;1;1;2;2;0;2
292;21.04.2016;2016;04;03;Torstai;0;1;1;1;2;3
292;21.04.2016;2016;04;04;Torstai;1;0;1;0;0;0
292;21.04.2016;2016;04;05;Torstai;6;5;11;3;1;4
292;21.04.2016;2016;04;06;Torstai;24;13;37;4;6;10
292;21.04.2016;2016;04;07;Torstai;59;38;97;10;12;22
292;21.04.2016;2016;04;08;Torstai;41;28;69;13;8;21
292;21.04.2016;2016;04;09;Torstai;62;27;89;11;7;18
292;21.04.2016;2016;04;10;Torstai;25;16;41;6;4;10
292;21.04.2016;2016;04;11;Torstai;19;18;37;16;10;26
292;21.04.2016;2016;04;12;Torstai;33;27;60;9;10;19
292;21.04.2016;2016;04;13;Torstai;39;53;92;15;15;30
292;21.04.2016;2016;04;14;Torstai;34;57;91;8;15;23
292;21.04.2016;2016;04;15;Torstai;39;62;101;21;16;37
292;21.04.2016;2016;04;16;Torstai;61;84;145;13;12;25
292;21.04.2016;2016;04;17;Torstai;40;36;76;6;11;17
292;21.04.2016;2016;04;18;Torstai;23;40;63;6;10;16
292;21.04.2016;2016;04;19;Torstai;41;30;71;17;12;29
292;21.04.2016;2016;04;20;Torstai;18;18;36;8;6;14
292;21.04.2016;2016;04;21;Torstai;12;8;20;8;7;15
292;21.04.2016;2016;04;22;Torstai;4;5;9;0;2;2
292;21.04.2016;2016;04;23;Torstai;3;1;4;2;0;2
292;22.04.2016;2016;04;00;Perjantai;2;0;2;0;0;0
292;22.04.2016;2016;04;01;Perjantai;0;0;0;0;0;0
292;22.04.2016;2016;04;02;Perjantai;0;2;2;0;0;0
292;22.04.2016;2016;04;03;Perjantai;1;0;1;1;1;2
292;22.04.2016;2016;04;04;Perjantai;2;1;3;0;0;0
292;22.04.2016;2016;04;05;Perjantai;9;5;14;0;2;2
292;22.04.2016;2016;04;06;Perjantai;14;6;20;3;4;7
292;22.04.2016;2016;04;07;Perjantai;63;33;96;11;9;20
292;22.04.2016;2016;04;08;Perjantai;75;31;106;17;9;26
292;22.04.2016;2016;04;09;Perjantai;37;25;62;12;10;22
292;22.04.2016;2016;04;10;Perjantai;29;36;65;6;10;16
292;22.04.2016;2016;04;11;Perjantai;22;18;40;9;8;17
292;22.04.2016;2016;04;12;Perjantai;32;27;59;13;12;25
292;22.04.2016;2016;04;13;Perjantai;36;70;106;15;15;30
292;22.04.2016;2016;04;14;Perjantai;40;72;112;12;14;26
292;22.04.2016;2016;04;15;Perjantai;33;45;78;15;14;29
292;22.04.2016;2016;04;16;Perjantai;45;33;78;14;16;30
292;22.04.2016;2016;04;17;Perjantai;27;31;58;17;14;31
292;22.04.2016;2016;04;18;Perjantai;22;39;61;8;11;19
292;22.04.2016;2016;04;19;Perjantai;34;28;62;12;11;23
292;22.04.2016;2016;04;20;Perjantai;22;16;38;6;10;16
292;22.04.2016;2016;04;21;Perjantai;18;11;29;11;4;15
292;22.04.2016;2016;04;22;Perjantai;8;5;13;2;2;4
292;22.04.2016;2016;04;23;Perjantai;2;2;4;4;1;5
292;23.04.2016;2016;04;00;Lauantai;2;4;6;2;2;4
292;23.04.2016;2016;04;01;Lauantai;2;4;6;4;5;9
292;23.04.2016;2016;04;02;Lauantai;0;1;1;0;7;7
292;23.04.2016;2016;04;03;Lauantai;0;2;2;1;0;1
292;23.04.2016;2016;04;04;Lauantai;1;0;1;1;1;2
292;23.04.2016;2016;04;05;Lauantai;0;0;0;2;1;3
292;23.04.2016;2016;04;06;Lauantai;8;4;12;1;2;3
292;23.04.2016;2016;04;07;Lauantai;4;1;5;0;1;1
292;23.04.2016;2016;04;08;Lauantai;2;11;13;4;3;7
292;23.04.2016;2016;04;09;Lauantai;18;24;42;5;8;13
292;23.04.2016;2016;04;10;Lauantai;31;25;56;6;8;14
292;23.04.2016;2016;04;11;Lauantai;37;33;70;11;7;18
292;23.04.2016;2016;04;12;Lauantai;46;51;97;5;7;12
292;23.04.2016;2016;04;13;Lauantai;45;36;81;9;9;18
292;23.04.2016;2016;04;14;Lauantai;39;48;87;22;21;43
292;23.04.2016;2016;04;15;Lauantai;49;44;93;11;17;28
292;23.04.2016;2016;04;16;Lauantai;34;25;59;11;6;17
292;23.04.2016;2016;04;17;Lauantai;33;23;56;10;10;20
292;23.04.2016;2016;04;18;Lauantai;29;15;44;15;11;26
292;23.04.2016;2016;04;19;Lauantai;19;24;43;6;11;17
292;23.04.2016;2016;04;20;Lauantai;21;10;31;8;10;18
292;23.04.2016;2016;04;21;Lauantai;7;6;13;1;9;10
292;23.04.2016;2016;04;22;Lauantai;4;10;14;4;5;9
292;23.04.2016;2016;04;23;Lauantai;6;3;9;3;2;5
292;24.04.2016;2016;04;00;Sunnuntai;0;1;1;3;2;5
292;24.04.2016;2016;04;01;Sunnuntai;1;5;6;5;1;6
292;24.04.2016;2016;04;02;Sunnuntai;1;1;2;0;7;7
292;24.04.2016;2016;04;03;Sunnuntai;3;1;4;0;0;0
292;24.04.2016;2016;04;04;Sunnuntai;0;0;0;1;0;1
292;24.04.2016;2016;04;05;Sunnuntai;1;0;1;4;0;4
292;24.04.2016;2016;04;06;Sunnuntai;5;4;9;2;0;2
292;24.04.2016;2016;04;07;Sunnuntai;6;2;8;3;2;5
292;24.04.2016;2016;04;08;Sunnuntai;7;2;9;9;1;10
292;24.04.2016;2016;04;09;Sunnuntai;22;13;35;2;7;9
292;24.04.2016;2016;04;10;Sunnuntai;19;13;32;4;9;13
292;24.04.2016;2016;04;11;Sunnuntai;24;29;53;22;12;34
292;24.04.2016;2016;04;12;Sunnuntai;30;17;47;14;10;24
292;24.04.2016;2016;04;13;Sunnuntai;35;31;66;11;11;22
292;24.04.2016;2016;04;14;Sunnuntai;39;44;83;10;8;18
292;24.04.2016;2016;04;15;Sunnuntai;36;31;67;10;13;23
292;24.04.2016;2016;04;16;Sunnuntai;32;34;66;11;16;27
292;24.04.2016;2016;04;17;Sunnuntai;32;15;47;6;10;16
292;24.04.2016;2016;04;18;Sunnuntai;32;25;57;9;12;21
292;24.04.2016;2016;04;19;Sunnuntai;16;23;39;18;11;29
292;24.04.2016;2016;04;20;Sunnuntai;17;14;31;5;4;9
292;24.04.2016;2016;04;21;Sunnuntai;5;10;15;2;6;8
292;24.04.2016;2016;04;22;Sunnuntai;4;3;7;2;2;4
292;24.04.2016;2016;04;23;Sunnuntai;0;2;2;0;2;2
292;25.04.2016;2016;04;00;Maanantai;0;0;0;0;0;0
292;25.04.2016;2016;04;01;Maanantai;0;0;0;0;0;0
292;25.04.2016;2016;04;02;Maanantai;0;1;1;0;0;0
292;25.04.2016;2016;04;03;Maanantai;0;0;0;1;0;1
292;25.04.2016;2016;04;04;Maanantai;2;1;3;0;1;1
292;25.04.2016;2016;04;05;Maanantai;4;7;11;2;2;4
292;25.04.2016;2016;04;06;Maanantai;25;11;36;1;6;7
292;25.04.2016;2016;04;07;Maanantai;64;28;92;9;17;26
292;25.04.2016;2016;04;08;Maanantai;37;27;64;10;13;23
292;25.04.2016;2016;04;09;Maanantai;55;28;83;7;10;17
292;25.04.2016;2016;04;10;Maanantai;28;20;48;10;5;15
292;25.04.2016;2016;04;11;Maanantai;24;15;39;10;6;16
292;25.04.2016;2016;04;12;Maanantai;18;18;36;15;9;24
292;25.04.2016;2016;04;13;Maanantai;28;40;68;18;17;35
292;25.04.2016;2016;04;14;Maanantai;30;52;82;3;8;11
292;25.04.2016;2016;04;15;Maanantai;27;39;66;3;10;13
292;25.04.2016;2016;04;16;Maanantai;29;47;76;9;14;23
292;25.04.2016;2016;04;17;Maanantai;16;17;33;8;6;14
292;25.04.2016;2016;04;18;Maanantai;21;7;28;10;5;15
292;25.04.2016;2016;04;19;Maanantai;9;6;15;6;8;14
292;25.04.2016;2016;04;20;Maanantai;14;9;23;9;7;16
292;25.04.2016;2016;04;21;Maanantai;7;8;15;8;4;12
292;25.04.2016;2016;04;22;Maanantai;2;7;9;1;1;2
292;25.04.2016;2016;04;23;Maanantai;0;1;1;0;0;0
292;26.04.2016;2016;04;00;Tiistai;0;0;0;0;0;0
292;26.04.2016;2016;04;01;Tiistai;0;0;0;0;0;0
292;26.04.2016;2016;04;02;Tiistai;0;0;0;0;0;0
292;26.04.2016;2016;04;03;Tiistai;0;0;0;1;0;1
292;26.04.2016;2016;04;04;Tiistai;2;0;2;0;0;0
292;26.04.2016;2016;04;05;Tiistai;4;10;14;0;1;1
292;26.04.2016;2016;04;06;Tiistai;18;19;37;6;3;9
292;26.04.2016;2016;04;07;Tiistai;65;28;93;9;13;22
292;26.04.2016;2016;04;08;Tiistai;51;28;79;16;4;20
292;26.04.2016;2016;04;09;Tiistai;26;23;49;6;3;9
292;26.04.2016;2016;04;10;Tiistai;23;15;38;4;7;11
292;26.04.2016;2016;04;11;Tiistai;14;8;22;4;6;10
292;26.04.2016;2016;04;12;Tiistai;21;21;42;6;4;10
292;26.04.2016;2016;04;13;Tiistai;31;34;65;9;8;17
292;26.04.2016;2016;04;14;Tiistai;35;85;120;13;9;22
292;26.04.2016;2016;04;15;Tiistai;26;49;75;14;7;21
292;26.04.2016;2016;04;16;Tiistai;50;36;86;12;16;28
292;26.04.2016;2016;04;17;Tiistai;19;24;43;6;2;8
292;26.04.2016;2016;04;18;Tiistai;14;28;42;6;10;16
292;26.04.2016;2016;04;19;Tiistai;15;14;29;6;11;17
292;26.04.2016;2016;04;20;Tiistai;28;12;40;8;5;13
292;26.04.2016;2016;04;21;Tiistai;12;6;18;4;5;9
292;26.04.2016;2016;04;22;Tiistai;0;5;5;3;0;3
292;26.04.2016;2016;04;23;Tiistai;1;1;2;0;0;0
292;27.04.2016;2016;04;00;Keskiviikko;0;0;0;0;0;0
292;27.04.2016;2016;04;01;Keskiviikko;0;0;0;0;0;0
292;27.04.2016;2016;04;02;Keskiviikko;0;0;0;0;0;0
292;27.04.2016;2016;04;03;Keskiviikko;1;0;1;1;0;1
292;27.04.2016;2016;04;04;Keskiviikko;2;0;2;0;0;0
292;27.04.2016;2016;04;05;Keskiviikko;8;7;15;1;1;2
292;27.04.2016;2016;04;06;Keskiviikko;17;13;30;3;5;8
292;27.04.2016;2016;04;07;Keskiviikko;77;31;108;14;9;23
292;27.04.2016;2016;04;08;Keskiviikko;52;28;80;8;10;18
292;27.04.2016;2016;04;09;Keskiviikko;20;27;47;5;6;11
292;27.04.2016;2016;04;10;Keskiviikko;24;14;38;13;12;25
292;27.04.2016;2016;04;11;Keskiviikko;15;23;38;21;5;26
292;27.04.2016;2016;04;12;Keskiviikko;27;22;49;4;5;9
292;27.04.2016;2016;04;13;Keskiviikko;26;69;95;7;11;18
292;27.04.2016;2016;04;14;Keskiviikko;30;54;84;15;9;24
292;27.04.2016;2016;04;15;Keskiviikko;48;43;91;18;12;30
292;27.04.2016;2016;04;16;Keskiviikko;39;46;85;15;21;36
292;27.04.2016;2016;04;17;Keskiviikko;26;34;60;7;12;19
292;27.04.2016;2016;04;18;Keskiviikko;27;18;45;6;6;12
292;27.04.2016;2016;04;19;Keskiviikko;27;29;56;5;7;12
292;27.04.2016;2016;04;20;Keskiviikko;13;28;41;13;9;22
292;27.04.2016;2016;04;21;Keskiviikko;13;14;27;4;2;6
292;27.04.2016;2016;04;22;Keskiviikko;2;6;8;2;1;3
292;27.04.2016;2016;04;23;Keskiviikko;0;0;0;1;1;2
292;28.04.2016;2016;04;00;Torstai;1;0;1;1;0;1
292;28.04.2016;2016;04;01;Torstai;1;1;2;0;0;0
292;28.04.2016;2016;04;02;Torstai;1;1;2;0;0;0
292;28.04.2016;2016;04;03;Torstai;0;0;0;1;0;1
292;28.04.2016;2016;04;04;Torstai;2;0;2;0;0;0
292;28.04.2016;2016;04;05;Torstai;9;7;16;1;0;1
292;28.04.2016;2016;04;06;Torstai;27;18;45;3;0;3
292;28.04.2016;2016;04;07;Torstai;76;38;114;8;0;8
292;28.04.2016;2016;04;08;Torstai;38;35;73;7;1;8
292;28.04.2016;2016;04;09;Torstai;51;30;81;10;2;12
292;28.04.2016;2016;04;10;Torstai;27;23;50;5;7;12
292;28.04.2016;2016;04;11;Torstai;27;15;42;9;5;14
292;28.04.2016;2016;04;12;Torstai;36;25;61;13;6;19
292;28.04.2016;2016;04;13;Torstai;39;70;109;10;8;18
292;28.04.2016;2016;04;14;Torstai;53;60;113;8;10;18
292;28.04.2016;2016;04;15;Torstai;67;66;133;22;10;32
292;28.04.2016;2016;04;16;Torstai;69;94;163;13;14;27
292;28.04.2016;2016;04;17;Torstai;57;39;96;9;12;21
292;28.04.2016;2016;04;18;Torstai;64;37;101;11;19;30
292;28.04.2016;2016;04;19;Torstai;42;48;90;10;16;26
292;28.04.2016;2016;04;20;Torstai;27;43;70;7;14;21
292;28.04.2016;2016;04;21;Torstai;14;19;33;5;7;12
292;28.04.2016;2016;04;22;Torstai;6;4;10;4;1;5
292;28.04.2016;2016;04;23;Torstai;3;3;6;0;0;0
292;29.04.2016;2016;04;00;Perjantai;0;3;3;0;1;1
292;29.04.2016;2016;04;01;Perjantai;0;1;1;0;0;0
292;29.04.2016;2016;04;02;Perjantai;0;2;2;0;0;0
292;29.04.2016;2016;04;03;Perjantai;2;2;4;0;0;0
292;29.04.2016;2016;04;04;Perjantai;2;0;2;1;0;1
292;29.04.2016;2016;04;05;Perjantai;5;6;11;2;3;5
292;29.04.2016;2016;04;06;Perjantai;18;16;34;5;5;10
292;29.04.2016;2016;04;07;Perjantai;70;31;101;5;14;19
292;29.04.2016;2016;04;08;Perjantai;71;32;103;13;12;25
292;29.04.2016;2016;04;09;Perjantai;46;24;70;12;3;15
292;29.04.2016;2016;04;10;Perjantai;30;22;52;7;8;15
292;29.04.2016;2016;04;11;Perjantai;32;22;54;8;4;12
292;29.04.2016;2016;04;12;Perjantai;37;39;76;9;8;17
292;29.04.2016;2016;04;13;Perjantai;30;67;97;6;17;23
292;29.04.2016;2016;04;14;Perjantai;38;46;84;7;13;20
292;29.04.2016;2016;04;15;Perjantai;33;39;72;8;6;14
292;29.04.2016;2016;04;16;Perjantai;23;27;50;7;3;10
292;29.04.2016;2016;04;17;Perjantai;28;18;46;5;8;13
292;29.04.2016;2016;04;18;Perjantai;16;24;40;9;6;15
292;29.04.2016;2016;04;19;Perjantai;32;35;67;10;7;17
292;29.04.2016;2016;04;20;Perjantai;19;13;32;11;10;21
292;29.04.2016;2016;04;21;Perjantai;14;15;29;3;4;7
292;29.04.2016;2016;04;22;Perjantai;7;8;15;3;2;5
292;29.04.2016;2016;04;23;Perjantai;3;3;6;2;3;5
292;30.04.2016;2016;04;00;Lauantai;4;4;8;6;1;7
292;30.04.2016;2016;04;01;Lauantai;1;2;3;2;0;2
292;30.04.2016;2016;04;02;Lauantai;2;4;6;0;3;3
292;30.04.2016;2016;04;03;Lauantai;1;2;3;0;0;0
292;30.04.2016;2016;04;04;Lauantai;1;1;2;2;2;4
292;30.04.2016;2016;04;05;Lauantai;2;1;3;1;2;3
292;30.04.2016;2016;04;06;Lauantai;6;4;10;5;2;7
292;30.04.2016;2016;04;07;Lauantai;8;11;19;3;3;6
292;30.04.2016;2016;04;08;Lauantai;9;14;23;2;3;5
292;30.04.2016;2016;04;09;Lauantai;23;13;36;4;7;11
292;30.04.2016;2016;04;10;Lauantai;32;29;61;12;7;19
292;30.04.2016;2016;04;11;Lauantai;47;37;84;8;7;15
292;30.04.2016;2016;04;12;Lauantai;63;35;98;10;10;20
292;30.04.2016;2016;04;13;Lauantai;51;38;89;10;13;23
292;30.04.2016;2016;04;14;Lauantai;38;40;78;13;12;25
292;30.04.2016;2016;04;15;Lauantai;51;47;98;14;8;22
292;30.04.2016;2016;04;16;Lauantai;44;48;92;12;11;23
292;30.04.2016;2016;04;17;Lauantai;45;29;74;11;9;20
292;30.04.2016;2016;04;18;Lauantai;38;27;65;7;4;11
292;30.04.2016;2016;04;19;Lauantai;17;29;46;11;6;17
292;30.04.2016;2016;04;20;Lauantai;37;43;80;4;8;12
292;30.04.2016;2016;04;21;Lauantai;6;20;26;3;9;12
292;30.04.2016;2016;04;22;Lauantai;18;8;26;6;5;11
292;30.04.2016;2016;04;23;Lauantai;11;15;26;4;0;4
292;01.05.2016;2016;05;00;Sunnuntai;2;1;3;2;1;3
292;01.05.2016;2016;05;01;Sunnuntai;2;4;6;1;2;3
292;01.05.2016;2016;05;02;Sunnuntai;1;4;5;3;5;8
292;01.05.2016;2016;05;03;Sunnuntai;2;4;6;0;10;10
292;01.05.2016;2016;05;04;Sunnuntai;1;4;5;2;1;3
292;01.05.2016;2016;05;05;Sunnuntai;1;3;4;0;0;0
292;01.05.2016;2016;05;06;Sunnuntai;11;1;12;2;1;3
292;01.05.2016;2016;05;07;Sunnuntai;2;8;10;1;3;4
292;01.05.2016;2016;05;08;Sunnuntai;12;5;17;4;2;6
292;01.05.2016;2016;05;09;Sunnuntai;22;9;31;2;3;5
292;01.05.2016;2016;05;10;Sunnuntai;29;16;45;5;4;9
292;01.05.2016;2016;05;11;Sunnuntai;41;22;63;11;9;20
292;01.05.2016;2016;05;12;Sunnuntai;68;40;108;10;3;13
292;01.05.2016;2016;05;13;Sunnuntai;77;53;130;16;7;23
292;01.05.2016;2016;05;14;Sunnuntai;59;59;118;20;15;35
292;01.05.2016;2016;05;15;Sunnuntai;44;48;92;17;10;27
292;01.05.2016;2016;05;16;Sunnuntai;38;62;100;15;15;30
292;01.05.2016;2016;05;17;Sunnuntai;37;50;87;4;9;13
292;01.05.2016;2016;05;18;Sunnuntai;57;47;104;18;13;31
292;01.05.2016;2016;05;19;Sunnuntai;35;36;71;8;15;23
292;01.05.2016;2016;05;20;Sunnuntai;18;25;43;9;6;15
292;01.05.2016;2016;05;21;Sunnuntai;12;14;26;0;1;1
292;01.05.2016;2016;05;22;Sunnuntai;2;4;6;2;5;7
292;01.05.2016;2016;05;23;Sunnuntai;2;2;4;1;1;2
292;02.05.2016;2016;05;00;Maanantai;2;2;4;0;0;0
292;02.05.2016;2016;05;01;Maanantai;1;3;4;0;1;1
292;02.05.2016;2016;05;02;Maanantai;0;1;1;0;0;0
292;02.05.2016;2016;05;03;Maanantai;0;0;0;1;0;1
292;02.05.2016;2016;05;04;Maanantai;2;0;2;0;0;0
292;02.05.2016;2016;05;05;Maanantai;8;6;14;3;2;5
292;02.05.2016;2016;05;06;Maanantai;32;20;52;2;5;7
292;02.05.2016;2016;05;07;Maanantai;93;34;127;9;8;17
292;02.05.2016;2016;05;08;Maanantai;58;21;79;11;10;21
292;02.05.2016;2016;05;09;Maanantai;65;26;91;5;5;10
292;02.05.2016;2016;05;10;Maanantai;35;20;55;11;2;13
292;02.05.2016;2016;05;11;Maanantai;50;45;95;12;12;24
292;02.05.2016;2016;05;12;Maanantai;32;34;66;8;12;20
292;02.05.2016;2016;05;13;Maanantai;47;54;101;10;3;13
292;02.05.2016;2016;05;14;Maanantai;55;69;124;8;10;18
292;02.05.2016;2016;05;15;Maanantai;57;69;126;15;10;25
292;02.05.2016;2016;05;16;Maanantai;65;77;142;11;14;25
292;02.05.2016;2016;05;17;Maanantai;56;54;110;11;16;27
292;02.05.2016;2016;05;18;Maanantai;63;57;120;15;9;24
292;02.05.2016;2016;05;19;Maanantai;46;55;101;13;15;28
292;02.05.2016;2016;05;20;Maanantai;29;30;59;11;7;18
292;02.05.2016;2016;05;21;Maanantai;13;25;38;6;4;10
292;02.05.2016;2016;05;22;Maanantai;4;5;9;3;1;4
292;02.05.2016;2016;05;23;Maanantai;0;0;0;0;0;0
292;03.05.2016;2016;05;00;Tiistai;1;1;2;0;0;0
292;03.05.2016;2016;05;01;Tiistai;0;0;0;0;0;0
292;03.05.2016;2016;05;02;Tiistai;0;1;1;1;0;1
292;03.05.2016;2016;05;03;Tiistai;0;0;0;0;0;0
292;03.05.2016;2016;05;04;Tiistai;2;0;2;0;0;0
292;03.05.2016;2016;05;05;Tiistai;11;7;18;0;3;3
292;03.05.2016;2016;05;06;Tiistai;30;21;51;2;3;5
292;03.05.2016;2016;05;07;Tiistai;85;38;123;17;8;25
292;03.05.2016;2016;05;08;Tiistai;69;31;100;16;5;21
292;03.05.2016;2016;05;09;Tiistai;43;23;66;4;4;8
292;03.05.2016;2016;05;10;Tiistai;42;20;62;12;1;13
292;03.05.2016;2016;05;11;Tiistai;37;24;61;11;3;14
292;03.05.2016;2016;05;12;Tiistai;50;26;76;10;4;14
292;03.05.2016;2016;05;13;Tiistai;44;38;82;12;3;15
292;03.05.2016;2016;05;14;Tiistai;64;64;128;5;14;19
292;03.05.2016;2016;05;15;Tiistai;64;65;129;8;12;20
292;03.05.2016;2016;05;16;Tiistai;87;66;153;11;15;26
292;03.05.2016;2016;05;17;Tiistai;69;46;115;10;15;25
292;03.05.2016;2016;05;18;Tiistai;66;48;114;16;12;28
292;03.05.2016;2016;05;19;Tiistai;28;39;67;11;12;23
292;03.05.2016;2016;05;20;Tiistai;30;25;55;16;10;26
292;03.05.2016;2016;05;21;Tiistai;10;11;21;7;9;16
292;03.05.2016;2016;05;22;Tiistai;4;9;13;4;3;7
292;03.05.2016;2016;05;23;Tiistai;1;1;2;0;0;0
292;04.05.2016;2016;05;00;Keskiviikko;3;1;4;0;0;0
292;04.05.2016;2016;05;01;Keskiviikko;0;2;2;1;0;1
292;04.05.2016;2016;05;02;Keskiviikko;0;1;1;0;0;0
292;04.05.2016;2016;05;03;Keskiviikko;0;0;0;2;1;3
292;04.05.2016;2016;05;04;Keskiviikko;1;2;3;0;0;0
292;04.05.2016;2016;05;05;Keskiviikko;11;6;17;1;2;3
292;04.05.2016;2016;05;06;Keskiviikko;31;24;55;3;3;6
292;04.05.2016;2016;05;07;Keskiviikko;83;35;118;21;12;33
292;04.05.2016;2016;05;08;Keskiviikko;82;27;109;13;8;21
292;04.05.2016;2016;05;09;Keskiviikko;49;29;78;11;5;16
292;04.05.2016;2016;05;10;Keskiviikko;52;20;72;7;3;10
292;04.05.2016;2016;05;11;Keskiviikko;46;24;70;10;4;14
292;04.05.2016;2016;05;12;Keskiviikko;49;30;79;7;3;10
292;04.05.2016;2016;05;13;Keskiviikko;59;89;148;6;11;17
292;04.05.2016;2016;05;14;Keskiviikko;53;61;114;14;9;23
292;04.05.2016;2016;05;15;Keskiviikko;62;88;150;12;15;27
292;04.05.2016;2016;05;16;Keskiviikko;72;76;148;25;12;37
292;04.05.2016;2016;05;17;Keskiviikko;74;57;131;12;14;26
292;04.05.2016;2016;05;18;Keskiviikko;62;53;115;13;13;26
292;04.05.2016;2016;05;19;Keskiviikko;57;53;110;6;13;19
292;04.05.2016;2016;05;20;Keskiviikko;28;46;74;12;12;24
292;04.05.2016;2016;05;21;Keskiviikko;14;22;36;3;6;9
292;04.05.2016;2016;05;22;Keskiviikko;7;7;14;4;4;8
292;04.05.2016;2016;05;23;Keskiviikko;8;7;15;3;1;4
292;05.05.2016;2016;05;00;Torstai;3;5;8;2;0;2
292;05.05.2016;2016;05;01;Torstai;0;3;3;1;1;2
292;05.05.2016;2016;05;02;Torstai;3;2;5;0;4;4
292;05.05.2016;2016;05;03;Torstai;0;1;1;0;0;0
292;05.05.2016;2016;05;04;Torstai;2;0;2;0;0;0
292;05.05.2016;2016;05;05;Torstai;1;5;6;1;2;3
292;05.05.2016;2016;05;06;Torstai;6;3;9;0;0;0
292;05.05.2016;2016;05;07;Torstai;9;7;16;1;3;4
292;05.05.2016;2016;05;08;Torstai;19;6;25;7;0;7
292;05.05.2016;2016;05;09;Torstai;32;16;48;6;7;13
292;05.05.2016;2016;05;10;Torstai;44;31;75;10;3;13
292;05.05.2016;2016;05;11;Torstai;60;40;100;16;7;23
292;05.05.2016;2016;05;12;Torstai;45;48;93;5;19;24
292;05.05.2016;2016;05;13;Torstai;64;46;110;16;16;32
292;05.05.2016;2016;05;14;Torstai;58;65;123;15;12;27
292;05.05.2016;2016;05;15;Torstai;64;45;109;16;9;25
292;05.05.2016;2016;05;16;Torstai;68;38;106;16;13;29
292;05.05.2016;2016;05;17;Torstai;54;57;111;14;14;28
292;05.05.2016;2016;05;18;Torstai;43;46;89;13;14;27
292;05.05.2016;2016;05;19;Torstai;38;35;73;26;15;41
292;05.05.2016;2016;05;20;Torstai;28;33;61;12;10;22
292;05.05.2016;2016;05;21;Torstai;8;16;24;3;7;10
292;05.05.2016;2016;05;22;Torstai;7;14;21;4;4;8
292;05.05.2016;2016;05;23;Torstai;5;4;9;2;4;6
292;06.05.2016;2016;05;00;Perjantai;7;3;10;3;0;3
292;06.05.2016;2016;05;01;Perjantai;0;4;4;0;1;1
292;06.05.2016;2016;05;02;Perjantai;0;1;1;0;0;0
292;06.05.2016;2016;05;03;Perjantai;0;0;0;2;2;4
292;06.05.2016;2016;05;04;Perjantai;1;3;4;0;0;0
292;06.05.2016;2016;05;05;Perjantai;7;9;16;1;0;1
292;06.05.2016;2016;05;06;Perjantai;24;12;36;2;6;8
292;06.05.2016;2016;05;07;Perjantai;24;15;39;3;6;9
292;06.05.2016;2016;05;08;Perjantai;22;25;47;2;5;7
292;06.05.2016;2016;05;09;Perjantai;40;30;70;7;3;10
292;06.05.2016;2016;05;10;Perjantai;43;15;58;2;3;5
292;06.05.2016;2016;05;11;Perjantai;45;23;68;5;2;7
292;06.05.2016;2016;05;12;Perjantai;84;35;119;8;1;9
292;06.05.2016;2016;05;13;Perjantai;65;52;117;10;10;20
292;06.05.2016;2016;05;14;Perjantai;62;55;117;12;17;29
292;06.05.2016;2016;05;15;Perjantai;62;56;118;13;8;21
292;06.05.2016;2016;05;16;Perjantai;70;66;136;17;13;30
292;06.05.2016;2016;05;17;Perjantai;47;41;88;7;10;17
292;06.05.2016;2016;05;18;Perjantai;38;42;80;19;11;30
292;06.05.2016;2016;05;19;Perjantai;39;34;73;13;12;25
292;06.05.2016;2016;05;20;Perjantai;31;40;71;12;5;17
292;06.05.2016;2016;05;21;Perjantai;10;11;21;3;5;8
292;06.05.2016;2016;05;22;Perjantai;10;11;21;4;2;6
292;06.05.2016;2016;05;23;Perjantai;6;5;11;7;4;11
292;07.05.2016;2016;05;00;Lauantai;5;7;12;1;3;4
292;07.05.2016;2016;05;01;Lauantai;1;2;3;2;2;4
292;07.05.2016;2016;05;02;Lauantai;1;3;4;0;4;4
292;07.05.2016;2016;05;03;Lauantai;0;2;2;2;8;10
292;07.05.2016;2016;05;04;Lauantai;1;3;4;2;1;3
292;07.05.2016;2016;05;05;Lauantai;1;1;2;1;0;1
292;07.05.2016;2016;05;06;Lauantai;6;6;12;3;1;4
292;07.05.2016;2016;05;07;Lauantai;8;6;14;2;1;3
292;07.05.2016;2016;05;08;Lauantai;15;11;26;0;1;1
292;07.05.2016;2016;05;09;Lauantai;26;12;38;3;3;6
292;07.05.2016;2016;05;10;Lauantai;46;21;67;6;7;13
292;07.05.2016;2016;05;11;Lauantai;49;29;78;2;2;4
292;07.05.2016;2016;05;12;Lauantai;52;39;91;8;5;13
292;07.05.2016;2016;05;13;Lauantai;48;39;87;7;4;11
292;07.05.2016;2016;05;14;Lauantai;58;41;99;11;6;17
292;07.05.2016;2016;05;15;Lauantai;48;54;102;15;11;26
292;07.05.2016;2016;05;16;Lauantai;68;44;112;14;12;26
292;07.05.2016;2016;05;17;Lauantai;53;44;97;22;8;30
292;07.05.2016;2016;05;18;Lauantai;48;47;95;11;10;21
292;07.05.2016;2016;05;19;Lauantai;41;53;94;7;23;30
292;07.05.2016;2016;05;20;Lauantai;30;18;48;5;10;15
292;07.05.2016;2016;05;21;Lauantai;12;22;34;3;7;10
292;07.05.2016;2016;05;22;Lauantai;10;13;23;2;3;5
292;07.05.2016;2016;05;23;Lauantai;3;5;8;2;0;2
292;08.05.2016;2016;05;00;Sunnuntai;4;4;8;5;5;10
292;08.05.2016;2016;05;01;Sunnuntai;0;2;2;0;1;1
292;08.05.2016;2016;05;02;Sunnuntai;1;5;6;0;1;1
292;08.05.2016;2016;05;03;Sunnuntai;0;1;1;2;1;3
292;08.05.2016;2016;05;04;Sunnuntai;0;1;1;0;1;1
292;08.05.2016;2016;05;05;Sunnuntai;0;1;1;1;3;4
292;08.05.2016;2016;05;06;Sunnuntai;7;2;9;1;1;2
292;08.05.2016;2016;05;07;Sunnuntai;7;4;11;2;0;2
292;08.05.2016;2016;05;08;Sunnuntai;11;8;19;2;2;4
292;08.05.2016;2016;05;09;Sunnuntai;21;10;31;7;3;10
292;08.05.2016;2016;05;10;Sunnuntai;26;14;40;17;1;18
292;08.05.2016;2016;05;11;Sunnuntai;45;31;76;9;9;18
292;08.05.2016;2016;05;12;Sunnuntai;63;45;108;6;9;15
292;08.05.2016;2016;05;13;Sunnuntai;47;38;85;9;10;19
292;08.05.2016;2016;05;14;Sunnuntai;46;41;87;10;11;21
292;08.05.2016;2016;05;15;Sunnuntai;51;45;96;14;13;27
292;08.05.2016;2016;05;16;Sunnuntai;42;35;77;9;14;23
292;08.05.2016;2016;05;17;Sunnuntai;34;30;64;12;14;26
292;08.05.2016;2016;05;18;Sunnuntai;48;38;86;11;11;22
292;08.05.2016;2016;05;19;Sunnuntai;41;40;81;17;20;37
292;08.05.2016;2016;05;20;Sunnuntai;25;25;50;11;10;21
292;08.05.2016;2016;05;21;Sunnuntai;10;15;25;8;7;15
292;08.05.2016;2016;05;22;Sunnuntai;0;5;5;1;0;1
292;08.05.2016;2016;05;23;Sunnuntai;0;1;1;1;0;1
292;09.05.2016;2016;05;00;Maanantai;0;3;3;1;1;2
292;09.05.2016;2016;05;01;Maanantai;0;0;0;0;0;0
292;09.05.2016;2016;05;02;Maanantai;0;1;1;0;1;1
292;09.05.2016;2016;05;03;Maanantai;0;0;0;0;0;0
292;09.05.2016;2016;05;04;Maanantai;3;1;4;0;0;0
292;09.05.2016;2016;05;05;Maanantai;8;12;20;2;0;2
292;09.05.2016;2016;05;06;Maanantai;31;18;49;1;4;5
292;09.05.2016;2016;05;07;Maanantai;88;47;135;12;12;24
292;09.05.2016;2016;05;08;Maanantai;56;31;87;5;5;10
292;09.05.2016;2016;05;09;Maanantai;68;29;97;11;3;14
292;09.05.2016;2016;05;10;Maanantai;37;22;59;2;3;5
292;09.05.2016;2016;05;11;Maanantai;36;23;59;9;4;13
292;09.05.2016;2016;05;12;Maanantai;42;44;86;12;8;20
292;09.05.2016;2016;05;13;Maanantai;41;63;104;8;9;17
292;09.05.2016;2016;05;14;Maanantai;40;73;113;12;15;27
292;09.05.2016;2016;05;15;Maanantai;65;77;142;18;22;40
292;09.05.2016;2016;05;16;Maanantai;66;83;149;12;23;35
292;09.05.2016;2016;05;17;Maanantai;50;42;92;15;24;39
292;09.05.2016;2016;05;18;Maanantai;63;48;111;17;14;31
292;09.05.2016;2016;05;19;Maanantai;50;40;90;16;17;33
292;09.05.2016;2016;05;20;Maanantai;25;31;56;4;4;8
292;09.05.2016;2016;05;21;Maanantai;8;20;28;6;2;8
292;09.05.2016;2016;05;22;Maanantai;3;13;16;2;2;4
292;09.05.2016;2016;05;23;Maanantai;1;3;4;0;1;1
292;10.05.2016;2016;05;00;Tiistai;0;0;0;0;0;0
292;10.05.2016;2016;05;01;Tiistai;2;3;5;0;0;0
292;10.05.2016;2016;05;02;Tiistai;0;0;0;0;0;0
292;10.05.2016;2016;05;03;Tiistai;0;0;0;1;0;1
292;10.05.2016;2016;05;04;Tiistai;2;1;3;0;0;0
292;10.05.2016;2016;05;05;Tiistai;7;2;9;1;1;2
292;10.05.2016;2016;05;06;Tiistai;21;19;40;1;3;4
292;10.05.2016;2016;05;07;Tiistai;45;20;65;4;6;10
292;10.05.2016;2016;05;08;Tiistai;47;16;63;4;1;5
292;10.05.2016;2016;05;09;Tiistai;20;10;30;4;5;9
292;10.05.2016;2016;05;10;Tiistai;15;8;23;6;2;8
292;10.05.2016;2016;05;11;Tiistai;10;13;23;1;4;5
292;10.05.2016;2016;05;12;Tiistai;14;18;32;4;2;6
292;10.05.2016;2016;05;13;Tiistai;25;30;55;7;3;10
292;10.05.2016;2016;05;14;Tiistai;21;61;82;6;18;24
292;10.05.2016;2016;05;15;Tiistai;33;55;88;12;15;27
292;10.05.2016;2016;05;16;Tiistai;53;53;106;8;8;16
292;10.05.2016;2016;05;17;Tiistai;62;29;91;4;6;10
292;10.05.2016;2016;05;18;Tiistai;34;47;81;9;9;18
292;10.05.2016;2016;05;19;Tiistai;33;26;59;9;2;11
292;10.05.2016;2016;05;20;Tiistai;32;12;44;6;9;15
292;10.05.2016;2016;05;21;Tiistai;8;12;20;7;9;16
292;10.05.2016;2016;05;22;Tiistai;3;6;9;2;0;2
292;10.05.2016;2016;05;23;Tiistai;1;1;2;1;1;2
292;11.05.2016;2016;05;00;Keskiviikko;0;0;0;3;0;3
292;11.05.2016;2016;05;01;Keskiviikko;1;1;2;0;0;0
292;11.05.2016;2016;05;02;Keskiviikko;0;1;1;1;0;1
292;11.05.2016;2016;05;03;Keskiviikko;0;0;0;1;0;1
292;11.05.2016;2016;05;04;Keskiviikko;2;0;2;0;0;0
292;11.05.2016;2016;05;05;Keskiviikko;8;7;15;1;2;3
292;11.05.2016;2016;05;06;Keskiviikko;30;22;52;4;5;9
292;11.05.2016;2016;05;07;Keskiviikko;89;33;122;12;6;18
292;11.05.2016;2016;05;08;Keskiviikko;74;26;100;11;5;16
292;11.05.2016;2016;05;09;Keskiviikko;44;25;69;15;4;19
292;11.05.2016;2016;05;10;Keskiviikko;26;24;50;12;16;28
292;11.05.2016;2016;05;11;Keskiviikko;36;29;65;10;12;22
292;11.05.2016;2016;05;12;Keskiviikko;33;26;59;6;15;21
292;11.05.2016;2016;05;13;Keskiviikko;44;101;145;9;17;26
292;11.05.2016;2016;05;14;Keskiviikko;38;59;97;7;8;15
292;11.05.2016;2016;05;15;Keskiviikko;56;51;107;15;8;23
292;11.05.2016;2016;05;16;Keskiviikko;61;65;126;15;20;35
292;11.05.2016;2016;05;17;Keskiviikko;52;44;96;11;12;23
292;11.05.2016;2016;05;18;Keskiviikko;49;55;104;11;12;23
292;11.05.2016;2016;05;19;Keskiviikko;55;48;103;6;12;18
292;11.05.2016;2016;05;20;Keskiviikko;27;20;47;11;6;17
292;11.05.2016;2016;05;21;Keskiviikko;6;19;25;0;4;4
292;11.05.2016;2016;05;22;Keskiviikko;3;9;12;3;4;7
292;11.05.2016;2016;05;23;Keskiviikko;2;1;3;1;0;1
292;12.05.2016;2016;05;00;Torstai;0;2;2;0;0;0
292;12.05.2016;2016;05;01;Torstai;0;1;1;0;1;1
292;12.05.2016;2016;05;02;Torstai;0;0;0;0;0;0
292;12.05.2016;2016;05;03;Torstai;1;3;4;1;0;1
292;12.05.2016;2016;05;04;Torstai;2;0;2;1;0;1
292;12.05.2016;2016;05;05;Torstai;10;6;16;2;2;4
292;12.05.2016;2016;05;06;Torstai;31;19;50;2;6;8
292;12.05.2016;2016;05;07;Torstai;87;27;114;15;6;21
292;12.05.2016;2016;05;08;Torstai;64;16;80;12;1;13
292;12.05.2016;2016;05;09;Torstai;74;24;98;10;3;13
292;12.05.2016;2016;05;10;Torstai;43;13;56;9;1;10
292;12.05.2016;2016;05;11;Torstai;51;23;74;7;4;11
292;12.05.2016;2016;05;12;Torstai;65;24;89;6;1;7
292;12.05.2016;2016;05;13;Torstai;55;63;118;8;11;19
292;12.05.2016;2016;05;14;Torstai;42;78;120;16;16;32
292;12.05.2016;2016;05;15;Torstai;66;77;143;18;21;39
292;12.05.2016;2016;05;16;Torstai;68;92;160;13;32;45
292;12.05.2016;2016;05;17;Torstai;68;49;117;18;10;28
292;12.05.2016;2016;05;18;Torstai;45;40;85;21;23;44
292;12.05.2016;2016;05;19;Torstai;48;53;101;18;15;33
292;12.05.2016;2016;05;20;Torstai;25;43;68;7;12;19
292;12.05.2016;2016;05;21;Torstai;14;8;22;6;5;11
292;12.05.2016;2016;05;22;Torstai;1;8;9;0;0;0
292;12.05.2016;2016;05;23;Torstai;2;2;4;0;1;1
292;13.05.2016;2016;05;00;Perjantai;0;0;0;0;0;0
292;13.05.2016;2016;05;01;Perjantai;2;2;4;0;0;0
292;13.05.2016;2016;05;02;Perjantai;0;1;1;0;0;0
292;13.05.2016;2016;05;03;Perjantai;1;2;3;1;0;1
292;13.05.2016;2016;05;04;Perjantai;3;1;4;0;0;0
292;13.05.2016;2016;05;05;Perjantai;8;10;18;0;0;0
292;13.05.2016;2016;05;06;Perjantai;27;12;39;5;2;7
292;13.05.2016;2016;05;07;Perjantai;69;28;97;9;8;17
292;13.05.2016;2016;05;08;Perjantai;65;26;91;16;3;19
292;13.05.2016;2016;05;09;Perjantai;51;13;64;7;3;10
292;13.05.2016;2016;05;10;Perjantai;42;15;57;3;1;4
292;13.05.2016;2016;05;11;Perjantai;33;21;54;4;3;7
292;13.05.2016;2016;05;12;Perjantai;40;36;76;15;2;17
292;13.05.2016;2016;05;13;Perjantai;54;77;131;10;16;26
292;13.05.2016;2016;05;14;Perjantai;35;84;119;7;19;26
292;13.05.2016;2016;05;15;Perjantai;53;47;100;9;8;17
292;13.05.2016;2016;05;16;Perjantai;52;41;93;10;8;18
292;13.05.2016;2016;05;17;Perjantai;31;29;60;12;12;24
292;13.05.2016;2016;05;18;Perjantai;36;21;57;5;6;11
292;13.05.2016;2016;05;19;Perjantai;26;41;67;9;7;16
292;13.05.2016;2016;05;20;Perjantai;25;18;43;16;7;23
292;13.05.2016;2016;05;21;Perjantai;32;18;50;3;3;6
292;13.05.2016;2016;05;22;Perjantai;4;7;11;3;0;3
292;13.05.2016;2016;05;23;Perjantai;5;5;10;4;5;9
292;14.05.2016;2016;05;00;Lauantai;0;4;4;5;1;6
292;14.05.2016;2016;05;01;Lauantai;1;5;6;0;0;0
292;14.05.2016;2016;05;02;Lauantai;1;2;3;2;3;5
292;14.05.2016;2016;05;03;Lauantai;1;1;2;0;1;1
292;14.05.2016;2016;05;04;Lauantai;2;1;3;2;0;2
292;14.05.2016;2016;05;05;Lauantai;2;2;4;1;3;4
292;14.05.2016;2016;05;06;Lauantai;6;1;7;1;1;2
292;14.05.2016;2016;05;07;Lauantai;4;9;13;2;3;5
292;14.05.2016;2016;05;08;Lauantai;14;19;33;7;3;10
292;14.05.2016;2016;05;09;Lauantai;24;21;45;5;6;11
292;14.05.2016;2016;05;10;Lauantai;19;33;52;6;5;11
292;14.05.2016;2016;05;11;Lauantai;51;28;79;7;8;15
292;14.05.2016;2016;05;12;Lauantai;49;18;67;7;6;13
292;14.05.2016;2016;05;13;Lauantai;23;18;41;9;3;12
292;14.05.2016;2016;05;14;Lauantai;30;35;65;7;4;11
292;14.05.2016;2016;05;15;Lauantai;30;26;56;8;9;17
292;14.05.2016;2016;05;16;Lauantai;40;30;70;10;9;19
292;14.05.2016;2016;05;17;Lauantai;35;22;57;7;7;14
292;14.05.2016;2016;05;18;Lauantai;25;15;40;14;8;22
292;14.05.2016;2016;05;19;Lauantai;17;7;24;10;12;22
292;14.05.2016;2016;05;20;Lauantai;9;13;22;8;12;20
292;14.05.2016;2016;05;21;Lauantai;10;10;20;3;4;7
292;14.05.2016;2016;05;22;Lauantai;2;9;11;4;3;7
292;14.05.2016;2016;05;23;Lauantai;5;3;8;6;5;11
292;15.05.2016;2016;05;00;Sunnuntai;6;3;9;0;0;0
292;15.05.2016;2016;05;01;Sunnuntai;1;4;5;1;1;2
292;15.05.2016;2016;05;02;Sunnuntai;1;2;3;0;6;6
292;15.05.2016;2016;05;03;Sunnuntai;0;2;2;0;1;1
292;15.05.2016;2016;05;04;Sunnuntai;1;0;1;0;0;0
292;15.05.2016;2016;05;05;Sunnuntai;1;2;3;1;0;1
292;15.05.2016;2016;05;06;Sunnuntai;6;4;10;4;3;7
292;15.05.2016;2016;05;07;Sunnuntai;2;4;6;1;5;6
292;15.05.2016;2016;05;08;Sunnuntai;5;2;7;9;4;13
292;15.05.2016;2016;05;09;Sunnuntai;14;16;30;7;2;9
292;15.05.2016;2016;05;10;Sunnuntai;13;8;21;4;8;12
292;15.05.2016;2016;05;11;Sunnuntai;27;26;53;12;12;24
292;15.05.2016;2016;05;12;Sunnuntai;36;19;55;3;6;9
292;15.05.2016;2016;05;13;Sunnuntai;20;25;45;14;7;21
292;15.05.2016;2016;05;14;Sunnuntai;24;20;44;9;7;16
292;15.05.2016;2016;05;15;Sunnuntai;23;20;43;8;9;17
292;15.05.2016;2016;05;16;Sunnuntai;15;15;30;6;7;13
292;15.05.2016;2016;05;17;Sunnuntai;26;13;39;9;5;14
292;15.05.2016;2016;05;18;Sunnuntai;18;12;30;6;6;12
292;15.05.2016;2016;05;19;Sunnuntai;15;21;36;6;6;12
292;15.05.2016;2016;05;20;Sunnuntai;6;10;16;2;2;4
292;15.05.2016;2016;05;21;Sunnuntai;5;7;12;2;3;5
292;15.05.2016;2016;05;22;Sunnuntai;6;7;13;1;2;3
292;15.05.2016;2016;05;23;Sunnuntai;3;1;4;0;3;3
292;16.05.2016;2016;05;00;Maanantai;0;2;2;0;0;0
292;16.05.2016;2016;05;01;Maanantai;0;4;4;2;1;3
292;16.05.2016;2016;05;02;Maanantai;0;1;1;0;0;0
292;16.05.2016;2016;05;03;Maanantai;0;0;0;1;0;1
292;16.05.2016;2016;05;04;Maanantai;3;0;3;0;0;0
292;16.05.2016;2016;05;05;Maanantai;15;7;22;2;0;2
292;16.05.2016;2016;05;06;Maanantai;34;17;51;4;2;6
292;16.05.2016;2016;05;07;Maanantai;71;45;116;13;12;25
292;16.05.2016;2016;05;08;Maanantai;49;29;78;11;7;18
292;16.05.2016;2016;05;09;Maanantai;55;34;89;7;3;10
292;16.05.2016;2016;05;10;Maanantai;33;24;57;1;8;9
292;16.05.2016;2016;05;11;Maanantai;38;36;74;11;4;15
292;16.05.2016;2016;05;12;Maanantai;48;32;80;5;7;12
292;16.05.2016;2016;05;13;Maanantai;43;52;95;8;7;15
292;16.05.2016;2016;05;14;Maanantai;57;56;113;8;6;14
292;16.05.2016;2016;05;15;Maanantai;63;86;149;14;15;29
292;16.05.2016;2016;05;16;Maanantai;73;73;146;17;25;42
292;16.05.2016;2016;05;17;Maanantai;89;64;153;19;18;37
292;16.05.2016;2016;05;18;Maanantai;71;65;136;11;20;31
292;16.05.2016;2016;05;19;Maanantai;69;50;119;12;26;38
292;16.05.2016;2016;05;20;Maanantai;19;52;71;15;12;27
292;16.05.2016;2016;05;21;Maanantai;19;23;42;7;3;10
292;16.05.2016;2016;05;22;Maanantai;5;7;12;1;0;1
292;16.05.2016;2016;05;23;Maanantai;4;7;11;1;0;1
292;17.05.2016;2016;05;00;Tiistai;0;0;0;5;5;10
292;17.05.2016;2016;05;01;Tiistai;0;0;0;0;0;0
292;17.05.2016;2016;05;02;Tiistai;0;1;1;0;1;1
292;17.05.2016;2016;05;03;Tiistai;0;2;2;1;0;1
292;17.05.2016;2016;05;04;Tiistai;4;0;4;0;0;0
292;17.05.2016;2016;05;05;Tiistai;14;3;17;2;0;2
292;17.05.2016;2016;05;06;Tiistai;22;12;34;4;3;7
292;17.05.2016;2016;05;07;Tiistai;48;35;83;10;5;15
292;17.05.2016;2016;05;08;Tiistai;62;33;95;9;6;15
292;17.05.2016;2016;05;09;Tiistai;20;17;37;6;4;10
292;17.05.2016;2016;05;10;Tiistai;8;12;20;1;1;2
292;17.05.2016;2016;05;11;Tiistai;11;10;21;7;2;9
292;17.05.2016;2016;05;12;Tiistai;15;10;25;4;3;7
292;17.05.2016;2016;05;13;Tiistai;21;25;46;3;2;5
292;17.05.2016;2016;05;14;Tiistai;33;68;101;6;9;15
292;17.05.2016;2016;05;15;Tiistai;52;38;90;7;6;13
292;17.05.2016;2016;05;16;Tiistai;46;42;88;10;7;17
292;17.05.2016;2016;05;17;Tiistai;37;38;75;12;9;21
292;17.05.2016;2016;05;18;Tiistai;41;32;73;9;7;16
292;17.05.2016;2016;05;19;Tiistai;49;34;83;22;15;37
292;17.05.2016;2016;05;20;Tiistai;21;18;39;9;4;13
292;17.05.2016;2016;05;21;Tiistai;4;9;13;5;7;12
292;17.05.2016;2016;05;22;Tiistai;10;9;19;1;0;1
292;17.05.2016;2016;05;23;Tiistai;2;7;9;3;0;3
292;18.05.2016;2016;05;00;Keskiviikko;0;1;1;0;0;0
292;18.05.2016;2016;05;01;Keskiviikko;0;0;0;0;0;0
292;18.05.2016;2016;05;02;Keskiviikko;0;0;0;0;0;0
292;18.05.2016;2016;05;03;Keskiviikko;0;1;1;1;0;1
292;18.05.2016;2016;05;04;Keskiviikko;1;0;1;3;0;3
292;18.05.2016;2016;05;05;Keskiviikko;13;6;19;4;3;7
292;18.05.2016;2016;05;06;Keskiviikko;28;14;42;1;3;4
292;18.05.2016;2016;05;07;Keskiviikko;83;34;117;13;7;20
292;18.05.2016;2016;05;08;Keskiviikko;78;42;120;3;9;12
292;18.05.2016;2016;05;09;Keskiviikko;38;28;66;10;6;16
292;18.05.2016;2016;05;10;Keskiviikko;33;27;60;9;7;16
292;18.05.2016;2016;05;11;Keskiviikko;37;28;65;12;2;14
292;18.05.2016;2016;05;12;Keskiviikko;43;22;65;12;2;14
292;18.05.2016;2016;05;13;Keskiviikko;48;92;140;16;15;31
292;18.05.2016;2016;05;14;Keskiviikko;40;56;96;7;8;15
292;18.05.2016;2016;05;15;Keskiviikko;47;45;92;9;13;22
292;18.05.2016;2016;05;16;Keskiviikko;35;36;71;9;6;15
292;18.05.2016;2016;05;17;Keskiviikko;25;13;38;2;4;6
292;18.05.2016;2016;05;18;Keskiviikko;18;19;37;4;2;6
292;18.05.2016;2016;05;19;Keskiviikko;27;22;49;6;2;8
292;18.05.2016;2016;05;20;Keskiviikko;21;8;29;4;2;6
292;18.05.2016;2016;05;21;Keskiviikko;6;12;18;5;2;7
292;18.05.2016;2016;05;22;Keskiviikko;1;1;2;0;1;1
292;18.05.2016;2016;05;23;Keskiviikko;0;1;1;0;0;0
292;19.05.2016;2016;05;00;Torstai;0;0;0;0;0;0
292;19.05.2016;2016;05;01;Torstai;0;1;1;0;0;0
292;19.05.2016;2016;05;02;Torstai;0;0;0;0;0;0
292;19.05.2016;2016;05;03;Torstai;0;0;0;1;0;1
292;19.05.2016;2016;05;04;Torstai;1;1;2;0;0;0
292;19.05.2016;2016;05;05;Torstai;12;5;17;0;0;0
292;19.05.2016;2016;05;06;Torstai;15;7;22;1;2;3
292;19.05.2016;2016;05;07;Torstai;57;34;91;6;4;10
292;19.05.2016;2016;05;08;Torstai;39;32;71;10;6;16
292;19.05.2016;2016;05;09;Torstai;54;25;79;4;5;9
292;19.05.2016;2016;05;10;Torstai;20;13;33;6;0;6
292;19.05.2016;2016;05;11;Torstai;29;17;46;8;2;10
292;19.05.2016;2016;05;12;Torstai;34;22;56;14;3;17
292;19.05.2016;2016;05;13;Torstai;48;49;97;4;3;7
292;19.05.2016;2016;05;14;Torstai;56;63;119;6;11;17
292;19.05.2016;2016;05;15;Torstai;56;77;133;17;20;37
292;19.05.2016;2016;05;16;Torstai;56;63;119;16;22;38
292;19.05.2016;2016;05;17;Torstai;48;25;73;8;6;14
292;19.05.2016;2016;05;18;Torstai;38;39;77;11;8;19
292;19.05.2016;2016;05;19;Torstai;24;32;56;10;17;27
292;19.05.2016;2016;05;20;Torstai;22;19;41;3;3;6
292;19.05.2016;2016;05;21;Torstai;16;17;33;2;2;4
292;19.05.2016;2016;05;22;Torstai;6;5;11;0;1;1
292;19.05.2016;2016;05;23;Torstai;2;2;4;3;3;6
292;20.05.2016;2016;05;00;Perjantai;2;0;2;2;0;2
292;20.05.2016;2016;05;01;Perjantai;0;3;3;0;0;0
292;20.05.2016;2016;05;02;Perjantai;0;2;2;0;0;0
292;20.05.2016;2016;05;03;Perjantai;0;3;3;1;0;1
292;20.05.2016;2016;05;04;Perjantai;3;1;4;0;0;0
292;20.05.2016;2016;05;05;Perjantai;9;7;16;2;1;3
292;20.05.2016;2016;05;06;Perjantai;32;19;51;4;1;5
292;20.05.2016;2016;05;07;Perjantai;69;33;102;9;7;16
292;20.05.2016;2016;05;08;Perjantai;90;32;122;7;6;13
292;20.05.2016;2016;05;09;Perjantai;59;21;80;7;7;14
292;20.05.2016;2016;05;10;Perjantai;25;21;46;6;5;11
292;20.05.2016;2016;05;11;Perjantai;35;32;67;6;9;15
292;20.05.2016;2016;05;12;Perjantai;58;59;117;17;10;27
292;20.05.2016;2016;05;13;Perjantai;32;77;109;5;23;28
292;20.05.2016;2016;05;14;Perjantai;60;91;151;19;20;39
292;20.05.2016;2016;05;15;Perjantai;60;74;134;22;17;39
292;20.05.2016;2016;05;16;Perjantai;76;53;129;15;13;28
292;20.05.2016;2016;05;17;Perjantai;57;43;100;14;19;33
292;20.05.2016;2016;05;18;Perjantai;46;41;87;18;9;27
292;20.05.2016;2016;05;19;Perjantai;56;45;101;19;18;37
292;20.05.2016;2016;05;20;Perjantai;34;46;80;5;15;20
292;20.05.2016;2016;05;21;Perjantai;18;26;44;8;7;15
292;20.05.2016;2016;05;22;Perjantai;9;17;26;4;3;7
292;20.05.2016;2016;05;23;Perjantai;15;8;23;5;2;7
292;21.05.2016;2016;05;00;Lauantai;10;6;16;2;1;3
292;21.05.2016;2016;05;01;Lauantai;3;4;7;0;2;2
292;21.05.2016;2016;05;02;Lauantai;2;2;4;2;4;6
292;21.05.2016;2016;05;03;Lauantai;1;5;6;0;3;3
292;21.05.2016;2016;05;04;Lauantai;1;0;1;1;0;1
292;21.05.2016;2016;05;05;Lauantai;0;4;4;1;1;2
292;21.05.2016;2016;05;06;Lauantai;4;3;7;3;1;4
292;21.05.2016;2016;05;07;Lauantai;16;9;25;4;4;8
292;21.05.2016;2016;05;08;Lauantai;15;12;27;9;6;15
292;21.05.2016;2016;05;09;Lauantai;40;25;65;8;3;11
292;21.05.2016;2016;05;10;Lauantai;50;46;96;10;11;21
292;21.05.2016;2016;05;11;Lauantai;62;47;109;7;8;15
292;21.05.2016;2016;05;12;Lauantai;69;43;112;10;8;18
292;21.05.2016;2016;05;13;Lauantai;50;25;75;21;8;29
292;21.05.2016;2016;05;14;Lauantai;62;39;101;9;14;23
292;21.05.2016;2016;05;15;Lauantai;33;46;79;14;14;28
292;21.05.2016;2016;05;16;Lauantai;32;26;58;13;9;22
292;21.05.2016;2016;05;17;Lauantai;29;12;41;8;3;11
292;21.05.2016;2016;05;18;Lauantai;20;19;39;6;12;18
292;21.05.2016;2016;05;19;Lauantai;34;32;66;8;8;16
292;21.05.2016;2016;05;20;Lauantai;27;28;55;3;5;8
292;21.05.2016;2016;05;21;Lauantai;16;14;30;5;7;12
292;21.05.2016;2016;05;22;Lauantai;5;5;10;2;0;2
292;21.05.2016;2016;05;23;Lauantai;5;8;13;5;5;10
292;22.05.2016;2016;05;00;Sunnuntai;8;4;12;3;1;4
292;22.05.2016;2016;05;01;Sunnuntai;3;2;5;1;0;1
292;22.05.2016;2016;05;02;Sunnuntai;0;2;2;0;6;6
292;22.05.2016;2016;05;03;Sunnuntai;0;1;1;0;5;5
292;22.05.2016;2016;05;04;Sunnuntai;0;0;0;0;0;0
292;22.05.2016;2016;05;05;Sunnuntai;0;1;1;2;2;4
292;22.05.2016;2016;05;06;Sunnuntai;2;1;3;0;0;0
292;22.05.2016;2016;05;07;Sunnuntai;2;4;6;0;0;0
292;22.05.2016;2016;05;08;Sunnuntai;9;6;15;4;1;5
292;22.05.2016;2016;05;09;Sunnuntai;21;12;33;12;2;14
292;22.05.2016;2016;05;10;Sunnuntai;27;9;36;12;12;24
292;22.05.2016;2016;05;11;Sunnuntai;39;51;90;11;15;26
292;22.05.2016;2016;05;12;Sunnuntai;43;58;101;17;8;25
292;22.05.2016;2016;05;13;Sunnuntai;69;54;123;14;22;36
292;22.05.2016;2016;05;14;Sunnuntai;57;46;103;12;9;21
292;22.05.2016;2016;05;15;Sunnuntai;47;48;95;15;16;31
292;22.05.2016;2016;05;16;Sunnuntai;69;79;148;13;16;29
292;22.05.2016;2016;05;17;Sunnuntai;68;40;108;17;11;28
292;22.05.2016;2016;05;18;Sunnuntai;45;41;86;16;10;26
292;22.05.2016;2016;05;19;Sunnuntai;41;42;83;17;13;30
292;22.05.2016;2016;05;20;Sunnuntai;17;12;29;10;8;18
292;22.05.2016;2016;05;21;Sunnuntai;5;10;15;5;2;7
292;22.05.2016;2016;05;22;Sunnuntai;1;5;6;3;3;6
292;22.05.2016;2016;05;23;Sunnuntai;3;4;7;2;5;7
292;23.05.2016;2016;05;00;Maanantai;2;3;5;1;0;1
292;23.05.2016;2016;05;01;Maanantai;2;1;3;0;1;1
292;23.05.2016;2016;05;02;Maanantai;0;2;2;0;0;0
292;23.05.2016;2016;05;03;Maanantai;0;0;0;1;0;1
292;23.05.2016;2016;05;04;Maanantai;2;1;3;0;0;0
292;23.05.2016;2016;05;05;Maanantai;8;4;12;1;1;2
292;23.05.2016;2016;05;06;Maanantai;36;21;57;6;1;7
292;23.05.2016;2016;05;07;Maanantai;93;37;130;15;5;20
292;23.05.2016;2016;05;08;Maanantai;72;33;105;10;3;13
292;23.05.2016;2016;05;09;Maanantai;75;29;104;11;6;17
292;23.05.2016;2016;05;10;Maanantai;47;37;84;9;3;12
292;23.05.2016;2016;05;11;Maanantai;62;42;104;6;6;12
292;23.05.2016;2016;05;12;Maanantai;50;34;84;5;14;19
292;23.05.2016;2016;05;13;Maanantai;47;70;117;15;13;28
292;23.05.2016;2016;05;14;Maanantai;64;73;137;12;12;24
292;23.05.2016;2016;05;15;Maanantai;62;103;165;11;20;31
292;23.05.2016;2016;05;16;Maanantai;92;81;173;19;23;42
292;23.05.2016;2016;05;17;Maanantai;92;62;154;11;20;31
292;23.05.2016;2016;05;18;Maanantai;62;59;121;21;22;43
292;23.05.2016;2016;05;19;Maanantai;52;86;138;13;23;36
292;23.05.2016;2016;05;20;Maanantai;50;46;96;14;12;26
292;23.05.2016;2016;05;21;Maanantai;11;16;27;7;5;12
292;23.05.2016;2016;05;22;Maanantai;4;14;18;1;3;4
292;23.05.2016;2016;05;23;Maanantai;4;2;6;3;0;3
292;24.05.2016;2016;05;00;Tiistai;0;1;1;0;3;3
292;24.05.2016;2016;05;01;Tiistai;0;1;1;0;1;1
292;24.05.2016;2016;05;02;Tiistai;1;0;1;0;0;0
292;24.05.2016;2016;05;03;Tiistai;0;0;0;1;0;1
292;24.05.2016;2016;05;04;Tiistai;3;0;3;0;0;0
292;24.05.2016;2016;05;05;Tiistai;5;5;10;4;1;5
292;24.05.2016;2016;05;06;Tiistai;37;21;58;2;8;10
292;24.05.2016;2016;05;07;Tiistai;103;42;145;14;8;22
292;24.05.2016;2016;05;08;Tiistai;82;29;111;7;5;12
292;24.05.2016;2016;05;09;Tiistai;53;28;81;9;11;20
292;24.05.2016;2016;05;10;Tiistai;46;29;75;10;7;17
292;24.05.2016;2016;05;11;Tiistai;45;50;95;5;8;13
292;24.05.2016;2016;05;12;Tiistai;40;47;87;15;8;23
292;24.05.2016;2016;05;13;Tiistai;45;63;108;16;17;33
292;24.05.2016;2016;05;14;Tiistai;60;99;159;8;15;23
292;24.05.2016;2016;05;15;Tiistai;60;81;141;19;20;39
292;24.05.2016;2016;05;16;Tiistai;86;71;157;16;15;31
292;24.05.2016;2016;05;17;Tiistai;35;18;53;6;7;13
292;24.05.2016;2016;05;18;Tiistai;17;25;42;4;5;9
292;24.05.2016;2016;05;19;Tiistai;21;30;51;6;13;19
292;24.05.2016;2016;05;20;Tiistai;16;25;41;7;7;14
292;24.05.2016;2016;05;21;Tiistai;11;12;23;0;1;1
292;24.05.2016;2016;05;22;Tiistai;2;3;5;3;3;6
292;24.05.2016;2016;05;23;Tiistai;1;2;3;0;1;1
292;25.05.2016;2016;05;00;Keskiviikko;0;3;3;0;0;0
292;25.05.2016;2016;05;01;Keskiviikko;3;2;5;0;0;0
292;25.05.2016;2016;05;02;Keskiviikko;1;1;2;0;2;2
292;25.05.2016;2016;05;03;Keskiviikko;0;1;1;1;0;1
292;25.05.2016;2016;05;04;Keskiviikko;2;0;2;0;0;0
292;25.05.2016;2016;05;05;Keskiviikko;4;4;8;2;2;4
292;25.05.2016;2016;05;06;Keskiviikko;20;20;40;3;3;6
292;25.05.2016;2016;05;07;Keskiviikko;76;38;114;7;6;13
292;25.05.2016;2016;05;08;Keskiviikko;53;25;78;16;11;27
292;25.05.2016;2016;05;09;Keskiviikko;31;13;44;3;9;12
292;25.05.2016;2016;05;10;Keskiviikko;19;24;43;2;8;10
292;25.05.2016;2016;05;11;Keskiviikko;19;27;46;5;3;8
292;25.05.2016;2016;05;12;Keskiviikko;24;39;63;8;7;15
292;25.05.2016;2016;05;13;Keskiviikko;39;88;127;9;15;24
292;25.05.2016;2016;05;14;Keskiviikko;37;58;95;6;9;15
292;25.05.2016;2016;05;15;Keskiviikko;72;56;128;13;16;29
292;25.05.2016;2016;05;16;Keskiviikko;42;50;92;22;12;34
292;25.05.2016;2016;05;17;Keskiviikko;55;32;87;14;6;20
292;25.05.2016;2016;05;18;Keskiviikko;28;26;54;7;12;19
292;25.05.2016;2016;05;19;Keskiviikko;29;34;63;9;7;16
292;25.05.2016;2016;05;20;Keskiviikko;13;23;36;10;7;17
292;25.05.2016;2016;05;21;Keskiviikko;8;14;22;2;4;6
292;25.05.2016;2016;05;22;Keskiviikko;4;11;15;1;2;3
292;25.05.2016;2016;05;23;Keskiviikko;3;5;8;0;3;3
292;26.05.2016;2016;05;00;Torstai;0;1;1;0;0;0
292;26.05.2016;2016;05;01;Torstai;0;0;0;0;0;0
292;26.05.2016;2016;05;02;Torstai;0;0;0;0;0;0
292;26.05.2016;2016;05;03;Torstai;1;0;1;0;0;0
292;26.05.2016;2016;05;04;Torstai;3;0;3;0;0;0
292;26.05.2016;2016;05;05;Torstai;10;5;15;2;2;4
292;26.05.2016;2016;05;06;Torstai;29;21;50;4;4;8
292;26.05.2016;2016;05;07;Torstai;82;40;122;13;7;20
292;26.05.2016;2016;05;08;Torstai;66;35;101;14;3;17
292;26.05.2016;2016;05;09;Torstai;35;48;83;5;14;19
292;26.05.2016;2016;05;10;Torstai;26;42;68;7;12;19
292;26.05.2016;2016;05;11;Torstai;40;43;83;10;8;18
292;26.05.2016;2016;05;12;Torstai;57;41;98;15;12;27
292;26.05.2016;2016;05;13;Torstai;36;82;118;14;10;24
292;26.05.2016;2016;05;14;Torstai;44;56;100;7;8;15
292;26.05.2016;2016;05;15;Torstai;48;66;114;11;13;24
292;26.05.2016;2016;05;16;Torstai;66;67;133;8;19;27
292;26.05.2016;2016;05;17;Torstai;43;46;89;10;9;19
292;26.05.2016;2016;05;18;Torstai;60;54;114;9;11;20
292;26.05.2016;2016;05;19;Torstai;52;55;107;14;11;25
292;26.05.2016;2016;05;20;Torstai;30;51;81;7;12;19
292;26.05.2016;2016;05;21;Torstai;12;18;30;6;10;16
292;26.05.2016;2016;05;22;Torstai;6;10;16;5;1;6
292;26.05.2016;2016;05;23;Torstai;3;5;8;1;2;3
292;27.05.2016;2016;05;00;Perjantai;0;0;0;2;0;2
292;27.05.2016;2016;05;01;Perjantai;0;2;2;0;1;1
292;27.05.2016;2016;05;02;Perjantai;2;2;4;0;0;0
292;27.05.2016;2016;05;03;Perjantai;0;2;2;0;0;0
292;27.05.2016;2016;05;04;Perjantai;2;1;3;0;0;0
292;27.05.2016;2016;05;05;Perjantai;9;8;17;2;2;4
292;27.05.2016;2016;05;06;Perjantai;38;16;54;5;1;6
292;27.05.2016;2016;05;07;Perjantai;69;37;106;14;10;24
292;27.05.2016;2016;05;08;Perjantai;85;29;114;20;11;31
292;27.05.2016;2016;05;09;Perjantai;55;28;83;7;6;13
292;27.05.2016;2016;05;10;Perjantai;27;39;66;10;7;17
292;27.05.2016;2016;05;11;Perjantai;39;50;89;7;9;16
292;27.05.2016;2016;05;12;Perjantai;55;44;99;11;12;23
292;27.05.2016;2016;05;13;Perjantai;53;100;153;14;13;27
292;27.05.2016;2016;05;14;Perjantai;68;92;160;11;11;22
292;27.05.2016;2016;05;15;Perjantai;55;77;132;13;13;26
292;27.05.2016;2016;05;16;Perjantai;82;76;158;27;15;42
292;27.05.2016;2016;05;17;Perjantai;81;65;146;15;13;28
292;27.05.2016;2016;05;18;Perjantai;73;58;131;20;15;35
292;27.05.2016;2016;05;19;Perjantai;56;55;111;11;11;22
292;27.05.2016;2016;05;20;Perjantai;32;34;66;11;16;27
292;27.05.2016;2016;05;21;Perjantai;20;29;49;3;6;9
292;27.05.2016;2016;05;22;Perjantai;4;14;18;4;8;12
292;27.05.2016;2016;05;23;Perjantai;12;7;19;8;4;12
292;28.05.2016;2016;05;00;Lauantai;7;6;13;4;3;7
292;28.05.2016;2016;05;01;Lauantai;1;3;4;3;1;4
292;28.05.2016;2016;05;02;Lauantai;0;4;4;2;6;8
292;28.05.2016;2016;05;03;Lauantai;1;1;2;1;2;3
292;28.05.2016;2016;05;04;Lauantai;0;3;3;2;1;3
292;28.05.2016;2016;05;05;Lauantai;1;1;2;2;0;2
292;28.05.2016;2016;05;06;Lauantai;9;7;16;1;2;3
292;28.05.2016;2016;05;07;Lauantai;8;8;16;4;3;7
292;28.05.2016;2016;05;08;Lauantai;20;16;36;4;2;6
292;28.05.2016;2016;05;09;Lauantai;29;33;62;7;11;18
292;28.05.2016;2016;05;10;Lauantai;41;38;79;14;8;22
292;28.05.2016;2016;05;11;Lauantai;54;46;100;15;11;26
292;28.05.2016;2016;05;12;Lauantai;60;56;116;13;9;22
292;28.05.2016;2016;05;13;Lauantai;47;46;93;17;14;31
292;28.05.2016;2016;05;14;Lauantai;50;72;122;7;13;20
292;28.05.2016;2016;05;15;Lauantai;77;68;145;13;12;25
292;28.05.2016;2016;05;16;Lauantai;58;54;112;12;12;24
292;28.05.2016;2016;05;17;Lauantai;82;43;125;20;11;31
292;28.05.2016;2016;05;18;Lauantai;51;41;92;14;16;30
292;28.05.2016;2016;05;19;Lauantai;55;46;101;18;10;28
292;28.05.2016;2016;05;20;Lauantai;32;32;64;8;18;26
292;28.05.2016;2016;05;21;Lauantai;14;29;43;5;11;16
292;28.05.2016;2016;05;22;Lauantai;8;12;20;0;4;4
292;28.05.2016;2016;05;23;Lauantai;5;9;14;3;2;5
292;29.05.2016;2016;05;00;Sunnuntai;9;5;14;7;2;9
292;29.05.2016;2016;05;01;Sunnuntai;3;7;10;3;1;4
292;29.05.2016;2016;05;02;Sunnuntai;2;2;4;3;4;7
292;29.05.2016;2016;05;03;Sunnuntai;2;7;9;1;2;3
292;29.05.2016;2016;05;04;Sunnuntai;1;1;2;2;1;3
292;29.05.2016;2016;05;05;Sunnuntai;1;5;6;1;0;1
292;29.05.2016;2016;05;06;Sunnuntai;9;5;14;2;1;3
292;29.05.2016;2016;05;07;Sunnuntai;4;5;9;2;0;2
292;29.05.2016;2016;05;08;Sunnuntai;16;15;31;7;4;11
292;29.05.2016;2016;05;09;Sunnuntai;42;23;65;6;10;16
292;29.05.2016;2016;05;10;Sunnuntai;55;46;101;9;14;23
292;29.05.2016;2016;05;11;Sunnuntai;55;60;115;18;14;32
292;29.05.2016;2016;05;12;Sunnuntai;57;84;141;12;15;27
292;29.05.2016;2016;05;13;Sunnuntai;91;83;174;11;16;27
292;29.05.2016;2016;05;14;Sunnuntai;52;54;106;16;9;25
292;29.05.2016;2016;05;15;Sunnuntai;74;72;146;11;13;24
292;29.05.2016;2016;05;16;Sunnuntai;171;64;235;17;14;31
292;29.05.2016;2016;05;17;Sunnuntai;89;56;145;16;11;27
292;29.05.2016;2016;05;18;Sunnuntai;66;68;134;23;13;36
292;29.05.2016;2016;05;19;Sunnuntai;60;123;183;19;26;45
292;29.05.2016;2016;05;20;Sunnuntai;23;43;66;11;10;21
292;29.05.2016;2016;05;21;Sunnuntai;10;27;37;6;7;13
292;29.05.2016;2016;05;22;Sunnuntai;4;6;10;6;3;9
292;29.05.2016;2016;05;23;Sunnuntai;2;4;6;1;1;2
292;30.05.2016;2016;05;00;Maanantai;2;2;4;0;2;2
292;30.05.2016;2016;05;01;Maanantai;2;2;4;2;1;3
292;30.05.2016;2016;05;02;Maanantai;0;0;0;0;0;0
292;30.05.2016;2016;05;03;Maanantai;1;1;2;2;0;2
292;30.05.2016;2016;05;04;Maanantai;2;0;2;1;0;1
292;30.05.2016;2016;05;05;Maanantai;11;10;21;4;0;4
292;30.05.2016;2016;05;06;Maanantai;32;21;53;9;7;16
292;30.05.2016;2016;05;07;Maanantai;101;46;147;12;13;25
292;30.05.2016;2016;05;08;Maanantai;81;41;122;26;6;32
292;30.05.2016;2016;05;09;Maanantai;37;41;78;8;8;16
292;30.05.2016;2016;05;10;Maanantai;28;52;80;8;11;19
292;30.05.2016;2016;05;11;Maanantai;66;57;123;15;10;25
292;30.05.2016;2016;05;12;Maanantai;45;63;108;13;8;21
292;30.05.2016;2016;05;13;Maanantai;61;90;151;18;13;31
292;30.05.2016;2016;05;14;Maanantai;57;101;158;15;8;23
292;30.05.2016;2016;05;15;Maanantai;79;82;161;16;15;31
292;30.05.2016;2016;05;16;Maanantai;106;105;211;20;21;41
292;30.05.2016;2016;05;17;Maanantai;81;69;150;20;16;36
292;30.05.2016;2016;05;18;Maanantai;87;76;163;18;17;35
292;30.05.2016;2016;05;19;Maanantai;70;52;122;20;18;38
292;30.05.2016;2016;05;20;Maanantai;44;63;107;16;20;36
292;30.05.2016;2016;05;21;Maanantai;14;25;39;4;5;9
292;30.05.2016;2016;05;22;Maanantai;5;5;10;1;3;4
292;30.05.2016;2016;05;23;Maanantai;3;5;8;0;0;0
292;31.05.2016;2016;05;00;Tiistai;0;3;3;0;0;0
292;31.05.2016;2016;05;01;Tiistai;1;2;3;0;1;1
292;31.05.2016;2016;05;02;Tiistai;0;1;1;0;0;0
292;31.05.2016;2016;05;03;Tiistai;1;0;1;2;0;2
292;31.05.2016;2016;05;04;Tiistai;4;1;5;0;0;0
292;31.05.2016;2016;05;05;Tiistai;16;8;24;2;2;4
292;31.05.2016;2016;05;06;Tiistai;34;19;53;7;2;9
292;31.05.2016;2016;05;07;Tiistai;71;40;111;10;8;18
292;31.05.2016;2016;05;08;Tiistai;188;40;228;31;4;35
292;31.05.2016;2016;05;09;Tiistai;101;95;196;12;8;20
292;31.05.2016;2016;05;10;Tiistai;60;55;115;6;8;14
292;31.05.2016;2016;05;11;Tiistai;73;46;119;15;11;26
292;31.05.2016;2016;05;12;Tiistai;58;96;154;18;21;39
292;31.05.2016;2016;05;13;Tiistai;78;176;254;16;19;35
292;31.05.2016;2016;05;14;Tiistai;81;135;216;11;13;24
292;31.05.2016;2016;05;15;Tiistai;67;75;142;15;18;33
292;31.05.2016;2016;05;16;Tiistai;100;102;202;16;16;32
292;31.05.2016;2016;05;17;Tiistai;132;65;197;24;19;43
292;31.05.2016;2016;05;18;Tiistai;79;58;137;18;10;28
292;31.05.2016;2016;05;19;Tiistai;55;74;129;26;18;44
292;31.05.2016;2016;05;20;Tiistai;42;98;140;17;15;32
292;31.05.2016;2016;05;21;Tiistai;14;30;44;9;9;18
292;31.05.2016;2016;05;22;Tiistai;8;7;15;1;6;7
292;31.05.2016;2016;05;23;Tiistai;1;0;1;2;3;5
292;01.06.2016;2016;06;00;Keskiviikko;0;2;2;0;2;2
292;01.06.2016;2016;06;01;Keskiviikko;1;1;2;0;1;1
292;01.06.2016;2016;06;02;Keskiviikko;2;2;4;0;0;0
292;01.06.2016;2016;06;03;Keskiviikko;2;0;2;2;0;2
292;01.06.2016;2016;06;04;Keskiviikko;3;1;4;0;0;0
292;01.06.2016;2016;06;05;Keskiviikko;13;9;22;3;1;4
292;01.06.2016;2016;06;06;Keskiviikko;35;21;56;4;3;7
292;01.06.2016;2016;06;07;Keskiviikko;74;42;116;9;10;19
292;01.06.2016;2016;06;08;Keskiviikko;95;41;136;19;4;23
292;01.06.2016;2016;06;09;Keskiviikko;55;51;106;7;7;14
292;01.06.2016;2016;06;10;Keskiviikko;25;31;56;1;10;11
292;01.06.2016;2016;06;11;Keskiviikko;24;35;59;13;9;22
292;01.06.2016;2016;06;12;Keskiviikko;35;48;83;5;9;14
292;01.06.2016;2016;06;13;Keskiviikko;44;85;129;6;13;19
292;01.06.2016;2016;06;14;Keskiviikko;48;65;113;15;15;30
292;01.06.2016;2016;06;15;Keskiviikko;67;77;144;26;16;42
292;01.06.2016;2016;06;16;Keskiviikko;79;101;180;15;17;32
292;01.06.2016;2016;06;17;Keskiviikko;71;67;138;7;21;28
292;01.06.2016;2016;06;18;Keskiviikko;70;57;127;28;8;36
292;01.06.2016;2016;06;19;Keskiviikko;59;52;111;16;18;34
292;01.06.2016;2016;06;20;Keskiviikko;31;60;91;11;21;32
292;01.06.2016;2016;06;21;Keskiviikko;26;28;54;3;6;9
292;01.06.2016;2016;06;22;Keskiviikko;7;9;16;0;2;2
292;01.06.2016;2016;06;23;Keskiviikko;4;2;6;1;0;1
292;02.06.2016;2016;06;00;Torstai;0;2;2;0;0;0
292;02.06.2016;2016;06;01;Torstai;1;3;4;0;2;2
292;02.06.2016;2016;06;02;Torstai;0;2;2;1;0;1
292;02.06.2016;2016;06;03;Torstai;0;1;1;3;0;3
292;02.06.2016;2016;06;04;Torstai;6;1;7;0;0;0
292;02.06.2016;2016;06;05;Torstai;16;9;25;1;0;1
292;02.06.2016;2016;06;06;Torstai;39;17;56;10;6;16
292;02.06.2016;2016;06;07;Torstai;60;37;97;4;7;11
292;02.06.2016;2016;06;08;Torstai;118;67;185;17;11;28
292;02.06.2016;2016;06;09;Torstai;62;46;108;11;7;18
292;02.06.2016;2016;06;10;Torstai;70;78;148;13;15;28
292;02.06.2016;2016;06;11;Torstai;52;41;93;9;12;21
292;02.06.2016;2016;06;12;Torstai;60;61;121;16;8;24
292;02.06.2016;2016;06;13;Torstai;65;129;194;18;21;39
292;02.06.2016;2016;06;14;Torstai;73;67;140;20;14;34
292;02.06.2016;2016;06;15;Torstai;73;91;164;18;20;38
292;02.06.2016;2016;06;16;Torstai;91;84;175;16;23;39
292;02.06.2016;2016;06;17;Torstai;70;54;124;24;14;38
292;02.06.2016;2016;06;18;Torstai;85;91;176;21;18;39
292;02.06.2016;2016;06;19;Torstai;53;63;116;22;21;43
292;02.06.2016;2016;06;20;Torstai;38;41;79;11;14;25
292;02.06.2016;2016;06;21;Torstai;24;35;59;4;9;13
292;02.06.2016;2016;06;22;Torstai;7;11;18;2;2;4
292;02.06.2016;2016;06;23;Torstai;3;5;8;1;0;1
292;03.06.2016;2016;06;00;Perjantai;1;0;1;0;1;1
292;03.06.2016;2016;06;01;Perjantai;0;0;0;0;1;1
292;03.06.2016;2016;06;02;Perjantai;0;0;0;0;0;0
292;03.06.2016;2016;06;03;Perjantai;1;1;2;2;0;2
292;03.06.2016;2016;06;04;Perjantai;2;1;3;0;0;0
292;03.06.2016;2016;06;05;Perjantai;8;7;15;3;2;5
292;03.06.2016;2016;06;06;Perjantai;39;17;56;0;3;3
292;03.06.2016;2016;06;07;Perjantai;33;34;67;4;6;10
292;03.06.2016;2016;06;08;Perjantai;61;38;99;8;9;17
292;03.06.2016;2016;06;09;Perjantai;90;30;120;16;3;19
292;03.06.2016;2016;06;10;Perjantai;23;28;51;12;5;17
292;03.06.2016;2016;06;11;Perjantai;29;61;90;7;5;12
292;03.06.2016;2016;06;12;Perjantai;48;93;141;18;16;34
292;03.06.2016;2016;06;13;Perjantai;46;49;95;6;6;12
292;03.06.2016;2016;06;14;Perjantai;46;69;115;19;10;29
292;03.06.2016;2016;06;15;Perjantai;49;67;116;10;16;26
292;03.06.2016;2016;06;16;Perjantai;65;49;114;15;18;33
292;03.06.2016;2016;06;17;Perjantai;49;47;96;12;10;22
292;03.06.2016;2016;06;18;Perjantai;69;38;107;7;14;21
292;03.06.2016;2016;06;19;Perjantai;31;36;67;4;7;11
292;03.06.2016;2016;06;20;Perjantai;23;34;57;6;11;17
292;03.06.2016;2016;06;21;Perjantai;15;13;28;3;7;10
292;03.06.2016;2016;06;22;Perjantai;20;8;28;3;1;4
292;03.06.2016;2016;06;23;Perjantai;9;6;15;1;1;2
292;04.06.2016;2016;06;00;Lauantai;1;4;5;0;5;5
292;04.06.2016;2016;06;01;Lauantai;1;4;5;0;1;1
292;04.06.2016;2016;06;02;Lauantai;2;2;4;0;4;4
292;04.06.2016;2016;06;03;Lauantai;3;0;3;0;1;1
292;04.06.2016;2016;06;04;Lauantai;1;2;3;1;4;5
292;04.06.2016;2016;06;05;Lauantai;1;1;2;2;0;2
292;04.06.2016;2016;06;06;Lauantai;3;2;5;0;3;3
292;04.06.2016;2016;06;07;Lauantai;30;14;44;2;1;3
292;04.06.2016;2016;06;08;Lauantai;7;20;27;7;1;8
292;04.06.2016;2016;06;09;Lauantai;24;35;59;7;6;13
292;04.06.2016;2016;06;10;Lauantai;33;33;66;2;9;11
292;04.06.2016;2016;06;11;Lauantai;31;39;70;12;10;22
292;04.06.2016;2016;06;12;Lauantai;41;39;80;16;15;31
292;04.06.2016;2016;06;13;Lauantai;27;36;63;8;15;23
292;04.06.2016;2016;06;14;Lauantai;51;35;86;8;6;14
292;04.06.2016;2016;06;15;Lauantai;22;33;55;8;7;15
292;04.06.2016;2016;06;16;Lauantai;39;46;85;7;8;15
292;04.06.2016;2016;06;17;Lauantai;19;25;44;7;6;13
292;04.06.2016;2016;06;18;Lauantai;35;20;55;5;8;13
292;04.06.2016;2016;06;19;Lauantai;19;34;53;9;9;18
292;04.06.2016;2016;06;20;Lauantai;28;28;56;2;12;14
292;04.06.2016;2016;06;21;Lauantai;17;21;38;5;5;10
292;04.06.2016;2016;06;22;Lauantai;10;9;19;2;3;5
292;04.06.2016;2016;06;23;Lauantai;16;6;22;3;1;4
292;05.06.2016;2016;06;00;Sunnuntai;16;9;25;2;1;3
292;05.06.2016;2016;06;01;Sunnuntai;8;7;15;3;2;5
292;05.06.2016;2016;06;02;Sunnuntai;5;7;12;2;5;7
292;05.06.2016;2016;06;03;Sunnuntai;8;2;10;0;5;5
292;05.06.2016;2016;06;04;Sunnuntai;4;3;7;3;2;5
292;05.06.2016;2016;06;05;Sunnuntai;0;3;3;0;2;2
292;05.06.2016;2016;06;06;Sunnuntai;3;5;8;0;2;2
292;05.06.2016;2016;06;07;Sunnuntai;8;5;13;3;1;4
292;05.06.2016;2016;06;08;Sunnuntai;5;4;9;4;3;7
292;05.06.2016;2016;06;09;Sunnuntai;11;11;22;6;10;16
292;05.06.2016;2016;06;10;Sunnuntai;16;19;35;5;12;17
292;05.06.2016;2016;06;11;Sunnuntai;24;33;57;10;6;16
292;05.06.2016;2016;06;12;Sunnuntai;28;30;58;5;5;10
292;05.06.2016;2016;06;13;Sunnuntai;29;37;66;13;13;26
292;05.06.2016;2016;06;14;Sunnuntai;41;34;75;10;13;23
292;05.06.2016;2016;06;15;Sunnuntai;32;21;53;8;7;15
292;05.06.2016;2016;06;16;Sunnuntai;38;17;55;8;4;12
292;05.06.2016;2016;06;17;Sunnuntai;23;22;45;5;11;16
292;05.06.2016;2016;06;18;Sunnuntai;23;38;61;8;8;16
292;05.06.2016;2016;06;19;Sunnuntai;34;42;76;17;10;27
292;05.06.2016;2016;06;20;Sunnuntai;12;9;21;9;4;13
292;05.06.2016;2016;06;21;Sunnuntai;9;16;25;20;19;39
292;05.06.2016;2016;06;22;Sunnuntai;5;10;15;1;1;2
292;05.06.2016;2016;06;23;Sunnuntai;3;1;4;2;1;3
292;06.06.2016;2016;06;00;Maanantai;0;0;0;1;1;2
292;06.06.2016;2016;06;01;Maanantai;1;1;2;0;0;0
292;06.06.2016;2016;06;02;Maanantai;0;0;0;0;0;0
292;06.06.2016;2016;06;03;Maanantai;0;0;0;3;1;4
292;06.06.2016;2016;06;04;Maanantai;2;0;2;0;1;1
292;06.06.2016;2016;06;05;Maanantai;8;5;13;2;1;3
292;06.06.2016;2016;06;06;Maanantai;25;15;40;3;4;7
292;06.06.2016;2016;06;07;Maanantai;34;42;76;4;14;18
292;06.06.2016;2016;06;08;Maanantai;29;34;63;6;8;14
292;06.06.2016;2016;06;09;Maanantai;36;28;64;9;11;20
292;06.06.2016;2016;06;10;Maanantai;22;32;54;10;9;19
292;06.06.2016;2016;06;11;Maanantai;38;61;99;10;6;16
292;06.06.2016;2016;06;12;Maanantai;68;53;121;25;24;49
292;06.06.2016;2016;06;13;Maanantai;49;82;131;15;9;24
292;06.06.2016;2016;06;14;Maanantai;64;60;124;18;11;29
292;06.06.2016;2016;06;15;Maanantai;71;61;132;15;10;25
292;06.06.2016;2016;06;16;Maanantai;85;81;166;17;11;28
292;06.06.2016;2016;06;17;Maanantai;55;46;101;14;17;31
292;06.06.2016;2016;06;18;Maanantai;60;62;122;15;14;29
292;06.06.2016;2016;06;19;Maanantai;63;42;105;13;9;22
292;06.06.2016;2016;06;20;Maanantai;33;34;67;12;8;20
292;06.06.2016;2016;06;21;Maanantai;36;39;75;6;6;12
292;06.06.2016;2016;06;22;Maanantai;2;13;15;5;1;6
292;06.06.2016;2016;06;23;Maanantai;1;3;4;3;1;4
292;07.06.2016;2016;06;00;Tiistai;2;2;4;0;0;0
292;07.06.2016;2016;06;01;Tiistai;0;1;1;0;0;0
292;07.06.2016;2016;06;02;Tiistai;0;0;0;0;1;1
292;07.06.2016;2016;06;03;Tiistai;1;1;2;2;0;2
292;07.06.2016;2016;06;04;Tiistai;2;0;2;0;0;0
292;07.06.2016;2016;06;05;Tiistai;10;9;19;0;0;0
292;07.06.2016;2016;06;06;Tiistai;35;14;49;6;2;8
292;07.06.2016;2016;06;07;Tiistai;45;33;78;2;8;10
292;07.06.2016;2016;06;08;Tiistai;45;25;70;6;4;10
292;07.06.2016;2016;06;09;Tiistai;53;30;83;3;3;6
292;07.06.2016;2016;06;10;Tiistai;29;24;53;6;6;12
292;07.06.2016;2016;06;11;Tiistai;45;45;90;8;15;23
292;07.06.2016;2016;06;12;Tiistai;56;45;101;17;9;26
292;07.06.2016;2016;06;13;Tiistai;51;53;104;8;12;20
292;07.06.2016;2016;06;14;Tiistai;67;62;129;8;7;15
292;07.06.2016;2016;06;15;Tiistai;72;77;149;17;14;31
292;07.06.2016;2016;06;16;Tiistai;70;67;137;10;8;18
292;07.06.2016;2016;06;17;Tiistai;96;67;163;17;14;31
292;07.06.2016;2016;06;18;Tiistai;56;48;104;17;14;31
292;07.06.2016;2016;06;19;Tiistai;53;47;100;6;8;14
292;07.06.2016;2016;06;20;Tiistai;35;44;79;9;9;18
292;07.06.2016;2016;06;21;Tiistai;16;31;47;10;7;17
292;07.06.2016;2016;06;22;Tiistai;8;14;22;5;2;7
292;07.06.2016;2016;06;23;Tiistai;2;5;7;0;2;2
292;08.06.2016;2016;06;00;Keskiviikko;1;5;6;1;1;2
292;08.06.2016;2016;06;01;Keskiviikko;1;2;3;0;0;0
292;08.06.2016;2016;06;02;Keskiviikko;1;0;1;0;0;0
292;08.06.2016;2016;06;03;Keskiviikko;1;2;3;2;1;3
292;08.06.2016;2016;06;04;Keskiviikko;2;1;3;0;0;0
292;08.06.2016;2016;06;05;Keskiviikko;6;3;9;0;1;1
292;08.06.2016;2016;06;06;Keskiviikko;19;6;25;3;0;3
292;08.06.2016;2016;06;07;Keskiviikko;17;27;44;7;8;15
292;08.06.2016;2016;06;08;Keskiviikko;23;21;44;4;4;8
292;08.06.2016;2016;06;09;Keskiviikko;19;28;47;4;6;10
292;08.06.2016;2016;06;10;Keskiviikko;16;12;28;9;4;13
292;08.06.2016;2016;06;11;Keskiviikko;13;25;38;6;3;9
292;08.06.2016;2016;06;12;Keskiviikko;22;20;42;14;10;24
292;08.06.2016;2016;06;13;Keskiviikko;20;12;32;6;4;10
292;08.06.2016;2016;06;14;Keskiviikko;22;32;54;8;3;11
292;08.06.2016;2016;06;15;Keskiviikko;26;21;47;5;1;6
292;08.06.2016;2016;06;16;Keskiviikko;15;18;33;4;3;7
292;08.06.2016;2016;06;17;Keskiviikko;10;10;20;1;1;2
292;08.06.2016;2016;06;18;Keskiviikko;3;3;6;1;0;1
292;08.06.2016;2016;06;19;Keskiviikko;8;7;15;2;2;4
292;08.06.2016;2016;06;20;Keskiviikko;10;7;17;5;2;7
292;08.06.2016;2016;06;21;Keskiviikko;4;6;10;1;5;6
292;08.06.2016;2016;06;22;Keskiviikko;6;3;9;1;2;3
292;08.06.2016;2016;06;23;Keskiviikko;2;2;4;0;0;0
292;09.06.2016;2016;06;00;Torstai;0;0;0;2;0;2
292;09.06.2016;2016;06;01;Torstai;0;0;0;0;0;0
292;09.06.2016;2016;06;02;Torstai;0;0;0;0;0;0
292;09.06.2016;2016;06;03;Torstai;0;0;0;2;0;2
292;09.06.2016;2016;06;04;Torstai;2;1;3;0;0;0
292;09.06.2016;2016;06;05;Torstai;4;6;10;2;1;3
292;09.06.2016;2016;06;06;Torstai;16;9;25;5;2;7
292;09.06.2016;2016;06;07;Torstai;21;26;47;4;13;17
292;09.06.2016;2016;06;08;Torstai;27;20;47;5;6;11
292;09.06.2016;2016;06;09;Torstai;9;15;24;3;11;14
292;09.06.2016;2016;06;10;Torstai;20;30;50;6;6;12
292;09.06.2016;2016;06;11;Torstai;25;41;66;7;9;16
292;09.06.2016;2016;06;12;Torstai;33;28;61;5;8;13
292;09.06.2016;2016;06;13;Torstai;39;38;77;11;3;14
292;09.06.2016;2016;06;14;Torstai;41;31;72;21;16;37
292;09.06.2016;2016;06;15;Torstai;46;51;97;7;9;16
292;09.06.2016;2016;06;16;Torstai;70;41;111;16;12;28
292;09.06.2016;2016;06;17;Torstai;34;32;66;8;13;21
292;09.06.2016;2016;06;18;Torstai;37;40;77;5;8;13
292;09.06.2016;2016;06;19;Torstai;30;37;67;8;9;17
292;09.06.2016;2016;06;20;Torstai;33;19;52;5;10;15
292;09.06.2016;2016;06;21;Torstai;15;26;41;3;8;11
292;09.06.2016;2016;06;22;Torstai;3;8;11;5;3;8
292;09.06.2016;2016;06;23;Torstai;2;5;7;1;3;4
292;10.06.2016;2016;06;00;Perjantai;5;3;8;1;0;1
292;10.06.2016;2016;06;01;Perjantai;1;0;1;0;1;1
292;10.06.2016;2016;06;02;Perjantai;1;0;1;0;0;0
292;10.06.2016;2016;06;03;Perjantai;0;1;1;2;0;2
292;10.06.2016;2016;06;04;Perjantai;2;1;3;0;0;0
292;10.06.2016;2016;06;05;Perjantai;6;7;13;0;1;1
292;10.06.2016;2016;06;06;Perjantai;21;11;32;4;2;6
292;10.06.2016;2016;06;07;Perjantai;35;27;62;3;4;7
292;10.06.2016;2016;06;08;Perjantai;18;30;48;4;5;9
292;10.06.2016;2016;06;09;Perjantai;17;17;34;6;9;15
292;10.06.2016;2016;06;10;Perjantai;12;18;30;3;4;7
292;10.06.2016;2016;06;11;Perjantai;25;20;45;2;1;3
292;10.06.2016;2016;06;12;Perjantai;35;31;66;7;6;13
292;10.06.2016;2016;06;13;Perjantai;40;30;70;12;8;20
292;10.06.2016;2016;06;14;Perjantai;38;46;84;9;9;18
292;10.06.2016;2016;06;15;Perjantai;35;55;90;5;14;19
292;10.06.2016;2016;06;16;Perjantai;55;39;94;8;7;15
292;10.06.2016;2016;06;17;Perjantai;51;29;80;15;13;28
292;10.06.2016;2016;06;18;Perjantai;34;44;78;15;8;23
292;10.06.2016;2016;06;19;Perjantai;37;32;69;10;7;17
292;10.06.2016;2016;06;20;Perjantai;20;22;42;8;14;22
292;10.06.2016;2016;06;21;Perjantai;18;7;25;4;4;8
292;10.06.2016;2016;06;22;Perjantai;6;10;16;5;5;10
292;10.06.2016;2016;06;23;Perjantai;4;2;6;1;3;4
292;11.06.2016;2016;06;00;Lauantai;2;4;6;4;1;5
292;11.06.2016;2016;06;01;Lauantai;5;2;7;0;0;0
292;11.06.2016;2016;06;02;Lauantai;1;6;7;0;2;2
292;11.06.2016;2016;06;03;Lauantai;0;5;5;1;6;7
292;11.06.2016;2016;06;04;Lauantai;0;1;1;1;0;1
292;11.06.2016;2016;06;05;Lauantai;0;1;1;2;0;2
292;11.06.2016;2016;06;06;Lauantai;4;4;8;0;3;3
292;11.06.2016;2016;06;07;Lauantai;6;11;17;7;4;11
292;11.06.2016;2016;06;08;Lauantai;12;12;24;3;2;5
292;11.06.2016;2016;06;09;Lauantai;18;9;27;5;8;13
292;11.06.2016;2016;06;10;Lauantai;16;26;42;6;5;11
292;11.06.2016;2016;06;11;Lauantai;41;44;85;10;11;21
292;11.06.2016;2016;06;12;Lauantai;42;24;66;9;6;15
292;11.06.2016;2016;06;13;Lauantai;57;30;87;8;6;14
292;11.06.2016;2016;06;14;Lauantai;41;42;83;9;9;18
292;11.06.2016;2016;06;15;Lauantai;47;42;89;18;13;31
292;11.06.2016;2016;06;16;Lauantai;22;33;55;9;11;20
292;11.06.2016;2016;06;17;Lauantai;25;24;49;1;5;6
292;11.06.2016;2016;06;18;Lauantai;35;23;58;13;9;22
292;11.06.2016;2016;06;19;Lauantai;30;37;67;15;14;29
292;11.06.2016;2016;06;20;Lauantai;30;21;51;6;10;16
292;11.06.2016;2016;06;21;Lauantai;11;19;30;1;3;4
292;11.06.2016;2016;06;22;Lauantai;5;9;14;1;2;3
292;11.06.2016;2016;06;23;Lauantai;6;3;9;2;2;4
292;12.06.2016;2016;06;00;Sunnuntai;6;4;10;2;1;3
292;12.06.2016;2016;06;01;Sunnuntai;1;4;5;1;4;5
292;12.06.2016;2016;06;02;Sunnuntai;2;6;8;0;5;5
292;12.06.2016;2016;06;03;Sunnuntai;1;0;1;1;2;3
292;12.06.2016;2016;06;04;Sunnuntai;1;0;1;3;0;3
292;12.06.2016;2016;06;05;Sunnuntai;1;2;3;1;2;3
292;12.06.2016;2016;06;06;Sunnuntai;4;4;8;1;0;1
292;12.06.2016;2016;06;07;Sunnuntai;6;4;10;1;3;4
292;12.06.2016;2016;06;08;Sunnuntai;6;7;13;2;1;3
292;12.06.2016;2016;06;09;Sunnuntai;21;13;34;5;3;8
292;12.06.2016;2016;06;10;Sunnuntai;20;25;45;8;8;16
292;12.06.2016;2016;06;11;Sunnuntai;38;38;76;12;13;25
292;12.06.2016;2016;06;12;Sunnuntai;59;57;116;13;12;25
292;12.06.2016;2016;06;13;Sunnuntai;58;61;119;11;15;26
292;12.06.2016;2016;06;14;Sunnuntai;48;52;100;11;8;19
292;12.06.2016;2016;06;15;Sunnuntai;81;33;114;11;9;20
292;12.06.2016;2016;06;16;Sunnuntai;101;27;128;17;10;27
292;12.06.2016;2016;06;17;Sunnuntai;38;47;85;8;10;18
292;12.06.2016;2016;06;18;Sunnuntai;37;44;81;9;16;25
292;12.06.2016;2016;06;19;Sunnuntai;35;59;94;11;13;24
292;12.06.2016;2016;06;20;Sunnuntai;18;32;50;6;14;20
292;12.06.2016;2016;06;21;Sunnuntai;11;16;27;3;8;11
292;12.06.2016;2016;06;22;Sunnuntai;13;12;25;5;1;6
292;12.06.2016;2016;06;23;Sunnuntai;5;7;12;1;2;3
292;13.06.2016;2016;06;00;Maanantai;4;2;6;2;2;4
292;13.06.2016;2016;06;01;Maanantai;3;4;7;1;1;2
292;13.06.2016;2016;06;02;Maanantai;3;0;3;1;0;1
292;13.06.2016;2016;06;03;Maanantai;3;0;3;2;1;3
292;13.06.2016;2016;06;04;Maanantai;5;1;6;0;0;0
292;13.06.2016;2016;06;05;Maanantai;9;6;15;5;3;8
292;13.06.2016;2016;06;06;Maanantai;32;23;55;4;7;11
292;13.06.2016;2016;06;07;Maanantai;47;37;84;7;9;16
292;13.06.2016;2016;06;08;Maanantai;29;31;60;8;15;23
292;13.06.2016;2016;06;09;Maanantai;37;37;74;5;9;14
292;13.06.2016;2016;06;10;Maanantai;30;37;67;12;13;25
292;13.06.2016;2016;06;11;Maanantai;44;37;81;14;5;19
292;13.06.2016;2016;06;12;Maanantai;50;51;101;12;13;25
292;13.06.2016;2016;06;13;Maanantai;52;41;93;13;10;23
292;13.06.2016;2016;06;14;Maanantai;38;70;108;10;10;20
292;13.06.2016;2016;06;15;Maanantai;77;61;138;18;22;40
292;13.06.2016;2016;06;16;Maanantai;62;68;130;17;11;28
292;13.06.2016;2016;06;17;Maanantai;50;48;98;13;12;25
292;13.06.2016;2016;06;18;Maanantai;40;58;98;15;19;34
292;13.06.2016;2016;06;19;Maanantai;57;72;129;25;12;37
292;13.06.2016;2016;06;20;Maanantai;49;47;96;15;13;28
292;13.06.2016;2016;06;21;Maanantai;19;24;43;4;5;9
292;13.06.2016;2016;06;22;Maanantai;12;18;30;2;2;4
292;13.06.2016;2016;06;23;Maanantai;4;9;13;3;7;10
292;14.06.2016;2016;06;00;Tiistai;2;2;4;0;0;0
292;14.06.2016;2016;06;01;Tiistai;3;2;5;2;3;5
292;14.06.2016;2016;06;02;Tiistai;2;3;5;1;1;2
292;14.06.2016;2016;06;03;Tiistai;2;1;3;2;0;2
292;14.06.2016;2016;06;04;Tiistai;1;1;2;0;0;0
292;14.06.2016;2016;06;05;Tiistai;16;7;23;2;1;3
292;14.06.2016;2016;06;06;Tiistai;33;14;47;5;7;12
292;14.06.2016;2016;06;07;Tiistai;67;28;95;6;4;10
292;14.06.2016;2016;06;08;Tiistai;34;26;60;5;5;10
292;14.06.2016;2016;06;09;Tiistai;33;30;63;10;8;18
292;14.06.2016;2016;06;10;Tiistai;29;34;63;7;8;15
292;14.06.2016;2016;06;11;Tiistai;52;57;109;14;16;30
292;14.06.2016;2016;06;12;Tiistai;48;56;104;15;8;23
292;14.06.2016;2016;06;13;Tiistai;62;64;126;22;9;31
292;14.06.2016;2016;06;14;Tiistai;69;61;130;8;11;19
292;14.06.2016;2016;06;15;Tiistai;58;73;131;14;23;37
292;14.06.2016;2016;06;16;Tiistai;90;92;182;18;17;35
292;14.06.2016;2016;06;17;Tiistai;96;53;149;14;11;25
292;14.06.2016;2016;06;18;Tiistai;61;77;138;14;19;33
292;14.06.2016;2016;06;19;Tiistai;65;52;117;13;16;29
292;14.06.2016;2016;06;20;Tiistai;42;55;97;8;14;22
292;14.06.2016;2016;06;21;Tiistai;16;18;34;9;7;16
292;14.06.2016;2016;06;22;Tiistai;11;14;25;5;3;8
292;14.06.2016;2016;06;23;Tiistai;4;9;13;1;4;5
292;15.06.2016;2016;06;00;Keskiviikko;3;5;8;1;1;2
292;15.06.2016;2016;06;01;Keskiviikko;3;2;5;0;1;1
292;15.06.2016;2016;06;02;Keskiviikko;2;1;3;0;0;0
292;15.06.2016;2016;06;03;Keskiviikko;1;1;2;2;0;2
292;15.06.2016;2016;06;04;Keskiviikko;2;2;4;1;0;1
292;15.06.2016;2016;06;05;Keskiviikko;14;8;22;0;1;1
292;15.06.2016;2016;06;06;Keskiviikko;36;15;51;2;2;4
292;15.06.2016;2016;06;07;Keskiviikko;68;26;94;5;7;12
292;15.06.2016;2016;06;08;Keskiviikko;36;18;54;8;4;12
292;15.06.2016;2016;06;09;Keskiviikko;43;22;65;10;7;17
292;15.06.2016;2016;06;10;Keskiviikko;38;35;73;8;2;10
292;15.06.2016;2016;06;11;Keskiviikko;43;28;71;9;11;20
292;15.06.2016;2016;06;12;Keskiviikko;45;44;89;12;7;19
292;15.06.2016;2016;06;13;Keskiviikko;57;67;124;12;7;19
292;15.06.2016;2016;06;14;Keskiviikko;50;47;97;12;7;19
292;15.06.2016;2016;06;15;Keskiviikko;57;82;139;12;14;26
292;15.06.2016;2016;06;16;Keskiviikko;67;103;170;19;18;37
292;15.06.2016;2016;06;17;Keskiviikko;53;50;103;19;9;28
292;15.06.2016;2016;06;18;Keskiviikko;61;55;116;15;17;32
292;15.06.2016;2016;06;19;Keskiviikko;59;53;112;18;15;33
292;15.06.2016;2016;06;20;Keskiviikko;49;45;94;12;14;26
292;15.06.2016;2016;06;21;Keskiviikko;22;39;61;4;13;17
292;15.06.2016;2016;06;22;Keskiviikko;10;8;18;3;3;6
292;15.06.2016;2016;06;23;Keskiviikko;11;8;19;3;3;6
292;16.06.2016;2016;06;00;Torstai;1;2;3;1;0;1
292;16.06.2016;2016;06;01;Torstai;1;10;11;0;0;0
292;16.06.2016;2016;06;02;Torstai;3;5;8;0;1;1
292;16.06.2016;2016;06;03;Torstai;0;2;2;2;0;2
292;16.06.2016;2016;06;04;Torstai;3;1;4;1;0;1
292;16.06.2016;2016;06;05;Torstai;11;9;20;2;0;2
292;16.06.2016;2016;06;06;Torstai;24;13;37;6;7;13
292;16.06.2016;2016;06;07;Torstai;41;33;74;3;6;9
292;16.06.2016;2016;06;08;Torstai;47;25;72;9;4;13
292;16.06.2016;2016;06;09;Torstai;34;36;70;5;8;13
292;16.06.2016;2016;06;10;Torstai;39;39;78;3;8;11
292;16.06.2016;2016;06;11;Torstai;36;29;65;12;9;21
292;16.06.2016;2016;06;12;Torstai;38;30;68;9;5;14
292;16.06.2016;2016;06;13;Torstai;32;42;74;10;7;17
292;16.06.2016;2016;06;14;Torstai;38;26;64;5;5;10
292;16.06.2016;2016;06;15;Torstai;34;37;71;8;5;13
292;16.06.2016;2016;06;16;Torstai;43;34;77;6;2;8
292;16.06.2016;2016;06;17;Torstai;21;24;45;4;3;7
292;16.06.2016;2016;06;18;Torstai;14;13;27;8;3;11
292;16.06.2016;2016;06;19;Torstai;20;17;37;3;3;6
292;16.06.2016;2016;06;20;Torstai;13;17;30;1;6;7
292;16.06.2016;2016;06;21;Torstai;6;6;12;3;1;4
292;16.06.2016;2016;06;22;Torstai;2;4;6;3;2;5
292;16.06.2016;2016;06;23;Torstai;0;4;4;0;0;0
292;17.06.2016;2016;06;00;Perjantai;2;0;2;1;0;1
292;17.06.2016;2016;06;01;Perjantai;1;1;2;1;1;2
292;17.06.2016;2016;06;02;Perjantai;0;1;1;0;0;0
292;17.06.2016;2016;06;03;Perjantai;0;0;0;2;0;2
292;17.06.2016;2016;06;04;Perjantai;2;0;2;0;0;0
292;17.06.2016;2016;06;05;Perjantai;7;8;15;5;3;8
292;17.06.2016;2016;06;06;Perjantai;11;7;18;2;5;7
292;17.06.2016;2016;06;07;Perjantai;18;17;35;5;1;6
292;17.06.2016;2016;06;08;Perjantai;11;13;24;2;3;5
292;17.06.2016;2016;06;09;Perjantai;17;11;28;3;1;4
292;17.06.2016;2016;06;10;Perjantai;19;13;32;6;4;10
292;17.06.2016;2016;06;11;Perjantai;19;20;39;7;2;9
292;17.06.2016;2016;06;12;Perjantai;23;22;45;7;4;11
292;17.06.2016;2016;06;13;Perjantai;24;16;40;3;2;5
292;17.06.2016;2016;06;14;Perjantai;26;24;50;2;3;5
292;17.06.2016;2016;06;15;Perjantai;24;18;42;5;2;7
292;17.06.2016;2016;06;16;Perjantai;31;31;62;13;7;20
292;17.06.2016;2016;06;17;Perjantai;22;26;48;16;22;38
292;17.06.2016;2016;06;18;Perjantai;59;44;103;24;115;139
292;17.06.2016;2016;06;19;Perjantai;45;41;86;11;53;64
292;17.06.2016;2016;06;20;Perjantai;24;25;49;8;9;17
292;17.06.2016;2016;06;21;Perjantai;15;15;30;5;7;12
292;17.06.2016;2016;06;22;Perjantai;15;16;31;7;3;10
292;17.06.2016;2016;06;23;Perjantai;6;8;14;4;3;7
292;18.06.2016;2016;06;00;Lauantai;3;6;9;5;6;11
292;18.06.2016;2016;06;01;Lauantai;2;6;8;4;2;6
292;18.06.2016;2016;06;02;Lauantai;0;2;2;5;1;6
292;18.06.2016;2016;06;03;Lauantai;0;4;4;0;3;3
292;18.06.2016;2016;06;04;Lauantai;0;0;0;0;1;1
292;18.06.2016;2016;06;05;Lauantai;2;1;3;1;1;2
292;18.06.2016;2016;06;06;Lauantai;6;8;14;4;2;6
292;18.06.2016;2016;06;07;Lauantai;8;6;14;2;2;4
292;18.06.2016;2016;06;08;Lauantai;23;23;46;4;4;8
292;18.06.2016;2016;06;09;Lauantai;29;30;59;6;6;12
292;18.06.2016;2016;06;10;Lauantai;27;28;55;5;3;8
292;18.06.2016;2016;06;11;Lauantai;21;17;38;3;2;5
292;18.06.2016;2016;06;12;Lauantai;12;6;18;3;1;4
292;18.06.2016;2016;06;13;Lauantai;11;10;21;2;2;4
292;18.06.2016;2016;06;14;Lauantai;13;11;24;2;4;6
292;18.06.2016;2016;06;15;Lauantai;18;17;35;3;4;7
292;18.06.2016;2016;06;16;Lauantai;25;28;53;4;10;14
292;18.06.2016;2016;06;17;Lauantai;23;22;45;6;7;13
292;18.06.2016;2016;06;18;Lauantai;12;21;33;1;2;3
292;18.06.2016;2016;06;19;Lauantai;18;5;23;5;3;8
292;18.06.2016;2016;06;20;Lauantai;11;10;21;4;7;11
292;18.06.2016;2016;06;21;Lauantai;12;10;22;0;4;4
292;18.06.2016;2016;06;22;Lauantai;7;8;15;2;2;4
292;18.06.2016;2016;06;23;Lauantai;5;4;9;4;0;4
292;19.06.2016;2016;06;00;Sunnuntai;3;9;12;4;1;5
292;19.06.2016;2016;06;01;Sunnuntai;5;8;13;1;2;3
292;19.06.2016;2016;06;02;Sunnuntai;0;2;2;1;8;9
292;19.06.2016;2016;06;03;Sunnuntai;1;1;2;0;8;8
292;19.06.2016;2016;06;04;Sunnuntai;1;0;1;1;0;1
292;19.06.2016;2016;06;05;Sunnuntai;0;3;3;3;0;3
292;19.06.2016;2016;06;06;Sunnuntai;4;0;4;0;2;2
292;19.06.2016;2016;06;07;Sunnuntai;3;3;6;1;1;2
292;19.06.2016;2016;06;08;Sunnuntai;8;6;14;6;2;8
292;19.06.2016;2016;06;09;Sunnuntai;19;14;33;4;0;4
292;19.06.2016;2016;06;10;Sunnuntai;15;18;33;8;7;15
292;19.06.2016;2016;06;11;Sunnuntai;21;25;46;7;13;20
292;19.06.2016;2016;06;12;Sunnuntai;44;46;90;9;3;12
292;19.06.2016;2016;06;13;Sunnuntai;35;23;58;3;9;12
292;19.06.2016;2016;06;14;Sunnuntai;23;33;56;7;1;8
292;19.06.2016;2016;06;15;Sunnuntai;30;22;52;10;6;16
292;19.06.2016;2016;06;16;Sunnuntai;26;13;39;9;3;12
292;19.06.2016;2016;06;17;Sunnuntai;18;20;38;2;3;5
292;19.06.2016;2016;06;18;Sunnuntai;15;16;31;6;9;15
292;19.06.2016;2016;06;19;Sunnuntai;14;22;36;10;8;18
292;19.06.2016;2016;06;20;Sunnuntai;12;16;28;13;6;19
292;19.06.2016;2016;06;21;Sunnuntai;16;11;27;2;5;7
292;19.06.2016;2016;06;22;Sunnuntai;8;4;12;2;2;4
292;19.06.2016;2016;06;23;Sunnuntai;2;0;2;0;0;0
292;20.06.2016;2016;06;00;Maanantai;1;2;3;0;0;0
292;20.06.2016;2016;06;01;Maanantai;0;4;4;1;2;3
292;20.06.2016;2016;06;02;Maanantai;5;1;6;0;0;0
292;20.06.2016;2016;06;03;Maanantai;1;2;3;2;0;2
292;20.06.2016;2016;06;04;Maanantai;1;1;2;1;3;4
292;20.06.2016;2016;06;05;Maanantai;9;7;16;3;0;3
292;20.06.2016;2016;06;06;Maanantai;24;16;40;18;6;24
292;20.06.2016;2016;06;07;Maanantai;36;26;62;8;5;13
292;20.06.2016;2016;06;08;Maanantai;24;19;43;3;9;12
292;20.06.2016;2016;06;09;Maanantai;33;23;56;5;5;10
292;20.06.2016;2016;06;10;Maanantai;35;32;67;25;9;34
292;20.06.2016;2016;06;11;Maanantai;38;31;69;10;6;16
292;20.06.2016;2016;06;12;Maanantai;59;41;100;17;12;29
292;20.06.2016;2016;06;13;Maanantai;145;41;186;52;4;56
292;20.06.2016;2016;06;14;Maanantai;81;152;233;63;81;144
292;20.06.2016;2016;06;15;Maanantai;56;92;148;12;21;33
292;20.06.2016;2016;06;16;Maanantai;80;61;141;9;8;17
292;20.06.2016;2016;06;17;Maanantai;51;63;114;19;24;43
292;20.06.2016;2016;06;18;Maanantai;42;52;94;21;13;34
292;20.06.2016;2016;06;19;Maanantai;53;53;106;17;14;31
292;20.06.2016;2016;06;20;Maanantai;36;34;70;7;9;16
292;20.06.2016;2016;06;21;Maanantai;23;21;44;9;9;18
292;20.06.2016;2016;06;22;Maanantai;8;18;26;3;1;4
292;20.06.2016;2016;06;23;Maanantai;1;6;7;0;3;3
292;21.06.2016;2016;06;00;Tiistai;2;3;5;1;0;1
292;21.06.2016;2016;06;01;Tiistai;0;3;3;0;1;1
292;21.06.2016;2016;06;02;Tiistai;0;1;1;0;0;0
292;21.06.2016;2016;06;03;Tiistai;1;1;2;2;0;2
292;21.06.2016;2016;06;04;Tiistai;2;1;3;0;1;1
292;21.06.2016;2016;06;05;Tiistai;11;8;19;1;1;2
292;21.06.2016;2016;06;06;Tiistai;31;18;49;7;5;12
292;21.06.2016;2016;06;07;Tiistai;43;33;76;2;7;9
292;21.06.2016;2016;06;08;Tiistai;28;22;50;5;5;10
292;21.06.2016;2016;06;09;Tiistai;38;23;61;8;5;13
292;21.06.2016;2016;06;10;Tiistai;38;37;75;7;7;14
292;21.06.2016;2016;06;11;Tiistai;43;45;88;6;9;15
292;21.06.2016;2016;06;12;Tiistai;39;49;88;11;10;21
292;21.06.2016;2016;06;13;Tiistai;64;66;130;15;6;21
292;21.06.2016;2016;06;14;Tiistai;71;57;128;20;3;23
292;21.06.2016;2016;06;15;Tiistai;63;72;135;10;7;17
292;21.06.2016;2016;06;16;Tiistai;84;81;165;13;11;24
292;21.06.2016;2016;06;17;Tiistai;65;52;117;17;19;36
292;21.06.2016;2016;06;18;Tiistai;61;64;125;17;19;36
292;21.06.2016;2016;06;19;Tiistai;53;49;102;21;17;38
292;21.06.2016;2016;06;20;Tiistai;34;56;90;20;13;33
292;21.06.2016;2016;06;21;Tiistai;14;21;35;15;4;19
292;21.06.2016;2016;06;22;Tiistai;8;18;26;0;3;3
292;21.06.2016;2016;06;23;Tiistai;6;4;10;4;1;5
292;22.06.2016;2016;06;00;Keskiviikko;6;6;12;5;3;8
292;22.06.2016;2016;06;01;Keskiviikko;3;0;3;3;0;3
292;22.06.2016;2016;06;02;Keskiviikko;3;4;7;1;2;3
292;22.06.2016;2016;06;03;Keskiviikko;0;0;0;2;0;2
292;22.06.2016;2016;06;04;Keskiviikko;2;1;3;0;0;0
292;22.06.2016;2016;06;05;Keskiviikko;8;8;16;1;3;4
292;22.06.2016;2016;06;06;Keskiviikko;26;15;41;1;4;5
292;22.06.2016;2016;06;07;Keskiviikko;37;31;68;2;4;6
292;22.06.2016;2016;06;08;Keskiviikko;18;30;48;6;6;12
292;22.06.2016;2016;06;09;Keskiviikko;33;27;60;11;9;20
292;22.06.2016;2016;06;10;Keskiviikko;44;36;80;5;8;13
292;22.06.2016;2016;06;11;Keskiviikko;43;37;80;15;8;23
292;22.06.2016;2016;06;12;Keskiviikko;46;70;116;12;14;26
292;22.06.2016;2016;06;13;Keskiviikko;61;65;126;7;9;16
292;22.06.2016;2016;06;14;Keskiviikko;65;67;132;17;13;30
292;22.06.2016;2016;06;15;Keskiviikko;48;68;116;13;6;19
292;22.06.2016;2016;06;16;Keskiviikko;59;54;113;23;9;32
292;22.06.2016;2016;06;17;Keskiviikko;55;45;100;10;8;18
292;22.06.2016;2016;06;18;Keskiviikko;38;43;81;12;15;27
292;22.06.2016;2016;06;19;Keskiviikko;54;31;85;18;8;26
292;22.06.2016;2016;06;20;Keskiviikko;22;31;53;19;12;31
292;22.06.2016;2016;06;21;Keskiviikko;14;23;37;8;13;21
292;22.06.2016;2016;06;22;Keskiviikko;10;12;22;3;7;10
292;22.06.2016;2016;06;23;Keskiviikko;4;5;9;3;1;4
292;23.06.2016;2016;06;00;Torstai;1;3;4;0;0;0
292;23.06.2016;2016;06;01;Torstai;0;2;2;0;0;0
292;23.06.2016;2016;06;02;Torstai;0;1;1;0;1;1
292;23.06.2016;2016;06;03;Torstai;5;1;6;3;1;4
292;23.06.2016;2016;06;04;Torstai;2;3;5;0;0;0
292;23.06.2016;2016;06;05;Torstai;7;4;11;2;1;3
292;23.06.2016;2016;06;06;Torstai;26;17;43;2;5;7
292;23.06.2016;2016;06;07;Torstai;49;28;77;4;3;7
292;23.06.2016;2016;06;08;Torstai;26;14;40;4;4;8
292;23.06.2016;2016;06;09;Torstai;38;25;63;6;6;12
292;23.06.2016;2016;06;10;Torstai;35;40;75;5;10;15
292;23.06.2016;2016;06;11;Torstai;40;54;94;11;11;22
292;23.06.2016;2016;06;12;Torstai;55;57;112;11;6;17
292;23.06.2016;2016;06;13;Torstai;59;53;112;12;6;18
292;23.06.2016;2016;06;14;Torstai;49;66;115;13;13;26
292;23.06.2016;2016;06;15;Torstai;48;59;107;11;3;14
292;23.06.2016;2016;06;16;Torstai;51;58;109;14;6;20
292;23.06.2016;2016;06;17;Torstai;50;47;97;7;7;14
292;23.06.2016;2016;06;18;Torstai;41;48;89;10;6;16
292;23.06.2016;2016;06;19;Torstai;34;40;74;8;9;17
292;23.06.2016;2016;06;20;Torstai;25;16;41;4;1;5
292;23.06.2016;2016;06;21;Torstai;12;19;31;8;7;15
292;23.06.2016;2016;06;22;Torstai;3;6;9;1;5;6
292;23.06.2016;2016;06;23;Torstai;16;7;23;5;0;5
292;24.06.2016;2016;06;00;Perjantai;3;6;9;3;2;5
292;24.06.2016;2016;06;01;Perjantai;4;8;12;2;3;5
292;24.06.2016;2016;06;02;Perjantai;1;1;2;0;0;0
292;24.06.2016;2016;06;03;Perjantai;1;1;2;0;0;0
292;24.06.2016;2016;06;04;Perjantai;1;1;2;1;0;1
292;24.06.2016;2016;06;05;Perjantai;3;2;5;1;1;2
292;24.06.2016;2016;06;06;Perjantai;8;3;11;1;0;1
292;24.06.2016;2016;06;07;Perjantai;7;11;18;0;1;1
292;24.06.2016;2016;06;08;Perjantai;6;9;15;11;4;15
292;24.06.2016;2016;06;09;Perjantai;10;18;28;1;4;5
292;24.06.2016;2016;06;10;Perjantai;27;28;55;3;4;7
292;24.06.2016;2016;06;11;Perjantai;29;25;54;12;3;15
292;24.06.2016;2016;06;12;Perjantai;27;31;58;8;5;13
292;24.06.2016;2016;06;13;Perjantai;35;26;61;8;5;13
292;24.06.2016;2016;06;14;Perjantai;30;33;63;8;10;18
292;24.06.2016;2016;06;15;Perjantai;29;50;79;7;5;12
292;24.06.2016;2016;06;16;Perjantai;34;40;74;13;6;19
292;24.06.2016;2016;06;17;Perjantai;21;38;59;8;6;14
292;24.06.2016;2016;06;18;Perjantai;25;28;53;5;7;12
292;24.06.2016;2016;06;19;Perjantai;37;14;51;3;4;7
292;24.06.2016;2016;06;20;Perjantai;23;12;35;3;4;7
292;24.06.2016;2016;06;21;Perjantai;12;18;30;1;4;5
292;24.06.2016;2016;06;22;Perjantai;21;13;34;5;3;8
292;24.06.2016;2016;06;23;Perjantai;10;21;31;3;1;4
292;25.06.2016;2016;06;00;Lauantai;13;6;19;1;2;3
292;25.06.2016;2016;06;01;Lauantai;7;9;16;2;2;4
292;25.06.2016;2016;06;02;Lauantai;5;10;15;0;0;0
292;25.06.2016;2016;06;03;Lauantai;8;7;15;0;3;3
292;25.06.2016;2016;06;04;Lauantai;5;2;7;3;4;7
292;25.06.2016;2016;06;05;Lauantai;3;3;6;1;1;2
292;25.06.2016;2016;06;06;Lauantai;6;5;11;0;0;0
292;25.06.2016;2016;06;07;Lauantai;1;5;6;0;0;0
292;25.06.2016;2016;06;08;Lauantai;14;2;16;2;4;6
292;25.06.2016;2016;06;09;Lauantai;15;13;28;3;2;5
292;25.06.2016;2016;06;10;Lauantai;25;26;51;2;5;7
292;25.06.2016;2016;06;11;Lauantai;16;13;29;6;4;10
292;25.06.2016;2016;06;12;Lauantai;3;4;7;1;0;1
292;25.06.2016;2016;06;13;Lauantai;1;0;1;0;0;0
292;25.06.2016;2016;06;14;Lauantai;6;7;13;2;0;2
292;25.06.2016;2016;06;15;Lauantai;11;7;18;1;1;2
292;25.06.2016;2016;06;16;Lauantai;11;9;20;5;3;8
292;25.06.2016;2016;06;17;Lauantai;15;14;29;8;7;15
292;25.06.2016;2016;06;18;Lauantai;18;13;31;8;5;13
292;25.06.2016;2016;06;19;Lauantai;22;20;42;9;9;18
292;25.06.2016;2016;06;20;Lauantai;20;23;43;5;10;15
292;25.06.2016;2016;06;21;Lauantai;10;14;24;6;5;11
292;25.06.2016;2016;06;22;Lauantai;7;8;15;5;2;7
292;25.06.2016;2016;06;23;Lauantai;3;8;11;1;1;2
292;26.06.2016;2016;06;00;Sunnuntai;10;0;10;4;3;7
292;26.06.2016;2016;06;01;Sunnuntai;3;6;9;0;2;2
292;26.06.2016;2016;06;02;Sunnuntai;2;2;4;0;2;2
292;26.06.2016;2016;06;03;Sunnuntai;6;8;14;3;1;4
292;26.06.2016;2016;06;04;Sunnuntai;0;3;3;1;0;1
292;26.06.2016;2016;06;05;Sunnuntai;1;1;2;4;2;6
292;26.06.2016;2016;06;06;Sunnuntai;9;3;12;2;0;2
292;26.06.2016;2016;06;07;Sunnuntai;3;4;7;2;0;2
292;26.06.2016;2016;06;08;Sunnuntai;13;11;24;8;4;12
292;26.06.2016;2016;06;09;Sunnuntai;11;9;20;8;2;10
292;26.06.2016;2016;06;10;Sunnuntai;24;16;40;4;6;10
292;26.06.2016;2016;06;11;Sunnuntai;21;28;49;9;5;14
292;26.06.2016;2016;06;12;Sunnuntai;29;25;54;13;11;24
292;26.06.2016;2016;06;13;Sunnuntai;45;32;77;14;7;21
292;26.06.2016;2016;06;14;Sunnuntai;47;60;107;14;17;31
292;26.06.2016;2016;06;15;Sunnuntai;59;37;96;14;9;23
292;26.06.2016;2016;06;16;Sunnuntai;62;41;103;13;12;25
292;26.06.2016;2016;06;17;Sunnuntai;45;41;86;8;7;15
292;26.06.2016;2016;06;18;Sunnuntai;50;59;109;14;12;26
292;26.06.2016;2016;06;19;Sunnuntai;58;49;107;14;16;30
292;26.06.2016;2016;06;20;Sunnuntai;33;33;66;12;8;20
292;26.06.2016;2016;06;21;Sunnuntai;21;15;36;4;8;12
292;26.06.2016;2016;06;22;Sunnuntai;6;12;18;3;2;5
292;26.06.2016;2016;06;23;Sunnuntai;5;6;11;3;1;4
292;27.06.2016;2016;06;00;Maanantai;6;2;8;1;0;1
292;27.06.2016;2016;06;01;Maanantai;0;0;0;0;0;0
292;27.06.2016;2016;06;02;Maanantai;1;2;3;0;0;0
292;27.06.2016;2016;06;03;Maanantai;0;3;3;2;0;2
292;27.06.2016;2016;06;04;Maanantai;2;2;4;2;0;2
292;27.06.2016;2016;06;05;Maanantai;4;8;12;1;0;1
292;27.06.2016;2016;06;06;Maanantai;29;15;44;2;2;4
292;27.06.2016;2016;06;07;Maanantai;30;34;64;9;8;17
292;27.06.2016;2016;06;08;Maanantai;22;22;44;5;10;15
292;27.06.2016;2016;06;09;Maanantai;27;21;48;7;4;11
292;27.06.2016;2016;06;10;Maanantai;48;37;85;9;6;15
292;27.06.2016;2016;06;11;Maanantai;36;42;78;7;7;14
292;27.06.2016;2016;06;12;Maanantai;59;54;113;10;9;19
292;27.06.2016;2016;06;13;Maanantai;50;39;89;9;6;15
292;27.06.2016;2016;06;14;Maanantai;63;46;109;10;9;19
292;27.06.2016;2016;06;15;Maanantai;56;74;130;10;12;22
292;27.06.2016;2016;06;16;Maanantai;59;72;131;18;9;27
292;27.06.2016;2016;06;17;Maanantai;67;64;131;10;12;22
292;27.06.2016;2016;06;18;Maanantai;53;50;103;10;17;27
292;27.06.2016;2016;06;19;Maanantai;49;37;86;21;24;45
292;27.06.2016;2016;06;20;Maanantai;28;22;50;3;9;12
292;27.06.2016;2016;06;21;Maanantai;14;21;35;4;3;7
292;27.06.2016;2016;06;22;Maanantai;11;12;23;4;0;4
292;27.06.2016;2016;06;23;Maanantai;2;9;11;3;1;4
292;28.06.2016;2016;06;00;Tiistai;1;4;5;2;1;3
292;28.06.2016;2016;06;01;Tiistai;2;3;5;2;0;2
292;28.06.2016;2016;06;02;Tiistai;1;1;2;0;2;2
292;28.06.2016;2016;06;03;Tiistai;0;0;0;2;0;2
292;28.06.2016;2016;06;04;Tiistai;1;1;2;0;0;0
292;28.06.2016;2016;06;05;Tiistai;4;3;7;1;0;1
292;28.06.2016;2016;06;06;Tiistai;14;13;27;3;1;4
292;28.06.2016;2016;06;07;Tiistai;22;15;37;1;4;5
292;28.06.2016;2016;06;08;Tiistai;14;15;29;4;1;5
292;28.06.2016;2016;06;09;Tiistai;6;9;15;3;3;6
292;28.06.2016;2016;06;10;Tiistai;13;19;32;6;4;10
292;28.06.2016;2016;06;11;Tiistai;18;12;30;6;4;10
292;28.06.2016;2016;06;12;Tiistai;21;24;45;10;3;13
292;28.06.2016;2016;06;13;Tiistai;33;28;61;10;5;15
292;28.06.2016;2016;06;14;Tiistai;37;35;72;12;7;19
292;28.06.2016;2016;06;15;Tiistai;53;67;120;9;12;21
292;28.06.2016;2016;06;16;Tiistai;65;53;118;16;11;27
292;28.06.2016;2016;06;17;Tiistai;74;48;122;18;11;29
292;28.06.2016;2016;06;18;Tiistai;62;54;116;20;20;40
292;28.06.2016;2016;06;19;Tiistai;65;54;119;18;12;30
292;28.06.2016;2016;06;20;Tiistai;45;62;107;17;18;35
292;28.06.2016;2016;06;21;Tiistai;24;25;49;7;9;16
292;28.06.2016;2016;06;22;Tiistai;3;15;18;4;0;4
292;28.06.2016;2016;06;23;Tiistai;5;3;8;7;3;10
292;29.06.2016;2016;06;00;Keskiviikko;1;0;1;0;2;2
292;29.06.2016;2016;06;01;Keskiviikko;2;5;7;0;3;3
292;29.06.2016;2016;06;02;Keskiviikko;1;2;3;0;1;1
292;29.06.2016;2016;06;03;Keskiviikko;2;1;3;2;0;2
292;29.06.2016;2016;06;04;Keskiviikko;1;0;1;1;0;1
292;29.06.2016;2016;06;05;Keskiviikko;6;5;11;3;1;4
292;29.06.2016;2016;06;06;Keskiviikko;27;12;39;8;3;11
292;29.06.2016;2016;06;07;Keskiviikko;31;22;53;5;6;11
292;29.06.2016;2016;06;08;Keskiviikko;20;28;48;8;4;12
292;29.06.2016;2016;06;09;Keskiviikko;22;30;52;6;6;12
292;29.06.2016;2016;06;10;Keskiviikko;41;27;68;5;9;14
292;29.06.2016;2016;06;11;Keskiviikko;57;52;109;12;8;20
292;29.06.2016;2016;06;12;Keskiviikko;66;45;111;7;6;13
292;29.06.2016;2016;06;13;Keskiviikko;54;50;104;13;17;30
292;29.06.2016;2016;06;14;Keskiviikko;41;65;106;12;7;19
292;29.06.2016;2016;06;15;Keskiviikko;62;67;129;11;8;19
292;29.06.2016;2016;06;16;Keskiviikko;35;25;60;4;4;8
292;29.06.2016;2016;06;17;Keskiviikko;36;41;77;9;11;20
292;29.06.2016;2016;06;18;Keskiviikko;53;35;88;17;8;25
292;29.06.2016;2016;06;19;Keskiviikko;51;30;81;13;11;24
292;29.06.2016;2016;06;20;Keskiviikko;31;21;52;6;13;19
292;29.06.2016;2016;06;21;Keskiviikko;23;31;54;4;10;14
292;29.06.2016;2016;06;22;Keskiviikko;15;6;21;1;7;8
292;29.06.2016;2016;06;23;Keskiviikko;1;4;5;0;0;0
292;30.06.2016;2016;06;00;Torstai;5;1;6;1;2;3
292;30.06.2016;2016;06;01;Torstai;1;4;5;1;2;3
292;30.06.2016;2016;06;02;Torstai;1;1;2;0;1;1
292;30.06.2016;2016;06;03;Torstai;0;1;1;2;0;2
292;30.06.2016;2016;06;04;Torstai;3;2;5;0;0;0
292;30.06.2016;2016;06;05;Torstai;5;7;12;3;0;3
292;30.06.2016;2016;06;06;Torstai;19;11;30;2;4;6
292;30.06.2016;2016;06;07;Torstai;43;20;63;4;5;9
292;30.06.2016;2016;06;08;Torstai;31;26;57;9;7;16
292;30.06.2016;2016;06;09;Torstai;33;33;66;5;9;14
292;30.06.2016;2016;06;10;Torstai;34;33;67;12;9;21
292;30.06.2016;2016;06;11;Torstai;58;54;112;17;9;26
292;30.06.2016;2016;06;12;Torstai;63;67;130;13;10;23
292;30.06.2016;2016;06;13;Torstai;58;62;120;10;2;12
292;30.06.2016;2016;06;14;Torstai;65;50;115;9;8;17
292;30.06.2016;2016;06;15;Torstai;42;44;86;9;8;17
292;30.06.2016;2016;06;16;Torstai;30;26;56;5;0;5
292;30.06.2016;2016;06;17;Torstai;16;18;34;4;4;8
292;30.06.2016;2016;06;18;Torstai;24;26;50;7;6;13
292;30.06.2016;2016;06;19;Torstai;41;25;66;14;9;23
292;30.06.2016;2016;06;20;Torstai;31;27;58;14;6;20
292;30.06.2016;2016;06;21;Torstai;18;22;40;4;5;9
292;30.06.2016;2016;06;22;Torstai;13;12;25;4;1;5
292;30.06.2016;2016;06;23;Torstai;7;1;8;5;2;7
292;01.07.2016;2016;07;00;Perjantai;3;6;9;0;0;0
292;01.07.2016;2016;07;01;Perjantai;2;5;7;0;2;2
292;01.07.2016;2016;07;02;Perjantai;3;1;4;0;0;0
292;01.07.2016;2016;07;03;Perjantai;0;0;0;1;0;1
292;01.07.2016;2016;07;04;Perjantai;2;0;2;0;0;0
292;01.07.2016;2016;07;05;Perjantai;4;3;7;1;1;2
292;01.07.2016;2016;07;06;Perjantai;14;9;23;6;2;8
292;01.07.2016;2016;07;07;Perjantai;29;23;52;5;1;6
292;01.07.2016;2016;07;08;Perjantai;14;29;43;3;2;5
292;01.07.2016;2016;07;09;Perjantai;26;26;52;3;8;11
292;01.07.2016;2016;07;10;Perjantai;32;31;63;6;7;13
292;01.07.2016;2016;07;11;Perjantai;33;21;54;5;4;9
292;01.07.2016;2016;07;12;Perjantai;24;15;39;7;11;18
292;01.07.2016;2016;07;13;Perjantai;20;14;34;9;3;12
292;01.07.2016;2016;07;14;Perjantai;27;35;62;9;10;19
292;01.07.2016;2016;07;15;Perjantai;33;40;73;2;7;9
292;01.07.2016;2016;07;16;Perjantai;15;14;29;2;3;5
292;01.07.2016;2016;07;17;Perjantai;26;22;48;4;5;9
292;01.07.2016;2016;07;18;Perjantai;49;30;79;9;4;13
292;01.07.2016;2016;07;19;Perjantai;28;25;53;8;10;18
292;01.07.2016;2016;07;20;Perjantai;33;22;55;5;5;10
292;01.07.2016;2016;07;21;Perjantai;18;21;39;7;5;12
292;01.07.2016;2016;07;22;Perjantai;4;8;12;3;3;6
292;01.07.2016;2016;07;23;Perjantai;5;6;11;0;1;1
292;02.07.2016;2016;07;00;Lauantai;9;4;13;7;2;9
292;02.07.2016;2016;07;01;Lauantai;2;3;5;0;1;1
292;02.07.2016;2016;07;02;Lauantai;3;6;9;1;2;3
292;02.07.2016;2016;07;03;Lauantai;0;2;2;1;4;5
292;02.07.2016;2016;07;04;Lauantai;0;0;0;0;1;1
292;02.07.2016;2016;07;05;Lauantai;1;3;4;3;0;3
292;02.07.2016;2016;07;06;Lauantai;7;2;9;0;4;4
292;02.07.2016;2016;07;07;Lauantai;5;11;16;0;1;1
292;02.07.2016;2016;07;08;Lauantai;16;12;28;3;3;6
292;02.07.2016;2016;07;09;Lauantai;16;15;31;5;7;12
292;02.07.2016;2016;07;10;Lauantai;32;31;63;6;7;13
292;02.07.2016;2016;07;11;Lauantai;34;43;77;6;4;10
292;02.07.2016;2016;07;12;Lauantai;67;55;122;10;9;19
292;02.07.2016;2016;07;13;Lauantai;49;30;79;10;1;11
292;02.07.2016;2016;07;14;Lauantai;49;48;97;7;8;15
292;02.07.2016;2016;07;15;Lauantai;44;31;75;13;12;25
292;02.07.2016;2016;07;16;Lauantai;32;23;55;7;4;11
292;02.07.2016;2016;07;17;Lauantai;41;30;71;5;4;9
292;02.07.2016;2016;07;18;Lauantai;31;30;61;6;6;12
292;02.07.2016;2016;07;19;Lauantai;39;33;72;15;3;18
292;02.07.2016;2016;07;20;Lauantai;35;27;62;9;10;19
292;02.07.2016;2016;07;21;Lauantai;23;22;45;4;1;5
292;02.07.2016;2016;07;22;Lauantai;9;17;26;7;7;14
292;02.07.2016;2016;07;23;Lauantai;10;6;16;3;4;7
292;03.07.2016;2016;07;00;Sunnuntai;4;9;13;2;1;3
292;03.07.2016;2016;07;01;Sunnuntai;3;11;14;2;2;4
292;03.07.2016;2016;07;02;Sunnuntai;2;6;8;0;2;2
292;03.07.2016;2016;07;03;Sunnuntai;1;8;9;0;2;2
292;03.07.2016;2016;07;04;Sunnuntai;2;7;9;0;0;0
292;03.07.2016;2016;07;05;Sunnuntai;2;3;5;3;0;3
292;03.07.2016;2016;07;06;Sunnuntai;2;4;6;1;2;3
292;03.07.2016;2016;07;07;Sunnuntai;5;11;16;1;3;4
292;03.07.2016;2016;07;08;Sunnuntai;7;7;14;1;0;1
292;03.07.2016;2016;07;09;Sunnuntai;11;11;22;1;4;5
292;03.07.2016;2016;07;10;Sunnuntai;4;7;11;5;2;7
292;03.07.2016;2016;07;11;Sunnuntai;6;9;15;4;4;8
292;03.07.2016;2016;07;12;Sunnuntai;13;11;24;2;4;6
292;03.07.2016;2016;07;13;Sunnuntai;9;15;24;3;3;6
292;03.07.2016;2016;07;14;Sunnuntai;23;29;52;10;2;12
292;03.07.2016;2016;07;15;Sunnuntai;20;13;33;6;7;13
292;03.07.2016;2016;07;16;Sunnuntai;30;38;68;9;18;27
292;03.07.2016;2016;07;17;Sunnuntai;38;32;70;14;10;24
292;03.07.2016;2016;07;18;Sunnuntai;52;46;98;17;20;37
292;03.07.2016;2016;07;19;Sunnuntai;44;47;91;17;16;33
292;03.07.2016;2016;07;20;Sunnuntai;29;26;55;7;9;16
292;03.07.2016;2016;07;21;Sunnuntai;9;20;29;5;7;12
292;03.07.2016;2016;07;22;Sunnuntai;8;13;21;1;2;3
292;03.07.2016;2016;07;23;Sunnuntai;11;4;15;0;0;0
292;04.07.2016;2016;07;00;Maanantai;5;2;7;1;0;1
292;04.07.2016;2016;07;01;Maanantai;0;4;4;0;0;0
292;04.07.2016;2016;07;02;Maanantai;0;0;0;0;1;1
292;04.07.2016;2016;07;03;Maanantai;0;2;2;2;0;2
292;04.07.2016;2016;07;04;Maanantai;2;2;4;0;0;0
292;04.07.2016;2016;07;05;Maanantai;4;3;7;1;1;2
292;04.07.2016;2016;07;06;Maanantai;15;9;24;1;1;2
292;04.07.2016;2016;07;07;Maanantai;15;21;36;1;3;4
292;04.07.2016;2016;07;08;Maanantai;21;14;35;2;2;4
292;04.07.2016;2016;07;09;Maanantai;8;15;23;8;7;15
292;04.07.2016;2016;07;10;Maanantai;16;19;35;5;10;15
292;04.07.2016;2016;07;11;Maanantai;25;22;47;3;6;9
292;04.07.2016;2016;07;12;Maanantai;9;15;24;5;5;10
292;04.07.2016;2016;07;13;Maanantai;16;14;30;7;0;7
292;04.07.2016;2016;07;14;Maanantai;26;17;43;3;4;7
292;04.07.2016;2016;07;15;Maanantai;30;20;50;8;4;12
292;04.07.2016;2016;07;16;Maanantai;26;30;56;5;11;16
292;04.07.2016;2016;07;17;Maanantai;21;25;46;15;7;22
292;04.07.2016;2016;07;18;Maanantai;35;26;61;8;9;17
292;04.07.2016;2016;07;19;Maanantai;29;27;56;4;6;10
292;04.07.2016;2016;07;20;Maanantai;10;19;29;2;6;8
292;04.07.2016;2016;07;21;Maanantai;7;6;13;1;1;2
292;04.07.2016;2016;07;22;Maanantai;6;2;8;1;0;1
292;04.07.2016;2016;07;23;Maanantai;2;3;5;0;0;0
292;05.07.2016;2016;07;00;Tiistai;1;1;2;2;0;2
292;05.07.2016;2016;07;01;Tiistai;2;0;2;0;0;0
292;05.07.2016;2016;07;02;Tiistai;3;1;4;0;0;0
292;05.07.2016;2016;07;03;Tiistai;1;1;2;2;1;3
292;05.07.2016;2016;07;04;Tiistai;1;2;3;0;0;0
292;05.07.2016;2016;07;05;Tiistai;5;2;7;0;0;0
292;05.07.2016;2016;07;06;Tiistai;10;8;18;3;1;4
292;05.07.2016;2016;07;07;Tiistai;18;18;36;3;4;7
292;05.07.2016;2016;07;08;Tiistai;10;10;20;4;1;5
292;05.07.2016;2016;07;09;Tiistai;10;11;21;1;1;2
292;05.07.2016;2016;07;10;Tiistai;10;13;23;7;1;8
292;05.07.2016;2016;07;11;Tiistai;20;23;43;6;3;9
292;05.07.2016;2016;07;12;Tiistai;42;23;65;5;5;10
292;05.07.2016;2016;07;13;Tiistai;36;44;80;7;9;16
292;05.07.2016;2016;07;14;Tiistai;29;44;73;5;13;18
292;05.07.2016;2016;07;15;Tiistai;23;18;41;3;3;6
292;05.07.2016;2016;07;16;Tiistai;26;20;46;3;1;4
292;05.07.2016;2016;07;17;Tiistai;9;11;20;3;2;5
292;05.07.2016;2016;07;18;Tiistai;18;12;30;2;2;4
292;05.07.2016;2016;07;19;Tiistai;15;20;35;6;10;16
292;05.07.2016;2016;07;20;Tiistai;27;15;42;6;4;10
292;05.07.2016;2016;07;21;Tiistai;9;17;26;4;3;7
292;05.07.2016;2016;07;22;Tiistai;5;5;10;0;1;1
292;05.07.2016;2016;07;23;Tiistai;1;1;2;0;1;1
292;06.07.2016;2016;07;00;Keskiviikko;3;3;6;2;0;2
292;06.07.2016;2016;07;01;Keskiviikko;0;2;2;0;0;0
292;06.07.2016;2016;07;02;Keskiviikko;0;0;0;0;1;1
292;06.07.2016;2016;07;03;Keskiviikko;2;3;5;0;1;1
292;06.07.2016;2016;07;04;Keskiviikko;1;0;1;1;0;1
292;06.07.2016;2016;07;05;Keskiviikko;8;7;15;1;0;1
292;06.07.2016;2016;07;06;Keskiviikko;13;6;19;1;2;3
292;06.07.2016;2016;07;07;Keskiviikko;10;12;22;3;3;6
292;06.07.2016;2016;07;08;Keskiviikko;7;8;15;3;0;3
292;06.07.2016;2016;07;09;Keskiviikko;6;7;13;1;0;1
292;06.07.2016;2016;07;10;Keskiviikko;9;8;17;1;3;4
292;06.07.2016;2016;07;11;Keskiviikko;23;17;40;3;6;9
292;06.07.2016;2016;07;12;Keskiviikko;41;34;75;9;3;12
292;06.07.2016;2016;07;13;Keskiviikko;52;49;101;10;8;18
292;06.07.2016;2016;07;14;Keskiviikko;61;51;112;9;10;19
292;06.07.2016;2016;07;15;Keskiviikko;35;45;80;8;3;11
292;06.07.2016;2016;07;16;Keskiviikko;49;41;90;8;6;14
292;06.07.2016;2016;07;17;Keskiviikko;54;44;98;6;9;15
292;06.07.2016;2016;07;18;Keskiviikko;9;11;20;3;4;7
292;06.07.2016;2016;07;19;Keskiviikko;15;10;25;7;1;8
292;06.07.2016;2016;07;20;Keskiviikko;26;25;51;9;7;16
292;06.07.2016;2016;07;21;Keskiviikko;24;25;49;6;9;15
292;06.07.2016;2016;07;22;Keskiviikko;6;15;21;1;3;4
292;06.07.2016;2016;07;23;Keskiviikko;3;4;7;2;1;3
292;07.07.2016;2016;07;00;Torstai;4;1;5;0;0;0
292;07.07.2016;2016;07;01;Torstai;3;1;4;0;0;0
292;07.07.2016;2016;07;02;Torstai;2;2;4;0;0;0
292;07.07.2016;2016;07;03;Torstai;1;1;2;1;0;1
292;07.07.2016;2016;07;04;Torstai;1;1;2;0;0;0
292;07.07.2016;2016;07;05;Torstai;5;5;10;0;1;1
292;07.07.2016;2016;07;06;Torstai;15;10;25;1;1;2
292;07.07.2016;2016;07;07;Torstai;22;18;40;2;5;7
292;07.07.2016;2016;07;08;Torstai;17;13;30;8;2;10
292;07.07.2016;2016;07;09;Torstai;28;23;51;6;3;9
292;07.07.2016;2016;07;10;Torstai;18;16;34;3;0;3
292;07.07.2016;2016;07;11;Torstai;10;12;22;3;5;8
292;07.07.2016;2016;07;12;Torstai;30;19;49;3;1;4
292;07.07.2016;2016;07;13;Torstai;13;12;25;3;3;6
292;07.07.2016;2016;07;14;Torstai;24;27;51;3;4;7
292;07.07.2016;2016;07;15;Torstai;44;38;82;6;7;13
292;07.07.2016;2016;07;16;Torstai;48;35;83;10;13;23
292;07.07.2016;2016;07;17;Torstai;17;27;44;1;3;4
292;07.07.2016;2016;07;18;Torstai;21;35;56;11;10;21
292;07.07.2016;2016;07;19;Torstai;25;26;51;7;9;16
292;07.07.2016;2016;07;20;Torstai;28;25;53;10;11;21
292;07.07.2016;2016;07;21;Torstai;32;20;52;4;6;10
292;07.07.2016;2016;07;22;Torstai;10;7;17;0;2;2
292;07.07.2016;2016;07;23;Torstai;1;1;2;1;2;3
292;08.07.2016;2016;07;00;Perjantai;0;3;3;0;0;0
292;08.07.2016;2016;07;01;Perjantai;2;1;3;2;0;2
292;08.07.2016;2016;07;02;Perjantai;1;3;4;0;0;0
292;08.07.2016;2016;07;03;Perjantai;0;1;1;3;1;4
292;08.07.2016;2016;07;04;Perjantai;1;3;4;1;1;2
292;08.07.2016;2016;07;05;Perjantai;7;5;12;4;3;7
292;08.07.2016;2016;07;06;Perjantai;15;9;24;4;4;8
292;08.07.2016;2016;07;07;Perjantai;24;22;46;6;3;9
292;08.07.2016;2016;07;08;Perjantai;13;11;24;11;5;16
292;08.07.2016;2016;07;09;Perjantai;18;16;34;4;3;7
292;08.07.2016;2016;07;10;Perjantai;30;27;57;5;6;11
292;08.07.2016;2016;07;11;Perjantai;52;31;83;6;8;14
292;08.07.2016;2016;07;12;Perjantai;39;61;100;10;14;24
292;08.07.2016;2016;07;13;Perjantai;43;34;77;13;13;26
292;08.07.2016;2016;07;14;Perjantai;61;51;112;12;16;28
292;08.07.2016;2016;07;15;Perjantai;55;44;99;18;7;25
292;08.07.2016;2016;07;16;Perjantai;46;60;106;9;11;20
292;08.07.2016;2016;07;17;Perjantai;39;47;86;14;10;24
292;08.07.2016;2016;07;18;Perjantai;46;25;71;11;15;26
292;08.07.2016;2016;07;19;Perjantai;34;25;59;6;8;14
292;08.07.2016;2016;07;20;Perjantai;26;36;62;8;13;21
292;08.07.2016;2016;07;21;Perjantai;18;19;37;1;6;7
292;08.07.2016;2016;07;22;Perjantai;11;12;23;4;3;7
292;08.07.2016;2016;07;23;Perjantai;8;6;14;3;0;3
292;09.07.2016;2016;07;00;Lauantai;8;3;11;1;5;6
292;09.07.2016;2016;07;01;Lauantai;2;5;7;1;0;1
292;09.07.2016;2016;07;02;Lauantai;1;6;7;2;1;3
292;09.07.2016;2016;07;03;Lauantai;2;1;3;0;3;3
292;09.07.2016;2016;07;04;Lauantai;0;0;0;0;0;0
292;09.07.2016;2016;07;05;Lauantai;2;3;5;1;1;2
292;09.07.2016;2016;07;06;Lauantai;4;2;6;3;0;3
292;09.07.2016;2016;07;07;Lauantai;1;8;9;1;3;4
292;09.07.2016;2016;07;08;Lauantai;9;10;19;4;6;10
292;09.07.2016;2016;07;09;Lauantai;11;15;26;2;3;5
292;09.07.2016;2016;07;10;Lauantai;15;26;41;12;9;21
292;09.07.2016;2016;07;11;Lauantai;27;18;45;8;9;17
292;09.07.2016;2016;07;12;Lauantai;34;24;58;6;10;16
292;09.07.2016;2016;07;13;Lauantai;34;30;64;11;4;15
292;09.07.2016;2016;07;14;Lauantai;24;39;63;15;6;21
292;09.07.2016;2016;07;15;Lauantai;32;27;59;5;3;8
292;09.07.2016;2016;07;16;Lauantai;34;22;56;9;10;19
292;09.07.2016;2016;07;17;Lauantai;28;29;57;9;7;16
292;09.07.2016;2016;07;18;Lauantai;43;22;65;5;5;10
292;09.07.2016;2016;07;19;Lauantai;26;29;55;9;6;15
292;09.07.2016;2016;07;20;Lauantai;25;8;33;3;4;7
292;09.07.2016;2016;07;21;Lauantai;10;14;24;1;4;5
292;09.07.2016;2016;07;22;Lauantai;5;9;14;4;4;8
292;09.07.2016;2016;07;23;Lauantai;2;4;6;7;4;11
292;10.07.2016;2016;07;00;Sunnuntai;6;5;11;4;3;7
292;10.07.2016;2016;07;01;Sunnuntai;3;1;4;1;5;6
292;10.07.2016;2016;07;02;Sunnuntai;8;6;14;4;6;10
292;10.07.2016;2016;07;03;Sunnuntai;0;3;3;3;5;8
292;10.07.2016;2016;07;04;Sunnuntai;3;0;3;1;1;2
292;10.07.2016;2016;07;05;Sunnuntai;2;4;6;3;1;4
292;10.07.2016;2016;07;06;Sunnuntai;8;4;12;3;4;7
292;10.07.2016;2016;07;07;Sunnuntai;5;3;8;1;0;1
292;10.07.2016;2016;07;08;Sunnuntai;5;4;9;7;4;11
292;10.07.2016;2016;07;09;Sunnuntai;20;14;34;6;6;12
292;10.07.2016;2016;07;10;Sunnuntai;37;28;65;4;8;12
292;10.07.2016;2016;07;11;Sunnuntai;38;41;79;12;6;18
292;10.07.2016;2016;07;12;Sunnuntai;44;49;93;8;18;26
292;10.07.2016;2016;07;13;Sunnuntai;44;54;98;16;7;23
292;10.07.2016;2016;07;14;Sunnuntai;58;50;108;19;21;40
292;10.07.2016;2016;07;15;Sunnuntai;50;46;96;10;12;22
292;10.07.2016;2016;07;16;Sunnuntai;38;29;67;11;8;19
292;10.07.2016;2016;07;17;Sunnuntai;42;35;77;8;13;21
292;10.07.2016;2016;07;18;Sunnuntai;40;24;64;17;9;26
292;10.07.2016;2016;07;19;Sunnuntai;52;37;89;15;16;31
292;10.07.2016;2016;07;20;Sunnuntai;35;40;75;9;11;20
292;10.07.2016;2016;07;21;Sunnuntai;27;26;53;6;6;12
292;10.07.2016;2016;07;22;Sunnuntai;3;12;15;3;4;7
292;10.07.2016;2016;07;23;Sunnuntai;5;5;10;1;2;3
292;11.07.2016;2016;07;00;Maanantai;7;2;9;1;1;2
292;11.07.2016;2016;07;01;Maanantai;3;4;7;0;0;0
292;11.07.2016;2016;07;02;Maanantai;1;5;6;2;1;3
292;11.07.2016;2016;07;03;Maanantai;0;0;0;2;0;2
292;11.07.2016;2016;07;04;Maanantai;1;2;3;0;1;1
292;11.07.2016;2016;07;05;Maanantai;7;6;13;1;1;2
292;11.07.2016;2016;07;06;Maanantai;15;11;26;2;1;3
292;11.07.2016;2016;07;07;Maanantai;24;18;42;6;1;7
292;11.07.2016;2016;07;08;Maanantai;27;12;39;3;4;7
292;11.07.2016;2016;07;09;Maanantai;25;19;44;7;2;9
292;11.07.2016;2016;07;10;Maanantai;41;28;69;5;8;13
292;11.07.2016;2016;07;11;Maanantai;46;46;92;10;9;19
292;11.07.2016;2016;07;12;Maanantai;60;46;106;5;10;15
292;11.07.2016;2016;07;13;Maanantai;64;59;123;11;8;19
292;11.07.2016;2016;07;14;Maanantai;58;46;104;11;23;34
292;11.07.2016;2016;07;15;Maanantai;61;53;114;11;12;23
292;11.07.2016;2016;07;16;Maanantai;56;60;116;14;16;30
292;11.07.2016;2016;07;17;Maanantai;44;53;97;14;18;32
292;11.07.2016;2016;07;18;Maanantai;77;66;143;17;15;32
292;11.07.2016;2016;07;19;Maanantai;67;60;127;14;15;29
292;11.07.2016;2016;07;20;Maanantai;52;52;104;21;16;37
292;11.07.2016;2016;07;21;Maanantai;37;31;68;7;9;16
292;11.07.2016;2016;07;22;Maanantai;9;12;21;4;5;9
292;11.07.2016;2016;07;23;Maanantai;10;3;13;4;4;8
292;12.07.2016;2016;07;00;Tiistai;3;10;13;2;2;4
292;12.07.2016;2016;07;01;Tiistai;5;7;12;0;1;1
292;12.07.2016;2016;07;02;Tiistai;0;3;3;4;1;5
292;12.07.2016;2016;07;03;Tiistai;2;3;5;2;2;4
292;12.07.2016;2016;07;04;Tiistai;4;0;4;0;1;1
292;12.07.2016;2016;07;05;Tiistai;7;8;15;2;3;5
292;12.07.2016;2016;07;06;Tiistai;18;15;33;2;4;6
292;12.07.2016;2016;07;07;Tiistai;33;14;47;4;4;8
292;12.07.2016;2016;07;08;Tiistai;22;19;41;5;1;6
292;12.07.2016;2016;07;09;Tiistai;28;25;53;4;9;13
292;12.07.2016;2016;07;10;Tiistai;35;24;59;10;8;18
292;12.07.2016;2016;07;11;Tiistai;40;50;90;15;10;25
292;12.07.2016;2016;07;12;Tiistai;50;47;97;23;9;32
292;12.07.2016;2016;07;13;Tiistai;47;49;96;10;12;22
292;12.07.2016;2016;07;14;Tiistai;52;74;126;6;13;19
292;12.07.2016;2016;07;15;Tiistai;69;63;132;21;9;30
292;12.07.2016;2016;07;16;Tiistai;54;62;116;11;9;20
292;12.07.2016;2016;07;17;Tiistai;118;33;151;12;12;24
292;12.07.2016;2016;07;18;Tiistai;52;41;93;12;13;25
292;12.07.2016;2016;07;19;Tiistai;50;49;99;8;6;14
292;12.07.2016;2016;07;20;Tiistai;20;80;100;13;18;31
292;12.07.2016;2016;07;21;Tiistai;43;32;75;9;18;27
292;12.07.2016;2016;07;22;Tiistai;12;17;29;3;3;6
292;12.07.2016;2016;07;23;Tiistai;8;10;18;2;4;6
292;13.07.2016;2016;07;00;Keskiviikko;2;9;11;0;1;1
292;13.07.2016;2016;07;01;Keskiviikko;1;8;9;0;2;2
292;13.07.2016;2016;07;02;Keskiviikko;2;0;2;0;0;0
292;13.07.2016;2016;07;03;Keskiviikko;1;0;1;2;1;3
292;13.07.2016;2016;07;04;Keskiviikko;3;1;4;0;0;0
292;13.07.2016;2016;07;05;Keskiviikko;9;6;15;3;1;4
292;13.07.2016;2016;07;06;Keskiviikko;18;12;30;1;4;5
292;13.07.2016;2016;07;07;Keskiviikko;28;20;48;11;5;16
292;13.07.2016;2016;07;08;Keskiviikko;14;14;28;8;5;13
292;13.07.2016;2016;07;09;Keskiviikko;40;35;75;5;9;14
292;13.07.2016;2016;07;10;Keskiviikko;37;27;64;10;5;15
292;13.07.2016;2016;07;11;Keskiviikko;52;51;103;13;11;24
292;13.07.2016;2016;07;12;Keskiviikko;43;52;95;7;11;18
292;13.07.2016;2016;07;13;Keskiviikko;50;54;104;12;11;23
292;13.07.2016;2016;07;14;Keskiviikko;50;67;117;16;12;28
292;13.07.2016;2016;07;15;Keskiviikko;72;81;153;18;12;30
292;13.07.2016;2016;07;16;Keskiviikko;73;73;146;14;14;28
292;13.07.2016;2016;07;17;Keskiviikko;91;61;152;15;23;38
292;13.07.2016;2016;07;18;Keskiviikko;85;70;155;20;18;38
292;13.07.2016;2016;07;19;Keskiviikko;59;47;106;12;12;24
292;13.07.2016;2016;07;20;Keskiviikko;53;73;126;6;17;23
292;13.07.2016;2016;07;21;Keskiviikko;27;23;50;7;5;12
292;13.07.2016;2016;07;22;Keskiviikko;10;16;26;5;9;14
292;13.07.2016;2016;07;23;Keskiviikko;4;9;13;3;1;4
292;14.07.2016;2016;07;00;Torstai;2;2;4;0;0;0
292;14.07.2016;2016;07;01;Torstai;1;1;2;4;3;7
292;14.07.2016;2016;07;02;Torstai;4;3;7;0;2;2
292;14.07.2016;2016;07;03;Torstai;3;1;4;2;2;4
292;14.07.2016;2016;07;04;Torstai;3;4;7;0;0;0
292;14.07.2016;2016;07;05;Torstai;7;8;15;1;0;1
292;14.07.2016;2016;07;06;Torstai;21;10;31;3;5;8
292;14.07.2016;2016;07;07;Torstai;30;25;55;10;2;12
292;14.07.2016;2016;07;08;Torstai;22;13;35;9;5;14
292;14.07.2016;2016;07;09;Torstai;29;41;70;9;2;11
292;14.07.2016;2016;07;10;Torstai;44;29;73;6;3;9
292;14.07.2016;2016;07;11;Torstai;66;68;134;14;15;29
292;14.07.2016;2016;07;12;Torstai;54;61;115;12;10;22
292;14.07.2016;2016;07;13;Torstai;45;73;118;12;11;23
292;14.07.2016;2016;07;14;Torstai;60;49;109;6;5;11
292;14.07.2016;2016;07;15;Torstai;65;54;119;8;10;18
292;14.07.2016;2016;07;16;Torstai;52;56;108;10;18;28
292;14.07.2016;2016;07;17;Torstai;71;56;127;14;7;21
292;14.07.2016;2016;07;18;Torstai;58;64;122;11;16;27
292;14.07.2016;2016;07;19;Torstai;44;57;101;19;9;28
292;14.07.2016;2016;07;20;Torstai;49;31;80;14;14;28
292;14.07.2016;2016;07;21;Torstai;19;14;33;6;10;16
292;14.07.2016;2016;07;22;Torstai;6;21;27;5;4;9
292;14.07.2016;2016;07;23;Torstai;8;6;14;6;8;14
292;15.07.2016;2016;07;00;Perjantai;4;8;12;4;3;7
292;15.07.2016;2016;07;01;Perjantai;3;5;8;0;0;0
292;15.07.2016;2016;07;02;Perjantai;0;1;1;1;0;1
292;15.07.2016;2016;07;03;Perjantai;1;1;2;1;0;1
292;15.07.2016;2016;07;04;Perjantai;1;0;1;0;4;4
292;15.07.2016;2016;07;05;Perjantai;5;5;10;2;1;3
292;15.07.2016;2016;07;06;Perjantai;14;11;25;2;2;4
292;15.07.2016;2016;07;07;Perjantai;23;7;30;4;3;7
292;15.07.2016;2016;07;08;Perjantai;14;16;30;1;5;6
292;15.07.2016;2016;07;09;Perjantai;12;22;34;4;4;8
292;15.07.2016;2016;07;10;Perjantai;29;30;59;4;7;11
292;15.07.2016;2016;07;11;Perjantai;46;26;72;6;7;13
292;15.07.2016;2016;07;12;Perjantai;38;61;99;19;10;29
292;15.07.2016;2016;07;13;Perjantai;35;52;87;10;10;20
292;15.07.2016;2016;07;14;Perjantai;39;31;70;10;6;16
292;15.07.2016;2016;07;15;Perjantai;22;30;52;6;4;10
292;15.07.2016;2016;07;16;Perjantai;44;36;80;7;5;12
292;15.07.2016;2016;07;17;Perjantai;44;38;82;4;8;12
292;15.07.2016;2016;07;18;Perjantai;37;16;53;11;17;28
292;15.07.2016;2016;07;19;Perjantai;34;25;59;13;14;27
292;15.07.2016;2016;07;20;Perjantai;33;28;61;10;14;24
292;15.07.2016;2016;07;21;Perjantai;14;20;34;7;8;15
292;15.07.2016;2016;07;22;Perjantai;17;3;20;5;4;9
292;15.07.2016;2016;07;23;Perjantai;10;9;19;3;5;8
292;16.07.2016;2016;07;00;Lauantai;6;9;15;1;2;3
292;16.07.2016;2016;07;01;Lauantai;1;3;4;0;3;3
292;16.07.2016;2016;07;02;Lauantai;1;11;12;1;2;3
292;16.07.2016;2016;07;03;Lauantai;2;2;4;0;2;2
292;16.07.2016;2016;07;04;Lauantai;0;2;2;1;2;3
292;16.07.2016;2016;07;05;Lauantai;1;2;3;1;1;2
292;16.07.2016;2016;07;06;Lauantai;2;0;2;0;1;1
292;16.07.2016;2016;07;07;Lauantai;1;2;3;0;1;1
292;16.07.2016;2016;07;08;Lauantai;3;4;7;2;2;4
292;16.07.2016;2016;07;09;Lauantai;8;2;10;5;2;7
292;16.07.2016;2016;07;10;Lauantai;11;13;24;8;8;16
292;16.07.2016;2016;07;11;Lauantai;5;6;11;2;1;3
292;16.07.2016;2016;07;12;Lauantai;12;18;30;8;5;13
292;16.07.2016;2016;07;13;Lauantai;10;12;22;4;2;6
292;16.07.2016;2016;07;14;Lauantai;8;7;15;0;0;0
292;16.07.2016;2016;07;15;Lauantai;10;10;20;5;5;10
292;16.07.2016;2016;07;16;Lauantai;36;18;54;5;8;13
292;16.07.2016;2016;07;17;Lauantai;24;21;45;9;4;13
292;16.07.2016;2016;07;18;Lauantai;27;21;48;13;11;24
292;16.07.2016;2016;07;19;Lauantai;37;43;80;18;19;37
292;16.07.2016;2016;07;20;Lauantai;47;18;65;9;11;20
292;16.07.2016;2016;07;21;Lauantai;18;19;37;2;12;14
292;16.07.2016;2016;07;22;Lauantai;9;11;20;4;3;7
292;16.07.2016;2016;07;23;Lauantai;26;13;39;5;2;7
292;17.07.2016;2016;07;00;Sunnuntai;8;6;14;5;1;6
292;17.07.2016;2016;07;01;Sunnuntai;3;5;8;0;8;8
292;17.07.2016;2016;07;02;Sunnuntai;4;19;23;0;4;4
292;17.07.2016;2016;07;03;Sunnuntai;3;2;5;0;0;0
292;17.07.2016;2016;07;04;Sunnuntai;0;2;2;1;0;1
292;17.07.2016;2016;07;05;Sunnuntai;0;2;2;4;0;4
292;17.07.2016;2016;07;06;Sunnuntai;0;3;3;2;2;4
292;17.07.2016;2016;07;07;Sunnuntai;3;2;5;3;1;4
292;17.07.2016;2016;07;08;Sunnuntai;4;7;11;3;1;4
292;17.07.2016;2016;07;09;Sunnuntai;14;10;24;9;6;15
292;17.07.2016;2016;07;10;Sunnuntai;15;10;25;5;4;9
292;17.07.2016;2016;07;11;Sunnuntai;31;30;61;7;10;17
292;17.07.2016;2016;07;12;Sunnuntai;27;30;57;12;15;27
292;17.07.2016;2016;07;13;Sunnuntai;23;27;50;13;7;20
292;17.07.2016;2016;07;14;Sunnuntai;34;31;65;7;6;13
292;17.07.2016;2016;07;15;Sunnuntai;33;45;78;3;11;14
292;17.07.2016;2016;07;16;Sunnuntai;10;5;15;3;3;6
292;17.07.2016;2016;07;17;Sunnuntai;28;21;49;6;3;9
292;17.07.2016;2016;07;18;Sunnuntai;47;29;76;15;10;25
292;17.07.2016;2016;07;19;Sunnuntai;47;47;94;10;19;29
292;17.07.2016;2016;07;20;Sunnuntai;42;37;79;13;17;30
292;17.07.2016;2016;07;21;Sunnuntai;19;26;45;4;5;9
292;17.07.2016;2016;07;22;Sunnuntai;3;7;10;6;2;8
292;17.07.2016;2016;07;23;Sunnuntai;6;5;11;2;2;4
292;18.07.2016;2016;07;00;Maanantai;5;6;11;0;3;3
292;18.07.2016;2016;07;01;Maanantai;1;2;3;2;2;4
292;18.07.2016;2016;07;02;Maanantai;3;1;4;2;2;4
292;18.07.2016;2016;07;03;Maanantai;0;1;1;1;1;2
292;18.07.2016;2016;07;04;Maanantai;0;1;1;1;1;2
292;18.07.2016;2016;07;05;Maanantai;8;7;15;0;0;0
292;18.07.2016;2016;07;06;Maanantai;13;12;25;5;0;5
292;18.07.2016;2016;07;07;Maanantai;33;16;49;2;3;5
292;18.07.2016;2016;07;08;Maanantai;19;18;37;11;3;14
292;18.07.2016;2016;07;09;Maanantai;26;17;43;11;9;20
292;18.07.2016;2016;07;10;Maanantai;29;36;65;7;8;15
292;18.07.2016;2016;07;11;Maanantai;40;40;80;17;7;24
292;18.07.2016;2016;07;12;Maanantai;50;40;90;7;7;14
292;18.07.2016;2016;07;13;Maanantai;41;52;93;19;12;31
292;18.07.2016;2016;07;14;Maanantai;61;67;128;11;10;21
292;18.07.2016;2016;07;15;Maanantai;72;69;141;10;9;19
292;18.07.2016;2016;07;16;Maanantai;92;71;163;14;12;26
292;18.07.2016;2016;07;17;Maanantai;67;55;122;6;12;18
292;18.07.2016;2016;07;18;Maanantai;62;63;125;24;14;38
292;18.07.2016;2016;07;19;Maanantai;67;56;123;15;17;32
292;18.07.2016;2016;07;20;Maanantai;42;38;80;12;23;35
292;18.07.2016;2016;07;21;Maanantai;30;30;60;12;12;24
292;18.07.2016;2016;07;22;Maanantai;12;24;36;10;6;16
292;18.07.2016;2016;07;23;Maanantai;6;10;16;3;11;14
292;19.07.2016;2016;07;00;Tiistai;6;5;11;1;1;2
292;19.07.2016;2016;07;01;Tiistai;9;6;15;1;1;2
292;19.07.2016;2016;07;02;Tiistai;0;3;3;2;3;5
292;19.07.2016;2016;07;03;Tiistai;3;1;4;0;0;0
292;19.07.2016;2016;07;04;Tiistai;3;3;6;3;2;5
292;19.07.2016;2016;07;05;Tiistai;5;7;12;2;2;4
292;19.07.2016;2016;07;06;Tiistai;19;11;30;1;5;6
292;19.07.2016;2016;07;07;Tiistai;29;20;49;1;4;5
292;19.07.2016;2016;07;08;Tiistai;21;23;44;9;4;13
292;19.07.2016;2016;07;09;Tiistai;26;21;47;3;4;7
292;19.07.2016;2016;07;10;Tiistai;30;33;63;2;4;6
292;19.07.2016;2016;07;11;Tiistai;40;44;84;9;8;17
292;19.07.2016;2016;07;12;Tiistai;47;45;92;12;3;15
292;19.07.2016;2016;07;13;Tiistai;58;59;117;4;7;11
292;19.07.2016;2016;07;14;Tiistai;58;76;134;27;15;42
292;19.07.2016;2016;07;15;Tiistai;73;58;131;18;10;28
292;19.07.2016;2016;07;16;Tiistai;67;70;137;17;25;42
292;19.07.2016;2016;07;17;Tiistai;66;46;112;18;10;28
292;19.07.2016;2016;07;18;Tiistai;55;70;125;18;14;32
292;19.07.2016;2016;07;19;Tiistai;58;65;123;22;20;42
292;19.07.2016;2016;07;20;Tiistai;58;45;103;12;12;24
292;19.07.2016;2016;07;21;Tiistai;31;27;58;9;7;16
292;19.07.2016;2016;07;22;Tiistai;7;20;27;5;9;14
292;19.07.2016;2016;07;23;Tiistai;9;11;20;4;2;6
292;20.07.2016;2016;07;00;Keskiviikko;1;5;6;1;4;5
292;20.07.2016;2016;07;01;Keskiviikko;6;6;12;1;1;2
292;20.07.2016;2016;07;02;Keskiviikko;1;3;4;0;0;0
292;20.07.2016;2016;07;03;Keskiviikko;4;3;7;0;2;2
292;20.07.2016;2016;07;04;Keskiviikko;2;4;6;1;1;2
292;20.07.2016;2016;07;05;Keskiviikko;5;7;12;1;1;2
292;20.07.2016;2016;07;06;Keskiviikko;24;14;38;4;2;6
292;20.07.2016;2016;07;07;Keskiviikko;33;21;54;4;5;9
292;20.07.2016;2016;07;08;Keskiviikko;21;15;36;8;3;11
292;20.07.2016;2016;07;09;Keskiviikko;34;26;60;8;4;12
292;20.07.2016;2016;07;10;Keskiviikko;38;35;73;4;4;8
292;20.07.2016;2016;07;11;Keskiviikko;53;50;103;7;8;15
292;20.07.2016;2016;07;12;Keskiviikko;47;58;105;9;8;17
292;20.07.2016;2016;07;13;Keskiviikko;69;72;141;15;10;25
292;20.07.2016;2016;07;14;Keskiviikko;57;55;112;9;16;25
292;20.07.2016;2016;07;15;Keskiviikko;75;62;137;8;6;14
292;20.07.2016;2016;07;16;Keskiviikko;76;80;156;12;11;23
292;20.07.2016;2016;07;17;Keskiviikko;76;48;124;17;16;33
292;20.07.2016;2016;07;18;Keskiviikko;60;60;120;17;13;30
292;20.07.2016;2016;07;19;Keskiviikko;65;48;113;16;9;25
292;20.07.2016;2016;07;20;Keskiviikko;37;52;89;19;18;37
292;20.07.2016;2016;07;21;Keskiviikko;46;47;93;4;11;15
292;20.07.2016;2016;07;22;Keskiviikko;10;19;29;5;7;12
292;20.07.2016;2016;07;23;Keskiviikko;5;12;17;3;4;7
292;21.07.2016;2016;07;00;Torstai;4;9;13;1;4;5
292;21.07.2016;2016;07;01;Torstai;2;7;9;5;0;5
292;21.07.2016;2016;07;02;Torstai;1;4;5;0;1;1
292;21.07.2016;2016;07;03;Torstai;3;1;4;0;1;1
292;21.07.2016;2016;07;04;Torstai;1;1;2;2;2;4
292;21.07.2016;2016;07;05;Torstai;5;7;12;1;1;2
292;21.07.2016;2016;07;06;Torstai;26;14;40;1;1;2
292;21.07.2016;2016;07;07;Torstai;21;14;35;10;1;11
292;21.07.2016;2016;07;08;Torstai;26;14;40;4;3;7
292;21.07.2016;2016;07;09;Torstai;35;19;54;6;5;11
292;21.07.2016;2016;07;10;Torstai;33;28;61;9;7;16
292;21.07.2016;2016;07;11;Torstai;41;36;77;8;6;14
292;21.07.2016;2016;07;12;Torstai;50;62;112;14;13;27
292;21.07.2016;2016;07;13;Torstai;57;62;119;10;14;24
292;21.07.2016;2016;07;14;Torstai;54;58;112;16;8;24
292;21.07.2016;2016;07;15;Torstai;65;56;121;19;8;27
292;21.07.2016;2016;07;16;Torstai;54;60;114;17;18;35
292;21.07.2016;2016;07;17;Torstai;118;71;189;16;10;26
292;21.07.2016;2016;07;18;Torstai;76;64;140;11;14;25
292;21.07.2016;2016;07;19;Torstai;70;53;123;12;10;22
292;21.07.2016;2016;07;20;Torstai;42;60;102;9;13;22
292;21.07.2016;2016;07;21;Torstai;24;58;82;6;11;17
292;21.07.2016;2016;07;22;Torstai;4;33;37;4;11;15
292;21.07.2016;2016;07;23;Torstai;4;8;12;1;2;3
292;22.07.2016;2016;07;00;Perjantai;7;6;13;1;1;2
292;22.07.2016;2016;07;01;Perjantai;2;0;2;1;0;1
292;22.07.2016;2016;07;02;Perjantai;3;6;9;4;1;5
292;22.07.2016;2016;07;03;Perjantai;0;2;2;0;1;1
292;22.07.2016;2016;07;04;Perjantai;2;1;3;2;0;2
292;22.07.2016;2016;07;05;Perjantai;7;9;16;0;2;2
292;22.07.2016;2016;07;06;Perjantai;14;12;26;2;2;4
292;22.07.2016;2016;07;07;Perjantai;27;15;42;4;1;5
292;22.07.2016;2016;07;08;Perjantai;30;22;52;5;1;6
292;22.07.2016;2016;07;09;Perjantai;26;29;55;2;3;5
292;22.07.2016;2016;07;10;Perjantai;40;32;72;9;6;15
292;22.07.2016;2016;07;11;Perjantai;30;38;68;11;12;23
292;22.07.2016;2016;07;12;Perjantai;60;51;111;14;10;24
292;22.07.2016;2016;07;13;Perjantai;61;62;123;10;8;18
292;22.07.2016;2016;07;14;Perjantai;56;58;114;11;10;21
292;22.07.2016;2016;07;15;Perjantai;63;57;120;7;11;18
292;22.07.2016;2016;07;16;Perjantai;51;39;90;8;12;20
292;22.07.2016;2016;07;17;Perjantai;65;40;105;17;14;31
292;22.07.2016;2016;07;18;Perjantai;61;42;103;16;14;30
292;22.07.2016;2016;07;19;Perjantai;48;49;97;5;5;10
292;22.07.2016;2016;07;20;Perjantai;31;42;73;7;9;16
292;22.07.2016;2016;07;21;Perjantai;21;34;55;7;7;14
292;22.07.2016;2016;07;22;Perjantai;21;26;47;2;8;10
292;22.07.2016;2016;07;23;Perjantai;8;16;24;4;2;6
292;23.07.2016;2016;07;00;Lauantai;14;9;23;2;8;10
292;23.07.2016;2016;07;01;Lauantai;10;13;23;4;1;5
292;23.07.2016;2016;07;02;Lauantai;3;12;15;0;4;4
292;23.07.2016;2016;07;03;Lauantai;0;4;4;0;2;2
292;23.07.2016;2016;07;04;Lauantai;2;3;5;1;0;1
292;23.07.2016;2016;07;05;Lauantai;1;4;5;2;0;2
292;23.07.2016;2016;07;06;Lauantai;4;4;8;2;5;7
292;23.07.2016;2016;07;07;Lauantai;5;5;10;4;2;6
292;23.07.2016;2016;07;08;Lauantai;3;13;16;6;3;9
292;23.07.2016;2016;07;09;Lauantai;15;25;40;2;4;6
292;23.07.2016;2016;07;10;Lauantai;43;37;80;9;10;19
292;23.07.2016;2016;07;11;Lauantai;31;27;58;9;6;15
292;23.07.2016;2016;07;12;Lauantai;61;39;100;17;9;26
292;23.07.2016;2016;07;13;Lauantai;51;28;79;12;4;16
292;23.07.2016;2016;07;14;Lauantai;52;44;96;8;9;17
292;23.07.2016;2016;07;15;Lauantai;35;49;84;6;11;17
292;23.07.2016;2016;07;16;Lauantai;52;41;93;14;4;18
292;23.07.2016;2016;07;17;Lauantai;46;29;75;7;10;17
292;23.07.2016;2016;07;18;Lauantai;50;47;97;14;8;22
292;23.07.2016;2016;07;19;Lauantai;37;38;75;7;6;13
292;23.07.2016;2016;07;20;Lauantai;41;33;74;10;5;15
292;23.07.2016;2016;07;21;Lauantai;22;30;52;11;6;17
292;23.07.2016;2016;07;22;Lauantai;8;17;25;9;6;15
292;23.07.2016;2016;07;23;Lauantai;16;11;27;1;2;3
292;24.07.2016;2016;07;00;Sunnuntai;13;9;22;3;5;8
292;24.07.2016;2016;07;01;Sunnuntai;3;10;13;0;2;2
292;24.07.2016;2016;07;02;Sunnuntai;2;11;13;0;5;5
292;24.07.2016;2016;07;03;Sunnuntai;2;3;5;1;2;3
292;24.07.2016;2016;07;04;Sunnuntai;1;1;2;1;0;1
292;24.07.2016;2016;07;05;Sunnuntai;2;0;2;0;0;0
292;24.07.2016;2016;07;06;Sunnuntai;2;3;5;0;1;1
292;24.07.2016;2016;07;07;Sunnuntai;7;5;12;1;0;1
292;24.07.2016;2016;07;08;Sunnuntai;2;6;8;1;1;2
292;24.07.2016;2016;07;09;Sunnuntai;14;14;28;3;5;8
292;24.07.2016;2016;07;10;Sunnuntai;26;19;45;2;3;5
292;24.07.2016;2016;07;11;Sunnuntai;50;36;86;6;0;6
292;24.07.2016;2016;07;12;Sunnuntai;60;56;116;7;6;13
292;24.07.2016;2016;07;13;Sunnuntai;68;54;122;5;7;12
292;24.07.2016;2016;07;14;Sunnuntai;49;44;93;13;12;25
292;24.07.2016;2016;07;15;Sunnuntai;59;44;103;11;8;19
292;24.07.2016;2016;07;16;Sunnuntai;35;35;70;7;6;13
292;24.07.2016;2016;07;17;Sunnuntai;46;53;99;9;9;18
292;24.07.2016;2016;07;18;Sunnuntai;62;49;111;13;6;19
292;24.07.2016;2016;07;19;Sunnuntai;62;64;126;15;14;29
292;24.07.2016;2016;07;20;Sunnuntai;40;47;87;8;13;21
292;24.07.2016;2016;07;21;Sunnuntai;25;33;58;3;6;9
292;24.07.2016;2016;07;22;Sunnuntai;15;21;36;2;4;6
292;24.07.2016;2016;07;23;Sunnuntai;8;8;16;4;1;5
292;25.07.2016;2016;07;00;Maanantai;8;16;24;0;3;3
292;25.07.2016;2016;07;01;Maanantai;0;5;5;1;1;2
292;25.07.2016;2016;07;02;Maanantai;2;5;7;0;2;2
292;25.07.2016;2016;07;03;Maanantai;1;2;3;0;0;0
292;25.07.2016;2016;07;04;Maanantai;1;4;5;2;1;3
292;25.07.2016;2016;07;05;Maanantai;7;7;14;3;3;6
292;25.07.2016;2016;07;06;Maanantai;21;14;35;4;1;5
292;25.07.2016;2016;07;07;Maanantai;29;14;43;6;6;12
292;25.07.2016;2016;07;08;Maanantai;19;19;38;7;6;13
292;25.07.2016;2016;07;09;Maanantai;23;25;48;10;1;11
292;25.07.2016;2016;07;10;Maanantai;38;33;71;2;6;8
292;25.07.2016;2016;07;11;Maanantai;48;42;90;7;9;16
292;25.07.2016;2016;07;12;Maanantai;47;54;101;8;11;19
292;25.07.2016;2016;07;13;Maanantai;69;63;132;12;7;19
292;25.07.2016;2016;07;14;Maanantai;66;58;124;9;17;26
292;25.07.2016;2016;07;15;Maanantai;77;90;167;14;3;17
292;25.07.2016;2016;07;16;Maanantai;75;78;153;12;18;30
292;25.07.2016;2016;07;17;Maanantai;67;60;127;17;12;29
292;25.07.2016;2016;07;18;Maanantai;67;55;122;21;18;39
292;25.07.2016;2016;07;19;Maanantai;59;71;130;14;20;34
292;25.07.2016;2016;07;20;Maanantai;61;44;105;19;19;38
292;25.07.2016;2016;07;21;Maanantai;28;31;59;7;11;18
292;25.07.2016;2016;07;22;Maanantai;12;7;19;4;3;7
292;25.07.2016;2016;07;23;Maanantai;10;14;24;3;2;5
292;26.07.2016;2016;07;00;Tiistai;3;5;8;1;3;4
292;26.07.2016;2016;07;01;Tiistai;5;4;9;1;0;1
292;26.07.2016;2016;07;02;Tiistai;0;1;1;1;0;1
292;26.07.2016;2016;07;03;Tiistai;0;1;1;0;0;0
292;26.07.2016;2016;07;04;Tiistai;3;3;6;1;0;1
292;26.07.2016;2016;07;05;Tiistai;12;5;17;1;2;3
292;26.07.2016;2016;07;06;Tiistai;21;24;45;4;3;7
292;26.07.2016;2016;07;07;Tiistai;39;21;60;3;1;4
292;26.07.2016;2016;07;08;Tiistai;33;22;55;7;4;11
292;26.07.2016;2016;07;09;Tiistai;37;28;65;4;4;8
292;26.07.2016;2016;07;10;Tiistai;49;37;86;4;4;8
292;26.07.2016;2016;07;11;Tiistai;40;52;92;0;8;8
292;26.07.2016;2016;07;12;Tiistai;69;58;127;12;9;21
292;26.07.2016;2016;07;13;Tiistai;43;61;104;8;9;17
292;26.07.2016;2016;07;14;Tiistai;60;53;113;17;4;21
292;26.07.2016;2016;07;15;Tiistai;86;63;149;13;13;26
292;26.07.2016;2016;07;16;Tiistai;70;68;138;13;23;36
292;26.07.2016;2016;07;17;Tiistai;84;69;153;9;4;13
292;26.07.2016;2016;07;18;Tiistai;65;67;132;5;9;14
292;26.07.2016;2016;07;19;Tiistai;64;52;116;19;11;30
292;26.07.2016;2016;07;20;Tiistai;49;44;93;18;11;29
292;26.07.2016;2016;07;21;Tiistai;30;22;52;3;8;11
292;26.07.2016;2016;07;22;Tiistai;8;14;22;3;4;7
292;26.07.2016;2016;07;23;Tiistai;6;11;17;3;1;4
292;27.07.2016;2016;07;00;Keskiviikko;3;5;8;4;1;5
292;27.07.2016;2016;07;01;Keskiviikko;2;8;10;0;3;3
292;27.07.2016;2016;07;02;Keskiviikko;0;7;7;0;2;2
292;27.07.2016;2016;07;03;Keskiviikko;5;4;9;3;6;9
292;27.07.2016;2016;07;04;Keskiviikko;4;0;4;2;1;3
292;27.07.2016;2016;07;05;Keskiviikko;9;7;16;2;1;3
292;27.07.2016;2016;07;06;Keskiviikko;15;11;26;3;0;3
292;27.07.2016;2016;07;07;Keskiviikko;21;16;37;9;2;11
292;27.07.2016;2016;07;08;Keskiviikko;10;12;22;3;3;6
292;27.07.2016;2016;07;09;Keskiviikko;8;9;17;0;0;0
292;27.07.2016;2016;07;10;Keskiviikko;13;19;32;4;4;8
292;27.07.2016;2016;07;11;Keskiviikko;33;46;79;8;8;16
292;27.07.2016;2016;07;12;Keskiviikko;35;36;71;8;6;14
292;27.07.2016;2016;07;13;Keskiviikko;45;50;95;10;3;13
292;27.07.2016;2016;07;14;Keskiviikko;34;44;78;7;9;16
292;27.07.2016;2016;07;15;Keskiviikko;58;57;115;16;13;29
292;27.07.2016;2016;07;16;Keskiviikko;74;69;143;24;9;33
292;27.07.2016;2016;07;17;Keskiviikko;53;51;104;7;11;18
292;27.07.2016;2016;07;18;Keskiviikko;54;60;114;9;14;23
292;27.07.2016;2016;07;19;Keskiviikko;50;43;93;20;13;33
292;27.07.2016;2016;07;20;Keskiviikko;38;35;73;6;17;23
292;27.07.2016;2016;07;21;Keskiviikko;28;31;59;8;7;15
292;27.07.2016;2016;07;22;Keskiviikko;16;17;33;2;7;9
292;27.07.2016;2016;07;23;Keskiviikko;18;10;28;6;0;6
292;28.07.2016;2016;07;00;Torstai;2;5;7;1;4;5
292;28.07.2016;2016;07;01;Torstai;5;4;9;0;4;4
292;28.07.2016;2016;07;02;Torstai;1;3;4;0;3;3
292;28.07.2016;2016;07;03;Torstai;2;1;3;1;0;1
292;28.07.2016;2016;07;04;Torstai;2;1;3;0;1;1
292;28.07.2016;2016;07;05;Torstai;7;9;16;2;1;3
292;28.07.2016;2016;07;06;Torstai;24;14;38;2;1;3
292;28.07.2016;2016;07;07;Torstai;23;16;39;7;3;10
292;28.07.2016;2016;07;08;Torstai;16;14;30;8;2;10
292;28.07.2016;2016;07;09;Torstai;25;19;44;10;9;19
292;28.07.2016;2016;07;10;Torstai;27;31;58;5;3;8
292;28.07.2016;2016;07;11;Torstai;47;40;87;11;3;14
292;28.07.2016;2016;07;12;Torstai;59;59;118;15;6;21
292;28.07.2016;2016;07;13;Torstai;59;68;127;11;15;26
292;28.07.2016;2016;07;14;Torstai;84;72;156;9;8;17
292;28.07.2016;2016;07;15;Torstai;80;63;143;13;21;34
292;28.07.2016;2016;07;16;Torstai;67;58;125;18;13;31
292;28.07.2016;2016;07;17;Torstai;59;55;114;9;12;21
292;28.07.2016;2016;07;18;Torstai;43;48;91;11;13;24
292;28.07.2016;2016;07;19;Torstai;62;40;102;10;16;26
292;28.07.2016;2016;07;20;Torstai;38;23;61;12;8;20
292;28.07.2016;2016;07;21;Torstai;19;39;58;8;7;15
292;28.07.2016;2016;07;22;Torstai;6;8;14;4;3;7
292;28.07.2016;2016;07;23;Torstai;4;12;16;4;5;9
292;29.07.2016;2016;07;00;Perjantai;9;3;12;3;1;4
292;29.07.2016;2016;07;01;Perjantai;7;8;15;1;5;6
292;29.07.2016;2016;07;02;Perjantai;0;1;1;0;1;1
292;29.07.2016;2016;07;03;Perjantai;0;1;1;0;2;2
292;29.07.2016;2016;07;04;Perjantai;1;0;1;1;0;1
292;29.07.2016;2016;07;05;Perjantai;8;7;15;2;3;5
292;29.07.2016;2016;07;06;Perjantai;18;5;23;3;1;4
292;29.07.2016;2016;07;07;Perjantai;24;16;40;3;2;5
292;29.07.2016;2016;07;08;Perjantai;16;13;29;3;3;6
292;29.07.2016;2016;07;09;Perjantai;26;25;51;10;6;16
292;29.07.2016;2016;07;10;Perjantai;25;21;46;13;6;19
292;29.07.2016;2016;07;11;Perjantai;37;48;85;6;10;16
292;29.07.2016;2016;07;12;Perjantai;45;45;90;7;2;9
292;29.07.2016;2016;07;13;Perjantai;39;43;82;7;10;17
292;29.07.2016;2016;07;14;Perjantai;49;62;111;3;6;9
292;29.07.2016;2016;07;15;Perjantai;49;57;106;16;17;33
292;29.07.2016;2016;07;16;Perjantai;55;45;100;16;10;26
292;29.07.2016;2016;07;17;Perjantai;53;36;89;12;8;20
292;29.07.2016;2016;07;18;Perjantai;51;38;89;7;6;13
292;29.07.2016;2016;07;19;Perjantai;58;39;97;21;7;28
292;29.07.2016;2016;07;20;Perjantai;36;37;73;7;15;22
292;29.07.2016;2016;07;21;Perjantai;30;12;42;9;6;15
292;29.07.2016;2016;07;22;Perjantai;16;15;31;4;1;5
292;29.07.2016;2016;07;23;Perjantai;8;7;15;7;5;12
292;30.07.2016;2016;07;00;Lauantai;6;12;18;2;0;2
292;30.07.2016;2016;07;01;Lauantai;3;5;8;3;4;7
292;30.07.2016;2016;07;02;Lauantai;3;15;18;1;9;10
292;30.07.2016;2016;07;03;Lauantai;0;6;6;0;2;2
292;30.07.2016;2016;07;04;Lauantai;0;1;1;0;0;0
292;30.07.2016;2016;07;05;Lauantai;3;7;10;0;0;0
292;30.07.2016;2016;07;06;Lauantai;6;6;12;2;2;4
292;30.07.2016;2016;07;07;Lauantai;10;9;19;0;1;1
292;30.07.2016;2016;07;08;Lauantai;11;14;25;6;2;8
292;30.07.2016;2016;07;09;Lauantai;13;18;31;7;4;11
292;30.07.2016;2016;07;10;Lauantai;34;30;64;9;6;15
292;30.07.2016;2016;07;11;Lauantai;41;34;75;10;5;15
292;30.07.2016;2016;07;12;Lauantai;45;48;93;12;10;22
292;30.07.2016;2016;07;13;Lauantai;47;45;92;8;8;16
292;30.07.2016;2016;07;14;Lauantai;51;50;101;7;8;15
292;30.07.2016;2016;07;15;Lauantai;28;23;51;2;1;3
292;30.07.2016;2016;07;16;Lauantai;19;19;38;8;2;10
292;30.07.2016;2016;07;17;Lauantai;24;35;59;7;8;15
292;30.07.2016;2016;07;18;Lauantai;37;38;75;10;3;13
292;30.07.2016;2016;07;19;Lauantai;55;41;96;15;7;22
292;30.07.2016;2016;07;20;Lauantai;27;26;53;8;6;14
292;30.07.2016;2016;07;21;Lauantai;35;25;60;2;6;8
292;30.07.2016;2016;07;22;Lauantai;19;17;36;3;5;8
292;30.07.2016;2016;07;23;Lauantai;13;2;15;2;1;3
292;31.07.2016;2016;07;00;Sunnuntai;7;11;18;3;3;6
292;31.07.2016;2016;07;01;Sunnuntai;3;10;13;1;3;4
292;31.07.2016;2016;07;02;Sunnuntai;4;5;9;0;3;3
292;31.07.2016;2016;07;03;Sunnuntai;2;6;8;0;1;1
292;31.07.2016;2016;07;04;Sunnuntai;0;2;2;0;0;0
292;31.07.2016;2016;07;05;Sunnuntai;0;3;3;4;1;5
292;31.07.2016;2016;07;06;Sunnuntai;6;3;9;4;3;7
292;31.07.2016;2016;07;07;Sunnuntai;3;2;5;0;2;2
292;31.07.2016;2016;07;08;Sunnuntai;4;7;11;2;3;5
292;31.07.2016;2016;07;09;Sunnuntai;22;11;33;4;6;10
292;31.07.2016;2016;07;10;Sunnuntai;15;15;30;7;4;11
292;31.07.2016;2016;07;11;Sunnuntai;18;23;41;14;5;19
292;31.07.2016;2016;07;12;Sunnuntai;19;10;29;9;4;13
292;31.07.2016;2016;07;13;Sunnuntai;17;19;36;5;1;6
292;31.07.2016;2016;07;14;Sunnuntai;32;30;62;12;6;18
292;31.07.2016;2016;07;15;Sunnuntai;35;23;58;8;6;14
292;31.07.2016;2016;07;16;Sunnuntai;39;23;62;4;2;6
292;31.07.2016;2016;07;17;Sunnuntai;17;20;37;3;3;6
292;31.07.2016;2016;07;18;Sunnuntai;17;8;25;4;3;7
292;31.07.2016;2016;07;19;Sunnuntai;19;27;46;7;5;12
292;31.07.2016;2016;07;20;Sunnuntai;16;21;37;4;4;8
292;31.07.2016;2016;07;21;Sunnuntai;11;8;19;1;7;8
292;31.07.2016;2016;07;22;Sunnuntai;5;8;13;0;2;2
292;31.07.2016;2016;07;23;Sunnuntai;1;4;5;0;1;1
292;01.08.2016;2016;08;00;Maanantai;5;1;6;1;5;6
292;01.08.2016;2016;08;01;Maanantai;3;5;8;1;1;2
292;01.08.2016;2016;08;02;Maanantai;0;0;0;0;1;1
292;01.08.2016;2016;08;03;Maanantai;0;1;1;0;2;2
292;01.08.2016;2016;08;04;Maanantai;0;1;1;1;1;2
292;01.08.2016;2016;08;05;Maanantai;7;9;16;0;1;1
292;01.08.2016;2016;08;06;Maanantai;27;11;38;10;3;13
292;01.08.2016;2016;08;07;Maanantai;37;25;62;3;5;8
292;01.08.2016;2016;08;08;Maanantai;22;18;40;11;10;21
292;01.08.2016;2016;08;09;Maanantai;28;34;62;8;6;14
292;01.08.2016;2016;08;10;Maanantai;45;35;80;14;8;22
292;01.08.2016;2016;08;11;Maanantai;44;55;99;2;4;6
292;01.08.2016;2016;08;12;Maanantai;65;58;123;13;9;22
292;01.08.2016;2016;08;13;Maanantai;78;56;134;17;7;24
292;01.08.2016;2016;08;14;Maanantai;79;74;153;13;11;24
292;01.08.2016;2016;08;15;Maanantai;54;63;117;11;18;29
292;01.08.2016;2016;08;16;Maanantai;82;78;160;9;10;19
292;01.08.2016;2016;08;17;Maanantai;53;53;106;12;13;25
292;01.08.2016;2016;08;18;Maanantai;50;69;119;13;11;24
292;01.08.2016;2016;08;19;Maanantai;74;57;131;15;21;36
292;01.08.2016;2016;08;20;Maanantai;58;63;121;19;14;33
292;01.08.2016;2016;08;21;Maanantai;18;32;50;7;7;14
292;01.08.2016;2016;08;22;Maanantai;23;13;36;4;3;7
292;01.08.2016;2016;08;23;Maanantai;6;11;17;1;4;5
292;02.08.2016;2016;08;00;Tiistai;7;8;15;0;1;1
292;02.08.2016;2016;08;01;Tiistai;3;10;13;2;2;4
292;02.08.2016;2016;08;02;Tiistai;1;5;6;0;3;3
292;02.08.2016;2016;08;03;Tiistai;1;1;2;1;2;3
292;02.08.2016;2016;08;04;Tiistai;1;0;1;0;0;0
292;02.08.2016;2016;08;05;Tiistai;10;5;15;1;2;3
292;02.08.2016;2016;08;06;Tiistai;22;13;35;1;2;3
292;02.08.2016;2016;08;07;Tiistai;35;33;68;6;9;15
292;02.08.2016;2016;08;08;Tiistai;7;18;25;2;4;6
292;02.08.2016;2016;08;09;Tiistai;6;12;18;4;4;8
292;02.08.2016;2016;08;10;Tiistai;18;17;35;2;6;8
292;02.08.2016;2016;08;11;Tiistai;21;29;50;7;1;8
292;02.08.2016;2016;08;12;Tiistai;57;35;92;8;2;10
292;02.08.2016;2016;08;13;Tiistai;55;36;91;9;6;15
292;02.08.2016;2016;08;14;Tiistai;35;46;81;14;4;18
292;02.08.2016;2016;08;15;Tiistai;31;29;60;2;3;5
292;02.08.2016;2016;08;16;Tiistai;42;34;76;5;2;7
292;02.08.2016;2016;08;17;Tiistai;32;30;62;13;6;19
292;02.08.2016;2016;08;18;Tiistai;44;44;88;21;13;34
292;02.08.2016;2016;08;19;Tiistai;53;41;94;14;15;29
292;02.08.2016;2016;08;20;Tiistai;32;21;53;9;6;15
292;02.08.2016;2016;08;21;Tiistai;24;16;40;8;10;18
292;02.08.2016;2016;08;22;Tiistai;9;19;28;3;5;8
292;02.08.2016;2016;08;23;Tiistai;7;10;17;1;4;5
292;03.08.2016;2016;08;00;Keskiviikko;7;3;10;2;1;3
292;03.08.2016;2016;08;01;Keskiviikko;1;4;5;1;0;1
292;03.08.2016;2016;08;02;Keskiviikko;1;4;5;0;1;1
292;03.08.2016;2016;08;03;Keskiviikko;1;1;2;0;0;0
292;03.08.2016;2016;08;04;Keskiviikko;0;3;3;0;0;0
292;03.08.2016;2016;08;05;Keskiviikko;5;6;11;2;3;5
292;03.08.2016;2016;08;06;Keskiviikko;21;18;39;3;1;4
292;03.08.2016;2016;08;07;Keskiviikko;40;28;68;3;3;6
292;03.08.2016;2016;08;08;Keskiviikko;23;25;48;4;3;7
292;03.08.2016;2016;08;09;Keskiviikko;34;21;55;8;8;16
292;03.08.2016;2016;08;10;Keskiviikko;45;28;73;5;8;13
292;03.08.2016;2016;08;11;Keskiviikko;30;42;72;4;11;15
292;03.08.2016;2016;08;12;Keskiviikko;41;44;85;5;10;15
292;03.08.2016;2016;08;13;Keskiviikko;66;42;108;14;11;25
292;03.08.2016;2016;08;14;Keskiviikko;33;36;69;5;4;9
292;03.08.2016;2016;08;15;Keskiviikko;47;24;71;5;3;8
292;03.08.2016;2016;08;16;Keskiviikko;41;25;66;7;3;10
292;03.08.2016;2016;08;17;Keskiviikko;45;29;74;7;2;9
292;03.08.2016;2016;08;18;Keskiviikko;43;44;87;22;8;30
292;03.08.2016;2016;08;19;Keskiviikko;45;48;93;16;13;29
292;03.08.2016;2016;08;20;Keskiviikko;28;51;79;13;8;21
292;03.08.2016;2016;08;21;Keskiviikko;31;27;58;12;5;17
292;03.08.2016;2016;08;22;Keskiviikko;9;16;25;8;8;16
292;03.08.2016;2016;08;23;Keskiviikko;9;11;20;3;5;8
292;04.08.2016;2016;08;00;Torstai;4;6;10;4;7;11
292;04.08.2016;2016;08;01;Torstai;6;1;7;2;1;3
292;04.08.2016;2016;08;02;Torstai;1;4;5;0;0;0
292;04.08.2016;2016;08;03;Torstai;1;3;4;0;0;0
292;04.08.2016;2016;08;04;Torstai;0;0;0;1;0;1
292;04.08.2016;2016;08;05;Torstai;3;7;10;0;2;2
292;04.08.2016;2016;08;06;Torstai;22;15;37;4;2;6
292;04.08.2016;2016;08;07;Torstai;36;26;62;4;3;7
292;04.08.2016;2016;08;08;Torstai;26;21;47;6;3;9
292;04.08.2016;2016;08;09;Torstai;44;33;77;5;6;11
292;04.08.2016;2016;08;10;Torstai;49;31;80;9;7;16
292;04.08.2016;2016;08;11;Torstai;48;39;87;9;12;21
292;04.08.2016;2016;08;12;Torstai;42;64;106;16;11;27
292;04.08.2016;2016;08;13;Torstai;52;42;94;11;16;27
292;04.08.2016;2016;08;14;Torstai;85;66;151;12;13;25
292;04.08.2016;2016;08;15;Torstai;68;65;133;9;9;18
292;04.08.2016;2016;08;16;Torstai;80;62;142;13;11;24
292;04.08.2016;2016;08;17;Torstai;42;28;70;8;8;16
292;04.08.2016;2016;08;18;Torstai;59;36;95;8;4;12
292;04.08.2016;2016;08;19;Torstai;23;42;65;10;7;17
292;04.08.2016;2016;08;20;Torstai;22;34;56;1;9;10
292;04.08.2016;2016;08;21;Torstai;17;13;30;3;2;5
292;04.08.2016;2016;08;22;Torstai;7;6;13;0;0;0
292;04.08.2016;2016;08;23;Torstai;1;3;4;2;0;2
292;05.08.2016;2016;08;00;Perjantai;2;2;4;0;5;5
292;05.08.2016;2016;08;01;Perjantai;3;0;3;3;1;4
292;05.08.2016;2016;08;02;Perjantai;2;1;3;1;1;2
292;05.08.2016;2016;08;03;Perjantai;0;1;1;0;1;1
292;05.08.2016;2016;08;04;Perjantai;0;1;1;0;0;0
292;05.08.2016;2016;08;05;Perjantai;5;3;8;3;1;4
292;05.08.2016;2016;08;06;Perjantai;16;12;28;5;4;9
292;05.08.2016;2016;08;07;Perjantai;24;19;43;4;10;14
292;05.08.2016;2016;08;08;Perjantai;13;22;35;9;6;15
292;05.08.2016;2016;08;09;Perjantai;20;17;37;6;10;16
292;05.08.2016;2016;08;10;Perjantai;23;22;45;6;4;10
292;05.08.2016;2016;08;11;Perjantai;36;25;61;5;5;10
292;05.08.2016;2016;08;12;Perjantai;28;34;62;8;7;15
292;05.08.2016;2016;08;13;Perjantai;54;47;101;11;6;17
292;05.08.2016;2016;08;14;Perjantai;49;60;109;6;7;13
292;05.08.2016;2016;08;15;Perjantai;61;71;132;14;3;17
292;05.08.2016;2016;08;16;Perjantai;74;66;140;14;9;23
292;05.08.2016;2016;08;17;Perjantai;59;48;107;13;5;18
292;05.08.2016;2016;08;18;Perjantai;39;56;95;13;17;30
292;05.08.2016;2016;08;19;Perjantai;49;42;91;14;15;29
292;05.08.2016;2016;08;20;Perjantai;53;34;87;10;9;19
292;05.08.2016;2016;08;21;Perjantai;29;32;61;9;4;13
292;05.08.2016;2016;08;22;Perjantai;11;20;31;2;10;12
292;05.08.2016;2016;08;23;Perjantai;3;7;10;2;2;4
292;06.08.2016;2016;08;00;Lauantai;8;4;12;5;0;5
292;06.08.2016;2016;08;01;Lauantai;4;6;10;0;2;2
292;06.08.2016;2016;08;02;Lauantai;0;9;9;2;8;10
292;06.08.2016;2016;08;03;Lauantai;0;2;2;0;3;3
292;06.08.2016;2016;08;04;Lauantai;0;0;0;2;0;2
292;06.08.2016;2016;08;05;Lauantai;1;1;2;1;1;2
292;06.08.2016;2016;08;06;Lauantai;5;2;7;0;0;0
292;06.08.2016;2016;08;07;Lauantai;4;3;7;2;0;2
292;06.08.2016;2016;08;08;Lauantai;12;13;25;2;2;4
292;06.08.2016;2016;08;09;Lauantai;27;17;44;7;1;8
292;06.08.2016;2016;08;10;Lauantai;28;32;60;4;8;12
292;06.08.2016;2016;08;11;Lauantai;51;43;94;11;11;22
292;06.08.2016;2016;08;12;Lauantai;42;29;71;7;17;24
292;06.08.2016;2016;08;13;Lauantai;59;68;127;15;11;26
292;06.08.2016;2016;08;14;Lauantai;63;28;91;16;14;30
292;06.08.2016;2016;08;15;Lauantai;35;40;75;11;12;23
292;06.08.2016;2016;08;16;Lauantai;40;41;81;11;3;14
292;06.08.2016;2016;08;17;Lauantai;55;47;102;6;5;11
292;06.08.2016;2016;08;18;Lauantai;52;43;95;31;13;44
292;06.08.2016;2016;08;19;Lauantai;27;31;58;14;3;17
292;06.08.2016;2016;08;20;Lauantai;25;27;52;3;6;9
292;06.08.2016;2016;08;21;Lauantai;25;21;46;7;4;11
292;06.08.2016;2016;08;22;Lauantai;10;7;17;0;3;3
292;06.08.2016;2016;08;23;Lauantai;17;13;30;4;3;7
292;07.08.2016;2016;08;00;Sunnuntai;10;11;21;6;4;10
292;07.08.2016;2016;08;01;Sunnuntai;5;8;13;0;2;2
292;07.08.2016;2016;08;02;Sunnuntai;5;9;14;4;1;5
292;07.08.2016;2016;08;03;Sunnuntai;2;5;7;1;3;4
292;07.08.2016;2016;08;04;Sunnuntai;0;4;4;0;0;0
292;07.08.2016;2016;08;05;Sunnuntai;1;2;3;1;1;2
292;07.08.2016;2016;08;06;Sunnuntai;5;5;10;1;0;1
292;07.08.2016;2016;08;07;Sunnuntai;7;5;12;2;0;2
292;07.08.2016;2016;08;08;Sunnuntai;8;4;12;6;2;8
292;07.08.2016;2016;08;09;Sunnuntai;17;16;33;3;1;4
292;07.08.2016;2016;08;10;Sunnuntai;30;27;57;6;2;8
292;07.08.2016;2016;08;11;Sunnuntai;56;50;106;11;15;26
292;07.08.2016;2016;08;12;Sunnuntai;52;47;99;1;7;8
292;07.08.2016;2016;08;13;Sunnuntai;46;20;66;12;12;24
292;07.08.2016;2016;08;14;Sunnuntai;48;40;88;9;5;14
292;07.08.2016;2016;08;15;Sunnuntai;39;35;74;8;10;18
292;07.08.2016;2016;08;16;Sunnuntai;75;33;108;15;9;24
292;07.08.2016;2016;08;17;Sunnuntai;49;31;80;18;8;26
292;07.08.2016;2016;08;18;Sunnuntai;56;56;112;15;19;34
292;07.08.2016;2016;08;19;Sunnuntai;57;85;142;12;15;27
292;07.08.2016;2016;08;20;Sunnuntai;43;45;88;14;9;23
292;07.08.2016;2016;08;21;Sunnuntai;28;20;48;6;10;16
292;07.08.2016;2016;08;22;Sunnuntai;11;24;35;4;9;13
292;07.08.2016;2016;08;23;Sunnuntai;0;6;6;4;2;6
292;08.08.2016;2016;08;00;Maanantai;4;9;13;0;2;2
292;08.08.2016;2016;08;01;Maanantai;1;1;2;1;2;3
292;08.08.2016;2016;08;02;Maanantai;2;3;5;2;0;2
292;08.08.2016;2016;08;03;Maanantai;0;0;0;0;0;0
292;08.08.2016;2016;08;04;Maanantai;1;1;2;0;0;0
292;08.08.2016;2016;08;05;Maanantai;5;8;13;1;3;4
292;08.08.2016;2016;08;06;Maanantai;25;17;42;5;4;9
292;08.08.2016;2016;08;07;Maanantai;47;38;85;5;7;12
292;08.08.2016;2016;08;08;Maanantai;37;32;69;1;6;7
292;08.08.2016;2016;08;09;Maanantai;33;29;62;5;4;9
292;08.08.2016;2016;08;10;Maanantai;52;40;92;11;8;19
292;08.08.2016;2016;08;11;Maanantai;54;44;98;13;9;22
292;08.08.2016;2016;08;12;Maanantai;48;55;103;13;16;29
292;08.08.2016;2016;08;13;Maanantai;67;44;111;11;7;18
292;08.08.2016;2016;08;14;Maanantai;66;54;120;17;10;27
292;08.08.2016;2016;08;15;Maanantai;66;60;126;16;12;28
292;08.08.2016;2016;08;16;Maanantai;56;76;132;20;15;35
292;08.08.2016;2016;08;17;Maanantai;54;66;120;11;16;27
292;08.08.2016;2016;08;18;Maanantai;66;38;104;18;13;31
292;08.08.2016;2016;08;19;Maanantai;38;47;85;14;17;31
292;08.08.2016;2016;08;20;Maanantai;52;43;95;12;15;27
292;08.08.2016;2016;08;21;Maanantai;23;15;38;10;6;16
292;08.08.2016;2016;08;22;Maanantai;6;14;20;2;4;6
292;08.08.2016;2016;08;23;Maanantai;4;7;11;1;0;1
292;09.08.2016;2016;08;00;Tiistai;9;7;16;2;1;3
292;09.08.2016;2016;08;01;Tiistai;2;2;4;1;3;4
292;09.08.2016;2016;08;02;Tiistai;5;1;6;3;1;4
292;09.08.2016;2016;08;03;Tiistai;0;1;1;1;1;2
292;09.08.2016;2016;08;04;Tiistai;2;0;2;0;0;0
292;09.08.2016;2016;08;05;Tiistai;5;8;13;3;4;7
292;09.08.2016;2016;08;06;Tiistai;23;16;39;7;2;9
292;09.08.2016;2016;08;07;Tiistai;37;26;63;7;9;16
292;09.08.2016;2016;08;08;Tiistai;24;32;56;16;7;23
292;09.08.2016;2016;08;09;Tiistai;32;30;62;8;3;11
292;09.08.2016;2016;08;10;Tiistai;30;25;55;8;6;14
292;09.08.2016;2016;08;11;Tiistai;46;29;75;9;2;11
292;09.08.2016;2016;08;12;Tiistai;34;33;67;7;5;12
292;09.08.2016;2016;08;13;Tiistai;48;28;76;11;2;13
292;09.08.2016;2016;08;14;Tiistai;47;35;82;10;7;17
292;09.08.2016;2016;08;15;Tiistai;52;53;105;13;5;18
292;09.08.2016;2016;08;16;Tiistai;61;66;127;17;17;34
292;09.08.2016;2016;08;17;Tiistai;58;36;94;9;7;16
292;09.08.2016;2016;08;18;Tiistai;41;39;80;12;15;27
292;09.08.2016;2016;08;19;Tiistai;40;43;83;19;11;30
292;09.08.2016;2016;08;20;Tiistai;41;46;87;11;17;28
292;09.08.2016;2016;08;21;Tiistai;19;17;36;4;2;6
292;09.08.2016;2016;08;22;Tiistai;8;12;20;8;2;10
292;09.08.2016;2016;08;23;Tiistai;3;6;9;0;1;1
292;10.08.2016;2016;08;00;Keskiviikko;1;2;3;0;4;4
292;10.08.2016;2016;08;01;Keskiviikko;0;2;2;0;0;0
292;10.08.2016;2016;08;02;Keskiviikko;7;3;10;1;0;1
292;10.08.2016;2016;08;03;Keskiviikko;2;4;6;0;0;0
292;10.08.2016;2016;08;04;Keskiviikko;2;0;2;1;0;1
292;10.08.2016;2016;08;05;Keskiviikko;6;3;9;0;1;1
292;10.08.2016;2016;08;06;Keskiviikko;16;13;29;4;3;7
292;10.08.2016;2016;08;07;Keskiviikko;27;17;44;8;3;11
292;10.08.2016;2016;08;08;Keskiviikko;15;29;44;9;6;15
292;10.08.2016;2016;08;09;Keskiviikko;17;25;42;4;5;9
292;10.08.2016;2016;08;10;Keskiviikko;27;29;56;6;3;9
292;10.08.2016;2016;08;11;Keskiviikko;34;24;58;13;6;19
292;10.08.2016;2016;08;12;Keskiviikko;45;51;96;12;7;19
292;10.08.2016;2016;08;13;Keskiviikko;54;56;110;13;8;21
292;10.08.2016;2016;08;14;Keskiviikko;55;55;110;10;11;21
292;10.08.2016;2016;08;15;Keskiviikko;60;55;115;8;3;11
292;10.08.2016;2016;08;16;Keskiviikko;45;39;84;9;7;16
292;10.08.2016;2016;08;17;Keskiviikko;46;27;73;6;2;8
292;10.08.2016;2016;08;18;Keskiviikko;41;22;63;12;8;20
292;10.08.2016;2016;08;19;Keskiviikko;46;25;71;8;7;15
292;10.08.2016;2016;08;20;Keskiviikko;14;44;58;9;10;19
292;10.08.2016;2016;08;21;Keskiviikko;16;20;36;5;4;9
292;10.08.2016;2016;08;22;Keskiviikko;6;4;10;2;2;4
292;10.08.2016;2016;08;23;Keskiviikko;2;2;4;0;1;1
292;11.08.2016;2016;08;00;Torstai;2;1;3;0;0;0
292;11.08.2016;2016;08;01;Torstai;0;1;1;0;1;1
292;11.08.2016;2016;08;02;Torstai;1;2;3;0;0;0
292;11.08.2016;2016;08;03;Torstai;0;1;1;0;1;1
292;11.08.2016;2016;08;04;Torstai;0;1;1;0;0;0
292;11.08.2016;2016;08;05;Torstai;8;10;18;2;3;5
292;11.08.2016;2016;08;06;Torstai;25;13;38;3;4;7
292;11.08.2016;2016;08;07;Torstai;32;23;55;9;9;18
292;11.08.2016;2016;08;08;Torstai;148;38;186;21;6;27
292;11.08.2016;2016;08;09;Torstai;24;29;53;9;8;17
292;11.08.2016;2016;08;10;Torstai;37;24;61;15;8;23
292;11.08.2016;2016;08;11;Torstai;20;28;48;4;3;7
292;11.08.2016;2016;08;12;Torstai;32;71;103;8;5;13
292;11.08.2016;2016;08;13;Torstai;44;114;158;13;15;28
292;11.08.2016;2016;08;14;Torstai;56;57;113;11;10;21
292;11.08.2016;2016;08;15;Torstai;59;56;115;8;12;20
292;11.08.2016;2016;08;16;Torstai;71;60;131;11;17;28
292;11.08.2016;2016;08;17;Torstai;62;47;109;17;7;24
292;11.08.2016;2016;08;18;Torstai;54;46;100;13;11;24
292;11.08.2016;2016;08;19;Torstai;28;39;67;7;10;17
292;11.08.2016;2016;08;20;Torstai;20;21;41;4;6;10
292;11.08.2016;2016;08;21;Torstai;10;17;27;2;4;6
292;11.08.2016;2016;08;22;Torstai;7;1;8;4;0;4
292;11.08.2016;2016;08;23;Torstai;1;3;4;0;3;3
292;12.08.2016;2016;08;00;Perjantai;1;0;1;0;0;0
292;12.08.2016;2016;08;01;Perjantai;0;1;1;1;1;2
292;12.08.2016;2016;08;02;Perjantai;0;6;6;0;0;0
292;12.08.2016;2016;08;03;Perjantai;1;0;1;0;0;0
292;12.08.2016;2016;08;04;Perjantai;1;0;1;0;0;0
292;12.08.2016;2016;08;05;Perjantai;7;9;16;0;1;1
292;12.08.2016;2016;08;06;Perjantai;22;14;36;5;4;9
292;12.08.2016;2016;08;07;Perjantai;27;21;48;10;2;12
292;12.08.2016;2016;08;08;Perjantai;93;29;122;17;2;19
292;12.08.2016;2016;08;09;Perjantai;29;14;43;8;4;12
292;12.08.2016;2016;08;10;Perjantai;8;10;18;2;0;2
292;12.08.2016;2016;08;11;Perjantai;20;15;35;5;3;8
292;12.08.2016;2016;08;12;Perjantai;34;34;68;8;6;14
292;12.08.2016;2016;08;13;Perjantai;31;103;134;3;8;11
292;12.08.2016;2016;08;14;Perjantai;37;66;103;11;19;30
292;12.08.2016;2016;08;15;Perjantai;48;66;114;17;13;30
292;12.08.2016;2016;08;16;Perjantai;44;48;92;14;13;27
292;12.08.2016;2016;08;17;Perjantai;56;27;83;10;12;22
292;12.08.2016;2016;08;18;Perjantai;44;37;81;11;13;24
292;12.08.2016;2016;08;19;Perjantai;37;29;66;13;12;25
292;12.08.2016;2016;08;20;Perjantai;36;40;76;10;10;20
292;12.08.2016;2016;08;21;Perjantai;19;17;36;4;3;7
292;12.08.2016;2016;08;22;Perjantai;10;12;22;4;4;8
292;12.08.2016;2016;08;23;Perjantai;9;4;13;4;1;5
292;13.08.2016;2016;08;00;Lauantai;10;3;13;8;3;11
292;13.08.2016;2016;08;01;Lauantai;4;6;10;2;1;3
292;13.08.2016;2016;08;02;Lauantai;2;9;11;1;6;7
292;13.08.2016;2016;08;03;Lauantai;1;3;4;0;4;4
292;13.08.2016;2016;08;04;Lauantai;0;2;2;0;0;0
292;13.08.2016;2016;08;05;Lauantai;1;2;3;2;0;2
292;13.08.2016;2016;08;06;Lauantai;4;7;11;1;4;5
292;13.08.2016;2016;08;07;Lauantai;2;4;6;1;1;2
292;13.08.2016;2016;08;08;Lauantai;7;9;16;4;3;7
292;13.08.2016;2016;08;09;Lauantai;11;15;26;4;3;7
292;13.08.2016;2016;08;10;Lauantai;12;12;24;134;75;209
292;13.08.2016;2016;08;11;Lauantai;12;12;24;18;58;76
292;13.08.2016;2016;08;12;Lauantai;13;6;19;219;3;222
292;13.08.2016;2016;08;13;Lauantai;17;10;27;8;199;207
292;13.08.2016;2016;08;14;Lauantai;14;8;22;8;22;30
292;13.08.2016;2016;08;15;Lauantai;15;5;20;4;7;11
292;13.08.2016;2016;08;16;Lauantai;15;9;24;4;0;4
292;13.08.2016;2016;08;17;Lauantai;15;7;22;4;4;8
292;13.08.2016;2016;08;18;Lauantai;16;15;31;6;1;7
292;13.08.2016;2016;08;19;Lauantai;16;10;26;8;0;8
292;13.08.2016;2016;08;20;Lauantai;8;9;17;3;3;6
292;13.08.2016;2016;08;21;Lauantai;15;7;22;2;0;2
292;13.08.2016;2016;08;22;Lauantai;5;7;12;3;4;7
292;13.08.2016;2016;08;23;Lauantai;3;2;5;7;1;8
292;14.08.2016;2016;08;00;Sunnuntai;0;3;3;1;4;5
292;14.08.2016;2016;08;01;Sunnuntai;1;2;3;2;2;4
292;14.08.2016;2016;08;02;Sunnuntai;1;4;5;2;4;6
292;14.08.2016;2016;08;03;Sunnuntai;0;1;1;0;1;1
292;14.08.2016;2016;08;04;Sunnuntai;3;1;4;1;0;1
292;14.08.2016;2016;08;05;Sunnuntai;4;2;6;3;0;3
292;14.08.2016;2016;08;06;Sunnuntai;5;3;8;1;2;3
292;14.08.2016;2016;08;07;Sunnuntai;3;3;6;1;0;1
292;14.08.2016;2016;08;08;Sunnuntai;1;2;3;2;0;2
292;14.08.2016;2016;08;09;Sunnuntai;16;10;26;4;3;7
292;14.08.2016;2016;08;10;Sunnuntai;25;19;44;7;7;14
292;14.08.2016;2016;08;11;Sunnuntai;35;38;73;17;17;34
292;14.08.2016;2016;08;12;Sunnuntai;46;51;97;12;8;20
292;14.08.2016;2016;08;13;Sunnuntai;53;33;86;15;8;23
292;14.08.2016;2016;08;14;Sunnuntai;60;45;105;5;13;18
292;14.08.2016;2016;08;15;Sunnuntai;54;43;97;6;12;18
292;14.08.2016;2016;08;16;Sunnuntai;63;46;109;23;11;34
292;14.08.2016;2016;08;17;Sunnuntai;55;62;117;10;21;31
292;14.08.2016;2016;08;18;Sunnuntai;63;77;140;22;16;38
292;14.08.2016;2016;08;19;Sunnuntai;54;58;112;21;19;40
292;14.08.2016;2016;08;20;Sunnuntai;32;36;68;19;20;39
292;14.08.2016;2016;08;21;Sunnuntai;15;19;34;5;0;5
292;14.08.2016;2016;08;22;Sunnuntai;3;8;11;2;1;3
292;14.08.2016;2016;08;23;Sunnuntai;1;1;2;0;1;1
292;15.08.2016;2016;08;00;Maanantai;0;0;0;1;1;2
292;15.08.2016;2016;08;01;Maanantai;0;0;0;1;1;2
292;15.08.2016;2016;08;02;Maanantai;0;0;0;0;0;0
292;15.08.2016;2016;08;03;Maanantai;0;0;0;0;0;0
292;15.08.2016;2016;08;04;Maanantai;1;1;2;0;0;0
292;15.08.2016;2016;08;05;Maanantai;4;7;11;0;1;1
292;15.08.2016;2016;08;06;Maanantai;26;11;37;3;3;6
292;15.08.2016;2016;08;07;Maanantai;83;43;126;14;7;21
292;15.08.2016;2016;08;08;Maanantai;52;34;86;13;12;25
292;15.08.2016;2016;08;09;Maanantai;77;23;100;9;5;14
292;15.08.2016;2016;08;10;Maanantai;33;35;68;12;3;15
292;15.08.2016;2016;08;11;Maanantai;31;26;57;9;5;14
292;15.08.2016;2016;08;12;Maanantai;28;38;66;4;8;12
292;15.08.2016;2016;08;13;Maanantai;38;53;91;14;18;32
292;15.08.2016;2016;08;14;Maanantai;60;87;147;9;11;20
292;15.08.2016;2016;08;15;Maanantai;60;126;186;7;15;22
292;15.08.2016;2016;08;16;Maanantai;53;69;122;9;18;27
292;15.08.2016;2016;08;17;Maanantai;56;48;104;23;7;30
292;15.08.2016;2016;08;18;Maanantai;62;45;107;17;18;35
292;15.08.2016;2016;08;19;Maanantai;54;52;106;13;17;30
292;15.08.2016;2016;08;20;Maanantai;38;26;64;4;15;19
292;15.08.2016;2016;08;21;Maanantai;18;19;37;8;8;16
292;15.08.2016;2016;08;22;Maanantai;2;10;12;1;4;5
292;15.08.2016;2016;08;23;Maanantai;0;1;1;0;0;0
292;16.08.2016;2016;08;00;Tiistai;1;1;2;0;0;0
292;16.08.2016;2016;08;01;Tiistai;0;1;1;0;1;1
292;16.08.2016;2016;08;02;Tiistai;0;0;0;0;0;0
292;16.08.2016;2016;08;03;Tiistai;0;0;0;0;0;0
292;16.08.2016;2016;08;04;Tiistai;1;3;4;0;0;0
292;16.08.2016;2016;08;05;Tiistai;7;6;13;2;0;2
292;16.08.2016;2016;08;06;Tiistai;32;21;53;2;4;6
292;16.08.2016;2016;08;07;Tiistai;95;30;125;9;8;17
292;16.08.2016;2016;08;08;Tiistai;74;31;105;11;9;20
292;16.08.2016;2016;08;09;Tiistai;17;22;39;8;7;15
292;16.08.2016;2016;08;10;Tiistai;30;20;50;5;11;16
292;16.08.2016;2016;08;11;Tiistai;29;24;53;8;6;14
292;16.08.2016;2016;08;12;Tiistai;27;21;48;8;10;18
292;16.08.2016;2016;08;13;Tiistai;18;45;63;6;4;10
292;16.08.2016;2016;08;14;Tiistai;24;86;110;8;10;18
292;16.08.2016;2016;08;15;Tiistai;34;53;87;9;10;19
292;16.08.2016;2016;08;16;Tiistai;52;52;104;5;13;18
292;16.08.2016;2016;08;17;Tiistai;36;33;69;9;9;18
292;16.08.2016;2016;08;18;Tiistai;31;32;63;19;14;33
292;16.08.2016;2016;08;19;Tiistai;28;35;63;16;16;32
292;16.08.2016;2016;08;20;Tiistai;25;21;46;9;10;19
292;16.08.2016;2016;08;21;Tiistai;10;7;17;1;2;3
292;16.08.2016;2016;08;22;Tiistai;2;3;5;1;2;3
292;16.08.2016;2016;08;23;Tiistai;1;1;2;0;1;1
292;17.08.2016;2016;08;00;Keskiviikko;1;1;2;0;1;1
292;17.08.2016;2016;08;01;Keskiviikko;0;1;1;0;0;0
292;17.08.2016;2016;08;02;Keskiviikko;0;1;1;0;0;0
292;17.08.2016;2016;08;03;Keskiviikko;0;0;0;1;0;1
292;17.08.2016;2016;08;04;Keskiviikko;0;0;0;1;0;1
292;17.08.2016;2016;08;05;Keskiviikko;8;5;13;1;2;3
292;17.08.2016;2016;08;06;Keskiviikko;28;15;43;0;3;3
292;17.08.2016;2016;08;07;Keskiviikko;97;35;132;14;10;24
292;17.08.2016;2016;08;08;Keskiviikko;48;25;73;19;8;27
292;17.08.2016;2016;08;09;Keskiviikko;39;24;63;6;4;10
292;17.08.2016;2016;08;10;Keskiviikko;9;18;27;3;4;7
292;17.08.2016;2016;08;11;Keskiviikko;23;22;45;5;7;12
292;17.08.2016;2016;08;12;Keskiviikko;28;41;69;11;8;19
292;17.08.2016;2016;08;13;Keskiviikko;41;110;151;14;21;35
292;17.08.2016;2016;08;14;Keskiviikko;55;65;120;12;15;27
292;17.08.2016;2016;08;15;Keskiviikko;65;66;131;14;15;29
292;17.08.2016;2016;08;16;Keskiviikko;80;64;144;12;17;29
292;17.08.2016;2016;08;17;Keskiviikko;74;43;117;14;16;30
292;17.08.2016;2016;08;18;Keskiviikko;71;64;135;22;25;47
292;17.08.2016;2016;08;19;Keskiviikko;47;58;105;16;25;41
292;17.08.2016;2016;08;20;Keskiviikko;38;51;89;13;14;27
292;17.08.2016;2016;08;21;Keskiviikko;11;21;32;3;10;13
292;17.08.2016;2016;08;22;Keskiviikko;2;9;11;1;3;4
292;17.08.2016;2016;08;23;Keskiviikko;1;2;3;2;0;2
292;18.08.2016;2016;08;00;Torstai;0;1;1;0;1;1
292;18.08.2016;2016;08;01;Torstai;0;0;0;0;0;0
292;18.08.2016;2016;08;02;Torstai;1;3;4;0;0;0
292;18.08.2016;2016;08;03;Torstai;0;1;1;1;0;1
292;18.08.2016;2016;08;04;Torstai;0;1;1;0;0;0
292;18.08.2016;2016;08;05;Torstai;6;5;11;2;3;5
292;18.08.2016;2016;08;06;Torstai;29;18;47;2;4;6
292;18.08.2016;2016;08;07;Torstai;79;39;118;14;7;21
292;18.08.2016;2016;08;08;Torstai;52;33;85;8;10;18
292;18.08.2016;2016;08;09;Torstai;77;23;100;15;11;26
292;18.08.2016;2016;08;10;Torstai;37;32;69;3;7;10
292;18.08.2016;2016;08;11;Torstai;43;31;74;10;1;11
292;18.08.2016;2016;08;12;Torstai;33;38;71;9;5;14
292;18.08.2016;2016;08;13;Torstai;34;44;78;11;8;19
292;18.08.2016;2016;08;14;Torstai;40;70;110;9;16;25
292;18.08.2016;2016;08;15;Torstai;65;85;150;14;12;26
292;18.08.2016;2016;08;16;Torstai;56;85;141;12;26;38
292;18.08.2016;2016;08;17;Torstai;56;62;118;27;20;47
292;18.08.2016;2016;08;18;Torstai;50;69;119;8;17;25
292;18.08.2016;2016;08;19;Torstai;64;42;106;17;24;41
292;18.08.2016;2016;08;20;Torstai;40;33;73;15;11;26
292;18.08.2016;2016;08;21;Torstai;8;25;33;2;4;6
292;18.08.2016;2016;08;22;Torstai;8;6;14;1;0;1
292;18.08.2016;2016;08;23;Torstai;0;3;3;0;2;2
292;19.08.2016;2016;08;00;Perjantai;0;1;1;0;0;0
292;19.08.2016;2016;08;01;Perjantai;2;0;2;0;0;0
292;19.08.2016;2016;08;02;Perjantai;0;3;3;0;0;0
292;19.08.2016;2016;08;03;Perjantai;0;1;1;0;0;0
292;19.08.2016;2016;08;04;Perjantai;0;0;0;0;0;0
292;19.08.2016;2016;08;05;Perjantai;6;3;9;0;0;0
292;19.08.2016;2016;08;06;Perjantai;12;7;19;4;5;9
292;19.08.2016;2016;08;07;Perjantai;49;20;69;9;1;10
292;19.08.2016;2016;08;08;Perjantai;35;19;54;4;4;8
292;19.08.2016;2016;08;09;Perjantai;30;15;45;6;4;10
292;19.08.2016;2016;08;10;Perjantai;16;16;32;6;3;9
292;19.08.2016;2016;08;11;Perjantai;24;26;50;3;5;8
292;19.08.2016;2016;08;12;Perjantai;31;29;60;11;4;15
292;19.08.2016;2016;08;13;Perjantai;36;69;105;6;15;21
292;19.08.2016;2016;08;14;Perjantai;38;65;103;6;8;14
292;19.08.2016;2016;08;15;Perjantai;30;30;60;8;4;12
292;19.08.2016;2016;08;16;Perjantai;44;43;87;5;6;11
292;19.08.2016;2016;08;17;Perjantai;34;33;67;2;10;12
292;19.08.2016;2016;08;18;Perjantai;50;32;82;14;14;28
292;19.08.2016;2016;08;19;Perjantai;44;33;77;20;14;34
292;19.08.2016;2016;08;20;Perjantai;38;44;82;14;16;30
292;19.08.2016;2016;08;21;Perjantai;15;28;43;7;10;17
292;19.08.2016;2016;08;22;Perjantai;7;6;13;5;2;7
292;19.08.2016;2016;08;23;Perjantai;8;8;16;5;7;12
292;20.08.2016;2016;08;00;Lauantai;3;3;6;8;4;12
292;20.08.2016;2016;08;01;Lauantai;4;3;7;1;4;5
292;20.08.2016;2016;08;02;Lauantai;1;5;6;1;3;4
292;20.08.2016;2016;08;03;Lauantai;1;1;2;2;1;3
292;20.08.2016;2016;08;04;Lauantai;0;3;3;0;2;2
292;20.08.2016;2016;08;05;Lauantai;0;0;0;2;1;3
292;20.08.2016;2016;08;06;Lauantai;4;3;7;3;3;6
292;20.08.2016;2016;08;07;Lauantai;4;8;12;1;1;2
292;20.08.2016;2016;08;08;Lauantai;9;11;20;3;3;6
292;20.08.2016;2016;08;09;Lauantai;9;23;32;5;8;13
292;20.08.2016;2016;08;10;Lauantai;33;30;63;5;4;9
292;20.08.2016;2016;08;11;Lauantai;43;39;82;5;7;12
292;20.08.2016;2016;08;12;Lauantai;47;28;75;9;4;13
292;20.08.2016;2016;08;13;Lauantai;52;26;78;12;9;21
292;20.08.2016;2016;08;14;Lauantai;54;40;94;8;10;18
292;20.08.2016;2016;08;15;Lauantai;41;46;87;8;15;23
292;20.08.2016;2016;08;16;Lauantai;34;50;84;10;12;22
292;20.08.2016;2016;08;17;Lauantai;56;44;100;10;6;16
292;20.08.2016;2016;08;18;Lauantai;19;12;31;3;2;5
292;20.08.2016;2016;08;19;Lauantai;14;24;38;4;6;10
292;20.08.2016;2016;08;20;Lauantai;6;9;15;0;3;3
292;20.08.2016;2016;08;21;Lauantai;14;8;22;1;5;6
292;20.08.2016;2016;08;22;Lauantai;7;12;19;4;0;4
292;20.08.2016;2016;08;23;Lauantai;1;0;1;2;0;2
292;21.08.2016;2016;08;00;Sunnuntai;2;1;3;2;2;4
292;21.08.2016;2016;08;01;Sunnuntai;1;5;6;0;0;0
292;21.08.2016;2016;08;02;Sunnuntai;0;4;4;1;1;2
292;21.08.2016;2016;08;03;Sunnuntai;0;1;1;7;7;14
292;21.08.2016;2016;08;04;Sunnuntai;0;0;0;2;0;2
292;21.08.2016;2016;08;05;Sunnuntai;1;2;3;0;0;0
292;21.08.2016;2016;08;06;Sunnuntai;5;2;7;2;0;2
292;21.08.2016;2016;08;07;Sunnuntai;3;3;6;1;0;1
292;21.08.2016;2016;08;08;Sunnuntai;5;4;9;2;2;4
292;21.08.2016;2016;08;09;Sunnuntai;14;9;23;3;5;8
292;21.08.2016;2016;08;10;Sunnuntai;18;17;35;3;7;10
292;21.08.2016;2016;08;11;Sunnuntai;31;31;62;11;10;21
292;21.08.2016;2016;08;12;Sunnuntai;42;36;78;8;14;22
292;21.08.2016;2016;08;13;Sunnuntai;43;35;78;9;10;19
292;21.08.2016;2016;08;14;Sunnuntai;42;39;81;11;5;16
292;21.08.2016;2016;08;15;Sunnuntai;46;29;75;12;14;26
292;21.08.2016;2016;08;16;Sunnuntai;43;35;78;5;4;9
292;21.08.2016;2016;08;17;Sunnuntai;46;36;82;9;7;16
292;21.08.2016;2016;08;18;Sunnuntai;64;59;123;14;20;34
292;21.08.2016;2016;08;19;Sunnuntai;41;44;85;14;7;21
292;21.08.2016;2016;08;20;Sunnuntai;25;24;49;6;14;20
292;21.08.2016;2016;08;21;Sunnuntai;10;17;27;7;1;8
292;21.08.2016;2016;08;22;Sunnuntai;5;4;9;2;2;4
292;21.08.2016;2016;08;23;Sunnuntai;3;1;4;0;0;0
292;22.08.2016;2016;08;00;Maanantai;2;0;2;0;1;1
292;22.08.2016;2016;08;01;Maanantai;0;1;1;0;1;1
292;22.08.2016;2016;08;02;Maanantai;1;1;2;0;0;0
292;22.08.2016;2016;08;03;Maanantai;1;0;1;0;0;0
292;22.08.2016;2016;08;04;Maanantai;1;1;2;0;0;0
292;22.08.2016;2016;08;05;Maanantai;4;4;8;1;2;3
292;22.08.2016;2016;08;06;Maanantai;11;7;18;4;0;4
292;22.08.2016;2016;08;07;Maanantai;44;24;68;5;3;8
292;22.08.2016;2016;08;08;Maanantai;30;18;48;6;3;9
292;22.08.2016;2016;08;09;Maanantai;28;14;42;4;2;6
292;22.08.2016;2016;08;10;Maanantai;19;13;32;3;2;5
292;22.08.2016;2016;08;11;Maanantai;34;15;49;1;3;4
292;22.08.2016;2016;08;12;Maanantai;27;23;50;11;4;15
292;22.08.2016;2016;08;13;Maanantai;33;34;67;6;2;8
292;22.08.2016;2016;08;14;Maanantai;45;35;80;5;3;8
292;22.08.2016;2016;08;15;Maanantai;28;43;71;6;7;13
292;22.08.2016;2016;08;16;Maanantai;39;44;83;7;6;13
292;22.08.2016;2016;08;17;Maanantai;23;18;41;10;8;18
292;22.08.2016;2016;08;18;Maanantai;24;23;47;14;9;23
292;22.08.2016;2016;08;19;Maanantai;34;25;59;10;14;24
292;22.08.2016;2016;08;20;Maanantai;20;13;33;5;7;12
292;22.08.2016;2016;08;21;Maanantai;7;11;18;2;2;4
292;22.08.2016;2016;08;22;Maanantai;4;4;8;1;0;1
292;22.08.2016;2016;08;23;Maanantai;0;0;0;1;0;1
292;23.08.2016;2016;08;00;Tiistai;0;0;0;0;0;0
292;23.08.2016;2016;08;01;Tiistai;0;1;1;0;0;0
292;23.08.2016;2016;08;02;Tiistai;0;0;0;0;0;0
292;23.08.2016;2016;08;03;Tiistai;1;0;1;1;0;1
292;23.08.2016;2016;08;04;Tiistai;3;0;3;0;0;0
292;23.08.2016;2016;08;05;Tiistai;10;6;16;1;2;3
292;23.08.2016;2016;08;06;Tiistai;19;21;40;2;4;6
292;23.08.2016;2016;08;07;Tiistai;83;34;117;16;5;21
292;23.08.2016;2016;08;08;Tiistai;84;37;121;15;3;18
292;23.08.2016;2016;08;09;Tiistai;36;23;59;12;6;18
292;23.08.2016;2016;08;10;Tiistai;33;30;63;12;9;21
292;23.08.2016;2016;08;11;Tiistai;38;39;77;10;8;18
292;23.08.2016;2016;08;12;Tiistai;32;32;64;11;1;12
292;23.08.2016;2016;08;13;Tiistai;30;56;86;14;9;23
292;23.08.2016;2016;08;14;Tiistai;57;99;156;13;17;30
292;23.08.2016;2016;08;15;Tiistai;60;111;171;11;27;38
292;23.08.2016;2016;08;16;Tiistai;68;69;137;16;12;28
292;23.08.2016;2016;08;17;Tiistai;81;60;141;13;11;24
292;23.08.2016;2016;08;18;Tiistai;55;76;131;22;27;49
292;23.08.2016;2016;08;19;Tiistai;63;63;126;16;15;31
292;23.08.2016;2016;08;20;Tiistai;39;58;97;13;7;20
292;23.08.2016;2016;08;21;Tiistai;20;16;36;3;1;4
292;23.08.2016;2016;08;22;Tiistai;6;6;12;2;1;3
292;23.08.2016;2016;08;23;Tiistai;2;4;6;0;0;0
292;24.08.2016;2016;08;00;Keskiviikko;3;0;3;0;0;0
292;24.08.2016;2016;08;01;Keskiviikko;0;2;2;1;0;1
292;24.08.2016;2016;08;02;Keskiviikko;0;1;1;0;2;2
292;24.08.2016;2016;08;03;Keskiviikko;0;1;1;1;0;1
292;24.08.2016;2016;08;04;Keskiviikko;2;1;3;1;0;1
292;24.08.2016;2016;08;05;Keskiviikko;7;5;12;0;2;2
292;24.08.2016;2016;08;06;Keskiviikko;21;13;34;7;6;13
292;24.08.2016;2016;08;07;Keskiviikko;89;41;130;14;11;25
292;24.08.2016;2016;08;08;Keskiviikko;81;32;113;11;6;17
292;24.08.2016;2016;08;09;Keskiviikko;34;21;55;11;13;24
292;24.08.2016;2016;08;10;Keskiviikko;31;29;60;9;8;17
292;24.08.2016;2016;08;11;Keskiviikko;33;29;62;9;7;16
292;24.08.2016;2016;08;12;Keskiviikko;25;55;80;14;15;29
292;24.08.2016;2016;08;13;Keskiviikko;44;90;134;13;20;33
292;24.08.2016;2016;08;14;Keskiviikko;66;103;169;17;23;40
292;24.08.2016;2016;08;15;Keskiviikko;69;72;141;12;11;23
292;24.08.2016;2016;08;16;Keskiviikko;79;87;166;18;24;42
292;24.08.2016;2016;08;17;Keskiviikko;53;48;101;13;14;27
292;24.08.2016;2016;08;18;Keskiviikko;60;50;110;23;21;44
292;24.08.2016;2016;08;19;Keskiviikko;47;48;95;29;24;53
292;24.08.2016;2016;08;20;Keskiviikko;39;40;79;8;11;19
292;24.08.2016;2016;08;21;Keskiviikko;10;14;24;3;10;13
292;24.08.2016;2016;08;22;Keskiviikko;3;5;8;2;4;6
292;24.08.2016;2016;08;23;Keskiviikko;0;1;1;0;1;1
292;25.08.2016;2016;08;00;Torstai;2;0;2;0;0;0
292;25.08.2016;2016;08;01;Torstai;0;1;1;0;0;0
292;25.08.2016;2016;08;02;Torstai;0;1;1;0;0;0
292;25.08.2016;2016;08;03;Torstai;0;0;0;1;0;1
292;25.08.2016;2016;08;04;Torstai;1;0;1;0;0;0
292;25.08.2016;2016;08;05;Torstai;6;8;14;0;0;0
292;25.08.2016;2016;08;06;Torstai;18;17;35;2;3;5
292;25.08.2016;2016;08;07;Torstai;84;24;108;9;5;14
292;25.08.2016;2016;08;08;Torstai;46;28;74;14;5;19
292;25.08.2016;2016;08;09;Torstai;43;19;62;9;5;14
292;25.08.2016;2016;08;10;Torstai;16;8;24;1;1;2
292;25.08.2016;2016;08;11;Torstai;21;16;37;5;4;9
292;25.08.2016;2016;08;12;Torstai;21;13;34;12;7;19
292;25.08.2016;2016;08;13;Torstai;28;39;67;9;9;18
292;25.08.2016;2016;08;14;Torstai;39;52;91;14;16;30
292;25.08.2016;2016;08;15;Torstai;35;90;125;7;21;28
292;25.08.2016;2016;08;16;Torstai;50;61;111;12;10;22
292;25.08.2016;2016;08;17;Torstai;55;35;90;8;6;14
292;25.08.2016;2016;08;18;Torstai;34;35;69;10;10;20
292;25.08.2016;2016;08;19;Torstai;41;34;75;30;32;62
292;25.08.2016;2016;08;20;Torstai;31;28;59;10;10;20
292;25.08.2016;2016;08;21;Torstai;10;14;24;3;5;8
292;25.08.2016;2016;08;22;Torstai;4;4;8;4;4;8
292;25.08.2016;2016;08;23;Torstai;0;1;1;0;1;1
292;26.08.2016;2016;08;00;Perjantai;0;1;1;0;0;0
292;26.08.2016;2016;08;01;Perjantai;2;0;2;0;0;0
292;26.08.2016;2016;08;02;Perjantai;0;3;3;0;0;0
292;26.08.2016;2016;08;03;Perjantai;0;1;1;0;0;0
292;26.08.2016;2016;08;04;Perjantai;0;0;0;0;0;0
292;26.08.2016;2016;08;05;Perjantai;6;3;9;0;0;0
292;26.08.2016;2016;08;06;Perjantai;12;7;19;4;5;9
292;26.08.2016;2016;08;07;Perjantai;49;20;69;9;1;10
292;26.08.2016;2016;08;08;Perjantai;35;19;54;4;4;8
292;26.08.2016;2016;08;09;Perjantai;30;15;45;6;4;10
292;26.08.2016;2016;08;10;Perjantai;16;16;32;6;3;9
292;26.08.2016;2016;08;11;Perjantai;24;26;50;3;5;8
292;26.08.2016;2016;08;12;Perjantai;31;29;60;11;4;15
292;26.08.2016;2016;08;13;Perjantai;36;69;105;6;15;21
292;26.08.2016;2016;08;14;Perjantai;38;65;103;6;8;14
292;26.08.2016;2016;08;15;Perjantai;30;30;60;8;4;12
292;26.08.2016;2016;08;16;Perjantai;44;43;87;5;6;11
292;26.08.2016;2016;08;17;Perjantai;34;33;67;2;10;12
292;26.08.2016;2016;08;18;Perjantai;50;32;82;14;14;28
292;26.08.2016;2016;08;19;Perjantai;44;33;77;20;14;34
292;26.08.2016;2016;08;20;Perjantai;38;44;82;14;16;30
292;26.08.2016;2016;08;21;Perjantai;15;28;43;7;10;17
292;26.08.2016;2016;08;22;Perjantai;7;6;13;5;2;7
292;26.08.2016;2016;08;23;Perjantai;8;8;16;5;7;12
292;27.08.2016;2016;08;00;Lauantai;1;1;2;2;1;3
292;27.08.2016;2016;08;01;Lauantai;1;1;2;0;1;1
292;27.08.2016;2016;08;02;Lauantai;0;2;2;0;1;1
292;27.08.2016;2016;08;03;Lauantai;0;0;0;1;0;1
292;27.08.2016;2016;08;04;Lauantai;0;1;1;0;1;1
292;27.08.2016;2016;08;05;Lauantai;0;0;0;1;0;1
292;27.08.2016;2016;08;06;Lauantai;1;1;2;1;1;2
292;27.08.2016;2016;08;07;Lauantai;1;2;3;0;0;0
292;27.08.2016;2016;08;08;Lauantai;3;3;6;1;1;2
292;27.08.2016;2016;08;09;Lauantai;3;7;10;2;2;4
292;27.08.2016;2016;08;10;Lauantai;10;9;19;2;1;3
292;27.08.2016;2016;08;11;Lauantai;13;12;25;2;2;4
292;27.08.2016;2016;08;12;Lauantai;14;8;22;3;1;4
292;27.08.2016;2016;08;13;Lauantai;16;8;24;4;3;7
292;27.08.2016;2016;08;14;Lauantai;16;12;28;2;3;5
292;27.08.2016;2016;08;15;Lauantai;12;14;26;2;5;7
292;27.08.2016;2016;08;16;Lauantai;10;15;25;3;4;7
292;27.08.2016;2016;08;17;Lauantai;17;13;30;3;2;5
292;27.08.2016;2016;08;18;Lauantai;6;4;10;1;1;2
292;27.08.2016;2016;08;19;Lauantai;4;7;11;1;2;3
292;27.08.2016;2016;08;20;Lauantai;2;3;5;0;1;1
292;27.08.2016;2016;08;21;Lauantai;4;2;6;0;2;2
292;27.08.2016;2016;08;22;Lauantai;2;4;6;1;0;1
292;27.08.2016;2016;08;23;Lauantai;0;0;0;1;0;1
292;28.08.2016;2016;08;00;Sunnuntai;2;1;3;2;2;4
292;28.08.2016;2016;08;01;Sunnuntai;1;5;6;0;0;0
292;28.08.2016;2016;08;02;Sunnuntai;0;4;4;1;1;2
292;28.08.2016;2016;08;03;Sunnuntai;0;1;1;7;7;14
292;28.08.2016;2016;08;04;Sunnuntai;0;0;0;2;0;2
292;28.08.2016;2016;08;05;Sunnuntai;1;2;3;0;0;0
292;28.08.2016;2016;08;06;Sunnuntai;5;2;7;2;0;2
292;28.08.2016;2016;08;07;Sunnuntai;3;3;6;1;0;1
292;28.08.2016;2016;08;08;Sunnuntai;5;4;9;2;2;4
292;28.08.2016;2016;08;09;Sunnuntai;14;9;23;3;5;8
292;28.08.2016;2016;08;10;Sunnuntai;18;17;35;3;7;10
292;28.08.2016;2016;08;11;Sunnuntai;31;31;62;11;10;21
292;28.08.2016;2016;08;12;Sunnuntai;42;36;78;8;14;22
292;28.08.2016;2016;08;13;Sunnuntai;43;35;78;9;10;19
292;28.08.2016;2016;08;14;Sunnuntai;42;39;81;11;5;16
292;28.08.2016;2016;08;15;Sunnuntai;46;29;75;12;14;26
292;28.08.2016;2016;08;16;Sunnuntai;43;35;78;5;4;9
292;28.08.2016;2016;08;17;Sunnuntai;46;36;82;9;7;16
292;28.08.2016;2016;08;18;Sunnuntai;64;59;123;14;20;34
292;28.08.2016;2016;08;19;Sunnuntai;41;44;85;14;7;21
292;28.08.2016;2016;08;20;Sunnuntai;25;24;49;6;14;20
292;28.08.2016;2016;08;21;Sunnuntai;10;17;27;7;1;8
292;28.08.2016;2016;08;22;Sunnuntai;5;4;9;2;2;4
292;28.08.2016;2016;08;23;Sunnuntai;3;1;4;0;0;0
292;31.10.2016;2016;10;00;Maanantai;0;0;0;0;0;0
292;31.10.2016;2016;10;01;Maanantai;0;1;1;0;0;0
292;31.10.2016;2016;10;02;Maanantai;0;0;0;0;0;0
292;31.10.2016;2016;10;03;Maanantai;1;0;1;0;0;0
292;31.10.2016;2016;10;04;Maanantai;2;0;2;0;2;2
292;31.10.2016;2016;10;05;Maanantai;6;2;8;1;2;3
292;31.10.2016;2016;10;06;Maanantai;12;3;15;2;9;11
292;31.10.2016;2016;10;07;Maanantai;49;15;64;17;23;40
292;31.10.2016;2016;10;08;Maanantai;36;10;46;12;20;32
292;31.10.2016;2016;10;09;Maanantai;45;10;55;9;13;22
292;31.10.2016;2016;10;10;Maanantai;16;7;23;8;12;20
292;31.10.2016;2016;10;11;Maanantai;19;7;26;11;14;25
292;31.10.2016;2016;10;12;Maanantai;17;14;31;10;24;34
292;31.10.2016;2016;10;13;Maanantai;12;17;29;19;34;53
292;31.10.2016;2016;10;14;Maanantai;22;24;46;18;29;47
292;31.10.2016;2016;10;15;Maanantai;19;33;52;16;40;56
292;31.10.2016;2016;10;16;Maanantai;24;37;61;27;41;68
292;31.10.2016;2016;10;17;Maanantai;19;10;29;16;14;30
292;31.10.2016;2016;10;18;Maanantai;16;3;19;15;25;40
292;31.10.2016;2016;10;19;Maanantai;10;7;17;11;11;22
292;31.10.2016;2016;10;20;Maanantai;6;4;10;7;10;17
292;31.10.2016;2016;10;21;Maanantai;4;9;13;4;5;9
292;31.10.2016;2016;10;22;Maanantai;3;1;4;1;1;2
292;31.10.2016;2016;10;23;Maanantai;0;2;2;0;1;1
292;01.11.2016;2016;11;00;Tiistai;0;0;0;0;0;0
292;01.11.2016;2016;11;01;Tiistai;0;0;0;0;0;0
292;01.11.2016;2016;11;02;Tiistai;0;2;2;0;0;0
292;01.11.2016;2016;11;03;Tiistai;1;0;1;0;0;0
292;01.11.2016;2016;11;04;Tiistai;2;1;3;1;0;1
292;01.11.2016;2016;11;05;Tiistai;9;4;13;1;0;1
292;01.11.2016;2016;11;06;Tiistai;13;9;22;2;2;4
292;01.11.2016;2016;11;07;Tiistai;69;26;95;22;10;32
292;01.11.2016;2016;11;08;Tiistai;42;21;63;12;18;30
292;01.11.2016;2016;11;09;Tiistai;22;16;38;15;16;31
292;01.11.2016;2016;11;10;Tiistai;24;23;47;12;20;32
292;01.11.2016;2016;11;11;Tiistai;23;18;41;9;13;22
292;01.11.2016;2016;11;12;Tiistai;27;17;44;4;4;8
292;01.11.2016;2016;11;13;Tiistai;19;21;40;11;14;25
292;01.11.2016;2016;11;14;Tiistai;15;63;78;19;26;45
292;01.11.2016;2016;11;15;Tiistai;30;43;73;13;28;41
292;01.11.2016;2016;11;16;Tiistai;33;35;68;13;24;37
292;01.11.2016;2016;11;17;Tiistai;14;21;35;14;13;27
292;01.11.2016;2016;11;18;Tiistai;29;12;41;17;15;32
292;01.11.2016;2016;11;19;Tiistai;11;23;34;12;14;26
292;01.11.2016;2016;11;20;Tiistai;15;7;22;3;9;12
292;01.11.2016;2016;11;21;Tiistai;7;2;9;2;4;6
292;01.11.2016;2016;11;22;Tiistai;2;2;4;1;1;2
292;01.11.2016;2016;11;23;Tiistai;3;2;5;0;0;0
292;02.11.2016;2016;11;00;Keskiviikko;0;0;0;0;0;0
292;02.11.2016;2016;11;01;Keskiviikko;0;0;0;0;1;1
292;02.11.2016;2016;11;02;Keskiviikko;0;2;2;0;0;0
292;02.11.2016;2016;11;03;Keskiviikko;1;0;1;0;0;0
292;02.11.2016;2016;11;04;Keskiviikko;2;1;3;1;0;1
292;02.11.2016;2016;11;05;Keskiviikko;9;4;13;1;2;3
292;02.11.2016;2016;11;06;Keskiviikko;13;9;22;2;10;12
292;02.11.2016;2016;11;07;Keskiviikko;69;26;95;22;10;32
292;02.11.2016;2016;11;08;Keskiviikko;42;21;63;12;18;30
292;02.11.2016;2016;11;09;Keskiviikko;22;16;38;15;16;31
292;02.11.2016;2016;11;10;Keskiviikko;13;12;25;12;20;32
292;02.11.2016;2016;11;11;Keskiviikko;21;17;38;15;20;35
292;02.11.2016;2016;11;12;Keskiviikko;22;20;42;25;24;49
292;02.11.2016;2016;11;13;Keskiviikko;27;64;91;16;25;41
292;02.11.2016;2016;11;14;Keskiviikko;32;47;79;8;15;23
292;02.11.2016;2016;11;15;Keskiviikko;34;34;68;8;21;29
292;02.11.2016;2016;11;16;Keskiviikko;39;34;73;15;19;34
292;02.11.2016;2016;11;17;Keskiviikko;20;22;42;18;23;41
292;02.11.2016;2016;11;18;Keskiviikko;17;12;29;18;27;45
292;02.11.2016;2016;11;19;Keskiviikko;8;8;16;9;10;19
292;02.11.2016;2016;11;20;Keskiviikko;25;8;33;7;3;10
292;02.11.2016;2016;11;21;Keskiviikko;6;9;15;3;6;9
292;02.11.2016;2016;11;22;Keskiviikko;3;6;9;1;2;3
292;02.11.2016;2016;11;23;Keskiviikko;3;1;4;1;0;1
292;03.11.2016;2016;11;00;Torstai;0;2;2;1;2;3
292;03.11.2016;2016;11;01;Torstai;0;1;1;0;1;1
292;03.11.2016;2016;11;02;Torstai;0;0;0;0;1;1
292;03.11.2016;2016;11;03;Torstai;1;0;1;0;0;0
292;03.11.2016;2016;11;04;Torstai;2;1;3;0;0;0
292;03.11.2016;2016;11;05;Torstai;11;2;13;1;1;2
292;03.11.2016;2016;11;06;Torstai;10;8;18;2;5;7
292;03.11.2016;2016;11;07;Torstai;61;17;78;15;16;31
292;03.11.2016;2016;11;08;Torstai;45;14;59;8;22;30
292;03.11.2016;2016;11;09;Torstai;56;18;74;8;16;24
292;03.11.2016;2016;11;10;Torstai;22;10;32;6;7;13
292;03.11.2016;2016;11;11;Torstai;46;18;64;31;20;51
292;03.11.2016;2016;11;12;Torstai;40;42;82;43;80;123
292;03.11.2016;2016;11;13;Torstai;40;26;66;27;26;53
292;03.11.2016;2016;11;14;Torstai;26;41;67;24;28;52
292;03.11.2016;2016;11;15;Torstai;26;36;62;15;40;55
292;03.11.2016;2016;11;16;Torstai;27;60;87;16;33;49
292;03.11.2016;2016;11;17;Torstai;19;17;36;17;19;36
292;03.11.2016;2016;11;18;Torstai;21;13;34;19;26;45
292;03.11.2016;2016;11;19;Torstai;6;7;13;12;15;27
292;03.11.2016;2016;11;20;Torstai;17;8;25;2;19;21
292;03.11.2016;2016;11;21;Torstai;6;5;11;3;8;11
292;03.11.2016;2016;11;22;Torstai;2;5;7;2;0;2
292;03.11.2016;2016;11;23;Torstai;1;3;4;1;0;1
292;04.11.2016;2016;11;00;Perjantai;1;0;1;0;0;0
292;04.11.2016;2016;11;01;Perjantai;0;1;1;0;1;1
292;04.11.2016;2016;11;02;Perjantai;0;1;1;0;0;0
292;04.11.2016;2016;11;03;Perjantai;1;1;2;0;0;0
292;04.11.2016;2016;11;04;Perjantai;2;0;2;2;1;3
292;04.11.2016;2016;11;05;Perjantai;9;2;11;3;2;5
292;04.11.2016;2016;11;06;Perjantai;15;6;21;3;5;8
292;04.11.2016;2016;11;07;Perjantai;58;22;80;15;9;24
292;04.11.2016;2016;11;08;Perjantai;51;17;68;8;19;27
292;04.11.2016;2016;11;09;Perjantai;31;11;42;10;22;32
292;04.11.2016;2016;11;10;Perjantai;18;9;27;8;19;27
292;04.11.2016;2016;11;11;Perjantai;13;9;22;7;21;28
292;04.11.2016;2016;11;12;Perjantai;24;14;38;20;22;42
292;04.11.2016;2016;11;13;Perjantai;22;53;75;18;37;55
292;04.11.2016;2016;11;14;Perjantai;22;44;66;16;40;56
292;04.11.2016;2016;11;15;Perjantai;26;31;57;9;29;38
292;04.11.2016;2016;11;16;Perjantai;25;14;39;25;17;42
292;04.11.2016;2016;11;17;Perjantai;23;11;34;13;10;23
292;04.11.2016;2016;11;18;Perjantai;4;9;13;9;12;21
292;04.11.2016;2016;11;19;Perjantai;11;11;22;12;13;25
292;04.11.2016;2016;11;20;Perjantai;10;4;14;19;15;34
292;04.11.2016;2016;11;21;Perjantai;2;5;7;5;3;8
292;04.11.2016;2016;11;22;Perjantai;3;5;8;2;3;5
292;04.11.2016;2016;11;23;Perjantai;6;1;7;2;0;2
292;05.11.2016;2016;11;00;Lauantai;4;2;6;2;1;3
292;05.11.2016;2016;11;01;Lauantai;0;0;0;0;3;3
292;05.11.2016;2016;11;02;Lauantai;2;5;7;1;1;2
292;05.11.2016;2016;11;03;Lauantai;0;0;0;0;2;2
292;05.11.2016;2016;11;04;Lauantai;1;0;1;0;0;0
292;05.11.2016;2016;11;05;Lauantai;2;1;3;1;1;2
292;05.11.2016;2016;11;06;Lauantai;3;1;4;1;2;3
292;05.11.2016;2016;11;07;Lauantai;1;0;1;1;2;3
292;05.11.2016;2016;11;08;Lauantai;0;1;1;4;2;6
292;05.11.2016;2016;11;09;Lauantai;4;3;7;11;11;22
292;05.11.2016;2016;11;10;Lauantai;6;3;9;9;16;25
292;05.11.2016;2016;11;11;Lauantai;7;14;21;9;10;19
292;05.11.2016;2016;11;12;Lauantai;13;10;23;19;21;40
292;05.11.2016;2016;11;13;Lauantai;13;10;23;13;23;36
292;05.11.2016;2016;11;14;Lauantai;20;17;37;16;23;39
292;05.11.2016;2016;11;15;Lauantai;15;9;24;20;19;39
292;05.11.2016;2016;11;16;Lauantai;15;9;24;14;11;25
292;05.11.2016;2016;11;17;Lauantai;20;15;35;14;11;25
292;05.11.2016;2016;11;18;Lauantai;7;7;14;15;11;26
292;05.11.2016;2016;11;19;Lauantai;8;12;20;10;6;16
292;05.11.2016;2016;11;20;Lauantai;8;10;18;4;7;11
292;05.11.2016;2016;11;21;Lauantai;3;5;8;3;8;11
292;05.11.2016;2016;11;22;Lauantai;2;2;4;1;2;3
292;05.11.2016;2016;11;23;Lauantai;2;4;6;2;0;2
292;06.11.2016;2016;11;00;Sunnuntai;1;1;2;3;2;5
292;06.11.2016;2016;11;01;Sunnuntai;0;1;1;1;3;4
292;06.11.2016;2016;11;02;Sunnuntai;1;0;1;1;2;3
292;06.11.2016;2016;11;03;Sunnuntai;0;1;1;0;0;0
292;06.11.2016;2016;11;04;Sunnuntai;0;0;0;0;0;0
292;06.11.2016;2016;11;05;Sunnuntai;1;0;1;0;1;1
292;06.11.2016;2016;11;06;Sunnuntai;5;1;6;0;1;1
292;06.11.2016;2016;11;07;Sunnuntai;1;1;2;3;0;3
292;06.11.2016;2016;11;08;Sunnuntai;2;1;3;3;2;5
292;06.11.2016;2016;11;09;Sunnuntai;9;4;13;11;10;21
292;06.11.2016;2016;11;10;Sunnuntai;5;8;13;12;13;25
292;06.11.2016;2016;11;11;Sunnuntai;7;11;18;15;24;39
292;06.11.2016;2016;11;12;Sunnuntai;18;9;27;16;24;40
292;06.11.2016;2016;11;13;Sunnuntai;12;7;19;18;18;36
292;06.11.2016;2016;11;14;Sunnuntai;16;16;32;12;16;28
292;06.11.2016;2016;11;15;Sunnuntai;10;10;20;12;9;21
292;06.11.2016;2016;11;16;Sunnuntai;16;11;27;10;18;28
292;06.11.2016;2016;11;17;Sunnuntai;11;4;15;10;18;28
292;06.11.2016;2016;11;18;Sunnuntai;8;3;11;12;14;26
292;06.11.2016;2016;11;19;Sunnuntai;5;7;12;8;4;12
292;06.11.2016;2016;11;20;Sunnuntai;7;1;8;6;8;14
292;06.11.2016;2016;11;21;Sunnuntai;1;8;9;4;4;8
292;06.11.2016;2016;11;22;Sunnuntai;2;5;7;0;2;2
292;06.11.2016;2016;11;23;Sunnuntai;2;0;2;0;0;0
292;07.11.2016;2016;11;00;Maanantai;0;0;0;0;0;0
292;07.11.2016;2016;11;01;Maanantai;0;1;1;0;0;0
292;07.11.2016;2016;11;02;Maanantai;0;0;0;0;0;0
292;07.11.2016;2016;11;03;Maanantai;1;0;1;0;0;0
292;07.11.2016;2016;11;04;Maanantai;2;0;2;0;2;2
292;07.11.2016;2016;11;05;Maanantai;6;2;8;1;2;3
292;07.11.2016;2016;11;06;Maanantai;12;3;15;2;9;11
292;07.11.2016;2016;11;07;Maanantai;49;15;64;17;23;40
292;07.11.2016;2016;11;08;Maanantai;36;10;46;12;20;32
292;07.11.2016;2016;11;09;Maanantai;45;10;55;9;13;22
292;07.11.2016;2016;11;10;Maanantai;16;7;23;8;12;20
292;07.11.2016;2016;11;11;Maanantai;19;7;26;11;14;25
292;07.11.2016;2016;11;12;Maanantai;17;14;31;10;24;34
292;07.11.2016;2016;11;13;Maanantai;12;17;29;19;34;53
292;07.11.2016;2016;11;14;Maanantai;22;24;46;18;29;47
292;07.11.2016;2016;11;15;Maanantai;19;33;52;16;40;56
292;07.11.2016;2016;11;16;Maanantai;24;37;61;27;41;68
292;07.11.2016;2016;11;17;Maanantai;19;10;29;16;14;30
292;07.11.2016;2016;11;18;Maanantai;16;3;19;15;25;40
292;07.11.2016;2016;11;19;Maanantai;10;7;17;11;11;22
292;07.11.2016;2016;11;20;Maanantai;6;4;10;7;10;17
292;07.11.2016;2016;11;21;Maanantai;4;9;13;4;5;9
292;07.11.2016;2016;11;22;Maanantai;3;1;4;1;1;2
292;07.11.2016;2016;11;23;Maanantai;0;2;2;0;1;1
292;08.11.2016;2016;11;00;Tiistai;0;0;0;0;0;0
292;08.11.2016;2016;11;01;Tiistai;0;0;0;0;0;0
292;08.11.2016;2016;11;02;Tiistai;0;0;0;0;0;0
292;08.11.2016;2016;11;03;Tiistai;0;0;0;1;0;1
292;08.11.2016;2016;11;04;Tiistai;3;1;4;0;0;0
292;08.11.2016;2016;11;05;Tiistai;5;5;10;2;1;3
292;08.11.2016;2016;11;06;Tiistai;14;8;22;2;6;8
292;08.11.2016;2016;11;07;Tiistai;59;16;75;18;24;42
292;08.11.2016;2016;11;08;Tiistai;55;11;66;14;26;40
292;08.11.2016;2016;11;09;Tiistai;23;11;34;19;13;32
292;08.11.2016;2016;11;10;Tiistai;15;10;25;14;18;32
292;08.11.2016;2016;11;11;Tiistai;8;10;18;13;17;30
292;08.11.2016;2016;11;12;Tiistai;14;10;24;9;26;35
292;08.11.2016;2016;11;13;Tiistai;12;17;29;18;23;41
292;08.11.2016;2016;11;14;Tiistai;24;38;62;21;44;65
292;08.11.2016;2016;11;15;Tiistai;25;20;45;13;36;49
292;08.11.2016;2016;11;16;Tiistai;26;28;54;20;22;42
292;08.11.2016;2016;11;17;Tiistai;20;10;30;19;20;39
292;08.11.2016;2016;11;18;Tiistai;12;12;24;12;18;30
292;08.11.2016;2016;11;19;Tiistai;10;14;24;19;24;43
292;08.11.2016;2016;11;20;Tiistai;15;5;20;12;7;19
292;08.11.2016;2016;11;21;Tiistai;7;3;10;3;7;10
292;08.11.2016;2016;11;22;Tiistai;3;2;5;1;2;3
292;08.11.2016;2016;11;23;Tiistai;0;0;0;0;2;2
292;09.11.2016;2016;11;00;Keskiviikko;0;0;0;0;1;1
292;09.11.2016;2016;11;01;Keskiviikko;0;0;0;0;0;0
292;09.11.2016;2016;11;02;Keskiviikko;0;0;0;0;0;0
292;09.11.2016;2016;11;03;Keskiviikko;1;0;1;0;0;0
292;09.11.2016;2016;11;04;Keskiviikko;2;1;3;1;0;1
292;09.11.2016;2016;11;05;Keskiviikko;5;5;10;1;1;2
292;09.11.2016;2016;11;06;Keskiviikko;13;9;22;1;6;7
292;09.11.2016;2016;11;07;Keskiviikko;66;16;82;14;16;30
292;09.11.2016;2016;11;08;Keskiviikko;43;13;56;18;23;41
292;09.11.2016;2016;11;09;Keskiviikko;14;7;21;6;23;29
292;09.11.2016;2016;11;10;Keskiviikko;17;6;23;13;19;32
292;09.11.2016;2016;11;11;Keskiviikko;22;16;38;13;18;31
292;09.11.2016;2016;11;12;Keskiviikko;21;14;35;16;23;39
292;09.11.2016;2016;11;13;Keskiviikko;27;44;71;21;46;67
292;09.11.2016;2016;11;14;Keskiviikko;28;25;53;20;33;53
292;09.11.2016;2016;11;15;Keskiviikko;22;25;47;17;30;47
292;09.11.2016;2016;11;16;Keskiviikko;29;20;49;13;22;35
292;09.11.2016;2016;11;17;Keskiviikko;11;10;21;13;20;33
292;09.11.2016;2016;11;18;Keskiviikko;10;5;15;8;11;19
292;09.11.2016;2016;11;19;Keskiviikko;16;8;24;14;17;31
292;09.11.2016;2016;11;20;Keskiviikko;9;5;14;5;6;11
292;09.11.2016;2016;11;21;Keskiviikko;3;5;8;3;5;8
292;09.11.2016;2016;11;22;Keskiviikko;1;5;6;1;1;2
292;09.11.2016;2016;11;23;Keskiviikko;0;1;1;2;2;4
292;10.11.2016;2016;11;00;Torstai;0;2;2;0;0;0
292;10.11.2016;2016;11;01;Torstai;0;0;0;0;1;1
292;10.11.2016;2016;11;02;Torstai;0;0;0;0;0;0
292;10.11.2016;2016;11;03;Torstai;0;0;0;1;0;1
292;10.11.2016;2016;11;04;Torstai;3;0;3;0;0;0
292;10.11.2016;2016;11;05;Torstai;5;1;6;1;3;4
292;10.11.2016;2016;11;06;Torstai;11;10;21;3;6;9
292;10.11.2016;2016;11;07;Torstai;51;9;60;12;18;30
292;10.11.2016;2016;11;08;Torstai;42;10;52;14;21;35
292;10.11.2016;2016;11;09;Torstai;45;8;53;14;21;35
292;10.11.2016;2016;11;10;Torstai;26;5;31;12;14;26
292;10.11.2016;2016;11;11;Torstai;12;6;18;16;12;28
292;10.11.2016;2016;11;12;Torstai;18;14;32;8;22;30
292;10.11.2016;2016;11;13;Torstai;23;17;40;25;25;50
292;10.11.2016;2016;11;14;Torstai;18;26;44;16;28;44
292;10.11.2016;2016;11;15;Torstai;19;35;54;14;44;58
292;10.11.2016;2016;11;16;Torstai;25;21;46;16;40;56
292;10.11.2016;2016;11;17;Torstai;15;9;24;4;12;16
292;10.11.2016;2016;11;18;Torstai;13;12;25;22;24;46
292;10.11.2016;2016;11;19;Torstai;6;7;13;14;19;33
292;10.11.2016;2016;11;20;Torstai;12;8;20;6;7;13
292;10.11.2016;2016;11;21;Torstai;10;4;14;9;9;18
292;10.11.2016;2016;11;22;Torstai;1;4;5;3;5;8
292;10.11.2016;2016;11;23;Torstai;0;0;0;0;0;0
292;11.11.2016;2016;11;00;Perjantai;1;0;1;0;0;0
292;11.11.2016;2016;11;01;Perjantai;1;2;3;1;0;1
292;11.11.2016;2016;11;02;Perjantai;0;0;0;0;0;0
292;11.11.2016;2016;11;03;Perjantai;0;3;3;1;0;1
292;11.11.2016;2016;11;04;Perjantai;4;0;4;0;0;0
292;11.11.2016;2016;11;05;Perjantai;7;7;14;2;0;2
292;11.11.2016;2016;11;06;Perjantai;11;9;20;8;9;17
292;11.11.2016;2016;11;07;Perjantai;53;16;69;15;9;24
292;11.11.2016;2016;11;08;Perjantai;58;13;71;22;17;39
292;11.11.2016;2016;11;09;Perjantai;20;16;36;13;17;30
292;11.11.2016;2016;11;10;Perjantai;10;10;20;10;7;17
292;11.11.2016;2016;11;11;Perjantai;11;14;25;18;6;24
292;11.11.2016;2016;11;12;Perjantai;20;13;33;16;17;33
292;11.11.2016;2016;11;13;Perjantai;9;55;64;18;33;51
292;11.11.2016;2016;11;14;Perjantai;16;44;60;15;32;47
292;11.11.2016;2016;11;15;Perjantai;17;33;50;24;22;46
292;11.11.2016;2016;11;16;Perjantai;15;23;38;16;29;45
292;11.11.2016;2016;11;17;Perjantai;15;16;31;10;14;24
292;11.11.2016;2016;11;18;Perjantai;17;12;29;23;10;33
292;11.11.2016;2016;11;19;Perjantai;12;10;22;21;12;33
292;11.11.2016;2016;11;20;Perjantai;9;10;19;13;5;18
292;11.11.2016;2016;11;21;Perjantai;12;4;16;12;14;26
292;11.11.2016;2016;11;22;Perjantai;2;3;5;5;4;9
292;11.11.2016;2016;11;23;Perjantai;1;7;8;1;6;7
292;12.11.2016;2016;11;00;Lauantai;2;1;3;4;0;4
292;12.11.2016;2016;11;01;Lauantai;1;2;3;0;5;5
292;12.11.2016;2016;11;02;Lauantai;0;3;3;0;2;2
292;12.11.2016;2016;11;03;Lauantai;0;1;1;0;1;1
292;12.11.2016;2016;11;04;Lauantai;0;1;1;1;2;3
292;12.11.2016;2016;11;05;Lauantai;2;1;3;2;1;3
292;12.11.2016;2016;11;06;Lauantai;6;1;7;6;3;9
292;12.11.2016;2016;11;07;Lauantai;0;1;1;1;2;3
292;12.11.2016;2016;11;08;Lauantai;1;3;4;6;7;13
292;12.11.2016;2016;11;09;Lauantai;5;7;12;10;17;27
292;12.11.2016;2016;11;10;Lauantai;7;6;13;16;21;37
292;12.11.2016;2016;11;11;Lauantai;4;11;15;12;9;21
292;12.11.2016;2016;11;12;Lauantai;16;11;27;22;18;40
292;12.11.2016;2016;11;13;Lauantai;12;11;23;13;21;34
292;12.11.2016;2016;11;14;Lauantai;15;18;33;15;15;30
292;12.11.2016;2016;11;15;Lauantai;11;14;25;13;15;28
292;12.11.2016;2016;11;16;Lauantai;12;6;18;23;14;37
292;12.11.2016;2016;11;17;Lauantai;5;4;9;13;18;31
292;12.11.2016;2016;11;18;Lauantai;7;8;15;20;12;32
292;12.11.2016;2016;11;19;Lauantai;3;3;6;6;11;17
292;12.11.2016;2016;11;20;Lauantai;3;2;5;8;7;15
292;12.11.2016;2016;11;21;Lauantai;5;4;9;5;1;6
292;12.11.2016;2016;11;22;Lauantai;5;5;10;0;3;3
292;12.11.2016;2016;11;23;Lauantai;0;0;0;3;2;5
292;13.11.2016;2016;11;00;Sunnuntai;1;2;3;2;0;2
292;13.11.2016;2016;11;01;Sunnuntai;1;0;1;2;1;3
292;13.11.2016;2016;11;02;Sunnuntai;1;0;1;0;2;2
292;13.11.2016;2016;11;03;Sunnuntai;0;1;1;0;1;1
292;13.11.2016;2016;11;04;Sunnuntai;0;0;0;1;0;1
292;13.11.2016;2016;11;05;Sunnuntai;2;0;2;2;0;2
292;13.11.2016;2016;11;06;Sunnuntai;5;1;6;3;4;7
292;13.11.2016;2016;11;07;Sunnuntai;1;0;1;2;1;3
292;13.11.2016;2016;11;08;Sunnuntai;1;2;3;11;7;18
292;13.11.2016;2016;11;09;Sunnuntai;4;1;5;7;8;15
292;13.11.2016;2016;11;10;Sunnuntai;2;3;5;5;9;14
292;13.11.2016;2016;11;11;Sunnuntai;10;11;21;6;8;14
292;13.11.2016;2016;11;12;Sunnuntai;8;6;14;13;7;20
292;13.11.2016;2016;11;13;Sunnuntai;6;9;15;9;11;20
292;13.11.2016;2016;11;14;Sunnuntai;13;14;27;8;9;17
292;13.11.2016;2016;11;15;Sunnuntai;12;11;23;24;14;38
292;13.11.2016;2016;11;16;Sunnuntai;11;8;19;18;13;31
292;13.11.2016;2016;11;17;Sunnuntai;4;15;19;23;15;38
292;13.11.2016;2016;11;18;Sunnuntai;7;4;11;16;19;35
292;13.11.2016;2016;11;19;Sunnuntai;5;8;13;19;13;32
292;13.11.2016;2016;11;20;Sunnuntai;3;6;9;7;6;13
292;13.11.2016;2016;11;21;Sunnuntai;7;4;11;5;4;9
292;13.11.2016;2016;11;22;Sunnuntai;3;1;4;2;2;4
292;13.11.2016;2016;11;23;Sunnuntai;0;1;1;1;0;1
292;14.11.2016;2016;11;00;Maanantai;0;0;0;0;0;0
292;14.11.2016;2016;11;01;Maanantai;0;2;2;0;0;0
292;14.11.2016;2016;11;02;Maanantai;0;0;0;0;1;1
292;14.11.2016;2016;11;03;Maanantai;1;0;1;1;0;1
292;14.11.2016;2016;11;04;Maanantai;2;1;3;0;1;1
292;14.11.2016;2016;11;05;Maanantai;4;6;10;2;1;3
292;14.11.2016;2016;11;06;Maanantai;11;9;20;1;5;6
292;14.11.2016;2016;11;07;Maanantai;46;22;68;17;19;36
292;14.11.2016;2016;11;08;Maanantai;31;13;44;14;17;31
292;14.11.2016;2016;11;09;Maanantai;45;17;62;14;15;29
292;14.11.2016;2016;11;10;Maanantai;16;9;25;18;6;24
292;14.11.2016;2016;11;11;Maanantai;14;19;33;14;20;34
292;14.11.2016;2016;11;12;Maanantai;8;13;21;23;14;37
292;14.11.2016;2016;11;13;Maanantai;12;21;33;19;15;34
292;14.11.2016;2016;11;14;Maanantai;21;31;52;19;22;41
292;14.11.2016;2016;11;15;Maanantai;18;49;67;30;18;48
292;14.11.2016;2016;11;16;Maanantai;20;49;69;25;22;47
292;14.11.2016;2016;11;17;Maanantai;7;12;19;21;13;34
292;14.11.2016;2016;11;18;Maanantai;13;12;25;14;17;31
292;14.11.2016;2016;11;19;Maanantai;10;10;20;16;17;33
292;14.11.2016;2016;11;20;Maanantai;11;9;20;5;9;14
292;14.11.2016;2016;11;21;Maanantai;8;8;16;1;3;4
292;14.11.2016;2016;11;22;Maanantai;0;1;1;1;0;1
292;14.11.2016;2016;11;23;Maanantai;0;0;0;1;0;1
292;15.11.2016;2016;11;00;Tiistai;0;1;1;1;1;2
292;15.11.2016;2016;11;01;Tiistai;0;0;0;0;0;0
292;15.11.2016;2016;11;02;Tiistai;0;0;0;0;1;1
292;15.11.2016;2016;11;03;Tiistai;0;0;0;1;0;1
292;15.11.2016;2016;11;04;Tiistai;4;0;4;0;0;0
292;15.11.2016;2016;11;05;Tiistai;3;4;7;3;1;4
292;15.11.2016;2016;11;06;Tiistai;9;12;21;5;4;9
292;15.11.2016;2016;11;07;Tiistai;50;21;71;29;15;44
292;15.11.2016;2016;11;08;Tiistai;52;13;65;21;21;42
292;15.11.2016;2016;11;09;Tiistai;15;19;34;19;14;33
292;15.11.2016;2016;11;10;Tiistai;14;12;26;16;11;27
292;15.11.2016;2016;11;11;Tiistai;13;14;27;18;12;30
292;15.11.2016;2016;11;12;Tiistai;11;10;21;17;13;30
292;15.11.2016;2016;11;13;Tiistai;11;15;26;13;7;20
292;15.11.2016;2016;11;14;Tiistai;16;54;70;22;31;53
292;15.11.2016;2016;11;15;Tiistai;16;44;60;11;20;31
292;15.11.2016;2016;11;16;Tiistai;24;28;52;18;21;39
292;15.11.2016;2016;11;17;Tiistai;13;22;35;23;18;41
292;15.11.2016;2016;11;18;Tiistai;19;13;32;22;14;36
292;15.11.2016;2016;11;19;Tiistai;12;22;34;16;8;24
292;15.11.2016;2016;11;20;Tiistai;8;8;16;15;6;21
292;15.11.2016;2016;11;21;Tiistai;3;6;9;4;5;9
292;15.11.2016;2016;11;22;Tiistai;2;2;4;4;0;4
292;15.11.2016;2016;11;23;Tiistai;1;2;3;2;0;2
292;16.11.2016;2016;11;00;Keskiviikko;0;0;0;0;0;0
292;16.11.2016;2016;11;01;Keskiviikko;0;0;0;0;0;0
292;16.11.2016;2016;11;02;Keskiviikko;0;0;0;0;0;0
292;16.11.2016;2016;11;03;Keskiviikko;1;0;1;0;0;0
292;16.11.2016;2016;11;04;Keskiviikko;1;0;1;0;0;0
292;16.11.2016;2016;11;05;Keskiviikko;4;3;7;8;7;15
292;16.11.2016;2016;11;06;Keskiviikko;15;11;26;4;2;6
292;16.11.2016;2016;11;07;Keskiviikko;60;15;75;24;12;36
292;16.11.2016;2016;11;08;Keskiviikko;46;20;66;15;16;31
292;16.11.2016;2016;11;09;Keskiviikko;12;14;26;20;14;34
292;16.11.2016;2016;11;10;Keskiviikko;13;4;17;10;13;23
292;16.11.2016;2016;11;11;Keskiviikko;14;15;29;18;15;33
292;16.11.2016;2016;11;12;Keskiviikko;17;5;22;11;14;25
292;16.11.2016;2016;11;13;Keskiviikko;13;64;77;18;35;53
292;16.11.2016;2016;11;14;Keskiviikko;24;32;56;24;20;44
292;16.11.2016;2016;11;15;Keskiviikko;19;40;59;23;28;51
292;16.11.2016;2016;11;16;Keskiviikko;20;32;52;25;22;47
292;16.11.2016;2016;11;17;Keskiviikko;22;16;38;22;13;35
292;16.11.2016;2016;11;18;Keskiviikko;11;20;31;27;17;44
292;16.11.2016;2016;11;19;Keskiviikko;13;10;23;16;15;31
292;16.11.2016;2016;11;20;Keskiviikko;14;6;20;8;7;15
292;16.11.2016;2016;11;21;Keskiviikko;6;6;12;1;3;4
292;16.11.2016;2016;11;22;Keskiviikko;1;4;5;2;0;2
292;16.11.2016;2016;11;23;Keskiviikko;2;0;2;1;0;1
292;17.11.2016;2016;11;00;Torstai;0;0;0;2;0;2
292;17.11.2016;2016;11;01;Torstai;0;1;1;0;1;1
292;17.11.2016;2016;11;02;Torstai;0;0;0;0;0;0
292;17.11.2016;2016;11;03;Torstai;1;0;1;1;0;1
292;17.11.2016;2016;11;04;Torstai;1;0;1;0;0;0
292;17.11.2016;2016;11;05;Torstai;3;5;8;2;0;2
292;17.11.2016;2016;11;06;Torstai;13;13;26;4;6;10
292;17.11.2016;2016;11;07;Torstai;43;30;73;23;11;34
292;17.11.2016;2016;11;08;Torstai;35;17;52;32;18;50
292;17.11.2016;2016;11;09;Torstai;43;16;59;16;24;40
292;17.11.2016;2016;11;10;Torstai;14;16;30;15;7;22
292;17.11.2016;2016;11;11;Torstai;10;15;25;20;9;29
292;17.11.2016;2016;11;12;Torstai;19;13;32;10;19;29
292;17.11.2016;2016;11;13;Torstai;15;24;39;27;21;48
292;17.11.2016;2016;11;14;Torstai;28;30;58;25;25;50
292;17.11.2016;2016;11;15;Torstai;22;43;65;19;35;54
292;17.11.2016;2016;11;16;Torstai;18;42;60;20;31;51
292;17.11.2016;2016;11;17;Torstai;18;19;37;17;21;38
292;17.11.2016;2016;11;18;Torstai;11;8;19;22;13;35
292;17.11.2016;2016;11;19;Torstai;15;14;29;16;16;32
292;17.11.2016;2016;11;20;Torstai;13;7;20;12;4;16
292;17.11.2016;2016;11;21;Torstai;6;4;10;4;7;11
292;17.11.2016;2016;11;22;Torstai;2;2;4;5;4;9
292;17.11.2016;2016;11;23;Torstai;1;1;2;0;0;0
292;18.11.2016;2016;11;00;Perjantai;0;0;0;1;2;3
292;18.11.2016;2016;11;01;Perjantai;1;0;1;2;3;5
292;18.11.2016;2016;11;02;Perjantai;0;0;0;0;0;0
292;18.11.2016;2016;11;03;Perjantai;1;0;1;1;1;2
292;18.11.2016;2016;11;04;Perjantai;0;1;1;2;1;3
292;18.11.2016;2016;11;05;Perjantai;4;5;9;4;2;6
292;18.11.2016;2016;11;06;Perjantai;10;9;19;6;9;15
292;18.11.2016;2016;11;07;Perjantai;47;11;58;26;13;39
292;18.11.2016;2016;11;08;Perjantai;55;10;65;26;19;45
292;18.11.2016;2016;11;09;Perjantai;29;11;40;6;11;17
292;18.11.2016;2016;11;10;Perjantai;11;9;20;12;14;26
292;18.11.2016;2016;11;11;Perjantai;9;16;25;5;9;14
292;18.11.2016;2016;11;12;Perjantai;17;26;43;19;22;41
292;18.11.2016;2016;11;13;Perjantai;18;44;62;17;24;41
292;18.11.2016;2016;11;14;Perjantai;15;42;57;11;23;34
292;18.11.2016;2016;11;15;Perjantai;17;40;57;20;20;40
292;18.11.2016;2016;11;16;Perjantai;18;16;34;17;15;32
292;18.11.2016;2016;11;17;Perjantai;15;13;28;17;8;25
292;18.11.2016;2016;11;18;Perjantai;5;11;16;12;16;28
292;18.11.2016;2016;11;19;Perjantai;11;9;20;10;5;15
292;18.11.2016;2016;11;20;Perjantai;14;3;17;3;5;8
292;18.11.2016;2016;11;21;Perjantai;4;5;9;4;7;11
292;18.11.2016;2016;11;22;Perjantai;4;3;7;1;4;5
292;18.11.2016;2016;11;23;Perjantai;0;4;4;2;3;5
292;19.11.2016;2016;11;00;Lauantai;7;1;8;0;2;2
292;19.11.2016;2016;11;01;Lauantai;1;2;3;3;1;4
292;19.11.2016;2016;11;02;Lauantai;0;1;1;0;0;0
292;19.11.2016;2016;11;03;Lauantai;0;2;2;0;0;0
292;19.11.2016;2016;11;04;Lauantai;0;1;1;0;0;0
292;19.11.2016;2016;11;05;Lauantai;1;0;1;1;0;1
292;19.11.2016;2016;11;06;Lauantai;2;1;3;3;3;6
292;19.11.2016;2016;11;07;Lauantai;3;3;6;2;1;3
292;19.11.2016;2016;11;08;Lauantai;2;3;5;0;3;3
292;19.11.2016;2016;11;09;Lauantai;3;8;11;3;2;5
292;19.11.2016;2016;11;10;Lauantai;7;7;14;5;8;13
292;19.11.2016;2016;11;11;Lauantai;9;11;20;9;10;19
292;19.11.2016;2016;11;12;Lauantai;6;8;14;11;7;18
292;19.11.2016;2016;11;13;Lauantai;14;8;22;8;5;13
292;19.11.2016;2016;11;14;Lauantai;6;12;18;6;3;9
292;19.11.2016;2016;11;15;Lauantai;10;11;21;5;9;14
292;19.11.2016;2016;11;16;Lauantai;9;12;21;8;7;15
292;19.11.2016;2016;11;17;Lauantai;9;13;22;9;6;15
292;19.11.2016;2016;11;18;Lauantai;10;9;19;11;7;18
292;19.11.2016;2016;11;19;Lauantai;7;4;11;10;4;14
292;19.11.2016;2016;11;20;Lauantai;8;4;12;2;3;5
292;19.11.2016;2016;11;21;Lauantai;3;5;8;1;3;4
292;19.11.2016;2016;11;22;Lauantai;2;7;9;7;0;7
292;19.11.2016;2016;11;23;Lauantai;7;1;8;3;0;3
292;20.11.2016;2016;11;00;Sunnuntai;4;1;5;3;1;4
292;20.11.2016;2016;11;01;Sunnuntai;0;1;1;5;3;8
292;20.11.2016;2016;11;02;Sunnuntai;1;0;1;1;3;4
292;20.11.2016;2016;11;03;Sunnuntai;1;3;4;2;3;5
292;20.11.2016;2016;11;04;Sunnuntai;0;1;1;0;1;1
292;20.11.2016;2016;11;05;Sunnuntai;2;0;2;3;0;3
292;20.11.2016;2016;11;06;Sunnuntai;5;0;5;1;4;5
292;20.11.2016;2016;11;07;Sunnuntai;4;4;8;0;6;6
292;20.11.2016;2016;11;08;Sunnuntai;2;2;4;11;3;14
292;20.11.2016;2016;11;09;Sunnuntai;14;8;22;10;8;18
292;20.11.2016;2016;11;10;Sunnuntai;14;8;22;12;9;21
292;20.11.2016;2016;11;11;Sunnuntai;5;21;26;15;12;27
292;20.11.2016;2016;11;12;Sunnuntai;10;20;30;6;13;19
292;20.11.2016;2016;11;13;Sunnuntai;14;8;22;11;8;19
292;20.11.2016;2016;11;14;Sunnuntai;28;25;53;17;19;36
292;20.11.2016;2016;11;15;Sunnuntai;24;17;41;17;12;29
292;20.11.2016;2016;11;16;Sunnuntai;11;10;21;13;14;27
292;20.11.2016;2016;11;17;Sunnuntai;17;18;35;11;14;25
292;20.11.2016;2016;11;18;Sunnuntai;7;12;19;19;11;30
292;20.11.2016;2016;11;19;Sunnuntai;12;5;17;6;10;16
292;20.11.2016;2016;11;20;Sunnuntai;6;3;9;7;1;8
292;20.11.2016;2016;11;21;Sunnuntai;6;1;7;2;6;8
292;20.11.2016;2016;11;22;Sunnuntai;3;5;8;2;0;2
292;20.11.2016;2016;11;23;Sunnuntai;0;2;2;0;3;3
292;21.11.2016;2016;11;00;Maanantai;0;0;0;0;2;2
292;21.11.2016;2016;11;01;Maanantai;0;1;1;0;0;0
292;21.11.2016;2016;11;02;Maanantai;0;1;1;0;1;1
292;21.11.2016;2016;11;03;Maanantai;1;1;2;0;0;0
292;21.11.2016;2016;11;04;Maanantai;3;0;3;0;1;1
292;21.11.2016;2016;11;05;Maanantai;7;5;12;0;0;0
292;21.11.2016;2016;11;06;Maanantai;19;7;26;0;4;4
292;21.11.2016;2016;11;07;Maanantai;52;26;78;12;10;22
292;21.11.2016;2016;11;08;Maanantai;46;26;72;11;17;28
292;21.11.2016;2016;11;09;Maanantai;45;16;61;9;16;25
292;21.11.2016;2016;11;10;Maanantai;26;20;46;8;15;23
292;21.11.2016;2016;11;11;Maanantai;31;10;41;10;10;20
292;21.11.2016;2016;11;12;Maanantai;18;25;43;7;7;14
292;21.11.2016;2016;11;13;Maanantai;23;32;55;15;11;26
292;21.11.2016;2016;11;14;Maanantai;23;47;70;14;6;20
292;21.11.2016;2016;11;15;Maanantai;25;57;82;13;16;29
292;21.11.2016;2016;11;16;Maanantai;23;44;67;9;16;25
292;21.11.2016;2016;11;17;Maanantai;10;11;21;8;8;16
292;21.11.2016;2016;11;18;Maanantai;13;11;24;14;11;25
292;21.11.2016;2016;11;19;Maanantai;10;3;13;5;11;16
292;21.11.2016;2016;11;20;Maanantai;8;9;17;4;6;10
292;21.11.2016;2016;11;21;Maanantai;6;6;12;2;1;3
292;21.11.2016;2016;11;22;Maanantai;2;2;4;1;1;2
292;21.11.2016;2016;11;23;Maanantai;0;0;0;2;1;3
292;22.11.2016;2016;11;00;Tiistai;0;0;0;1;1;2
292;22.11.2016;2016;11;01;Tiistai;0;0;0;0;1;1
292;22.11.2016;2016;11;02;Tiistai;0;0;0;0;0;0
292;22.11.2016;2016;11;03;Tiistai;0;0;0;0;0;0
292;22.11.2016;2016;11;04;Tiistai;2;0;2;0;0;0
292;22.11.2016;2016;11;05;Tiistai;2;5;7;2;2;4
292;22.11.2016;2016;11;06;Tiistai;19;11;30;2;5;7
292;22.11.2016;2016;11;07;Tiistai;62;16;78;7;17;24
292;22.11.2016;2016;11;08;Tiistai;58;11;69;11;30;41
292;22.11.2016;2016;11;09;Tiistai;31;11;42;7;14;21
292;22.11.2016;2016;11;10;Tiistai;28;10;38;14;14;28
292;22.11.2016;2016;11;11;Tiistai;16;13;29;11;19;30
292;22.11.2016;2016;11;12;Tiistai;29;14;43;17;25;42
292;22.11.2016;2016;11;13;Tiistai;31;26;57;19;19;38
292;22.11.2016;2016;11;14;Tiistai;26;53;79;14;36;50
292;22.11.2016;2016;11;15;Tiistai;38;41;79;14;44;58
292;22.11.2016;2016;11;16;Tiistai;40;29;69;18;29;47
292;22.11.2016;2016;11;17;Tiistai;23;22;45;10;15;25
292;22.11.2016;2016;11;18;Tiistai;8;10;18;6;13;19
292;22.11.2016;2016;11;19;Tiistai;10;8;18;13;8;21
292;22.11.2016;2016;11;20;Tiistai;14;4;18;9;10;19
292;22.11.2016;2016;11;21;Tiistai;10;6;16;0;3;3
292;22.11.2016;2016;11;22;Tiistai;3;2;5;1;0;1
292;22.11.2016;2016;11;23;Tiistai;2;0;2;0;0;0
292;23.11.2016;2016;11;00;Keskiviikko;1;0;1;1;0;1
292;23.11.2016;2016;11;01;Keskiviikko;1;0;1;0;0;0
292;23.11.2016;2016;11;02;Keskiviikko;0;0;0;0;0;0
292;23.11.2016;2016;11;03;Keskiviikko;0;0;0;0;0;0
292;23.11.2016;2016;11;04;Keskiviikko;1;0;1;0;0;0
292;23.11.2016;2016;11;05;Keskiviikko;6;4;10;2;1;3
292;23.11.2016;2016;11;06;Keskiviikko;15;9;24;1;5;6
292;23.11.2016;2016;11;07;Keskiviikko;79;17;96;12;12;24
292;23.11.2016;2016;11;08;Keskiviikko;33;11;44;13;14;27
292;23.11.2016;2016;11;09;Keskiviikko;17;14;31;10;15;25
292;23.11.2016;2016;11;10;Keskiviikko;13;24;37;4;7;11
292;23.11.2016;2016;11;11;Keskiviikko;10;20;30;5;14;19
292;23.11.2016;2016;11;12;Keskiviikko;19;19;38;11;13;24
292;23.11.2016;2016;11;13;Keskiviikko;23;46;69;11;18;29
292;23.11.2016;2016;11;14;Keskiviikko;34;27;61;9;16;25
292;23.11.2016;2016;11;15;Keskiviikko;29;29;58;11;20;31
292;23.11.2016;2016;11;16;Keskiviikko;33;24;57;11;13;24
292;23.11.2016;2016;11;17;Keskiviikko;16;14;30;9;16;25
292;23.11.2016;2016;11;18;Keskiviikko;21;9;30;17;6;23
292;23.11.2016;2016;11;19;Keskiviikko;11;6;17;13;12;25
292;23.11.2016;2016;11;20;Keskiviikko;12;4;16;1;10;11
292;23.11.2016;2016;11;21;Keskiviikko;6;7;13;3;5;8
292;23.11.2016;2016;11;22;Keskiviikko;2;6;8;2;3;5
292;23.11.2016;2016;11;23;Keskiviikko;1;0;1;2;2;4
292;24.11.2016;2016;11;00;Torstai;0;0;0;0;0;0
292;24.11.2016;2016;11;01;Torstai;1;0;1;0;0;0
292;24.11.2016;2016;11;02;Torstai;0;1;1;0;0;0
292;24.11.2016;2016;11;03;Torstai;1;0;1;0;0;0
292;24.11.2016;2016;11;04;Torstai;2;0;2;0;0;0
292;24.11.2016;2016;11;05;Torstai;2;5;7;1;1;2
292;24.11.2016;2016;11;06;Torstai;12;9;21;2;10;12
292;24.11.2016;2016;11;07;Torstai;68;11;79;8;17;25
292;24.11.2016;2016;11;08;Torstai;59;21;80;9;16;25
292;24.11.2016;2016;11;09;Torstai;23;13;36;8;19;27
292;24.11.2016;2016;11;10;Torstai;22;20;42;15;32;47
292;24.11.2016;2016;11;11;Torstai;10;19;29;19;24;43
292;24.11.2016;2016;11;12;Torstai;22;22;44;13;38;51
292;24.11.2016;2016;11;13;Torstai;18;21;39;16;17;33
292;24.11.2016;2016;11;14;Torstai;20;23;43;19;25;44
292;24.11.2016;2016;11;15;Torstai;38;32;70;11;52;63
292;24.11.2016;2016;11;16;Torstai;30;24;54;10;12;22
292;24.11.2016;2016;11;17;Torstai;18;15;33;8;18;26
292;24.11.2016;2016;11;18;Torstai;16;15;31;21;15;36
292;24.11.2016;2016;11;19;Torstai;6;9;15;10;13;23
292;24.11.2016;2016;11;20;Torstai;15;3;18;7;8;15
292;24.11.2016;2016;11;21;Torstai;10;2;12;4;11;15
292;24.11.2016;2016;11;22;Torstai;0;0;0;0;1;1
292;24.11.2016;2016;11;23;Torstai;1;2;3;0;1;1
292;25.11.2016;2016;11;00;Perjantai;0;0;0;0;0;0
292;25.11.2016;2016;11;01;Perjantai;0;1;1;0;2;2
292;25.11.2016;2016;11;02;Perjantai;0;0;0;0;0;0
292;25.11.2016;2016;11;03;Perjantai;0;1;1;0;0;0
292;25.11.2016;2016;11;04;Perjantai;2;0;2;1;1;2
292;25.11.2016;2016;11;05;Perjantai;4;3;7;1;3;4
292;25.11.2016;2016;11;06;Perjantai;12;7;19;2;10;12
292;25.11.2016;2016;11;07;Perjantai;69;12;81;14;16;30
292;25.11.2016;2016;11;08;Perjantai;45;13;58;10;14;24
292;25.11.2016;2016;11;09;Perjantai;15;9;24;13;22;35
292;25.11.2016;2016;11;10;Perjantai;15;41;56;11;15;26
292;25.11.2016;2016;11;11;Perjantai;11;19;30;3;16;19
292;25.11.2016;2016;11;12;Perjantai;16;16;32;17;25;42
292;25.11.2016;2016;11;13;Perjantai;24;29;53;15;18;33
292;25.11.2016;2016;11;14;Perjantai;25;31;56;6;24;30
292;25.11.2016;2016;11;15;Perjantai;31;32;63;14;18;32
292;25.11.2016;2016;11;16;Perjantai;25;15;40;14;16;30
292;25.11.2016;2016;11;17;Perjantai;21;17;38;14;11;25
292;25.11.2016;2016;11;18;Perjantai;21;20;41;10;17;27
292;25.11.2016;2016;11;19;Perjantai;18;18;36;16;12;28
292;25.11.2016;2016;11;20;Perjantai;13;5;18;12;4;16
292;25.11.2016;2016;11;21;Perjantai;11;6;17;10;10;20
292;25.11.2016;2016;11;22;Perjantai;5;4;9;2;0;2
292;25.11.2016;2016;11;23;Perjantai;4;2;6;4;2;6
292;26.11.2016;2016;11;00;Lauantai;6;2;8;4;3;7
292;26.11.2016;2016;11;01;Lauantai;2;0;2;2;1;3
292;26.11.2016;2016;11;02;Lauantai;0;1;1;0;3;3
292;26.11.2016;2016;11;03;Lauantai;1;0;1;1;2;3
292;26.11.2016;2016;11;04;Lauantai;0;0;0;10;9;19
292;26.11.2016;2016;11;05;Lauantai;2;0;2;3;0;3
292;26.11.2016;2016;11;06;Lauantai;3;2;5;0;3;3
292;26.11.2016;2016;11;07;Lauantai;2;4;6;1;3;4
292;26.11.2016;2016;11;08;Lauantai;1;5;6;11;5;16
292;26.11.2016;2016;11;09;Lauantai;3;6;9;7;3;10
292;26.11.2016;2016;11;10;Lauantai;6;11;17;7;12;19
292;26.11.2016;2016;11;11;Lauantai;10;17;27;17;14;31
292;26.11.2016;2016;11;12;Lauantai;14;14;28;17;12;29
292;26.11.2016;2016;11;13;Lauantai;11;11;22;10;21;31
292;26.11.2016;2016;11;14;Lauantai;11;8;19;9;11;20
292;26.11.2016;2016;11;15;Lauantai;12;10;22;23;15;38
292;26.11.2016;2016;11;16;Lauantai;11;6;17;13;14;27
292;26.11.2016;2016;11;17;Lauantai;5;5;10;9;8;17
292;26.11.2016;2016;11;18;Lauantai;8;6;14;16;7;23
292;26.11.2016;2016;11;19;Lauantai;6;6;12;8;13;21
292;26.11.2016;2016;11;20;Lauantai;4;6;10;8;9;17
292;26.11.2016;2016;11;21;Lauantai;4;4;8;2;4;6
292;26.11.2016;2016;11;22;Lauantai;3;3;6;0;1;1
292;26.11.2016;2016;11;23;Lauantai;4;4;8;3;0;3
292;27.11.2016;2016;11;00;Sunnuntai;0;0;0;3;3;6
292;27.11.2016;2016;11;01;Sunnuntai;1;1;2;4;1;5
292;27.11.2016;2016;11;02;Sunnuntai;0;2;2;1;2;3
292;27.11.2016;2016;11;03;Sunnuntai;0;0;0;0;1;1
292;27.11.2016;2016;11;04;Sunnuntai;0;0;0;0;0;0
292;27.11.2016;2016;11;05;Sunnuntai;1;0;1;1;0;1
292;27.11.2016;2016;11;06;Sunnuntai;2;2;4;1;2;3
292;27.11.2016;2016;11;07;Sunnuntai;0;2;2;0;2;2
292;27.11.2016;2016;11;08;Sunnuntai;0;1;1;4;0;4
292;27.11.2016;2016;11;09;Sunnuntai;7;4;11;11;1;12
292;27.11.2016;2016;11;10;Sunnuntai;4;2;6;5;8;13
292;27.11.2016;2016;11;11;Sunnuntai;2;8;10;4;1;5
292;27.11.2016;2016;11;12;Sunnuntai;7;17;24;8;16;24
292;27.11.2016;2016;11;13;Sunnuntai;11;11;22;13;14;27
292;27.11.2016;2016;11;14;Sunnuntai;9;8;17;12;11;23
292;27.11.2016;2016;11;15;Sunnuntai;8;11;19;14;10;24
292;27.11.2016;2016;11;16;Sunnuntai;7;10;17;19;12;31
292;27.11.2016;2016;11;17;Sunnuntai;12;4;16;14;9;23
292;27.11.2016;2016;11;18;Sunnuntai;5;6;11;10;17;27
292;27.11.2016;2016;11;19;Sunnuntai;10;11;21;18;11;29
292;27.11.2016;2016;11;20;Sunnuntai;6;7;13;7;5;12
292;27.11.2016;2016;11;21;Sunnuntai;4;1;5;3;3;6
292;27.11.2016;2016;11;22;Sunnuntai;0;2;2;2;1;3
292;27.11.2016;2016;11;23;Sunnuntai;1;0;1;0;0;0
292;28.11.2016;2016;11;00;Maanantai;0;0;0;0;0;0
292;28.11.2016;2016;11;01;Maanantai;0;0;0;0;0;0
292;28.11.2016;2016;11;02;Maanantai;0;2;2;0;0;0
292;28.11.2016;2016;11;03;Maanantai;0;0;0;0;0;0
292;28.11.2016;2016;11;04;Maanantai;2;1;3;0;0;0
292;28.11.2016;2016;11;05;Maanantai;3;4;7;2;0;2
292;28.11.2016;2016;11;06;Maanantai;13;10;23;2;4;6
292;28.11.2016;2016;11;07;Maanantai;47;18;65;18;19;37
292;28.11.2016;2016;11;08;Maanantai;38;18;56;21;13;34
292;28.11.2016;2016;11;09;Maanantai;17;16;33;6;11;17
292;28.11.2016;2016;11;10;Maanantai;16;20;36;7;15;22
292;28.11.2016;2016;11;11;Maanantai;8;18;26;18;21;39
292;28.11.2016;2016;11;12;Maanantai;8;19;27;19;18;37
292;28.11.2016;2016;11;13;Maanantai;9;22;31;19;15;34
292;28.11.2016;2016;11;14;Maanantai;22;30;52;11;14;25
292;28.11.2016;2016;11;15;Maanantai;27;40;67;12;24;36
292;28.11.2016;2016;11;16;Maanantai;29;26;55;23;27;50
292;28.11.2016;2016;11;17;Maanantai;15;14;29;11;6;17
292;28.11.2016;2016;11;18;Maanantai;21;11;32;21;17;38
292;28.11.2016;2016;11;19;Maanantai;9;10;19;3;12;15
292;28.11.2016;2016;11;20;Maanantai;9;8;17;7;4;11
292;28.11.2016;2016;11;21;Maanantai;3;8;11;2;2;4
292;28.11.2016;2016;11;22;Maanantai;0;1;1;0;0;0
292;28.11.2016;2016;11;23;Maanantai;0;1;1;0;0;0
292;29.11.2016;2016;11;00;Tiistai;0;0;0;0;0;0
292;29.11.2016;2016;11;01;Tiistai;1;1;2;0;1;1
292;29.11.2016;2016;11;02;Tiistai;0;0;0;0;0;0
292;29.11.2016;2016;11;03;Tiistai;0;0;0;0;0;0
292;29.11.2016;2016;11;04;Tiistai;1;0;1;0;1;1
292;29.11.2016;2016;11;05;Tiistai;5;6;11;2;0;2
292;29.11.2016;2016;11;06;Tiistai;17;10;27;5;3;8
292;29.11.2016;2016;11;07;Tiistai;56;21;77;14;20;34
292;29.11.2016;2016;11;08;Tiistai;36;21;57;22;18;40
292;29.11.2016;2016;11;09;Tiistai;16;13;29;7;9;16
292;29.11.2016;2016;11;10;Tiistai;16;12;28;7;12;19
292;29.11.2016;2016;11;11;Tiistai;13;21;34;14;13;27
292;29.11.2016;2016;11;12;Tiistai;20;19;39;6;12;18
292;29.11.2016;2016;11;13;Tiistai;14;19;33;16;10;26
292;29.11.2016;2016;11;14;Tiistai;16;38;54;19;24;43
292;29.11.2016;2016;11;15;Tiistai;28;28;56;20;22;42
292;29.11.2016;2016;11;16;Tiistai;25;23;48;13;14;27
292;29.11.2016;2016;11;17;Tiistai;13;20;33;14;13;27
292;29.11.2016;2016;11;18;Tiistai;16;11;27;19;9;28
292;29.11.2016;2016;11;19;Tiistai;3;10;13;19;11;30
292;29.11.2016;2016;11;20;Tiistai;6;6;12;12;10;22
292;29.11.2016;2016;11;21;Tiistai;0;2;2;5;8;13
292;29.11.2016;2016;11;22;Tiistai;2;1;3;0;0;0
292;29.11.2016;2016;11;23;Tiistai;0;0;0;1;0;1
292;30.11.2016;2016;11;00;Keskiviikko;0;0;0;0;0;0
292;30.11.2016;2016;11;01;Keskiviikko;0;0;0;0;0;0
292;30.11.2016;2016;11;02;Keskiviikko;0;0;0;0;0;0
292;30.11.2016;2016;11;03;Keskiviikko;0;2;2;8;4;12
292;30.11.2016;2016;11;04;Keskiviikko;2;1;3;0;0;0
292;30.11.2016;2016;11;05;Keskiviikko;3;8;11;3;1;4
292;30.11.2016;2016;11;06;Keskiviikko;12;9;21;4;5;9
292;30.11.2016;2016;11;07;Keskiviikko;53;15;68;23;20;43
292;30.11.2016;2016;11;08;Keskiviikko;36;22;58;12;16;28
292;30.11.2016;2016;11;09;Keskiviikko;18;11;29;10;12;22
292;30.11.2016;2016;11;10;Keskiviikko;14;10;24;11;14;25
292;30.11.2016;2016;11;11;Keskiviikko;15;16;31;22;23;45
292;30.11.2016;2016;11;12;Keskiviikko;23;19;42;15;19;34
292;30.11.2016;2016;11;13;Keskiviikko;14;39;53;18;26;44
292;30.11.2016;2016;11;14;Keskiviikko;25;28;53;14;25;39
292;30.11.2016;2016;11;15;Keskiviikko;16;31;47;17;34;51
292;30.11.2016;2016;11;16;Keskiviikko;29;22;51;19;18;37
292;30.11.2016;2016;11;17;Keskiviikko;14;14;28;13;11;24
292;30.11.2016;2016;11;18;Keskiviikko;14;6;20;22;14;36
292;30.11.2016;2016;11;19;Keskiviikko;4;6;10;17;19;36
292;30.11.2016;2016;11;20;Keskiviikko;7;7;14;18;15;33
292;30.11.2016;2016;11;21;Keskiviikko;5;1;6;5;5;10
292;30.11.2016;2016;11;22;Keskiviikko;2;3;5;2;0;2
292;30.11.2016;2016;11;23;Keskiviikko;3;0;3;0;0;0
292;01.12.2016;2016;12;00;Torstai;0;1;1;1;0;1
292;01.12.2016;2016;12;01;Torstai;0;0;0;0;0;0
292;01.12.2016;2016;12;02;Torstai;0;0;0;0;0;0
292;01.12.2016;2016;12;03;Torstai;0;0;0;0;0;0
292;01.12.2016;2016;12;04;Torstai;2;0;2;0;0;0
292;01.12.2016;2016;12;05;Torstai;4;7;11;12;5;17
292;01.12.2016;2016;12;06;Torstai;16;13;29;1;6;7
292;01.12.2016;2016;12;07;Torstai;37;17;54;13;21;34
292;01.12.2016;2016;12;08;Torstai;31;20;51;11;15;26
292;01.12.2016;2016;12;09;Torstai;41;18;59;19;17;36
292;01.12.2016;2016;12;10;Torstai;21;9;30;12;12;24
292;01.12.2016;2016;12;11;Torstai;15;5;20;12;10;22
292;01.12.2016;2016;12;12;Torstai;19;13;32;23;25;48
292;01.12.2016;2016;12;13;Torstai;18;17;35;9;21;30
292;01.12.2016;2016;12;14;Torstai;22;35;57;18;32;50
292;01.12.2016;2016;12;15;Torstai;26;40;66;27;42;69
292;01.12.2016;2016;12;16;Torstai;20;42;62;15;27;42
292;01.12.2016;2016;12;17;Torstai;11;18;29;19;15;34
292;01.12.2016;2016;12;18;Torstai;14;10;24;28;20;48
292;01.12.2016;2016;12;19;Torstai;11;5;16;20;13;33
292;01.12.2016;2016;12;20;Torstai;9;5;14;9;3;12
292;01.12.2016;2016;12;21;Torstai;7;5;12;4;7;11
292;01.12.2016;2016;12;22;Torstai;3;6;9;1;1;2
292;01.12.2016;2016;12;23;Torstai;0;1;1;1;0;1
292;02.12.2016;2016;12;00;Perjantai;0;0;0;0;0;0
292;02.12.2016;2016;12;01;Perjantai;1;2;3;2;0;2
292;02.12.2016;2016;12;02;Perjantai;0;1;1;0;0;0
292;02.12.2016;2016;12;03;Perjantai;0;0;0;0;0;0
292;02.12.2016;2016;12;04;Perjantai;0;0;0;0;0;0
292;02.12.2016;2016;12;05;Perjantai;4;8;12;3;0;3
292;02.12.2016;2016;12;06;Perjantai;16;3;19;4;5;9
292;02.12.2016;2016;12;07;Perjantai;51;20;71;22;16;38
292;02.12.2016;2016;12;08;Perjantai;44;14;58;19;24;43
292;02.12.2016;2016;12;09;Perjantai;24;10;34;17;16;33
292;02.12.2016;2016;12;10;Perjantai;14;5;19;9;11;20
292;02.12.2016;2016;12;11;Perjantai;14;12;26;12;18;30
292;02.12.2016;2016;12;12;Perjantai;20;19;39;19;28;47
292;02.12.2016;2016;12;13;Perjantai;14;44;58;27;38;65
292;02.12.2016;2016;12;14;Perjantai;18;48;66;11;37;48
292;02.12.2016;2016;12;15;Perjantai;18;27;45;20;15;35
292;02.12.2016;2016;12;16;Perjantai;21;22;43;22;14;36
292;02.12.2016;2016;12;17;Perjantai;11;20;31;7;7;14
292;02.12.2016;2016;12;18;Perjantai;9;6;15;19;15;34
292;02.12.2016;2016;12;19;Perjantai;6;9;15;14;5;19
292;02.12.2016;2016;12;20;Perjantai;10;5;15;11;8;19
292;02.12.2016;2016;12;21;Perjantai;3;8;11;10;6;16
292;02.12.2016;2016;12;22;Perjantai;3;1;4;5;3;8
292;02.12.2016;2016;12;23;Perjantai;0;1;1;1;0;1
292;03.12.2016;2016;12;00;Lauantai;0;0;0;3;1;4
292;03.12.2016;2016;12;01;Lauantai;0;2;2;0;0;0
292;03.12.2016;2016;12;02;Lauantai;0;0;0;1;4;5
292;03.12.2016;2016;12;03;Lauantai;0;0;0;0;1;1
292;03.12.2016;2016;12;04;Lauantai;1;1;2;2;1;3
292;03.12.2016;2016;12;05;Lauantai;2;1;3;1;0;1
292;03.12.2016;2016;12;06;Lauantai;2;1;3;2;2;4
292;03.12.2016;2016;12;07;Lauantai;1;1;2;7;5;12
292;03.12.2016;2016;12;08;Lauantai;2;5;7;2;6;8
292;03.12.2016;2016;12;09;Lauantai;3;7;10;4;11;15
292;03.12.2016;2016;12;10;Lauantai;3;8;11;8;9;17
292;03.12.2016;2016;12;11;Lauantai;7;6;13;13;7;20
292;03.12.2016;2016;12;12;Lauantai;6;4;10;17;7;24
292;03.12.2016;2016;12;13;Lauantai;6;12;18;11;19;30
292;03.12.2016;2016;12;14;Lauantai;6;14;20;12;17;29
292;03.12.2016;2016;12;15;Lauantai;6;12;18;11;10;21
292;03.12.2016;2016;12;16;Lauantai;9;3;12;14;9;23
292;03.12.2016;2016;12;17;Lauantai;8;5;13;9;2;11
292;03.12.2016;2016;12;18;Lauantai;6;3;9;12;5;17
292;03.12.2016;2016;12;19;Lauantai;4;5;9;12;6;18
292;03.12.2016;2016;12;20;Lauantai;4;2;6;7;3;10
292;03.12.2016;2016;12;21;Lauantai;2;3;5;7;11;18
292;03.12.2016;2016;12;22;Lauantai;2;0;2;3;0;3
292;03.12.2016;2016;12;23;Lauantai;0;5;5;4;0;4
292;04.12.2016;2016;12;00;Sunnuntai;2;2;4;5;0;5
292;04.12.2016;2016;12;01;Sunnuntai;1;0;1;0;7;7
292;04.12.2016;2016;12;02;Sunnuntai;1;2;3;5;5;10
292;04.12.2016;2016;12;03;Sunnuntai;1;0;1;1;6;7
292;04.12.2016;2016;12;04;Sunnuntai;0;1;1;1;1;2
292;04.12.2016;2016;12;05;Sunnuntai;2;0;2;0;0;0
292;04.12.2016;2016;12;06;Sunnuntai;2;0;2;0;0;0
292;04.12.2016;2016;12;07;Sunnuntai;0;0;0;0;2;2
292;04.12.2016;2016;12;08;Sunnuntai;0;0;0;4;2;6
292;04.12.2016;2016;12;09;Sunnuntai;2;0;2;3;1;4
292;04.12.2016;2016;12;10;Sunnuntai;6;4;10;4;8;12
292;04.12.2016;2016;12;11;Sunnuntai;1;5;6;4;8;12
292;04.12.2016;2016;12;12;Sunnuntai;4;6;10;8;10;18
292;04.12.2016;2016;12;13;Sunnuntai;12;9;21;16;8;24
292;04.12.2016;2016;12;14;Sunnuntai;6;6;12;11;10;21
292;04.12.2016;2016;12;15;Sunnuntai;11;4;15;6;4;10
292;04.12.2016;2016;12;16;Sunnuntai;5;7;12;7;7;14
292;04.12.2016;2016;12;17;Sunnuntai;6;3;9;10;5;15
292;04.12.2016;2016;12;18;Sunnuntai;3;2;5;13;6;19
292;04.12.2016;2016;12;19;Sunnuntai;1;2;3;5;7;12
292;04.12.2016;2016;12;20;Sunnuntai;2;4;6;6;6;12
292;04.12.2016;2016;12;21;Sunnuntai;1;3;4;4;4;8
292;04.12.2016;2016;12;22;Sunnuntai;2;1;3;0;4;4
292;04.12.2016;2016;12;23;Sunnuntai;4;0;4;3;1;4
292;05.12.2016;2016;12;00;Maanantai;1;1;2;3;3;6
292;05.12.2016;2016;12;01;Maanantai;0;0;0;0;0;0
292;05.12.2016;2016;12;02;Maanantai;2;1;3;11;4;15
292;05.12.2016;2016;12;03;Maanantai;0;0;0;0;0;0
292;05.12.2016;2016;12;04;Maanantai;2;0;2;1;1;2
292;05.12.2016;2016;12;05;Maanantai;1;4;5;5;0;5
292;05.12.2016;2016;12;06;Maanantai;7;4;11;0;4;4
292;05.12.2016;2016;12;07;Maanantai;17;6;23;20;18;38
292;05.12.2016;2016;12;08;Maanantai;24;12;36;12;11;23
292;05.12.2016;2016;12;09;Maanantai;24;12;36;14;7;21
292;05.12.2016;2016;12;10;Maanantai;9;9;18;16;7;23
292;05.12.2016;2016;12;11;Maanantai;12;10;22;11;17;28
292;05.12.2016;2016;12;12;Maanantai;9;7;16;7;15;22
292;05.12.2016;2016;12;13;Maanantai;10;18;28;23;17;40
292;05.12.2016;2016;12;14;Maanantai;11;41;52;8;11;19
292;05.12.2016;2016;12;15;Maanantai;18;23;41;14;12;26
292;05.12.2016;2016;12;16;Maanantai;12;14;26;11;6;17
292;05.12.2016;2016;12;17;Maanantai;7;8;15;6;10;16
292;05.12.2016;2016;12;18;Maanantai;9;4;13;9;13;22
292;05.12.2016;2016;12;19;Maanantai;6;9;15;18;12;30
292;05.12.2016;2016;12;20;Maanantai;6;7;13;7;10;17
292;05.12.2016;2016;12;21;Maanantai;4;13;17;10;4;14
292;05.12.2016;2016;12;22;Maanantai;2;0;2;1;1;2
292;05.12.2016;2016;12;23;Maanantai;1;3;4;3;1;4
292;06.12.2016;2016;12;00;Tiistai;1;2;3;0;2;2
292;06.12.2016;2016;12;01;Tiistai;1;1;2;0;1;1
292;06.12.2016;2016;12;02;Tiistai;0;0;0;0;1;1
292;06.12.2016;2016;12;03;Tiistai;0;0;0;1;3;4
292;06.12.2016;2016;12;04;Tiistai;0;0;0;0;2;2
292;06.12.2016;2016;12;05;Tiistai;0;1;1;2;0;2
292;06.12.2016;2016;12;06;Tiistai;0;0;0;1;2;3
292;06.12.2016;2016;12;07;Tiistai;0;1;1;1;2;3
292;06.12.2016;2016;12;08;Tiistai;0;0;0;2;2;4
292;06.12.2016;2016;12;09;Tiistai;0;1;1;3;5;8
292;06.12.2016;2016;12;10;Tiistai;1;1;2;6;9;15
292;06.12.2016;2016;12;11;Tiistai;1;1;2;10;5;15
292;06.12.2016;2016;12;12;Tiistai;4;5;9;12;9;21
292;06.12.2016;2016;12;13;Tiistai;2;3;5;9;6;15
292;06.12.2016;2016;12;14;Tiistai;1;1;2;6;9;15
292;06.12.2016;2016;12;15;Tiistai;6;3;9;6;7;13
292;06.12.2016;2016;12;16;Tiistai;6;2;8;8;8;16
292;06.12.2016;2016;12;17;Tiistai;1;2;3;8;7;15
292;06.12.2016;2016;12;18;Tiistai;1;2;3;9;13;22
292;06.12.2016;2016;12;19;Tiistai;1;2;3;3;2;5
292;06.12.2016;2016;12;20;Tiistai;1;0;1;4;0;4
292;06.12.2016;2016;12;21;Tiistai;2;2;4;3;4;7
292;06.12.2016;2016;12;22;Tiistai;0;0;0;2;1;3
292;06.12.2016;2016;12;23;Tiistai;1;0;1;2;2;4
292;07.12.2016;2016;12;00;Keskiviikko;0;0;0;0;0;0
292;07.12.2016;2016;12;01;Keskiviikko;0;0;0;0;0;0
292;07.12.2016;2016;12;02;Keskiviikko;0;0;0;0;0;0
292;07.12.2016;2016;12;03;Keskiviikko;0;0;0;1;1;2
292;07.12.2016;2016;12;04;Keskiviikko;2;0;2;0;0;0
292;07.12.2016;2016;12;05;Keskiviikko;3;1;4;1;1;2
292;07.12.2016;2016;12;06;Keskiviikko;10;6;16;4;2;6
292;07.12.2016;2016;12;07;Keskiviikko;58;18;76;20;17;37
292;07.12.2016;2016;12;08;Keskiviikko;43;24;67;15;18;33
292;07.12.2016;2016;12;09;Keskiviikko;25;13;38;7;10;17
292;07.12.2016;2016;12;10;Keskiviikko;9;11;20;11;15;26
292;07.12.2016;2016;12;11;Keskiviikko;16;12;28;14;16;30
292;07.12.2016;2016;12;12;Keskiviikko;10;15;25;29;19;48
292;07.12.2016;2016;12;13;Keskiviikko;16;47;63;17;40;57
292;07.12.2016;2016;12;14;Keskiviikko;18;34;52;19;42;61
292;07.12.2016;2016;12;15;Keskiviikko;22;25;47;18;32;50
292;07.12.2016;2016;12;16;Keskiviikko;16;27;43;29;18;47
292;07.12.2016;2016;12;17;Keskiviikko;11;10;21;18;10;28
292;07.12.2016;2016;12;18;Keskiviikko;17;8;25;19;15;34
292;07.12.2016;2016;12;19;Keskiviikko;8;15;23;18;16;34
292;07.12.2016;2016;12;20;Keskiviikko;5;4;9;8;17;25
292;07.12.2016;2016;12;21;Keskiviikko;2;4;6;5;2;7
292;07.12.2016;2016;12;22;Keskiviikko;1;4;5;2;1;3
292;07.12.2016;2016;12;23;Keskiviikko;1;1;2;2;1;3
292;08.12.2016;2016;12;00;Torstai;0;0;0;1;0;1
292;08.12.2016;2016;12;01;Torstai;1;0;1;0;1;1
292;08.12.2016;2016;12;02;Torstai;0;1;1;0;1;1
292;08.12.2016;2016;12;03;Torstai;0;0;0;0;0;0
292;08.12.2016;2016;12;04;Torstai;3;1;4;1;0;1
292;08.12.2016;2016;12;05;Torstai;2;4;6;3;1;4
292;08.12.2016;2016;12;06;Torstai;13;5;18;3;4;7
292;08.12.2016;2016;12;07;Torstai;38;13;51;23;12;35
292;08.12.2016;2016;12;08;Torstai;28;25;53;24;21;45
292;08.12.2016;2016;12;09;Torstai;43;9;52;15;9;24
292;08.12.2016;2016;12;10;Torstai;29;6;35;31;11;42
292;08.12.2016;2016;12;11;Torstai;18;11;29;11;19;30
292;08.12.2016;2016;12;12;Torstai;20;9;29;16;21;37
292;08.12.2016;2016;12;13;Torstai;12;11;23;12;20;32
292;08.12.2016;2016;12;14;Torstai;12;19;31;12;35;47
292;08.12.2016;2016;12;15;Torstai;18;44;62;20;44;64
292;08.12.2016;2016;12;16;Torstai;22;33;55;16;36;52
292;08.12.2016;2016;12;17;Torstai;16;15;31;21;14;35
292;08.12.2016;2016;12;18;Torstai;10;7;17;7;15;22
292;08.12.2016;2016;12;19;Torstai;12;9;21;17;7;24
292;08.12.2016;2016;12;20;Torstai;14;14;28;13;12;25
292;08.12.2016;2016;12;21;Torstai;6;5;11;2;6;8
292;08.12.2016;2016;12;22;Torstai;0;9;9;2;1;3
292;08.12.2016;2016;12;23;Torstai;1;0;1;0;0;0
292;09.12.2016;2016;12;00;Perjantai;0;0;0;0;0;0
292;09.12.2016;2016;12;01;Perjantai;0;0;0;0;0;0
292;09.12.2016;2016;12;02;Perjantai;0;2;2;1;0;1
292;09.12.2016;2016;12;03;Perjantai;0;0;0;0;0;0
292;09.12.2016;2016;12;04;Perjantai;2;0;2;0;0;0
292;09.12.2016;2016;12;05;Perjantai;3;2;5;3;2;5
292;09.12.2016;2016;12;06;Perjantai;14;4;18;4;8;12
292;09.12.2016;2016;12;07;Perjantai;45;7;52;20;28;48
292;09.12.2016;2016;12;08;Perjantai;39;13;52;21;22;43
292;09.12.2016;2016;12;09;Perjantai;26;11;37;15;10;25
292;09.12.2016;2016;12;10;Perjantai;9;9;18;10;15;25
292;09.12.2016;2016;12;11;Perjantai;14;14;28;15;16;31
292;09.12.2016;2016;12;12;Perjantai;16;11;27;17;19;36
292;09.12.2016;2016;12;13;Perjantai;11;48;59;16;29;45
292;09.12.2016;2016;12;14;Perjantai;14;45;59;19;33;52
292;09.12.2016;2016;12;15;Perjantai;18;25;43;27;29;56
292;09.12.2016;2016;12;16;Perjantai;13;13;26;16;27;43
292;09.12.2016;2016;12;17;Perjantai;8;6;14;13;16;29
292;09.12.2016;2016;12;18;Perjantai;4;3;7;10;12;22
292;09.12.2016;2016;12;19;Perjantai;11;2;13;9;14;23
292;09.12.2016;2016;12;20;Perjantai;9;5;14;17;5;22
292;09.12.2016;2016;12;21;Perjantai;2;4;6;3;3;6
292;09.12.2016;2016;12;22;Perjantai;3;2;5;9;7;16
292;09.12.2016;2016;12;23;Perjantai;2;0;2;1;9;10
292;10.12.2016;2016;12;00;Lauantai;0;1;1;4;0;4
292;10.12.2016;2016;12;01;Lauantai;0;2;2;3;3;6
292;10.12.2016;2016;12;02;Lauantai;0;0;0;1;4;5
292;10.12.2016;2016;12;03;Lauantai;1;0;1;0;0;0
292;10.12.2016;2016;12;04;Lauantai;1;0;1;1;1;2
292;10.12.2016;2016;12;05;Lauantai;1;0;1;1;1;2
292;10.12.2016;2016;12;06;Lauantai;3;1;4;0;2;2
292;10.12.2016;2016;12;07;Lauantai;0;1;1;2;4;6
292;10.12.2016;2016;12;08;Lauantai;1;3;4;8;6;14
292;10.12.2016;2016;12;09;Lauantai;5;3;8;2;6;8
292;10.12.2016;2016;12;10;Lauantai;4;6;10;9;12;21
292;10.12.2016;2016;12;11;Lauantai;7;7;14;15;12;27
292;10.12.2016;2016;12;12;Lauantai;7;12;19;12;18;30
292;10.12.2016;2016;12;13;Lauantai;9;6;15;19;17;36
292;10.12.2016;2016;12;14;Lauantai;5;17;22;15;13;28
292;10.12.2016;2016;12;15;Lauantai;9;6;15;12;10;22
292;10.12.2016;2016;12;16;Lauantai;7;6;13;14;11;25
292;10.12.2016;2016;12;17;Lauantai;7;3;10;11;11;22
292;10.12.2016;2016;12;18;Lauantai;14;6;20;16;14;30
292;10.12.2016;2016;12;19;Lauantai;4;4;8;21;16;37
292;10.12.2016;2016;12;20;Lauantai;2;4;6;8;7;15
292;10.12.2016;2016;12;21;Lauantai;4;6;10;5;11;16
292;10.12.2016;2016;12;22;Lauantai;3;2;5;3;4;7
292;10.12.2016;2016;12;23;Lauantai;2;4;6;4;6;10
292;11.12.2016;2016;12;00;Sunnuntai;2;0;2;2;3;5
292;11.12.2016;2016;12;01;Sunnuntai;0;0;0;5;1;6
292;11.12.2016;2016;12;02;Sunnuntai;0;1;1;2;3;5
292;11.12.2016;2016;12;03;Sunnuntai;0;0;0;1;8;9
292;11.12.2016;2016;12;04;Sunnuntai;0;0;0;1;0;1
292;11.12.2016;2016;12;05;Sunnuntai;1;0;1;0;0;0
292;11.12.2016;2016;12;06;Sunnuntai;3;0;3;1;0;1
292;11.12.2016;2016;12;07;Sunnuntai;0;1;1;3;1;4
292;11.12.2016;2016;12;08;Sunnuntai;0;2;2;2;7;9
292;11.12.2016;2016;12;09;Sunnuntai;2;1;3;9;8;17
292;11.12.2016;2016;12;10;Sunnuntai;4;2;6;6;6;12
292;11.12.2016;2016;12;11;Sunnuntai;4;5;9;20;16;36
292;11.12.2016;2016;12;12;Sunnuntai;6;7;13;12;17;29
292;11.12.2016;2016;12;13;Sunnuntai;7;7;14;16;22;38
292;11.12.2016;2016;12;14;Sunnuntai;2;6;8;9;9;18
292;11.12.2016;2016;12;15;Sunnuntai;7;6;13;12;5;17
292;11.12.2016;2016;12;16;Sunnuntai;3;1;4;12;11;23
292;11.12.2016;2016;12;17;Sunnuntai;2;5;7;13;6;19
292;11.12.2016;2016;12;18;Sunnuntai;7;6;13;8;8;16
292;11.12.2016;2016;12;19;Sunnuntai;2;4;6;11;7;18
292;11.12.2016;2016;12;20;Sunnuntai;3;3;6;7;10;17
292;11.12.2016;2016;12;21;Sunnuntai;3;2;5;3;3;6
292;11.12.2016;2016;12;22;Sunnuntai;1;1;2;1;4;5
292;11.12.2016;2016;12;23;Sunnuntai;0;0;0;0;0;0
292;12.12.2016;2016;12;00;Maanantai;0;0;0;0;0;0
292;12.12.2016;2016;12;01;Maanantai;0;0;0;0;0;0
292;12.12.2016;2016;12;02;Maanantai;0;0;0;0;0;0
292;12.12.2016;2016;12;03;Maanantai;0;0;0;0;0;0
292;12.12.2016;2016;12;04;Maanantai;0;0;0;0;0;0
292;12.12.2016;2016;12;05;Maanantai;5;1;6;4;2;6
292;12.12.2016;2016;12;06;Maanantai;8;5;13;5;5;10
292;12.12.2016;2016;12;07;Maanantai;30;17;47;21;19;40
292;12.12.2016;2016;12;08;Maanantai;30;13;43;19;19;38
292;12.12.2016;2016;12;09;Maanantai;37;7;44;13;14;27
292;12.12.2016;2016;12;10;Maanantai;9;5;14;13;9;22
292;12.12.2016;2016;12;11;Maanantai;7;9;16;14;13;27
292;12.12.2016;2016;12;12;Maanantai;11;10;21;13;15;28
292;12.12.2016;2016;12;13;Maanantai;12;16;28;18;14;32
292;12.12.2016;2016;12;14;Maanantai;15;22;37;19;29;48
292;12.12.2016;2016;12;15;Maanantai;13;32;45;14;30;44
292;12.12.2016;2016;12;16;Maanantai;17;34;51;19;18;37
292;12.12.2016;2016;12;17;Maanantai;7;9;16;13;15;28
292;12.12.2016;2016;12;18;Maanantai;1;4;5;9;15;24
292;12.12.2016;2016;12;19;Maanantai;7;2;9;16;5;21
292;12.12.2016;2016;12;20;Maanantai;4;3;7;4;3;7
292;12.12.2016;2016;12;21;Maanantai;1;5;6;2;4;6
292;12.12.2016;2016;12;22;Maanantai;0;1;1;1;0;1
292;12.12.2016;2016;12;23;Maanantai;0;0;0;0;1;1
292;13.12.2016;2016;12;00;Tiistai;0;0;0;1;0;1
292;13.12.2016;2016;12;01;Tiistai;0;1;1;0;0;0
292;13.12.2016;2016;12;02;Tiistai;0;0;0;0;0;0
292;13.12.2016;2016;12;03;Tiistai;0;0;0;0;0;0
292;13.12.2016;2016;12;04;Tiistai;1;0;1;0;0;0
292;13.12.2016;2016;12;05;Tiistai;7;3;10;5;3;8
292;13.12.2016;2016;12;06;Tiistai;9;6;15;7;9;16
292;13.12.2016;2016;12;07;Tiistai;39;11;50;30;19;49
292;13.12.2016;2016;12;08;Tiistai;40;19;59;23;27;50
292;13.12.2016;2016;12;09;Tiistai;23;10;33;14;14;28
292;13.12.2016;2016;12;10;Tiistai;12;4;16;11;12;23
292;13.12.2016;2016;12;11;Tiistai;9;8;17;11;15;26
292;13.12.2016;2016;12;12;Tiistai;8;13;21;16;14;30
292;13.12.2016;2016;12;13;Tiistai;14;20;34;22;21;43
292;13.12.2016;2016;12;14;Tiistai;14;38;52;20;28;48
292;13.12.2016;2016;12;15;Tiistai;16;30;46;21;30;51
292;13.12.2016;2016;12;16;Tiistai;25;20;45;8;28;36
292;13.12.2016;2016;12;17;Tiistai;14;21;35;25;15;40
292;13.12.2016;2016;12;18;Tiistai;11;12;23;15;19;34
292;13.12.2016;2016;12;19;Tiistai;10;9;19;15;11;26
292;13.12.2016;2016;12;20;Tiistai;10;5;15;6;15;21
292;13.12.2016;2016;12;21;Tiistai;5;4;9;4;3;7
292;13.12.2016;2016;12;22;Tiistai;0;0;0;3;2;5
292;13.12.2016;2016;12;23;Tiistai;1;0;1;1;1;2
292;14.12.2016;2016;12;00;Keskiviikko;1;0;1;0;1;1
292;14.12.2016;2016;12;01;Keskiviikko;0;1;1;0;1;1
292;14.12.2016;2016;12;02;Keskiviikko;0;1;1;0;0;0
292;14.12.2016;2016;12;03;Keskiviikko;0;0;0;0;1;1
292;14.12.2016;2016;12;04;Keskiviikko;2;0;2;1;0;1
292;14.12.2016;2016;12;05;Keskiviikko;5;5;10;4;2;6
292;14.12.2016;2016;12;06;Keskiviikko;6;11;17;6;7;13
292;14.12.2016;2016;12;07;Keskiviikko;54;19;73;30;14;44
292;14.12.2016;2016;12;08;Keskiviikko;34;13;47;20;27;47
292;14.12.2016;2016;12;09;Keskiviikko;14;15;29;16;17;33
292;14.12.2016;2016;12;10;Keskiviikko;14;6;20;14;16;30
292;14.12.2016;2016;12;11;Keskiviikko;13;16;29;9;11;20
292;14.12.2016;2016;12;12;Keskiviikko;15;13;28;24;9;33
292;14.12.2016;2016;12;13;Keskiviikko;14;30;44;29;26;55
292;14.12.2016;2016;12;14;Keskiviikko;16;50;66;18;31;49
292;14.12.2016;2016;12;15;Keskiviikko;23;25;48;17;19;36
292;14.12.2016;2016;12;16;Keskiviikko;21;23;44;24;21;45
292;14.12.2016;2016;12;17;Keskiviikko;13;10;23;17;13;30
292;14.12.2016;2016;12;18;Keskiviikko;7;7;14;11;9;20
292;14.12.2016;2016;12;19;Keskiviikko;6;4;10;16;11;27
292;14.12.2016;2016;12;20;Keskiviikko;9;12;21;9;3;12
292;14.12.2016;2016;12;21;Keskiviikko;4;3;7;4;9;13
292;14.12.2016;2016;12;22;Keskiviikko;0;3;3;2;2;4
292;14.12.2016;2016;12;23;Keskiviikko;0;1;1;0;0;0
292;15.12.2016;2016;12;00;Torstai;0;0;0;0;0;0
292;15.12.2016;2016;12;01;Torstai;0;0;0;0;0;0
292;15.12.2016;2016;12;02;Torstai;0;1;1;0;0;0
292;15.12.2016;2016;12;03;Torstai;0;0;0;0;0;0
292;15.12.2016;2016;12;04;Torstai;3;0;3;0;0;0
292;15.12.2016;2016;12;05;Torstai;1;2;3;5;3;8
292;15.12.2016;2016;12;06;Torstai;10;9;19;6;6;12
292;15.12.2016;2016;12;07;Torstai;49;17;66;20;12;32
292;15.12.2016;2016;12;08;Torstai;28;20;48;23;24;47
292;15.12.2016;2016;12;09;Torstai;34;14;48;20;19;39
292;15.12.2016;2016;12;10;Torstai;9;3;12;14;14;28
292;15.12.2016;2016;12;11;Torstai;13;13;26;10;10;20
292;15.12.2016;2016;12;12;Torstai;19;10;29;17;14;31
292;15.12.2016;2016;12;13;Torstai;16;12;28;14;14;28
292;15.12.2016;2016;12;14;Torstai;18;26;44;13;24;37
292;15.12.2016;2016;12;15;Torstai;23;51;74;18;25;43
292;15.12.2016;2016;12;16;Torstai;22;33;55;26;27;53
292;15.12.2016;2016;12;17;Torstai;12;17;29;14;10;24
292;15.12.2016;2016;12;18;Torstai;14;10;24;10;11;21
292;15.12.2016;2016;12;19;Torstai;7;12;19;12;9;21
292;15.12.2016;2016;12;20;Torstai;10;6;16;8;9;17
292;15.12.2016;2016;12;21;Torstai;8;3;11;6;3;9
292;15.12.2016;2016;12;22;Torstai;4;4;8;1;1;2
292;15.12.2016;2016;12;23;Torstai;0;1;1;1;1;2
292;16.12.2016;2016;12;00;Perjantai;0;0;0;0;0;0
292;16.12.2016;2016;12;01;Perjantai;1;1;2;0;0;0
292;16.12.2016;2016;12;02;Perjantai;1;0;1;0;0;0
292;16.12.2016;2016;12;03;Perjantai;1;0;1;0;0;0
292;16.12.2016;2016;12;04;Perjantai;1;0;1;0;0;0
292;16.12.2016;2016;12;05;Perjantai;2;5;7;8;5;13
292;16.12.2016;2016;12;06;Perjantai;13;7;20;6;7;13
292;16.12.2016;2016;12;07;Perjantai;50;17;67;18;7;25
292;16.12.2016;2016;12;08;Perjantai;45;14;59;13;20;33
292;16.12.2016;2016;12;09;Perjantai;15;10;25;15;16;31
292;16.12.2016;2016;12;10;Perjantai;13;7;20;10;21;31
292;16.12.2016;2016;12;11;Perjantai;11;7;18;18;18;36
292;16.12.2016;2016;12;12;Perjantai;13;19;32;23;18;41
292;16.12.2016;2016;12;13;Perjantai;16;38;54;15;29;44
292;16.12.2016;2016;12;14;Perjantai;18;35;53;17;29;46
292;16.12.2016;2016;12;15;Perjantai;13;23;36;10;20;30
292;16.12.2016;2016;12;16;Perjantai;19;18;37;13;19;32
292;16.12.2016;2016;12;17;Perjantai;9;8;17;7;11;18
292;16.12.2016;2016;12;18;Perjantai;15;5;20;12;17;29
292;16.12.2016;2016;12;19;Perjantai;15;5;20;25;12;37
292;16.12.2016;2016;12;20;Perjantai;5;8;13;12;10;22
292;16.12.2016;2016;12;21;Perjantai;7;5;12;8;7;15
292;16.12.2016;2016;12;22;Perjantai;4;2;6;6;1;7
292;16.12.2016;2016;12;23;Perjantai;0;7;7;1;6;7
292;17.12.2016;2016;12;00;Lauantai;3;0;3;6;4;10
292;17.12.2016;2016;12;01;Lauantai;0;0;0;3;6;9
292;17.12.2016;2016;12;02;Lauantai;1;0;1;0;1;1
292;17.12.2016;2016;12;03;Lauantai;1;0;1;0;8;8
292;17.12.2016;2016;12;04;Lauantai;0;0;0;0;1;1
292;17.12.2016;2016;12;05;Lauantai;1;0;1;1;0;1
292;17.12.2016;2016;12;06;Lauantai;0;1;1;3;1;4
292;17.12.2016;2016;12;07;Lauantai;0;0;0;10;6;16
292;17.12.2016;2016;12;08;Lauantai;2;4;6;7;3;10
292;17.12.2016;2016;12;09;Lauantai;5;5;10;11;7;18
292;17.12.2016;2016;12;10;Lauantai;3;2;5;9;11;20
292;17.12.2016;2016;12;11;Lauantai;7;13;20;18;15;33
292;17.12.2016;2016;12;12;Lauantai;8;14;22;14;17;31
292;17.12.2016;2016;12;13;Lauantai;7;7;14;12;7;19
292;17.12.2016;2016;12;14;Lauantai;10;8;18;9;6;15
292;17.12.2016;2016;12;15;Lauantai;8;7;15;9;10;19
292;17.12.2016;2016;12;16;Lauantai;5;6;11;14;9;23
292;17.12.2016;2016;12;17;Lauantai;12;10;22;11;6;17
292;17.12.2016;2016;12;18;Lauantai;8;9;17;5;4;9
292;17.12.2016;2016;12;19;Lauantai;8;11;19;6;7;13
292;17.12.2016;2016;12;20;Lauantai;6;5;11;3;3;6
292;17.12.2016;2016;12;21;Lauantai;5;3;8;2;4;6
292;17.12.2016;2016;12;22;Lauantai;3;2;5;0;3;3
292;17.12.2016;2016;12;23;Lauantai;2;2;4;1;0;1
292;18.12.2016;2016;12;00;Sunnuntai;2;4;6;2;2;4
292;18.12.2016;2016;12;01;Sunnuntai;0;2;2;2;2;4
292;18.12.2016;2016;12;02;Sunnuntai;1;1;2;3;4;7
292;18.12.2016;2016;12;03;Sunnuntai;1;0;1;0;3;3
292;18.12.2016;2016;12;04;Sunnuntai;0;1;1;3;1;4
292;18.12.2016;2016;12;05;Sunnuntai;3;0;3;4;0;4
292;18.12.2016;2016;12;06;Sunnuntai;4;1;5;2;1;3
292;18.12.2016;2016;12;07;Sunnuntai;2;0;2;2;1;3
292;18.12.2016;2016;12;08;Sunnuntai;0;3;3;2;3;5
292;18.12.2016;2016;12;09;Sunnuntai;8;7;15;15;6;21
292;18.12.2016;2016;12;10;Sunnuntai;3;3;6;12;11;23
292;18.12.2016;2016;12;11;Sunnuntai;3;12;15;5;16;21
292;18.12.2016;2016;12;12;Sunnuntai;6;10;16;22;13;35
292;18.12.2016;2016;12;13;Sunnuntai;4;7;11;19;7;26
292;18.12.2016;2016;12;14;Sunnuntai;9;12;21;20;8;28
292;18.12.2016;2016;12;15;Sunnuntai;6;10;16;14;13;27
292;18.12.2016;2016;12;16;Sunnuntai;8;11;19;20;10;30
292;18.12.2016;2016;12;17;Sunnuntai;8;9;17;16;15;31
292;18.12.2016;2016;12;18;Sunnuntai;7;6;13;19;14;33
292;18.12.2016;2016;12;19;Sunnuntai;2;3;5;16;17;33
292;18.12.2016;2016;12;20;Sunnuntai;3;4;7;9;7;16
292;18.12.2016;2016;12;21;Sunnuntai;3;4;7;2;5;7
292;18.12.2016;2016;12;22;Sunnuntai;1;3;4;1;1;2
292;18.12.2016;2016;12;23;Sunnuntai;2;0;2;1;1;2
292;19.12.2016;2016;12;00;Maanantai;0;0;0;0;0;0
292;19.12.2016;2016;12;01;Maanantai;0;0;0;0;0;0
292;19.12.2016;2016;12;02;Maanantai;0;0;0;0;0;0
292;19.12.2016;2016;12;03;Maanantai;0;1;1;0;0;0
292;19.12.2016;2016;12;04;Maanantai;1;0;1;0;0;0
292;19.12.2016;2016;12;05;Maanantai;3;4;7;4;1;5
292;19.12.2016;2016;12;06;Maanantai;7;4;11;3;5;8
292;19.12.2016;2016;12;07;Maanantai;37;12;49;17;12;29
292;19.12.2016;2016;12;08;Maanantai;40;15;55;21;6;27
292;19.12.2016;2016;12;09;Maanantai;32;13;45;16;16;32
292;19.12.2016;2016;12;10;Maanantai;10;6;16;7;10;17
292;19.12.2016;2016;12;11;Maanantai;10;7;17;12;12;24
292;19.12.2016;2016;12;12;Maanantai;10;14;24;12;14;26
292;19.12.2016;2016;12;13;Maanantai;12;20;32;15;10;25
292;19.12.2016;2016;12;14;Maanantai;21;30;51;16;21;37
292;19.12.2016;2016;12;15;Maanantai;31;34;65;15;24;39
292;19.12.2016;2016;12;16;Maanantai;25;39;64;17;15;32
292;19.12.2016;2016;12;17;Maanantai;10;15;25;13;15;28
292;19.12.2016;2016;12;18;Maanantai;8;12;20;17;5;22
292;19.12.2016;2016;12;19;Maanantai;22;11;33;10;7;17
292;19.12.2016;2016;12;20;Maanantai;14;6;20;9;5;14
292;19.12.2016;2016;12;21;Maanantai;6;6;12;9;4;13
292;19.12.2016;2016;12;22;Maanantai;1;1;2;0;1;1
292;19.12.2016;2016;12;23;Maanantai;0;0;0;0;0;0
292;20.12.2016;2016;12;00;Tiistai;1;1;2;0;0;0
292;20.12.2016;2016;12;01;Tiistai;0;0;0;1;0;1
292;20.12.2016;2016;12;02;Tiistai;1;1;2;0;0;0
292;20.12.2016;2016;12;03;Tiistai;0;0;0;0;0;0
292;20.12.2016;2016;12;04;Tiistai;0;0;0;0;0;0
292;20.12.2016;2016;12;05;Tiistai;3;1;4;2;0;2
292;20.12.2016;2016;12;06;Tiistai;9;4;13;7;5;12
292;20.12.2016;2016;12;07;Tiistai;23;16;39;16;10;26
292;20.12.2016;2016;12;08;Tiistai;59;10;69;17;15;32
292;20.12.2016;2016;12;09;Tiistai;30;9;39;9;15;24
292;20.12.2016;2016;12;10;Tiistai;7;6;13;6;8;14
292;20.12.2016;2016;12;11;Tiistai;8;6;14;6;12;18
292;20.12.2016;2016;12;12;Tiistai;14;46;60;15;26;41
292;20.12.2016;2016;12;13;Tiistai;19;12;31;10;21;31
292;20.12.2016;2016;12;14;Tiistai;20;24;44;21;36;57
292;20.12.2016;2016;12;15;Tiistai;18;24;42;24;17;41
292;20.12.2016;2016;12;16;Tiistai;25;19;44;12;18;30
292;20.12.2016;2016;12;17;Tiistai;20;8;28;8;5;13
292;20.12.2016;2016;12;18;Tiistai;13;4;17;12;12;24
292;20.12.2016;2016;12;19;Tiistai;11;10;21;11;10;21
292;20.12.2016;2016;12;20;Tiistai;6;7;13;11;16;27
292;20.12.2016;2016;12;21;Tiistai;1;3;4;8;8;16
292;20.12.2016;2016;12;22;Tiistai;1;3;4;0;1;1
292;20.12.2016;2016;12;23;Tiistai;1;0;1;1;0;1
292;21.12.2016;2016;12;00;Keskiviikko;0;0;0;0;1;1
292;21.12.2016;2016;12;01;Keskiviikko;0;1;1;2;0;2
292;21.12.2016;2016;12;02;Keskiviikko;0;0;0;1;0;1
292;21.12.2016;2016;12;03;Keskiviikko;1;1;2;0;1;1
292;21.12.2016;2016;12;04;Keskiviikko;1;0;1;6;6;12
292;21.12.2016;2016;12;05;Keskiviikko;4;2;6;3;1;4
292;21.12.2016;2016;12;06;Keskiviikko;12;5;17;4;5;9
292;21.12.2016;2016;12;07;Keskiviikko;23;8;31;10;7;17
292;21.12.2016;2016;12;08;Keskiviikko;47;14;61;21;9;30
292;21.12.2016;2016;12;09;Keskiviikko;21;6;27;11;12;23
292;21.12.2016;2016;12;10;Keskiviikko;11;5;16;11;14;25
292;21.12.2016;2016;12;11;Keskiviikko;8;16;24;8;26;34
292;21.12.2016;2016;12;12;Keskiviikko;19;38;57;9;27;36
292;21.12.2016;2016;12;13;Keskiviikko;6;21;27;16;22;38
292;21.12.2016;2016;12;14;Keskiviikko;13;18;31;19;13;32
292;21.12.2016;2016;12;15;Keskiviikko;19;14;33;16;18;34
292;21.12.2016;2016;12;16;Keskiviikko;10;13;23;17;25;42
292;21.12.2016;2016;12;17;Keskiviikko;10;14;24;7;14;21
292;21.12.2016;2016;12;18;Keskiviikko;6;9;15;17;10;27
292;21.12.2016;2016;12;19;Keskiviikko;7;5;12;11;11;22
292;21.12.2016;2016;12;20;Keskiviikko;15;8;23;13;10;23
292;21.12.2016;2016;12;21;Keskiviikko;5;6;11;8;3;11
292;21.12.2016;2016;12;22;Keskiviikko;7;4;11;5;4;9
292;21.12.2016;2016;12;23;Keskiviikko;1;2;3;0;0;0
292;22.12.2016;2016;12;00;Torstai;1;9;10;0;0;0
292;22.12.2016;2016;12;01;Torstai;0;0;0;0;6;6
292;22.12.2016;2016;12;02;Torstai;1;0;1;1;0;1
292;22.12.2016;2016;12;03;Torstai;0;1;1;1;0;1
292;22.12.2016;2016;12;04;Torstai;0;1;1;0;0;0
292;22.12.2016;2016;12;05;Torstai;4;1;5;3;2;5
292;22.12.2016;2016;12;06;Torstai;11;8;19;2;3;5
292;22.12.2016;2016;12;07;Torstai;14;5;19;4;7;11
292;22.12.2016;2016;12;08;Torstai;20;12;32;12;15;27
292;22.12.2016;2016;12;09;Torstai;14;4;18;14;16;30
292;22.12.2016;2016;12;10;Torstai;6;27;33;6;27;33
292;22.12.2016;2016;12;11;Torstai;12;12;24;9;10;19
292;22.12.2016;2016;12;12;Torstai;14;9;23;9;15;24
292;22.12.2016;2016;12;13;Torstai;12;15;27;10;19;29
292;22.12.2016;2016;12;14;Torstai;12;12;24;12;22;34
292;22.12.2016;2016;12;15;Torstai;23;10;33;22;8;30
292;22.12.2016;2016;12;16;Torstai;23;10;33;13;13;26
292;22.12.2016;2016;12;17;Torstai;12;13;25;13;6;19
292;22.12.2016;2016;12;18;Torstai;10;12;22;10;20;30
292;22.12.2016;2016;12;19;Torstai;8;14;22;16;12;28
292;22.12.2016;2016;12;20;Torstai;9;2;11;7;10;17
292;22.12.2016;2016;12;21;Torstai;4;5;9;6;3;9
292;22.12.2016;2016;12;22;Torstai;1;1;2;2;2;4
292;22.12.2016;2016;12;23;Torstai;2;2;4;3;1;4
292;23.12.2016;2016;12;00;Perjantai;2;5;7;3;2;5
292;23.12.2016;2016;12;01;Perjantai;0;0;0;0;1;1
292;23.12.2016;2016;12;02;Perjantai;0;0;0;0;1;1
292;23.12.2016;2016;12;03;Perjantai;0;0;0;0;0;0
292;23.12.2016;2016;12;04;Perjantai;0;0;0;0;0;0
292;23.12.2016;2016;12;05;Perjantai;4;4;8;3;3;6
292;23.12.2016;2016;12;06;Perjantai;6;5;11;2;3;5
292;23.12.2016;2016;12;07;Perjantai;9;5;14;7;7;14
292;23.12.2016;2016;12;08;Perjantai;8;10;18;11;12;23
292;23.12.2016;2016;12;09;Perjantai;4;8;12;1;16;17
292;23.12.2016;2016;12;10;Perjantai;10;11;21;21;16;37
292;23.12.2016;2016;12;11;Perjantai;11;10;21;13;13;26
292;23.12.2016;2016;12;12;Perjantai;5;9;14;17;10;27
292;23.12.2016;2016;12;13;Perjantai;17;17;34;5;10;15
292;23.12.2016;2016;12;14;Perjantai;12;11;23;16;20;36
292;23.12.2016;2016;12;15;Perjantai;16;11;27;18;19;37
292;23.12.2016;2016;12;16;Perjantai;13;6;19;8;10;18
292;23.12.2016;2016;12;17;Perjantai;5;6;11;10;9;19
292;23.12.2016;2016;12;18;Perjantai;4;9;13;10;9;19
292;23.12.2016;2016;12;19;Perjantai;9;7;16;17;10;27
292;23.12.2016;2016;12;20;Perjantai;4;3;7;11;8;19
292;23.12.2016;2016;12;21;Perjantai;1;0;1;8;5;13
292;23.12.2016;2016;12;22;Perjantai;3;2;5;4;4;8
292;23.12.2016;2016;12;23;Perjantai;0;0;0;0;1;1
292;24.12.2016;2016;12;00;Lauantai;1;1;2;4;0;4
292;24.12.2016;2016;12;01;Lauantai;0;1;1;2;2;4
292;24.12.2016;2016;12;02;Lauantai;0;1;1;0;2;2
292;24.12.2016;2016;12;03;Lauantai;0;0;0;0;0;0
292;24.12.2016;2016;12;04;Lauantai;1;0;1;1;0;1
292;24.12.2016;2016;12;05;Lauantai;0;0;0;0;1;1
292;24.12.2016;2016;12;06;Lauantai;3;2;5;0;1;1
292;24.12.2016;2016;12;07;Lauantai;1;2;3;3;1;4
292;24.12.2016;2016;12;08;Lauantai;0;3;3;6;9;15
292;24.12.2016;2016;12;09;Lauantai;1;4;5;6;8;14
292;24.12.2016;2016;12;10;Lauantai;3;3;6;11;10;21
292;24.12.2016;2016;12;11;Lauantai;2;4;6;12;13;25
292;24.12.2016;2016;12;12;Lauantai;7;3;10;14;10;24
292;24.12.2016;2016;12;13;Lauantai;3;4;7;11;10;21
292;24.12.2016;2016;12;14;Lauantai;1;3;4;7;13;20
292;24.12.2016;2016;12;15;Lauantai;2;1;3;4;0;4
292;24.12.2016;2016;12;16;Lauantai;2;4;6;4;3;7
292;24.12.2016;2016;12;17;Lauantai;0;0;0;3;2;5
292;24.12.2016;2016;12;18;Lauantai;1;0;1;5;3;8
292;24.12.2016;2016;12;19;Lauantai;1;0;1;9;10;19
292;24.12.2016;2016;12;20;Lauantai;2;3;5;4;2;6
292;24.12.2016;2016;12;21;Lauantai;1;0;1;6;7;13
292;24.12.2016;2016;12;22;Lauantai;1;2;3;3;6;9
292;24.12.2016;2016;12;23;Lauantai;0;0;0;3;1;4
292;25.12.2016;2016;12;00;Sunnuntai;0;0;0;2;1;3
292;25.12.2016;2016;12;01;Sunnuntai;0;0;0;3;1;4
292;25.12.2016;2016;12;02;Sunnuntai;0;0;0;0;1;1
292;25.12.2016;2016;12;03;Sunnuntai;0;1;1;5;8;13
292;25.12.2016;2016;12;04;Sunnuntai;0;0;0;1;0;1
292;25.12.2016;2016;12;05;Sunnuntai;1;0;1;1;1;2
292;25.12.2016;2016;12;06;Sunnuntai;1;0;1;3;3;6
292;25.12.2016;2016;12;07;Sunnuntai;0;1;1;3;3;6
292;25.12.2016;2016;12;08;Sunnuntai;1;0;1;7;4;11
292;25.12.2016;2016;12;09;Sunnuntai;0;3;3;6;7;13
292;25.12.2016;2016;12;10;Sunnuntai;0;2;2;8;10;18
292;25.12.2016;2016;12;11;Sunnuntai;3;3;6;8;4;12
292;25.12.2016;2016;12;12;Sunnuntai;8;3;11;16;12;28
292;25.12.2016;2016;12;13;Sunnuntai;5;2;7;19;13;32
292;25.12.2016;2016;12;14;Sunnuntai;6;4;10;18;21;39
292;25.12.2016;2016;12;15;Sunnuntai;5;4;9;20;10;30
292;25.12.2016;2016;12;16;Sunnuntai;6;8;14;12;16;28
292;25.12.2016;2016;12;17;Sunnuntai;9;3;12;16;15;31
292;25.12.2016;2016;12;18;Sunnuntai;2;3;5;11;17;28
292;25.12.2016;2016;12;19;Sunnuntai;5;3;8;17;10;27
292;25.12.2016;2016;12;20;Sunnuntai;5;4;9;7;16;23
292;25.12.2016;2016;12;21;Sunnuntai;4;3;7;4;3;7
292;25.12.2016;2016;12;22;Sunnuntai;3;6;9;3;4;7
292;25.12.2016;2016;12;23;Sunnuntai;4;2;6;5;3;8
292;26.12.2016;2016;12;00;Maanantai;2;1;3;0;3;3
292;26.12.2016;2016;12;01;Maanantai;1;0;1;0;3;3
292;26.12.2016;2016;12;02;Maanantai;0;1;1;0;2;2
292;26.12.2016;2016;12;03;Maanantai;1;1;2;1;5;6
292;26.12.2016;2016;12;04;Maanantai;0;2;2;0;0;0
292;26.12.2016;2016;12;05;Maanantai;1;1;2;3;1;4
292;26.12.2016;2016;12;06;Maanantai;5;0;5;1;3;4
292;26.12.2016;2016;12;07;Maanantai;0;0;0;3;3;6
292;26.12.2016;2016;12;08;Maanantai;1;1;2;5;6;11
292;26.12.2016;2016;12;09;Maanantai;2;5;7;6;6;12
292;26.12.2016;2016;12;10;Maanantai;3;5;8;10;5;15
292;26.12.2016;2016;12;11;Maanantai;7;7;14;8;11;19
292;26.12.2016;2016;12;12;Maanantai;5;8;13;11;9;20
292;26.12.2016;2016;12;13;Maanantai;5;6;11;8;9;17
292;26.12.2016;2016;12;14;Maanantai;5;11;16;16;7;23
292;26.12.2016;2016;12;15;Maanantai;7;4;11;15;17;32
292;26.12.2016;2016;12;16;Maanantai;3;7;10;16;12;28
292;26.12.2016;2016;12;17;Maanantai;12;7;19;17;18;35
292;26.12.2016;2016;12;18;Maanantai;7;7;14;13;10;23
292;26.12.2016;2016;12;19;Maanantai;8;4;12;7;10;17
292;26.12.2016;2016;12;20;Maanantai;1;0;1;2;3;5
292;26.12.2016;2016;12;21;Maanantai;3;3;6;5;3;8
292;26.12.2016;2016;12;22;Maanantai;0;0;0;1;0;1
292;26.12.2016;2016;12;23;Maanantai;2;0;2;0;0;0
292;27.12.2016;2016;12;00;Tiistai;1;1;2;1;1;2
292;27.12.2016;2016;12;01;Tiistai;1;0;1;9;4;13
292;27.12.2016;2016;12;02;Tiistai;0;0;0;1;2;3
292;27.12.2016;2016;12;03;Tiistai;0;0;0;0;2;2
292;27.12.2016;2016;12;04;Tiistai;0;1;1;1;0;1
292;27.12.2016;2016;12;05;Tiistai;1;1;2;3;0;3
292;27.12.2016;2016;12;06;Tiistai;4;3;7;10;8;18
292;27.12.2016;2016;12;07;Tiistai;5;5;10;5;4;9
292;27.12.2016;2016;12;08;Tiistai;6;6;12;15;10;25
292;27.12.2016;2016;12;09;Tiistai;3;2;5;10;11;21
292;27.12.2016;2016;12;10;Tiistai;3;6;9;14;11;25
292;27.12.2016;2016;12;11;Tiistai;5;14;19;10;12;22
292;27.12.2016;2016;12;12;Tiistai;9;12;21;13;18;31
292;27.12.2016;2016;12;13;Tiistai;8;13;21;16;11;27
292;27.12.2016;2016;12;14;Tiistai;11;17;28;22;14;36
292;27.12.2016;2016;12;15;Tiistai;9;11;20;15;9;24
292;27.12.2016;2016;12;16;Tiistai;7;5;12;14;15;29
292;27.12.2016;2016;12;17;Tiistai;12;13;25;17;14;31
292;27.12.2016;2016;12;18;Tiistai;10;7;17;12;9;21
292;27.12.2016;2016;12;19;Tiistai;8;7;15;19;10;29
292;27.12.2016;2016;12;20;Tiistai;4;5;9;8;5;13
292;27.12.2016;2016;12;21;Tiistai;9;8;17;3;5;8
292;27.12.2016;2016;12;22;Tiistai;1;6;7;3;3;6
292;27.12.2016;2016;12;23;Tiistai;1;0;1;2;0;2
292;28.12.2016;2016;12;00;Keskiviikko;0;0;0;0;0;0
292;28.12.2016;2016;12;01;Keskiviikko;0;1;1;0;0;0
292;28.12.2016;2016;12;02;Keskiviikko;0;0;0;0;0;0
292;28.12.2016;2016;12;03;Keskiviikko;0;0;0;0;0;0
292;28.12.2016;2016;12;04;Keskiviikko;2;0;2;0;0;0
292;28.12.2016;2016;12;05;Keskiviikko;1;7;8;3;0;3
292;28.12.2016;2016;12;06;Keskiviikko;9;4;13;3;0;3
292;28.12.2016;2016;12;07;Keskiviikko;5;7;12;5;7;12
292;28.12.2016;2016;12;08;Keskiviikko;3;6;9;6;6;12
292;28.12.2016;2016;12;09;Keskiviikko;2;4;6;6;12;18
292;28.12.2016;2016;12;10;Keskiviikko;3;2;5;9;8;17
292;28.12.2016;2016;12;11;Keskiviikko;3;9;12;11;10;21
292;28.12.2016;2016;12;12;Keskiviikko;9;11;20;22;18;40
292;28.12.2016;2016;12;13;Keskiviikko;12;4;16;12;9;21
292;28.12.2016;2016;12;14;Keskiviikko;9;13;22;17;20;37
292;28.12.2016;2016;12;15;Keskiviikko;10;8;18;13;21;34
292;28.12.2016;2016;12;16;Keskiviikko;16;14;30;21;10;31
292;28.12.2016;2016;12;17;Keskiviikko;2;8;10;18;11;29
292;28.12.2016;2016;12;18;Keskiviikko;5;10;15;13;17;30
292;28.12.2016;2016;12;19;Keskiviikko;7;6;13;11;6;17
292;28.12.2016;2016;12;20;Keskiviikko;4;2;6;6;6;12
292;28.12.2016;2016;12;21;Keskiviikko;3;2;5;6;2;8
292;28.12.2016;2016;12;22;Keskiviikko;3;2;5;1;0;1
292;28.12.2016;2016;12;23;Keskiviikko;1;2;3;2;0;2
292;29.12.2016;2016;12;00;Torstai;2;0;2;4;1;5
292;29.12.2016;2016;12;01;Torstai;2;0;2;0;0;0
292;29.12.2016;2016;12;02;Torstai;1;2;3;0;3;3
292;29.12.2016;2016;12;03;Torstai;0;0;0;0;0;0
292;29.12.2016;2016;12;04;Torstai;3;0;3;0;0;0
292;29.12.2016;2016;12;05;Torstai;2;2;4;2;0;2
292;29.12.2016;2016;12;06;Torstai;10;6;16;1;1;2
292;29.12.2016;2016;12;07;Torstai;8;10;18;7;11;18
292;29.12.2016;2016;12;08;Torstai;6;6;12;10;9;19
292;29.12.2016;2016;12;09;Torstai;5;7;12;8;14;22
292;29.12.2016;2016;12;10;Torstai;4;7;11;8;8;16
292;29.12.2016;2016;12;11;Torstai;8;10;18;17;23;40
292;29.12.2016;2016;12;12;Torstai;12;14;26;24;16;40
292;29.12.2016;2016;12;13;Torstai;9;16;25;17;7;24
292;29.12.2016;2016;12;14;Torstai;7;20;27;10;13;23
292;29.12.2016;2016;12;15;Torstai;13;17;30;10;8;18
292;29.12.2016;2016;12;16;Torstai;18;18;36;21;10;31
292;29.12.2016;2016;12;17;Torstai;8;8;16;15;12;27
292;29.12.2016;2016;12;18;Torstai;8;10;18;14;18;32
292;29.12.2016;2016;12;19;Torstai;11;13;24;15;8;23
292;29.12.2016;2016;12;20;Torstai;12;5;17;15;9;24
292;29.12.2016;2016;12;21;Torstai;7;7;14;4;6;10
292;29.12.2016;2016;12;22;Torstai;0;6;6;2;5;7
292;29.12.2016;2016;12;23;Torstai;2;2;4;2;3;5
292;30.12.2016;2016;12;00;Perjantai;0;1;1;5;2;7
292;30.12.2016;2016;12;01;Perjantai;0;1;1;1;0;1
292;30.12.2016;2016;12;02;Perjantai;1;1;2;0;2;2
292;30.12.2016;2016;12;03;Perjantai;0;0;0;0;2;2
292;30.12.2016;2016;12;04;Perjantai;3;0;3;0;0;0
292;30.12.2016;2016;12;05;Perjantai;3;1;4;3;0;3
292;30.12.2016;2016;12;06;Perjantai;9;5;14;2;3;5
292;30.12.2016;2016;12;07;Perjantai;5;3;8;5;10;15
292;30.12.2016;2016;12;08;Perjantai;6;2;8;8;7;15
292;30.12.2016;2016;12;09;Perjantai;3;3;6;9;7;16
292;30.12.2016;2016;12;10;Perjantai;9;13;22;11;9;20
292;30.12.2016;2016;12;11;Perjantai;7;6;13;13;10;23
292;30.12.2016;2016;12;12;Perjantai;10;10;20;11;9;20
292;30.12.2016;2016;12;13;Perjantai;5;11;16;18;16;34
292;30.12.2016;2016;12;14;Perjantai;4;5;9;12;14;26
292;30.12.2016;2016;12;15;Perjantai;7;12;19;18;13;31
292;30.12.2016;2016;12;16;Perjantai;12;10;22;9;15;24
292;30.12.2016;2016;12;17;Perjantai;7;4;11;16;8;24
292;30.12.2016;2016;12;18;Perjantai;4;5;9;9;14;23
292;30.12.2016;2016;12;19;Perjantai;8;7;15;12;2;14
292;30.12.2016;2016;12;20;Perjantai;7;6;13;9;10;19
292;30.12.2016;2016;12;21;Perjantai;3;2;5;3;3;6
292;30.12.2016;2016;12;22;Perjantai;1;5;6;2;0;2
292;30.12.2016;2016;12;23;Perjantai;0;8;8;9;7;16
292;31.12.2016;2016;12;00;Lauantai;2;2;4;5;5;10
292;31.12.2016;2016;12;01;Lauantai;2;1;3;1;1;2
292;31.12.2016;2016;12;02;Lauantai;1;2;3;0;5;5
292;31.12.2016;2016;12;03;Lauantai;0;0;0;0;2;2
292;31.12.2016;2016;12;04;Lauantai;0;0;0;1;0;1
292;31.12.2016;2016;12;05;Lauantai;0;0;0;0;0;0
292;31.12.2016;2016;12;06;Lauantai;2;0;2;3;1;4
292;31.12.2016;2016;12;07;Lauantai;2;3;5;1;3;4
292;31.12.2016;2016;12;08;Lauantai;1;1;2;6;4;10
292;31.12.2016;2016;12;09;Lauantai;0;1;1;3;4;7
292;31.12.2016;2016;12;10;Lauantai;4;4;8;8;7;15
292;31.12.2016;2016;12;11;Lauantai;4;4;8;14;9;23
292;31.12.2016;2016;12;12;Lauantai;7;9;16;10;16;26
292;31.12.2016;2016;12;13;Lauantai;10;6;16;9;8;17
292;31.12.2016;2016;12;14;Lauantai;9;11;20;8;13;21
292;31.12.2016;2016;12;15;Lauantai;8;7;15;14;12;26
292;31.12.2016;2016;12;16;Lauantai;4;13;17;8;20;28
292;31.12.2016;2016;12;17;Lauantai;10;10;20;11;15;26
292;31.12.2016;2016;12;18;Lauantai;18;3;21;23;12;35
292;31.12.2016;2016;12;19;Lauantai;9;2;11;10;4;14
292;31.12.2016;2016;12;20;Lauantai;3;3;6;7;2;9
292;31.12.2016;2016;12;21;Lauantai;3;7;10;1;1;2
292;31.12.2016;2016;12;22;Lauantai;2;5;7;3;0;3
292;31.12.2016;2016;12;23;Lauantai;1;7;8;6;4;10
292;01.01.2017;2017;01;00;Sunnuntai;4;5;9;12;9;21
292;01.01.2017;2017;01;01;Sunnuntai;4;1;5;10;7;17
292;01.01.2017;2017;01;02;Sunnuntai;0;1;1;7;12;19
292;01.01.2017;2017;01;03;Sunnuntai;0;3;3;1;19;20
292;01.01.2017;2017;01;04;Sunnuntai;0;0;0;0;5;5
292;01.01.2017;2017;01;05;Sunnuntai;1;2;3;5;2;7
292;01.01.2017;2017;01;06;Sunnuntai;3;1;4;3;1;4
292;01.01.2017;2017;01;07;Sunnuntai;0;2;2;1;0;1
292;01.01.2017;2017;01;08;Sunnuntai;0;0;0;4;4;8
292;01.01.2017;2017;01;09;Sunnuntai;0;1;1;3;6;9
292;01.01.2017;2017;01;10;Sunnuntai;4;1;5;9;5;14
292;01.01.2017;2017;01;11;Sunnuntai;3;3;6;8;11;19
292;01.01.2017;2017;01;12;Sunnuntai;2;2;4;12;11;23
292;01.01.2017;2017;01;13;Sunnuntai;11;3;14;14;11;25
292;01.01.2017;2017;01;14;Sunnuntai;7;10;17;17;12;29
292;01.01.2017;2017;01;15;Sunnuntai;5;10;15;9;10;19
292;01.01.2017;2017;01;16;Sunnuntai;4;9;13;15;12;27
292;01.01.2017;2017;01;17;Sunnuntai;2;4;6;17;7;24
292;01.01.2017;2017;01;18;Sunnuntai;2;6;8;10;17;27
292;01.01.2017;2017;01;19;Sunnuntai;3;1;4;4;4;8
292;01.01.2017;2017;01;20;Sunnuntai;6;8;14;6;3;9
292;01.01.2017;2017;01;21;Sunnuntai;1;4;5;2;2;4
292;01.01.2017;2017;01;22;Sunnuntai;2;3;5;0;2;2
292;01.01.2017;2017;01;23;Sunnuntai;0;1;1;1;0;1
292;02.01.2017;2017;01;00;Maanantai;0;1;1;0;0;0
292;02.01.2017;2017;01;01;Maanantai;0;0;0;0;0;0
292;02.01.2017;2017;01;02;Maanantai;0;0;0;0;0;0
292;02.01.2017;2017;01;03;Maanantai;0;0;0;0;0;0
292;02.01.2017;2017;01;04;Maanantai;0;0;0;1;0;1
292;02.01.2017;2017;01;05;Maanantai;4;4;8;2;0;2
292;02.01.2017;2017;01;06;Maanantai;7;3;10;3;6;9
292;02.01.2017;2017;01;07;Maanantai;12;15;27;10;10;20
292;02.01.2017;2017;01;08;Maanantai;11;7;18;10;14;24
292;02.01.2017;2017;01;09;Maanantai;5;10;15;3;13;16
292;02.01.2017;2017;01;10;Maanantai;4;6;10;16;22;38
292;02.01.2017;2017;01;11;Maanantai;7;10;17;11;9;20
292;02.01.2017;2017;01;12;Maanantai;13;8;21;16;10;26
292;02.01.2017;2017;01;13;Maanantai;11;15;26;11;13;24
292;02.01.2017;2017;01;14;Maanantai;11;16;27;11;3;14
292;02.01.2017;2017;01;15;Maanantai;13;23;36;13;17;30
292;02.01.2017;2017;01;16;Maanantai;22;21;43;17;23;40
292;02.01.2017;2017;01;17;Maanantai;12;6;18;15;15;30
292;02.01.2017;2017;01;18;Maanantai;8;9;17;13;11;24
292;02.01.2017;2017;01;19;Maanantai;3;4;7;14;13;27
292;02.01.2017;2017;01;20;Maanantai;6;11;17;10;4;14
292;02.01.2017;2017;01;21;Maanantai;2;5;7;3;5;8
292;02.01.2017;2017;01;22;Maanantai;3;1;4;2;0;2
292;02.01.2017;2017;01;23;Maanantai;1;1;2;0;0;0
292;03.01.2017;2017;01;00;Tiistai;0;2;2;0;0;0
292;03.01.2017;2017;01;01;Tiistai;0;2;2;0;0;0
292;03.01.2017;2017;01;02;Tiistai;0;0;0;0;0;0
292;03.01.2017;2017;01;03;Tiistai;0;0;0;0;0;0
292;03.01.2017;2017;01;04;Tiistai;2;0;2;0;0;0
292;03.01.2017;2017;01;05;Tiistai;3;5;8;5;1;6
292;03.01.2017;2017;01;06;Tiistai;6;4;10;1;5;6
292;03.01.2017;2017;01;07;Tiistai;15;11;26;11;8;19
292;03.01.2017;2017;01;08;Tiistai;7;7;14;9;6;15
292;03.01.2017;2017;01;09;Tiistai;8;4;12;6;13;19
292;03.01.2017;2017;01;10;Tiistai;7;7;14;4;14;18
292;03.01.2017;2017;01;11;Tiistai;3;8;11;9;16;25
292;03.01.2017;2017;01;12;Tiistai;8;11;19;12;12;24
292;03.01.2017;2017;01;13;Tiistai;7;15;22;11;11;22
292;03.01.2017;2017;01;14;Tiistai;5;10;15;17;14;31
292;03.01.2017;2017;01;15;Tiistai;15;11;26;20;11;31
292;03.01.2017;2017;01;16;Tiistai;13;7;20;14;15;29
292;03.01.2017;2017;01;17;Tiistai;3;8;11;7;9;16
292;03.01.2017;2017;01;18;Tiistai;2;3;5;13;11;24
292;03.01.2017;2017;01;19;Tiistai;4;3;7;16;15;31
292;03.01.2017;2017;01;20;Tiistai;5;4;9;9;8;17
292;03.01.2017;2017;01;21;Tiistai;4;5;9;6;4;10
292;03.01.2017;2017;01;22;Tiistai;0;0;0;2;0;2
292;03.01.2017;2017;01;23;Tiistai;0;0;0;0;0;0
292;04.01.2017;2017;01;00;Keskiviikko;1;0;1;0;1;1
292;04.01.2017;2017;01;01;Keskiviikko;0;0;0;1;0;1
292;04.01.2017;2017;01;02;Keskiviikko;0;0;0;0;0;0
292;04.01.2017;2017;01;03;Keskiviikko;1;1;2;0;0;0
292;04.01.2017;2017;01;04;Keskiviikko;0;0;0;0;0;0
292;04.01.2017;2017;01;05;Keskiviikko;2;3;5;3;0;3
292;04.01.2017;2017;01;06;Keskiviikko;3;5;8;3;4;7
292;04.01.2017;2017;01;07;Keskiviikko;6;5;11;11;8;19
292;04.01.2017;2017;01;08;Keskiviikko;7;3;10;7;8;15
292;04.01.2017;2017;01;09;Keskiviikko;5;2;7;3;10;13
292;04.01.2017;2017;01;10;Keskiviikko;1;2;3;8;9;17
292;04.01.2017;2017;01;11;Keskiviikko;3;5;8;9;8;17
292;04.01.2017;2017;01;12;Keskiviikko;5;6;11;13;14;27
292;04.01.2017;2017;01;13;Keskiviikko;5;6;11;11;10;21
292;04.01.2017;2017;01;14;Keskiviikko;4;2;6;9;17;26
292;04.01.2017;2017;01;15;Keskiviikko;9;9;18;10;9;19
292;04.01.2017;2017;01;16;Keskiviikko;8;6;14;7;9;16
292;04.01.2017;2017;01;17;Keskiviikko;4;6;10;9;9;18
292;04.01.2017;2017;01;18;Keskiviikko;1;3;4;5;6;11
292;04.01.2017;2017;01;19;Keskiviikko;0;1;1;3;3;6
292;04.01.2017;2017;01;20;Keskiviikko;3;1;4;6;2;8
292;04.01.2017;2017;01;21;Keskiviikko;1;1;2;1;1;2
292;04.01.2017;2017;01;22;Keskiviikko;0;1;1;0;4;4
292;04.01.2017;2017;01;23;Keskiviikko;0;2;2;0;1;1
292;05.01.2017;2017;01;00;Torstai;0;1;1;0;1;1
292;05.01.2017;2017;01;01;Torstai;1;1;2;0;0;0
292;05.01.2017;2017;01;02;Torstai;0;2;2;0;0;0
292;05.01.2017;2017;01;03;Torstai;0;0;0;0;0;0
292;05.01.2017;2017;01;04;Torstai;0;0;0;0;0;0
292;05.01.2017;2017;01;05;Torstai;2;3;5;2;0;2
292;05.01.2017;2017;01;06;Torstai;4;2;6;4;2;6
292;05.01.2017;2017;01;07;Torstai;5;5;10;10;4;14
292;05.01.2017;2017;01;08;Torstai;3;3;6;16;12;28
292;05.01.2017;2017;01;09;Torstai;1;1;2;12;10;22
292;05.01.2017;2017;01;10;Torstai;3;1;4;6;7;13
292;05.01.2017;2017;01;11;Torstai;1;2;3;3;4;7
292;05.01.2017;2017;01;12;Torstai;1;3;4;9;7;16
292;05.01.2017;2017;01;13;Torstai;3;6;9;14;3;17
292;05.01.2017;2017;01;14;Torstai;0;4;4;5;6;11
292;05.01.2017;2017;01;15;Torstai;6;2;8;8;13;21
292;05.01.2017;2017;01;16;Torstai;6;3;9;10;13;23
292;05.01.2017;2017;01;17;Torstai;3;5;8;6;9;15
292;05.01.2017;2017;01;18;Torstai;1;4;5;3;8;11
292;05.01.2017;2017;01;19;Torstai;1;0;1;8;2;10
292;05.01.2017;2017;01;20;Torstai;3;3;6;5;5;10
292;05.01.2017;2017;01;21;Torstai;3;1;4;7;3;10
292;05.01.2017;2017;01;22;Torstai;0;1;1;1;4;5
292;05.01.2017;2017;01;23;Torstai;1;1;2;0;0;0
292;06.01.2017;2017;01;00;Perjantai;0;1;1;0;1;1
292;06.01.2017;2017;01;01;Perjantai;0;0;0;0;0;0
292;06.01.2017;2017;01;02;Perjantai;0;0;0;0;1;1
292;06.01.2017;2017;01;03;Perjantai;0;0;0;0;0;0
292;06.01.2017;2017;01;04;Perjantai;0;0;0;0;0;0
292;06.01.2017;2017;01;05;Perjantai;0;0;0;0;0;0
292;06.01.2017;2017;01;06;Perjantai;2;1;3;0;1;1
292;06.01.2017;2017;01;07;Perjantai;0;0;0;0;2;2
292;06.01.2017;2017;01;08;Perjantai;0;1;1;3;2;5
292;06.01.2017;2017;01;09;Perjantai;1;4;5;2;5;7
292;06.01.2017;2017;01;10;Perjantai;3;2;5;11;8;19
292;06.01.2017;2017;01;11;Perjantai;5;6;11;9;8;17
292;06.01.2017;2017;01;12;Perjantai;2;2;4;15;7;22
292;06.01.2017;2017;01;13;Perjantai;3;2;5;7;7;14
292;06.01.2017;2017;01;14;Perjantai;3;5;8;8;13;21
292;06.01.2017;2017;01;15;Perjantai;5;0;5;10;6;16
292;06.01.2017;2017;01;16;Perjantai;6;4;10;12;6;18
292;06.01.2017;2017;01;17;Perjantai;1;1;2;11;10;21
292;06.01.2017;2017;01;18;Perjantai;4;2;6;3;10;13
292;06.01.2017;2017;01;19;Perjantai;0;1;1;11;12;23
292;06.01.2017;2017;01;20;Perjantai;2;2;4;1;5;6
292;06.01.2017;2017;01;21;Perjantai;1;1;2;3;3;6
292;06.01.2017;2017;01;22;Perjantai;1;1;2;3;1;4
292;06.01.2017;2017;01;23;Perjantai;0;0;0;0;2;2
292;07.01.2017;2017;01;00;Lauantai;2;3;5;5;1;6
292;07.01.2017;2017;01;01;Lauantai;0;0;0;2;0;2
292;07.01.2017;2017;01;02;Lauantai;0;0;0;0;3;3
292;07.01.2017;2017;01;03;Lauantai;1;0;1;0;6;6
292;07.01.2017;2017;01;04;Lauantai;0;0;0;1;0;1
292;07.01.2017;2017;01;05;Lauantai;2;0;2;0;0;0
292;07.01.2017;2017;01;06;Lauantai;4;0;4;2;3;5
292;07.01.2017;2017;01;07;Lauantai;1;1;2;5;9;14
292;07.01.2017;2017;01;08;Lauantai;0;4;4;5;3;8
292;07.01.2017;2017;01;09;Lauantai;1;5;6;3;5;8
292;07.01.2017;2017;01;10;Lauantai;5;5;10;9;5;14
292;07.01.2017;2017;01;11;Lauantai;8;16;24;12;6;18
292;07.01.2017;2017;01;12;Lauantai;9;15;24;14;20;34
292;07.01.2017;2017;01;13;Lauantai;6;11;17;20;14;34
292;07.01.2017;2017;01;14;Lauantai;8;9;17;10;8;18
292;07.01.2017;2017;01;15;Lauantai;8;5;13;27;10;37
292;07.01.2017;2017;01;16;Lauantai;7;7;14;22;18;40
292;07.01.2017;2017;01;17;Lauantai;7;5;12;11;12;23
292;07.01.2017;2017;01;18;Lauantai;9;6;15;12;6;18
292;07.01.2017;2017;01;19;Lauantai;6;4;10;15;18;33
292;07.01.2017;2017;01;20;Lauantai;3;3;6;7;10;17
292;07.01.2017;2017;01;21;Lauantai;7;7;14;2;0;2
292;07.01.2017;2017;01;22;Lauantai;3;1;4;3;0;3
292;07.01.2017;2017;01;23;Lauantai;0;2;2;3;2;5
292;08.01.2017;2017;01;00;Sunnuntai;1;1;2;2;4;6
292;08.01.2017;2017;01;01;Sunnuntai;1;2;3;3;2;5
292;08.01.2017;2017;01;02;Sunnuntai;1;1;2;0;3;3
292;08.01.2017;2017;01;03;Sunnuntai;0;0;0;0;1;1
292;08.01.2017;2017;01;04;Sunnuntai;2;0;2;0;0;0
292;08.01.2017;2017;01;05;Sunnuntai;3;2;5;2;0;2
292;08.01.2017;2017;01;06;Sunnuntai;1;0;1;2;3;5
292;08.01.2017;2017;01;07;Sunnuntai;1;3;4;0;2;2
292;08.01.2017;2017;01;08;Sunnuntai;1;1;2;1;4;5
292;08.01.2017;2017;01;09;Sunnuntai;6;2;8;4;3;7
292;08.01.2017;2017;01;10;Sunnuntai;9;4;13;18;12;30
292;08.01.2017;2017;01;11;Sunnuntai;5;14;19;13;13;26
292;08.01.2017;2017;01;12;Sunnuntai;7;9;16;13;12;25
292;08.01.2017;2017;01;13;Sunnuntai;12;2;14;7;15;22
292;08.01.2017;2017;01;14;Sunnuntai;8;11;19;12;14;26
292;08.01.2017;2017;01;15;Sunnuntai;6;4;10;14;15;29
292;08.01.2017;2017;01;16;Sunnuntai;6;4;10;7;6;13
292;08.01.2017;2017;01;17;Sunnuntai;8;5;13;11;14;25
292;08.01.2017;2017;01;18;Sunnuntai;9;7;16;13;15;28
292;08.01.2017;2017;01;19;Sunnuntai;2;8;10;8;8;16
292;08.01.2017;2017;01;20;Sunnuntai;6;2;8;3;7;10
292;08.01.2017;2017;01;21;Sunnuntai;1;2;3;4;6;10
292;08.01.2017;2017;01;22;Sunnuntai;0;2;2;0;1;1
292;08.01.2017;2017;01;23;Sunnuntai;0;1;1;3;2;5
292;09.01.2017;2017;01;00;Maanantai;0;1;1;0;0;0
292;09.01.2017;2017;01;01;Maanantai;0;0;0;0;0;0
292;09.01.2017;2017;01;02;Maanantai;0;1;1;0;0;0
292;09.01.2017;2017;01;03;Maanantai;0;0;0;0;0;0
292;09.01.2017;2017;01;04;Maanantai;4;0;4;0;0;0
292;09.01.2017;2017;01;05;Maanantai;4;6;10;4;1;5
292;09.01.2017;2017;01;06;Maanantai;9;4;13;1;5;6
292;09.01.2017;2017;01;07;Maanantai;28;19;47;26;16;42
292;09.01.2017;2017;01;08;Maanantai;47;16;63;20;19;39
292;09.01.2017;2017;01;09;Maanantai;34;8;42;22;10;32
292;09.01.2017;2017;01;10;Maanantai;15;9;24;19;11;30
292;09.01.2017;2017;01;11;Maanantai;9;13;22;15;11;26
292;09.01.2017;2017;01;12;Maanantai;11;24;35;12;13;25
292;09.01.2017;2017;01;13;Maanantai;12;21;33;10;16;26
292;09.01.2017;2017;01;14;Maanantai;14;39;53;29;17;46
292;09.01.2017;2017;01;15;Maanantai;11;43;54;18;34;52
292;09.01.2017;2017;01;16;Maanantai;30;40;70;22;32;54
292;09.01.2017;2017;01;17;Maanantai;17;13;30;20;10;30
292;09.01.2017;2017;01;18;Maanantai;18;19;37;13;17;30
292;09.01.2017;2017;01;19;Maanantai;11;4;15;16;10;26
292;09.01.2017;2017;01;20;Maanantai;10;10;20;13;8;21
292;09.01.2017;2017;01;21;Maanantai;1;8;9;2;3;5
292;09.01.2017;2017;01;22;Maanantai;1;1;2;2;1;3
292;09.01.2017;2017;01;23;Maanantai;0;1;1;0;0;0
292;10.01.2017;2017;01;00;Tiistai;0;0;0;0;0;0
292;10.01.2017;2017;01;01;Tiistai;1;1;2;0;1;1
292;10.01.2017;2017;01;02;Tiistai;0;0;0;0;0;0
292;10.01.2017;2017;01;03;Tiistai;1;0;1;0;0;0
292;10.01.2017;2017;01;04;Tiistai;2;0;2;0;0;0
292;10.01.2017;2017;01;05;Tiistai;4;2;6;4;3;7
292;10.01.2017;2017;01;06;Tiistai;10;4;14;2;10;12
292;10.01.2017;2017;01;07;Tiistai;56;15;71;14;18;32
292;10.01.2017;2017;01;08;Tiistai;56;20;76;15;16;31
292;10.01.2017;2017;01;09;Tiistai;16;12;28;9;13;22
292;10.01.2017;2017;01;10;Tiistai;19;10;29;6;9;15
292;10.01.2017;2017;01;11;Tiistai;15;9;24;10;11;21
292;10.01.2017;2017;01;12;Tiistai;14;9;23;12;7;19
292;10.01.2017;2017;01;13;Tiistai;15;30;45;15;28;43
292;10.01.2017;2017;01;14;Tiistai;16;52;68;21;26;47
292;10.01.2017;2017;01;15;Tiistai;24;33;57;17;21;38
292;10.01.2017;2017;01;16;Tiistai;20;25;45;22;36;58
292;10.01.2017;2017;01;17;Tiistai;13;19;32;22;22;44
292;10.01.2017;2017;01;18;Tiistai;8;12;20;22;16;38
292;10.01.2017;2017;01;19;Tiistai;8;13;21;14;10;24
292;10.01.2017;2017;01;20;Tiistai;10;4;14;13;6;19
292;10.01.2017;2017;01;21;Tiistai;1;7;8;2;5;7
292;10.01.2017;2017;01;22;Tiistai;0;3;3;2;1;3
292;10.01.2017;2017;01;23;Tiistai;0;0;0;0;0;0
292;11.01.2017;2017;01;00;Keskiviikko;0;0;0;0;0;0
292;11.01.2017;2017;01;01;Keskiviikko;0;1;1;0;0;0
292;11.01.2017;2017;01;02;Keskiviikko;0;0;0;0;0;0
292;11.01.2017;2017;01;03;Keskiviikko;0;0;0;0;0;0
292;11.01.2017;2017;01;04;Keskiviikko;1;0;1;0;0;0
292;11.01.2017;2017;01;05;Keskiviikko;4;7;11;12;9;21
292;11.01.2017;2017;01;06;Keskiviikko;10;9;19;3;7;10
292;11.01.2017;2017;01;07;Keskiviikko;55;17;72;24;12;36
292;11.01.2017;2017;01;08;Keskiviikko;42;10;52;14;12;26
292;11.01.2017;2017;01;09;Keskiviikko;14;7;21;12;21;33
292;11.01.2017;2017;01;10;Keskiviikko;6;6;12;13;10;23
292;11.01.2017;2017;01;11;Keskiviikko;14;16;30;15;11;26
292;11.01.2017;2017;01;12;Keskiviikko;16;13;29;13;7;20
292;11.01.2017;2017;01;13;Keskiviikko;6;74;80;15;17;32
292;11.01.2017;2017;01;14;Keskiviikko;17;36;53;15;26;41
292;11.01.2017;2017;01;15;Keskiviikko;19;16;35;15;15;30
292;11.01.2017;2017;01;16;Keskiviikko;18;23;41;16;17;33
292;11.01.2017;2017;01;17;Keskiviikko;19;18;37;10;15;25
292;11.01.2017;2017;01;18;Keskiviikko;11;4;15;11;14;25
292;11.01.2017;2017;01;19;Keskiviikko;7;7;14;15;6;21
292;11.01.2017;2017;01;20;Keskiviikko;7;3;10;7;10;17
292;11.01.2017;2017;01;21;Keskiviikko;2;1;3;4;6;10
292;11.01.2017;2017;01;22;Keskiviikko;3;6;9;0;2;2
292;11.01.2017;2017;01;23;Keskiviikko;0;0;0;1;1;2
292;12.01.2017;2017;01;00;Torstai;0;0;0;0;3;3
292;12.01.2017;2017;01;01;Torstai;1;1;2;0;2;2
292;12.01.2017;2017;01;02;Torstai;0;0;0;0;0;0
292;12.01.2017;2017;01;03;Torstai;0;0;0;0;0;0
292;12.01.2017;2017;01;04;Torstai;1;0;1;0;0;0
292;12.01.2017;2017;01;05;Torstai;2;3;5;5;0;5
292;12.01.2017;2017;01;06;Torstai;8;9;17;2;5;7
292;12.01.2017;2017;01;07;Torstai;46;6;52;19;17;36
292;12.01.2017;2017;01;08;Torstai;25;6;31;15;19;34
292;12.01.2017;2017;01;09;Torstai;37;11;48;24;8;32
292;12.01.2017;2017;01;10;Torstai;9;4;13;15;10;25
292;12.01.2017;2017;01;11;Torstai;16;2;18;7;7;14
292;12.01.2017;2017;01;12;Torstai;13;5;18;8;8;16
292;12.01.2017;2017;01;13;Torstai;16;20;36;11;18;29
292;12.01.2017;2017;01;14;Torstai;9;34;43;22;18;40
292;12.01.2017;2017;01;15;Torstai;22;49;71;10;26;36
292;12.01.2017;2017;01;16;Torstai;16;24;40;12;24;36
292;12.01.2017;2017;01;17;Torstai;9;11;20;9;8;17
292;12.01.2017;2017;01;18;Torstai;10;7;17;15;9;24
292;12.01.2017;2017;01;19;Torstai;5;4;9;6;9;15
292;12.01.2017;2017;01;20;Torstai;7;2;9;11;7;18
292;12.01.2017;2017;01;21;Torstai;0;5;5;5;6;11
292;12.01.2017;2017;01;22;Torstai;0;4;4;0;1;1
292;12.01.2017;2017;01;23;Torstai;1;0;1;3;0;3
292;13.01.2017;2017;01;00;Perjantai;0;1;1;0;1;1
292;13.01.2017;2017;01;01;Perjantai;0;0;0;0;0;0
292;13.01.2017;2017;01;02;Perjantai;0;0;0;0;1;1
292;13.01.2017;2017;01;03;Perjantai;0;0;0;0;0;0
292;13.01.2017;2017;01;04;Perjantai;2;0;2;0;1;1
292;13.01.2017;2017;01;05;Perjantai;3;5;8;1;0;1
292;13.01.2017;2017;01;06;Perjantai;8;5;13;3;6;9
292;13.01.2017;2017;01;07;Perjantai;53;14;67;19;7;26
292;13.01.2017;2017;01;08;Perjantai;36;11;47;14;14;28
292;13.01.2017;2017;01;09;Perjantai;18;9;27;14;13;27
292;13.01.2017;2017;01;10;Perjantai;13;7;20;5;10;15
292;13.01.2017;2017;01;11;Perjantai;7;12;19;21;12;33
292;13.01.2017;2017;01;12;Perjantai;10;18;28;13;9;22
292;13.01.2017;2017;01;13;Perjantai;12;44;56;17;16;33
292;13.01.2017;2017;01;14;Perjantai;15;38;53;17;12;29
292;13.01.2017;2017;01;15;Perjantai;12;29;41;20;17;37
292;13.01.2017;2017;01;16;Perjantai;12;16;28;15;14;29
292;13.01.2017;2017;01;17;Perjantai;6;12;18;15;9;24
292;13.01.2017;2017;01;18;Perjantai;12;7;19;15;7;22
292;13.01.2017;2017;01;19;Perjantai;6;6;12;11;7;18
292;13.01.2017;2017;01;20;Perjantai;7;3;10;7;8;15
292;13.01.2017;2017;01;21;Perjantai;5;7;12;5;5;10
292;13.01.2017;2017;01;22;Perjantai;1;1;2;4;0;4
292;13.01.2017;2017;01;23;Perjantai;2;4;6;6;4;10
292;14.01.2017;2017;01;00;Lauantai;0;3;3;3;2;5
292;14.01.2017;2017;01;01;Lauantai;1;0;1;2;7;9
292;14.01.2017;2017;01;02;Lauantai;0;1;1;0;6;6
292;14.01.2017;2017;01;03;Lauantai;0;0;0;1;4;5
292;14.01.2017;2017;01;04;Lauantai;1;0;1;0;0;0
292;14.01.2017;2017;01;05;Lauantai;1;0;1;3;0;3
292;14.01.2017;2017;01;06;Lauantai;1;0;1;1;1;2
292;14.01.2017;2017;01;07;Lauantai;2;2;4;3;6;9
292;14.01.2017;2017;01;08;Lauantai;1;0;1;2;7;9
292;14.01.2017;2017;01;09;Lauantai;3;4;7;6;7;13
292;14.01.2017;2017;01;10;Lauantai;2;9;11;4;9;13
292;14.01.2017;2017;01;11;Lauantai;8;12;20;16;28;44
292;14.01.2017;2017;01;12;Lauantai;13;12;25;22;20;42
292;14.01.2017;2017;01;13;Lauantai;13;2;15;16;10;26
292;14.01.2017;2017;01;14;Lauantai;6;12;18;22;17;39
292;14.01.2017;2017;01;15;Lauantai;9;7;16;17;10;27
292;14.01.2017;2017;01;16;Lauantai;9;13;22;18;10;28
292;14.01.2017;2017;01;17;Lauantai;4;6;10;13;11;24
292;14.01.2017;2017;01;18;Lauantai;7;8;15;13;13;26
292;14.01.2017;2017;01;19;Lauantai;5;5;10;5;7;12
292;14.01.2017;2017;01;20;Lauantai;7;2;9;10;8;18
292;14.01.2017;2017;01;21;Lauantai;6;3;9;9;2;11
292;14.01.2017;2017;01;22;Lauantai;2;6;8;7;2;9
292;14.01.2017;2017;01;23;Lauantai;1;2;3;6;2;8
292;15.01.2017;2017;01;00;Sunnuntai;2;1;3;3;0;3
292;15.01.2017;2017;01;01;Sunnuntai;0;1;1;1;3;4
292;15.01.2017;2017;01;02;Sunnuntai;1;1;2;2;7;9
292;15.01.2017;2017;01;03;Sunnuntai;0;1;1;1;2;3
292;15.01.2017;2017;01;04;Sunnuntai;1;2;3;0;4;4
292;15.01.2017;2017;01;05;Sunnuntai;0;2;2;2;0;2
292;15.01.2017;2017;01;06;Sunnuntai;4;1;5;2;3;5
292;15.01.2017;2017;01;07;Sunnuntai;2;3;5;1;0;1
292;15.01.2017;2017;01;08;Sunnuntai;1;3;4;5;0;5
292;15.01.2017;2017;01;09;Sunnuntai;9;6;15;12;4;16
292;15.01.2017;2017;01;10;Sunnuntai;5;2;7;13;11;24
292;15.01.2017;2017;01;11;Sunnuntai;6;11;17;5;19;24
292;15.01.2017;2017;01;12;Sunnuntai;7;14;21;21;8;29
292;15.01.2017;2017;01;13;Sunnuntai;7;8;15;6;20;26
292;15.01.2017;2017;01;14;Sunnuntai;3;4;7;17;13;30
292;15.01.2017;2017;01;15;Sunnuntai;10;8;18;9;7;16
292;15.01.2017;2017;01;16;Sunnuntai;14;11;25;16;8;24
292;15.01.2017;2017;01;17;Sunnuntai;7;8;15;17;18;35
292;15.01.2017;2017;01;18;Sunnuntai;9;9;18;16;19;35
292;15.01.2017;2017;01;19;Sunnuntai;4;9;13;12;8;20
292;15.01.2017;2017;01;20;Sunnuntai;2;2;4;5;3;8
292;15.01.2017;2017;01;21;Sunnuntai;1;3;4;1;4;5
292;15.01.2017;2017;01;22;Sunnuntai;0;1;1;1;2;3
292;15.01.2017;2017;01;23;Sunnuntai;1;0;1;1;0;1
292;16.01.2017;2017;01;00;Maanantai;0;0;0;1;0;1
292;16.01.2017;2017;01;01;Maanantai;0;0;0;0;1;1
292;16.01.2017;2017;01;02;Maanantai;0;1;1;0;2;2
292;16.01.2017;2017;01;03;Maanantai;0;0;0;0;0;0
292;16.01.2017;2017;01;04;Maanantai;1;1;2;1;0;1
292;16.01.2017;2017;01;05;Maanantai;3;5;8;2;2;4
292;16.01.2017;2017;01;06;Maanantai;6;6;12;6;4;10
292;16.01.2017;2017;01;07;Maanantai;11;11;22;34;16;50
292;16.01.2017;2017;01;08;Maanantai;29;14;43;24;20;44
292;16.01.2017;2017;01;09;Maanantai;35;4;39;12;12;24
292;16.01.2017;2017;01;10;Maanantai;8;1;9;21;6;27
292;16.01.2017;2017;01;11;Maanantai;11;11;22;11;7;18
292;16.01.2017;2017;01;12;Maanantai;9;12;21;18;13;31
292;16.01.2017;2017;01;13;Maanantai;12;26;38;13;21;34
292;16.01.2017;2017;01;14;Maanantai;15;31;46;30;21;51
292;16.01.2017;2017;01;15;Maanantai;15;43;58;19;21;40
292;16.01.2017;2017;01;16;Maanantai;19;37;56;16;24;40
292;16.01.2017;2017;01;17;Maanantai;7;13;20;23;17;40
292;16.01.2017;2017;01;18;Maanantai;10;8;18;24;17;41
292;16.01.2017;2017;01;19;Maanantai;8;9;17;7;16;23
292;16.01.2017;2017;01;20;Maanantai;10;6;16;13;9;22
292;16.01.2017;2017;01;21;Maanantai;2;6;8;3;3;6
292;16.01.2017;2017;01;22;Maanantai;2;1;3;0;0;0
292;16.01.2017;2017;01;23;Maanantai;2;0;2;0;0;0
292;17.01.2017;2017;01;00;Tiistai;0;0;0;0;0;0
292;17.01.2017;2017;01;01;Tiistai;0;1;1;0;2;2
292;17.01.2017;2017;01;02;Tiistai;0;0;0;0;0;0
292;17.01.2017;2017;01;03;Tiistai;0;0;0;0;0;0
292;17.01.2017;2017;01;04;Tiistai;2;0;2;0;0;0
292;17.01.2017;2017;01;05;Tiistai;6;3;9;6;2;8
292;17.01.2017;2017;01;06;Tiistai;5;10;15;2;7;9
292;17.01.2017;2017;01;07;Tiistai;41;13;54;19;16;35
292;17.01.2017;2017;01;08;Tiistai;55;15;70;21;23;44
292;17.01.2017;2017;01;09;Tiistai;24;9;33;16;16;32
292;17.01.2017;2017;01;10;Tiistai;11;10;21;12;12;24
292;17.01.2017;2017;01;11;Tiistai;5;7;12;15;12;27
292;17.01.2017;2017;01;12;Tiistai;7;20;27;14;15;29
292;17.01.2017;2017;01;13;Tiistai;16;31;47;23;13;36
292;17.01.2017;2017;01;14;Tiistai;15;43;58;22;26;48
292;17.01.2017;2017;01;15;Tiistai;17;30;47;15;22;37
292;17.01.2017;2017;01;16;Tiistai;25;16;41;8;20;28
292;17.01.2017;2017;01;17;Tiistai;33;13;46;21;20;41
292;17.01.2017;2017;01;18;Tiistai;9;9;18;16;12;28
292;17.01.2017;2017;01;19;Tiistai;11;27;38;14;24;38
292;17.01.2017;2017;01;20;Tiistai;4;3;7;10;9;19
292;17.01.2017;2017;01;21;Tiistai;4;4;8;5;4;9
292;17.01.2017;2017;01;22;Tiistai;1;2;3;4;3;7
292;17.01.2017;2017;01;23;Tiistai;1;0;1;0;1;1
292;18.01.2017;2017;01;00;Keskiviikko;0;0;0;0;0;0
292;18.01.2017;2017;01;01;Keskiviikko;1;1;2;0;0;0
292;18.01.2017;2017;01;02;Keskiviikko;0;0;0;0;0;0
292;18.01.2017;2017;01;03;Keskiviikko;0;0;0;0;0;0
292;18.01.2017;2017;01;04;Keskiviikko;3;0;3;1;1;2
292;18.01.2017;2017;01;05;Keskiviikko;2;6;8;4;0;4
292;18.01.2017;2017;01;06;Keskiviikko;5;13;18;5;7;12
292;18.01.2017;2017;01;07;Keskiviikko;47;16;63;14;10;24
292;18.01.2017;2017;01;08;Keskiviikko;51;16;67;30;12;42
292;18.01.2017;2017;01;09;Keskiviikko;15;13;28;5;13;18
292;18.01.2017;2017;01;10;Keskiviikko;11;12;23;7;9;16
292;18.01.2017;2017;01;11;Keskiviikko;16;8;24;18;18;36
292;18.01.2017;2017;01;12;Keskiviikko;13;14;27;19;14;33
292;18.01.2017;2017;01;13;Keskiviikko;20;74;94;24;31;55
292;18.01.2017;2017;01;14;Keskiviikko;21;41;62;25;23;48
292;18.01.2017;2017;01;15;Keskiviikko;22;42;64;10;18;28
292;18.01.2017;2017;01;16;Keskiviikko;24;14;38;18;23;41
292;18.01.2017;2017;01;17;Keskiviikko;17;15;32;25;16;41
292;18.01.2017;2017;01;18;Keskiviikko;11;10;21;18;15;33
292;18.01.2017;2017;01;19;Keskiviikko;7;9;16;12;11;23
292;18.01.2017;2017;01;20;Keskiviikko;6;8;14;10;10;20
292;18.01.2017;2017;01;21;Keskiviikko;4;6;10;1;7;8
292;18.01.2017;2017;01;22;Keskiviikko;1;6;7;4;0;4
292;18.01.2017;2017;01;23;Keskiviikko;0;0;0;0;0;0
292;19.01.2017;2017;01;00;Torstai;0;0;0;0;0;0
292;19.01.2017;2017;01;01;Torstai;0;0;0;0;0;0
292;19.01.2017;2017;01;02;Torstai;0;0;0;0;0;0
292;19.01.2017;2017;01;03;Torstai;0;1;1;0;0;0
292;19.01.2017;2017;01;04;Torstai;2;0;2;1;0;1
292;19.01.2017;2017;01;05;Torstai;2;4;6;3;2;5
292;19.01.2017;2017;01;06;Torstai;8;7;15;3;8;11
292;19.01.2017;2017;01;07;Torstai;27;7;34;27;5;32
292;19.01.2017;2017;01;08;Torstai;34;10;44;19;19;38
292;19.01.2017;2017;01;09;Torstai;36;8;44;14;12;26
292;19.01.2017;2017;01;10;Torstai;3;4;7;15;7;22
292;19.01.2017;2017;01;11;Torstai;10;5;15;18;15;33
292;19.01.2017;2017;01;12;Torstai;13;10;23;19;11;30
292;19.01.2017;2017;01;13;Torstai;6;29;35;12;15;27
292;19.01.2017;2017;01;14;Torstai;13;34;47;14;21;35
292;19.01.2017;2017;01;15;Torstai;5;48;53;23;20;43
292;19.01.2017;2017;01;16;Torstai;10;21;31;11;26;37
292;19.01.2017;2017;01;17;Torstai;12;16;28;22;19;41
292;19.01.2017;2017;01;18;Torstai;9;8;17;8;10;18
292;19.01.2017;2017;01;19;Torstai;5;7;12;18;13;31
292;19.01.2017;2017;01;20;Torstai;6;6;12;11;6;17
292;19.01.2017;2017;01;21;Torstai;3;4;7;4;1;5
292;19.01.2017;2017;01;22;Torstai;0;4;4;3;0;3
292;19.01.2017;2017;01;23;Torstai;0;1;1;0;1;1
292;20.01.2017;2017;01;00;Perjantai;0;0;0;1;0;1
292;20.01.2017;2017;01;01;Perjantai;0;0;0;0;4;4
292;20.01.2017;2017;01;02;Perjantai;1;0;1;0;0;0
292;20.01.2017;2017;01;03;Perjantai;0;0;0;0;0;0
292;20.01.2017;2017;01;04;Perjantai;2;0;2;1;0;1
292;20.01.2017;2017;01;05;Perjantai;2;6;8;5;2;7
292;20.01.2017;2017;01;06;Perjantai;8;6;14;3;9;12
292;20.01.2017;2017;01;07;Perjantai;31;7;38;15;4;19
292;20.01.2017;2017;01;08;Perjantai;50;5;55;21;10;31
292;20.01.2017;2017;01;09;Perjantai;16;5;21;11;7;18
292;20.01.2017;2017;01;10;Perjantai;7;3;10;9;14;23
292;20.01.2017;2017;01;11;Perjantai;6;9;15;7;12;19
292;20.01.2017;2017;01;12;Perjantai;8;12;20;17;9;26
292;20.01.2017;2017;01;13;Perjantai;7;43;50;19;35;54
292;20.01.2017;2017;01;14;Perjantai;7;37;44;22;30;52
292;20.01.2017;2017;01;15;Perjantai;11;36;47;14;25;39
292;20.01.2017;2017;01;16;Perjantai;15;12;27;7;15;22
292;20.01.2017;2017;01;17;Perjantai;8;11;19;27;13;40
292;20.01.2017;2017;01;18;Perjantai;7;7;14;11;15;26
292;20.01.2017;2017;01;19;Perjantai;7;9;16;17;7;24
292;20.01.2017;2017;01;20;Perjantai;14;1;15;14;1;15
292;20.01.2017;2017;01;21;Perjantai;4;10;14;10;7;17
292;20.01.2017;2017;01;22;Perjantai;2;4;6;4;9;13
292;20.01.2017;2017;01;23;Perjantai;2;4;6;4;1;5
292;21.01.2017;2017;01;00;Lauantai;1;0;1;0;0;0
292;21.01.2017;2017;01;01;Lauantai;1;2;3;1;0;1
292;21.01.2017;2017;01;02;Lauantai;1;2;3;1;3;4
292;21.01.2017;2017;01;03;Lauantai;0;1;1;0;0;0
292;21.01.2017;2017;01;04;Lauantai;0;3;3;0;0;0
292;21.01.2017;2017;01;05;Lauantai;1;3;4;0;0;0
292;21.01.2017;2017;01;06;Lauantai;3;2;5;1;1;2
292;21.01.2017;2017;01;07;Lauantai;0;1;1;3;0;3
292;21.01.2017;2017;01;08;Lauantai;0;2;2;5;4;9
292;21.01.2017;2017;01;09;Lauantai;3;2;5;5;7;12
292;21.01.2017;2017;01;10;Lauantai;3;6;9;5;11;16
292;21.01.2017;2017;01;11;Lauantai;9;12;21;17;13;30
292;21.01.2017;2017;01;12;Lauantai;9;5;14;23;24;47
292;21.01.2017;2017;01;13;Lauantai;11;7;18;14;13;27
292;21.01.2017;2017;01;14;Lauantai;10;18;28;19;13;32
292;21.01.2017;2017;01;15;Lauantai;5;3;8;12;15;27
292;21.01.2017;2017;01;16;Lauantai;10;12;22;14;14;28
292;21.01.2017;2017;01;17;Lauantai;4;8;12;18;11;29
292;21.01.2017;2017;01;18;Lauantai;7;4;11;13;11;24
292;21.01.2017;2017;01;19;Lauantai;6;3;9;12;13;25
292;21.01.2017;2017;01;20;Lauantai;2;7;9;7;7;14
292;21.01.2017;2017;01;21;Lauantai;2;3;5;4;4;8
292;21.01.2017;2017;01;22;Lauantai;2;1;3;0;0;0
292;21.01.2017;2017;01;23;Lauantai;0;0;0;0;0;0
292;22.01.2017;2017;01;00;Sunnuntai;0;1;1;10;0;10
292;22.01.2017;2017;01;01;Sunnuntai;1;1;2;1;1;2
292;22.01.2017;2017;01;02;Sunnuntai;0;0;0;5;6;11
292;22.01.2017;2017;01;03;Sunnuntai;0;1;1;0;1;1
292;22.01.2017;2017;01;04;Sunnuntai;0;0;0;0;0;0
292;22.01.2017;2017;01;05;Sunnuntai;1;0;1;1;0;1
292;22.01.2017;2017;01;06;Sunnuntai;3;2;5;0;2;2
292;22.01.2017;2017;01;07;Sunnuntai;0;2;2;1;1;2
292;22.01.2017;2017;01;08;Sunnuntai;0;1;1;6;1;7
292;22.01.2017;2017;01;09;Sunnuntai;7;1;8;11;3;14
292;22.01.2017;2017;01;10;Sunnuntai;3;3;6;2;7;9
292;22.01.2017;2017;01;11;Sunnuntai;4;14;18;19;14;33
292;22.01.2017;2017;01;12;Sunnuntai;6;9;15;21;19;40
292;22.01.2017;2017;01;13;Sunnuntai;7;6;13;8;10;18
292;22.01.2017;2017;01;14;Sunnuntai;8;21;29;10;17;27
292;22.01.2017;2017;01;15;Sunnuntai;14;5;19;13;10;23
292;22.01.2017;2017;01;16;Sunnuntai;12;15;27;10;13;23
292;22.01.2017;2017;01;17;Sunnuntai;5;2;7;18;16;34
292;22.01.2017;2017;01;18;Sunnuntai;5;7;12;18;22;40
292;22.01.2017;2017;01;19;Sunnuntai;7;4;11;7;10;17
292;22.01.2017;2017;01;20;Sunnuntai;5;3;8;10;6;16
292;22.01.2017;2017;01;21;Sunnuntai;2;1;3;2;5;7
292;22.01.2017;2017;01;22;Sunnuntai;0;3;3;1;2;3
292;22.01.2017;2017;01;23;Sunnuntai;0;0;0;2;0;2
292;23.01.2017;2017;01;00;Maanantai;0;1;1;0;0;0
292;23.01.2017;2017;01;01;Maanantai;0;0;0;0;0;0
292;23.01.2017;2017;01;02;Maanantai;0;0;0;0;1;1
292;23.01.2017;2017;01;03;Maanantai;0;1;1;0;0;0
292;23.01.2017;2017;01;04;Maanantai;1;0;1;2;0;2
292;23.01.2017;2017;01;05;Maanantai;5;2;7;3;0;3
292;23.01.2017;2017;01;06;Maanantai;7;10;17;4;4;8
292;23.01.2017;2017;01;07;Maanantai;48;14;62;11;14;25
292;23.01.2017;2017;01;08;Maanantai;30;23;53;15;21;36
292;23.01.2017;2017;01;09;Maanantai;36;9;45;20;10;30
292;23.01.2017;2017;01;10;Maanantai;17;6;23;19;16;35
292;23.01.2017;2017;01;11;Maanantai;19;8;27;10;17;27
292;23.01.2017;2017;01;12;Maanantai;13;11;24;13;17;30
292;23.01.2017;2017;01;13;Maanantai;11;23;34;14;15;29
292;23.01.2017;2017;01;14;Maanantai;21;29;50;13;18;31
292;23.01.2017;2017;01;15;Maanantai;14;43;57;22;19;41
292;23.01.2017;2017;01;16;Maanantai;20;41;61;21;36;57
292;23.01.2017;2017;01;17;Maanantai;10;20;30;17;28;45
292;23.01.2017;2017;01;18;Maanantai;11;9;20;14;15;29
292;23.01.2017;2017;01;19;Maanantai;11;9;20;12;9;21
292;23.01.2017;2017;01;20;Maanantai;8;3;11;15;14;29
292;23.01.2017;2017;01;21;Maanantai;2;9;11;2;1;3
292;23.01.2017;2017;01;22;Maanantai;1;2;3;0;0;0
292;23.01.2017;2017;01;23;Maanantai;0;1;1;0;0;0
292;24.01.2017;2017;01;00;Tiistai;0;1;1;0;0;0
292;24.01.2017;2017;01;01;Tiistai;1;2;3;0;0;0
292;24.01.2017;2017;01;02;Tiistai;0;0;0;0;0;0
292;24.01.2017;2017;01;03;Tiistai;0;1;1;1;0;1
292;24.01.2017;2017;01;04;Tiistai;3;1;4;0;0;0
292;24.01.2017;2017;01;05;Tiistai;4;6;10;2;0;2
292;24.01.2017;2017;01;06;Tiistai;8;7;15;3;4;7
292;24.01.2017;2017;01;07;Tiistai;36;8;44;23;17;40
292;24.01.2017;2017;01;08;Tiistai;43;14;57;16;16;32
292;24.01.2017;2017;01;09;Tiistai;14;9;23;10;11;21
292;24.01.2017;2017;01;10;Tiistai;16;6;22;9;9;18
292;24.01.2017;2017;01;11;Tiistai;6;9;15;14;18;32
292;24.01.2017;2017;01;12;Tiistai;8;7;15;16;9;25
292;24.01.2017;2017;01;13;Tiistai;10;13;23;15;18;33
292;24.01.2017;2017;01;14;Tiistai;16;42;58;14;28;42
292;24.01.2017;2017;01;15;Tiistai;13;35;48;16;22;38
292;24.01.2017;2017;01;16;Tiistai;19;18;37;21;19;40
292;24.01.2017;2017;01;17;Tiistai;7;12;19;15;19;34
292;24.01.2017;2017;01;18;Tiistai;8;9;17;8;4;12
292;24.01.2017;2017;01;19;Tiistai;7;9;16;6;3;9
292;24.01.2017;2017;01;20;Tiistai;4;2;6;5;5;10
292;24.01.2017;2017;01;21;Tiistai;3;3;6;0;6;6
292;24.01.2017;2017;01;22;Tiistai;0;0;0;1;0;1
292;24.01.2017;2017;01;23;Tiistai;1;0;1;0;0;0
292;25.01.2017;2017;01;00;Keskiviikko;0;0;0;0;1;1
292;25.01.2017;2017;01;01;Keskiviikko;0;0;0;0;0;0
292;25.01.2017;2017;01;02;Keskiviikko;0;0;0;0;0;0
292;25.01.2017;2017;01;03;Keskiviikko;0;0;0;0;0;0
292;25.01.2017;2017;01;04;Keskiviikko;2;0;2;0;0;0
292;25.01.2017;2017;01;05;Keskiviikko;2;3;5;6;1;7
292;25.01.2017;2017;01;06;Keskiviikko;10;3;13;6;9;15
292;25.01.2017;2017;01;07;Keskiviikko;50;15;65;19;9;28
292;25.01.2017;2017;01;08;Keskiviikko;36;15;51;18;12;30
292;25.01.2017;2017;01;09;Keskiviikko;9;6;15;16;12;28
292;25.01.2017;2017;01;10;Keskiviikko;11;12;23;9;13;22
292;25.01.2017;2017;01;11;Keskiviikko;11;7;18;9;12;21
292;25.01.2017;2017;01;12;Keskiviikko;18;16;34;14;8;22
292;25.01.2017;2017;01;13;Keskiviikko;11;48;59;10;26;36
292;25.01.2017;2017;01;14;Keskiviikko;19;29;48;7;23;30
292;25.01.2017;2017;01;15;Keskiviikko;19;25;44;23;23;46
292;25.01.2017;2017;01;16;Keskiviikko;21;27;48;14;15;29
292;25.01.2017;2017;01;17;Keskiviikko;14;11;25;16;7;23
292;25.01.2017;2017;01;18;Keskiviikko;5;7;12;15;14;29
292;25.01.2017;2017;01;19;Keskiviikko;5;7;12;12;11;23
292;25.01.2017;2017;01;20;Keskiviikko;8;3;11;8;7;15
292;25.01.2017;2017;01;21;Keskiviikko;2;2;4;2;1;3
292;25.01.2017;2017;01;22;Keskiviikko;1;3;4;2;3;5
292;25.01.2017;2017;01;23;Keskiviikko;2;0;2;0;0;0
292;26.01.2017;2017;01;00;Torstai;0;0;0;0;0;0
292;26.01.2017;2017;01;01;Torstai;0;1;1;0;2;2
292;26.01.2017;2017;01;02;Torstai;0;0;0;0;0;0
292;26.01.2017;2017;01;03;Torstai;0;0;0;0;0;0
292;26.01.2017;2017;01;04;Torstai;1;2;3;8;6;14
292;26.01.2017;2017;01;05;Torstai;3;3;6;4;2;6
292;26.01.2017;2017;01;06;Torstai;5;7;12;7;7;14
292;26.01.2017;2017;01;07;Torstai;31;12;43;17;8;25
292;26.01.2017;2017;01;08;Torstai;24;10;34;19;20;39
292;26.01.2017;2017;01;09;Torstai;33;6;39;21;9;30
292;26.01.2017;2017;01;10;Torstai;10;6;16;16;24;40
292;26.01.2017;2017;01;11;Torstai;12;10;22;15;13;28
292;26.01.2017;2017;01;12;Torstai;7;15;22;20;13;33
292;26.01.2017;2017;01;13;Torstai;9;21;30;19;32;51
292;26.01.2017;2017;01;14;Torstai;15;28;43;26;21;47
292;26.01.2017;2017;01;15;Torstai;14;31;45;16;35;51
292;26.01.2017;2017;01;16;Torstai;14;25;39;26;28;54
292;26.01.2017;2017;01;17;Torstai;10;11;21;18;14;32
292;26.01.2017;2017;01;18;Torstai;9;11;20;18;17;35
292;26.01.2017;2017;01;19;Torstai;8;9;17;17;9;26
292;26.01.2017;2017;01;20;Torstai;11;5;16;7;8;15
292;26.01.2017;2017;01;21;Torstai;5;2;7;4;4;8
292;26.01.2017;2017;01;22;Torstai;0;5;5;2;1;3
292;26.01.2017;2017;01;23;Torstai;0;0;0;0;1;1
292;27.01.2017;2017;01;00;Perjantai;0;0;0;1;0;1
292;27.01.2017;2017;01;01;Perjantai;0;1;1;0;2;2
292;27.01.2017;2017;01;02;Perjantai;0;0;0;0;0;0
292;27.01.2017;2017;01;03;Perjantai;0;0;0;0;0;0
292;27.01.2017;2017;01;04;Perjantai;3;0;3;0;0;0
292;27.01.2017;2017;01;05;Perjantai;4;3;7;3;2;5
292;27.01.2017;2017;01;06;Perjantai;11;4;15;4;8;12
292;27.01.2017;2017;01;07;Perjantai;39;11;50;19;15;34
292;27.01.2017;2017;01;08;Perjantai;41;12;53;22;19;41
292;27.01.2017;2017;01;09;Perjantai;18;5;23;15;11;26
292;27.01.2017;2017;01;10;Perjantai;7;13;20;7;14;21
292;27.01.2017;2017;01;11;Perjantai;5;8;13;11;13;24
292;27.01.2017;2017;01;12;Perjantai;14;15;29;11;21;32
292;27.01.2017;2017;01;13;Perjantai;15;36;51;17;39;56
292;27.01.2017;2017;01;14;Perjantai;11;32;43;27;29;56
292;27.01.2017;2017;01;15;Perjantai;19;28;47;13;22;35
292;27.01.2017;2017;01;16;Perjantai;20;18;38;14;17;31
292;27.01.2017;2017;01;17;Perjantai;9;15;24;11;19;30
292;27.01.2017;2017;01;18;Perjantai;4;14;18;14;17;31
292;27.01.2017;2017;01;19;Perjantai;13;6;19;6;6;12
292;27.01.2017;2017;01;20;Perjantai;5;2;7;4;6;10
292;27.01.2017;2017;01;21;Perjantai;9;4;13;8;3;11
292;27.01.2017;2017;01;22;Perjantai;5;6;11;13;2;15
292;27.01.2017;2017;01;23;Perjantai;0;2;2;2;1;3
292;28.01.2017;2017;01;00;Lauantai;0;1;1;4;1;5
292;28.01.2017;2017;01;01;Lauantai;2;2;4;3;0;3
292;28.01.2017;2017;01;02;Lauantai;0;3;3;1;8;9
292;28.01.2017;2017;01;03;Lauantai;1;1;2;6;2;8
292;28.01.2017;2017;01;04;Lauantai;1;0;1;1;2;3
292;28.01.2017;2017;01;05;Lauantai;0;1;1;1;1;2
292;28.01.2017;2017;01;06;Lauantai;1;0;1;1;0;1
292;28.01.2017;2017;01;07;Lauantai;0;1;1;4;7;11
292;28.01.2017;2017;01;08;Lauantai;0;8;8;4;4;8
292;28.01.2017;2017;01;09;Lauantai;5;3;8;3;17;20
292;28.01.2017;2017;01;10;Lauantai;7;5;12;11;21;32
292;28.01.2017;2017;01;11;Lauantai;11;6;17;20;32;52
292;28.01.2017;2017;01;12;Lauantai;14;14;28;19;18;37
292;28.01.2017;2017;01;13;Lauantai;13;13;26;9;20;29
292;28.01.2017;2017;01;14;Lauantai;22;15;37;20;19;39
292;28.01.2017;2017;01;15;Lauantai;18;7;25;25;10;35
292;28.01.2017;2017;01;16;Lauantai;10;8;18;20;15;35
292;28.01.2017;2017;01;17;Lauantai;14;7;21;16;9;25
292;28.01.2017;2017;01;18;Lauantai;7;13;20;12;12;24
292;28.01.2017;2017;01;19;Lauantai;7;3;10;8;8;16
292;28.01.2017;2017;01;20;Lauantai;4;9;13;6;3;9
292;28.01.2017;2017;01;21;Lauantai;4;7;11;5;5;10
292;28.01.2017;2017;01;22;Lauantai;2;5;7;1;8;9
292;28.01.2017;2017;01;23;Lauantai;2;2;4;8;2;10
292;29.01.2017;2017;01;00;Sunnuntai;4;4;8;7;3;10
292;29.01.2017;2017;01;01;Sunnuntai;2;5;7;1;3;4
292;29.01.2017;2017;01;02;Sunnuntai;1;1;2;4;7;11
292;29.01.2017;2017;01;03;Sunnuntai;0;1;1;1;2;3
292;29.01.2017;2017;01;04;Sunnuntai;2;1;3;0;0;0
292;29.01.2017;2017;01;05;Sunnuntai;1;0;1;1;3;4
292;29.01.2017;2017;01;06;Sunnuntai;3;1;4;5;2;7
292;29.01.2017;2017;01;07;Sunnuntai;0;1;1;2;2;4
292;29.01.2017;2017;01;08;Sunnuntai;1;1;2;7;1;8
292;29.01.2017;2017;01;09;Sunnuntai;5;3;8;11;8;19
292;29.01.2017;2017;01;10;Sunnuntai;5;4;9;13;18;31
292;29.01.2017;2017;01;11;Sunnuntai;6;13;19;8;17;25
292;29.01.2017;2017;01;12;Sunnuntai;15;6;21;18;20;38
292;29.01.2017;2017;01;13;Sunnuntai;9;5;14;17;13;30
292;29.01.2017;2017;01;14;Sunnuntai;9;8;17;15;16;31
292;29.01.2017;2017;01;15;Sunnuntai;10;10;20;13;9;22
292;29.01.2017;2017;01;16;Sunnuntai;8;7;15;22;24;46
292;29.01.2017;2017;01;17;Sunnuntai;5;4;9;17;16;33
292;29.01.2017;2017;01;18;Sunnuntai;11;11;22;12;20;32
292;29.01.2017;2017;01;19;Sunnuntai;3;4;7;13;11;24
292;29.01.2017;2017;01;20;Sunnuntai;11;6;17;4;6;10
292;29.01.2017;2017;01;21;Sunnuntai;3;4;7;2;2;4
292;29.01.2017;2017;01;22;Sunnuntai;1;2;3;1;2;3
292;29.01.2017;2017;01;23;Sunnuntai;0;0;0;1;0;1
292;30.01.2017;2017;01;00;Maanantai;0;0;0;0;0;0
292;30.01.2017;2017;01;01;Maanantai;0;0;0;0;0;0
292;30.01.2017;2017;01;02;Maanantai;0;0;0;0;0;0
292;30.01.2017;2017;01;03;Maanantai;0;0;0;0;0;0
292;30.01.2017;2017;01;04;Maanantai;1;2;3;1;0;1
292;30.01.2017;2017;01;05;Maanantai;3;3;6;2;2;4
292;30.01.2017;2017;01;06;Maanantai;8;6;14;4;6;10
292;30.01.2017;2017;01;07;Maanantai;31;13;44;25;16;41
292;30.01.2017;2017;01;08;Maanantai;29;13;42;15;15;30
292;30.01.2017;2017;01;09;Maanantai;37;2;39;16;14;30
292;30.01.2017;2017;01;10;Maanantai;6;1;7;16;5;21
292;30.01.2017;2017;01;11;Maanantai;9;6;15;12;14;26
292;30.01.2017;2017;01;12;Maanantai;7;5;12;5;21;26
292;30.01.2017;2017;01;13;Maanantai;5;11;16;18;26;44
292;30.01.2017;2017;01;14;Maanantai;5;21;26;31;37;68
292;30.01.2017;2017;01;15;Maanantai;8;28;36;33;46;79
292;30.01.2017;2017;01;16;Maanantai;10;17;27;37;38;75
292;30.01.2017;2017;01;17;Maanantai;9;9;18;14;28;42
292;30.01.2017;2017;01;18;Maanantai;2;9;11;20;22;42
292;30.01.2017;2017;01;19;Maanantai;8;4;12;20;13;33
292;30.01.2017;2017;01;20;Maanantai;3;2;5;14;10;24
292;30.01.2017;2017;01;21;Maanantai;3;4;7;6;2;8
292;30.01.2017;2017;01;22;Maanantai;0;1;1;2;0;2
292;30.01.2017;2017;01;23;Maanantai;0;0;0;1;0;1
292;31.01.2017;2017;01;00;Tiistai;0;0;0;1;0;1
292;31.01.2017;2017;01;01;Tiistai;0;1;1;1;1;2
292;31.01.2017;2017;01;02;Tiistai;0;0;0;0;2;2
292;31.01.2017;2017;01;03;Tiistai;0;0;0;0;0;0
292;31.01.2017;2017;01;04;Tiistai;1;0;1;0;1;1
292;31.01.2017;2017;01;05;Tiistai;1;2;3;5;1;6
292;31.01.2017;2017;01;06;Tiistai;1;6;7;10;8;18
292;31.01.2017;2017;01;07;Tiistai;18;5;23;45;21;66
292;31.01.2017;2017;01;08;Tiistai;19;8;27;46;22;68
292;31.01.2017;2017;01;09;Tiistai;10;10;20;19;18;37
292;31.01.2017;2017;01;10;Tiistai;9;7;16;20;21;41
292;31.01.2017;2017;01;11;Tiistai;6;7;13;22;11;33
292;31.01.2017;2017;01;12;Tiistai;2;7;9;25;22;47
292;31.01.2017;2017;01;13;Tiistai;7;20;27;21;25;46
292;31.01.2017;2017;01;14;Tiistai;14;38;52;20;42;62
292;31.01.2017;2017;01;15;Tiistai;15;27;42;26;31;57
292;31.01.2017;2017;01;16;Tiistai;22;18;40;23;28;51
292;31.01.2017;2017;01;17;Tiistai;6;12;18;17;25;42
292;31.01.2017;2017;01;18;Tiistai;6;8;14;15;21;36
292;31.01.2017;2017;01;19;Tiistai;4;8;12;17;14;31
292;31.01.2017;2017;01;20;Tiistai;3;3;6;21;5;26
292;31.01.2017;2017;01;21;Tiistai;3;2;5;6;7;13
292;31.01.2017;2017;01;22;Tiistai;1;2;3;1;1;2
292;31.01.2017;2017;01;23;Tiistai;0;0;0;0;1;1
292;01.02.2017;2017;02;00;Keskiviikko;0;1;1;1;0;1
292;01.02.2017;2017;02;01;Keskiviikko;0;2;2;0;3;3
292;01.02.2017;2017;02;02;Keskiviikko;1;0;1;2;0;2
292;01.02.2017;2017;02;03;Keskiviikko;0;0;0;0;0;0
292;01.02.2017;2017;02;04;Keskiviikko;1;0;1;2;0;2
292;01.02.2017;2017;02;05;Keskiviikko;1;3;4;5;0;5
292;01.02.2017;2017;02;06;Keskiviikko;3;2;5;10;10;20
292;01.02.2017;2017;02;07;Keskiviikko;51;15;66;33;19;52
292;01.02.2017;2017;02;08;Keskiviikko;28;13;41;18;12;30
292;01.02.2017;2017;02;09;Keskiviikko;3;12;15;10;16;26
292;01.02.2017;2017;02;10;Keskiviikko;11;17;28;10;22;32
292;01.02.2017;2017;02;11;Keskiviikko;7;16;23;18;19;37
292;01.02.2017;2017;02;12;Keskiviikko;10;18;28;13;19;32
292;01.02.2017;2017;02;13;Keskiviikko;16;33;49;18;27;45
292;01.02.2017;2017;02;14;Keskiviikko;15;22;37;14;21;35
292;01.02.2017;2017;02;15;Keskiviikko;12;22;34;23;22;45
292;01.02.2017;2017;02;16;Keskiviikko;19;23;42;18;16;34
292;01.02.2017;2017;02;17;Keskiviikko;6;5;11;17;16;33
292;01.02.2017;2017;02;18;Keskiviikko;6;7;13;13;10;23
292;01.02.2017;2017;02;19;Keskiviikko;4;3;7;18;15;33
292;01.02.2017;2017;02;20;Keskiviikko;7;3;10;13;6;19
292;01.02.2017;2017;02;21;Keskiviikko;4;1;5;2;1;3
292;01.02.2017;2017;02;22;Keskiviikko;1;2;3;2;3;5
292;01.02.2017;2017;02;23;Keskiviikko;0;0;0;1;0;1
292;02.02.2017;2017;02;00;Torstai;1;0;1;0;1;1
292;02.02.2017;2017;02;01;Torstai;0;1;1;1;1;2
292;02.02.2017;2017;02;02;Torstai;0;0;0;1;0;1
292;02.02.2017;2017;02;03;Torstai;0;0;0;0;0;0
292;02.02.2017;2017;02;04;Torstai;2;0;2;0;0;0
292;02.02.2017;2017;02;05;Torstai;2;2;4;4;3;7
292;02.02.2017;2017;02;06;Torstai;8;4;12;6;15;21
292;02.02.2017;2017;02;07;Torstai;43;13;56;27;16;43
292;02.02.2017;2017;02;08;Torstai;28;15;43;19;17;36
292;02.02.2017;2017;02;09;Torstai;12;13;25;19;9;28
292;02.02.2017;2017;02;10;Torstai;10;17;27;16;29;45
292;02.02.2017;2017;02;11;Torstai;7;15;22;21;25;46
292;02.02.2017;2017;02;12;Torstai;12;15;27;17;11;28
292;02.02.2017;2017;02;13;Torstai;6;22;28;27;21;48
292;02.02.2017;2017;02;14;Torstai;16;30;46;11;10;21
292;02.02.2017;2017;02;15;Torstai;19;30;49;11;21;32
292;02.02.2017;2017;02;16;Torstai;19;12;31;15;19;34
292;02.02.2017;2017;02;17;Torstai;14;7;21;15;12;27
292;02.02.2017;2017;02;18;Torstai;5;4;9;4;6;10
292;02.02.2017;2017;02;19;Torstai;6;11;17;9;3;12
292;02.02.2017;2017;02;20;Torstai;7;2;9;20;14;34
292;02.02.2017;2017;02;21;Torstai;3;5;8;4;2;6
292;02.02.2017;2017;02;22;Torstai;0;3;3;1;2;3
292;02.02.2017;2017;02;23;Torstai;1;0;1;1;0;1
292;03.02.2017;2017;02;00;Perjantai;0;0;0;0;0;0
292;03.02.2017;2017;02;01;Perjantai;0;0;0;0;1;1
292;03.02.2017;2017;02;02;Perjantai;0;1;1;0;0;0
292;03.02.2017;2017;02;03;Perjantai;0;0;0;0;0;0
292;03.02.2017;2017;02;04;Perjantai;1;0;1;0;0;0
292;03.02.2017;2017;02;05;Perjantai;6;4;10;9;8;17
292;03.02.2017;2017;02;06;Perjantai;9;5;14;4;7;11
292;03.02.2017;2017;02;07;Perjantai;40;9;49;33;13;46
292;03.02.2017;2017;02;08;Perjantai;30;12;42;16;13;29
292;03.02.2017;2017;02;09;Perjantai;10;13;23;8;12;20
292;03.02.2017;2017;02;10;Perjantai;10;15;25;8;16;24
292;03.02.2017;2017;02;11;Perjantai;6;21;27;13;17;30
292;03.02.2017;2017;02;12;Perjantai;10;25;35;23;14;37
292;03.02.2017;2017;02;13;Perjantai;21;23;44;16;17;33
292;03.02.2017;2017;02;14;Perjantai;11;17;28;19;19;38
292;03.02.2017;2017;02;15;Perjantai;18;27;45;18;26;44
292;03.02.2017;2017;02;16;Perjantai;17;13;30;20;11;31
292;03.02.2017;2017;02;17;Perjantai;7;9;16;16;10;26
292;03.02.2017;2017;02;18;Perjantai;7;9;16;19;17;36
292;03.02.2017;2017;02;19;Perjantai;13;6;19;15;5;20
292;03.02.2017;2017;02;20;Perjantai;12;10;22;5;8;13
292;03.02.2017;2017;02;21;Perjantai;5;7;12;6;5;11
292;03.02.2017;2017;02;22;Perjantai;4;0;4;10;7;17
292;03.02.2017;2017;02;23;Perjantai;1;5;6;3;1;4
292;04.02.2017;2017;02;00;Lauantai;1;3;4;3;1;4
292;04.02.2017;2017;02;01;Lauantai;0;2;2;0;6;6
292;04.02.2017;2017;02;02;Lauantai;0;0;0;0;5;5
292;04.02.2017;2017;02;03;Lauantai;1;0;1;1;3;4
292;04.02.2017;2017;02;04;Lauantai;0;0;0;1;1;2
292;04.02.2017;2017;02;05;Lauantai;1;0;1;1;1;2
292;04.02.2017;2017;02;06;Lauantai;6;2;8;1;1;2
292;04.02.2017;2017;02;07;Lauantai;3;2;5;2;8;10
292;04.02.2017;2017;02;08;Lauantai;1;5;6;9;9;18
292;04.02.2017;2017;02;09;Lauantai;2;8;10;11;17;28
292;04.02.2017;2017;02;10;Lauantai;8;11;19;2;13;15
292;04.02.2017;2017;02;11;Lauantai;10;12;22;19;11;30
292;04.02.2017;2017;02;12;Lauantai;9;13;22;18;24;42
292;04.02.2017;2017;02;13;Lauantai;15;18;33;14;13;27
292;04.02.2017;2017;02;14;Lauantai;22;8;30;17;19;36
292;04.02.2017;2017;02;15;Lauantai;8;9;17;18;7;25
292;04.02.2017;2017;02;16;Lauantai;12;8;20;18;12;30
292;04.02.2017;2017;02;17;Lauantai;8;8;16;13;11;24
292;04.02.2017;2017;02;18;Lauantai;14;3;17;17;11;28
292;04.02.2017;2017;02;19;Lauantai;4;13;17;16;19;35
292;04.02.2017;2017;02;20;Lauantai;5;3;8;8;6;14
292;04.02.2017;2017;02;21;Lauantai;1;4;5;4;8;12
292;04.02.2017;2017;02;22;Lauantai;1;2;3;6;3;9
292;04.02.2017;2017;02;23;Lauantai;0;2;2;0;4;4
292;05.02.2017;2017;02;00;Sunnuntai;0;1;1;3;1;4
292;05.02.2017;2017;02;01;Sunnuntai;1;0;1;1;6;7
292;05.02.2017;2017;02;02;Sunnuntai;0;1;1;0;4;4
292;05.02.2017;2017;02;03;Sunnuntai;0;0;0;0;1;1
292;05.02.2017;2017;02;04;Sunnuntai;0;0;0;0;0;0
292;05.02.2017;2017;02;05;Sunnuntai;0;0;0;4;1;5
292;05.02.2017;2017;02;06;Sunnuntai;2;0;2;3;3;6
292;05.02.2017;2017;02;07;Sunnuntai;2;1;3;4;2;6
292;05.02.2017;2017;02;08;Sunnuntai;0;0;0;5;1;6
292;05.02.2017;2017;02;09;Sunnuntai;7;4;11;17;10;27
292;05.02.2017;2017;02;10;Sunnuntai;3;8;11;14;12;26
292;05.02.2017;2017;02;11;Sunnuntai;7;14;21;10;18;28
292;05.02.2017;2017;02;12;Sunnuntai;7;12;19;18;9;27
292;05.02.2017;2017;02;13;Sunnuntai;8;7;15;14;19;33
292;05.02.2017;2017;02;14;Sunnuntai;14;15;29;10;12;22
292;05.02.2017;2017;02;15;Sunnuntai;8;8;16;15;8;23
292;05.02.2017;2017;02;16;Sunnuntai;7;7;14;18;10;28
292;05.02.2017;2017;02;17;Sunnuntai;7;1;8;7;16;23
292;05.02.2017;2017;02;18;Sunnuntai;8;9;17;11;15;26
292;05.02.2017;2017;02;19;Sunnuntai;4;3;7;14;8;22
292;05.02.2017;2017;02;20;Sunnuntai;4;6;10;1;2;3
292;05.02.2017;2017;02;21;Sunnuntai;4;3;7;5;3;8
292;05.02.2017;2017;02;22;Sunnuntai;1;3;4;1;0;1
292;05.02.2017;2017;02;23;Sunnuntai;1;0;1;3;1;4
292;06.02.2017;2017;02;00;Maanantai;0;0;0;3;3;6
292;06.02.2017;2017;02;01;Maanantai;0;1;1;0;0;0
292;06.02.2017;2017;02;02;Maanantai;0;0;0;0;0;0
292;06.02.2017;2017;02;03;Maanantai;0;0;0;0;0;0
292;06.02.2017;2017;02;04;Maanantai;0;0;0;2;0;2
292;06.02.2017;2017;02;05;Maanantai;2;5;7;2;3;5
292;06.02.2017;2017;02;06;Maanantai;8;5;13;5;9;14
292;06.02.2017;2017;02;07;Maanantai;53;11;64;22;15;37
292;06.02.2017;2017;02;08;Maanantai;34;22;56;20;16;36
292;06.02.2017;2017;02;09;Maanantai;13;8;21;11;15;26
292;06.02.2017;2017;02;10;Maanantai;12;22;34;21;13;34
292;06.02.2017;2017;02;11;Maanantai;11;14;25;14;22;36
292;06.02.2017;2017;02;12;Maanantai;9;17;26;14;17;31
292;06.02.2017;2017;02;13;Maanantai;7;22;29;13;11;24
292;06.02.2017;2017;02;14;Maanantai;18;25;43;23;25;48
292;06.02.2017;2017;02;15;Maanantai;19;31;50;16;18;34
292;06.02.2017;2017;02;16;Maanantai;32;26;58;22;29;51
292;06.02.2017;2017;02;17;Maanantai;12;19;31;19;13;32
292;06.02.2017;2017;02;18;Maanantai;13;13;26;16;12;28
292;06.02.2017;2017;02;19;Maanantai;7;8;15;13;11;24
292;06.02.2017;2017;02;20;Maanantai;9;7;16;6;5;11
292;06.02.2017;2017;02;21;Maanantai;4;4;8;4;7;11
292;06.02.2017;2017;02;22;Maanantai;1;0;1;3;0;3
292;06.02.2017;2017;02;23;Maanantai;0;1;1;2;0;2
292;07.02.2017;2017;02;00;Tiistai;0;0;0;0;0;0
292;07.02.2017;2017;02;01;Tiistai;1;0;1;0;1;1
292;07.02.2017;2017;02;02;Tiistai;0;1;1;0;0;0
292;07.02.2017;2017;02;03;Tiistai;0;0;0;0;0;0
292;07.02.2017;2017;02;04;Tiistai;1;1;2;0;0;0
292;07.02.2017;2017;02;05;Tiistai;3;2;5;2;0;2
292;07.02.2017;2017;02;06;Tiistai;9;10;19;3;7;10
292;07.02.2017;2017;02;07;Tiistai;41;11;52;20;13;33
292;07.02.2017;2017;02;08;Tiistai;35;24;59;25;22;47
292;07.02.2017;2017;02;09;Tiistai;11;13;24;11;9;20
292;07.02.2017;2017;02;10;Tiistai;15;19;34;15;15;30
292;07.02.2017;2017;02;11;Tiistai;8;23;31;14;17;31
292;07.02.2017;2017;02;12;Tiistai;7;21;28;9;10;19
292;07.02.2017;2017;02;13;Tiistai;12;19;31;19;16;35
292;07.02.2017;2017;02;14;Tiistai;7;27;34;20;21;41
292;07.02.2017;2017;02;15;Tiistai;21;29;50;25;15;40
292;07.02.2017;2017;02;16;Tiistai;24;24;48;23;27;50
292;07.02.2017;2017;02;17;Tiistai;12;23;35;18;14;32
292;07.02.2017;2017;02;18;Tiistai;15;13;28;15;17;32
292;07.02.2017;2017;02;19;Tiistai;6;13;19;13;7;20
292;07.02.2017;2017;02;20;Tiistai;6;3;9;7;3;10
292;07.02.2017;2017;02;21;Tiistai;1;5;6;6;4;10
292;07.02.2017;2017;02;22;Tiistai;0;0;0;3;1;4
292;07.02.2017;2017;02;23;Tiistai;0;0;0;0;0;0
292;08.02.2017;2017;02;00;Keskiviikko;0;1;1;1;0;1
292;08.02.2017;2017;02;01;Keskiviikko;0;1;1;0;1;1
292;08.02.2017;2017;02;02;Keskiviikko;0;0;0;1;0;1
292;08.02.2017;2017;02;03;Keskiviikko;0;0;0;0;0;0
292;08.02.2017;2017;02;04;Keskiviikko;2;0;2;1;0;1
292;08.02.2017;2017;02;05;Keskiviikko;2;5;7;1;1;2
292;08.02.2017;2017;02;06;Keskiviikko;6;7;13;5;5;10
292;08.02.2017;2017;02;07;Keskiviikko;48;7;55;18;16;34
292;08.02.2017;2017;02;08;Keskiviikko;30;13;43;12;22;34
292;08.02.2017;2017;02;09;Keskiviikko;3;7;10;10;8;18
292;08.02.2017;2017;02;10;Keskiviikko;8;10;18;7;18;25
292;08.02.2017;2017;02;11;Keskiviikko;2;13;15;12;10;22
292;08.02.2017;2017;02;12;Keskiviikko;11;14;25;16;13;29
292;08.02.2017;2017;02;13;Keskiviikko;7;28;35;20;21;41
292;08.02.2017;2017;02;14;Keskiviikko;13;28;41;12;22;34
292;08.02.2017;2017;02;15;Keskiviikko;15;17;32;29;20;49
292;08.02.2017;2017;02;16;Keskiviikko;18;15;33;17;21;38
292;08.02.2017;2017;02;17;Keskiviikko;14;7;21;18;7;25
292;08.02.2017;2017;02;18;Keskiviikko;4;6;10;10;10;20
292;08.02.2017;2017;02;19;Keskiviikko;5;6;11;7;11;18
292;08.02.2017;2017;02;20;Keskiviikko;7;3;10;8;2;10
292;08.02.2017;2017;02;21;Keskiviikko;1;2;3;4;10;14
292;08.02.2017;2017;02;22;Keskiviikko;0;1;1;2;0;2
292;08.02.2017;2017;02;23;Keskiviikko;0;0;0;0;0;0
292;09.02.2017;2017;02;00;Torstai;0;0;0;0;0;0
292;09.02.2017;2017;02;01;Torstai;1;0;1;0;0;0
292;09.02.2017;2017;02;02;Torstai;0;0;0;0;0;0
292;09.02.2017;2017;02;03;Torstai;0;0;0;0;0;0
292;09.02.2017;2017;02;04;Torstai;1;0;1;0;0;0
292;09.02.2017;2017;02;05;Torstai;4;4;8;2;2;4
292;09.02.2017;2017;02;06;Torstai;3;10;13;4;4;8
292;09.02.2017;2017;02;07;Torstai;26;10;36;19;9;28
292;09.02.2017;2017;02;08;Torstai;17;14;31;14;14;28
292;09.02.2017;2017;02;09;Torstai;15;4;19;19;12;31
292;09.02.2017;2017;02;10;Torstai;5;7;12;8;9;17
292;09.02.2017;2017;02;11;Torstai;11;9;20;11;13;24
292;09.02.2017;2017;02;12;Torstai;5;10;15;6;7;13
292;09.02.2017;2017;02;13;Torstai;11;14;25;21;11;32
292;09.02.2017;2017;02;14;Torstai;11;23;34;23;15;38
292;09.02.2017;2017;02;15;Torstai;17;28;45;6;29;35
292;09.02.2017;2017;02;16;Torstai;18;15;33;14;12;26
292;09.02.2017;2017;02;17;Torstai;9;12;21;17;15;32
292;09.02.2017;2017;02;18;Torstai;9;10;19;13;11;24
292;09.02.2017;2017;02;19;Torstai;4;6;10;8;6;14
292;09.02.2017;2017;02;20;Torstai;6;0;6;11;11;22
292;09.02.2017;2017;02;21;Torstai;3;3;6;2;4;6
292;09.02.2017;2017;02;22;Torstai;1;0;1;0;0;0
292;09.02.2017;2017;02;23;Torstai;1;0;1;5;2;7
292;10.02.2017;2017;02;00;Perjantai;0;0;0;0;1;1
292;10.02.2017;2017;02;01;Perjantai;0;0;0;0;0;0
292;10.02.2017;2017;02;02;Perjantai;0;0;0;1;1;2
292;10.02.2017;2017;02;03;Perjantai;0;0;0;0;0;0
292;10.02.2017;2017;02;04;Perjantai;3;0;3;0;0;0
292;10.02.2017;2017;02;05;Perjantai;4;7;11;1;2;3
292;10.02.2017;2017;02;06;Perjantai;5;8;13;5;7;12
292;10.02.2017;2017;02;07;Perjantai;45;14;59;20;4;24
292;10.02.2017;2017;02;08;Perjantai;33;18;51;16;12;28
292;10.02.2017;2017;02;09;Perjantai;21;8;29;17;11;28
292;10.02.2017;2017;02;10;Perjantai;12;13;25;6;20;26
292;10.02.2017;2017;02;11;Perjantai;10;17;27;13;8;21
292;10.02.2017;2017;02;12;Perjantai;14;17;31;7;11;18
292;10.02.2017;2017;02;13;Perjantai;19;33;52;9;21;30
292;10.02.2017;2017;02;14;Perjantai;13;40;53;17;21;38
292;10.02.2017;2017;02;15;Perjantai;10;24;34;27;10;37
292;10.02.2017;2017;02;16;Perjantai;12;14;26;9;16;25
292;10.02.2017;2017;02;17;Perjantai;16;23;39;20;18;38
292;10.02.2017;2017;02;18;Perjantai;13;6;19;11;7;18
292;10.02.2017;2017;02;19;Perjantai;8;7;15;13;15;28
292;10.02.2017;2017;02;20;Perjantai;15;3;18;8;4;12
292;10.02.2017;2017;02;21;Perjantai;5;3;8;2;9;11
292;10.02.2017;2017;02;22;Perjantai;3;5;8;3;4;7
292;10.02.2017;2017;02;23;Perjantai;2;1;3;5;2;7
292;11.02.2017;2017;02;00;Lauantai;2;1;3;1;4;5
292;11.02.2017;2017;02;01;Lauantai;1;1;2;4;1;5
292;11.02.2017;2017;02;02;Lauantai;0;1;1;0;6;6
292;11.02.2017;2017;02;03;Lauantai;1;1;2;1;1;2
292;11.02.2017;2017;02;04;Lauantai;0;0;0;0;0;0
292;11.02.2017;2017;02;05;Lauantai;0;0;0;2;1;3
292;11.02.2017;2017;02;06;Lauantai;3;2;5;0;1;1
292;11.02.2017;2017;02;07;Lauantai;2;0;2;2;0;2
292;11.02.2017;2017;02;08;Lauantai;0;2;2;2;3;5
292;11.02.2017;2017;02;09;Lauantai;2;8;10;8;6;14
292;11.02.2017;2017;02;10;Lauantai;6;10;16;6;10;16
292;11.02.2017;2017;02;11;Lauantai;5;14;19;15;7;22
292;11.02.2017;2017;02;12;Lauantai;13;19;32;29;16;45
292;11.02.2017;2017;02;13;Lauantai;13;19;32;20;16;36
292;11.02.2017;2017;02;14;Lauantai;9;6;15;15;12;27
292;11.02.2017;2017;02;15;Lauantai;12;15;27;13;18;31
292;11.02.2017;2017;02;16;Lauantai;11;8;19;26;14;40
292;11.02.2017;2017;02;17;Lauantai;9;7;16;10;12;22
292;11.02.2017;2017;02;18;Lauantai;12;3;15;15;13;28
292;11.02.2017;2017;02;19;Lauantai;7;4;11;11;11;22
292;11.02.2017;2017;02;20;Lauantai;5;14;19;10;5;15
292;11.02.2017;2017;02;21;Lauantai;5;3;8;6;4;10
292;11.02.2017;2017;02;22;Lauantai;0;0;0;0;0;0
292;11.02.2017;2017;02;23;Lauantai;2;2;4;1;0;1
292;12.02.2017;2017;02;00;Sunnuntai;1;0;1;0;1;1
292;12.02.2017;2017;02;01;Sunnuntai;0;0;0;0;2;2
292;12.02.2017;2017;02;02;Sunnuntai;1;1;2;0;5;5
292;12.02.2017;2017;02;03;Sunnuntai;0;0;0;1;0;1
292;12.02.2017;2017;02;04;Sunnuntai;0;0;0;0;0;0
292;12.02.2017;2017;02;05;Sunnuntai;0;0;0;1;1;2
292;12.02.2017;2017;02;06;Sunnuntai;3;1;4;3;1;4
292;12.02.2017;2017;02;07;Sunnuntai;0;2;2;1;1;2
292;12.02.2017;2017;02;08;Sunnuntai;2;3;5;5;4;9
292;12.02.2017;2017;02;09;Sunnuntai;4;5;9;2;4;6
292;12.02.2017;2017;02;10;Sunnuntai;3;3;6;9;13;22
292;12.02.2017;2017;02;11;Sunnuntai;9;10;19;12;17;29
292;12.02.2017;2017;02;12;Sunnuntai;8;13;21;15;18;33
292;12.02.2017;2017;02;13;Sunnuntai;9;14;23;14;11;25
292;12.02.2017;2017;02;14;Sunnuntai;9;8;17;14;15;29
292;12.02.2017;2017;02;15;Sunnuntai;6;6;12;18;12;30
292;12.02.2017;2017;02;16;Sunnuntai;12;6;18;15;5;20
292;12.02.2017;2017;02;17;Sunnuntai;2;8;10;23;18;41
292;12.02.2017;2017;02;18;Sunnuntai;11;16;27;19;24;43
292;12.02.2017;2017;02;19;Sunnuntai;5;7;12;10;12;22
292;12.02.2017;2017;02;20;Sunnuntai;6;7;13;10;13;23
292;12.02.2017;2017;02;21;Sunnuntai;2;2;4;2;3;5
292;12.02.2017;2017;02;22;Sunnuntai;2;3;5;1;0;1
292;12.02.2017;2017;02;23;Sunnuntai;0;1;1;1;0;1
292;13.02.2017;2017;02;00;Maanantai;1;0;1;0;0;0
292;13.02.2017;2017;02;01;Maanantai;0;1;1;0;0;0
292;13.02.2017;2017;02;02;Maanantai;0;0;0;0;0;0
292;13.02.2017;2017;02;03;Maanantai;0;0;0;0;0;0
292;13.02.2017;2017;02;04;Maanantai;1;0;1;0;0;0
292;13.02.2017;2017;02;05;Maanantai;3;4;7;1;0;1
292;13.02.2017;2017;02;06;Maanantai;10;10;20;7;5;12
292;13.02.2017;2017;02;07;Maanantai;46;13;59;16;14;30
292;13.02.2017;2017;02;08;Maanantai;29;21;50;19;11;30
292;13.02.2017;2017;02;09;Maanantai;36;18;54;18;16;34
292;13.02.2017;2017;02;10;Maanantai;17;10;27;22;15;37
292;13.02.2017;2017;02;11;Maanantai;7;13;20;23;19;42
292;13.02.2017;2017;02;12;Maanantai;9;20;29;32;15;47
292;13.02.2017;2017;02;13;Maanantai;13;15;28;25;34;59
292;13.02.2017;2017;02;14;Maanantai;25;50;75;27;23;50
292;13.02.2017;2017;02;15;Maanantai;21;48;69;21;26;47
292;13.02.2017;2017;02;16;Maanantai;24;37;61;14;24;38
292;13.02.2017;2017;02;17;Maanantai;14;20;34;19;19;38
292;13.02.2017;2017;02;18;Maanantai;8;10;18;21;14;35
292;13.02.2017;2017;02;19;Maanantai;12;7;19;5;15;20
292;13.02.2017;2017;02;20;Maanantai;9;5;14;5;3;8
292;13.02.2017;2017;02;21;Maanantai;3;4;7;2;3;5
292;13.02.2017;2017;02;22;Maanantai;5;0;5;0;1;1
292;13.02.2017;2017;02;23;Maanantai;0;1;1;3;1;4
292;14.02.2017;2017;02;00;Tiistai;0;1;1;0;0;0
292;14.02.2017;2017;02;01;Tiistai;0;0;0;0;0;0
292;14.02.2017;2017;02;02;Tiistai;0;1;1;0;0;0
292;14.02.2017;2017;02;03;Tiistai;0;1;1;12;9;21
292;14.02.2017;2017;02;04;Tiistai;1;0;1;1;0;1
292;14.02.2017;2017;02;05;Tiistai;4;5;9;1;2;3
292;14.02.2017;2017;02;06;Tiistai;14;12;26;5;4;9
292;14.02.2017;2017;02;07;Tiistai;52;19;71;14;12;26
292;14.02.2017;2017;02;08;Tiistai;41;17;58;20;10;30
292;14.02.2017;2017;02;09;Tiistai;17;16;33;13;14;27
292;14.02.2017;2017;02;10;Tiistai;14;9;23;16;17;33
292;14.02.2017;2017;02;11;Tiistai;5;8;13;21;14;35
292;14.02.2017;2017;02;12;Tiistai;5;17;22;5;6;11
292;14.02.2017;2017;02;13;Tiistai;14;20;34;21;19;40
292;14.02.2017;2017;02;14;Tiistai;21;60;81;19;26;45
292;14.02.2017;2017;02;15;Tiistai;15;40;55;15;18;33
292;14.02.2017;2017;02;16;Tiistai;24;26;50;17;20;37
292;14.02.2017;2017;02;17;Tiistai;21;25;46;21;20;41
292;14.02.2017;2017;02;18;Tiistai;7;13;20;14;11;25
292;14.02.2017;2017;02;19;Tiistai;6;8;14;12;17;29
292;14.02.2017;2017;02;20;Tiistai;13;8;21;13;4;17
292;14.02.2017;2017;02;21;Tiistai;5;4;9;5;9;14
292;14.02.2017;2017;02;22;Tiistai;1;6;7;3;1;4
292;14.02.2017;2017;02;23;Tiistai;1;0;1;0;0;0
292;15.02.2017;2017;02;00;Keskiviikko;0;1;1;0;0;0
292;15.02.2017;2017;02;01;Keskiviikko;0;0;0;1;1;2
292;15.02.2017;2017;02;02;Keskiviikko;0;0;0;0;1;1
292;15.02.2017;2017;02;03;Keskiviikko;0;1;1;1;0;1
292;15.02.2017;2017;02;04;Keskiviikko;1;0;1;0;0;0
292;15.02.2017;2017;02;05;Keskiviikko;3;5;8;3;1;4
292;15.02.2017;2017;02;06;Keskiviikko;7;8;15;5;6;11
292;15.02.2017;2017;02;07;Keskiviikko;40;22;62;26;9;35
292;15.02.2017;2017;02;08;Keskiviikko;40;13;53;22;11;33
292;15.02.2017;2017;02;09;Keskiviikko;27;11;38;10;15;25
292;15.02.2017;2017;02;10;Keskiviikko;12;12;24;9;10;19
292;15.02.2017;2017;02;11;Keskiviikko;11;9;20;12;8;20
292;15.02.2017;2017;02;12;Keskiviikko;13;15;28;16;7;23
292;15.02.2017;2017;02;13;Keskiviikko;20;59;79;15;12;27
292;15.02.2017;2017;02;14;Keskiviikko;20;52;72;21;24;45
292;15.02.2017;2017;02;15;Keskiviikko;15;29;44;20;17;37
292;15.02.2017;2017;02;16;Keskiviikko;23;27;50;14;16;30
292;15.02.2017;2017;02;17;Keskiviikko;17;26;43;19;12;31
292;15.02.2017;2017;02;18;Keskiviikko;13;7;20;23;15;38
292;15.02.2017;2017;02;19;Keskiviikko;9;11;20;14;13;27
292;15.02.2017;2017;02;20;Keskiviikko;14;8;22;13;5;18
292;15.02.2017;2017;02;21;Keskiviikko;0;2;2;2;1;3
292;15.02.2017;2017;02;22;Keskiviikko;1;4;5;2;0;2
292;15.02.2017;2017;02;23;Keskiviikko;0;1;1;0;0;0
292;16.02.2017;2017;02;00;Torstai;1;0;1;0;0;0
292;16.02.2017;2017;02;01;Torstai;0;0;0;0;0;0
292;16.02.2017;2017;02;02;Torstai;0;0;0;0;0;0
292;16.02.2017;2017;02;03;Torstai;0;0;0;0;0;0
292;16.02.2017;2017;02;04;Torstai;0;0;0;1;0;1
292;16.02.2017;2017;02;05;Torstai;3;8;11;2;1;3
292;16.02.2017;2017;02;06;Torstai;12;11;23;2;4;6
292;16.02.2017;2017;02;07;Torstai;24;24;48;17;9;26
292;16.02.2017;2017;02;08;Torstai;34;15;49;15;10;25
292;16.02.2017;2017;02;09;Torstai;48;12;60;22;10;32
292;16.02.2017;2017;02;10;Torstai;11;9;20;17;14;31
292;16.02.2017;2017;02;11;Torstai;11;14;25;17;17;34
292;16.02.2017;2017;02;12;Torstai;8;17;25;12;16;28
292;16.02.2017;2017;02;13;Torstai;12;45;57;17;15;32
292;16.02.2017;2017;02;14;Torstai;20;29;49;21;15;36
292;16.02.2017;2017;02;15;Torstai;22;41;63;21;19;40
292;16.02.2017;2017;02;16;Torstai;23;25;48;17;17;34
292;16.02.2017;2017;02;17;Torstai;6;15;21;20;8;28
292;16.02.2017;2017;02;18;Torstai;7;10;17;19;14;33
292;16.02.2017;2017;02;19;Torstai;10;16;26;13;10;23
292;16.02.2017;2017;02;20;Torstai;12;6;18;5;3;8
292;16.02.2017;2017;02;21;Torstai;6;4;10;2;2;4
292;16.02.2017;2017;02;22;Torstai;2;4;6;1;1;2
292;16.02.2017;2017;02;23;Torstai;0;0;0;1;0;1
292;17.02.2017;2017;02;00;Perjantai;0;1;1;0;0;0
292;17.02.2017;2017;02;01;Perjantai;0;0;0;1;1;2
292;17.02.2017;2017;02;02;Perjantai;0;0;0;0;2;2
292;17.02.2017;2017;02;03;Perjantai;0;0;0;0;0;0
292;17.02.2017;2017;02;04;Perjantai;1;0;1;1;0;1
292;17.02.2017;2017;02;05;Perjantai;2;6;8;2;1;3
292;17.02.2017;2017;02;06;Perjantai;12;9;21;4;3;7
292;17.02.2017;2017;02;07;Perjantai;51;15;66;19;5;24
292;17.02.2017;2017;02;08;Perjantai;28;17;45;11;8;19
292;17.02.2017;2017;02;09;Perjantai;13;7;20;13;14;27
292;17.02.2017;2017;02;10;Perjantai;14;13;27;12;12;24
292;17.02.2017;2017;02;11;Perjantai;13;20;33;18;13;31
292;17.02.2017;2017;02;12;Perjantai;17;24;41;18;11;29
292;17.02.2017;2017;02;13;Perjantai;19;43;62;11;11;22
292;17.02.2017;2017;02;14;Perjantai;16;44;60;15;13;28
292;17.02.2017;2017;02;15;Perjantai;21;37;58;21;13;34
292;17.02.2017;2017;02;16;Perjantai;18;20;38;14;14;28
292;17.02.2017;2017;02;17;Perjantai;11;21;32;13;4;17
292;17.02.2017;2017;02;18;Perjantai;21;7;28;21;14;35
292;17.02.2017;2017;02;19;Perjantai;10;9;19;15;8;23
292;17.02.2017;2017;02;20;Perjantai;11;7;18;8;5;13
292;17.02.2017;2017;02;21;Perjantai;7;11;18;4;12;16
292;17.02.2017;2017;02;22;Perjantai;3;7;10;2;2;4
292;17.02.2017;2017;02;23;Perjantai;0;3;3;3;1;4
292;18.02.2017;2017;02;00;Lauantai;1;1;2;7;1;8
292;18.02.2017;2017;02;01;Lauantai;1;0;1;3;8;11
292;18.02.2017;2017;02;02;Lauantai;1;2;3;5;5;10
292;18.02.2017;2017;02;03;Lauantai;0;4;4;0;2;2
292;18.02.2017;2017;02;04;Lauantai;2;0;2;0;0;0
292;18.02.2017;2017;02;05;Lauantai;1;0;1;1;1;2
292;18.02.2017;2017;02;06;Lauantai;3;0;3;3;1;4
292;18.02.2017;2017;02;07;Lauantai;0;4;4;3;2;5
292;18.02.2017;2017;02;08;Lauantai;4;0;4;12;3;15
292;18.02.2017;2017;02;09;Lauantai;0;7;7;4;9;13
292;18.02.2017;2017;02;10;Lauantai;7;11;18;9;12;21
292;18.02.2017;2017;02;11;Lauantai;10;11;21;18;17;35
292;18.02.2017;2017;02;12;Lauantai;10;11;21;16;14;30
292;18.02.2017;2017;02;13;Lauantai;8;11;19;22;19;41
292;18.02.2017;2017;02;14;Lauantai;10;12;22;22;22;44
292;18.02.2017;2017;02;15;Lauantai;8;14;22;14;20;34
292;18.02.2017;2017;02;16;Lauantai;18;11;29;19;14;33
292;18.02.2017;2017;02;17;Lauantai;3;10;13;11;13;24
292;18.02.2017;2017;02;18;Lauantai;8;6;14;18;5;23
292;18.02.2017;2017;02;19;Lauantai;6;6;12;4;6;10
292;18.02.2017;2017;02;20;Lauantai;5;3;8;7;5;12
292;18.02.2017;2017;02;21;Lauantai;7;12;19;6;3;9
292;18.02.2017;2017;02;22;Lauantai;2;1;3;4;3;7
292;18.02.2017;2017;02;23;Lauantai;3;4;7;2;0;2
292;19.02.2017;2017;02;00;Sunnuntai;0;1;1;3;0;3
292;19.02.2017;2017;02;01;Sunnuntai;0;1;1;1;0;1
292;19.02.2017;2017;02;02;Sunnuntai;1;0;1;0;6;6
292;19.02.2017;2017;02;03;Sunnuntai;0;2;2;0;6;6
292;19.02.2017;2017;02;04;Sunnuntai;0;0;0;0;0;0
292;19.02.2017;2017;02;05;Sunnuntai;0;0;0;2;0;2
292;19.02.2017;2017;02;06;Sunnuntai;2;2;4;2;2;4
292;19.02.2017;2017;02;07;Sunnuntai;0;1;1;1;0;1
292;19.02.2017;2017;02;08;Sunnuntai;0;2;2;8;5;13
292;19.02.2017;2017;02;09;Sunnuntai;4;9;13;11;10;21
292;19.02.2017;2017;02;10;Sunnuntai;6;10;16;8;13;21
292;19.02.2017;2017;02;11;Sunnuntai;13;5;18;22;14;36
292;19.02.2017;2017;02;12;Sunnuntai;4;14;18;12;16;28
292;19.02.2017;2017;02;13;Sunnuntai;6;5;11;12;14;26
292;19.02.2017;2017;02;14;Sunnuntai;12;13;25;19;7;26
292;19.02.2017;2017;02;15;Sunnuntai;9;9;18;17;11;28
292;19.02.2017;2017;02;16;Sunnuntai;4;14;18;19;14;33
292;19.02.2017;2017;02;17;Sunnuntai;10;5;15;17;16;33
292;19.02.2017;2017;02;18;Sunnuntai;8;14;22;12;12;24
292;19.02.2017;2017;02;19;Sunnuntai;10;4;14;15;10;25
292;19.02.2017;2017;02;20;Sunnuntai;7;2;9;4;5;9
292;19.02.2017;2017;02;21;Sunnuntai;0;5;5;2;2;4
292;19.02.2017;2017;02;22;Sunnuntai;0;3;3;1;0;1
292;19.02.2017;2017;02;23;Sunnuntai;1;1;2;1;2;3
292;20.02.2017;2017;02;00;Maanantai;0;0;0;0;2;2
292;20.02.2017;2017;02;01;Maanantai;0;0;0;0;0;0
292;20.02.2017;2017;02;02;Maanantai;0;0;0;0;0;0
292;20.02.2017;2017;02;03;Maanantai;0;0;0;9;0;9
292;20.02.2017;2017;02;04;Maanantai;1;0;1;1;0;1
292;20.02.2017;2017;02;05;Maanantai;2;4;6;2;2;4
292;20.02.2017;2017;02;06;Maanantai;10;11;21;0;4;4
292;20.02.2017;2017;02;07;Maanantai;35;15;50;15;11;26
292;20.02.2017;2017;02;08;Maanantai;22;9;31;13;11;24
292;20.02.2017;2017;02;09;Maanantai;30;10;40;17;8;25
292;20.02.2017;2017;02;10;Maanantai;20;6;26;8;12;20
292;20.02.2017;2017;02;11;Maanantai;13;7;20;25;18;43
292;20.02.2017;2017;02;12;Maanantai;5;10;15;15;22;37
292;20.02.2017;2017;02;13;Maanantai;12;21;33;28;11;39
292;20.02.2017;2017;02;14;Maanantai;20;38;58;16;23;39
292;20.02.2017;2017;02;15;Maanantai;10;39;49;16;19;35
292;20.02.2017;2017;02;16;Maanantai;26;33;59;16;23;39
292;20.02.2017;2017;02;17;Maanantai;12;21;33;13;13;26
292;20.02.2017;2017;02;18;Maanantai;12;14;26;18;16;34
292;20.02.2017;2017;02;19;Maanantai;11;8;19;11;12;23
292;20.02.2017;2017;02;20;Maanantai;10;3;13;8;3;11
292;20.02.2017;2017;02;21;Maanantai;4;8;12;3;7;10
292;20.02.2017;2017;02;22;Maanantai;0;3;3;0;0;0
292;20.02.2017;2017;02;23;Maanantai;2;1;3;0;0;0
292;21.02.2017;2017;02;00;Tiistai;0;1;1;0;0;0
292;21.02.2017;2017;02;01;Tiistai;0;2;2;0;0;0
292;21.02.2017;2017;02;02;Tiistai;0;0;0;1;0;1
292;21.02.2017;2017;02;03;Tiistai;0;0;0;0;0;0
292;21.02.2017;2017;02;04;Tiistai;0;1;1;1;0;1
292;21.02.2017;2017;02;05;Tiistai;2;4;6;3;3;6
292;21.02.2017;2017;02;06;Tiistai;10;10;20;1;4;5
292;21.02.2017;2017;02;07;Tiistai;35;16;51;27;7;34
292;21.02.2017;2017;02;08;Tiistai;36;20;56;10;18;28
292;21.02.2017;2017;02;09;Tiistai;13;10;23;10;9;19
292;21.02.2017;2017;02;10;Tiistai;15;9;24;12;6;18
292;21.02.2017;2017;02;11;Tiistai;10;11;21;8;13;21
292;21.02.2017;2017;02;12;Tiistai;4;10;14;11;8;19
292;21.02.2017;2017;02;13;Tiistai;13;24;37;15;14;29
292;21.02.2017;2017;02;14;Tiistai;17;41;58;21;29;50
292;21.02.2017;2017;02;15;Tiistai;18;40;58;14;27;41
292;21.02.2017;2017;02;16;Tiistai;14;24;38;22;16;38
292;21.02.2017;2017;02;17;Tiistai;16;26;42;22;11;33
292;21.02.2017;2017;02;18;Tiistai;4;6;10;18;8;26
292;21.02.2017;2017;02;19;Tiistai;1;11;12;8;11;19
292;21.02.2017;2017;02;20;Tiistai;7;2;9;7;2;9
292;21.02.2017;2017;02;21;Tiistai;7;4;11;3;5;8
292;21.02.2017;2017;02;22;Tiistai;0;1;1;1;0;1
292;21.02.2017;2017;02;23;Tiistai;0;0;0;0;0;0
292;22.02.2017;2017;02;00;Keskiviikko;0;0;0;0;0;0
292;22.02.2017;2017;02;01;Keskiviikko;0;1;1;0;0;0
292;22.02.2017;2017;02;02;Keskiviikko;0;1;1;0;0;0
292;22.02.2017;2017;02;03;Keskiviikko;0;0;0;0;0;0
292;22.02.2017;2017;02;04;Keskiviikko;2;1;3;0;0;0
292;22.02.2017;2017;02;05;Keskiviikko;1;4;5;4;1;5
292;22.02.2017;2017;02;06;Keskiviikko;12;9;21;4;5;9
292;22.02.2017;2017;02;07;Keskiviikko;36;20;56;28;9;37
292;22.02.2017;2017;02;08;Keskiviikko;23;20;43;12;13;25
292;22.02.2017;2017;02;09;Keskiviikko;23;7;30;11;7;18
292;22.02.2017;2017;02;10;Keskiviikko;9;7;16;14;11;25
292;22.02.2017;2017;02;11;Keskiviikko;8;14;22;17;12;29
292;22.02.2017;2017;02;12;Keskiviikko;16;13;29;17;6;23
292;22.02.2017;2017;02;13;Keskiviikko;14;30;44;16;25;41
292;22.02.2017;2017;02;14;Keskiviikko;8;43;51;13;22;35
292;22.02.2017;2017;02;15;Keskiviikko;16;22;38;20;17;37
292;22.02.2017;2017;02;16;Keskiviikko;17;24;41;19;13;32
292;22.02.2017;2017;02;17;Keskiviikko;9;13;22;18;10;28
292;22.02.2017;2017;02;18;Keskiviikko;4;11;15;9;6;15
292;22.02.2017;2017;02;19;Keskiviikko;6;10;16;6;6;12
292;22.02.2017;2017;02;20;Keskiviikko;6;2;8;8;4;12
292;22.02.2017;2017;02;21;Keskiviikko;0;5;5;3;2;5
292;22.02.2017;2017;02;22;Keskiviikko;0;3;3;0;3;3
292;22.02.2017;2017;02;23;Keskiviikko;1;0;1;1;0;1
292;23.02.2017;2017;02;00;Torstai;0;0;0;1;0;1
292;23.02.2017;2017;02;01;Torstai;1;0;1;0;0;0
292;23.02.2017;2017;02;02;Torstai;0;0;0;0;0;0
292;23.02.2017;2017;02;03;Torstai;0;0;0;0;0;0
292;23.02.2017;2017;02;04;Torstai;1;1;2;0;0;0
292;23.02.2017;2017;02;05;Torstai;3;3;6;2;2;4
292;23.02.2017;2017;02;06;Torstai;8;9;17;5;5;10
292;23.02.2017;2017;02;07;Torstai;30;15;45;29;9;38
292;23.02.2017;2017;02;08;Torstai;25;20;45;16;7;23
292;23.02.2017;2017;02;09;Torstai;32;6;38;12;12;24
292;23.02.2017;2017;02;10;Torstai;10;1;11;12;13;25
292;23.02.2017;2017;02;11;Torstai;9;9;18;15;9;24
292;23.02.2017;2017;02;12;Torstai;2;13;15;8;14;22
292;23.02.2017;2017;02;13;Torstai;9;22;31;14;16;30
292;23.02.2017;2017;02;14;Torstai;16;33;49;17;10;27
292;23.02.2017;2017;02;15;Torstai;11;34;45;20;16;36
292;23.02.2017;2017;02;16;Torstai;14;34;48;17;13;30
292;23.02.2017;2017;02;17;Torstai;7;13;20;10;7;17
292;23.02.2017;2017;02;18;Torstai;9;15;24;12;10;22
292;23.02.2017;2017;02;19;Torstai;7;7;14;20;9;29
292;23.02.2017;2017;02;20;Torstai;8;4;12;13;2;15
292;23.02.2017;2017;02;21;Torstai;1;6;7;4;6;10
292;23.02.2017;2017;02;22;Torstai;0;5;5;3;1;4
292;23.02.2017;2017;02;23;Torstai;0;0;0;0;1;1
292;24.02.2017;2017;02;00;Perjantai;0;0;0;0;0;0
292;24.02.2017;2017;02;01;Perjantai;0;0;0;0;1;1
292;24.02.2017;2017;02;02;Perjantai;0;0;0;0;1;1
292;24.02.2017;2017;02;03;Perjantai;1;0;1;7;0;7
292;24.02.2017;2017;02;04;Perjantai;1;0;1;0;0;0
292;24.02.2017;2017;02;05;Perjantai;4;6;10;0;1;1
292;24.02.2017;2017;02;06;Perjantai;7;6;13;8;6;14
292;24.02.2017;2017;02;07;Perjantai;41;7;48;29;12;41
292;24.02.2017;2017;02;08;Perjantai;30;11;41;19;14;33
292;24.02.2017;2017;02;09;Perjantai;14;7;21;15;15;30
292;24.02.2017;2017;02;10;Perjantai;12;4;16;11;6;17
292;24.02.2017;2017;02;11;Perjantai;6;12;18;10;11;21
292;24.02.2017;2017;02;12;Perjantai;16;17;33;13;16;29
292;24.02.2017;2017;02;13;Perjantai;8;35;43;15;17;32
292;24.02.2017;2017;02;14;Perjantai;15;40;55;10;15;25
292;24.02.2017;2017;02;15;Perjantai;8;27;35;10;14;24
292;24.02.2017;2017;02;16;Perjantai;11;17;28;15;7;22
292;24.02.2017;2017;02;17;Perjantai;9;18;27;13;13;26
292;24.02.2017;2017;02;18;Perjantai;10;7;17;16;8;24
292;24.02.2017;2017;02;19;Perjantai;7;4;11;13;9;22
292;24.02.2017;2017;02;20;Perjantai;6;3;9;12;5;17
292;24.02.2017;2017;02;21;Perjantai;6;6;12;7;5;12
292;24.02.2017;2017;02;22;Perjantai;2;1;3;4;0;4
292;24.02.2017;2017;02;23;Perjantai;0;6;6;2;2;4
292;25.02.2017;2017;02;00;Lauantai;2;4;6;3;1;4
292;25.02.2017;2017;02;01;Lauantai;3;1;4;2;2;4
292;25.02.2017;2017;02;02;Lauantai;0;1;1;0;0;0
292;25.02.2017;2017;02;03;Lauantai;0;0;0;0;1;1
292;25.02.2017;2017;02;04;Lauantai;0;0;0;1;0;1
292;25.02.2017;2017;02;05;Lauantai;2;0;2;0;0;0
292;25.02.2017;2017;02;06;Lauantai;3;0;3;1;1;2
292;25.02.2017;2017;02;07;Lauantai;0;2;2;2;0;2
292;25.02.2017;2017;02;08;Lauantai;0;2;2;5;5;10
292;25.02.2017;2017;02;09;Lauantai;3;10;13;4;7;11
292;25.02.2017;2017;02;10;Lauantai;6;6;12;16;16;32
292;25.02.2017;2017;02;11;Lauantai;7;12;19;22;22;44
292;25.02.2017;2017;02;12;Lauantai;10;13;23;27;14;41
292;25.02.2017;2017;02;13;Lauantai;12;19;31;22;21;43
292;25.02.2017;2017;02;14;Lauantai;7;14;21;24;15;39
292;25.02.2017;2017;02;15;Lauantai;9;8;17;11;15;26
292;25.02.2017;2017;02;16;Lauantai;5;11;16;17;9;26
292;25.02.2017;2017;02;17;Lauantai;4;11;15;13;2;15
292;25.02.2017;2017;02;18;Lauantai;2;4;6;10;5;15
292;25.02.2017;2017;02;19;Lauantai;9;7;16;6;7;13
292;25.02.2017;2017;02;20;Lauantai;5;5;10;7;2;9
292;25.02.2017;2017;02;21;Lauantai;1;7;8;5;4;9
292;25.02.2017;2017;02;22;Lauantai;3;3;6;6;2;8
292;25.02.2017;2017;02;23;Lauantai;0;2;2;1;0;1
292;26.02.2017;2017;02;00;Sunnuntai;0;1;1;2;2;4
292;26.02.2017;2017;02;01;Sunnuntai;0;0;0;1;1;2
292;26.02.2017;2017;02;02;Sunnuntai;0;0;0;0;5;5
292;26.02.2017;2017;02;03;Sunnuntai;1;1;2;1;0;1
292;26.02.2017;2017;02;04;Sunnuntai;0;1;1;0;1;1
292;26.02.2017;2017;02;05;Sunnuntai;0;1;1;2;0;2
292;26.02.2017;2017;02;06;Sunnuntai;6;1;7;1;2;3
292;26.02.2017;2017;02;07;Sunnuntai;0;2;2;2;1;3
292;26.02.2017;2017;02;08;Sunnuntai;1;2;3;5;4;9
292;26.02.2017;2017;02;09;Sunnuntai;4;3;7;9;8;17
292;26.02.2017;2017;02;10;Sunnuntai;1;1;2;8;13;21
292;26.02.2017;2017;02;11;Sunnuntai;11;9;20;18;17;35
292;26.02.2017;2017;02;12;Sunnuntai;7;13;20;21;24;45
292;26.02.2017;2017;02;13;Sunnuntai;8;8;16;20;17;37
292;26.02.2017;2017;02;14;Sunnuntai;8;7;15;22;15;37
292;26.02.2017;2017;02;15;Sunnuntai;11;9;20;24;11;35
292;26.02.2017;2017;02;16;Sunnuntai;8;14;22;14;19;33
292;26.02.2017;2017;02;17;Sunnuntai;5;6;11;11;14;25
292;26.02.2017;2017;02;18;Sunnuntai;1;7;8;14;11;25
292;26.02.2017;2017;02;19;Sunnuntai;6;3;9;7;4;11
292;26.02.2017;2017;02;20;Sunnuntai;2;1;3;9;4;13
292;26.02.2017;2017;02;21;Sunnuntai;1;1;2;7;3;10
292;26.02.2017;2017;02;22;Sunnuntai;1;1;2;0;0;0
292;26.02.2017;2017;02;23;Sunnuntai;0;0;0;0;1;1
292;27.02.2017;2017;02;00;Maanantai;0;1;1;0;0;0
292;27.02.2017;2017;02;01;Maanantai;0;0;0;0;1;1
292;27.02.2017;2017;02;02;Maanantai;0;0;0;0;0;0
292;27.02.2017;2017;02;03;Maanantai;0;0;0;0;0;0
292;27.02.2017;2017;02;04;Maanantai;1;0;1;1;0;1
292;27.02.2017;2017;02;05;Maanantai;2;6;8;5;1;6
292;27.02.2017;2017;02;06;Maanantai;4;8;12;1;1;2
292;27.02.2017;2017;02;07;Maanantai;28;16;44;25;8;33
292;27.02.2017;2017;02;08;Maanantai;15;13;28;16;11;27
292;27.02.2017;2017;02;09;Maanantai;19;9;28;15;6;21
292;27.02.2017;2017;02;10;Maanantai;11;5;16;8;7;15
292;27.02.2017;2017;02;11;Maanantai;14;6;20;15;5;20
292;27.02.2017;2017;02;12;Maanantai;5;13;18;7;10;17
292;27.02.2017;2017;02;13;Maanantai;6;21;27;15;17;32
292;27.02.2017;2017;02;14;Maanantai;11;30;41;21;21;42
292;27.02.2017;2017;02;15;Maanantai;12;35;47;22;22;44
292;27.02.2017;2017;02;16;Maanantai;16;26;42;24;23;47
292;27.02.2017;2017;02;17;Maanantai;7;20;27;14;12;26
292;27.02.2017;2017;02;18;Maanantai;6;10;16;19;20;39
292;27.02.2017;2017;02;19;Maanantai;13;8;21;12;6;18
292;27.02.2017;2017;02;20;Maanantai;9;7;16;10;9;19
292;27.02.2017;2017;02;21;Maanantai;1;7;8;3;1;4
292;27.02.2017;2017;02;22;Maanantai;1;1;2;1;2;3
292;27.02.2017;2017;02;23;Maanantai;0;0;0;0;0;0
292;28.02.2017;2017;02;00;Tiistai;0;0;0;0;1;1
292;28.02.2017;2017;02;01;Tiistai;0;0;0;0;0;0
292;28.02.2017;2017;02;02;Tiistai;1;1;2;0;0;0
292;28.02.2017;2017;02;03;Tiistai;0;0;0;0;0;0
292;28.02.2017;2017;02;04;Tiistai;0;0;0;2;0;2
292;28.02.2017;2017;02;05;Tiistai;6;6;12;1;1;2
292;28.02.2017;2017;02;06;Tiistai;18;10;28;3;8;11
292;28.02.2017;2017;02;07;Tiistai;32;18;50;18;5;23
292;28.02.2017;2017;02;08;Tiistai;44;21;65;19;11;30
292;28.02.2017;2017;02;09;Tiistai;20;11;31;18;10;28
292;28.02.2017;2017;02;10;Tiistai;15;8;23;9;15;24
292;28.02.2017;2017;02;11;Tiistai;10;12;22;23;19;42
292;28.02.2017;2017;02;12;Tiistai;11;10;21;15;11;26
292;28.02.2017;2017;02;13;Tiistai;18;26;44;10;8;18
292;28.02.2017;2017;02;14;Tiistai;18;45;63;17;23;40
292;28.02.2017;2017;02;15;Tiistai;21;43;64;11;15;26
292;28.02.2017;2017;02;16;Tiistai;17;32;49;14;15;29
292;28.02.2017;2017;02;17;Tiistai;17;26;43;13;13;26
292;28.02.2017;2017;02;18;Tiistai;13;10;23;19;21;40
292;28.02.2017;2017;02;19;Tiistai;10;8;18;12;13;25
292;28.02.2017;2017;02;20;Tiistai;10;9;19;3;4;7
292;28.02.2017;2017;02;21;Tiistai;2;2;4;6;4;10
292;28.02.2017;2017;02;22;Tiistai;0;1;1;3;1;4
292;28.02.2017;2017;02;23;Tiistai;0;0;0;1;0;1
292;01.03.2017;2017;03;00;Keskiviikko;0;0;0;0;0;0
292;01.03.2017;2017;03;01;Keskiviikko;0;0;0;0;0;0
292;01.03.2017;2017;03;02;Keskiviikko;0;2;2;0;0;0
292;01.03.2017;2017;03;03;Keskiviikko;0;0;0;0;0;0
292;01.03.2017;2017;03;04;Keskiviikko;0;0;0;1;1;2
292;01.03.2017;2017;03;05;Keskiviikko;5;3;8;3;1;4
292;01.03.2017;2017;03;06;Keskiviikko;13;11;24;5;4;9
292;01.03.2017;2017;03;07;Keskiviikko;60;18;78;13;6;19
292;01.03.2017;2017;03;08;Keskiviikko;25;13;38;16;11;27
292;01.03.2017;2017;03;09;Keskiviikko;22;4;26;4;11;15
292;01.03.2017;2017;03;10;Keskiviikko;11;9;20;9;16;25
292;01.03.2017;2017;03;11;Keskiviikko;13;11;24;18;12;30
292;01.03.2017;2017;03;12;Keskiviikko;7;9;16;12;9;21
292;01.03.2017;2017;03;13;Keskiviikko;11;50;61;8;10;18
292;01.03.2017;2017;03;14;Keskiviikko;16;33;49;10;9;19
292;01.03.2017;2017;03;15;Keskiviikko;20;27;47;9;14;23
292;01.03.2017;2017;03;16;Keskiviikko;20;21;41;13;4;17
292;01.03.2017;2017;03;17;Keskiviikko;13;7;20;9;14;23
292;01.03.2017;2017;03;18;Keskiviikko;11;13;24;11;9;20
292;01.03.2017;2017;03;19;Keskiviikko;12;7;19;20;20;40
292;01.03.2017;2017;03;20;Keskiviikko;9;9;18;7;11;18
292;01.03.2017;2017;03;21;Keskiviikko;2;4;6;6;2;8
292;01.03.2017;2017;03;22;Keskiviikko;2;2;4;3;3;6
292;01.03.2017;2017;03;23;Keskiviikko;0;0;0;1;0;1
292;02.03.2017;2017;03;00;Torstai;1;0;1;0;0;0
292;02.03.2017;2017;03;01;Torstai;1;0;1;0;2;2
292;02.03.2017;2017;03;02;Torstai;2;0;2;0;1;1
292;02.03.2017;2017;03;03;Torstai;1;1;2;7;1;8
292;02.03.2017;2017;03;04;Torstai;1;0;1;1;0;1
292;02.03.2017;2017;03;05;Torstai;5;6;11;1;0;1
292;02.03.2017;2017;03;06;Torstai;8;6;14;1;6;7
292;02.03.2017;2017;03;07;Torstai;41;14;55;14;10;24
292;02.03.2017;2017;03;08;Torstai;38;20;58;14;14;28
292;02.03.2017;2017;03;09;Torstai;36;9;45;15;10;25
292;02.03.2017;2017;03;10;Torstai;18;16;34;14;7;21
292;02.03.2017;2017;03;11;Torstai;14;8;22;12;7;19
292;02.03.2017;2017;03;12;Torstai;11;14;25;14;18;32
292;02.03.2017;2017;03;13;Torstai;10;20;30;11;16;27
292;02.03.2017;2017;03;14;Torstai;16;36;52;13;9;22
292;02.03.2017;2017;03;15;Torstai;15;41;56;13;18;31
292;02.03.2017;2017;03;16;Torstai;22;38;60;15;20;35
292;02.03.2017;2017;03;17;Torstai;9;13;22;15;10;25
292;02.03.2017;2017;03;18;Torstai;8;8;16;12;18;30
292;02.03.2017;2017;03;19;Torstai;6;7;13;11;5;16
292;02.03.2017;2017;03;20;Torstai;8;3;11;9;3;12
292;02.03.2017;2017;03;21;Torstai;2;8;10;5;2;7
292;02.03.2017;2017;03;22;Torstai;4;2;6;3;0;3
292;02.03.2017;2017;03;23;Torstai;1;1;2;0;0;0
292;03.03.2017;2017;03;00;Perjantai;0;0;0;0;0;0
292;03.03.2017;2017;03;01;Perjantai;0;1;1;0;0;0
292;03.03.2017;2017;03;02;Perjantai;1;1;2;0;1;1
292;03.03.2017;2017;03;03;Perjantai;2;0;2;7;6;13
292;03.03.2017;2017;03;04;Perjantai;0;1;1;1;0;1
292;03.03.2017;2017;03;05;Perjantai;3;7;10;0;1;1
292;03.03.2017;2017;03;06;Perjantai;6;7;13;3;4;7
292;03.03.2017;2017;03;07;Perjantai;33;17;50;17;10;27
292;03.03.2017;2017;03;08;Perjantai;33;13;46;17;4;21
292;03.03.2017;2017;03;09;Perjantai;23;8;31;8;6;14
292;03.03.2017;2017;03;10;Perjantai;9;6;15;10;11;21
292;03.03.2017;2017;03;11;Perjantai;7;16;23;16;23;39
292;03.03.2017;2017;03;12;Perjantai;15;18;33;21;22;43
292;03.03.2017;2017;03;13;Perjantai;11;37;48;10;20;30
292;03.03.2017;2017;03;14;Perjantai;11;24;35;15;17;32
292;03.03.2017;2017;03;15;Perjantai;20;26;46;20;14;34
292;03.03.2017;2017;03;16;Perjantai;13;20;33;14;16;30
292;03.03.2017;2017;03;17;Perjantai;8;12;20;14;15;29
292;03.03.2017;2017;03;18;Perjantai;6;7;13;12;17;29
292;03.03.2017;2017;03;19;Perjantai;5;4;9;8;7;15
292;03.03.2017;2017;03;20;Perjantai;9;5;14;8;9;17
292;03.03.2017;2017;03;21;Perjantai;5;7;12;10;5;15
292;03.03.2017;2017;03;22;Perjantai;3;2;5;1;1;2
292;03.03.2017;2017;03;23;Perjantai;1;3;4;4;4;8
292;04.03.2017;2017;03;00;Lauantai;0;0;0;1;1;2
292;04.03.2017;2017;03;01;Lauantai;0;2;2;0;0;0
292;04.03.2017;2017;03;02;Lauantai;0;1;1;0;7;7
292;04.03.2017;2017;03;03;Lauantai;0;1;1;0;0;0
292;04.03.2017;2017;03;04;Lauantai;0;0;0;1;0;1
292;04.03.2017;2017;03;05;Lauantai;0;2;2;3;1;4
292;04.03.2017;2017;03;06;Lauantai;3;0;3;0;4;4
292;04.03.2017;2017;03;07;Lauantai;1;1;2;1;3;4
292;04.03.2017;2017;03;08;Lauantai;0;6;6;6;6;12
292;04.03.2017;2017;03;09;Lauantai;3;6;9;6;16;22
292;04.03.2017;2017;03;10;Lauantai;9;6;15;20;12;32
292;04.03.2017;2017;03;11;Lauantai;6;7;13;14;20;34
292;04.03.2017;2017;03;12;Lauantai;10;16;26;13;17;30
292;04.03.2017;2017;03;13;Lauantai;16;12;28;12;9;21
292;04.03.2017;2017;03;14;Lauantai;14;5;19;11;10;21
292;04.03.2017;2017;03;15;Lauantai;12;5;17;21;11;32
292;04.03.2017;2017;03;16;Lauantai;7;9;16;9;9;18
292;04.03.2017;2017;03;17;Lauantai;4;10;14;15;6;21
292;04.03.2017;2017;03;18;Lauantai;6;5;11;11;6;17
292;04.03.2017;2017;03;19;Lauantai;5;7;12;8;10;18
292;04.03.2017;2017;03;20;Lauantai;6;3;9;7;3;10
292;04.03.2017;2017;03;21;Lauantai;2;3;5;6;1;7
292;04.03.2017;2017;03;22;Lauantai;1;7;8;4;3;7
292;04.03.2017;2017;03;23;Lauantai;0;2;2;3;1;4
292;05.03.2017;2017;03;00;Sunnuntai;0;3;3;3;1;4
292;05.03.2017;2017;03;01;Sunnuntai;0;2;2;0;2;2
292;05.03.2017;2017;03;02;Sunnuntai;0;0;0;1;6;7
292;05.03.2017;2017;03;03;Sunnuntai;2;1;3;1;2;3
292;05.03.2017;2017;03;04;Sunnuntai;0;0;0;0;0;0
292;05.03.2017;2017;03;05;Sunnuntai;0;0;0;0;0;0
292;05.03.2017;2017;03;06;Sunnuntai;4;1;5;0;1;1
292;05.03.2017;2017;03;07;Sunnuntai;0;4;4;2;1;3
292;05.03.2017;2017;03;08;Sunnuntai;0;0;0;2;2;4
292;05.03.2017;2017;03;09;Sunnuntai;3;2;5;5;3;8
292;05.03.2017;2017;03;10;Sunnuntai;2;4;6;5;12;17
292;05.03.2017;2017;03;11;Sunnuntai;2;6;8;10;16;26
292;05.03.2017;2017;03;12;Sunnuntai;4;9;13;21;16;37
292;05.03.2017;2017;03;13;Sunnuntai;15;11;26;18;12;30
292;05.03.2017;2017;03;14;Sunnuntai;4;6;10;18;16;34
292;05.03.2017;2017;03;15;Sunnuntai;7;5;12;10;16;26
292;05.03.2017;2017;03;16;Sunnuntai;2;4;6;12;10;22
292;05.03.2017;2017;03;17;Sunnuntai;5;8;13;14;10;24
292;05.03.2017;2017;03;18;Sunnuntai;8;7;15;10;14;24
292;05.03.2017;2017;03;19;Sunnuntai;1;3;4;6;1;7
292;05.03.2017;2017;03;20;Sunnuntai;3;2;5;5;3;8
292;05.03.2017;2017;03;21;Sunnuntai;2;2;4;2;5;7
292;05.03.2017;2017;03;22;Sunnuntai;0;2;2;1;0;1
292;05.03.2017;2017;03;23;Sunnuntai;0;1;1;0;1;1
292;06.03.2017;2017;03;00;Maanantai;0;0;0;1;0;1
292;06.03.2017;2017;03;01;Maanantai;0;0;0;0;0;0
292;06.03.2017;2017;03;02;Maanantai;0;0;0;0;0;0
292;06.03.2017;2017;03;03;Maanantai;0;0;0;0;0;0
292;06.03.2017;2017;03;04;Maanantai;2;0;2;0;0;0
292;06.03.2017;2017;03;05;Maanantai;3;6;9;1;2;3
292;06.03.2017;2017;03;06;Maanantai;7;4;11;0;3;3
292;06.03.2017;2017;03;07;Maanantai;8;5;13;4;8;12
292;06.03.2017;2017;03;08;Maanantai;7;8;15;13;12;25
292;06.03.2017;2017;03;09;Maanantai;4;6;10;11;13;24
292;06.03.2017;2017;03;10;Maanantai;7;10;17;5;9;14
292;06.03.2017;2017;03;11;Maanantai;6;16;22;13;14;27
292;06.03.2017;2017;03;12;Maanantai;12;8;20;10;16;26
292;06.03.2017;2017;03;13;Maanantai;13;19;32;29;39;68
292;06.03.2017;2017;03;14;Maanantai;21;21;42;24;33;57
292;06.03.2017;2017;03;15;Maanantai;22;16;38;18;17;35
292;06.03.2017;2017;03;16;Maanantai;14;14;28;19;21;40
292;06.03.2017;2017;03;17;Maanantai;7;10;17;17;10;27
292;06.03.2017;2017;03;18;Maanantai;11;6;17;16;8;24
292;06.03.2017;2017;03;19;Maanantai;3;4;7;2;5;7
292;06.03.2017;2017;03;20;Maanantai;4;5;9;10;2;12
292;06.03.2017;2017;03;21;Maanantai;5;2;7;4;5;9
292;06.03.2017;2017;03;22;Maanantai;1;1;2;1;1;2
292;06.03.2017;2017;03;23;Maanantai;1;1;2;4;0;4
292;07.03.2017;2017;03;00;Tiistai;0;0;0;1;1;2
292;07.03.2017;2017;03;01;Tiistai;0;0;0;0;2;2
292;07.03.2017;2017;03;02;Tiistai;0;0;0;0;0;0
292;07.03.2017;2017;03;03;Tiistai;0;0;0;0;0;0
292;07.03.2017;2017;03;04;Tiistai;2;0;2;0;0;0
292;07.03.2017;2017;03;05;Tiistai;1;5;6;1;3;4
292;07.03.2017;2017;03;06;Tiistai;8;7;15;0;5;5
292;07.03.2017;2017;03;07;Tiistai;11;10;21;5;1;6
292;07.03.2017;2017;03;08;Tiistai;11;9;20;5;12;17
292;07.03.2017;2017;03;09;Tiistai;8;14;22;7;8;15
292;07.03.2017;2017;03;10;Tiistai;7;9;16;17;19;36
292;07.03.2017;2017;03;11;Tiistai;13;9;22;22;17;39
292;07.03.2017;2017;03;12;Tiistai;5;15;20;17;20;37
292;07.03.2017;2017;03;13;Tiistai;8;11;19;18;19;37
292;07.03.2017;2017;03;14;Tiistai;19;10;29;24;13;37
292;07.03.2017;2017;03;15;Tiistai;12;22;34;17;22;39
292;07.03.2017;2017;03;16;Tiistai;12;9;21;16;17;33
292;07.03.2017;2017;03;17;Tiistai;7;12;19;14;15;29
292;07.03.2017;2017;03;18;Tiistai;6;13;19;14;8;22
292;07.03.2017;2017;03;19;Tiistai;8;5;13;7;2;9
292;07.03.2017;2017;03;20;Tiistai;7;5;12;6;5;11
292;07.03.2017;2017;03;21;Tiistai;4;3;7;5;1;6
292;07.03.2017;2017;03;22;Tiistai;1;1;2;1;1;2
292;07.03.2017;2017;03;23;Tiistai;0;4;4;1;0;1
292;08.03.2017;2017;03;00;Keskiviikko;3;1;4;0;0;0
292;08.03.2017;2017;03;01;Keskiviikko;0;0;0;0;0;0
292;08.03.2017;2017;03;02;Keskiviikko;0;1;1;0;1;1
292;08.03.2017;2017;03;03;Keskiviikko;0;0;0;0;0;0
292;08.03.2017;2017;03;04;Keskiviikko;2;0;2;1;1;2
292;08.03.2017;2017;03;05;Keskiviikko;5;4;9;0;2;2
292;08.03.2017;2017;03;06;Keskiviikko;6;5;11;4;3;7
292;08.03.2017;2017;03;07;Keskiviikko;9;16;25;6;8;14
292;08.03.2017;2017;03;08;Keskiviikko;10;7;17;5;11;16
292;08.03.2017;2017;03;09;Keskiviikko;13;6;19;9;4;13
292;08.03.2017;2017;03;10;Keskiviikko;6;11;17;4;10;14
292;08.03.2017;2017;03;11;Keskiviikko;10;15;25;12;4;16
292;08.03.2017;2017;03;12;Keskiviikko;13;16;29;12;14;26
292;08.03.2017;2017;03;13;Keskiviikko;13;12;25;12;4;16
292;08.03.2017;2017;03;14;Keskiviikko;13;11;24;16;9;25
292;08.03.2017;2017;03;15;Keskiviikko;10;15;25;10;3;13
292;08.03.2017;2017;03;16;Keskiviikko;17;16;33;10;12;22
292;08.03.2017;2017;03;17;Keskiviikko;8;18;26;15;14;29
292;08.03.2017;2017;03;18;Keskiviikko;6;5;11;13;7;20
292;08.03.2017;2017;03;19;Keskiviikko;10;8;18;10;11;21
292;08.03.2017;2017;03;20;Keskiviikko;7;3;10;3;4;7
292;08.03.2017;2017;03;21;Keskiviikko;3;4;7;3;8;11
292;08.03.2017;2017;03;22;Keskiviikko;3;2;5;2;0;2
292;08.03.2017;2017;03;23;Keskiviikko;0;1;1;1;2;3
292;09.03.2017;2017;03;00;Torstai;0;1;1;0;0;0
292;09.03.2017;2017;03;01;Torstai;0;0;0;2;0;2
292;09.03.2017;2017;03;02;Torstai;0;1;1;2;0;2
292;09.03.2017;2017;03;03;Torstai;0;0;0;2;0;2
292;09.03.2017;2017;03;04;Torstai;2;0;2;1;0;1
292;09.03.2017;2017;03;05;Torstai;2;4;6;1;0;1
292;09.03.2017;2017;03;06;Torstai;2;7;9;2;2;4
292;09.03.2017;2017;03;07;Torstai;16;14;30;4;3;7
292;09.03.2017;2017;03;08;Torstai;8;10;18;6;4;10
292;09.03.2017;2017;03;09;Torstai;8;13;21;8;12;20
292;09.03.2017;2017;03;10;Torstai;7;6;13;7;10;17
292;09.03.2017;2017;03;11;Torstai;9;18;27;16;10;26
292;09.03.2017;2017;03;12;Torstai;14;9;23;9;5;14
292;09.03.2017;2017;03;13;Torstai;14;7;21;7;10;17
292;09.03.2017;2017;03;14;Torstai;16;11;27;14;7;21
292;09.03.2017;2017;03;15;Torstai;11;17;28;13;7;20
292;09.03.2017;2017;03;16;Torstai;13;16;29;9;10;19
292;09.03.2017;2017;03;17;Torstai;9;16;25;10;8;18
292;09.03.2017;2017;03;18;Torstai;5;11;16;12;15;27
292;09.03.2017;2017;03;19;Torstai;6;2;8;11;8;19
292;09.03.2017;2017;03;20;Torstai;4;4;8;6;0;6
292;09.03.2017;2017;03;21;Torstai;3;6;9;3;4;7
292;09.03.2017;2017;03;22;Torstai;2;3;5;1;3;4
292;09.03.2017;2017;03;23;Torstai;1;1;2;2;1;3
292;10.03.2017;2017;03;00;Perjantai;0;0;0;1;1;2
292;10.03.2017;2017;03;01;Perjantai;0;2;2;0;0;0
292;10.03.2017;2017;03;02;Perjantai;0;0;0;0;0;0
292;10.03.2017;2017;03;03;Perjantai;0;0;0;7;4;11
292;10.03.2017;2017;03;04;Perjantai;4;0;4;0;0;0
292;10.03.2017;2017;03;05;Perjantai;2;6;8;3;3;6
292;10.03.2017;2017;03;06;Perjantai;10;3;13;0;3;3
292;10.03.2017;2017;03;07;Perjantai;6;6;12;10;2;12
292;10.03.2017;2017;03;08;Perjantai;5;7;12;10;7;17
292;10.03.2017;2017;03;09;Perjantai;4;11;15;3;13;16
292;10.03.2017;2017;03;10;Perjantai;8;11;19;13;14;27
292;10.03.2017;2017;03;11;Perjantai;13;9;22;20;12;32
292;10.03.2017;2017;03;12;Perjantai;15;12;27;7;9;16
292;10.03.2017;2017;03;13;Perjantai;14;15;29;13;12;25
292;10.03.2017;2017;03;14;Perjantai;16;18;34;12;17;29
292;10.03.2017;2017;03;15;Perjantai;19;20;39;12;12;24
292;10.03.2017;2017;03;16;Perjantai;16;11;27;12;15;27
292;10.03.2017;2017;03;17;Perjantai;7;11;18;8;12;20
292;10.03.2017;2017;03;18;Perjantai;11;3;14;8;10;18
292;10.03.2017;2017;03;19;Perjantai;8;4;12;9;12;21
292;10.03.2017;2017;03;20;Perjantai;6;2;8;11;8;19
292;10.03.2017;2017;03;21;Perjantai;1;1;2;8;5;13
292;10.03.2017;2017;03;22;Perjantai;3;2;5;5;6;11
292;10.03.2017;2017;03;23;Perjantai;1;0;1;6;2;8
292;11.03.2017;2017;03;00;Lauantai;2;4;6;1;0;1
292;11.03.2017;2017;03;01;Lauantai;0;3;3;1;3;4
292;11.03.2017;2017;03;02;Lauantai;1;0;1;0;3;3
292;11.03.2017;2017;03;03;Lauantai;0;4;4;1;7;8
292;11.03.2017;2017;03;04;Lauantai;0;0;0;0;0;0
292;11.03.2017;2017;03;05;Lauantai;1;2;3;6;2;8
292;11.03.2017;2017;03;06;Lauantai;3;1;4;0;2;2
292;11.03.2017;2017;03;07;Lauantai;0;3;3;1;2;3
292;11.03.2017;2017;03;08;Lauantai;1;4;5;10;4;14
292;11.03.2017;2017;03;09;Lauantai;4;4;8;4;21;25
292;11.03.2017;2017;03;10;Lauantai;9;12;21;8;15;23
292;11.03.2017;2017;03;11;Lauantai;12;14;26;18;13;31
292;11.03.2017;2017;03;12;Lauantai;12;12;24;16;15;31
292;11.03.2017;2017;03;13;Lauantai;15;16;31;18;9;27
292;11.03.2017;2017;03;14;Lauantai;12;14;26;17;21;38
292;11.03.2017;2017;03;15;Lauantai;20;9;29;12;15;27
292;11.03.2017;2017;03;16;Lauantai;10;11;21;9;9;18
292;11.03.2017;2017;03;17;Lauantai;9;10;19;9;12;21
292;11.03.2017;2017;03;18;Lauantai;9;12;21;14;6;20
292;11.03.2017;2017;03;19;Lauantai;4;3;7;11;10;21
292;11.03.2017;2017;03;20;Lauantai;3;2;5;2;4;6
292;11.03.2017;2017;03;21;Lauantai;3;4;7;4;3;7
292;11.03.2017;2017;03;22;Lauantai;1;4;5;3;0;3
292;11.03.2017;2017;03;23;Lauantai;0;1;1;1;2;3
292;12.03.2017;2017;03;00;Sunnuntai;0;0;0;3;0;3
292;12.03.2017;2017;03;01;Sunnuntai;0;0;0;1;1;2
292;12.03.2017;2017;03;02;Sunnuntai;0;2;2;0;3;3
292;12.03.2017;2017;03;03;Sunnuntai;0;2;2;0;0;0
292;12.03.2017;2017;03;04;Sunnuntai;0;0;0;0;0;0
292;12.03.2017;2017;03;05;Sunnuntai;0;1;1;2;0;2
292;12.03.2017;2017;03;06;Sunnuntai;2;0;2;0;2;2
292;12.03.2017;2017;03;07;Sunnuntai;1;3;4;2;0;2
292;12.03.2017;2017;03;08;Sunnuntai;0;1;1;5;3;8
292;12.03.2017;2017;03;09;Sunnuntai;1;6;7;5;9;14
292;12.03.2017;2017;03;10;Sunnuntai;6;6;12;7;15;22
292;12.03.2017;2017;03;11;Sunnuntai;10;11;21;19;9;28
292;12.03.2017;2017;03;12;Sunnuntai;12;12;24;12;12;24
292;12.03.2017;2017;03;13;Sunnuntai;10;12;22;13;15;28
292;12.03.2017;2017;03;14;Sunnuntai;12;9;21;15;8;23
292;12.03.2017;2017;03;15;Sunnuntai;14;11;25;13;14;27
292;12.03.2017;2017;03;16;Sunnuntai;11;8;19;12;11;23
292;12.03.2017;2017;03;17;Sunnuntai;3;4;7;11;12;23
292;12.03.2017;2017;03;18;Sunnuntai;10;11;21;14;17;31
292;12.03.2017;2017;03;19;Sunnuntai;4;2;6;19;9;28
292;12.03.2017;2017;03;20;Sunnuntai;6;7;13;3;3;6
292;12.03.2017;2017;03;21;Sunnuntai;2;4;6;0;5;5
292;12.03.2017;2017;03;22;Sunnuntai;3;2;5;0;0;0
292;12.03.2017;2017;03;23;Sunnuntai;0;0;0;1;1;2
292;13.03.2017;2017;03;00;Maanantai;0;0;0;1;0;1
292;13.03.2017;2017;03;01;Maanantai;0;0;0;0;0;0
292;13.03.2017;2017;03;02;Maanantai;0;1;1;0;0;0
292;13.03.2017;2017;03;03;Maanantai;0;0;0;0;1;1
292;13.03.2017;2017;03;04;Maanantai;2;0;2;0;0;0
292;13.03.2017;2017;03;05;Maanantai;4;9;13;2;0;2
292;13.03.2017;2017;03;06;Maanantai;10;9;19;1;4;5
292;13.03.2017;2017;03;07;Maanantai;45;14;59;14;20;34
292;13.03.2017;2017;03;08;Maanantai;38;14;52;10;14;24
292;13.03.2017;2017;03;09;Maanantai;41;14;55;12;15;27
292;13.03.2017;2017;03;10;Maanantai;20;2;22;10;11;21
292;13.03.2017;2017;03;11;Maanantai;10;12;22;24;11;35
292;13.03.2017;2017;03;12;Maanantai;9;23;32;14;29;43
292;13.03.2017;2017;03;13;Maanantai;16;28;44;16;21;37
292;13.03.2017;2017;03;14;Maanantai;29;40;69;22;34;56
292;13.03.2017;2017;03;15;Maanantai;26;39;65;22;41;63
292;13.03.2017;2017;03;16;Maanantai;30;33;63;10;22;32
292;13.03.2017;2017;03;17;Maanantai;10;19;29;12;14;26
292;13.03.2017;2017;03;18;Maanantai;15;11;26;19;19;38
292;13.03.2017;2017;03;19;Maanantai;16;10;26;18;11;29
292;13.03.2017;2017;03;20;Maanantai;9;8;17;5;9;14
292;13.03.2017;2017;03;21;Maanantai;4;10;14;2;4;6
292;13.03.2017;2017;03;22;Maanantai;2;0;2;0;0;0
292;13.03.2017;2017;03;23;Maanantai;0;0;0;1;0;1
292;14.03.2017;2017;03;00;Tiistai;1;0;1;1;0;1
292;14.03.2017;2017;03;01;Tiistai;0;0;0;0;0;0
292;14.03.2017;2017;03;02;Tiistai;0;0;0;0;0;0
292;14.03.2017;2017;03;03;Tiistai;0;0;0;0;0;0
292;14.03.2017;2017;03;04;Tiistai;1;1;2;8;1;9
292;14.03.2017;2017;03;05;Tiistai;4;5;9;3;0;3
292;14.03.2017;2017;03;06;Tiistai;11;7;18;1;7;8
292;14.03.2017;2017;03;07;Tiistai;49;10;59;20;12;32
292;14.03.2017;2017;03;08;Tiistai;41;18;59;14;19;33
292;14.03.2017;2017;03;09;Tiistai;16;16;32;17;9;26
292;14.03.2017;2017;03;10;Tiistai;17;6;23;11;17;28
292;14.03.2017;2017;03;11;Tiistai;12;15;27;10;7;17
292;14.03.2017;2017;03;12;Tiistai;12;10;22;4;10;14
292;14.03.2017;2017;03;13;Tiistai;8;25;33;12;9;21
292;14.03.2017;2017;03;14;Tiistai;24;43;67;13;20;33
292;14.03.2017;2017;03;15;Tiistai;19;41;60;16;20;36
292;14.03.2017;2017;03;16;Tiistai;23;29;52;9;15;24
292;14.03.2017;2017;03;17;Tiistai;19;21;40;11;17;28
292;14.03.2017;2017;03;18;Tiistai;10;12;22;9;13;22
292;14.03.2017;2017;03;19;Tiistai;8;10;18;17;11;28
292;14.03.2017;2017;03;20;Tiistai;8;10;18;5;4;9
292;14.03.2017;2017;03;21;Tiistai;4;3;7;3;1;4
292;14.03.2017;2017;03;22;Tiistai;1;1;2;1;0;1
292;14.03.2017;2017;03;23;Tiistai;0;0;0;0;1;1
292;15.03.2017;2017;03;00;Keskiviikko;0;0;0;1;0;1
292;15.03.2017;2017;03;01;Keskiviikko;0;1;1;0;0;0
292;15.03.2017;2017;03;02;Keskiviikko;0;1;1;0;0;0
292;15.03.2017;2017;03;03;Keskiviikko;0;0;0;0;0;0
292;15.03.2017;2017;03;04;Keskiviikko;2;0;2;0;1;1
292;15.03.2017;2017;03;05;Keskiviikko;5;3;8;5;1;6
292;15.03.2017;2017;03;06;Keskiviikko;14;9;23;3;6;9
292;15.03.2017;2017;03;07;Keskiviikko;61;10;71;16;12;28
292;15.03.2017;2017;03;08;Keskiviikko;31;13;44;20;19;39
292;15.03.2017;2017;03;09;Keskiviikko;25;14;39;17;8;25
292;15.03.2017;2017;03;10;Keskiviikko;14;14;28;14;18;32
292;15.03.2017;2017;03;11;Keskiviikko;12;11;23;15;11;26
292;15.03.2017;2017;03;12;Keskiviikko;8;19;27;6;20;26
292;15.03.2017;2017;03;13;Keskiviikko;14;44;58;25;14;39
292;15.03.2017;2017;03;14;Keskiviikko;19;35;54;11;12;23
292;15.03.2017;2017;03;15;Keskiviikko;14;35;49;9;20;29
292;15.03.2017;2017;03;16;Keskiviikko;20;27;47;13;15;28
292;15.03.2017;2017;03;17;Keskiviikko;11;14;25;22;14;36
292;15.03.2017;2017;03;18;Keskiviikko;10;13;23;21;11;32
292;15.03.2017;2017;03;19;Keskiviikko;5;9;14;9;9;18
292;15.03.2017;2017;03;20;Keskiviikko;8;5;13;6;3;9
292;15.03.2017;2017;03;21;Keskiviikko;6;3;9;1;3;4
292;15.03.2017;2017;03;22;Keskiviikko;2;1;3;1;2;3
292;15.03.2017;2017;03;23;Keskiviikko;1;0;1;0;2;2
292;16.03.2017;2017;03;00;Torstai;1;0;1;0;2;2
292;16.03.2017;2017;03;01;Torstai;0;0;0;0;0;0
292;16.03.2017;2017;03;02;Torstai;0;1;1;0;0;0
292;16.03.2017;2017;03;03;Torstai;0;0;0;0;0;0
292;16.03.2017;2017;03;04;Torstai;1;1;2;0;0;0
292;16.03.2017;2017;03;05;Torstai;5;1;6;2;3;5
292;16.03.2017;2017;03;06;Torstai;12;10;22;4;4;8
292;16.03.2017;2017;03;07;Torstai;39;11;50;14;11;25
292;16.03.2017;2017;03;08;Torstai;25;11;36;7;18;25
292;16.03.2017;2017;03;09;Torstai;36;13;49;15;12;27
292;16.03.2017;2017;03;10;Torstai;17;7;24;21;10;31
292;16.03.2017;2017;03;11;Torstai;13;8;21;21;12;33
292;16.03.2017;2017;03;12;Torstai;8;15;23;14;18;32
292;16.03.2017;2017;03;13;Torstai;9;27;36;11;21;32
292;16.03.2017;2017;03;14;Torstai;22;21;43;12;19;31
292;16.03.2017;2017;03;15;Torstai;18;36;54;19;29;48
292;16.03.2017;2017;03;16;Torstai;18;25;43;9;37;46
292;16.03.2017;2017;03;17;Torstai;19;21;40;10;10;20
292;16.03.2017;2017;03;18;Torstai;9;13;22;15;12;27
292;16.03.2017;2017;03;19;Torstai;23;11;34;14;14;28
292;16.03.2017;2017;03;20;Torstai;8;1;9;6;5;11
292;16.03.2017;2017;03;21;Torstai;4;5;9;2;3;5
292;16.03.2017;2017;03;22;Torstai;3;4;7;1;1;2
292;16.03.2017;2017;03;23;Torstai;1;1;2;0;0;0
292;17.03.2017;2017;03;00;Perjantai;0;0;0;0;0;0
292;17.03.2017;2017;03;01;Perjantai;0;0;0;0;0;0
292;17.03.2017;2017;03;02;Perjantai;0;0;0;0;0;0
292;17.03.2017;2017;03;03;Perjantai;0;0;0;0;1;1
292;17.03.2017;2017;03;04;Perjantai;0;0;0;1;0;1
292;17.03.2017;2017;03;05;Perjantai;3;5;8;0;0;0
292;17.03.2017;2017;03;06;Perjantai;8;7;15;8;6;14
292;17.03.2017;2017;03;07;Perjantai;39;8;47;12;5;17
292;17.03.2017;2017;03;08;Perjantai;25;13;38;11;5;16
292;17.03.2017;2017;03;09;Perjantai;24;7;31;8;7;15
292;17.03.2017;2017;03;10;Perjantai;9;5;14;3;6;9
292;17.03.2017;2017;03;11;Perjantai;6;6;12;12;11;23
292;17.03.2017;2017;03;12;Perjantai;14;16;30;15;12;27
292;17.03.2017;2017;03;13;Perjantai;10;45;55;10;26;36
292;17.03.2017;2017;03;14;Perjantai;13;22;35;7;8;15
292;17.03.2017;2017;03;15;Perjantai;11;17;28;3;24;27
292;17.03.2017;2017;03;16;Perjantai;9;6;15;10;11;21
292;17.03.2017;2017;03;17;Perjantai;3;3;6;8;5;13
292;17.03.2017;2017;03;18;Perjantai;15;3;18;9;9;18
292;17.03.2017;2017;03;19;Perjantai;5;6;11;13;16;29
292;17.03.2017;2017;03;20;Perjantai;4;1;5;10;3;13
292;17.03.2017;2017;03;21;Perjantai;4;7;11;4;5;9
292;17.03.2017;2017;03;22;Perjantai;3;2;5;0;2;2
292;17.03.2017;2017;03;23;Perjantai;0;1;1;4;1;5
292;18.03.2017;2017;03;00;Lauantai;0;2;2;0;0;0
292;18.03.2017;2017;03;01;Lauantai;2;0;2;2;2;4
292;18.03.2017;2017;03;02;Lauantai;0;1;1;0;4;4
292;18.03.2017;2017;03;03;Lauantai;0;1;1;1;5;6
292;18.03.2017;2017;03;04;Lauantai;0;0;0;1;0;1
292;18.03.2017;2017;03;05;Lauantai;1;0;1;1;0;1
292;18.03.2017;2017;03;06;Lauantai;3;0;3;0;3;3
292;18.03.2017;2017;03;07;Lauantai;0;3;3;5;1;6
292;18.03.2017;2017;03;08;Lauantai;1;2;3;6;5;11
292;18.03.2017;2017;03;09;Lauantai;5;1;6;1;8;9
292;18.03.2017;2017;03;10;Lauantai;2;4;6;9;16;25
292;18.03.2017;2017;03;11;Lauantai;7;14;21;7;8;15
292;18.03.2017;2017;03;12;Lauantai;10;5;15;18;14;32
292;18.03.2017;2017;03;13;Lauantai;11;14;25;11;23;34
292;18.03.2017;2017;03;14;Lauantai;16;15;31;13;10;23
292;18.03.2017;2017;03;15;Lauantai;12;13;25;18;15;33
292;18.03.2017;2017;03;16;Lauantai;9;14;23;12;8;20
292;18.03.2017;2017;03;17;Lauantai;14;10;24;16;12;28
292;18.03.2017;2017;03;18;Lauantai;15;3;18;5;7;12
292;18.03.2017;2017;03;19;Lauantai;6;5;11;8;4;12
292;18.03.2017;2017;03;20;Lauantai;3;3;6;4;6;10
292;18.03.2017;2017;03;21;Lauantai;4;9;13;4;5;9
292;18.03.2017;2017;03;22;Lauantai;1;1;2;3;2;5
292;18.03.2017;2017;03;23;Lauantai;2;5;7;1;2;3
292;19.03.2017;2017;03;00;Sunnuntai;4;1;5;5;3;8
292;19.03.2017;2017;03;01;Sunnuntai;1;2;3;2;2;4
292;19.03.2017;2017;03;02;Sunnuntai;1;3;4;1;3;4
292;19.03.2017;2017;03;03;Sunnuntai;0;0;0;2;2;4
292;19.03.2017;2017;03;04;Sunnuntai;1;0;1;0;0;0
292;19.03.2017;2017;03;05;Sunnuntai;1;0;1;1;0;1
292;19.03.2017;2017;03;06;Sunnuntai;4;2;6;10;8;18
292;19.03.2017;2017;03;07;Sunnuntai;1;3;4;4;3;7
292;19.03.2017;2017;03;08;Sunnuntai;2;10;12;8;7;15
292;19.03.2017;2017;03;09;Sunnuntai;6;5;11;5;11;16
292;19.03.2017;2017;03;10;Sunnuntai;3;6;9;10;15;25
292;19.03.2017;2017;03;11;Sunnuntai;6;12;18;24;20;44
292;19.03.2017;2017;03;12;Sunnuntai;17;13;30;16;35;51
292;19.03.2017;2017;03;13;Sunnuntai;18;14;32;14;16;30
292;19.03.2017;2017;03;14;Sunnuntai;13;10;23;18;12;30
292;19.03.2017;2017;03;15;Sunnuntai;10;10;20;23;13;36
292;19.03.2017;2017;03;16;Sunnuntai;15;12;27;16;14;30
292;19.03.2017;2017;03;17;Sunnuntai;7;6;13;7;13;20
292;19.03.2017;2017;03;18;Sunnuntai;9;13;22;8;17;25
292;19.03.2017;2017;03;19;Sunnuntai;9;6;15;6;6;12
292;19.03.2017;2017;03;20;Sunnuntai;7;2;9;10;3;13
292;19.03.2017;2017;03;21;Sunnuntai;1;5;6;1;0;1
292;19.03.2017;2017;03;22;Sunnuntai;2;1;3;0;1;1
292;19.03.2017;2017;03;23;Sunnuntai;1;3;4;0;0;0
292;20.03.2017;2017;03;00;Maanantai;0;0;0;1;0;1
292;20.03.2017;2017;03;01;Maanantai;0;0;0;0;0;0
292;20.03.2017;2017;03;02;Maanantai;0;1;1;0;0;0
292;20.03.2017;2017;03;03;Maanantai;0;0;0;0;0;0
292;20.03.2017;2017;03;04;Maanantai;3;1;4;1;0;1
292;20.03.2017;2017;03;05;Maanantai;5;5;10;0;1;1
292;20.03.2017;2017;03;06;Maanantai;10;10;20;2;1;3
292;20.03.2017;2017;03;07;Maanantai;31;15;46;12;13;25
292;20.03.2017;2017;03;08;Maanantai;38;16;54;11;6;17
292;20.03.2017;2017;03;09;Maanantai;38;13;51;19;21;40
292;20.03.2017;2017;03;10;Maanantai;27;9;36;11;16;27
292;20.03.2017;2017;03;11;Maanantai;13;11;24;9;13;22
292;20.03.2017;2017;03;12;Maanantai;14;26;40;15;18;33
292;20.03.2017;2017;03;13;Maanantai;9;31;40;17;19;36
292;20.03.2017;2017;03;14;Maanantai;18;53;71;24;20;44
292;20.03.2017;2017;03;15;Maanantai;24;39;63;23;15;38
292;20.03.2017;2017;03;16;Maanantai;32;41;73;18;24;42
292;20.03.2017;2017;03;17;Maanantai;19;25;44;9;10;19
292;20.03.2017;2017;03;18;Maanantai;15;15;30;17;11;28
292;20.03.2017;2017;03;19;Maanantai;15;11;26;12;13;25
292;20.03.2017;2017;03;20;Maanantai;10;2;12;11;7;18
292;20.03.2017;2017;03;21;Maanantai;3;8;11;2;3;5
292;20.03.2017;2017;03;22;Maanantai;1;0;1;0;2;2
292;20.03.2017;2017;03;23;Maanantai;1;0;1;0;0;0
292;21.03.2017;2017;03;00;Tiistai;0;0;0;0;1;1
292;21.03.2017;2017;03;01;Tiistai;0;1;1;0;0;0
292;21.03.2017;2017;03;02;Tiistai;0;0;0;0;0;0
292;21.03.2017;2017;03;03;Tiistai;0;0;0;0;0;0
292;21.03.2017;2017;03;04;Tiistai;2;1;3;0;0;0
292;21.03.2017;2017;03;05;Tiistai;3;6;9;1;0;1
292;21.03.2017;2017;03;06;Tiistai;15;13;28;0;5;5
292;21.03.2017;2017;03;07;Tiistai;53;11;64;8;11;19
292;21.03.2017;2017;03;08;Tiistai;44;15;59;13;15;28
292;21.03.2017;2017;03;09;Tiistai;18;9;27;15;10;25
292;21.03.2017;2017;03;10;Tiistai;20;9;29;8;10;18
292;21.03.2017;2017;03;11;Tiistai;15;13;28;13;10;23
292;21.03.2017;2017;03;12;Tiistai;10;12;22;14;20;34
292;21.03.2017;2017;03;13;Tiistai;8;27;35;22;19;41
292;21.03.2017;2017;03;14;Tiistai;14;35;49;27;37;64
292;21.03.2017;2017;03;15;Tiistai;13;38;51;29;19;48
292;21.03.2017;2017;03;16;Tiistai;15;30;45;23;26;49
292;21.03.2017;2017;03;17;Tiistai;14;16;30;23;17;40
292;21.03.2017;2017;03;18;Tiistai;18;11;29;17;18;35
292;21.03.2017;2017;03;19;Tiistai;9;15;24;10;14;24
292;21.03.2017;2017;03;20;Tiistai;7;9;16;6;4;10
292;21.03.2017;2017;03;21;Tiistai;3;2;5;6;4;10
292;21.03.2017;2017;03;22;Tiistai;5;3;8;1;2;3
292;21.03.2017;2017;03;23;Tiistai;0;1;1;0;1;1
292;22.03.2017;2017;03;00;Keskiviikko;1;1;2;0;0;0
292;22.03.2017;2017;03;01;Keskiviikko;0;0;0;0;2;2
292;22.03.2017;2017;03;02;Keskiviikko;0;0;0;0;0;0
292;22.03.2017;2017;03;03;Keskiviikko;0;1;1;0;0;0
292;22.03.2017;2017;03;04;Keskiviikko;1;0;1;0;0;0
292;22.03.2017;2017;03;05;Keskiviikko;4;5;9;2;2;4
292;22.03.2017;2017;03;06;Keskiviikko;9;10;19;3;6;9
292;22.03.2017;2017;03;07;Keskiviikko;67;9;76;10;8;18
292;22.03.2017;2017;03;08;Keskiviikko;45;14;59;12;7;19
292;22.03.2017;2017;03;09;Keskiviikko;23;8;31;6;8;14
292;22.03.2017;2017;03;10;Keskiviikko;8;9;17;4;13;17
292;22.03.2017;2017;03;11;Keskiviikko;15;12;27;30;13;43
292;22.03.2017;2017;03;12;Keskiviikko;12;10;22;14;28;42
292;22.03.2017;2017;03;13;Keskiviikko;10;47;57;23;24;47
292;22.03.2017;2017;03;14;Keskiviikko;27;44;71;24;23;47
292;22.03.2017;2017;03;15;Keskiviikko;18;32;50;14;19;33
292;22.03.2017;2017;03;16;Keskiviikko;35;39;74;17;14;31
292;22.03.2017;2017;03;17;Keskiviikko;20;17;37;17;13;30
292;22.03.2017;2017;03;18;Keskiviikko;10;8;18;11;16;27
292;22.03.2017;2017;03;19;Keskiviikko;8;10;18;12;9;21
292;22.03.2017;2017;03;20;Keskiviikko;8;2;10;9;10;19
292;22.03.2017;2017;03;21;Keskiviikko;1;6;7;3;1;4
292;22.03.2017;2017;03;22;Keskiviikko;7;4;11;4;1;5
292;22.03.2017;2017;03;23;Keskiviikko;0;0;0;0;0;0
292;23.03.2017;2017;03;00;Torstai;0;1;1;1;0;1
292;23.03.2017;2017;03;01;Torstai;0;2;2;0;1;1
292;23.03.2017;2017;03;02;Torstai;1;2;3;0;0;0
292;23.03.2017;2017;03;03;Torstai;0;3;3;8;8;16
292;23.03.2017;2017;03;04;Torstai;1;0;1;0;0;0
292;23.03.2017;2017;03;05;Torstai;5;7;12;1;2;3
292;23.03.2017;2017;03;06;Torstai;13;15;28;0;3;3
292;23.03.2017;2017;03;07;Torstai;32;16;48;7;6;13
292;23.03.2017;2017;03;08;Torstai;28;15;43;7;11;18
292;23.03.2017;2017;03;09;Torstai;37;13;50;9;10;19
292;23.03.2017;2017;03;10;Torstai;16;4;20;12;11;23
292;23.03.2017;2017;03;11;Torstai;19;16;35;16;14;30
292;23.03.2017;2017;03;12;Torstai;10;25;35;9;10;19
292;23.03.2017;2017;03;13;Torstai;14;30;44;13;18;31
292;23.03.2017;2017;03;14;Torstai;16;16;32;17;11;28
292;23.03.2017;2017;03;15;Torstai;20;39;59;15;12;27
292;23.03.2017;2017;03;16;Torstai;25;31;56;8;20;28
292;23.03.2017;2017;03;17;Torstai;15;19;34;11;6;17
292;23.03.2017;2017;03;18;Torstai;9;9;18;7;10;17
292;23.03.2017;2017;03;19;Torstai;9;8;17;9;6;15
292;23.03.2017;2017;03;20;Torstai;11;4;15;10;4;14
292;23.03.2017;2017;03;21;Torstai;3;7;10;3;7;10
292;23.03.2017;2017;03;22;Torstai;2;6;8;2;0;2
292;23.03.2017;2017;03;23;Torstai;0;0;0;1;0;1
292;24.03.2017;2017;03;00;Perjantai;0;0;0;0;1;1
292;24.03.2017;2017;03;01;Perjantai;0;0;0;0;0;0
292;24.03.2017;2017;03;02;Perjantai;0;0;0;0;0;0
292;24.03.2017;2017;03;03;Perjantai;0;0;0;0;1;1
292;24.03.2017;2017;03;04;Perjantai;1;0;1;1;1;2
292;24.03.2017;2017;03;05;Perjantai;5;5;10;3;3;6
292;24.03.2017;2017;03;06;Perjantai;8;13;21;1;6;7
292;24.03.2017;2017;03;07;Perjantai;44;12;56;12;6;18
292;24.03.2017;2017;03;08;Perjantai;36;19;55;6;9;15
292;24.03.2017;2017;03;09;Perjantai;26;11;37;15;11;26
292;24.03.2017;2017;03;10;Perjantai;7;8;15;10;20;30
292;24.03.2017;2017;03;11;Perjantai;5;17;22;7;9;16
292;24.03.2017;2017;03;12;Perjantai;17;26;43;14;24;38
292;24.03.2017;2017;03;13;Perjantai;24;61;85;22;24;46
292;24.03.2017;2017;03;14;Perjantai;21;50;71;16;17;33
292;24.03.2017;2017;03;15;Perjantai;23;31;54;6;20;26
292;24.03.2017;2017;03;16;Perjantai;24;21;45;16;13;29
292;24.03.2017;2017;03;17;Perjantai;24;19;43;13;14;27
292;24.03.2017;2017;03;18;Perjantai;24;21;45;17;14;31
292;24.03.2017;2017;03;19;Perjantai;15;14;29;8;12;20
292;24.03.2017;2017;03;20;Perjantai;11;10;21;9;2;11
292;24.03.2017;2017;03;21;Perjantai;7;10;17;5;3;8
292;24.03.2017;2017;03;22;Perjantai;4;2;6;2;1;3
292;24.03.2017;2017;03;23;Perjantai;6;2;8;4;0;4
292;25.03.2017;2017;03;00;Lauantai;1;0;1;1;0;1
292;25.03.2017;2017;03;01;Lauantai;0;1;1;1;0;1
292;25.03.2017;2017;03;02;Lauantai;0;1;1;1;1;2
292;25.03.2017;2017;03;03;Lauantai;1;2;3;0;3;3
292;25.03.2017;2017;03;04;Lauantai;0;0;0;0;0;0
292;25.03.2017;2017;03;05;Lauantai;0;0;0;3;0;3
292;25.03.2017;2017;03;06;Lauantai;2;0;2;0;2;2
292;25.03.2017;2017;03;07;Lauantai;0;2;2;2;2;4
292;25.03.2017;2017;03;08;Lauantai;4;5;9;2;9;11
292;25.03.2017;2017;03;09;Lauantai;8;7;15;6;8;14
292;25.03.2017;2017;03;10;Lauantai;7;10;17;10;11;21
292;25.03.2017;2017;03;11;Lauantai;13;13;26;23;14;37
292;25.03.2017;2017;03;12;Lauantai;18;26;44;14;25;39
292;25.03.2017;2017;03;13;Lauantai;24;16;40;15;11;26
292;25.03.2017;2017;03;14;Lauantai;11;23;34;14;12;26
292;25.03.2017;2017;03;15;Lauantai;17;17;34;10;12;22
292;25.03.2017;2017;03;16;Lauantai;25;21;46;16;10;26
292;25.03.2017;2017;03;17;Lauantai;23;20;43;9;17;26
292;25.03.2017;2017;03;18;Lauantai;11;9;20;20;10;30
292;25.03.2017;2017;03;19;Lauantai;5;7;12;9;3;12
292;25.03.2017;2017;03;20;Lauantai;7;5;12;10;4;14
292;25.03.2017;2017;03;21;Lauantai;11;11;22;3;2;5
292;25.03.2017;2017;03;22;Lauantai;5;0;5;1;0;1
292;25.03.2017;2017;03;23;Lauantai;1;1;2;3;1;4
292;26.03.2017;2017;03;00;Sunnuntai;1;0;1;1;1;2
292;26.03.2017;2017;03;01;Sunnuntai;1;2;3;0;2;2
292;26.03.2017;2017;03;02;Sunnuntai;0;0;0;0;0;0
292;26.03.2017;2017;03;03;Sunnuntai;0;3;3;0;6;6
292;26.03.2017;2017;03;04;Sunnuntai;0;3;3;0;8;8
292;26.03.2017;2017;03;05;Sunnuntai;1;0;1;1;0;1
292;26.03.2017;2017;03;06;Sunnuntai;2;0;2;2;1;3
292;26.03.2017;2017;03;07;Sunnuntai;0;1;1;0;0;0
292;26.03.2017;2017;03;08;Sunnuntai;1;3;4;8;1;9
292;26.03.2017;2017;03;09;Sunnuntai;8;3;11;6;3;9
292;26.03.2017;2017;03;10;Sunnuntai;3;7;10;9;16;25
292;26.03.2017;2017;03;11;Sunnuntai;7;14;21;15;16;31
292;26.03.2017;2017;03;12;Sunnuntai;14;20;34;12;22;34
292;26.03.2017;2017;03;13;Sunnuntai;20;15;35;15;22;37
292;26.03.2017;2017;03;14;Sunnuntai;11;17;28;21;15;36
292;26.03.2017;2017;03;15;Sunnuntai;20;11;31;22;13;35
292;26.03.2017;2017;03;16;Sunnuntai;15;12;27;16;8;24
292;26.03.2017;2017;03;17;Sunnuntai;10;15;25;12;9;21
292;26.03.2017;2017;03;18;Sunnuntai;11;10;21;20;15;35
292;26.03.2017;2017;03;19;Sunnuntai;9;10;19;6;10;16
292;26.03.2017;2017;03;20;Sunnuntai;8;5;13;7;3;10
292;26.03.2017;2017;03;21;Sunnuntai;4;9;13;2;2;4
292;26.03.2017;2017;03;22;Sunnuntai;1;1;2;0;0;0
292;26.03.2017;2017;03;23;Sunnuntai;0;0;0;0;1;1
292;27.03.2017;2017;03;00;Maanantai;0;0;0;0;0;0
292;27.03.2017;2017;03;01;Maanantai;0;1;1;0;0;0
292;27.03.2017;2017;03;02;Maanantai;0;0;0;0;0;0
292;27.03.2017;2017;03;03;Maanantai;0;0;0;0;0;0
292;27.03.2017;2017;03;04;Maanantai;2;0;2;1;0;1
292;27.03.2017;2017;03;05;Maanantai;3;7;10;4;0;4
292;27.03.2017;2017;03;06;Maanantai;12;7;19;0;3;3
292;27.03.2017;2017;03;07;Maanantai;42;19;61;11;6;17
292;27.03.2017;2017;03;08;Maanantai;27;13;40;10;15;25
292;27.03.2017;2017;03;09;Maanantai;42;12;54;16;16;32
292;27.03.2017;2017;03;10;Maanantai;25;12;37;13;10;23
292;27.03.2017;2017;03;11;Maanantai;20;16;36;9;7;16
292;27.03.2017;2017;03;12;Maanantai;10;19;29;11;8;19
292;27.03.2017;2017;03;13;Maanantai;19;37;56;14;15;29
292;27.03.2017;2017;03;14;Maanantai;24;47;71;10;15;25
292;27.03.2017;2017;03;15;Maanantai;25;31;56;11;22;33
292;27.03.2017;2017;03;16;Maanantai;15;37;52;7;18;25
292;27.03.2017;2017;03;17;Maanantai;13;20;33;4;11;15
292;27.03.2017;2017;03;18;Maanantai;16;12;28;16;7;23
292;27.03.2017;2017;03;19;Maanantai;11;12;23;6;7;13
292;27.03.2017;2017;03;20;Maanantai;11;7;18;10;9;19
292;27.03.2017;2017;03;21;Maanantai;6;1;7;3;2;5
292;27.03.2017;2017;03;22;Maanantai;2;0;2;1;1;2
292;27.03.2017;2017;03;23;Maanantai;0;1;1;0;0;0
292;28.03.2017;2017;03;00;Tiistai;1;0;1;0;0;0
292;28.03.2017;2017;03;01;Tiistai;0;0;0;0;0;0
292;28.03.2017;2017;03;02;Tiistai;0;0;0;0;0;0
292;28.03.2017;2017;03;03;Tiistai;1;0;1;0;0;0
292;28.03.2017;2017;03;04;Tiistai;2;0;2;0;0;0
292;28.03.2017;2017;03;05;Tiistai;4;4;8;0;0;0
292;28.03.2017;2017;03;06;Tiistai;8;13;21;2;2;4
292;28.03.2017;2017;03;07;Tiistai;54;13;67;15;7;22
292;28.03.2017;2017;03;08;Tiistai;38;18;56;11;15;26
292;28.03.2017;2017;03;09;Tiistai;29;19;48;12;12;24
292;28.03.2017;2017;03;10;Tiistai;19;7;26;8;12;20
292;28.03.2017;2017;03;11;Tiistai;13;17;30;25;11;36
292;28.03.2017;2017;03;12;Tiistai;11;18;29;15;17;32
292;28.03.2017;2017;03;13;Tiistai;17;29;46;12;16;28
292;28.03.2017;2017;03;14;Tiistai;20;58;78;19;25;44
292;28.03.2017;2017;03;15;Tiistai;19;52;71;16;14;30
292;28.03.2017;2017;03;16;Tiistai;24;31;55;14;18;32
292;28.03.2017;2017;03;17;Tiistai;40;29;69;15;14;29
292;28.03.2017;2017;03;18;Tiistai;13;26;39;19;20;39
292;28.03.2017;2017;03;19;Tiistai;12;26;38;13;11;24
292;28.03.2017;2017;03;20;Tiistai;10;7;17;10;5;15
292;28.03.2017;2017;03;21;Tiistai;5;9;14;2;2;4
292;28.03.2017;2017;03;22;Tiistai;3;0;3;2;0;2
292;28.03.2017;2017;03;23;Tiistai;0;0;0;2;0;2
292;29.03.2017;2017;03;00;Keskiviikko;0;0;0;0;0;0
292;29.03.2017;2017;03;01;Keskiviikko;0;1;1;0;1;1
292;29.03.2017;2017;03;02;Keskiviikko;0;0;0;0;0;0
292;29.03.2017;2017;03;03;Keskiviikko;0;0;0;0;0;0
292;29.03.2017;2017;03;04;Keskiviikko;4;1;5;0;0;0
292;29.03.2017;2017;03;05;Keskiviikko;6;5;11;0;0;0
292;29.03.2017;2017;03;06;Keskiviikko;12;11;23;1;4;5
292;29.03.2017;2017;03;07;Keskiviikko;64;13;77;15;4;19
292;29.03.2017;2017;03;08;Keskiviikko;32;16;48;11;10;21
292;29.03.2017;2017;03;09;Keskiviikko;26;14;40;13;9;22
292;29.03.2017;2017;03;10;Keskiviikko;13;7;20;15;13;28
292;29.03.2017;2017;03;11;Keskiviikko;9;12;21;21;22;43
292;29.03.2017;2017;03;12;Keskiviikko;9;13;22;13;11;24
292;29.03.2017;2017;03;13;Keskiviikko;17;64;81;21;23;44
292;29.03.2017;2017;03;14;Keskiviikko;29;57;86;12;20;32
292;29.03.2017;2017;03;15;Keskiviikko;23;41;64;18;22;40
292;29.03.2017;2017;03;16;Keskiviikko;38;24;62;15;11;26
292;29.03.2017;2017;03;17;Keskiviikko;28;29;57;19;16;35
292;29.03.2017;2017;03;18;Keskiviikko;22;18;40;12;15;27
292;29.03.2017;2017;03;19;Keskiviikko;17;24;41;15;10;25
292;29.03.2017;2017;03;20;Keskiviikko;14;7;21;6;8;14
292;29.03.2017;2017;03;21;Keskiviikko;6;6;12;1;1;2
292;29.03.2017;2017;03;22;Keskiviikko;4;4;8;2;0;2
292;29.03.2017;2017;03;23;Keskiviikko;0;0;0;1;1;2
292;30.03.2017;2017;03;00;Torstai;1;1;2;2;1;3
292;30.03.2017;2017;03;01;Torstai;0;2;2;0;1;1
292;30.03.2017;2017;03;02;Torstai;0;0;0;0;0;0
292;30.03.2017;2017;03;03;Torstai;0;0;0;0;0;0
292;30.03.2017;2017;03;04;Torstai;3;0;3;0;0;0
292;30.03.2017;2017;03;05;Torstai;3;4;7;0;1;1
292;30.03.2017;2017;03;06;Torstai;14;12;26;1;3;4
292;30.03.2017;2017;03;07;Torstai;42;15;57;9;3;12
292;30.03.2017;2017;03;08;Torstai;27;19;46;9;8;17
292;30.03.2017;2017;03;09;Torstai;42;11;53;13;12;25
292;30.03.2017;2017;03;10;Torstai;15;11;26;11;7;18
292;30.03.2017;2017;03;11;Torstai;14;24;38;10;16;26
292;30.03.2017;2017;03;12;Torstai;20;17;37;10;14;24
292;30.03.2017;2017;03;13;Torstai;15;30;45;17;20;37
292;30.03.2017;2017;03;14;Torstai;23;53;76;24;19;43
292;30.03.2017;2017;03;15;Torstai;29;44;73;13;25;38
292;30.03.2017;2017;03;16;Torstai;34;38;72;14;18;32
292;30.03.2017;2017;03;17;Torstai;20;27;47;16;11;27
292;30.03.2017;2017;03;18;Torstai;11;20;31;18;19;37
292;30.03.2017;2017;03;19;Torstai;16;15;31;15;13;28
292;30.03.2017;2017;03;20;Torstai;12;8;20;6;3;9
292;30.03.2017;2017;03;21;Torstai;7;4;11;2;1;3
292;30.03.2017;2017;03;22;Torstai;3;5;8;1;1;2
292;30.03.2017;2017;03;23;Torstai;3;2;5;2;0;2
292;31.03.2017;2017;03;00;Perjantai;0;1;1;0;2;2
292;31.03.2017;2017;03;01;Perjantai;0;0;0;0;0;0
292;31.03.2017;2017;03;02;Perjantai;0;0;0;0;1;1
292;31.03.2017;2017;03;03;Perjantai;1;0;1;0;0;0
292;31.03.2017;2017;03;04;Perjantai;3;0;3;0;0;0
292;31.03.2017;2017;03;05;Perjantai;2;7;9;2;1;3
292;31.03.2017;2017;03;06;Perjantai;11;8;19;2;7;9
292;31.03.2017;2017;03;07;Perjantai;58;12;70;9;2;11
292;31.03.2017;2017;03;08;Perjantai;42;18;60;7;14;21
292;31.03.2017;2017;03;09;Perjantai;20;14;34;7;9;16
292;31.03.2017;2017;03;10;Perjantai;13;20;33;11;11;22
292;31.03.2017;2017;03;11;Perjantai;17;19;36;8;13;21
292;31.03.2017;2017;03;12;Perjantai;11;28;39;19;16;35
292;31.03.2017;2017;03;13;Perjantai;18;52;70;19;16;35
292;31.03.2017;2017;03;14;Perjantai;22;44;66;13;26;39
292;31.03.2017;2017;03;15;Perjantai;32;36;68;14;15;29
292;31.03.2017;2017;03;16;Perjantai;30;30;60;15;9;24
292;31.03.2017;2017;03;17;Perjantai;33;18;51;7;13;20
292;31.03.2017;2017;03;18;Perjantai;23;23;46;28;19;47
292;31.03.2017;2017;03;19;Perjantai;17;15;32;11;9;20
292;31.03.2017;2017;03;20;Perjantai;13;7;20;2;5;7
292;31.03.2017;2017;03;21;Perjantai;11;12;23;1;9;10
292;31.03.2017;2017;03;22;Perjantai;8;5;13;6;5;11
292;31.03.2017;2017;03;23;Perjantai;2;7;9;2;0;2
292;01.04.2017;2017;04;00;Lauantai;0;3;3;2;0;2
292;01.04.2017;2017;04;01;Lauantai;0;2;2;3;0;3
292;01.04.2017;2017;04;02;Lauantai;1;2;3;0;3;3
292;01.04.2017;2017;04;03;Lauantai;0;2;2;0;4;4
292;01.04.2017;2017;04;04;Lauantai;0;1;1;0;0;0
292;01.04.2017;2017;04;05;Lauantai;0;0;0;1;0;1
292;01.04.2017;2017;04;06;Lauantai;4;5;9;1;1;2
292;01.04.2017;2017;04;07;Lauantai;2;1;3;0;1;1
292;01.04.2017;2017;04;08;Lauantai;1;5;6;3;3;6
292;01.04.2017;2017;04;09;Lauantai;6;12;18;5;7;12
292;01.04.2017;2017;04;10;Lauantai;7;4;11;11;12;23
292;01.04.2017;2017;04;11;Lauantai;10;25;35;15;9;24
292;01.04.2017;2017;04;12;Lauantai;16;13;29;12;10;22
292;01.04.2017;2017;04;13;Lauantai;13;29;42;14;11;25
292;01.04.2017;2017;04;14;Lauantai;12;11;23;11;8;19
292;01.04.2017;2017;04;15;Lauantai;13;6;19;8;4;12
292;01.04.2017;2017;04;16;Lauantai;11;5;16;7;5;12
292;01.04.2017;2017;04;17;Lauantai;14;7;21;8;12;20
292;01.04.2017;2017;04;18;Lauantai;12;5;17;6;6;12
292;01.04.2017;2017;04;19;Lauantai;10;4;14;8;7;15
292;01.04.2017;2017;04;20;Lauantai;5;7;12;5;6;11
292;01.04.2017;2017;04;21;Lauantai;5;5;10;1;2;3
292;01.04.2017;2017;04;22;Lauantai;1;1;2;4;0;4
292;01.04.2017;2017;04;23;Lauantai;1;1;2;10;4;14
292;02.04.2017;2017;04;00;Sunnuntai;3;1;4;1;6;7
292;02.04.2017;2017;04;01;Sunnuntai;0;1;1;1;2;3
292;02.04.2017;2017;04;02;Sunnuntai;0;2;2;0;2;2
292;02.04.2017;2017;04;03;Sunnuntai;0;0;0;0;2;2
292;02.04.2017;2017;04;04;Sunnuntai;0;0;0;1;0;1
292;02.04.2017;2017;04;05;Sunnuntai;0;1;1;2;0;2
292;02.04.2017;2017;04;06;Sunnuntai;2;0;2;0;2;2
292;02.04.2017;2017;04;07;Sunnuntai;1;2;3;4;1;5
292;02.04.2017;2017;04;08;Sunnuntai;1;5;6;6;4;10
292;02.04.2017;2017;04;09;Sunnuntai;3;8;11;10;13;23
292;02.04.2017;2017;04;10;Sunnuntai;5;9;14;14;8;22
292;02.04.2017;2017;04;11;Sunnuntai;8;4;12;12;14;26
292;02.04.2017;2017;04;12;Sunnuntai;7;10;17;23;10;33
292;02.04.2017;2017;04;13;Sunnuntai;14;12;26;10;13;23
292;02.04.2017;2017;04;14;Sunnuntai;13;14;27;14;14;28
292;02.04.2017;2017;04;15;Sunnuntai;21;18;39;18;11;29
292;02.04.2017;2017;04;16;Sunnuntai;23;11;34;10;9;19
292;02.04.2017;2017;04;17;Sunnuntai;9;18;27;19;12;31
292;02.04.2017;2017;04;18;Sunnuntai;10;10;20;16;14;30
292;02.04.2017;2017;04;19;Sunnuntai;8;2;10;8;10;18
292;02.04.2017;2017;04;20;Sunnuntai;7;4;11;8;3;11
292;02.04.2017;2017;04;21;Sunnuntai;1;2;3;5;1;6
292;02.04.2017;2017;04;22;Sunnuntai;1;5;6;0;2;2
292;02.04.2017;2017;04;23;Sunnuntai;1;0;1;0;0;0
292;03.04.2017;2017;04;00;Maanantai;0;0;0;0;0;0
292;03.04.2017;2017;04;01;Maanantai;1;0;1;0;1;1
292;03.04.2017;2017;04;02;Maanantai;0;0;0;0;0;0
292;03.04.2017;2017;04;03;Maanantai;0;1;1;0;0;0
292;03.04.2017;2017;04;04;Maanantai;3;0;3;0;0;0
292;03.04.2017;2017;04;05;Maanantai;5;5;10;1;2;3
292;03.04.2017;2017;04;06;Maanantai;11;11;22;0;4;4
292;03.04.2017;2017;04;07;Maanantai;58;25;83;11;8;19
292;03.04.2017;2017;04;08;Maanantai;40;23;63;16;5;21
292;03.04.2017;2017;04;09;Maanantai;22;17;39;12;18;30
292;03.04.2017;2017;04;10;Maanantai;28;32;60;16;24;40
292;03.04.2017;2017;04;11;Maanantai;18;35;53;23;29;52
292;03.04.2017;2017;04;12;Maanantai;15;23;38;5;14;19
292;03.04.2017;2017;04;13;Maanantai;25;37;62;18;24;42
292;03.04.2017;2017;04;14;Maanantai;26;38;64;21;10;31
292;03.04.2017;2017;04;15;Maanantai;40;28;68;10;27;37
292;03.04.2017;2017;04;16;Maanantai;40;32;72;14;18;32
292;03.04.2017;2017;04;17;Maanantai;16;28;44;10;17;27
292;03.04.2017;2017;04;18;Maanantai;19;14;33;17;24;41
292;03.04.2017;2017;04;19;Maanantai;26;14;40;13;10;23
292;03.04.2017;2017;04;20;Maanantai;15;9;24;11;10;21
292;03.04.2017;2017;04;21;Maanantai;4;11;15;3;1;4
292;03.04.2017;2017;04;22;Maanantai;1;1;2;1;1;2
292;03.04.2017;2017;04;23;Maanantai;0;1;1;0;0;0
292;04.04.2017;2017;04;00;Tiistai;0;1;1;0;0;0
292;04.04.2017;2017;04;01;Tiistai;0;0;0;0;0;0
292;04.04.2017;2017;04;02;Tiistai;0;0;0;0;0;0
292;04.04.2017;2017;04;03;Tiistai;0;1;1;0;0;0
292;04.04.2017;2017;04;04;Tiistai;5;0;5;0;0;0
292;04.04.2017;2017;04;05;Tiistai;6;3;9;1;1;2
292;04.04.2017;2017;04;06;Tiistai;18;15;33;0;8;8
292;04.04.2017;2017;04;07;Tiistai;66;16;82;9;6;15
292;04.04.2017;2017;04;08;Tiistai;51;22;73;15;14;29
292;04.04.2017;2017;04;09;Tiistai;21;22;43;10;15;25
292;04.04.2017;2017;04;10;Tiistai;20;29;49;12;14;26
292;04.04.2017;2017;04;11;Tiistai;20;27;47;7;22;29
292;04.04.2017;2017;04;12;Tiistai;27;20;47;14;14;28
292;04.04.2017;2017;04;13;Tiistai;25;36;61;6;8;14
292;04.04.2017;2017;04;14;Tiistai;21;43;64;26;27;53
292;04.04.2017;2017;04;15;Tiistai;46;53;99;26;30;56
292;04.04.2017;2017;04;16;Tiistai;37;32;69;14;29;43
292;04.04.2017;2017;04;17;Tiistai;35;40;75;24;17;41
292;04.04.2017;2017;04;18;Tiistai;31;37;68;14;12;26
292;04.04.2017;2017;04;19;Tiistai;24;21;45;20;15;35
292;04.04.2017;2017;04;20;Tiistai;12;9;21;13;8;21
292;04.04.2017;2017;04;21;Tiistai;6;6;12;11;5;16
292;04.04.2017;2017;04;22;Tiistai;3;4;7;2;0;2
292;04.04.2017;2017;04;23;Tiistai;0;0;0;0;0;0
292;05.04.2017;2017;04;00;Keskiviikko;0;0;0;0;0;0
292;05.04.2017;2017;04;01;Keskiviikko;0;1;1;0;1;1
292;05.04.2017;2017;04;02;Keskiviikko;0;0;0;0;0;0
292;05.04.2017;2017;04;03;Keskiviikko;0;0;0;0;0;0
292;05.04.2017;2017;04;04;Keskiviikko;3;1;4;0;0;0
292;05.04.2017;2017;04;05;Keskiviikko;5;4;9;0;1;1
292;05.04.2017;2017;04;06;Keskiviikko;18;13;31;2;3;5
292;05.04.2017;2017;04;07;Keskiviikko;91;21;112;11;6;17
292;05.04.2017;2017;04;08;Keskiviikko;44;15;59;14;15;29
292;05.04.2017;2017;04;09;Keskiviikko;19;22;41;10;8;18
292;05.04.2017;2017;04;10;Keskiviikko;14;31;45;15;12;27
292;05.04.2017;2017;04;11;Keskiviikko;22;44;66;14;19;33
292;05.04.2017;2017;04;12;Keskiviikko;36;35;71;20;20;40
292;05.04.2017;2017;04;13;Keskiviikko;36;52;88;15;18;33
292;05.04.2017;2017;04;14;Keskiviikko;33;56;89;19;14;33
292;05.04.2017;2017;04;15;Keskiviikko;40;43;83;18;20;38
292;05.04.2017;2017;04;16;Keskiviikko;49;47;96;14;20;34
292;05.04.2017;2017;04;17;Keskiviikko;28;29;57;17;20;37
292;05.04.2017;2017;04;18;Keskiviikko;26;27;53;32;24;56
292;05.04.2017;2017;04;19;Keskiviikko;22;25;47;20;20;40
292;05.04.2017;2017;04;20;Keskiviikko;11;14;25;9;7;16
292;05.04.2017;2017;04;21;Keskiviikko;6;9;15;2;2;4
292;05.04.2017;2017;04;22;Keskiviikko;7;6;13;0;0;0
292;05.04.2017;2017;04;23;Keskiviikko;2;4;6;0;0;0
292;06.04.2017;2017;04;00;Torstai;1;0;1;0;0;0
292;06.04.2017;2017;04;01;Torstai;0;2;2;0;0;0
292;06.04.2017;2017;04;02;Torstai;0;0;0;0;0;0
292;06.04.2017;2017;04;03;Torstai;0;2;2;0;0;0
292;06.04.2017;2017;04;04;Torstai;2;0;2;0;0;0
292;06.04.2017;2017;04;05;Torstai;8;4;12;1;0;1
292;06.04.2017;2017;04;06;Torstai;8;17;25;0;4;4
292;06.04.2017;2017;04;07;Torstai;76;20;96;16;7;23
292;06.04.2017;2017;04;08;Torstai;38;26;64;11;10;21
292;06.04.2017;2017;04;09;Torstai;21;27;48;8;12;20
292;06.04.2017;2017;04;10;Torstai;33;37;70;23;12;35
292;06.04.2017;2017;04;11;Torstai;16;36;52;24;24;48
292;06.04.2017;2017;04;12;Torstai;20;35;55;15;15;30
292;06.04.2017;2017;04;13;Torstai;18;39;57;14;11;25
292;06.04.2017;2017;04;14;Torstai;39;55;94;11;21;32
292;06.04.2017;2017;04;15;Torstai;29;38;67;10;19;29
292;06.04.2017;2017;04;16;Torstai;34;23;57;10;14;24
292;06.04.2017;2017;04;17;Torstai;22;28;50;14;15;29
292;06.04.2017;2017;04;18;Torstai;31;20;51;19;12;31
292;06.04.2017;2017;04;19;Torstai;24;12;36;11;17;28
292;06.04.2017;2017;04;20;Torstai;19;10;29;13;4;17
292;06.04.2017;2017;04;21;Torstai;8;9;17;2;2;4
292;06.04.2017;2017;04;22;Torstai;3;4;7;2;4;6
292;06.04.2017;2017;04;23;Torstai;1;1;2;1;0;1
292;07.04.2017;2017;04;00;Perjantai;0;1;1;0;0;0
292;07.04.2017;2017;04;01;Perjantai;0;1;1;0;0;0
292;07.04.2017;2017;04;02;Perjantai;0;0;0;0;1;1
292;07.04.2017;2017;04;03;Perjantai;0;0;0;0;0;0
292;07.04.2017;2017;04;04;Perjantai;1;0;1;0;0;0
292;07.04.2017;2017;04;05;Perjantai;6;3;9;0;1;1
292;07.04.2017;2017;04;06;Perjantai;9;12;21;3;6;9
292;07.04.2017;2017;04;07;Perjantai;70;14;84;11;6;17
292;07.04.2017;2017;04;08;Perjantai;42;23;65;13;20;33
292;07.04.2017;2017;04;09;Perjantai;19;15;34;11;9;20
292;07.04.2017;2017;04;10;Perjantai;9;37;46;11;15;26
292;07.04.2017;2017;04;11;Perjantai;16;35;51;7;5;12
292;07.04.2017;2017;04;12;Perjantai;26;32;58;15;14;29
292;07.04.2017;2017;04;13;Perjantai;33;58;91;10;30;40
292;07.04.2017;2017;04;14;Perjantai;35;47;82;20;17;37
292;07.04.2017;2017;04;15;Perjantai;35;30;65;18;16;34
292;07.04.2017;2017;04;16;Perjantai;23;29;52;12;18;30
292;07.04.2017;2017;04;17;Perjantai;16;19;35;10;6;16
292;07.04.2017;2017;04;18;Perjantai;14;14;28;7;7;14
292;07.04.2017;2017;04;19;Perjantai;24;6;30;10;8;18
292;07.04.2017;2017;04;20;Perjantai;10;8;18;13;7;20
292;07.04.2017;2017;04;21;Perjantai;11;10;21;9;13;22
292;07.04.2017;2017;04;22;Perjantai;4;2;6;0;1;1
292;07.04.2017;2017;04;23;Perjantai;3;1;4;0;2;2
292;08.04.2017;2017;04;00;Lauantai;0;2;2;2;0;2
292;08.04.2017;2017;04;01;Lauantai;1;2;3;2;4;6
292;08.04.2017;2017;04;02;Lauantai;0;1;1;0;4;4
292;08.04.2017;2017;04;03;Lauantai;0;1;1;0;1;1
292;08.04.2017;2017;04;04;Lauantai;0;1;1;1;0;1
292;08.04.2017;2017;04;05;Lauantai;1;0;1;3;0;3
292;08.04.2017;2017;04;06;Lauantai;4;2;6;1;1;2
292;08.04.2017;2017;04;07;Lauantai;1;7;8;3;2;5
292;08.04.2017;2017;04;08;Lauantai;1;7;8;1;4;5
292;08.04.2017;2017;04;09;Lauantai;3;16;19;8;7;15
292;08.04.2017;2017;04;10;Lauantai;5;19;24;5;13;18
292;08.04.2017;2017;04;11;Lauantai;12;16;28;14;4;18
292;08.04.2017;2017;04;12;Lauantai;34;29;63;13;15;28
292;08.04.2017;2017;04;13;Lauantai;38;41;79;10;14;24
292;08.04.2017;2017;04;14;Lauantai;22;26;48;16;13;29
292;08.04.2017;2017;04;15;Lauantai;28;35;63;17;19;36
292;08.04.2017;2017;04;16;Lauantai;38;23;61;24;16;40
292;08.04.2017;2017;04;17;Lauantai;20;12;32;17;15;32
292;08.04.2017;2017;04;18;Lauantai;21;17;38;23;14;37
292;08.04.2017;2017;04;19;Lauantai;18;14;32;15;9;24
292;08.04.2017;2017;04;20;Lauantai;7;7;14;6;5;11
292;08.04.2017;2017;04;21;Lauantai;6;9;15;6;2;8
292;08.04.2017;2017;04;22;Lauantai;3;9;12;3;3;6
292;08.04.2017;2017;04;23;Lauantai;6;4;10;2;0;2
292;09.04.2017;2017;04;00;Sunnuntai;3;4;7;5;1;6
292;09.04.2017;2017;04;01;Sunnuntai;4;2;6;2;1;3
292;09.04.2017;2017;04;02;Sunnuntai;0;0;0;0;3;3
292;09.04.2017;2017;04;03;Sunnuntai;1;1;2;0;1;1
292;09.04.2017;2017;04;04;Sunnuntai;0;0;0;0;0;0
292;09.04.2017;2017;04;05;Sunnuntai;1;0;1;1;1;2
292;09.04.2017;2017;04;06;Sunnuntai;7;1;8;1;0;1
292;09.04.2017;2017;04;07;Sunnuntai;1;2;3;1;0;1
292;09.04.2017;2017;04;08;Sunnuntai;3;3;6;2;0;2
292;09.04.2017;2017;04;09;Sunnuntai;6;6;12;6;13;19
292;09.04.2017;2017;04;10;Sunnuntai;7;5;12;14;13;27
292;09.04.2017;2017;04;11;Sunnuntai;12;12;24;13;16;29
292;09.04.2017;2017;04;12;Sunnuntai;14;11;25;19;13;32
292;09.04.2017;2017;04;13;Sunnuntai;10;13;23;9;14;23
292;09.04.2017;2017;04;14;Sunnuntai;14;11;25;22;7;29
292;09.04.2017;2017;04;15;Sunnuntai;16;20;36;14;12;26
292;09.04.2017;2017;04;16;Sunnuntai;18;14;32;6;14;20
292;09.04.2017;2017;04;17;Sunnuntai;10;19;29;19;15;34
292;09.04.2017;2017;04;18;Sunnuntai;17;19;36;14;11;25
292;09.04.2017;2017;04;19;Sunnuntai;15;16;31;8;17;25
292;09.04.2017;2017;04;20;Sunnuntai;14;6;20;9;3;12
292;09.04.2017;2017;04;21;Sunnuntai;1;3;4;2;3;5
292;09.04.2017;2017;04;22;Sunnuntai;1;3;4;0;0;0
292;09.04.2017;2017;04;23;Sunnuntai;0;1;1;0;1;1
292;10.04.2017;2017;04;00;Maanantai;0;1;1;1;0;1
292;10.04.2017;2017;04;01;Maanantai;0;1;1;0;0;0
292;10.04.2017;2017;04;02;Maanantai;0;0;0;0;0;0
292;10.04.2017;2017;04;03;Maanantai;0;0;0;0;0;0
292;10.04.2017;2017;04;04;Maanantai;0;1;1;0;1;1
292;10.04.2017;2017;04;05;Maanantai;5;2;7;1;3;4
292;10.04.2017;2017;04;06;Maanantai;12;13;25;1;6;7
292;10.04.2017;2017;04;07;Maanantai;44;21;65;9;4;13
292;10.04.2017;2017;04;08;Maanantai;37;23;60;5;17;22
292;10.04.2017;2017;04;09;Maanantai;41;17;58;9;8;17
292;10.04.2017;2017;04;10;Maanantai;26;15;41;8;9;17
292;10.04.2017;2017;04;11;Maanantai;12;14;26;7;11;18
292;10.04.2017;2017;04;12;Maanantai;13;17;30;19;6;25
292;10.04.2017;2017;04;13;Maanantai;23;32;55;12;12;24
292;10.04.2017;2017;04;14;Maanantai;23;35;58;13;11;24
292;10.04.2017;2017;04;15;Maanantai;27;44;71;7;14;21
292;10.04.2017;2017;04;16;Maanantai;18;36;54;8;10;18
292;10.04.2017;2017;04;17;Maanantai;9;17;26;7;9;16
292;10.04.2017;2017;04;18;Maanantai;9;4;13;10;4;14
292;10.04.2017;2017;04;19;Maanantai;7;5;12;6;8;14
292;10.04.2017;2017;04;20;Maanantai;7;4;11;9;5;14
292;10.04.2017;2017;04;21;Maanantai;5;3;8;0;1;1
292;10.04.2017;2017;04;22;Maanantai;3;4;7;3;1;4
292;10.04.2017;2017;04;23;Maanantai;0;0;0;0;0;0
292;11.04.2017;2017;04;00;Tiistai;0;1;1;0;0;0
292;11.04.2017;2017;04;01;Tiistai;0;2;2;0;0;0
292;11.04.2017;2017;04;02;Tiistai;0;0;0;0;0;0
292;11.04.2017;2017;04;03;Tiistai;0;0;0;0;0;0
292;11.04.2017;2017;04;04;Tiistai;1;0;1;0;0;0
292;11.04.2017;2017;04;05;Tiistai;5;3;8;1;0;1
292;11.04.2017;2017;04;06;Tiistai;15;12;27;1;7;8
292;11.04.2017;2017;04;07;Tiistai;34;21;55;16;5;21
292;11.04.2017;2017;04;08;Tiistai;35;16;51;17;9;26
292;11.04.2017;2017;04;09;Tiistai;6;5;11;9;8;17
292;11.04.2017;2017;04;10;Tiistai;4;4;8;14;8;22
292;11.04.2017;2017;04;11;Tiistai;11;6;17;8;8;16
292;11.04.2017;2017;04;12;Tiistai;8;10;18;9;8;17
292;11.04.2017;2017;04;13;Tiistai;8;24;32;7;9;16
292;11.04.2017;2017;04;14;Tiistai;11;50;61;21;8;29
292;11.04.2017;2017;04;15;Tiistai;12;40;52;12;10;22
292;11.04.2017;2017;04;16;Tiistai;20;26;46;12;18;30
292;11.04.2017;2017;04;17;Tiistai;15;24;39;11;15;26
292;11.04.2017;2017;04;18;Tiistai;19;12;31;16;14;30
292;11.04.2017;2017;04;19;Tiistai;18;11;29;18;21;39
292;11.04.2017;2017;04;20;Tiistai;9;13;22;21;9;30
292;11.04.2017;2017;04;21;Tiistai;7;7;14;5;4;9
292;11.04.2017;2017;04;22;Tiistai;2;2;4;2;2;4
292;11.04.2017;2017;04;23;Tiistai;0;0;0;0;0;0
292;12.04.2017;2017;04;00;Keskiviikko;0;0;0;0;0;0
292;12.04.2017;2017;04;01;Keskiviikko;0;2;2;0;0;0
292;12.04.2017;2017;04;02;Keskiviikko;0;0;0;0;0;0
292;12.04.2017;2017;04;03;Keskiviikko;0;1;1;0;0;0
292;12.04.2017;2017;04;04;Keskiviikko;0;1;1;0;0;0
292;12.04.2017;2017;04;05;Keskiviikko;5;3;8;0;1;1
292;12.04.2017;2017;04;06;Keskiviikko;16;18;34;0;4;4
292;12.04.2017;2017;04;07;Keskiviikko;67;17;84;12;4;16
292;12.04.2017;2017;04;08;Keskiviikko;43;22;65;19;17;36
292;12.04.2017;2017;04;09;Keskiviikko;17;17;34;14;11;25
292;12.04.2017;2017;04;10;Keskiviikko;12;15;27;7;10;17
292;12.04.2017;2017;04;11;Keskiviikko;21;20;41;22;12;34
292;12.04.2017;2017;04;12;Keskiviikko;22;20;42;12;20;32
292;12.04.2017;2017;04;13;Keskiviikko;31;75;106;17;22;39
292;12.04.2017;2017;04;14;Keskiviikko;28;49;77;18;13;31
292;12.04.2017;2017;04;15;Keskiviikko;32;25;57;13;11;24
292;12.04.2017;2017;04;16;Keskiviikko;31;40;71;19;15;34
292;12.04.2017;2017;04;17;Keskiviikko;18;36;54;11;8;19
292;12.04.2017;2017;04;18;Keskiviikko;28;14;42;19;6;25
292;12.04.2017;2017;04;19;Keskiviikko;18;17;35;14;12;26
292;12.04.2017;2017;04;20;Keskiviikko;12;13;25;9;6;15
292;12.04.2017;2017;04;21;Keskiviikko;10;4;14;1;4;5
292;12.04.2017;2017;04;22;Keskiviikko;2;5;7;1;1;2
292;12.04.2017;2017;04;23;Keskiviikko;2;1;3;3;1;4
292;13.04.2017;2017;04;00;Torstai;0;0;0;1;1;2
292;13.04.2017;2017;04;01;Torstai;1;0;1;0;0;0
292;13.04.2017;2017;04;02;Torstai;0;0;0;0;0;0
292;13.04.2017;2017;04;03;Torstai;0;1;1;0;0;0
292;13.04.2017;2017;04;04;Torstai;1;0;1;0;0;0
292;13.04.2017;2017;04;05;Torstai;5;4;9;1;1;2
292;13.04.2017;2017;04;06;Torstai;17;16;33;4;3;7
292;13.04.2017;2017;04;07;Torstai;45;18;63;11;5;16
292;13.04.2017;2017;04;08;Torstai;22;22;44;8;7;15
292;13.04.2017;2017;04;09;Torstai;37;22;59;8;9;17
292;13.04.2017;2017;04;10;Torstai;9;27;36;9;15;24
292;13.04.2017;2017;04;11;Torstai;23;15;38;10;8;18
292;13.04.2017;2017;04;12;Torstai;21;15;36;9;9;18
292;13.04.2017;2017;04;13;Torstai;18;27;45;5;16;21
292;13.04.2017;2017;04;14;Torstai;20;35;55;6;12;18
292;13.04.2017;2017;04;15;Torstai;19;45;64;19;21;40
292;13.04.2017;2017;04;16;Torstai;31;30;61;44;32;76
292;13.04.2017;2017;04;17;Torstai;19;19;38;12;11;23
292;13.04.2017;2017;04;18;Torstai;19;17;36;17;9;26
292;13.04.2017;2017;04;19;Torstai;16;19;35;11;8;19
292;13.04.2017;2017;04;20;Torstai;17;11;28;13;11;24
292;13.04.2017;2017;04;21;Torstai;10;5;15;9;4;13
292;13.04.2017;2017;04;22;Torstai;6;5;11;3;0;3
292;13.04.2017;2017;04;23;Torstai;1;7;8;3;5;8
292;14.04.2017;2017;04;00;Perjantai;3;0;3;1;1;2
292;14.04.2017;2017;04;01;Perjantai;0;1;1;0;5;5
292;14.04.2017;2017;04;02;Perjantai;0;2;2;4;3;7
292;14.04.2017;2017;04;03;Perjantai;0;2;2;0;3;3
292;14.04.2017;2017;04;04;Perjantai;1;1;2;0;0;0
292;14.04.2017;2017;04;05;Perjantai;1;0;1;0;0;0
292;14.04.2017;2017;04;06;Perjantai;3;1;4;1;2;3
292;14.04.2017;2017;04;07;Perjantai;1;1;2;1;1;2
292;14.04.2017;2017;04;08;Perjantai;2;2;4;6;4;10
292;14.04.2017;2017;04;09;Perjantai;2;5;7;9;13;22
292;14.04.2017;2017;04;10;Perjantai;8;6;14;11;4;15
292;14.04.2017;2017;04;11;Perjantai;10;13;23;12;15;27
292;14.04.2017;2017;04;12;Perjantai;12;11;23;16;12;28
292;14.04.2017;2017;04;13;Perjantai;18;17;35;5;6;11
292;14.04.2017;2017;04;14;Perjantai;16;16;32;17;10;27
292;14.04.2017;2017;04;15;Perjantai;11;21;32;12;8;20
292;14.04.2017;2017;04;16;Perjantai;11;12;23;7;11;18
292;14.04.2017;2017;04;17;Perjantai;12;12;24;20;14;34
292;14.04.2017;2017;04;18;Perjantai;7;15;22;10;12;22
292;14.04.2017;2017;04;19;Perjantai;6;10;16;13;4;17
292;14.04.2017;2017;04;20;Perjantai;4;7;11;9;4;13
292;14.04.2017;2017;04;21;Perjantai;5;7;12;5;7;12
292;14.04.2017;2017;04;22;Perjantai;5;3;8;2;2;4
292;14.04.2017;2017;04;23;Perjantai;1;3;4;2;2;4
292;15.04.2017;2017;04;00;Lauantai;3;3;6;2;2;4
292;15.04.2017;2017;04;01;Lauantai;3;4;7;1;1;2
292;15.04.2017;2017;04;02;Lauantai;0;0;0;0;4;4
292;15.04.2017;2017;04;03;Lauantai;0;2;2;0;3;3
292;15.04.2017;2017;04;04;Lauantai;0;0;0;1;0;1
292;15.04.2017;2017;04;05;Lauantai;1;1;2;1;0;1
292;15.04.2017;2017;04;06;Lauantai;2;1;3;0;2;2
292;15.04.2017;2017;04;07;Lauantai;1;2;3;2;3;5
292;15.04.2017;2017;04;08;Lauantai;2;5;7;7;3;10
292;15.04.2017;2017;04;09;Lauantai;2;5;7;4;7;11
292;15.04.2017;2017;04;10;Lauantai;8;7;15;3;6;9
292;15.04.2017;2017;04;11;Lauantai;7;11;18;10;10;20
292;15.04.2017;2017;04;12;Lauantai;14;16;30;14;11;25
292;15.04.2017;2017;04;13;Lauantai;8;12;20;11;6;17
292;15.04.2017;2017;04;14;Lauantai;19;17;36;6;10;16
292;15.04.2017;2017;04;15;Lauantai;8;21;29;11;9;20
292;15.04.2017;2017;04;16;Lauantai;24;12;36;10;16;26
292;15.04.2017;2017;04;17;Lauantai;15;14;29;10;11;21
292;15.04.2017;2017;04;18;Lauantai;16;9;25;11;8;19
292;15.04.2017;2017;04;19;Lauantai;5;9;14;10;9;19
292;15.04.2017;2017;04;20;Lauantai;9;3;12;7;8;15
292;15.04.2017;2017;04;21;Lauantai;0;2;2;6;4;10
292;15.04.2017;2017;04;22;Lauantai;2;1;3;2;3;5
292;15.04.2017;2017;04;23;Lauantai;4;2;6;1;0;1
292;16.04.2017;2017;04;00;Sunnuntai;1;1;2;3;2;5
292;16.04.2017;2017;04;01;Sunnuntai;0;2;2;3;0;3
292;16.04.2017;2017;04;02;Sunnuntai;0;1;1;1;6;7
292;16.04.2017;2017;04;03;Sunnuntai;2;1;3;0;3;3
292;16.04.2017;2017;04;04;Sunnuntai;0;0;0;1;0;1
292;16.04.2017;2017;04;05;Sunnuntai;1;0;1;1;0;1
292;16.04.2017;2017;04;06;Sunnuntai;3;1;4;0;2;2
292;16.04.2017;2017;04;07;Sunnuntai;0;1;1;2;1;3
292;16.04.2017;2017;04;08;Sunnuntai;0;4;4;10;9;19
292;16.04.2017;2017;04;09;Sunnuntai;7;7;14;6;11;17
292;16.04.2017;2017;04;10;Sunnuntai;4;9;13;15;8;23
292;16.04.2017;2017;04;11;Sunnuntai;18;14;32;11;16;27
292;16.04.2017;2017;04;12;Sunnuntai;16;15;31;15;20;35
292;16.04.2017;2017;04;13;Sunnuntai;12;20;32;13;9;22
292;16.04.2017;2017;04;14;Sunnuntai;24;11;35;9;11;20
292;16.04.2017;2017;04;15;Sunnuntai;16;18;34;11;15;26
292;16.04.2017;2017;04;16;Sunnuntai;17;11;28;19;15;34
292;16.04.2017;2017;04;17;Sunnuntai;14;20;34;15;12;27
292;16.04.2017;2017;04;18;Sunnuntai;13;14;27;13;7;20
292;16.04.2017;2017;04;19;Sunnuntai;13;13;26;6;10;16
292;16.04.2017;2017;04;20;Sunnuntai;8;8;16;3;6;9
292;16.04.2017;2017;04;21;Sunnuntai;6;3;9;3;3;6
292;16.04.2017;2017;04;22;Sunnuntai;1;6;7;1;6;7
292;16.04.2017;2017;04;23;Sunnuntai;0;3;3;1;1;2
292;17.04.2017;2017;04;00;Maanantai;3;1;4;1;0;1
292;17.04.2017;2017;04;01;Maanantai;1;3;4;3;2;5
292;17.04.2017;2017;04;02;Maanantai;0;2;2;0;0;0
292;17.04.2017;2017;04;03;Maanantai;0;2;2;0;2;2
292;17.04.2017;2017;04;04;Maanantai;1;2;3;0;1;1
292;17.04.2017;2017;04;05;Maanantai;1;1;2;1;0;1
292;17.04.2017;2017;04;06;Maanantai;3;0;3;1;0;1
292;17.04.2017;2017;04;07;Maanantai;1;2;3;2;4;6
292;17.04.2017;2017;04;08;Maanantai;2;3;5;10;5;15
292;17.04.2017;2017;04;09;Maanantai;5;5;10;6;7;13
292;17.04.2017;2017;04;10;Maanantai;6;6;12;13;16;29
292;17.04.2017;2017;04;11;Maanantai;13;30;43;12;20;32
292;17.04.2017;2017;04;12;Maanantai;18;24;42;10;19;29
292;17.04.2017;2017;04;13;Maanantai;35;37;72;21;16;37
292;17.04.2017;2017;04;14;Maanantai;41;26;67;18;27;45
292;17.04.2017;2017;04;15;Maanantai;25;23;48;19;19;38
292;17.04.2017;2017;04;16;Maanantai;23;24;47;14;22;36
292;17.04.2017;2017;04;17;Maanantai;20;29;49;38;13;51
292;17.04.2017;2017;04;18;Maanantai;22;14;36;21;31;52
292;17.04.2017;2017;04;19;Maanantai;21;18;39;20;15;35
292;17.04.2017;2017;04;20;Maanantai;15;8;23;9;6;15
292;17.04.2017;2017;04;21;Maanantai;2;3;5;3;7;10
292;17.04.2017;2017;04;22;Maanantai;1;2;3;1;0;1
292;17.04.2017;2017;04;23;Maanantai;0;1;1;0;1;1
292;18.04.2017;2017;04;00;Tiistai;0;1;1;1;0;1
292;18.04.2017;2017;04;01;Tiistai;0;0;0;0;1;1
292;18.04.2017;2017;04;02;Tiistai;0;0;0;0;1;1
292;18.04.2017;2017;04;03;Tiistai;0;1;1;0;0;0
292;18.04.2017;2017;04;04;Tiistai;1;0;1;0;1;1
292;18.04.2017;2017;04;05;Tiistai;7;6;13;0;0;0
292;18.04.2017;2017;04;06;Tiistai;11;10;21;2;4;6
292;18.04.2017;2017;04;07;Tiistai;52;25;77;16;11;27
292;18.04.2017;2017;04;08;Tiistai;48;19;67;23;13;36
292;18.04.2017;2017;04;09;Tiistai;16;16;32;6;15;21
292;18.04.2017;2017;04;10;Tiistai;26;17;43;10;18;28
292;18.04.2017;2017;04;11;Tiistai;19;20;39;11;13;24
292;18.04.2017;2017;04;12;Tiistai;29;33;62;15;12;27
292;18.04.2017;2017;04;13;Tiistai;25;32;57;18;17;35
292;18.04.2017;2017;04;14;Tiistai;41;68;109;19;36;55
292;18.04.2017;2017;04;15;Tiistai;46;41;87;28;38;66
292;18.04.2017;2017;04;16;Tiistai;53;56;109;29;34;63
292;18.04.2017;2017;04;17;Tiistai;32;36;68;12;30;42
292;18.04.2017;2017;04;18;Tiistai;19;24;43;27;21;48
292;18.04.2017;2017;04;19;Tiistai;25;11;36;25;15;40
292;18.04.2017;2017;04;20;Tiistai;16;8;24;14;7;21
292;18.04.2017;2017;04;21;Tiistai;3;10;13;1;6;7
292;18.04.2017;2017;04;22;Tiistai;4;2;6;0;3;3
292;18.04.2017;2017;04;23;Tiistai;0;0;0;4;1;5
292;19.04.2017;2017;04;00;Keskiviikko;0;1;1;0;1;1
292;19.04.2017;2017;04;01;Keskiviikko;0;0;0;0;0;0
292;19.04.2017;2017;04;02;Keskiviikko;0;1;1;0;0;0
292;19.04.2017;2017;04;03;Keskiviikko;0;0;0;0;0;0
292;19.04.2017;2017;04;04;Keskiviikko;1;1;2;0;0;0
292;19.04.2017;2017;04;05;Keskiviikko;5;7;12;1;0;1
292;19.04.2017;2017;04;06;Keskiviikko;22;12;34;1;6;7
292;19.04.2017;2017;04;07;Keskiviikko;73;25;98;8;11;19
292;19.04.2017;2017;04;08;Keskiviikko;44;23;67;19;13;32
292;19.04.2017;2017;04;09;Keskiviikko;34;20;54;9;12;21
292;19.04.2017;2017;04;10;Keskiviikko;26;19;45;9;12;21
292;19.04.2017;2017;04;11;Keskiviikko;21;13;34;14;12;26
292;19.04.2017;2017;04;12;Keskiviikko;17;27;44;7;13;20
292;19.04.2017;2017;04;13;Keskiviikko;24;74;98;11;11;22
292;19.04.2017;2017;04;14;Keskiviikko;32;66;98;18;26;44
292;19.04.2017;2017;04;15;Keskiviikko;57;57;114;9;14;23
292;19.04.2017;2017;04;16;Keskiviikko;56;66;122;20;21;41
292;19.04.2017;2017;04;17;Keskiviikko;28;33;61;25;6;31
292;19.04.2017;2017;04;18;Keskiviikko;30;28;58;22;15;37
292;19.04.2017;2017;04;19;Keskiviikko;23;24;47;6;14;20
292;19.04.2017;2017;04;20;Keskiviikko;21;12;33;12;6;18
292;19.04.2017;2017;04;21;Keskiviikko;5;10;15;3;5;8
292;19.04.2017;2017;04;22;Keskiviikko;4;5;9;1;1;2
292;19.04.2017;2017;04;23;Keskiviikko;0;0;0;0;0;0
292;20.04.2017;2017;04;00;Torstai;0;0;0;0;0;0
292;20.04.2017;2017;04;01;Torstai;0;1;1;0;0;0
292;20.04.2017;2017;04;02;Torstai;0;0;0;0;0;0
292;20.04.2017;2017;04;03;Torstai;0;0;0;0;0;0
292;20.04.2017;2017;04;04;Torstai;2;0;2;0;0;0
292;20.04.2017;2017;04;05;Torstai;4;6;10;0;0;0
292;20.04.2017;2017;04;06;Torstai;16;11;27;3;4;7
292;20.04.2017;2017;04;07;Torstai;62;21;83;15;4;19
292;20.04.2017;2017;04;08;Torstai;34;22;56;15;16;31
292;20.04.2017;2017;04;09;Torstai;73;17;90;29;9;38
292;20.04.2017;2017;04;10;Torstai;24;17;41;17;17;34
292;20.04.2017;2017;04;11;Torstai;64;61;125;27;21;48
292;20.04.2017;2017;04;12;Torstai;21;19;40;11;11;22
292;20.04.2017;2017;04;13;Torstai;26;75;101;11;26;37
292;20.04.2017;2017;04;14;Torstai;31;70;101;17;16;33
292;20.04.2017;2017;04;15;Torstai;52;32;84;7;18;25
292;20.04.2017;2017;04;16;Torstai;16;39;55;6;11;17
292;20.04.2017;2017;04;17;Torstai;21;16;37;12;2;14
292;20.04.2017;2017;04;18;Torstai;14;22;36;7;8;15
292;20.04.2017;2017;04;19;Torstai;9;9;18;5;3;8
292;20.04.2017;2017;04;20;Torstai;5;3;8;3;1;4
292;20.04.2017;2017;04;21;Torstai;6;8;14;2;3;5
292;20.04.2017;2017;04;22;Torstai;2;6;8;5;2;7
292;20.04.2017;2017;04;23;Torstai;0;2;2;0;1;1
292;21.04.2017;2017;04;00;Perjantai;1;1;2;1;1;2
292;21.04.2017;2017;04;01;Perjantai;0;1;1;0;0;0
292;21.04.2017;2017;04;02;Perjantai;0;1;1;0;1;1
292;21.04.2017;2017;04;03;Perjantai;0;0;0;0;1;1
292;21.04.2017;2017;04;04;Perjantai;0;0;0;0;0;0
292;21.04.2017;2017;04;05;Perjantai;5;9;14;2;0;2
292;21.04.2017;2017;04;06;Perjantai;15;11;26;0;4;4
292;21.04.2017;2017;04;07;Perjantai;54;13;67;9;8;17
292;21.04.2017;2017;04;08;Perjantai;41;22;63;14;8;22
292;21.04.2017;2017;04;09;Perjantai;42;19;61;13;8;21
292;21.04.2017;2017;04;10;Perjantai;20;26;46;8;17;25
292;21.04.2017;2017;04;11;Perjantai;18;36;54;10;7;17
292;21.04.2017;2017;04;12;Perjantai;35;36;71;13;23;36
292;21.04.2017;2017;04;13;Perjantai;33;82;115;29;26;55
292;21.04.2017;2017;04;14;Perjantai;28;61;89;20;15;35
292;21.04.2017;2017;04;15;Perjantai;34;40;74;21;18;39
292;21.04.2017;2017;04;16;Perjantai;44;33;77;14;14;28
292;21.04.2017;2017;04;17;Perjantai;21;26;47;27;21;48
292;21.04.2017;2017;04;18;Perjantai;22;19;41;21;16;37
292;21.04.2017;2017;04;19;Perjantai;17;11;28;4;8;12
292;21.04.2017;2017;04;20;Perjantai;17;12;29;9;6;15
292;21.04.2017;2017;04;21;Perjantai;10;13;23;7;11;18
292;21.04.2017;2017;04;22;Perjantai;7;7;14;8;4;12
292;21.04.2017;2017;04;23;Perjantai;1;8;9;3;2;5
292;22.04.2017;2017;04;00;Lauantai;1;1;2;5;2;7
292;22.04.2017;2017;04;01;Lauantai;1;2;3;1;0;1
292;22.04.2017;2017;04;02;Lauantai;0;1;1;0;9;9
292;22.04.2017;2017;04;03;Lauantai;1;5;6;3;2;5
292;22.04.2017;2017;04;04;Lauantai;0;1;1;0;3;3
292;22.04.2017;2017;04;05;Lauantai;0;0;0;2;1;3
292;22.04.2017;2017;04;06;Lauantai;2;2;4;0;1;1
292;22.04.2017;2017;04;07;Lauantai;3;5;8;5;0;5
292;22.04.2017;2017;04;08;Lauantai;3;7;10;4;3;7
292;22.04.2017;2017;04;09;Lauantai;11;13;24;6;6;12
292;22.04.2017;2017;04;10;Lauantai;18;23;41;10;15;25
292;22.04.2017;2017;04;11;Lauantai;29;36;65;11;12;23
292;22.04.2017;2017;04;12;Lauantai;52;42;94;18;19;37
292;22.04.2017;2017;04;13;Lauantai;34;32;66;27;15;42
292;22.04.2017;2017;04;14;Lauantai;30;39;69;26;14;40
292;22.04.2017;2017;04;15;Lauantai;28;13;41;20;4;24
292;22.04.2017;2017;04;16;Lauantai;19;26;45;14;13;27
292;22.04.2017;2017;04;17;Lauantai;27;33;60;20;11;31
292;22.04.2017;2017;04;18;Lauantai;19;17;36;15;14;29
292;22.04.2017;2017;04;19;Lauantai;21;22;43;17;17;34
292;22.04.2017;2017;04;20;Lauantai;10;23;33;11;6;17
292;22.04.2017;2017;04;21;Lauantai;2;6;8;2;5;7
292;22.04.2017;2017;04;22;Lauantai;3;6;9;1;1;2
292;22.04.2017;2017;04;23;Lauantai;6;2;8;5;2;7
292;23.04.2017;2017;04;00;Sunnuntai;4;1;5;14;4;18
292;23.04.2017;2017;04;01;Sunnuntai;2;3;5;0;3;3
292;23.04.2017;2017;04;02;Sunnuntai;0;3;3;1;4;5
292;23.04.2017;2017;04;03;Sunnuntai;0;0;0;1;1;2
292;23.04.2017;2017;04;04;Sunnuntai;0;0;0;0;0;0
292;23.04.2017;2017;04;05;Sunnuntai;0;0;0;2;1;3
292;23.04.2017;2017;04;06;Sunnuntai;3;2;5;0;2;2
292;23.04.2017;2017;04;07;Sunnuntai;2;5;7;5;4;9
292;23.04.2017;2017;04;08;Sunnuntai;2;1;3;3;2;5
292;23.04.2017;2017;04;09;Sunnuntai;14;9;23;8;3;11
292;23.04.2017;2017;04;10;Sunnuntai;18;23;41;14;13;27
292;23.04.2017;2017;04;11;Sunnuntai;23;24;47;16;11;27
292;23.04.2017;2017;04;12;Sunnuntai;24;44;68;17;24;41
292;23.04.2017;2017;04;13;Sunnuntai;55;34;89;21;17;38
292;23.04.2017;2017;04;14;Sunnuntai;42;37;79;26;16;42
292;23.04.2017;2017;04;15;Sunnuntai;34;26;60;23;11;34
292;23.04.2017;2017;04;16;Sunnuntai;25;29;54;28;18;46
292;23.04.2017;2017;04;17;Sunnuntai;19;26;45;20;24;44
292;23.04.2017;2017;04;18;Sunnuntai;21;23;44;17;25;42
292;23.04.2017;2017;04;19;Sunnuntai;8;17;25;13;15;28
292;23.04.2017;2017;04;20;Sunnuntai;9;7;16;10;6;16
292;23.04.2017;2017;04;21;Sunnuntai;6;8;14;4;5;9
292;23.04.2017;2017;04;22;Sunnuntai;3;3;6;1;2;3
292;23.04.2017;2017;04;23;Sunnuntai;0;0;0;0;0;0
292;24.04.2017;2017;04;00;Maanantai;0;1;1;0;1;1
292;24.04.2017;2017;04;01;Maanantai;0;0;0;0;0;0
292;24.04.2017;2017;04;02;Maanantai;0;0;0;0;0;0
292;24.04.2017;2017;04;03;Maanantai;0;0;0;0;0;0
292;24.04.2017;2017;04;04;Maanantai;4;1;5;0;0;0
292;24.04.2017;2017;04;05;Maanantai;4;7;11;0;1;1
292;24.04.2017;2017;04;06;Maanantai;17;6;23;2;4;6
292;24.04.2017;2017;04;07;Maanantai;52;25;77;9;8;17
292;24.04.2017;2017;04;08;Maanantai;35;22;57;14;14;28
292;24.04.2017;2017;04;09;Maanantai;50;17;67;21;17;38
292;24.04.2017;2017;04;10;Maanantai;40;13;53;15;29;44
292;24.04.2017;2017;04;11;Maanantai;27;26;53;20;18;38
292;24.04.2017;2017;04;12;Maanantai;27;42;69;15;13;28
292;24.04.2017;2017;04;13;Maanantai;19;47;66;21;16;37
292;24.04.2017;2017;04;14;Maanantai;34;53;87;16;23;39
292;24.04.2017;2017;04;15;Maanantai;46;75;121;22;25;47
292;24.04.2017;2017;04;16;Maanantai;31;62;93;24;23;47
292;24.04.2017;2017;04;17;Maanantai;35;45;80;18;19;37
292;24.04.2017;2017;04;18;Maanantai;22;23;45;23;16;39
292;24.04.2017;2017;04;19;Maanantai;16;14;30;26;12;38
292;24.04.2017;2017;04;20;Maanantai;12;10;22;9;13;22
292;24.04.2017;2017;04;21;Maanantai;7;6;13;3;4;7
292;24.04.2017;2017;04;22;Maanantai;4;3;7;3;0;3
292;24.04.2017;2017;04;23;Maanantai;1;0;1;2;0;2
292;25.04.2017;2017;04;00;Tiistai;1;1;2;0;0;0
292;25.04.2017;2017;04;01;Tiistai;0;0;0;2;0;2
292;25.04.2017;2017;04;02;Tiistai;0;1;1;1;2;3
292;25.04.2017;2017;04;03;Tiistai;0;0;0;0;0;0
292;25.04.2017;2017;04;04;Tiistai;2;0;2;0;0;0
292;25.04.2017;2017;04;05;Tiistai;7;6;13;1;0;1
292;25.04.2017;2017;04;06;Tiistai;19;9;28;2;5;7
292;25.04.2017;2017;04;07;Tiistai;70;27;97;24;10;34
292;25.04.2017;2017;04;08;Tiistai;55;26;81;18;10;28
292;25.04.2017;2017;04;09;Tiistai;26;30;56;11;10;21
292;25.04.2017;2017;04;10;Tiistai;41;34;75;12;15;27
292;25.04.2017;2017;04;11;Tiistai;21;31;52;14;14;28
292;25.04.2017;2017;04;12;Tiistai;42;30;72;13;17;30
292;25.04.2017;2017;04;13;Tiistai;28;44;72;24;20;44
292;25.04.2017;2017;04;14;Tiistai;35;64;99;26;30;56
292;25.04.2017;2017;04;15;Tiistai;29;63;92;29;24;53
292;25.04.2017;2017;04;16;Tiistai;47;51;98;28;28;56
292;25.04.2017;2017;04;17;Tiistai;37;46;83;28;22;50
292;25.04.2017;2017;04;18;Tiistai;26;36;62;30;24;54
292;25.04.2017;2017;04;19;Tiistai;23;26;49;28;27;55
292;25.04.2017;2017;04;20;Tiistai;19;22;41;20;8;28
292;25.04.2017;2017;04;21;Tiistai;7;11;18;6;3;9
292;25.04.2017;2017;04;22;Tiistai;2;5;7;1;1;2
292;25.04.2017;2017;04;23;Tiistai;0;0;0;1;1;2
292;26.04.2017;2017;04;00;Keskiviikko;1;0;1;0;0;0
292;26.04.2017;2017;04;01;Keskiviikko;0;0;0;0;0;0
292;26.04.2017;2017;04;02;Keskiviikko;0;3;3;0;0;0
292;26.04.2017;2017;04;03;Keskiviikko;0;0;0;0;0;0
292;26.04.2017;2017;04;04;Keskiviikko;2;1;3;1;1;2
292;26.04.2017;2017;04;05;Keskiviikko;7;6;13;3;1;4
292;26.04.2017;2017;04;06;Keskiviikko;9;12;21;5;3;8
292;26.04.2017;2017;04;07;Keskiviikko;65;27;92;17;6;23
292;26.04.2017;2017;04;08;Keskiviikko;40;17;57;12;7;19
292;26.04.2017;2017;04;09;Keskiviikko;13;7;20;6;10;16
292;26.04.2017;2017;04;10;Keskiviikko;10;6;16;3;1;4
292;26.04.2017;2017;04;11;Keskiviikko;11;10;21;5;4;9
292;26.04.2017;2017;04;12;Keskiviikko;6;14;20;8;10;18
292;26.04.2017;2017;04;13;Keskiviikko;46;49;95;28;9;37
292;26.04.2017;2017;04;14;Keskiviikko;16;45;61;6;10;16
292;26.04.2017;2017;04;15;Keskiviikko;24;25;49;7;8;15
292;26.04.2017;2017;04;16;Keskiviikko;20;59;79;8;12;20
292;26.04.2017;2017;04;17;Keskiviikko;10;9;19;12;5;17
292;26.04.2017;2017;04;18;Keskiviikko;5;13;18;8;8;16
292;26.04.2017;2017;04;19;Keskiviikko;9;7;16;8;11;19
292;26.04.2017;2017;04;20;Keskiviikko;7;2;9;8;4;12
292;26.04.2017;2017;04;21;Keskiviikko;2;0;2;3;2;5
292;26.04.2017;2017;04;22;Keskiviikko;2;4;6;0;1;1
292;26.04.2017;2017;04;23;Keskiviikko;0;1;1;1;1;2
292;27.04.2017;2017;04;00;Torstai;1;0;1;0;0;0
292;27.04.2017;2017;04;01;Torstai;0;0;0;0;0;0
292;27.04.2017;2017;04;02;Torstai;0;1;1;0;0;0
292;27.04.2017;2017;04;03;Torstai;0;0;0;0;0;0
292;27.04.2017;2017;04;04;Torstai;1;0;1;0;0;0
292;27.04.2017;2017;04;05;Torstai;8;5;13;1;0;1
292;27.04.2017;2017;04;06;Torstai;13;12;25;2;4;6
292;27.04.2017;2017;04;07;Torstai;51;18;69;6;6;12
292;27.04.2017;2017;04;08;Torstai;38;37;75;13;13;26
292;27.04.2017;2017;04;09;Torstai;32;37;69;11;16;27
292;27.04.2017;2017;04;10;Torstai;37;27;64;11;8;19
292;27.04.2017;2017;04;11;Torstai;16;28;44;12;12;24
292;27.04.2017;2017;04;12;Torstai;27;37;64;12;10;22
292;27.04.2017;2017;04;13;Torstai;42;26;68;17;20;37
292;27.04.2017;2017;04;14;Torstai;41;54;95;18;16;34
292;27.04.2017;2017;04;15;Torstai;30;40;70;12;28;40
292;27.04.2017;2017;04;16;Torstai;32;33;65;16;15;31
292;27.04.2017;2017;04;17;Torstai;33;27;60;13;17;30
292;27.04.2017;2017;04;18;Torstai;19;15;34;12;7;19
292;27.04.2017;2017;04;19;Torstai;23;15;38;15;13;28
292;27.04.2017;2017;04;20;Torstai;21;17;38;9;7;16
292;27.04.2017;2017;04;21;Torstai;4;7;11;4;3;7
292;27.04.2017;2017;04;22;Torstai;6;4;10;2;1;3
292;27.04.2017;2017;04;23;Torstai;2;0;2;1;0;1
292;28.04.2017;2017;04;00;Perjantai;0;3;3;0;1;1
292;28.04.2017;2017;04;01;Perjantai;0;0;0;0;0;0
292;28.04.2017;2017;04;02;Perjantai;0;2;2;0;1;1
292;28.04.2017;2017;04;03;Perjantai;0;0;0;0;0;0
292;28.04.2017;2017;04;04;Perjantai;1;0;1;0;0;0
292;28.04.2017;2017;04;05;Perjantai;8;5;13;3;0;3
292;28.04.2017;2017;04;06;Perjantai;12;10;22;1;5;6
292;28.04.2017;2017;04;07;Perjantai;54;24;78;14;5;19
292;28.04.2017;2017;04;08;Perjantai;43;45;88;16;16;32
292;28.04.2017;2017;04;09;Perjantai;57;35;92;14;17;31
292;28.04.2017;2017;04;10;Perjantai;36;36;72;17;17;34
292;28.04.2017;2017;04;11;Perjantai;32;34;66;21;9;30
292;28.04.2017;2017;04;12;Perjantai;60;39;99;39;28;67
292;28.04.2017;2017;04;13;Perjantai;26;76;102;15;23;38
292;28.04.2017;2017;04;14;Perjantai;32;50;82;11;21;32
292;28.04.2017;2017;04;15;Perjantai;36;48;84;9;18;27
292;28.04.2017;2017;04;16;Perjantai;26;37;63;13;11;24
292;28.04.2017;2017;04;17;Perjantai;20;26;46;15;12;27
292;28.04.2017;2017;04;18;Perjantai;33;37;70;29;21;50
292;28.04.2017;2017;04;19;Perjantai;23;25;48;16;12;28
292;28.04.2017;2017;04;20;Perjantai;21;14;35;11;7;18
292;28.04.2017;2017;04;21;Perjantai;12;9;21;6;2;8
292;28.04.2017;2017;04;22;Perjantai;7;16;23;11;6;17
292;28.04.2017;2017;04;23;Perjantai;4;5;9;4;1;5
292;29.04.2017;2017;04;00;Lauantai;4;1;5;2;2;4
292;29.04.2017;2017;04;01;Lauantai;0;2;2;4;3;7
292;29.04.2017;2017;04;02;Lauantai;0;0;0;0;2;2
292;29.04.2017;2017;04;03;Lauantai;0;3;3;0;1;1
292;29.04.2017;2017;04;04;Lauantai;0;0;0;3;0;3
292;29.04.2017;2017;04;05;Lauantai;0;1;1;0;2;2
292;29.04.2017;2017;04;06;Lauantai;7;4;11;2;0;2
292;29.04.2017;2017;04;07;Lauantai;3;12;15;5;2;7
292;29.04.2017;2017;04;08;Lauantai;12;13;25;8;9;17
292;29.04.2017;2017;04;09;Lauantai;13;26;39;9;13;22
292;29.04.2017;2017;04;10;Lauantai;20;37;57;11;8;19
292;29.04.2017;2017;04;11;Lauantai;50;36;86;18;23;41
292;29.04.2017;2017;04;12;Lauantai;42;18;60;11;14;25
292;29.04.2017;2017;04;13;Lauantai;50;32;82;15;11;26
292;29.04.2017;2017;04;14;Lauantai;27;49;76;17;17;34
292;29.04.2017;2017;04;15;Lauantai;42;25;67;31;16;47
292;29.04.2017;2017;04;16;Lauantai;25;39;64;30;12;42
292;29.04.2017;2017;04;17;Lauantai;29;30;59;16;12;28
292;29.04.2017;2017;04;18;Lauantai;40;24;64;22;22;44
292;29.04.2017;2017;04;19;Lauantai;12;24;36;11;11;22
292;29.04.2017;2017;04;20;Lauantai;13;16;29;11;5;16
292;29.04.2017;2017;04;21;Lauantai;11;15;26;6;6;12
292;29.04.2017;2017;04;22;Lauantai;4;5;9;4;0;4
292;29.04.2017;2017;04;23;Lauantai;3;7;10;5;3;8
292;30.04.2017;2017;04;00;Sunnuntai;4;2;6;0;4;4
292;30.04.2017;2017;04;01;Sunnuntai;2;3;5;0;0;0
292;30.04.2017;2017;04;02;Sunnuntai;1;1;2;0;1;1
292;30.04.2017;2017;04;03;Sunnuntai;0;1;1;0;2;2
292;30.04.2017;2017;04;04;Sunnuntai;0;1;1;0;0;0
292;30.04.2017;2017;04;05;Sunnuntai;0;0;0;1;0;1
292;30.04.2017;2017;04;06;Sunnuntai;6;1;7;1;2;3
292;30.04.2017;2017;04;07;Sunnuntai;0;4;4;3;3;6
292;30.04.2017;2017;04;08;Sunnuntai;0;3;3;6;1;7
292;30.04.2017;2017;04;09;Sunnuntai;3;3;6;7;6;13
292;30.04.2017;2017;04;10;Sunnuntai;8;5;13;12;13;25
292;30.04.2017;2017;04;11;Sunnuntai;9;12;21;11;15;26
292;30.04.2017;2017;04;12;Sunnuntai;16;17;33;12;20;32
292;30.04.2017;2017;04;13;Sunnuntai;14;9;23;6;6;12
292;30.04.2017;2017;04;14;Sunnuntai;6;8;14;6;10;16
292;30.04.2017;2017;04;15;Sunnuntai;13;7;20;8;8;16
292;30.04.2017;2017;04;16;Sunnuntai;12;14;26;11;17;28
292;30.04.2017;2017;04;17;Sunnuntai;13;11;24;9;3;12
292;30.04.2017;2017;04;18;Sunnuntai;17;26;43;15;14;29
292;30.04.2017;2017;04;19;Sunnuntai;11;4;15;4;5;9
292;30.04.2017;2017;04;20;Sunnuntai;9;9;18;4;4;8
292;30.04.2017;2017;04;21;Sunnuntai;5;11;16;3;3;6
292;30.04.2017;2017;04;22;Sunnuntai;2;2;4;3;2;5
292;30.04.2017;2017;04;23;Sunnuntai;6;3;9;1;0;1
292;01.05.2017;2017;05;00;Maanantai;3;3;6;6;4;10
292;01.05.2017;2017;05;01;Maanantai;1;7;8;3;2;5
292;01.05.2017;2017;05;02;Maanantai;0;1;1;0;3;3
292;01.05.2017;2017;05;03;Maanantai;0;1;1;0;3;3
292;01.05.2017;2017;05;04;Maanantai;1;2;3;0;1;1
292;01.05.2017;2017;05;05;Maanantai;1;0;1;1;0;1
292;01.05.2017;2017;05;06;Maanantai;5;2;7;3;2;5
292;01.05.2017;2017;05;07;Maanantai;2;5;7;3;3;6
292;01.05.2017;2017;05;08;Maanantai;4;6;10;8;8;16
292;01.05.2017;2017;05;09;Maanantai;18;9;27;10;11;21
292;01.05.2017;2017;05;10;Maanantai;21;15;36;19;8;27
292;01.05.2017;2017;05;11;Maanantai;35;15;50;13;25;38
292;01.05.2017;2017;05;12;Maanantai;35;32;67;13;20;33
292;01.05.2017;2017;05;13;Maanantai;29;35;64;21;25;46
292;01.05.2017;2017;05;14;Maanantai;31;41;72;26;14;40
292;01.05.2017;2017;05;15;Maanantai;23;25;48;20;16;36
292;01.05.2017;2017;05;16;Maanantai;42;32;74;21;19;40
292;01.05.2017;2017;05;17;Maanantai;29;25;54;22;17;39
292;01.05.2017;2017;05;18;Maanantai;21;31;52;27;22;49
292;01.05.2017;2017;05;19;Maanantai;27;21;48;23;27;50
292;01.05.2017;2017;05;20;Maanantai;11;16;27;12;8;20
292;01.05.2017;2017;05;21;Maanantai;2;12;14;2;7;9
292;01.05.2017;2017;05;22;Maanantai;3;3;6;2;1;3
292;01.05.2017;2017;05;23;Maanantai;2;2;4;0;0;0
292;02.05.2017;2017;05;00;Tiistai;0;1;1;0;0;0
292;02.05.2017;2017;05;01;Tiistai;0;2;2;0;0;0
292;02.05.2017;2017;05;02;Tiistai;1;0;1;0;0;0
292;02.05.2017;2017;05;03;Tiistai;0;0;0;0;0;0
292;02.05.2017;2017;05;04;Tiistai;3;0;3;0;0;0
292;02.05.2017;2017;05;05;Tiistai;8;5;13;0;1;1
292;02.05.2017;2017;05;06;Tiistai;24;15;39;3;6;9
292;02.05.2017;2017;05;07;Tiistai;61;42;103;13;11;24
292;02.05.2017;2017;05;08;Tiistai;66;31;97;15;15;30
292;02.05.2017;2017;05;09;Tiistai;27;18;45;12;11;23
292;02.05.2017;2017;05;10;Tiistai;28;24;52;11;11;22
292;02.05.2017;2017;05;11;Tiistai;20;27;47;6;8;14
292;02.05.2017;2017;05;12;Tiistai;29;20;49;9;9;18
292;02.05.2017;2017;05;13;Tiistai;34;58;92;17;21;38
292;02.05.2017;2017;05;14;Tiistai;41;87;128;23;21;44
292;02.05.2017;2017;05;15;Tiistai;46;62;108;22;17;39
292;02.05.2017;2017;05;16;Tiistai;56;69;125;19;19;38
292;02.05.2017;2017;05;17;Tiistai;49;61;110;28;20;48
292;02.05.2017;2017;05;18;Tiistai;41;28;69;27;28;55
292;02.05.2017;2017;05;19;Tiistai;33;34;67;19;15;34
292;02.05.2017;2017;05;20;Tiistai;18;32;50;8;11;19
292;02.05.2017;2017;05;21;Tiistai;4;8;12;4;2;6
292;02.05.2017;2017;05;22;Tiistai;1;3;4;2;1;3
292;02.05.2017;2017;05;23;Tiistai;2;1;3;0;1;1
292;03.05.2017;2017;05;00;Keskiviikko;0;0;0;0;0;0
292;03.05.2017;2017;05;01;Keskiviikko;1;1;2;0;1;1
292;03.05.2017;2017;05;02;Keskiviikko;0;1;1;0;0;0
292;03.05.2017;2017;05;03;Keskiviikko;0;0;0;0;0;0
292;03.05.2017;2017;05;04;Keskiviikko;3;1;4;0;0;0
292;03.05.2017;2017;05;05;Keskiviikko;9;8;17;3;0;3
292;03.05.2017;2017;05;06;Keskiviikko;20;19;39;2;4;6
292;03.05.2017;2017;05;07;Keskiviikko;75;37;112;16;11;27
292;03.05.2017;2017;05;08;Keskiviikko;45;34;79;15;12;27
292;03.05.2017;2017;05;09;Keskiviikko;35;24;59;6;12;18
292;03.05.2017;2017;05;10;Keskiviikko;22;31;53;11;6;17
292;03.05.2017;2017;05;11;Keskiviikko;30;30;60;10;8;18
292;03.05.2017;2017;05;12;Keskiviikko;32;33;65;13;10;23
292;03.05.2017;2017;05;13;Keskiviikko;34;57;91;13;26;39
292;03.05.2017;2017;05;14;Keskiviikko;49;69;118;15;11;26
292;03.05.2017;2017;05;15;Keskiviikko;34;76;110;22;10;32
292;03.05.2017;2017;05;16;Keskiviikko;58;62;120;23;16;39
292;03.05.2017;2017;05;17;Keskiviikko;40;31;71;19;17;36
292;03.05.2017;2017;05;18;Keskiviikko;20;24;44;15;12;27
292;03.05.2017;2017;05;19;Keskiviikko;29;44;73;15;8;23
292;03.05.2017;2017;05;20;Keskiviikko;19;17;36;14;11;25
292;03.05.2017;2017;05;21;Keskiviikko;6;13;19;2;6;8
292;03.05.2017;2017;05;22;Keskiviikko;4;5;9;1;1;2
292;03.05.2017;2017;05;23;Keskiviikko;1;2;3;1;0;1
292;04.05.2017;2017;05;00;Torstai;1;1;2;0;0;0
292;04.05.2017;2017;05;01;Torstai;0;1;1;0;0;0
292;04.05.2017;2017;05;02;Torstai;0;0;0;0;0;0
292;04.05.2017;2017;05;03;Torstai;0;0;0;0;0;0
292;04.05.2017;2017;05;04;Torstai;3;4;7;1;1;2
292;04.05.2017;2017;05;05;Torstai;11;6;17;1;2;3
292;04.05.2017;2017;05;06;Torstai;26;18;44;3;3;6
292;04.05.2017;2017;05;07;Torstai;77;33;110;7;8;15
292;04.05.2017;2017;05;08;Torstai;46;27;73;20;12;32
292;04.05.2017;2017;05;09;Torstai;51;31;82;12;10;22
292;04.05.2017;2017;05;10;Torstai;37;32;69;14;14;28
292;04.05.2017;2017;05;11;Torstai;30;27;57;15;20;35
292;04.05.2017;2017;05;12;Torstai;35;39;74;7;12;19
292;04.05.2017;2017;05;13;Torstai;34;40;74;14;16;30
292;04.05.2017;2017;05;14;Torstai;41;79;120;14;16;30
292;04.05.2017;2017;05;15;Torstai;46;76;122;20;18;38
292;04.05.2017;2017;05;16;Torstai;53;63;116;12;22;34
292;04.05.2017;2017;05;17;Torstai;40;51;91;27;22;49
292;04.05.2017;2017;05;18;Torstai;56;35;91;29;16;45
292;04.05.2017;2017;05;19;Torstai;34;44;78;30;12;42
292;04.05.2017;2017;05;20;Torstai;20;26;46;10;14;24
292;04.05.2017;2017;05;21;Torstai;7;21;28;8;4;12
292;04.05.2017;2017;05;22;Torstai;4;5;9;1;2;3
292;04.05.2017;2017;05;23;Torstai;2;2;4;2;1;3
292;05.05.2017;2017;05;00;Perjantai;0;1;1;0;0;0
292;05.05.2017;2017;05;01;Perjantai;0;0;0;0;0;0
292;05.05.2017;2017;05;02;Perjantai;1;1;2;0;0;0
292;05.05.2017;2017;05;03;Perjantai;1;0;1;0;0;0
292;05.05.2017;2017;05;04;Perjantai;3;2;5;0;0;0
292;05.05.2017;2017;05;05;Perjantai;7;8;15;1;1;2
292;05.05.2017;2017;05;06;Perjantai;19;13;32;3;8;11
292;05.05.2017;2017;05;07;Perjantai;65;30;95;7;5;12
292;05.05.2017;2017;05;08;Perjantai;56;29;85;11;13;24
292;05.05.2017;2017;05;09;Perjantai;46;25;71;15;16;31
292;05.05.2017;2017;05;10;Perjantai;23;24;47;6;7;13
292;05.05.2017;2017;05;11;Perjantai;33;36;69;6;12;18
292;05.05.2017;2017;05;12;Perjantai;43;54;97;18;15;33
292;05.05.2017;2017;05;13;Perjantai;41;78;119;18;18;36
292;05.05.2017;2017;05;14;Perjantai;55;82;137;24;19;43
292;05.05.2017;2017;05;15;Perjantai;55;51;106;19;25;44
292;05.05.2017;2017;05;16;Perjantai;81;63;144;24;24;48
292;05.05.2017;2017;05;17;Perjantai;46;50;96;18;22;40
292;05.05.2017;2017;05;18;Perjantai;38;40;78;20;20;40
292;05.05.2017;2017;05;19;Perjantai;41;41;82;29;23;52
292;05.05.2017;2017;05;20;Perjantai;29;29;58;24;10;34
292;05.05.2017;2017;05;21;Perjantai;20;17;37;11;6;17
292;05.05.2017;2017;05;22;Perjantai;6;6;12;6;3;9
292;05.05.2017;2017;05;23;Perjantai;5;2;7;7;1;8
292;06.05.2017;2017;05;00;Lauantai;2;9;11;4;2;6
292;06.05.2017;2017;05;01;Lauantai;1;2;3;1;2;3
292;06.05.2017;2017;05;02;Lauantai;0;3;3;0;4;4
292;06.05.2017;2017;05;03;Lauantai;1;1;2;1;4;5
292;06.05.2017;2017;05;04;Lauantai;0;0;0;0;0;0
292;06.05.2017;2017;05;05;Lauantai;1;0;1;1;0;1
292;06.05.2017;2017;05;06;Lauantai;5;3;8;3;2;5
292;06.05.2017;2017;05;07;Lauantai;4;7;11;2;2;4
292;06.05.2017;2017;05;08;Lauantai;9;7;16;5;3;8
292;06.05.2017;2017;05;09;Lauantai;10;13;23;10;13;23
292;06.05.2017;2017;05;10;Lauantai;21;22;43;3;7;10
292;06.05.2017;2017;05;11;Lauantai;26;27;53;13;10;23
292;06.05.2017;2017;05;12;Lauantai;42;23;65;61;60;121
292;06.05.2017;2017;05;13;Lauantai;29;33;62;9;14;23
292;06.05.2017;2017;05;14;Lauantai;41;28;69;6;20;26
292;06.05.2017;2017;05;15;Lauantai;28;24;52;7;14;21
292;06.05.2017;2017;05;16;Lauantai;30;20;50;16;12;28
292;06.05.2017;2017;05;17;Lauantai;23;20;43;15;10;25
292;06.05.2017;2017;05;18;Lauantai;17;17;34;18;24;42
292;06.05.2017;2017;05;19;Lauantai;23;19;42;23;7;30
292;06.05.2017;2017;05;20;Lauantai;19;18;37;14;14;28
292;06.05.2017;2017;05;21;Lauantai;7;17;24;4;5;9
292;06.05.2017;2017;05;22;Lauantai;5;4;9;1;1;2
292;06.05.2017;2017;05;23;Lauantai;5;2;7;5;3;8
292;07.05.2017;2017;05;00;Sunnuntai;2;4;6;3;0;3
292;07.05.2017;2017;05;01;Sunnuntai;5;2;7;5;2;7
292;07.05.2017;2017;05;02;Sunnuntai;0;1;1;3;4;7
292;07.05.2017;2017;05;03;Sunnuntai;1;4;5;0;4;4
292;07.05.2017;2017;05;04;Sunnuntai;0;0;0;0;0;0
292;07.05.2017;2017;05;05;Sunnuntai;0;0;0;2;1;3
292;07.05.2017;2017;05;06;Sunnuntai;5;0;5;2;3;5
292;07.05.2017;2017;05;07;Sunnuntai;4;5;9;1;0;1
292;07.05.2017;2017;05;08;Sunnuntai;6;6;12;4;2;6
292;07.05.2017;2017;05;09;Sunnuntai;25;17;42;8;3;11
292;07.05.2017;2017;05;10;Sunnuntai;30;17;47;10;9;19
292;07.05.2017;2017;05;11;Sunnuntai;32;23;55;13;8;21
292;07.05.2017;2017;05;12;Sunnuntai;58;35;93;23;26;49
292;07.05.2017;2017;05;13;Sunnuntai;49;26;75;18;13;31
292;07.05.2017;2017;05;14;Sunnuntai;33;30;63;16;24;40
292;07.05.2017;2017;05;15;Sunnuntai;33;41;74;14;23;37
292;07.05.2017;2017;05;16;Sunnuntai;32;40;72;19;16;35
292;07.05.2017;2017;05;17;Sunnuntai;37;28;65;14;14;28
292;07.05.2017;2017;05;18;Sunnuntai;15;24;39;11;12;23
292;07.05.2017;2017;05;19;Sunnuntai;17;19;36;10;18;28
292;07.05.2017;2017;05;20;Sunnuntai;14;13;27;11;12;23
292;07.05.2017;2017;05;21;Sunnuntai;4;12;16;3;4;7
292;07.05.2017;2017;05;22;Sunnuntai;3;1;4;1;2;3
292;07.05.2017;2017;05;23;Sunnuntai;2;1;3;0;0;0
292;08.05.2017;2017;05;00;Maanantai;0;0;0;0;1;1
292;08.05.2017;2017;05;01;Maanantai;0;1;1;0;1;1
292;08.05.2017;2017;05;02;Maanantai;0;0;0;0;0;0
292;08.05.2017;2017;05;03;Maanantai;0;0;0;0;0;0
292;08.05.2017;2017;05;04;Maanantai;5;1;6;0;0;0
292;08.05.2017;2017;05;05;Maanantai;6;4;10;0;2;2
292;08.05.2017;2017;05;06;Maanantai;17;17;34;1;0;1
292;08.05.2017;2017;05;07;Maanantai;56;25;81;7;13;20
292;08.05.2017;2017;05;08;Maanantai;42;23;65;15;13;28
292;08.05.2017;2017;05;09;Maanantai;46;19;65;8;9;17
292;08.05.2017;2017;05;10;Maanantai;33;17;50;10;13;23
292;08.05.2017;2017;05;11;Maanantai;28;22;50;6;4;10
292;08.05.2017;2017;05;12;Maanantai;32;17;49;6;8;14
292;08.05.2017;2017;05;13;Maanantai;35;29;64;8;6;14
292;08.05.2017;2017;05;14;Maanantai;32;30;62;14;17;31
292;08.05.2017;2017;05;15;Maanantai;47;54;101;12;21;33
292;08.05.2017;2017;05;16;Maanantai;50;28;78;10;19;29
292;08.05.2017;2017;05;17;Maanantai;29;26;55;18;14;32
292;08.05.2017;2017;05;18;Maanantai;21;24;45;11;18;29
292;08.05.2017;2017;05;19;Maanantai;22;20;42;20;28;48
292;08.05.2017;2017;05;20;Maanantai;16;7;23;9;8;17
292;08.05.2017;2017;05;21;Maanantai;8;9;17;4;4;8
292;08.05.2017;2017;05;22;Maanantai;6;2;8;1;0;1
292;08.05.2017;2017;05;23;Maanantai;0;0;0;0;0;0
292;09.05.2017;2017;05;00;Tiistai;0;0;0;0;0;0
292;09.05.2017;2017;05;01;Tiistai;0;1;1;0;0;0
292;09.05.2017;2017;05;02;Tiistai;0;0;0;0;0;0
292;09.05.2017;2017;05;03;Tiistai;0;0;0;0;0;0
292;09.05.2017;2017;05;04;Tiistai;4;0;4;0;1;1
292;09.05.2017;2017;05;05;Tiistai;6;6;12;1;1;2
292;09.05.2017;2017;05;06;Tiistai;17;20;37;1;4;5
292;09.05.2017;2017;05;07;Tiistai;71;28;99;13;7;20
292;09.05.2017;2017;05;08;Tiistai;42;25;67;11;9;20
292;09.05.2017;2017;05;09;Tiistai;21;17;38;3;5;8
292;09.05.2017;2017;05;10;Tiistai;20;15;35;6;10;16
292;09.05.2017;2017;05;11;Tiistai;21;15;36;10;11;21
292;09.05.2017;2017;05;12;Tiistai;27;19;46;8;6;14
292;09.05.2017;2017;05;13;Tiistai;26;33;59;7;16;23
292;09.05.2017;2017;05;14;Tiistai;35;54;89;18;11;29
292;09.05.2017;2017;05;15;Tiistai;36;50;86;5;34;39
292;09.05.2017;2017;05;16;Tiistai;50;44;94;11;18;29
292;09.05.2017;2017;05;17;Tiistai;31;36;67;13;16;29
292;09.05.2017;2017;05;18;Tiistai;24;20;44;16;15;31
292;09.05.2017;2017;05;19;Tiistai;24;20;44;19;22;41
292;09.05.2017;2017;05;20;Tiistai;19;9;28;8;10;18
292;09.05.2017;2017;05;21;Tiistai;9;8;17;3;6;9
292;09.05.2017;2017;05;22;Tiistai;4;3;7;0;0;0
292;09.05.2017;2017;05;23;Tiistai;1;1;2;1;0;1
292;10.05.2017;2017;05;00;Keskiviikko;0;0;0;0;0;0
292;10.05.2017;2017;05;01;Keskiviikko;0;0;0;0;0;0
292;10.05.2017;2017;05;02;Keskiviikko;0;1;1;0;0;0
292;10.05.2017;2017;05;03;Keskiviikko;1;2;3;1;0;1
292;10.05.2017;2017;05;04;Keskiviikko;3;1;4;0;0;0
292;10.05.2017;2017;05;05;Keskiviikko;6;4;10;0;0;0
292;10.05.2017;2017;05;06;Keskiviikko;24;13;37;1;4;5
292;10.05.2017;2017;05;07;Keskiviikko;69;27;96;11;16;27
292;10.05.2017;2017;05;08;Keskiviikko;62;23;85;9;12;21
292;10.05.2017;2017;05;09;Keskiviikko;29;23;52;6;11;17
292;10.05.2017;2017;05;10;Keskiviikko;21;21;42;2;12;14
292;10.05.2017;2017;05;11;Keskiviikko;34;21;55;9;10;19
292;10.05.2017;2017;05;12;Keskiviikko;27;21;48;9;7;16
292;10.05.2017;2017;05;13;Keskiviikko;21;69;90;15;24;39
292;10.05.2017;2017;05;14;Keskiviikko;31;35;66;9;14;23
292;10.05.2017;2017;05;15;Keskiviikko;37;39;76;12;28;40
292;10.05.2017;2017;05;16;Keskiviikko;48;32;80;21;21;42
292;10.05.2017;2017;05;17;Keskiviikko;17;22;39;6;8;14
292;10.05.2017;2017;05;18;Keskiviikko;15;22;37;19;14;33
292;10.05.2017;2017;05;19;Keskiviikko;23;8;31;12;20;32
292;10.05.2017;2017;05;20;Keskiviikko;21;16;37;10;9;19
292;10.05.2017;2017;05;21;Keskiviikko;5;13;18;4;3;7
292;10.05.2017;2017;05;22;Keskiviikko;2;1;3;0;1;1
292;10.05.2017;2017;05;23;Keskiviikko;0;1;1;2;0;2
292;11.05.2017;2017;05;00;Torstai;2;1;3;3;1;4
292;11.05.2017;2017;05;01;Torstai;1;0;1;0;0;0
292;11.05.2017;2017;05;02;Torstai;0;1;1;0;0;0
292;11.05.2017;2017;05;03;Torstai;0;1;1;0;0;0
292;11.05.2017;2017;05;04;Torstai;3;0;3;0;0;0
292;11.05.2017;2017;05;05;Torstai;5;4;9;1;1;2
292;11.05.2017;2017;05;06;Torstai;16;9;25;3;9;12
292;11.05.2017;2017;05;07;Torstai;73;29;102;11;7;18
292;11.05.2017;2017;05;08;Torstai;44;31;75;13;11;24
292;11.05.2017;2017;05;09;Torstai;54;22;76;5;5;10
292;11.05.2017;2017;05;10;Torstai;27;14;41;7;11;18
292;11.05.2017;2017;05;11;Torstai;13;10;23;5;16;21
292;11.05.2017;2017;05;12;Torstai;20;18;38;13;6;19
292;11.05.2017;2017;05;13;Torstai;33;25;58;14;6;20
292;11.05.2017;2017;05;14;Torstai;42;36;78;9;18;27
292;11.05.2017;2017;05;15;Torstai;32;57;89;8;29;37
292;11.05.2017;2017;05;16;Torstai;36;43;79;12;27;39
292;11.05.2017;2017;05;17;Torstai;31;31;62;19;19;38
292;11.05.2017;2017;05;18;Torstai;35;27;62;26;25;51
292;11.05.2017;2017;05;19;Torstai;18;21;39;29;22;51
292;11.05.2017;2017;05;20;Torstai;22;18;40;19;24;43
292;11.05.2017;2017;05;21;Torstai;10;9;19;4;3;7
292;11.05.2017;2017;05;22;Torstai;4;1;5;4;1;5
292;11.05.2017;2017;05;23;Torstai;0;0;0;0;0;0
292;12.05.2017;2017;05;00;Perjantai;2;1;3;0;0;0
292;12.05.2017;2017;05;01;Perjantai;0;0;0;0;0;0
292;12.05.2017;2017;05;02;Perjantai;0;0;0;0;0;0
292;12.05.2017;2017;05;03;Perjantai;0;1;1;0;0;0
292;12.05.2017;2017;05;04;Perjantai;1;1;2;0;0;0
292;12.05.2017;2017;05;05;Perjantai;4;8;12;2;1;3
292;12.05.2017;2017;05;06;Perjantai;22;8;30;7;5;12
292;12.05.2017;2017;05;07;Perjantai;67;24;91;12;14;26
292;12.05.2017;2017;05;08;Perjantai;56;26;82;15;13;28
292;12.05.2017;2017;05;09;Perjantai;41;20;61;15;10;25
292;12.05.2017;2017;05;10;Perjantai;27;12;39;7;4;11
292;12.05.2017;2017;05;11;Perjantai;40;28;68;3;11;14
292;12.05.2017;2017;05;12;Perjantai;36;36;72;17;23;40
292;12.05.2017;2017;05;13;Perjantai;34;71;105;16;31;47
292;12.05.2017;2017;05;14;Perjantai;33;52;85;11;19;30
292;12.05.2017;2017;05;15;Perjantai;41;49;90;17;26;43
292;12.05.2017;2017;05;16;Perjantai;49;32;81;13;19;32
292;12.05.2017;2017;05;17;Perjantai;27;26;53;16;15;31
292;12.05.2017;2017;05;18;Perjantai;25;23;48;17;22;39
292;12.05.2017;2017;05;19;Perjantai;28;25;53;14;12;26
292;12.05.2017;2017;05;20;Perjantai;24;22;46;17;16;33
292;12.05.2017;2017;05;21;Perjantai;15;19;34;11;15;26
292;12.05.2017;2017;05;22;Perjantai;12;7;19;7;3;10
292;12.05.2017;2017;05;23;Perjantai;7;2;9;2;0;2
292;13.05.2017;2017;05;00;Lauantai;2;5;7;3;2;5
292;13.05.2017;2017;05;01;Lauantai;0;3;3;0;3;3
292;13.05.2017;2017;05;02;Lauantai;1;1;2;0;3;3
292;13.05.2017;2017;05;03;Lauantai;1;4;5;0;1;1
292;13.05.2017;2017;05;04;Lauantai;0;1;1;0;1;1
292;13.05.2017;2017;05;05;Lauantai;1;4;5;3;1;4
292;13.05.2017;2017;05;06;Lauantai;5;3;8;0;2;2
292;13.05.2017;2017;05;07;Lauantai;3;6;9;6;2;8
292;13.05.2017;2017;05;08;Lauantai;5;13;18;7;5;12
292;13.05.2017;2017;05;09;Lauantai;12;24;36;3;14;17
292;13.05.2017;2017;05;10;Lauantai;37;18;55;10;8;18
292;13.05.2017;2017;05;11;Lauantai;52;35;87;16;12;28
292;13.05.2017;2017;05;12;Lauantai;45;33;78;16;14;30
292;13.05.2017;2017;05;13;Lauantai;43;28;71;13;28;41
292;13.05.2017;2017;05;14;Lauantai;53;23;76;14;18;32
292;13.05.2017;2017;05;15;Lauantai;38;35;73;21;26;47
292;13.05.2017;2017;05;16;Lauantai;53;19;72;12;19;31
292;13.05.2017;2017;05;17;Lauantai;40;29;69;26;16;42
292;13.05.2017;2017;05;18;Lauantai;33;29;62;15;21;36
292;13.05.2017;2017;05;19;Lauantai;29;15;44;8;9;17
292;13.05.2017;2017;05;20;Lauantai;18;15;33;5;21;26
292;13.05.2017;2017;05;21;Lauantai;13;12;25;8;3;11
292;13.05.2017;2017;05;22;Lauantai;4;8;12;3;4;7
292;13.05.2017;2017;05;23;Lauantai;3;5;8;6;1;7
292;14.05.2017;2017;05;00;Sunnuntai;1;2;3;1;0;1
292;14.05.2017;2017;05;01;Sunnuntai;1;2;3;1;0;1
292;14.05.2017;2017;05;02;Sunnuntai;4;5;9;2;3;5
292;14.05.2017;2017;05;03;Sunnuntai;0;0;0;0;3;3
292;14.05.2017;2017;05;04;Sunnuntai;0;1;1;0;0;0
292;14.05.2017;2017;05;05;Sunnuntai;1;0;1;0;0;0
292;14.05.2017;2017;05;06;Sunnuntai;3;3;6;1;1;2
292;14.05.2017;2017;05;07;Sunnuntai;5;3;8;2;2;4
292;14.05.2017;2017;05;08;Sunnuntai;5;2;7;7;6;13
292;14.05.2017;2017;05;09;Sunnuntai;3;2;5;4;4;8
292;14.05.2017;2017;05;10;Sunnuntai;3;10;13;2;2;4
292;14.05.2017;2017;05;11;Sunnuntai;2;5;7;4;7;11
292;14.05.2017;2017;05;12;Sunnuntai;19;7;26;4;5;9
292;14.05.2017;2017;05;13;Sunnuntai;11;3;14;3;5;8
292;14.05.2017;2017;05;14;Sunnuntai;6;5;11;3;2;5
292;14.05.2017;2017;05;15;Sunnuntai;9;6;15;0;5;5
292;14.05.2017;2017;05;16;Sunnuntai;5;4;9;4;4;8
292;14.05.2017;2017;05;17;Sunnuntai;8;3;11;7;5;12
292;14.05.2017;2017;05;18;Sunnuntai;7;5;12;10;7;17
292;14.05.2017;2017;05;19;Sunnuntai;5;1;6;7;9;16
292;14.05.2017;2017;05;20;Sunnuntai;8;7;15;8;11;19
292;14.05.2017;2017;05;21;Sunnuntai;5;3;8;3;4;7
292;14.05.2017;2017;05;22;Sunnuntai;0;0;0;0;1;1
292;14.05.2017;2017;05;23;Sunnuntai;0;0;0;2;0;2
292;15.05.2017;2017;05;00;Maanantai;0;0;0;0;0;0
292;15.05.2017;2017;05;01;Maanantai;0;1;1;0;0;0
292;15.05.2017;2017;05;02;Maanantai;0;0;0;0;0;0
292;15.05.2017;2017;05;03;Maanantai;1;0;1;0;0;0
292;15.05.2017;2017;05;04;Maanantai;3;2;5;0;0;0
292;15.05.2017;2017;05;05;Maanantai;5;8;13;1;1;2
292;15.05.2017;2017;05;06;Maanantai;19;11;30;2;8;10
292;15.05.2017;2017;05;07;Maanantai;62;21;83;9;9;18
292;15.05.2017;2017;05;08;Maanantai;37;28;65;11;14;25
292;15.05.2017;2017;05;09;Maanantai;41;23;64;8;9;17
292;15.05.2017;2017;05;10;Maanantai;35;21;56;23;16;39
292;15.05.2017;2017;05;11;Maanantai;26;18;44;7;10;17
292;15.05.2017;2017;05;12;Maanantai;28;13;41;19;11;30
292;15.05.2017;2017;05;13;Maanantai;41;35;76;12;16;28
292;15.05.2017;2017;05;14;Maanantai;38;69;107;26;26;52
292;15.05.2017;2017;05;15;Maanantai;41;67;108;17;64;81
292;15.05.2017;2017;05;16;Maanantai;57;57;114;38;29;67
292;15.05.2017;2017;05;17;Maanantai;67;36;103;25;35;60
292;15.05.2017;2017;05;18;Maanantai;51;47;98;31;32;63
292;15.05.2017;2017;05;19;Maanantai;32;50;82;12;37;49
292;15.05.2017;2017;05;20;Maanantai;29;22;51;14;16;30
292;15.05.2017;2017;05;21;Maanantai;12;12;24;5;5;10
292;15.05.2017;2017;05;22;Maanantai;3;4;7;0;3;3
292;15.05.2017;2017;05;23;Maanantai;1;0;1;1;0;1
292;16.05.2017;2017;05;00;Tiistai;0;0;0;0;0;0
292;16.05.2017;2017;05;01;Tiistai;0;3;3;0;1;1
292;16.05.2017;2017;05;02;Tiistai;0;0;0;0;1;1
292;16.05.2017;2017;05;03;Tiistai;1;1;2;0;0;0
292;16.05.2017;2017;05;04;Tiistai;3;1;4;0;0;0
292;16.05.2017;2017;05;05;Tiistai;9;12;21;0;0;0
292;16.05.2017;2017;05;06;Tiistai;23;14;37;2;6;8
292;16.05.2017;2017;05;07;Tiistai;86;24;110;9;10;19
292;16.05.2017;2017;05;08;Tiistai;71;26;97;12;18;30
292;16.05.2017;2017;05;09;Tiistai;37;26;63;8;16;24
292;16.05.2017;2017;05;10;Tiistai;27;24;51;9;20;29
292;16.05.2017;2017;05;11;Tiistai;37;24;61;8;6;14
292;16.05.2017;2017;05;12;Tiistai;30;26;56;8;20;28
292;16.05.2017;2017;05;13;Tiistai;38;43;81;16;12;28
292;16.05.2017;2017;05;14;Tiistai;48;69;117;22;32;54
292;16.05.2017;2017;05;15;Tiistai;47;72;119;19;40;59
292;16.05.2017;2017;05;16;Tiistai;50;55;105;22;49;71
292;16.05.2017;2017;05;17;Tiistai;44;48;92;24;14;38
292;16.05.2017;2017;05;18;Tiistai;69;38;107;26;33;59
292;16.05.2017;2017;05;19;Tiistai;30;48;78;29;37;66
292;16.05.2017;2017;05;20;Tiistai;35;29;64;16;14;30
292;16.05.2017;2017;05;21;Tiistai;6;13;19;3;8;11
292;16.05.2017;2017;05;22;Tiistai;5;3;8;1;3;4
292;16.05.2017;2017;05;23;Tiistai;0;0;0;0;0;0
292;17.05.2017;2017;05;00;Keskiviikko;1;0;1;0;0;0
292;17.05.2017;2017;05;01;Keskiviikko;0;0;0;0;0;0
292;17.05.2017;2017;05;02;Keskiviikko;1;2;3;0;0;0
292;17.05.2017;2017;05;03;Keskiviikko;0;0;0;0;1;1
292;17.05.2017;2017;05;04;Keskiviikko;2;1;3;0;0;0
292;17.05.2017;2017;05;05;Keskiviikko;8;7;15;1;2;3
292;17.05.2017;2017;05;06;Keskiviikko;19;10;29;0;7;7
292;17.05.2017;2017;05;07;Keskiviikko;63;25;88;8;12;20
292;17.05.2017;2017;05;08;Keskiviikko;54;13;67;8;14;22
292;17.05.2017;2017;05;09;Keskiviikko;33;9;42;6;11;17
292;17.05.2017;2017;05;10;Keskiviikko;17;16;33;3;1;4
292;17.05.2017;2017;05;11;Keskiviikko;12;9;21;11;7;18
292;17.05.2017;2017;05;12;Keskiviikko;22;18;40;7;7;14
292;17.05.2017;2017;05;13;Keskiviikko;15;31;46;9;26;35
292;17.05.2017;2017;05;14;Keskiviikko;28;39;67;9;32;41
292;17.05.2017;2017;05;15;Keskiviikko;35;29;64;11;19;30
292;17.05.2017;2017;05;16;Keskiviikko;31;27;58;12;24;36
292;17.05.2017;2017;05;17;Keskiviikko;32;18;50;7;9;16
292;17.05.2017;2017;05;18;Keskiviikko;18;18;36;10;8;18
292;17.05.2017;2017;05;19;Keskiviikko;23;10;33;9;5;14
292;17.05.2017;2017;05;20;Keskiviikko;12;7;19;4;3;7
292;17.05.2017;2017;05;21;Keskiviikko;9;6;15;2;2;4
292;17.05.2017;2017;05;22;Keskiviikko;1;0;1;0;1;1
292;17.05.2017;2017;05;23;Keskiviikko;1;0;1;0;1;1
292;18.05.2017;2017;05;00;Torstai;0;1;1;0;0;0
292;18.05.2017;2017;05;01;Torstai;1;1;2;0;0;0
292;18.05.2017;2017;05;02;Torstai;0;1;1;1;0;1
292;18.05.2017;2017;05;03;Torstai;1;0;1;0;3;3
292;18.05.2017;2017;05;04;Torstai;4;1;5;0;0;0
292;18.05.2017;2017;05;05;Torstai;8;6;14;0;0;0
292;18.05.2017;2017;05;06;Torstai;17;16;33;2;2;4
292;18.05.2017;2017;05;07;Torstai;57;27;84;12;9;21
292;18.05.2017;2017;05;08;Torstai;43;23;66;9;12;21
292;18.05.2017;2017;05;09;Torstai;45;25;70;12;11;23
292;18.05.2017;2017;05;10;Torstai;32;19;51;8;7;15
292;18.05.2017;2017;05;11;Torstai;24;19;43;8;10;18
292;18.05.2017;2017;05;12;Torstai;30;22;52;8;4;12
292;18.05.2017;2017;05;13;Torstai;38;27;65;8;7;15
292;18.05.2017;2017;05;14;Torstai;47;45;92;14;11;25
292;18.05.2017;2017;05;15;Torstai;61;62;123;7;11;18
292;18.05.2017;2017;05;16;Torstai;50;56;106;11;12;23
292;18.05.2017;2017;05;17;Torstai;46;27;73;11;5;16
292;18.05.2017;2017;05;18;Torstai;33;23;56;9;10;19
292;18.05.2017;2017;05;19;Torstai;33;33;66;12;24;36
292;18.05.2017;2017;05;20;Torstai;25;26;51;10;22;32
292;18.05.2017;2017;05;21;Torstai;12;7;19;6;4;10
292;18.05.2017;2017;05;22;Torstai;5;4;9;2;2;4
292;18.05.2017;2017;05;23;Torstai;1;0;1;0;0;0
292;19.05.2017;2017;05;00;Perjantai;0;1;1;1;0;1
292;19.05.2017;2017;05;01;Perjantai;1;2;3;0;3;3
292;19.05.2017;2017;05;02;Perjantai;0;1;1;0;0;0
292;19.05.2017;2017;05;03;Perjantai;1;0;1;0;0;0
292;19.05.2017;2017;05;04;Perjantai;3;1;4;0;0;0
292;19.05.2017;2017;05;05;Perjantai;4;3;7;0;0;0
292;19.05.2017;2017;05;06;Perjantai;11;7;18;2;2;4
292;19.05.2017;2017;05;07;Perjantai;25;18;43;6;4;10
292;19.05.2017;2017;05;08;Perjantai;27;14;41;6;4;10
292;19.05.2017;2017;05;09;Perjantai;23;13;36;5;2;7
292;19.05.2017;2017;05;10;Perjantai;10;10;20;2;3;5
292;19.05.2017;2017;05;11;Perjantai;14;13;27;4;7;11
292;19.05.2017;2017;05;12;Perjantai;20;18;38;10;11;21
292;19.05.2017;2017;05;13;Perjantai;39;35;74;14;9;23
292;19.05.2017;2017;05;14;Perjantai;35;27;62;11;11;22
292;19.05.2017;2017;05;15;Perjantai;29;34;63;8;19;27
292;19.05.2017;2017;05;16;Perjantai;35;27;62;7;9;16
292;19.05.2017;2017;05;17;Perjantai;30;26;56;7;12;19
292;19.05.2017;2017;05;18;Perjantai;30;21;51;8;10;18
292;19.05.2017;2017;05;19;Perjantai;21;20;41;11;12;23
292;19.05.2017;2017;05;20;Perjantai;18;19;37;18;17;35
292;19.05.2017;2017;05;21;Perjantai;16;13;29;3;5;8
292;19.05.2017;2017;05;22;Perjantai;5;4;9;5;4;9
292;19.05.2017;2017;05;23;Perjantai;2;2;4;5;1;6
292;20.05.2017;2017;05;00;Lauantai;3;4;7;3;0;3
292;20.05.2017;2017;05;01;Lauantai;0;1;1;0;0;0
292;20.05.2017;2017;05;02;Lauantai;1;1;2;1;5;6
292;20.05.2017;2017;05;03;Lauantai;0;2;2;1;3;4
292;20.05.2017;2017;05;04;Lauantai;0;1;1;0;0;0
292;20.05.2017;2017;05;05;Lauantai;1;1;2;1;0;1
292;20.05.2017;2017;05;06;Lauantai;5;4;9;1;3;4
292;20.05.2017;2017;05;07;Lauantai;7;3;10;4;0;4
292;20.05.2017;2017;05;08;Lauantai;15;14;29;2;5;7
292;20.05.2017;2017;05;09;Lauantai;21;16;37;3;3;6
292;20.05.2017;2017;05;10;Lauantai;51;30;81;9;10;19
292;20.05.2017;2017;05;11;Lauantai;44;39;83;15;13;28
292;20.05.2017;2017;05;12;Lauantai;46;37;83;22;21;43
292;20.05.2017;2017;05;13;Lauantai;78;33;111;20;19;39
292;20.05.2017;2017;05;14;Lauantai;38;51;89;14;27;41
292;20.05.2017;2017;05;15;Lauantai;44;39;83;24;19;43
292;20.05.2017;2017;05;16;Lauantai;48;36;84;20;17;37
292;20.05.2017;2017;05;17;Lauantai;40;37;77;14;22;36
292;20.05.2017;2017;05;18;Lauantai;52;25;77;20;15;35
292;20.05.2017;2017;05;19;Lauantai;27;24;51;15;23;38
292;20.05.2017;2017;05;20;Lauantai;8;18;26;7;10;17
292;20.05.2017;2017;05;21;Lauantai;7;7;14;4;5;9
292;20.05.2017;2017;05;22;Lauantai;6;9;15;6;5;11
292;20.05.2017;2017;05;23;Lauantai;7;5;12;7;1;8
292;21.05.2017;2017;05;00;Sunnuntai;10;7;17;8;5;13
292;21.05.2017;2017;05;01;Sunnuntai;4;7;11;5;4;9
292;21.05.2017;2017;05;02;Sunnuntai;2;6;8;1;2;3
292;21.05.2017;2017;05;03;Sunnuntai;0;3;3;0;6;6
292;21.05.2017;2017;05;04;Sunnuntai;0;1;1;0;1;1
292;21.05.2017;2017;05;05;Sunnuntai;1;1;2;2;1;3
292;21.05.2017;2017;05;06;Sunnuntai;5;4;9;0;2;2
292;21.05.2017;2017;05;07;Sunnuntai;5;4;9;3;3;6
292;21.05.2017;2017;05;08;Sunnuntai;11;11;22;7;1;8
292;21.05.2017;2017;05;09;Sunnuntai;25;15;40;5;4;9
292;21.05.2017;2017;05;10;Sunnuntai;20;9;29;7;10;17
292;21.05.2017;2017;05;11;Sunnuntai;35;23;58;17;9;26
292;21.05.2017;2017;05;12;Sunnuntai;61;41;102;7;5;12
292;21.05.2017;2017;05;13;Sunnuntai;56;32;88;10;18;28
292;21.05.2017;2017;05;14;Sunnuntai;66;39;105;18;28;46
292;21.05.2017;2017;05;15;Sunnuntai;50;40;90;15;24;39
292;21.05.2017;2017;05;16;Sunnuntai;68;55;123;27;41;68
292;21.05.2017;2017;05;17;Sunnuntai;36;53;89;11;25;36
292;21.05.2017;2017;05;18;Sunnuntai;35;29;64;21;18;39
292;21.05.2017;2017;05;19;Sunnuntai;41;31;72;8;19;27
292;21.05.2017;2017;05;20;Sunnuntai;29;24;53;15;16;31
292;21.05.2017;2017;05;21;Sunnuntai;9;12;21;9;6;15
292;21.05.2017;2017;05;22;Sunnuntai;1;6;7;4;4;8
292;21.05.2017;2017;05;23;Sunnuntai;0;2;2;0;2;2
292;22.05.2017;2017;05;00;Maanantai;0;0;0;0;1;1
292;22.05.2017;2017;05;01;Maanantai;0;1;1;0;0;0
292;22.05.2017;2017;05;02;Maanantai;1;0;1;0;1;1
292;22.05.2017;2017;05;03;Maanantai;0;0;0;1;0;1
292;22.05.2017;2017;05;04;Maanantai;3;2;5;0;0;0
292;22.05.2017;2017;05;05;Maanantai;6;5;11;1;0;1
292;22.05.2017;2017;05;06;Maanantai;22;15;37;2;13;15
292;22.05.2017;2017;05;07;Maanantai;68;34;102;12;16;28
292;22.05.2017;2017;05;08;Maanantai;47;23;70;13;14;27
292;22.05.2017;2017;05;09;Maanantai;66;28;94;8;19;27
292;22.05.2017;2017;05;10;Maanantai;47;20;67;12;13;25
292;22.05.2017;2017;05;11;Maanantai;39;26;65;14;6;20
292;22.05.2017;2017;05;12;Maanantai;57;32;89;9;20;29
292;22.05.2017;2017;05;13;Maanantai;42;58;100;16;25;41
292;22.05.2017;2017;05;14;Maanantai;42;70;112;14;30;44
292;22.05.2017;2017;05;15;Maanantai;57;77;134;18;43;61
292;22.05.2017;2017;05;16;Maanantai;65;60;125;16;35;51
292;22.05.2017;2017;05;17;Maanantai;66;51;117;24;30;54
292;22.05.2017;2017;05;18;Maanantai;56;49;105;24;31;55
292;22.05.2017;2017;05;19;Maanantai;41;41;82;27;34;61
292;22.05.2017;2017;05;20;Maanantai;32;24;56;12;22;34
292;22.05.2017;2017;05;21;Maanantai;21;13;34;3;4;7
292;22.05.2017;2017;05;22;Maanantai;4;2;6;1;3;4
292;22.05.2017;2017;05;23;Maanantai;1;0;1;1;1;2
292;23.05.2017;2017;05;00;Tiistai;2;2;4;0;0;0
292;23.05.2017;2017;05;01;Tiistai;0;1;1;0;0;0
292;23.05.2017;2017;05;02;Tiistai;0;2;2;0;0;0
292;23.05.2017;2017;05;03;Tiistai;2;1;3;0;0;0
292;23.05.2017;2017;05;04;Tiistai;3;1;4;0;0;0
292;23.05.2017;2017;05;05;Tiistai;10;8;18;1;1;2
292;23.05.2017;2017;05;06;Tiistai;29;16;45;0;2;2
292;23.05.2017;2017;05;07;Tiistai;78;28;106;8;18;26
292;23.05.2017;2017;05;08;Tiistai;75;26;101;25;23;48
292;23.05.2017;2017;05;09;Tiistai;40;32;72;3;25;28
292;23.05.2017;2017;05;10;Tiistai;43;9;52;9;12;21
292;23.05.2017;2017;05;11;Tiistai;30;26;56;13;13;26
292;23.05.2017;2017;05;12;Tiistai;34;21;55;9;22;31
292;23.05.2017;2017;05;13;Tiistai;62;45;107;15;29;44
292;23.05.2017;2017;05;14;Tiistai;43;70;113;15;29;44
292;23.05.2017;2017;05;15;Tiistai;58;64;122;20;41;61
292;23.05.2017;2017;05;16;Tiistai;68;51;119;20;43;63
292;23.05.2017;2017;05;17;Tiistai;70;50;120;21;19;40
292;23.05.2017;2017;05;18;Tiistai;49;41;90;22;38;60
292;23.05.2017;2017;05;19;Tiistai;57;36;93;25;27;52
292;23.05.2017;2017;05;20;Tiistai;23;33;56;17;32;49
292;23.05.2017;2017;05;21;Tiistai;12;18;30;4;10;14
292;23.05.2017;2017;05;22;Tiistai;11;7;18;0;4;4
292;23.05.2017;2017;05;23;Tiistai;0;0;0;4;2;6
292;24.05.2017;2017;05;00;Keskiviikko;0;1;1;0;2;2
292;24.05.2017;2017;05;01;Keskiviikko;0;0;0;0;1;1
292;24.05.2017;2017;05;02;Keskiviikko;0;0;0;0;0;0
292;24.05.2017;2017;05;03;Keskiviikko;3;1;4;0;0;0
292;24.05.2017;2017;05;04;Keskiviikko;3;3;6;0;1;1
292;24.05.2017;2017;05;05;Keskiviikko;8;7;15;2;0;2
292;24.05.2017;2017;05;06;Keskiviikko;25;12;37;3;11;14
292;24.05.2017;2017;05;07;Keskiviikko;75;39;114;17;23;40
292;24.05.2017;2017;05;08;Keskiviikko;118;24;142;9;16;25
292;24.05.2017;2017;05;09;Keskiviikko;70;23;93;11;20;31
292;24.05.2017;2017;05;10;Keskiviikko;33;42;75;11;26;37
292;24.05.2017;2017;05;11;Keskiviikko;54;42;96;24;11;35
292;24.05.2017;2017;05;12;Keskiviikko;37;40;77;11;19;30
292;24.05.2017;2017;05;13;Keskiviikko;48;83;131;10;44;54
292;24.05.2017;2017;05;14;Keskiviikko;53;114;167;23;62;85
292;24.05.2017;2017;05;15;Keskiviikko;68;49;117;18;32;50
292;24.05.2017;2017;05;16;Keskiviikko;67;61;128;18;34;52
292;24.05.2017;2017;05;17;Keskiviikko;75;37;112;17;23;40
292;24.05.2017;2017;05;18;Keskiviikko;64;66;130;22;25;47
292;24.05.2017;2017;05;19;Keskiviikko;55;42;97;26;24;50
292;24.05.2017;2017;05;20;Keskiviikko;40;36;76;22;34;56
292;24.05.2017;2017;05;21;Keskiviikko;24;13;37;8;14;22
292;24.05.2017;2017;05;22;Keskiviikko;10;13;23;11;14;25
292;24.05.2017;2017;05;23;Keskiviikko;9;7;16;7;2;9
292;25.05.2017;2017;05;00;Torstai;5;3;8;5;1;6
292;25.05.2017;2017;05;01;Torstai;1;4;5;2;3;5
292;25.05.2017;2017;05;02;Torstai;3;13;16;1;3;4
292;25.05.2017;2017;05;03;Torstai;0;5;5;1;2;3
292;25.05.2017;2017;05;04;Torstai;0;0;0;0;0;0
292;25.05.2017;2017;05;05;Torstai;0;1;1;2;1;3
292;25.05.2017;2017;05;06;Torstai;6;5;11;4;2;6
292;25.05.2017;2017;05;07;Torstai;7;9;16;2;5;7
292;25.05.2017;2017;05;08;Torstai;12;7;19;4;5;9
292;25.05.2017;2017;05;09;Torstai;25;13;38;5;1;6
292;25.05.2017;2017;05;10;Torstai;23;18;41;5;14;19
292;25.05.2017;2017;05;11;Torstai;30;21;51;8;4;12
292;25.05.2017;2017;05;12;Torstai;45;32;77;5;5;10
292;25.05.2017;2017;05;13;Torstai;34;21;55;4;4;8
292;25.05.2017;2017;05;14;Torstai;31;26;57;7;6;13
292;25.05.2017;2017;05;15;Torstai;37;34;71;6;10;16
292;25.05.2017;2017;05;16;Torstai;36;42;78;15;22;37
292;25.05.2017;2017;05;17;Torstai;67;29;96;15;27;42
292;25.05.2017;2017;05;18;Torstai;52;41;93;12;23;35
292;25.05.2017;2017;05;19;Torstai;42;32;74;26;19;45
292;25.05.2017;2017;05;20;Torstai;28;18;46;5;15;20
292;25.05.2017;2017;05;21;Torstai;16;13;29;4;9;13
292;25.05.2017;2017;05;22;Torstai;4;4;8;1;2;3
292;25.05.2017;2017;05;23;Torstai;1;1;2;0;1;1
292;26.05.2017;2017;05;00;Perjantai;1;2;3;0;0;0
292;26.05.2017;2017;05;01;Perjantai;1;4;5;1;1;2
292;26.05.2017;2017;05;02;Perjantai;0;0;0;0;0;0
292;26.05.2017;2017;05;03;Perjantai;1;1;2;0;0;0
292;26.05.2017;2017;05;04;Perjantai;4;3;7;0;0;0
292;26.05.2017;2017;05;05;Perjantai;6;4;10;0;0;0
292;26.05.2017;2017;05;06;Perjantai;20;10;30;2;6;8
292;26.05.2017;2017;05;07;Perjantai;59;16;75;6;13;19
292;26.05.2017;2017;05;08;Perjantai;58;14;72;10;21;31
292;26.05.2017;2017;05;09;Perjantai;48;17;65;8;14;22
292;26.05.2017;2017;05;10;Perjantai;43;30;73;5;11;16
292;26.05.2017;2017;05;11;Perjantai;31;19;50;11;8;19
292;26.05.2017;2017;05;12;Perjantai;39;48;87;15;18;33
292;26.05.2017;2017;05;13;Perjantai;37;56;93;7;21;28
292;26.05.2017;2017;05;14;Perjantai;38;54;92;13;24;37
292;26.05.2017;2017;05;15;Perjantai;54;53;107;15;17;32
292;26.05.2017;2017;05;16;Perjantai;32;29;61;17;19;36
292;26.05.2017;2017;05;17;Perjantai;37;36;73;15;17;32
292;26.05.2017;2017;05;18;Perjantai;47;23;70;12;29;41
292;26.05.2017;2017;05;19;Perjantai;37;25;62;17;23;40
292;26.05.2017;2017;05;20;Perjantai;28;25;53;15;13;28
292;26.05.2017;2017;05;21;Perjantai;15;14;29;3;14;17
292;26.05.2017;2017;05;22;Perjantai;6;7;13;7;6;13
292;26.05.2017;2017;05;23;Perjantai;5;3;8;5;0;5
292;27.05.2017;2017;05;00;Lauantai;12;0;12;6;1;7
292;27.05.2017;2017;05;01;Lauantai;8;2;10;13;5;18
292;27.05.2017;2017;05;02;Lauantai;1;12;13;3;10;13
292;27.05.2017;2017;05;03;Lauantai;4;4;8;2;4;6
292;27.05.2017;2017;05;04;Lauantai;2;0;2;0;0;0
292;27.05.2017;2017;05;05;Lauantai;0;1;1;1;0;1
292;27.05.2017;2017;05;06;Lauantai;7;2;9;3;3;6
292;27.05.2017;2017;05;07;Lauantai;5;4;9;2;3;5
292;27.05.2017;2017;05;08;Lauantai;16;7;23;6;3;9
292;27.05.2017;2017;05;09;Lauantai;16;9;25;3;4;7
292;27.05.2017;2017;05;10;Lauantai;17;10;27;7;5;12
292;27.05.2017;2017;05;11;Lauantai;24;17;41;9;3;12
292;27.05.2017;2017;05;12;Lauantai;39;24;63;7;6;13
292;27.05.2017;2017;05;13;Lauantai;43;33;76;6;7;13
292;27.05.2017;2017;05;14;Lauantai;40;27;67;9;6;15
292;27.05.2017;2017;05;15;Lauantai;31;26;57;4;7;11
292;27.05.2017;2017;05;16;Lauantai;21;14;35;7;12;19
292;27.05.2017;2017;05;17;Lauantai;21;15;36;9;6;15
292;27.05.2017;2017;05;18;Lauantai;19;10;29;16;13;29
292;27.05.2017;2017;05;19;Lauantai;32;19;51;18;12;30
292;27.05.2017;2017;05;20;Lauantai;19;15;34;7;6;13
292;27.05.2017;2017;05;21;Lauantai;6;8;14;5;6;11
292;27.05.2017;2017;05;22;Lauantai;6;7;13;3;5;8
292;27.05.2017;2017;05;23;Lauantai;6;6;12;0;10;10
292;28.05.2017;2017;05;00;Sunnuntai;1;2;3;2;2;4
292;28.05.2017;2017;05;01;Sunnuntai;4;3;7;1;0;1
292;28.05.2017;2017;05;02;Sunnuntai;3;2;5;0;4;4
292;28.05.2017;2017;05;03;Sunnuntai;1;2;3;0;0;0
292;28.05.2017;2017;05;04;Sunnuntai;0;1;1;0;0;0
292;28.05.2017;2017;05;05;Sunnuntai;1;0;1;2;0;2
292;28.05.2017;2017;05;06;Sunnuntai;7;2;9;3;2;5
292;28.05.2017;2017;05;07;Sunnuntai;6;4;10;5;2;7
292;28.05.2017;2017;05;08;Sunnuntai;4;4;8;3;3;6
292;28.05.2017;2017;05;09;Sunnuntai;14;5;19;6;4;10
292;28.05.2017;2017;05;10;Sunnuntai;12;8;20;3;5;8
292;28.05.2017;2017;05;11;Sunnuntai;5;5;10;1;4;5
292;28.05.2017;2017;05;12;Sunnuntai;5;7;12;4;3;7
292;28.05.2017;2017;05;13;Sunnuntai;6;3;9;1;2;3
292;28.05.2017;2017;05;14;Sunnuntai;13;9;22;10;7;17
292;28.05.2017;2017;05;15;Sunnuntai;8;18;26;4;5;9
292;28.05.2017;2017;05;16;Sunnuntai;12;11;23;11;9;20
292;28.05.2017;2017;05;17;Sunnuntai;14;11;25;11;2;13
292;28.05.2017;2017;05;18;Sunnuntai;17;14;31;10;14;24
292;28.05.2017;2017;05;19;Sunnuntai;9;10;19;6;8;14
292;28.05.2017;2017;05;20;Sunnuntai;22;12;34;7;9;16
292;28.05.2017;2017;05;21;Sunnuntai;10;4;14;4;1;5
292;28.05.2017;2017;05;22;Sunnuntai;1;1;2;1;0;1
292;28.05.2017;2017;05;23;Sunnuntai;3;1;4;1;1;2
292;29.05.2017;2017;05;00;Maanantai;0;1;1;1;0;1
292;29.05.2017;2017;05;01;Maanantai;0;1;1;0;1;1
292;29.05.2017;2017;05;02;Maanantai;0;0;0;0;0;0
292;29.05.2017;2017;05;03;Maanantai;0;1;1;0;0;0
292;29.05.2017;2017;05;04;Maanantai;3;1;4;0;0;0
292;29.05.2017;2017;05;05;Maanantai;10;8;18;0;5;5
292;29.05.2017;2017;05;06;Maanantai;19;20;39;2;7;9
292;29.05.2017;2017;05;07;Maanantai;67;28;95;11;10;21
292;29.05.2017;2017;05;08;Maanantai;51;29;80;9;13;22
292;29.05.2017;2017;05;09;Maanantai;39;19;58;10;9;19
292;29.05.2017;2017;05;10;Maanantai;47;26;73;5;19;24
292;29.05.2017;2017;05;11;Maanantai;29;23;52;11;6;17
292;29.05.2017;2017;05;12;Maanantai;33;26;59;14;16;30
292;29.05.2017;2017;05;13;Maanantai;34;42;76;15;32;47
292;29.05.2017;2017;05;14;Maanantai;44;49;93;7;20;27
292;29.05.2017;2017;05;15;Maanantai;41;52;93;12;39;51
292;29.05.2017;2017;05;16;Maanantai;70;49;119;22;32;54
292;29.05.2017;2017;05;17;Maanantai;60;47;107;23;26;49
292;29.05.2017;2017;05;18;Maanantai;42;44;86;20;25;45
292;29.05.2017;2017;05;19;Maanantai;31;20;51;18;23;41
292;29.05.2017;2017;05;20;Maanantai;31;37;68;18;16;34
292;29.05.2017;2017;05;21;Maanantai;12;14;26;8;8;16
292;29.05.2017;2017;05;22;Maanantai;3;3;6;1;4;5
292;29.05.2017;2017;05;23;Maanantai;3;0;3;0;4;4
292;30.05.2017;2017;05;00;Tiistai;0;1;1;0;1;1
292;30.05.2017;2017;05;01;Tiistai;1;1;2;0;2;2
292;30.05.2017;2017;05;02;Tiistai;1;0;1;0;0;0
292;30.05.2017;2017;05;03;Tiistai;1;0;1;3;0;3
292;30.05.2017;2017;05;04;Tiistai;4;0;4;0;0;0
292;30.05.2017;2017;05;05;Tiistai;14;3;17;2;1;3
292;30.05.2017;2017;05;06;Tiistai;23;14;37;3;3;6
292;30.05.2017;2017;05;07;Tiistai;56;39;95;5;13;18
292;30.05.2017;2017;05;08;Tiistai;84;32;116;11;10;21
292;30.05.2017;2017;05;09;Tiistai;51;44;95;14;25;39
292;30.05.2017;2017;05;10;Tiistai;22;23;45;17;17;34
292;30.05.2017;2017;05;11;Tiistai;40;21;61;12;6;18
292;30.05.2017;2017;05;12;Tiistai;54;46;100;12;7;19
292;30.05.2017;2017;05;13;Tiistai;36;77;113;17;44;61
292;30.05.2017;2017;05;14;Tiistai;59;40;99;11;29;40
292;30.05.2017;2017;05;15;Tiistai;63;50;113;13;37;50
292;30.05.2017;2017;05;16;Tiistai;81;58;139;17;39;56
292;30.05.2017;2017;05;17;Tiistai;90;29;119;17;21;38
292;30.05.2017;2017;05;18;Tiistai;49;46;95;17;33;50
292;30.05.2017;2017;05;19;Tiistai;41;47;88;25;31;56
292;30.05.2017;2017;05;20;Tiistai;27;39;66;12;23;35
292;30.05.2017;2017;05;21;Tiistai;9;14;23;4;11;15
292;30.05.2017;2017;05;22;Tiistai;7;6;13;2;2;4
292;30.05.2017;2017;05;23;Tiistai;0;6;6;2;1;3
292;31.05.2017;2017;05;00;Keskiviikko;1;0;1;2;1;3
292;31.05.2017;2017;05;01;Keskiviikko;1;4;5;0;0;0
292;31.05.2017;2017;05;02;Keskiviikko;0;0;0;0;0;0
292;31.05.2017;2017;05;03;Keskiviikko;0;0;0;0;0;0
292;31.05.2017;2017;05;04;Keskiviikko;3;2;5;0;0;0
292;31.05.2017;2017;05;05;Keskiviikko;7;8;15;0;0;0
292;31.05.2017;2017;05;06;Keskiviikko;25;16;41;2;1;3
292;31.05.2017;2017;05;07;Keskiviikko;54;31;85;3;5;8
292;31.05.2017;2017;05;08;Keskiviikko;63;31;94;18;10;28
292;31.05.2017;2017;05;09;Keskiviikko;32;21;53;10;12;22
292;31.05.2017;2017;05;10;Keskiviikko;19;22;41;3;8;11
292;31.05.2017;2017;05;11;Keskiviikko;15;16;31;7;10;17
292;31.05.2017;2017;05;12;Keskiviikko;18;27;45;11;12;23
292;31.05.2017;2017;05;13;Keskiviikko;29;57;86;7;15;22
292;31.05.2017;2017;05;14;Keskiviikko;40;38;78;13;17;30
292;31.05.2017;2017;05;15;Keskiviikko;45;42;87;16;22;38
292;31.05.2017;2017;05;16;Keskiviikko;47;41;88;13;27;40
292;31.05.2017;2017;05;17;Keskiviikko;49;20;69;15;21;36
292;31.05.2017;2017;05;18;Keskiviikko;35;38;73;21;23;44
292;31.05.2017;2017;05;19;Keskiviikko;42;33;75;14;15;29
292;31.05.2017;2017;05;20;Keskiviikko;25;15;40;8;18;26
292;31.05.2017;2017;05;21;Keskiviikko;5;7;12;6;4;10
292;31.05.2017;2017;05;22;Keskiviikko;2;4;6;0;1;1
292;31.05.2017;2017;05;23;Keskiviikko;2;0;2;1;0;1
292;01.06.2017;2017;06;00;Torstai;0;0;0;0;0;0
292;01.06.2017;2017;06;01;Torstai;4;1;5;0;0;0
292;01.06.2017;2017;06;02;Torstai;0;3;3;0;1;1
292;01.06.2017;2017;06;03;Torstai;0;1;1;0;2;2
292;01.06.2017;2017;06;04;Torstai;5;1;6;0;0;0
292;01.06.2017;2017;06;05;Torstai;9;6;15;1;1;2
292;01.06.2017;2017;06;06;Torstai;30;19;49;2;6;8
292;01.06.2017;2017;06;07;Torstai;55;27;82;8;14;22
292;01.06.2017;2017;06;08;Torstai;65;28;93;11;15;26
292;01.06.2017;2017;06;09;Torstai;41;18;59;6;7;13
292;01.06.2017;2017;06;10;Torstai;39;30;69;10;7;17
292;01.06.2017;2017;06;11;Torstai;38;29;67;10;7;17
292;01.06.2017;2017;06;12;Torstai;22;24;46;10;12;22
292;01.06.2017;2017;06;13;Torstai;33;42;75;8;21;29
292;01.06.2017;2017;06;14;Torstai;29;22;51;6;7;13
292;01.06.2017;2017;06;15;Torstai;40;34;74;12;24;36
292;01.06.2017;2017;06;16;Torstai;37;29;66;8;9;17
292;01.06.2017;2017;06;17;Torstai;31;25;56;3;13;16
292;01.06.2017;2017;06;18;Torstai;23;22;45;14;17;31
292;01.06.2017;2017;06;19;Torstai;20;16;36;13;17;30
292;01.06.2017;2017;06;20;Torstai;13;11;24;8;4;12
292;01.06.2017;2017;06;21;Torstai;8;4;12;3;4;7
292;01.06.2017;2017;06;22;Torstai;7;3;10;1;2;3
292;01.06.2017;2017;06;23;Torstai;1;1;2;1;0;1
292;02.06.2017;2017;06;00;Perjantai;0;2;2;0;4;4
292;02.06.2017;2017;06;01;Perjantai;0;1;1;0;1;1
292;02.06.2017;2017;06;02;Perjantai;0;0;0;0;0;0
292;02.06.2017;2017;06;03;Perjantai;0;0;0;0;0;0
292;02.06.2017;2017;06;04;Perjantai;2;2;4;0;0;0
292;02.06.2017;2017;06;05;Perjantai;6;6;12;0;1;1
292;02.06.2017;2017;06;06;Perjantai;9;7;16;2;1;3
292;02.06.2017;2017;06;07;Perjantai;18;15;33;2;8;10
292;02.06.2017;2017;06;08;Perjantai;36;11;47;10;13;23
292;02.06.2017;2017;06;09;Perjantai;51;25;76;7;9;16
292;02.06.2017;2017;06;10;Perjantai;18;8;26;7;11;18
292;02.06.2017;2017;06;11;Perjantai;18;37;55;5;19;24
292;02.06.2017;2017;06;12;Perjantai;30;37;67;8;23;31
292;02.06.2017;2017;06;13;Perjantai;31;27;58;8;9;17
292;02.06.2017;2017;06;14;Perjantai;28;24;52;5;9;14
292;02.06.2017;2017;06;15;Perjantai;30;24;54;6;10;16
292;02.06.2017;2017;06;16;Perjantai;33;28;61;16;16;32
292;02.06.2017;2017;06;17;Perjantai;21;18;39;5;11;16
292;02.06.2017;2017;06;18;Perjantai;23;17;40;9;10;19
292;02.06.2017;2017;06;19;Perjantai;21;13;34;4;11;15
292;02.06.2017;2017;06;20;Perjantai;10;7;17;13;7;20
292;02.06.2017;2017;06;21;Perjantai;5;6;11;5;7;12
292;02.06.2017;2017;06;22;Perjantai;7;1;8;1;1;2
292;02.06.2017;2017;06;23;Perjantai;1;3;4;3;5;8
292;03.06.2017;2017;06;00;Lauantai;4;4;8;3;2;5
292;03.06.2017;2017;06;01;Lauantai;0;5;5;2;3;5
292;03.06.2017;2017;06;02;Lauantai;1;2;3;0;3;3
292;03.06.2017;2017;06;03;Lauantai;0;1;1;2;1;3
292;03.06.2017;2017;06;04;Lauantai;0;0;0;0;2;2
292;03.06.2017;2017;06;05;Lauantai;1;0;1;0;2;2
292;03.06.2017;2017;06;06;Lauantai;7;2;9;0;1;1
292;03.06.2017;2017;06;07;Lauantai;22;10;32;1;3;4
292;03.06.2017;2017;06;08;Lauantai;10;11;21;4;7;11
292;03.06.2017;2017;06;09;Lauantai;18;20;38;7;5;12
292;03.06.2017;2017;06;10;Lauantai;32;15;47;10;8;18
292;03.06.2017;2017;06;11;Lauantai;17;29;46;8;12;20
292;03.06.2017;2017;06;12;Lauantai;29;14;43;13;13;26
292;03.06.2017;2017;06;13;Lauantai;21;22;43;8;13;21
292;03.06.2017;2017;06;14;Lauantai;32;22;54;10;8;18
292;03.06.2017;2017;06;15;Lauantai;34;21;55;12;11;23
292;03.06.2017;2017;06;16;Lauantai;26;27;53;13;9;22
292;03.06.2017;2017;06;17;Lauantai;25;16;41;9;5;14
292;03.06.2017;2017;06;18;Lauantai;18;24;42;20;10;30
292;03.06.2017;2017;06;19;Lauantai;16;14;30;14;9;23
292;03.06.2017;2017;06;20;Lauantai;20;29;49;2;11;13
292;03.06.2017;2017;06;21;Lauantai;11;8;19;4;8;12
292;03.06.2017;2017;06;22;Lauantai;5;4;9;3;10;13
292;03.06.2017;2017;06;23;Lauantai;6;2;8;11;10;21
292;04.06.2017;2017;06;00;Sunnuntai;2;4;6;2;3;5
292;04.06.2017;2017;06;01;Sunnuntai;0;2;2;4;4;8
292;04.06.2017;2017;06;02;Sunnuntai;2;6;8;3;5;8
292;04.06.2017;2017;06;03;Sunnuntai;4;1;5;0;1;1
292;04.06.2017;2017;06;04;Sunnuntai;0;1;1;0;2;2
292;04.06.2017;2017;06;05;Sunnuntai;3;1;4;8;1;9
292;04.06.2017;2017;06;06;Sunnuntai;3;3;6;1;0;1
292;04.06.2017;2017;06;07;Sunnuntai;3;2;5;1;3;4
292;04.06.2017;2017;06;08;Sunnuntai;8;8;16;7;9;16
292;04.06.2017;2017;06;09;Sunnuntai;21;5;26;8;8;16
292;04.06.2017;2017;06;10;Sunnuntai;34;12;46;10;10;20
292;04.06.2017;2017;06;11;Sunnuntai;32;26;58;7;8;15
292;04.06.2017;2017;06;12;Sunnuntai;28;38;66;6;16;22
292;04.06.2017;2017;06;13;Sunnuntai;36;42;78;17;20;37
292;04.06.2017;2017;06;14;Sunnuntai;44;29;73;17;24;41
292;04.06.2017;2017;06;15;Sunnuntai;35;24;59;17;7;24
292;04.06.2017;2017;06;16;Sunnuntai;48;37;85;17;6;23
292;04.06.2017;2017;06;17;Sunnuntai;23;21;44;8;19;27
292;04.06.2017;2017;06;18;Sunnuntai;31;36;67;17;9;26
292;04.06.2017;2017;06;19;Sunnuntai;32;35;67;15;12;27
292;04.06.2017;2017;06;20;Sunnuntai;13;11;24;11;11;22
292;04.06.2017;2017;06;21;Sunnuntai;13;13;26;5;8;13
292;04.06.2017;2017;06;22;Sunnuntai;4;5;9;6;7;13
292;04.06.2017;2017;06;23;Sunnuntai;3;2;5;0;2;2
292;05.06.2017;2017;06;00;Maanantai;2;1;3;2;1;3
292;05.06.2017;2017;06;01;Maanantai;1;2;3;2;5;7
292;05.06.2017;2017;06;02;Maanantai;0;2;2;3;0;3
292;05.06.2017;2017;06;03;Maanantai;0;0;0;0;0;0
292;05.06.2017;2017;06;04;Maanantai;3;1;4;0;0;0
292;05.06.2017;2017;06;05;Maanantai;7;4;11;0;0;0
292;05.06.2017;2017;06;06;Maanantai;24;17;41;6;5;11
292;05.06.2017;2017;06;07;Maanantai;42;20;62;5;12;17
292;05.06.2017;2017;06;08;Maanantai;40;17;57;4;16;20
292;05.06.2017;2017;06;09;Maanantai;33;20;53;6;15;21
292;05.06.2017;2017;06;10;Maanantai;36;31;67;8;7;15
292;05.06.2017;2017;06;11;Maanantai;46;39;85;20;11;31
292;05.06.2017;2017;06;12;Maanantai;44;46;90;16;33;49
292;05.06.2017;2017;06;13;Maanantai;65;53;118;8;18;26
292;05.06.2017;2017;06;14;Maanantai;57;50;107;13;6;19
292;05.06.2017;2017;06;15;Maanantai;59;58;117;13;5;18
292;05.06.2017;2017;06;16;Maanantai;74;51;125;9;14;23
292;05.06.2017;2017;06;17;Maanantai;49;49;98;21;17;38
292;05.06.2017;2017;06;18;Maanantai;32;38;70;28;27;55
292;05.06.2017;2017;06;19;Maanantai;33;38;71;20;18;38
292;05.06.2017;2017;06;20;Maanantai;30;19;49;14;17;31
292;05.06.2017;2017;06;21;Maanantai;18;19;37;8;15;23
292;05.06.2017;2017;06;22;Maanantai;7;5;12;1;4;5
292;05.06.2017;2017;06;23;Maanantai;2;6;8;3;1;4
292;06.06.2017;2017;06;00;Tiistai;1;2;3;2;1;3
292;06.06.2017;2017;06;01;Tiistai;1;3;4;1;1;2
292;06.06.2017;2017;06;02;Tiistai;0;2;2;0;0;0
292;06.06.2017;2017;06;03;Tiistai;0;0;0;1;0;1
292;06.06.2017;2017;06;04;Tiistai;3;1;4;0;1;1
292;06.06.2017;2017;06;05;Tiistai;5;1;6;3;4;7
292;06.06.2017;2017;06;06;Tiistai;19;10;29;0;7;7
292;06.06.2017;2017;06;07;Tiistai;39;16;55;4;11;15
292;06.06.2017;2017;06;08;Tiistai;25;18;43;4;11;15
292;06.06.2017;2017;06;09;Tiistai;19;16;35;4;6;10
292;06.06.2017;2017;06;10;Tiistai;28;21;49;4;7;11
292;06.06.2017;2017;06;11;Tiistai;30;26;56;7;12;19
292;06.06.2017;2017;06;12;Tiistai;35;37;72;4;6;10
292;06.06.2017;2017;06;13;Tiistai;42;35;77;8;10;18
292;06.06.2017;2017;06;14;Tiistai;39;46;85;20;17;37
292;06.06.2017;2017;06;15;Tiistai;72;66;138;21;29;50
292;06.06.2017;2017;06;16;Tiistai;72;48;120;17;31;48
292;06.06.2017;2017;06;17;Tiistai;76;50;126;29;31;60
292;06.06.2017;2017;06;18;Tiistai;61;52;113;14;35;49
292;06.06.2017;2017;06;19;Tiistai;62;64;126;23;26;49
292;06.06.2017;2017;06;20;Tiistai;32;37;69;17;38;55
292;06.06.2017;2017;06;21;Tiistai;27;13;40;13;14;27
292;06.06.2017;2017;06;22;Tiistai;8;10;18;4;4;8
292;06.06.2017;2017;06;23;Tiistai;6;11;17;3;2;5
292;07.06.2017;2017;06;00;Keskiviikko;2;7;9;1;6;7
292;07.06.2017;2017;06;01;Keskiviikko;4;2;6;2;1;3
292;07.06.2017;2017;06;02;Keskiviikko;0;0;0;0;0;0
292;07.06.2017;2017;06;03;Keskiviikko;1;1;2;2;1;3
292;07.06.2017;2017;06;04;Keskiviikko;2;1;3;1;2;3
292;07.06.2017;2017;06;05;Keskiviikko;8;6;14;0;2;2
292;07.06.2017;2017;06;06;Keskiviikko;30;19;49;2;4;6
292;07.06.2017;2017;06;07;Keskiviikko;53;23;76;6;11;17
292;07.06.2017;2017;06;08;Keskiviikko;38;20;58;5;16;21
292;07.06.2017;2017;06;09;Keskiviikko;44;24;68;20;6;26
292;07.06.2017;2017;06;10;Keskiviikko;31;32;63;5;10;15
292;07.06.2017;2017;06;11;Keskiviikko;52;41;93;8;18;26
292;07.06.2017;2017;06;12;Keskiviikko;70;49;119;21;28;49
292;07.06.2017;2017;06;13;Keskiviikko;58;56;114;16;31;47
292;07.06.2017;2017;06;14;Keskiviikko;53;48;101;16;32;48
292;07.06.2017;2017;06;15;Keskiviikko;72;48;120;39;54;93
292;07.06.2017;2017;06;16;Keskiviikko;93;73;166;17;36;53
292;07.06.2017;2017;06;17;Keskiviikko;69;48;117;15;33;48
292;07.06.2017;2017;06;18;Keskiviikko;43;65;108;17;35;52
292;07.06.2017;2017;06;19;Keskiviikko;67;42;109;23;55;78
292;07.06.2017;2017;06;20;Keskiviikko;56;31;87;17;17;34
292;07.06.2017;2017;06;21;Keskiviikko;17;23;40;11;10;21
292;07.06.2017;2017;06;22;Keskiviikko;17;10;27;8;4;12
292;07.06.2017;2017;06;23;Keskiviikko;2;8;10;0;8;8
292;08.06.2017;2017;06;00;Torstai;4;8;12;2;2;4
292;08.06.2017;2017;06;01;Torstai;2;2;4;0;1;1
292;08.06.2017;2017;06;02;Torstai;4;5;9;2;2;4
292;08.06.2017;2017;06;03;Torstai;0;1;1;2;0;2
292;08.06.2017;2017;06;04;Torstai;4;1;5;1;1;2
292;08.06.2017;2017;06;05;Torstai;8;4;12;1;3;4
292;08.06.2017;2017;06;06;Torstai;31;18;49;2;9;11
292;08.06.2017;2017;06;07;Torstai;43;25;68;6;0;6
292;08.06.2017;2017;06;08;Torstai;40;27;67;15;8;23
292;08.06.2017;2017;06;09;Torstai;34;27;61;6;3;9
292;08.06.2017;2017;06;10;Torstai;42;37;79;3;8;11
292;08.06.2017;2017;06;11;Torstai;54;29;83;11;16;27
292;08.06.2017;2017;06;12;Torstai;52;55;107;10;33;43
292;08.06.2017;2017;06;13;Torstai;64;35;99;11;29;40
292;08.06.2017;2017;06;14;Torstai;71;46;117;8;40;48
292;08.06.2017;2017;06;15;Torstai;64;62;126;29;34;63
292;08.06.2017;2017;06;16;Torstai;72;71;143;17;37;54
292;08.06.2017;2017;06;17;Torstai;66;40;106;20;39;59
292;08.06.2017;2017;06;18;Torstai;55;54;109;29;33;62
292;08.06.2017;2017;06;19;Torstai;68;44;112;21;36;57
292;08.06.2017;2017;06;20;Torstai;42;37;79;12;30;42
292;08.06.2017;2017;06;21;Torstai;18;14;32;12;12;24
292;08.06.2017;2017;06;22;Torstai;12;7;19;4;4;8
292;08.06.2017;2017;06;23;Torstai;4;7;11;2;3;5
292;09.06.2017;2017;06;00;Perjantai;9;6;15;0;2;2
292;09.06.2017;2017;06;01;Perjantai;3;4;7;2;4;6
292;09.06.2017;2017;06;02;Perjantai;0;0;0;0;1;1
292;09.06.2017;2017;06;03;Perjantai;2;1;3;0;1;1
292;09.06.2017;2017;06;04;Perjantai;1;0;1;0;0;0
292;09.06.2017;2017;06;05;Perjantai;7;3;10;0;2;2
292;09.06.2017;2017;06;06;Perjantai;25;18;43;0;6;6
292;09.06.2017;2017;06;07;Perjantai;34;17;51;5;10;15
292;09.06.2017;2017;06;08;Perjantai;27;23;50;5;3;8
292;09.06.2017;2017;06;09;Perjantai;17;16;33;7;12;19
292;09.06.2017;2017;06;10;Perjantai;33;23;56;7;12;19
292;09.06.2017;2017;06;11;Perjantai;45;33;78;13;20;33
292;09.06.2017;2017;06;12;Perjantai;43;35;78;19;34;53
292;09.06.2017;2017;06;13;Perjantai;51;44;95;7;22;29
292;09.06.2017;2017;06;14;Perjantai;56;45;101;20;35;55
292;09.06.2017;2017;06;15;Perjantai;59;43;102;17;38;55
292;09.06.2017;2017;06;16;Perjantai;57;39;96;10;34;44
292;09.06.2017;2017;06;17;Perjantai;45;44;89;16;29;45
292;09.06.2017;2017;06;18;Perjantai;59;33;92;26;22;48
292;09.06.2017;2017;06;19;Perjantai;50;34;84;10;20;30
292;09.06.2017;2017;06;20;Perjantai;33;29;62;14;28;42
292;09.06.2017;2017;06;21;Perjantai;25;23;48;15;15;30
292;09.06.2017;2017;06;22;Perjantai;8;11;19;11;8;19
292;09.06.2017;2017;06;23;Perjantai;12;11;23;4;5;9
292;10.06.2017;2017;06;00;Lauantai;13;8;21;8;5;13
292;10.06.2017;2017;06;01;Lauantai;4;4;8;5;2;7
292;10.06.2017;2017;06;02;Lauantai;1;6;7;4;12;16
292;10.06.2017;2017;06;03;Lauantai;4;4;8;1;8;9
292;10.06.2017;2017;06;04;Lauantai;0;1;1;3;1;4
292;10.06.2017;2017;06;05;Lauantai;2;0;2;0;0;0
292;10.06.2017;2017;06;06;Lauantai;6;5;11;5;6;11
292;10.06.2017;2017;06;07;Lauantai;5;5;10;2;0;2
292;10.06.2017;2017;06;08;Lauantai;19;16;35;4;2;6
292;10.06.2017;2017;06;09;Lauantai;20;27;47;3;9;12
292;10.06.2017;2017;06;10;Lauantai;26;23;49;7;3;10
292;10.06.2017;2017;06;11;Lauantai;33;34;67;12;12;24
292;10.06.2017;2017;06;12;Lauantai;76;39;115;12;37;49
292;10.06.2017;2017;06;13;Lauantai;62;48;110;16;23;39
292;10.06.2017;2017;06;14;Lauantai;57;40;97;22;33;55
292;10.06.2017;2017;06;15;Lauantai;75;43;118;12;25;37
292;10.06.2017;2017;06;16;Lauantai;98;47;145;15;32;47
292;10.06.2017;2017;06;17;Lauantai;49;29;78;18;26;44
292;10.06.2017;2017;06;18;Lauantai;34;33;67;16;22;38
292;10.06.2017;2017;06;19;Lauantai;26;58;84;16;45;61
292;10.06.2017;2017;06;20;Lauantai;21;11;32;5;23;28
292;10.06.2017;2017;06;21;Lauantai;12;18;30;0;13;13
292;10.06.2017;2017;06;22;Lauantai;13;10;23;6;3;9
292;10.06.2017;2017;06;23;Lauantai;5;5;10;3;6;9
292;11.06.2017;2017;06;00;Sunnuntai;7;4;11;7;5;12
292;11.06.2017;2017;06;01;Sunnuntai;1;6;7;2;3;5
292;11.06.2017;2017;06;02;Sunnuntai;4;7;11;4;11;15
292;11.06.2017;2017;06;03;Sunnuntai;0;6;6;0;4;4
292;11.06.2017;2017;06;04;Sunnuntai;3;1;4;4;0;4
292;11.06.2017;2017;06;05;Sunnuntai;1;1;2;0;2;2
292;11.06.2017;2017;06;06;Sunnuntai;6;5;11;1;1;2
292;11.06.2017;2017;06;07;Sunnuntai;5;4;9;0;0;0
292;11.06.2017;2017;06;08;Sunnuntai;14;9;23;4;4;8
292;11.06.2017;2017;06;09;Sunnuntai;16;17;33;7;9;16
292;11.06.2017;2017;06;10;Sunnuntai;34;35;69;5;21;26
292;11.06.2017;2017;06;11;Sunnuntai;35;36;71;13;18;31
292;11.06.2017;2017;06;12;Sunnuntai;62;45;107;15;31;46
292;11.06.2017;2017;06;13;Sunnuntai;61;37;98;7;25;32
292;11.06.2017;2017;06;14;Sunnuntai;60;40;100;28;35;63
292;11.06.2017;2017;06;15;Sunnuntai;52;35;87;11;23;34
292;11.06.2017;2017;06;16;Sunnuntai;74;39;113;24;15;39
292;11.06.2017;2017;06;17;Sunnuntai;43;41;84;16;23;39
292;11.06.2017;2017;06;18;Sunnuntai;53;20;73;15;28;43
292;11.06.2017;2017;06;19;Sunnuntai;47;35;82;11;25;36
292;11.06.2017;2017;06;20;Sunnuntai;25;23;48;14;16;30
292;11.06.2017;2017;06;21;Sunnuntai;23;13;36;12;11;23
292;11.06.2017;2017;06;22;Sunnuntai;8;6;14;1;6;7
292;11.06.2017;2017;06;23;Sunnuntai;2;6;8;1;5;6
292;12.06.2017;2017;06;00;Maanantai;2;3;5;0;1;1
292;12.06.2017;2017;06;01;Maanantai;0;0;0;0;1;1
292;12.06.2017;2017;06;02;Maanantai;4;4;8;0;0;0
292;12.06.2017;2017;06;03;Maanantai;1;1;2;1;1;2
292;12.06.2017;2017;06;04;Maanantai;3;3;6;0;0;0
292;12.06.2017;2017;06;05;Maanantai;6;5;11;1;5;6
292;12.06.2017;2017;06;06;Maanantai;13;11;24;6;9;15
292;12.06.2017;2017;06;07;Maanantai;26;17;43;4;10;14
292;12.06.2017;2017;06;08;Maanantai;14;12;26;5;2;7
292;12.06.2017;2017;06;09;Maanantai;11;7;18;1;3;4
292;12.06.2017;2017;06;10;Maanantai;8;11;19;2;9;11
292;12.06.2017;2017;06;11;Maanantai;21;12;33;4;6;10
292;12.06.2017;2017;06;12;Maanantai;25;18;43;2;15;17
292;12.06.2017;2017;06;13;Maanantai;25;21;46;11;16;27
292;12.06.2017;2017;06;14;Maanantai;41;28;69;11;13;24
292;12.06.2017;2017;06;15;Maanantai;57;35;92;14;26;40
292;12.06.2017;2017;06;16;Maanantai;64;44;108;9;27;36
292;12.06.2017;2017;06;17;Maanantai;51;39;90;19;19;38
292;12.06.2017;2017;06;18;Maanantai;49;39;88;15;21;36
292;12.06.2017;2017;06;19;Maanantai;25;32;57;14;22;36
292;12.06.2017;2017;06;20;Maanantai;38;18;56;25;21;46
292;12.06.2017;2017;06;21;Maanantai;21;11;32;10;18;28
292;12.06.2017;2017;06;22;Maanantai;3;8;11;2;9;11
292;12.06.2017;2017;06;23;Maanantai;1;3;4;5;1;6
292;13.06.2017;2017;06;00;Tiistai;3;0;3;2;2;4
292;13.06.2017;2017;06;01;Tiistai;0;3;3;0;1;1
292;13.06.2017;2017;06;02;Tiistai;0;2;2;0;0;0
292;13.06.2017;2017;06;03;Tiistai;0;0;0;0;1;1
292;13.06.2017;2017;06;04;Tiistai;2;0;2;0;1;1
292;13.06.2017;2017;06;05;Tiistai;9;7;16;1;2;3
292;13.06.2017;2017;06;06;Tiistai;25;16;41;1;3;4
292;13.06.2017;2017;06;07;Tiistai;42;30;72;5;3;8
292;13.06.2017;2017;06;08;Tiistai;33;32;65;10;14;24
292;13.06.2017;2017;06;09;Tiistai;33;25;58;10;10;20
292;13.06.2017;2017;06;10;Tiistai;33;22;55;9;12;21
292;13.06.2017;2017;06;11;Tiistai;27;48;75;13;33;46
292;13.06.2017;2017;06;12;Tiistai;52;43;95;16;23;39
292;13.06.2017;2017;06;13;Tiistai;52;27;79;10;25;35
292;13.06.2017;2017;06;14;Tiistai;54;49;103;18;23;41
292;13.06.2017;2017;06;15;Tiistai;87;58;145;19;28;47
292;13.06.2017;2017;06;16;Tiistai;81;78;159;25;40;65
292;13.06.2017;2017;06;17;Tiistai;62;60;122;16;21;37
292;13.06.2017;2017;06;18;Tiistai;61;49;110;20;29;49
292;13.06.2017;2017;06;19;Tiistai;53;32;85;17;32;49
292;13.06.2017;2017;06;20;Tiistai;41;32;73;7;28;35
292;13.06.2017;2017;06;21;Tiistai;23;11;34;15;16;31
292;13.06.2017;2017;06;22;Tiistai;10;6;16;2;9;11
292;13.06.2017;2017;06;23;Tiistai;4;4;8;4;3;7
292;14.06.2017;2017;06;00;Keskiviikko;1;1;2;1;1;2
292;14.06.2017;2017;06;01;Keskiviikko;2;2;4;0;4;4
292;14.06.2017;2017;06;02;Keskiviikko;0;2;2;0;3;3
292;14.06.2017;2017;06;03;Keskiviikko;1;2;3;0;0;0
292;14.06.2017;2017;06;04;Keskiviikko;1;2;3;0;0;0
292;14.06.2017;2017;06;05;Keskiviikko;5;7;12;2;6;8
292;14.06.2017;2017;06;06;Keskiviikko;25;22;47;2;4;6
292;14.06.2017;2017;06;07;Keskiviikko;36;26;62;4;2;6
292;14.06.2017;2017;06;08;Keskiviikko;31;28;59;9;11;20
292;14.06.2017;2017;06;09;Keskiviikko;44;40;84;14;12;26
292;14.06.2017;2017;06;10;Keskiviikko;32;35;67;7;24;31
292;14.06.2017;2017;06;11;Keskiviikko;52;46;98;25;40;65
292;14.06.2017;2017;06;12;Keskiviikko;52;45;97;16;42;58
292;14.06.2017;2017;06;13;Keskiviikko;52;54;106;10;40;50
292;14.06.2017;2017;06;14;Keskiviikko;69;55;124;19;28;47
292;14.06.2017;2017;06;15;Keskiviikko;75;53;128;13;39;52
292;14.06.2017;2017;06;16;Keskiviikko;81;67;148;14;41;55
292;14.06.2017;2017;06;17;Keskiviikko;82;53;135;21;39;60
292;14.06.2017;2017;06;18;Keskiviikko;61;30;91;17;32;49
292;14.06.2017;2017;06;19;Keskiviikko;47;38;85;9;36;45
292;14.06.2017;2017;06;20;Keskiviikko;49;51;100;14;35;49
292;14.06.2017;2017;06;21;Keskiviikko;22;10;32;11;17;28
292;14.06.2017;2017;06;22;Keskiviikko;17;14;31;14;4;18
292;14.06.2017;2017;06;23;Keskiviikko;3;1;4;3;4;7
292;15.06.2017;2017;06;00;Torstai;5;8;13;0;8;8
292;15.06.2017;2017;06;01;Torstai;1;2;3;1;2;3
292;15.06.2017;2017;06;02;Torstai;2;2;4;0;3;3
292;15.06.2017;2017;06;03;Torstai;2;2;4;1;0;1
292;15.06.2017;2017;06;04;Torstai;2;0;2;0;1;1
292;15.06.2017;2017;06;05;Torstai;10;4;14;2;3;5
292;15.06.2017;2017;06;06;Torstai;23;24;47;4;6;10
292;15.06.2017;2017;06;07;Torstai;43;34;77;4;3;7
292;15.06.2017;2017;06;08;Torstai;30;20;50;11;7;18
292;15.06.2017;2017;06;09;Torstai;34;34;68;9;15;24
292;15.06.2017;2017;06;10;Torstai;41;28;69;11;31;42
292;15.06.2017;2017;06;11;Torstai;58;51;109;14;36;50
292;15.06.2017;2017;06;12;Torstai;53;35;88;10;28;38
292;15.06.2017;2017;06;13;Torstai;71;48;119;13;29;42
292;15.06.2017;2017;06;14;Torstai;60;45;105;34;27;61
292;15.06.2017;2017;06;15;Torstai;77;68;145;26;36;62
292;15.06.2017;2017;06;16;Torstai;77;57;134;17;42;59
292;15.06.2017;2017;06;17;Torstai;96;48;144;9;41;50
292;15.06.2017;2017;06;18;Torstai;85;70;155;28;50;78
292;15.06.2017;2017;06;19;Torstai;74;50;124;28;29;57
292;15.06.2017;2017;06;20;Torstai;59;51;110;24;33;57
292;15.06.2017;2017;06;21;Torstai;24;33;57;6;23;29
292;15.06.2017;2017;06;22;Torstai;13;13;26;3;9;12
292;15.06.2017;2017;06;23;Torstai;9;13;22;4;2;6
292;16.06.2017;2017;06;00;Perjantai;4;5;9;4;2;6
292;16.06.2017;2017;06;01;Perjantai;3;10;13;3;3;6
292;16.06.2017;2017;06;02;Perjantai;4;2;6;1;2;3
292;16.06.2017;2017;06;03;Perjantai;2;0;2;2;2;4
292;16.06.2017;2017;06;04;Perjantai;3;0;3;1;3;4
292;16.06.2017;2017;06;05;Perjantai;7;7;14;1;5;6
292;16.06.2017;2017;06;06;Perjantai;23;14;37;0;4;4
292;16.06.2017;2017;06;07;Perjantai;33;21;54;8;3;11
292;16.06.2017;2017;06;08;Perjantai;33;23;56;7;10;17
292;16.06.2017;2017;06;09;Perjantai;47;30;77;11;12;23
292;16.06.2017;2017;06;10;Perjantai;37;29;66;10;28;38
292;16.06.2017;2017;06;11;Perjantai;45;79;124;11;28;39
292;16.06.2017;2017;06;12;Perjantai;79;51;130;15;26;41
292;16.06.2017;2017;06;13;Perjantai;83;33;116;6;22;28
292;16.06.2017;2017;06;14;Perjantai;60;58;118;17;27;44
292;16.06.2017;2017;06;15;Perjantai;66;63;129;17;44;61
292;16.06.2017;2017;06;16;Perjantai;55;43;98;10;31;41
292;16.06.2017;2017;06;17;Perjantai;55;34;89;15;29;44
292;16.06.2017;2017;06;18;Perjantai;83;54;137;18;37;55
292;16.06.2017;2017;06;19;Perjantai;61;35;96;15;33;48
292;16.06.2017;2017;06;20;Perjantai;38;37;75;15;21;36
292;16.06.2017;2017;06;21;Perjantai;24;29;53;13;20;33
292;16.06.2017;2017;06;22;Perjantai;15;5;20;9;15;24
292;16.06.2017;2017;06;23;Perjantai;11;5;16;9;1;10
292;17.06.2017;2017;06;00;Lauantai;4;3;7;12;7;19
292;17.06.2017;2017;06;01;Lauantai;1;6;7;4;3;7
292;17.06.2017;2017;06;02;Lauantai;4;4;8;0;7;7
292;17.06.2017;2017;06;03;Lauantai;5;3;8;0;3;3
292;17.06.2017;2017;06;04;Lauantai;3;2;5;2;3;5
292;17.06.2017;2017;06;05;Lauantai;2;0;2;2;2;4
292;17.06.2017;2017;06;06;Lauantai;7;3;10;0;3;3
292;17.06.2017;2017;06;07;Lauantai;10;7;17;2;4;6
292;17.06.2017;2017;06;08;Lauantai;10;10;20;13;3;16
292;17.06.2017;2017;06;09;Lauantai;34;30;64;5;9;14
292;17.06.2017;2017;06;10;Lauantai;35;39;74;12;16;28
292;17.06.2017;2017;06;11;Lauantai;60;56;116;14;32;46
292;17.06.2017;2017;06;12;Lauantai;83;49;132;13;36;49
292;17.06.2017;2017;06;13;Lauantai;59;35;94;12;21;33
292;17.06.2017;2017;06;14;Lauantai;45;61;106;6;27;33
292;17.06.2017;2017;06;15;Lauantai;66;29;95;11;23;34
292;17.06.2017;2017;06;16;Lauantai;53;42;95;6;19;25
292;17.06.2017;2017;06;17;Lauantai;61;34;95;17;25;42
292;17.06.2017;2017;06;18;Lauantai;54;30;84;14;28;42
292;17.06.2017;2017;06;19;Lauantai;27;25;52;13;19;32
292;17.06.2017;2017;06;20;Lauantai;30;30;60;12;18;30
292;17.06.2017;2017;06;21;Lauantai;17;18;35;10;14;24
292;17.06.2017;2017;06;22;Lauantai;10;11;21;12;2;14
292;17.06.2017;2017;06;23;Lauantai;16;16;32;8;5;13
292;18.06.2017;2017;06;00;Sunnuntai;10;1;11;6;4;10
292;18.06.2017;2017;06;01;Sunnuntai;1;2;3;3;4;7
292;18.06.2017;2017;06;02;Sunnuntai;6;18;24;3;17;20
292;18.06.2017;2017;06;03;Sunnuntai;5;4;9;3;3;6
292;18.06.2017;2017;06;04;Sunnuntai;3;0;3;1;0;1
292;18.06.2017;2017;06;05;Sunnuntai;1;2;3;0;0;0
292;18.06.2017;2017;06;06;Sunnuntai;3;4;7;1;0;1
292;18.06.2017;2017;06;07;Sunnuntai;3;4;7;0;0;0
292;18.06.2017;2017;06;08;Sunnuntai;1;0;1;3;2;5
292;18.06.2017;2017;06;09;Sunnuntai;6;2;8;3;1;4
292;18.06.2017;2017;06;10;Sunnuntai;13;9;22;4;2;6
292;18.06.2017;2017;06;11;Sunnuntai;9;15;24;9;9;18
292;18.06.2017;2017;06;12;Sunnuntai;35;22;57;7;24;31
292;18.06.2017;2017;06;13;Sunnuntai;38;30;68;16;27;43
292;18.06.2017;2017;06;14;Sunnuntai;36;25;61;14;12;26
292;18.06.2017;2017;06;15;Sunnuntai;35;21;56;14;19;33
292;18.06.2017;2017;06;16;Sunnuntai;26;24;50;12;27;39
292;18.06.2017;2017;06;17;Sunnuntai;33;33;66;15;26;41
292;18.06.2017;2017;06;18;Sunnuntai;40;20;60;14;17;31
292;18.06.2017;2017;06;19;Sunnuntai;21;19;40;12;21;33
292;18.06.2017;2017;06;20;Sunnuntai;16;15;31;5;12;17
292;18.06.2017;2017;06;21;Sunnuntai;12;11;23;5;7;12
292;18.06.2017;2017;06;22;Sunnuntai;5;5;10;3;10;13
292;18.06.2017;2017;06;23;Sunnuntai;4;0;4;3;1;4
292;19.06.2017;2017;06;00;Maanantai;5;2;7;3;2;5
292;19.06.2017;2017;06;01;Maanantai;0;6;6;3;2;5
292;19.06.2017;2017;06;02;Maanantai;2;0;2;2;3;5
292;19.06.2017;2017;06;03;Maanantai;0;1;1;0;0;0
292;19.06.2017;2017;06;04;Maanantai;5;1;6;1;0;1
292;19.06.2017;2017;06;05;Maanantai;8;3;11;4;1;5
292;19.06.2017;2017;06;06;Maanantai;20;10;30;1;16;17
292;19.06.2017;2017;06;07;Maanantai;28;26;54;3;8;11
292;19.06.2017;2017;06;08;Maanantai;23;24;47;8;11;19
292;19.06.2017;2017;06;09;Maanantai;21;20;41;3;14;17
292;19.06.2017;2017;06;10;Maanantai;27;26;53;9;29;38
292;19.06.2017;2017;06;11;Maanantai;46;33;79;12;30;42
292;19.06.2017;2017;06;12;Maanantai;49;36;85;26;30;56
292;19.06.2017;2017;06;13;Maanantai;48;30;78;11;44;55
292;19.06.2017;2017;06;14;Maanantai;66;34;100;13;26;39
292;19.06.2017;2017;06;15;Maanantai;51;54;105;26;36;62
292;19.06.2017;2017;06;16;Maanantai;75;58;133;19;47;66
292;19.06.2017;2017;06;17;Maanantai;57;35;92;13;24;37
292;19.06.2017;2017;06;18;Maanantai;67;41;108;14;34;48
292;19.06.2017;2017;06;19;Maanantai;74;45;119;10;30;40
292;19.06.2017;2017;06;20;Maanantai;45;46;91;16;22;38
292;19.06.2017;2017;06;21;Maanantai;24;18;42;8;18;26
292;19.06.2017;2017;06;22;Maanantai;17;9;26;5;5;10
292;19.06.2017;2017;06;23;Maanantai;4;9;13;2;5;7
292;20.06.2017;2017;06;00;Tiistai;3;3;6;2;3;5
292;20.06.2017;2017;06;01;Tiistai;0;1;1;0;0;0
292;20.06.2017;2017;06;02;Tiistai;1;0;1;0;0;0
292;20.06.2017;2017;06;03;Tiistai;0;1;1;0;0;0
292;20.06.2017;2017;06;04;Tiistai;2;2;4;0;0;0
292;20.06.2017;2017;06;05;Tiistai;7;4;11;1;3;4
292;20.06.2017;2017;06;06;Tiistai;24;14;38;2;4;6
292;20.06.2017;2017;06;07;Tiistai;31;20;51;5;6;11
292;20.06.2017;2017;06;08;Tiistai;27;28;55;5;14;19
292;20.06.2017;2017;06;09;Tiistai;31;30;61;8;17;25
292;20.06.2017;2017;06;10;Tiistai;59;32;91;15;25;40
292;20.06.2017;2017;06;11;Tiistai;32;36;68;30;27;57
292;20.06.2017;2017;06;12;Tiistai;50;29;79;7;28;35
292;20.06.2017;2017;06;13;Tiistai;49;45;94;13;23;36
292;20.06.2017;2017;06;14;Tiistai;54;52;106;9;30;39
292;20.06.2017;2017;06;15;Tiistai;72;53;125;20;35;55
292;20.06.2017;2017;06;16;Tiistai;70;64;134;27;29;56
292;20.06.2017;2017;06;17;Tiistai;86;32;118;18;31;49
292;20.06.2017;2017;06;18;Tiistai;62;54;116;12;33;45
292;20.06.2017;2017;06;19;Tiistai;55;42;97;15;21;36
292;20.06.2017;2017;06;20;Tiistai;38;53;91;16;41;57
292;20.06.2017;2017;06;21;Tiistai;23;26;49;5;21;26
292;20.06.2017;2017;06;22;Tiistai;14;11;25;6;10;16
292;20.06.2017;2017;06;23;Tiistai;10;6;16;4;5;9
292;21.06.2017;2017;06;00;Keskiviikko;6;4;10;2;2;4
292;21.06.2017;2017;06;01;Keskiviikko;3;3;6;3;1;4
292;21.06.2017;2017;06;02;Keskiviikko;0;2;2;0;0;0
292;21.06.2017;2017;06;03;Keskiviikko;0;0;0;0;0;0
292;21.06.2017;2017;06;04;Keskiviikko;2;2;4;1;0;1
292;21.06.2017;2017;06;05;Keskiviikko;4;2;6;2;7;9
292;21.06.2017;2017;06;06;Keskiviikko;19;14;33;5;4;9
292;21.06.2017;2017;06;07;Keskiviikko;19;21;40;7;6;13
292;21.06.2017;2017;06;08;Keskiviikko;18;22;40;4;12;16
292;21.06.2017;2017;06;09;Keskiviikko;23;18;41;11;16;27
292;21.06.2017;2017;06;10;Keskiviikko;25;27;52;8;18;26
292;21.06.2017;2017;06;11;Keskiviikko;26;33;59;8;22;30
292;21.06.2017;2017;06;12;Keskiviikko;35;21;56;18;25;43
292;21.06.2017;2017;06;13;Keskiviikko;31;21;52;15;24;39
292;21.06.2017;2017;06;14;Keskiviikko;33;27;60;25;38;63
292;21.06.2017;2017;06;15;Keskiviikko;42;49;91;6;31;37
292;21.06.2017;2017;06;16;Keskiviikko;58;39;97;13;22;35
292;21.06.2017;2017;06;17;Keskiviikko;28;25;53;13;32;45
292;21.06.2017;2017;06;18;Keskiviikko;35;24;59;20;17;37
292;21.06.2017;2017;06;19;Keskiviikko;28;20;48;7;15;22
292;21.06.2017;2017;06;20;Keskiviikko;28;23;51;9;17;26
292;21.06.2017;2017;06;21;Keskiviikko;18;13;31;6;7;13
292;21.06.2017;2017;06;22;Keskiviikko;13;6;19;5;3;8
292;21.06.2017;2017;06;23;Keskiviikko;1;2;3;0;2;2
292;22.06.2017;2017;06;00;Torstai;4;2;6;0;3;3
292;22.06.2017;2017;06;01;Torstai;1;1;2;1;2;3
292;22.06.2017;2017;06;02;Torstai;0;3;3;0;1;1
292;22.06.2017;2017;06;03;Torstai;0;4;4;0;0;0
292;22.06.2017;2017;06;04;Torstai;2;0;2;0;0;0
292;22.06.2017;2017;06;05;Torstai;4;4;8;0;1;1
292;22.06.2017;2017;06;06;Torstai;12;11;23;3;4;7
292;22.06.2017;2017;06;07;Torstai;22;21;43;2;6;8
292;22.06.2017;2017;06;08;Torstai;24;10;34;6;8;14
292;22.06.2017;2017;06;09;Torstai;19;12;31;11;10;21
292;22.06.2017;2017;06;10;Torstai;19;22;41;5;9;14
292;22.06.2017;2017;06;11;Torstai;26;23;49;4;9;13
292;22.06.2017;2017;06;12;Torstai;26;21;47;12;10;22
292;22.06.2017;2017;06;13;Torstai;31;33;64;11;13;24
292;22.06.2017;2017;06;14;Torstai;27;32;59;13;8;21
292;22.06.2017;2017;06;15;Torstai;29;30;59;11;17;28
292;22.06.2017;2017;06;16;Torstai;37;24;61;7;24;31
292;22.06.2017;2017;06;17;Torstai;35;19;54;8;14;22
292;22.06.2017;2017;06;18;Torstai;22;27;49;8;12;20
292;22.06.2017;2017;06;19;Torstai;33;28;61;14;8;22
292;22.06.2017;2017;06;20;Torstai;18;8;26;7;8;15
292;22.06.2017;2017;06;21;Torstai;17;7;24;2;6;8
292;22.06.2017;2017;06;22;Torstai;3;6;9;1;7;8
292;22.06.2017;2017;06;23;Torstai;1;3;4;1;3;4
292;23.06.2017;2017;06;00;Perjantai;9;9;18;4;2;6
292;23.06.2017;2017;06;01;Perjantai;0;8;8;0;4;4
292;23.06.2017;2017;06;02;Perjantai;2;5;7;3;1;4
292;23.06.2017;2017;06;03;Perjantai;0;1;1;1;0;1
292;23.06.2017;2017;06;04;Perjantai;0;1;1;1;0;1
292;23.06.2017;2017;06;05;Perjantai;2;1;3;2;0;2
292;23.06.2017;2017;06;06;Perjantai;6;4;10;2;2;4
292;23.06.2017;2017;06;07;Perjantai;3;5;8;1;3;4
292;23.06.2017;2017;06;08;Perjantai;8;8;16;5;7;12
292;23.06.2017;2017;06;09;Perjantai;13;10;23;3;12;15
292;23.06.2017;2017;06;10;Perjantai;18;18;36;7;2;9
292;23.06.2017;2017;06;11;Perjantai;27;18;45;3;5;8
292;23.06.2017;2017;06;12;Perjantai;35;26;61;7;7;14
292;23.06.2017;2017;06;13;Perjantai;29;20;49;4;1;5
292;23.06.2017;2017;06;14;Perjantai;28;21;49;8;13;21
292;23.06.2017;2017;06;15;Perjantai;27;35;62;10;17;27
292;23.06.2017;2017;06;16;Perjantai;22;22;44;13;16;29
292;23.06.2017;2017;06;17;Perjantai;16;23;39;9;19;28
292;23.06.2017;2017;06;18;Perjantai;23;20;43;12;11;23
292;23.06.2017;2017;06;19;Perjantai;23;16;39;4;19;23
292;23.06.2017;2017;06;20;Perjantai;17;9;26;5;12;17
292;23.06.2017;2017;06;21;Perjantai;6;11;17;10;9;19
292;23.06.2017;2017;06;22;Perjantai;8;6;14;7;8;15
292;23.06.2017;2017;06;23;Perjantai;6;8;14;0;5;5
292;24.06.2017;2017;06;00;Lauantai;3;4;7;2;11;13
292;24.06.2017;2017;06;01;Lauantai;5;3;8;4;3;7
292;24.06.2017;2017;06;02;Lauantai;4;4;8;4;0;4
292;24.06.2017;2017;06;03;Lauantai;1;4;5;2;5;7
292;24.06.2017;2017;06;04;Lauantai;0;2;2;1;1;2
292;24.06.2017;2017;06;05;Lauantai;4;1;5;8;1;9
292;24.06.2017;2017;06;06;Lauantai;5;3;8;1;2;3
292;24.06.2017;2017;06;07;Lauantai;5;3;8;2;4;6
292;24.06.2017;2017;06;08;Lauantai;4;4;8;2;0;2
292;24.06.2017;2017;06;09;Lauantai;8;5;13;5;6;11
292;24.06.2017;2017;06;10;Lauantai;9;7;16;3;4;7
292;24.06.2017;2017;06;11;Lauantai;21;21;42;7;2;9
292;24.06.2017;2017;06;12;Lauantai;19;18;37;4;11;15
292;24.06.2017;2017;06;13;Lauantai;47;27;74;13;22;35
292;24.06.2017;2017;06;14;Lauantai;34;25;59;15;10;25
292;24.06.2017;2017;06;15;Lauantai;42;23;65;12;16;28
292;24.06.2017;2017;06;16;Lauantai;38;20;58;17;15;32
292;24.06.2017;2017;06;17;Lauantai;28;31;59;11;23;34
292;24.06.2017;2017;06;18;Lauantai;36;33;69;4;15;19
292;24.06.2017;2017;06;19;Lauantai;25;22;47;14;21;35
292;24.06.2017;2017;06;20;Lauantai;33;20;53;12;19;31
292;24.06.2017;2017;06;21;Lauantai;13;11;24;3;13;16
292;24.06.2017;2017;06;22;Lauantai;4;9;13;4;6;10
292;24.06.2017;2017;06;23;Lauantai;9;8;17;6;3;9
292;25.06.2017;2017;06;00;Sunnuntai;5;4;9;6;1;7
292;25.06.2017;2017;06;01;Sunnuntai;2;2;4;2;4;6
292;25.06.2017;2017;06;02;Sunnuntai;7;10;17;4;8;12
292;25.06.2017;2017;06;03;Sunnuntai;0;4;4;0;1;1
292;25.06.2017;2017;06;04;Sunnuntai;0;0;0;0;2;2
292;25.06.2017;2017;06;05;Sunnuntai;2;2;4;2;3;5
292;25.06.2017;2017;06;06;Sunnuntai;8;4;12;4;1;5
292;25.06.2017;2017;06;07;Sunnuntai;4;3;7;3;0;3
292;25.06.2017;2017;06;08;Sunnuntai;6;5;11;7;1;8
292;25.06.2017;2017;06;09;Sunnuntai;9;8;17;2;2;4
292;25.06.2017;2017;06;10;Sunnuntai;19;11;30;4;5;9
292;25.06.2017;2017;06;11;Sunnuntai;11;7;18;1;1;2
292;25.06.2017;2017;06;12;Sunnuntai;10;6;16;3;5;8
292;25.06.2017;2017;06;13;Sunnuntai;14;10;24;6;12;18
292;25.06.2017;2017;06;14;Sunnuntai;7;15;22;8;12;20
292;25.06.2017;2017;06;15;Sunnuntai;9;6;15;8;5;13
292;25.06.2017;2017;06;16;Sunnuntai;16;12;28;6;1;7
292;25.06.2017;2017;06;17;Sunnuntai;14;7;21;5;4;9
292;25.06.2017;2017;06;18;Sunnuntai;25;6;31;20;15;35
292;25.06.2017;2017;06;19;Sunnuntai;33;19;52;12;17;29
292;25.06.2017;2017;06;20;Sunnuntai;7;11;18;11;6;17
292;25.06.2017;2017;06;21;Sunnuntai;9;7;16;2;4;6
292;25.06.2017;2017;06;22;Sunnuntai;2;4;6;3;3;6
292;25.06.2017;2017;06;23;Sunnuntai;1;1;2;2;2;4
292;26.06.2017;2017;06;00;Maanantai;2;0;2;0;1;1
292;26.06.2017;2017;06;01;Maanantai;1;3;4;1;2;3
292;26.06.2017;2017;06;02;Maanantai;0;3;3;0;0;0
292;26.06.2017;2017;06;03;Maanantai;0;0;0;0;0;0
292;26.06.2017;2017;06;04;Maanantai;2;0;2;2;0;2
292;26.06.2017;2017;06;05;Maanantai;2;4;6;0;1;1
292;26.06.2017;2017;06;06;Maanantai;13;8;21;1;4;5
292;26.06.2017;2017;06;07;Maanantai;18;18;36;3;2;5
292;26.06.2017;2017;06;08;Maanantai;19;16;35;2;7;9
292;26.06.2017;2017;06;09;Maanantai;11;9;20;0;5;5
292;26.06.2017;2017;06;10;Maanantai;10;11;21;4;4;8
292;26.06.2017;2017;06;11;Maanantai;10;9;19;4;2;6
292;26.06.2017;2017;06;12;Maanantai;21;21;42;9;12;21
292;26.06.2017;2017;06;13;Maanantai;23;18;41;5;9;14
292;26.06.2017;2017;06;14;Maanantai;42;42;84;10;9;19
292;26.06.2017;2017;06;15;Maanantai;43;40;83;15;28;43
292;26.06.2017;2017;06;16;Maanantai;51;45;96;18;42;60
292;26.06.2017;2017;06;17;Maanantai;44;37;81;21;19;40
292;26.06.2017;2017;06;18;Maanantai;64;40;104;13;33;46
292;26.06.2017;2017;06;19;Maanantai;57;33;90;16;29;45
292;26.06.2017;2017;06;20;Maanantai;40;30;70;13;25;38
292;26.06.2017;2017;06;21;Maanantai;22;21;43;11;14;25
292;26.06.2017;2017;06;22;Maanantai;9;7;16;4;6;10
292;26.06.2017;2017;06;23;Maanantai;4;6;10;5;4;9
292;27.06.2017;2017;06;00;Tiistai;1;1;2;0;1;1
292;27.06.2017;2017;06;01;Tiistai;1;4;5;1;3;4
292;27.06.2017;2017;06;02;Tiistai;0;2;2;1;0;1
292;27.06.2017;2017;06;03;Tiistai;0;0;0;1;0;1
292;27.06.2017;2017;06;04;Tiistai;3;1;4;0;1;1
292;27.06.2017;2017;06;05;Tiistai;6;5;11;2;1;3
292;27.06.2017;2017;06;06;Tiistai;13;10;23;1;2;3
292;27.06.2017;2017;06;07;Tiistai;24;20;44;4;5;9
292;27.06.2017;2017;06;08;Tiistai;18;17;35;6;5;11
292;27.06.2017;2017;06;09;Tiistai;28;24;52;4;4;8
292;27.06.2017;2017;06;10;Tiistai;26;31;57;7;9;16
292;27.06.2017;2017;06;11;Tiistai;36;36;72;9;10;19
292;27.06.2017;2017;06;12;Tiistai;43;36;79;12;20;32
292;27.06.2017;2017;06;13;Tiistai;40;30;70;7;29;36
292;27.06.2017;2017;06;14;Tiistai;49;37;86;12;15;27
292;27.06.2017;2017;06;15;Tiistai;34;46;80;20;24;44
292;27.06.2017;2017;06;16;Tiistai;82;48;130;23;35;58
292;27.06.2017;2017;06;17;Tiistai;70;42;112;15;29;44
292;27.06.2017;2017;06;18;Tiistai;53;41;94;19;36;55
292;27.06.2017;2017;06;19;Tiistai;44;39;83;18;36;54
292;27.06.2017;2017;06;20;Tiistai;32;41;73;12;18;30
292;27.06.2017;2017;06;21;Tiistai;23;16;39;12;14;26
292;27.06.2017;2017;06;22;Tiistai;10;8;18;1;12;13
292;27.06.2017;2017;06;23;Tiistai;1;3;4;3;1;4
292;28.06.2017;2017;06;00;Keskiviikko;0;2;2;0;1;1
292;28.06.2017;2017;06;01;Keskiviikko;0;1;1;0;0;0
292;28.06.2017;2017;06;02;Keskiviikko;0;3;3;3;2;5
292;28.06.2017;2017;06;03;Keskiviikko;0;2;2;2;0;2
292;28.06.2017;2017;06;04;Keskiviikko;4;1;5;1;1;2
292;28.06.2017;2017;06;05;Keskiviikko;5;7;12;0;1;1
292;28.06.2017;2017;06;06;Keskiviikko;19;8;27;2;10;12
292;28.06.2017;2017;06;07;Keskiviikko;19;23;42;2;5;7
292;28.06.2017;2017;06;08;Keskiviikko;14;17;31;14;9;23
292;28.06.2017;2017;06;09;Keskiviikko;24;13;37;3;11;14
292;28.06.2017;2017;06;10;Keskiviikko;12;9;21;1;0;1
292;28.06.2017;2017;06;11;Keskiviikko;19;17;36;10;8;18
292;28.06.2017;2017;06;12;Keskiviikko;28;18;46;2;5;7
292;28.06.2017;2017;06;13;Keskiviikko;25;19;44;7;9;16
292;28.06.2017;2017;06;14;Keskiviikko;38;29;67;7;5;12
292;28.06.2017;2017;06;15;Keskiviikko;32;30;62;8;9;17
292;28.06.2017;2017;06;16;Keskiviikko;33;30;63;7;8;15
292;28.06.2017;2017;06;17;Keskiviikko;35;29;64;10;20;30
292;28.06.2017;2017;06;18;Keskiviikko;37;36;73;14;21;35
292;28.06.2017;2017;06;19;Keskiviikko;46;32;78;10;9;19
292;28.06.2017;2017;06;20;Keskiviikko;32;28;60;15;19;34
292;28.06.2017;2017;06;21;Keskiviikko;12;15;27;16;20;36
292;28.06.2017;2017;06;22;Keskiviikko;3;9;12;2;6;8
292;28.06.2017;2017;06;23;Keskiviikko;5;3;8;4;3;7
292;29.06.2017;2017;06;00;Torstai;2;1;3;2;5;7
292;29.06.2017;2017;06;01;Torstai;0;2;2;0;1;1
292;29.06.2017;2017;06;02;Torstai;0;0;0;0;0;0
292;29.06.2017;2017;06;03;Torstai;2;0;2;1;1;2
292;29.06.2017;2017;06;04;Torstai;5;2;7;0;0;0
292;29.06.2017;2017;06;05;Torstai;7;4;11;1;0;1
292;29.06.2017;2017;06;06;Torstai;25;14;39;0;5;5
292;29.06.2017;2017;06;07;Torstai;27;26;53;1;8;9
292;29.06.2017;2017;06;08;Torstai;20;11;31;4;9;13
292;29.06.2017;2017;06;09;Torstai;25;16;41;2;6;8
292;29.06.2017;2017;06;10;Torstai;47;34;81;8;5;13
292;29.06.2017;2017;06;11;Torstai;33;33;66;10;16;26
292;29.06.2017;2017;06;12;Torstai;47;42;89;12;17;29
292;29.06.2017;2017;06;13;Torstai;45;44;89;11;19;30
292;29.06.2017;2017;06;14;Torstai;66;47;113;15;27;42
292;29.06.2017;2017;06;15;Torstai;62;55;117;18;26;44
292;29.06.2017;2017;06;16;Torstai;75;49;124;15;28;43
292;29.06.2017;2017;06;17;Torstai;66;57;123;7;27;34
292;29.06.2017;2017;06;18;Torstai;58;32;90;6;23;29
292;29.06.2017;2017;06;19;Torstai;47;42;89;17;24;41
292;29.06.2017;2017;06;20;Torstai;40;29;69;19;39;58
292;29.06.2017;2017;06;21;Torstai;22;21;43;9;5;14
292;29.06.2017;2017;06;22;Torstai;9;0;9;4;5;9
292;29.06.2017;2017;06;23;Torstai;2;1;3;2;2;4
292;30.06.2017;2017;06;00;Perjantai;0;2;2;0;0;0
292;30.06.2017;2017;06;01;Perjantai;1;1;2;0;1;1
292;30.06.2017;2017;06;02;Perjantai;0;0;0;1;1;2
292;30.06.2017;2017;06;03;Perjantai;2;0;2;1;1;2
292;30.06.2017;2017;06;04;Perjantai;5;1;6;0;0;0
292;30.06.2017;2017;06;05;Perjantai;7;7;14;1;2;3
292;30.06.2017;2017;06;06;Perjantai;21;20;41;0;4;4
292;30.06.2017;2017;06;07;Perjantai;23;15;38;5;10;15
292;30.06.2017;2017;06;08;Perjantai;26;13;39;5;11;16
292;30.06.2017;2017;06;09;Perjantai;37;19;56;16;8;24
292;30.06.2017;2017;06;10;Perjantai;49;18;67;15;11;26
292;30.06.2017;2017;06;11;Perjantai;51;43;94;6;9;15
292;30.06.2017;2017;06;12;Perjantai;51;49;100;11;8;19
292;30.06.2017;2017;06;13;Perjantai;61;44;105;17;22;39
292;30.06.2017;2017;06;14;Perjantai;72;41;113;28;20;48
292;30.06.2017;2017;06;15;Perjantai;63;50;113;11;32;43
292;30.06.2017;2017;06;16;Perjantai;55;38;93;14;33;47
292;30.06.2017;2017;06;17;Perjantai;53;26;79;18;24;42
292;30.06.2017;2017;06;18;Perjantai;54;45;99;19;39;58
292;30.06.2017;2017;06;19;Perjantai;51;39;90;14;24;38
292;30.06.2017;2017;06;20;Perjantai;48;27;75;19;24;43
292;30.06.2017;2017;06;21;Perjantai;21;23;44;16;18;34
292;30.06.2017;2017;06;22;Perjantai;12;21;33;15;10;25
292;30.06.2017;2017;06;23;Perjantai;16;2;18;7;3;10
292;01.07.2017;2017;07;00;Lauantai;4;9;13;3;7;10
292;01.07.2017;2017;07;01;Lauantai;1;4;5;1;0;1
292;01.07.2017;2017;07;02;Lauantai;4;11;15;2;4;6
292;01.07.2017;2017;07;03;Lauantai;1;8;9;0;6;6
292;01.07.2017;2017;07;04;Lauantai;1;0;1;1;2;3
292;01.07.2017;2017;07;05;Lauantai;0;2;2;2;5;7
292;01.07.2017;2017;07;06;Lauantai;8;8;16;2;1;3
292;01.07.2017;2017;07;07;Lauantai;13;5;18;4;6;10
292;01.07.2017;2017;07;08;Lauantai;22;9;31;3;9;12
292;01.07.2017;2017;07;09;Lauantai;26;8;34;5;9;14
292;01.07.2017;2017;07;10;Lauantai;40;30;70;8;4;12
292;01.07.2017;2017;07;11;Lauantai;40;35;75;5;9;14
292;01.07.2017;2017;07;12;Lauantai;56;38;94;12;26;38
292;01.07.2017;2017;07;13;Lauantai;50;42;92;13;29;42
292;01.07.2017;2017;07;14;Lauantai;59;28;87;17;27;44
292;01.07.2017;2017;07;15;Lauantai;43;26;69;5;24;29
292;01.07.2017;2017;07;16;Lauantai;55;27;82;21;25;46
292;01.07.2017;2017;07;17;Lauantai;52;41;93;19;39;58
292;01.07.2017;2017;07;18;Lauantai;46;31;77;19;28;47
292;01.07.2017;2017;07;19;Lauantai;39;24;63;13;35;48
292;01.07.2017;2017;07;20;Lauantai;57;20;77;14;16;30
292;01.07.2017;2017;07;21;Lauantai;14;29;43;10;25;35
292;01.07.2017;2017;07;22;Lauantai;18;13;31;4;13;17
292;01.07.2017;2017;07;23;Lauantai;13;10;23;4;8;12
292;02.07.2017;2017;07;00;Sunnuntai;11;13;24;5;6;11
292;02.07.2017;2017;07;01;Sunnuntai;5;7;12;5;7;12
292;02.07.2017;2017;07;02;Sunnuntai;0;8;8;3;3;6
292;02.07.2017;2017;07;03;Sunnuntai;5;7;12;2;2;4
292;02.07.2017;2017;07;04;Sunnuntai;0;2;2;2;0;2
292;02.07.2017;2017;07;05;Sunnuntai;3;2;5;1;0;1
292;02.07.2017;2017;07;06;Sunnuntai;8;7;15;1;6;7
292;02.07.2017;2017;07;07;Sunnuntai;12;6;18;1;2;3
292;02.07.2017;2017;07;08;Sunnuntai;11;2;13;15;5;20
292;02.07.2017;2017;07;09;Sunnuntai;33;10;43;12;5;17
292;02.07.2017;2017;07;10;Sunnuntai;36;29;65;5;2;7
292;02.07.2017;2017;07;11;Sunnuntai;49;41;90;5;8;13
292;02.07.2017;2017;07;12;Sunnuntai;40;50;90;16;23;39
292;02.07.2017;2017;07;13;Sunnuntai;78;41;119;12;29;41
292;02.07.2017;2017;07;14;Sunnuntai;62;40;102;12;31;43
292;02.07.2017;2017;07;15;Sunnuntai;61;32;93;14;28;42
292;02.07.2017;2017;07;16;Sunnuntai;69;37;106;10;23;33
292;02.07.2017;2017;07;17;Sunnuntai;69;34;103;20;28;48
292;02.07.2017;2017;07;18;Sunnuntai;52;38;90;19;22;41
292;02.07.2017;2017;07;19;Sunnuntai;49;48;97;15;37;52
292;02.07.2017;2017;07;20;Sunnuntai;34;32;66;15;23;38
292;02.07.2017;2017;07;21;Sunnuntai;7;13;20;6;31;37
292;02.07.2017;2017;07;22;Sunnuntai;11;13;24;6;5;11
292;02.07.2017;2017;07;23;Sunnuntai;4;6;10;4;8;12
292;03.07.2017;2017;07;00;Maanantai;5;5;10;4;0;4
292;03.07.2017;2017;07;01;Maanantai;0;4;4;2;3;5
292;03.07.2017;2017;07;02;Maanantai;3;1;4;3;4;7
292;03.07.2017;2017;07;03;Maanantai;2;0;2;0;1;1
292;03.07.2017;2017;07;04;Maanantai;3;4;7;0;3;3
292;03.07.2017;2017;07;05;Maanantai;6;4;10;1;1;2
292;03.07.2017;2017;07;06;Maanantai;17;14;31;0;5;5
292;03.07.2017;2017;07;07;Maanantai;52;12;64;2;9;11
292;03.07.2017;2017;07;08;Maanantai;27;12;39;12;7;19
292;03.07.2017;2017;07;09;Maanantai;40;18;58;8;4;12
292;03.07.2017;2017;07;10;Maanantai;36;34;70;6;1;7
292;03.07.2017;2017;07;11;Maanantai;45;44;89;10;21;31
292;03.07.2017;2017;07;12;Maanantai;54;49;103;15;21;36
292;03.07.2017;2017;07;13;Maanantai;69;42;111;8;24;32
292;03.07.2017;2017;07;14;Maanantai;59;51;110;13;19;32
292;03.07.2017;2017;07;15;Maanantai;70;58;128;13;27;40
292;03.07.2017;2017;07;16;Maanantai;64;48;112;12;29;41
292;03.07.2017;2017;07;17;Maanantai;52;38;90;14;29;43
292;03.07.2017;2017;07;18;Maanantai;50;47;97;13;26;39
292;03.07.2017;2017;07;19;Maanantai;45;26;71;10;22;32
292;03.07.2017;2017;07;20;Maanantai;33;33;66;14;21;35
292;03.07.2017;2017;07;21;Maanantai;32;15;47;8;14;22
292;03.07.2017;2017;07;22;Maanantai;6;6;12;8;4;12
292;03.07.2017;2017;07;23;Maanantai;7;4;11;3;3;6
292;04.07.2017;2017;07;00;Tiistai;1;3;4;1;1;2
292;04.07.2017;2017;07;01;Tiistai;0;4;4;1;1;2
292;04.07.2017;2017;07;02;Tiistai;1;2;3;0;1;1
292;04.07.2017;2017;07;03;Tiistai;1;0;1;1;0;1
292;04.07.2017;2017;07;04;Tiistai;2;0;2;0;0;0
292;04.07.2017;2017;07;05;Tiistai;4;4;8;4;2;6
292;04.07.2017;2017;07;06;Tiistai;15;14;29;0;3;3
292;04.07.2017;2017;07;07;Tiistai;25;17;42;5;5;10
292;04.07.2017;2017;07;08;Tiistai;19;9;28;8;8;16
292;04.07.2017;2017;07;09;Tiistai;29;17;46;8;4;12
292;04.07.2017;2017;07;10;Tiistai;28;27;55;11;11;22
292;04.07.2017;2017;07;11;Tiistai;40;33;73;10;8;18
292;04.07.2017;2017;07;12;Tiistai;32;20;52;7;15;22
292;04.07.2017;2017;07;13;Tiistai;28;18;46;6;1;7
292;04.07.2017;2017;07;14;Tiistai;35;29;64;11;14;25
292;04.07.2017;2017;07;15;Tiistai;56;31;87;9;19;28
292;04.07.2017;2017;07;16;Tiistai;54;45;99;17;31;48
292;04.07.2017;2017;07;17;Tiistai;50;29;79;4;9;13
292;04.07.2017;2017;07;18;Tiistai;42;23;65;11;37;48
292;04.07.2017;2017;07;19;Tiistai;44;21;65;21;20;41
292;04.07.2017;2017;07;20;Tiistai;38;67;105;23;39;62
292;04.07.2017;2017;07;21;Tiistai;7;17;24;7;13;20
292;04.07.2017;2017;07;22;Tiistai;9;7;16;5;7;12
292;04.07.2017;2017;07;23;Tiistai;1;1;2;0;0;0
292;05.07.2017;2017;07;00;Keskiviikko;1;1;2;1;2;3
292;05.07.2017;2017;07;01;Keskiviikko;2;3;5;1;4;5
292;05.07.2017;2017;07;02;Keskiviikko;0;3;3;0;2;2
292;05.07.2017;2017;07;03;Keskiviikko;0;4;4;0;0;0
292;05.07.2017;2017;07;04;Keskiviikko;2;0;2;0;0;0
292;05.07.2017;2017;07;05;Keskiviikko;2;6;8;2;3;5
292;05.07.2017;2017;07;06;Keskiviikko;14;9;23;0;4;4
292;05.07.2017;2017;07;07;Keskiviikko;24;16;40;2;4;6
292;05.07.2017;2017;07;08;Keskiviikko;8;14;22;5;7;12
292;05.07.2017;2017;07;09;Keskiviikko;24;16;40;4;4;8
292;05.07.2017;2017;07;10;Keskiviikko;21;16;37;8;10;18
292;05.07.2017;2017;07;11;Keskiviikko;40;36;76;5;8;13
292;05.07.2017;2017;07;12;Keskiviikko;26;18;44;12;13;25
292;05.07.2017;2017;07;13;Keskiviikko;24;27;51;3;14;17
292;05.07.2017;2017;07;14;Keskiviikko;39;34;73;8;5;13
292;05.07.2017;2017;07;15;Keskiviikko;33;33;66;10;8;18
292;05.07.2017;2017;07;16;Keskiviikko;29;38;67;9;18;27
292;05.07.2017;2017;07;17;Keskiviikko;34;32;66;7;17;24
292;05.07.2017;2017;07;18;Keskiviikko;26;21;47;8;15;23
292;05.07.2017;2017;07;19;Keskiviikko;31;29;60;9;12;21
292;05.07.2017;2017;07;20;Keskiviikko;32;17;49;7;7;14
292;05.07.2017;2017;07;21;Keskiviikko;13;15;28;4;5;9
292;05.07.2017;2017;07;22;Keskiviikko;11;3;14;0;3;3
292;05.07.2017;2017;07;23;Keskiviikko;2;1;3;1;1;2
292;06.07.2017;2017;07;00;Torstai;0;1;1;1;3;4
292;06.07.2017;2017;07;01;Torstai;1;3;4;0;1;1
292;06.07.2017;2017;07;02;Torstai;2;0;2;0;0;0
292;06.07.2017;2017;07;03;Torstai;0;2;2;0;1;1
292;06.07.2017;2017;07;04;Torstai;1;1;2;0;0;0
292;06.07.2017;2017;07;05;Torstai;2;3;5;3;3;6
292;06.07.2017;2017;07;06;Torstai;10;5;15;1;2;3
292;06.07.2017;2017;07;07;Torstai;13;9;22;0;3;3
292;06.07.2017;2017;07;08;Torstai;9;7;16;3;2;5
292;06.07.2017;2017;07;09;Torstai;19;10;29;1;4;5
292;06.07.2017;2017;07;10;Torstai;11;10;21;1;4;5
292;06.07.2017;2017;07;11;Torstai;15;21;36;5;13;18
292;06.07.2017;2017;07;12;Torstai;21;18;39;12;11;23
292;06.07.2017;2017;07;13;Torstai;27;24;51;5;4;9
292;06.07.2017;2017;07;14;Torstai;28;29;57;6;15;21
292;06.07.2017;2017;07;15;Torstai;28;27;55;12;21;33
292;06.07.2017;2017;07;16;Torstai;42;27;69;15;16;31
292;06.07.2017;2017;07;17;Torstai;41;25;66;13;13;26
292;06.07.2017;2017;07;18;Torstai;21;14;35;10;22;32
292;06.07.2017;2017;07;19;Torstai;27;32;59;16;21;37
292;06.07.2017;2017;07;20;Torstai;23;23;46;10;21;31
292;06.07.2017;2017;07;21;Torstai;18;6;24;9;8;17
292;06.07.2017;2017;07;22;Torstai;6;7;13;0;11;11
292;06.07.2017;2017;07;23;Torstai;7;1;8;4;1;5
292;07.07.2017;2017;07;00;Perjantai;1;3;4;0;0;0
292;07.07.2017;2017;07;01;Perjantai;0;5;5;0;0;0
292;07.07.2017;2017;07;02;Perjantai;1;2;3;0;1;1
292;07.07.2017;2017;07;03;Perjantai;1;1;2;0;1;1
292;07.07.2017;2017;07;04;Perjantai;3;2;5;0;0;0
292;07.07.2017;2017;07;05;Perjantai;3;5;8;2;3;5
292;07.07.2017;2017;07;06;Perjantai;13;10;23;4;8;12
292;07.07.2017;2017;07;07;Perjantai;29;22;51;2;6;8
292;07.07.2017;2017;07;08;Perjantai;14;7;21;7;4;11
292;07.07.2017;2017;07;09;Perjantai;32;11;43;7;10;17
292;07.07.2017;2017;07;10;Perjantai;42;10;52;13;14;27
292;07.07.2017;2017;07;11;Perjantai;40;27;67;8;16;24
292;07.07.2017;2017;07;12;Perjantai;37;36;73;8;32;40
292;07.07.2017;2017;07;13;Perjantai;45;47;92;6;23;29
292;07.07.2017;2017;07;14;Perjantai;58;36;94;14;30;44
292;07.07.2017;2017;07;15;Perjantai;57;47;104;9;36;45
292;07.07.2017;2017;07;16;Perjantai;55;38;93;20;30;50
292;07.07.2017;2017;07;17;Perjantai;62;32;94;5;27;32
292;07.07.2017;2017;07;18;Perjantai;49;33;82;16;31;47
292;07.07.2017;2017;07;19;Perjantai;46;26;72;17;16;33
292;07.07.2017;2017;07;20;Perjantai;41;33;74;10;32;42
292;07.07.2017;2017;07;21;Perjantai;27;18;45;19;13;32
292;07.07.2017;2017;07;22;Perjantai;11;9;20;5;5;10
292;07.07.2017;2017;07;23;Perjantai;11;0;11;7;4;11
292;08.07.2017;2017;07;00;Lauantai;6;5;11;2;1;3
292;08.07.2017;2017;07;01;Lauantai;3;3;6;2;4;6
292;08.07.2017;2017;07;02;Lauantai;2;14;16;0;3;3
292;08.07.2017;2017;07;03;Lauantai;1;3;4;0;2;2
292;08.07.2017;2017;07;04;Lauantai;1;2;3;0;2;2
292;08.07.2017;2017;07;05;Lauantai;2;0;2;2;0;2
292;08.07.2017;2017;07;06;Lauantai;7;5;12;2;5;7
292;08.07.2017;2017;07;07;Lauantai;7;4;11;2;3;5
292;08.07.2017;2017;07;08;Lauantai;9;8;17;3;8;11
292;08.07.2017;2017;07;09;Lauantai;26;19;45;5;10;15
292;08.07.2017;2017;07;10;Lauantai;40;15;55;17;9;26
292;08.07.2017;2017;07;11;Lauantai;29;25;54;10;9;19
292;08.07.2017;2017;07;12;Lauantai;59;28;87;13;27;40
292;08.07.2017;2017;07;13;Lauantai;48;31;79;4;22;26
292;08.07.2017;2017;07;14;Lauantai;38;42;80;16;25;41
292;08.07.2017;2017;07;15;Lauantai;43;36;79;9;22;31
292;08.07.2017;2017;07;16;Lauantai;62;20;82;12;18;30
292;08.07.2017;2017;07;17;Lauantai;44;36;80;11;22;33
292;08.07.2017;2017;07;18;Lauantai;73;30;103;14;24;38
292;08.07.2017;2017;07;19;Lauantai;33;16;49;9;19;28
292;08.07.2017;2017;07;20;Lauantai;32;28;60;11;23;34
292;08.07.2017;2017;07;21;Lauantai;18;9;27;5;13;18
292;08.07.2017;2017;07;22;Lauantai;9;11;20;6;13;19
292;08.07.2017;2017;07;23;Lauantai;5;1;6;1;1;2
292;09.07.2017;2017;07;00;Sunnuntai;10;3;13;11;5;16
292;09.07.2017;2017;07;01;Sunnuntai;2;4;6;3;4;7
292;09.07.2017;2017;07;02;Sunnuntai;3;4;7;0;6;6
292;09.07.2017;2017;07;03;Sunnuntai;0;7;7;0;2;2
292;09.07.2017;2017;07;04;Sunnuntai;2;4;6;1;2;3
292;09.07.2017;2017;07;05;Sunnuntai;3;2;5;2;1;3
292;09.07.2017;2017;07;06;Sunnuntai;5;5;10;1;4;5
292;09.07.2017;2017;07;07;Sunnuntai;6;2;8;2;2;4
292;09.07.2017;2017;07;08;Sunnuntai;12;5;17;1;4;5
292;09.07.2017;2017;07;09;Sunnuntai;25;11;36;3;12;15
292;09.07.2017;2017;07;10;Sunnuntai;35;24;59;13;6;19
292;09.07.2017;2017;07;11;Sunnuntai;54;44;98;11;7;18
292;09.07.2017;2017;07;12;Sunnuntai;65;50;115;12;23;35
292;09.07.2017;2017;07;13;Sunnuntai;60;40;100;13;41;54
292;09.07.2017;2017;07;14;Sunnuntai;56;23;79;9;22;31
292;09.07.2017;2017;07;15;Sunnuntai;44;45;89;7;18;25
292;09.07.2017;2017;07;16;Sunnuntai;64;29;93;14;24;38
292;09.07.2017;2017;07;17;Sunnuntai;60;43;103;9;29;38
292;09.07.2017;2017;07;18;Sunnuntai;79;37;116;11;28;39
292;09.07.2017;2017;07;19;Sunnuntai;36;47;83;12;20;32
292;09.07.2017;2017;07;20;Sunnuntai;47;21;68;8;20;28
292;09.07.2017;2017;07;21;Sunnuntai;23;29;52;7;14;21
292;09.07.2017;2017;07;22;Sunnuntai;6;2;8;2;4;6
292;09.07.2017;2017;07;23;Sunnuntai;3;7;10;1;4;5
292;10.07.2017;2017;07;00;Maanantai;5;2;7;2;5;7
292;10.07.2017;2017;07;01;Maanantai;0;2;2;0;2;2
292;10.07.2017;2017;07;02;Maanantai;0;1;1;1;0;1
292;10.07.2017;2017;07;03;Maanantai;1;0;1;1;1;2
292;10.07.2017;2017;07;04;Maanantai;6;1;7;0;0;0
292;10.07.2017;2017;07;05;Maanantai;7;10;17;2;1;3
292;10.07.2017;2017;07;06;Maanantai;14;12;26;0;8;8
292;10.07.2017;2017;07;07;Maanantai;39;21;60;6;10;16
292;10.07.2017;2017;07;08;Maanantai;26;17;43;10;9;19
292;10.07.2017;2017;07;09;Maanantai;37;21;58;14;4;18
292;10.07.2017;2017;07;10;Maanantai;47;37;84;4;4;8
292;10.07.2017;2017;07;11;Maanantai;52;48;100;12;11;23
292;10.07.2017;2017;07;12;Maanantai;65;43;108;5;17;22
292;10.07.2017;2017;07;13;Maanantai;78;55;133;5;23;28
292;10.07.2017;2017;07;14;Maanantai;62;43;105;11;17;28
292;10.07.2017;2017;07;15;Maanantai;67;56;123;5;24;29
292;10.07.2017;2017;07;16;Maanantai;73;51;124;9;22;31
292;10.07.2017;2017;07;17;Maanantai;59;44;103;11;18;29
292;10.07.2017;2017;07;18;Maanantai;45;33;78;8;20;28
292;10.07.2017;2017;07;19;Maanantai;64;30;94;16;20;36
292;10.07.2017;2017;07;20;Maanantai;35;38;73;15;15;30
292;10.07.2017;2017;07;21;Maanantai;22;10;32;11;10;21
292;10.07.2017;2017;07;22;Maanantai;5;6;11;3;6;9
292;10.07.2017;2017;07;23;Maanantai;8;13;21;4;3;7
292;11.07.2017;2017;07;00;Tiistai;5;2;7;5;2;7
292;11.07.2017;2017;07;01;Tiistai;4;1;5;1;6;7
292;11.07.2017;2017;07;02;Tiistai;2;1;3;0;2;2
292;11.07.2017;2017;07;03;Tiistai;2;2;4;0;0;0
292;11.07.2017;2017;07;04;Tiistai;4;0;4;0;1;1
292;11.07.2017;2017;07;05;Tiistai;8;5;13;1;2;3
292;11.07.2017;2017;07;06;Tiistai;14;11;25;3;5;8
292;11.07.2017;2017;07;07;Tiistai;33;17;50;4;13;17
292;11.07.2017;2017;07;08;Tiistai;24;11;35;7;8;15
292;11.07.2017;2017;07;09;Tiistai;34;26;60;4;4;8
292;11.07.2017;2017;07;10;Tiistai;46;36;82;7;8;15
292;11.07.2017;2017;07;11;Tiistai;54;51;105;12;8;20
292;11.07.2017;2017;07;12;Tiistai;70;41;111;4;10;14
292;11.07.2017;2017;07;13;Tiistai;55;35;90;11;17;28
292;11.07.2017;2017;07;14;Tiistai;68;43;111;9;6;15
292;11.07.2017;2017;07;15;Tiistai;81;34;115;11;18;29
292;11.07.2017;2017;07;16;Tiistai;82;49;131;13;29;42
292;11.07.2017;2017;07;17;Tiistai;68;40;108;16;35;51
292;11.07.2017;2017;07;18;Tiistai;73;62;135;21;35;56
292;11.07.2017;2017;07;19;Tiistai;45;28;73;20;25;45
292;11.07.2017;2017;07;20;Tiistai;29;27;56;13;20;33
292;11.07.2017;2017;07;21;Tiistai;16;15;31;5;5;10
292;11.07.2017;2017;07;22;Tiistai;5;8;13;3;1;4
292;11.07.2017;2017;07;23;Tiistai;0;1;1;0;1;1
292;12.07.2017;2017;07;00;Keskiviikko;1;3;4;0;0;0
292;12.07.2017;2017;07;01;Keskiviikko;0;0;0;0;1;1
292;12.07.2017;2017;07;02;Keskiviikko;1;0;1;0;1;1
292;12.07.2017;2017;07;03;Keskiviikko;0;0;0;0;0;0
292;12.07.2017;2017;07;04;Keskiviikko;2;0;2;0;0;0
292;12.07.2017;2017;07;05;Keskiviikko;4;10;14;0;0;0
292;12.07.2017;2017;07;06;Keskiviikko;9;9;18;0;4;4
292;12.07.2017;2017;07;07;Keskiviikko;14;10;24;0;1;1
292;12.07.2017;2017;07;08;Keskiviikko;12;7;19;3;2;5
292;12.07.2017;2017;07;09;Keskiviikko;14;9;23;1;1;2
292;12.07.2017;2017;07;10;Keskiviikko;11;11;22;5;6;11
292;12.07.2017;2017;07;11;Keskiviikko;13;14;27;5;6;11
292;12.07.2017;2017;07;12;Keskiviikko;29;14;43;7;8;15
292;12.07.2017;2017;07;13;Keskiviikko;23;14;37;4;8;12
292;12.07.2017;2017;07;14;Keskiviikko;31;25;56;6;7;13
292;12.07.2017;2017;07;15;Keskiviikko;11;9;20;2;2;4
292;12.07.2017;2017;07;16;Keskiviikko;24;18;42;7;2;9
292;12.07.2017;2017;07;17;Keskiviikko;20;22;42;7;14;21
292;12.07.2017;2017;07;18;Keskiviikko;9;7;16;4;7;11
292;12.07.2017;2017;07;19;Keskiviikko;8;10;18;1;1;2
292;12.07.2017;2017;07;20;Keskiviikko;11;9;20;3;2;5
292;12.07.2017;2017;07;21;Keskiviikko;7;7;14;0;1;1
292;12.07.2017;2017;07;22;Keskiviikko;2;2;4;0;0;0
292;12.07.2017;2017;07;23;Keskiviikko;0;0;0;1;1;2
292;13.07.2017;2017;07;00;Torstai;0;0;0;1;0;1
292;13.07.2017;2017;07;01;Torstai;0;1;1;0;1;1
292;13.07.2017;2017;07;02;Torstai;2;0;2;1;0;1
292;13.07.2017;2017;07;03;Torstai;1;1;2;2;1;3
292;13.07.2017;2017;07;04;Torstai;2;2;4;0;0;0
292;13.07.2017;2017;07;05;Torstai;4;4;8;1;1;2
292;13.07.2017;2017;07;06;Torstai;14;11;25;1;5;6
292;13.07.2017;2017;07;07;Torstai;17;14;31;2;2;4
292;13.07.2017;2017;07;08;Torstai;11;10;21;9;5;14
292;13.07.2017;2017;07;09;Torstai;23;19;42;6;6;12
292;13.07.2017;2017;07;10;Torstai;27;28;55;1;2;3
292;13.07.2017;2017;07;11;Torstai;35;31;66;6;8;14
292;13.07.2017;2017;07;12;Torstai;48;43;91;4;12;16
292;13.07.2017;2017;07;13;Torstai;56;42;98;13;27;40
292;13.07.2017;2017;07;14;Torstai;59;52;111;12;32;44
292;13.07.2017;2017;07;15;Torstai;54;34;88;15;26;41
292;13.07.2017;2017;07;16;Torstai;45;30;75;17;8;25
292;13.07.2017;2017;07;17;Torstai;55;26;81;7;15;22
292;13.07.2017;2017;07;18;Torstai;30;22;52;14;10;24
292;13.07.2017;2017;07;19;Torstai;19;16;35;8;12;20
292;13.07.2017;2017;07;20;Torstai;36;30;66;8;3;11
292;13.07.2017;2017;07;21;Torstai;20;11;31;3;7;10
292;13.07.2017;2017;07;22;Torstai;9;6;15;2;4;6
292;13.07.2017;2017;07;23;Torstai;4;3;7;4;1;5
292;14.07.2017;2017;07;00;Perjantai;1;7;8;3;7;10
292;14.07.2017;2017;07;01;Perjantai;0;6;6;0;2;2
292;14.07.2017;2017;07;02;Perjantai;1;1;2;2;0;2
292;14.07.2017;2017;07;03;Perjantai;2;0;2;0;0;0
292;14.07.2017;2017;07;04;Perjantai;3;0;3;0;0;0
292;14.07.2017;2017;07;05;Perjantai;5;6;11;1;2;3
292;14.07.2017;2017;07;06;Perjantai;6;6;12;0;2;2
292;14.07.2017;2017;07;07;Perjantai;14;13;27;4;10;14
292;14.07.2017;2017;07;08;Perjantai;6;6;12;3;1;4
292;14.07.2017;2017;07;09;Perjantai;4;3;7;2;0;2
292;14.07.2017;2017;07;10;Perjantai;1;1;2;0;0;0
292;14.07.2017;2017;07;11;Perjantai;7;6;13;3;1;4
292;14.07.2017;2017;07;12;Perjantai;9;9;18;1;2;3
292;14.07.2017;2017;07;13;Perjantai;20;16;36;5;8;13
292;14.07.2017;2017;07;14;Perjantai;25;20;45;8;8;16
292;14.07.2017;2017;07;15;Perjantai;34;29;63;9;11;20
292;14.07.2017;2017;07;16;Perjantai;42;34;76;10;9;19
292;14.07.2017;2017;07;17;Perjantai;48;32;80;18;19;37
292;14.07.2017;2017;07;18;Perjantai;45;36;81;14;24;38
292;14.07.2017;2017;07;19;Perjantai;47;31;78;13;27;40
292;14.07.2017;2017;07;20;Perjantai;35;20;55;11;17;28
292;14.07.2017;2017;07;21;Perjantai;12;8;20;3;8;11
292;14.07.2017;2017;07;22;Perjantai;13;6;19;3;5;8
292;14.07.2017;2017;07;23;Perjantai;8;2;10;4;3;7
292;15.07.2017;2017;07;00;Lauantai;9;3;12;8;2;10
292;15.07.2017;2017;07;01;Lauantai;5;7;12;2;5;7
292;15.07.2017;2017;07;02;Lauantai;1;5;6;8;11;19
292;15.07.2017;2017;07;03;Lauantai;0;1;1;1;4;5
292;15.07.2017;2017;07;04;Lauantai;1;0;1;1;0;1
292;15.07.2017;2017;07;05;Lauantai;1;1;2;1;4;5
292;15.07.2017;2017;07;06;Lauantai;5;1;6;2;1;3
292;15.07.2017;2017;07;07;Lauantai;6;3;9;0;1;1
292;15.07.2017;2017;07;08;Lauantai;13;8;21;3;2;5
292;15.07.2017;2017;07;09;Lauantai;19;15;34;1;6;7
292;15.07.2017;2017;07;10;Lauantai;20;18;38;5;6;11
292;15.07.2017;2017;07;11;Lauantai;45;44;89;12;12;24
292;15.07.2017;2017;07;12;Lauantai;34;30;64;4;19;23
292;15.07.2017;2017;07;13;Lauantai;52;39;91;13;28;41
292;15.07.2017;2017;07;14;Lauantai;39;35;74;17;21;38
292;15.07.2017;2017;07;15;Lauantai;66;40;106;16;14;30
292;15.07.2017;2017;07;16;Lauantai;47;37;84;16;18;34
292;15.07.2017;2017;07;17;Lauantai;33;18;51;1;19;20
292;15.07.2017;2017;07;18;Lauantai;40;22;62;14;15;29
292;15.07.2017;2017;07;19;Lauantai;21;26;47;16;17;33
292;15.07.2017;2017;07;20;Lauantai;22;16;38;10;12;22
292;15.07.2017;2017;07;21;Lauantai;17;16;33;12;17;29
292;15.07.2017;2017;07;22;Lauantai;7;5;12;4;12;16
292;15.07.2017;2017;07;23;Lauantai;9;7;16;4;3;7
292;16.07.2017;2017;07;00;Sunnuntai;8;6;14;2;2;4
292;16.07.2017;2017;07;01;Sunnuntai;1;7;8;1;1;2
292;16.07.2017;2017;07;02;Sunnuntai;4;8;12;5;3;8
292;16.07.2017;2017;07;03;Sunnuntai;0;2;2;4;8;12
292;16.07.2017;2017;07;04;Sunnuntai;1;0;1;1;5;6
292;16.07.2017;2017;07;05;Sunnuntai;2;0;2;1;2;3
292;16.07.2017;2017;07;06;Sunnuntai;9;3;12;0;3;3
292;16.07.2017;2017;07;07;Sunnuntai;7;1;8;6;3;9
292;16.07.2017;2017;07;08;Sunnuntai;20;6;26;6;4;10
292;16.07.2017;2017;07;09;Sunnuntai;32;11;43;9;6;15
292;16.07.2017;2017;07;10;Sunnuntai;31;27;58;9;7;16
292;16.07.2017;2017;07;11;Sunnuntai;45;52;97;14;19;33
292;16.07.2017;2017;07;12;Sunnuntai;61;39;100;15;24;39
292;16.07.2017;2017;07;13;Sunnuntai;63;39;102;14;29;43
292;16.07.2017;2017;07;14;Sunnuntai;59;44;103;23;32;55
292;16.07.2017;2017;07;15;Sunnuntai;83;45;128;16;18;34
292;16.07.2017;2017;07;16;Sunnuntai;104;46;150;16;23;39
292;16.07.2017;2017;07;17;Sunnuntai;53;32;85;14;24;38
292;16.07.2017;2017;07;18;Sunnuntai;58;38;96;21;24;45
292;16.07.2017;2017;07;19;Sunnuntai;52;74;126;12;44;56
292;16.07.2017;2017;07;20;Sunnuntai;35;32;67;12;16;28
292;16.07.2017;2017;07;21;Sunnuntai;19;25;44;10;17;27
292;16.07.2017;2017;07;22;Sunnuntai;9;12;21;8;8;16
292;16.07.2017;2017;07;23;Sunnuntai;11;8;19;5;4;9
292;17.07.2017;2017;07;00;Maanantai;7;1;8;2;1;3
292;17.07.2017;2017;07;01;Maanantai;0;3;3;0;3;3
292;17.07.2017;2017;07;02;Maanantai;0;9;9;2;6;8
292;17.07.2017;2017;07;03;Maanantai;0;2;2;0;0;0
292;17.07.2017;2017;07;04;Maanantai;4;1;5;0;0;0
292;17.07.2017;2017;07;05;Maanantai;7;2;9;1;2;3
292;17.07.2017;2017;07;06;Maanantai;18;11;29;2;7;9
292;17.07.2017;2017;07;07;Maanantai;27;10;37;6;2;8
292;17.07.2017;2017;07;08;Maanantai;24;12;36;7;5;12
292;17.07.2017;2017;07;09;Maanantai;33;23;56;4;4;8
292;17.07.2017;2017;07;10;Maanantai;29;25;54;8;2;10
292;17.07.2017;2017;07;11;Maanantai;40;35;75;15;19;34
292;17.07.2017;2017;07;12;Maanantai;50;40;90;6;21;27
292;17.07.2017;2017;07;13;Maanantai;48;33;81;5;20;25
292;17.07.2017;2017;07;14;Maanantai;46;35;81;16;31;47
292;17.07.2017;2017;07;15;Maanantai;58;30;88;18;25;43
292;17.07.2017;2017;07;16;Maanantai;80;42;122;18;26;44
292;17.07.2017;2017;07;17;Maanantai;75;41;116;18;34;52
292;17.07.2017;2017;07;18;Maanantai;64;44;108;17;24;41
292;17.07.2017;2017;07;19;Maanantai;43;33;76;8;31;39
292;17.07.2017;2017;07;20;Maanantai;41;30;71;7;11;18
292;17.07.2017;2017;07;21;Maanantai;22;16;38;10;13;23
292;17.07.2017;2017;07;22;Maanantai;10;13;23;5;8;13
292;17.07.2017;2017;07;23;Maanantai;3;4;7;1;7;8
292;18.07.2017;2017;07;00;Tiistai;2;1;3;0;1;1
292;18.07.2017;2017;07;01;Tiistai;0;1;1;1;2;3
292;18.07.2017;2017;07;02;Tiistai;0;4;4;1;0;1
292;18.07.2017;2017;07;03;Tiistai;0;1;1;0;1;1
292;18.07.2017;2017;07;04;Tiistai;1;0;1;0;0;0
292;18.07.2017;2017;07;05;Tiistai;3;3;6;1;0;1
292;18.07.2017;2017;07;06;Tiistai;7;5;12;0;1;1
292;18.07.2017;2017;07;07;Tiistai;2;0;2;1;1;2
292;18.07.2017;2017;07;08;Tiistai;2;2;4;2;1;3
292;18.07.2017;2017;07;09;Tiistai;3;3;6;3;1;4
292;18.07.2017;2017;07;10;Tiistai;9;6;15;6;1;7
292;18.07.2017;2017;07;11;Tiistai;11;9;20;4;8;12
292;18.07.2017;2017;07;12;Tiistai;14;17;31;2;3;5
292;18.07.2017;2017;07;13;Tiistai;20;21;41;3;1;4
292;18.07.2017;2017;07;14;Tiistai;22;21;43;6;1;7
292;18.07.2017;2017;07;15;Tiistai;24;26;50;10;21;31
292;18.07.2017;2017;07;16;Tiistai;30;20;50;12;9;21
292;18.07.2017;2017;07;17;Tiistai;45;27;72;13;14;27
292;18.07.2017;2017;07;18;Tiistai;28;21;49;10;14;24
292;18.07.2017;2017;07;19;Tiistai;26;10;36;14;9;23
292;18.07.2017;2017;07;20;Tiistai;13;17;30;4;8;12
292;18.07.2017;2017;07;21;Tiistai;7;6;13;5;4;9
292;18.07.2017;2017;07;22;Tiistai;4;2;6;2;2;4
292;18.07.2017;2017;07;23;Tiistai;1;3;4;2;1;3
292;19.07.2017;2017;07;00;Keskiviikko;4;0;4;3;1;4
292;19.07.2017;2017;07;01;Keskiviikko;0;1;1;0;0;0
292;19.07.2017;2017;07;02;Keskiviikko;0;0;0;0;1;1
292;19.07.2017;2017;07;03;Keskiviikko;1;0;1;1;1;2
292;19.07.2017;2017;07;04;Keskiviikko;3;2;5;0;0;0
292;19.07.2017;2017;07;05;Keskiviikko;3;2;5;0;3;3
292;19.07.2017;2017;07;06;Keskiviikko;11;7;18;2;3;5
292;19.07.2017;2017;07;07;Keskiviikko;9;10;19;1;3;4
292;19.07.2017;2017;07;08;Keskiviikko;17;15;32;9;0;9
292;19.07.2017;2017;07;09;Keskiviikko;19;19;38;3;3;6
292;19.07.2017;2017;07;10;Keskiviikko;25;22;47;8;8;16
292;19.07.2017;2017;07;11;Keskiviikko;44;29;73;6;14;20
292;19.07.2017;2017;07;12;Keskiviikko;44;26;70;6;19;25
292;19.07.2017;2017;07;13;Keskiviikko;42;31;73;6;16;22
292;19.07.2017;2017;07;14;Keskiviikko;29;26;55;16;17;33
292;19.07.2017;2017;07;15;Keskiviikko;44;36;80;10;23;33
292;19.07.2017;2017;07;16;Keskiviikko;42;45;87;6;21;27
292;19.07.2017;2017;07;17;Keskiviikko;32;27;59;11;16;27
292;19.07.2017;2017;07;18;Keskiviikko;43;31;74;19;6;25
292;19.07.2017;2017;07;19;Keskiviikko;52;34;86;18;21;39
292;19.07.2017;2017;07;20;Keskiviikko;36;16;52;5;14;19
292;19.07.2017;2017;07;21;Keskiviikko;27;10;37;9;11;20
292;19.07.2017;2017;07;22;Keskiviikko;3;10;13;3;7;10
292;19.07.2017;2017;07;23;Keskiviikko;10;5;15;1;3;4
292;20.07.2017;2017;07;00;Torstai;5;4;9;0;0;0
292;20.07.2017;2017;07;01;Torstai;3;6;9;2;0;2
292;20.07.2017;2017;07;02;Torstai;1;2;3;0;3;3
292;20.07.2017;2017;07;03;Torstai;0;1;1;0;0;0
292;20.07.2017;2017;07;04;Torstai;1;2;3;1;2;3
292;20.07.2017;2017;07;05;Torstai;5;4;9;1;1;2
292;20.07.2017;2017;07;06;Torstai;18;7;25;1;8;9
292;20.07.2017;2017;07;07;Torstai;17;15;32;5;6;11
292;20.07.2017;2017;07;08;Torstai;19;17;36;7;10;17
292;20.07.2017;2017;07;09;Torstai;19;14;33;5;4;9
292;20.07.2017;2017;07;10;Torstai;25;17;42;21;14;35
292;20.07.2017;2017;07;11;Torstai;28;28;56;12;11;23
292;20.07.2017;2017;07;12;Torstai;39;38;77;10;6;16
292;20.07.2017;2017;07;13;Torstai;49;42;91;6;5;11
292;20.07.2017;2017;07;14;Torstai;38;40;78;7;9;16
292;20.07.2017;2017;07;15;Torstai;45;41;86;7;28;35
292;20.07.2017;2017;07;16;Torstai;61;45;106;13;15;28
292;20.07.2017;2017;07;17;Torstai;79;36;115;17;22;39
292;20.07.2017;2017;07;18;Torstai;53;40;93;14;27;41
292;20.07.2017;2017;07;19;Torstai;50;31;81;12;25;37
292;20.07.2017;2017;07;20;Torstai;38;33;71;11;28;39
292;20.07.2017;2017;07;21;Torstai;10;15;25;10;14;24
292;20.07.2017;2017;07;22;Torstai;6;9;15;0;2;2
292;20.07.2017;2017;07;23;Torstai;4;8;12;3;4;7
292;21.07.2017;2017;07;00;Perjantai;3;3;6;1;2;3
292;21.07.2017;2017;07;01;Perjantai;0;3;3;0;0;0
292;21.07.2017;2017;07;02;Perjantai;2;2;4;0;1;1
292;21.07.2017;2017;07;03;Perjantai;0;1;1;1;0;1
292;21.07.2017;2017;07;04;Perjantai;1;0;1;1;0;1
292;21.07.2017;2017;07;05;Perjantai;4;1;5;0;1;1
292;21.07.2017;2017;07;06;Perjantai;8;8;16;0;4;4
292;21.07.2017;2017;07;07;Perjantai;13;14;27;2;3;5
292;21.07.2017;2017;07;08;Perjantai;19;10;29;5;8;13
292;21.07.2017;2017;07;09;Perjantai;26;14;40;7;5;12
292;21.07.2017;2017;07;10;Perjantai;39;20;59;7;9;16
292;21.07.2017;2017;07;11;Perjantai;42;27;69;11;5;16
292;21.07.2017;2017;07;12;Perjantai;44;45;89;17;17;34
292;21.07.2017;2017;07;13;Perjantai;30;21;51;11;18;29
292;21.07.2017;2017;07;14;Perjantai;37;31;68;14;19;33
292;21.07.2017;2017;07;15;Perjantai;32;39;71;3;11;14
292;21.07.2017;2017;07;16;Perjantai;44;19;63;15;14;29
292;21.07.2017;2017;07;17;Perjantai;33;35;68;21;18;39
292;21.07.2017;2017;07;18;Perjantai;29;31;60;14;37;51
292;21.07.2017;2017;07;19;Perjantai;38;26;64;13;9;22
292;21.07.2017;2017;07;20;Perjantai;26;11;37;10;15;25
292;21.07.2017;2017;07;21;Perjantai;17;12;29;6;20;26
292;21.07.2017;2017;07;22;Perjantai;12;9;21;6;8;14
292;21.07.2017;2017;07;23;Perjantai;7;4;11;6;4;10
292;22.07.2017;2017;07;00;Lauantai;8;5;13;4;3;7
292;22.07.2017;2017;07;01;Lauantai;3;1;4;8;4;12
292;22.07.2017;2017;07;02;Lauantai;2;3;5;4;5;9
292;22.07.2017;2017;07;03;Lauantai;0;3;3;3;11;14
292;22.07.2017;2017;07;04;Lauantai;0;0;0;0;3;3
292;22.07.2017;2017;07;05;Lauantai;1;0;1;0;0;0
292;22.07.2017;2017;07;06;Lauantai;6;1;7;2;2;4
292;22.07.2017;2017;07;07;Lauantai;5;5;10;0;2;2
292;22.07.2017;2017;07;08;Lauantai;8;6;14;0;2;2
292;22.07.2017;2017;07;09;Lauantai;21;17;38;3;5;8
292;22.07.2017;2017;07;10;Lauantai;27;23;50;6;11;17
292;22.07.2017;2017;07;11;Lauantai;30;24;54;16;14;30
292;22.07.2017;2017;07;12;Lauantai;46;30;76;4;15;19
292;22.07.2017;2017;07;13;Lauantai;34;31;65;13;8;21
292;22.07.2017;2017;07;14;Lauantai;32;36;68;10;8;18
292;22.07.2017;2017;07;15;Lauantai;43;41;84;10;13;23
292;22.07.2017;2017;07;16;Lauantai;42;25;67;9;5;14
292;22.07.2017;2017;07;17;Lauantai;32;24;56;6;8;14
292;22.07.2017;2017;07;18;Lauantai;37;29;66;10;10;20
292;22.07.2017;2017;07;19;Lauantai;33;22;55;17;25;42
292;22.07.2017;2017;07;20;Lauantai;25;16;41;16;11;27
292;22.07.2017;2017;07;21;Lauantai;13;15;28;3;12;15
292;22.07.2017;2017;07;22;Lauantai;12;12;24;5;7;12
292;22.07.2017;2017;07;23;Lauantai;4;12;16;2;3;5
292;23.07.2017;2017;07;00;Sunnuntai;10;10;20;9;4;13
292;23.07.2017;2017;07;01;Sunnuntai;8;4;12;0;8;8
292;23.07.2017;2017;07;02;Sunnuntai;3;10;13;1;1;2
292;23.07.2017;2017;07;03;Sunnuntai;2;1;3;1;7;8
292;23.07.2017;2017;07;04;Sunnuntai;1;0;1;0;1;1
292;23.07.2017;2017;07;05;Sunnuntai;1;0;1;1;0;1
292;23.07.2017;2017;07;06;Sunnuntai;6;5;11;2;2;4
292;23.07.2017;2017;07;07;Sunnuntai;5;5;10;0;2;2
292;23.07.2017;2017;07;08;Sunnuntai;10;6;16;6;3;9
292;23.07.2017;2017;07;09;Sunnuntai;27;9;36;5;8;13
292;23.07.2017;2017;07;10;Sunnuntai;48;27;75;8;10;18
292;23.07.2017;2017;07;11;Sunnuntai;38;36;74;8;10;18
292;23.07.2017;2017;07;12;Sunnuntai;50;49;99;12;12;24
292;23.07.2017;2017;07;13;Sunnuntai;37;33;70;8;11;19
292;23.07.2017;2017;07;14;Sunnuntai;33;36;69;8;11;19
292;23.07.2017;2017;07;15;Sunnuntai;42;29;71;11;18;29
292;23.07.2017;2017;07;16;Sunnuntai;15;9;24;5;4;9
292;23.07.2017;2017;07;17;Sunnuntai;16;14;30;7;10;17
292;23.07.2017;2017;07;18;Sunnuntai;22;9;31;11;13;24
292;23.07.2017;2017;07;19;Sunnuntai;24;10;34;12;6;18
292;23.07.2017;2017;07;20;Sunnuntai;21;12;33;4;11;15
292;23.07.2017;2017;07;21;Sunnuntai;7;9;16;3;2;5
292;23.07.2017;2017;07;22;Sunnuntai;1;6;7;4;1;5
292;23.07.2017;2017;07;23;Sunnuntai;5;2;7;4;2;6
292;24.07.2017;2017;07;00;Maanantai;2;4;6;1;6;7
292;24.07.2017;2017;07;01;Maanantai;0;2;2;0;4;4
292;24.07.2017;2017;07;02;Maanantai;1;1;2;2;0;2
292;24.07.2017;2017;07;03;Maanantai;0;2;2;0;1;1
292;24.07.2017;2017;07;04;Maanantai;1;2;3;0;1;1
292;24.07.2017;2017;07;05;Maanantai;3;5;8;0;2;2
292;24.07.2017;2017;07;06;Maanantai;15;5;20;3;10;13
292;24.07.2017;2017;07;07;Maanantai;21;15;36;2;12;14
292;24.07.2017;2017;07;08;Maanantai;13;11;24;7;4;11
292;24.07.2017;2017;07;09;Maanantai;20;16;36;11;4;15
292;24.07.2017;2017;07;10;Maanantai;33;23;56;4;15;19
292;24.07.2017;2017;07;11;Maanantai;36;34;70;7;2;9
292;24.07.2017;2017;07;12;Maanantai;48;36;84;10;5;15
292;24.07.2017;2017;07;13;Maanantai;55;44;99;7;8;15
292;24.07.2017;2017;07;14;Maanantai;57;50;107;7;8;15
292;24.07.2017;2017;07;15;Maanantai;35;29;64;7;6;13
292;24.07.2017;2017;07;16;Maanantai;51;42;93;16;6;22
292;24.07.2017;2017;07;17;Maanantai;53;34;87;10;10;20
292;24.07.2017;2017;07;18;Maanantai;52;46;98;9;21;30
292;24.07.2017;2017;07;19;Maanantai;49;20;69;17;18;35
292;24.07.2017;2017;07;20;Maanantai;46;33;79;16;28;44
292;24.07.2017;2017;07;21;Maanantai;25;15;40;8;16;24
292;24.07.2017;2017;07;22;Maanantai;13;9;22;8;6;14
292;24.07.2017;2017;07;23;Maanantai;5;4;9;2;8;10
292;25.07.2017;2017;07;00;Tiistai;3;5;8;4;6;10
292;25.07.2017;2017;07;01;Tiistai;2;4;6;0;4;4
292;25.07.2017;2017;07;02;Tiistai;0;0;0;2;1;3
292;25.07.2017;2017;07;03;Tiistai;1;2;3;0;2;2
292;25.07.2017;2017;07;04;Tiistai;2;1;3;0;4;4
292;25.07.2017;2017;07;05;Tiistai;8;4;12;0;1;1
292;25.07.2017;2017;07;06;Tiistai;25;12;37;1;7;8
292;25.07.2017;2017;07;07;Tiistai;26;12;38;6;5;11
292;25.07.2017;2017;07;08;Tiistai;17;13;30;3;6;9
292;25.07.2017;2017;07;09;Tiistai;27;17;44;5;3;8
292;25.07.2017;2017;07;10;Tiistai;42;37;79;6;10;16
292;25.07.2017;2017;07;11;Tiistai;53;51;104;10;9;19
292;25.07.2017;2017;07;12;Tiistai;57;36;93;4;18;22
292;25.07.2017;2017;07;13;Tiistai;44;42;86;6;5;11
292;25.07.2017;2017;07;14;Tiistai;61;53;114;7;13;20
292;25.07.2017;2017;07;15;Tiistai;75;66;141;9;9;18
292;25.07.2017;2017;07;16;Tiistai;60;44;104;20;18;38
292;25.07.2017;2017;07;17;Tiistai;128;50;178;21;33;54
292;25.07.2017;2017;07;18;Tiistai;86;52;138;24;34;58
292;25.07.2017;2017;07;19;Tiistai;49;45;94;22;38;60
292;25.07.2017;2017;07;20;Tiistai;45;36;81;21;39;60
292;25.07.2017;2017;07;21;Tiistai;24;47;71;6;21;27
292;25.07.2017;2017;07;22;Tiistai;5;15;20;2;7;9
292;25.07.2017;2017;07;23;Tiistai;9;4;13;2;4;6
292;26.07.2017;2017;07;00;Keskiviikko;3;10;13;3;4;7
292;26.07.2017;2017;07;01;Keskiviikko;0;3;3;0;1;1
292;26.07.2017;2017;07;02;Keskiviikko;0;3;3;0;2;2
292;26.07.2017;2017;07;03;Keskiviikko;0;0;0;0;2;2
292;26.07.2017;2017;07;04;Keskiviikko;1;4;5;0;0;0
292;26.07.2017;2017;07;05;Keskiviikko;7;7;14;0;2;2
292;26.07.2017;2017;07;06;Keskiviikko;18;10;28;1;4;5
292;26.07.2017;2017;07;07;Keskiviikko;31;18;49;4;4;8
292;26.07.2017;2017;07;08;Keskiviikko;26;12;38;8;6;14
292;26.07.2017;2017;07;09;Keskiviikko;40;20;60;2;9;11
292;26.07.2017;2017;07;10;Keskiviikko;43;31;74;7;7;14
292;26.07.2017;2017;07;11;Keskiviikko;58;61;119;3;9;12
292;26.07.2017;2017;07;12;Keskiviikko;61;38;99;16;16;32
292;26.07.2017;2017;07;13;Keskiviikko;52;33;85;12;12;24
292;26.07.2017;2017;07;14;Keskiviikko;45;51;96;24;44;68
292;26.07.2017;2017;07;15;Keskiviikko;70;44;114;14;23;37
292;26.07.2017;2017;07;16;Keskiviikko;88;44;132;20;24;44
292;26.07.2017;2017;07;17;Keskiviikko;60;41;101;18;24;42
292;26.07.2017;2017;07;18;Keskiviikko;70;52;122;16;47;63
292;26.07.2017;2017;07;19;Keskiviikko;67;50;117;16;27;43
292;26.07.2017;2017;07;20;Keskiviikko;47;31;78;14;23;37
292;26.07.2017;2017;07;21;Keskiviikko;23;27;50;15;17;32
292;26.07.2017;2017;07;22;Keskiviikko;13;5;18;4;10;14
292;26.07.2017;2017;07;23;Keskiviikko;9;8;17;2;4;6
292;27.07.2017;2017;07;00;Torstai;1;4;5;0;2;2
292;27.07.2017;2017;07;01;Torstai;1;3;4;0;4;4
292;27.07.2017;2017;07;02;Torstai;1;2;3;0;1;1
292;27.07.2017;2017;07;03;Torstai;0;0;0;1;2;3
292;27.07.2017;2017;07;04;Torstai;2;0;2;1;0;1
292;27.07.2017;2017;07;05;Torstai;3;6;9;1;2;3
292;27.07.2017;2017;07;06;Torstai;16;12;28;5;9;14
292;27.07.2017;2017;07;07;Torstai;28;19;47;3;1;4
292;27.07.2017;2017;07;08;Torstai;20;14;34;5;2;7
292;27.07.2017;2017;07;09;Torstai;35;16;51;3;4;7
292;27.07.2017;2017;07;10;Torstai;39;29;68;3;6;9
292;27.07.2017;2017;07;11;Torstai;47;43;90;9;9;18
292;27.07.2017;2017;07;12;Torstai;52;51;103;5;11;16
292;27.07.2017;2017;07;13;Torstai;60;53;113;16;23;39
292;27.07.2017;2017;07;14;Torstai;71;35;106;13;16;29
292;27.07.2017;2017;07;15;Torstai;71;45;116;13;26;39
292;27.07.2017;2017;07;16;Torstai;79;61;140;15;27;42
292;27.07.2017;2017;07;17;Torstai;79;46;125;10;43;53
292;27.07.2017;2017;07;18;Torstai;77;60;137;26;50;76
292;27.07.2017;2017;07;19;Torstai;65;54;119;7;29;36
292;27.07.2017;2017;07;20;Torstai;54;26;80;14;22;36
292;27.07.2017;2017;07;21;Torstai;20;16;36;8;13;21
292;27.07.2017;2017;07;22;Torstai;10;9;19;1;13;14
292;27.07.2017;2017;07;23;Torstai;7;7;14;5;2;7
292;28.07.2017;2017;07;00;Perjantai;3;3;6;5;3;8
292;28.07.2017;2017;07;01;Perjantai;1;4;5;0;3;3
292;28.07.2017;2017;07;02;Perjantai;0;2;2;0;0;0
292;28.07.2017;2017;07;03;Perjantai;1;0;1;2;1;3
292;28.07.2017;2017;07;04;Perjantai;1;2;3;1;1;2
292;28.07.2017;2017;07;05;Perjantai;4;4;8;1;7;8
292;28.07.2017;2017;07;06;Perjantai;11;10;21;1;5;6
292;28.07.2017;2017;07;07;Perjantai;26;12;38;4;1;5
292;28.07.2017;2017;07;08;Perjantai;21;8;29;8;6;14
292;28.07.2017;2017;07;09;Perjantai;31;12;43;9;3;12
292;28.07.2017;2017;07;10;Perjantai;37;29;66;7;4;11
292;28.07.2017;2017;07;11;Perjantai;53;42;95;8;10;18
292;28.07.2017;2017;07;12;Perjantai;48;36;84;5;11;16
292;28.07.2017;2017;07;13;Perjantai;51;35;86;10;21;31
292;28.07.2017;2017;07;14;Perjantai;77;40;117;16;15;31
292;28.07.2017;2017;07;15;Perjantai;70;40;110;6;24;30
292;28.07.2017;2017;07;16;Perjantai;58;43;101;12;18;30
292;28.07.2017;2017;07;17;Perjantai;70;44;114;12;11;23
292;28.07.2017;2017;07;18;Perjantai;54;56;110;14;34;48
292;28.07.2017;2017;07;19;Perjantai;41;29;70;19;17;36
292;28.07.2017;2017;07;20;Perjantai;36;25;61;11;19;30
292;28.07.2017;2017;07;21;Perjantai;28;8;36;6;23;29
292;28.07.2017;2017;07;22;Perjantai;9;10;19;13;7;20
292;28.07.2017;2017;07;23;Perjantai;7;7;14;2;9;11
292;29.07.2017;2017;07;00;Lauantai;2;3;5;2;3;5
292;29.07.2017;2017;07;01;Lauantai;1;9;10;5;1;6
292;29.07.2017;2017;07;02;Lauantai;5;5;10;2;2;4
292;29.07.2017;2017;07;03;Lauantai;1;5;6;2;7;9
292;29.07.2017;2017;07;04;Lauantai;1;0;1;1;0;1
292;29.07.2017;2017;07;05;Lauantai;1;3;4;1;1;2
292;29.07.2017;2017;07;06;Lauantai;9;5;14;4;2;6
292;29.07.2017;2017;07;07;Lauantai;6;4;10;2;3;5
292;29.07.2017;2017;07;08;Lauantai;9;10;19;3;2;5
292;29.07.2017;2017;07;09;Lauantai;14;13;27;2;3;5
292;29.07.2017;2017;07;10;Lauantai;28;19;47;9;6;15
292;29.07.2017;2017;07;11;Lauantai;26;14;40;12;7;19
292;29.07.2017;2017;07;12;Lauantai;16;15;31;3;7;10
292;29.07.2017;2017;07;13;Lauantai;26;19;45;4;2;6
292;29.07.2017;2017;07;14;Lauantai;22;21;43;2;8;10
292;29.07.2017;2017;07;15;Lauantai;26;18;44;3;6;9
292;29.07.2017;2017;07;16;Lauantai;40;22;62;17;13;30
292;29.07.2017;2017;07;17;Lauantai;39;19;58;5;19;24
292;29.07.2017;2017;07;18;Lauantai;52;13;65;14;18;32
292;29.07.2017;2017;07;19;Lauantai;37;18;55;12;14;26
292;29.07.2017;2017;07;20;Lauantai;24;23;47;13;23;36
292;29.07.2017;2017;07;21;Lauantai;24;19;43;11;9;20
292;29.07.2017;2017;07;22;Lauantai;8;6;14;2;7;9
292;29.07.2017;2017;07;23;Lauantai;6;5;11;6;5;11
292;30.07.2017;2017;07;00;Sunnuntai;5;2;7;4;6;10
292;30.07.2017;2017;07;01;Sunnuntai;4;3;7;0;5;5
292;30.07.2017;2017;07;02;Sunnuntai;0;2;2;1;9;10
292;30.07.2017;2017;07;03;Sunnuntai;0;7;7;2;3;5
292;30.07.2017;2017;07;04;Sunnuntai;0;3;3;2;1;3
292;30.07.2017;2017;07;05;Sunnuntai;0;1;1;0;1;1
292;30.07.2017;2017;07;06;Sunnuntai;9;7;16;3;1;4
292;30.07.2017;2017;07;07;Sunnuntai;8;0;8;3;3;6
292;30.07.2017;2017;07;08;Sunnuntai;12;3;15;4;4;8
292;30.07.2017;2017;07;09;Sunnuntai;27;9;36;6;5;11
292;30.07.2017;2017;07;10;Sunnuntai;31;28;59;7;3;10
292;30.07.2017;2017;07;11;Sunnuntai;44;39;83;7;20;27
292;30.07.2017;2017;07;12;Sunnuntai;77;38;115;12;36;48
292;30.07.2017;2017;07;13;Sunnuntai;70;34;104;13;26;39
292;30.07.2017;2017;07;14;Sunnuntai;51;53;104;12;33;45
292;30.07.2017;2017;07;15;Sunnuntai;69;57;126;7;25;32
292;30.07.2017;2017;07;16;Sunnuntai;83;43;126;11;18;29
292;30.07.2017;2017;07;17;Sunnuntai;66;59;125;15;30;45
292;30.07.2017;2017;07;18;Sunnuntai;45;40;85;12;32;44
292;30.07.2017;2017;07;19;Sunnuntai;61;75;136;18;53;71
292;30.07.2017;2017;07;20;Sunnuntai;57;25;82;14;19;33
292;30.07.2017;2017;07;21;Sunnuntai;14;21;35;4;19;23
292;30.07.2017;2017;07;22;Sunnuntai;5;8;13;3;15;18
292;30.07.2017;2017;07;23;Sunnuntai;5;4;9;1;1;2
292;31.07.2017;2017;07;00;Maanantai;4;6;10;1;4;5
292;31.07.2017;2017;07;01;Maanantai;7;12;19;7;4;11
292;31.07.2017;2017;07;02;Maanantai;1;0;1;1;2;3
292;31.07.2017;2017;07;03;Maanantai;0;0;0;0;0;0
292;31.07.2017;2017;07;04;Maanantai;1;3;4;0;1;1
292;31.07.2017;2017;07;05;Maanantai;4;6;10;1;4;5
292;31.07.2017;2017;07;06;Maanantai;22;8;30;2;9;11
292;31.07.2017;2017;07;07;Maanantai;39;21;60;1;10;11
292;31.07.2017;2017;07;08;Maanantai;20;15;35;2;8;10
292;31.07.2017;2017;07;09;Maanantai;25;22;47;10;6;16
292;31.07.2017;2017;07;10;Maanantai;29;29;58;7;13;20
292;31.07.2017;2017;07;11;Maanantai;38;36;74;14;7;21
292;31.07.2017;2017;07;12;Maanantai;58;38;96;9;20;29
292;31.07.2017;2017;07;13;Maanantai;73;48;121;14;33;47
292;31.07.2017;2017;07;14;Maanantai;67;53;120;25;37;62
292;31.07.2017;2017;07;15;Maanantai;75;54;129;19;31;50
292;31.07.2017;2017;07;16;Maanantai;95;58;153;17;35;52
292;31.07.2017;2017;07;17;Maanantai;65;55;120;19;28;47
292;31.07.2017;2017;07;18;Maanantai;85;63;148;21;38;59
292;31.07.2017;2017;07;19;Maanantai;33;25;58;18;13;31
292;31.07.2017;2017;07;20;Maanantai;41;25;66;19;20;39
292;31.07.2017;2017;07;21;Maanantai;24;24;48;5;13;18
292;31.07.2017;2017;07;22;Maanantai;4;12;16;3;8;11
292;31.07.2017;2017;07;23;Maanantai;3;6;9;5;0;5
292;01.08.2017;2017;08;00;Tiistai;3;0;3;2;0;2
292;01.08.2017;2017;08;01;Tiistai;0;1;1;0;1;1
292;01.08.2017;2017;08;02;Tiistai;2;7;9;4;1;5
292;01.08.2017;2017;08;03;Tiistai;4;1;5;1;0;1
292;01.08.2017;2017;08;04;Tiistai;3;2;5;1;1;2
292;01.08.2017;2017;08;05;Tiistai;7;5;12;0;5;5
292;01.08.2017;2017;08;06;Tiistai;19;14;33;2;6;8
292;01.08.2017;2017;08;07;Tiistai;48;34;82;3;6;9
292;01.08.2017;2017;08;08;Tiistai;23;21;44;7;1;8
292;01.08.2017;2017;08;09;Tiistai;29;20;49;5;8;13
292;01.08.2017;2017;08;10;Tiistai;31;28;59;7;3;10
292;01.08.2017;2017;08;11;Tiistai;51;47;98;15;17;32
292;01.08.2017;2017;08;12;Tiistai;46;38;84;9;24;33
292;01.08.2017;2017;08;13;Tiistai;57;47;104;17;26;43
292;01.08.2017;2017;08;14;Tiistai;60;53;113;17;35;52
292;01.08.2017;2017;08;15;Tiistai;74;58;132;29;31;60
292;01.08.2017;2017;08;16;Tiistai;89;50;139;22;26;48
292;01.08.2017;2017;08;17;Tiistai;78;50;128;15;27;42
292;01.08.2017;2017;08;18;Tiistai;62;47;109;20;29;49
292;01.08.2017;2017;08;19;Tiistai;62;43;105;16;29;45
292;01.08.2017;2017;08;20;Tiistai;47;58;105;16;28;44
292;01.08.2017;2017;08;21;Tiistai;23;21;44;10;18;28
292;01.08.2017;2017;08;22;Tiistai;15;16;31;7;11;18
292;01.08.2017;2017;08;23;Tiistai;12;7;19;1;2;3
292;02.08.2017;2017;08;00;Keskiviikko;6;3;9;2;3;5
292;02.08.2017;2017;08;01;Keskiviikko;2;6;8;3;3;6
292;02.08.2017;2017;08;02;Keskiviikko;1;1;2;0;1;1
292;02.08.2017;2017;08;03;Keskiviikko;0;1;1;0;0;0
292;02.08.2017;2017;08;04;Keskiviikko;3;0;3;0;1;1
292;02.08.2017;2017;08;05;Keskiviikko;2;6;8;0;4;4
292;02.08.2017;2017;08;06;Keskiviikko;24;14;38;0;7;7
292;02.08.2017;2017;08;07;Keskiviikko;52;16;68;4;2;6
292;02.08.2017;2017;08;08;Keskiviikko;29;17;46;7;4;11
292;02.08.2017;2017;08;09;Keskiviikko;40;20;60;7;6;13
292;02.08.2017;2017;08;10;Keskiviikko;42;39;81;7;4;11
292;02.08.2017;2017;08;11;Keskiviikko;57;44;101;8;28;36
292;02.08.2017;2017;08;12;Keskiviikko;65;45;110;14;32;46
292;02.08.2017;2017;08;13;Keskiviikko;47;41;88;17;27;44
292;02.08.2017;2017;08;14;Keskiviikko;58;49;107;18;28;46
292;02.08.2017;2017;08;15;Keskiviikko;79;54;133;12;34;46
292;02.08.2017;2017;08;16;Keskiviikko;73;65;138;13;33;46
292;02.08.2017;2017;08;17;Keskiviikko;72;36;108;15;21;36
292;02.08.2017;2017;08;18;Keskiviikko;39;44;83;24;28;52
292;02.08.2017;2017;08;19;Keskiviikko;52;37;89;11;27;38
292;02.08.2017;2017;08;20;Keskiviikko;48;43;91;20;23;43
292;02.08.2017;2017;08;21;Keskiviikko;24;13;37;9;15;24
292;02.08.2017;2017;08;22;Keskiviikko;8;5;13;3;3;6
292;02.08.2017;2017;08;23;Keskiviikko;4;2;6;4;1;5
292;03.08.2017;2017;08;00;Torstai;1;5;6;1;3;4
292;03.08.2017;2017;08;01;Torstai;1;7;8;0;4;4
292;03.08.2017;2017;08;02;Torstai;4;2;6;3;0;3
292;03.08.2017;2017;08;03;Torstai;0;0;0;0;0;0
292;03.08.2017;2017;08;04;Torstai;3;1;4;1;1;2
292;03.08.2017;2017;08;05;Torstai;7;4;11;0;4;4
292;03.08.2017;2017;08;06;Torstai;15;15;30;3;6;9
292;03.08.2017;2017;08;07;Torstai;37;24;61;2;9;11
292;03.08.2017;2017;08;08;Torstai;27;24;51;4;3;7
292;03.08.2017;2017;08;09;Torstai;38;32;70;5;8;13
292;03.08.2017;2017;08;10;Torstai;33;31;64;7;15;22
292;03.08.2017;2017;08;11;Torstai;42;38;80;14;13;27
292;03.08.2017;2017;08;12;Torstai;51;46;97;11;22;33
292;03.08.2017;2017;08;13;Torstai;44;45;89;17;42;59
292;03.08.2017;2017;08;14;Torstai;69;42;111;16;33;49
292;03.08.2017;2017;08;15;Torstai;72;51;123;8;36;44
292;03.08.2017;2017;08;16;Torstai;66;54;120;15;31;46
292;03.08.2017;2017;08;17;Torstai;40;49;89;17;27;44
292;03.08.2017;2017;08;18;Torstai;77;50;127;12;36;48
292;03.08.2017;2017;08;19;Torstai;61;46;107;17;38;55
292;03.08.2017;2017;08;20;Torstai;59;36;95;22;23;45
292;03.08.2017;2017;08;21;Torstai;16;17;33;4;22;26
292;03.08.2017;2017;08;22;Torstai;16;10;26;3;5;8
292;03.08.2017;2017;08;23;Torstai;5;1;6;3;2;5
292;04.08.2017;2017;08;00;Perjantai;2;4;6;1;2;3
292;04.08.2017;2017;08;01;Perjantai;1;1;2;0;0;0
292;04.08.2017;2017;08;02;Perjantai;0;0;0;0;4;4
292;04.08.2017;2017;08;03;Perjantai;0;0;0;0;0;0
292;04.08.2017;2017;08;04;Perjantai;1;0;1;0;0;0
292;04.08.2017;2017;08;05;Perjantai;3;5;8;1;6;7
292;04.08.2017;2017;08;06;Perjantai;21;9;30;0;7;7
292;04.08.2017;2017;08;07;Perjantai;44;29;73;1;4;5
292;04.08.2017;2017;08;08;Perjantai;22;18;40;12;3;15
292;04.08.2017;2017;08;09;Perjantai;34;32;66;12;5;17
292;04.08.2017;2017;08;10;Perjantai;42;25;67;13;6;19
292;04.08.2017;2017;08;11;Perjantai;48;43;91;16;22;38
292;04.08.2017;2017;08;12;Perjantai;60;45;105;9;26;35
292;04.08.2017;2017;08;13;Perjantai;52;48;100;13;21;34
292;04.08.2017;2017;08;14;Perjantai;58;43;101;17;28;45
292;04.08.2017;2017;08;15;Perjantai;69;62;131;14;30;44
292;04.08.2017;2017;08;16;Perjantai;75;39;114;13;31;44
292;04.08.2017;2017;08;17;Perjantai;97;46;143;32;30;62
292;04.08.2017;2017;08;18;Perjantai;50;46;96;24;35;59
292;04.08.2017;2017;08;19;Perjantai;52;35;87;13;26;39
292;04.08.2017;2017;08;20;Perjantai;32;61;93;16;31;47
292;04.08.2017;2017;08;21;Perjantai;28;22;50;10;12;22
292;04.08.2017;2017;08;22;Perjantai;17;17;34;10;5;15
292;04.08.2017;2017;08;23;Perjantai;4;10;14;3;7;10
292;05.08.2017;2017;08;00;Lauantai;7;2;9;3;2;5
292;05.08.2017;2017;08;01;Lauantai;4;3;7;2;5;7
292;05.08.2017;2017;08;02;Lauantai;3;3;6;0;5;5
292;05.08.2017;2017;08;03;Lauantai;0;6;6;1;1;2
292;05.08.2017;2017;08;04;Lauantai;0;0;0;0;0;0
292;05.08.2017;2017;08;05;Lauantai;1;2;3;2;1;3
292;05.08.2017;2017;08;06;Lauantai;5;2;7;0;3;3
292;05.08.2017;2017;08;07;Lauantai;6;6;12;2;6;8
292;05.08.2017;2017;08;08;Lauantai;9;11;20;5;8;13
292;05.08.2017;2017;08;09;Lauantai;11;13;24;9;16;25
292;05.08.2017;2017;08;10;Lauantai;21;18;39;169;95;264
292;05.08.2017;2017;08;11;Lauantai;30;30;60;20;85;105
292;05.08.2017;2017;08;12;Lauantai;53;19;72;229;8;237
292;05.08.2017;2017;08;13;Lauantai;23;33;56;12;248;260
292;05.08.2017;2017;08;14;Lauantai;34;36;70;8;54;62
292;05.08.2017;2017;08;15;Lauantai;28;15;43;11;13;24
292;05.08.2017;2017;08;16;Lauantai;21;23;44;9;15;24
292;05.08.2017;2017;08;17;Lauantai;20;15;35;11;5;16
292;05.08.2017;2017;08;18;Lauantai;25;12;37;7;3;10
292;05.08.2017;2017;08;19;Lauantai;10;5;15;5;2;7
292;05.08.2017;2017;08;20;Lauantai;9;5;14;3;5;8
292;05.08.2017;2017;08;21;Lauantai;7;7;14;4;4;8
292;05.08.2017;2017;08;22;Lauantai;4;5;9;1;5;6
292;05.08.2017;2017;08;23;Lauantai;3;4;7;4;1;5
292;06.08.2017;2017;08;00;Sunnuntai;1;3;4;6;2;8
292;06.08.2017;2017;08;01;Sunnuntai;3;4;7;0;8;8
292;06.08.2017;2017;08;02;Sunnuntai;3;2;5;5;1;6
292;06.08.2017;2017;08;03;Sunnuntai;3;1;4;1;0;1
292;06.08.2017;2017;08;04;Sunnuntai;2;1;3;0;2;2
292;06.08.2017;2017;08;05;Sunnuntai;1;0;1;1;0;1
292;06.08.2017;2017;08;06;Sunnuntai;1;1;2;0;4;4
292;06.08.2017;2017;08;07;Sunnuntai;7;5;12;2;3;5
292;06.08.2017;2017;08;08;Sunnuntai;6;2;8;8;3;11
292;06.08.2017;2017;08;09;Sunnuntai;13;7;20;6;8;14
292;06.08.2017;2017;08;10;Sunnuntai;16;15;31;7;12;19
292;06.08.2017;2017;08;11;Sunnuntai;25;17;42;10;14;24
292;06.08.2017;2017;08;12;Sunnuntai;31;21;52;13;11;24
292;06.08.2017;2017;08;13;Sunnuntai;26;15;41;3;8;11
292;06.08.2017;2017;08;14;Sunnuntai;17;19;36;9;19;28
292;06.08.2017;2017;08;15;Sunnuntai;29;25;54;8;18;26
292;06.08.2017;2017;08;16;Sunnuntai;35;19;54;15;16;31
292;06.08.2017;2017;08;17;Sunnuntai;50;29;79;13;18;31
292;06.08.2017;2017;08;18;Sunnuntai;43;28;71;12;21;33
292;06.08.2017;2017;08;19;Sunnuntai;40;36;76;13;20;33
292;06.08.2017;2017;08;20;Sunnuntai;22;20;42;10;11;21
292;06.08.2017;2017;08;21;Sunnuntai;6;10;16;6;14;20
292;06.08.2017;2017;08;22;Sunnuntai;1;11;12;2;7;9
292;06.08.2017;2017;08;23;Sunnuntai;0;2;2;1;1;2
292;07.08.2017;2017;08;00;Maanantai;3;2;5;1;1;2
292;07.08.2017;2017;08;01;Maanantai;0;1;1;1;0;1
292;07.08.2017;2017;08;02;Maanantai;0;1;1;1;1;2
292;07.08.2017;2017;08;03;Maanantai;1;2;3;0;0;0
292;07.08.2017;2017;08;04;Maanantai;2;2;4;0;1;1
292;07.08.2017;2017;08;05;Maanantai;8;3;11;0;4;4
292;07.08.2017;2017;08;06;Maanantai;24;10;34;1;10;11
292;07.08.2017;2017;08;07;Maanantai;33;27;60;3;4;7
292;07.08.2017;2017;08;08;Maanantai;29;24;53;4;23;27
292;07.08.2017;2017;08;09;Maanantai;26;21;47;12;11;23
292;07.08.2017;2017;08;10;Maanantai;21;29;50;10;21;31
292;07.08.2017;2017;08;11;Maanantai;39;26;65;7;14;21
292;07.08.2017;2017;08;12;Maanantai;30;33;63;15;24;39
292;07.08.2017;2017;08;13;Maanantai;41;40;81;11;25;36
292;07.08.2017;2017;08;14;Maanantai;56;43;99;23;18;41
292;07.08.2017;2017;08;15;Maanantai;59;54;113;13;24;37
292;07.08.2017;2017;08;16;Maanantai;86;64;150;19;31;50
292;07.08.2017;2017;08;17;Maanantai;46;45;91;20;33;53
292;07.08.2017;2017;08;18;Maanantai;54;36;90;27;42;69
292;07.08.2017;2017;08;19;Maanantai;44;33;77;16;37;53
292;07.08.2017;2017;08;20;Maanantai;44;24;68;20;23;43
292;07.08.2017;2017;08;21;Maanantai;22;17;39;11;7;18
292;07.08.2017;2017;08;22;Maanantai;2;4;6;2;7;9
292;07.08.2017;2017;08;23;Maanantai;1;3;4;3;1;4
292;08.08.2017;2017;08;00;Tiistai;2;1;3;1;1;2
292;08.08.2017;2017;08;01;Tiistai;1;2;3;0;0;0
292;08.08.2017;2017;08;02;Tiistai;0;2;2;0;1;1
292;08.08.2017;2017;08;03;Tiistai;0;0;0;0;0;0
292;08.08.2017;2017;08;04;Tiistai;1;0;1;0;0;0
292;08.08.2017;2017;08;05;Tiistai;5;6;11;0;5;5
292;08.08.2017;2017;08;06;Tiistai;27;12;39;3;9;12
292;08.08.2017;2017;08;07;Tiistai;49;31;80;0;13;13
292;08.08.2017;2017;08;08;Tiistai;23;18;41;5;17;22
292;08.08.2017;2017;08;09;Tiistai;31;28;59;13;9;22
292;08.08.2017;2017;08;10;Tiistai;38;25;63;6;9;15
292;08.08.2017;2017;08;11;Tiistai;33;28;61;20;22;42
292;08.08.2017;2017;08;12;Tiistai;67;45;112;14;33;47
292;08.08.2017;2017;08;13;Tiistai;64;49;113;17;24;41
292;08.08.2017;2017;08;14;Tiistai;67;29;96;20;20;40
292;08.08.2017;2017;08;15;Tiistai;75;45;120;21;37;58
292;08.08.2017;2017;08;16;Tiistai;81;61;142;16;35;51
292;08.08.2017;2017;08;17;Tiistai;58;60;118;10;30;40
292;08.08.2017;2017;08;18;Tiistai;81;60;141;16;29;45
292;08.08.2017;2017;08;19;Tiistai;49;25;74;9;15;24
292;08.08.2017;2017;08;20;Tiistai;23;12;35;12;9;21
292;08.08.2017;2017;08;21;Tiistai;12;12;24;4;10;14
292;08.08.2017;2017;08;22;Tiistai;8;4;12;0;3;3
292;08.08.2017;2017;08;23;Tiistai;5;2;7;1;2;3
292;09.08.2017;2017;08;00;Keskiviikko;1;0;1;0;1;1
292;09.08.2017;2017;08;01;Keskiviikko;2;1;3;0;0;0
292;09.08.2017;2017;08;02;Keskiviikko;0;1;1;0;0;0
292;09.08.2017;2017;08;03;Keskiviikko;0;0;0;0;1;1
292;09.08.2017;2017;08;04;Keskiviikko;1;0;1;0;0;0
292;09.08.2017;2017;08;05;Keskiviikko;7;7;14;0;1;1
292;09.08.2017;2017;08;06;Keskiviikko;28;15;43;0;10;10
292;09.08.2017;2017;08;07;Keskiviikko;44;37;81;2;7;9
292;09.08.2017;2017;08;08;Keskiviikko;35;27;62;8;9;17
292;09.08.2017;2017;08;09;Keskiviikko;26;17;43;6;9;15
292;09.08.2017;2017;08;10;Keskiviikko;27;22;49;7;11;18
292;09.08.2017;2017;08;11;Keskiviikko;45;39;84;14;18;32
292;09.08.2017;2017;08;12;Keskiviikko;64;39;103;20;34;54
292;09.08.2017;2017;08;13;Keskiviikko;56;48;104;14;31;45
292;09.08.2017;2017;08;14;Keskiviikko;71;50;121;8;35;43
292;09.08.2017;2017;08;15;Keskiviikko;82;56;138;23;23;46
292;09.08.2017;2017;08;16;Keskiviikko;92;79;171;22;47;69
292;09.08.2017;2017;08;17;Keskiviikko;69;39;108;17;32;49
292;09.08.2017;2017;08;18;Keskiviikko;67;48;115;25;28;53
292;09.08.2017;2017;08;19;Keskiviikko;62;52;114;19;40;59
292;09.08.2017;2017;08;20;Keskiviikko;40;48;88;14;26;40
292;09.08.2017;2017;08;21;Keskiviikko;19;17;36;10;11;21
292;09.08.2017;2017;08;22;Keskiviikko;5;10;15;5;3;8
292;09.08.2017;2017;08;23;Keskiviikko;5;6;11;1;2;3
292;10.08.2017;2017;08;00;Torstai;0;0;0;1;1;2
292;10.08.2017;2017;08;01;Torstai;1;1;2;0;0;0
292;10.08.2017;2017;08;02;Torstai;0;0;0;0;1;1
292;10.08.2017;2017;08;03;Torstai;0;0;0;0;0;0
292;10.08.2017;2017;08;04;Torstai;3;1;4;0;0;0
292;10.08.2017;2017;08;05;Torstai;4;4;8;1;3;4
292;10.08.2017;2017;08;06;Torstai;18;14;32;1;14;15
292;10.08.2017;2017;08;07;Torstai;38;22;60;4;6;10
292;10.08.2017;2017;08;08;Torstai;115;48;163;17;11;28
292;10.08.2017;2017;08;09;Torstai;53;24;77;4;16;20
292;10.08.2017;2017;08;10;Torstai;35;18;53;11;11;22
292;10.08.2017;2017;08;11;Torstai;16;18;34;3;14;17
292;10.08.2017;2017;08;12;Torstai;11;23;34;3;6;9
292;10.08.2017;2017;08;13;Torstai;32;48;80;7;8;15
292;10.08.2017;2017;08;14;Torstai;29;24;53;2;9;11
292;10.08.2017;2017;08;15;Torstai;35;27;62;5;9;14
292;10.08.2017;2017;08;16;Torstai;36;33;69;2;8;10
292;10.08.2017;2017;08;17;Torstai;44;29;73;9;13;22
292;10.08.2017;2017;08;18;Torstai;38;25;63;16;13;29
292;10.08.2017;2017;08;19;Torstai;25;20;45;13;31;44
292;10.08.2017;2017;08;20;Torstai;34;11;45;12;22;34
292;10.08.2017;2017;08;21;Torstai;10;6;16;4;7;11
292;10.08.2017;2017;08;22;Torstai;3;1;4;3;4;7
292;10.08.2017;2017;08;23;Torstai;2;4;6;2;3;5
292;11.08.2017;2017;08;00;Perjantai;1;3;4;1;0;1
292;11.08.2017;2017;08;01;Perjantai;0;3;3;0;0;0
292;11.08.2017;2017;08;02;Perjantai;1;2;3;0;1;1
292;11.08.2017;2017;08;03;Perjantai;0;1;1;0;0;0
292;11.08.2017;2017;08;04;Perjantai;4;0;4;1;0;1
292;11.08.2017;2017;08;05;Perjantai;5;5;10;0;3;3
292;11.08.2017;2017;08;06;Perjantai;21;17;38;0;9;9
292;11.08.2017;2017;08;07;Perjantai;47;31;78;3;10;13
292;11.08.2017;2017;08;08;Perjantai;99;44;143;17;8;25
292;11.08.2017;2017;08;09;Perjantai;44;32;76;5;5;10
292;11.08.2017;2017;08;10;Perjantai;28;27;55;5;10;15
292;11.08.2017;2017;08;11;Perjantai;33;25;58;5;21;26
292;11.08.2017;2017;08;12;Perjantai;47;23;70;12;14;26
292;11.08.2017;2017;08;13;Perjantai;49;122;171;14;60;74
292;11.08.2017;2017;08;14;Perjantai;61;55;116;17;37;54
292;11.08.2017;2017;08;15;Perjantai;42;55;97;22;40;62
292;11.08.2017;2017;08;16;Perjantai;85;56;141;17;32;49
292;11.08.2017;2017;08;17;Perjantai;75;33;108;21;21;42
292;11.08.2017;2017;08;18;Perjantai;54;45;99;20;25;45
292;11.08.2017;2017;08;19;Perjantai;45;37;82;17;24;41
292;11.08.2017;2017;08;20;Perjantai;29;43;72;22;32;54
292;11.08.2017;2017;08;21;Perjantai;23;22;45;11;14;25
292;11.08.2017;2017;08;22;Perjantai;7;9;16;8;6;14
292;11.08.2017;2017;08;23;Perjantai;8;7;15;7;4;11
292;12.08.2017;2017;08;00;Lauantai;1;4;5;4;4;8
292;12.08.2017;2017;08;01;Lauantai;3;10;13;2;7;9
292;12.08.2017;2017;08;02;Lauantai;3;4;7;6;7;13
292;12.08.2017;2017;08;03;Lauantai;1;4;5;1;1;2
292;12.08.2017;2017;08;04;Lauantai;1;0;1;0;0;0
292;12.08.2017;2017;08;05;Lauantai;0;1;1;0;1;1
292;12.08.2017;2017;08;06;Lauantai;3;3;6;0;1;1
292;12.08.2017;2017;08;07;Lauantai;9;6;15;3;9;12
292;12.08.2017;2017;08;08;Lauantai;12;11;23;6;4;10
292;12.08.2017;2017;08;09;Lauantai;20;21;41;4;6;10
292;12.08.2017;2017;08;10;Lauantai;35;39;74;8;19;27
292;12.08.2017;2017;08;11;Lauantai;54;33;87;23;28;51
292;12.08.2017;2017;08;12;Lauantai;53;43;96;15;24;39
292;12.08.2017;2017;08;13;Lauantai;55;30;85;10;28;38
292;12.08.2017;2017;08;14;Lauantai;51;32;83;12;19;31
292;12.08.2017;2017;08;15;Lauantai;50;32;82;13;19;32
292;12.08.2017;2017;08;16;Lauantai;57;38;95;22;31;53
292;12.08.2017;2017;08;17;Lauantai;44;33;77;18;19;37
292;12.08.2017;2017;08;18;Lauantai;36;22;58;10;14;24
292;12.08.2017;2017;08;19;Lauantai;25;21;46;15;22;37
292;12.08.2017;2017;08;20;Lauantai;24;19;43;11;15;26
292;12.08.2017;2017;08;21;Lauantai;14;14;28;3;13;16
292;12.08.2017;2017;08;22;Lauantai;4;5;9;6;3;9
292;12.08.2017;2017;08;23;Lauantai;4;4;8;1;3;4
292;13.08.2017;2017;08;00;Sunnuntai;8;2;10;3;1;4
292;13.08.2017;2017;08;01;Sunnuntai;1;1;2;2;2;4
292;13.08.2017;2017;08;02;Sunnuntai;0;1;1;0;4;4
292;13.08.2017;2017;08;03;Sunnuntai;0;3;3;0;2;2
292;13.08.2017;2017;08;04;Sunnuntai;1;1;2;4;2;6
292;13.08.2017;2017;08;05;Sunnuntai;0;0;0;0;0;0
292;13.08.2017;2017;08;06;Sunnuntai;2;2;4;1;1;2
292;13.08.2017;2017;08;07;Sunnuntai;3;2;5;0;0;0
292;13.08.2017;2017;08;08;Sunnuntai;4;0;4;0;2;2
292;13.08.2017;2017;08;09;Sunnuntai;12;7;19;4;9;13
292;13.08.2017;2017;08;10;Sunnuntai;16;16;32;10;7;17
292;13.08.2017;2017;08;11;Sunnuntai;16;14;30;11;8;19
292;13.08.2017;2017;08;12;Sunnuntai;19;13;32;4;4;8
292;13.08.2017;2017;08;13;Sunnuntai;13;12;25;4;8;12
292;13.08.2017;2017;08;14;Sunnuntai;11;15;26;4;5;9
292;13.08.2017;2017;08;15;Sunnuntai;14;20;34;14;7;21
292;13.08.2017;2017;08;16;Sunnuntai;25;19;44;3;10;13
292;13.08.2017;2017;08;17;Sunnuntai;27;15;42;5;20;25
292;13.08.2017;2017;08;18;Sunnuntai;35;8;43;14;17;31
292;13.08.2017;2017;08;19;Sunnuntai;26;35;61;24;20;44
292;13.08.2017;2017;08;20;Sunnuntai;21;20;41;8;22;30
292;13.08.2017;2017;08;21;Sunnuntai;11;11;22;8;6;14
292;13.08.2017;2017;08;22;Sunnuntai;1;3;4;1;2;3
292;13.08.2017;2017;08;23;Sunnuntai;3;1;4;0;1;1
292;14.08.2017;2017;08;00;Maanantai;1;0;1;0;1;1
292;14.08.2017;2017;08;01;Maanantai;0;0;0;0;0;0
292;14.08.2017;2017;08;02;Maanantai;0;0;0;0;1;1
292;14.08.2017;2017;08;03;Maanantai;0;0;0;0;1;1
292;14.08.2017;2017;08;04;Maanantai;4;2;6;0;0;0
292;14.08.2017;2017;08;05;Maanantai;8;8;16;0;1;1
292;14.08.2017;2017;08;06;Maanantai;25;13;38;2;8;10
292;14.08.2017;2017;08;07;Maanantai;79;46;125;7;10;17
292;14.08.2017;2017;08;08;Maanantai;54;28;82;7;15;22
292;14.08.2017;2017;08;09;Maanantai;74;28;102;3;5;8
292;14.08.2017;2017;08;10;Maanantai;28;22;50;7;14;21
292;14.08.2017;2017;08;11;Maanantai;26;26;52;10;22;32
292;14.08.2017;2017;08;12;Maanantai;29;14;43;9;14;23
292;14.08.2017;2017;08;13;Maanantai;29;49;78;9;27;36
292;14.08.2017;2017;08;14;Maanantai;43;58;101;17;28;45
292;14.08.2017;2017;08;15;Maanantai;46;73;119;9;30;39
292;14.08.2017;2017;08;16;Maanantai;73;88;161;14;31;45
292;14.08.2017;2017;08;17;Maanantai;62;44;106;19;30;49
292;14.08.2017;2017;08;18;Maanantai;68;32;100;14;26;40
292;14.08.2017;2017;08;19;Maanantai;59;43;102;19;35;54
292;14.08.2017;2017;08;20;Maanantai;31;22;53;20;29;49
292;14.08.2017;2017;08;21;Maanantai;14;21;35;7;9;16
292;14.08.2017;2017;08;22;Maanantai;6;6;12;4;1;5
292;14.08.2017;2017;08;23;Maanantai;1;0;1;0;0;0
292;15.08.2017;2017;08;00;Tiistai;1;3;4;2;0;2
292;15.08.2017;2017;08;01;Tiistai;1;1;2;0;0;0
292;15.08.2017;2017;08;02;Tiistai;1;1;2;0;0;0
292;15.08.2017;2017;08;03;Tiistai;0;1;1;0;0;0
292;15.08.2017;2017;08;04;Tiistai;1;0;1;1;0;1
292;15.08.2017;2017;08;05;Tiistai;9;6;15;1;2;3
292;15.08.2017;2017;08;06;Tiistai;30;14;44;3;16;19
292;15.08.2017;2017;08;07;Tiistai;92;54;146;10;5;15
292;15.08.2017;2017;08;08;Tiistai;68;44;112;11;7;18
292;15.08.2017;2017;08;09;Tiistai;31;27;58;12;23;35
292;15.08.2017;2017;08;10;Tiistai;29;20;49;10;23;33
292;15.08.2017;2017;08;11;Tiistai;31;24;55;13;16;29
292;15.08.2017;2017;08;12;Tiistai;38;20;58;6;16;22
292;15.08.2017;2017;08;13;Tiistai;40;54;94;13;33;46
292;15.08.2017;2017;08;14;Tiistai;49;85;134;11;47;58
292;15.08.2017;2017;08;15;Tiistai;63;65;128;17;40;57
292;15.08.2017;2017;08;16;Tiistai;80;75;155;17;32;49
292;15.08.2017;2017;08;17;Tiistai;72;56;128;19;37;56
292;15.08.2017;2017;08;18;Tiistai;54;54;108;27;39;66
292;15.08.2017;2017;08;19;Tiistai;67;38;105;15;30;45
292;15.08.2017;2017;08;20;Tiistai;40;35;75;15;30;45
292;15.08.2017;2017;08;21;Tiistai;10;15;25;3;10;13
292;15.08.2017;2017;08;22;Tiistai;7;1;8;4;5;9
292;15.08.2017;2017;08;23;Tiistai;3;3;6;2;2;4
292;16.08.2017;2017;08;00;Keskiviikko;1;0;1;0;1;1
292;16.08.2017;2017;08;01;Keskiviikko;0;0;0;0;1;1
292;16.08.2017;2017;08;02;Keskiviikko;0;2;2;0;0;0
292;16.08.2017;2017;08;03;Keskiviikko;0;1;1;0;0;0
292;16.08.2017;2017;08;04;Keskiviikko;2;2;4;1;0;1
292;16.08.2017;2017;08;05;Keskiviikko;4;8;12;1;4;5
292;16.08.2017;2017;08;06;Keskiviikko;25;12;37;18;15;33
292;16.08.2017;2017;08;07;Keskiviikko;90;32;122;10;14;24
292;16.08.2017;2017;08;08;Keskiviikko;80;33;113;8;9;17
292;16.08.2017;2017;08;09;Keskiviikko;51;27;78;7;8;15
292;16.08.2017;2017;08;10;Keskiviikko;34;25;59;4;23;27
292;16.08.2017;2017;08;11;Keskiviikko;62;59;121;111;59;170
292;16.08.2017;2017;08;12;Keskiviikko;45;33;78;47;61;108
292;16.08.2017;2017;08;13;Keskiviikko;39;51;90;13;46;59
292;16.08.2017;2017;08;14;Keskiviikko;54;78;132;16;44;60
292;16.08.2017;2017;08;15;Keskiviikko;59;80;139;13;34;47
292;16.08.2017;2017;08;16;Keskiviikko;80;72;152;18;40;58
292;16.08.2017;2017;08;17;Keskiviikko;42;56;98;13;37;50
292;16.08.2017;2017;08;18;Keskiviikko;72;48;120;17;17;34
292;16.08.2017;2017;08;19;Keskiviikko;74;37;111;25;24;49
292;16.08.2017;2017;08;20;Keskiviikko;37;36;73;16;32;48
292;16.08.2017;2017;08;21;Keskiviikko;17;17;34;10;10;20
292;16.08.2017;2017;08;22;Keskiviikko;14;4;18;7;2;9
292;16.08.2017;2017;08;23;Keskiviikko;3;1;4;1;6;7
292;17.08.2017;2017;08;00;Torstai;0;0;0;2;1;3
292;17.08.2017;2017;08;01;Torstai;0;0;0;0;2;2
292;17.08.2017;2017;08;02;Torstai;0;2;2;0;0;0
292;17.08.2017;2017;08;03;Torstai;1;1;2;0;0;0
292;17.08.2017;2017;08;04;Torstai;3;0;3;0;1;1
292;17.08.2017;2017;08;05;Torstai;8;3;11;0;5;5
292;17.08.2017;2017;08;06;Torstai;21;19;40;0;13;13
292;17.08.2017;2017;08;07;Torstai;73;46;119;6;8;14
292;17.08.2017;2017;08;08;Torstai;47;39;86;3;7;10
292;17.08.2017;2017;08;09;Torstai;64;49;113;10;5;15
292;17.08.2017;2017;08;10;Torstai;25;21;46;8;16;24
292;17.08.2017;2017;08;11;Torstai;38;30;68;12;22;34
292;17.08.2017;2017;08;12;Torstai;32;23;55;6;24;30
292;17.08.2017;2017;08;13;Torstai;47;40;87;13;28;41
292;17.08.2017;2017;08;14;Torstai;52;75;127;21;37;58
292;17.08.2017;2017;08;15;Torstai;59;81;140;11;43;54
292;17.08.2017;2017;08;16;Torstai;64;82;146;28;38;66
292;17.08.2017;2017;08;17;Torstai;59;72;131;18;31;49
292;17.08.2017;2017;08;18;Torstai;70;53;123;21;44;65
292;17.08.2017;2017;08;19;Torstai;68;37;105;23;46;69
292;17.08.2017;2017;08;20;Torstai;45;26;71;25;19;44
292;17.08.2017;2017;08;21;Torstai;15;10;25;6;15;21
292;17.08.2017;2017;08;22;Torstai;7;5;12;3;6;9
292;17.08.2017;2017;08;23;Torstai;2;3;5;0;1;1
292;18.08.2017;2017;08;00;Perjantai;2;1;3;1;1;2
292;18.08.2017;2017;08;01;Perjantai;0;0;0;0;0;0
292;18.08.2017;2017;08;02;Perjantai;1;3;4;0;0;0
292;18.08.2017;2017;08;03;Perjantai;0;0;0;0;0;0
292;18.08.2017;2017;08;04;Perjantai;2;1;3;1;0;1
292;18.08.2017;2017;08;05;Perjantai;7;5;12;0;3;3
292;18.08.2017;2017;08;06;Perjantai;19;12;31;4;7;11
292;18.08.2017;2017;08;07;Perjantai;87;49;136;9;3;12
292;18.08.2017;2017;08;08;Perjantai;46;42;88;5;2;7
292;18.08.2017;2017;08;09;Perjantai;37;28;65;5;8;13
292;18.08.2017;2017;08;10;Perjantai;30;22;52;9;13;22
292;18.08.2017;2017;08;11;Perjantai;39;34;73;7;23;30
292;18.08.2017;2017;08;12;Perjantai;51;45;96;13;26;39
292;18.08.2017;2017;08;13;Perjantai;42;76;118;10;34;44
292;18.08.2017;2017;08;14;Perjantai;50;71;121;20;42;62
292;18.08.2017;2017;08;15;Perjantai;32;41;73;12;20;32
292;18.08.2017;2017;08;16;Perjantai;47;32;79;8;24;32
292;18.08.2017;2017;08;17;Perjantai;65;35;100;33;30;63
292;18.08.2017;2017;08;18;Perjantai;44;36;80;11;14;25
292;18.08.2017;2017;08;19;Perjantai;41;34;75;16;27;43
292;18.08.2017;2017;08;20;Perjantai;43;30;73;11;17;28
292;18.08.2017;2017;08;21;Perjantai;10;12;22;6;4;10
292;18.08.2017;2017;08;22;Perjantai;5;10;15;2;5;7
292;18.08.2017;2017;08;23;Perjantai;4;0;4;0;2;2
292;19.08.2017;2017;08;00;Lauantai;8;1;9;4;2;6
292;19.08.2017;2017;08;01;Lauantai;3;3;6;0;2;2
292;19.08.2017;2017;08;02;Lauantai;1;1;2;0;3;3
292;19.08.2017;2017;08;03;Lauantai;1;4;5;0;6;6
292;19.08.2017;2017;08;04;Lauantai;0;2;2;2;0;2
292;19.08.2017;2017;08;05;Lauantai;1;0;1;1;3;4
292;19.08.2017;2017;08;06;Lauantai;2;1;3;1;4;5
292;19.08.2017;2017;08;07;Lauantai;4;5;9;3;1;4
292;19.08.2017;2017;08;08;Lauantai;12;11;23;2;4;6
292;19.08.2017;2017;08;09;Lauantai;17;16;33;3;5;8
292;19.08.2017;2017;08;10;Lauantai;18;19;37;5;6;11
292;19.08.2017;2017;08;11;Lauantai;32;18;50;9;19;28
292;19.08.2017;2017;08;12;Lauantai;52;33;85;16;31;47
292;19.08.2017;2017;08;13;Lauantai;61;43;104;16;30;46
292;19.08.2017;2017;08;14;Lauantai;47;32;79;11;27;38
292;19.08.2017;2017;08;15;Lauantai;65;30;95;14;23;37
292;19.08.2017;2017;08;16;Lauantai;36;29;65;9;18;27
292;19.08.2017;2017;08;17;Lauantai;49;29;78;17;13;30
292;19.08.2017;2017;08;18;Lauantai;33;32;65;11;10;21
292;19.08.2017;2017;08;19;Lauantai;12;10;22;5;8;13
292;19.08.2017;2017;08;20;Lauantai;15;7;22;5;6;11
292;19.08.2017;2017;08;21;Lauantai;14;7;21;2;5;7
292;19.08.2017;2017;08;22;Lauantai;7;6;13;1;1;2
292;19.08.2017;2017;08;23;Lauantai;2;2;4;2;1;3
292;20.08.2017;2017;08;00;Sunnuntai;5;7;12;1;3;4
292;20.08.2017;2017;08;01;Sunnuntai;3;2;5;2;2;4
292;20.08.2017;2017;08;02;Sunnuntai;1;3;4;1;3;4
292;20.08.2017;2017;08;03;Sunnuntai;2;1;3;3;3;6
292;20.08.2017;2017;08;04;Sunnuntai;0;1;1;0;0;0
292;20.08.2017;2017;08;05;Sunnuntai;0;0;0;1;0;1
292;20.08.2017;2017;08;06;Sunnuntai;4;6;10;1;5;6
292;20.08.2017;2017;08;07;Sunnuntai;11;4;15;3;2;5
292;20.08.2017;2017;08;08;Sunnuntai;3;4;7;5;3;8
292;20.08.2017;2017;08;09;Sunnuntai;21;18;39;6;4;10
292;20.08.2017;2017;08;10;Sunnuntai;19;20;39;8;19;27
292;20.08.2017;2017;08;11;Sunnuntai;30;31;61;14;30;44
292;20.08.2017;2017;08;12;Sunnuntai;52;27;79;15;14;29
292;20.08.2017;2017;08;13;Sunnuntai;46;24;70;12;18;30
292;20.08.2017;2017;08;14;Sunnuntai;37;15;52;7;15;22
292;20.08.2017;2017;08;15;Sunnuntai;42;18;60;17;16;33
292;20.08.2017;2017;08;16;Sunnuntai;42;33;75;15;17;32
292;20.08.2017;2017;08;17;Sunnuntai;33;22;55;11;20;31
292;20.08.2017;2017;08;18;Sunnuntai;37;31;68;10;25;35
292;20.08.2017;2017;08;19;Sunnuntai;36;31;67;13;27;40
292;20.08.2017;2017;08;20;Sunnuntai;20;17;37;15;16;31
292;20.08.2017;2017;08;21;Sunnuntai;15;8;23;4;7;11
292;20.08.2017;2017;08;22;Sunnuntai;0;2;2;4;6;10
292;20.08.2017;2017;08;23;Sunnuntai;0;0;0;1;2;3
292;21.08.2017;2017;08;00;Maanantai;1;6;7;1;1;2
292;21.08.2017;2017;08;01;Maanantai;0;1;1;0;1;1
292;21.08.2017;2017;08;02;Maanantai;0;1;1;0;0;0
292;21.08.2017;2017;08;03;Maanantai;2;0;2;0;0;0
292;21.08.2017;2017;08;04;Maanantai;1;1;2;0;1;1
292;21.08.2017;2017;08;05;Maanantai;8;7;15;0;6;6
292;21.08.2017;2017;08;06;Maanantai;21;9;30;1;16;17
292;21.08.2017;2017;08;07;Maanantai;72;38;110;6;11;17
292;21.08.2017;2017;08;08;Maanantai;58;28;86;4;7;11
292;21.08.2017;2017;08;09;Maanantai;79;27;106;3;13;16
292;21.08.2017;2017;08;10;Maanantai;37;26;63;3;4;7
292;21.08.2017;2017;08;11;Maanantai;38;22;60;19;7;26
292;21.08.2017;2017;08;12;Maanantai;27;18;45;15;23;38
292;21.08.2017;2017;08;13;Maanantai;39;60;99;10;23;33
292;21.08.2017;2017;08;14;Maanantai;64;79;143;13;46;59
292;21.08.2017;2017;08;15;Maanantai;64;65;129;8;43;51
292;21.08.2017;2017;08;16;Maanantai;72;68;140;6;46;52
292;21.08.2017;2017;08;17;Maanantai;69;41;110;28;33;61
292;21.08.2017;2017;08;18;Maanantai;51;44;95;20;31;51
292;21.08.2017;2017;08;19;Maanantai;35;29;64;14;14;28
292;21.08.2017;2017;08;20;Maanantai;26;20;46;8;10;18
292;21.08.2017;2017;08;21;Maanantai;10;4;14;5;6;11
292;21.08.2017;2017;08;22;Maanantai;3;1;4;1;0;1
292;21.08.2017;2017;08;23;Maanantai;1;1;2;1;3;4
292;22.08.2017;2017;08;00;Tiistai;1;0;1;0;0;0
292;22.08.2017;2017;08;01;Tiistai;0;1;1;0;0;0
292;22.08.2017;2017;08;02;Tiistai;1;0;1;0;1;1
292;22.08.2017;2017;08;03;Tiistai;0;0;0;0;0;0
292;22.08.2017;2017;08;04;Tiistai;2;1;3;0;0;0
292;22.08.2017;2017;08;05;Tiistai;5;6;11;3;2;5
292;22.08.2017;2017;08;06;Tiistai;22;18;40;0;5;5
292;22.08.2017;2017;08;07;Tiistai;68;58;126;8;8;16
292;22.08.2017;2017;08;08;Tiistai;59;44;103;4;3;7
292;22.08.2017;2017;08;09;Tiistai;38;34;72;11;10;21
292;22.08.2017;2017;08;10;Tiistai;27;22;49;4;8;12
292;22.08.2017;2017;08;11;Tiistai;26;19;45;10;6;16
292;22.08.2017;2017;08;12;Tiistai;27;20;47;7;9;16
292;22.08.2017;2017;08;13;Tiistai;34;37;71;8;7;15
292;22.08.2017;2017;08;14;Tiistai;40;66;106;10;24;34
292;22.08.2017;2017;08;15;Tiistai;57;67;124;11;23;34
292;22.08.2017;2017;08;16;Tiistai;53;47;100;7;21;28
292;22.08.2017;2017;08;17;Tiistai;74;46;120;16;26;42
292;22.08.2017;2017;08;18;Tiistai;44;34;78;13;24;37
292;22.08.2017;2017;08;19;Tiistai;49;44;93;29;18;47
292;22.08.2017;2017;08;20;Tiistai;26;23;49;17;16;33
292;22.08.2017;2017;08;21;Tiistai;14;7;21;3;5;8
292;22.08.2017;2017;08;22;Tiistai;3;3;6;1;1;2
292;22.08.2017;2017;08;23;Tiistai;0;1;1;1;1;2
292;23.08.2017;2017;08;00;Keskiviikko;0;0;0;0;0;0
292;23.08.2017;2017;08;01;Keskiviikko;2;2;4;0;1;1
292;23.08.2017;2017;08;02;Keskiviikko;0;0;0;0;0;0
292;23.08.2017;2017;08;03;Keskiviikko;0;0;0;0;0;0
292;23.08.2017;2017;08;04;Keskiviikko;1;1;2;0;0;0
292;23.08.2017;2017;08;05;Keskiviikko;9;6;15;1;2;3
292;23.08.2017;2017;08;06;Keskiviikko;19;14;33;1;12;13
292;23.08.2017;2017;08;07;Keskiviikko;77;46;123;13;8;21
292;23.08.2017;2017;08;08;Keskiviikko;73;28;101;7;12;19
292;23.08.2017;2017;08;09;Keskiviikko;45;35;80;8;19;27
292;23.08.2017;2017;08;10;Keskiviikko;31;23;54;11;6;17
292;23.08.2017;2017;08;11;Keskiviikko;22;20;42;11;11;22
292;23.08.2017;2017;08;12;Keskiviikko;27;25;52;6;11;17
292;23.08.2017;2017;08;13;Keskiviikko;42;38;80;7;23;30
292;23.08.2017;2017;08;14;Keskiviikko;58;85;143;16;39;55
292;23.08.2017;2017;08;15;Keskiviikko;42;51;93;7;24;31
292;23.08.2017;2017;08;16;Keskiviikko;65;44;109;6;21;27
292;23.08.2017;2017;08;17;Keskiviikko;70;46;116;15;30;45
292;23.08.2017;2017;08;18;Keskiviikko;44;42;86;15;21;36
292;23.08.2017;2017;08;19;Keskiviikko;42;35;77;7;17;24
292;23.08.2017;2017;08;20;Keskiviikko;35;16;51;12;11;23
292;23.08.2017;2017;08;21;Keskiviikko;11;9;20;5;10;15
292;23.08.2017;2017;08;22;Keskiviikko;5;6;11;2;1;3
292;23.08.2017;2017;08;23;Keskiviikko;3;0;3;0;0;0
292;24.08.2017;2017;08;00;Torstai;0;0;0;0;0;0
292;24.08.2017;2017;08;01;Torstai;0;0;0;0;0;0
292;24.08.2017;2017;08;02;Torstai;0;1;1;0;1;1
292;24.08.2017;2017;08;03;Torstai;1;0;1;0;0;0
292;24.08.2017;2017;08;04;Torstai;1;0;1;0;2;2
292;24.08.2017;2017;08;05;Torstai;6;3;9;0;3;3
292;24.08.2017;2017;08;06;Torstai;20;17;37;2;5;7
292;24.08.2017;2017;08;07;Torstai;80;39;119;10;14;24
292;24.08.2017;2017;08;08;Torstai;58;49;107;9;11;20
292;24.08.2017;2017;08;09;Torstai;59;35;94;8;13;21
292;24.08.2017;2017;08;10;Torstai;43;21;64;12;9;21
292;24.08.2017;2017;08;11;Torstai;39;31;70;7;8;15
292;24.08.2017;2017;08;12;Torstai;26;25;51;3;6;9
292;24.08.2017;2017;08;13;Torstai;40;31;71;8;11;19
292;24.08.2017;2017;08;14;Torstai;47;52;99;14;31;45
292;24.08.2017;2017;08;15;Torstai;46;66;112;18;39;57
292;24.08.2017;2017;08;16;Torstai;56;58;114;15;27;42
292;24.08.2017;2017;08;17;Torstai;50;26;76;21;20;41
292;24.08.2017;2017;08;18;Torstai;47;26;73;17;30;47
292;24.08.2017;2017;08;19;Torstai;27;32;59;10;20;30
292;24.08.2017;2017;08;20;Torstai;29;36;65;10;14;24
292;24.08.2017;2017;08;21;Torstai;12;5;17;6;7;13
292;24.08.2017;2017;08;22;Torstai;6;3;9;0;0;0
292;24.08.2017;2017;08;23;Torstai;1;1;2;1;0;1
292;25.08.2017;2017;08;00;Perjantai;0;0;0;3;2;5
292;25.08.2017;2017;08;01;Perjantai;0;1;1;1;0;1
292;25.08.2017;2017;08;02;Perjantai;1;0;1;0;0;0
292;25.08.2017;2017;08;03;Perjantai;1;0;1;0;0;0
292;25.08.2017;2017;08;04;Perjantai;1;1;2;0;0;0
292;25.08.2017;2017;08;05;Perjantai;6;5;11;0;2;2
292;25.08.2017;2017;08;06;Perjantai;18;14;32;1;2;3
292;25.08.2017;2017;08;07;Perjantai;64;38;102;4;5;9
292;25.08.2017;2017;08;08;Perjantai;45;27;72;5;8;13
292;25.08.2017;2017;08;09;Perjantai;17;13;30;4;1;5
292;25.08.2017;2017;08;10;Perjantai;15;12;27;2;3;5
292;25.08.2017;2017;08;11;Perjantai;16;12;28;8;7;15
292;25.08.2017;2017;08;12;Perjantai;20;16;36;6;7;13
292;25.08.2017;2017;08;13;Perjantai;25;29;54;6;5;11
292;25.08.2017;2017;08;14;Perjantai;28;49;77;2;16;18
292;25.08.2017;2017;08;15;Perjantai;25;34;59;5;10;15
292;25.08.2017;2017;08;16;Perjantai;23;19;42;4;5;9
292;25.08.2017;2017;08;17;Perjantai;23;18;41;6;4;10
292;25.08.2017;2017;08;18;Perjantai;16;9;25;9;13;22
292;25.08.2017;2017;08;19;Perjantai;11;18;29;8;9;17
292;25.08.2017;2017;08;20;Perjantai;13;5;18;7;15;22
292;25.08.2017;2017;08;21;Perjantai;10;7;17;7;5;12
292;25.08.2017;2017;08;22;Perjantai;4;5;9;5;6;11
292;25.08.2017;2017;08;23;Perjantai;1;2;3;6;1;7
292;26.08.2017;2017;08;00;Lauantai;1;0;1;0;2;2
292;26.08.2017;2017;08;01;Lauantai;1;3;4;0;5;5
292;26.08.2017;2017;08;02;Lauantai;2;2;4;1;7;8
292;26.08.2017;2017;08;03;Lauantai;0;0;0;0;1;1
292;26.08.2017;2017;08;04;Lauantai;1;1;2;0;0;0
292;26.08.2017;2017;08;05;Lauantai;0;0;0;1;0;1
292;26.08.2017;2017;08;06;Lauantai;5;3;8;3;1;4
292;26.08.2017;2017;08;07;Lauantai;4;4;8;0;1;1
292;26.08.2017;2017;08;08;Lauantai;4;5;9;1;0;1
292;26.08.2017;2017;08;09;Lauantai;5;4;9;1;4;5
292;26.08.2017;2017;08;10;Lauantai;16;13;29;6;2;8
292;26.08.2017;2017;08;11;Lauantai;18;17;35;7;4;11
292;26.08.2017;2017;08;12;Lauantai;32;26;58;5;9;14
292;26.08.2017;2017;08;13;Lauantai;21;28;49;12;13;25
292;26.08.2017;2017;08;14;Lauantai;28;31;59;7;12;19
292;26.08.2017;2017;08;15;Lauantai;36;26;62;14;12;26
292;26.08.2017;2017;08;16;Lauantai;50;24;74;21;20;41
292;26.08.2017;2017;08;17;Lauantai;38;21;59;23;24;47
292;26.08.2017;2017;08;18;Lauantai;38;22;60;10;21;31
292;26.08.2017;2017;08;19;Lauantai;22;14;36;17;18;35
292;26.08.2017;2017;08;20;Lauantai;19;16;35;12;13;25
292;26.08.2017;2017;08;21;Lauantai;13;13;26;9;19;28
292;26.08.2017;2017;08;22;Lauantai;3;8;11;7;5;12
292;26.08.2017;2017;08;23;Lauantai;5;7;12;3;9;12
292;27.08.2017;2017;08;00;Sunnuntai;5;5;10;0;2;2
292;27.08.2017;2017;08;01;Sunnuntai;1;0;1;0;2;2
292;27.08.2017;2017;08;02;Sunnuntai;1;3;4;0;2;2
292;27.08.2017;2017;08;03;Sunnuntai;1;1;2;0;1;1
292;27.08.2017;2017;08;04;Sunnuntai;1;1;2;1;0;1
292;27.08.2017;2017;08;05;Sunnuntai;0;0;0;2;0;2
292;27.08.2017;2017;08;06;Sunnuntai;7;4;11;0;3;3
292;27.08.2017;2017;08;07;Sunnuntai;5;7;12;3;3;6
292;27.08.2017;2017;08;08;Sunnuntai;9;4;13;6;9;15
292;27.08.2017;2017;08;09;Sunnuntai;11;10;21;7;2;9
292;27.08.2017;2017;08;10;Sunnuntai;11;11;22;7;13;20
292;27.08.2017;2017;08;11;Sunnuntai;23;18;41;10;13;23
292;27.08.2017;2017;08;12;Sunnuntai;30;30;60;12;9;21
292;27.08.2017;2017;08;13;Sunnuntai;33;28;61;7;11;18
292;27.08.2017;2017;08;14;Sunnuntai;37;30;67;8;12;20
292;27.08.2017;2017;08;15;Sunnuntai;35;34;69;14;12;26
292;27.08.2017;2017;08;16;Sunnuntai;52;20;72;19;14;33
292;27.08.2017;2017;08;17;Sunnuntai;33;30;63;19;27;46
292;27.08.2017;2017;08;18;Sunnuntai;33;36;69;19;30;49
292;27.08.2017;2017;08;19;Sunnuntai;33;25;58;20;20;40
292;27.08.2017;2017;08;20;Sunnuntai;18;19;37;12;17;29
292;27.08.2017;2017;08;21;Sunnuntai;3;7;10;4;11;15
292;27.08.2017;2017;08;22;Sunnuntai;1;1;2;0;3;3
292;27.08.2017;2017;08;23;Sunnuntai;0;1;1;0;1;1
292;28.08.2017;2017;08;00;Maanantai;1;0;1;0;0;0
292;28.08.2017;2017;08;01;Maanantai;0;0;0;0;0;0
292;28.08.2017;2017;08;02;Maanantai;0;0;0;0;0;0
292;28.08.2017;2017;08;03;Maanantai;0;1;1;0;0;0
292;28.08.2017;2017;08;04;Maanantai;1;1;2;1;0;1
292;28.08.2017;2017;08;05;Maanantai;9;6;15;0;1;1
292;28.08.2017;2017;08;06;Maanantai;16;12;28;4;11;15
292;28.08.2017;2017;08;07;Maanantai;65;28;93;7;13;20
292;28.08.2017;2017;08;08;Maanantai;56;23;79;7;13;20
292;28.08.2017;2017;08;09;Maanantai;67;29;96;8;10;18
292;28.08.2017;2017;08;10;Maanantai;35;22;57;8;10;18
292;28.08.2017;2017;08;11;Maanantai;73;15;88;10;19;29
292;28.08.2017;2017;08;12;Maanantai;27;17;44;9;19;28
292;28.08.2017;2017;08;13;Maanantai;40;63;103;21;60;81
292;28.08.2017;2017;08;14;Maanantai;58;67;125;14;42;56
292;28.08.2017;2017;08;15;Maanantai;72;91;163;25;41;66
292;28.08.2017;2017;08;16;Maanantai;60;75;135;20;37;57
292;28.08.2017;2017;08;17;Maanantai;59;40;99;10;30;40
292;28.08.2017;2017;08;18;Maanantai;56;50;106;27;25;52
292;28.08.2017;2017;08;19;Maanantai;53;29;82;22;33;55
292;28.08.2017;2017;08;20;Maanantai;41;22;63;12;20;32
292;28.08.2017;2017;08;21;Maanantai;11;13;24;4;11;15
292;28.08.2017;2017;08;22;Maanantai;4;2;6;3;1;4
292;28.08.2017;2017;08;23;Maanantai;0;0;0;0;0;0
292;29.08.2017;2017;08;00;Tiistai;0;0;0;0;0;0
292;29.08.2017;2017;08;01;Tiistai;0;1;1;0;0;0
292;29.08.2017;2017;08;02;Tiistai;0;0;0;0;0;0
292;29.08.2017;2017;08;03;Tiistai;1;0;1;0;0;0
292;29.08.2017;2017;08;04;Tiistai;0;0;0;0;0;0
292;29.08.2017;2017;08;05;Tiistai;8;6;14;1;3;4
292;29.08.2017;2017;08;06;Tiistai;27;20;47;0;7;7
292;29.08.2017;2017;08;07;Tiistai;92;31;123;19;5;24
292;29.08.2017;2017;08;08;Tiistai;85;26;111;14;12;26
292;29.08.2017;2017;08;09;Tiistai;42;25;67;9;6;15
292;29.08.2017;2017;08;10;Tiistai;27;20;47;11;11;22
292;29.08.2017;2017;08;11;Tiistai;23;16;39;8;20;28
292;29.08.2017;2017;08;12;Tiistai;35;18;53;9;7;16
292;29.08.2017;2017;08;13;Tiistai;34;32;66;10;16;26
292;29.08.2017;2017;08;14;Tiistai;45;64;109;6;23;29
292;29.08.2017;2017;08;15;Tiistai;31;40;71;6;14;20
292;29.08.2017;2017;08;16;Tiistai;34;32;66;8;6;14
292;29.08.2017;2017;08;17;Tiistai;18;15;33;2;4;6
292;29.08.2017;2017;08;18;Tiistai;19;10;29;4;5;9
292;29.08.2017;2017;08;19;Tiistai;12;8;20;10;4;14
292;29.08.2017;2017;08;20;Tiistai;10;7;17;8;7;15
292;29.08.2017;2017;08;21;Tiistai;5;5;10;1;2;3
292;29.08.2017;2017;08;22;Tiistai;6;5;11;0;1;1
292;29.08.2017;2017;08;23;Tiistai;1;0;1;1;0;1
292;30.08.2017;2017;08;00;Keskiviikko;1;1;2;0;2;2
292;30.08.2017;2017;08;01;Keskiviikko;0;0;0;0;0;0
292;30.08.2017;2017;08;02;Keskiviikko;1;1;2;0;0;0
292;30.08.2017;2017;08;03;Keskiviikko;0;0;0;0;0;0
292;30.08.2017;2017;08;04;Keskiviikko;1;1;2;0;0;0
292;30.08.2017;2017;08;05;Keskiviikko;2;2;4;0;0;0
292;30.08.2017;2017;08;06;Keskiviikko;10;6;16;1;3;4
292;30.08.2017;2017;08;07;Keskiviikko;39;37;76;7;4;11
292;30.08.2017;2017;08;08;Keskiviikko;42;39;81;2;7;9
292;30.08.2017;2017;08;09;Keskiviikko;22;22;44;3;4;7
292;30.08.2017;2017;08;10;Keskiviikko;5;5;10;1;1;2
292;30.08.2017;2017;08;11;Keskiviikko;10;8;18;3;1;4
292;30.08.2017;2017;08;12;Keskiviikko;7;6;13;4;5;9
292;30.08.2017;2017;08;13;Keskiviikko;30;30;60;4;2;6
292;30.08.2017;2017;08;14;Keskiviikko;40;43;83;6;14;20
292;30.08.2017;2017;08;15;Keskiviikko;44;44;88;9;16;25
292;30.08.2017;2017;08;16;Keskiviikko;45;40;85;11;22;33
292;30.08.2017;2017;08;17;Keskiviikko;49;35;84;19;21;40
292;30.08.2017;2017;08;18;Keskiviikko;51;41;92;19;29;48
292;30.08.2017;2017;08;19;Keskiviikko;47;26;73;21;30;51
292;30.08.2017;2017;08;20;Keskiviikko;33;25;58;17;15;32
292;30.08.2017;2017;08;21;Keskiviikko;25;9;34;5;14;19
292;30.08.2017;2017;08;22;Keskiviikko;5;5;10;2;1;3
292;30.08.2017;2017;08;23;Keskiviikko;0;0;0;0;5;5
292;31.08.2017;2017;08;00;Torstai;2;0;2;1;1;2
292;31.08.2017;2017;08;01;Torstai;1;0;1;0;2;2
292;31.08.2017;2017;08;02;Torstai;1;1;2;0;0;0
292;31.08.2017;2017;08;03;Torstai;0;0;0;0;0;0
292;31.08.2017;2017;08;04;Torstai;1;0;1;0;0;0
292;31.08.2017;2017;08;05;Torstai;10;4;14;0;3;3
292;31.08.2017;2017;08;06;Torstai;33;20;53;3;9;12
292;31.08.2017;2017;08;07;Torstai;69;43;112;7;6;13
292;31.08.2017;2017;08;08;Torstai;51;37;88;5;11;16
292;31.08.2017;2017;08;09;Torstai;60;41;101;5;19;24
292;31.08.2017;2017;08;10;Torstai;119;20;139;7;23;30
292;31.08.2017;2017;08;11;Torstai;29;34;63;12;19;31
292;31.08.2017;2017;08;12;Torstai;37;34;71;10;22;32
292;31.08.2017;2017;08;13;Torstai;39;83;122;12;42;54
292;31.08.2017;2017;08;14;Torstai;62;65;127;19;36;55
292;31.08.2017;2017;08;15;Torstai;53;91;144;15;40;55
292;31.08.2017;2017;08;16;Torstai;64;80;144;15;40;55
292;31.08.2017;2017;08;17;Torstai;48;49;97;26;36;62
292;31.08.2017;2017;08;18;Torstai;43;42;85;15;25;40
292;31.08.2017;2017;08;19;Torstai;36;30;66;22;23;45
292;31.08.2017;2017;08;20;Torstai;34;32;66;11;18;29
292;31.08.2017;2017;08;21;Torstai;23;6;29;6;8;14
292;31.08.2017;2017;08;22;Torstai;6;5;11;3;0;3
292;31.08.2017;2017;08;23;Torstai;5;6;11;1;2;3
292;01.09.2017;2017;09;00;Perjantai;2;0;2;1;1;2
292;01.09.2017;2017;09;01;Perjantai;0;0;0;0;0;0
292;01.09.2017;2017;09;02;Perjantai;1;1;2;0;0;0
292;01.09.2017;2017;09;03;Perjantai;0;0;0;0;0;0
292;01.09.2017;2017;09;04;Perjantai;1;0;1;1;0;1
292;01.09.2017;2017;09;05;Perjantai;4;4;8;0;2;2
292;01.09.2017;2017;09;06;Perjantai;7;6;13;0;2;2
292;01.09.2017;2017;09;07;Perjantai;27;22;49;1;4;5
292;01.09.2017;2017;09;08;Perjantai;19;12;31;4;4;8
292;01.09.2017;2017;09;09;Perjantai;7;5;12;4;1;5
292;01.09.2017;2017;09;10;Perjantai;6;6;12;2;2;4
292;01.09.2017;2017;09;11;Perjantai;7;7;14;5;3;8
292;01.09.2017;2017;09;12;Perjantai;12;12;24;1;0;1
292;01.09.2017;2017;09;13;Perjantai;18;19;37;2;3;5
292;01.09.2017;2017;09;14;Perjantai;21;20;41;0;4;4
292;01.09.2017;2017;09;15;Perjantai;23;21;44;5;3;8
292;01.09.2017;2017;09;16;Perjantai;18;13;31;3;10;13
292;01.09.2017;2017;09;17;Perjantai;13;15;28;8;11;19
292;01.09.2017;2017;09;18;Perjantai;23;19;42;9;11;20
292;01.09.2017;2017;09;19;Perjantai;20;20;40;9;8;17
292;01.09.2017;2017;09;20;Perjantai;18;10;28;12;12;24
292;01.09.2017;2017;09;21;Perjantai;16;8;24;10;12;22
292;01.09.2017;2017;09;22;Perjantai;4;3;7;3;5;8
292;01.09.2017;2017;09;23;Perjantai;7;4;11;7;5;12
292;02.09.2017;2017;09;00;Lauantai;5;5;10;4;3;7
292;02.09.2017;2017;09;01;Lauantai;2;2;4;4;2;6
292;02.09.2017;2017;09;02;Lauantai;4;4;8;4;5;9
292;02.09.2017;2017;09;03;Lauantai;0;0;0;1;2;3
292;02.09.2017;2017;09;04;Lauantai;0;2;2;0;2;2
292;02.09.2017;2017;09;05;Lauantai;2;1;3;1;1;2
292;02.09.2017;2017;09;06;Lauantai;6;4;10;1;4;5
292;02.09.2017;2017;09;07;Lauantai;4;3;7;3;3;6
292;02.09.2017;2017;09;08;Lauantai;15;12;27;1;6;7
292;02.09.2017;2017;09;09;Lauantai;16;15;31;6;5;11
292;02.09.2017;2017;09;10;Lauantai;19;19;38;2;3;5
292;02.09.2017;2017;09;11;Lauantai;30;27;57;9;7;16
292;02.09.2017;2017;09;12;Lauantai;42;29;71;5;6;11
292;02.09.2017;2017;09;13;Lauantai;40;34;74;14;17;31
292;02.09.2017;2017;09;14;Lauantai;43;34;77;24;19;43
292;02.09.2017;2017;09;15;Lauantai;71;41;112;18;19;37
292;02.09.2017;2017;09;16;Lauantai;59;44;103;14;21;35
292;02.09.2017;2017;09;17;Lauantai;44;28;72;15;17;32
292;02.09.2017;2017;09;18;Lauantai;50;26;76;23;30;53
292;02.09.2017;2017;09;19;Lauantai;12;22;34;16;21;37
292;02.09.2017;2017;09;20;Lauantai;21;14;35;15;17;32
292;02.09.2017;2017;09;21;Lauantai;7;13;20;15;15;30
292;02.09.2017;2017;09;22;Lauantai;12;9;21;10;16;26
292;02.09.2017;2017;09;23;Lauantai;7;12;19;4;5;9
292;03.09.2017;2017;09;00;Sunnuntai;5;4;9;5;2;7
292;03.09.2017;2017;09;01;Sunnuntai;2;4;6;1;1;2
292;03.09.2017;2017;09;02;Sunnuntai;3;7;10;1;4;5
292;03.09.2017;2017;09;03;Sunnuntai;2;2;4;0;3;3
292;03.09.2017;2017;09;04;Sunnuntai;0;0;0;0;0;0
292;03.09.2017;2017;09;05;Sunnuntai;1;0;1;1;0;1
292;03.09.2017;2017;09;06;Sunnuntai;3;1;4;2;1;3
292;03.09.2017;2017;09;07;Sunnuntai;3;3;6;4;2;6
292;03.09.2017;2017;09;08;Sunnuntai;7;5;12;4;5;9
292;03.09.2017;2017;09;09;Sunnuntai;20;16;36;4;7;11
292;03.09.2017;2017;09;10;Sunnuntai;18;21;39;5;8;13
292;03.09.2017;2017;09;11;Sunnuntai;30;26;56;6;10;16
292;03.09.2017;2017;09;12;Sunnuntai;35;30;65;13;23;36
292;03.09.2017;2017;09;13;Sunnuntai;52;33;85;15;24;39
292;03.09.2017;2017;09;14;Sunnuntai;47;31;78;18;31;49
292;03.09.2017;2017;09;15;Sunnuntai;66;32;98;20;22;42
292;03.09.2017;2017;09;16;Sunnuntai;39;47;86;15;30;45
292;03.09.2017;2017;09;17;Sunnuntai;57;34;91;20;33;53
292;03.09.2017;2017;09;18;Sunnuntai;46;40;86;16;28;44
292;03.09.2017;2017;09;19;Sunnuntai;35;20;55;12;26;38
292;03.09.2017;2017;09;20;Sunnuntai;31;18;49;15;13;28
292;03.09.2017;2017;09;21;Sunnuntai;8;12;20;5;7;12
292;03.09.2017;2017;09;22;Sunnuntai;2;1;3;2;2;4
292;03.09.2017;2017;09;23;Sunnuntai;2;1;3;0;3;3
292;04.09.2017;2017;09;00;Maanantai;0;0;0;1;1;2
292;04.09.2017;2017;09;01;Maanantai;0;3;3;0;4;4
292;04.09.2017;2017;09;02;Maanantai;0;0;0;0;0;0
292;04.09.2017;2017;09;03;Maanantai;0;0;0;0;0;0
292;04.09.2017;2017;09;04;Maanantai;1;1;2;0;0;0
292;04.09.2017;2017;09;05;Maanantai;10;6;16;2;1;3
292;04.09.2017;2017;09;06;Maanantai;27;11;38;2;11;13
292;04.09.2017;2017;09;07;Maanantai;66;49;115;12;8;20
292;04.09.2017;2017;09;08;Maanantai;37;32;69;7;12;19
292;04.09.2017;2017;09;09;Maanantai;69;32;101;14;10;24
292;04.09.2017;2017;09;10;Maanantai;40;19;59;4;15;19
292;04.09.2017;2017;09;11;Maanantai;38;26;64;4;16;20
292;04.09.2017;2017;09;12;Maanantai;45;25;70;8;16;24
292;04.09.2017;2017;09;13;Maanantai;34;51;85;9;32;41
292;04.09.2017;2017;09;14;Maanantai;46;66;112;10;47;57
292;04.09.2017;2017;09;15;Maanantai;72;83;155;21;55;76
292;04.09.2017;2017;09;16;Maanantai;64;101;165;19;48;67
292;04.09.2017;2017;09;17;Maanantai;64;53;117;13;34;47
292;04.09.2017;2017;09;18;Maanantai;67;49;116;20;34;54
292;04.09.2017;2017;09;19;Maanantai;44;38;82;17;28;45
292;04.09.2017;2017;09;20;Maanantai;55;28;83;13;11;24
292;04.09.2017;2017;09;21;Maanantai;8;5;13;5;4;9
292;04.09.2017;2017;09;22;Maanantai;3;5;8;0;2;2
292;04.09.2017;2017;09;23;Maanantai;1;1;2;2;1;3
292;05.09.2017;2017;09;00;Tiistai;0;1;1;0;0;0
292;05.09.2017;2017;09;01;Tiistai;0;0;0;0;0;0
292;05.09.2017;2017;09;02;Tiistai;0;0;0;1;0;1
292;05.09.2017;2017;09;03;Tiistai;1;2;3;0;0;0
292;05.09.2017;2017;09;04;Tiistai;2;0;2;0;0;0
292;05.09.2017;2017;09;05;Tiistai;7;3;10;2;3;5
292;05.09.2017;2017;09;06;Tiistai;28;13;41;4;17;21
292;05.09.2017;2017;09;07;Tiistai;77;40;117;9;15;24
292;05.09.2017;2017;09;08;Tiistai;68;46;114;8;7;15
292;05.09.2017;2017;09;09;Tiistai;37;29;66;3;6;9
292;05.09.2017;2017;09;10;Tiistai;33;18;51;7;15;22
292;05.09.2017;2017;09;11;Tiistai;35;18;53;6;14;20
292;05.09.2017;2017;09;12;Tiistai;35;30;65;8;31;39
292;05.09.2017;2017;09;13;Tiistai;45;51;96;12;31;43
292;05.09.2017;2017;09;14;Tiistai;42;80;122;22;55;77
292;05.09.2017;2017;09;15;Tiistai;64;66;130;12;38;50
292;05.09.2017;2017;09;16;Tiistai;69;77;146;23;37;60
292;05.09.2017;2017;09;17;Tiistai;64;40;104;23;30;53
292;05.09.2017;2017;09;18;Tiistai;74;41;115;29;36;65
292;05.09.2017;2017;09;19;Tiistai;47;40;87;11;37;48
292;05.09.2017;2017;09;20;Tiistai;38;21;59;9;14;23
292;05.09.2017;2017;09;21;Tiistai;17;10;27;3;6;9
292;05.09.2017;2017;09;22;Tiistai;4;3;7;4;1;5
292;05.09.2017;2017;09;23;Tiistai;0;1;1;2;0;2
292;06.09.2017;2017;09;00;Keskiviikko;0;0;0;0;1;1
292;06.09.2017;2017;09;01;Keskiviikko;1;0;1;0;1;1
292;06.09.2017;2017;09;02;Keskiviikko;0;3;3;0;1;1
292;06.09.2017;2017;09;03;Keskiviikko;0;0;0;4;0;4
292;06.09.2017;2017;09;04;Keskiviikko;3;1;4;0;0;0
292;06.09.2017;2017;09;05;Keskiviikko;6;7;13;1;2;3
292;06.09.2017;2017;09;06;Keskiviikko;22;12;34;0;13;13
292;06.09.2017;2017;09;07;Keskiviikko;63;46;109;5;10;15
292;06.09.2017;2017;09;08;Keskiviikko;65;47;112;8;7;15
292;06.09.2017;2017;09;09;Keskiviikko;40;30;70;13;11;24
292;06.09.2017;2017;09;10;Keskiviikko;30;18;48;11;17;28
292;06.09.2017;2017;09;11;Keskiviikko;31;46;77;16;18;34
292;06.09.2017;2017;09;12;Keskiviikko;40;32;72;9;17;26
292;06.09.2017;2017;09;13;Keskiviikko;55;58;113;13;37;50
292;06.09.2017;2017;09;14;Keskiviikko;42;87;129;28;56;84
292;06.09.2017;2017;09;15;Keskiviikko;61;63;124;12;46;58
292;06.09.2017;2017;09;16;Keskiviikko;76;68;144;14;52;66
292;06.09.2017;2017;09;17;Keskiviikko;53;51;104;20;32;52
292;06.09.2017;2017;09;18;Keskiviikko;50;30;80;11;31;42
292;06.09.2017;2017;09;19;Keskiviikko;53;39;92;27;20;47
292;06.09.2017;2017;09;20;Keskiviikko;39;19;58;11;14;25
292;06.09.2017;2017;09;21;Keskiviikko;14;9;23;4;7;11
292;06.09.2017;2017;09;22;Keskiviikko;5;3;8;0;1;1
292;06.09.2017;2017;09;23;Keskiviikko;1;1;2;3;0;3
292;07.09.2017;2017;09;00;Torstai;0;0;0;0;3;3
292;07.09.2017;2017;09;01;Torstai;0;0;0;0;3;3
292;07.09.2017;2017;09;02;Torstai;0;1;1;0;0;0
292;07.09.2017;2017;09;03;Torstai;0;0;0;0;0;0
292;07.09.2017;2017;09;04;Torstai;3;0;3;0;0;0
292;07.09.2017;2017;09;05;Torstai;7;2;9;0;3;3
292;07.09.2017;2017;09;06;Torstai;12;15;27;1;10;11
292;07.09.2017;2017;09;07;Torstai;74;32;106;10;11;21
292;07.09.2017;2017;09;08;Torstai;56;33;89;7;12;19
292;07.09.2017;2017;09;09;Torstai;69;23;92;7;9;16
292;07.09.2017;2017;09;10;Torstai;42;19;61;12;9;21
292;07.09.2017;2017;09;11;Torstai;29;24;53;4;14;18
292;07.09.2017;2017;09;12;Torstai;32;16;48;6;12;18
292;07.09.2017;2017;09;13;Torstai;38;40;78;8;27;35
292;07.09.2017;2017;09;14;Torstai;45;55;100;20;43;63
292;07.09.2017;2017;09;15;Torstai;55;93;148;19;30;49
292;07.09.2017;2017;09;16;Torstai;57;69;126;15;49;64
292;07.09.2017;2017;09;17;Torstai;49;43;92;16;28;44
292;07.09.2017;2017;09;18;Torstai;45;31;76;16;25;41
292;07.09.2017;2017;09;19;Torstai;29;22;51;13;19;32
292;07.09.2017;2017;09;20;Torstai;36;16;52;10;13;23
292;07.09.2017;2017;09;21;Torstai;9;6;15;8;5;13
292;07.09.2017;2017;09;22;Torstai;4;3;7;0;5;5
292;07.09.2017;2017;09;23;Torstai;1;0;1;0;0;0
292;08.09.2017;2017;09;00;Perjantai;0;1;1;0;1;1
292;08.09.2017;2017;09;01;Perjantai;0;0;0;0;0;0
292;08.09.2017;2017;09;02;Perjantai;0;0;0;0;0;0
292;08.09.2017;2017;09;03;Perjantai;0;0;0;1;1;2
292;08.09.2017;2017;09;04;Perjantai;1;0;1;1;0;1
292;08.09.2017;2017;09;05;Perjantai;4;3;7;0;2;2
292;08.09.2017;2017;09;06;Perjantai;11;6;17;0;6;6
292;08.09.2017;2017;09;07;Perjantai;51;25;76;4;8;12
292;08.09.2017;2017;09;08;Perjantai;59;24;83;7;7;14
292;08.09.2017;2017;09;09;Perjantai;25;12;37;4;9;13
292;08.09.2017;2017;09;10;Perjantai;20;12;32;7;8;15
292;08.09.2017;2017;09;11;Perjantai;23;11;34;13;16;29
292;08.09.2017;2017;09;12;Perjantai;27;15;42;9;3;12
292;08.09.2017;2017;09;13;Perjantai;24;72;96;7;27;34
292;08.09.2017;2017;09;14;Perjantai;31;28;59;7;14;21
292;08.09.2017;2017;09;15;Perjantai;40;29;69;9;20;29
292;08.09.2017;2017;09;16;Perjantai;37;22;59;12;14;26
292;08.09.2017;2017;09;17;Perjantai;37;23;60;6;12;18
292;08.09.2017;2017;09;18;Perjantai;27;20;47;10;9;19
292;08.09.2017;2017;09;19;Perjantai;42;13;55;16;11;27
292;08.09.2017;2017;09;20;Perjantai;24;20;44;13;13;26
292;08.09.2017;2017;09;21;Perjantai;15;11;26;13;5;18
292;08.09.2017;2017;09;22;Perjantai;11;9;20;5;3;8
292;08.09.2017;2017;09;23;Perjantai;3;0;3;7;4;11
292;09.09.2017;2017;09;00;Lauantai;5;2;7;2;2;4
292;09.09.2017;2017;09;01;Lauantai;2;2;4;1;1;2
292;09.09.2017;2017;09;02;Lauantai;6;4;10;0;6;6
292;09.09.2017;2017;09;03;Lauantai;2;1;3;2;3;5
292;09.09.2017;2017;09;04;Lauantai;0;0;0;1;1;2
292;09.09.2017;2017;09;05;Lauantai;0;1;1;0;0;0
292;09.09.2017;2017;09;06;Lauantai;2;3;5;0;2;2
292;09.09.2017;2017;09;07;Lauantai;5;4;9;3;4;7
292;09.09.2017;2017;09;08;Lauantai;17;12;29;1;10;11
292;09.09.2017;2017;09;09;Lauantai;15;10;25;7;5;12
292;09.09.2017;2017;09;10;Lauantai;35;15;50;6;6;12
292;09.09.2017;2017;09;11;Lauantai;14;11;25;6;10;16
292;09.09.2017;2017;09;12;Lauantai;23;26;49;8;9;17
292;09.09.2017;2017;09;13;Lauantai;38;29;67;4;12;16
292;09.09.2017;2017;09;14;Lauantai;28;13;41;10;4;14
292;09.09.2017;2017;09;15;Lauantai;50;36;86;7;15;22
292;09.09.2017;2017;09;16;Lauantai;33;22;55;16;12;28
292;09.09.2017;2017;09;17;Lauantai;35;23;58;13;20;33
292;09.09.2017;2017;09;18;Lauantai;32;19;51;14;12;26
292;09.09.2017;2017;09;19;Lauantai;45;19;64;10;6;16
292;09.09.2017;2017;09;20;Lauantai;15;13;28;2;8;10
292;09.09.2017;2017;09;21;Lauantai;11;21;32;5;9;14
292;09.09.2017;2017;09;22;Lauantai;12;9;21;1;5;6
292;09.09.2017;2017;09;23;Lauantai;5;8;13;4;3;7
292;10.09.2017;2017;09;00;Sunnuntai;4;2;6;8;0;8
292;10.09.2017;2017;09;01;Sunnuntai;1;0;1;1;2;3
292;10.09.2017;2017;09;02;Sunnuntai;1;1;2;1;3;4
292;10.09.2017;2017;09;03;Sunnuntai;1;1;2;1;1;2
292;10.09.2017;2017;09;04;Sunnuntai;1;0;1;1;0;1
292;10.09.2017;2017;09;05;Sunnuntai;1;0;1;0;0;0
292;10.09.2017;2017;09;06;Sunnuntai;5;1;6;5;2;7
292;10.09.2017;2017;09;07;Sunnuntai;2;1;3;3;3;6
292;10.09.2017;2017;09;08;Sunnuntai;2;0;2;0;3;3
292;10.09.2017;2017;09;09;Sunnuntai;2;1;3;0;0;0
292;10.09.2017;2017;09;10;Sunnuntai;4;4;8;1;4;5
292;10.09.2017;2017;09;11;Sunnuntai;6;6;12;5;1;6
292;10.09.2017;2017;09;12;Sunnuntai;4;2;6;1;5;6
292;10.09.2017;2017;09;13;Sunnuntai;5;5;10;0;0;0
292;10.09.2017;2017;09;14;Sunnuntai;11;11;22;3;1;4
292;10.09.2017;2017;09;15;Sunnuntai;6;5;11;3;0;3
292;10.09.2017;2017;09;16;Sunnuntai;10;8;18;2;0;2
292;10.09.2017;2017;09;17;Sunnuntai;13;17;30;9;5;14
292;10.09.2017;2017;09;18;Sunnuntai;18;7;25;9;6;15
292;10.09.2017;2017;09;19;Sunnuntai;11;13;24;7;6;13
292;10.09.2017;2017;09;20;Sunnuntai;13;5;18;6;14;20
292;10.09.2017;2017;09;21;Sunnuntai;4;6;10;3;1;4
292;10.09.2017;2017;09;22;Sunnuntai;0;0;0;3;2;5
292;10.09.2017;2017;09;23;Sunnuntai;0;0;0;9;1;10
292;11.09.2017;2017;09;00;Maanantai;0;0;0;0;0;0
292;11.09.2017;2017;09;01;Maanantai;0;0;0;0;0;0
292;11.09.2017;2017;09;02;Maanantai;0;0;0;0;0;0
292;11.09.2017;2017;09;03;Maanantai;0;0;0;0;0;0
292;11.09.2017;2017;09;04;Maanantai;0;1;1;0;0;0
292;11.09.2017;2017;09;05;Maanantai;8;9;17;0;1;1
292;11.09.2017;2017;09;06;Maanantai;21;17;38;4;1;5
292;11.09.2017;2017;09;07;Maanantai;82;39;121;10;15;25
292;11.09.2017;2017;09;08;Maanantai;37;29;66;9;14;23
292;11.09.2017;2017;09;09;Maanantai;51;38;89;4;6;10
292;11.09.2017;2017;09;10;Maanantai;27;19;46;6;8;14
292;11.09.2017;2017;09;11;Maanantai;31;29;60;10;6;16
292;11.09.2017;2017;09;12;Maanantai;25;23;48;7;7;14
292;11.09.2017;2017;09;13;Maanantai;40;41;81;7;9;16
292;11.09.2017;2017;09;14;Maanantai;54;67;121;14;13;27
292;11.09.2017;2017;09;15;Maanantai;53;71;124;10;19;29
292;11.09.2017;2017;09;16;Maanantai;77;57;134;12;35;47
292;11.09.2017;2017;09;17;Maanantai;49;48;97;20;45;65
292;11.09.2017;2017;09;18;Maanantai;61;39;100;10;29;39
292;11.09.2017;2017;09;19;Maanantai;56;35;91;14;33;47
292;11.09.2017;2017;09;20;Maanantai;35;16;51;12;9;21
292;11.09.2017;2017;09;21;Maanantai;13;14;27;5;6;11
292;11.09.2017;2017;09;22;Maanantai;7;1;8;1;2;3
292;11.09.2017;2017;09;23;Maanantai;0;0;0;0;0;0
292;12.09.2017;2017;09;00;Tiistai;0;0;0;0;1;1
292;12.09.2017;2017;09;01;Tiistai;0;0;0;0;1;1
292;12.09.2017;2017;09;02;Tiistai;0;0;0;0;0;0
292;12.09.2017;2017;09;03;Tiistai;0;0;0;0;0;0
292;12.09.2017;2017;09;04;Tiistai;1;0;1;0;0;0
292;12.09.2017;2017;09;05;Tiistai;6;5;11;1;3;4
292;12.09.2017;2017;09;06;Tiistai;25;13;38;2;12;14
292;12.09.2017;2017;09;07;Tiistai;98;40;138;7;6;13
292;12.09.2017;2017;09;08;Tiistai;71;38;109;15;11;26
292;12.09.2017;2017;09;09;Tiistai;25;21;46;5;3;8
292;12.09.2017;2017;09;10;Tiistai;29;16;45;6;9;15
292;12.09.2017;2017;09;11;Tiistai;24;9;33;9;7;16
292;12.09.2017;2017;09;12;Tiistai;27;15;42;8;18;26
292;12.09.2017;2017;09;13;Tiistai;41;44;85;11;20;31
292;12.09.2017;2017;09;14;Tiistai;35;52;87;8;4;12
292;12.09.2017;2017;09;15;Tiistai;40;36;76;3;5;8
292;12.09.2017;2017;09;16;Tiistai;27;29;56;0;7;7
292;12.09.2017;2017;09;17;Tiistai;19;15;34;4;0;4
292;12.09.2017;2017;09;18;Tiistai;23;18;41;4;3;7
292;12.09.2017;2017;09;19;Tiistai;22;16;38;3;4;7
292;12.09.2017;2017;09;20;Tiistai;16;15;31;7;6;13
292;12.09.2017;2017;09;21;Tiistai;2;2;4;3;0;3
292;12.09.2017;2017;09;22;Tiistai;7;6;13;0;0;0
292;12.09.2017;2017;09;23;Tiistai;1;1;2;0;0;0
292;13.09.2017;2017;09;00;Keskiviikko;0;0;0;0;0;0
292;13.09.2017;2017;09;01;Keskiviikko;0;0;0;0;0;0
292;13.09.2017;2017;09;02;Keskiviikko;0;0;0;0;0;0
292;13.09.2017;2017;09;03;Keskiviikko;0;0;0;0;0;0
292;13.09.2017;2017;09;04;Keskiviikko;1;0;1;0;0;0
292;13.09.2017;2017;09;05;Keskiviikko;5;5;10;0;0;0
292;13.09.2017;2017;09;06;Keskiviikko;16;12;28;2;7;9
292;13.09.2017;2017;09;07;Keskiviikko;74;41;115;3;6;9
292;13.09.2017;2017;09;08;Keskiviikko;54;32;86;6;9;15
292;13.09.2017;2017;09;09;Keskiviikko;39;23;62;8;8;16
292;13.09.2017;2017;09;10;Keskiviikko;26;19;45;10;6;16
292;13.09.2017;2017;09;11;Keskiviikko;40;33;73;5;8;13
292;13.09.2017;2017;09;12;Keskiviikko;33;21;54;8;4;12
292;13.09.2017;2017;09;13;Keskiviikko;59;52;111;13;13;26
292;13.09.2017;2017;09;14;Keskiviikko;45;57;102;12;24;36
292;13.09.2017;2017;09;15;Keskiviikko;53;59;112;20;16;36
292;13.09.2017;2017;09;16;Keskiviikko;58;41;99;8;19;27
292;13.09.2017;2017;09;17;Keskiviikko;56;48;104;7;16;23
292;13.09.2017;2017;09;18;Keskiviikko;49;27;76;13;21;34
292;13.09.2017;2017;09;19;Keskiviikko;53;23;76;10;20;30
292;13.09.2017;2017;09;20;Keskiviikko;32;20;52;14;21;35
292;13.09.2017;2017;09;21;Keskiviikko;6;3;9;9;8;17
292;13.09.2017;2017;09;22;Keskiviikko;7;3;10;2;6;8
292;13.09.2017;2017;09;23;Keskiviikko;0;0;0;0;2;2
292;14.09.2017;2017;09;00;Torstai;1;0;1;0;0;0
292;14.09.2017;2017;09;01;Torstai;1;0;1;0;0;0
292;14.09.2017;2017;09;02;Torstai;1;0;1;0;0;0
292;14.09.2017;2017;09;03;Torstai;0;0;0;0;0;0
292;14.09.2017;2017;09;04;Torstai;1;1;2;0;0;0
292;14.09.2017;2017;09;05;Torstai;8;4;12;2;1;3
292;14.09.2017;2017;09;06;Torstai;25;18;43;1;9;10
292;14.09.2017;2017;09;07;Torstai;69;41;110;4;7;11
292;14.09.2017;2017;09;08;Torstai;86;69;155;10;19;29
292;14.09.2017;2017;09;09;Torstai;57;34;91;12;12;24
292;14.09.2017;2017;09;10;Torstai;31;20;51;9;7;16
292;14.09.2017;2017;09;11;Torstai;53;42;95;4;6;10
292;14.09.2017;2017;09;12;Torstai;27;20;47;3;7;10
292;14.09.2017;2017;09;13;Torstai;105;85;190;12;20;32
292;14.09.2017;2017;09;14;Torstai;48;63;111;8;28;36
292;14.09.2017;2017;09;15;Torstai;96;70;166;15;21;36
292;14.09.2017;2017;09;16;Torstai;64;59;123;13;31;44
292;14.09.2017;2017;09;17;Torstai;50;49;99;17;31;48
292;14.09.2017;2017;09;18;Torstai;50;45;95;19;30;49
292;14.09.2017;2017;09;19;Torstai;55;18;73;26;20;46
292;14.09.2017;2017;09;20;Torstai;32;18;50;10;12;22
292;14.09.2017;2017;09;21;Torstai;12;7;19;3;6;9
292;14.09.2017;2017;09;22;Torstai;2;3;5;1;4;5
292;14.09.2017;2017;09;23;Torstai;0;1;1;0;0;0
292;15.09.2017;2017;09;00;Perjantai;0;0;0;0;0;0
292;15.09.2017;2017;09;01;Perjantai;0;0;0;0;0;0
292;15.09.2017;2017;09;02;Perjantai;0;0;0;0;0;0
292;15.09.2017;2017;09;03;Perjantai;0;1;1;0;0;0
292;15.09.2017;2017;09;04;Perjantai;1;2;3;1;0;1
292;15.09.2017;2017;09;05;Perjantai;7;5;12;0;1;1
292;15.09.2017;2017;09;06;Perjantai;16;9;25;2;11;13
292;15.09.2017;2017;09;07;Perjantai;72;31;103;6;15;21
292;15.09.2017;2017;09;08;Perjantai;58;23;81;10;7;17
292;15.09.2017;2017;09;09;Perjantai;32;23;55;5;6;11
292;15.09.2017;2017;09;10;Perjantai;30;16;46;4;6;10
292;15.09.2017;2017;09;11;Perjantai;14;13;27;2;7;9
292;15.09.2017;2017;09;12;Perjantai;33;29;62;6;12;18
292;15.09.2017;2017;09;13;Perjantai;36;59;95;7;15;22
292;15.09.2017;2017;09;14;Perjantai;37;37;74;4;4;8
292;15.09.2017;2017;09;15;Perjantai;38;38;76;8;14;22
292;15.09.2017;2017;09;16;Perjantai;35;28;63;5;9;14
292;15.09.2017;2017;09;17;Perjantai;31;26;57;6;10;16
292;15.09.2017;2017;09;18;Perjantai;22;21;43;10;14;24
292;15.09.2017;2017;09;19;Perjantai;26;12;38;9;6;15
292;15.09.2017;2017;09;20;Perjantai;23;12;35;14;10;24
292;15.09.2017;2017;09;21;Perjantai;14;17;31;3;8;11
292;15.09.2017;2017;09;22;Perjantai;8;5;13;2;9;11
292;15.09.2017;2017;09;23;Perjantai;14;2;16;3;4;7
292;16.09.2017;2017;09;00;Lauantai;7;5;12;5;3;8
292;16.09.2017;2017;09;01;Lauantai;0;5;5;2;5;7
292;16.09.2017;2017;09;02;Lauantai;0;1;1;1;6;7
292;16.09.2017;2017;09;03;Lauantai;0;2;2;0;1;1
292;16.09.2017;2017;09;04;Lauantai;0;3;3;1;3;4
292;16.09.2017;2017;09;05;Lauantai;1;2;3;0;0;0
292;16.09.2017;2017;09;06;Lauantai;3;2;5;5;1;6
292;16.09.2017;2017;09;07;Lauantai;2;5;7;1;4;5
292;16.09.2017;2017;09;08;Lauantai;12;11;23;1;4;5
292;16.09.2017;2017;09;09;Lauantai;10;18;28;4;10;14
292;16.09.2017;2017;09;10;Lauantai;16;19;35;10;14;24
292;16.09.2017;2017;09;11;Lauantai;18;24;42;5;13;18
292;16.09.2017;2017;09;12;Lauantai;34;33;67;7;7;14
292;16.09.2017;2017;09;13;Lauantai;30;43;73;6;10;16
292;16.09.2017;2017;09;14;Lauantai;33;25;58;9;20;29
292;16.09.2017;2017;09;15;Lauantai;56;42;98;14;13;27
292;16.09.2017;2017;09;16;Lauantai;33;25;58;12;11;23
292;16.09.2017;2017;09;17;Lauantai;32;25;57;14;14;28
292;16.09.2017;2017;09;18;Lauantai;29;13;42;18;11;29
292;16.09.2017;2017;09;19;Lauantai;20;19;39;13;13;26
292;16.09.2017;2017;09;20;Lauantai;17;15;32;13;16;29
292;16.09.2017;2017;09;21;Lauantai;12;12;24;3;10;13
292;16.09.2017;2017;09;22;Lauantai;6;6;12;4;2;6
292;16.09.2017;2017;09;23;Lauantai;9;5;14;5;2;7
292;17.09.2017;2017;09;00;Sunnuntai;3;4;7;2;8;10
292;17.09.2017;2017;09;01;Sunnuntai;2;5;7;0;5;5
292;17.09.2017;2017;09;02;Sunnuntai;1;2;3;5;4;9
292;17.09.2017;2017;09;03;Sunnuntai;1;1;2;0;4;4
292;17.09.2017;2017;09;04;Sunnuntai;1;2;3;1;1;2
292;17.09.2017;2017;09;05;Sunnuntai;0;0;0;0;0;0
292;17.09.2017;2017;09;06;Sunnuntai;3;3;6;3;2;5
292;17.09.2017;2017;09;07;Sunnuntai;3;2;5;4;4;8
292;17.09.2017;2017;09;08;Sunnuntai;6;6;12;3;6;9
292;17.09.2017;2017;09;09;Sunnuntai;7;5;12;1;2;3
292;17.09.2017;2017;09;10;Sunnuntai;10;9;19;2;6;8
292;17.09.2017;2017;09;11;Sunnuntai;11;14;25;1;9;10
292;17.09.2017;2017;09;12;Sunnuntai;29;28;57;4;11;15
292;17.09.2017;2017;09;13;Sunnuntai;36;36;72;15;12;27
292;17.09.2017;2017;09;14;Sunnuntai;34;28;62;11;9;20
292;17.09.2017;2017;09;15;Sunnuntai;36;22;58;16;13;29
292;17.09.2017;2017;09;16;Sunnuntai;39;41;80;10;19;29
292;17.09.2017;2017;09;17;Sunnuntai;29;28;57;13;15;28
292;17.09.2017;2017;09;18;Sunnuntai;36;30;66;13;23;36
292;17.09.2017;2017;09;19;Sunnuntai;15;21;36;8;7;15
292;17.09.2017;2017;09;20;Sunnuntai;26;12;38;10;4;14
292;17.09.2017;2017;09;21;Sunnuntai;10;9;19;4;8;12
292;17.09.2017;2017;09;22;Sunnuntai;1;3;4;2;0;2
292;17.09.2017;2017;09;23;Sunnuntai;0;0;0;0;0;0
292;18.09.2017;2017;09;00;Maanantai;1;0;1;0;2;2
292;18.09.2017;2017;09;01;Maanantai;1;0;1;0;0;0
292;18.09.2017;2017;09;02;Maanantai;0;0;0;0;0;0
292;18.09.2017;2017;09;03;Maanantai;0;0;0;0;0;0
292;18.09.2017;2017;09;04;Maanantai;1;1;2;0;1;1
292;18.09.2017;2017;09;05;Maanantai;6;8;14;1;1;2
292;18.09.2017;2017;09;06;Maanantai;15;18;33;2;4;6
292;18.09.2017;2017;09;07;Maanantai;58;36;94;7;8;15
292;18.09.2017;2017;09;08;Maanantai;40;26;66;7;12;19
292;18.09.2017;2017;09;09;Maanantai;51;31;82;8;6;14
292;18.09.2017;2017;09;10;Maanantai;20;13;33;4;9;13
292;18.09.2017;2017;09;11;Maanantai;16;11;27;6;5;11
292;18.09.2017;2017;09;12;Maanantai;31;13;44;6;11;17
292;18.09.2017;2017;09;13;Maanantai;27;38;65;12;29;41
292;18.09.2017;2017;09;14;Maanantai;46;72;118;11;24;35
292;18.09.2017;2017;09;15;Maanantai;45;57;102;12;25;37
292;18.09.2017;2017;09;16;Maanantai;66;80;146;11;25;36
292;18.09.2017;2017;09;17;Maanantai;52;37;89;20;20;40
292;18.09.2017;2017;09;18;Maanantai;30;26;56;22;18;40
292;18.09.2017;2017;09;19;Maanantai;45;30;75;12;25;37
292;18.09.2017;2017;09;20;Maanantai;38;20;58;10;15;25
292;18.09.2017;2017;09;21;Maanantai;9;9;18;3;7;10
292;18.09.2017;2017;09;22;Maanantai;1;3;4;0;0;0
292;18.09.2017;2017;09;23;Maanantai;0;0;0;0;0;0
292;19.09.2017;2017;09;00;Tiistai;0;0;0;0;0;0
292;19.09.2017;2017;09;01;Tiistai;1;1;2;0;1;1
292;19.09.2017;2017;09;02;Tiistai;2;0;2;1;0;1
292;19.09.2017;2017;09;03;Tiistai;0;1;1;0;0;0
292;19.09.2017;2017;09;04;Tiistai;1;0;1;1;0;1
292;19.09.2017;2017;09;05;Tiistai;6;6;12;0;1;1
292;19.09.2017;2017;09;06;Tiistai;11;20;31;2;11;13
292;19.09.2017;2017;09;07;Tiistai;70;31;101;6;17;23
292;19.09.2017;2017;09;08;Tiistai;78;27;105;15;13;28
292;19.09.2017;2017;09;09;Tiistai;30;17;47;7;10;17
292;19.09.2017;2017;09;10;Tiistai;15;11;26;3;8;11
292;19.09.2017;2017;09;11;Tiistai;8;4;12;6;6;12
292;19.09.2017;2017;09;12;Tiistai;12;10;22;3;3;6
292;19.09.2017;2017;09;13;Tiistai;25;26;51;6;5;11
292;19.09.2017;2017;09;14;Tiistai;35;51;86;10;16;26
292;19.09.2017;2017;09;15;Tiistai;46;56;102;9;11;20
292;19.09.2017;2017;09;16;Tiistai;49;41;90;8;24;32
292;19.09.2017;2017;09;17;Tiistai;44;24;68;11;21;32
292;19.09.2017;2017;09;18;Tiistai;24;36;60;16;13;29
292;19.09.2017;2017;09;19;Tiistai;21;29;50;14;15;29
292;19.09.2017;2017;09;20;Tiistai;34;23;57;16;9;25
292;19.09.2017;2017;09;21;Tiistai;9;10;19;3;3;6
292;19.09.2017;2017;09;22;Tiistai;5;2;7;0;1;1
292;19.09.2017;2017;09;23;Tiistai;0;1;1;1;1;2
292;20.09.2017;2017;09;00;Keskiviikko;0;0;0;1;0;1
292;20.09.2017;2017;09;01;Keskiviikko;0;2;2;0;1;1
292;20.09.2017;2017;09;02;Keskiviikko;1;0;1;0;0;0
292;20.09.2017;2017;09;03;Keskiviikko;0;0;0;0;0;0
292;20.09.2017;2017;09;04;Keskiviikko;1;2;3;1;0;1
292;20.09.2017;2017;09;05;Keskiviikko;5;4;9;1;2;3
292;20.09.2017;2017;09;06;Keskiviikko;20;16;36;3;11;14
292;20.09.2017;2017;09;07;Keskiviikko;65;34;99;8;16;24
292;20.09.2017;2017;09;08;Keskiviikko;79;19;98;7;16;23
292;20.09.2017;2017;09;09;Keskiviikko;40;14;54;4;17;21
292;20.09.2017;2017;09;10;Keskiviikko;21;10;31;8;5;13
292;20.09.2017;2017;09;11;Keskiviikko;27;18;45;8;21;29
292;20.09.2017;2017;09;12;Keskiviikko;27;20;47;3;19;22
292;20.09.2017;2017;09;13;Keskiviikko;40;56;96;8;22;30
292;20.09.2017;2017;09;14;Keskiviikko;33;50;83;15;21;36
292;20.09.2017;2017;09;15;Keskiviikko;52;59;111;9;22;31
292;20.09.2017;2017;09;16;Keskiviikko;43;54;97;11;27;38
292;20.09.2017;2017;09;17;Keskiviikko;35;36;71;9;18;27
292;20.09.2017;2017;09;18;Keskiviikko;30;32;62;11;21;32
292;20.09.2017;2017;09;19;Keskiviikko;37;21;58;17;13;30
292;20.09.2017;2017;09;20;Keskiviikko;34;12;46;5;10;15
292;20.09.2017;2017;09;21;Keskiviikko;7;13;20;8;4;12
292;20.09.2017;2017;09;22;Keskiviikko;0;0;0;1;0;1
292;20.09.2017;2017;09;23;Keskiviikko;0;1;1;0;2;2
292;21.09.2017;2017;09;00;Torstai;0;0;0;3;0;3
292;21.09.2017;2017;09;01;Torstai;1;0;1;0;3;3
292;21.09.2017;2017;09;02;Torstai;0;1;1;0;1;1
292;21.09.2017;2017;09;03;Torstai;2;3;5;0;1;1
292;21.09.2017;2017;09;04;Torstai;1;0;1;0;0;0
292;21.09.2017;2017;09;05;Torstai;6;3;9;1;3;4
292;21.09.2017;2017;09;06;Torstai;15;19;34;3;4;7
292;21.09.2017;2017;09;07;Torstai;72;33;105;7;11;18
292;21.09.2017;2017;09;08;Torstai;40;23;63;12;14;26
292;21.09.2017;2017;09;09;Torstai;66;25;91;12;12;24
292;21.09.2017;2017;09;10;Torstai;34;10;44;11;10;21
292;21.09.2017;2017;09;11;Torstai;29;19;48;9;6;15
292;21.09.2017;2017;09;12;Torstai;29;14;43;4;8;12
292;21.09.2017;2017;09;13;Torstai;39;45;84;6;14;20
292;21.09.2017;2017;09;14;Torstai;42;59;101;11;16;27
292;21.09.2017;2017;09;15;Torstai;58;68;126;9;19;28
292;21.09.2017;2017;09;16;Torstai;55;68;123;17;23;40
292;21.09.2017;2017;09;17;Torstai;42;21;63;13;20;33
292;21.09.2017;2017;09;18;Torstai;43;35;78;18;16;34
292;21.09.2017;2017;09;19;Torstai;30;20;50;12;10;22
292;21.09.2017;2017;09;20;Torstai;12;12;24;7;6;13
292;21.09.2017;2017;09;21;Torstai;10;2;12;6;6;12
292;21.09.2017;2017;09;22;Torstai;1;2;3;0;3;3
292;21.09.2017;2017;09;23;Torstai;1;0;1;0;0;0
292;22.09.2017;2017;09;00;Perjantai;0;1;1;1;0;1
292;22.09.2017;2017;09;01;Perjantai;0;1;1;1;0;1
292;22.09.2017;2017;09;02;Perjantai;1;1;2;0;0;0
292;22.09.2017;2017;09;03;Perjantai;1;0;1;0;0;0
292;22.09.2017;2017;09;04;Perjantai;1;0;1;1;0;1
292;22.09.2017;2017;09;05;Perjantai;7;7;14;1;1;2
292;22.09.2017;2017;09;06;Perjantai;15;11;26;1;4;5
292;22.09.2017;2017;09;07;Perjantai;80;35;115;16;3;19
292;22.09.2017;2017;09;08;Perjantai;103;54;157;12;19;31
292;22.09.2017;2017;09;09;Perjantai;74;34;108;11;8;19
292;22.09.2017;2017;09;10;Perjantai;72;70;142;13;8;21
292;22.09.2017;2017;09;11;Perjantai;37;15;52;13;13;26
292;22.09.2017;2017;09;12;Perjantai;36;51;87;14;26;40
292;22.09.2017;2017;09;13;Perjantai;23;82;105;4;33;37
292;22.09.2017;2017;09;14;Perjantai;51;58;109;16;30;46
292;22.09.2017;2017;09;15;Perjantai;57;50;107;23;30;53
292;22.09.2017;2017;09;16;Perjantai;54;41;95;17;43;60
292;22.09.2017;2017;09;17;Perjantai;47;30;77;11;33;44
292;22.09.2017;2017;09;18;Perjantai;54;29;83;18;27;45
292;22.09.2017;2017;09;19;Perjantai;31;33;64;15;11;26
292;22.09.2017;2017;09;20;Perjantai;36;11;47;12;9;21
292;22.09.2017;2017;09;21;Perjantai;8;4;12;3;6;9
292;22.09.2017;2017;09;22;Perjantai;6;2;8;4;3;7
292;22.09.2017;2017;09;23;Perjantai;3;5;8;4;0;4
292;23.09.2017;2017;09;00;Lauantai;4;7;11;9;1;10
292;23.09.2017;2017;09;01;Lauantai;1;0;1;3;2;5
292;23.09.2017;2017;09;02;Lauantai;1;4;5;2;3;5
292;23.09.2017;2017;09;03;Lauantai;1;4;5;1;3;4
292;23.09.2017;2017;09;04;Lauantai;0;0;0;1;0;1
292;23.09.2017;2017;09;05;Lauantai;0;0;0;1;0;1
292;23.09.2017;2017;09;06;Lauantai;4;2;6;2;4;6
292;23.09.2017;2017;09;07;Lauantai;6;2;8;2;5;7
292;23.09.2017;2017;09;08;Lauantai;16;10;26;4;4;8
292;23.09.2017;2017;09;09;Lauantai;7;9;16;4;8;12
292;23.09.2017;2017;09;10;Lauantai;18;13;31;7;10;17
292;23.09.2017;2017;09;11;Lauantai;26;17;43;3;17;20
292;23.09.2017;2017;09;12;Lauantai;32;27;59;11;10;21
292;23.09.2017;2017;09;13;Lauantai;28;33;61;9;17;26
292;23.09.2017;2017;09;14;Lauantai;37;28;65;12;11;23
292;23.09.2017;2017;09;15;Lauantai;43;29;72;17;12;29
292;23.09.2017;2017;09;16;Lauantai;30;17;47;8;9;17
292;23.09.2017;2017;09;17;Lauantai;23;24;47;13;13;26
292;23.09.2017;2017;09;18;Lauantai;30;24;54;10;22;32
292;23.09.2017;2017;09;19;Lauantai;20;17;37;14;11;25
292;23.09.2017;2017;09;20;Lauantai;19;17;36;13;18;31
292;23.09.2017;2017;09;21;Lauantai;21;18;39;15;24;39
292;23.09.2017;2017;09;22;Lauantai;12;6;18;8;5;13
292;23.09.2017;2017;09;23;Lauantai;4;3;7;3;7;10
292;24.09.2017;2017;09;00;Sunnuntai;1;4;5;3;4;7
292;24.09.2017;2017;09;01;Sunnuntai;3;1;4;2;3;5
292;24.09.2017;2017;09;02;Sunnuntai;2;5;7;3;6;9
292;24.09.2017;2017;09;03;Sunnuntai;1;3;4;0;2;2
292;24.09.2017;2017;09;04;Sunnuntai;1;0;1;1;1;2
292;24.09.2017;2017;09;05;Sunnuntai;1;0;1;0;0;0
292;24.09.2017;2017;09;06;Sunnuntai;3;2;5;0;1;1
292;24.09.2017;2017;09;07;Sunnuntai;2;2;4;4;4;8
292;24.09.2017;2017;09;08;Sunnuntai;10;8;18;5;9;14
292;24.09.2017;2017;09;09;Sunnuntai;12;12;24;3;10;13
292;24.09.2017;2017;09;10;Sunnuntai;17;13;30;6;14;20
292;24.09.2017;2017;09;11;Sunnuntai;27;24;51;8;7;15
292;24.09.2017;2017;09;12;Sunnuntai;30;26;56;11;12;23
292;24.09.2017;2017;09;13;Sunnuntai;25;28;53;8;9;17
292;24.09.2017;2017;09;14;Sunnuntai;44;27;71;10;19;29
292;24.09.2017;2017;09;15;Sunnuntai;45;29;74;11;7;18
292;24.09.2017;2017;09;16;Sunnuntai;41;24;65;16;14;30
292;24.09.2017;2017;09;17;Sunnuntai;28;14;42;24;16;40
292;24.09.2017;2017;09;18;Sunnuntai;37;28;65;15;22;37
292;24.09.2017;2017;09;19;Sunnuntai;28;31;59;12;18;30
292;24.09.2017;2017;09;20;Sunnuntai;16;18;34;9;12;21
292;24.09.2017;2017;09;21;Sunnuntai;8;6;14;6;2;8
292;24.09.2017;2017;09;22;Sunnuntai;1;2;3;0;1;1
292;24.09.2017;2017;09;23;Sunnuntai;1;0;1;1;0;1
292;25.09.2017;2017;09;00;Maanantai;0;0;0;0;0;0
292;25.09.2017;2017;09;01;Maanantai;0;1;1;0;0;0
292;25.09.2017;2017;09;02;Maanantai;0;0;0;0;0;0
292;25.09.2017;2017;09;03;Maanantai;1;0;1;0;0;0
292;25.09.2017;2017;09;04;Maanantai;1;0;1;0;1;1
292;25.09.2017;2017;09;05;Maanantai;3;4;7;0;0;0
292;25.09.2017;2017;09;06;Maanantai;19;19;38;2;5;7
292;25.09.2017;2017;09;07;Maanantai;73;49;122;3;6;9
292;25.09.2017;2017;09;08;Maanantai;59;44;103;7;7;14
292;25.09.2017;2017;09;09;Maanantai;68;43;111;7;11;18
292;25.09.2017;2017;09;10;Maanantai;54;47;101;6;10;16
292;25.09.2017;2017;09;11;Maanantai;36;34;70;8;8;16
292;25.09.2017;2017;09;12;Maanantai;26;24;50;13;11;24
292;25.09.2017;2017;09;13;Maanantai;38;54;92;9;27;36
292;25.09.2017;2017;09;14;Maanantai;40;55;95;15;33;48
292;25.09.2017;2017;09;15;Maanantai;60;50;110;21;37;58
292;25.09.2017;2017;09;16;Maanantai;55;61;116;16;32;48
292;25.09.2017;2017;09;17;Maanantai;54;45;99;18;37;55
292;25.09.2017;2017;09;18;Maanantai;61;25;86;23;44;67
292;25.09.2017;2017;09;19;Maanantai;47;32;79;25;29;54
292;25.09.2017;2017;09;20;Maanantai;27;27;54;7;23;30
292;25.09.2017;2017;09;21;Maanantai;8;3;11;6;2;8
292;25.09.2017;2017;09;22;Maanantai;3;4;7;1;0;1
292;25.09.2017;2017;09;23;Maanantai;0;1;1;0;1;1
292;26.09.2017;2017;09;00;Tiistai;0;0;0;0;0;0
292;26.09.2017;2017;09;01;Tiistai;0;1;1;0;0;0
292;26.09.2017;2017;09;02;Tiistai;0;0;0;0;0;0
292;26.09.2017;2017;09;03;Tiistai;0;0;0;0;0;0
292;26.09.2017;2017;09;04;Tiistai;2;1;3;0;0;0
292;26.09.2017;2017;09;05;Tiistai;6;4;10;1;1;2
292;26.09.2017;2017;09;06;Tiistai;19;18;37;2;3;5
292;26.09.2017;2017;09;07;Tiistai;85;53;138;4;5;9
292;26.09.2017;2017;09;08;Tiistai;53;37;90;9;9;18
292;26.09.2017;2017;09;09;Tiistai;30;23;53;9;7;16
292;26.09.2017;2017;09;10;Tiistai;24;21;45;6;8;14
292;26.09.2017;2017;09;11;Tiistai;22;24;46;8;7;15
292;26.09.2017;2017;09;12;Tiistai;29;24;53;6;2;8
292;26.09.2017;2017;09;13;Tiistai;37;38;75;8;8;16
292;26.09.2017;2017;09;14;Tiistai;47;43;90;8;15;23
292;26.09.2017;2017;09;15;Tiistai;51;56;107;11;8;19
292;26.09.2017;2017;09;16;Tiistai;46;44;90;3;10;13
292;26.09.2017;2017;09;17;Tiistai;39;30;69;7;9;16
292;26.09.2017;2017;09;18;Tiistai;40;32;72;14;7;21
292;26.09.2017;2017;09;19;Tiistai;28;16;44;12;7;19
292;26.09.2017;2017;09;20;Tiistai;22;13;35;9;5;14
292;26.09.2017;2017;09;21;Tiistai;10;8;18;2;0;2
292;26.09.2017;2017;09;22;Tiistai;5;3;8;1;1;2
292;26.09.2017;2017;09;23;Tiistai;1;1;2;0;2;2
292;27.09.2017;2017;09;00;Keskiviikko;1;0;1;0;0;0
292;27.09.2017;2017;09;01;Keskiviikko;0;0;0;0;0;0
292;27.09.2017;2017;09;02;Keskiviikko;0;0;0;0;0;0
292;27.09.2017;2017;09;03;Keskiviikko;0;0;0;0;0;0
292;27.09.2017;2017;09;04;Keskiviikko;0;0;0;1;0;1
292;27.09.2017;2017;09;05;Keskiviikko;6;3;9;0;2;2
292;27.09.2017;2017;09;06;Keskiviikko;20;19;39;0;3;3
292;27.09.2017;2017;09;07;Keskiviikko;84;48;132;6;7;13
292;27.09.2017;2017;09;08;Keskiviikko;61;37;98;5;6;11
292;27.09.2017;2017;09;09;Keskiviikko;28;21;49;10;10;20
292;27.09.2017;2017;09;10;Keskiviikko;26;27;53;9;6;15
292;27.09.2017;2017;09;11;Keskiviikko;28;24;52;5;9;14
292;27.09.2017;2017;09;12;Keskiviikko;37;34;71;3;10;13
292;27.09.2017;2017;09;13;Keskiviikko;47;42;89;14;9;23
292;27.09.2017;2017;09;14;Keskiviikko;55;43;98;6;11;17
292;27.09.2017;2017;09;15;Keskiviikko;50;48;98;9;5;14
292;27.09.2017;2017;09;16;Keskiviikko;49;51;100;6;3;9
292;27.09.2017;2017;09;17;Keskiviikko;33;29;62;12;10;22
292;27.09.2017;2017;09;18;Keskiviikko;25;23;48;14;12;26
292;27.09.2017;2017;09;19;Keskiviikko;27;32;59;17;13;30
292;27.09.2017;2017;09;20;Keskiviikko;25;13;38;9;10;19
292;27.09.2017;2017;09;21;Keskiviikko;13;7;20;2;5;7
292;27.09.2017;2017;09;22;Keskiviikko;2;3;5;2;2;4
292;27.09.2017;2017;09;23;Keskiviikko;1;1;2;0;2;2
292;28.09.2017;2017;09;00;Torstai;0;1;1;0;0;0
292;28.09.2017;2017;09;01;Torstai;1;0;1;0;1;1
292;28.09.2017;2017;09;02;Torstai;1;0;1;0;0;0
292;28.09.2017;2017;09;03;Torstai;0;0;0;0;0;0
292;28.09.2017;2017;09;04;Torstai;1;0;1;1;0;1
292;28.09.2017;2017;09;05;Torstai;5;3;8;0;2;2
292;28.09.2017;2017;09;06;Torstai;15;16;31;0;5;5
292;28.09.2017;2017;09;07;Torstai;81;47;128;6;6;12
292;28.09.2017;2017;09;08;Torstai;50;34;84;9;9;18
292;28.09.2017;2017;09;09;Torstai;23;24;47;8;11;19
292;28.09.2017;2017;09;10;Torstai;37;39;76;5;12;17
292;28.09.2017;2017;09;11;Torstai;23;25;48;6;13;19
292;28.09.2017;2017;09;12;Torstai;29;29;58;8;14;22
292;28.09.2017;2017;09;13;Torstai;27;32;59;8;10;18
292;28.09.2017;2017;09;14;Torstai;46;43;89;9;7;16
292;28.09.2017;2017;09;15;Torstai;53;43;96;9;22;31
292;28.09.2017;2017;09;16;Torstai;57;43;100;5;10;15
292;28.09.2017;2017;09;17;Torstai;29;34;63;10;16;26
292;28.09.2017;2017;09;18;Torstai;46;25;71;13;17;30
292;28.09.2017;2017;09;19;Torstai;37;18;55;13;21;34
292;28.09.2017;2017;09;20;Torstai;28;14;42;12;12;24
292;28.09.2017;2017;09;21;Torstai;12;12;24;5;7;12
292;28.09.2017;2017;09;22;Torstai;6;5;11;0;2;2
292;28.09.2017;2017;09;23;Torstai;2;2;4;0;2;2
292;29.09.2017;2017;09;00;Perjantai;2;2;4;1;0;1
292;29.09.2017;2017;09;01;Perjantai;0;1;1;0;1;1
292;29.09.2017;2017;09;02;Perjantai;0;1;1;0;0;0
292;29.09.2017;2017;09;03;Perjantai;0;0;0;0;0;0
292;29.09.2017;2017;09;04;Perjantai;1;0;1;0;0;0
292;29.09.2017;2017;09;05;Perjantai;4;3;7;1;2;3
292;29.09.2017;2017;09;06;Perjantai;16;11;27;2;6;8
292;29.09.2017;2017;09;07;Perjantai;71;35;106;1;6;7
292;29.09.2017;2017;09;08;Perjantai;47;34;81;8;11;19
292;29.09.2017;2017;09;09;Perjantai;19;20;39;16;9;25
292;29.09.2017;2017;09;10;Perjantai;32;27;59;7;7;14
292;29.09.2017;2017;09;11;Perjantai;28;31;59;4;11;15
292;29.09.2017;2017;09;12;Perjantai;39;38;77;12;15;27
292;29.09.2017;2017;09;13;Perjantai;37;42;79;4;9;13
292;29.09.2017;2017;09;14;Perjantai;37;42;79;15;18;33
292;29.09.2017;2017;09;15;Perjantai;37;37;74;8;17;25
292;29.09.2017;2017;09;16;Perjantai;36;34;70;17;7;24
292;29.09.2017;2017;09;17;Perjantai;41;46;87;15;14;29
292;29.09.2017;2017;09;18;Perjantai;39;32;71;13;31;44
292;29.09.2017;2017;09;19;Perjantai;35;28;63;23;21;44
292;29.09.2017;2017;09;20;Perjantai;31;16;47;12;17;29
292;29.09.2017;2017;09;21;Perjantai;11;17;28;7;8;15
292;29.09.2017;2017;09;22;Perjantai;12;12;24;7;2;9
292;29.09.2017;2017;09;23;Perjantai;16;5;21;4;1;5
292;30.09.2017;2017;09;00;Lauantai;5;0;5;4;6;10
292;30.09.2017;2017;09;01;Lauantai;1;4;5;0;3;3
292;30.09.2017;2017;09;02;Lauantai;0;6;6;0;3;3
292;30.09.2017;2017;09;03;Lauantai;6;5;11;0;1;1
292;30.09.2017;2017;09;04;Lauantai;0;1;1;1;1;2
292;30.09.2017;2017;09;05;Lauantai;0;3;3;1;0;1
292;30.09.2017;2017;09;06;Lauantai;2;2;4;0;3;3
292;30.09.2017;2017;09;07;Lauantai;2;2;4;3;1;4
292;30.09.2017;2017;09;08;Lauantai;5;8;13;9;5;14
292;30.09.2017;2017;09;09;Lauantai;11;11;22;9;6;15
292;30.09.2017;2017;09;10;Lauantai;22;20;42;5;8;13
292;30.09.2017;2017;09;11;Lauantai;21;22;43;8;14;22
292;30.09.2017;2017;09;12;Lauantai;34;25;59;7;8;15
292;30.09.2017;2017;09;13;Lauantai;26;28;54;8;17;25
292;30.09.2017;2017;09;14;Lauantai;39;29;68;21;12;33
292;30.09.2017;2017;09;15;Lauantai;27;23;50;9;5;14
292;30.09.2017;2017;09;16;Lauantai;21;20;41;13;15;28
292;30.09.2017;2017;09;17;Lauantai;29;30;59;14;12;26
292;30.09.2017;2017;09;18;Lauantai;36;17;53;14;13;27
292;30.09.2017;2017;09;19;Lauantai;21;13;34;9;7;16
292;30.09.2017;2017;09;20;Lauantai;12;7;19;6;9;15
292;30.09.2017;2017;09;21;Lauantai;13;4;17;15;3;18
292;30.09.2017;2017;09;22;Lauantai;7;9;16;6;3;9
292;30.09.2017;2017;09;23;Lauantai;1;3;4;3;3;6
292;01.10.2017;2017;10;00;Sunnuntai;2;6;8;7;2;9
292;01.10.2017;2017;10;01;Sunnuntai;1;0;1;2;0;2
292;01.10.2017;2017;10;02;Sunnuntai;1;2;3;1;7;8
292;01.10.2017;2017;10;03;Sunnuntai;0;3;3;0;2;2
292;01.10.2017;2017;10;04;Sunnuntai;1;1;2;1;0;1
292;01.10.2017;2017;10;05;Sunnuntai;0;0;0;0;0;0
292;01.10.2017;2017;10;06;Sunnuntai;2;2;4;2;4;6
292;01.10.2017;2017;10;07;Sunnuntai;4;1;5;4;0;4
292;01.10.2017;2017;10;08;Sunnuntai;4;4;8;4;5;9
292;01.10.2017;2017;10;09;Sunnuntai;10;10;20;4;6;10
292;01.10.2017;2017;10;10;Sunnuntai;12;18;30;9;12;21
292;01.10.2017;2017;10;11;Sunnuntai;20;20;40;14;3;17
292;01.10.2017;2017;10;12;Sunnuntai;28;30;58;6;17;23
292;01.10.2017;2017;10;13;Sunnuntai;25;19;44;9;14;23
292;01.10.2017;2017;10;14;Sunnuntai;24;29;53;13;7;20
292;01.10.2017;2017;10;15;Sunnuntai;40;35;75;12;2;14
292;01.10.2017;2017;10;16;Sunnuntai;34;27;61;11;8;19
292;01.10.2017;2017;10;17;Sunnuntai;29;27;56;15;9;24
292;01.10.2017;2017;10;18;Sunnuntai;24;16;40;20;19;39
292;01.10.2017;2017;10;19;Sunnuntai;25;27;52;20;16;36
292;01.10.2017;2017;10;20;Sunnuntai;14;11;25;3;11;14
292;01.10.2017;2017;10;21;Sunnuntai;2;4;6;2;6;8
292;01.10.2017;2017;10;22;Sunnuntai;1;1;2;2;0;2
292;01.10.2017;2017;10;23;Sunnuntai;2;0;2;1;2;3
292;02.10.2017;2017;10;00;Maanantai;0;1;1;1;1;2
292;02.10.2017;2017;10;01;Maanantai;0;0;0;0;0;0
292;02.10.2017;2017;10;02;Maanantai;0;0;0;1;0;1
292;02.10.2017;2017;10;03;Maanantai;0;0;0;0;0;0
292;02.10.2017;2017;10;04;Maanantai;1;1;2;1;0;1
292;02.10.2017;2017;10;05;Maanantai;4;3;7;0;0;0
292;02.10.2017;2017;10;06;Maanantai;15;16;31;0;5;5
292;02.10.2017;2017;10;07;Maanantai;77;43;120;11;7;18
292;02.10.2017;2017;10;08;Maanantai;59;24;83;12;15;27
292;02.10.2017;2017;10;09;Maanantai;29;27;56;3;9;12
292;02.10.2017;2017;10;10;Maanantai;25;38;63;5;14;19
292;02.10.2017;2017;10;11;Maanantai;25;28;53;10;14;24
292;02.10.2017;2017;10;12;Maanantai;28;25;53;5;8;13
292;02.10.2017;2017;10;13;Maanantai;34;37;71;18;21;39
292;02.10.2017;2017;10;14;Maanantai;42;56;98;17;21;38
292;02.10.2017;2017;10;15;Maanantai;52;44;96;6;14;20
292;02.10.2017;2017;10;16;Maanantai;64;48;112;15;12;27
292;02.10.2017;2017;10;17;Maanantai;47;34;81;13;21;34
292;02.10.2017;2017;10;18;Maanantai;38;30;68;19;22;41
292;02.10.2017;2017;10;19;Maanantai;36;17;53;13;13;26
292;02.10.2017;2017;10;20;Maanantai;30;12;42;10;14;24
292;02.10.2017;2017;10;21;Maanantai;5;4;9;1;5;6
292;02.10.2017;2017;10;22;Maanantai;4;3;7;2;0;2
292;02.10.2017;2017;10;23;Maanantai;1;2;3;0;0;0
292;03.10.2017;2017;10;00;Tiistai;1;0;1;0;0;0
292;03.10.2017;2017;10;01;Tiistai;0;3;3;0;1;1
292;03.10.2017;2017;10;02;Tiistai;0;0;0;0;0;0
292;03.10.2017;2017;10;03;Tiistai;1;0;1;0;0;0
292;03.10.2017;2017;10;04;Tiistai;1;1;2;1;0;1
292;03.10.2017;2017;10;05;Tiistai;3;3;6;0;1;1
292;03.10.2017;2017;10;06;Tiistai;14;15;29;0;5;5
292;03.10.2017;2017;10;07;Tiistai;81;35;116;13;8;21
292;03.10.2017;2017;10;08;Tiistai;66;25;91;8;10;18
292;03.10.2017;2017;10;09;Tiistai;18;19;37;6;15;21
292;03.10.2017;2017;10;10;Tiistai;23;17;40;10;12;22
292;03.10.2017;2017;10;11;Tiistai;21;12;33;6;7;13
292;03.10.2017;2017;10;12;Tiistai;22;16;38;6;7;13
292;03.10.2017;2017;10;13;Tiistai;35;28;63;7;10;17
292;03.10.2017;2017;10;14;Tiistai;39;98;137;13;30;43
292;03.10.2017;2017;10;15;Tiistai;60;35;95;9;16;25
292;03.10.2017;2017;10;16;Tiistai;50;38;88;7;14;21
292;03.10.2017;2017;10;17;Tiistai;38;22;60;14;13;27
292;03.10.2017;2017;10;18;Tiistai;29;19;48;13;15;28
292;03.10.2017;2017;10;19;Tiistai;17;17;34;10;10;20
292;03.10.2017;2017;10;20;Tiistai;16;8;24;5;5;10
292;03.10.2017;2017;10;21;Tiistai;8;4;12;4;3;7
292;03.10.2017;2017;10;22;Tiistai;3;1;4;0;0;0
292;03.10.2017;2017;10;23;Tiistai;0;0;0;0;0;0
292;04.10.2017;2017;10;00;Keskiviikko;0;0;0;0;0;0
292;04.10.2017;2017;10;01;Keskiviikko;1;2;3;0;0;0
292;04.10.2017;2017;10;02;Keskiviikko;0;0;0;0;0;0
292;04.10.2017;2017;10;03;Keskiviikko;0;0;0;0;0;0
292;04.10.2017;2017;10;04;Keskiviikko;1;1;2;0;0;0
292;04.10.2017;2017;10;05;Keskiviikko;4;4;8;0;2;2
292;04.10.2017;2017;10;06;Keskiviikko;11;12;23;3;2;5
292;04.10.2017;2017;10;07;Keskiviikko;64;33;97;6;6;12
292;04.10.2017;2017;10;08;Keskiviikko;58;26;84;6;8;14
292;04.10.2017;2017;10;09;Keskiviikko;33;13;46;11;7;18
292;04.10.2017;2017;10;10;Keskiviikko;15;13;28;4;11;15
292;04.10.2017;2017;10;11;Keskiviikko;21;12;33;7;15;22
292;04.10.2017;2017;10;12;Keskiviikko;15;14;29;4;6;10
292;04.10.2017;2017;10;13;Keskiviikko;33;28;61;7;11;18
292;04.10.2017;2017;10;14;Keskiviikko;37;45;82;15;15;30
292;04.10.2017;2017;10;15;Keskiviikko;44;40;84;9;14;23
292;04.10.2017;2017;10;16;Keskiviikko;40;45;85;8;20;28
292;04.10.2017;2017;10;17;Keskiviikko;32;35;67;8;12;20
292;04.10.2017;2017;10;18;Keskiviikko;38;19;57;13;15;28
292;04.10.2017;2017;10;19;Keskiviikko;25;20;45;16;13;29
292;04.10.2017;2017;10;20;Keskiviikko;22;7;29;6;13;19
292;04.10.2017;2017;10;21;Keskiviikko;11;8;19;3;4;7
292;04.10.2017;2017;10;22;Keskiviikko;2;0;2;3;1;4
292;04.10.2017;2017;10;23;Keskiviikko;1;0;1;0;0;0
292;05.10.2017;2017;10;00;Torstai;1;0;1;0;1;1
292;05.10.2017;2017;10;01;Torstai;0;0;0;0;0;0
292;05.10.2017;2017;10;02;Torstai;0;0;0;0;0;0
292;05.10.2017;2017;10;03;Torstai;0;0;0;0;0;0
292;05.10.2017;2017;10;04;Torstai;1;1;2;1;0;1
292;05.10.2017;2017;10;05;Torstai;4;5;9;0;0;0
292;05.10.2017;2017;10;06;Torstai;18;12;30;2;4;6
292;05.10.2017;2017;10;07;Torstai;65;37;102;7;10;17
292;05.10.2017;2017;10;08;Torstai;41;33;74;10;12;22
292;05.10.2017;2017;10;09;Torstai;56;37;93;6;5;11
292;05.10.2017;2017;10;10;Torstai;27;14;41;6;10;16
292;05.10.2017;2017;10;11;Torstai;38;24;62;13;15;28
292;05.10.2017;2017;10;12;Torstai;30;18;48;5;18;23
292;05.10.2017;2017;10;13;Torstai;27;28;55;10;12;22
292;05.10.2017;2017;10;14;Torstai;42;41;83;5;14;19
292;05.10.2017;2017;10;15;Torstai;45;59;104;8;11;19
292;05.10.2017;2017;10;16;Torstai;56;66;122;11;26;37
292;05.10.2017;2017;10;17;Torstai;28;30;58;11;17;28
292;05.10.2017;2017;10;18;Torstai;42;32;74;8;21;29
292;05.10.2017;2017;10;19;Torstai;35;15;50;10;11;21
292;05.10.2017;2017;10;20;Torstai;24;8;32;7;7;14
292;05.10.2017;2017;10;21;Torstai;8;10;18;6;4;10
292;05.10.2017;2017;10;22;Torstai;1;1;2;0;3;3
292;05.10.2017;2017;10;23;Torstai;0;0;0;0;1;1
292;06.10.2017;2017;10;00;Perjantai;2;0;2;0;1;1
292;06.10.2017;2017;10;01;Perjantai;0;0;0;0;0;0
292;06.10.2017;2017;10;02;Perjantai;0;0;0;0;0;0
292;06.10.2017;2017;10;03;Perjantai;0;0;0;0;0;0
292;06.10.2017;2017;10;04;Perjantai;2;1;3;0;1;1
292;06.10.2017;2017;10;05;Perjantai;6;6;12;0;1;1
292;06.10.2017;2017;10;06;Perjantai;17;9;26;4;5;9
292;06.10.2017;2017;10;07;Perjantai;74;34;108;6;12;18
292;06.10.2017;2017;10;08;Perjantai;69;39;108;15;10;25
292;06.10.2017;2017;10;09;Perjantai;43;27;70;4;6;10
292;06.10.2017;2017;10;10;Perjantai;25;17;42;8;4;12
292;06.10.2017;2017;10;11;Perjantai;40;40;80;12;11;23
292;06.10.2017;2017;10;12;Perjantai;27;30;57;12;21;33
292;06.10.2017;2017;10;13;Perjantai;44;82;126;11;16;27
292;06.10.2017;2017;10;14;Perjantai;57;56;113;11;19;30
292;06.10.2017;2017;10;15;Perjantai;46;32;78;17;15;32
292;06.10.2017;2017;10;16;Perjantai;39;31;70;11;14;25
292;06.10.2017;2017;10;17;Perjantai;29;18;47;8;14;22
292;06.10.2017;2017;10;18;Perjantai;17;23;40;6;10;16
292;06.10.2017;2017;10;19;Perjantai;24;14;38;8;8;16
292;06.10.2017;2017;10;20;Perjantai;31;11;42;3;7;10
292;06.10.2017;2017;10;21;Perjantai;9;6;15;5;7;12
292;06.10.2017;2017;10;22;Perjantai;11;7;18;1;4;5
292;06.10.2017;2017;10;23;Perjantai;5;2;7;2;1;3
292;07.10.2017;2017;10;00;Lauantai;0;0;0;5;0;5
292;07.10.2017;2017;10;01;Lauantai;2;5;7;2;1;3
292;07.10.2017;2017;10;02;Lauantai;1;3;4;0;5;5
292;07.10.2017;2017;10;03;Lauantai;2;3;5;1;2;3
292;07.10.2017;2017;10;04;Lauantai;1;1;2;1;0;1
292;07.10.2017;2017;10;05;Lauantai;0;1;1;1;0;1
292;07.10.2017;2017;10;06;Lauantai;3;2;5;0;2;2
292;07.10.2017;2017;10;07;Lauantai;3;5;8;4;2;6
292;07.10.2017;2017;10;08;Lauantai;8;7;15;7;4;11
292;07.10.2017;2017;10;09;Lauantai;11;7;18;1;4;5
292;07.10.2017;2017;10;10;Lauantai;18;17;35;9;6;15
292;07.10.2017;2017;10;11;Lauantai;24;22;46;12;11;23
292;07.10.2017;2017;10;12;Lauantai;29;20;49;9;10;19
292;07.10.2017;2017;10;13;Lauantai;19;18;37;3;7;10
292;07.10.2017;2017;10;14;Lauantai;25;22;47;5;12;17
292;07.10.2017;2017;10;15;Lauantai;30;32;62;7;4;11
292;07.10.2017;2017;10;16;Lauantai;27;25;52;16;8;24
292;07.10.2017;2017;10;17;Lauantai;27;26;53;16;21;37
292;07.10.2017;2017;10;18;Lauantai;34;19;53;29;21;50
292;07.10.2017;2017;10;19;Lauantai;17;21;38;16;15;31
292;07.10.2017;2017;10;20;Lauantai;16;13;29;7;13;20
292;07.10.2017;2017;10;21;Lauantai;12;5;17;8;6;14
292;07.10.2017;2017;10;22;Lauantai;7;5;12;12;2;14
292;07.10.2017;2017;10;23;Lauantai;2;3;5;5;3;8
292;08.10.2017;2017;10;00;Sunnuntai;4;0;4;1;3;4
292;08.10.2017;2017;10;01;Sunnuntai;0;2;2;2;2;4
292;08.10.2017;2017;10;02;Sunnuntai;1;3;4;1;2;3
292;08.10.2017;2017;10;03;Sunnuntai;3;1;4;0;1;1
292;08.10.2017;2017;10;04;Sunnuntai;0;1;1;0;1;1
292;08.10.2017;2017;10;05;Sunnuntai;0;0;0;1;0;1
292;08.10.2017;2017;10;06;Sunnuntai;1;0;1;2;2;4
292;08.10.2017;2017;10;07;Sunnuntai;2;3;5;1;3;4
292;08.10.2017;2017;10;08;Sunnuntai;7;6;13;3;5;8
292;08.10.2017;2017;10;09;Sunnuntai;7;6;13;9;2;11
292;08.10.2017;2017;10;10;Sunnuntai;14;20;34;7;9;16
292;08.10.2017;2017;10;11;Sunnuntai;23;25;48;16;11;27
292;08.10.2017;2017;10;12;Sunnuntai;34;39;73;9;8;17
292;08.10.2017;2017;10;13;Sunnuntai;28;27;55;8;13;21
292;08.10.2017;2017;10;14;Sunnuntai;36;31;67;12;13;25
292;08.10.2017;2017;10;15;Sunnuntai;37;29;66;14;13;27
292;08.10.2017;2017;10;16;Sunnuntai;47;33;80;21;21;42
292;08.10.2017;2017;10;17;Sunnuntai;36;30;66;18;23;41
292;08.10.2017;2017;10;18;Sunnuntai;31;25;56;18;25;43
292;08.10.2017;2017;10;19;Sunnuntai;24;12;36;11;14;25
292;08.10.2017;2017;10;20;Sunnuntai;5;13;18;3;8;11
292;08.10.2017;2017;10;21;Sunnuntai;3;6;9;2;4;6
292;08.10.2017;2017;10;22;Sunnuntai;1;3;4;1;3;4
292;08.10.2017;2017;10;23;Sunnuntai;2;3;5;0;0;0
292;09.10.2017;2017;10;00;Maanantai;0;0;0;0;0;0
292;09.10.2017;2017;10;01;Maanantai;0;4;4;0;0;0
292;09.10.2017;2017;10;02;Maanantai;0;0;0;0;0;0
292;09.10.2017;2017;10;03;Maanantai;0;0;0;0;0;0
292;09.10.2017;2017;10;04;Maanantai;1;0;1;0;0;0
292;09.10.2017;2017;10;05;Maanantai;5;5;10;0;2;2
292;09.10.2017;2017;10;06;Maanantai;20;18;38;1;3;4
292;09.10.2017;2017;10;07;Maanantai;61;33;94;11;8;19
292;09.10.2017;2017;10;08;Maanantai;42;35;77;9;18;27
292;09.10.2017;2017;10;09;Maanantai;69;23;92;17;11;28
292;09.10.2017;2017;10;10;Maanantai;23;16;39;13;12;25
292;09.10.2017;2017;10;11;Maanantai;47;25;72;14;13;27
292;09.10.2017;2017;10;12;Maanantai;29;24;53;11;13;24
292;09.10.2017;2017;10;13;Maanantai;27;46;73;14;20;34
292;09.10.2017;2017;10;14;Maanantai;42;68;110;12;22;34
292;09.10.2017;2017;10;15;Maanantai;45;77;122;9;11;20
292;09.10.2017;2017;10;16;Maanantai;61;57;118;17;16;33
292;09.10.2017;2017;10;17;Maanantai;48;35;83;13;19;32
292;09.10.2017;2017;10;18;Maanantai;47;28;75;16;17;33
292;09.10.2017;2017;10;19;Maanantai;16;15;31;15;16;31
292;09.10.2017;2017;10;20;Maanantai;18;17;35;7;17;24
292;09.10.2017;2017;10;21;Maanantai;13;3;16;6;7;13
292;09.10.2017;2017;10;22;Maanantai;5;1;6;1;1;2
292;09.10.2017;2017;10;23;Maanantai;3;0;3;0;0;0
292;10.10.2017;2017;10;00;Tiistai;1;1;2;1;1;2
292;10.10.2017;2017;10;01;Tiistai;0;0;0;0;0;0
292;10.10.2017;2017;10;02;Tiistai;0;0;0;0;0;0
292;10.10.2017;2017;10;03;Tiistai;0;0;0;0;0;0
292;10.10.2017;2017;10;04;Tiistai;1;1;2;0;0;0
292;10.10.2017;2017;10;05;Tiistai;4;1;5;0;0;0
292;10.10.2017;2017;10;06;Tiistai;12;13;25;2;6;8
292;10.10.2017;2017;10;07;Tiistai;52;28;80;6;3;9
292;10.10.2017;2017;10;08;Tiistai;46;18;64;10;11;21
292;10.10.2017;2017;10;09;Tiistai;17;6;23;3;7;10
292;10.10.2017;2017;10;10;Tiistai;9;5;14;5;6;11
292;10.10.2017;2017;10;11;Tiistai;15;13;28;6;9;15
292;10.10.2017;2017;10;12;Tiistai;6;9;15;3;4;7
292;10.10.2017;2017;10;13;Tiistai;22;28;50;4;11;15
292;10.10.2017;2017;10;14;Tiistai;39;51;90;6;11;17
292;10.10.2017;2017;10;15;Tiistai;26;33;59;6;16;22
292;10.10.2017;2017;10;16;Tiistai;40;32;72;14;18;32
292;10.10.2017;2017;10;17;Tiistai;27;20;47;11;9;20
292;10.10.2017;2017;10;18;Tiistai;14;23;37;15;15;30
292;10.10.2017;2017;10;19;Tiistai;20;13;33;14;7;21
292;10.10.2017;2017;10;20;Tiistai;16;10;26;6;9;15
292;10.10.2017;2017;10;21;Tiistai;5;5;10;2;2;4
292;10.10.2017;2017;10;22;Tiistai;3;1;4;0;0;0
292;10.10.2017;2017;10;23;Tiistai;1;0;1;1;0;1
292;11.10.2017;2017;10;00;Keskiviikko;0;0;0;0;0;0
292;11.10.2017;2017;10;01;Keskiviikko;0;2;2;0;0;0
292;11.10.2017;2017;10;02;Keskiviikko;1;1;2;1;0;1
292;11.10.2017;2017;10;03;Keskiviikko;0;0;0;0;0;0
292;11.10.2017;2017;10;04;Keskiviikko;1;2;3;0;0;0
292;11.10.2017;2017;10;05;Keskiviikko;6;4;10;0;2;2
292;11.10.2017;2017;10;06;Keskiviikko;19;22;41;1;5;6
292;11.10.2017;2017;10;07;Keskiviikko;74;29;103;6;5;11
292;11.10.2017;2017;10;08;Keskiviikko;66;26;92;7;14;21
292;11.10.2017;2017;10;09;Keskiviikko;45;16;61;8;16;24
292;11.10.2017;2017;10;10;Keskiviikko;27;23;50;7;6;13
292;11.10.2017;2017;10;11;Keskiviikko;32;28;60;7;16;23
292;11.10.2017;2017;10;12;Keskiviikko;25;30;55;11;17;28
292;11.10.2017;2017;10;13;Keskiviikko;59;37;96;11;24;35
292;11.10.2017;2017;10;14;Keskiviikko;44;71;115;13;32;45
292;11.10.2017;2017;10;15;Keskiviikko;48;48;96;16;22;38
292;11.10.2017;2017;10;16;Keskiviikko;50;42;92;16;33;49
292;11.10.2017;2017;10;17;Keskiviikko;36;19;55;8;19;27
292;11.10.2017;2017;10;18;Keskiviikko;31;28;59;14;17;31
292;11.10.2017;2017;10;19;Keskiviikko;22;21;43;24;20;44
292;11.10.2017;2017;10;20;Keskiviikko;20;13;33;17;13;30
292;11.10.2017;2017;10;21;Keskiviikko;10;5;15;0;6;6
292;11.10.2017;2017;10;22;Keskiviikko;5;1;6;1;1;2
292;11.10.2017;2017;10;23;Keskiviikko;0;0;0;1;0;1
292;12.10.2017;2017;10;00;Torstai;2;0;2;0;1;1
292;12.10.2017;2017;10;01;Torstai;0;0;0;0;0;0
292;12.10.2017;2017;10;02;Torstai;1;1;2;0;0;0
292;12.10.2017;2017;10;03;Torstai;0;0;0;0;0;0
292;12.10.2017;2017;10;04;Torstai;2;1;3;0;0;0
292;12.10.2017;2017;10;05;Torstai;6;4;10;0;1;1
292;12.10.2017;2017;10;06;Torstai;19;15;34;2;6;8
292;12.10.2017;2017;10;07;Torstai;69;25;94;7;15;22
292;12.10.2017;2017;10;08;Torstai;50;22;72;15;18;33
292;12.10.2017;2017;10;09;Torstai;81;26;107;6;14;20
292;12.10.2017;2017;10;10;Torstai;28;17;45;7;10;17
292;12.10.2017;2017;10;11;Torstai;28;23;51;13;2;15
292;12.10.2017;2017;10;12;Torstai;24;18;42;4;10;14
292;12.10.2017;2017;10;13;Torstai;35;44;79;8;14;22
292;12.10.2017;2017;10;14;Torstai;37;53;90;13;14;27
292;12.10.2017;2017;10;15;Torstai;50;72;122;6;22;28
292;12.10.2017;2017;10;16;Torstai;42;56;98;11;15;26
292;12.10.2017;2017;10;17;Torstai;33;21;54;13;11;24
292;12.10.2017;2017;10;18;Torstai;33;22;55;10;27;37
292;12.10.2017;2017;10;19;Torstai;24;18;42;11;13;24
292;12.10.2017;2017;10;20;Torstai;13;13;26;9;3;12
292;12.10.2017;2017;10;21;Torstai;5;7;12;0;7;7
292;12.10.2017;2017;10;22;Torstai;8;2;10;2;1;3
292;12.10.2017;2017;10;23;Torstai;2;0;2;0;1;1
292;13.10.2017;2017;10;00;Perjantai;0;1;1;0;1;1
292;13.10.2017;2017;10;01;Perjantai;1;0;1;0;1;1
292;13.10.2017;2017;10;02;Perjantai;1;0;1;0;0;0
292;13.10.2017;2017;10;03;Perjantai;0;0;0;0;0;0
292;13.10.2017;2017;10;04;Perjantai;0;0;0;0;0;0
292;13.10.2017;2017;10;05;Perjantai;5;3;8;4;3;7
292;13.10.2017;2017;10;06;Perjantai;15;9;24;1;7;8
292;13.10.2017;2017;10;07;Perjantai;78;29;107;5;11;16
292;13.10.2017;2017;10;08;Perjantai;62;24;86;14;13;27
292;13.10.2017;2017;10;09;Perjantai;42;20;62;8;13;21
292;13.10.2017;2017;10;10;Perjantai;23;22;45;7;10;17
292;13.10.2017;2017;10;11;Perjantai;21;31;52;6;15;21
292;13.10.2017;2017;10;12;Perjantai;36;36;72;11;13;24
292;13.10.2017;2017;10;13;Perjantai;40;95;135;10;19;29
292;13.10.2017;2017;10;14;Perjantai;40;58;98;11;14;25
292;13.10.2017;2017;10;15;Perjantai;32;40;72;12;13;25
292;13.10.2017;2017;10;16;Perjantai;37;33;70;8;7;15
292;13.10.2017;2017;10;17;Perjantai;41;34;75;17;13;30
292;13.10.2017;2017;10;18;Perjantai;33;27;60;15;15;30
292;13.10.2017;2017;10;19;Perjantai;32;32;64;13;13;26
292;13.10.2017;2017;10;20;Perjantai;21;7;28;9;12;21
292;13.10.2017;2017;10;21;Perjantai;16;14;30;3;9;12
292;13.10.2017;2017;10;22;Perjantai;13;11;24;5;8;13
292;13.10.2017;2017;10;23;Perjantai;3;4;7;2;4;6
292;14.10.2017;2017;10;00;Lauantai;3;4;7;6;1;7
292;14.10.2017;2017;10;01;Lauantai;2;1;3;1;0;1
292;14.10.2017;2017;10;02;Lauantai;1;2;3;0;3;3
292;14.10.2017;2017;10;03;Lauantai;1;5;6;1;3;4
292;14.10.2017;2017;10;04;Lauantai;1;0;1;0;1;1
292;14.10.2017;2017;10;05;Lauantai;0;1;1;1;6;7
292;14.10.2017;2017;10;06;Lauantai;2;3;5;0;2;2
292;14.10.2017;2017;10;07;Lauantai;4;5;9;4;2;6
292;14.10.2017;2017;10;08;Lauantai;11;8;19;7;6;13
292;14.10.2017;2017;10;09;Lauantai;8;15;23;5;6;11
292;14.10.2017;2017;10;10;Lauantai;18;17;35;4;8;12
292;14.10.2017;2017;10;11;Lauantai;20;20;40;10;11;21
292;14.10.2017;2017;10;12;Lauantai;32;16;48;6;16;22
292;14.10.2017;2017;10;13;Lauantai;25;23;48;6;8;14
292;14.10.2017;2017;10;14;Lauantai;37;22;59;17;16;33
292;14.10.2017;2017;10;15;Lauantai;22;25;47;7;9;16
292;14.10.2017;2017;10;16;Lauantai;13;10;23;11;3;14
292;14.10.2017;2017;10;17;Lauantai;11;9;20;5;9;14
292;14.10.2017;2017;10;18;Lauantai;19;8;27;11;2;13
292;14.10.2017;2017;10;19;Lauantai;7;6;13;4;5;9
292;14.10.2017;2017;10;20;Lauantai;12;7;19;5;8;13
292;14.10.2017;2017;10;21;Lauantai;4;10;14;3;5;8
292;14.10.2017;2017;10;22;Lauantai;5;2;7;1;4;5
292;14.10.2017;2017;10;23;Lauantai;6;1;7;3;1;4
292;15.10.2017;2017;10;00;Sunnuntai;4;0;4;0;2;2
292;15.10.2017;2017;10;01;Sunnuntai;1;2;3;0;1;1
292;15.10.2017;2017;10;02;Sunnuntai;0;3;3;0;1;1
292;15.10.2017;2017;10;03;Sunnuntai;1;3;4;0;1;1
292;15.10.2017;2017;10;04;Sunnuntai;0;0;0;1;0;1
292;15.10.2017;2017;10;05;Sunnuntai;0;1;1;2;0;2
292;15.10.2017;2017;10;06;Sunnuntai;3;1;4;0;2;2
292;15.10.2017;2017;10;07;Sunnuntai;1;4;5;2;1;3
292;15.10.2017;2017;10;08;Sunnuntai;2;5;7;5;9;14
292;15.10.2017;2017;10;09;Sunnuntai;8;6;14;4;4;8
292;15.10.2017;2017;10;10;Sunnuntai;9;8;17;6;9;15
292;15.10.2017;2017;10;11;Sunnuntai;15;17;32;14;6;20
292;15.10.2017;2017;10;12;Sunnuntai;20;18;38;8;7;15
292;15.10.2017;2017;10;13;Sunnuntai;24;25;49;8;11;19
292;15.10.2017;2017;10;14;Sunnuntai;36;33;69;5;6;11
292;15.10.2017;2017;10;15;Sunnuntai;52;25;77;16;17;33
292;15.10.2017;2017;10;16;Sunnuntai;30;14;44;9;17;26
292;15.10.2017;2017;10;17;Sunnuntai;24;27;51;21;19;40
292;15.10.2017;2017;10;18;Sunnuntai;24;23;47;17;28;45
292;15.10.2017;2017;10;19;Sunnuntai;18;19;37;11;14;25
292;15.10.2017;2017;10;20;Sunnuntai;7;9;16;7;5;12
292;15.10.2017;2017;10;21;Sunnuntai;3;5;8;3;5;8
292;15.10.2017;2017;10;22;Sunnuntai;1;1;2;1;1;2
292;15.10.2017;2017;10;23;Sunnuntai;2;1;3;1;2;3
292;16.10.2017;2017;10;00;Maanantai;0;1;1;2;1;3
292;16.10.2017;2017;10;01;Maanantai;0;1;1;0;1;1
292;16.10.2017;2017;10;02;Maanantai;0;0;0;0;0;0
292;16.10.2017;2017;10;03;Maanantai;0;0;0;0;0;0
292;16.10.2017;2017;10;04;Maanantai;1;0;1;0;0;0
292;16.10.2017;2017;10;05;Maanantai;8;7;15;0;0;0
292;16.10.2017;2017;10;06;Maanantai;12;14;26;1;1;2
292;16.10.2017;2017;10;07;Maanantai;59;27;86;7;6;13
292;16.10.2017;2017;10;08;Maanantai;33;21;54;8;5;13
292;16.10.2017;2017;10;09;Maanantai;46;20;66;9;5;14
292;16.10.2017;2017;10;10;Maanantai;12;8;20;4;6;10
292;16.10.2017;2017;10;11;Maanantai;12;7;19;4;3;7
292;16.10.2017;2017;10;12;Maanantai;16;13;29;6;3;9
292;16.10.2017;2017;10;13;Maanantai;19;22;41;11;4;15
292;16.10.2017;2017;10;14;Maanantai;32;33;65;5;8;13
292;16.10.2017;2017;10;15;Maanantai;40;63;103;9;37;46
292;16.10.2017;2017;10;16;Maanantai;35;51;86;15;33;48
292;16.10.2017;2017;10;17;Maanantai;37;33;70;14;12;26
292;16.10.2017;2017;10;18;Maanantai;32;17;49;21;28;49
292;16.10.2017;2017;10;19;Maanantai;19;24;43;10;8;18
292;16.10.2017;2017;10;20;Maanantai;16;17;33;4;14;18
292;16.10.2017;2017;10;21;Maanantai;4;2;6;6;6;12
292;16.10.2017;2017;10;22;Maanantai;4;2;6;1;1;2
292;16.10.2017;2017;10;23;Maanantai;0;1;1;0;0;0
292;17.10.2017;2017;10;00;Tiistai;0;0;0;0;1;1
292;17.10.2017;2017;10;01;Tiistai;0;0;0;0;1;1
292;17.10.2017;2017;10;02;Tiistai;0;1;1;0;0;0
292;17.10.2017;2017;10;03;Tiistai;0;0;0;1;0;1
292;17.10.2017;2017;10;04;Tiistai;0;1;1;0;0;0
292;17.10.2017;2017;10;05;Tiistai;6;5;11;1;2;3
292;17.10.2017;2017;10;06;Tiistai;17;10;27;0;15;15
292;17.10.2017;2017;10;07;Tiistai;66;30;96;10;9;19
292;17.10.2017;2017;10;08;Tiistai;65;21;86;8;12;20
292;17.10.2017;2017;10;09;Tiistai;27;23;50;10;11;21
292;17.10.2017;2017;10;10;Tiistai;28;10;38;16;14;30
292;17.10.2017;2017;10;11;Tiistai;17;26;43;7;20;27
292;17.10.2017;2017;10;12;Tiistai;16;26;42;11;15;26
292;17.10.2017;2017;10;13;Tiistai;32;51;83;18;22;40
292;17.10.2017;2017;10;14;Tiistai;34;65;99;14;46;60
292;17.10.2017;2017;10;15;Tiistai;46;54;100;8;20;28
292;17.10.2017;2017;10;16;Tiistai;48;52;100;8;22;30
292;17.10.2017;2017;10;17;Tiistai;35;30;65;10;16;26
292;17.10.2017;2017;10;18;Tiistai;26;30;56;15;20;35
292;17.10.2017;2017;10;19;Tiistai;23;14;37;10;15;25
292;17.10.2017;2017;10;20;Tiistai;17;6;23;5;4;9
292;17.10.2017;2017;10;21;Tiistai;6;6;12;4;0;4
292;17.10.2017;2017;10;22;Tiistai;2;0;2;1;0;1
292;17.10.2017;2017;10;23;Tiistai;1;1;2;0;0;0
292;18.10.2017;2017;10;00;Keskiviikko;1;0;1;0;0;0
292;18.10.2017;2017;10;01;Keskiviikko;1;2;3;0;1;1
292;18.10.2017;2017;10;02;Keskiviikko;1;0;1;0;0;0
292;18.10.2017;2017;10;03;Keskiviikko;0;0;0;0;0;0
292;18.10.2017;2017;10;04;Keskiviikko;1;0;1;0;0;0
292;18.10.2017;2017;10;05;Keskiviikko;6;4;10;0;1;1
292;18.10.2017;2017;10;06;Keskiviikko;13;14;27;0;3;3
292;18.10.2017;2017;10;07;Keskiviikko;76;37;113;5;2;7
292;18.10.2017;2017;10;08;Keskiviikko;59;30;89;5;7;12
292;18.10.2017;2017;10;09;Keskiviikko;30;13;43;7;7;14
292;18.10.2017;2017;10;10;Keskiviikko;20;12;32;7;10;17
292;18.10.2017;2017;10;11;Keskiviikko;18;15;33;7;8;15
292;18.10.2017;2017;10;12;Keskiviikko;16;16;32;7;4;11
292;18.10.2017;2017;10;13;Keskiviikko;28;45;73;15;23;38
292;18.10.2017;2017;10;14;Keskiviikko;31;64;95;7;20;27
292;18.10.2017;2017;10;15;Keskiviikko;42;48;90;6;7;13
292;18.10.2017;2017;10;16;Keskiviikko;42;44;86;5;15;20
292;18.10.2017;2017;10;17;Keskiviikko;24;21;45;15;18;33
292;18.10.2017;2017;10;18;Keskiviikko;24;26;50;10;21;31
292;18.10.2017;2017;10;19;Keskiviikko;22;18;40;13;15;28
292;18.10.2017;2017;10;20;Keskiviikko;23;8;31;7;6;13
292;18.10.2017;2017;10;21;Keskiviikko;8;5;13;2;6;8
292;18.10.2017;2017;10;22;Keskiviikko;2;1;3;0;3;3
292;18.10.2017;2017;10;23;Keskiviikko;0;0;0;0;0;0
292;19.10.2017;2017;10;00;Torstai;1;0;1;0;0;0
292;19.10.2017;2017;10;01;Torstai;0;0;0;0;0;0
292;19.10.2017;2017;10;02;Torstai;0;0;0;0;0;0
292;19.10.2017;2017;10;03;Torstai;0;0;0;0;0;0
292;19.10.2017;2017;10;04;Torstai;1;0;1;0;0;0
292;19.10.2017;2017;10;05;Torstai;6;7;13;1;0;1
292;19.10.2017;2017;10;06;Torstai;12;10;22;0;4;4
292;19.10.2017;2017;10;07;Torstai;69;34;103;4;12;16
292;19.10.2017;2017;10;08;Torstai;47;24;71;5;10;15
292;19.10.2017;2017;10;09;Torstai;59;26;85;10;5;15
292;19.10.2017;2017;10;10;Torstai;20;13;33;7;2;9
292;19.10.2017;2017;10;11;Torstai;31;25;56;3;6;9
292;19.10.2017;2017;10;12;Torstai;30;31;61;6;7;13
292;19.10.2017;2017;10;13;Torstai;23;22;45;11;16;27
292;19.10.2017;2017;10;14;Torstai;35;43;78;10;30;40
292;19.10.2017;2017;10;15;Torstai;53;66;119;19;28;47
292;19.10.2017;2017;10;16;Torstai;39;72;111;7;21;28
292;19.10.2017;2017;10;17;Torstai;27;36;63;14;24;38
292;19.10.2017;2017;10;18;Torstai;45;33;78;18;25;43
292;19.10.2017;2017;10;19;Torstai;24;14;38;8;10;18
292;19.10.2017;2017;10;20;Torstai;15;19;34;11;14;25
292;19.10.2017;2017;10;21;Torstai;10;5;15;2;7;9
292;19.10.2017;2017;10;22;Torstai;1;2;3;0;1;1
292;19.10.2017;2017;10;23;Torstai;1;0;1;0;1;1
292;20.10.2017;2017;10;00;Perjantai;0;1;1;0;1;1
292;20.10.2017;2017;10;01;Perjantai;0;0;0;0;0;0
292;20.10.2017;2017;10;02;Perjantai;0;0;0;0;0;0
292;20.10.2017;2017;10;03;Perjantai;0;0;0;0;0;0
292;20.10.2017;2017;10;04;Perjantai;0;0;0;0;0;0
292;20.10.2017;2017;10;05;Perjantai;4;6;10;0;2;2
292;20.10.2017;2017;10;06;Perjantai;10;14;24;0;2;2
292;20.10.2017;2017;10;07;Perjantai;78;28;106;9;12;21
292;20.10.2017;2017;10;08;Perjantai;43;19;62;7;8;15
292;20.10.2017;2017;10;09;Perjantai;32;5;37;10;8;18
292;20.10.2017;2017;10;10;Perjantai;9;12;21;3;3;6
292;20.10.2017;2017;10;11;Perjantai;6;7;13;6;14;20
292;20.10.2017;2017;10;12;Perjantai;28;29;57;8;11;19
292;20.10.2017;2017;10;13;Perjantai;24;60;84;9;34;43
292;20.10.2017;2017;10;14;Perjantai;29;34;63;15;22;37
292;20.10.2017;2017;10;15;Perjantai;37;25;62;10;13;23
292;20.10.2017;2017;10;16;Perjantai;34;30;64;15;20;35
292;20.10.2017;2017;10;17;Perjantai;20;15;35;5;16;21
292;20.10.2017;2017;10;18;Perjantai;9;20;29;10;8;18
292;20.10.2017;2017;10;19;Perjantai;21;19;40;18;16;34
292;20.10.2017;2017;10;20;Perjantai;17;4;21;11;8;19
292;20.10.2017;2017;10;21;Perjantai;10;8;18;3;11;14
292;20.10.2017;2017;10;22;Perjantai;7;2;9;5;2;7
292;20.10.2017;2017;10;23;Perjantai;4;2;6;7;0;7
292;21.10.2017;2017;10;00;Lauantai;1;7;8;5;4;9
292;21.10.2017;2017;10;01;Lauantai;0;2;2;0;1;1
292;21.10.2017;2017;10;02;Lauantai;1;0;1;2;1;3
292;21.10.2017;2017;10;03;Lauantai;1;3;4;0;4;4
292;21.10.2017;2017;10;04;Lauantai;1;0;1;1;1;2
292;21.10.2017;2017;10;05;Lauantai;2;1;3;0;0;0
292;21.10.2017;2017;10;06;Lauantai;4;0;4;1;2;3
292;21.10.2017;2017;10;07;Lauantai;2;2;4;3;1;4
292;21.10.2017;2017;10;08;Lauantai;1;5;6;4;7;11
292;21.10.2017;2017;10;09;Lauantai;11;6;17;7;9;16
292;21.10.2017;2017;10;10;Lauantai;8;8;16;11;12;23
292;21.10.2017;2017;10;11;Lauantai;11;10;21;6;9;15
292;21.10.2017;2017;10;12;Lauantai;10;26;36;9;16;25
292;21.10.2017;2017;10;13;Lauantai;17;10;27;7;14;21
292;21.10.2017;2017;10;14;Lauantai;22;21;43;11;23;34
292;21.10.2017;2017;10;15;Lauantai;31;18;49;21;12;33
292;21.10.2017;2017;10;16;Lauantai;21;14;35;13;8;21
292;21.10.2017;2017;10;17;Lauantai;17;11;28;11;13;24
292;21.10.2017;2017;10;18;Lauantai;13;12;25;10;15;25
292;21.10.2017;2017;10;19;Lauantai;14;7;21;15;13;28
292;21.10.2017;2017;10;20;Lauantai;10;12;22;17;20;37
292;21.10.2017;2017;10;21;Lauantai;10;5;15;12;10;22
292;21.10.2017;2017;10;22;Lauantai;11;4;15;18;3;21
292;21.10.2017;2017;10;23;Lauantai;3;6;9;10;3;13
292;22.10.2017;2017;10;00;Sunnuntai;3;5;8;2;7;9
292;22.10.2017;2017;10;01;Sunnuntai;2;1;3;1;0;1
292;22.10.2017;2017;10;02;Sunnuntai;1;0;1;0;4;4
292;22.10.2017;2017;10;03;Sunnuntai;0;4;4;1;3;4
292;22.10.2017;2017;10;04;Sunnuntai;1;0;1;1;0;1
292;22.10.2017;2017;10;05;Sunnuntai;0;0;0;1;0;1
292;22.10.2017;2017;10;06;Sunnuntai;5;2;7;2;2;4
292;22.10.2017;2017;10;07;Sunnuntai;1;1;2;5;3;8
292;22.10.2017;2017;10;08;Sunnuntai;5;3;8;8;5;13
292;22.10.2017;2017;10;09;Sunnuntai;10;8;18;5;13;18
292;22.10.2017;2017;10;10;Sunnuntai;10;6;16;9;17;26
292;22.10.2017;2017;10;11;Sunnuntai;11;7;18;19;12;31
292;22.10.2017;2017;10;12;Sunnuntai;16;19;35;12;26;38
292;22.10.2017;2017;10;13;Sunnuntai;13;22;35;14;12;26
292;22.10.2017;2017;10;14;Sunnuntai;25;16;41;14;12;26
292;22.10.2017;2017;10;15;Sunnuntai;20;16;36;10;13;23
292;22.10.2017;2017;10;16;Sunnuntai;28;13;41;13;15;28
292;22.10.2017;2017;10;17;Sunnuntai;20;16;36;15;23;38
292;22.10.2017;2017;10;18;Sunnuntai;20;12;32;15;17;32
292;22.10.2017;2017;10;19;Sunnuntai;11;12;23;34;24;58
292;22.10.2017;2017;10;20;Sunnuntai;12;15;27;12;11;23
292;22.10.2017;2017;10;21;Sunnuntai;9;10;19;3;4;7
292;22.10.2017;2017;10;22;Sunnuntai;1;3;4;4;7;11
292;22.10.2017;2017;10;23;Sunnuntai;1;0;1;0;0;0
292;23.10.2017;2017;10;00;Maanantai;0;1;1;0;0;0
292;23.10.2017;2017;10;01;Maanantai;0;1;1;2;1;3
292;23.10.2017;2017;10;02;Maanantai;1;0;1;1;1;2
292;23.10.2017;2017;10;03;Maanantai;1;0;1;0;1;1
292;23.10.2017;2017;10;04;Maanantai;2;0;2;0;0;0
292;23.10.2017;2017;10;05;Maanantai;4;1;5;0;0;0
292;23.10.2017;2017;10;06;Maanantai;13;11;24;2;11;13
292;23.10.2017;2017;10;07;Maanantai;18;15;33;4;9;13
292;23.10.2017;2017;10;08;Maanantai;13;10;23;8;8;16
292;23.10.2017;2017;10;09;Maanantai;11;4;15;8;11;19
292;23.10.2017;2017;10;10;Maanantai;14;16;30;9;11;20
292;23.10.2017;2017;10;11;Maanantai;17;15;32;14;27;41
292;23.10.2017;2017;10;12;Maanantai;28;13;41;15;19;34
292;23.10.2017;2017;10;13;Maanantai;21;29;50;12;17;29
292;23.10.2017;2017;10;14;Maanantai;21;16;37;19;18;37
292;23.10.2017;2017;10;15;Maanantai;37;18;55;12;14;26
292;23.10.2017;2017;10;16;Maanantai;28;32;60;18;22;40
292;23.10.2017;2017;10;17;Maanantai;22;13;35;11;11;22
292;23.10.2017;2017;10;18;Maanantai;8;17;25;13;16;29
292;23.10.2017;2017;10;19;Maanantai;11;11;22;17;12;29
292;23.10.2017;2017;10;20;Maanantai;10;7;17;5;5;10
292;23.10.2017;2017;10;21;Maanantai;5;5;10;9;2;11
292;23.10.2017;2017;10;22;Maanantai;2;1;3;3;3;6
292;23.10.2017;2017;10;23;Maanantai;1;0;1;0;0;0
292;24.10.2017;2017;10;00;Tiistai;1;0;1;0;0;0
292;24.10.2017;2017;10;01;Tiistai;0;0;0;1;1;2
292;24.10.2017;2017;10;02;Tiistai;0;2;2;0;0;0
292;24.10.2017;2017;10;03;Tiistai;0;0;0;1;0;1
292;24.10.2017;2017;10;04;Tiistai;1;1;2;0;0;0
292;24.10.2017;2017;10;05;Tiistai;3;3;6;1;0;1
292;24.10.2017;2017;10;06;Tiistai;11;10;21;1;5;6
292;24.10.2017;2017;10;07;Tiistai;20;11;31;7;6;13
292;24.10.2017;2017;10;08;Tiistai;12;10;22;5;14;19
292;24.10.2017;2017;10;09;Tiistai;9;6;15;11;20;31
292;24.10.2017;2017;10;10;Tiistai;13;12;25;4;12;16
292;24.10.2017;2017;10;11;Tiistai;19;13;32;7;6;13
292;24.10.2017;2017;10;12;Tiistai;25;20;45;19;12;31
292;24.10.2017;2017;10;13;Tiistai;17;10;27;9;16;25
292;24.10.2017;2017;10;14;Tiistai;37;24;61;15;11;26
292;24.10.2017;2017;10;15;Tiistai;27;20;47;7;16;23
292;24.10.2017;2017;10;16;Tiistai;26;17;43;12;10;22
292;24.10.2017;2017;10;17;Tiistai;25;17;42;14;8;22
292;24.10.2017;2017;10;18;Tiistai;22;10;32;10;10;20
292;24.10.2017;2017;10;19;Tiistai;6;5;11;7;10;17
292;24.10.2017;2017;10;20;Tiistai;9;6;15;9;6;15
292;24.10.2017;2017;10;21;Tiistai;5;3;8;6;5;11
292;24.10.2017;2017;10;22;Tiistai;3;4;7;2;0;2
292;24.10.2017;2017;10;23;Tiistai;2;0;2;2;1;3
292;25.10.2017;2017;10;00;Keskiviikko;1;1;2;1;2;3
292;25.10.2017;2017;10;01;Keskiviikko;2;1;3;1;2;3
292;25.10.2017;2017;10;02;Keskiviikko;0;1;1;0;0;0
292;25.10.2017;2017;10;03;Keskiviikko;0;0;0;0;0;0
292;25.10.2017;2017;10;04;Keskiviikko;5;0;5;0;0;0
292;25.10.2017;2017;10;05;Keskiviikko;3;3;6;0;1;1
292;25.10.2017;2017;10;06;Keskiviikko;13;11;24;2;3;5
292;25.10.2017;2017;10;07;Keskiviikko;23;12;35;1;9;10
292;25.10.2017;2017;10;08;Keskiviikko;13;9;22;10;19;29
292;25.10.2017;2017;10;09;Keskiviikko;12;10;22;9;10;19
292;25.10.2017;2017;10;10;Keskiviikko;21;12;33;7;8;15
292;25.10.2017;2017;10;11;Keskiviikko;14;7;21;6;17;23
292;25.10.2017;2017;10;12;Keskiviikko;19;17;36;13;14;27
292;25.10.2017;2017;10;13;Keskiviikko;19;19;38;16;13;29
292;25.10.2017;2017;10;14;Keskiviikko;24;12;36;10;15;25
292;25.10.2017;2017;10;15;Keskiviikko;30;18;48;19;9;28
292;25.10.2017;2017;10;16;Keskiviikko;28;24;52;8;29;37
292;25.10.2017;2017;10;17;Keskiviikko;18;15;33;10;23;33
292;25.10.2017;2017;10;18;Keskiviikko;13;9;22;9;17;26
292;25.10.2017;2017;10;19;Keskiviikko;17;10;27;8;10;18
292;25.10.2017;2017;10;20;Keskiviikko;11;5;16;3;6;9
292;25.10.2017;2017;10;21;Keskiviikko;10;3;13;6;7;13
292;25.10.2017;2017;10;22;Keskiviikko;3;4;7;2;1;3
292;25.10.2017;2017;10;23;Keskiviikko;6;3;9;1;1;2
292;26.10.2017;2017;10;00;Torstai;0;1;1;2;1;3
292;26.10.2017;2017;10;01;Torstai;1;2;3;0;0;0
292;26.10.2017;2017;10;02;Torstai;1;0;1;0;0;0
292;26.10.2017;2017;10;03;Torstai;0;0;0;0;0;0
292;26.10.2017;2017;10;04;Torstai;3;0;3;0;0;0
292;26.10.2017;2017;10;05;Torstai;4;1;5;1;3;4
292;26.10.2017;2017;10;06;Torstai;13;6;19;2;8;10
292;26.10.2017;2017;10;07;Torstai;20;11;31;1;9;10
292;26.10.2017;2017;10;08;Torstai;18;12;30;12;6;18
292;26.10.2017;2017;10;09;Torstai;9;11;20;5;13;18
292;26.10.2017;2017;10;10;Torstai;10;8;18;8;13;21
292;26.10.2017;2017;10;11;Torstai;15;11;26;10;16;26
292;26.10.2017;2017;10;12;Torstai;21;16;37;7;14;21
292;26.10.2017;2017;10;13;Torstai;21;10;31;8;15;23
292;26.10.2017;2017;10;14;Torstai;32;22;54;9;13;22
292;26.10.2017;2017;10;15;Torstai;32;15;47;4;16;20
292;26.10.2017;2017;10;16;Torstai;33;21;54;9;27;36
292;26.10.2017;2017;10;17;Torstai;16;16;32;6;19;25
292;26.10.2017;2017;10;18;Torstai;13;11;24;11;17;28
292;26.10.2017;2017;10;19;Torstai;13;10;23;9;18;27
292;26.10.2017;2017;10;20;Torstai;14;5;19;7;7;14
292;26.10.2017;2017;10;21;Torstai;4;7;11;6;1;7
292;26.10.2017;2017;10;22;Torstai;7;0;7;0;3;3
292;26.10.2017;2017;10;23;Torstai;2;0;2;0;0;0
292;27.10.2017;2017;10;00;Perjantai;0;0;0;0;0;0
292;27.10.2017;2017;10;01;Perjantai;0;1;1;0;1;1
292;27.10.2017;2017;10;02;Perjantai;0;0;0;0;0;0
292;27.10.2017;2017;10;03;Perjantai;0;0;0;0;0;0
292;27.10.2017;2017;10;04;Perjantai;1;1;2;0;0;0
292;27.10.2017;2017;10;05;Perjantai;2;1;3;1;1;2
292;27.10.2017;2017;10;06;Perjantai;10;6;16;1;6;7
292;27.10.2017;2017;10;07;Perjantai;21;11;32;6;5;11
292;27.10.2017;2017;10;08;Perjantai;9;12;21;10;13;23
292;27.10.2017;2017;10;09;Perjantai;17;10;27;6;8;14
292;27.10.2017;2017;10;10;Perjantai;13;8;21;4;12;16
292;27.10.2017;2017;10;11;Perjantai;13;15;28;6;13;19
292;27.10.2017;2017;10;12;Perjantai;23;14;37;15;11;26
292;27.10.2017;2017;10;13;Perjantai;22;16;38;13;9;22
292;27.10.2017;2017;10;14;Perjantai;33;17;50;12;21;33
292;27.10.2017;2017;10;15;Perjantai;24;14;38;24;13;37
292;27.10.2017;2017;10;16;Perjantai;23;23;46;10;16;26
292;27.10.2017;2017;10;17;Perjantai;24;14;38;12;20;32
292;27.10.2017;2017;10;18;Perjantai;22;9;31;15;21;36
292;27.10.2017;2017;10;19;Perjantai;16;13;29;3;8;11
292;27.10.2017;2017;10;20;Perjantai;13;6;19;6;8;14
292;27.10.2017;2017;10;21;Perjantai;5;8;13;5;4;9
292;27.10.2017;2017;10;22;Perjantai;5;3;8;5;7;12
292;27.10.2017;2017;10;23;Perjantai;0;0;0;3;0;3
292;28.10.2017;2017;10;00;Lauantai;1;0;1;5;0;5
292;28.10.2017;2017;10;01;Lauantai;2;3;5;2;1;3
292;28.10.2017;2017;10;02;Lauantai;1;0;1;0;1;1
292;28.10.2017;2017;10;03;Lauantai;1;0;1;0;3;3
292;28.10.2017;2017;10;04;Lauantai;1;0;1;1;0;1
292;28.10.2017;2017;10;05;Lauantai;0;1;1;1;0;1
292;28.10.2017;2017;10;06;Lauantai;3;1;4;0;1;1
292;28.10.2017;2017;10;07;Lauantai;1;2;3;1;2;3
292;28.10.2017;2017;10;08;Lauantai;4;5;9;5;4;9
292;28.10.2017;2017;10;09;Lauantai;7;6;13;2;4;6
292;28.10.2017;2017;10;10;Lauantai;8;10;18;4;8;12
292;28.10.2017;2017;10;11;Lauantai;12;12;24;9;5;14
292;28.10.2017;2017;10;12;Lauantai;11;10;21;2;5;7
292;28.10.2017;2017;10;13;Lauantai;11;14;25;4;6;10
292;28.10.2017;2017;10;14;Lauantai;3;8;11;2;4;6
292;28.10.2017;2017;10;15;Lauantai;11;12;23;4;3;7
292;28.10.2017;2017;10;16;Lauantai;9;3;12;10;5;15
292;28.10.2017;2017;10;17;Lauantai;15;8;23;7;6;13
292;28.10.2017;2017;10;18;Lauantai;12;4;16;14;9;23
292;28.10.2017;2017;10;19;Lauantai;6;4;10;1;4;5
292;28.10.2017;2017;10;20;Lauantai;10;4;14;1;3;4
292;28.10.2017;2017;10;21;Lauantai;3;0;3;5;1;6
292;28.10.2017;2017;10;22;Lauantai;3;3;6;3;1;4
292;28.10.2017;2017;10;23;Lauantai;1;2;3;0;0;0
292;29.10.2017;2017;10;00;Sunnuntai;4;0;4;3;1;4
292;29.10.2017;2017;10;01;Sunnuntai;0;0;0;1;5;6
292;29.10.2017;2017;10;02;Sunnuntai;1;0;1;0;1;1
292;29.10.2017;2017;10;03;Sunnuntai;1;2;3;0;1;1
292;29.10.2017;2017;10;04;Sunnuntai;0;0;0;0;0;0
292;29.10.2017;2017;10;05;Sunnuntai;1;0;1;1;0;1
292;29.10.2017;2017;10;06;Sunnuntai;2;0;2;2;4;6
292;29.10.2017;2017;10;07;Sunnuntai;1;1;2;0;1;1
292;29.10.2017;2017;10;08;Sunnuntai;4;4;8;11;6;17
292;29.10.2017;2017;10;09;Sunnuntai;2;2;4;7;4;11
292;29.10.2017;2017;10;10;Sunnuntai;2;6;8;7;10;17
292;29.10.2017;2017;10;11;Sunnuntai;6;3;9;10;7;17
292;29.10.2017;2017;10;12;Sunnuntai;11;4;15;12;12;24
292;29.10.2017;2017;10;13;Sunnuntai;6;7;13;5;11;16
292;29.10.2017;2017;10;14;Sunnuntai;18;12;30;6;7;13
292;29.10.2017;2017;10;15;Sunnuntai;10;6;16;10;7;17
292;29.10.2017;2017;10;16;Sunnuntai;2;2;4;9;7;16
292;29.10.2017;2017;10;17;Sunnuntai;3;6;9;16;8;24
292;29.10.2017;2017;10;18;Sunnuntai;3;7;10;15;11;26
292;29.10.2017;2017;10;19;Sunnuntai;3;4;7;6;5;11
292;29.10.2017;2017;10;20;Sunnuntai;5;4;9;5;6;11
292;29.10.2017;2017;10;21;Sunnuntai;2;0;2;3;7;10
292;29.10.2017;2017;10;22;Sunnuntai;1;4;5;0;0;0
292;29.10.2017;2017;10;23;Sunnuntai;1;0;1;0;0;0
292;30.10.2017;2017;10;00;Maanantai;0;0;0;1;0;1
292;30.10.2017;2017;10;01;Maanantai;0;1;1;0;1;1
292;30.10.2017;2017;10;02;Maanantai;0;0;0;0;0;0
292;30.10.2017;2017;10;03;Maanantai;0;0;0;0;0;0
292;30.10.2017;2017;10;04;Maanantai;1;1;2;1;0;1
292;30.10.2017;2017;10;05;Maanantai;5;3;8;2;0;2
292;30.10.2017;2017;10;06;Maanantai;12;9;21;9;6;15
292;30.10.2017;2017;10;07;Maanantai;24;20;44;39;10;49
292;30.10.2017;2017;10;08;Maanantai;15;12;27;36;9;45
292;30.10.2017;2017;10;09;Maanantai;51;10;61;22;12;34
292;30.10.2017;2017;10;10;Maanantai;11;11;22;15;13;28
292;30.10.2017;2017;10;11;Maanantai;11;16;27;14;13;27
292;30.10.2017;2017;10;12;Maanantai;10;15;25;19;12;31
292;30.10.2017;2017;10;13;Maanantai;14;37;51;20;16;36
292;30.10.2017;2017;10;14;Maanantai;17;41;58;22;11;33
292;30.10.2017;2017;10;15;Maanantai;18;44;62;27;33;60
292;30.10.2017;2017;10;16;Maanantai;24;43;67;22;17;39
292;30.10.2017;2017;10;17;Maanantai;16;18;34;8;14;22
292;30.10.2017;2017;10;18;Maanantai;13;19;32;19;19;38
292;30.10.2017;2017;10;19;Maanantai;10;9;19;8;10;18
292;30.10.2017;2017;10;20;Maanantai;18;7;25;7;8;15
292;30.10.2017;2017;10;21;Maanantai;1;8;9;7;1;8
292;30.10.2017;2017;10;22;Maanantai;1;1;2;0;1;1
292;30.10.2017;2017;10;23;Maanantai;0;0;0;0;0;0
292;31.10.2017;2017;10;00;Tiistai;0;0;0;0;0;0
292;31.10.2017;2017;10;01;Tiistai;0;0;0;0;0;0
292;31.10.2017;2017;10;02;Tiistai;0;0;0;0;0;0
292;31.10.2017;2017;10;03;Tiistai;0;0;0;0;1;1
292;31.10.2017;2017;10;04;Tiistai;1;0;1;0;0;0
292;31.10.2017;2017;10;05;Tiistai;10;3;13;0;1;1
292;31.10.2017;2017;10;06;Tiistai;13;15;28;3;7;10
292;31.10.2017;2017;10;07;Tiistai;60;28;88;13;12;25
292;31.10.2017;2017;10;08;Tiistai;49;24;73;28;13;41
292;31.10.2017;2017;10;09;Tiistai;17;15;32;10;14;24
292;31.10.2017;2017;10;10;Tiistai;18;11;29;10;12;22
292;31.10.2017;2017;10;11;Tiistai;7;8;15;16;15;31
292;31.10.2017;2017;10;12;Tiistai;15;12;27;14;11;25
292;31.10.2017;2017;10;13;Tiistai;19;25;44;16;17;33
292;31.10.2017;2017;10;14;Tiistai;25;54;79;19;33;52
292;31.10.2017;2017;10;15;Tiistai;30;41;71;15;20;35
292;31.10.2017;2017;10;16;Tiistai;25;38;63;18;20;38
292;31.10.2017;2017;10;17;Tiistai;19;18;37;22;13;35
292;31.10.2017;2017;10;18;Tiistai;13;15;28;16;21;37
292;31.10.2017;2017;10;19;Tiistai;9;12;21;14;18;32
292;31.10.2017;2017;10;20;Tiistai;15;4;19;5;6;11
292;31.10.2017;2017;10;21;Tiistai;3;3;6;5;4;9
292;31.10.2017;2017;10;22;Tiistai;1;2;3;2;0;2
292;31.10.2017;2017;10;23;Tiistai;0;0;0;1;0;1
292;01.11.2017;2017;11;00;Keskiviikko;0;0;0;0;0;0
292;01.11.2017;2017;11;01;Keskiviikko;0;1;1;0;0;0
292;01.11.2017;2017;11;02;Keskiviikko;0;0;0;0;0;0
292;01.11.2017;2017;11;03;Keskiviikko;0;0;0;0;0;0
292;01.11.2017;2017;11;04;Keskiviikko;2;1;3;0;0;0
292;01.11.2017;2017;11;05;Keskiviikko;5;4;9;0;1;1
292;01.11.2017;2017;11;06;Keskiviikko;11;20;31;1;3;4
292;01.11.2017;2017;11;07;Keskiviikko;37;23;60;15;13;28
292;01.11.2017;2017;11;08;Keskiviikko;44;15;59;20;11;31
292;01.11.2017;2017;11;09;Keskiviikko;20;8;28;20;7;27
292;01.11.2017;2017;11;10;Keskiviikko;11;9;20;14;10;24
292;01.11.2017;2017;11;11;Keskiviikko;7;10;17;7;8;15
292;01.11.2017;2017;11;12;Keskiviikko;14;18;32;14;16;30
292;01.11.2017;2017;11;13;Keskiviikko;16;21;37;11;21;32
292;01.11.2017;2017;11;14;Keskiviikko;21;55;76;20;21;41
292;01.11.2017;2017;11;15;Keskiviikko;19;29;48;23;23;46
292;01.11.2017;2017;11;16;Keskiviikko;23;32;55;16;15;31
292;01.11.2017;2017;11;17;Keskiviikko;12;28;40;14;18;32
292;01.11.2017;2017;11;18;Keskiviikko;14;15;29;12;17;29
292;01.11.2017;2017;11;19;Keskiviikko;8;7;15;22;9;31
292;01.11.2017;2017;11;20;Keskiviikko;10;4;14;11;14;25
292;01.11.2017;2017;11;21;Keskiviikko;8;0;8;2;2;4
292;01.11.2017;2017;11;22;Keskiviikko;1;1;2;1;0;1
292;01.11.2017;2017;11;23;Keskiviikko;1;2;3;0;1;1
292;02.11.2017;2017;11;00;Torstai;0;1;1;2;1;3
292;02.11.2017;2017;11;01;Torstai;1;3;4;0;0;0
292;02.11.2017;2017;11;02;Torstai;1;0;1;0;0;0
292;02.11.2017;2017;11;03;Torstai;0;0;0;0;0;0
292;02.11.2017;2017;11;04;Torstai;4;0;4;0;0;0
292;02.11.2017;2017;11;05;Torstai;5;1;6;1;4;5
292;02.11.2017;2017;11;06;Torstai;16;8;24;2;10;12
292;02.11.2017;2017;11;07;Torstai;25;14;39;1;10;11
292;02.11.2017;2017;11;08;Torstai;23;15;38;13;7;20
292;02.11.2017;2017;11;09;Torstai;11;14;25;6;15;21
292;02.11.2017;2017;11;10;Torstai;13;10;23;10;15;25
292;02.11.2017;2017;11;11;Torstai;19;14;33;11;18;29
292;02.11.2017;2017;11;12;Torstai;26;20;46;8;16;24
292;02.11.2017;2017;11;13;Torstai;26;13;39;10;17;27
292;02.11.2017;2017;11;14;Torstai;40;28;68;10;15;25
292;02.11.2017;2017;11;15;Torstai;40;19;59;5;18;23
292;02.11.2017;2017;11;16;Torstai;41;26;67;10;30;40
292;02.11.2017;2017;11;17;Torstai;20;20;40;7;22;29
292;02.11.2017;2017;11;18;Torstai;16;14;30;12;19;31
292;02.11.2017;2017;11;19;Torstai;16;13;29;10;21;31
292;02.11.2017;2017;11;20;Torstai;18;6;24;8;8;16
292;02.11.2017;2017;11;21;Torstai;5;9;14;7;1;8
292;02.11.2017;2017;11;22;Torstai;9;0;9;0;4;4
292;02.11.2017;2017;11;23;Torstai;3;0;3;0;0;0
292;03.11.2017;2017;11;00;Perjantai;0;0;0;1;0;1
292;03.11.2017;2017;11;01;Perjantai;0;1;1;0;0;0
292;03.11.2017;2017;11;02;Perjantai;1;1;2;0;0;0
292;03.11.2017;2017;11;03;Perjantai;1;0;1;0;0;0
292;03.11.2017;2017;11;04;Perjantai;1;1;2;0;0;0
292;03.11.2017;2017;11;05;Perjantai;8;5;13;1;6;7
292;03.11.2017;2017;11;06;Perjantai;9;5;14;1;11;12
292;03.11.2017;2017;11;07;Perjantai;40;26;66;11;7;18
292;03.11.2017;2017;11;08;Perjantai;36;17;53;19;13;32
292;03.11.2017;2017;11;09;Perjantai;23;12;35;10;17;27
292;03.11.2017;2017;11;10;Perjantai;15;8;23;8;5;13
292;03.11.2017;2017;11;11;Perjantai;13;9;22;16;17;33
292;03.11.2017;2017;11;12;Perjantai;14;26;40;10;21;31
292;03.11.2017;2017;11;13;Perjantai;21;47;68;18;30;48
292;03.11.2017;2017;11;14;Perjantai;24;51;75;29;20;49
292;03.11.2017;2017;11;15;Perjantai;27;21;48;18;27;45
292;03.11.2017;2017;11;16;Perjantai;17;26;43;17;15;32
292;03.11.2017;2017;11;17;Perjantai;16;25;41;14;16;30
292;03.11.2017;2017;11;18;Perjantai;15;15;30;16;12;28
292;03.11.2017;2017;11;19;Perjantai;14;14;28;13;18;31
292;03.11.2017;2017;11;20;Perjantai;8;8;16;19;8;27
292;03.11.2017;2017;11;21;Perjantai;5;6;11;8;6;14
292;03.11.2017;2017;11;22;Perjantai;8;5;13;10;2;12
292;03.11.2017;2017;11;23;Perjantai;3;1;4;11;0;11
292;04.11.2017;2017;11;00;Lauantai;2;2;4;0;5;5
292;04.11.2017;2017;11;01;Lauantai;3;0;3;0;3;3
292;04.11.2017;2017;11;02;Lauantai;0;3;3;2;7;9
292;04.11.2017;2017;11;03;Lauantai;0;1;1;1;7;8
292;04.11.2017;2017;11;04;Lauantai;1;0;1;0;0;0
292;04.11.2017;2017;11;05;Lauantai;1;0;1;2;0;2
292;04.11.2017;2017;11;06;Lauantai;2;1;3;6;2;8
292;04.11.2017;2017;11;07;Lauantai;1;2;3;1;2;3
292;04.11.2017;2017;11;08;Lauantai;2;5;7;11;4;15
292;04.11.2017;2017;11;09;Lauantai;5;5;10;10;6;16
292;04.11.2017;2017;11;10;Lauantai;9;12;21;14;9;23
292;04.11.2017;2017;11;11;Lauantai;11;7;18;5;18;23
292;04.11.2017;2017;11;12;Lauantai;8;7;15;9;7;16
292;04.11.2017;2017;11;13;Lauantai;14;15;29;3;10;13
292;04.11.2017;2017;11;14;Lauantai;13;10;23;16;12;28
292;04.11.2017;2017;11;15;Lauantai;22;7;29;17;13;30
292;04.11.2017;2017;11;16;Lauantai;7;11;18;9;3;12
292;04.11.2017;2017;11;17;Lauantai;12;13;25;13;15;28
292;04.11.2017;2017;11;18;Lauantai;11;6;17;13;10;23
292;04.11.2017;2017;11;19;Lauantai;7;5;12;5;12;17
292;04.11.2017;2017;11;20;Lauantai;6;4;10;6;1;7
292;04.11.2017;2017;11;21;Lauantai;7;5;12;9;2;11
292;04.11.2017;2017;11;22;Lauantai;5;7;12;6;2;8
292;04.11.2017;2017;11;23;Lauantai;2;7;9;8;5;13
292;05.11.2017;2017;11;00;Sunnuntai;2;3;5;8;6;14
292;05.11.2017;2017;11;01;Sunnuntai;1;3;4;2;2;4
292;05.11.2017;2017;11;02;Sunnuntai;0;1;1;0;6;6
292;05.11.2017;2017;11;03;Sunnuntai;1;4;5;0;0;0
292;05.11.2017;2017;11;04;Sunnuntai;2;1;3;1;0;1
292;05.11.2017;2017;11;05;Sunnuntai;1;0;1;2;0;2
292;05.11.2017;2017;11;06;Sunnuntai;3;2;5;2;3;5
292;05.11.2017;2017;11;07;Sunnuntai;1;2;3;3;1;4
292;05.11.2017;2017;11;08;Sunnuntai;3;6;9;11;9;20
292;05.11.2017;2017;11;09;Sunnuntai;2;6;8;9;11;20
292;05.11.2017;2017;11;10;Sunnuntai;4;9;13;7;13;20
292;05.11.2017;2017;11;11;Sunnuntai;14;5;19;13;14;27
292;05.11.2017;2017;11;12;Sunnuntai;15;10;25;13;10;23
292;05.11.2017;2017;11;13;Sunnuntai;12;19;31;19;11;30
292;05.11.2017;2017;11;14;Sunnuntai;25;22;47;15;15;30
292;05.11.2017;2017;11;15;Sunnuntai;16;15;31;14;11;25
292;05.11.2017;2017;11;16;Sunnuntai;17;11;28;16;11;27
292;05.11.2017;2017;11;17;Sunnuntai;10;7;17;5;5;10
292;05.11.2017;2017;11;18;Sunnuntai;8;9;17;8;10;18
292;05.11.2017;2017;11;19;Sunnuntai;8;3;11;5;2;7
292;05.11.2017;2017;11;20;Sunnuntai;6;4;10;2;1;3
292;05.11.2017;2017;11;21;Sunnuntai;2;1;3;2;3;5
292;05.11.2017;2017;11;22;Sunnuntai;2;0;2;2;3;5
292;05.11.2017;2017;11;23;Sunnuntai;1;1;2;0;0;0
292;06.11.2017;2017;11;00;Maanantai;1;0;1;0;0;0
292;06.11.2017;2017;11;01;Maanantai;0;0;0;0;0;0
292;06.11.2017;2017;11;02;Maanantai;1;0;1;0;0;0
292;06.11.2017;2017;11;03;Maanantai;0;0;0;0;0;0
292;06.11.2017;2017;11;04;Maanantai;1;0;1;0;0;0
292;06.11.2017;2017;11;05;Maanantai;6;4;10;1;2;3
292;06.11.2017;2017;11;06;Maanantai;11;10;21;0;0;0
292;06.11.2017;2017;11;07;Maanantai;37;35;72;4;1;5
292;06.11.2017;2017;11;08;Maanantai;34;30;64;4;2;6
292;06.11.2017;2017;11;09;Maanantai;45;44;89;5;5;10
292;06.11.2017;2017;11;10;Maanantai;19;19;38;6;3;9
292;06.11.2017;2017;11;11;Maanantai;21;21;42;5;4;9
292;06.11.2017;2017;11;12;Maanantai;24;29;53;14;13;27
292;06.11.2017;2017;11;13;Maanantai;29;30;59;12;13;25
292;06.11.2017;2017;11;14;Maanantai;34;30;64;10;7;17
292;06.11.2017;2017;11;15;Maanantai;30;42;72;6;11;17
292;06.11.2017;2017;11;16;Maanantai;31;40;71;10;23;33
292;06.11.2017;2017;11;17;Maanantai;26;22;48;9;12;21
292;06.11.2017;2017;11;18;Maanantai;22;18;40;8;13;21
292;06.11.2017;2017;11;19;Maanantai;17;14;31;7;7;14
292;06.11.2017;2017;11;20;Maanantai;16;9;25;7;5;12
292;06.11.2017;2017;11;21;Maanantai;8;7;15;4;3;7
292;06.11.2017;2017;11;22;Maanantai;2;1;3;2;1;3
292;06.11.2017;2017;11;23;Maanantai;1;0;1;1;0;1
292;07.11.2017;2017;11;00;Tiistai;0;0;0;0;0;0
292;07.11.2017;2017;11;01;Tiistai;0;0;0;0;0;0
292;07.11.2017;2017;11;02;Tiistai;0;0;0;0;0;0
292;07.11.2017;2017;11;03;Tiistai;0;0;0;0;0;0
292;07.11.2017;2017;11;04;Tiistai;1;0;1;0;0;0
292;07.11.2017;2017;11;05;Tiistai;10;6;16;1;1;2
292;07.11.2017;2017;11;06;Tiistai;20;14;34;2;8;10
292;07.11.2017;2017;11;07;Tiistai;66;17;83;10;8;18
292;07.11.2017;2017;11;08;Tiistai;70;19;89;9;12;21
292;07.11.2017;2017;11;09;Tiistai;30;13;43;9;21;30
292;07.11.2017;2017;11;10;Tiistai;19;10;29;11;8;19
292;07.11.2017;2017;11;11;Tiistai;21;23;44;15;16;31
292;07.11.2017;2017;11;12;Tiistai;15;12;27;10;20;30
292;07.11.2017;2017;11;13;Tiistai;22;19;41;18;19;37
292;07.11.2017;2017;11;14;Tiistai;42;53;95;8;40;48
292;07.11.2017;2017;11;15;Tiistai;36;37;73;15;28;43
292;07.11.2017;2017;11;16;Tiistai;31;34;65;9;26;35
292;07.11.2017;2017;11;17;Tiistai;30;20;50;15;21;36
292;07.11.2017;2017;11;18;Tiistai;18;6;24;13;9;22
292;07.11.2017;2017;11;19;Tiistai;13;13;26;10;15;25
292;07.11.2017;2017;11;20;Tiistai;13;12;25;14;7;21
292;07.11.2017;2017;11;21;Tiistai;7;5;12;3;4;7
292;07.11.2017;2017;11;22;Tiistai;3;2;5;0;0;0
292;07.11.2017;2017;11;23;Tiistai;2;1;3;0;0;0
292;08.11.2017;2017;11;00;Keskiviikko;0;0;0;0;1;1
292;08.11.2017;2017;11;01;Keskiviikko;0;0;0;0;0;0
292;08.11.2017;2017;11;02;Keskiviikko;0;1;1;0;0;0
292;08.11.2017;2017;11;03;Keskiviikko;0;0;0;0;0;0
292;08.11.2017;2017;11;04;Keskiviikko;1;1;2;0;0;0
292;08.11.2017;2017;11;05;Keskiviikko;5;5;10;1;0;1
292;08.11.2017;2017;11;06;Keskiviikko;12;10;22;1;4;5
292;08.11.2017;2017;11;07;Keskiviikko;42;34;76;8;3;11
292;08.11.2017;2017;11;08;Keskiviikko;45;34;79;4;9;13
292;08.11.2017;2017;11;09;Keskiviikko;28;17;45;8;9;17
292;08.11.2017;2017;11;10;Keskiviikko;18;14;32;6;5;11
292;08.11.2017;2017;11;11;Keskiviikko;25;17;42;5;11;16
292;08.11.2017;2017;11;12;Keskiviikko;20;20;40;17;7;24
292;08.11.2017;2017;11;13;Keskiviikko;35;41;76;9;15;24
292;08.11.2017;2017;11;14;Keskiviikko;27;42;69;18;12;30
292;08.11.2017;2017;11;15;Keskiviikko;36;32;68;20;20;40
292;08.11.2017;2017;11;16;Keskiviikko;36;38;74;7;20;27
292;08.11.2017;2017;11;17;Keskiviikko;27;22;49;14;10;24
292;08.11.2017;2017;11;18;Keskiviikko;12;13;25;15;21;36
292;08.11.2017;2017;11;19;Keskiviikko;15;8;23;14;13;27
292;08.11.2017;2017;11;20;Keskiviikko;17;8;25;8;7;15
292;08.11.2017;2017;11;21;Keskiviikko;6;5;11;3;2;5
292;08.11.2017;2017;11;22;Keskiviikko;2;0;2;1;0;1
292;08.11.2017;2017;11;23;Keskiviikko;1;1;2;0;0;0
292;09.11.2017;2017;11;00;Torstai;2;0;2;0;0;0
292;09.11.2017;2017;11;01;Torstai;0;0;0;0;1;1
292;09.11.2017;2017;11;02;Torstai;0;0;0;0;0;0
292;09.11.2017;2017;11;03;Torstai;0;0;0;0;0;0
292;09.11.2017;2017;11;04;Torstai;1;1;2;0;0;0
292;09.11.2017;2017;11;05;Torstai;4;4;8;1;1;2
292;09.11.2017;2017;11;06;Torstai;15;12;27;1;5;6
292;09.11.2017;2017;11;07;Torstai;62;17;79;15;9;24
292;09.11.2017;2017;11;08;Torstai;51;19;70;8;13;21
292;09.11.2017;2017;11;09;Torstai;52;20;72;8;9;17
292;09.11.2017;2017;11;10;Torstai;25;14;39;8;12;20
292;09.11.2017;2017;11;11;Torstai;26;11;37;7;18;25
292;09.11.2017;2017;11;12;Torstai;25;21;46;10;16;26
292;09.11.2017;2017;11;13;Torstai;31;32;63;10;24;34
292;09.11.2017;2017;11;14;Torstai;20;34;54;16;23;39
292;09.11.2017;2017;11;15;Torstai;31;59;90;18;33;51
292;09.11.2017;2017;11;16;Torstai;29;65;94;18;32;50
292;09.11.2017;2017;11;17;Torstai;25;8;33;23;26;49
292;09.11.2017;2017;11;18;Torstai;25;19;44;15;28;43
292;09.11.2017;2017;11;19;Torstai;17;7;24;14;9;23
292;09.11.2017;2017;11;20;Torstai;14;3;17;11;5;16
292;09.11.2017;2017;11;21;Torstai;1;4;5;2;2;4
292;09.11.2017;2017;11;22;Torstai;2;1;3;1;1;2
292;09.11.2017;2017;11;23;Torstai;1;1;2;2;2;4
292;10.11.2017;2017;11;00;Perjantai;3;1;4;1;1;2
292;10.11.2017;2017;11;01;Perjantai;0;1;1;1;2;3
292;10.11.2017;2017;11;02;Perjantai;1;2;3;0;0;0
292;10.11.2017;2017;11;03;Perjantai;0;0;0;0;0;0
292;10.11.2017;2017;11;04;Perjantai;1;0;1;0;1;1
292;10.11.2017;2017;11;05;Perjantai;4;3;7;0;3;3
292;10.11.2017;2017;11;06;Perjantai;15;8;23;1;6;7
292;10.11.2017;2017;11;07;Perjantai;82;20;102;12;7;19
292;10.11.2017;2017;11;08;Perjantai;51;17;68;12;12;24
292;10.11.2017;2017;11;09;Perjantai;38;17;55;5;17;22
292;10.11.2017;2017;11;10;Perjantai;20;7;27;11;9;20
292;10.11.2017;2017;11;11;Perjantai;14;17;31;6;14;20
292;10.11.2017;2017;11;12;Perjantai;25;30;55;14;15;29
292;10.11.2017;2017;11;13;Perjantai;36;62;98;11;35;46
292;10.11.2017;2017;11;14;Perjantai;31;56;87;14;24;38
292;10.11.2017;2017;11;15;Perjantai;26;40;66;14;27;41
292;10.11.2017;2017;11;16;Perjantai;17;39;56;11;10;21
292;10.11.2017;2017;11;17;Perjantai;35;22;57;10;18;28
292;10.11.2017;2017;11;18;Perjantai;19;18;37;13;33;46
292;10.11.2017;2017;11;19;Perjantai;20;18;38;12;13;25
292;10.11.2017;2017;11;20;Perjantai;16;6;22;10;12;22
292;10.11.2017;2017;11;21;Perjantai;16;9;25;11;13;24
292;10.11.2017;2017;11;22;Perjantai;13;5;18;7;6;13
292;10.11.2017;2017;11;23;Perjantai;3;3;6;6;2;8
292;11.11.2017;2017;11;00;Lauantai;0;2;2;4;2;6
292;11.11.2017;2017;11;01;Lauantai;1;0;1;2;3;5
292;11.11.2017;2017;11;02;Lauantai;2;1;3;2;3;5
292;11.11.2017;2017;11;03;Lauantai;0;0;0;1;5;6
292;11.11.2017;2017;11;04;Lauantai;0;0;0;0;0;0
292;11.11.2017;2017;11;05;Lauantai;0;0;0;5;1;6
292;11.11.2017;2017;11;06;Lauantai;1;2;3;1;2;3
292;11.11.2017;2017;11;07;Lauantai;2;1;3;4;3;7
292;11.11.2017;2017;11;08;Lauantai;3;6;9;6;11;17
292;11.11.2017;2017;11;09;Lauantai;12;14;26;5;13;18
292;11.11.2017;2017;11;10;Lauantai;16;15;31;7;17;24
292;11.11.2017;2017;11;11;Lauantai;21;14;35;6;14;20
292;11.11.2017;2017;11;12;Lauantai;28;16;44;13;8;21
292;11.11.2017;2017;11;13;Lauantai;15;15;30;10;18;28
292;11.11.2017;2017;11;14;Lauantai;29;25;54;10;13;23
292;11.11.2017;2017;11;15;Lauantai;27;8;35;14;6;20
292;11.11.2017;2017;11;16;Lauantai;24;11;35;10;15;25
292;11.11.2017;2017;11;17;Lauantai;9;17;26;16;10;26
292;11.11.2017;2017;11;18;Lauantai;14;9;23;16;11;27
292;11.11.2017;2017;11;19;Lauantai;9;7;16;13;11;24
292;11.11.2017;2017;11;20;Lauantai;8;9;17;7;5;12
292;11.11.2017;2017;11;21;Lauantai;6;6;12;5;4;9
292;11.11.2017;2017;11;22;Lauantai;4;4;8;1;4;5
292;11.11.2017;2017;11;23;Lauantai;3;5;8;0;3;3
292;12.11.2017;2017;11;00;Sunnuntai;5;3;8;7;1;8
292;12.11.2017;2017;11;01;Sunnuntai;1;3;4;8;1;9
292;12.11.2017;2017;11;02;Sunnuntai;2;0;2;0;0;0
292;12.11.2017;2017;11;03;Sunnuntai;0;0;0;1;2;3
292;12.11.2017;2017;11;04;Sunnuntai;0;0;0;0;0;0
292;12.11.2017;2017;11;05;Sunnuntai;1;0;1;2;0;2
292;12.11.2017;2017;11;06;Sunnuntai;2;2;4;2;3;5
292;12.11.2017;2017;11;07;Sunnuntai;1;1;2;3;0;3
292;12.11.2017;2017;11;08;Sunnuntai;5;7;12;7;7;14
292;12.11.2017;2017;11;09;Sunnuntai;10;5;15;10;11;21
292;12.11.2017;2017;11;10;Sunnuntai;8;7;15;10;10;20
292;12.11.2017;2017;11;11;Sunnuntai;11;9;20;7;11;18
292;12.11.2017;2017;11;12;Sunnuntai;25;13;38;14;17;31
292;12.11.2017;2017;11;13;Sunnuntai;13;11;24;14;14;28
292;12.11.2017;2017;11;14;Sunnuntai;13;10;23;9;8;17
292;12.11.2017;2017;11;15;Sunnuntai;11;11;22;11;9;20
292;12.11.2017;2017;11;16;Sunnuntai;11;14;25;12;13;25
292;12.11.2017;2017;11;17;Sunnuntai;12;9;21;12;10;22
292;12.11.2017;2017;11;18;Sunnuntai;15;12;27;13;12;25
292;12.11.2017;2017;11;19;Sunnuntai;8;5;13;5;6;11
292;12.11.2017;2017;11;20;Sunnuntai;9;6;15;4;6;10
292;12.11.2017;2017;11;21;Sunnuntai;9;1;10;0;2;2
292;12.11.2017;2017;11;22;Sunnuntai;0;3;3;3;0;3
292;12.11.2017;2017;11;23;Sunnuntai;1;0;1;0;1;1
292;13.11.2017;2017;11;00;Maanantai;0;0;0;0;1;1
292;13.11.2017;2017;11;01;Maanantai;1;0;1;0;0;0
292;13.11.2017;2017;11;02;Maanantai;0;0;0;0;0;0
292;13.11.2017;2017;11;03;Maanantai;0;0;0;0;0;0
292;13.11.2017;2017;11;04;Maanantai;1;0;1;0;0;0
292;13.11.2017;2017;11;05;Maanantai;5;7;12;0;0;0
292;13.11.2017;2017;11;06;Maanantai;11;9;20;1;8;9
292;13.11.2017;2017;11;07;Maanantai;51;14;65;12;12;24
292;13.11.2017;2017;11;08;Maanantai;41;16;57;10;12;22
292;13.11.2017;2017;11;09;Maanantai;61;18;79;14;20;34
292;13.11.2017;2017;11;10;Maanantai;18;10;28;8;16;24
292;13.11.2017;2017;11;11;Maanantai;21;14;35;11;3;14
292;13.11.2017;2017;11;12;Maanantai;25;18;43;8;14;22
292;13.11.2017;2017;11;13;Maanantai;25;27;52;15;20;35
292;13.11.2017;2017;11;14;Maanantai;37;41;78;10;40;50
292;13.11.2017;2017;11;15;Maanantai;35;60;95;15;29;44
292;13.11.2017;2017;11;16;Maanantai;28;49;77;13;30;43
292;13.11.2017;2017;11;17;Maanantai;23;22;45;13;24;37
292;13.11.2017;2017;11;18;Maanantai;21;13;34;21;13;34
292;13.11.2017;2017;11;19;Maanantai;14;10;24;13;19;32
292;13.11.2017;2017;11;20;Maanantai;17;9;26;9;9;18
292;13.11.2017;2017;11;21;Maanantai;5;5;10;2;2;4
292;13.11.2017;2017;11;22;Maanantai;2;1;3;1;0;1
292;13.11.2017;2017;11;23;Maanantai;2;2;4;0;0;0
292;14.11.2017;2017;11;00;Tiistai;0;0;0;1;2;3
292;14.11.2017;2017;11;01;Tiistai;0;0;0;1;1;2
292;14.11.2017;2017;11;02;Tiistai;0;0;0;0;0;0
292;14.11.2017;2017;11;03;Tiistai;0;1;1;0;0;0
292;14.11.2017;2017;11;04;Tiistai;2;1;3;1;0;1
292;14.11.2017;2017;11;05;Tiistai;6;4;10;0;1;1
292;14.11.2017;2017;11;06;Tiistai;18;18;36;2;5;7
292;14.11.2017;2017;11;07;Tiistai;56;17;73;20;17;37
292;14.11.2017;2017;11;08;Tiistai;70;10;80;13;13;26
292;14.11.2017;2017;11;09;Tiistai;15;10;25;13;15;28
292;14.11.2017;2017;11;10;Tiistai;26;5;31;12;15;27
292;14.11.2017;2017;11;11;Tiistai;7;11;18;14;10;24
292;14.11.2017;2017;11;12;Tiistai;7;9;16;10;12;22
292;14.11.2017;2017;11;13;Tiistai;17;19;36;9;22;31
292;14.11.2017;2017;11;14;Tiistai;23;61;84;16;25;41
292;14.11.2017;2017;11;15;Tiistai;28;28;56;14;32;46
292;14.11.2017;2017;11;16;Tiistai;30;34;64;12;23;35
292;14.11.2017;2017;11;17;Tiistai;17;15;32;11;31;42
292;14.11.2017;2017;11;18;Tiistai;23;6;29;21;16;37
292;14.11.2017;2017;11;19;Tiistai;9;22;31;11;9;20
292;14.11.2017;2017;11;20;Tiistai;23;13;36;10;14;24
292;14.11.2017;2017;11;21;Tiistai;9;5;14;2;3;5
292;14.11.2017;2017;11;22;Tiistai;1;3;4;1;2;3
292;14.11.2017;2017;11;23;Tiistai;0;0;0;0;1;1
292;15.11.2017;2017;11;00;Keskiviikko;0;0;0;0;2;2
292;15.11.2017;2017;11;01;Keskiviikko;0;0;0;0;0;0
292;15.11.2017;2017;11;02;Keskiviikko;0;1;1;0;0;0
292;15.11.2017;2017;11;03;Keskiviikko;0;0;0;0;0;0
292;15.11.2017;2017;11;04;Keskiviikko;1;1;2;0;0;0
292;15.11.2017;2017;11;05;Keskiviikko;4;4;8;2;0;2
292;15.11.2017;2017;11;06;Keskiviikko;10;9;19;2;7;9
292;15.11.2017;2017;11;07;Keskiviikko;36;29;65;13;5;18
292;15.11.2017;2017;11;08;Keskiviikko;38;29;67;7;14;21
292;15.11.2017;2017;11;09;Keskiviikko;24;14;38;13;14;27
292;15.11.2017;2017;11;10;Keskiviikko;15;12;27;10;9;19
292;15.11.2017;2017;11;11;Keskiviikko;21;14;35;9;18;27
292;15.11.2017;2017;11;12;Keskiviikko;17;17;34;28;11;39
292;15.11.2017;2017;11;13;Keskiviikko;30;35;65;14;25;39
292;15.11.2017;2017;11;14;Keskiviikko;23;36;59;29;19;48
292;15.11.2017;2017;11;15;Keskiviikko;31;27;58;32;32;64
292;15.11.2017;2017;11;16;Keskiviikko;31;32;63;11;32;43
292;15.11.2017;2017;11;17;Keskiviikko;23;19;42;23;16;39
292;15.11.2017;2017;11;18;Keskiviikko;10;11;21;25;34;59
292;15.11.2017;2017;11;19;Keskiviikko;13;7;20;23;21;44
292;15.11.2017;2017;11;20;Keskiviikko;14;7;21;13;11;24
292;15.11.2017;2017;11;21;Keskiviikko;5;4;9;5;3;8
292;15.11.2017;2017;11;22;Keskiviikko;2;0;2;2;0;2
292;15.11.2017;2017;11;23;Keskiviikko;1;1;2;0;0;0
292;16.11.2017;2017;11;00;Torstai;2;0;2;0;0;0
292;16.11.2017;2017;11;01;Torstai;0;0;0;0;1;1
292;16.11.2017;2017;11;02;Torstai;0;0;0;0;0;0
292;16.11.2017;2017;11;03;Torstai;0;0;0;0;0;0
292;16.11.2017;2017;11;04;Torstai;1;1;2;0;0;0
292;16.11.2017;2017;11;05;Torstai;3;3;6;1;1;2
292;16.11.2017;2017;11;06;Torstai;13;10;23;1;6;7
292;16.11.2017;2017;11;07;Torstai;55;14;69;17;10;27
292;16.11.2017;2017;11;08;Torstai;44;16;60;9;14;23
292;16.11.2017;2017;11;09;Torstai;45;18;63;9;10;19
292;16.11.2017;2017;11;10;Torstai;22;12;34;9;13;22
292;16.11.2017;2017;11;11;Torstai;23;9;32;8;20;28
292;16.11.2017;2017;11;12;Torstai;22;19;41;11;18;29
292;16.11.2017;2017;11;13;Torstai;27;28;55;11;26;37
292;16.11.2017;2017;11;14;Torstai;18;30;48;18;25;43
292;16.11.2017;2017;11;15;Torstai;27;52;79;20;36;56
292;16.11.2017;2017;11;16;Torstai;26;57;83;20;35;55
292;16.11.2017;2017;11;17;Torstai;22;7;29;25;29;54
292;16.11.2017;2017;11;18;Torstai;22;16;38;17;31;48
292;16.11.2017;2017;11;19;Torstai;14;6;20;15;10;25
292;16.11.2017;2017;11;20;Torstai;12;3;15;12;6;18
292;16.11.2017;2017;11;21;Torstai;1;3;4;2;2;4
292;16.11.2017;2017;11;22;Torstai;2;1;3;1;1;2
292;16.11.2017;2017;11;23;Torstai;1;1;2;2;2;4
292;17.11.2017;2017;11;00;Perjantai;0;0;0;1;1;2
292;17.11.2017;2017;11;01;Perjantai;0;0;0;1;0;1
292;17.11.2017;2017;11;02;Perjantai;1;0;1;0;0;0
292;17.11.2017;2017;11;03;Perjantai;0;0;0;0;0;0
292;17.11.2017;2017;11;04;Perjantai;1;1;2;0;0;0
292;17.11.2017;2017;11;05;Perjantai;5;5;10;0;0;0
292;17.11.2017;2017;11;06;Perjantai;10;4;14;0;10;10
292;17.11.2017;2017;11;07;Perjantai;61;20;81;16;8;24
292;17.11.2017;2017;11;08;Perjantai;43;17;60;15;9;24
292;17.11.2017;2017;11;09;Perjantai;25;9;34;9;9;18
292;17.11.2017;2017;11;10;Perjantai;16;6;22;6;7;13
292;17.11.2017;2017;11;11;Perjantai;13;9;22;6;9;15
292;17.11.2017;2017;11;12;Perjantai;23;9;32;11;10;21
292;17.11.2017;2017;11;13;Perjantai;14;40;54;14;18;32
292;17.11.2017;2017;11;14;Perjantai;21;25;46;8;18;26
292;17.11.2017;2017;11;15;Perjantai;19;20;39;10;18;28
292;17.11.2017;2017;11;16;Perjantai;13;17;30;11;15;26
292;17.11.2017;2017;11;17;Perjantai;8;9;17;6;16;22
292;17.11.2017;2017;11;18;Perjantai;13;5;18;9;12;21
292;17.11.2017;2017;11;19;Perjantai;8;7;15;7;10;17
292;17.11.2017;2017;11;20;Perjantai;13;4;17;6;5;11
292;17.11.2017;2017;11;21;Perjantai;11;1;12;6;5;11
292;17.11.2017;2017;11;22;Perjantai;5;2;7;2;3;5
292;17.11.2017;2017;11;23;Perjantai;5;3;8;2;1;3
292;18.11.2017;2017;11;00;Lauantai;5;0;5;5;1;6
292;18.11.2017;2017;11;01;Lauantai;0;3;3;0;0;0
292;18.11.2017;2017;11;02;Lauantai;1;2;3;1;1;2
292;18.11.2017;2017;11;03;Lauantai;0;2;2;0;2;2
292;18.11.2017;2017;11;04;Lauantai;0;0;0;0;0;0
292;18.11.2017;2017;11;05;Lauantai;1;1;2;3;1;4
292;18.11.2017;2017;11;06;Lauantai;1;1;2;0;2;2
292;18.11.2017;2017;11;07;Lauantai;4;1;5;4;3;7
292;18.11.2017;2017;11;08;Lauantai;3;1;4;6;6;12
292;18.11.2017;2017;11;09;Lauantai;4;2;6;5;9;14
292;18.11.2017;2017;11;10;Lauantai;4;5;9;6;8;14
292;18.11.2017;2017;11;11;Lauantai;7;10;17;5;18;23
292;18.11.2017;2017;11;12;Lauantai;12;9;21;11;5;16
292;18.11.2017;2017;11;13;Lauantai;20;9;29;12;16;28
292;18.11.2017;2017;11;14;Lauantai;16;15;31;17;13;30
292;18.11.2017;2017;11;15;Lauantai;13;7;20;8;15;23
292;18.11.2017;2017;11;16;Lauantai;11;11;22;10;12;22
292;18.11.2017;2017;11;17;Lauantai;13;4;17;19;13;32
292;18.11.2017;2017;11;18;Lauantai;11;7;18;13;17;30
292;18.11.2017;2017;11;19;Lauantai;17;5;22;15;10;25
292;18.11.2017;2017;11;20;Lauantai;12;5;17;11;6;17
292;18.11.2017;2017;11;21;Lauantai;3;4;7;11;1;12
292;18.11.2017;2017;11;22;Lauantai;11;8;19;8;5;13
292;18.11.2017;2017;11;23;Lauantai;2;5;7;2;2;4
292;19.11.2017;2017;11;00;Sunnuntai;1;2;3;6;4;10
292;19.11.2017;2017;11;01;Sunnuntai;2;1;3;4;1;5
292;19.11.2017;2017;11;02;Sunnuntai;1;1;2;1;6;7
292;19.11.2017;2017;11;03;Sunnuntai;0;1;1;0;2;2
292;19.11.2017;2017;11;04;Sunnuntai;0;0;0;0;0;0
292;19.11.2017;2017;11;05;Sunnuntai;1;0;1;1;3;4
292;19.11.2017;2017;11;06;Sunnuntai;5;1;6;2;3;5
292;19.11.2017;2017;11;07;Sunnuntai;4;1;5;4;4;8
292;19.11.2017;2017;11;08;Sunnuntai;1;0;1;8;6;14
292;19.11.2017;2017;11;09;Sunnuntai;5;1;6;16;11;27
292;19.11.2017;2017;11;10;Sunnuntai;5;5;10;6;15;21
292;19.11.2017;2017;11;11;Sunnuntai;11;12;23;11;12;23
292;19.11.2017;2017;11;12;Sunnuntai;8;7;15;11;9;20
292;19.11.2017;2017;11;13;Sunnuntai;7;2;9;5;6;11
292;19.11.2017;2017;11;14;Sunnuntai;12;14;26;16;15;31
292;19.11.2017;2017;11;15;Sunnuntai;11;4;15;16;13;29
292;19.11.2017;2017;11;16;Sunnuntai;18;10;28;12;12;24
292;19.11.2017;2017;11;17;Sunnuntai;10;9;19;12;17;29
292;19.11.2017;2017;11;18;Sunnuntai;9;4;13;15;10;25
292;19.11.2017;2017;11;19;Sunnuntai;4;3;7;10;11;21
292;19.11.2017;2017;11;20;Sunnuntai;9;9;18;11;5;16
292;19.11.2017;2017;11;21;Sunnuntai;2;2;4;5;1;6
292;19.11.2017;2017;11;22;Sunnuntai;0;2;2;1;2;3
292;19.11.2017;2017;11;23;Sunnuntai;2;3;5;0;0;0
292;20.11.2017;2017;11;00;Maanantai;0;0;0;1;0;1
292;20.11.2017;2017;11;01;Maanantai;0;1;1;0;0;0
292;20.11.2017;2017;11;02;Maanantai;1;0;1;0;0;0
292;20.11.2017;2017;11;03;Maanantai;0;0;0;0;0;0
292;20.11.2017;2017;11;04;Maanantai;2;0;2;0;0;0
292;20.11.2017;2017;11;05;Maanantai;5;3;8;2;1;3
292;20.11.2017;2017;11;06;Maanantai;13;13;26;0;5;5
292;20.11.2017;2017;11;07;Maanantai;43;18;61;12;15;27
292;20.11.2017;2017;11;08;Maanantai;37;12;49;15;11;26
292;20.11.2017;2017;11;09;Maanantai;51;15;66;19;17;36
292;20.11.2017;2017;11;10;Maanantai;22;10;32;14;19;33
292;20.11.2017;2017;11;11;Maanantai;23;9;32;9;17;26
292;20.11.2017;2017;11;12;Maanantai;15;13;28;16;12;28
292;20.11.2017;2017;11;13;Maanantai;20;14;34;17;21;38
292;20.11.2017;2017;11;14;Maanantai;25;35;60;18;33;51
292;20.11.2017;2017;11;15;Maanantai;29;45;74;20;27;47
292;20.11.2017;2017;11;16;Maanantai;23;36;59;15;34;49
292;20.11.2017;2017;11;17;Maanantai;17;24;41;19;23;42
292;20.11.2017;2017;11;18;Maanantai;17;15;32;21;13;34
292;20.11.2017;2017;11;19;Maanantai;15;10;25;10;13;23
292;20.11.2017;2017;11;20;Maanantai;13;7;20;10;12;22
292;20.11.2017;2017;11;21;Maanantai;5;3;8;6;3;9
292;20.11.2017;2017;11;22;Maanantai;2;0;2;1;2;3
292;20.11.2017;2017;11;23;Maanantai;2;1;3;1;1;2
292;21.11.2017;2017;11;00;Tiistai;1;1;2;0;0;0
292;21.11.2017;2017;11;01;Tiistai;0;0;0;0;0;0
292;21.11.2017;2017;11;02;Tiistai;0;0;0;0;0;0
292;21.11.2017;2017;11;03;Tiistai;1;1;2;0;0;0
292;21.11.2017;2017;11;04;Tiistai;0;0;0;0;0;0
292;21.11.2017;2017;11;05;Tiistai;3;2;5;0;1;1
292;21.11.2017;2017;11;06;Tiistai;16;9;25;2;12;14
292;21.11.2017;2017;11;07;Tiistai;47;10;57;18;16;34
292;21.11.2017;2017;11;08;Tiistai;62;13;75;16;22;38
292;21.11.2017;2017;11;09;Tiistai;20;9;29;9;8;17
292;21.11.2017;2017;11;10;Tiistai;22;5;27;12;15;27
292;21.11.2017;2017;11;11;Tiistai;16;14;30;10;17;27
292;21.11.2017;2017;11;12;Tiistai;13;12;25;15;12;27
292;21.11.2017;2017;11;13;Tiistai;7;20;27;21;14;35
292;21.11.2017;2017;11;14;Tiistai;24;63;87;8;43;51
292;21.11.2017;2017;11;15;Tiistai;22;20;42;21;32;53
292;21.11.2017;2017;11;16;Tiistai;28;26;54;14;30;44
292;21.11.2017;2017;11;17;Tiistai;9;16;25;13;31;44
292;21.11.2017;2017;11;18;Tiistai;8;12;20;10;20;30
292;21.11.2017;2017;11;19;Tiistai;16;6;22;9;4;13
292;21.11.2017;2017;11;20;Tiistai;11;8;19;9;8;17
292;21.11.2017;2017;11;21;Tiistai;3;2;5;2;4;6
292;21.11.2017;2017;11;22;Tiistai;3;1;4;0;2;2
292;21.11.2017;2017;11;23;Tiistai;0;0;0;0;0;0
292;22.11.2017;2017;11;00;Keskiviikko;1;0;1;0;0;0
292;22.11.2017;2017;11;01;Keskiviikko;0;0;0;0;1;1
292;22.11.2017;2017;11;02;Keskiviikko;0;0;0;0;0;0
292;22.11.2017;2017;11;03;Keskiviikko;0;0;0;0;0;0
292;22.11.2017;2017;11;04;Keskiviikko;1;1;2;0;0;0
292;22.11.2017;2017;11;05;Keskiviikko;4;1;5;2;2;4
292;22.11.2017;2017;11;06;Keskiviikko;11;11;22;2;11;13
292;22.11.2017;2017;11;07;Keskiviikko;60;20;80;11;21;32
292;22.11.2017;2017;11;08;Keskiviikko;39;18;57;10;17;27
292;22.11.2017;2017;11;09;Keskiviikko;17;3;20;11;14;25
292;22.11.2017;2017;11;10;Keskiviikko;14;16;30;10;26;36
292;22.11.2017;2017;11;11;Keskiviikko;15;17;32;10;19;29
292;22.11.2017;2017;11;12;Keskiviikko;1;20;21;14;15;29
292;22.11.2017;2017;11;13;Keskiviikko;15;16;31;13;13;26
292;22.11.2017;2017;11;14;Keskiviikko;21;21;42;14;30;44
292;22.11.2017;2017;11;15;Keskiviikko;25;19;44;29;28;57
292;22.11.2017;2017;11;16;Keskiviikko;19;20;39;8;26;34
292;22.11.2017;2017;11;17;Keskiviikko;15;9;24;11;17;28
292;22.11.2017;2017;11;18;Keskiviikko;14;14;28;17;14;31
292;22.11.2017;2017;11;19;Keskiviikko;13;8;21;12;11;23
292;22.11.2017;2017;11;20;Keskiviikko;13;5;18;9;6;15
292;22.11.2017;2017;11;21;Keskiviikko;5;3;8;0;3;3
292;22.11.2017;2017;11;22;Keskiviikko;3;0;3;2;1;3
292;22.11.2017;2017;11;23;Keskiviikko;0;0;0;0;0;0
292;23.11.2017;2017;11;00;Torstai;1;0;1;0;1;1
292;23.11.2017;2017;11;01;Torstai;1;0;1;0;1;1
292;23.11.2017;2017;11;02;Torstai;0;0;0;1;1;2
292;23.11.2017;2017;11;03;Torstai;0;0;0;0;0;0
292;23.11.2017;2017;11;04;Torstai;1;0;1;0;0;0
292;23.11.2017;2017;11;05;Torstai;3;2;5;0;2;2
292;23.11.2017;2017;11;06;Torstai;9;6;15;3;11;14
292;23.11.2017;2017;11;07;Torstai;61;14;75;18;10;28
292;23.11.2017;2017;11;08;Torstai;43;10;53;18;18;36
292;23.11.2017;2017;11;09;Torstai;16;11;27;9;19;28
292;23.11.2017;2017;11;10;Torstai;19;14;33;13;16;29
292;23.11.2017;2017;11;11;Torstai;14;21;35;15;14;29
292;23.11.2017;2017;11;12;Torstai;9;16;25;10;13;23
292;23.11.2017;2017;11;13;Torstai;11;8;19;16;9;25
292;23.11.2017;2017;11;14;Torstai;25;24;49;12;26;38
292;23.11.2017;2017;11;15;Torstai;21;23;44;7;7;14
292;23.11.2017;2017;11;16;Torstai;18;13;31;11;5;16
292;23.11.2017;2017;11;17;Torstai;12;6;18;7;6;13
292;23.11.2017;2017;11;18;Torstai;7;10;17;4;8;12
292;23.11.2017;2017;11;19;Torstai;7;1;8;7;4;11
292;23.11.2017;2017;11;20;Torstai;10;2;12;1;3;4
292;23.11.2017;2017;11;21;Torstai;2;1;3;5;5;10
292;23.11.2017;2017;11;22;Torstai;3;0;3;1;0;1
292;23.11.2017;2017;11;23;Torstai;0;0;0;0;0;0
292;24.11.2017;2017;11;00;Perjantai;0;0;0;0;0;0
292;24.11.2017;2017;11;01;Perjantai;0;0;0;0;0;0
292;24.11.2017;2017;11;02;Perjantai;1;1;2;1;0;1
292;24.11.2017;2017;11;03;Perjantai;0;0;0;0;0;0
292;24.11.2017;2017;11;04;Perjantai;1;0;1;0;0;0
292;24.11.2017;2017;11;05;Perjantai;2;3;5;1;1;2
292;24.11.2017;2017;11;06;Perjantai;7;8;15;4;4;8
292;24.11.2017;2017;11;07;Perjantai;35;14;49;16;7;23
292;24.11.2017;2017;11;08;Perjantai;30;9;39;11;10;21
292;24.11.2017;2017;11;09;Perjantai;11;7;18;5;4;9
292;24.11.2017;2017;11;10;Perjantai;15;21;36;7;12;19
292;24.11.2017;2017;11;11;Perjantai;10;17;27;8;10;18
292;24.11.2017;2017;11;12;Perjantai;17;25;42;15;13;28
292;24.11.2017;2017;11;13;Perjantai;9;25;34;15;23;38
292;24.11.2017;2017;11;14;Perjantai;20;34;54;22;20;42
292;24.11.2017;2017;11;15;Perjantai;20;27;47;20;24;44
292;24.11.2017;2017;11;16;Perjantai;19;19;38;15;18;33
292;24.11.2017;2017;11;17;Perjantai;7;22;29;11;18;29
292;24.11.2017;2017;11;18;Perjantai;4;3;7;13;12;25
292;24.11.2017;2017;11;19;Perjantai;13;10;23;20;11;31
292;24.11.2017;2017;11;20;Perjantai;11;5;16;12;8;20
292;24.11.2017;2017;11;21;Perjantai;8;1;9;11;5;16
292;24.11.2017;2017;11;22;Perjantai;4;5;9;8;6;14
292;24.11.2017;2017;11;23;Perjantai;3;1;4;6;4;10
292;25.11.2017;2017;11;00;Lauantai;1;0;1;2;2;4
292;25.11.2017;2017;11;01;Lauantai;2;1;3;1;5;6
292;25.11.2017;2017;11;02;Lauantai;0;0;0;2;12;14
292;25.11.2017;2017;11;03;Lauantai;0;2;2;0;4;4
292;25.11.2017;2017;11;04;Lauantai;2;0;2;0;0;0
292;25.11.2017;2017;11;05;Lauantai;0;0;0;2;0;2
292;25.11.2017;2017;11;06;Lauantai;5;1;6;1;2;3
292;25.11.2017;2017;11;07;Lauantai;0;1;1;2;6;8
292;25.11.2017;2017;11;08;Lauantai;1;5;6;6;6;12
292;25.11.2017;2017;11;09;Lauantai;4;3;7;11;4;15
292;25.11.2017;2017;11;10;Lauantai;4;2;6;4;11;15
292;25.11.2017;2017;11;11;Lauantai;8;10;18;11;6;17
292;25.11.2017;2017;11;12;Lauantai;8;12;20;6;12;18
292;25.11.2017;2017;11;13;Lauantai;11;19;30;13;13;26
292;25.11.2017;2017;11;14;Lauantai;11;18;29;14;5;19
292;25.11.2017;2017;11;15;Lauantai;22;7;29;14;11;25
292;25.11.2017;2017;11;16;Lauantai;4;11;15;19;13;32
292;25.11.2017;2017;11;17;Lauantai;10;7;17;11;11;22
292;25.11.2017;2017;11;18;Lauantai;7;7;14;17;10;27
292;25.11.2017;2017;11;19;Lauantai;9;8;17;14;5;19
292;25.11.2017;2017;11;20;Lauantai;6;0;6;11;6;17
292;25.11.2017;2017;11;21;Lauantai;9;3;12;11;8;19
292;25.11.2017;2017;11;22;Lauantai;3;4;7;2;4;6
292;25.11.2017;2017;11;23;Lauantai;4;2;6;4;4;8
292;26.11.2017;2017;11;00;Sunnuntai;2;3;5;2;2;4
292;26.11.2017;2017;11;01;Sunnuntai;2;1;3;1;0;1
292;26.11.2017;2017;11;02;Sunnuntai;1;1;2;0;4;4
292;26.11.2017;2017;11;03;Sunnuntai;0;0;0;0;3;3
292;26.11.2017;2017;11;04;Sunnuntai;0;0;0;0;0;0
292;26.11.2017;2017;11;05;Sunnuntai;0;0;0;1;0;1
292;26.11.2017;2017;11;06;Sunnuntai;4;0;4;2;0;2
292;26.11.2017;2017;11;07;Sunnuntai;1;0;1;3;3;6
292;26.11.2017;2017;11;08;Sunnuntai;1;2;3;7;2;9
292;26.11.2017;2017;11;09;Sunnuntai;9;4;13;8;7;15
292;26.11.2017;2017;11;10;Sunnuntai;3;5;8;11;9;20
292;26.11.2017;2017;11;11;Sunnuntai;7;11;18;11;11;22
292;26.11.2017;2017;11;12;Sunnuntai;8;6;14;12;13;25
292;26.11.2017;2017;11;13;Sunnuntai;7;11;18;13;11;24
292;26.11.2017;2017;11;14;Sunnuntai;10;13;23;10;16;26
292;26.11.2017;2017;11;15;Sunnuntai;11;5;16;17;17;34
292;26.11.2017;2017;11;16;Sunnuntai;10;10;20;8;8;16
292;26.11.2017;2017;11;17;Sunnuntai;7;14;21;17;22;39
292;26.11.2017;2017;11;18;Sunnuntai;8;7;15;15;8;23
292;26.11.2017;2017;11;19;Sunnuntai;6;2;8;10;13;23
292;26.11.2017;2017;11;20;Sunnuntai;8;4;12;5;7;12
292;26.11.2017;2017;11;21;Sunnuntai;1;1;2;8;5;13
292;26.11.2017;2017;11;22;Sunnuntai;1;0;1;3;3;6
292;26.11.2017;2017;11;23;Sunnuntai;0;0;0;1;1;2
292;27.11.2017;2017;11;00;Maanantai;0;0;0;0;0;0
292;27.11.2017;2017;11;01;Maanantai;0;0;0;0;3;3
292;27.11.2017;2017;11;02;Maanantai;0;0;0;1;0;1
292;27.11.2017;2017;11;03;Maanantai;0;0;0;0;0;0
292;27.11.2017;2017;11;04;Maanantai;0;0;0;0;0;0
292;27.11.2017;2017;11;05;Maanantai;6;2;8;1;4;5
292;27.11.2017;2017;11;06;Maanantai;11;15;26;2;5;7
292;27.11.2017;2017;11;07;Maanantai;46;15;61;12;14;26
292;27.11.2017;2017;11;08;Maanantai;52;8;60;20;15;35
292;27.11.2017;2017;11;09;Maanantai;13;19;32;7;9;16
292;27.11.2017;2017;11;10;Maanantai;11;23;34;11;20;31
292;27.11.2017;2017;11;11;Maanantai;12;21;33;8;19;27
292;27.11.2017;2017;11;12;Maanantai;8;22;30;22;18;40
292;27.11.2017;2017;11;13;Maanantai;10;31;41;21;15;36
292;27.11.2017;2017;11;14;Maanantai;20;21;41;32;17;49
292;27.11.2017;2017;11;15;Maanantai;25;17;42;26;29;55
292;27.11.2017;2017;11;16;Maanantai;23;22;45;14;20;34
292;27.11.2017;2017;11;17;Maanantai;10;18;28;12;13;25
292;27.11.2017;2017;11;18;Maanantai;15;5;20;20;15;35
292;27.11.2017;2017;11;19;Maanantai;10;5;15;15;10;25
292;27.11.2017;2017;11;20;Maanantai;13;12;25;10;7;17
292;27.11.2017;2017;11;21;Maanantai;4;1;5;1;3;4
292;27.11.2017;2017;11;22;Maanantai;2;1;3;3;1;4
292;27.11.2017;2017;11;23;Maanantai;0;1;1;0;2;2
292;28.11.2017;2017;11;00;Tiistai;2;0;2;0;1;1
292;28.11.2017;2017;11;01;Tiistai;2;0;2;0;1;1
292;28.11.2017;2017;11;02;Tiistai;0;1;1;0;0;0
292;28.11.2017;2017;11;03;Tiistai;0;0;0;2;1;3
292;28.11.2017;2017;11;04;Tiistai;0;0;0;0;0;0
292;28.11.2017;2017;11;05;Tiistai;3;5;8;2;0;2
292;28.11.2017;2017;11;06;Tiistai;10;14;24;5;8;13
292;28.11.2017;2017;11;07;Tiistai;24;16;40;29;12;41
292;28.11.2017;2017;11;08;Tiistai;25;12;37;29;16;45
292;28.11.2017;2017;11;09;Tiistai;6;9;15;15;14;29
292;28.11.2017;2017;11;10;Tiistai;12;8;20;18;13;31
292;28.11.2017;2017;11;11;Tiistai;12;15;27;11;14;25
292;28.11.2017;2017;11;12;Tiistai;9;9;18;9;11;20
292;28.11.2017;2017;11;13;Tiistai;9;24;33;20;22;42
292;28.11.2017;2017;11;14;Tiistai;12;24;36;26;26;52
292;28.11.2017;2017;11;15;Tiistai;17;20;37;19;18;37
292;28.11.2017;2017;11;16;Tiistai;17;20;37;15;18;33
292;28.11.2017;2017;11;17;Tiistai;12;15;27;15;13;28
292;28.11.2017;2017;11;18;Tiistai;22;6;28;29;17;46
292;28.11.2017;2017;11;19;Tiistai;6;13;19;26;20;46
292;28.11.2017;2017;11;20;Tiistai;11;16;27;7;8;15
292;28.11.2017;2017;11;21;Tiistai;6;2;8;5;5;10
292;28.11.2017;2017;11;22;Tiistai;4;2;6;1;1;2
292;28.11.2017;2017;11;23;Tiistai;0;0;0;0;0;0
292;29.11.2017;2017;11;00;Keskiviikko;0;0;0;0;1;1
292;29.11.2017;2017;11;01;Keskiviikko;1;0;1;0;1;1
292;29.11.2017;2017;11;02;Keskiviikko;0;0;0;0;1;1
292;29.11.2017;2017;11;03;Keskiviikko;0;0;0;0;0;0
292;29.11.2017;2017;11;04;Keskiviikko;0;0;0;0;0;0
292;29.11.2017;2017;11;05;Keskiviikko;6;5;11;2;1;3
292;29.11.2017;2017;11;06;Keskiviikko;12;17;29;2;4;6
292;29.11.2017;2017;11;07;Keskiviikko;40;22;62;11;15;26
292;29.11.2017;2017;11;08;Keskiviikko;43;17;60;12;10;22
292;29.11.2017;2017;11;09;Keskiviikko;18;9;27;10;8;18
292;29.11.2017;2017;11;10;Keskiviikko;14;19;33;8;22;30
292;29.11.2017;2017;11;11;Keskiviikko;20;16;36;15;16;31
292;29.11.2017;2017;11;12;Keskiviikko;15;23;38;16;14;30
292;29.11.2017;2017;11;13;Keskiviikko;16;21;37;12;16;28
292;29.11.2017;2017;11;14;Keskiviikko;17;29;46;17;21;38
292;29.11.2017;2017;11;15;Keskiviikko;27;34;61;17;18;35
292;29.11.2017;2017;11;16;Keskiviikko;27;20;47;10;11;21
292;29.11.2017;2017;11;17;Keskiviikko;11;12;23;12;10;22
292;29.11.2017;2017;11;18;Keskiviikko;13;12;25;10;7;17
292;29.11.2017;2017;11;19;Keskiviikko;12;9;21;18;11;29
292;29.11.2017;2017;11;20;Keskiviikko;14;8;22;5;4;9
292;29.11.2017;2017;11;21;Keskiviikko;5;6;11;4;1;5
292;29.11.2017;2017;11;22;Keskiviikko;1;0;1;0;3;3
292;29.11.2017;2017;11;23;Keskiviikko;0;0;0;0;0;0
292;30.11.2017;2017;11;00;Torstai;0;0;0;0;0;0
292;30.11.2017;2017;11;01;Torstai;0;0;0;0;0;0
292;30.11.2017;2017;11;02;Torstai;1;1;2;1;1;2
292;30.11.2017;2017;11;03;Torstai;0;0;0;0;0;0
292;30.11.2017;2017;11;04;Torstai;2;0;2;0;0;0
292;30.11.2017;2017;11;05;Torstai;4;3;7;1;1;2
292;30.11.2017;2017;11;06;Torstai;18;18;36;3;5;8
292;30.11.2017;2017;11;07;Torstai;32;13;45;19;18;37
292;30.11.2017;2017;11;08;Torstai;31;15;46;16;14;30
292;30.11.2017;2017;11;09;Torstai;55;12;67;22;9;31
292;30.11.2017;2017;11;10;Torstai;14;7;21;11;7;18
292;30.11.2017;2017;11;11;Torstai;11;12;23;7;13;20
292;30.11.2017;2017;11;12;Torstai;8;9;17;16;9;25
292;30.11.2017;2017;11;13;Torstai;15;34;49;15;26;41
292;30.11.2017;2017;11;14;Torstai;30;17;47;52;16;68
292;30.11.2017;2017;11;15;Torstai;30;34;64;27;45;72
292;30.11.2017;2017;11;16;Torstai;26;45;71;13;20;33
292;30.11.2017;2017;11;17;Torstai;20;6;26;11;9;20
292;30.11.2017;2017;11;18;Torstai;13;16;29;10;18;28
292;30.11.2017;2017;11;19;Torstai;9;10;19;10;12;22
292;30.11.2017;2017;11;20;Torstai;10;6;16;8;4;12
292;30.11.2017;2017;11;21;Torstai;4;2;6;5;7;12
292;30.11.2017;2017;11;22;Torstai;1;1;2;2;0;2
292;30.11.2017;2017;11;23;Torstai;0;0;0;0;2;2
292;01.12.2017;2017;12;00;Perjantai;1;0;1;1;0;1
292;01.12.2017;2017;12;01;Perjantai;0;0;0;0;0;0
292;01.12.2017;2017;12;02;Perjantai;1;0;1;3;0;3
292;01.12.2017;2017;12;03;Perjantai;0;0;0;0;0;0
292;01.12.2017;2017;12;04;Perjantai;0;0;0;0;0;0
292;01.12.2017;2017;12;05;Perjantai;6;5;11;1;1;2
292;01.12.2017;2017;12;06;Perjantai;10;6;16;6;7;13
292;01.12.2017;2017;12;07;Perjantai;50;23;73;11;11;22
292;01.12.2017;2017;12;08;Perjantai;50;22;72;7;12;19
292;01.12.2017;2017;12;09;Perjantai;24;12;36;6;9;15
292;01.12.2017;2017;12;10;Perjantai;21;13;34;6;5;11
292;01.12.2017;2017;12;11;Perjantai;12;12;24;13;9;22
292;01.12.2017;2017;12;12;Perjantai;25;20;45;19;17;36
292;01.12.2017;2017;12;13;Perjantai;15;44;59;12;18;30
292;01.12.2017;2017;12;14;Perjantai;29;38;67;15;26;41
292;01.12.2017;2017;12;15;Perjantai;24;19;43;18;26;44
292;01.12.2017;2017;12;16;Perjantai;13;13;26;10;16;26
292;01.12.2017;2017;12;17;Perjantai;18;13;31;16;21;37
292;01.12.2017;2017;12;18;Perjantai;12;8;20;12;16;28
292;01.12.2017;2017;12;19;Perjantai;7;10;17;14;11;25
292;01.12.2017;2017;12;20;Perjantai;6;3;9;14;12;26
292;01.12.2017;2017;12;21;Perjantai;7;3;10;9;7;16
292;01.12.2017;2017;12;22;Perjantai;7;2;9;5;4;9
292;01.12.2017;2017;12;23;Perjantai;4;3;7;11;9;20
292;02.12.2017;2017;12;00;Lauantai;3;2;5;2;4;6
292;02.12.2017;2017;12;01;Lauantai;2;2;4;5;2;7
292;02.12.2017;2017;12;02;Lauantai;1;0;1;1;13;14
292;02.12.2017;2017;12;03;Lauantai;0;0;0;1;1;2
292;02.12.2017;2017;12;04;Lauantai;0;0;0;0;0;0
292;02.12.2017;2017;12;05;Lauantai;1;0;1;2;1;3
292;02.12.2017;2017;12;06;Lauantai;1;1;2;0;1;1
292;02.12.2017;2017;12;07;Lauantai;1;0;1;6;7;13
292;02.12.2017;2017;12;08;Lauantai;2;3;5;4;6;10
292;02.12.2017;2017;12;09;Lauantai;2;3;5;6;9;15
292;02.12.2017;2017;12;10;Lauantai;7;4;11;8;15;23
292;02.12.2017;2017;12;11;Lauantai;8;13;21;18;12;30
292;02.12.2017;2017;12;12;Lauantai;17;10;27;10;14;24
292;02.12.2017;2017;12;13;Lauantai;16;9;25;9;9;18
292;02.12.2017;2017;12;14;Lauantai;18;10;28;9;10;19
292;02.12.2017;2017;12;15;Lauantai;23;18;41;9;17;26
292;02.12.2017;2017;12;16;Lauantai;21;8;29;14;7;21
292;02.12.2017;2017;12;17;Lauantai;7;5;12;10;13;23
292;02.12.2017;2017;12;18;Lauantai;10;9;19;10;7;17
292;02.12.2017;2017;12;19;Lauantai;10;4;14;7;15;22
292;02.12.2017;2017;12;20;Lauantai;12;5;17;5;5;10
292;02.12.2017;2017;12;21;Lauantai;6;4;10;6;14;20
292;02.12.2017;2017;12;22;Lauantai;7;5;12;5;4;9
292;02.12.2017;2017;12;23;Lauantai;5;3;8;1;2;3
292;03.12.2017;2017;12;00;Sunnuntai;1;0;1;3;2;5
292;03.12.2017;2017;12;01;Sunnuntai;2;2;4;2;2;4
292;03.12.2017;2017;12;02;Sunnuntai;1;4;5;1;5;6
292;03.12.2017;2017;12;03;Sunnuntai;0;0;0;0;0;0
292;03.12.2017;2017;12;04;Sunnuntai;1;0;1;2;1;3
292;03.12.2017;2017;12;05;Sunnuntai;0;0;0;3;0;3
292;03.12.2017;2017;12;06;Sunnuntai;2;0;2;0;2;2
292;03.12.2017;2017;12;07;Sunnuntai;1;2;3;2;1;3
292;03.12.2017;2017;12;08;Sunnuntai;3;0;3;6;3;9
292;03.12.2017;2017;12;09;Sunnuntai;5;3;8;9;8;17
292;03.12.2017;2017;12;10;Sunnuntai;8;6;14;11;12;23
292;03.12.2017;2017;12;11;Sunnuntai;8;15;23;13;14;27
292;03.12.2017;2017;12;12;Sunnuntai;5;11;16;15;16;31
292;03.12.2017;2017;12;13;Sunnuntai;9;10;19;16;18;34
292;03.12.2017;2017;12;14;Sunnuntai;6;12;18;19;11;30
292;03.12.2017;2017;12;15;Sunnuntai;11;13;24;19;8;27
292;03.12.2017;2017;12;16;Sunnuntai;4;3;7;11;9;20
292;03.12.2017;2017;12;17;Sunnuntai;13;9;22;14;5;19
292;03.12.2017;2017;12;18;Sunnuntai;7;14;21;12;18;30
292;03.12.2017;2017;12;19;Sunnuntai;6;1;7;10;6;16
292;03.12.2017;2017;12;20;Sunnuntai;2;3;5;10;11;21
292;03.12.2017;2017;12;21;Sunnuntai;0;3;3;2;6;8
292;03.12.2017;2017;12;22;Sunnuntai;1;1;2;1;0;1
292;03.12.2017;2017;12;23;Sunnuntai;1;0;1;0;0;0
292;04.12.2017;2017;12;00;Maanantai;0;0;0;1;1;2
292;04.12.2017;2017;12;01;Maanantai;0;0;0;0;0;0
292;04.12.2017;2017;12;02;Maanantai;0;0;0;0;0;0
292;04.12.2017;2017;12;03;Maanantai;0;0;0;0;0;0
292;04.12.2017;2017;12;04;Maanantai;0;0;0;0;0;0
292;04.12.2017;2017;12;05;Maanantai;4;5;9;0;0;0
292;04.12.2017;2017;12;06;Maanantai;7;10;17;5;3;8
292;04.12.2017;2017;12;07;Maanantai;34;21;55;9;13;22
292;04.12.2017;2017;12;08;Maanantai;31;16;47;17;9;26
292;04.12.2017;2017;12;09;Maanantai;38;15;53;18;8;26
292;04.12.2017;2017;12;10;Maanantai;14;8;22;19;15;34
292;04.12.2017;2017;12;11;Maanantai;10;11;21;20;18;38
292;04.12.2017;2017;12;12;Maanantai;12;13;25;14;24;38
292;04.12.2017;2017;12;13;Maanantai;11;27;38;28;18;46
292;04.12.2017;2017;12;14;Maanantai;12;40;52;23;20;43
292;04.12.2017;2017;12;15;Maanantai;17;37;54;26;27;53
292;04.12.2017;2017;12;16;Maanantai;18;38;56;21;28;49
292;04.12.2017;2017;12;17;Maanantai;8;24;32;17;12;29
292;04.12.2017;2017;12;18;Maanantai;11;14;25;9;14;23
292;04.12.2017;2017;12;19;Maanantai;8;6;14;11;10;21
292;04.12.2017;2017;12;20;Maanantai;9;2;11;11;4;15
292;04.12.2017;2017;12;21;Maanantai;1;1;2;3;0;3
292;04.12.2017;2017;12;22;Maanantai;1;0;1;2;2;4
292;04.12.2017;2017;12;23;Maanantai;0;0;0;1;0;1
292;05.12.2017;2017;12;00;Tiistai;0;0;0;1;2;3
292;05.12.2017;2017;12;01;Tiistai;0;0;0;0;2;2
292;05.12.2017;2017;12;02;Tiistai;0;0;0;0;0;0
292;05.12.2017;2017;12;03;Tiistai;0;0;0;0;0;0
292;05.12.2017;2017;12;04;Tiistai;1;0;1;0;0;0
292;05.12.2017;2017;12;05;Tiistai;4;2;6;2;2;4
292;05.12.2017;2017;12;06;Tiistai;12;12;24;4;4;8
292;05.12.2017;2017;12;07;Tiistai;34;12;46;17;16;33
292;05.12.2017;2017;12;08;Tiistai;33;14;47;17;21;38
292;05.12.2017;2017;12;09;Tiistai;20;7;27;12;10;22
292;05.12.2017;2017;12;10;Tiistai;14;15;29;8;14;22
292;05.12.2017;2017;12;11;Tiistai;6;11;17;10;8;18
292;05.12.2017;2017;12;12;Tiistai;11;14;25;10;16;26
292;05.12.2017;2017;12;13;Tiistai;12;18;30;14;18;32
292;05.12.2017;2017;12;14;Tiistai;13;44;57;25;32;57
292;05.12.2017;2017;12;15;Tiistai;26;26;52;12;14;26
292;05.12.2017;2017;12;16;Tiistai;19;15;34;20;17;37
292;05.12.2017;2017;12;17;Tiistai;18;16;34;22;11;33
292;05.12.2017;2017;12;18;Tiistai;9;8;17;9;17;26
292;05.12.2017;2017;12;19;Tiistai;16;10;26;14;10;24
292;05.12.2017;2017;12;20;Tiistai;14;4;18;9;10;19
292;05.12.2017;2017;12;21;Tiistai;10;2;12;7;3;10
292;05.12.2017;2017;12;22;Tiistai;5;7;12;1;4;5
292;05.12.2017;2017;12;23;Tiistai;1;7;8;3;3;6
292;06.12.2017;2017;12;00;Keskiviikko;1;1;2;3;2;5
292;06.12.2017;2017;12;01;Keskiviikko;1;2;3;0;3;3
292;06.12.2017;2017;12;02;Keskiviikko;0;3;3;1;6;7
292;06.12.2017;2017;12;03;Keskiviikko;0;3;3;0;3;3
292;06.12.2017;2017;12;04;Keskiviikko;0;0;0;1;0;1
292;06.12.2017;2017;12;05;Keskiviikko;1;0;1;0;0;0
292;06.12.2017;2017;12;06;Keskiviikko;1;3;4;2;1;3
292;06.12.2017;2017;12;07;Keskiviikko;1;2;3;1;4;5
292;06.12.2017;2017;12;08;Keskiviikko;2;4;6;5;1;6
292;06.12.2017;2017;12;09;Keskiviikko;4;6;10;8;11;19
292;06.12.2017;2017;12;10;Keskiviikko;4;5;9;9;13;22
292;06.12.2017;2017;12;11;Keskiviikko;7;10;17;19;11;30
292;06.12.2017;2017;12;12;Keskiviikko;9;7;16;13;17;30
292;06.12.2017;2017;12;13;Keskiviikko;5;10;15;12;11;23
292;06.12.2017;2017;12;14;Keskiviikko;15;6;21;19;9;28
292;06.12.2017;2017;12;15;Keskiviikko;11;9;20;10;8;18
292;06.12.2017;2017;12;16;Keskiviikko;17;8;25;8;9;17
292;06.12.2017;2017;12;17;Keskiviikko;3;3;6;16;20;36
292;06.12.2017;2017;12;18;Keskiviikko;7;9;16;9;7;16
292;06.12.2017;2017;12;19;Keskiviikko;5;5;10;3;6;9
292;06.12.2017;2017;12;20;Keskiviikko;2;4;6;3;6;9
292;06.12.2017;2017;12;21;Keskiviikko;6;3;9;3;2;5
292;06.12.2017;2017;12;22;Keskiviikko;2;0;2;0;0;0
292;06.12.2017;2017;12;23;Keskiviikko;0;1;1;0;1;1
292;07.12.2017;2017;12;00;Torstai;1;1;2;0;0;0
292;07.12.2017;2017;12;01;Torstai;0;1;1;0;1;1
292;07.12.2017;2017;12;02;Torstai;0;0;0;0;0;0
292;07.12.2017;2017;12;03;Torstai;0;0;0;0;0;0
292;07.12.2017;2017;12;04;Torstai;0;0;0;0;0;0
292;07.12.2017;2017;12;05;Torstai;4;3;7;1;1;2
292;07.12.2017;2017;12;06;Torstai;8;9;17;3;6;9
292;07.12.2017;2017;12;07;Torstai;30;21;51;17;12;29
292;07.12.2017;2017;12;08;Torstai;25;17;42;15;15;30
292;07.12.2017;2017;12;09;Torstai;42;10;52;10;7;17
292;07.12.2017;2017;12;10;Torstai;14;14;28;14;12;26
292;07.12.2017;2017;12;11;Torstai;11;8;19;16;10;26
292;07.12.2017;2017;12;12;Torstai;12;14;26;12;9;21
292;07.12.2017;2017;12;13;Torstai;19;17;36;18;9;27
292;07.12.2017;2017;12;14;Torstai;26;28;54;23;19;42
292;07.12.2017;2017;12;15;Torstai;24;36;60;17;17;34
292;07.12.2017;2017;12;16;Torstai;22;27;49;17;23;40
292;07.12.2017;2017;12;17;Torstai;16;8;24;7;12;19
292;07.12.2017;2017;12;18;Torstai;12;9;21;11;15;26
292;07.12.2017;2017;12;19;Torstai;8;5;13;10;5;15
292;07.12.2017;2017;12;20;Torstai;10;4;14;7;3;10
292;07.12.2017;2017;12;21;Torstai;5;1;6;3;2;5
292;07.12.2017;2017;12;22;Torstai;2;1;3;1;1;2
292;07.12.2017;2017;12;23;Torstai;1;0;1;0;1;1
292;08.12.2017;2017;12;00;Perjantai;1;0;1;0;2;2
292;08.12.2017;2017;12;01;Perjantai;0;0;0;0;0;0
292;08.12.2017;2017;12;02;Perjantai;0;0;0;0;0;0
292;08.12.2017;2017;12;03;Perjantai;1;0;1;2;2;4
292;08.12.2017;2017;12;04;Perjantai;0;0;0;0;1;1
292;08.12.2017;2017;12;05;Perjantai;4;5;9;1;1;2
292;08.12.2017;2017;12;06;Perjantai;8;5;13;3;7;10
292;08.12.2017;2017;12;07;Perjantai;34;11;45;12;12;24
292;08.12.2017;2017;12;08;Perjantai;35;11;46;13;5;18
292;08.12.2017;2017;12;09;Perjantai;19;5;24;9;8;17
292;08.12.2017;2017;12;10;Perjantai;8;4;12;7;11;18
292;08.12.2017;2017;12;11;Perjantai;9;2;11;7;9;16
292;08.12.2017;2017;12;12;Perjantai;12;12;24;11;11;22
292;08.12.2017;2017;12;13;Perjantai;11;27;38;12;12;24
292;08.12.2017;2017;12;14;Perjantai;14;25;39;16;22;38
292;08.12.2017;2017;12;15;Perjantai;10;6;16;10;11;21
292;08.12.2017;2017;12;16;Perjantai;8;15;23;12;8;20
292;08.12.2017;2017;12;17;Perjantai;12;11;23;7;8;15
292;08.12.2017;2017;12;18;Perjantai;5;7;12;12;19;31
292;08.12.2017;2017;12;19;Perjantai;4;4;8;12;10;22
292;08.12.2017;2017;12;20;Perjantai;8;0;8;7;5;12
292;08.12.2017;2017;12;21;Perjantai;5;2;7;8;5;13
292;08.12.2017;2017;12;22;Perjantai;5;4;9;2;8;10
292;08.12.2017;2017;12;23;Perjantai;2;1;3;8;3;11
292;09.12.2017;2017;12;00;Lauantai;1;2;3;0;1;1
292;09.12.2017;2017;12;01;Lauantai;0;1;1;2;3;5
292;09.12.2017;2017;12;02;Lauantai;1;1;2;0;2;2
292;09.12.2017;2017;12;03;Lauantai;0;1;1;3;5;8
292;09.12.2017;2017;12;04;Lauantai;0;0;0;3;0;3
292;09.12.2017;2017;12;05;Lauantai;0;0;0;0;0;0
292;09.12.2017;2017;12;06;Lauantai;2;2;4;0;3;3
292;09.12.2017;2017;12;07;Lauantai;0;0;0;5;4;9
292;09.12.2017;2017;12;08;Lauantai;3;6;9;6;6;12
292;09.12.2017;2017;12;09;Lauantai;3;9;12;9;9;18
292;09.12.2017;2017;12;10;Lauantai;3;11;14;8;8;16
292;09.12.2017;2017;12;11;Lauantai;8;5;13;20;13;33
292;09.12.2017;2017;12;12;Lauantai;11;17;28;14;19;33
292;09.12.2017;2017;12;13;Lauantai;14;14;28;13;16;29
292;09.12.2017;2017;12;14;Lauantai;10;6;16;19;19;38
292;09.12.2017;2017;12;15;Lauantai;13;10;23;8;14;22
292;09.12.2017;2017;12;16;Lauantai;7;8;15;13;14;27
292;09.12.2017;2017;12;17;Lauantai;11;2;13;13;4;17
292;09.12.2017;2017;12;18;Lauantai;7;4;11;9;12;21
292;09.12.2017;2017;12;19;Lauantai;9;1;10;3;9;12
292;09.12.2017;2017;12;20;Lauantai;4;2;6;6;8;14
292;09.12.2017;2017;12;21;Lauantai;2;2;4;7;9;16
292;09.12.2017;2017;12;22;Lauantai;5;2;7;3;2;5
292;09.12.2017;2017;12;23;Lauantai;2;2;4;6;5;11
292;10.12.2017;2017;12;00;Sunnuntai;2;1;3;0;2;2
292;10.12.2017;2017;12;01;Sunnuntai;2;0;2;0;5;5
292;10.12.2017;2017;12;02;Sunnuntai;1;0;1;1;1;2
292;10.12.2017;2017;12;03;Sunnuntai;0;0;0;1;1;2
292;10.12.2017;2017;12;04;Sunnuntai;0;0;0;1;0;1
292;10.12.2017;2017;12;05;Sunnuntai;1;0;1;1;0;1
292;10.12.2017;2017;12;06;Sunnuntai;2;0;2;0;2;2
292;10.12.2017;2017;12;07;Sunnuntai;0;0;0;1;3;4
292;10.12.2017;2017;12;08;Sunnuntai;1;1;2;6;2;8
292;10.12.2017;2017;12;09;Sunnuntai;3;8;11;3;5;8
292;10.12.2017;2017;12;10;Sunnuntai;1;4;5;11;12;23
292;10.12.2017;2017;12;11;Sunnuntai;8;4;12;8;11;19
292;10.12.2017;2017;12;12;Sunnuntai;14;7;21;15;15;30
292;10.12.2017;2017;12;13;Sunnuntai;8;12;20;12;8;20
292;10.12.2017;2017;12;14;Sunnuntai;8;20;28;11;10;21
292;10.12.2017;2017;12;15;Sunnuntai;29;5;34;15;4;19
292;10.12.2017;2017;12;16;Sunnuntai;9;3;12;14;8;22
292;10.12.2017;2017;12;17;Sunnuntai;11;18;29;15;23;38
292;10.12.2017;2017;12;18;Sunnuntai;7;7;14;13;16;29
292;10.12.2017;2017;12;19;Sunnuntai;3;3;6;4;8;12
292;10.12.2017;2017;12;20;Sunnuntai;3;1;4;4;9;13
292;10.12.2017;2017;12;21;Sunnuntai;1;1;2;5;3;8
292;10.12.2017;2017;12;22;Sunnuntai;0;2;2;0;0;0
292;10.12.2017;2017;12;23;Sunnuntai;0;0;0;1;0;1
292;11.12.2017;2017;12;00;Maanantai;0;1;1;0;1;1
292;11.12.2017;2017;12;01;Maanantai;1;0;1;0;0;0
292;11.12.2017;2017;12;02;Maanantai;0;0;0;0;1;1
292;11.12.2017;2017;12;03;Maanantai;0;0;0;0;0;0
292;11.12.2017;2017;12;04;Maanantai;1;0;1;0;0;0
292;11.12.2017;2017;12;05;Maanantai;6;6;12;2;1;3
292;11.12.2017;2017;12;06;Maanantai;8;14;22;4;6;10
292;11.12.2017;2017;12;07;Maanantai;34;18;52;18;12;30
292;11.12.2017;2017;12;08;Maanantai;24;14;38;25;13;38
292;11.12.2017;2017;12;09;Maanantai;42;15;57;18;13;31
292;11.12.2017;2017;12;10;Maanantai;7;8;15;15;11;26
292;11.12.2017;2017;12;11;Maanantai;11;7;18;6;9;15
292;11.12.2017;2017;12;12;Maanantai;11;17;28;21;19;40
292;11.12.2017;2017;12;13;Maanantai;11;27;38;18;15;33
292;11.12.2017;2017;12;14;Maanantai;16;35;51;26;18;44
292;11.12.2017;2017;12;15;Maanantai;24;35;59;26;26;52
292;11.12.2017;2017;12;16;Maanantai;18;44;62;17;30;47
292;11.12.2017;2017;12;17;Maanantai;14;16;30;14;18;32
292;11.12.2017;2017;12;18;Maanantai;15;6;21;16;17;33
292;11.12.2017;2017;12;19;Maanantai;14;9;23;14;18;32
292;11.12.2017;2017;12;20;Maanantai;11;7;18;6;9;15
292;11.12.2017;2017;12;21;Maanantai;2;3;5;4;0;4
292;11.12.2017;2017;12;22;Maanantai;2;1;3;1;0;1
292;11.12.2017;2017;12;23;Maanantai;2;2;4;1;3;4
292;12.12.2017;2017;12;00;Tiistai;0;0;0;0;1;1
292;12.12.2017;2017;12;01;Tiistai;0;1;1;0;0;0
292;12.12.2017;2017;12;02;Tiistai;0;1;1;0;1;1
292;12.12.2017;2017;12;03;Tiistai;0;0;0;0;0;0
292;12.12.2017;2017;12;04;Tiistai;2;0;2;0;0;0
292;12.12.2017;2017;12;05;Tiistai;1;4;5;4;0;4
292;12.12.2017;2017;12;06;Tiistai;8;12;20;7;11;18
292;12.12.2017;2017;12;07;Tiistai;38;17;55;20;12;32
292;12.12.2017;2017;12;08;Tiistai;42;11;53;21;14;35
292;12.12.2017;2017;12;09;Tiistai;19;14;33;15;11;26
292;12.12.2017;2017;12;10;Tiistai;15;8;23;13;10;23
292;12.12.2017;2017;12;11;Tiistai;11;13;24;23;17;40
292;12.12.2017;2017;12;12;Tiistai;16;6;22;19;9;28
292;12.12.2017;2017;12;13;Tiistai;18;23;41;19;13;32
292;12.12.2017;2017;12;14;Tiistai;16;39;55;12;13;25
292;12.12.2017;2017;12;15;Tiistai;20;31;51;18;17;35
292;12.12.2017;2017;12;16;Tiistai;22;26;48;13;20;33
292;12.12.2017;2017;12;17;Tiistai;13;9;22;8;11;19
292;12.12.2017;2017;12;18;Tiistai;6;4;10;4;9;13
292;12.12.2017;2017;12;19;Tiistai;14;6;20;10;11;21
292;12.12.2017;2017;12;20;Tiistai;13;0;13;9;9;18
292;12.12.2017;2017;12;21;Tiistai;2;2;4;2;2;4
292;12.12.2017;2017;12;22;Tiistai;1;1;2;3;1;4
292;12.12.2017;2017;12;23;Tiistai;2;1;3;0;0;0
292;13.12.2017;2017;12;00;Keskiviikko;0;0;0;0;1;1
292;13.12.2017;2017;12;01;Keskiviikko;0;0;0;0;0;0
292;13.12.2017;2017;12;02;Keskiviikko;1;0;1;1;2;3
292;13.12.2017;2017;12;03;Keskiviikko;0;0;0;0;0;0
292;13.12.2017;2017;12;04;Keskiviikko;1;1;2;0;0;0
292;13.12.2017;2017;12;05;Keskiviikko;4;2;6;1;0;1
292;13.12.2017;2017;12;06;Keskiviikko;11;15;26;7;7;14
292;13.12.2017;2017;12;07;Keskiviikko;24;15;39;20;10;30
292;13.12.2017;2017;12;08;Keskiviikko;42;15;57;9;14;23
292;13.12.2017;2017;12;09;Keskiviikko;25;7;32;7;13;20
292;13.12.2017;2017;12;10;Keskiviikko;15;11;26;9;5;14
292;13.12.2017;2017;12;11;Keskiviikko;10;13;23;16;10;26
292;13.12.2017;2017;12;12;Keskiviikko;7;9;16;8;15;23
292;13.12.2017;2017;12;13;Keskiviikko;9;29;38;13;18;31
292;13.12.2017;2017;12;14;Keskiviikko;8;34;42;19;11;30
292;13.12.2017;2017;12;15;Keskiviikko;22;32;54;19;23;42
292;13.12.2017;2017;12;16;Keskiviikko;20;30;50;13;26;39
292;13.12.2017;2017;12;17;Keskiviikko;10;17;27;17;4;21
292;13.12.2017;2017;12;18;Keskiviikko;11;9;20;12;16;28
292;13.12.2017;2017;12;19;Keskiviikko;8;7;15;10;5;15
292;13.12.2017;2017;12;20;Keskiviikko;11;6;17;14;5;19
292;13.12.2017;2017;12;21;Keskiviikko;5;4;9;1;3;4
292;13.12.2017;2017;12;22;Keskiviikko;1;1;2;0;0;0
292;13.12.2017;2017;12;23;Keskiviikko;1;0;1;0;0;0
292;14.12.2017;2017;12;00;Torstai;1;1;2;0;1;1
292;14.12.2017;2017;12;01;Torstai;0;1;1;0;0;0
292;14.12.2017;2017;12;02;Torstai;0;0;0;0;0;0
292;14.12.2017;2017;12;03;Torstai;0;0;0;0;0;0
292;14.12.2017;2017;12;04;Torstai;0;0;0;0;0;0
292;14.12.2017;2017;12;05;Torstai;4;6;10;2;1;3
292;14.12.2017;2017;12;06;Torstai;14;9;23;5;7;12
292;14.12.2017;2017;12;07;Torstai;36;20;56;16;11;27
292;14.12.2017;2017;12;08;Torstai;31;17;48;17;11;28
292;14.12.2017;2017;12;09;Torstai;48;14;62;16;6;22
292;14.12.2017;2017;12;10;Torstai;14;12;26;10;12;22
292;14.12.2017;2017;12;11;Torstai;14;8;22;17;7;24
292;14.12.2017;2017;12;12;Torstai;9;9;18;5;14;19
292;14.12.2017;2017;12;13;Torstai;20;17;37;15;11;26
292;14.12.2017;2017;12;14;Torstai;14;21;35;15;9;24
292;14.12.2017;2017;12;15;Torstai;15;52;67;15;11;26
292;14.12.2017;2017;12;16;Torstai;25;39;64;9;13;22
292;14.12.2017;2017;12;17;Torstai;9;16;25;11;12;23
292;14.12.2017;2017;12;18;Torstai;11;14;25;14;10;24
292;14.12.2017;2017;12;19;Torstai;16;12;28;10;10;20
292;14.12.2017;2017;12;20;Torstai;7;4;11;8;5;13
292;14.12.2017;2017;12;21;Torstai;8;1;9;3;6;9
292;14.12.2017;2017;12;22;Torstai;0;3;3;1;0;1
292;14.12.2017;2017;12;23;Torstai;0;0;0;0;1;1
292;15.12.2017;2017;12;00;Perjantai;0;0;0;0;0;0
292;15.12.2017;2017;12;01;Perjantai;2;0;2;0;1;1
292;15.12.2017;2017;12;02;Perjantai;0;0;0;0;0;0
292;15.12.2017;2017;12;03;Perjantai;2;1;3;2;0;2
292;15.12.2017;2017;12;04;Perjantai;0;0;0;0;0;0
292;15.12.2017;2017;12;05;Perjantai;3;8;11;2;1;3
292;15.12.2017;2017;12;06;Perjantai;18;8;26;4;9;13
292;15.12.2017;2017;12;07;Perjantai;48;21;69;12;11;23
292;15.12.2017;2017;12;08;Perjantai;49;14;63;14;17;31
292;15.12.2017;2017;12;09;Perjantai;14;9;23;5;9;14
292;15.12.2017;2017;12;10;Perjantai;16;11;27;6;8;14
292;15.12.2017;2017;12;11;Perjantai;22;12;34;12;14;26
292;15.12.2017;2017;12;12;Perjantai;19;16;35;18;16;34
292;15.12.2017;2017;12;13;Perjantai;18;53;71;9;14;23
292;15.12.2017;2017;12;14;Perjantai;21;33;54;14;19;33
292;15.12.2017;2017;12;15;Perjantai;21;25;46;12;15;27
292;15.12.2017;2017;12;16;Perjantai;25;30;55;11;13;24
292;15.12.2017;2017;12;17;Perjantai;13;12;25;13;11;24
292;15.12.2017;2017;12;18;Perjantai;7;12;19;18;12;30
292;15.12.2017;2017;12;19;Perjantai;12;11;23;21;13;34
292;15.12.2017;2017;12;20;Perjantai;10;8;18;8;6;14
292;15.12.2017;2017;12;21;Perjantai;3;1;4;11;6;17
292;15.12.2017;2017;12;22;Perjantai;6;4;10;4;4;8
292;15.12.2017;2017;12;23;Perjantai;3;2;5;3;0;3
292;16.12.2017;2017;12;00;Lauantai;1;2;3;1;2;3
292;16.12.2017;2017;12;01;Lauantai;2;0;2;1;4;5
292;16.12.2017;2017;12;02;Lauantai;0;2;2;0;5;5
292;16.12.2017;2017;12;03;Lauantai;1;1;2;0;2;2
292;16.12.2017;2017;12;04;Lauantai;0;0;0;0;0;0
292;16.12.2017;2017;12;05;Lauantai;0;0;0;0;0;0
292;16.12.2017;2017;12;06;Lauantai;2;0;2;2;1;3
292;16.12.2017;2017;12;07;Lauantai;3;4;7;1;1;2
292;16.12.2017;2017;12;08;Lauantai;2;6;8;9;7;16
292;16.12.2017;2017;12;09;Lauantai;9;7;16;6;8;14
292;16.12.2017;2017;12;10;Lauantai;6;10;16;12;15;27
292;16.12.2017;2017;12;11;Lauantai;12;13;25;14;13;27
292;16.12.2017;2017;12;12;Lauantai;8;8;16;16;12;28
292;16.12.2017;2017;12;13;Lauantai;9;10;19;14;18;32
292;16.12.2017;2017;12;14;Lauantai;12;9;21;11;12;23
292;16.12.2017;2017;12;15;Lauantai;8;16;24;11;4;15
292;16.12.2017;2017;12;16;Lauantai;9;13;22;8;19;27
292;16.12.2017;2017;12;17;Lauantai;9;4;13;13;6;19
292;16.12.2017;2017;12;18;Lauantai;9;6;15;14;17;31
292;16.12.2017;2017;12;19;Lauantai;5;3;8;8;12;20
292;16.12.2017;2017;12;20;Lauantai;6;7;13;5;10;15
292;16.12.2017;2017;12;21;Lauantai;4;3;7;3;2;5
292;16.12.2017;2017;12;22;Lauantai;4;2;6;6;4;10
292;16.12.2017;2017;12;23;Lauantai;1;1;2;6;1;7
292;17.12.2017;2017;12;00;Sunnuntai;1;1;2;3;2;5
292;17.12.2017;2017;12;01;Sunnuntai;2;0;2;4;4;8
292;17.12.2017;2017;12;02;Sunnuntai;0;1;1;1;6;7
292;17.12.2017;2017;12;03;Sunnuntai;0;0;0;0;3;3
292;17.12.2017;2017;12;04;Sunnuntai;0;0;0;0;2;2
292;17.12.2017;2017;12;05;Sunnuntai;0;1;1;1;0;1
292;17.12.2017;2017;12;06;Sunnuntai;3;0;3;0;1;1
292;17.12.2017;2017;12;07;Sunnuntai;3;0;3;4;6;10
292;17.12.2017;2017;12;08;Sunnuntai;2;7;9;8;1;9
292;17.12.2017;2017;12;09;Sunnuntai;6;6;12;9;13;22
292;17.12.2017;2017;12;10;Sunnuntai;3;4;7;8;9;17
292;17.12.2017;2017;12;11;Sunnuntai;10;14;24;11;20;31
292;17.12.2017;2017;12;12;Sunnuntai;7;10;17;12;12;24
292;17.12.2017;2017;12;13;Sunnuntai;7;9;16;8;12;20
292;17.12.2017;2017;12;14;Sunnuntai;10;11;21;15;4;19
292;17.12.2017;2017;12;15;Sunnuntai;11;12;23;33;9;42
292;17.12.2017;2017;12;16;Sunnuntai;4;4;8;6;11;17
292;17.12.2017;2017;12;17;Sunnuntai;13;9;22;17;10;27
292;17.12.2017;2017;12;18;Sunnuntai;11;7;18;20;11;31
292;17.12.2017;2017;12;19;Sunnuntai;10;7;17;12;12;24
292;17.12.2017;2017;12;20;Sunnuntai;5;6;11;15;9;24
292;17.12.2017;2017;12;21;Sunnuntai;3;3;6;0;3;3
292;17.12.2017;2017;12;22;Sunnuntai;1;2;3;0;4;4
292;17.12.2017;2017;12;23;Sunnuntai;2;0;2;1;0;1
292;18.12.2017;2017;12;00;Maanantai;0;1;1;0;0;0
292;18.12.2017;2017;12;01;Maanantai;0;1;1;0;1;1
292;18.12.2017;2017;12;02;Maanantai;0;1;1;0;0;0
292;18.12.2017;2017;12;03;Maanantai;0;0;0;0;0;0
292;18.12.2017;2017;12;04;Maanantai;0;0;0;1;1;2
292;18.12.2017;2017;12;05;Maanantai;3;4;7;4;1;5
292;18.12.2017;2017;12;06;Maanantai;10;12;22;5;4;9
292;18.12.2017;2017;12;07;Maanantai;45;16;61;15;13;28
292;18.12.2017;2017;12;08;Maanantai;27;12;39;16;11;27
292;18.12.2017;2017;12;09;Maanantai;45;14;59;12;13;25
292;18.12.2017;2017;12;10;Maanantai;15;11;26;6;10;16
292;18.12.2017;2017;12;11;Maanantai;16;6;22;10;10;20
292;18.12.2017;2017;12;12;Maanantai;15;20;35;8;22;30
292;18.12.2017;2017;12;13;Maanantai;13;21;34;13;19;32
292;18.12.2017;2017;12;14;Maanantai;17;30;47;12;15;27
292;18.12.2017;2017;12;15;Maanantai;28;46;74;21;26;47
292;18.12.2017;2017;12;16;Maanantai;21;41;62;26;25;51
292;18.12.2017;2017;12;17;Maanantai;17;16;33;23;14;37
292;18.12.2017;2017;12;18;Maanantai;14;11;25;17;17;34
292;18.12.2017;2017;12;19;Maanantai;12;7;19;15;13;28
292;18.12.2017;2017;12;20;Maanantai;8;6;14;8;8;16
292;18.12.2017;2017;12;21;Maanantai;6;2;8;6;9;15
292;18.12.2017;2017;12;22;Maanantai;2;1;3;1;1;2
292;18.12.2017;2017;12;23;Maanantai;0;0;0;0;2;2
292;19.12.2017;2017;12;00;Tiistai;0;0;0;0;0;0
292;19.12.2017;2017;12;01;Tiistai;0;1;1;0;0;0
292;19.12.2017;2017;12;02;Tiistai;0;0;0;0;0;0
292;19.12.2017;2017;12;03;Tiistai;0;0;0;0;1;1
292;19.12.2017;2017;12;04;Tiistai;0;0;0;1;0;1
292;19.12.2017;2017;12;05;Tiistai;5;6;11;2;0;2
292;19.12.2017;2017;12;06;Tiistai;17;13;30;2;8;10
292;19.12.2017;2017;12;07;Tiistai;39;17;56;17;4;21
292;19.12.2017;2017;12;08;Tiistai;59;12;71;19;11;30
292;19.12.2017;2017;12;09;Tiistai;20;13;33;13;10;23
292;19.12.2017;2017;12;10;Tiistai;17;16;33;13;15;28
292;19.12.2017;2017;12;11;Tiistai;9;17;26;20;17;37
292;19.12.2017;2017;12;12;Tiistai;11;11;22;17;10;27
292;19.12.2017;2017;12;13;Tiistai;15;26;41;20;16;36
292;19.12.2017;2017;12;14;Tiistai;17;41;58;22;23;45
292;19.12.2017;2017;12;15;Tiistai;19;39;58;17;23;40
292;19.12.2017;2017;12;16;Tiistai;24;34;58;11;23;34
292;19.12.2017;2017;12;17;Tiistai;12;15;27;16;13;29
292;19.12.2017;2017;12;18;Tiistai;14;16;30;8;11;19
292;19.12.2017;2017;12;19;Tiistai;12;9;21;18;10;28
292;19.12.2017;2017;12;20;Tiistai;10;8;18;11;5;16
292;19.12.2017;2017;12;21;Tiistai;5;3;8;4;3;7
292;19.12.2017;2017;12;22;Tiistai;2;2;4;0;1;1
292;19.12.2017;2017;12;23;Tiistai;0;0;0;0;0;0
292;20.12.2017;2017;12;00;Keskiviikko;1;0;1;0;0;0
292;20.12.2017;2017;12;01;Keskiviikko;0;0;0;0;0;0
292;20.12.2017;2017;12;02;Keskiviikko;1;0;1;0;0;0
292;20.12.2017;2017;12;03;Keskiviikko;0;0;0;0;0;0
292;20.12.2017;2017;12;04;Keskiviikko;0;0;0;0;0;0
292;20.12.2017;2017;12;05;Keskiviikko;3;6;9;5;1;6
292;20.12.2017;2017;12;06;Keskiviikko;10;10;20;8;8;16
292;20.12.2017;2017;12;07;Keskiviikko;26;11;37;8;7;15
292;20.12.2017;2017;12;08;Keskiviikko;51;14;65;27;8;35
292;20.12.2017;2017;12;09;Keskiviikko;31;12;43;11;6;17
292;20.12.2017;2017;12;10;Keskiviikko;6;11;17;7;7;14
292;20.12.2017;2017;12;11;Keskiviikko;11;9;20;4;8;12
292;20.12.2017;2017;12;12;Keskiviikko;16;28;44;5;20;25
292;20.12.2017;2017;12;13;Keskiviikko;11;13;24;9;5;14
292;20.12.2017;2017;12;14;Keskiviikko;13;32;45;10;10;20
292;20.12.2017;2017;12;15;Keskiviikko;21;21;42;9;10;19
292;20.12.2017;2017;12;16;Keskiviikko;14;16;30;3;9;12
292;20.12.2017;2017;12;17;Keskiviikko;10;13;23;12;6;18
292;20.12.2017;2017;12;18;Keskiviikko;8;4;12;2;8;10
292;20.12.2017;2017;12;19;Keskiviikko;6;5;11;10;6;16
292;20.12.2017;2017;12;20;Keskiviikko;9;1;10;3;3;6
292;20.12.2017;2017;12;21;Keskiviikko;2;0;2;4;5;9
292;20.12.2017;2017;12;22;Keskiviikko;2;1;3;1;0;1
292;20.12.2017;2017;12;23;Keskiviikko;0;1;1;1;0;1
292;21.12.2017;2017;12;00;Torstai;0;0;0;0;1;1
292;21.12.2017;2017;12;01;Torstai;0;0;0;1;0;1
292;21.12.2017;2017;12;02;Torstai;2;0;2;0;0;0
292;21.12.2017;2017;12;03;Torstai;0;0;0;0;0;0
292;21.12.2017;2017;12;04;Torstai;0;0;0;0;0;0
292;21.12.2017;2017;12;05;Torstai;3;2;5;1;0;1
292;21.12.2017;2017;12;06;Torstai;11;10;21;5;5;10
292;21.12.2017;2017;12;07;Torstai;11;8;19;9;13;22
292;21.12.2017;2017;12;08;Torstai;26;21;47;20;4;24
292;21.12.2017;2017;12;09;Torstai;51;18;69;7;13;20
292;21.12.2017;2017;12;10;Torstai;15;8;23;11;9;20
292;21.12.2017;2017;12;11;Torstai;11;16;27;11;14;25
292;21.12.2017;2017;12;12;Torstai;20;34;54;14;13;27
292;21.12.2017;2017;12;13;Torstai;23;18;41;9;10;19
292;21.12.2017;2017;12;14;Torstai;19;31;50;20;14;34
292;21.12.2017;2017;12;15;Torstai;14;38;52;25;14;39
292;21.12.2017;2017;12;16;Torstai;12;34;46;9;14;23
292;21.12.2017;2017;12;17;Torstai;17;14;31;18;9;27
292;21.12.2017;2017;12;18;Torstai;11;12;23;21;17;38
292;21.12.2017;2017;12;19;Torstai;5;5;10;15;19;34
292;21.12.2017;2017;12;20;Torstai;11;4;15;12;13;25
292;21.12.2017;2017;12;21;Torstai;5;5;10;10;2;12
292;21.12.2017;2017;12;22;Torstai;6;5;11;6;5;11
292;21.12.2017;2017;12;23;Torstai;0;1;1;2;0;2
292;22.12.2017;2017;12;00;Perjantai;1;9;10;2;5;7
292;22.12.2017;2017;12;01;Perjantai;0;1;1;0;1;1
292;22.12.2017;2017;12;02;Perjantai;0;0;0;1;1;2
292;22.12.2017;2017;12;03;Perjantai;0;0;0;0;0;0
292;22.12.2017;2017;12;04;Perjantai;0;0;0;0;0;0
292;22.12.2017;2017;12;05;Perjantai;4;3;7;7;9;16
292;22.12.2017;2017;12;06;Perjantai;9;8;17;2;7;9
292;22.12.2017;2017;12;07;Perjantai;12;15;27;10;5;15
292;22.12.2017;2017;12;08;Perjantai;28;15;43;17;9;26
292;22.12.2017;2017;12;09;Perjantai;11;14;25;10;22;32
292;22.12.2017;2017;12;10;Perjantai;11;26;37;8;18;26
292;22.12.2017;2017;12;11;Perjantai;6;19;25;18;19;37
292;22.12.2017;2017;12;12;Perjantai;18;15;33;12;9;21
292;22.12.2017;2017;12;13;Perjantai;17;17;34;10;18;28
292;22.12.2017;2017;12;14;Perjantai;16;18;34;17;15;32
292;22.12.2017;2017;12;15;Perjantai;13;19;32;14;13;27
292;22.12.2017;2017;12;16;Perjantai;12;10;22;11;14;25
292;22.12.2017;2017;12;17;Perjantai;8;11;19;15;5;20
292;22.12.2017;2017;12;18;Perjantai;12;14;26;11;21;32
292;22.12.2017;2017;12;19;Perjantai;6;7;13;13;8;21
292;22.12.2017;2017;12;20;Perjantai;6;6;12;10;6;16
292;22.12.2017;2017;12;21;Perjantai;7;0;7;11;4;15
292;22.12.2017;2017;12;22;Perjantai;3;2;5;6;5;11
292;22.12.2017;2017;12;23;Perjantai;3;3;6;5;1;6
292;23.12.2017;2017;12;00;Lauantai;1;0;1;6;0;6
292;23.12.2017;2017;12;01;Lauantai;1;0;1;0;6;6
292;23.12.2017;2017;12;02;Lauantai;0;1;1;0;4;4
292;23.12.2017;2017;12;03;Lauantai;0;0;0;1;0;1
292;23.12.2017;2017;12;04;Lauantai;0;1;1;3;3;6
292;23.12.2017;2017;12;05;Lauantai;1;0;1;1;0;1
292;23.12.2017;2017;12;06;Lauantai;2;1;3;1;2;3
292;23.12.2017;2017;12;07;Lauantai;3;1;4;3;2;5
292;23.12.2017;2017;12;08;Lauantai;1;2;3;7;3;10
292;23.12.2017;2017;12;09;Lauantai;5;3;8;7;1;8
292;23.12.2017;2017;12;10;Lauantai;1;2;3;4;10;14
292;23.12.2017;2017;12;11;Lauantai;2;2;4;9;5;14
292;23.12.2017;2017;12;12;Lauantai;2;2;4;6;4;10
292;23.12.2017;2017;12;13;Lauantai;3;1;4;7;7;14
292;23.12.2017;2017;12;14;Lauantai;4;5;9;12;8;20
292;23.12.2017;2017;12;15;Lauantai;4;5;9;13;10;23
292;23.12.2017;2017;12;16;Lauantai;2;8;10;9;5;14
292;23.12.2017;2017;12;17;Lauantai;5;4;9;20;9;29
292;23.12.2017;2017;12;18;Lauantai;2;2;4;8;12;20
292;23.12.2017;2017;12;19;Lauantai;1;2;3;7;7;14
292;23.12.2017;2017;12;20;Lauantai;2;0;2;4;4;8
292;23.12.2017;2017;12;21;Lauantai;1;0;1;2;5;7
292;23.12.2017;2017;12;22;Lauantai;0;1;1;1;2;3
292;23.12.2017;2017;12;23;Lauantai;1;0;1;2;1;3
292;24.12.2017;2017;12;00;Sunnuntai;0;1;1;0;1;1
292;24.12.2017;2017;12;01;Sunnuntai;0;0;0;0;1;1
292;24.12.2017;2017;12;02;Sunnuntai;0;0;0;0;1;1
292;24.12.2017;2017;12;03;Sunnuntai;0;0;0;0;0;0
292;24.12.2017;2017;12;04;Sunnuntai;0;0;0;0;0;0
292;24.12.2017;2017;12;05;Sunnuntai;0;0;0;2;0;2
292;24.12.2017;2017;12;06;Sunnuntai;0;2;2;0;0;0
292;24.12.2017;2017;12;07;Sunnuntai;0;3;3;4;6;10
292;24.12.2017;2017;12;08;Sunnuntai;0;0;0;7;2;9
292;24.12.2017;2017;12;09;Sunnuntai;1;4;5;10;10;20
292;24.12.2017;2017;12;10;Sunnuntai;5;2;7;6;11;17
292;24.12.2017;2017;12;11;Sunnuntai;0;5;5;15;14;29
292;24.12.2017;2017;12;12;Sunnuntai;3;5;8;8;5;13
292;24.12.2017;2017;12;13;Sunnuntai;5;5;10;12;11;23
292;24.12.2017;2017;12;14;Sunnuntai;2;2;4;4;4;8
292;24.12.2017;2017;12;15;Sunnuntai;7;2;9;3;4;7
292;24.12.2017;2017;12;16;Sunnuntai;3;1;4;1;3;4
292;24.12.2017;2017;12;17;Sunnuntai;2;3;5;3;2;5
292;24.12.2017;2017;12;18;Sunnuntai;0;2;2;1;4;5
292;24.12.2017;2017;12;19;Sunnuntai;0;3;3;13;1;14
292;24.12.2017;2017;12;20;Sunnuntai;2;2;4;1;7;8
292;24.12.2017;2017;12;21;Sunnuntai;1;0;1;3;3;6
292;24.12.2017;2017;12;22;Sunnuntai;3;1;4;2;0;2
292;24.12.2017;2017;12;23;Sunnuntai;0;0;0;0;0;0
292;25.12.2017;2017;12;00;Maanantai;1;2;3;3;3;6
292;25.12.2017;2017;12;01;Maanantai;0;0;0;2;0;2
292;25.12.2017;2017;12;02;Maanantai;0;0;0;0;1;1
292;25.12.2017;2017;12;03;Maanantai;0;1;1;1;3;4
292;25.12.2017;2017;12;04;Maanantai;0;0;0;0;0;0
292;25.12.2017;2017;12;05;Maanantai;1;0;1;0;1;1
292;25.12.2017;2017;12;06;Maanantai;2;1;3;1;0;1
292;25.12.2017;2017;12;07;Maanantai;1;0;1;3;1;4
292;25.12.2017;2017;12;08;Maanantai;0;0;0;6;0;6
292;25.12.2017;2017;12;09;Maanantai;0;0;0;5;5;10
292;25.12.2017;2017;12;10;Maanantai;5;3;8;7;8;15
292;25.12.2017;2017;12;11;Maanantai;3;4;7;17;8;25
292;25.12.2017;2017;12;12;Maanantai;5;2;7;10;6;16
292;25.12.2017;2017;12;13;Maanantai;6;4;10;8;10;18
292;25.12.2017;2017;12;14;Maanantai;2;4;6;16;6;22
292;25.12.2017;2017;12;15;Maanantai;10;6;16;16;12;28
292;25.12.2017;2017;12;16;Maanantai;7;7;14;6;14;20
292;25.12.2017;2017;12;17;Maanantai;6;5;11;12;7;19
292;25.12.2017;2017;12;18;Maanantai;6;4;10;11;14;25
292;25.12.2017;2017;12;19;Maanantai;2;4;6;7;13;20
292;25.12.2017;2017;12;20;Maanantai;3;3;6;20;11;31
292;25.12.2017;2017;12;21;Maanantai;2;2;4;5;7;12
292;25.12.2017;2017;12;22;Maanantai;1;2;3;3;4;7
292;25.12.2017;2017;12;23;Maanantai;1;0;1;3;0;3
292;26.12.2017;2017;12;00;Tiistai;0;0;0;1;0;1
292;26.12.2017;2017;12;01;Tiistai;1;0;1;1;2;3
292;26.12.2017;2017;12;02;Tiistai;0;0;0;1;2;3
292;26.12.2017;2017;12;03;Tiistai;0;2;2;0;7;7
292;26.12.2017;2017;12;04;Tiistai;1;0;1;0;0;0
292;26.12.2017;2017;12;05;Tiistai;0;0;0;1;0;1
292;26.12.2017;2017;12;06;Tiistai;2;1;3;2;2;4
292;26.12.2017;2017;12;07;Tiistai;1;2;3;4;2;6
292;26.12.2017;2017;12;08;Tiistai;0;4;4;4;3;7
292;26.12.2017;2017;12;09;Tiistai;0;3;3;10;10;20
292;26.12.2017;2017;12;10;Tiistai;4;6;10;8;7;15
292;26.12.2017;2017;12;11;Tiistai;6;6;12;10;12;22
292;26.12.2017;2017;12;12;Tiistai;4;10;14;14;13;27
292;26.12.2017;2017;12;13;Tiistai;2;4;6;11;9;20
292;26.12.2017;2017;12;14;Tiistai;6;6;12;19;10;29
292;26.12.2017;2017;12;15;Tiistai;7;3;10;18;16;34
292;26.12.2017;2017;12;16;Tiistai;0;0;0;5;8;13
292;26.12.2017;2017;12;17;Tiistai;4;4;8;12;8;20
292;26.12.2017;2017;12;18;Tiistai;2;3;5;6;6;12
292;26.12.2017;2017;12;19;Tiistai;1;4;5;4;9;13
292;26.12.2017;2017;12;20;Tiistai;3;1;4;7;3;10
292;26.12.2017;2017;12;21;Tiistai;1;1;2;4;6;10
292;26.12.2017;2017;12;22;Tiistai;0;0;0;2;3;5
292;26.12.2017;2017;12;23;Tiistai;0;1;1;1;0;1
292;27.12.2017;2017;12;00;Keskiviikko;0;0;0;0;0;0
292;27.12.2017;2017;12;01;Keskiviikko;0;0;0;0;1;1
292;27.12.2017;2017;12;02;Keskiviikko;0;2;2;0;1;1
292;27.12.2017;2017;12;03;Keskiviikko;0;0;0;0;0;0
292;27.12.2017;2017;12;04;Keskiviikko;1;0;1;2;0;2
292;27.12.2017;2017;12;05;Keskiviikko;3;2;5;2;0;2
292;27.12.2017;2017;12;06;Keskiviikko;6;4;10;3;4;7
292;27.12.2017;2017;12;07;Keskiviikko;6;6;12;6;6;12
292;27.12.2017;2017;12;08;Keskiviikko;5;2;7;9;4;13
292;27.12.2017;2017;12;09;Keskiviikko;3;3;6;5;4;9
292;27.12.2017;2017;12;10;Keskiviikko;6;8;14;9;8;17
292;27.12.2017;2017;12;11;Keskiviikko;3;7;10;13;17;30
292;27.12.2017;2017;12;12;Keskiviikko;6;9;15;7;11;18
292;27.12.2017;2017;12;13;Keskiviikko;6;2;8;17;10;27
292;27.12.2017;2017;12;14;Keskiviikko;7;6;13;11;10;21
292;27.12.2017;2017;12;15;Keskiviikko;8;10;18;18;16;34
292;27.12.2017;2017;12;16;Keskiviikko;8;9;17;18;9;27
292;27.12.2017;2017;12;17;Keskiviikko;6;8;14;18;9;27
292;27.12.2017;2017;12;18;Keskiviikko;6;2;8;20;8;28
292;27.12.2017;2017;12;19;Keskiviikko;4;7;11;14;12;26
292;27.12.2017;2017;12;20;Keskiviikko;6;5;11;9;11;20
292;27.12.2017;2017;12;21;Keskiviikko;6;2;8;1;2;3
292;27.12.2017;2017;12;22;Keskiviikko;1;3;4;1;0;1
292;27.12.2017;2017;12;23;Keskiviikko;0;0;0;1;1;2
292;28.12.2017;2017;12;00;Torstai;2;1;3;3;1;4
292;28.12.2017;2017;12;01;Torstai;0;0;0;0;0;0
292;28.12.2017;2017;12;02;Torstai;0;0;0;0;0;0
292;28.12.2017;2017;12;03;Torstai;0;0;0;0;0;0
292;28.12.2017;2017;12;04;Torstai;4;3;7;3;1;4
292;28.12.2017;2017;12;05;Torstai;4;1;5;2;0;2
292;28.12.2017;2017;12;06;Torstai;7;7;14;5;7;12
292;28.12.2017;2017;12;07;Torstai;4;8;12;6;3;9
292;28.12.2017;2017;12;08;Torstai;7;7;14;19;13;32
292;28.12.2017;2017;12;09;Torstai;7;11;18;3;7;10
292;28.12.2017;2017;12;10;Torstai;7;7;14;9;6;15
292;28.12.2017;2017;12;11;Torstai;5;10;15;16;10;26
292;28.12.2017;2017;12;12;Torstai;6;12;18;9;8;17
292;28.12.2017;2017;12;13;Torstai;11;9;20;11;8;19
292;28.12.2017;2017;12;14;Torstai;13;11;24;15;18;33
292;28.12.2017;2017;12;15;Torstai;11;14;25;12;14;26
292;28.12.2017;2017;12;16;Torstai;8;14;22;12;10;22
292;28.12.2017;2017;12;17;Torstai;4;6;10;21;14;35
292;28.12.2017;2017;12;18;Torstai;13;10;23;16;17;33
292;28.12.2017;2017;12;19;Torstai;8;4;12;15;16;31
292;28.12.2017;2017;12;20;Torstai;6;2;8;14;4;18
292;28.12.2017;2017;12;21;Torstai;5;3;8;6;7;13
292;28.12.2017;2017;12;22;Torstai;2;0;2;5;5;10
292;28.12.2017;2017;12;23;Torstai;2;2;4;1;1;2
292;29.12.2017;2017;12;00;Perjantai;2;0;2;0;0;0
292;29.12.2017;2017;12;01;Perjantai;1;2;3;1;0;1
292;29.12.2017;2017;12;02;Perjantai;1;0;1;0;0;0
292;29.12.2017;2017;12;03;Perjantai;0;2;2;0;0;0
292;29.12.2017;2017;12;04;Perjantai;1;1;2;0;0;0
292;29.12.2017;2017;12;05;Perjantai;2;0;2;2;0;2
292;29.12.2017;2017;12;06;Perjantai;8;5;13;3;4;7
292;29.12.2017;2017;12;07;Perjantai;6;4;10;7;5;12
292;29.12.2017;2017;12;08;Perjantai;3;2;5;11;4;15
292;29.12.2017;2017;12;09;Perjantai;8;3;11;8;6;14
292;29.12.2017;2017;12;10;Perjantai;3;3;6;3;5;8
292;29.12.2017;2017;12;11;Perjantai;5;5;10;8;7;15
292;29.12.2017;2017;12;12;Perjantai;6;5;11;11;12;23
292;29.12.2017;2017;12;13;Perjantai;5;5;10;14;8;22
292;29.12.2017;2017;12;14;Perjantai;6;10;16;11;12;23
292;29.12.2017;2017;12;15;Perjantai;13;10;23;18;15;33
292;29.12.2017;2017;12;16;Perjantai;10;7;17;12;12;24
292;29.12.2017;2017;12;17;Perjantai;4;7;11;15;11;26
292;29.12.2017;2017;12;18;Perjantai;4;3;7;14;12;26
292;29.12.2017;2017;12;19;Perjantai;6;1;7;16;10;26
292;29.12.2017;2017;12;20;Perjantai;4;3;7;11;8;19
292;29.12.2017;2017;12;21;Perjantai;5;3;8;7;2;9
292;29.12.2017;2017;12;22;Perjantai;0;3;3;4;2;6
292;29.12.2017;2017;12;23;Perjantai;1;1;2;6;1;7
292;30.12.2017;2017;12;00;Lauantai;0;2;2;1;1;2
292;30.12.2017;2017;12;01;Lauantai;0;0;0;0;0;0
292;30.12.2017;2017;12;02;Lauantai;0;3;3;0;7;7
292;30.12.2017;2017;12;03;Lauantai;0;0;0;0;2;2
292;30.12.2017;2017;12;04;Lauantai;0;0;0;1;0;1
292;30.12.2017;2017;12;05;Lauantai;1;0;1;0;0;0
292;30.12.2017;2017;12;06;Lauantai;1;2;3;4;2;6
292;30.12.2017;2017;12;07;Lauantai;2;2;4;4;3;7
292;30.12.2017;2017;12;08;Lauantai;2;1;3;5;4;9
292;30.12.2017;2017;12;09;Lauantai;6;5;11;0;8;8
292;30.12.2017;2017;12;10;Lauantai;5;8;13;4;6;10
292;30.12.2017;2017;12;11;Lauantai;6;6;12;12;8;20
292;30.12.2017;2017;12;12;Lauantai;11;9;20;13;11;24
292;30.12.2017;2017;12;13;Lauantai;12;11;23;9;12;21
292;30.12.2017;2017;12;14;Lauantai;12;10;22;10;13;23
292;30.12.2017;2017;12;15;Lauantai;10;11;21;15;11;26
292;30.12.2017;2017;12;16;Lauantai;6;5;11;27;12;39
292;30.12.2017;2017;12;17;Lauantai;2;8;10;13;6;19
292;30.12.2017;2017;12;18;Lauantai;12;6;18;15;17;32
292;30.12.2017;2017;12;19;Lauantai;5;7;12;4;7;11
292;30.12.2017;2017;12;20;Lauantai;3;5;8;12;6;18
292;30.12.2017;2017;12;21;Lauantai;2;1;3;8;2;10
292;30.12.2017;2017;12;22;Lauantai;0;3;3;3;1;4
292;30.12.2017;2017;12;23;Lauantai;0;0;0;5;0;5
292;31.12.2017;2017;12;00;Sunnuntai;1;0;1;7;1;8
292;31.12.2017;2017;12;01;Sunnuntai;0;2;2;0;2;2
292;31.12.2017;2017;12;02;Sunnuntai;0;2;2;0;3;3
292;31.12.2017;2017;12;03;Sunnuntai;0;1;1;0;2;2
292;31.12.2017;2017;12;04;Sunnuntai;0;1;1;1;0;1
292;31.12.2017;2017;12;05;Sunnuntai;0;0;0;2;0;2
292;31.12.2017;2017;12;06;Sunnuntai;2;1;3;1;0;1
292;31.12.2017;2017;12;07;Sunnuntai;1;1;2;1;3;4
292;31.12.2017;2017;12;08;Sunnuntai;2;3;5;8;4;12
292;31.12.2017;2017;12;09;Sunnuntai;7;4;11;6;12;18
292;31.12.2017;2017;12;10;Sunnuntai;1;9;10;8;10;18
292;31.12.2017;2017;12;11;Sunnuntai;8;7;15;26;16;42
292;31.12.2017;2017;12;12;Sunnuntai;6;9;15;14;8;22
292;31.12.2017;2017;12;13;Sunnuntai;3;8;11;14;14;28
292;31.12.2017;2017;12;14;Sunnuntai;6;6;12;19;11;30
292;31.12.2017;2017;12;15;Sunnuntai;6;7;13;9;10;19
292;31.12.2017;2017;12;16;Sunnuntai;8;5;13;16;5;21
292;31.12.2017;2017;12;17;Sunnuntai;6;9;15;9;9;18
292;31.12.2017;2017;12;18;Sunnuntai;7;18;25;19;9;28
292;31.12.2017;2017;12;19;Sunnuntai;8;7;15;19;9;28
292;31.12.2017;2017;12;20;Sunnuntai;6;5;11;8;8;16
292;31.12.2017;2017;12;21;Sunnuntai;4;5;9;4;5;9
292;31.12.2017;2017;12;22;Sunnuntai;5;5;10;12;3;15
292;31.12.2017;2017;12;23;Sunnuntai;4;4;8;17;9;26
292;01.01.2018;2018;01;00;Maanantai;2;5;7;9;3;12
292;01.01.2018;2018;01;01;Maanantai;3;8;11;9;3;12
292;01.01.2018;2018;01;02;Maanantai;2;1;3;6;6;12
292;01.01.2018;2018;01;03;Maanantai;0;4;4;0;13;13
292;01.01.2018;2018;01;04;Maanantai;0;4;4;5;6;11
292;01.01.2018;2018;01;05;Maanantai;5;0;5;2;1;3
292;01.01.2018;2018;01;06;Maanantai;3;1;4;1;1;2
292;01.01.2018;2018;01;07;Maanantai;0;1;1;2;1;3
292;01.01.2018;2018;01;08;Maanantai;0;2;2;5;4;9
292;01.01.2018;2018;01;09;Maanantai;2;1;3;4;3;7
292;01.01.2018;2018;01;10;Maanantai;3;3;6;7;8;15
292;01.01.2018;2018;01;11;Maanantai;5;3;8;16;10;26
292;01.01.2018;2018;01;12;Maanantai;2;8;10;8;14;22
292;01.01.2018;2018;01;13;Maanantai;6;3;9;16;11;27
292;01.01.2018;2018;01;14;Maanantai;5;7;12;22;8;30
292;01.01.2018;2018;01;15;Maanantai;2;6;8;16;10;26
292;01.01.2018;2018;01;16;Maanantai;7;9;16;10;10;20
292;01.01.2018;2018;01;17;Maanantai;3;9;12;9;16;25
292;01.01.2018;2018;01;18;Maanantai;5;6;11;12;14;26
292;01.01.2018;2018;01;19;Maanantai;5;2;7;9;7;16
292;01.01.2018;2018;01;20;Maanantai;2;5;7;12;5;17
292;01.01.2018;2018;01;21;Maanantai;3;4;7;1;4;5
292;01.01.2018;2018;01;22;Maanantai;0;1;1;5;1;6
292;01.01.2018;2018;01;23;Maanantai;1;1;2;0;1;1
292;02.01.2018;2018;01;00;Tiistai;1;0;1;2;0;2
292;02.01.2018;2018;01;01;Tiistai;0;0;0;0;0;0
292;02.01.2018;2018;01;02;Tiistai;0;0;0;0;2;2
292;02.01.2018;2018;01;03;Tiistai;0;0;0;0;0;0
292;02.01.2018;2018;01;04;Tiistai;0;0;0;0;0;0
292;02.01.2018;2018;01;05;Tiistai;2;1;3;1;0;1
292;02.01.2018;2018;01;06;Tiistai;4;10;14;9;4;13
292;02.01.2018;2018;01;07;Tiistai;9;12;21;12;8;20
292;02.01.2018;2018;01;08;Tiistai;6;19;25;10;9;19
292;02.01.2018;2018;01;09;Tiistai;6;10;16;6;9;15
292;02.01.2018;2018;01;10;Tiistai;8;15;23;12;17;29
292;02.01.2018;2018;01;11;Tiistai;14;18;32;19;18;37
292;02.01.2018;2018;01;12;Tiistai;6;5;11;16;13;29
292;02.01.2018;2018;01;13;Tiistai;13;15;28;29;12;41
292;02.01.2018;2018;01;14;Tiistai;11;22;33;27;12;39
292;02.01.2018;2018;01;15;Tiistai;18;26;44;29;20;49
292;02.01.2018;2018;01;16;Tiistai;10;21;31;17;21;38
292;02.01.2018;2018;01;17;Tiistai;13;9;22;25;12;37
292;02.01.2018;2018;01;18;Tiistai;9;9;18;18;24;42
292;02.01.2018;2018;01;19;Tiistai;6;7;13;22;9;31
292;02.01.2018;2018;01;20;Tiistai;9;3;12;13;8;21
292;02.01.2018;2018;01;21;Tiistai;1;1;2;2;5;7
292;02.01.2018;2018;01;22;Tiistai;1;3;4;6;4;10
292;02.01.2018;2018;01;23;Tiistai;0;0;0;3;2;5
292;03.01.2018;2018;01;00;Keskiviikko;1;0;1;4;2;6
292;03.01.2018;2018;01;01;Keskiviikko;0;0;0;0;1;1
292;03.01.2018;2018;01;02;Keskiviikko;0;0;0;0;0;0
292;03.01.2018;2018;01;03;Keskiviikko;0;0;0;0;0;0
292;03.01.2018;2018;01;04;Keskiviikko;0;0;0;0;0;0
292;03.01.2018;2018;01;05;Keskiviikko;2;3;5;1;0;1
292;03.01.2018;2018;01;06;Keskiviikko;9;7;16;5;4;9
292;03.01.2018;2018;01;07;Keskiviikko;24;14;38;11;7;18
292;03.01.2018;2018;01;08;Keskiviikko;7;10;17;7;13;20
292;03.01.2018;2018;01;09;Keskiviikko;10;9;19;9;7;16
292;03.01.2018;2018;01;10;Keskiviikko;7;8;15;13;10;23
292;03.01.2018;2018;01;11;Keskiviikko;12;8;20;11;11;22
292;03.01.2018;2018;01;12;Keskiviikko;12;12;24;14;15;29
292;03.01.2018;2018;01;13;Keskiviikko;14;16;30;13;19;32
292;03.01.2018;2018;01;14;Keskiviikko;15;15;30;27;12;39
292;03.01.2018;2018;01;15;Keskiviikko;16;14;30;15;13;28
292;03.01.2018;2018;01;16;Keskiviikko;17;20;37;15;20;35
292;03.01.2018;2018;01;17;Keskiviikko;9;6;15;13;14;27
292;03.01.2018;2018;01;18;Keskiviikko;15;10;25;18;14;32
292;03.01.2018;2018;01;19;Keskiviikko;16;13;29;13;14;27
292;03.01.2018;2018;01;20;Keskiviikko;6;8;14;13;7;20
292;03.01.2018;2018;01;21;Keskiviikko;5;7;12;10;10;20
292;03.01.2018;2018;01;22;Keskiviikko;2;2;4;3;2;5
292;03.01.2018;2018;01;23;Keskiviikko;1;0;1;6;3;9
292;04.01.2018;2018;01;00;Torstai;3;0;3;4;0;4
292;04.01.2018;2018;01;01;Torstai;0;0;0;0;0;0
292;04.01.2018;2018;01;02;Torstai;0;0;0;0;0;0
292;04.01.2018;2018;01;03;Torstai;0;0;0;0;0;0
292;04.01.2018;2018;01;04;Torstai;7;0;7;4;0;4
292;04.01.2018;2018;01;05;Torstai;5;0;5;2;0;2
292;04.01.2018;2018;01;06;Torstai;14;0;14;12;0;12
292;04.01.2018;2018;01;07;Torstai;12;0;12;9;0;9
292;04.01.2018;2018;01;08;Torstai;14;0;14;32;0;32
292;04.01.2018;2018;01;09;Torstai;18;0;18;10;0;10
292;04.01.2018;2018;01;10;Torstai;14;0;14;15;0;15
292;04.01.2018;2018;01;11;Torstai;15;0;15;26;0;26
292;04.01.2018;2018;01;12;Torstai;18;0;18;17;0;17
292;04.01.2018;2018;01;13;Torstai;20;0;20;19;0;19
292;04.01.2018;2018;01;14;Torstai;24;0;24;33;0;33
292;04.01.2018;2018;01;15;Torstai;25;0;25;26;0;26
292;04.01.2018;2018;01;16;Torstai;22;0;22;22;0;22
292;04.01.2018;2018;01;17;Torstai;10;0;10;35;0;35
292;04.01.2018;2018;01;18;Torstai;23;0;23;33;0;33
292;04.01.2018;2018;01;19;Torstai;12;0;12;31;0;31
292;04.01.2018;2018;01;20;Torstai;8;0;8;18;0;18
292;04.01.2018;2018;01;21;Torstai;8;0;8;13;0;13
292;04.01.2018;2018;01;22;Torstai;2;0;2;10;0;10
292;04.01.2018;2018;01;23;Torstai;4;0;4;2;0;2
292;05.01.2018;2018;01;00;Perjantai;0;0;0;0;0;0
292;05.01.2018;2018;01;01;Perjantai;1;1;2;0;0;0
292;05.01.2018;2018;01;02;Perjantai;0;0;0;0;0;0
292;05.01.2018;2018;01;03;Perjantai;0;0;0;0;0;0
292;05.01.2018;2018;01;04;Perjantai;1;0;1;0;0;0
292;05.01.2018;2018;01;05;Perjantai;4;3;7;2;0;2
292;05.01.2018;2018;01;06;Perjantai;5;1;6;5;6;11
292;05.01.2018;2018;01;07;Perjantai;14;8;22;8;14;22
292;05.01.2018;2018;01;08;Perjantai;10;13;23;7;12;19
292;05.01.2018;2018;01;09;Perjantai;8;5;13;11;5;16
292;05.01.2018;2018;01;10;Perjantai;4;3;7;10;8;18
292;05.01.2018;2018;01;11;Perjantai;3;3;6;10;9;19
292;05.01.2018;2018;01;12;Perjantai;14;9;23;10;12;22
292;05.01.2018;2018;01;13;Perjantai;11;9;20;21;7;28
292;05.01.2018;2018;01;14;Perjantai;12;8;20;12;11;23
292;05.01.2018;2018;01;15;Perjantai;11;10;21;8;17;25
292;05.01.2018;2018;01;16;Perjantai;15;19;34;9;9;18
292;05.01.2018;2018;01;17;Perjantai;5;5;10;13;7;20
292;05.01.2018;2018;01;18;Perjantai;9;5;14;6;12;18
292;05.01.2018;2018;01;19;Perjantai;8;5;13;18;11;29
292;05.01.2018;2018;01;20;Perjantai;6;3;9;14;6;20
292;05.01.2018;2018;01;21;Perjantai;3;2;5;10;3;13
292;05.01.2018;2018;01;22;Perjantai;0;0;0;4;2;6
292;05.01.2018;2018;01;23;Perjantai;0;2;2;2;0;2
292;06.01.2018;2018;01;00;Lauantai;1;2;3;0;0;0
292;06.01.2018;2018;01;01;Lauantai;1;0;1;0;3;3
292;06.01.2018;2018;01;02;Lauantai;1;1;2;0;3;3
292;06.01.2018;2018;01;03;Lauantai;0;0;0;0;0;0
292;06.01.2018;2018;01;04;Lauantai;0;0;0;0;0;0
292;06.01.2018;2018;01;05;Lauantai;1;0;1;2;0;2
292;06.01.2018;2018;01;06;Lauantai;4;0;4;2;2;4
292;06.01.2018;2018;01;07;Lauantai;1;1;2;4;5;9
292;06.01.2018;2018;01;08;Lauantai;3;3;6;7;6;13
292;06.01.2018;2018;01;09;Lauantai;8;5;13;6;10;16
292;06.01.2018;2018;01;10;Lauantai;5;2;7;7;5;12
292;06.01.2018;2018;01;11;Lauantai;9;5;14;4;7;11
292;06.01.2018;2018;01;12;Lauantai;6;2;8;12;9;21
292;06.01.2018;2018;01;13;Lauantai;6;6;12;14;13;27
292;06.01.2018;2018;01;14;Lauantai;1;6;7;9;6;15
292;06.01.2018;2018;01;15;Lauantai;9;13;22;11;9;20
292;06.01.2018;2018;01;16;Lauantai;6;5;11;14;8;22
292;06.01.2018;2018;01;17;Lauantai;3;5;8;6;16;22
292;06.01.2018;2018;01;18;Lauantai;7;8;15;11;11;22
292;06.01.2018;2018;01;19;Lauantai;6;2;8;9;12;21
292;06.01.2018;2018;01;20;Lauantai;4;4;8;8;9;17
292;06.01.2018;2018;01;21;Lauantai;3;5;8;4;8;12
292;06.01.2018;2018;01;22;Lauantai;4;2;6;3;1;4
292;06.01.2018;2018;01;23;Lauantai;0;1;1;1;0;1
292;07.01.2018;2018;01;00;Sunnuntai;0;0;0;1;0;1
292;07.01.2018;2018;01;01;Sunnuntai;0;1;1;0;1;1
292;07.01.2018;2018;01;02;Sunnuntai;0;0;0;0;5;5
292;07.01.2018;2018;01;03;Sunnuntai;0;1;1;0;2;2
292;07.01.2018;2018;01;04;Sunnuntai;0;0;0;0;0;0
292;07.01.2018;2018;01;05;Sunnuntai;2;2;4;5;3;8
292;07.01.2018;2018;01;06;Sunnuntai;1;1;2;4;2;6
292;07.01.2018;2018;01;07;Sunnuntai;1;0;1;4;4;8
292;07.01.2018;2018;01;08;Sunnuntai;1;3;4;8;5;13
292;07.01.2018;2018;01;09;Sunnuntai;9;2;11;6;7;13
292;07.01.2018;2018;01;10;Sunnuntai;0;8;8;7;3;10
292;07.01.2018;2018;01;11;Sunnuntai;13;11;24;11;13;24
292;07.01.2018;2018;01;12;Sunnuntai;12;8;20;21;6;27
292;07.01.2018;2018;01;13;Sunnuntai;8;7;15;15;17;32
292;07.01.2018;2018;01;14;Sunnuntai;4;13;17;22;23;45
292;07.01.2018;2018;01;15;Sunnuntai;3;6;9;10;16;26
292;07.01.2018;2018;01;16;Sunnuntai;5;7;12;12;11;23
292;07.01.2018;2018;01;17;Sunnuntai;5;4;9;21;17;38
292;07.01.2018;2018;01;18;Sunnuntai;5;2;7;13;15;28
292;07.01.2018;2018;01;19;Sunnuntai;3;4;7;4;5;9
292;07.01.2018;2018;01;20;Sunnuntai;4;2;6;4;2;6
292;07.01.2018;2018;01;21;Sunnuntai;2;2;4;1;3;4
292;07.01.2018;2018;01;22;Sunnuntai;0;2;2;2;1;3
292;07.01.2018;2018;01;23;Sunnuntai;0;0;0;0;1;1
292;08.01.2018;2018;01;00;Maanantai;1;0;1;0;1;1
292;08.01.2018;2018;01;01;Maanantai;1;0;1;0;0;0
292;08.01.2018;2018;01;02;Maanantai;0;0;0;0;1;1
292;08.01.2018;2018;01;03;Maanantai;0;1;1;0;0;0
292;08.01.2018;2018;01;04;Maanantai;0;0;0;0;0;0
292;08.01.2018;2018;01;05;Maanantai;3;5;8;1;1;2
292;08.01.2018;2018;01;06;Maanantai;6;10;16;5;5;10
292;08.01.2018;2018;01;07;Maanantai;28;17;45;16;19;35
292;08.01.2018;2018;01;08;Maanantai;28;11;39;10;17;27
292;08.01.2018;2018;01;09;Maanantai;35;6;41;11;6;17
292;08.01.2018;2018;01;10;Maanantai;12;11;23;6;6;12
292;08.01.2018;2018;01;11;Maanantai;8;5;13;6;10;16
292;08.01.2018;2018;01;12;Maanantai;8;15;23;11;7;18
292;08.01.2018;2018;01;13;Maanantai;10;23;33;28;23;51
292;08.01.2018;2018;01;14;Maanantai;17;23;40;21;20;41
292;08.01.2018;2018;01;15;Maanantai;15;28;43;22;22;44
292;08.01.2018;2018;01;16;Maanantai;14;32;46;12;20;32
292;08.01.2018;2018;01;17;Maanantai;11;12;23;17;16;33
292;08.01.2018;2018;01;18;Maanantai;9;5;14;16;9;25
292;08.01.2018;2018;01;19;Maanantai;9;9;18;10;12;22
292;08.01.2018;2018;01;20;Maanantai;5;8;13;7;8;15
292;08.01.2018;2018;01;21;Maanantai;3;1;4;1;4;5
292;08.01.2018;2018;01;22;Maanantai;0;0;0;2;0;2
292;08.01.2018;2018;01;23;Maanantai;0;1;1;0;0;0
292;09.01.2018;2018;01;00;Tiistai;0;0;0;0;1;1
292;09.01.2018;2018;01;01;Tiistai;0;0;0;0;1;1
292;09.01.2018;2018;01;02;Tiistai;0;1;1;0;0;0
292;09.01.2018;2018;01;03;Tiistai;0;0;0;0;0;0
292;09.01.2018;2018;01;04;Tiistai;0;0;0;0;0;0
292;09.01.2018;2018;01;05;Tiistai;3;4;7;3;1;4
292;09.01.2018;2018;01;06;Tiistai;15;13;28;7;7;14
292;09.01.2018;2018;01;07;Tiistai;41;21;62;19;16;35
292;09.01.2018;2018;01;08;Tiistai;53;23;76;26;19;45
292;09.01.2018;2018;01;09;Tiistai;19;11;30;16;18;34
292;09.01.2018;2018;01;10;Tiistai;15;6;21;14;10;24
292;09.01.2018;2018;01;11;Tiistai;11;13;24;20;10;30
292;09.01.2018;2018;01;12;Tiistai;11;13;24;13;20;33
292;09.01.2018;2018;01;13;Tiistai;18;21;39;17;13;30
292;09.01.2018;2018;01;14;Tiistai;21;38;59;17;18;35
292;09.01.2018;2018;01;15;Tiistai;20;36;56;10;16;26
292;09.01.2018;2018;01;16;Tiistai;25;33;58;17;15;32
292;09.01.2018;2018;01;17;Tiistai;15;12;27;20;7;27
292;09.01.2018;2018;01;18;Tiistai;10;4;14;8;21;29
292;09.01.2018;2018;01;19;Tiistai;5;7;12;16;19;35
292;09.01.2018;2018;01;20;Tiistai;12;4;16;8;6;14
292;09.01.2018;2018;01;21;Tiistai;5;4;9;5;2;7
292;09.01.2018;2018;01;22;Tiistai;2;3;5;1;1;2
292;09.01.2018;2018;01;23;Tiistai;0;0;0;1;1;2
292;10.01.2018;2018;01;00;Keskiviikko;0;0;0;0;0;0
292;10.01.2018;2018;01;01;Keskiviikko;1;1;2;1;0;1
292;10.01.2018;2018;01;02;Keskiviikko;0;0;0;0;0;0
292;10.01.2018;2018;01;03;Keskiviikko;0;0;0;0;0;0
292;10.01.2018;2018;01;04;Keskiviikko;0;0;0;0;0;0
292;10.01.2018;2018;01;05;Keskiviikko;4;3;7;1;0;1
292;10.01.2018;2018;01;06;Keskiviikko;14;12;26;4;6;10
292;10.01.2018;2018;01;07;Keskiviikko;48;17;65;15;9;24
292;10.01.2018;2018;01;08;Keskiviikko;28;17;45;18;21;39
292;10.01.2018;2018;01;09;Keskiviikko;16;12;28;12;15;27
292;10.01.2018;2018;01;10;Keskiviikko;10;11;21;14;12;26
292;10.01.2018;2018;01;11;Keskiviikko;8;15;23;15;9;24
292;10.01.2018;2018;01;12;Keskiviikko;16;20;36;13;12;25
292;10.01.2018;2018;01;13;Keskiviikko;12;35;47;16;13;29
292;10.01.2018;2018;01;14;Keskiviikko;20;33;53;22;23;45
292;10.01.2018;2018;01;15;Keskiviikko;24;34;58;21;23;44
292;10.01.2018;2018;01;16;Keskiviikko;18;30;48;23;14;37
292;10.01.2018;2018;01;17;Keskiviikko;15;14;29;23;23;46
292;10.01.2018;2018;01;18;Keskiviikko;5;14;19;24;21;45
292;10.01.2018;2018;01;19;Keskiviikko;12;10;22;17;8;25
292;10.01.2018;2018;01;20;Keskiviikko;16;4;20;12;8;20
292;10.01.2018;2018;01;21;Keskiviikko;4;5;9;9;4;13
292;10.01.2018;2018;01;22;Keskiviikko;1;2;3;1;4;5
292;10.01.2018;2018;01;23;Keskiviikko;0;0;0;0;0;0
292;11.01.2018;2018;01;00;Torstai;0;0;0;0;2;2
292;11.01.2018;2018;01;01;Torstai;1;1;2;0;0;0
292;11.01.2018;2018;01;02;Torstai;0;0;0;0;0;0
292;11.01.2018;2018;01;03;Torstai;0;0;0;0;0;0
292;11.01.2018;2018;01;04;Torstai;0;0;0;0;0;0
292;11.01.2018;2018;01;05;Torstai;4;3;7;2;1;3
292;11.01.2018;2018;01;06;Torstai;10;14;24;5;3;8
292;11.01.2018;2018;01;07;Torstai;40;16;56;20;13;33
292;11.01.2018;2018;01;08;Torstai;24;13;37;13;22;35
292;11.01.2018;2018;01;09;Torstai;43;16;59;23;12;35
292;11.01.2018;2018;01;10;Torstai;10;7;17;6;11;17
292;11.01.2018;2018;01;11;Torstai;13;15;28;10;7;17
292;11.01.2018;2018;01;12;Torstai;11;11;22;20;21;41
292;11.01.2018;2018;01;13;Torstai;12;18;30;15;11;26
292;11.01.2018;2018;01;14;Torstai;17;31;48;26;13;39
292;11.01.2018;2018;01;15;Torstai;18;35;53;26;23;49
292;11.01.2018;2018;01;16;Torstai;16;38;54;12;15;27
292;11.01.2018;2018;01;17;Torstai;12;14;26;23;14;37
292;11.01.2018;2018;01;18;Torstai;9;10;19;24;12;36
292;11.01.2018;2018;01;19;Torstai;7;3;10;13;15;28
292;11.01.2018;2018;01;20;Torstai;6;5;11;4;5;9
292;11.01.2018;2018;01;21;Torstai;3;1;4;1;2;3
292;11.01.2018;2018;01;22;Torstai;0;1;1;1;2;3
292;11.01.2018;2018;01;23;Torstai;0;0;0;0;0;0
292;12.01.2018;2018;01;00;Perjantai;0;0;0;0;1;1
292;12.01.2018;2018;01;01;Perjantai;0;0;0;0;0;0
292;12.01.2018;2018;01;02;Perjantai;0;0;0;0;0;0
292;12.01.2018;2018;01;03;Perjantai;1;0;1;0;0;0
292;12.01.2018;2018;01;04;Perjantai;0;0;0;0;0;0
292;12.01.2018;2018;01;05;Perjantai;2;4;6;3;0;3
292;12.01.2018;2018;01;06;Perjantai;8;10;18;3;5;8
292;12.01.2018;2018;01;07;Perjantai;42;24;66;11;8;19
292;12.01.2018;2018;01;08;Perjantai;42;23;65;16;15;31
292;12.01.2018;2018;01;09;Perjantai;21;14;35;17;13;30
292;12.01.2018;2018;01;10;Perjantai;8;8;16;9;6;15
292;12.01.2018;2018;01;11;Perjantai;8;15;23;12;17;29
292;12.01.2018;2018;01;12;Perjantai;17;13;30;20;10;30
292;12.01.2018;2018;01;13;Perjantai;15;39;54;16;15;31
292;12.01.2018;2018;01;14;Perjantai;23;31;54;13;20;33
292;12.01.2018;2018;01;15;Perjantai;20;35;55;14;13;27
292;12.01.2018;2018;01;16;Perjantai;15;23;38;6;14;20
292;12.01.2018;2018;01;17;Perjantai;17;13;30;19;19;38
292;12.01.2018;2018;01;18;Perjantai;8;10;18;6;14;20
292;12.01.2018;2018;01;19;Perjantai;10;7;17;16;8;24
292;12.01.2018;2018;01;20;Perjantai;11;8;19;15;12;27
292;12.01.2018;2018;01;21;Perjantai;8;2;10;4;8;12
292;12.01.2018;2018;01;22;Perjantai;5;1;6;2;3;5
292;12.01.2018;2018;01;23;Perjantai;9;2;11;3;0;3
292;13.01.2018;2018;01;00;Lauantai;1;0;1;3;2;5
292;13.01.2018;2018;01;01;Lauantai;0;1;1;2;2;4
292;13.01.2018;2018;01;02;Lauantai;2;1;3;0;4;4
292;13.01.2018;2018;01;03;Lauantai;0;0;0;0;0;0
292;13.01.2018;2018;01;04;Lauantai;0;0;0;0;0;0
292;13.01.2018;2018;01;05;Lauantai;1;1;2;1;0;1
292;13.01.2018;2018;01;06;Lauantai;1;1;2;1;2;3
292;13.01.2018;2018;01;07;Lauantai;0;3;3;4;5;9
292;13.01.2018;2018;01;08;Lauantai;2;2;4;5;4;9
292;13.01.2018;2018;01;09;Lauantai;6;11;17;8;6;14
292;13.01.2018;2018;01;10;Lauantai;11;5;16;6;8;14
292;13.01.2018;2018;01;11;Lauantai;5;11;16;7;7;14
292;13.01.2018;2018;01;12;Lauantai;11;7;18;14;12;26
292;13.01.2018;2018;01;13;Lauantai;15;15;30;6;13;19
292;13.01.2018;2018;01;14;Lauantai;15;10;25;16;9;25
292;13.01.2018;2018;01;15;Lauantai;13;14;27;14;11;25
292;13.01.2018;2018;01;16;Lauantai;10;10;20;12;19;31
292;13.01.2018;2018;01;17;Lauantai;3;13;16;10;9;19
292;13.01.2018;2018;01;18;Lauantai;11;11;22;15;9;24
292;13.01.2018;2018;01;19;Lauantai;5;4;9;8;4;12
292;13.01.2018;2018;01;20;Lauantai;5;2;7;6;3;9
292;13.01.2018;2018;01;21;Lauantai;5;4;9;4;6;10
292;13.01.2018;2018;01;22;Lauantai;3;2;5;2;1;3
292;13.01.2018;2018;01;23;Lauantai;4;5;9;5;3;8
292;14.01.2018;2018;01;00;Sunnuntai;4;1;5;2;0;2
292;14.01.2018;2018;01;01;Sunnuntai;1;0;1;2;0;2
292;14.01.2018;2018;01;02;Sunnuntai;1;1;2;0;5;5
292;14.01.2018;2018;01;03;Sunnuntai;1;2;3;0;2;2
292;14.01.2018;2018;01;04;Sunnuntai;1;0;1;0;0;0
292;14.01.2018;2018;01;05;Sunnuntai;1;0;1;1;1;2
292;14.01.2018;2018;01;06;Sunnuntai;1;0;1;1;2;3
292;14.01.2018;2018;01;07;Sunnuntai;1;1;2;2;4;6
292;14.01.2018;2018;01;08;Sunnuntai;0;2;2;5;4;9
292;14.01.2018;2018;01;09;Sunnuntai;6;5;11;8;8;16
292;14.01.2018;2018;01;10;Sunnuntai;4;10;14;17;10;27
292;14.01.2018;2018;01;11;Sunnuntai;10;15;25;14;18;32
292;14.01.2018;2018;01;12;Sunnuntai;9;5;14;14;12;26
292;14.01.2018;2018;01;13;Sunnuntai;8;5;13;13;8;21
292;14.01.2018;2018;01;14;Sunnuntai;5;4;9;17;9;26
292;14.01.2018;2018;01;15;Sunnuntai;7;11;18;20;8;28
292;14.01.2018;2018;01;16;Sunnuntai;7;6;13;13;9;22
292;14.01.2018;2018;01;17;Sunnuntai;9;6;15;13;14;27
292;14.01.2018;2018;01;18;Sunnuntai;4;8;12;18;13;31
292;14.01.2018;2018;01;19;Sunnuntai;13;5;18;13;6;19
292;14.01.2018;2018;01;20;Sunnuntai;8;3;11;10;4;14
292;14.01.2018;2018;01;21;Sunnuntai;3;3;6;3;5;8
292;14.01.2018;2018;01;22;Sunnuntai;1;1;2;1;1;2
292;14.01.2018;2018;01;23;Sunnuntai;0;0;0;0;1;1
292;15.01.2018;2018;01;00;Maanantai;1;0;1;0;0;0
292;15.01.2018;2018;01;01;Maanantai;0;0;0;0;0;0
292;15.01.2018;2018;01;02;Maanantai;0;0;0;0;0;0
292;15.01.2018;2018;01;03;Maanantai;0;0;0;0;0;0
292;15.01.2018;2018;01;04;Maanantai;1;1;2;0;0;0
292;15.01.2018;2018;01;05;Maanantai;4;5;9;0;1;1
292;15.01.2018;2018;01;06;Maanantai;14;11;25;2;3;5
292;15.01.2018;2018;01;07;Maanantai;42;16;58;17;15;32
292;15.01.2018;2018;01;08;Maanantai;35;14;49;22;8;30
292;15.01.2018;2018;01;09;Maanantai;30;11;41;15;13;28
292;15.01.2018;2018;01;10;Maanantai;12;7;19;6;12;18
292;15.01.2018;2018;01;11;Maanantai;14;12;26;11;11;22
292;15.01.2018;2018;01;12;Maanantai;11;6;17;10;11;21
292;15.01.2018;2018;01;13;Maanantai;18;24;42;21;15;36
292;15.01.2018;2018;01;14;Maanantai;17;33;50;20;21;41
292;15.01.2018;2018;01;15;Maanantai;28;41;69;20;20;40
292;15.01.2018;2018;01;16;Maanantai;18;25;43;12;22;34
292;15.01.2018;2018;01;17;Maanantai;14;10;24;18;16;34
292;15.01.2018;2018;01;18;Maanantai;10;6;16;14;11;25
292;15.01.2018;2018;01;19;Maanantai;6;1;7;8;8;16
292;15.01.2018;2018;01;20;Maanantai;5;5;10;5;7;12
292;15.01.2018;2018;01;21;Maanantai;6;4;10;6;7;13
292;15.01.2018;2018;01;22;Maanantai;0;0;0;5;2;7
292;15.01.2018;2018;01;23;Maanantai;0;0;0;0;0;0
292;16.01.2018;2018;01;00;Tiistai;0;0;0;0;0;0
292;16.01.2018;2018;01;01;Tiistai;0;0;0;0;0;0
292;16.01.2018;2018;01;02;Tiistai;0;0;0;0;0;0
292;16.01.2018;2018;01;03;Tiistai;0;0;0;0;0;0
292;16.01.2018;2018;01;04;Tiistai;0;0;0;0;0;0
292;16.01.2018;2018;01;05;Tiistai;5;1;6;3;4;7
292;16.01.2018;2018;01;06;Tiistai;13;16;29;5;7;12
292;16.01.2018;2018;01;07;Tiistai;44;10;54;16;12;28
292;16.01.2018;2018;01;08;Tiistai;42;15;57;20;11;31
292;16.01.2018;2018;01;09;Tiistai;20;11;31;16;14;30
292;16.01.2018;2018;01;10;Tiistai;19;4;23;11;7;18
292;16.01.2018;2018;01;11;Tiistai;6;8;14;12;5;17
292;16.01.2018;2018;01;12;Tiistai;12;8;20;12;8;20
292;16.01.2018;2018;01;13;Tiistai;17;21;38;20;17;37
292;16.01.2018;2018;01;14;Tiistai;16;30;46;15;18;33
292;16.01.2018;2018;01;15;Tiistai;14;30;44;15;17;32
292;16.01.2018;2018;01;16;Tiistai;16;19;35;19;17;36
292;16.01.2018;2018;01;17;Tiistai;13;6;19;9;16;25
292;16.01.2018;2018;01;18;Tiistai;6;6;12;15;15;30
292;16.01.2018;2018;01;19;Tiistai;13;5;18;5;13;18
292;16.01.2018;2018;01;20;Tiistai;9;7;16;9;4;13
292;16.01.2018;2018;01;21;Tiistai;1;6;7;6;4;10
292;16.01.2018;2018;01;22;Tiistai;1;2;3;6;2;8
292;16.01.2018;2018;01;23;Tiistai;0;0;0;1;1;2
292;17.01.2018;2018;01;00;Keskiviikko;1;0;1;1;1;2
292;17.01.2018;2018;01;01;Keskiviikko;0;0;0;0;5;5
292;17.01.2018;2018;01;02;Keskiviikko;0;1;1;0;0;0
292;17.01.2018;2018;01;03;Keskiviikko;0;0;0;0;0;0
292;17.01.2018;2018;01;04;Keskiviikko;0;0;0;0;0;0
292;17.01.2018;2018;01;05;Keskiviikko;3;4;7;2;0;2
292;17.01.2018;2018;01;06;Keskiviikko;14;10;24;6;6;12
292;17.01.2018;2018;01;07;Keskiviikko;37;14;51;19;12;31
292;17.01.2018;2018;01;08;Keskiviikko;37;15;52;16;16;32
292;17.01.2018;2018;01;09;Keskiviikko;18;14;32;17;11;28
292;17.01.2018;2018;01;10;Keskiviikko;12;8;20;7;8;15
292;17.01.2018;2018;01;11;Keskiviikko;12;11;23;12;12;24
292;17.01.2018;2018;01;12;Keskiviikko;9;12;21;19;15;34
292;17.01.2018;2018;01;13;Keskiviikko;6;37;43;21;27;48
292;17.01.2018;2018;01;14;Keskiviikko;11;40;51;21;22;43
292;17.01.2018;2018;01;15;Keskiviikko;21;30;51;24;18;42
292;17.01.2018;2018;01;16;Keskiviikko;22;24;46;12;13;25
292;17.01.2018;2018;01;17;Keskiviikko;13;13;26;23;12;35
292;17.01.2018;2018;01;18;Keskiviikko;7;7;14;14;12;26
292;17.01.2018;2018;01;19;Keskiviikko;3;2;5;11;11;22
292;17.01.2018;2018;01;20;Keskiviikko;9;5;14;6;8;14
292;17.01.2018;2018;01;21;Keskiviikko;5;3;8;4;1;5
292;17.01.2018;2018;01;22;Keskiviikko;2;2;4;3;1;4
292;17.01.2018;2018;01;23;Keskiviikko;0;1;1;0;0;0
292;18.01.2018;2018;01;00;Torstai;0;0;0;0;0;0
292;18.01.2018;2018;01;01;Torstai;0;0;0;0;0;0
292;18.01.2018;2018;01;02;Torstai;0;0;0;0;0;0
292;18.01.2018;2018;01;03;Torstai;0;0;0;0;0;0
292;18.01.2018;2018;01;04;Torstai;0;0;0;0;0;0
292;18.01.2018;2018;01;05;Torstai;4;2;6;1;0;1
292;18.01.2018;2018;01;06;Torstai;10;18;28;4;5;9
292;18.01.2018;2018;01;07;Torstai;46;15;61;20;5;25
292;18.01.2018;2018;01;08;Torstai;29;13;42;16;16;32
292;18.01.2018;2018;01;09;Torstai;39;14;53;20;8;28
292;18.01.2018;2018;01;10;Torstai;1;2;3;22;17;39
292;18.01.2018;2018;01;11;Torstai;1;4;5;25;20;45
292;18.01.2018;2018;01;12;Torstai;0;7;7;13;25;38
292;18.01.2018;2018;01;13;Torstai;0;7;7;33;26;59
292;18.01.2018;2018;01;14;Torstai;12;14;26;35;26;61
292;18.01.2018;2018;01;15;Torstai;10;46;56;20;12;32
292;18.01.2018;2018;01;16;Torstai;17;34;51;13;13;26
292;18.01.2018;2018;01;17;Torstai;11;16;27;17;13;30
292;18.01.2018;2018;01;18;Torstai;7;15;22;17;16;33
292;18.01.2018;2018;01;19;Torstai;11;4;15;17;19;36
292;18.01.2018;2018;01;20;Torstai;3;8;11;13;8;21
292;18.01.2018;2018;01;21;Torstai;6;6;12;5;1;6
292;18.01.2018;2018;01;22;Torstai;2;1;3;4;1;5
292;18.01.2018;2018;01;23;Torstai;0;0;0;0;0;0
292;19.01.2018;2018;01;00;Perjantai;1;0;1;0;0;0
292;19.01.2018;2018;01;01;Perjantai;0;0;0;0;0;0
292;19.01.2018;2018;01;02;Perjantai;0;0;0;0;0;0
292;19.01.2018;2018;01;03;Perjantai;0;0;0;1;1;2
292;19.01.2018;2018;01;04;Perjantai;0;0;0;0;0;0
292;19.01.2018;2018;01;05;Perjantai;5;6;11;3;0;3
292;19.01.2018;2018;01;06;Perjantai;10;11;21;3;5;8
292;19.01.2018;2018;01;07;Perjantai;51;14;65;16;7;23
292;19.01.2018;2018;01;08;Perjantai;42;10;52;21;17;38
292;19.01.2018;2018;01;09;Perjantai;21;3;24;8;6;14
292;19.01.2018;2018;01;10;Perjantai;6;7;13;7;15;22
292;19.01.2018;2018;01;11;Perjantai;2;14;16;11;10;21
292;19.01.2018;2018;01;12;Perjantai;15;24;39;12;19;31
292;19.01.2018;2018;01;13;Perjantai;10;45;55;19;19;38
292;19.01.2018;2018;01;14;Perjantai;18;34;52;23;23;46
292;19.01.2018;2018;01;15;Perjantai;12;32;44;20;16;36
292;19.01.2018;2018;01;16;Perjantai;10;30;40;9;6;15
292;19.01.2018;2018;01;17;Perjantai;7;15;22;13;17;30
292;19.01.2018;2018;01;18;Perjantai;10;7;17;15;8;23
292;19.01.2018;2018;01;19;Perjantai;11;8;19;6;9;15
292;19.01.2018;2018;01;20;Perjantai;7;3;10;15;6;21
292;19.01.2018;2018;01;21;Perjantai;5;2;7;7;3;10
292;19.01.2018;2018;01;22;Perjantai;3;0;3;7;6;13
292;19.01.2018;2018;01;23;Perjantai;4;5;9;5;0;5
292;20.01.2018;2018;01;00;Lauantai;0;2;2;1;0;1
292;20.01.2018;2018;01;01;Lauantai;0;1;1;1;1;2
292;20.01.2018;2018;01;02;Lauantai;0;0;0;2;1;3
292;20.01.2018;2018;01;03;Lauantai;0;1;1;1;2;3
292;20.01.2018;2018;01;04;Lauantai;0;0;0;0;1;1
292;20.01.2018;2018;01;05;Lauantai;1;1;2;1;2;3
292;20.01.2018;2018;01;06;Lauantai;2;2;4;2;1;3
292;20.01.2018;2018;01;07;Lauantai;0;0;0;5;4;9
292;20.01.2018;2018;01;08;Lauantai;2;6;8;8;4;12
292;20.01.2018;2018;01;09;Lauantai;2;4;6;7;4;11
292;20.01.2018;2018;01;10;Lauantai;3;7;10;4;7;11
292;20.01.2018;2018;01;11;Lauantai;5;4;9;16;14;30
292;20.01.2018;2018;01;12;Lauantai;5;8;13;12;11;23
292;20.01.2018;2018;01;13;Lauantai;6;8;14;15;14;29
292;20.01.2018;2018;01;14;Lauantai;8;7;15;15;5;20
292;20.01.2018;2018;01;15;Lauantai;6;6;12;10;17;27
292;20.01.2018;2018;01;16;Lauantai;5;6;11;14;10;24
292;20.01.2018;2018;01;17;Lauantai;5;2;7;7;6;13
292;20.01.2018;2018;01;18;Lauantai;8;6;14;9;9;18
292;20.01.2018;2018;01;19;Lauantai;2;7;9;5;6;11
292;20.01.2018;2018;01;20;Lauantai;4;3;7;5;12;17
292;20.01.2018;2018;01;21;Lauantai;7;8;15;6;0;6
292;20.01.2018;2018;01;22;Lauantai;4;1;5;6;1;7
292;20.01.2018;2018;01;23;Lauantai;3;4;7;5;3;8
292;21.01.2018;2018;01;00;Sunnuntai;1;0;1;3;1;4
292;21.01.2018;2018;01;01;Sunnuntai;2;1;3;1;5;6
292;21.01.2018;2018;01;02;Sunnuntai;0;2;2;1;8;9
292;21.01.2018;2018;01;03;Sunnuntai;0;2;2;1;2;3
292;21.01.2018;2018;01;04;Sunnuntai;0;0;0;0;0;0
292;21.01.2018;2018;01;05;Sunnuntai;0;0;0;0;0;0
292;21.01.2018;2018;01;06;Sunnuntai;1;0;1;1;0;1
292;21.01.2018;2018;01;07;Sunnuntai;0;0;0;6;4;10
292;21.01.2018;2018;01;08;Sunnuntai;0;2;2;5;2;7
292;21.01.2018;2018;01;09;Sunnuntai;3;1;4;13;11;24
292;21.01.2018;2018;01;10;Sunnuntai;3;6;9;5;7;12
292;21.01.2018;2018;01;11;Sunnuntai;5;8;13;15;14;29
292;21.01.2018;2018;01;12;Sunnuntai;5;13;18;26;22;48
292;21.01.2018;2018;01;13;Sunnuntai;7;8;15;10;11;21
292;21.01.2018;2018;01;14;Sunnuntai;23;5;28;25;6;31
292;21.01.2018;2018;01;15;Sunnuntai;7;7;14;13;11;24
292;21.01.2018;2018;01;16;Sunnuntai;4;18;22;13;18;31
292;21.01.2018;2018;01;17;Sunnuntai;6;6;12;11;9;20
292;21.01.2018;2018;01;18;Sunnuntai;9;9;18;10;8;18
292;21.01.2018;2018;01;19;Sunnuntai;5;6;11;3;7;10
292;21.01.2018;2018;01;20;Sunnuntai;4;6;10;10;2;12
292;21.01.2018;2018;01;21;Sunnuntai;2;4;6;1;3;4
292;21.01.2018;2018;01;22;Sunnuntai;0;1;1;0;0;0
292;21.01.2018;2018;01;23;Sunnuntai;0;0;0;0;0;0
292;22.01.2018;2018;01;00;Maanantai;0;0;0;0;0;0
292;22.01.2018;2018;01;01;Maanantai;0;0;0;0;0;0
292;22.01.2018;2018;01;02;Maanantai;0;0;0;0;0;0
292;22.01.2018;2018;01;03;Maanantai;0;0;0;0;0;0
292;22.01.2018;2018;01;04;Maanantai;0;0;0;0;0;0
292;22.01.2018;2018;01;05;Maanantai;4;5;9;1;0;1
292;22.01.2018;2018;01;06;Maanantai;12;9;21;3;5;8
292;22.01.2018;2018;01;07;Maanantai;28;11;39;12;10;22
292;22.01.2018;2018;01;08;Maanantai;22;14;36;12;9;21
292;22.01.2018;2018;01;09;Maanantai;34;7;41;15;6;21
292;22.01.2018;2018;01;10;Maanantai;8;5;13;9;12;21
292;22.01.2018;2018;01;11;Maanantai;4;3;7;7;9;16
292;22.01.2018;2018;01;12;Maanantai;7;2;9;7;14;21
292;22.01.2018;2018;01;13;Maanantai;5;16;21;23;22;45
292;22.01.2018;2018;01;14;Maanantai;13;27;40;16;12;28
292;22.01.2018;2018;01;15;Maanantai;14;29;43;10;5;15
292;22.01.2018;2018;01;16;Maanantai;10;25;35;8;10;18
292;22.01.2018;2018;01;17;Maanantai;6;10;16;9;6;15
292;22.01.2018;2018;01;18;Maanantai;6;4;10;10;8;18
292;22.01.2018;2018;01;19;Maanantai;2;7;9;5;2;7
292;22.01.2018;2018;01;20;Maanantai;5;4;9;9;0;9
292;22.01.2018;2018;01;21;Maanantai;3;1;4;2;3;5
292;22.01.2018;2018;01;22;Maanantai;0;0;0;0;1;1
292;22.01.2018;2018;01;23;Maanantai;0;0;0;0;0;0
292;23.01.2018;2018;01;00;Tiistai;0;0;0;0;1;1
292;23.01.2018;2018;01;01;Tiistai;0;0;0;1;0;1
292;23.01.2018;2018;01;02;Tiistai;0;0;0;0;0;0
292;23.01.2018;2018;01;03;Tiistai;0;0;0;0;0;0
292;23.01.2018;2018;01;04;Tiistai;0;0;0;0;0;0
292;23.01.2018;2018;01;05;Tiistai;4;4;8;0;0;0
292;23.01.2018;2018;01;06;Tiistai;11;12;23;1;4;5
292;23.01.2018;2018;01;07;Tiistai;17;15;32;19;5;24
292;23.01.2018;2018;01;08;Tiistai;31;18;49;7;12;19
292;23.01.2018;2018;01;09;Tiistai;10;7;17;6;5;11
292;23.01.2018;2018;01;10;Tiistai;8;6;14;8;6;14
292;23.01.2018;2018;01;11;Tiistai;5;4;9;11;8;19
292;23.01.2018;2018;01;12;Tiistai;4;5;9;13;10;23
292;23.01.2018;2018;01;13;Tiistai;8;20;28;16;14;30
292;23.01.2018;2018;01;14;Tiistai;11;30;41;14;23;37
292;23.01.2018;2018;01;15;Tiistai;13;24;37;12;13;25
292;23.01.2018;2018;01;16;Tiistai;20;28;48;10;9;19
292;23.01.2018;2018;01;17;Tiistai;10;5;15;13;12;25
292;23.01.2018;2018;01;18;Tiistai;3;12;15;10;15;25
292;23.01.2018;2018;01;19;Tiistai;6;5;11;8;7;15
292;23.01.2018;2018;01;20;Tiistai;6;2;8;6;5;11
292;23.01.2018;2018;01;21;Tiistai;3;2;5;3;0;3
292;23.01.2018;2018;01;22;Tiistai;0;0;0;1;1;2
292;23.01.2018;2018;01;23;Tiistai;0;0;0;1;1;2
292;24.01.2018;2018;01;00;Keskiviikko;0;0;0;0;1;1
292;24.01.2018;2018;01;01;Keskiviikko;0;0;0;0;0;0
292;24.01.2018;2018;01;02;Keskiviikko;0;1;1;1;0;1
292;24.01.2018;2018;01;03;Keskiviikko;3;0;3;5;2;7
292;24.01.2018;2018;01;04;Keskiviikko;1;0;1;0;1;1
292;24.01.2018;2018;01;05;Keskiviikko;6;7;13;2;0;2
292;24.01.2018;2018;01;06;Keskiviikko;15;12;27;3;5;8
292;24.01.2018;2018;01;07;Keskiviikko;41;17;58;16;12;28
292;24.01.2018;2018;01;08;Keskiviikko;41;14;55;15;18;33
292;24.01.2018;2018;01;09;Keskiviikko;26;10;36;14;12;26
292;24.01.2018;2018;01;10;Keskiviikko;18;7;25;10;7;17
292;24.01.2018;2018;01;11;Keskiviikko;13;6;19;9;9;18
292;24.01.2018;2018;01;12;Keskiviikko;10;8;18;6;6;12
292;24.01.2018;2018;01;13;Keskiviikko;21;20;41;28;0;28
292;24.01.2018;2018;01;14;Keskiviikko;28;28;56;23;0;23
292;24.01.2018;2018;01;15;Keskiviikko;21;20;41;22;0;22
292;24.01.2018;2018;01;16;Keskiviikko;24;23;47;15;0;15
292;24.01.2018;2018;01;17;Keskiviikko;13;12;25;15;0;15
292;24.01.2018;2018;01;18;Keskiviikko;4;4;8;16;0;16
292;24.01.2018;2018;01;19;Keskiviikko;6;6;12;12;0;12
292;24.01.2018;2018;01;20;Keskiviikko;7;7;14;14;0;14
292;24.01.2018;2018;01;21;Keskiviikko;3;2;5;5;0;5
292;24.01.2018;2018;01;22;Keskiviikko;1;1;2;4;0;4
292;24.01.2018;2018;01;23;Keskiviikko;1;1;2;0;0;0
292;25.01.2018;2018;01;00;Torstai;1;1;2;0;0;0
292;25.01.2018;2018;01;01;Torstai;1;1;2;0;0;0
292;25.01.2018;2018;01;02;Torstai;1;0;1;0;0;0
292;25.01.2018;2018;01;03;Torstai;1;0;1;0;0;0
292;25.01.2018;2018;01;04;Torstai;3;3;6;0;0;0
292;25.01.2018;2018;01;05;Torstai;3;3;6;1;0;1
292;25.01.2018;2018;01;06;Torstai;6;6;12;9;0;9
292;25.01.2018;2018;01;07;Torstai;24;24;48;25;0;25
292;25.01.2018;2018;01;08;Torstai;19;19;38;32;0;32
292;25.01.2018;2018;01;09;Torstai;25;25;50;28;0;28
292;25.01.2018;2018;01;10;Torstai;11;10;21;39;0;39
292;25.01.2018;2018;01;11;Torstai;11;11;22;45;0;45
292;25.01.2018;2018;01;12;Torstai;11;10;21;38;0;38
292;25.01.2018;2018;01;13;Torstai;15;15;30;59;0;59
292;25.01.2018;2018;01;14;Torstai;28;27;55;61;0;61
292;25.01.2018;2018;01;15;Torstai;23;22;45;32;0;32
292;25.01.2018;2018;01;16;Torstai;23;22;45;26;0;26
292;25.01.2018;2018;01;17;Torstai;13;13;26;30;0;30
292;25.01.2018;2018;01;18;Torstai;7;6;13;33;0;33
292;25.01.2018;2018;01;19;Torstai;4;3;7;36;0;36
292;25.01.2018;2018;01;20;Torstai;6;5;11;21;0;21
292;25.01.2018;2018;01;21;Torstai;5;4;9;6;0;6
292;25.01.2018;2018;01;22;Torstai;2;1;3;5;0;5
292;25.01.2018;2018;01;23;Torstai;0;0;0;0;0;0
292;26.01.2018;2018;01;00;Perjantai;0;0;0;0;0;0
292;26.01.2018;2018;01;01;Perjantai;0;0;0;0;0;0
292;26.01.2018;2018;01;02;Perjantai;0;0;0;0;0;0
292;26.01.2018;2018;01;03;Perjantai;1;0;1;2;0;2
292;26.01.2018;2018;01;04;Perjantai;0;0;0;0;0;0
292;26.01.2018;2018;01;05;Perjantai;4;4;8;3;0;3
292;26.01.2018;2018;01;06;Perjantai;10;9;19;8;0;8
292;26.01.2018;2018;01;07;Perjantai;19;19;38;23;0;23
292;26.01.2018;2018;01;08;Perjantai;22;22;44;38;0;38
292;26.01.2018;2018;01;09;Perjantai;10;10;20;14;0;14
292;26.01.2018;2018;01;10;Perjantai;3;3;6;22;0;22
292;26.01.2018;2018;01;11;Perjantai;12;11;23;21;0;21
292;26.01.2018;2018;01;12;Perjantai;15;14;29;31;0;31
292;26.01.2018;2018;01;13;Perjantai;19;19;38;38;0;38
292;26.01.2018;2018;01;14;Perjantai;23;23;46;46;0;46
292;26.01.2018;2018;01;15;Perjantai;17;16;33;36;0;36
292;26.01.2018;2018;01;16;Perjantai;12;11;23;15;0;15
292;26.01.2018;2018;01;17;Perjantai;10;10;20;30;0;30
292;26.01.2018;2018;01;18;Perjantai;8;7;15;23;0;23
292;26.01.2018;2018;01;19;Perjantai;10;9;19;15;0;15
292;26.01.2018;2018;01;20;Perjantai;7;6;13;21;0;21
292;26.01.2018;2018;01;21;Perjantai;6;6;12;10;0;10
292;26.01.2018;2018;01;22;Perjantai;4;4;8;13;0;13
292;26.01.2018;2018;01;23;Perjantai;3;3;6;5;0;5
292;27.01.2018;2018;01;00;Lauantai;3;3;6;1;0;1
292;27.01.2018;2018;01;01;Lauantai;1;0;1;2;0;2
292;27.01.2018;2018;01;02;Lauantai;0;0;0;3;0;3
292;27.01.2018;2018;01;03;Lauantai;1;1;2;3;0;3
292;27.01.2018;2018;01;04;Lauantai;0;0;0;1;0;1
292;27.01.2018;2018;01;05;Lauantai;1;1;2;3;0;3
292;27.01.2018;2018;01;06;Lauantai;1;1;2;3;0;3
292;27.01.2018;2018;01;07;Lauantai;2;2;4;9;0;9
292;27.01.2018;2018;01;08;Lauantai;3;2;5;12;0;12
292;27.01.2018;2018;01;09;Lauantai;4;3;7;11;0;11
292;27.01.2018;2018;01;10;Lauantai;11;11;22;11;0;11
292;27.01.2018;2018;01;11;Lauantai;8;8;16;30;0;30
292;27.01.2018;2018;01;12;Lauantai;10;9;19;23;0;23
292;27.01.2018;2018;01;13;Lauantai;15;14;29;29;0;29
292;27.01.2018;2018;01;14;Lauantai;8;8;16;20;0;20
292;27.01.2018;2018;01;15;Lauantai;11;10;21;27;0;27
292;27.01.2018;2018;01;16;Lauantai;8;7;15;24;0;24
292;27.01.2018;2018;01;17;Lauantai;7;6;13;13;0;13
292;27.01.2018;2018;01;18;Lauantai;2;2;4;18;0;18
292;27.01.2018;2018;01;19;Lauantai;3;3;6;11;0;11
292;27.01.2018;2018;01;20;Lauantai;2;1;3;17;0;17
292;27.01.2018;2018;01;21;Lauantai;2;2;4;6;0;6
292;27.01.2018;2018;01;22;Lauantai;1;1;2;7;0;7
292;27.01.2018;2018;01;23;Lauantai;3;2;5;8;0;8
292;28.01.2018;2018;01;00;Sunnuntai;0;0;0;4;0;4
292;28.01.2018;2018;01;01;Sunnuntai;0;0;0;6;0;6
292;28.01.2018;2018;01;02;Sunnuntai;0;0;0;9;0;9
292;28.01.2018;2018;01;03;Sunnuntai;0;0;0;3;0;3
292;28.01.2018;2018;01;04;Sunnuntai;0;0;0;0;0;0
292;28.01.2018;2018;01;05;Sunnuntai;0;0;0;0;0;0
292;28.01.2018;2018;01;06;Sunnuntai;2;1;3;1;0;1
292;28.01.2018;2018;01;07;Sunnuntai;1;0;1;10;0;10
292;28.01.2018;2018;01;08;Sunnuntai;1;0;1;7;0;7
292;28.01.2018;2018;01;09;Sunnuntai;5;5;10;24;0;24
292;28.01.2018;2018;01;10;Sunnuntai;6;6;12;12;0;12
292;28.01.2018;2018;01;11;Sunnuntai;8;8;16;29;0;29
292;28.01.2018;2018;01;12;Sunnuntai;8;8;16;48;0;48
292;28.01.2018;2018;01;13;Sunnuntai;5;4;9;21;0;21
292;28.01.2018;2018;01;14;Sunnuntai;4;4;8;31;0;31
292;28.01.2018;2018;01;15;Sunnuntai;5;5;10;24;0;24
292;28.01.2018;2018;01;16;Sunnuntai;5;5;10;31;0;31
292;28.01.2018;2018;01;17;Sunnuntai;7;7;14;20;0;20
292;28.01.2018;2018;01;18;Sunnuntai;6;6;12;18;0;18
292;28.01.2018;2018;01;19;Sunnuntai;5;5;10;10;0;10
292;28.01.2018;2018;01;20;Sunnuntai;2;2;4;12;0;12
292;28.01.2018;2018;01;21;Sunnuntai;1;1;2;4;0;4
292;28.01.2018;2018;01;22;Sunnuntai;0;0;0;0;0;0
292;28.01.2018;2018;01;23;Sunnuntai;0;0;0;0;0;0
292;29.01.2018;2018;01;00;Maanantai;0;0;0;0;0;0
292;29.01.2018;2018;01;01;Maanantai;0;0;0;0;0;0
292;29.01.2018;2018;01;02;Maanantai;0;0;0;0;0;0
292;29.01.2018;2018;01;03;Maanantai;2;2;4;0;0;0
292;29.01.2018;2018;01;04;Maanantai;0;0;0;0;0;0
292;29.01.2018;2018;01;05;Maanantai;3;3;6;1;0;1
292;29.01.2018;2018;01;06;Maanantai;12;12;24;8;0;8
292;29.01.2018;2018;01;07;Maanantai;22;21;43;22;0;22
292;29.01.2018;2018;01;08;Maanantai;21;20;41;21;0;21
292;29.01.2018;2018;01;09;Maanantai;26;26;52;21;0;21
292;29.01.2018;2018;01;10;Maanantai;11;10;21;21;0;21
292;29.01.2018;2018;01;11;Maanantai;10;9;19;16;0;16
292;29.01.2018;2018;01;12;Maanantai;12;11;23;21;0;21
292;29.01.2018;2018;01;13;Maanantai;14;17;31;29;26;55
292;29.01.2018;2018;01;14;Maanantai;23;33;56;18;18;36
292;29.01.2018;2018;01;15;Maanantai;11;37;48;26;23;49
292;29.01.2018;2018;01;16;Maanantai;16;32;48;16;16;32
292;29.01.2018;2018;01;17;Maanantai;10;22;32;19;18;37
292;29.01.2018;2018;01;18;Maanantai;10;7;17;10;13;23
292;29.01.2018;2018;01;19;Maanantai;8;5;13;10;14;24
292;29.01.2018;2018;01;20;Maanantai;7;9;16;12;8;20
292;29.01.2018;2018;01;21;Maanantai;4;2;6;4;4;8
292;29.01.2018;2018;01;22;Maanantai;1;0;1;2;0;2
292;29.01.2018;2018;01;23;Maanantai;0;0;0;0;0;0
292;30.01.2018;2018;01;00;Tiistai;0;0;0;0;0;0
292;30.01.2018;2018;01;01;Tiistai;0;0;0;0;0;0
292;30.01.2018;2018;01;02;Tiistai;0;0;0;0;0;0
292;30.01.2018;2018;01;03;Tiistai;1;0;1;0;0;0
292;30.01.2018;2018;01;04;Tiistai;0;0;0;0;0;0
292;30.01.2018;2018;01;05;Tiistai;4;3;7;1;1;2
292;30.01.2018;2018;01;06;Tiistai;12;14;26;3;7;10
292;30.01.2018;2018;01;07;Tiistai;35;18;53;30;10;40
292;30.01.2018;2018;01;08;Tiistai;38;15;53;17;16;33
292;30.01.2018;2018;01;09;Tiistai;14;8;22;8;4;12
292;30.01.2018;2018;01;10;Tiistai;16;13;29;15;21;36
292;30.01.2018;2018;01;11;Tiistai;5;15;20;15;15;30
292;30.01.2018;2018;01;12;Tiistai;6;16;22;7;12;19
292;30.01.2018;2018;01;13;Tiistai;8;28;36;25;10;35
292;30.01.2018;2018;01;14;Tiistai;15;31;46;16;23;39
292;30.01.2018;2018;01;15;Tiistai;13;32;45;23;13;36
292;30.01.2018;2018;01;16;Tiistai;20;30;50;13;22;35
292;30.01.2018;2018;01;17;Tiistai;17;15;32;9;8;17
292;30.01.2018;2018;01;18;Tiistai;7;3;10;12;8;20
292;30.01.2018;2018;01;19;Tiistai;10;10;20;5;8;13
292;30.01.2018;2018;01;20;Tiistai;9;6;15;9;6;15
292;30.01.2018;2018;01;21;Tiistai;6;5;11;3;5;8
292;30.01.2018;2018;01;22;Tiistai;1;1;2;1;2;3
292;30.01.2018;2018;01;23;Tiistai;1;1;2;2;0;2
292;31.01.2018;2018;01;00;Keskiviikko;0;0;0;1;1;2
292;31.01.2018;2018;01;01;Keskiviikko;0;0;0;0;1;1
292;31.01.2018;2018;01;02;Keskiviikko;0;0;0;0;1;1
292;31.01.2018;2018;01;03;Keskiviikko;0;0;0;0;0;0
292;31.01.2018;2018;01;04;Keskiviikko;0;0;0;0;0;0
292;31.01.2018;2018;01;05;Keskiviikko;4;3;7;3;3;6
292;31.01.2018;2018;01;06;Keskiviikko;11;10;21;2;4;6
292;31.01.2018;2018;01;07;Keskiviikko;41;15;56;26;10;36
292;31.01.2018;2018;01;08;Keskiviikko;9;5;14;13;22;35
292;31.01.2018;2018;01;09;Keskiviikko;12;15;27;11;10;21
292;31.01.2018;2018;01;10;Keskiviikko;8;22;30;15;10;25
292;31.01.2018;2018;01;11;Keskiviikko;15;22;37;16;10;26
292;31.01.2018;2018;01;12;Keskiviikko;14;22;36;20;20;40
292;31.01.2018;2018;01;13;Keskiviikko;7;22;29;21;20;41
292;31.01.2018;2018;01;14;Keskiviikko;12;22;34;34;29;63
292;31.01.2018;2018;01;15;Keskiviikko;19;24;43;18;14;32
292;31.01.2018;2018;01;16;Keskiviikko;14;14;28;16;16;32
292;31.01.2018;2018;01;17;Keskiviikko;6;9;15;20;17;37
292;31.01.2018;2018;01;18;Keskiviikko;7;9;16;23;16;39
292;31.01.2018;2018;01;19;Keskiviikko;7;11;18;14;10;24
292;31.01.2018;2018;01;20;Keskiviikko;9;2;11;8;11;19
292;31.01.2018;2018;01;21;Keskiviikko;5;4;9;7;5;12
292;31.01.2018;2018;01;22;Keskiviikko;1;1;2;2;0;2
292;31.01.2018;2018;01;23;Keskiviikko;0;2;2;0;0;0
292;01.02.2018;2018;02;00;Torstai;0;0;0;1;0;1
292;01.02.2018;2018;02;01;Torstai;0;0;0;0;0;0
292;01.02.2018;2018;02;02;Torstai;0;0;0;0;0;0
292;01.02.2018;2018;02;03;Torstai;0;0;0;0;0;0
292;01.02.2018;2018;02;04;Torstai;0;0;0;0;0;0
292;01.02.2018;2018;02;05;Torstai;3;5;8;2;0;2
292;01.02.2018;2018;02;06;Torstai;12;9;21;8;5;13
292;01.02.2018;2018;02;07;Torstai;37;10;47;18;13;31
292;01.02.2018;2018;02;08;Torstai;42;12;54;31;20;51
292;01.02.2018;2018;02;09;Torstai;8;12;20;12;10;22
292;01.02.2018;2018;02;10;Torstai;6;18;24;9;13;22
292;01.02.2018;2018;02;11;Torstai;4;16;20;10;15;25
292;01.02.2018;2018;02;12;Torstai;5;30;35;10;11;21
292;01.02.2018;2018;02;13;Torstai;10;13;23;11;7;18
292;01.02.2018;2018;02;14;Torstai;17;22;39;13;15;28
292;01.02.2018;2018;02;15;Torstai;12;28;40;16;13;29
292;01.02.2018;2018;02;16;Torstai;10;21;31;15;10;25
292;01.02.2018;2018;02;17;Torstai;9;16;25;10;11;21
292;01.02.2018;2018;02;18;Torstai;7;6;13;17;8;25
292;01.02.2018;2018;02;19;Torstai;8;7;15;12;8;20
292;01.02.2018;2018;02;20;Torstai;9;3;12;6;9;15
292;01.02.2018;2018;02;21;Torstai;1;1;2;5;5;10
292;01.02.2018;2018;02;22;Torstai;1;0;1;2;4;6
292;01.02.2018;2018;02;23;Torstai;0;1;1;0;0;0
292;02.02.2018;2018;02;00;Perjantai;0;0;0;1;0;1
292;02.02.2018;2018;02;01;Perjantai;0;0;0;0;0;0
292;02.02.2018;2018;02;02;Perjantai;0;0;0;0;0;0
292;02.02.2018;2018;02;03;Perjantai;0;0;0;0;0;0
292;02.02.2018;2018;02;04;Perjantai;0;0;0;0;0;0
292;02.02.2018;2018;02;05;Perjantai;0;2;2;3;0;3
292;02.02.2018;2018;02;06;Perjantai;13;4;17;2;4;6
292;02.02.2018;2018;02;07;Perjantai;32;12;44;12;6;18
292;02.02.2018;2018;02;08;Perjantai;35;8;43;19;11;30
292;02.02.2018;2018;02;09;Perjantai;8;8;16;10;9;19
292;02.02.2018;2018;02;10;Perjantai;5;19;24;5;13;18
292;02.02.2018;2018;02;11;Perjantai;5;23;28;11;15;26
292;02.02.2018;2018;02;12;Perjantai;18;24;42;27;23;50
292;02.02.2018;2018;02;13;Perjantai;10;18;28;10;14;24
292;02.02.2018;2018;02;14;Perjantai;16;25;41;13;19;32
292;02.02.2018;2018;02;15;Perjantai;16;19;35;19;27;46
292;02.02.2018;2018;02;16;Perjantai;6;18;24;15;7;22
292;02.02.2018;2018;02;17;Perjantai;6;20;26;15;14;29
292;02.02.2018;2018;02;18;Perjantai;12;15;27;21;13;34
292;02.02.2018;2018;02;19;Perjantai;6;6;12;13;9;22
292;02.02.2018;2018;02;20;Perjantai;5;7;12;5;9;14
292;02.02.2018;2018;02;21;Perjantai;4;4;8;10;5;15
292;02.02.2018;2018;02;22;Perjantai;2;2;4;4;0;4
292;02.02.2018;2018;02;23;Perjantai;3;0;3;7;1;8
292;03.02.2018;2018;02;00;Lauantai;1;3;4;1;3;4
292;03.02.2018;2018;02;01;Lauantai;0;0;0;0;0;0
292;03.02.2018;2018;02;02;Lauantai;0;2;2;1;1;2
292;03.02.2018;2018;02;03;Lauantai;0;0;0;0;0;0
292;03.02.2018;2018;02;04;Lauantai;2;1;3;0;0;0
292;03.02.2018;2018;02;05;Lauantai;0;1;1;0;0;0
292;03.02.2018;2018;02;06;Lauantai;0;4;4;1;0;1
292;03.02.2018;2018;02;07;Lauantai;0;0;0;2;1;3
292;03.02.2018;2018;02;08;Lauantai;1;1;2;2;1;3
292;03.02.2018;2018;02;09;Lauantai;3;6;9;0;5;5
292;03.02.2018;2018;02;10;Lauantai;5;8;13;7;4;11
292;03.02.2018;2018;02;11;Lauantai;5;7;12;5;9;14
292;03.02.2018;2018;02;12;Lauantai;6;8;14;13;14;27
292;03.02.2018;2018;02;13;Lauantai;8;15;23;12;13;25
292;03.02.2018;2018;02;14;Lauantai;10;10;20;10;9;19
292;03.02.2018;2018;02;15;Lauantai;6;13;19;16;16;32
292;03.02.2018;2018;02;16;Lauantai;16;7;23;16;8;24
292;03.02.2018;2018;02;17;Lauantai;1;7;8;7;8;15
292;03.02.2018;2018;02;18;Lauantai;7;3;10;8;9;17
292;03.02.2018;2018;02;19;Lauantai;3;3;6;2;2;4
292;03.02.2018;2018;02;20;Lauantai;7;2;9;4;4;8
292;03.02.2018;2018;02;21;Lauantai;1;2;3;6;0;6
292;03.02.2018;2018;02;22;Lauantai;4;2;6;5;4;9
292;03.02.2018;2018;02;23;Lauantai;0;0;0;3;0;3
292;04.02.2018;2018;02;00;Sunnuntai;0;0;0;6;6;12
292;04.02.2018;2018;02;01;Sunnuntai;0;0;0;0;1;1
292;04.02.2018;2018;02;02;Sunnuntai;0;1;1;0;5;5
292;04.02.2018;2018;02;03;Sunnuntai;0;0;0;0;2;2
292;04.02.2018;2018;02;04;Sunnuntai;1;0;1;0;0;0
292;04.02.2018;2018;02;05;Sunnuntai;0;0;0;0;0;0
292;04.02.2018;2018;02;06;Sunnuntai;3;0;3;1;0;1
292;04.02.2018;2018;02;07;Sunnuntai;0;0;0;3;0;3
292;04.02.2018;2018;02;08;Sunnuntai;0;2;2;1;2;3
292;04.02.2018;2018;02;09;Sunnuntai;4;2;6;3;5;8
292;04.02.2018;2018;02;10;Sunnuntai;1;2;3;7;7;14
292;04.02.2018;2018;02;11;Sunnuntai;2;6;8;13;12;25
292;04.02.2018;2018;02;12;Sunnuntai;4;9;13;11;12;23
292;04.02.2018;2018;02;13;Sunnuntai;5;0;5;11;15;26
292;04.02.2018;2018;02;14;Sunnuntai;6;8;14;10;5;15
292;04.02.2018;2018;02;15;Sunnuntai;3;4;7;9;9;18
292;04.02.2018;2018;02;16;Sunnuntai;2;8;10;8;8;16
292;04.02.2018;2018;02;17;Sunnuntai;2;4;6;17;8;25
292;04.02.2018;2018;02;18;Sunnuntai;2;0;2;8;11;19
292;04.02.2018;2018;02;19;Sunnuntai;2;2;4;4;6;10
292;04.02.2018;2018;02;20;Sunnuntai;1;2;3;3;5;8
292;04.02.2018;2018;02;21;Sunnuntai;1;0;1;5;2;7
292;04.02.2018;2018;02;22;Sunnuntai;1;1;2;0;2;2
292;04.02.2018;2018;02;23;Sunnuntai;0;0;0;0;0;0
292;05.02.2018;2018;02;00;Maanantai;0;0;0;0;0;0
292;05.02.2018;2018;02;01;Maanantai;0;0;0;0;0;0
292;05.02.2018;2018;02;02;Maanantai;0;0;0;0;0;0
292;05.02.2018;2018;02;03;Maanantai;0;0;0;0;0;0
292;05.02.2018;2018;02;04;Maanantai;0;0;0;0;1;1
292;05.02.2018;2018;02;05;Maanantai;2;2;4;1;0;1
292;05.02.2018;2018;02;06;Maanantai;12;6;18;4;2;6
292;05.02.2018;2018;02;07;Maanantai;28;9;37;12;7;19
292;05.02.2018;2018;02;08;Maanantai;31;9;40;18;10;28
292;05.02.2018;2018;02;09;Maanantai;5;12;17;11;10;21
292;05.02.2018;2018;02;10;Maanantai;8;11;19;6;5;11
292;05.02.2018;2018;02;11;Maanantai;2;17;19;5;10;15
292;05.02.2018;2018;02;12;Maanantai;5;16;21;13;12;25
292;05.02.2018;2018;02;13;Maanantai;11;15;26;10;14;24
292;05.02.2018;2018;02;14;Maanantai;17;21;38;17;14;31
292;05.02.2018;2018;02;15;Maanantai;10;16;26;12;11;23
292;05.02.2018;2018;02;16;Maanantai;10;16;26;11;13;24
292;05.02.2018;2018;02;17;Maanantai;5;9;14;11;14;25
292;05.02.2018;2018;02;18;Maanantai;3;4;7;10;13;23
292;05.02.2018;2018;02;19;Maanantai;2;5;7;4;8;12
292;05.02.2018;2018;02;20;Maanantai;7;3;10;5;1;6
292;05.02.2018;2018;02;21;Maanantai;3;2;5;4;6;10
292;05.02.2018;2018;02;22;Maanantai;0;0;0;1;1;2
292;05.02.2018;2018;02;23;Maanantai;0;0;0;0;0;0
292;06.02.2018;2018;02;00;Tiistai;0;0;0;2;1;3
292;06.02.2018;2018;02;01;Tiistai;0;0;0;0;1;1
292;06.02.2018;2018;02;02;Tiistai;0;0;0;0;0;0
292;06.02.2018;2018;02;03;Tiistai;0;0;0;0;0;0
292;06.02.2018;2018;02;04;Tiistai;0;0;0;0;0;0
292;06.02.2018;2018;02;05;Tiistai;2;3;5;2;0;2
292;06.02.2018;2018;02;06;Tiistai;7;7;14;7;4;11
292;06.02.2018;2018;02;07;Tiistai;25;9;34;14;12;26
292;06.02.2018;2018;02;08;Tiistai;24;14;38;18;12;30
292;06.02.2018;2018;02;09;Tiistai;6;7;13;5;7;12
292;06.02.2018;2018;02;10;Tiistai;8;24;32;10;16;26
292;06.02.2018;2018;02;11;Tiistai;13;19;32;10;10;20
292;06.02.2018;2018;02;12;Tiistai;13;6;19;11;8;19
292;06.02.2018;2018;02;13;Tiistai;16;10;26;15;7;22
292;06.02.2018;2018;02;14;Tiistai;13;22;35;7;14;21
292;06.02.2018;2018;02;15;Tiistai;13;16;29;16;16;32
292;06.02.2018;2018;02;16;Tiistai;13;17;30;12;17;29
292;06.02.2018;2018;02;17;Tiistai;10;13;23;9;9;18
292;06.02.2018;2018;02;18;Tiistai;6;7;13;16;16;32
292;06.02.2018;2018;02;19;Tiistai;12;7;19;10;12;22
292;06.02.2018;2018;02;20;Tiistai;12;3;15;5;6;11
292;06.02.2018;2018;02;21;Tiistai;4;4;8;4;3;7
292;06.02.2018;2018;02;22;Tiistai;0;2;2;1;0;1
292;06.02.2018;2018;02;23;Tiistai;0;0;0;0;0;0
292;07.02.2018;2018;02;00;Keskiviikko;0;0;0;0;0;0
292;07.02.2018;2018;02;01;Keskiviikko;1;0;1;0;0;0
292;07.02.2018;2018;02;02;Keskiviikko;1;0;1;9;1;10
292;07.02.2018;2018;02;03;Keskiviikko;0;0;0;0;0;0
292;07.02.2018;2018;02;04;Keskiviikko;0;1;1;0;0;0
292;07.02.2018;2018;02;05;Keskiviikko;5;5;10;2;1;3
292;07.02.2018;2018;02;06;Keskiviikko;9;9;18;5;7;12
292;07.02.2018;2018;02;07;Keskiviikko;25;16;41;22;12;34
292;07.02.2018;2018;02;08;Keskiviikko;30;12;42;15;13;28
292;07.02.2018;2018;02;09;Keskiviikko;17;11;28;11;8;19
292;07.02.2018;2018;02;10;Keskiviikko;8;8;16;14;11;25
292;07.02.2018;2018;02;11;Keskiviikko;6;14;20;11;14;25
292;07.02.2018;2018;02;12;Keskiviikko;8;12;20;12;7;19
292;07.02.2018;2018;02;13;Keskiviikko;9;30;39;13;12;25
292;07.02.2018;2018;02;14;Keskiviikko;12;31;43;17;16;33
292;07.02.2018;2018;02;15;Keskiviikko;23;20;43;18;14;32
292;07.02.2018;2018;02;16;Keskiviikko;17;24;41;15;22;37
292;07.02.2018;2018;02;17;Keskiviikko;12;9;21;14;13;27
292;07.02.2018;2018;02;18;Keskiviikko;9;9;18;7;4;11
292;07.02.2018;2018;02;19;Keskiviikko;5;5;10;15;17;32
292;07.02.2018;2018;02;20;Keskiviikko;9;8;17;12;7;19
292;07.02.2018;2018;02;21;Keskiviikko;7;5;12;2;3;5
292;07.02.2018;2018;02;22;Keskiviikko;1;2;3;1;0;1
292;07.02.2018;2018;02;23;Keskiviikko;0;0;0;1;4;5
292;08.02.2018;2018;02;00;Torstai;0;0;0;0;0;0
292;08.02.2018;2018;02;01;Torstai;0;0;0;0;0;0
292;08.02.2018;2018;02;02;Torstai;0;0;0;0;0;0
292;08.02.2018;2018;02;03;Torstai;0;0;0;0;0;0
292;08.02.2018;2018;02;04;Torstai;0;0;0;0;0;0
292;08.02.2018;2018;02;05;Torstai;4;4;8;1;0;1
292;08.02.2018;2018;02;06;Torstai;9;14;23;3;3;6
292;08.02.2018;2018;02;07;Torstai;34;12;46;13;13;26
292;08.02.2018;2018;02;08;Torstai;16;13;29;10;13;23
292;08.02.2018;2018;02;09;Torstai;36;10;46;18;8;26
292;08.02.2018;2018;02;10;Torstai;11;7;18;13;11;24
292;08.02.2018;2018;02;11;Torstai;14;9;23;14;15;29
292;08.02.2018;2018;02;12;Torstai;14;12;26;3;10;13
292;08.02.2018;2018;02;13;Torstai;8;16;24;17;14;31
292;08.02.2018;2018;02;14;Torstai;19;17;36;18;14;32
292;08.02.2018;2018;02;15;Torstai;20;37;57;21;16;37
292;08.02.2018;2018;02;16;Torstai;11;33;44;4;10;14
292;08.02.2018;2018;02;17;Torstai;10;12;22;14;4;18
292;08.02.2018;2018;02;18;Torstai;8;10;18;4;12;16
292;08.02.2018;2018;02;19;Torstai;10;4;14;11;10;21
292;08.02.2018;2018;02;20;Torstai;8;5;13;9;12;21
292;08.02.2018;2018;02;21;Torstai;4;2;6;6;0;6
292;08.02.2018;2018;02;22;Torstai;1;0;1;1;2;3
292;08.02.2018;2018;02;23;Torstai;2;0;2;0;0;0
292;09.02.2018;2018;02;00;Perjantai;0;0;0;1;0;1
292;09.02.2018;2018;02;01;Perjantai;0;0;0;0;1;1
292;09.02.2018;2018;02;02;Perjantai;0;0;0;0;0;0
292;09.02.2018;2018;02;03;Perjantai;0;0;0;0;0;0
292;09.02.2018;2018;02;04;Perjantai;1;1;2;0;1;1
292;09.02.2018;2018;02;05;Perjantai;5;4;9;1;0;1
292;09.02.2018;2018;02;06;Perjantai;9;10;19;3;5;8
292;09.02.2018;2018;02;07;Perjantai;40;15;55;12;6;18
292;09.02.2018;2018;02;08;Perjantai;32;11;43;20;9;29
292;09.02.2018;2018;02;09;Perjantai;29;14;43;10;8;18
292;09.02.2018;2018;02;10;Perjantai;11;6;17;8;20;28
292;09.02.2018;2018;02;11;Perjantai;10;15;25;16;11;27
292;09.02.2018;2018;02;12;Perjantai;19;11;30;18;11;29
292;09.02.2018;2018;02;13;Perjantai;20;46;66;12;15;27
292;09.02.2018;2018;02;14;Perjantai;22;29;51;9;10;19
292;09.02.2018;2018;02;15;Perjantai;18;26;44;11;9;20
292;09.02.2018;2018;02;16;Perjantai;17;14;31;21;17;38
292;09.02.2018;2018;02;17;Perjantai;7;8;15;14;9;23
292;09.02.2018;2018;02;18;Perjantai;6;9;15;11;10;21
292;09.02.2018;2018;02;19;Perjantai;6;4;10;12;7;19
292;09.02.2018;2018;02;20;Perjantai;9;6;15;8;7;15
292;09.02.2018;2018;02;21;Perjantai;5;6;11;5;6;11
292;09.02.2018;2018;02;22;Perjantai;6;2;8;7;5;12
292;09.02.2018;2018;02;23;Perjantai;3;0;3;10;2;12
292;10.02.2018;2018;02;00;Lauantai;2;0;2;1;2;3
292;10.02.2018;2018;02;01;Lauantai;0;0;0;2;4;6
292;10.02.2018;2018;02;02;Lauantai;0;0;0;1;5;6
292;10.02.2018;2018;02;03;Lauantai;0;0;0;0;0;0
292;10.02.2018;2018;02;04;Lauantai;0;0;0;1;0;1
292;10.02.2018;2018;02;05;Lauantai;1;2;3;1;0;1
292;10.02.2018;2018;02;06;Lauantai;1;1;2;4;2;6
292;10.02.2018;2018;02;07;Lauantai;2;2;4;3;2;5
292;10.02.2018;2018;02;08;Lauantai;5;4;9;6;12;18
292;10.02.2018;2018;02;09;Lauantai;5;6;11;3;5;8
292;10.02.2018;2018;02;10;Lauantai;8;4;12;5;11;16
292;10.02.2018;2018;02;11;Lauantai;4;7;11;20;12;32
292;10.02.2018;2018;02;12;Lauantai;10;5;15;15;18;33
292;10.02.2018;2018;02;13;Lauantai;3;4;7;8;8;16
292;10.02.2018;2018;02;14;Lauantai;11;9;20;16;8;24
292;10.02.2018;2018;02;15;Lauantai;5;3;8;15;11;26
292;10.02.2018;2018;02;16;Lauantai;9;12;21;7;8;15
292;10.02.2018;2018;02;17;Lauantai;4;7;11;15;9;24
292;10.02.2018;2018;02;18;Lauantai;9;6;15;7;9;16
292;10.02.2018;2018;02;19;Lauantai;6;5;11;9;4;13
292;10.02.2018;2018;02;20;Lauantai;2;4;6;5;6;11
292;10.02.2018;2018;02;21;Lauantai;6;3;9;5;6;11
292;10.02.2018;2018;02;22;Lauantai;4;5;9;4;0;4
292;10.02.2018;2018;02;23;Lauantai;1;0;1;5;8;13
292;11.02.2018;2018;02;00;Sunnuntai;1;1;2;2;0;2
292;11.02.2018;2018;02;01;Sunnuntai;1;0;1;0;1;1
292;11.02.2018;2018;02;02;Sunnuntai;0;0;0;1;5;6
292;11.02.2018;2018;02;03;Sunnuntai;0;1;1;2;3;5
292;11.02.2018;2018;02;04;Sunnuntai;0;0;0;0;0;0
292;11.02.2018;2018;02;05;Sunnuntai;0;1;1;1;2;3
292;11.02.2018;2018;02;06;Sunnuntai;4;1;5;2;1;3
292;11.02.2018;2018;02;07;Sunnuntai;1;0;1;3;3;6
292;11.02.2018;2018;02;08;Sunnuntai;3;2;5;4;4;8
292;11.02.2018;2018;02;09;Sunnuntai;4;3;7;4;2;6
292;11.02.2018;2018;02;10;Sunnuntai;4;5;9;12;10;22
292;11.02.2018;2018;02;11;Sunnuntai;8;10;18;15;13;28
292;11.02.2018;2018;02;12;Sunnuntai;8;6;14;12;9;21
292;11.02.2018;2018;02;13;Sunnuntai;10;10;20;10;14;24
292;11.02.2018;2018;02;14;Sunnuntai;7;8;15;11;11;22
292;11.02.2018;2018;02;15;Sunnuntai;15;11;26;15;9;24
292;11.02.2018;2018;02;16;Sunnuntai;7;8;15;11;5;16
292;11.02.2018;2018;02;17;Sunnuntai;10;7;17;15;9;24
292;11.02.2018;2018;02;18;Sunnuntai;11;7;18;17;14;31
292;11.02.2018;2018;02;19;Sunnuntai;2;0;2;12;11;23
292;11.02.2018;2018;02;20;Sunnuntai;6;7;13;8;3;11
292;11.02.2018;2018;02;21;Sunnuntai;3;5;8;2;0;2
292;11.02.2018;2018;02;22;Sunnuntai;2;1;3;0;2;2
292;11.02.2018;2018;02;23;Sunnuntai;0;0;0;1;3;4
292;12.02.2018;2018;02;00;Maanantai;0;0;0;0;0;0
292;12.02.2018;2018;02;01;Maanantai;0;0;0;0;0;0
292;12.02.2018;2018;02;02;Maanantai;0;1;1;0;0;0
292;12.02.2018;2018;02;03;Maanantai;1;0;1;0;0;0
292;12.02.2018;2018;02;04;Maanantai;0;0;0;0;0;0
292;12.02.2018;2018;02;05;Maanantai;4;2;6;2;0;2
292;12.02.2018;2018;02;06;Maanantai;10;10;20;5;6;11
292;12.02.2018;2018;02;07;Maanantai;33;13;46;15;9;24
292;12.02.2018;2018;02;08;Maanantai;32;15;47;16;9;25
292;12.02.2018;2018;02;09;Maanantai;32;11;43;18;8;26
292;12.02.2018;2018;02;10;Maanantai;16;7;23;11;14;25
292;12.02.2018;2018;02;11;Maanantai;12;5;17;18;1;19
292;12.02.2018;2018;02;12;Maanantai;9;10;19;5;16;21
292;12.02.2018;2018;02;13;Maanantai;9;18;27;15;10;25
292;12.02.2018;2018;02;14;Maanantai;25;30;55;20;14;34
292;12.02.2018;2018;02;15;Maanantai;17;35;52;11;15;26
292;12.02.2018;2018;02;16;Maanantai;19;43;62;11;21;32
292;12.02.2018;2018;02;17;Maanantai;16;16;32;14;9;23
292;12.02.2018;2018;02;18;Maanantai;9;3;12;13;10;23
292;12.02.2018;2018;02;19;Maanantai;7;7;14;10;16;26
292;12.02.2018;2018;02;20;Maanantai;11;7;18;9;8;17
292;12.02.2018;2018;02;21;Maanantai;5;3;8;0;2;2
292;12.02.2018;2018;02;22;Maanantai;2;0;2;2;0;2
292;12.02.2018;2018;02;23;Maanantai;0;0;0;0;1;1
292;13.02.2018;2018;02;00;Tiistai;0;0;0;1;0;1
292;13.02.2018;2018;02;01;Tiistai;0;0;0;0;1;1
292;13.02.2018;2018;02;02;Tiistai;0;0;0;0;0;0
292;13.02.2018;2018;02;03;Tiistai;0;1;1;0;0;0
292;13.02.2018;2018;02;04;Tiistai;1;0;1;0;0;0
292;13.02.2018;2018;02;05;Tiistai;3;4;7;0;0;0
292;13.02.2018;2018;02;06;Tiistai;19;13;32;4;3;7
292;13.02.2018;2018;02;07;Tiistai;44;18;62;17;7;24
292;13.02.2018;2018;02;08;Tiistai;49;14;63;14;17;31
292;13.02.2018;2018;02;09;Tiistai;23;18;41;11;13;24
292;13.02.2018;2018;02;10;Tiistai;18;12;30;16;5;21
292;13.02.2018;2018;02;11;Tiistai;19;12;31;17;6;23
292;13.02.2018;2018;02;12;Tiistai;10;19;29;9;13;22
292;13.02.2018;2018;02;13;Tiistai;10;23;33;15;15;30
292;13.02.2018;2018;02;14;Tiistai;14;47;61;6;20;26
292;13.02.2018;2018;02;15;Tiistai;19;26;45;15;13;28
292;13.02.2018;2018;02;16;Tiistai;28;30;58;15;15;30
292;13.02.2018;2018;02;17;Tiistai;16;12;28;16;12;28
292;13.02.2018;2018;02;18;Tiistai;10;7;17;14;10;24
292;13.02.2018;2018;02;19;Tiistai;10;14;24;18;6;24
292;13.02.2018;2018;02;20;Tiistai;13;4;17;13;14;27
292;13.02.2018;2018;02;21;Tiistai;6;9;15;5;0;5
292;13.02.2018;2018;02;22;Tiistai;2;0;2;1;0;1
292;13.02.2018;2018;02;23;Tiistai;1;0;1;0;0;0
292;14.02.2018;2018;02;00;Keskiviikko;0;0;0;0;0;0
292;14.02.2018;2018;02;01;Keskiviikko;1;0;1;0;0;0
292;14.02.2018;2018;02;02;Keskiviikko;1;0;1;10;0;10
292;14.02.2018;2018;02;03;Keskiviikko;0;0;0;0;0;0
292;14.02.2018;2018;02;04;Keskiviikko;1;0;1;0;0;0
292;14.02.2018;2018;02;05;Keskiviikko;10;0;10;3;0;3
292;14.02.2018;2018;02;06;Keskiviikko;18;0;18;12;0;12
292;14.02.2018;2018;02;07;Keskiviikko;41;0;41;34;0;34
292;14.02.2018;2018;02;08;Keskiviikko;42;0;42;28;0;28
292;14.02.2018;2018;02;09;Keskiviikko;28;0;28;19;0;19
292;14.02.2018;2018;02;10;Keskiviikko;16;0;16;25;0;25
292;14.02.2018;2018;02;11;Keskiviikko;20;0;20;25;0;25
292;14.02.2018;2018;02;12;Keskiviikko;20;0;20;19;0;19
292;14.02.2018;2018;02;13;Keskiviikko;39;0;39;25;0;25
292;14.02.2018;2018;02;14;Keskiviikko;43;0;43;33;0;33
292;14.02.2018;2018;02;15;Keskiviikko;43;0;43;32;0;32
292;14.02.2018;2018;02;16;Keskiviikko;41;0;41;37;0;37
292;14.02.2018;2018;02;17;Keskiviikko;21;0;21;27;0;27
292;14.02.2018;2018;02;18;Keskiviikko;18;0;18;11;0;11
292;14.02.2018;2018;02;19;Keskiviikko;10;0;10;32;0;32
292;14.02.2018;2018;02;20;Keskiviikko;17;0;17;19;0;19
292;14.02.2018;2018;02;21;Keskiviikko;12;0;12;5;0;5
292;14.02.2018;2018;02;22;Keskiviikko;3;0;3;1;0;1
292;14.02.2018;2018;02;23;Keskiviikko;0;0;0;5;0;5
292;15.02.2018;2018;02;00;Torstai;0;0;0;0;0;0
292;15.02.2018;2018;02;01;Torstai;0;0;0;0;0;0
292;15.02.2018;2018;02;02;Torstai;0;0;0;0;0;0
292;15.02.2018;2018;02;03;Torstai;0;0;0;0;0;0
292;15.02.2018;2018;02;04;Torstai;0;0;0;0;0;0
292;15.02.2018;2018;02;05;Torstai;8;0;8;1;0;1
292;15.02.2018;2018;02;06;Torstai;23;0;23;6;0;6
292;15.02.2018;2018;02;07;Torstai;46;0;46;26;0;26
292;15.02.2018;2018;02;08;Torstai;29;0;29;23;0;23
292;15.02.2018;2018;02;09;Torstai;46;0;46;26;0;26
292;15.02.2018;2018;02;10;Torstai;18;0;18;24;0;24
292;15.02.2018;2018;02;11;Torstai;23;0;23;29;0;29
292;15.02.2018;2018;02;12;Torstai;26;0;26;13;0;13
292;15.02.2018;2018;02;13;Torstai;24;0;24;31;0;31
292;15.02.2018;2018;02;14;Torstai;36;0;36;32;0;32
292;15.02.2018;2018;02;15;Torstai;57;0;57;37;0;37
292;15.02.2018;2018;02;16;Torstai;44;0;44;14;0;14
292;15.02.2018;2018;02;17;Torstai;22;0;22;18;0;18
292;15.02.2018;2018;02;18;Torstai;18;0;18;16;0;16
292;15.02.2018;2018;02;19;Torstai;14;0;14;21;0;21
292;15.02.2018;2018;02;20;Torstai;13;0;13;21;0;21
292;15.02.2018;2018;02;21;Torstai;6;0;6;6;0;6
292;15.02.2018;2018;02;22;Torstai;1;0;1;3;0;3
292;15.02.2018;2018;02;23;Torstai;2;0;2;0;0;0
292;16.02.2018;2018;02;00;Perjantai;0;0;0;0;3;3
292;16.02.2018;2018;02;01;Perjantai;0;0;0;0;0;0
292;16.02.2018;2018;02;02;Perjantai;0;0;0;0;0;0
292;16.02.2018;2018;02;03;Perjantai;0;0;0;1;0;1
292;16.02.2018;2018;02;04;Perjantai;0;0;0;0;0;0
292;16.02.2018;2018;02;05;Perjantai;3;3;6;3;0;3
292;16.02.2018;2018;02;06;Perjantai;10;9;19;9;7;16
292;16.02.2018;2018;02;07;Perjantai;42;17;59;22;12;34
292;16.02.2018;2018;02;08;Perjantai;30;14;44;18;11;29
292;16.02.2018;2018;02;09;Perjantai;18;15;33;9;8;17
292;16.02.2018;2018;02;10;Perjantai;11;9;20;8;11;19
292;16.02.2018;2018;02;11;Perjantai;8;9;17;12;8;20
292;16.02.2018;2018;02;12;Perjantai;12;20;32;20;20;40
292;16.02.2018;2018;02;13;Perjantai;16;25;41;16;35;51
292;16.02.2018;2018;02;14;Perjantai;19;38;57;20;17;37
292;16.02.2018;2018;02;15;Perjantai;11;20;31;5;11;16
292;16.02.2018;2018;02;16;Perjantai;9;22;31;20;13;33
292;16.02.2018;2018;02;17;Perjantai;4;20;24;13;10;23
292;16.02.2018;2018;02;18;Perjantai;15;8;23;9;9;18
292;16.02.2018;2018;02;19;Perjantai;4;4;8;8;5;13
292;16.02.2018;2018;02;20;Perjantai;7;1;8;4;5;9
292;16.02.2018;2018;02;21;Perjantai;3;3;6;3;6;9
292;16.02.2018;2018;02;22;Perjantai;5;3;8;4;1;5
292;16.02.2018;2018;02;23;Perjantai;2;1;3;5;3;8
292;17.02.2018;2018;02;00;Lauantai;0;1;1;2;1;3
292;17.02.2018;2018;02;01;Lauantai;1;0;1;1;3;4
292;17.02.2018;2018;02;02;Lauantai;0;0;0;0;1;1
292;17.02.2018;2018;02;03;Lauantai;0;0;0;1;3;4
292;17.02.2018;2018;02;04;Lauantai;0;0;0;0;0;0
292;17.02.2018;2018;02;05;Lauantai;0;2;2;1;0;1
292;17.02.2018;2018;02;06;Lauantai;2;1;3;1;1;2
292;17.02.2018;2018;02;07;Lauantai;0;3;3;2;1;3
292;17.02.2018;2018;02;08;Lauantai;1;2;3;3;1;4
292;17.02.2018;2018;02;09;Lauantai;3;5;8;12;11;23
292;17.02.2018;2018;02;10;Lauantai;2;3;5;3;7;10
292;17.02.2018;2018;02;11;Lauantai;4;9;13;4;7;11
292;17.02.2018;2018;02;12;Lauantai;4;2;6;7;16;23
292;17.02.2018;2018;02;13;Lauantai;14;11;25;14;6;20
292;17.02.2018;2018;02;14;Lauantai;13;10;23;13;12;25
292;17.02.2018;2018;02;15;Lauantai;11;7;18;20;15;35
292;17.02.2018;2018;02;16;Lauantai;6;16;22;10;9;19
292;17.02.2018;2018;02;17;Lauantai;8;6;14;14;4;18
292;17.02.2018;2018;02;18;Lauantai;6;3;9;15;8;23
292;17.02.2018;2018;02;19;Lauantai;1;5;6;3;3;6
292;17.02.2018;2018;02;20;Lauantai;4;2;6;3;4;7
292;17.02.2018;2018;02;21;Lauantai;0;3;3;4;4;8
292;17.02.2018;2018;02;22;Lauantai;2;0;2;3;2;5
292;17.02.2018;2018;02;23;Lauantai;1;1;2;4;0;4
292;18.02.2018;2018;02;00;Sunnuntai;2;0;2;1;4;5
292;18.02.2018;2018;02;01;Sunnuntai;1;0;1;1;1;2
292;18.02.2018;2018;02;02;Sunnuntai;0;0;0;0;6;6
292;18.02.2018;2018;02;03;Sunnuntai;0;1;1;0;0;0
292;18.02.2018;2018;02;04;Sunnuntai;0;0;0;0;0;0
292;18.02.2018;2018;02;05;Sunnuntai;0;0;0;1;0;1
292;18.02.2018;2018;02;06;Sunnuntai;1;0;1;0;0;0
292;18.02.2018;2018;02;07;Sunnuntai;1;0;1;1;2;3
292;18.02.2018;2018;02;08;Sunnuntai;0;2;2;6;3;9
292;18.02.2018;2018;02;09;Sunnuntai;4;2;6;7;7;14
292;18.02.2018;2018;02;10;Sunnuntai;4;4;8;3;7;10
292;18.02.2018;2018;02;11;Sunnuntai;4;10;14;17;19;36
292;18.02.2018;2018;02;12;Sunnuntai;5;2;7;9;11;20
292;18.02.2018;2018;02;13;Sunnuntai;4;5;9;10;11;21
292;18.02.2018;2018;02;14;Sunnuntai;5;13;18;16;12;28
292;18.02.2018;2018;02;15;Sunnuntai;7;4;11;22;10;32
292;18.02.2018;2018;02;16;Sunnuntai;3;8;11;6;5;11
292;18.02.2018;2018;02;17;Sunnuntai;7;6;13;11;13;24
292;18.02.2018;2018;02;18;Sunnuntai;6;8;14;13;21;34
292;18.02.2018;2018;02;19;Sunnuntai;4;4;8;4;6;10
292;18.02.2018;2018;02;20;Sunnuntai;5;2;7;8;1;9
292;18.02.2018;2018;02;21;Sunnuntai;2;0;2;3;1;4
292;18.02.2018;2018;02;22;Sunnuntai;1;3;4;1;0;1
292;18.02.2018;2018;02;23;Sunnuntai;0;0;0;0;0;0
292;19.02.2018;2018;02;00;Maanantai;0;0;0;1;0;1
292;19.02.2018;2018;02;01;Maanantai;0;0;0;0;1;1
292;19.02.2018;2018;02;02;Maanantai;0;0;0;0;0;0
292;19.02.2018;2018;02;03;Maanantai;0;0;0;0;0;0
292;19.02.2018;2018;02;04;Maanantai;1;0;1;1;0;1
292;19.02.2018;2018;02;05;Maanantai;3;3;6;1;0;1
292;19.02.2018;2018;02;06;Maanantai;8;10;18;2;5;7
292;19.02.2018;2018;02;07;Maanantai;25;12;37;5;8;13
292;19.02.2018;2018;02;08;Maanantai;17;7;24;17;11;28
292;19.02.2018;2018;02;09;Maanantai;29;10;39;10;9;19
292;19.02.2018;2018;02;10;Maanantai;14;7;21;5;4;9
292;19.02.2018;2018;02;11;Maanantai;9;8;17;6;11;17
292;19.02.2018;2018;02;12;Maanantai;5;8;13;12;11;23
292;19.02.2018;2018;02;13;Maanantai;10;17;27;24;13;37
292;19.02.2018;2018;02;14;Maanantai;9;29;38;13;16;29
292;19.02.2018;2018;02;15;Maanantai;19;35;54;11;12;23
292;19.02.2018;2018;02;16;Maanantai;13;24;37;13;15;28
292;19.02.2018;2018;02;17;Maanantai;9;17;26;9;17;26
292;19.02.2018;2018;02;18;Maanantai;6;8;14;12;10;22
292;19.02.2018;2018;02;19;Maanantai;5;2;7;3;5;8
292;19.02.2018;2018;02;20;Maanantai;6;5;11;6;4;10
292;19.02.2018;2018;02;21;Maanantai;5;3;8;1;2;3
292;19.02.2018;2018;02;22;Maanantai;0;0;0;1;0;1
292;19.02.2018;2018;02;23;Maanantai;0;0;0;0;0;0
292;20.02.2018;2018;02;00;Tiistai;0;0;0;0;0;0
292;20.02.2018;2018;02;01;Tiistai;0;0;0;0;0;0
292;20.02.2018;2018;02;02;Tiistai;0;0;0;0;0;0
292;20.02.2018;2018;02;03;Tiistai;0;0;0;0;0;0
292;20.02.2018;2018;02;04;Tiistai;0;1;1;0;0;0
292;20.02.2018;2018;02;05;Tiistai;1;3;4;2;0;2
292;20.02.2018;2018;02;06;Tiistai;5;10;15;3;6;9
292;20.02.2018;2018;02;07;Tiistai;27;15;42;16;8;24
292;20.02.2018;2018;02;08;Tiistai;20;9;29;15;11;26
292;20.02.2018;2018;02;09;Tiistai;7;6;13;4;8;12
292;20.02.2018;2018;02;10;Tiistai;10;4;14;11;14;25
292;20.02.2018;2018;02;11;Tiistai;5;1;6;12;18;30
292;20.02.2018;2018;02;12;Tiistai;7;3;10;8;3;11
292;20.02.2018;2018;02;13;Tiistai;4;9;13;12;16;28
292;20.02.2018;2018;02;14;Tiistai;12;27;39;20;16;36
292;20.02.2018;2018;02;15;Tiistai;13;19;32;13;14;27
292;20.02.2018;2018;02;16;Tiistai;15;29;44;8;10;18
292;20.02.2018;2018;02;17;Tiistai;9;12;21;12;11;23
292;20.02.2018;2018;02;18;Tiistai;10;5;15;7;10;17
292;20.02.2018;2018;02;19;Tiistai;6;5;11;6;3;9
292;20.02.2018;2018;02;20;Tiistai;10;6;16;5;5;10
292;20.02.2018;2018;02;21;Tiistai;4;5;9;5;1;6
292;20.02.2018;2018;02;22;Tiistai;0;1;1;0;1;1
292;20.02.2018;2018;02;23;Tiistai;1;0;1;0;0;0
292;21.02.2018;2018;02;00;Keskiviikko;0;0;0;0;1;1
292;21.02.2018;2018;02;01;Keskiviikko;0;0;0;0;0;0
292;21.02.2018;2018;02;02;Keskiviikko;0;0;0;0;0;0
292;21.02.2018;2018;02;03;Keskiviikko;0;0;0;0;0;0
292;21.02.2018;2018;02;04;Keskiviikko;1;0;1;0;0;0
292;21.02.2018;2018;02;05;Keskiviikko;3;5;8;2;0;2
292;21.02.2018;2018;02;06;Keskiviikko;9;7;16;3;5;8
292;21.02.2018;2018;02;07;Keskiviikko;31;14;45;20;9;29
292;21.02.2018;2018;02;08;Keskiviikko;30;10;40;4;13;17
292;21.02.2018;2018;02;09;Keskiviikko;15;7;22;5;4;9
292;21.02.2018;2018;02;10;Keskiviikko;8;6;14;11;10;21
292;21.02.2018;2018;02;11;Keskiviikko;5;3;8;11;15;26
292;21.02.2018;2018;02;12;Keskiviikko;9;16;25;13;17;30
292;21.02.2018;2018;02;13;Keskiviikko;11;25;36;21;17;38
292;21.02.2018;2018;02;14;Keskiviikko;26;48;74;25;26;51
292;21.02.2018;2018;02;15;Keskiviikko;11;28;39;21;19;40
292;21.02.2018;2018;02;16;Keskiviikko;16;22;38;20;9;29
292;21.02.2018;2018;02;17;Keskiviikko;9;12;21;14;19;33
292;21.02.2018;2018;02;18;Keskiviikko;7;10;17;14;11;25
292;21.02.2018;2018;02;19;Keskiviikko;8;9;17;8;9;17
292;21.02.2018;2018;02;20;Keskiviikko;14;3;17;7;1;8
292;21.02.2018;2018;02;21;Keskiviikko;3;5;8;3;4;7
292;21.02.2018;2018;02;22;Keskiviikko;1;0;1;1;2;3
292;21.02.2018;2018;02;23;Keskiviikko;1;2;3;1;0;1
292;22.02.2018;2018;02;00;Torstai;1;1;2;1;1;2
292;22.02.2018;2018;02;01;Torstai;0;0;0;0;0;0
292;22.02.2018;2018;02;02;Torstai;0;0;0;0;0;0
292;22.02.2018;2018;02;03;Torstai;0;0;0;1;0;1
292;22.02.2018;2018;02;04;Torstai;1;0;1;0;0;0
292;22.02.2018;2018;02;05;Torstai;2;6;8;0;0;0
292;22.02.2018;2018;02;06;Torstai;7;11;18;5;2;7
292;22.02.2018;2018;02;07;Torstai;29;20;49;14;8;22
292;22.02.2018;2018;02;08;Torstai;21;13;34;13;13;26
292;22.02.2018;2018;02;09;Torstai;24;5;29;15;5;20
292;22.02.2018;2018;02;10;Torstai;10;6;16;10;8;18
292;22.02.2018;2018;02;11;Torstai;12;9;21;14;15;29
292;22.02.2018;2018;02;12;Torstai;3;9;12;3;9;12
292;22.02.2018;2018;02;13;Torstai;9;8;17;9;15;24
292;22.02.2018;2018;02;14;Torstai;16;26;42;20;13;33
292;22.02.2018;2018;02;15;Torstai;14;25;39;22;25;47
292;22.02.2018;2018;02;16;Torstai;13;35;48;17;13;30
292;22.02.2018;2018;02;17;Torstai;9;17;26;8;9;17
292;22.02.2018;2018;02;18;Torstai;10;8;18;9;10;19
292;22.02.2018;2018;02;19;Torstai;6;10;16;6;8;14
292;22.02.2018;2018;02;20;Torstai;9;2;11;7;4;11
292;22.02.2018;2018;02;21;Torstai;3;4;7;4;3;7
292;22.02.2018;2018;02;22;Torstai;0;4;4;3;1;4
292;22.02.2018;2018;02;23;Torstai;1;0;1;1;0;1
292;23.02.2018;2018;02;00;Perjantai;0;0;0;1;0;1
292;23.02.2018;2018;02;01;Perjantai;0;0;0;0;2;2
292;23.02.2018;2018;02;02;Perjantai;0;0;0;0;0;0
292;23.02.2018;2018;02;03;Perjantai;0;0;0;0;0;0
292;23.02.2018;2018;02;04;Perjantai;2;1;3;0;0;0
292;23.02.2018;2018;02;05;Perjantai;3;6;9;0;0;0
292;23.02.2018;2018;02;06;Perjantai;10;3;13;2;5;7
292;23.02.2018;2018;02;07;Perjantai;24;18;42;18;3;21
292;23.02.2018;2018;02;08;Perjantai;30;11;41;11;11;22
292;23.02.2018;2018;02;09;Perjantai;20;9;29;6;13;19
292;23.02.2018;2018;02;10;Perjantai;11;6;17;5;7;12
292;23.02.2018;2018;02;11;Perjantai;5;9;14;8;12;20
292;23.02.2018;2018;02;12;Perjantai;13;17;30;19;20;39
292;23.02.2018;2018;02;13;Perjantai;8;35;43;16;19;35
292;23.02.2018;2018;02;14;Perjantai;25;39;64;8;13;21
292;23.02.2018;2018;02;15;Perjantai;16;29;45;21;19;40
292;23.02.2018;2018;02;16;Perjantai;12;18;30;14;6;20
292;23.02.2018;2018;02;17;Perjantai;10;15;25;18;19;37
292;23.02.2018;2018;02;18;Perjantai;2;1;3;8;20;28
292;23.02.2018;2018;02;19;Perjantai;2;0;2;17;9;26
292;23.02.2018;2018;02;20;Perjantai;3;0;3;23;8;31
292;23.02.2018;2018;02;21;Perjantai;0;1;1;8;2;10
292;23.02.2018;2018;02;22;Perjantai;0;0;0;8;2;10
292;23.02.2018;2018;02;23;Perjantai;0;1;1;2;4;6
292;24.02.2018;2018;02;00;Lauantai;0;0;0;0;4;4
292;24.02.2018;2018;02;01;Lauantai;0;0;0;0;3;3
292;24.02.2018;2018;02;02;Lauantai;0;0;0;3;1;4
292;24.02.2018;2018;02;03;Lauantai;0;0;0;0;2;2
292;24.02.2018;2018;02;04;Lauantai;2;0;2;1;0;1
292;24.02.2018;2018;02;05;Lauantai;0;0;0;0;1;1
292;24.02.2018;2018;02;06;Lauantai;0;0;0;0;1;1
292;24.02.2018;2018;02;07;Lauantai;0;0;0;1;3;4
292;24.02.2018;2018;02;08;Lauantai;0;1;1;1;0;1
292;24.02.2018;2018;02;09;Lauantai;0;0;0;7;6;13
292;24.02.2018;2018;02;10;Lauantai;1;1;2;6;12;18
292;24.02.2018;2018;02;11;Lauantai;0;1;1;12;11;23
292;24.02.2018;2018;02;12;Lauantai;2;5;7;15;12;27
292;24.02.2018;2018;02;13;Lauantai;5;4;9;21;11;32
292;24.02.2018;2018;02;14;Lauantai;5;3;8;18;9;27
292;24.02.2018;2018;02;15;Lauantai;1;2;3;9;8;17
292;24.02.2018;2018;02;16;Lauantai;3;3;6;19;9;28
292;24.02.2018;2018;02;17;Lauantai;4;5;9;12;7;19
292;24.02.2018;2018;02;18;Lauantai;2;2;4;6;1;7
292;24.02.2018;2018;02;19;Lauantai;1;4;5;4;1;5
292;24.02.2018;2018;02;20;Lauantai;1;1;2;1;2;3
292;24.02.2018;2018;02;21;Lauantai;1;1;2;2;1;3
292;24.02.2018;2018;02;22;Lauantai;1;0;1;4;2;6
292;24.02.2018;2018;02;23;Lauantai;0;2;2;4;0;4
292;25.02.2018;2018;02;00;Sunnuntai;0;1;1;3;2;5
292;25.02.2018;2018;02;01;Sunnuntai;1;0;1;0;1;1
292;25.02.2018;2018;02;02;Sunnuntai;0;0;0;0;5;5
292;25.02.2018;2018;02;03;Sunnuntai;0;2;2;0;3;3
292;25.02.2018;2018;02;04;Sunnuntai;0;0;0;0;0;0
292;25.02.2018;2018;02;05;Sunnuntai;0;0;0;1;0;1
292;25.02.2018;2018;02;06;Sunnuntai;1;0;1;3;0;3
292;25.02.2018;2018;02;07;Sunnuntai;0;0;0;0;2;2
292;25.02.2018;2018;02;08;Sunnuntai;0;3;3;1;0;1
292;25.02.2018;2018;02;09;Sunnuntai;2;1;3;3;2;5
292;25.02.2018;2018;02;10;Sunnuntai;2;5;7;10;6;16
292;25.02.2018;2018;02;11;Sunnuntai;8;11;19;8;14;22
292;25.02.2018;2018;02;12;Sunnuntai;10;8;18;8;3;11
292;25.02.2018;2018;02;13;Sunnuntai;10;8;18;9;17;26
292;25.02.2018;2018;02;14;Sunnuntai;9;13;22;21;11;32
292;25.02.2018;2018;02;15;Sunnuntai;6;3;9;15;10;25
292;25.02.2018;2018;02;16;Sunnuntai;6;16;22;7;18;25
292;25.02.2018;2018;02;17;Sunnuntai;2;5;7;17;7;24
292;25.02.2018;2018;02;18;Sunnuntai;5;5;10;9;9;18
292;25.02.2018;2018;02;19;Sunnuntai;5;7;12;7;4;11
292;25.02.2018;2018;02;20;Sunnuntai;3;2;5;10;9;19
292;25.02.2018;2018;02;21;Sunnuntai;4;3;7;3;1;4
292;25.02.2018;2018;02;22;Sunnuntai;1;3;4;0;0;0
292;25.02.2018;2018;02;23;Sunnuntai;0;0;0;0;1;1
292;26.02.2018;2018;02;00;Maanantai;0;0;0;0;0;0
292;26.02.2018;2018;02;01;Maanantai;0;0;0;0;0;0
292;26.02.2018;2018;02;02;Maanantai;0;0;0;0;0;0
292;26.02.2018;2018;02;03;Maanantai;0;0;0;0;0;0
292;26.02.2018;2018;02;04;Maanantai;0;0;0;2;0;2
292;26.02.2018;2018;02;05;Maanantai;2;4;6;3;0;3
292;26.02.2018;2018;02;06;Maanantai;10;9;19;5;6;11
292;26.02.2018;2018;02;07;Maanantai;40;14;54;16;6;22
292;26.02.2018;2018;02;08;Maanantai;19;14;33;11;13;24
292;26.02.2018;2018;02;09;Maanantai;24;13;37;14;8;22
292;26.02.2018;2018;02;10;Maanantai;18;12;30;10;10;20
292;26.02.2018;2018;02;11;Maanantai;17;6;23;10;13;23
292;26.02.2018;2018;02;12;Maanantai;3;8;11;16;19;35
292;26.02.2018;2018;02;13;Maanantai;5;27;32;22;18;40
292;26.02.2018;2018;02;14;Maanantai;16;32;48;34;15;49
292;26.02.2018;2018;02;15;Maanantai;13;45;58;16;10;26
292;26.02.2018;2018;02;16;Maanantai;16;35;51;16;18;34
292;26.02.2018;2018;02;17;Maanantai;6;20;26;10;11;21
292;26.02.2018;2018;02;18;Maanantai;10;9;19;14;11;25
292;26.02.2018;2018;02;19;Maanantai;8;8;16;7;12;19
292;26.02.2018;2018;02;20;Maanantai;10;9;19;8;0;8
292;26.02.2018;2018;02;21;Maanantai;4;3;7;2;0;2
292;26.02.2018;2018;02;22;Maanantai;1;3;4;3;4;7
292;26.02.2018;2018;02;23;Maanantai;0;0;0;0;0;0
292;27.02.2018;2018;02;00;Tiistai;1;0;1;0;1;1
292;27.02.2018;2018;02;01;Tiistai;0;0;0;0;0;0
292;27.02.2018;2018;02;02;Tiistai;0;0;0;0;0;0
292;27.02.2018;2018;02;03;Tiistai;0;0;0;0;0;0
292;27.02.2018;2018;02;04;Tiistai;0;0;0;0;0;0
292;27.02.2018;2018;02;05;Tiistai;2;4;6;1;0;1
292;27.02.2018;2018;02;06;Tiistai;8;13;21;7;4;11
292;27.02.2018;2018;02;07;Tiistai;28;18;46;13;11;24
292;27.02.2018;2018;02;08;Tiistai;30;9;39;18;12;30
292;27.02.2018;2018;02;09;Tiistai;9;9;18;15;10;25
292;27.02.2018;2018;02;10;Tiistai;15;3;18;9;7;16
292;27.02.2018;2018;02;11;Tiistai;6;3;9;13;12;25
292;27.02.2018;2018;02;12;Tiistai;6;10;16;11;13;24
292;27.02.2018;2018;02;13;Tiistai;5;28;33;15;13;28
292;27.02.2018;2018;02;14;Tiistai;12;38;50;20;16;36
292;27.02.2018;2018;02;15;Tiistai;7;27;34;21;16;37
292;27.02.2018;2018;02;16;Tiistai;15;19;34;19;10;29
292;27.02.2018;2018;02;17;Tiistai;9;8;17;5;5;10
292;27.02.2018;2018;02;18;Tiistai;5;8;13;9;4;13
292;27.02.2018;2018;02;19;Tiistai;4;7;11;3;6;9
292;27.02.2018;2018;02;20;Tiistai;7;1;8;5;1;6
292;27.02.2018;2018;02;21;Tiistai;1;4;5;2;3;5
292;27.02.2018;2018;02;22;Tiistai;1;2;3;0;0;0
292;27.02.2018;2018;02;23;Tiistai;1;0;1;0;0;0
292;28.02.2018;2018;02;00;Keskiviikko;0;0;0;0;2;2
292;28.02.2018;2018;02;01;Keskiviikko;0;0;0;0;0;0
292;28.02.2018;2018;02;02;Keskiviikko;0;0;0;0;0;0
292;28.02.2018;2018;02;03;Keskiviikko;0;0;0;0;0;0
292;28.02.2018;2018;02;04;Keskiviikko;0;0;0;1;0;1
292;28.02.2018;2018;02;05;Keskiviikko;1;6;7;0;1;1
292;28.02.2018;2018;02;06;Keskiviikko;7;4;11;5;3;8
292;28.02.2018;2018;02;07;Keskiviikko;17;10;27;15;7;22
292;28.02.2018;2018;02;08;Keskiviikko;23;14;37;11;9;20
292;28.02.2018;2018;02;09;Keskiviikko;8;8;16;11;11;22
292;28.02.2018;2018;02;10;Keskiviikko;8;5;13;9;6;15
292;28.02.2018;2018;02;11;Keskiviikko;3;1;4;3;9;12
292;28.02.2018;2018;02;12;Keskiviikko;1;12;13;8;5;13
292;28.02.2018;2018;02;13;Keskiviikko;10;37;47;19;15;34
292;28.02.2018;2018;02;14;Keskiviikko;14;25;39;25;20;45
292;28.02.2018;2018;02;15;Keskiviikko;9;20;29;18;18;36
292;28.02.2018;2018;02;16;Keskiviikko;11;21;32;17;15;32
292;28.02.2018;2018;02;17;Keskiviikko;7;7;14;14;11;25
292;28.02.2018;2018;02;18;Keskiviikko;9;9;18;14;8;22
292;28.02.2018;2018;02;19;Keskiviikko;5;8;13;7;9;16
292;28.02.2018;2018;02;20;Keskiviikko;9;5;14;7;9;16
292;28.02.2018;2018;02;21;Keskiviikko;3;5;8;2;3;5
292;28.02.2018;2018;02;22;Keskiviikko;0;1;1;0;0;0
292;28.02.2018;2018;02;23;Keskiviikko;0;0;0;0;0;0
292;01.03.2018;2018;03;00;Torstai;0;0;0;2;1;3
292;01.03.2018;2018;03;01;Torstai;1;0;1;0;0;0
292;01.03.2018;2018;03;02;Torstai;0;0;0;0;0;0
292;01.03.2018;2018;03;03;Torstai;0;0;0;0;0;0
292;01.03.2018;2018;03;04;Torstai;0;0;0;0;0;0
292;01.03.2018;2018;03;05;Torstai;3;5;8;1;1;2
292;01.03.2018;2018;03;06;Torstai;6;9;15;3;3;6
292;01.03.2018;2018;03;07;Torstai;26;16;42;12;8;20
292;01.03.2018;2018;03;08;Torstai;26;19;45;9;17;26
292;01.03.2018;2018;03;09;Torstai;25;11;36;4;2;6
292;01.03.2018;2018;03;10;Torstai;10;8;18;14;12;26
292;01.03.2018;2018;03;11;Torstai;15;8;23;8;14;22
292;01.03.2018;2018;03;12;Torstai;9;8;17;10;12;22
292;01.03.2018;2018;03;13;Torstai;13;22;35;17;5;22
292;01.03.2018;2018;03;14;Torstai;26;22;48;18;16;34
292;01.03.2018;2018;03;15;Torstai;17;26;43;24;21;45
292;01.03.2018;2018;03;16;Torstai;10;32;42;15;14;29
292;01.03.2018;2018;03;17;Torstai;12;22;34;10;8;18
292;01.03.2018;2018;03;18;Torstai;11;5;16;10;9;19
292;01.03.2018;2018;03;19;Torstai;8;3;11;13;8;21
292;01.03.2018;2018;03;20;Torstai;12;6;18;8;7;15
292;01.03.2018;2018;03;21;Torstai;4;4;8;6;3;9
292;01.03.2018;2018;03;22;Torstai;1;2;3;0;4;4
292;01.03.2018;2018;03;23;Torstai;1;1;2;1;0;1
292;02.03.2018;2018;03;00;Perjantai;0;0;0;3;3;6
292;02.03.2018;2018;03;01;Perjantai;0;0;0;0;0;0
292;02.03.2018;2018;03;02;Perjantai;0;0;0;0;0;0
292;02.03.2018;2018;03;03;Perjantai;0;1;1;0;0;0
292;02.03.2018;2018;03;04;Perjantai;0;0;0;0;0;0
292;02.03.2018;2018;03;05;Perjantai;3;5;8;3;0;3
292;02.03.2018;2018;03;06;Perjantai;14;7;21;3;4;7
292;02.03.2018;2018;03;07;Perjantai;35;13;48;16;6;22
292;02.03.2018;2018;03;08;Perjantai;35;10;45;9;14;23
292;02.03.2018;2018;03;09;Perjantai;15;10;25;6;11;17
292;02.03.2018;2018;03;10;Perjantai;9;7;16;8;12;20
292;02.03.2018;2018;03;11;Perjantai;12;14;26;7;5;12
292;02.03.2018;2018;03;12;Perjantai;11;22;33;19;14;33
292;02.03.2018;2018;03;13;Perjantai;15;36;51;10;18;28
292;02.03.2018;2018;03;14;Perjantai;17;36;53;22;20;42
292;02.03.2018;2018;03;15;Perjantai;15;24;39;17;10;27
292;02.03.2018;2018;03;16;Perjantai;12;17;29;20;13;33
292;02.03.2018;2018;03;17;Perjantai;6;15;21;6;3;9
292;02.03.2018;2018;03;18;Perjantai;10;8;18;10;7;17
292;02.03.2018;2018;03;19;Perjantai;6;13;19;8;11;19
292;02.03.2018;2018;03;20;Perjantai;7;3;10;11;2;13
292;02.03.2018;2018;03;21;Perjantai;8;1;9;6;3;9
292;02.03.2018;2018;03;22;Perjantai;5;1;6;7;8;15
292;02.03.2018;2018;03;23;Perjantai;4;1;5;3;2;5
292;03.03.2018;2018;03;00;Lauantai;0;1;1;6;1;7
292;03.03.2018;2018;03;01;Lauantai;0;1;1;0;3;3
292;03.03.2018;2018;03;02;Lauantai;1;0;1;1;5;6
292;03.03.2018;2018;03;03;Lauantai;0;1;1;1;2;3
292;03.03.2018;2018;03;04;Lauantai;1;0;1;1;1;2
292;03.03.2018;2018;03;05;Lauantai;1;0;1;0;0;0
292;03.03.2018;2018;03;06;Lauantai;2;3;5;6;5;11
292;03.03.2018;2018;03;07;Lauantai;0;0;0;5;5;10
292;03.03.2018;2018;03;08;Lauantai;1;2;3;6;2;8
292;03.03.2018;2018;03;09;Lauantai;4;6;10;7;12;19
292;03.03.2018;2018;03;10;Lauantai;5;9;14;8;10;18
292;03.03.2018;2018;03;11;Lauantai;7;4;11;13;16;29
292;03.03.2018;2018;03;12;Lauantai;8;17;25;12;18;30
292;03.03.2018;2018;03;13;Lauantai;18;7;25;8;8;16
292;03.03.2018;2018;03;14;Lauantai;11;8;19;12;10;22
292;03.03.2018;2018;03;15;Lauantai;10;7;17;12;10;22
292;03.03.2018;2018;03;16;Lauantai;4;7;11;12;12;24
292;03.03.2018;2018;03;17;Lauantai;7;13;20;7;6;13
292;03.03.2018;2018;03;18;Lauantai;9;5;14;13;9;22
292;03.03.2018;2018;03;19;Lauantai;3;3;6;3;6;9
292;03.03.2018;2018;03;20;Lauantai;4;2;6;5;2;7
292;03.03.2018;2018;03;21;Lauantai;4;5;9;2;0;2
292;03.03.2018;2018;03;22;Lauantai;3;3;6;1;1;2
292;03.03.2018;2018;03;23;Lauantai;4;0;4;9;0;9
292;04.03.2018;2018;03;00;Sunnuntai;0;0;0;2;2;4
292;04.03.2018;2018;03;01;Sunnuntai;0;1;1;1;1;2
292;04.03.2018;2018;03;02;Sunnuntai;0;1;1;0;3;3
292;04.03.2018;2018;03;03;Sunnuntai;1;1;2;1;1;2
292;04.03.2018;2018;03;04;Sunnuntai;0;0;0;0;1;1
292;04.03.2018;2018;03;05;Sunnuntai;1;0;1;1;0;1
292;04.03.2018;2018;03;06;Sunnuntai;5;2;7;2;1;3
292;04.03.2018;2018;03;07;Sunnuntai;0;0;0;1;2;3
292;04.03.2018;2018;03;08;Sunnuntai;0;3;3;2;0;2
292;04.03.2018;2018;03;09;Sunnuntai;5;5;10;7;9;16
292;04.03.2018;2018;03;10;Sunnuntai;1;7;8;9;13;22
292;04.03.2018;2018;03;11;Sunnuntai;10;10;20;10;6;16
292;04.03.2018;2018;03;12;Sunnuntai;11;7;18;15;13;28
292;04.03.2018;2018;03;13;Sunnuntai;8;7;15;17;20;37
292;04.03.2018;2018;03;14;Sunnuntai;10;15;25;13;10;23
292;04.03.2018;2018;03;15;Sunnuntai;9;9;18;14;19;33
292;04.03.2018;2018;03;16;Sunnuntai;8;14;22;24;12;36
292;04.03.2018;2018;03;17;Sunnuntai;9;3;12;23;12;35
292;04.03.2018;2018;03;18;Sunnuntai;4;6;10;5;9;14
292;04.03.2018;2018;03;19;Sunnuntai;4;3;7;1;2;3
292;04.03.2018;2018;03;20;Sunnuntai;5;1;6;5;3;8
292;04.03.2018;2018;03;21;Sunnuntai;3;6;9;5;4;9
292;04.03.2018;2018;03;22;Sunnuntai;1;0;1;0;0;0
292;04.03.2018;2018;03;23;Sunnuntai;0;0;0;1;0;1
292;05.03.2018;2018;03;00;Maanantai;0;0;0;2;0;2
292;05.03.2018;2018;03;01;Maanantai;0;1;1;0;0;0
292;05.03.2018;2018;03;02;Maanantai;0;0;0;0;0;0
292;05.03.2018;2018;03;03;Maanantai;0;1;1;0;0;0
292;05.03.2018;2018;03;04;Maanantai;0;0;0;0;0;0
292;05.03.2018;2018;03;05;Maanantai;0;5;5;2;0;2
292;05.03.2018;2018;03;06;Maanantai;7;5;12;3;4;7
292;05.03.2018;2018;03;07;Maanantai;11;9;20;4;5;9
292;05.03.2018;2018;03;08;Maanantai;1;9;10;6;7;13
292;05.03.2018;2018;03;09;Maanantai;3;12;15;8;13;21
292;05.03.2018;2018;03;10;Maanantai;8;11;19;11;13;24
292;05.03.2018;2018;03;11;Maanantai;4;13;17;12;12;24
292;05.03.2018;2018;03;12;Maanantai;18;10;28;23;22;45
292;05.03.2018;2018;03;13;Maanantai;7;12;19;22;15;37
292;05.03.2018;2018;03;14;Maanantai;13;13;26;26;13;39
292;05.03.2018;2018;03;15;Maanantai;15;15;30;21;19;40
292;05.03.2018;2018;03;16;Maanantai;9;19;28;26;16;42
292;05.03.2018;2018;03;17;Maanantai;10;14;24;13;13;26
292;05.03.2018;2018;03;18;Maanantai;6;5;11;9;9;18
292;05.03.2018;2018;03;19;Maanantai;6;2;8;8;6;14
292;05.03.2018;2018;03;20;Maanantai;5;4;9;3;3;6
292;05.03.2018;2018;03;21;Maanantai;3;1;4;3;3;6
292;05.03.2018;2018;03;22;Maanantai;3;0;3;1;0;1
292;05.03.2018;2018;03;23;Maanantai;0;0;0;2;1;3
292;06.03.2018;2018;03;00;Tiistai;0;0;0;0;0;0
292;06.03.2018;2018;03;01;Tiistai;0;0;0;0;3;3
292;06.03.2018;2018;03;02;Tiistai;0;0;0;0;0;0
292;06.03.2018;2018;03;03;Tiistai;0;1;1;0;0;0
292;06.03.2018;2018;03;04;Tiistai;0;0;0;0;0;0
292;06.03.2018;2018;03;05;Tiistai;1;5;6;0;0;0
292;06.03.2018;2018;03;06;Tiistai;7;4;11;2;2;4
292;06.03.2018;2018;03;07;Tiistai;6;11;17;8;3;11
292;06.03.2018;2018;03;08;Tiistai;5;7;12;4;9;13
292;06.03.2018;2018;03;09;Tiistai;4;7;11;4;6;10
292;06.03.2018;2018;03;10;Tiistai;7;5;12;12;6;18
292;06.03.2018;2018;03;11;Tiistai;8;13;21;10;12;22
292;06.03.2018;2018;03;12;Tiistai;3;5;8;19;13;32
292;06.03.2018;2018;03;13;Tiistai;12;16;28;22;12;34
292;06.03.2018;2018;03;14;Tiistai;11;9;20;15;13;28
292;06.03.2018;2018;03;15;Tiistai;14;16;30;15;11;26
292;06.03.2018;2018;03;16;Tiistai;10;11;21;24;15;39
292;06.03.2018;2018;03;17;Tiistai;8;8;16;7;8;15
292;06.03.2018;2018;03;18;Tiistai;0;2;2;15;5;20
292;06.03.2018;2018;03;19;Tiistai;4;4;8;6;10;16
292;06.03.2018;2018;03;20;Tiistai;4;2;6;4;2;6
292;06.03.2018;2018;03;21;Tiistai;5;2;7;2;4;6
292;06.03.2018;2018;03;22;Tiistai;3;2;5;5;4;9
292;06.03.2018;2018;03;23;Tiistai;0;0;0;0;2;2
292;07.03.2018;2018;03;00;Keskiviikko;0;1;1;0;0;0
292;07.03.2018;2018;03;01;Keskiviikko;1;0;1;0;0;0
292;07.03.2018;2018;03;02;Keskiviikko;0;1;1;0;0;0
292;07.03.2018;2018;03;03;Keskiviikko;0;1;1;1;0;1
292;07.03.2018;2018;03;04;Keskiviikko;0;0;0;0;0;0
292;07.03.2018;2018;03;05;Keskiviikko;1;5;6;2;0;2
292;07.03.2018;2018;03;06;Keskiviikko;8;4;12;2;3;5
292;07.03.2018;2018;03;07;Keskiviikko;6;8;14;5;5;10
292;07.03.2018;2018;03;08;Keskiviikko;8;7;15;1;7;8
292;07.03.2018;2018;03;09;Keskiviikko;5;11;16;15;7;22
292;07.03.2018;2018;03;10;Keskiviikko;8;10;18;17;13;30
292;07.03.2018;2018;03;11;Keskiviikko;6;11;17;18;20;38
292;07.03.2018;2018;03;12;Keskiviikko;15;15;30;16;16;32
292;07.03.2018;2018;03;13;Keskiviikko;9;7;16;18;19;37
292;07.03.2018;2018;03;14;Keskiviikko;11;11;22;21;13;34
292;07.03.2018;2018;03;15;Keskiviikko;14;11;25;16;17;33
292;07.03.2018;2018;03;16;Keskiviikko;14;18;32;6;12;18
292;07.03.2018;2018;03;17;Keskiviikko;11;6;17;10;11;21
292;07.03.2018;2018;03;18;Keskiviikko;6;6;12;10;16;26
292;07.03.2018;2018;03;19;Keskiviikko;7;5;12;19;7;26
292;07.03.2018;2018;03;20;Keskiviikko;4;6;10;9;4;13
292;07.03.2018;2018;03;21;Keskiviikko;4;6;10;1;2;3
292;07.03.2018;2018;03;22;Keskiviikko;2;2;4;0;1;1
292;07.03.2018;2018;03;23;Keskiviikko;0;0;0;0;0;0
292;08.03.2018;2018;03;00;Torstai;2;1;3;0;0;0
292;08.03.2018;2018;03;01;Torstai;2;1;3;1;0;1
292;08.03.2018;2018;03;02;Torstai;0;0;0;0;0;0
292;08.03.2018;2018;03;03;Torstai;0;0;0;0;1;1
292;08.03.2018;2018;03;04;Torstai;0;1;1;1;0;1
292;08.03.2018;2018;03;05;Torstai;4;4;8;4;2;6
292;08.03.2018;2018;03;06;Torstai;8;5;13;1;3;4
292;08.03.2018;2018;03;07;Torstai;4;10;14;5;9;14
292;08.03.2018;2018;03;08;Torstai;7;10;17;7;11;18
292;08.03.2018;2018;03;09;Torstai;8;11;19;11;13;24
292;08.03.2018;2018;03;10;Torstai;3;9;12;16;9;25
292;08.03.2018;2018;03;11;Torstai;6;15;21;17;13;30
292;08.03.2018;2018;03;12;Torstai;9;7;16;18;18;36
292;08.03.2018;2018;03;13;Torstai;11;8;19;22;14;36
292;08.03.2018;2018;03;14;Torstai;18;5;23;17;15;32
292;08.03.2018;2018;03;15;Torstai;12;10;22;5;11;16
292;08.03.2018;2018;03;16;Torstai;16;5;21;11;13;24
292;08.03.2018;2018;03;17;Torstai;8;15;23;13;17;30
292;08.03.2018;2018;03;18;Torstai;8;7;15;13;11;24
292;08.03.2018;2018;03;19;Torstai;7;11;18;7;12;19
292;08.03.2018;2018;03;20;Torstai;9;3;12;4;6;10
292;08.03.2018;2018;03;21;Torstai;7;2;9;2;2;4
292;08.03.2018;2018;03;22;Torstai;2;2;4;4;3;7
292;08.03.2018;2018;03;23;Torstai;1;2;3;1;1;2
292;09.03.2018;2018;03;00;Perjantai;0;0;0;0;1;1
292;09.03.2018;2018;03;01;Perjantai;0;1;1;1;0;1
292;09.03.2018;2018;03;02;Perjantai;0;0;0;0;0;0
292;09.03.2018;2018;03;03;Perjantai;1;0;1;0;0;0
292;09.03.2018;2018;03;04;Perjantai;0;0;0;0;0;0
292;09.03.2018;2018;03;05;Perjantai;4;4;8;3;2;5
292;09.03.2018;2018;03;06;Perjantai;7;4;11;2;6;8
292;09.03.2018;2018;03;07;Perjantai;11;6;17;6;7;13
292;09.03.2018;2018;03;08;Perjantai;6;10;16;4;6;10
292;09.03.2018;2018;03;09;Perjantai;9;12;21;8;8;16
292;09.03.2018;2018;03;10;Perjantai;13;11;24;13;10;23
292;09.03.2018;2018;03;11;Perjantai;8;10;18;13;18;31
292;09.03.2018;2018;03;12;Perjantai;14;9;23;11;18;29
292;09.03.2018;2018;03;13;Perjantai;9;2;11;14;13;27
292;09.03.2018;2018;03;14;Perjantai;17;9;26;14;6;20
292;09.03.2018;2018;03;15;Perjantai;13;11;24;5;6;11
292;09.03.2018;2018;03;16;Perjantai;15;14;29;10;6;16
292;09.03.2018;2018;03;17;Perjantai;3;6;9;5;12;17
292;09.03.2018;2018;03;18;Perjantai;7;5;12;8;5;13
292;09.03.2018;2018;03;19;Perjantai;7;3;10;12;12;24
292;09.03.2018;2018;03;20;Perjantai;9;4;13;8;3;11
292;09.03.2018;2018;03;21;Perjantai;3;3;6;8;6;14
292;09.03.2018;2018;03;22;Perjantai;5;0;5;6;3;9
292;09.03.2018;2018;03;23;Perjantai;5;1;6;4;0;4
292;10.03.2018;2018;03;00;Lauantai;0;1;1;2;0;2
292;10.03.2018;2018;03;01;Lauantai;0;0;0;0;6;6
292;10.03.2018;2018;03;02;Lauantai;0;0;0;0;0;0
292;10.03.2018;2018;03;03;Lauantai;1;1;2;5;3;8
292;10.03.2018;2018;03;04;Lauantai;0;0;0;1;1;2
292;10.03.2018;2018;03;05;Lauantai;1;3;4;2;1;3
292;10.03.2018;2018;03;06;Lauantai;2;2;4;1;2;3
292;10.03.2018;2018;03;07;Lauantai;5;3;8;4;2;6
292;10.03.2018;2018;03;08;Lauantai;4;1;5;1;7;8
292;10.03.2018;2018;03;09;Lauantai;2;4;6;7;8;15
292;10.03.2018;2018;03;10;Lauantai;7;7;14;10;15;25
292;10.03.2018;2018;03;11;Lauantai;3;9;12;19;12;31
292;10.03.2018;2018;03;12;Lauantai;7;9;16;10;11;21
292;10.03.2018;2018;03;13;Lauantai;7;5;12;13;9;22
292;10.03.2018;2018;03;14;Lauantai;9;5;14;15;13;28
292;10.03.2018;2018;03;15;Lauantai;14;8;22;10;3;13
292;10.03.2018;2018;03;16;Lauantai;6;5;11;14;9;23
292;10.03.2018;2018;03;17;Lauantai;8;7;15;9;9;18
292;10.03.2018;2018;03;18;Lauantai;8;3;11;9;21;30
292;10.03.2018;2018;03;19;Lauantai;4;2;6;6;8;14
292;10.03.2018;2018;03;20;Lauantai;7;9;16;9;5;14
292;10.03.2018;2018;03;21;Lauantai;1;2;3;8;6;14
292;10.03.2018;2018;03;22;Lauantai;5;0;5;5;1;6
292;10.03.2018;2018;03;23;Lauantai;1;1;2;4;0;4
292;11.03.2018;2018;03;00;Sunnuntai;3;0;3;4;0;4
292;11.03.2018;2018;03;01;Sunnuntai;0;1;1;0;1;1
292;11.03.2018;2018;03;02;Sunnuntai;1;1;2;8;7;15
292;11.03.2018;2018;03;03;Sunnuntai;0;0;0;0;3;3
292;11.03.2018;2018;03;04;Sunnuntai;0;0;0;0;0;0
292;11.03.2018;2018;03;05;Sunnuntai;0;0;0;3;0;3
292;11.03.2018;2018;03;06;Sunnuntai;3;0;3;2;4;6
292;11.03.2018;2018;03;07;Sunnuntai;3;1;4;4;3;7
292;11.03.2018;2018;03;08;Sunnuntai;3;2;5;5;3;8
292;11.03.2018;2018;03;09;Sunnuntai;3;0;3;4;8;12
292;11.03.2018;2018;03;10;Sunnuntai;1;1;2;10;4;14
292;11.03.2018;2018;03;11;Sunnuntai;8;2;10;11;11;22
292;11.03.2018;2018;03;12;Sunnuntai;3;3;6;13;11;24
292;11.03.2018;2018;03;13;Sunnuntai;3;4;7;7;7;14
292;11.03.2018;2018;03;14;Sunnuntai;9;7;16;11;13;24
292;11.03.2018;2018;03;15;Sunnuntai;6;6;12;4;5;9
292;11.03.2018;2018;03;16;Sunnuntai;11;11;22;8;9;17
292;11.03.2018;2018;03;17;Sunnuntai;9;3;12;11;7;18
292;11.03.2018;2018;03;18;Sunnuntai;8;10;18;14;14;28
292;11.03.2018;2018;03;19;Sunnuntai;4;1;5;8;4;12
292;11.03.2018;2018;03;20;Sunnuntai;1;2;3;8;9;17
292;11.03.2018;2018;03;21;Sunnuntai;2;5;7;4;3;7
292;11.03.2018;2018;03;22;Sunnuntai;1;0;1;0;2;2
292;11.03.2018;2018;03;23;Sunnuntai;1;0;1;0;0;0
292;12.03.2018;2018;03;00;Maanantai;0;1;1;0;0;0
292;12.03.2018;2018;03;01;Maanantai;0;0;0;0;0;0
292;12.03.2018;2018;03;02;Maanantai;0;0;0;1;0;1
292;12.03.2018;2018;03;03;Maanantai;0;0;0;0;0;0
292;12.03.2018;2018;03;04;Maanantai;0;1;1;0;0;0
292;12.03.2018;2018;03;05;Maanantai;4;4;8;0;1;1
292;12.03.2018;2018;03;06;Maanantai;15;14;29;3;4;7
292;12.03.2018;2018;03;07;Maanantai;31;16;47;17;8;25
292;12.03.2018;2018;03;08;Maanantai;25;15;40;13;7;20
292;12.03.2018;2018;03;09;Maanantai;42;9;51;11;14;25
292;12.03.2018;2018;03;10;Maanantai;11;10;21;13;19;32
292;12.03.2018;2018;03;11;Maanantai;14;12;26;11;14;25
292;12.03.2018;2018;03;12;Maanantai;6;13;19;15;17;32
292;12.03.2018;2018;03;13;Maanantai;9;16;25;18;18;36
292;12.03.2018;2018;03;14;Maanantai;22;24;46;14;14;28
292;12.03.2018;2018;03;15;Maanantai;23;47;70;14;17;31
292;12.03.2018;2018;03;16;Maanantai;18;33;51;12;16;28
292;12.03.2018;2018;03;17;Maanantai;14;14;28;11;15;26
292;12.03.2018;2018;03;18;Maanantai;17;11;28;12;14;26
292;12.03.2018;2018;03;19;Maanantai;12;8;20;9;6;15
292;12.03.2018;2018;03;20;Maanantai;16;8;24;3;3;6
292;12.03.2018;2018;03;21;Maanantai;3;2;5;4;1;5
292;12.03.2018;2018;03;22;Maanantai;2;1;3;0;1;1
292;12.03.2018;2018;03;23;Maanantai;0;0;0;0;0;0
292;13.03.2018;2018;03;00;Tiistai;1;0;1;0;0;0
292;13.03.2018;2018;03;01;Tiistai;0;0;0;0;0;0
292;13.03.2018;2018;03;02;Tiistai;1;1;2;0;0;0
292;13.03.2018;2018;03;03;Tiistai;0;0;0;2;0;2
292;13.03.2018;2018;03;04;Tiistai;0;1;1;0;0;0
292;13.03.2018;2018;03;05;Tiistai;5;4;9;3;0;3
292;13.03.2018;2018;03;06;Tiistai;16;8;24;6;6;12
292;13.03.2018;2018;03;07;Tiistai;34;19;53;14;9;23
292;13.03.2018;2018;03;08;Tiistai;38;14;52;28;14;42
292;13.03.2018;2018;03;09;Tiistai;21;19;40;19;11;30
292;13.03.2018;2018;03;10;Tiistai;17;11;28;9;13;22
292;13.03.2018;2018;03;11;Tiistai;14;16;30;10;15;25
292;13.03.2018;2018;03;12;Tiistai;7;11;18;12;14;26
292;13.03.2018;2018;03;13;Tiistai;20;26;46;18;9;27
292;13.03.2018;2018;03;14;Tiistai;17;33;50;18;18;36
292;13.03.2018;2018;03;15;Tiistai;16;31;47;16;17;33
292;13.03.2018;2018;03;16;Tiistai;21;26;47;11;19;30
292;13.03.2018;2018;03;17;Tiistai;12;12;24;9;8;17
292;13.03.2018;2018;03;18;Tiistai;9;8;17;6;15;21
292;13.03.2018;2018;03;19;Tiistai;7;6;13;15;9;24
292;13.03.2018;2018;03;20;Tiistai;10;4;14;2;5;7
292;13.03.2018;2018;03;21;Tiistai;5;2;7;3;1;4
292;13.03.2018;2018;03;22;Tiistai;3;1;4;0;0;0
292;13.03.2018;2018;03;23;Tiistai;0;1;1;1;0;1
292;14.03.2018;2018;03;00;Keskiviikko;0;0;0;1;0;1
292;14.03.2018;2018;03;01;Keskiviikko;2;0;2;0;0;0
292;14.03.2018;2018;03;02;Keskiviikko;0;0;0;0;0;0
292;14.03.2018;2018;03;03;Keskiviikko;2;1;3;2;2;4
292;14.03.2018;2018;03;04;Keskiviikko;0;0;0;0;0;0
292;14.03.2018;2018;03;05;Keskiviikko;3;2;5;1;1;2
292;14.03.2018;2018;03;06;Keskiviikko;11;9;20;4;3;7
292;14.03.2018;2018;03;07;Keskiviikko;37;22;59;21;11;32
292;14.03.2018;2018;03;08;Keskiviikko;34;16;50;13;8;21
292;14.03.2018;2018;03;09;Keskiviikko;22;9;31;6;8;14
292;14.03.2018;2018;03;10;Keskiviikko;8;5;13;14;10;24
292;14.03.2018;2018;03;11;Keskiviikko;11;11;22;8;14;22
292;14.03.2018;2018;03;12;Keskiviikko;5;5;10;7;8;15
292;14.03.2018;2018;03;13;Keskiviikko;15;37;52;17;16;33
292;14.03.2018;2018;03;14;Keskiviikko;11;25;36;14;26;40
292;14.03.2018;2018;03;15;Keskiviikko;15;29;44;12;17;29
292;14.03.2018;2018;03;16;Keskiviikko;17;32;49;16;17;33
292;14.03.2018;2018;03;17;Keskiviikko;10;10;20;10;12;22
292;14.03.2018;2018;03;18;Keskiviikko;5;8;13;15;7;22
292;14.03.2018;2018;03;19;Keskiviikko;9;9;18;19;16;35
292;14.03.2018;2018;03;20;Keskiviikko;10;5;15;7;6;13
292;14.03.2018;2018;03;21;Keskiviikko;2;5;7;3;1;4
292;14.03.2018;2018;03;22;Keskiviikko;1;1;2;1;2;3
292;14.03.2018;2018;03;23;Keskiviikko;0;1;1;1;0;1
292;15.03.2018;2018;03;00;Torstai;2;0;2;0;0;0
292;15.03.2018;2018;03;01;Torstai;0;0;0;0;0;0
292;15.03.2018;2018;03;02;Torstai;0;0;0;0;0;0
292;15.03.2018;2018;03;03;Torstai;0;0;0;0;0;0
292;15.03.2018;2018;03;04;Torstai;1;0;1;0;0;0
292;15.03.2018;2018;03;05;Torstai;3;8;11;1;0;1
292;15.03.2018;2018;03;06;Torstai;12;10;22;4;6;10
292;15.03.2018;2018;03;07;Torstai;29;12;41;19;6;25
292;15.03.2018;2018;03;08;Torstai;22;17;39;14;13;27
292;15.03.2018;2018;03;09;Torstai;29;12;41;21;9;30
292;15.03.2018;2018;03;10;Torstai;7;11;18;21;10;31
292;15.03.2018;2018;03;11;Torstai;12;10;22;11;24;35
292;15.03.2018;2018;03;12;Torstai;9;20;29;16;11;27
292;15.03.2018;2018;03;13;Torstai;15;22;37;18;21;39
292;15.03.2018;2018;03;14;Torstai;11;26;37;19;24;43
292;15.03.2018;2018;03;15;Torstai;13;34;47;13;21;34
292;15.03.2018;2018;03;16;Torstai;10;35;45;8;17;25
292;15.03.2018;2018;03;17;Torstai;12;15;27;15;7;22
292;15.03.2018;2018;03;18;Torstai;9;6;15;16;13;29
292;15.03.2018;2018;03;19;Torstai;9;4;13;7;7;14
292;15.03.2018;2018;03;20;Torstai;11;6;17;10;8;18
292;15.03.2018;2018;03;21;Torstai;6;2;8;4;3;7
292;15.03.2018;2018;03;22;Torstai;2;3;5;0;1;1
292;15.03.2018;2018;03;23;Torstai;0;0;0;0;0;0
292;16.03.2018;2018;03;00;Perjantai;0;0;0;0;0;0
292;16.03.2018;2018;03;01;Perjantai;0;1;1;2;0;2
292;16.03.2018;2018;03;02;Perjantai;0;0;0;0;0;0
292;16.03.2018;2018;03;03;Perjantai;0;0;0;1;0;1
292;16.03.2018;2018;03;04;Perjantai;3;0;3;0;0;0
292;16.03.2018;2018;03;05;Perjantai;1;4;5;3;0;3
292;16.03.2018;2018;03;06;Perjantai;9;3;12;2;5;7
292;16.03.2018;2018;03;07;Perjantai;32;16;48;18;5;23
292;16.03.2018;2018;03;08;Perjantai;33;12;45;9;12;21
292;16.03.2018;2018;03;09;Perjantai;11;11;22;7;9;16
292;16.03.2018;2018;03;10;Perjantai;4;16;20;8;10;18
292;16.03.2018;2018;03;11;Perjantai;5;16;21;18;22;40
292;16.03.2018;2018;03;12;Perjantai;11;14;25;18;23;41
292;16.03.2018;2018;03;13;Perjantai;8;28;36;19;15;34
292;16.03.2018;2018;03;14;Perjantai;11;32;43;17;19;36
292;16.03.2018;2018;03;15;Perjantai;10;15;25;9;6;15
292;16.03.2018;2018;03;16;Perjantai;13;14;27;22;11;33
292;16.03.2018;2018;03;17;Perjantai;15;12;27;9;19;28
292;16.03.2018;2018;03;18;Perjantai;5;11;16;10;7;17
292;16.03.2018;2018;03;19;Perjantai;8;9;17;9;7;16
292;16.03.2018;2018;03;20;Perjantai;9;9;18;13;8;21
292;16.03.2018;2018;03;21;Perjantai;2;7;9;3;5;8
292;16.03.2018;2018;03;22;Perjantai;2;3;5;8;2;10
292;16.03.2018;2018;03;23;Perjantai;5;0;5;5;0;5
292;17.03.2018;2018;03;00;Lauantai;3;0;3;1;2;3
292;17.03.2018;2018;03;01;Lauantai;0;0;0;0;0;0
292;17.03.2018;2018;03;02;Lauantai;0;1;1;1;0;1
292;17.03.2018;2018;03;03;Lauantai;0;1;1;2;2;4
292;17.03.2018;2018;03;04;Lauantai;0;0;0;0;0;0
292;17.03.2018;2018;03;05;Lauantai;0;1;1;1;0;1
292;17.03.2018;2018;03;06;Lauantai;2;0;2;0;2;2
292;17.03.2018;2018;03;07;Lauantai;0;4;4;4;2;6
292;17.03.2018;2018;03;08;Lauantai;2;3;5;5;2;7
292;17.03.2018;2018;03;09;Lauantai;3;6;9;5;7;12
292;17.03.2018;2018;03;10;Lauantai;6;11;17;4;21;25
292;17.03.2018;2018;03;11;Lauantai;10;11;21;19;14;33
292;17.03.2018;2018;03;12;Lauantai;10;13;23;15;15;30
292;17.03.2018;2018;03;13;Lauantai;7;7;14;13;18;31
292;17.03.2018;2018;03;14;Lauantai;14;10;24;17;14;31
292;17.03.2018;2018;03;15;Lauantai;16;11;27;19;7;26
292;17.03.2018;2018;03;16;Lauantai;13;10;23;16;10;26
292;17.03.2018;2018;03;17;Lauantai;7;10;17;10;13;23
292;17.03.2018;2018;03;18;Lauantai;10;6;16;12;8;20
292;17.03.2018;2018;03;19;Lauantai;9;3;12;14;10;24
292;17.03.2018;2018;03;20;Lauantai;3;4;7;3;6;9
292;17.03.2018;2018;03;21;Lauantai;3;3;6;8;2;10
292;17.03.2018;2018;03;22;Lauantai;3;3;6;3;1;4
292;17.03.2018;2018;03;23;Lauantai;1;0;1;0;0;0
292;18.03.2018;2018;03;00;Sunnuntai;0;0;0;5;2;7
292;18.03.2018;2018;03;01;Sunnuntai;0;1;1;1;0;1
292;18.03.2018;2018;03;02;Sunnuntai;0;2;2;1;2;3
292;18.03.2018;2018;03;03;Sunnuntai;0;1;1;0;1;1
292;18.03.2018;2018;03;04;Sunnuntai;0;1;1;1;0;1
292;18.03.2018;2018;03;05;Sunnuntai;0;0;0;2;0;2
292;18.03.2018;2018;03;06;Sunnuntai;0;2;2;2;0;2
292;18.03.2018;2018;03;07;Sunnuntai;0;2;2;3;5;8
292;18.03.2018;2018;03;08;Sunnuntai;0;2;2;10;10;20
292;18.03.2018;2018;03;09;Sunnuntai;11;2;13;22;13;35
292;18.03.2018;2018;03;10;Sunnuntai;4;5;9;11;19;30
292;18.03.2018;2018;03;11;Sunnuntai;11;16;27;12;15;27
292;18.03.2018;2018;03;12;Sunnuntai;14;14;28;13;14;27
292;18.03.2018;2018;03;13;Sunnuntai;3;7;10;8;11;19
292;18.03.2018;2018;03;14;Sunnuntai;14;14;28;21;14;35
292;18.03.2018;2018;03;15;Sunnuntai;12;10;22;11;13;24
292;18.03.2018;2018;03;16;Sunnuntai;12;13;25;10;7;17
292;18.03.2018;2018;03;17;Sunnuntai;9;8;17;21;15;36
292;18.03.2018;2018;03;18;Sunnuntai;8;7;15;12;9;21
292;18.03.2018;2018;03;19;Sunnuntai;6;4;10;4;10;14
292;18.03.2018;2018;03;20;Sunnuntai;4;2;6;6;5;11
292;18.03.2018;2018;03;21;Sunnuntai;2;2;4;9;7;16
292;18.03.2018;2018;03;22;Sunnuntai;1;3;4;0;1;1
292;18.03.2018;2018;03;23;Sunnuntai;0;0;0;0;0;0
292;19.03.2018;2018;03;00;Maanantai;1;0;1;0;0;0
292;19.03.2018;2018;03;01;Maanantai;0;0;0;1;0;1
292;19.03.2018;2018;03;02;Maanantai;0;0;0;0;0;0
292;19.03.2018;2018;03;03;Maanantai;0;0;0;0;0;0
292;19.03.2018;2018;03;04;Maanantai;3;0;3;0;0;0
292;19.03.2018;2018;03;05;Maanantai;7;7;14;0;1;1
292;19.03.2018;2018;03;06;Maanantai;10;9;19;2;4;6
292;19.03.2018;2018;03;07;Maanantai;40;20;60;15;9;24
292;19.03.2018;2018;03;08;Maanantai;29;15;44;17;19;36
292;19.03.2018;2018;03;09;Maanantai;44;16;60;24;17;41
292;19.03.2018;2018;03;10;Maanantai;10;8;18;19;12;31
292;19.03.2018;2018;03;11;Maanantai;15;10;25;16;10;26
292;19.03.2018;2018;03;12;Maanantai;11;12;23;8;17;25
292;19.03.2018;2018;03;13;Maanantai;8;30;38;19;22;41
292;19.03.2018;2018;03;14;Maanantai;32;40;72;26;39;65
292;19.03.2018;2018;03;15;Maanantai;20;47;67;33;23;56
292;19.03.2018;2018;03;16;Maanantai;17;38;55;14;21;35
292;19.03.2018;2018;03;17;Maanantai;14;25;39;20;12;32
292;19.03.2018;2018;03;18;Maanantai;7;15;22;14;13;27
292;19.03.2018;2018;03;19;Maanantai;14;11;25;8;14;22
292;19.03.2018;2018;03;20;Maanantai;11;3;14;3;6;9
292;19.03.2018;2018;03;21;Maanantai;4;9;13;5;7;12
292;19.03.2018;2018;03;22;Maanantai;2;0;2;2;0;2
292;19.03.2018;2018;03;23;Maanantai;1;1;2;0;0;0
292;20.03.2018;2018;03;00;Tiistai;1;0;1;0;0;0
292;20.03.2018;2018;03;01;Tiistai;0;0;0;0;0;0
292;20.03.2018;2018;03;02;Tiistai;0;0;0;0;0;0
292;20.03.2018;2018;03;03;Tiistai;0;1;1;0;0;0
292;20.03.2018;2018;03;04;Tiistai;1;0;1;0;0;0
292;20.03.2018;2018;03;05;Tiistai;3;5;8;3;0;3
292;20.03.2018;2018;03;06;Tiistai;11;12;23;7;5;12
292;20.03.2018;2018;03;07;Tiistai;43;19;62;16;5;21
292;20.03.2018;2018;03;08;Tiistai;38;18;56;15;18;33
292;20.03.2018;2018;03;09;Tiistai;13;15;28;10;9;19
292;20.03.2018;2018;03;10;Tiistai;16;5;21;16;6;22
292;20.03.2018;2018;03;11;Tiistai;7;11;18;15;19;34
292;20.03.2018;2018;03;12;Tiistai;9;13;22;19;8;27
292;20.03.2018;2018;03;13;Tiistai;13;39;52;18;17;35
292;20.03.2018;2018;03;14;Tiistai;11;47;58;23;24;47
292;20.03.2018;2018;03;15;Tiistai;19;38;57;21;19;40
292;20.03.2018;2018;03;16;Tiistai;19;32;51;18;13;31
292;20.03.2018;2018;03;17;Tiistai;17;13;30;19;12;31
292;20.03.2018;2018;03;18;Tiistai;9;20;29;7;14;21
292;20.03.2018;2018;03;19;Tiistai;5;6;11;6;9;15
292;20.03.2018;2018;03;20;Tiistai;7;8;15;6;3;9
292;20.03.2018;2018;03;21;Tiistai;1;0;1;2;0;2
292;20.03.2018;2018;03;22;Tiistai;1;1;2;2;1;3
292;20.03.2018;2018;03;23;Tiistai;0;1;1;1;0;1
292;21.03.2018;2018;03;00;Keskiviikko;0;0;0;0;0;0
292;21.03.2018;2018;03;01;Keskiviikko;1;1;2;0;0;0
292;21.03.2018;2018;03;02;Keskiviikko;0;1;1;0;0;0
292;21.03.2018;2018;03;03;Keskiviikko;0;0;0;0;0;0
292;21.03.2018;2018;03;04;Keskiviikko;2;0;2;0;0;0
292;21.03.2018;2018;03;05;Keskiviikko;3;5;8;2;1;3
292;21.03.2018;2018;03;06;Keskiviikko;12;8;20;7;7;14
292;21.03.2018;2018;03;07;Keskiviikko;47;21;68;12;5;17
292;21.03.2018;2018;03;08;Keskiviikko;34;11;45;10;12;22
292;21.03.2018;2018;03;09;Keskiviikko;18;9;27;9;7;16
292;21.03.2018;2018;03;10;Keskiviikko;14;8;22;19;8;27
292;21.03.2018;2018;03;11;Keskiviikko;5;9;14;9;8;17
292;21.03.2018;2018;03;12;Keskiviikko;4;8;12;12;2;14
292;21.03.2018;2018;03;13;Keskiviikko;20;45;65;13;15;28
292;21.03.2018;2018;03;14;Keskiviikko;20;41;61;21;15;36
292;21.03.2018;2018;03;15;Keskiviikko;15;19;34;14;18;32
292;21.03.2018;2018;03;16;Keskiviikko;26;25;51;7;16;23
292;21.03.2018;2018;03;17;Keskiviikko;16;13;29;12;15;27
292;21.03.2018;2018;03;18;Keskiviikko;10;15;25;11;12;23
292;21.03.2018;2018;03;19;Keskiviikko;7;10;17;17;17;34
292;21.03.2018;2018;03;20;Keskiviikko;13;2;15;5;10;15
292;21.03.2018;2018;03;21;Keskiviikko;3;5;8;4;6;10
292;21.03.2018;2018;03;22;Keskiviikko;0;3;3;3;1;4
292;21.03.2018;2018;03;23;Keskiviikko;1;1;2;0;0;0
292;22.03.2018;2018;03;00;Torstai;0;0;0;0;0;0
292;22.03.2018;2018;03;01;Torstai;0;0;0;0;0;0
292;22.03.2018;2018;03;02;Torstai;0;0;0;0;0;0
292;22.03.2018;2018;03;03;Torstai;0;0;0;2;0;2
292;22.03.2018;2018;03;04;Torstai;2;0;2;1;0;1
292;22.03.2018;2018;03;05;Torstai;5;4;9;1;0;1
292;22.03.2018;2018;03;06;Torstai;11;11;22;3;5;8
292;22.03.2018;2018;03;07;Torstai;25;24;49;14;15;29
292;22.03.2018;2018;03;08;Torstai;28;19;47;15;12;27
292;22.03.2018;2018;03;09;Torstai;39;13;52;15;12;27
292;22.03.2018;2018;03;10;Torstai;13;9;22;18;1;19
292;22.03.2018;2018;03;11;Torstai;14;19;33;12;17;29
292;22.03.2018;2018;03;12;Torstai;10;14;24;12;11;23
292;22.03.2018;2018;03;13;Torstai;15;25;40;19;21;40
292;22.03.2018;2018;03;14;Torstai;18;25;43;22;21;43
292;22.03.2018;2018;03;15;Torstai;24;43;67;13;17;30
292;22.03.2018;2018;03;16;Torstai;25;35;60;11;11;22
292;22.03.2018;2018;03;17;Torstai;18;15;33;11;10;21
292;22.03.2018;2018;03;18;Torstai;9;13;22;6;5;11
292;22.03.2018;2018;03;19;Torstai;11;7;18;3;4;7
292;22.03.2018;2018;03;20;Torstai;9;7;16;10;6;16
292;22.03.2018;2018;03;21;Torstai;8;6;14;2;2;4
292;22.03.2018;2018;03;22;Torstai;1;1;2;4;1;5
292;22.03.2018;2018;03;23;Torstai;1;0;1;2;2;4
292;23.03.2018;2018;03;00;Perjantai;0;0;0;0;0;0
292;23.03.2018;2018;03;01;Perjantai;1;1;2;0;0;0
292;23.03.2018;2018;03;02;Perjantai;0;0;0;0;0;0
292;23.03.2018;2018;03;03;Perjantai;0;0;0;0;0;0
292;23.03.2018;2018;03;04;Perjantai;1;0;1;0;0;0
292;23.03.2018;2018;03;05;Perjantai;3;5;8;1;1;2
292;23.03.2018;2018;03;06;Perjantai;11;7;18;4;4;8
292;23.03.2018;2018;03;07;Perjantai;32;24;56;19;5;24
292;23.03.2018;2018;03;08;Perjantai;33;14;47;13;18;31
292;23.03.2018;2018;03;09;Perjantai;19;7;26;7;9;16
292;23.03.2018;2018;03;10;Perjantai;7;10;17;10;14;24
292;23.03.2018;2018;03;11;Perjantai;14;16;30;7;11;18
292;23.03.2018;2018;03;12;Perjantai;20;24;44;17;22;39
292;23.03.2018;2018;03;13;Perjantai;20;41;61;25;19;44
292;23.03.2018;2018;03;14;Perjantai;17;38;55;32;28;60
292;23.03.2018;2018;03;15;Perjantai;20;29;49;14;16;30
292;23.03.2018;2018;03;16;Perjantai;18;28;46;17;13;30
292;23.03.2018;2018;03;17;Perjantai;13;21;34;18;20;38
292;23.03.2018;2018;03;18;Perjantai;18;7;25;18;14;32
292;23.03.2018;2018;03;19;Perjantai;12;9;21;9;14;23
292;23.03.2018;2018;03;20;Perjantai;8;9;17;4;4;8
292;23.03.2018;2018;03;21;Perjantai;2;8;10;9;7;16
292;23.03.2018;2018;03;22;Perjantai;5;4;9;5;3;8
292;23.03.2018;2018;03;23;Perjantai;4;2;6;6;0;6
292;24.03.2018;2018;03;00;Lauantai;3;0;3;1;1;2
292;24.03.2018;2018;03;01;Lauantai;0;1;1;1;2;3
292;24.03.2018;2018;03;02;Lauantai;0;0;0;0;6;6
292;24.03.2018;2018;03;03;Lauantai;0;0;0;0;3;3
292;24.03.2018;2018;03;04;Lauantai;0;1;1;0;1;1
292;24.03.2018;2018;03;05;Lauantai;0;1;1;2;0;2
292;24.03.2018;2018;03;06;Lauantai;5;1;6;2;3;5
292;24.03.2018;2018;03;07;Lauantai;1;1;2;6;2;8
292;24.03.2018;2018;03;08;Lauantai;3;2;5;8;5;13
292;24.03.2018;2018;03;09;Lauantai;4;6;10;5;9;14
292;24.03.2018;2018;03;10;Lauantai;2;4;6;5;8;13
292;24.03.2018;2018;03;11;Lauantai;5;6;11;12;7;19
292;24.03.2018;2018;03;12;Lauantai;10;4;14;15;14;29
292;24.03.2018;2018;03;13;Lauantai;7;7;14;8;2;10
292;24.03.2018;2018;03;14;Lauantai;6;4;10;3;4;7
292;24.03.2018;2018;03;15;Lauantai;9;6;15;9;7;16
292;24.03.2018;2018;03;16;Lauantai;2;3;5;6;2;8
292;24.03.2018;2018;03;17;Lauantai;8;4;12;13;16;29
292;24.03.2018;2018;03;18;Lauantai;6;0;6;12;14;26
292;24.03.2018;2018;03;19;Lauantai;1;5;6;7;6;13
292;24.03.2018;2018;03;20;Lauantai;4;4;8;4;9;13
292;24.03.2018;2018;03;21;Lauantai;2;3;5;7;2;9
292;24.03.2018;2018;03;22;Lauantai;3;1;4;2;4;6
292;24.03.2018;2018;03;23;Lauantai;0;2;2;6;3;9
292;25.03.2018;2018;03;00;Sunnuntai;0;0;0;0;3;3
292;25.03.2018;2018;03;01;Sunnuntai;0;0;0;0;1;1
292;25.03.2018;2018;03;02;Sunnuntai;0;0;0;0;0;0
292;25.03.2018;2018;03;03;Sunnuntai;0;0;0;0;0;0
292;25.03.2018;2018;03;04;Sunnuntai;0;0;0;0;6;6
292;25.03.2018;2018;03;05;Sunnuntai;1;0;1;1;0;1
292;25.03.2018;2018;03;06;Sunnuntai;4;1;5;3;2;5
292;25.03.2018;2018;03;07;Sunnuntai;1;1;2;0;2;2
292;25.03.2018;2018;03;08;Sunnuntai;1;2;3;4;6;10
292;25.03.2018;2018;03;09;Sunnuntai;2;7;9;4;2;6
292;25.03.2018;2018;03;10;Sunnuntai;2;4;6;7;8;15
292;25.03.2018;2018;03;11;Sunnuntai;7;23;30;9;7;16
292;25.03.2018;2018;03;12;Sunnuntai;8;8;16;9;25;34
292;25.03.2018;2018;03;13;Sunnuntai;12;11;23;29;19;48
292;25.03.2018;2018;03;14;Sunnuntai;2;13;15;20;14;34
292;25.03.2018;2018;03;15;Sunnuntai;2;7;9;13;14;27
292;25.03.2018;2018;03;16;Sunnuntai;10;11;21;20;13;33
292;25.03.2018;2018;03;17;Sunnuntai;8;11;19;13;10;23
292;25.03.2018;2018;03;18;Sunnuntai;3;9;12;18;22;40
292;25.03.2018;2018;03;19;Sunnuntai;6;2;8;15;4;19
292;25.03.2018;2018;03;20;Sunnuntai;2;5;7;11;9;20
292;25.03.2018;2018;03;21;Sunnuntai;2;2;4;1;4;5
292;25.03.2018;2018;03;22;Sunnuntai;1;1;2;0;0;0
292;25.03.2018;2018;03;23;Sunnuntai;0;0;0;0;0;0
292;26.03.2018;2018;03;00;Maanantai;0;0;0;0;0;0
292;26.03.2018;2018;03;01;Maanantai;0;0;0;1;0;1
292;26.03.2018;2018;03;02;Maanantai;0;0;0;0;0;0
292;26.03.2018;2018;03;03;Maanantai;0;0;0;0;0;0
292;26.03.2018;2018;03;04;Maanantai;1;0;1;0;0;0
292;26.03.2018;2018;03;05;Maanantai;4;4;8;0;1;1
292;26.03.2018;2018;03;06;Maanantai;13;4;17;2;6;8
292;26.03.2018;2018;03;07;Maanantai;21;19;40;15;2;17
292;26.03.2018;2018;03;08;Maanantai;19;14;33;17;16;33
292;26.03.2018;2018;03;09;Maanantai;15;8;23;37;10;47
292;26.03.2018;2018;03;10;Maanantai;11;10;21;12;16;28
292;26.03.2018;2018;03;11;Maanantai;5;14;19;22;13;35
292;26.03.2018;2018;03;12;Maanantai;12;15;27;11;17;28
292;26.03.2018;2018;03;13;Maanantai;14;24;38;19;19;38
292;26.03.2018;2018;03;14;Maanantai;23;50;73;20;14;34
292;26.03.2018;2018;03;15;Maanantai;18;41;59;13;12;25
292;26.03.2018;2018;03;16;Maanantai;14;30;44;28;24;52
292;26.03.2018;2018;03;17;Maanantai;6;15;21;15;14;29
292;26.03.2018;2018;03;18;Maanantai;11;12;23;19;11;30
292;26.03.2018;2018;03;19;Maanantai;9;8;17;14;16;30
292;26.03.2018;2018;03;20;Maanantai;8;5;13;11;8;19
292;26.03.2018;2018;03;21;Maanantai;1;3;4;0;4;4
292;26.03.2018;2018;03;22;Maanantai;1;1;2;2;1;3
292;26.03.2018;2018;03;23;Maanantai;0;0;0;0;0;0
292;27.03.2018;2018;03;00;Tiistai;0;0;0;0;0;0
292;27.03.2018;2018;03;01;Tiistai;0;0;0;0;0;0
292;27.03.2018;2018;03;02;Tiistai;0;0;0;0;0;0
292;27.03.2018;2018;03;03;Tiistai;0;0;0;0;0;0
292;27.03.2018;2018;03;04;Tiistai;2;0;2;0;0;0
292;27.03.2018;2018;03;05;Tiistai;4;4;8;1;0;1
292;27.03.2018;2018;03;06;Tiistai;12;6;18;5;5;10
292;27.03.2018;2018;03;07;Tiistai;28;16;44;16;8;24
292;27.03.2018;2018;03;08;Tiistai;36;13;49;16;12;28
292;27.03.2018;2018;03;09;Tiistai;8;11;19;8;8;16
292;27.03.2018;2018;03;10;Tiistai;9;9;18;9;10;19
292;27.03.2018;2018;03;11;Tiistai;11;13;24;17;11;28
292;27.03.2018;2018;03;12;Tiistai;6;11;17;13;13;26
292;27.03.2018;2018;03;13;Tiistai;14;38;52;15;16;31
292;27.03.2018;2018;03;14;Tiistai;21;50;71;15;19;34
292;27.03.2018;2018;03;15;Tiistai;15;29;44;15;11;26
292;27.03.2018;2018;03;16;Tiistai;15;27;42;26;18;44
292;27.03.2018;2018;03;17;Tiistai;15;6;21;15;19;34
292;27.03.2018;2018;03;18;Tiistai;8;6;14;10;10;20
292;27.03.2018;2018;03;19;Tiistai;7;9;16;6;9;15
292;27.03.2018;2018;03;20;Tiistai;7;1;8;7;12;19
292;27.03.2018;2018;03;21;Tiistai;3;6;9;3;1;4
292;27.03.2018;2018;03;22;Tiistai;1;0;1;1;0;1
292;27.03.2018;2018;03;23;Tiistai;1;0;1;0;1;1
292;28.03.2018;2018;03;00;Keskiviikko;0;1;1;0;0;0
292;28.03.2018;2018;03;01;Keskiviikko;0;1;1;0;0;0
292;28.03.2018;2018;03;02;Keskiviikko;0;0;0;0;0;0
292;28.03.2018;2018;03;03;Keskiviikko;0;0;0;0;0;0
292;28.03.2018;2018;03;04;Keskiviikko;1;0;1;0;0;0
292;28.03.2018;2018;03;05;Keskiviikko;4;3;7;2;0;2
292;28.03.2018;2018;03;06;Keskiviikko;16;12;28;1;5;6
292;28.03.2018;2018;03;07;Keskiviikko;30;22;52;7;9;16
292;28.03.2018;2018;03;08;Keskiviikko;41;23;64;17;16;33
292;28.03.2018;2018;03;09;Keskiviikko;27;12;39;13;10;23
292;28.03.2018;2018;03;10;Keskiviikko;12;6;18;15;10;25
292;28.03.2018;2018;03;11;Keskiviikko;11;11;22;12;5;17
292;28.03.2018;2018;03;12;Keskiviikko;10;17;27;17;11;28
292;28.03.2018;2018;03;13;Keskiviikko;16;39;55;21;20;41
292;28.03.2018;2018;03;14;Keskiviikko;17;46;63;22;18;40
292;28.03.2018;2018;03;15;Keskiviikko;28;33;61;14;14;28
292;28.03.2018;2018;03;16;Keskiviikko;27;25;52;14;19;33
292;28.03.2018;2018;03;17;Keskiviikko;15;23;38;8;13;21
292;28.03.2018;2018;03;18;Keskiviikko;11;16;27;24;15;39
292;28.03.2018;2018;03;19;Keskiviikko;10;9;19;9;12;21
292;28.03.2018;2018;03;20;Keskiviikko;17;8;25;3;5;8
292;28.03.2018;2018;03;21;Keskiviikko;4;9;13;6;3;9
292;28.03.2018;2018;03;22;Keskiviikko;2;2;4;2;1;3
292;28.03.2018;2018;03;23;Keskiviikko;0;2;2;1;1;2
292;29.03.2018;2018;03;00;Torstai;0;0;0;1;1;2
292;29.03.2018;2018;03;01;Torstai;0;0;0;0;0;0
292;29.03.2018;2018;03;02;Torstai;0;0;0;0;0;0
292;29.03.2018;2018;03;03;Torstai;0;0;0;0;0;0
292;29.03.2018;2018;03;04;Torstai;1;0;1;2;0;2
292;29.03.2018;2018;03;05;Torstai;5;3;8;0;0;0
292;29.03.2018;2018;03;06;Torstai;12;8;20;2;4;6
292;29.03.2018;2018;03;07;Torstai;38;18;56;20;6;26
292;29.03.2018;2018;03;08;Torstai;36;17;53;14;14;28
292;29.03.2018;2018;03;09;Torstai;12;21;33;6;10;16
292;29.03.2018;2018;03;10;Torstai;12;19;31;20;7;27
292;29.03.2018;2018;03;11;Torstai;9;12;21;15;22;37
292;29.03.2018;2018;03;12;Torstai;12;21;33;9;11;20
292;29.03.2018;2018;03;13;Torstai;14;38;52;21;21;42
292;29.03.2018;2018;03;14;Torstai;17;29;46;16;14;30
292;29.03.2018;2018;03;15;Torstai;21;34;55;15;8;23
292;29.03.2018;2018;03;16;Torstai;15;20;35;17;18;35
292;29.03.2018;2018;03;17;Torstai;6;11;17;8;8;16
292;29.03.2018;2018;03;18;Torstai;14;13;27;12;11;23
292;29.03.2018;2018;03;19;Torstai;2;7;9;6;5;11
292;29.03.2018;2018;03;20;Torstai;11;3;14;6;10;16
292;29.03.2018;2018;03;21;Torstai;2;2;4;5;5;10
292;29.03.2018;2018;03;22;Torstai;1;5;6;4;1;5
292;29.03.2018;2018;03;23;Torstai;1;2;3;3;3;6
292;30.03.2018;2018;03;00;Perjantai;2;0;2;0;1;1
292;30.03.2018;2018;03;01;Perjantai;0;1;1;2;1;3
292;30.03.2018;2018;03;02;Perjantai;0;1;1;2;1;3
292;30.03.2018;2018;03;03;Perjantai;0;1;1;0;0;0
292;30.03.2018;2018;03;04;Perjantai;0;1;1;0;3;3
292;30.03.2018;2018;03;05;Perjantai;0;0;0;2;0;2
292;30.03.2018;2018;03;06;Perjantai;2;1;3;1;3;4
292;30.03.2018;2018;03;07;Perjantai;2;0;2;4;1;5
292;30.03.2018;2018;03;08;Perjantai;1;2;3;9;11;20
292;30.03.2018;2018;03;09;Perjantai;1;3;4;5;4;9
292;30.03.2018;2018;03;10;Perjantai;2;4;6;7;7;14
292;30.03.2018;2018;03;11;Perjantai;5;8;13;19;23;42
292;30.03.2018;2018;03;12;Perjantai;6;22;28;22;17;39
292;30.03.2018;2018;03;13;Perjantai;18;10;28;19;18;37
292;30.03.2018;2018;03;14;Perjantai;10;12;22;21;19;40
292;30.03.2018;2018;03;15;Perjantai;7;8;15;25;12;37
292;30.03.2018;2018;03;16;Perjantai;12;11;23;15;20;35
292;30.03.2018;2018;03;17;Perjantai;8;6;14;12;10;22
292;30.03.2018;2018;03;18;Perjantai;6;12;18;17;10;27
292;30.03.2018;2018;03;19;Perjantai;3;3;6;7;9;16
292;30.03.2018;2018;03;20;Perjantai;4;7;11;6;4;10
292;30.03.2018;2018;03;21;Perjantai;5;5;10;4;3;7
292;30.03.2018;2018;03;22;Perjantai;3;2;5;6;6;12
292;30.03.2018;2018;03;23;Perjantai;3;0;3;3;1;4
292;31.03.2018;2018;03;00;Lauantai;1;1;2;0;1;1
292;31.03.2018;2018;03;01;Lauantai;0;2;2;0;2;2
292;31.03.2018;2018;03;02;Lauantai;0;0;0;1;2;3
292;31.03.2018;2018;03;03;Lauantai;1;0;1;0;1;1
292;31.03.2018;2018;03;04;Lauantai;1;0;1;1;2;3
292;31.03.2018;2018;03;05;Lauantai;0;0;0;1;0;1
292;31.03.2018;2018;03;06;Lauantai;2;2;4;0;1;1
292;31.03.2018;2018;03;07;Lauantai;0;2;2;4;2;6
292;31.03.2018;2018;03;08;Lauantai;2;2;4;5;3;8
292;31.03.2018;2018;03;09;Lauantai;4;5;9;9;8;17
292;31.03.2018;2018;03;10;Lauantai;4;7;11;7;10;17
292;31.03.2018;2018;03;11;Lauantai;8;12;20;19;13;32
292;31.03.2018;2018;03;12;Lauantai;6;15;21;11;11;22
292;31.03.2018;2018;03;13;Lauantai;15;9;24;21;13;34
292;31.03.2018;2018;03;14;Lauantai;2;8;10;12;11;23
292;31.03.2018;2018;03;15;Lauantai;10;12;22;12;12;24
292;31.03.2018;2018;03;16;Lauantai;12;9;21;19;16;35
292;31.03.2018;2018;03;17;Lauantai;7;9;16;9;14;23
292;31.03.2018;2018;03;18;Lauantai;13;4;17;15;2;17
292;31.03.2018;2018;03;19;Lauantai;6;9;15;6;12;18
292;31.03.2018;2018;03;20;Lauantai;0;4;4;2;5;7
292;31.03.2018;2018;03;21;Lauantai;6;3;9;8;10;18
292;31.03.2018;2018;03;22;Lauantai;6;2;8;3;2;5
292;31.03.2018;2018;03;23;Lauantai;1;1;2;2;1;3
292;01.04.2018;2018;04;00;Sunnuntai;1;2;3;8;1;9
292;01.04.2018;2018;04;01;Sunnuntai;0;1;1;2;0;2
292;01.04.2018;2018;04;02;Sunnuntai;1;0;1;0;1;1
292;01.04.2018;2018;04;03;Sunnuntai;0;1;1;0;2;2
292;01.04.2018;2018;04;04;Sunnuntai;0;0;0;0;0;0
292;01.04.2018;2018;04;05;Sunnuntai;0;0;0;1;0;1
292;01.04.2018;2018;04;06;Sunnuntai;4;0;4;1;1;2
292;01.04.2018;2018;04;07;Sunnuntai;0;2;2;7;2;9
292;01.04.2018;2018;04;08;Sunnuntai;1;0;1;3;2;5
292;01.04.2018;2018;04;09;Sunnuntai;6;6;12;4;6;10
292;01.04.2018;2018;04;10;Sunnuntai;3;8;11;5;7;12
292;01.04.2018;2018;04;11;Sunnuntai;6;9;15;13;15;28
292;01.04.2018;2018;04;12;Sunnuntai;6;18;24;21;15;36
292;01.04.2018;2018;04;13;Sunnuntai;17;12;29;19;10;29
292;01.04.2018;2018;04;14;Sunnuntai;8;14;22;21;21;42
292;01.04.2018;2018;04;15;Sunnuntai;11;13;24;22;18;40
292;01.04.2018;2018;04;16;Sunnuntai;7;4;11;13;13;26
292;01.04.2018;2018;04;17;Sunnuntai;8;13;21;17;12;29
292;01.04.2018;2018;04;18;Sunnuntai;17;7;24;18;13;31
292;01.04.2018;2018;04;19;Sunnuntai;5;9;14;13;3;16
292;01.04.2018;2018;04;20;Sunnuntai;6;5;11;6;7;13
292;01.04.2018;2018;04;21;Sunnuntai;11;5;16;4;4;8
292;01.04.2018;2018;04;22;Sunnuntai;3;9;12;2;1;3
292;01.04.2018;2018;04;23;Sunnuntai;2;1;3;0;3;3
292;02.04.2018;2018;04;00;Maanantai;1;1;2;3;1;4
292;02.04.2018;2018;04;01;Maanantai;1;0;1;0;3;3
292;02.04.2018;2018;04;02;Maanantai;0;0;0;1;2;3
292;02.04.2018;2018;04;03;Maanantai;1;1;2;0;0;0
292;02.04.2018;2018;04;04;Maanantai;1;0;1;0;1;1
292;02.04.2018;2018;04;05;Maanantai;0;1;1;4;0;4
292;02.04.2018;2018;04;06;Maanantai;2;2;4;2;1;3
292;02.04.2018;2018;04;07;Maanantai;0;1;1;3;2;5
292;02.04.2018;2018;04;08;Maanantai;2;1;3;3;2;5
292;02.04.2018;2018;04;09;Maanantai;1;3;4;5;6;11
292;02.04.2018;2018;04;10;Maanantai;3;3;6;14;11;25
292;02.04.2018;2018;04;11;Maanantai;6;12;18;19;12;31
292;02.04.2018;2018;04;12;Maanantai;5;13;18;12;9;21
292;02.04.2018;2018;04;13;Maanantai;12;6;18;13;9;22
292;02.04.2018;2018;04;14;Maanantai;9;7;16;16;15;31
292;02.04.2018;2018;04;15;Maanantai;12;7;19;8;10;18
292;02.04.2018;2018;04;16;Maanantai;7;12;19;5;7;12
292;02.04.2018;2018;04;17;Maanantai;14;9;23;11;8;19
292;02.04.2018;2018;04;18;Maanantai;11;11;22;13;12;25
292;02.04.2018;2018;04;19;Maanantai;14;3;17;6;9;15
292;02.04.2018;2018;04;20;Maanantai;7;6;13;5;4;9
292;02.04.2018;2018;04;21;Maanantai;1;3;4;4;0;4
292;02.04.2018;2018;04;22;Maanantai;1;2;3;0;1;1
292;02.04.2018;2018;04;23;Maanantai;0;0;0;0;0;0
292;03.04.2018;2018;04;00;Tiistai;0;0;0;1;0;1
292;03.04.2018;2018;04;01;Tiistai;0;0;0;0;0;0
292;03.04.2018;2018;04;02;Tiistai;0;0;0;0;0;0
292;03.04.2018;2018;04;03;Tiistai;0;0;0;0;0;0
292;03.04.2018;2018;04;04;Tiistai;0;1;1;5;0;5
292;03.04.2018;2018;04;05;Tiistai;4;5;9;0;0;0
292;03.04.2018;2018;04;06;Tiistai;17;7;24;1;5;6
292;03.04.2018;2018;04;07;Tiistai;47;23;70;8;6;14
292;03.04.2018;2018;04;08;Tiistai;32;14;46;14;10;24
292;03.04.2018;2018;04;09;Tiistai;8;7;15;10;16;26
292;03.04.2018;2018;04;10;Tiistai;14;17;31;16;11;27
292;03.04.2018;2018;04;11;Tiistai;5;23;28;10;18;28
292;03.04.2018;2018;04;12;Tiistai;8;13;21;13;5;18
292;03.04.2018;2018;04;13;Tiistai;7;24;31;23;9;32
292;03.04.2018;2018;04;14;Tiistai;21;35;56;15;11;26
292;03.04.2018;2018;04;15;Tiistai;19;28;47;7;14;21
292;03.04.2018;2018;04;16;Tiistai;17;26;43;20;12;32
292;03.04.2018;2018;04;17;Tiistai;10;22;32;18;6;24
292;03.04.2018;2018;04;18;Tiistai;9;7;16;7;3;10
292;03.04.2018;2018;04;19;Tiistai;5;9;14;10;11;21
292;03.04.2018;2018;04;20;Tiistai;13;3;16;8;7;15
292;03.04.2018;2018;04;21;Tiistai;3;5;8;4;8;12
292;03.04.2018;2018;04;22;Tiistai;1;1;2;1;0;1
292;03.04.2018;2018;04;23;Tiistai;0;0;0;0;0;0
292;04.04.2018;2018;04;00;Keskiviikko;0;0;0;0;0;0
292;04.04.2018;2018;04;01;Keskiviikko;0;0;0;0;0;0
292;04.04.2018;2018;04;02;Keskiviikko;0;0;0;0;0;0
292;04.04.2018;2018;04;03;Keskiviikko;0;0;0;0;0;0
292;04.04.2018;2018;04;04;Keskiviikko;0;0;0;0;0;0
292;04.04.2018;2018;04;05;Keskiviikko;1;7;8;2;1;3
292;04.04.2018;2018;04;06;Keskiviikko;15;11;26;6;5;11
292;04.04.2018;2018;04;07;Keskiviikko;43;20;63;24;8;32
292;04.04.2018;2018;04;08;Keskiviikko;37;18;55;14;12;26
292;04.04.2018;2018;04;09;Keskiviikko;17;19;36;12;15;27
292;04.04.2018;2018;04;10;Keskiviikko;13;30;43;19;18;37
292;04.04.2018;2018;04;11;Keskiviikko;6;25;31;21;21;42
292;04.04.2018;2018;04;12;Keskiviikko;6;19;25;26;21;47
292;04.04.2018;2018;04;13;Keskiviikko;17;20;37;17;24;41
292;04.04.2018;2018;04;14;Keskiviikko;19;38;57;11;22;33
292;04.04.2018;2018;04;15;Keskiviikko;33;24;57;22;24;46
292;04.04.2018;2018;04;16;Keskiviikko;24;24;48;18;12;30
292;04.04.2018;2018;04;17;Keskiviikko;17;23;40;25;14;39
292;04.04.2018;2018;04;18;Keskiviikko;10;10;20;18;18;36
292;04.04.2018;2018;04;19;Keskiviikko;9;15;24;16;13;29
292;04.04.2018;2018;04;20;Keskiviikko;10;5;15;14;11;25
292;04.04.2018;2018;04;21;Keskiviikko;5;5;10;6;5;11
292;04.04.2018;2018;04;22;Keskiviikko;0;2;2;1;0;1
292;04.04.2018;2018;04;23;Keskiviikko;0;0;0;0;0;0
292;05.04.2018;2018;04;00;Torstai;0;0;0;0;0;0
292;05.04.2018;2018;04;01;Torstai;0;0;0;0;0;0
292;05.04.2018;2018;04;02;Torstai;0;0;0;0;0;0
292;05.04.2018;2018;04;03;Torstai;2;0;2;5;1;6
292;05.04.2018;2018;04;04;Torstai;1;0;1;0;0;0
292;05.04.2018;2018;04;05;Torstai;5;4;9;1;0;1
292;05.04.2018;2018;04;06;Torstai;14;8;22;3;6;9
292;05.04.2018;2018;04;07;Torstai;51;17;68;14;13;27
292;05.04.2018;2018;04;08;Torstai;47;15;62;13;14;27
292;05.04.2018;2018;04;09;Torstai;11;20;31;12;11;23
292;05.04.2018;2018;04;10;Torstai;8;30;38;13;11;24
292;05.04.2018;2018;04;11;Torstai;9;17;26;7;10;17
292;05.04.2018;2018;04;12;Torstai;10;21;31;7;11;18
292;05.04.2018;2018;04;13;Torstai;11;28;39;12;12;24
292;05.04.2018;2018;04;14;Torstai;28;29;57;19;13;32
292;05.04.2018;2018;04;15;Torstai;27;26;53;14;7;21
292;05.04.2018;2018;04;16;Torstai;16;33;49;18;7;25
292;05.04.2018;2018;04;17;Torstai;10;17;27;11;10;21
292;05.04.2018;2018;04;18;Torstai;14;12;26;17;11;28
292;05.04.2018;2018;04;19;Torstai;7;6;13;4;7;11
292;05.04.2018;2018;04;20;Torstai;16;6;22;7;6;13
292;05.04.2018;2018;04;21;Torstai;8;3;11;8;3;11
292;05.04.2018;2018;04;22;Torstai;1;1;2;0;2;2
292;05.04.2018;2018;04;23;Torstai;0;1;1;0;1;1
292;06.04.2018;2018;04;00;Perjantai;0;0;0;0;0;0
292;06.04.2018;2018;04;01;Perjantai;1;1;2;0;0;0
292;06.04.2018;2018;04;02;Perjantai;0;0;0;0;0;0
292;06.04.2018;2018;04;03;Perjantai;0;0;0;0;0;0
292;06.04.2018;2018;04;04;Perjantai;0;0;0;0;0;0
292;06.04.2018;2018;04;05;Perjantai;2;4;6;2;1;3
292;06.04.2018;2018;04;06;Perjantai;8;8;16;11;4;15
292;06.04.2018;2018;04;07;Perjantai;28;11;39;16;5;21
292;06.04.2018;2018;04;08;Perjantai;31;10;41;17;16;33
292;06.04.2018;2018;04;09;Perjantai;10;6;16;6;6;12
292;06.04.2018;2018;04;10;Perjantai;12;13;25;10;5;15
292;06.04.2018;2018;04;11;Perjantai;3;17;20;3;13;16
292;06.04.2018;2018;04;12;Perjantai;5;19;24;14;15;29
292;06.04.2018;2018;04;13;Perjantai;3;17;20;11;12;23
292;06.04.2018;2018;04;14;Perjantai;10;35;45;24;20;44
292;06.04.2018;2018;04;15;Perjantai;13;15;28;17;12;29
292;06.04.2018;2018;04;16;Perjantai;14;10;24;18;14;32
292;06.04.2018;2018;04;17;Perjantai;6;12;18;10;7;17
292;06.04.2018;2018;04;18;Perjantai;7;4;11;11;13;24
292;06.04.2018;2018;04;19;Perjantai;9;9;18;7;4;11
292;06.04.2018;2018;04;20;Perjantai;9;6;15;8;9;17
292;06.04.2018;2018;04;21;Perjantai;2;4;6;6;3;9
292;06.04.2018;2018;04;22;Perjantai;2;4;6;2;1;3
292;06.04.2018;2018;04;23;Perjantai;5;0;5;3;0;3
292;07.04.2018;2018;04;00;Lauantai;2;3;5;5;1;6
292;07.04.2018;2018;04;01;Lauantai;0;0;0;0;0;0
292;07.04.2018;2018;04;02;Lauantai;0;1;1;0;2;2
292;07.04.2018;2018;04;03;Lauantai;1;0;1;0;1;1
292;07.04.2018;2018;04;04;Lauantai;0;0;0;0;2;2
292;07.04.2018;2018;04;05;Lauantai;0;0;0;0;2;2
292;07.04.2018;2018;04;06;Lauantai;0;2;2;2;2;4
292;07.04.2018;2018;04;07;Lauantai;0;2;2;4;2;6
292;07.04.2018;2018;04;08;Lauantai;1;4;5;7;2;9
292;07.04.2018;2018;04;09;Lauantai;0;4;4;10;9;19
292;07.04.2018;2018;04;10;Lauantai;5;7;12;20;20;40
292;07.04.2018;2018;04;11;Lauantai;8;10;18;16;13;29
292;07.04.2018;2018;04;12;Lauantai;8;8;16;6;13;19
292;07.04.2018;2018;04;13;Lauantai;10;14;24;20;14;34
292;07.04.2018;2018;04;14;Lauantai;9;9;18;17;13;30
292;07.04.2018;2018;04;15;Lauantai;8;4;12;20;12;32
292;07.04.2018;2018;04;16;Lauantai;10;9;19;17;10;27
292;07.04.2018;2018;04;17;Lauantai;5;5;10;15;16;31
292;07.04.2018;2018;04;18;Lauantai;12;4;16;20;8;28
292;07.04.2018;2018;04;19;Lauantai;0;5;5;7;9;16
292;07.04.2018;2018;04;20;Lauantai;0;7;7;8;2;10
292;07.04.2018;2018;04;21;Lauantai;3;0;3;9;12;21
292;07.04.2018;2018;04;22;Lauantai;6;1;7;5;2;7
292;07.04.2018;2018;04;23;Lauantai;0;2;2;2;2;4
292;08.04.2018;2018;04;00;Sunnuntai;1;1;2;0;0;0
292;08.04.2018;2018;04;01;Sunnuntai;0;0;0;3;2;5
292;08.04.2018;2018;04;02;Sunnuntai;0;0;0;0;1;1
292;08.04.2018;2018;04;03;Sunnuntai;1;0;1;0;1;1
292;08.04.2018;2018;04;04;Sunnuntai;0;0;0;0;1;1
292;08.04.2018;2018;04;05;Sunnuntai;0;0;0;1;1;2
292;08.04.2018;2018;04;06;Sunnuntai;0;1;1;3;3;6
292;08.04.2018;2018;04;07;Sunnuntai;0;0;0;3;4;7
292;08.04.2018;2018;04;08;Sunnuntai;1;1;2;5;3;8
292;08.04.2018;2018;04;09;Sunnuntai;1;0;1;9;11;20
292;08.04.2018;2018;04;10;Sunnuntai;3;8;11;17;11;28
292;08.04.2018;2018;04;11;Sunnuntai;4;3;7;16;17;33
292;08.04.2018;2018;04;12;Sunnuntai;6;5;11;17;13;30
292;08.04.2018;2018;04;13;Sunnuntai;8;11;19;31;21;52
292;08.04.2018;2018;04;14;Sunnuntai;10;3;13;35;28;63
292;08.04.2018;2018;04;15;Sunnuntai;7;8;15;39;26;65
292;08.04.2018;2018;04;16;Sunnuntai;9;7;16;27;27;54
292;08.04.2018;2018;04;17;Sunnuntai;10;7;17;19;22;41
292;08.04.2018;2018;04;18;Sunnuntai;7;4;11;24;22;46
292;08.04.2018;2018;04;19;Sunnuntai;4;1;5;12;12;24
292;08.04.2018;2018;04;20;Sunnuntai;2;5;7;14;16;30
292;08.04.2018;2018;04;21;Sunnuntai;1;3;4;7;11;18
292;08.04.2018;2018;04;22;Sunnuntai;0;0;0;0;3;3
292;08.04.2018;2018;04;23;Sunnuntai;2;0;2;1;1;2
292;09.04.2018;2018;04;00;Maanantai;0;0;0;0;1;1
292;09.04.2018;2018;04;01;Maanantai;0;0;0;0;0;0
292;09.04.2018;2018;04;02;Maanantai;0;0;0;1;0;1
292;09.04.2018;2018;04;03;Maanantai;0;0;0;0;0;0
292;09.04.2018;2018;04;04;Maanantai;0;0;0;0;0;0
292;09.04.2018;2018;04;05;Maanantai;0;1;1;3;2;5
292;09.04.2018;2018;04;06;Maanantai;6;5;11;12;8;20
292;09.04.2018;2018;04;07;Maanantai;23;9;32;48;13;61
292;09.04.2018;2018;04;08;Maanantai;30;9;39;25;11;36
292;09.04.2018;2018;04;09;Maanantai;9;8;17;11;15;26
292;09.04.2018;2018;04;10;Maanantai;8;11;19;4;7;11
292;09.04.2018;2018;04;11;Maanantai;9;13;22;6;15;21
292;09.04.2018;2018;04;12;Maanantai;12;15;27;15;14;29
292;09.04.2018;2018;04;13;Maanantai;10;18;28;32;14;46
292;09.04.2018;2018;04;14;Maanantai;8;29;37;18;22;40
292;09.04.2018;2018;04;15;Maanantai;21;22;43;26;27;53
292;09.04.2018;2018;04;16;Maanantai;16;21;37;22;26;48
292;09.04.2018;2018;04;17;Maanantai;10;14;24;19;18;37
292;09.04.2018;2018;04;18;Maanantai;4;7;11;20;23;43
292;09.04.2018;2018;04;19;Maanantai;9;6;15;13;23;36
292;09.04.2018;2018;04;20;Maanantai;3;4;7;18;9;27
292;09.04.2018;2018;04;21;Maanantai;4;3;7;9;8;17
292;09.04.2018;2018;04;22;Maanantai;0;1;1;0;1;1
292;09.04.2018;2018;04;23;Maanantai;0;0;0;0;0;0
292;10.04.2018;2018;04;00;Tiistai;0;0;0;0;0;0
292;10.04.2018;2018;04;01;Tiistai;0;0;0;0;0;0
292;10.04.2018;2018;04;02;Tiistai;0;0;0;0;0;0
292;10.04.2018;2018;04;03;Tiistai;0;0;0;0;0;0
292;10.04.2018;2018;04;04;Tiistai;0;1;1;0;0;0
292;10.04.2018;2018;04;05;Tiistai;0;3;3;2;2;4
292;10.04.2018;2018;04;06;Tiistai;8;10;18;14;9;23
292;10.04.2018;2018;04;07;Tiistai;31;15;46;33;13;46
292;10.04.2018;2018;04;08;Tiistai;23;9;32;30;23;53
292;10.04.2018;2018;04;09;Tiistai;9;8;17;10;16;26
292;10.04.2018;2018;04;10;Tiistai;9;7;16;15;8;23
292;10.04.2018;2018;04;11;Tiistai;8;11;19;20;17;37
292;10.04.2018;2018;04;12;Tiistai;11;9;20;17;21;38
292;10.04.2018;2018;04;13;Tiistai;12;29;41;19;22;41
292;10.04.2018;2018;04;14;Tiistai;13;43;56;40;46;86
292;10.04.2018;2018;04;15;Tiistai;25;27;52;16;19;35
292;10.04.2018;2018;04;16;Tiistai;18;35;53;27;30;57
292;10.04.2018;2018;04;17;Tiistai;15;16;31;27;16;43
292;10.04.2018;2018;04;18;Tiistai;12;15;27;21;21;42
292;10.04.2018;2018;04;19;Tiistai;16;17;33;14;25;39
292;10.04.2018;2018;04;20;Tiistai;8;4;12;15;13;28
292;10.04.2018;2018;04;21;Tiistai;3;2;5;3;6;9
292;10.04.2018;2018;04;22;Tiistai;0;2;2;0;0;0
292;10.04.2018;2018;04;23;Tiistai;0;0;0;0;1;1
292;11.04.2018;2018;04;00;Keskiviikko;0;0;0;0;0;0
292;11.04.2018;2018;04;01;Keskiviikko;0;1;1;1;0;1
292;11.04.2018;2018;04;02;Keskiviikko;0;0;0;0;0;0
292;11.04.2018;2018;04;03;Keskiviikko;1;0;1;0;0;0
292;11.04.2018;2018;04;04;Keskiviikko;0;0;0;1;0;1
292;11.04.2018;2018;04;05;Keskiviikko;2;2;4;3;6;9
292;11.04.2018;2018;04;06;Keskiviikko;8;3;11;8;12;20
292;11.04.2018;2018;04;07;Keskiviikko;40;13;53;22;20;42
292;11.04.2018;2018;04;08;Keskiviikko;49;8;57;26;22;48
292;11.04.2018;2018;04;09;Keskiviikko;19;5;24;12;20;32
292;11.04.2018;2018;04;10;Keskiviikko;20;8;28;18;20;38
292;11.04.2018;2018;04;11;Keskiviikko;3;13;16;14;16;30
292;11.04.2018;2018;04;12;Keskiviikko;17;7;24;25;22;47
292;11.04.2018;2018;04;13;Keskiviikko;12;40;52;26;27;53
292;11.04.2018;2018;04;14;Keskiviikko;17;55;72;29;26;55
292;11.04.2018;2018;04;15;Keskiviikko;28;24;52;21;18;39
292;11.04.2018;2018;04;16;Keskiviikko;24;49;73;19;29;48
292;11.04.2018;2018;04;17;Keskiviikko;23;24;47;16;16;32
292;11.04.2018;2018;04;18;Keskiviikko;18;15;33;11;9;20
292;11.04.2018;2018;04;19;Keskiviikko;19;9;28;10;12;22
292;11.04.2018;2018;04;20;Keskiviikko;16;7;23;12;5;17
292;11.04.2018;2018;04;21;Keskiviikko;7;8;15;4;4;8
292;11.04.2018;2018;04;22;Keskiviikko;1;3;4;2;2;4
292;11.04.2018;2018;04;23;Keskiviikko;0;0;0;0;0;0
292;12.04.2018;2018;04;00;Torstai;0;0;0;0;0;0
292;12.04.2018;2018;04;01;Torstai;0;0;0;0;0;0
292;12.04.2018;2018;04;02;Torstai;0;0;0;0;0;0
292;12.04.2018;2018;04;03;Torstai;0;0;0;0;0;0
292;12.04.2018;2018;04;04;Torstai;1;0;1;0;0;0
292;12.04.2018;2018;04;05;Torstai;3;5;8;3;0;3
292;12.04.2018;2018;04;06;Torstai;14;8;22;2;5;7
292;12.04.2018;2018;04;07;Torstai;52;28;80;20;17;37
292;12.04.2018;2018;04;08;Torstai;32;19;51;10;11;21
292;12.04.2018;2018;04;09;Torstai;53;12;65;11;14;25
292;12.04.2018;2018;04;10;Torstai;12;15;27;21;10;31
292;12.04.2018;2018;04;11;Torstai;11;17;28;9;19;28
292;12.04.2018;2018;04;12;Torstai;10;16;26;17;9;26
292;12.04.2018;2018;04;13;Torstai;18;39;57;16;15;31
292;12.04.2018;2018;04;14;Torstai;20;45;65;28;17;45
292;12.04.2018;2018;04;15;Torstai;20;36;56;27;27;54
292;12.04.2018;2018;04;16;Torstai;13;60;73;32;13;45
292;12.04.2018;2018;04;17;Torstai;11;19;30;33;20;53
292;12.04.2018;2018;04;18;Torstai;8;22;30;39;13;52
292;12.04.2018;2018;04;19;Torstai;4;12;16;16;12;28
292;12.04.2018;2018;04;20;Torstai;4;8;12;25;14;39
292;12.04.2018;2018;04;21;Torstai;6;6;12;14;4;18
292;12.04.2018;2018;04;22;Torstai;2;3;5;3;0;3
292;12.04.2018;2018;04;23;Torstai;0;0;0;0;0;0
292;13.04.2018;2018;04;00;Perjantai;0;0;0;1;1;2
292;13.04.2018;2018;04;01;Perjantai;0;0;0;0;0;0
292;13.04.2018;2018;04;02;Perjantai;0;0;0;0;0;0
292;13.04.2018;2018;04;03;Perjantai;0;0;0;0;0;0
292;13.04.2018;2018;04;04;Perjantai;0;1;1;0;0;0
292;13.04.2018;2018;04;05;Perjantai;1;5;6;3;0;3
292;13.04.2018;2018;04;06;Perjantai;7;10;17;6;5;11
292;13.04.2018;2018;04;07;Perjantai;20;23;43;47;5;52
292;13.04.2018;2018;04;08;Perjantai;20;23;43;45;14;59
292;13.04.2018;2018;04;09;Perjantai;10;15;25;29;15;44
292;13.04.2018;2018;04;10;Perjantai;7;13;20;24;12;36
292;13.04.2018;2018;04;11;Perjantai;3;12;15;17;15;32
292;13.04.2018;2018;04;12;Perjantai;8;18;26;36;14;50
292;13.04.2018;2018;04;13;Perjantai;15;58;73;28;13;41
292;13.04.2018;2018;04;14;Perjantai;9;54;63;30;18;48
292;13.04.2018;2018;04;15;Perjantai;15;30;45;41;19;60
292;13.04.2018;2018;04;16;Perjantai;7;33;40;37;12;49
292;13.04.2018;2018;04;17;Perjantai;8;17;25;28;32;60
292;13.04.2018;2018;04;18;Perjantai;9;21;30;36;27;63
292;13.04.2018;2018;04;19;Perjantai;20;21;41;34;14;48
292;13.04.2018;2018;04;20;Perjantai;12;11;23;20;10;30
292;13.04.2018;2018;04;21;Perjantai;5;6;11;13;8;21
292;13.04.2018;2018;04;22;Perjantai;2;7;9;9;9;18
292;13.04.2018;2018;04;23;Perjantai;4;3;7;8;0;8
292;14.04.2018;2018;04;00;Lauantai;0;2;2;3;1;4
292;14.04.2018;2018;04;01;Lauantai;2;0;2;2;1;3
292;14.04.2018;2018;04;02;Lauantai;0;1;1;1;4;5
292;14.04.2018;2018;04;03;Lauantai;0;0;0;0;2;2
292;14.04.2018;2018;04;04;Lauantai;0;0;0;0;2;2
292;14.04.2018;2018;04;05;Lauantai;0;4;4;2;2;4
292;14.04.2018;2018;04;06;Lauantai;0;1;1;3;2;5
292;14.04.2018;2018;04;07;Lauantai;0;4;4;7;5;12
292;14.04.2018;2018;04;08;Lauantai;2;5;7;16;6;22
292;14.04.2018;2018;04;09;Lauantai;1;6;7;9;5;14
292;14.04.2018;2018;04;10;Lauantai;9;14;23;17;19;36
292;14.04.2018;2018;04;11;Lauantai;7;23;30;29;24;53
292;14.04.2018;2018;04;12;Lauantai;10;23;33;34;23;57
292;14.04.2018;2018;04;13;Lauantai;18;30;48;35;15;50
292;14.04.2018;2018;04;14;Lauantai;15;21;36;30;11;41
292;14.04.2018;2018;04;15;Lauantai;24;28;52;20;12;32
292;14.04.2018;2018;04;16;Lauantai;14;27;41;28;17;45
292;14.04.2018;2018;04;17;Lauantai;19;20;39;24;15;39
292;14.04.2018;2018;04;18;Lauantai;17;20;37;25;6;31
292;14.04.2018;2018;04;19;Lauantai;9;14;23;17;9;26
292;14.04.2018;2018;04;20;Lauantai;10;12;22;16;11;27
292;14.04.2018;2018;04;21;Lauantai;2;13;15;10;12;22
292;14.04.2018;2018;04;22;Lauantai;3;5;8;14;3;17
292;14.04.2018;2018;04;23;Lauantai;1;2;3;4;2;6
292;15.04.2018;2018;04;00;Sunnuntai;3;0;3;2;0;2
292;15.04.2018;2018;04;01;Sunnuntai;1;1;2;6;0;6
292;15.04.2018;2018;04;02;Sunnuntai;0;1;1;0;2;2
292;15.04.2018;2018;04;03;Sunnuntai;0;0;0;0;4;4
292;15.04.2018;2018;04;04;Sunnuntai;0;0;0;0;2;2
292;15.04.2018;2018;04;05;Sunnuntai;1;1;2;1;0;1
292;15.04.2018;2018;04;06;Sunnuntai;2;3;5;1;0;1
292;15.04.2018;2018;04;07;Sunnuntai;1;4;5;3;1;4
292;15.04.2018;2018;04;08;Sunnuntai;2;4;6;11;7;18
292;15.04.2018;2018;04;09;Sunnuntai;5;5;10;14;13;27
292;15.04.2018;2018;04;10;Sunnuntai;9;21;30;33;14;47
292;15.04.2018;2018;04;11;Sunnuntai;17;29;46;31;22;53
292;15.04.2018;2018;04;12;Sunnuntai;13;35;48;40;19;59
292;15.04.2018;2018;04;13;Sunnuntai;22;30;52;40;30;70
292;15.04.2018;2018;04;14;Sunnuntai;17;40;57;42;19;61
292;15.04.2018;2018;04;15;Sunnuntai;25;42;67;31;22;53
292;15.04.2018;2018;04;16;Sunnuntai;24;30;54;41;16;57
292;15.04.2018;2018;04;17;Sunnuntai;10;40;50;42;31;73
292;15.04.2018;2018;04;18;Sunnuntai;8;20;28;34;23;57
292;15.04.2018;2018;04;19;Sunnuntai;11;24;35;27;14;41
292;15.04.2018;2018;04;20;Sunnuntai;15;24;39;19;20;39
292;15.04.2018;2018;04;21;Sunnuntai;3;6;9;14;4;18
292;15.04.2018;2018;04;22;Sunnuntai;0;2;2;3;0;3
292;15.04.2018;2018;04;23;Sunnuntai;0;0;0;2;1;3
292;16.04.2018;2018;04;00;Maanantai;0;0;0;0;0;0
292;16.04.2018;2018;04;01;Maanantai;0;1;1;0;2;2
292;16.04.2018;2018;04;02;Maanantai;0;0;0;0;0;0
292;16.04.2018;2018;04;03;Maanantai;0;0;0;0;0;0
292;16.04.2018;2018;04;04;Maanantai;0;1;1;1;0;1
292;16.04.2018;2018;04;05;Maanantai;0;8;8;7;1;8
292;16.04.2018;2018;04;06;Maanantai;11;8;19;16;6;22
292;16.04.2018;2018;04;07;Maanantai;23;28;51;34;12;46
292;16.04.2018;2018;04;08;Maanantai;25;22;47;18;12;30
292;16.04.2018;2018;04;09;Maanantai;36;21;57;23;9;32
292;16.04.2018;2018;04;10;Maanantai;10;16;26;20;16;36
292;16.04.2018;2018;04;11;Maanantai;10;23;33;34;22;56
292;16.04.2018;2018;04;12;Maanantai;12;23;35;32;17;49
292;16.04.2018;2018;04;13;Maanantai;17;47;64;44;18;62
292;16.04.2018;2018;04;14;Maanantai;22;59;81;24;22;46
292;16.04.2018;2018;04;15;Maanantai;29;64;93;37;15;52
292;16.04.2018;2018;04;16;Maanantai;20;64;84;38;18;56
292;16.04.2018;2018;04;17;Maanantai;30;44;74;36;24;60
292;16.04.2018;2018;04;18;Maanantai;18;28;46;27;24;51
292;16.04.2018;2018;04;19;Maanantai;18;16;34;30;16;46
292;16.04.2018;2018;04;20;Maanantai;15;18;33;29;20;49
292;16.04.2018;2018;04;21;Maanantai;2;7;9;6;14;20
292;16.04.2018;2018;04;22;Maanantai;2;1;3;2;1;3
292;16.04.2018;2018;04;23;Maanantai;0;0;0;0;0;0
292;17.04.2018;2018;04;00;Tiistai;0;0;0;0;2;2
292;17.04.2018;2018;04;01;Tiistai;0;0;0;1;0;1
292;17.04.2018;2018;04;02;Tiistai;0;1;1;0;0;0
292;17.04.2018;2018;04;03;Tiistai;0;0;0;0;0;0
292;17.04.2018;2018;04;04;Tiistai;0;0;0;0;0;0
292;17.04.2018;2018;04;05;Tiistai;1;4;5;4;0;4
292;17.04.2018;2018;04;06;Tiistai;14;17;31;14;4;18
292;17.04.2018;2018;04;07;Tiistai;56;36;92;22;9;31
292;17.04.2018;2018;04;08;Tiistai;42;25;67;24;11;35
292;17.04.2018;2018;04;09;Tiistai;17;31;48;20;13;33
292;17.04.2018;2018;04;10;Tiistai;17;25;42;14;15;29
292;17.04.2018;2018;04;11;Tiistai;22;21;43;33;21;54
292;17.04.2018;2018;04;12;Tiistai;17;34;51;17;9;26
292;17.04.2018;2018;04;13;Tiistai;14;40;54;30;18;48
292;17.04.2018;2018;04;14;Tiistai;27;74;101;40;41;81
292;17.04.2018;2018;04;15;Tiistai;35;66;101;40;22;62
292;17.04.2018;2018;04;16;Tiistai;21;61;82;40;24;64
292;17.04.2018;2018;04;17;Tiistai;30;33;63;57;30;87
292;17.04.2018;2018;04;18;Tiistai;19;40;59;46;39;85
292;17.04.2018;2018;04;19;Tiistai;14;23;37;23;30;53
292;17.04.2018;2018;04;20;Tiistai;13;12;25;20;12;32
292;17.04.2018;2018;04;21;Tiistai;5;7;12;7;3;10
292;17.04.2018;2018;04;22;Tiistai;1;3;4;3;0;3
292;17.04.2018;2018;04;23;Tiistai;0;0;0;1;2;3
292;18.04.2018;2018;04;00;Keskiviikko;0;1;1;0;0;0
292;18.04.2018;2018;04;01;Keskiviikko;0;1;1;1;1;2
292;18.04.2018;2018;04;02;Keskiviikko;0;0;0;1;1;2
292;18.04.2018;2018;04;03;Keskiviikko;0;0;0;0;0;0
292;18.04.2018;2018;04;04;Keskiviikko;0;1;1;0;0;0
292;18.04.2018;2018;04;05;Keskiviikko;2;10;12;4;0;4
292;18.04.2018;2018;04;06;Keskiviikko;16;15;31;9;3;12
292;18.04.2018;2018;04;07;Keskiviikko;28;40;68;16;8;24
292;18.04.2018;2018;04;08;Keskiviikko;44;29;73;25;14;39
292;18.04.2018;2018;04;09;Keskiviikko;26;21;47;18;14;32
292;18.04.2018;2018;04;10;Keskiviikko;17;24;41;30;15;45
292;18.04.2018;2018;04;11;Keskiviikko;21;37;58;21;16;37
292;18.04.2018;2018;04;12;Keskiviikko;21;31;52;28;11;39
292;18.04.2018;2018;04;13;Keskiviikko;23;60;83;48;22;70
292;18.04.2018;2018;04;14;Keskiviikko;20;57;77;30;16;46
292;18.04.2018;2018;04;15;Keskiviikko;43;67;110;49;28;77
292;18.04.2018;2018;04;16;Keskiviikko;24;60;84;40;18;58
292;18.04.2018;2018;04;17;Keskiviikko;31;50;81;30;14;44
292;18.04.2018;2018;04;18;Keskiviikko;32;56;88;30;25;55
292;18.04.2018;2018;04;19;Keskiviikko;26;30;56;37;24;61
292;18.04.2018;2018;04;20;Keskiviikko;26;20;46;20;7;27
292;18.04.2018;2018;04;21;Keskiviikko;4;10;14;12;3;15
292;18.04.2018;2018;04;22;Keskiviikko;1;6;7;4;2;6
292;18.04.2018;2018;04;23;Keskiviikko;0;0;0;0;1;1
292;19.04.2018;2018;04;00;Torstai;0;1;1;0;0;0
292;19.04.2018;2018;04;01;Torstai;0;1;1;0;0;0
292;19.04.2018;2018;04;02;Torstai;0;0;0;0;0;0
292;19.04.2018;2018;04;03;Torstai;0;0;0;0;0;0
292;19.04.2018;2018;04;04;Torstai;0;0;0;1;0;1
292;19.04.2018;2018;04;05;Torstai;0;7;7;6;1;7
292;19.04.2018;2018;04;06;Torstai;10;14;24;13;9;22
292;19.04.2018;2018;04;07;Torstai;31;30;61;30;11;41
292;19.04.2018;2018;04;08;Torstai;27;33;60;24;8;32
292;19.04.2018;2018;04;09;Torstai;31;34;65;32;9;41
292;19.04.2018;2018;04;10;Torstai;27;23;50;25;13;38
292;19.04.2018;2018;04;11;Torstai;31;26;57;20;34;54
292;19.04.2018;2018;04;12;Torstai;24;28;52;16;38;54
292;19.04.2018;2018;04;13;Torstai;25;35;60;17;24;41
292;19.04.2018;2018;04;14;Torstai;49;39;88;33;27;60
292;19.04.2018;2018;04;15;Torstai;14;73;87;32;31;63
292;19.04.2018;2018;04;16;Torstai;33;49;82;37;20;57
292;19.04.2018;2018;04;17;Torstai;25;49;74;25;31;56
292;19.04.2018;2018;04;18;Torstai;30;30;60;32;16;48
292;19.04.2018;2018;04;19;Torstai;18;24;42;21;19;40
292;19.04.2018;2018;04;20;Torstai;18;15;33;15;12;27
292;19.04.2018;2018;04;21;Torstai;6;11;17;8;7;15
292;19.04.2018;2018;04;22;Torstai;1;2;3;4;0;4
292;19.04.2018;2018;04;23;Torstai;1;1;2;2;3;5
292;20.04.2018;2018;04;00;Perjantai;0;0;0;0;0;0
292;20.04.2018;2018;04;01;Perjantai;0;0;0;1;0;1
292;20.04.2018;2018;04;02;Perjantai;0;0;0;1;0;1
292;20.04.2018;2018;04;03;Perjantai;0;0;0;0;0;0
292;20.04.2018;2018;04;04;Perjantai;0;0;0;0;0;0
292;20.04.2018;2018;04;05;Perjantai;5;5;10;3;2;5
292;20.04.2018;2018;04;06;Perjantai;11;7;18;2;2;4
292;20.04.2018;2018;04;07;Perjantai;30;15;45;6;10;16
292;20.04.2018;2018;04;08;Perjantai;38;27;65;11;10;21
292;20.04.2018;2018;04;09;Perjantai;24;9;33;7;5;12
292;20.04.2018;2018;04;10;Perjantai;12;10;22;6;9;15
292;20.04.2018;2018;04;11;Perjantai;10;12;22;8;8;16
292;20.04.2018;2018;04;12;Perjantai;22;31;53;11;21;32
292;20.04.2018;2018;04;13;Perjantai;22;43;65;11;18;29
292;20.04.2018;2018;04;14;Perjantai;37;33;70;19;20;39
292;20.04.2018;2018;04;15;Perjantai;21;20;41;16;18;34
292;20.04.2018;2018;04;16;Perjantai;19;22;41;23;12;35
292;20.04.2018;2018;04;17;Perjantai;23;34;57;21;12;33
292;20.04.2018;2018;04;18;Perjantai;11;19;30;15;16;31
292;20.04.2018;2018;04;19;Perjantai;20;17;37;25;13;38
292;20.04.2018;2018;04;20;Perjantai;20;5;25;9;8;17
292;20.04.2018;2018;04;21;Perjantai;5;8;13;6;1;7
292;20.04.2018;2018;04;22;Perjantai;7;6;13;7;4;11
292;20.04.2018;2018;04;23;Perjantai;1;3;4;5;1;6
292;21.04.2018;2018;04;00;Lauantai;1;2;3;8;3;11
292;21.04.2018;2018;04;01;Lauantai;0;4;4;0;1;1
292;21.04.2018;2018;04;02;Lauantai;2;1;3;1;0;1
292;21.04.2018;2018;04;03;Lauantai;0;3;3;1;3;4
292;21.04.2018;2018;04;04;Lauantai;0;1;1;0;0;0
292;21.04.2018;2018;04;05;Lauantai;0;1;1;2;1;3
292;21.04.2018;2018;04;06;Lauantai;1;3;4;5;3;8
292;21.04.2018;2018;04;07;Lauantai;2;5;7;4;2;6
292;21.04.2018;2018;04;08;Lauantai;7;8;15;8;9;17
292;21.04.2018;2018;04;09;Lauantai;12;19;31;10;10;20
292;21.04.2018;2018;04;10;Lauantai;11;22;33;20;13;33
292;21.04.2018;2018;04;11;Lauantai;18;29;47;14;25;39
292;21.04.2018;2018;04;12;Lauantai;29;15;44;17;24;41
292;21.04.2018;2018;04;13;Lauantai;23;24;47;19;15;34
292;21.04.2018;2018;04;14;Lauantai;29;20;49;22;23;45
292;21.04.2018;2018;04;15;Lauantai;27;20;47;20;14;34
292;21.04.2018;2018;04;16;Lauantai;29;22;51;27;15;42
292;21.04.2018;2018;04;17;Lauantai;24;23;47;26;22;48
292;21.04.2018;2018;04;18;Lauantai;31;15;46;27;13;40
292;21.04.2018;2018;04;19;Lauantai;11;16;27;13;11;24
292;21.04.2018;2018;04;20;Lauantai;6;19;25;13;13;26
292;21.04.2018;2018;04;21;Lauantai;7;11;18;12;9;21
292;21.04.2018;2018;04;22;Lauantai;6;8;14;5;6;11
292;21.04.2018;2018;04;23;Lauantai;3;5;8;7;3;10
292;22.04.2018;2018;04;00;Sunnuntai;6;6;12;2;8;10
292;22.04.2018;2018;04;01;Sunnuntai;0;0;0;8;0;8
292;22.04.2018;2018;04;02;Sunnuntai;1;0;1;2;3;5
292;22.04.2018;2018;04;03;Sunnuntai;1;2;3;0;4;4
292;22.04.2018;2018;04;04;Sunnuntai;0;2;2;2;1;3
292;22.04.2018;2018;04;05;Sunnuntai;1;1;2;2;3;5
292;22.04.2018;2018;04;06;Sunnuntai;6;3;9;6;3;9
292;22.04.2018;2018;04;07;Sunnuntai;3;1;4;3;2;5
292;22.04.2018;2018;04;08;Sunnuntai;12;6;18;8;3;11
292;22.04.2018;2018;04;09;Sunnuntai;12;8;20;8;7;15
292;22.04.2018;2018;04;10;Sunnuntai;19;17;36;18;40;58
292;22.04.2018;2018;04;11;Sunnuntai;26;28;54;25;25;50
292;22.04.2018;2018;04;12;Sunnuntai;32;48;80;25;38;63
292;22.04.2018;2018;04;13;Sunnuntai;50;38;88;25;41;66
292;22.04.2018;2018;04;14;Sunnuntai;32;31;63;34;24;58
292;22.04.2018;2018;04;15;Sunnuntai;35;27;62;54;22;76
292;22.04.2018;2018;04;16;Sunnuntai;26;38;64;26;19;45
292;22.04.2018;2018;04;17;Sunnuntai;26;42;68;32;26;58
292;22.04.2018;2018;04;18;Sunnuntai;25;27;52;33;31;64
292;22.04.2018;2018;04;19;Sunnuntai;5;15;20;13;15;28
292;22.04.2018;2018;04;20;Sunnuntai;8;5;13;19;11;30
292;22.04.2018;2018;04;21;Sunnuntai;4;5;9;8;4;12
292;22.04.2018;2018;04;22;Sunnuntai;1;3;4;1;0;1
292;22.04.2018;2018;04;23;Sunnuntai;1;1;2;2;0;2
292;23.04.2018;2018;04;00;Maanantai;0;1;1;0;0;0
292;23.04.2018;2018;04;01;Maanantai;0;1;1;0;0;0
292;23.04.2018;2018;04;02;Maanantai;0;0;0;0;0;0
292;23.04.2018;2018;04;03;Maanantai;0;0;0;0;0;0
292;23.04.2018;2018;04;04;Maanantai;0;0;0;0;0;0
292;23.04.2018;2018;04;05;Maanantai;4;4;8;7;0;7
292;23.04.2018;2018;04;06;Maanantai;17;14;31;8;6;14
292;23.04.2018;2018;04;07;Maanantai;49;21;70;19;13;32
292;23.04.2018;2018;04;08;Maanantai;39;18;57;13;13;26
292;23.04.2018;2018;04;09;Maanantai;45;20;65;17;13;30
292;23.04.2018;2018;04;10;Maanantai;20;14;34;13;13;26
292;23.04.2018;2018;04;11;Maanantai;23;24;47;18;25;43
292;23.04.2018;2018;04;12;Maanantai;28;17;45;18;18;36
292;23.04.2018;2018;04;13;Maanantai;20;49;69;23;36;59
292;23.04.2018;2018;04;14;Maanantai;43;40;83;38;33;71
292;23.04.2018;2018;04;15;Maanantai;38;59;97;28;40;68
292;23.04.2018;2018;04;16;Maanantai;26;49;75;35;39;74
292;23.04.2018;2018;04;17;Maanantai;38;43;81;41;25;66
292;23.04.2018;2018;04;18;Maanantai;31;28;59;41;43;84
292;23.04.2018;2018;04;19;Maanantai;35;21;56;23;27;50
292;23.04.2018;2018;04;20;Maanantai;17;17;34;16;13;29
292;23.04.2018;2018;04;21;Maanantai;7;11;18;5;7;12
292;23.04.2018;2018;04;22;Maanantai;3;2;5;6;0;6
292;23.04.2018;2018;04;23;Maanantai;0;1;1;1;0;1
292;24.04.2018;2018;04;00;Tiistai;0;0;0;0;0;0
292;24.04.2018;2018;04;01;Tiistai;1;0;1;0;0;0
292;24.04.2018;2018;04;02;Tiistai;0;1;1;1;0;1
292;24.04.2018;2018;04;03;Tiistai;0;0;0;0;0;0
292;24.04.2018;2018;04;04;Tiistai;0;0;0;1;0;1
292;24.04.2018;2018;04;05;Tiistai;4;5;9;7;1;8
292;24.04.2018;2018;04;06;Tiistai;19;22;41;13;6;19
292;24.04.2018;2018;04;07;Tiistai;62;28;90;9;18;27
292;24.04.2018;2018;04;08;Tiistai;46;22;68;16;14;30
292;24.04.2018;2018;04;09;Tiistai;25;16;41;8;18;26
292;24.04.2018;2018;04;10;Tiistai;26;11;37;12;16;28
292;24.04.2018;2018;04;11;Tiistai;13;19;32;7;13;20
292;24.04.2018;2018;04;12;Tiistai;11;9;20;13;12;25
292;24.04.2018;2018;04;13;Tiistai;16;37;53;18;13;31
292;24.04.2018;2018;04;14;Tiistai;12;49;61;27;35;62
292;24.04.2018;2018;04;15;Tiistai;22;40;62;34;29;63
292;24.04.2018;2018;04;16;Tiistai;36;29;65;28;36;64
292;24.04.2018;2018;04;17;Tiistai;25;25;50;18;17;35
292;24.04.2018;2018;04;18;Tiistai;15;20;35;10;16;26
292;24.04.2018;2018;04;19;Tiistai;15;7;22;10;16;26
292;24.04.2018;2018;04;20;Tiistai;9;6;15;8;9;17
292;24.04.2018;2018;04;21;Tiistai;4;6;10;7;5;12
292;24.04.2018;2018;04;22;Tiistai;4;0;4;3;2;5
292;24.04.2018;2018;04;23;Tiistai;0;0;0;0;0;0
292;25.04.2018;2018;04;00;Keskiviikko;2;1;3;1;0;1
292;25.04.2018;2018;04;01;Keskiviikko;0;1;1;0;0;0
292;25.04.2018;2018;04;02;Keskiviikko;0;0;0;0;0;0
292;25.04.2018;2018;04;03;Keskiviikko;0;0;0;0;0;0
292;25.04.2018;2018;04;04;Keskiviikko;2;0;2;3;0;3
292;25.04.2018;2018;04;05;Keskiviikko;4;3;7;3;3;6
292;25.04.2018;2018;04;06;Keskiviikko;21;13;34;2;4;6
292;25.04.2018;2018;04;07;Keskiviikko;54;25;79;12;11;23
292;25.04.2018;2018;04;08;Keskiviikko;48;24;72;17;21;38
292;25.04.2018;2018;04;09;Keskiviikko;33;14;47;20;14;34
292;25.04.2018;2018;04;10;Keskiviikko;18;18;36;22;18;40
292;25.04.2018;2018;04;11;Keskiviikko;30;17;47;11;17;28
292;25.04.2018;2018;04;12;Keskiviikko;21;24;45;17;30;47
292;25.04.2018;2018;04;13;Keskiviikko;24;32;56;24;21;45
292;25.04.2018;2018;04;14;Keskiviikko;31;75;106;26;42;68
292;25.04.2018;2018;04;15;Keskiviikko;55;45;100;24;30;54
292;25.04.2018;2018;04;16;Keskiviikko;33;40;73;24;36;60
292;25.04.2018;2018;04;17;Keskiviikko;29;38;67;20;52;72
292;25.04.2018;2018;04;18;Keskiviikko;26;21;47;19;16;35
292;25.04.2018;2018;04;19;Keskiviikko;21;10;31;9;4;13
292;25.04.2018;2018;04;20;Keskiviikko;13;8;21;8;13;21
292;25.04.2018;2018;04;21;Keskiviikko;14;9;23;3;4;7
292;25.04.2018;2018;04;22;Keskiviikko;3;3;6;1;1;2
292;25.04.2018;2018;04;23;Keskiviikko;0;0;0;0;0;0
292;26.04.2018;2018;04;00;Torstai;0;0;0;0;0;0
292;26.04.2018;2018;04;01;Torstai;1;0;1;0;0;0
292;26.04.2018;2018;04;02;Torstai;0;0;0;0;0;0
292;26.04.2018;2018;04;03;Torstai;0;0;0;0;0;0
292;26.04.2018;2018;04;04;Torstai;2;0;2;1;0;1
292;26.04.2018;2018;04;05;Torstai;7;4;11;3;2;5
292;26.04.2018;2018;04;06;Torstai;25;15;40;7;2;9
292;26.04.2018;2018;04;07;Torstai;61;19;80;11;14;25
292;26.04.2018;2018;04;08;Torstai;46;20;66;8;16;24
292;26.04.2018;2018;04;09;Torstai;39;19;58;15;16;31
292;26.04.2018;2018;04;10;Torstai;26;25;51;9;9;18
292;26.04.2018;2018;04;11;Torstai;26;20;46;10;12;22
292;26.04.2018;2018;04;12;Torstai;24;20;44;21;27;48
292;26.04.2018;2018;04;13;Torstai;27;40;67;11;29;40
292;26.04.2018;2018;04;14;Torstai;37;37;74;23;33;56
292;26.04.2018;2018;04;15;Torstai;40;56;96;24;41;65
292;26.04.2018;2018;04;16;Torstai;43;44;87;17;27;44
292;26.04.2018;2018;04;17;Torstai;26;32;58;20;26;46
292;26.04.2018;2018;04;18;Torstai;29;29;58;27;26;53
292;26.04.2018;2018;04;19;Torstai;23;20;43;13;24;37
292;26.04.2018;2018;04;20;Torstai;22;8;30;16;9;25
292;26.04.2018;2018;04;21;Torstai;11;7;18;6;7;13
292;26.04.2018;2018;04;22;Torstai;3;6;9;8;4;12
292;26.04.2018;2018;04;23;Torstai;0;2;2;3;1;4
292;27.04.2018;2018;04;00;Perjantai;0;2;2;0;0;0
292;27.04.2018;2018;04;01;Perjantai;0;0;0;0;1;1
292;27.04.2018;2018;04;02;Perjantai;0;0;0;0;0;0
292;27.04.2018;2018;04;03;Perjantai;0;0;0;0;0;0
292;27.04.2018;2018;04;04;Perjantai;1;0;1;1;0;1
292;27.04.2018;2018;04;05;Perjantai;6;4;10;3;3;6
292;27.04.2018;2018;04;06;Perjantai;22;9;31;3;7;10
292;27.04.2018;2018;04;07;Perjantai;36;27;63;8;11;19
292;27.04.2018;2018;04;08;Perjantai;46;42;88;13;9;22
292;27.04.2018;2018;04;09;Perjantai;34;28;62;13;12;25
292;27.04.2018;2018;04;10;Perjantai;21;22;43;15;13;28
292;27.04.2018;2018;04;11;Perjantai;40;31;71;14;25;39
292;27.04.2018;2018;04;12;Perjantai;52;45;97;19;28;47
292;27.04.2018;2018;04;13;Perjantai;21;69;90;17;29;46
292;27.04.2018;2018;04;14;Perjantai;41;55;96;23;39;62
292;27.04.2018;2018;04;15;Perjantai;48;50;98;11;20;31
292;27.04.2018;2018;04;16;Perjantai;47;34;81;16;23;39
292;27.04.2018;2018;04;17;Perjantai;44;29;73;14;20;34
292;27.04.2018;2018;04;18;Perjantai;25;32;57;14;19;33
292;27.04.2018;2018;04;19;Perjantai;29;42;71;16;32;48
292;27.04.2018;2018;04;20;Perjantai;24;23;47;18;7;25
292;27.04.2018;2018;04;21;Perjantai;17;15;32;10;5;15
292;27.04.2018;2018;04;22;Perjantai;9;7;16;4;8;12
292;27.04.2018;2018;04;23;Perjantai;4;2;6;2;4;6
292;28.04.2018;2018;04;00;Lauantai;2;0;2;0;2;2
292;28.04.2018;2018;04;01;Lauantai;1;1;2;4;7;11
292;28.04.2018;2018;04;02;Lauantai;1;4;5;1;2;3
292;28.04.2018;2018;04;03;Lauantai;1;2;3;2;1;3
292;28.04.2018;2018;04;04;Lauantai;0;0;0;0;1;1
292;28.04.2018;2018;04;05;Lauantai;1;1;2;1;0;1
292;28.04.2018;2018;04;06;Lauantai;4;3;7;2;3;5
292;28.04.2018;2018;04;07;Lauantai;3;3;6;9;5;14
292;28.04.2018;2018;04;08;Lauantai;11;6;17;2;2;4
292;28.04.2018;2018;04;09;Lauantai;17;18;35;7;6;13
292;28.04.2018;2018;04;10;Lauantai;23;23;46;7;12;19
292;28.04.2018;2018;04;11;Lauantai;44;37;81;15;16;31
292;28.04.2018;2018;04;12;Lauantai;67;36;103;13;26;39
292;28.04.2018;2018;04;13;Lauantai;43;26;69;21;10;31
292;28.04.2018;2018;04;14;Lauantai;39;29;68;12;19;31
292;28.04.2018;2018;04;15;Lauantai;31;40;71;15;21;36
292;28.04.2018;2018;04;16;Lauantai;51;35;86;20;24;44
292;28.04.2018;2018;04;17;Lauantai;40;24;64;21;13;34
292;28.04.2018;2018;04;18;Lauantai;33;27;60;24;24;48
292;28.04.2018;2018;04;19;Lauantai;21;23;44;8;21;29
292;28.04.2018;2018;04;20;Lauantai;15;19;34;6;6;12
292;28.04.2018;2018;04;21;Lauantai;11;8;19;11;7;18
292;28.04.2018;2018;04;22;Lauantai;6;8;14;9;3;12
292;28.04.2018;2018;04;23;Lauantai;3;4;7;3;4;7
292;29.04.2018;2018;04;00;Sunnuntai;3;2;5;3;5;8
292;29.04.2018;2018;04;01;Sunnuntai;2;1;3;8;5;13
292;29.04.2018;2018;04;02;Sunnuntai;0;3;3;3;3;6
292;29.04.2018;2018;04;03;Sunnuntai;0;4;4;1;8;9
292;29.04.2018;2018;04;04;Sunnuntai;0;1;1;0;0;0
292;29.04.2018;2018;04;05;Sunnuntai;2;1;3;2;1;3
292;29.04.2018;2018;04;06;Sunnuntai;5;4;9;1;2;3
292;29.04.2018;2018;04;07;Sunnuntai;2;1;3;4;3;7
292;29.04.2018;2018;04;08;Sunnuntai;7;6;13;9;7;16
292;29.04.2018;2018;04;09;Sunnuntai;14;12;26;6;7;13
292;29.04.2018;2018;04;10;Sunnuntai;24;19;43;4;10;14
292;29.04.2018;2018;04;11;Sunnuntai;36;39;75;11;10;21
292;29.04.2018;2018;04;12;Sunnuntai;29;31;60;7;8;15
292;29.04.2018;2018;04;13;Sunnuntai;39;24;63;22;16;38
292;29.04.2018;2018;04;14;Sunnuntai;41;36;77;20;27;47
292;29.04.2018;2018;04;15;Sunnuntai;56;27;83;15;25;40
292;29.04.2018;2018;04;16;Sunnuntai;44;33;77;24;28;52
292;29.04.2018;2018;04;17;Sunnuntai;32;40;72;17;20;37
292;29.04.2018;2018;04;18;Sunnuntai;29;26;55;23;33;56
292;29.04.2018;2018;04;19;Sunnuntai;21;18;39;11;19;30
292;29.04.2018;2018;04;20;Sunnuntai;15;14;29;9;6;15
292;29.04.2018;2018;04;21;Sunnuntai;18;6;24;2;6;8
292;29.04.2018;2018;04;22;Sunnuntai;7;6;13;4;1;5
292;29.04.2018;2018;04;23;Sunnuntai;2;3;5;2;0;2
292;30.04.2018;2018;04;00;Maanantai;2;0;2;2;1;3
292;30.04.2018;2018;04;01;Maanantai;0;4;4;0;0;0
292;30.04.2018;2018;04;02;Maanantai;0;0;0;1;0;1
292;30.04.2018;2018;04;03;Maanantai;1;0;1;0;0;0
292;30.04.2018;2018;04;04;Maanantai;0;3;3;0;0;0
292;30.04.2018;2018;04;05;Maanantai;6;8;14;0;0;0
292;30.04.2018;2018;04;06;Maanantai;15;9;24;2;3;5
292;30.04.2018;2018;04;07;Maanantai;13;9;22;5;10;15
292;30.04.2018;2018;04;08;Maanantai;25;13;38;9;5;14
292;30.04.2018;2018;04;09;Maanantai;33;10;43;9;8;17
292;30.04.2018;2018;04;10;Maanantai;27;12;39;11;8;19
292;30.04.2018;2018;04;11;Maanantai;27;18;45;12;5;17
292;30.04.2018;2018;04;12;Maanantai;31;21;52;10;3;13
292;30.04.2018;2018;04;13;Maanantai;61;32;93;20;25;45
292;30.04.2018;2018;04;14;Maanantai;46;35;81;21;23;44
292;30.04.2018;2018;04;15;Maanantai;55;31;86;18;9;27
292;30.04.2018;2018;04;16;Maanantai;55;28;83;12;13;25
292;30.04.2018;2018;04;17;Maanantai;57;34;91;19;12;31
292;30.04.2018;2018;04;18;Maanantai;36;19;55;9;8;17
292;30.04.2018;2018;04;19;Maanantai;16;16;32;16;12;28
292;30.04.2018;2018;04;20;Maanantai;14;17;31;3;12;15
292;30.04.2018;2018;04;21;Maanantai;10;15;25;7;10;17
292;30.04.2018;2018;04;22;Maanantai;13;11;24;5;5;10
292;30.04.2018;2018;04;23;Maanantai;10;6;16;9;7;16
292;01.05.2018;2018;05;00;Tiistai;8;5;13;8;1;9
292;01.05.2018;2018;05;01;Tiistai;1;4;5;3;5;8
292;01.05.2018;2018;05;02;Tiistai;2;2;4;2;7;9
292;01.05.2018;2018;05;03;Tiistai;1;2;3;0;11;11
292;01.05.2018;2018;05;04;Tiistai;1;2;3;0;2;2
292;01.05.2018;2018;05;05;Tiistai;4;0;4;2;1;3
292;01.05.2018;2018;05;06;Tiistai;3;2;5;1;3;4
292;01.05.2018;2018;05;07;Tiistai;6;1;7;0;2;2
292;01.05.2018;2018;05;08;Tiistai;10;4;14;2;6;8
292;01.05.2018;2018;05;09;Tiistai;15;8;23;5;7;12
292;01.05.2018;2018;05;10;Tiistai;16;15;31;9;4;13
292;01.05.2018;2018;05;11;Tiistai;20;18;38;4;5;9
292;01.05.2018;2018;05;12;Tiistai;24;25;49;7;8;15
292;01.05.2018;2018;05;13;Tiistai;41;27;68;14;26;40
292;01.05.2018;2018;05;14;Tiistai;38;19;57;7;15;22
292;01.05.2018;2018;05;15;Tiistai;32;24;56;5;0;5
292;01.05.2018;2018;05;16;Tiistai;19;17;36;14;2;16
292;01.05.2018;2018;05;17;Tiistai;20;22;42;12;15;27
292;01.05.2018;2018;05;18;Tiistai;27;21;48;7;22;29
292;01.05.2018;2018;05;19;Tiistai;23;17;40;8;12;20
292;01.05.2018;2018;05;20;Tiistai;9;15;24;3;9;12
292;01.05.2018;2018;05;21;Tiistai;6;8;14;7;5;12
292;01.05.2018;2018;05;22;Tiistai;4;3;7;2;2;4
292;01.05.2018;2018;05;23;Tiistai;0;1;1;0;0;0
292;02.05.2018;2018;05;00;Keskiviikko;0;0;0;1;0;1
292;02.05.2018;2018;05;01;Keskiviikko;0;2;2;2;2;4
292;02.05.2018;2018;05;02;Keskiviikko;0;1;1;0;0;0
292;02.05.2018;2018;05;03;Keskiviikko;0;0;0;0;0;0
292;02.05.2018;2018;05;04;Keskiviikko;1;0;1;0;0;0
292;02.05.2018;2018;05;05;Keskiviikko;6;4;10;2;3;5
292;02.05.2018;2018;05;06;Keskiviikko;23;13;36;4;9;13
292;02.05.2018;2018;05;07;Keskiviikko;48;21;69;7;8;15
292;02.05.2018;2018;05;08;Keskiviikko;50;25;75;8;10;18
292;02.05.2018;2018;05;09;Keskiviikko;26;11;37;8;7;15
292;02.05.2018;2018;05;10;Keskiviikko;20;13;33;8;5;13
292;02.05.2018;2018;05;11;Keskiviikko;20;14;34;3;6;9
292;02.05.2018;2018;05;12;Keskiviikko;10;11;21;3;4;7
292;02.05.2018;2018;05;13;Keskiviikko;35;58;93;7;11;18
292;02.05.2018;2018;05;14;Keskiviikko;27;26;53;8;7;15
292;02.05.2018;2018;05;15;Keskiviikko;37;27;64;9;12;21
292;02.05.2018;2018;05;16;Keskiviikko;36;28;64;10;11;21
292;02.05.2018;2018;05;17;Keskiviikko;27;16;43;4;11;15
292;02.05.2018;2018;05;18;Keskiviikko;17;15;32;7;8;15
292;02.05.2018;2018;05;19;Keskiviikko;14;8;22;8;3;11
292;02.05.2018;2018;05;20;Keskiviikko;14;10;24;10;7;17
292;02.05.2018;2018;05;21;Keskiviikko;9;6;15;1;3;4
292;02.05.2018;2018;05;22;Keskiviikko;0;3;3;1;0;1
292;02.05.2018;2018;05;23;Keskiviikko;0;0;0;2;1;3
292;03.05.2018;2018;05;00;Torstai;0;0;0;0;1;1
292;03.05.2018;2018;05;01;Torstai;0;0;0;1;0;1
292;03.05.2018;2018;05;02;Torstai;0;0;0;0;0;0
292;03.05.2018;2018;05;03;Torstai;0;0;0;0;0;0
292;03.05.2018;2018;05;04;Torstai;1;1;2;0;0;0
292;03.05.2018;2018;05;05;Torstai;9;4;13;1;2;3
292;03.05.2018;2018;05;06;Torstai;21;21;42;2;2;4
292;03.05.2018;2018;05;07;Torstai;56;43;99;6;4;10
292;03.05.2018;2018;05;08;Torstai;40;29;69;10;12;22
292;03.05.2018;2018;05;09;Torstai;45;31;76;7;9;16
292;03.05.2018;2018;05;10;Torstai;19;17;36;12;1;13
292;03.05.2018;2018;05;11;Torstai;31;25;56;8;8;16
292;03.05.2018;2018;05;12;Torstai;30;22;52;13;5;18
292;03.05.2018;2018;05;13;Torstai;38;36;74;5;7;12
292;03.05.2018;2018;05;14;Torstai;42;42;84;15;8;23
292;03.05.2018;2018;05;15;Torstai;63;58;121;5;8;13
292;03.05.2018;2018;05;16;Torstai;50;42;92;11;5;16
292;03.05.2018;2018;05;17;Torstai;37;35;72;7;10;17
292;03.05.2018;2018;05;18;Torstai;25;22;47;16;12;28
292;03.05.2018;2018;05;19;Torstai;35;19;54;16;18;34
292;03.05.2018;2018;05;20;Torstai;19;18;37;15;11;26
292;03.05.2018;2018;05;21;Torstai;6;4;10;4;4;8
292;03.05.2018;2018;05;22;Torstai;2;1;3;0;0;0
292;03.05.2018;2018;05;23;Torstai;2;2;4;2;0;2
292;04.05.2018;2018;05;00;Perjantai;0;1;1;3;2;5
292;04.05.2018;2018;05;01;Perjantai;0;0;0;0;0;0
292;04.05.2018;2018;05;02;Perjantai;0;0;0;0;0;0
292;04.05.2018;2018;05;03;Perjantai;0;0;0;0;0;0
292;04.05.2018;2018;05;04;Perjantai;2;1;3;0;0;0
292;04.05.2018;2018;05;05;Perjantai;3;3;6;2;0;2
292;04.05.2018;2018;05;06;Perjantai;17;10;27;1;4;5
292;04.05.2018;2018;05;07;Perjantai;49;23;72;7;6;13
292;04.05.2018;2018;05;08;Perjantai;40;26;66;8;10;18
292;04.05.2018;2018;05;09;Perjantai;15;9;24;6;4;10
292;04.05.2018;2018;05;10;Perjantai;15;7;22;0;1;1
292;04.05.2018;2018;05;11;Perjantai;5;5;10;1;2;3
292;04.05.2018;2018;05;12;Perjantai;15;10;25;10;4;14
292;04.05.2018;2018;05;13;Perjantai;18;16;34;1;5;6
292;04.05.2018;2018;05;14;Perjantai;28;23;51;4;5;9
292;04.05.2018;2018;05;15;Perjantai;18;17;35;3;1;4
292;04.05.2018;2018;05;16;Perjantai;18;22;40;8;4;12
292;04.05.2018;2018;05;17;Perjantai;24;22;46;14;14;28
292;04.05.2018;2018;05;18;Perjantai;11;9;20;5;9;14
292;04.05.2018;2018;05;19;Perjantai;11;13;24;13;14;27
292;04.05.2018;2018;05;20;Perjantai;16;15;31;10;6;16
292;04.05.2018;2018;05;21;Perjantai;9;5;14;6;2;8
292;04.05.2018;2018;05;22;Perjantai;8;4;12;4;4;8
292;04.05.2018;2018;05;23;Perjantai;2;6;8;0;6;6
292;05.05.2018;2018;05;00;Lauantai;1;1;2;5;1;6
292;05.05.2018;2018;05;01;Lauantai;1;0;1;1;0;1
292;05.05.2018;2018;05;02;Lauantai;0;2;2;0;0;0
292;05.05.2018;2018;05;03;Lauantai;0;2;2;0;1;1
292;05.05.2018;2018;05;04;Lauantai;1;1;2;1;1;2
292;05.05.2018;2018;05;05;Lauantai;2;4;6;0;1;1
292;05.05.2018;2018;05;06;Lauantai;2;5;7;3;1;4
292;05.05.2018;2018;05;07;Lauantai;6;7;13;3;3;6
292;05.05.2018;2018;05;08;Lauantai;6;6;12;5;3;8
292;05.05.2018;2018;05;09;Lauantai;17;14;31;7;7;14
292;05.05.2018;2018;05;10;Lauantai;29;21;50;5;4;9
292;05.05.2018;2018;05;11;Lauantai;30;22;52;3;8;11
292;05.05.2018;2018;05;12;Lauantai;38;27;65;8;10;18
292;05.05.2018;2018;05;13;Lauantai;37;21;58;10;7;17
292;05.05.2018;2018;05;14;Lauantai;34;27;61;9;2;11
292;05.05.2018;2018;05;15;Lauantai;32;34;66;7;4;11
292;05.05.2018;2018;05;16;Lauantai;43;44;87;10;6;16
292;05.05.2018;2018;05;17;Lauantai;53;24;77;12;18;30
292;05.05.2018;2018;05;18;Lauantai;39;36;75;12;16;28
292;05.05.2018;2018;05;19;Lauantai;23;16;39;10;20;30
292;05.05.2018;2018;05;20;Lauantai;31;20;51;17;14;31
292;05.05.2018;2018;05;21;Lauantai;16;7;23;15;8;23
292;05.05.2018;2018;05;22;Lauantai;8;11;19;4;7;11
292;05.05.2018;2018;05;23;Lauantai;10;3;13;3;5;8
292;06.05.2018;2018;05;00;Sunnuntai;11;5;16;6;3;9
292;06.05.2018;2018;05;01;Sunnuntai;2;2;4;1;1;2
292;06.05.2018;2018;05;02;Sunnuntai;1;5;6;0;4;4
292;06.05.2018;2018;05;03;Sunnuntai;0;2;2;1;2;3
292;06.05.2018;2018;05;04;Sunnuntai;1;0;1;0;0;0
292;06.05.2018;2018;05;05;Sunnuntai;2;3;5;1;1;2
292;06.05.2018;2018;05;06;Sunnuntai;3;2;5;1;1;2
292;06.05.2018;2018;05;07;Sunnuntai;6;5;11;3;1;4
292;06.05.2018;2018;05;08;Sunnuntai;14;4;18;3;4;7
292;06.05.2018;2018;05;09;Sunnuntai;30;10;40;3;5;8
292;06.05.2018;2018;05;10;Sunnuntai;31;15;46;8;10;18
292;06.05.2018;2018;05;11;Sunnuntai;62;50;112;7;8;15
292;06.05.2018;2018;05;12;Sunnuntai;36;34;70;11;8;19
292;06.05.2018;2018;05;13;Sunnuntai;31;31;62;14;14;28
292;06.05.2018;2018;05;14;Sunnuntai;43;19;62;7;15;22
292;06.05.2018;2018;05;15;Sunnuntai;51;32;83;22;21;43
292;06.05.2018;2018;05;16;Sunnuntai;51;24;75;22;29;51
292;06.05.2018;2018;05;17;Sunnuntai;43;46;89;9;28;37
292;06.05.2018;2018;05;18;Sunnuntai;37;33;70;11;33;44
292;06.05.2018;2018;05;19;Sunnuntai;32;38;70;13;30;43
292;06.05.2018;2018;05;20;Sunnuntai;16;10;26;10;15;25
292;06.05.2018;2018;05;21;Sunnuntai;8;10;18;4;5;9
292;06.05.2018;2018;05;22;Sunnuntai;3;1;4;1;4;5
292;06.05.2018;2018;05;23;Sunnuntai;3;3;6;0;0;0
292;07.05.2018;2018;05;00;Maanantai;1;2;3;0;0;0
292;07.05.2018;2018;05;01;Maanantai;0;0;0;0;2;2
292;07.05.2018;2018;05;02;Maanantai;1;0;1;3;0;3
292;07.05.2018;2018;05;03;Maanantai;0;0;0;0;0;0
292;07.05.2018;2018;05;04;Maanantai;2;0;2;0;0;0
292;07.05.2018;2018;05;05;Maanantai;11;5;16;3;7;10
292;07.05.2018;2018;05;06;Maanantai;30;15;45;1;6;7
292;07.05.2018;2018;05;07;Maanantai;73;27;100;6;22;28
292;07.05.2018;2018;05;08;Maanantai;40;19;59;11;14;25
292;07.05.2018;2018;05;09;Maanantai;65;23;88;14;11;25
292;07.05.2018;2018;05;10;Maanantai;28;27;55;9;12;21
292;07.05.2018;2018;05;11;Maanantai;35;24;59;5;10;15
292;07.05.2018;2018;05;12;Maanantai;22;15;37;4;10;14
292;07.05.2018;2018;05;13;Maanantai;32;43;75;5;10;15
292;07.05.2018;2018;05;14;Maanantai;41;28;69;7;11;18
292;07.05.2018;2018;05;15;Maanantai;46;41;87;9;27;36
292;07.05.2018;2018;05;16;Maanantai;45;45;90;5;13;18
292;07.05.2018;2018;05;17;Maanantai;30;32;62;9;11;20
292;07.05.2018;2018;05;18;Maanantai;22;18;40;11;14;25
292;07.05.2018;2018;05;19;Maanantai;35;19;54;10;27;37
292;07.05.2018;2018;05;20;Maanantai;18;14;32;3;9;12
292;07.05.2018;2018;05;21;Maanantai;13;5;18;1;3;4
292;07.05.2018;2018;05;22;Maanantai;2;1;3;2;1;3
292;07.05.2018;2018;05;23;Maanantai;0;0;0;1;4;5
292;08.05.2018;2018;05;00;Tiistai;0;0;0;0;0;0
292;08.05.2018;2018;05;01;Tiistai;0;0;0;0;2;2
292;08.05.2018;2018;05;02;Tiistai;0;0;0;0;0;0
292;08.05.2018;2018;05;03;Tiistai;0;0;0;0;0;0
292;08.05.2018;2018;05;04;Tiistai;1;0;1;0;1;1
292;08.05.2018;2018;05;05;Tiistai;8;5;13;2;2;4
292;08.05.2018;2018;05;06;Tiistai;36;18;54;2;4;6
292;08.05.2018;2018;05;07;Tiistai;85;30;115;7;7;14
292;08.05.2018;2018;05;08;Tiistai;85;32;117;9;12;21
292;08.05.2018;2018;05;09;Tiistai;42;25;67;7;13;20
292;08.05.2018;2018;05;10;Tiistai;48;21;69;13;12;25
292;08.05.2018;2018;05;11;Tiistai;22;22;44;14;8;22
292;08.05.2018;2018;05;12;Tiistai;29;25;54;11;19;30
292;08.05.2018;2018;05;13;Tiistai;26;43;69;13;27;40
292;08.05.2018;2018;05;14;Tiistai;52;73;125;25;38;63
292;08.05.2018;2018;05;15;Tiistai;60;57;117;20;41;61
292;08.05.2018;2018;05;16;Tiistai;66;54;120;19;46;65
292;08.05.2018;2018;05;17;Tiistai;62;49;111;19;41;60
292;08.05.2018;2018;05;18;Tiistai;53;46;99;33;30;63
292;08.05.2018;2018;05;19;Tiistai;51;39;90;21;36;57
292;08.05.2018;2018;05;20;Tiistai;38;19;57;16;13;29
292;08.05.2018;2018;05;21;Tiistai;12;6;18;6;5;11
292;08.05.2018;2018;05;22;Tiistai;3;3;6;2;2;4
292;08.05.2018;2018;05;23;Tiistai;0;1;1;2;3;5
292;09.05.2018;2018;05;00;Keskiviikko;1;0;1;1;2;3
292;09.05.2018;2018;05;01;Keskiviikko;1;0;1;0;1;1
292;09.05.2018;2018;05;02;Keskiviikko;0;0;0;1;0;1
292;09.05.2018;2018;05;03;Keskiviikko;0;0;0;0;0;0
292;09.05.2018;2018;05;04;Keskiviikko;1;2;3;0;0;0
292;09.05.2018;2018;05;05;Keskiviikko;5;7;12;3;4;7
292;09.05.2018;2018;05;06;Keskiviikko;29;13;42;2;4;6
292;09.05.2018;2018;05;07;Keskiviikko;55;39;94;2;3;5
292;09.05.2018;2018;05;08;Keskiviikko;49;43;92;8;8;16
292;09.05.2018;2018;05;09;Keskiviikko;37;22;59;3;11;14
292;09.05.2018;2018;05;10;Keskiviikko;46;25;71;10;6;16
292;09.05.2018;2018;05;11;Keskiviikko;35;33;68;9;4;13
292;09.05.2018;2018;05;12;Keskiviikko;39;26;65;21;29;50
292;09.05.2018;2018;05;13;Keskiviikko;41;64;105;13;44;57
292;09.05.2018;2018;05;14;Keskiviikko;53;67;120;25;52;77
292;09.05.2018;2018;05;15;Keskiviikko;65;58;123;16;37;53
292;09.05.2018;2018;05;16;Keskiviikko;76;55;131;18;40;58
292;09.05.2018;2018;05;17;Keskiviikko;67;45;112;32;33;65
292;09.05.2018;2018;05;18;Keskiviikko;66;57;123;25;39;64
292;09.05.2018;2018;05;19;Keskiviikko;53;49;102;28;21;49
292;09.05.2018;2018;05;20;Keskiviikko;43;31;74;11;28;39
292;09.05.2018;2018;05;21;Keskiviikko;14;24;38;16;26;42
292;09.05.2018;2018;05;22;Keskiviikko;9;9;18;7;7;14
292;09.05.2018;2018;05;23;Keskiviikko;4;9;13;6;3;9
292;10.05.2018;2018;05;00;Torstai;3;6;9;3;0;3
292;10.05.2018;2018;05;01;Torstai;1;2;3;1;1;2
292;10.05.2018;2018;05;02;Torstai;2;4;6;3;3;6
292;10.05.2018;2018;05;03;Torstai;0;2;2;0;2;2
292;10.05.2018;2018;05;04;Torstai;0;0;0;0;2;2
292;10.05.2018;2018;05;05;Torstai;5;3;8;0;3;3
292;10.05.2018;2018;05;06;Torstai;8;4;12;1;1;2
292;10.05.2018;2018;05;07;Torstai;7;5;12;5;5;10
292;10.05.2018;2018;05;08;Torstai;25;13;38;10;12;22
292;10.05.2018;2018;05;09;Torstai;29;15;44;6;7;13
292;10.05.2018;2018;05;10;Torstai;58;30;88;8;8;16
292;10.05.2018;2018;05;11;Torstai;54;49;103;14;12;26
292;10.05.2018;2018;05;12;Torstai;70;54;124;17;45;62
292;10.05.2018;2018;05;13;Torstai;95;49;144;31;43;74
292;10.05.2018;2018;05;14;Torstai;74;40;114;20;32;52
292;10.05.2018;2018;05;15;Torstai;57;49;106;24;50;74
292;10.05.2018;2018;05;16;Torstai;49;42;91;20;45;65
292;10.05.2018;2018;05;17;Torstai;61;37;98;16;34;50
292;10.05.2018;2018;05;18;Torstai;83;55;138;33;23;56
292;10.05.2018;2018;05;19;Torstai;45;34;79;21;29;50
292;10.05.2018;2018;05;20;Torstai;38;30;68;10;21;31
292;10.05.2018;2018;05;21;Torstai;17;24;41;11;14;25
292;10.05.2018;2018;05;22;Torstai;9;3;12;0;3;3
292;10.05.2018;2018;05;23;Torstai;7;4;11;0;1;1
292;11.05.2018;2018;05;00;Perjantai;1;2;3;0;0;0
292;11.05.2018;2018;05;01;Perjantai;0;0;0;1;1;2
292;11.05.2018;2018;05;02;Perjantai;0;3;3;0;1;1
292;11.05.2018;2018;05;03;Perjantai;1;0;1;1;0;1
292;11.05.2018;2018;05;04;Perjantai;2;0;2;1;1;2
292;11.05.2018;2018;05;05;Perjantai;7;6;13;2;5;7
292;11.05.2018;2018;05;06;Perjantai;26;7;33;1;6;7
292;11.05.2018;2018;05;07;Perjantai;64;20;84;6;24;30
292;11.05.2018;2018;05;08;Perjantai;71;19;90;8;13;21
292;11.05.2018;2018;05;09;Perjantai;39;19;58;12;9;21
292;11.05.2018;2018;05;10;Perjantai;35;18;53;10;5;15
292;11.05.2018;2018;05;11;Perjantai;41;34;75;9;4;13
292;11.05.2018;2018;05;12;Perjantai;48;38;86;5;34;39
292;11.05.2018;2018;05;13;Perjantai;53;67;120;14;45;59
292;11.05.2018;2018;05;14;Perjantai;69;54;123;18;46;64
292;11.05.2018;2018;05;15;Perjantai;66;56;122;18;39;57
292;11.05.2018;2018;05;16;Perjantai;64;50;114;23;38;61
292;11.05.2018;2018;05;17;Perjantai;62;56;118;22;26;48
292;11.05.2018;2018;05;18;Perjantai;51;41;92;19;36;55
292;11.05.2018;2018;05;19;Perjantai;46;46;92;26;37;63
292;11.05.2018;2018;05;20;Perjantai;59;14;73;13;22;35
292;11.05.2018;2018;05;21;Perjantai;36;23;59;11;9;20
292;11.05.2018;2018;05;22;Perjantai;18;22;40;9;10;19
292;11.05.2018;2018;05;23;Perjantai;9;5;14;8;1;9
292;12.05.2018;2018;05;00;Lauantai;4;2;6;2;1;3
292;12.05.2018;2018;05;01;Lauantai;5;3;8;6;1;7
292;12.05.2018;2018;05;02;Lauantai;1;3;4;4;3;7
292;12.05.2018;2018;05;03;Lauantai;1;5;6;1;3;4
292;12.05.2018;2018;05;04;Lauantai;0;1;1;1;2;3
292;12.05.2018;2018;05;05;Lauantai;0;3;3;1;4;5
292;12.05.2018;2018;05;06;Lauantai;3;2;5;2;2;4
292;12.05.2018;2018;05;07;Lauantai;4;9;13;7;3;10
292;12.05.2018;2018;05;08;Lauantai;15;17;32;5;7;12
292;12.05.2018;2018;05;09;Lauantai;29;14;43;4;8;12
292;12.05.2018;2018;05;10;Lauantai;45;29;74;4;9;13
292;12.05.2018;2018;05;11;Lauantai;57;48;105;13;10;23
292;12.05.2018;2018;05;12;Lauantai;83;71;154;76;120;196
292;12.05.2018;2018;05;13;Lauantai;109;36;145;19;29;48
292;12.05.2018;2018;05;14;Lauantai;69;52;121;10;41;51
292;12.05.2018;2018;05;15;Lauantai;70;43;113;17;29;46
292;12.05.2018;2018;05;16;Lauantai;56;36;92;16;19;35
292;12.05.2018;2018;05;17;Lauantai;56;47;103;12;22;34
292;12.05.2018;2018;05;18;Lauantai;58;33;91;16;21;37
292;12.05.2018;2018;05;19;Lauantai;41;33;74;9;18;27
292;12.05.2018;2018;05;20;Lauantai;31;26;57;15;20;35
292;12.05.2018;2018;05;21;Lauantai;15;16;31;9;7;16
292;12.05.2018;2018;05;22;Lauantai;7;17;24;5;8;13
292;12.05.2018;2018;05;23;Lauantai;5;7;12;3;4;7
292;13.05.2018;2018;05;00;Sunnuntai;4;4;8;3;4;7
292;13.05.2018;2018;05;01;Sunnuntai;1;1;2;3;2;5
292;13.05.2018;2018;05;02;Sunnuntai;0;3;3;0;2;2
292;13.05.2018;2018;05;03;Sunnuntai;1;2;3;0;5;5
292;13.05.2018;2018;05;04;Sunnuntai;0;1;1;0;3;3
292;13.05.2018;2018;05;05;Sunnuntai;2;1;3;2;1;3
292;13.05.2018;2018;05;06;Sunnuntai;3;1;4;3;2;5
292;13.05.2018;2018;05;07;Sunnuntai;3;3;6;3;5;8
292;13.05.2018;2018;05;08;Sunnuntai;8;7;15;3;6;9
292;13.05.2018;2018;05;09;Sunnuntai;18;7;25;5;4;9
292;13.05.2018;2018;05;10;Sunnuntai;38;32;70;5;10;15
292;13.05.2018;2018;05;11;Sunnuntai;56;56;112;11;8;19
292;13.05.2018;2018;05;12;Sunnuntai;62;45;107;8;21;29
292;13.05.2018;2018;05;13;Sunnuntai;66;53;119;16;29;45
292;13.05.2018;2018;05;14;Sunnuntai;63;45;108;20;35;55
292;13.05.2018;2018;05;15;Sunnuntai;67;62;129;15;26;41
292;13.05.2018;2018;05;16;Sunnuntai;75;50;125;17;29;46
292;13.05.2018;2018;05;17;Sunnuntai;72;49;121;16;29;45
292;13.05.2018;2018;05;18;Sunnuntai;59;27;86;19;33;52
292;13.05.2018;2018;05;19;Sunnuntai;67;52;119;16;38;54
292;13.05.2018;2018;05;20;Sunnuntai;37;39;76;13;33;46
292;13.05.2018;2018;05;21;Sunnuntai;12;15;27;5;21;26
292;13.05.2018;2018;05;22;Sunnuntai;4;6;10;2;3;5
292;13.05.2018;2018;05;23;Sunnuntai;1;5;6;0;0;0
292;14.05.2018;2018;05;00;Maanantai;1;2;3;1;1;2
292;14.05.2018;2018;05;01;Maanantai;1;2;3;0;0;0
292;14.05.2018;2018;05;02;Maanantai;1;0;1;0;0;0
292;14.05.2018;2018;05;03;Maanantai;0;0;0;0;0;0
292;14.05.2018;2018;05;04;Maanantai;3;2;5;1;1;2
292;14.05.2018;2018;05;05;Maanantai;11;7;18;1;6;7
292;14.05.2018;2018;05;06;Maanantai;22;18;40;1;6;7
292;14.05.2018;2018;05;07;Maanantai;81;31;112;8;8;16
292;14.05.2018;2018;05;08;Maanantai;66;18;84;6;9;15
292;14.05.2018;2018;05;09;Maanantai;54;41;95;7;8;15
292;14.05.2018;2018;05;10;Maanantai;39;36;75;3;5;8
292;14.05.2018;2018;05;11;Maanantai;43;29;72;15;12;27
292;14.05.2018;2018;05;12;Maanantai;48;25;73;5;37;42
292;14.05.2018;2018;05;13;Maanantai;37;56;93;17;36;53
292;14.05.2018;2018;05;14;Maanantai;66;52;118;12;47;59
292;14.05.2018;2018;05;15;Maanantai;64;69;133;20;55;75
292;14.05.2018;2018;05;16;Maanantai;88;58;146;26;49;75
292;14.05.2018;2018;05;17;Maanantai;56;57;113;16;49;65
292;14.05.2018;2018;05;18;Maanantai;75;44;119;27;56;83
292;14.05.2018;2018;05;19;Maanantai;55;31;86;24;44;68
292;14.05.2018;2018;05;20;Maanantai;35;42;77;22;33;55
292;14.05.2018;2018;05;21;Maanantai;14;14;28;9;13;22
292;14.05.2018;2018;05;22;Maanantai;6;6;12;3;5;8
292;14.05.2018;2018;05;23;Maanantai;2;2;4;0;1;1
292;15.05.2018;2018;05;00;Tiistai;0;1;1;1;0;1
292;15.05.2018;2018;05;01;Tiistai;0;0;0;0;3;3
292;15.05.2018;2018;05;02;Tiistai;0;1;1;0;1;1
292;15.05.2018;2018;05;03;Tiistai;0;0;0;0;0;0
292;15.05.2018;2018;05;04;Tiistai;1;0;1;0;0;0
292;15.05.2018;2018;05;05;Tiistai;14;8;22;2;1;3
292;15.05.2018;2018;05;06;Tiistai;41;23;64;5;8;13
292;15.05.2018;2018;05;07;Tiistai;97;28;125;4;5;9
292;15.05.2018;2018;05;08;Tiistai;86;24;110;17;6;23
292;15.05.2018;2018;05;09;Tiistai;34;26;60;5;7;12
292;15.05.2018;2018;05;10;Tiistai;38;34;72;5;4;9
292;15.05.2018;2018;05;11;Tiistai;39;36;75;7;10;17
292;15.05.2018;2018;05;12;Tiistai;59;76;135;14;58;72
292;15.05.2018;2018;05;13;Tiistai;56;48;104;22;34;56
292;15.05.2018;2018;05;14;Tiistai;65;61;126;23;44;67
292;15.05.2018;2018;05;15;Tiistai;89;67;156;15;55;70
292;15.05.2018;2018;05;16;Tiistai;79;67;146;15;52;67
292;15.05.2018;2018;05;17;Tiistai;94;51;145;29;29;58
292;15.05.2018;2018;05;18;Tiistai;75;70;145;15;39;54
292;15.05.2018;2018;05;19;Tiistai;81;61;142;21;39;60
292;15.05.2018;2018;05;20;Tiistai;50;28;78;25;27;52
292;15.05.2018;2018;05;21;Tiistai;22;13;35;4;16;20
292;15.05.2018;2018;05;22;Tiistai;7;4;11;3;7;10
292;15.05.2018;2018;05;23;Tiistai;4;4;8;2;0;2
292;16.05.2018;2018;05;00;Keskiviikko;1;0;1;0;0;0
292;16.05.2018;2018;05;01;Keskiviikko;1;0;1;0;1;1
292;16.05.2018;2018;05;02;Keskiviikko;0;0;0;0;0;0
292;16.05.2018;2018;05;03;Keskiviikko;0;1;1;0;0;0
292;16.05.2018;2018;05;04;Keskiviikko;1;2;3;0;0;0
292;16.05.2018;2018;05;05;Keskiviikko;11;9;20;2;4;6
292;16.05.2018;2018;05;06;Keskiviikko;31;24;55;0;6;6
292;16.05.2018;2018;05;07;Keskiviikko;86;46;132;10;2;12
292;16.05.2018;2018;05;08;Keskiviikko;70;39;109;9;7;16
292;16.05.2018;2018;05;09;Keskiviikko;40;36;76;7;5;12
292;16.05.2018;2018;05;10;Keskiviikko;40;37;77;4;5;9
292;16.05.2018;2018;05;11;Keskiviikko;43;35;78;3;21;24
292;16.05.2018;2018;05;12;Keskiviikko;55;37;92;13;29;42
292;16.05.2018;2018;05;13;Keskiviikko;46;74;120;6;50;56
292;16.05.2018;2018;05;14;Keskiviikko;65;71;136;18;42;60
292;16.05.2018;2018;05;15;Keskiviikko;75;70;145;17;44;61
292;16.05.2018;2018;05;16;Keskiviikko;90;58;148;24;42;66
292;16.05.2018;2018;05;17;Keskiviikko;147;72;219;16;51;67
292;16.05.2018;2018;05;18;Keskiviikko;86;62;148;25;43;68
292;16.05.2018;2018;05;19;Keskiviikko;65;42;107;20;42;62
292;16.05.2018;2018;05;20;Keskiviikko;39;47;86;11;46;57
292;16.05.2018;2018;05;21;Keskiviikko;12;16;28;7;21;28
292;16.05.2018;2018;05;22;Keskiviikko;10;12;22;2;9;11
292;16.05.2018;2018;05;23;Keskiviikko;4;5;9;1;0;1
292;17.05.2018;2018;05;00;Torstai;1;1;2;1;0;1
292;17.05.2018;2018;05;01;Torstai;0;3;3;0;0;0
292;17.05.2018;2018;05;02;Torstai;0;0;0;0;0;0
292;17.05.2018;2018;05;03;Torstai;0;0;0;0;0;0
292;17.05.2018;2018;05;04;Torstai;3;1;4;0;0;0
292;17.05.2018;2018;05;05;Torstai;11;10;21;1;3;4
292;17.05.2018;2018;05;06;Torstai;27;20;47;3;11;14
292;17.05.2018;2018;05;07;Torstai;69;49;118;9;4;13
292;17.05.2018;2018;05;08;Torstai;45;36;81;5;10;15
292;17.05.2018;2018;05;09;Torstai;54;51;105;3;6;9
292;17.05.2018;2018;05;10;Torstai;32;28;60;1;5;6
292;17.05.2018;2018;05;11;Torstai;32;39;71;6;14;20
292;17.05.2018;2018;05;12;Torstai;29;35;64;5;20;25
292;17.05.2018;2018;05;13;Torstai;38;53;91;15;27;42
292;17.05.2018;2018;05;14;Torstai;44;61;105;16;29;45
292;17.05.2018;2018;05;15;Torstai;55;68;123;12;48;60
292;17.05.2018;2018;05;16;Torstai;41;48;89;13;37;50
292;17.05.2018;2018;05;17;Torstai;56;38;94;22;29;51
292;17.05.2018;2018;05;18;Torstai;53;32;85;18;25;43
292;17.05.2018;2018;05;19;Torstai;44;37;81;7;23;30
292;17.05.2018;2018;05;20;Torstai;37;27;64;13;26;39
292;17.05.2018;2018;05;21;Torstai;6;9;15;5;9;14
292;17.05.2018;2018;05;22;Torstai;6;4;10;1;6;7
292;17.05.2018;2018;05;23;Torstai;2;0;2;1;1;2
292;18.05.2018;2018;05;00;Perjantai;5;0;5;3;0;3
292;18.05.2018;2018;05;01;Perjantai;1;2;3;0;1;1
292;18.05.2018;2018;05;02;Perjantai;0;0;0;0;0;0
292;18.05.2018;2018;05;03;Perjantai;0;0;0;0;0;0
292;18.05.2018;2018;05;04;Perjantai;2;2;4;1;0;1
292;18.05.2018;2018;05;05;Perjantai;9;5;14;1;3;4
292;18.05.2018;2018;05;06;Perjantai;17;15;32;1;3;4
292;18.05.2018;2018;05;07;Perjantai;74;25;99;2;6;8
292;18.05.2018;2018;05;08;Perjantai;72;32;104;11;6;17
292;18.05.2018;2018;05;09;Perjantai;29;24;53;5;7;12
292;18.05.2018;2018;05;10;Perjantai;42;40;82;11;3;14
292;18.05.2018;2018;05;11;Perjantai;21;24;45;5;12;17
292;18.05.2018;2018;05;12;Perjantai;48;38;86;11;23;34
292;18.05.2018;2018;05;13;Perjantai;43;53;96;12;38;50
292;18.05.2018;2018;05;14;Perjantai;38;51;89;11;17;28
292;18.05.2018;2018;05;15;Perjantai;40;41;81;14;35;49
292;18.05.2018;2018;05;16;Perjantai;41;30;71;13;27;40
292;18.05.2018;2018;05;17;Perjantai;42;31;73;23;24;47
292;18.05.2018;2018;05;18;Perjantai;46;38;84;11;28;39
292;18.05.2018;2018;05;19;Perjantai;27;32;59;9;25;34
292;18.05.2018;2018;05;20;Perjantai;43;14;57;16;19;35
292;18.05.2018;2018;05;21;Perjantai;11;15;26;6;9;15
292;18.05.2018;2018;05;22;Perjantai;8;12;20;7;10;17
292;18.05.2018;2018;05;23;Perjantai;9;5;14;11;2;13
292;19.05.2018;2018;05;00;Lauantai;5;5;10;7;8;15
292;19.05.2018;2018;05;01;Lauantai;1;4;5;1;1;2
292;19.05.2018;2018;05;02;Lauantai;0;4;4;0;2;2
292;19.05.2018;2018;05;03;Lauantai;1;2;3;1;6;7
292;19.05.2018;2018;05;04;Lauantai;0;1;1;1;1;2
292;19.05.2018;2018;05;05;Lauantai;1;2;3;0;2;2
292;19.05.2018;2018;05;06;Lauantai;7;3;10;2;3;5
292;19.05.2018;2018;05;07;Lauantai;9;6;15;4;2;6
292;19.05.2018;2018;05;08;Lauantai;10;7;17;4;2;6
292;19.05.2018;2018;05;09;Lauantai;24;23;47;3;9;12
292;19.05.2018;2018;05;10;Lauantai;37;36;73;2;5;7
292;19.05.2018;2018;05;11;Lauantai;52;30;82;10;9;19
292;19.05.2018;2018;05;12;Lauantai;40;37;77;5;30;35
292;19.05.2018;2018;05;13;Lauantai;39;32;71;12;19;31
292;19.05.2018;2018;05;14;Lauantai;50;31;81;10;19;29
292;19.05.2018;2018;05;15;Lauantai;38;38;76;24;24;48
292;19.05.2018;2018;05;16;Lauantai;45;31;76;13;21;34
292;19.05.2018;2018;05;17;Lauantai;39;31;70;20;26;46
292;19.05.2018;2018;05;18;Lauantai;34;24;58;12;21;33
292;19.05.2018;2018;05;19;Lauantai;28;25;53;20;28;48
292;19.05.2018;2018;05;20;Lauantai;29;9;38;17;20;37
292;19.05.2018;2018;05;21;Lauantai;13;11;24;10;9;19
292;19.05.2018;2018;05;22;Lauantai;10;6;16;5;3;8
292;19.05.2018;2018;05;23;Lauantai;7;9;16;11;3;14
292;20.05.2018;2018;05;00;Sunnuntai;6;6;12;0;0;0
292;20.05.2018;2018;05;01;Sunnuntai;2;4;6;3;3;6
292;20.05.2018;2018;05;02;Sunnuntai;1;2;3;0;5;5
292;20.05.2018;2018;05;03;Sunnuntai;1;1;2;0;4;4
292;20.05.2018;2018;05;04;Sunnuntai;0;4;4;0;2;2
292;20.05.2018;2018;05;05;Sunnuntai;3;0;3;3;1;4
292;20.05.2018;2018;05;06;Sunnuntai;3;2;5;1;6;7
292;20.05.2018;2018;05;07;Sunnuntai;7;4;11;1;5;6
292;20.05.2018;2018;05;08;Sunnuntai;7;6;13;5;1;6
292;20.05.2018;2018;05;09;Sunnuntai;22;20;42;2;12;14
292;20.05.2018;2018;05;10;Sunnuntai;26;27;53;5;2;7
292;20.05.2018;2018;05;11;Sunnuntai;29;35;64;10;19;29
292;20.05.2018;2018;05;12;Sunnuntai;57;25;82;6;22;28
292;20.05.2018;2018;05;13;Sunnuntai;52;46;98;11;38;49
292;20.05.2018;2018;05;14;Sunnuntai;34;33;67;11;25;36
292;20.05.2018;2018;05;15;Sunnuntai;46;32;78;14;21;35
292;20.05.2018;2018;05;16;Sunnuntai;59;25;84;12;26;38
292;20.05.2018;2018;05;17;Sunnuntai;51;26;77;23;25;48
292;20.05.2018;2018;05;18;Sunnuntai;39;38;77;14;34;48
292;20.05.2018;2018;05;19;Sunnuntai;45;42;87;5;14;19
292;20.05.2018;2018;05;20;Sunnuntai;31;20;51;13;22;35
292;20.05.2018;2018;05;21;Sunnuntai;11;7;18;5;7;12
292;20.05.2018;2018;05;22;Sunnuntai;1;6;7;2;3;5
292;20.05.2018;2018;05;23;Sunnuntai;1;2;3;1;0;1
292;21.05.2018;2018;05;00;Maanantai;0;2;2;3;2;5
292;21.05.2018;2018;05;01;Maanantai;0;2;2;0;2;2
292;21.05.2018;2018;05;02;Maanantai;0;0;0;0;0;0
292;21.05.2018;2018;05;03;Maanantai;0;0;0;0;0;0
292;21.05.2018;2018;05;04;Maanantai;1;2;3;0;0;0
292;21.05.2018;2018;05;05;Maanantai;11;4;15;1;2;3
292;21.05.2018;2018;05;06;Maanantai;31;15;46;3;5;8
292;21.05.2018;2018;05;07;Maanantai;54;43;97;8;4;12
292;21.05.2018;2018;05;08;Maanantai;41;38;79;5;9;14
292;21.05.2018;2018;05;09;Maanantai;57;51;108;14;8;22
292;21.05.2018;2018;05;10;Maanantai;28;28;56;4;9;13
292;21.05.2018;2018;05;11;Maanantai;43;35;78;4;13;17
292;21.05.2018;2018;05;12;Maanantai;35;36;71;10;27;37
292;21.05.2018;2018;05;13;Maanantai;38;51;89;13;43;56
292;21.05.2018;2018;05;14;Maanantai;68;74;142;20;37;57
292;21.05.2018;2018;05;15;Maanantai;68;77;145;13;39;52
292;21.05.2018;2018;05;16;Maanantai;88;72;160;28;47;75
292;21.05.2018;2018;05;17;Maanantai;90;53;143;32;61;93
292;21.05.2018;2018;05;18;Maanantai;95;50;145;32;50;82
292;21.05.2018;2018;05;19;Maanantai;74;64;138;31;34;65
292;21.05.2018;2018;05;20;Maanantai;52;46;98;16;45;61
292;21.05.2018;2018;05;21;Maanantai;20;17;37;5;9;14
292;21.05.2018;2018;05;22;Maanantai;6;5;11;2;5;7
292;21.05.2018;2018;05;23;Maanantai;1;1;2;1;0;1
292;22.05.2018;2018;05;00;Tiistai;0;2;2;1;2;3
292;22.05.2018;2018;05;01;Tiistai;0;0;0;2;0;2
292;22.05.2018;2018;05;02;Tiistai;0;0;0;2;0;2
292;22.05.2018;2018;05;03;Tiistai;1;0;1;0;0;0
292;22.05.2018;2018;05;04;Tiistai;3;2;5;0;0;0
292;22.05.2018;2018;05;05;Tiistai;11;8;19;3;4;7
292;22.05.2018;2018;05;06;Tiistai;40;26;66;0;9;9
292;22.05.2018;2018;05;07;Tiistai;59;56;115;6;6;12
292;22.05.2018;2018;05;08;Tiistai;67;66;133;10;5;15
292;22.05.2018;2018;05;09;Tiistai;29;28;57;1;10;11
292;22.05.2018;2018;05;10;Tiistai;36;26;62;7;10;17
292;22.05.2018;2018;05;11;Tiistai;46;25;71;6;30;36
292;22.05.2018;2018;05;12;Tiistai;41;25;66;18;36;54
292;22.05.2018;2018;05;13;Tiistai;49;59;108;20;37;57
292;22.05.2018;2018;05;14;Tiistai;60;112;172;17;45;62
292;22.05.2018;2018;05;15;Tiistai;73;61;134;25;46;71
292;22.05.2018;2018;05;16;Tiistai;66;62;128;19;49;68
292;22.05.2018;2018;05;17;Tiistai;86;40;126;21;50;71
292;22.05.2018;2018;05;18;Tiistai;52;51;103;20;43;63
292;22.05.2018;2018;05;19;Tiistai;69;47;116;23;34;57
292;22.05.2018;2018;05;20;Tiistai;46;30;76;11;24;35
292;22.05.2018;2018;05;21;Tiistai;19;22;41;7;8;15
292;22.05.2018;2018;05;22;Tiistai;8;6;14;0;4;4
292;22.05.2018;2018;05;23;Tiistai;1;2;3;0;3;3
292;23.05.2018;2018;05;00;Keskiviikko;2;0;2;3;3;6
292;23.05.2018;2018;05;01;Keskiviikko;0;2;2;0;0;0
292;23.05.2018;2018;05;02;Keskiviikko;0;1;1;0;0;0
292;23.05.2018;2018;05;03;Keskiviikko;0;0;0;0;0;0
292;23.05.2018;2018;05;04;Keskiviikko;2;0;2;0;2;2
292;23.05.2018;2018;05;05;Keskiviikko;6;2;8;2;6;8
292;23.05.2018;2018;05;06;Keskiviikko;32;21;53;4;8;12
292;23.05.2018;2018;05;07;Keskiviikko;72;54;126;2;3;5
292;23.05.2018;2018;05;08;Keskiviikko;48;41;89;9;10;19
292;23.05.2018;2018;05;09;Keskiviikko;30;23;53;2;9;11
292;23.05.2018;2018;05;10;Keskiviikko;25;25;50;5;7;12
292;23.05.2018;2018;05;11;Keskiviikko;22;29;51;7;13;20
292;23.05.2018;2018;05;12;Keskiviikko;28;36;64;6;18;24
292;23.05.2018;2018;05;13;Keskiviikko;45;56;101;11;35;46
292;23.05.2018;2018;05;14;Keskiviikko;33;53;86;10;38;48
292;23.05.2018;2018;05;15;Keskiviikko;58;53;111;12;30;42
292;23.05.2018;2018;05;16;Keskiviikko;61;55;116;14;39;53
292;23.05.2018;2018;05;17;Keskiviikko;52;42;94;20;27;47
292;23.05.2018;2018;05;18;Keskiviikko;43;33;76;18;28;46
292;23.05.2018;2018;05;19;Keskiviikko;40;22;62;25;24;49
292;23.05.2018;2018;05;20;Keskiviikko;45;26;71;16;22;38
292;23.05.2018;2018;05;21;Keskiviikko;12;16;28;9;20;29
292;23.05.2018;2018;05;22;Keskiviikko;8;5;13;3;0;3
292;23.05.2018;2018;05;23;Keskiviikko;0;2;2;0;3;3
292;24.05.2018;2018;05;00;Torstai;3;2;5;3;0;3
292;24.05.2018;2018;05;01;Torstai;0;1;1;0;0;0
292;24.05.2018;2018;05;02;Torstai;0;0;0;0;0;0
292;24.05.2018;2018;05;03;Torstai;0;0;0;0;0;0
292;24.05.2018;2018;05;04;Torstai;4;0;4;1;3;4
292;24.05.2018;2018;05;05;Torstai;7;5;12;3;1;4
292;24.05.2018;2018;05;06;Torstai;31;23;54;1;9;10
292;24.05.2018;2018;05;07;Torstai;56;49;105;1;4;5
292;24.05.2018;2018;05;08;Torstai;42;42;84;10;4;14
292;24.05.2018;2018;05;09;Torstai;45;43;88;4;7;11
292;24.05.2018;2018;05;10;Torstai;35;31;66;3;13;16
292;24.05.2018;2018;05;11;Torstai;38;28;66;7;8;15
292;24.05.2018;2018;05;12;Torstai;53;24;77;9;20;29
292;24.05.2018;2018;05;13;Torstai;35;49;84;16;34;50
292;24.05.2018;2018;05;14;Torstai;64;58;122;12;31;43
292;24.05.2018;2018;05;15;Torstai;45;76;121;16;40;56
292;24.05.2018;2018;05;16;Torstai;49;44;93;10;39;49
292;24.05.2018;2018;05;17;Torstai;53;30;83;19;28;47
292;24.05.2018;2018;05;18;Torstai;34;30;64;19;27;46
292;24.05.2018;2018;05;19;Torstai;45;24;69;25;29;54
292;24.05.2018;2018;05;20;Torstai;33;12;45;11;20;31
292;24.05.2018;2018;05;21;Torstai;17;15;32;5;12;17
292;24.05.2018;2018;05;22;Torstai;9;8;17;1;2;3
292;24.05.2018;2018;05;23;Torstai;1;1;2;5;3;8
292;25.05.2018;2018;05;00;Perjantai;0;2;2;0;3;3
292;25.05.2018;2018;05;01;Perjantai;0;3;3;0;1;1
292;25.05.2018;2018;05;02;Perjantai;0;0;0;3;1;4
292;25.05.2018;2018;05;03;Perjantai;0;0;0;0;0;0
292;25.05.2018;2018;05;04;Perjantai;2;0;2;0;0;0
292;25.05.2018;2018;05;05;Perjantai;10;4;14;2;3;5
292;25.05.2018;2018;05;06;Perjantai;28;15;43;4;3;7
292;25.05.2018;2018;05;07;Perjantai;65;62;127;8;2;10
292;25.05.2018;2018;05;08;Perjantai;46;43;89;7;14;21
292;25.05.2018;2018;05;09;Perjantai;27;28;55;4;10;14
292;25.05.2018;2018;05;10;Perjantai;27;33;60;14;19;33
292;25.05.2018;2018;05;11;Perjantai;25;33;58;11;34;45
292;25.05.2018;2018;05;12;Perjantai;68;44;112;18;47;65
292;25.05.2018;2018;05;13;Perjantai;43;45;88;14;37;51
292;25.05.2018;2018;05;14;Perjantai;51;52;103;23;39;62
292;25.05.2018;2018;05;15;Perjantai;65;57;122;24;50;74
292;25.05.2018;2018;05;16;Perjantai;77;45;122;13;36;49
292;25.05.2018;2018;05;17;Perjantai;55;49;104;16;30;46
292;25.05.2018;2018;05;18;Perjantai;60;51;111;21;26;47
292;25.05.2018;2018;05;19;Perjantai;56;37;93;17;35;52
292;25.05.2018;2018;05;20;Perjantai;39;41;80;14;32;46
292;25.05.2018;2018;05;21;Perjantai;19;27;46;8;23;31
292;25.05.2018;2018;05;22;Perjantai;20;13;33;10;10;20
292;25.05.2018;2018;05;23;Perjantai;12;8;20;10;5;15
292;26.05.2018;2018;05;00;Lauantai;7;12;19;3;1;4
292;26.05.2018;2018;05;01;Lauantai;4;3;7;2;1;3
292;26.05.2018;2018;05;02;Lauantai;0;6;6;4;2;6
292;26.05.2018;2018;05;03;Lauantai;3;1;4;3;0;3
292;26.05.2018;2018;05;04;Lauantai;0;1;1;0;4;4
292;26.05.2018;2018;05;05;Lauantai;4;3;7;6;1;7
292;26.05.2018;2018;05;06;Lauantai;7;2;9;2;3;5
292;26.05.2018;2018;05;07;Lauantai;14;14;28;1;3;4
292;26.05.2018;2018;05;08;Lauantai;20;15;35;3;4;7
292;26.05.2018;2018;05;09;Lauantai;17;22;39;2;4;6
292;26.05.2018;2018;05;10;Lauantai;21;33;54;10;12;22
292;26.05.2018;2018;05;11;Lauantai;38;35;73;4;43;47
292;26.05.2018;2018;05;12;Lauantai;53;29;82;5;13;18
292;26.05.2018;2018;05;13;Lauantai;37;32;69;11;24;35
292;26.05.2018;2018;05;14;Lauantai;57;22;79;8;20;28
292;26.05.2018;2018;05;15;Lauantai;38;34;72;9;21;30
292;26.05.2018;2018;05;16;Lauantai;72;27;99;16;23;39
292;26.05.2018;2018;05;17;Lauantai;38;29;67;8;17;25
292;26.05.2018;2018;05;18;Lauantai;42;24;66;17;14;31
292;26.05.2018;2018;05;19;Lauantai;24;36;60;9;28;37
292;26.05.2018;2018;05;20;Lauantai;22;15;37;11;8;19
292;26.05.2018;2018;05;21;Lauantai;12;11;23;6;10;16
292;26.05.2018;2018;05;22;Lauantai;8;9;17;5;3;8
292;26.05.2018;2018;05;23;Lauantai;14;4;18;4;1;5
292;27.05.2018;2018;05;00;Sunnuntai;6;9;15;7;4;11
292;27.05.2018;2018;05;01;Sunnuntai;1;4;5;3;2;5
292;27.05.2018;2018;05;02;Sunnuntai;0;1;1;1;0;1
292;27.05.2018;2018;05;03;Sunnuntai;0;2;2;0;4;4
292;27.05.2018;2018;05;04;Sunnuntai;0;1;1;0;4;4
292;27.05.2018;2018;05;05;Sunnuntai;2;4;6;2;2;4
292;27.05.2018;2018;05;06;Sunnuntai;7;1;8;0;2;2
292;27.05.2018;2018;05;07;Sunnuntai;5;5;10;2;8;10
292;27.05.2018;2018;05;08;Sunnuntai;9;9;18;0;3;3
292;27.05.2018;2018;05;09;Sunnuntai;23;15;38;7;3;10
292;27.05.2018;2018;05;10;Sunnuntai;17;33;50;8;22;30
292;27.05.2018;2018;05;11;Sunnuntai;35;46;81;16;27;43
292;27.05.2018;2018;05;12;Sunnuntai;47;36;83;10;32;42
292;27.05.2018;2018;05;13;Sunnuntai;49;42;91;19;32;51
292;27.05.2018;2018;05;14;Sunnuntai;52;40;92;20;28;48
292;27.05.2018;2018;05;15;Sunnuntai;43;45;88;10;24;34
292;27.05.2018;2018;05;16;Sunnuntai;55;15;70;12;18;30
292;27.05.2018;2018;05;17;Sunnuntai;35;32;67;12;26;38
292;27.05.2018;2018;05;18;Sunnuntai;48;28;76;17;33;50
292;27.05.2018;2018;05;19;Sunnuntai;43;33;76;11;35;46
292;27.05.2018;2018;05;20;Sunnuntai;28;18;46;9;15;24
292;27.05.2018;2018;05;21;Sunnuntai;6;9;15;1;7;8
292;27.05.2018;2018;05;22;Sunnuntai;5;4;9;1;4;5
292;27.05.2018;2018;05;23;Sunnuntai;1;0;1;0;1;1
292;28.05.2018;2018;05;00;Maanantai;0;0;0;4;1;5
292;28.05.2018;2018;05;01;Maanantai;0;1;1;0;1;1
292;28.05.2018;2018;05;02;Maanantai;0;0;0;0;0;0
292;28.05.2018;2018;05;03;Maanantai;0;0;0;0;0;0
292;28.05.2018;2018;05;04;Maanantai;0;1;1;0;0;0
292;28.05.2018;2018;05;05;Maanantai;12;9;21;1;6;7
292;28.05.2018;2018;05;06;Maanantai;21;20;41;2;2;4
292;28.05.2018;2018;05;07;Maanantai;71;46;117;5;10;15
292;28.05.2018;2018;05;08;Maanantai;57;52;109;14;8;22
292;28.05.2018;2018;05;09;Maanantai;30;34;64;7;9;16
292;28.05.2018;2018;05;10;Maanantai;29;39;68;5;21;26
292;28.05.2018;2018;05;11;Maanantai;34;41;75;7;29;36
292;28.05.2018;2018;05;12;Maanantai;45;36;81;19;23;42
292;28.05.2018;2018;05;13;Maanantai;42;61;103;15;36;51
292;28.05.2018;2018;05;14;Maanantai;62;52;114;19;40;59
292;28.05.2018;2018;05;15;Maanantai;70;71;141;15;40;55
292;28.05.2018;2018;05;16;Maanantai;86;43;129;24;65;89
292;28.05.2018;2018;05;17;Maanantai;67;48;115;23;47;70
292;28.05.2018;2018;05;18;Maanantai;70;55;125;23;43;66
292;28.05.2018;2018;05;19;Maanantai;54;33;87;17;37;54
292;28.05.2018;2018;05;20;Maanantai;58;21;79;12;23;35
292;28.05.2018;2018;05;21;Maanantai;12;11;23;4;7;11
292;28.05.2018;2018;05;22;Maanantai;6;3;9;5;7;12
292;28.05.2018;2018;05;23;Maanantai;0;1;1;0;0;0
292;29.05.2018;2018;05;00;Tiistai;2;1;3;1;2;3
292;29.05.2018;2018;05;01;Tiistai;2;0;2;0;1;1
292;29.05.2018;2018;05;02;Tiistai;0;1;1;0;0;0
292;29.05.2018;2018;05;03;Tiistai;1;0;1;0;0;0
292;29.05.2018;2018;05;04;Tiistai;1;1;2;0;0;0
292;29.05.2018;2018;05;05;Tiistai;7;9;16;4;4;8
292;29.05.2018;2018;05;06;Tiistai;44;11;55;8;12;20
292;29.05.2018;2018;05;07;Tiistai;69;41;110;3;9;12
292;29.05.2018;2018;05;08;Tiistai;66;50;116;7;14;21
292;29.05.2018;2018;05;09;Tiistai;44;56;100;5;14;19
292;29.05.2018;2018;05;10;Tiistai;41;46;87;5;12;17
292;29.05.2018;2018;05;11;Tiistai;38;69;107;8;41;49
292;29.05.2018;2018;05;12;Tiistai;37;32;69;14;27;41
292;29.05.2018;2018;05;13;Tiistai;96;74;170;26;47;73
292;29.05.2018;2018;05;14;Tiistai;66;38;104;15;31;46
292;29.05.2018;2018;05;15;Tiistai;73;44;117;16;37;53
292;29.05.2018;2018;05;16;Tiistai;69;49;118;15;36;51
292;29.05.2018;2018;05;17;Tiistai;49;46;95;14;41;55
292;29.05.2018;2018;05;18;Tiistai;53;29;82;24;33;57
292;29.05.2018;2018;05;19;Tiistai;56;57;113;11;20;31
292;29.05.2018;2018;05;20;Tiistai;39;19;58;12;19;31
292;29.05.2018;2018;05;21;Tiistai;9;15;24;4;11;15
292;29.05.2018;2018;05;22;Tiistai;4;5;9;3;0;3
292;29.05.2018;2018;05;23;Tiistai;0;0;0;1;1;2
292;30.05.2018;2018;05;00;Keskiviikko;0;0;0;0;0;0
292;30.05.2018;2018;05;01;Keskiviikko;0;1;1;1;0;1
292;30.05.2018;2018;05;02;Keskiviikko;0;1;1;0;0;0
292;30.05.2018;2018;05;03;Keskiviikko;0;0;0;0;0;0
292;30.05.2018;2018;05;04;Keskiviikko;0;1;1;0;1;1
292;30.05.2018;2018;05;05;Keskiviikko;5;9;14;2;8;10
292;30.05.2018;2018;05;06;Keskiviikko;32;18;50;3;7;10
292;30.05.2018;2018;05;07;Keskiviikko;52;42;94;2;6;8
292;30.05.2018;2018;05;08;Keskiviikko;66;49;115;7;15;22
292;30.05.2018;2018;05;09;Keskiviikko;37;44;81;4;8;12
292;30.05.2018;2018;05;10;Keskiviikko;36;45;81;8;10;18
292;30.05.2018;2018;05;11;Keskiviikko;32;53;85;10;42;52
292;30.05.2018;2018;05;12;Keskiviikko;37;51;88;5;29;34
292;30.05.2018;2018;05;13;Keskiviikko;59;77;136;14;38;52
292;30.05.2018;2018;05;14;Keskiviikko;48;36;84;12;25;37
292;30.05.2018;2018;05;15;Keskiviikko;53;57;110;17;42;59
292;30.05.2018;2018;05;16;Keskiviikko;72;57;129;13;34;47
292;30.05.2018;2018;05;17;Keskiviikko;65;42;107;11;22;33
292;30.05.2018;2018;05;18;Keskiviikko;58;45;103;17;28;45
292;30.05.2018;2018;05;19;Keskiviikko;40;38;78;20;37;57
292;30.05.2018;2018;05;20;Keskiviikko;39;28;67;11;24;35
292;30.05.2018;2018;05;21;Keskiviikko;12;8;20;7;5;12
292;30.05.2018;2018;05;22;Keskiviikko;6;5;11;4;4;8
292;30.05.2018;2018;05;23;Keskiviikko;1;1;2;0;1;1
292;31.05.2018;2018;05;00;Torstai;1;2;3;2;0;2
292;31.05.2018;2018;05;01;Torstai;1;1;2;0;3;3
292;31.05.2018;2018;05;02;Torstai;0;1;1;0;1;1
292;31.05.2018;2018;05;03;Torstai;1;0;1;0;0;0
292;31.05.2018;2018;05;04;Torstai;1;1;2;0;0;0
292;31.05.2018;2018;05;05;Torstai;6;7;13;3;4;7
292;31.05.2018;2018;05;06;Torstai;27;22;49;0;6;6
292;31.05.2018;2018;05;07;Torstai;49;45;94;1;5;6
292;31.05.2018;2018;05;08;Torstai;69;59;128;9;5;14
292;31.05.2018;2018;05;09;Torstai;36;39;75;10;10;20
292;31.05.2018;2018;05;10;Torstai;24;28;52;2;16;18
292;31.05.2018;2018;05;11;Torstai;21;37;58;6;25;31
292;31.05.2018;2018;05;12;Torstai;46;31;77;17;29;46
292;31.05.2018;2018;05;13;Torstai;42;70;112;20;46;66
292;31.05.2018;2018;05;14;Torstai;51;39;90;15;29;44
292;31.05.2018;2018;05;15;Torstai;59;41;100;18;29;47
292;31.05.2018;2018;05;16;Torstai;68;53;121;16;29;45
292;31.05.2018;2018;05;17;Torstai;58;40;98;24;19;43
292;31.05.2018;2018;05;18;Torstai;48;58;106;13;37;50
292;31.05.2018;2018;05;19;Torstai;53;35;88;10;23;33
292;31.05.2018;2018;05;20;Torstai;32;20;52;9;25;34
292;31.05.2018;2018;05;21;Torstai;10;11;21;6;12;18
292;31.05.2018;2018;05;22;Torstai;9;5;14;3;6;9
292;31.05.2018;2018;05;23;Torstai;1;3;4;0;3;3
292;01.06.2018;2018;06;00;Perjantai;2;0;2;3;0;3
292;01.06.2018;2018;06;01;Perjantai;3;0;3;1;0;1
292;01.06.2018;2018;06;02;Perjantai;0;0;0;4;0;4
292;01.06.2018;2018;06;03;Perjantai;0;0;0;0;0;0
292;01.06.2018;2018;06;04;Perjantai;2;0;2;0;0;0
292;01.06.2018;2018;06;05;Perjantai;14;0;14;5;0;5
292;01.06.2018;2018;06;06;Perjantai;43;0;43;7;0;7
292;01.06.2018;2018;06;07;Perjantai;127;0;127;10;0;10
292;01.06.2018;2018;06;08;Perjantai;89;0;89;21;0;21
292;01.06.2018;2018;06;09;Perjantai;55;0;55;14;0;14
292;01.06.2018;2018;06;10;Perjantai;60;0;60;33;0;33
292;01.06.2018;2018;06;11;Perjantai;58;0;58;45;0;45
292;01.06.2018;2018;06;12;Perjantai;112;0;112;65;0;65
292;01.06.2018;2018;06;13;Perjantai;88;0;88;51;0;51
292;01.06.2018;2018;06;14;Perjantai;103;0;103;62;0;62
292;01.06.2018;2018;06;15;Perjantai;122;0;122;74;0;74
292;01.06.2018;2018;06;16;Perjantai;122;0;122;49;0;49
292;01.06.2018;2018;06;17;Perjantai;104;0;104;46;0;46
292;01.06.2018;2018;06;18;Perjantai;111;0;111;47;0;47
292;01.06.2018;2018;06;19;Perjantai;93;0;93;52;0;52
292;01.06.2018;2018;06;20;Perjantai;80;0;80;46;0;46
292;01.06.2018;2018;06;21;Perjantai;46;0;46;31;0;31
292;01.06.2018;2018;06;22;Perjantai;33;0;33;20;0;20
292;01.06.2018;2018;06;23;Perjantai;20;0;20;15;0;15
292;02.06.2018;2018;06;00;Lauantai;3;3;6;0;4;4
292;02.06.2018;2018;06;01;Lauantai;1;4;5;2;2;4
292;02.06.2018;2018;06;02;Lauantai;0;3;3;0;1;1
292;02.06.2018;2018;06;03;Lauantai;0;1;1;1;1;2
292;02.06.2018;2018;06;04;Lauantai;1;3;4;0;2;2
292;02.06.2018;2018;06;05;Lauantai;2;2;4;1;3;4
292;02.06.2018;2018;06;06;Lauantai;3;0;3;0;3;3
292;02.06.2018;2018;06;07;Lauantai;17;14;31;3;0;3
292;02.06.2018;2018;06;08;Lauantai;12;16;28;2;2;4
292;02.06.2018;2018;06;09;Lauantai;21;32;53;8;18;26
292;02.06.2018;2018;06;10;Lauantai;50;45;95;10;21;31
292;02.06.2018;2018;06;11;Lauantai;47;35;82;11;31;42
292;02.06.2018;2018;06;12;Lauantai;59;44;103;12;18;30
292;02.06.2018;2018;06;13;Lauantai;47;39;86;5;28;33
292;02.06.2018;2018;06;14;Lauantai;55;32;87;9;36;45
292;02.06.2018;2018;06;15;Lauantai;37;27;64;12;22;34
292;02.06.2018;2018;06;16;Lauantai;67;27;94;18;26;44
292;02.06.2018;2018;06;17;Lauantai;36;32;68;21;16;37
292;02.06.2018;2018;06;18;Lauantai;36;31;67;15;23;38
292;02.06.2018;2018;06;19;Lauantai;34;35;69;13;21;34
292;02.06.2018;2018;06;20;Lauantai;34;18;52;15;20;35
292;02.06.2018;2018;06;21;Lauantai;17;16;33;12;10;22
292;02.06.2018;2018;06;22;Lauantai;11;14;25;5;7;12
292;02.06.2018;2018;06;23;Lauantai;15;8;23;9;15;24
292;03.06.2018;2018;06;00;Sunnuntai;9;12;21;10;6;16
292;03.06.2018;2018;06;01;Sunnuntai;3;5;8;3;3;6
292;03.06.2018;2018;06;02;Sunnuntai;6;2;8;3;7;10
292;03.06.2018;2018;06;03;Sunnuntai;0;5;5;0;10;10
292;03.06.2018;2018;06;04;Sunnuntai;0;2;2;1;1;2
292;03.06.2018;2018;06;05;Sunnuntai;3;0;3;4;9;13
292;03.06.2018;2018;06;06;Sunnuntai;2;1;3;5;7;12
292;03.06.2018;2018;06;07;Sunnuntai;4;5;9;7;7;14
292;03.06.2018;2018;06;08;Sunnuntai;15;7;22;8;4;12
292;03.06.2018;2018;06;09;Sunnuntai;13;11;24;8;11;19
292;03.06.2018;2018;06;10;Sunnuntai;39;23;62;14;31;45
292;03.06.2018;2018;06;11;Sunnuntai;30;37;67;6;30;36
292;03.06.2018;2018;06;12;Sunnuntai;53;32;85;11;29;40
292;03.06.2018;2018;06;13;Sunnuntai;45;39;84;18;26;44
292;03.06.2018;2018;06;14;Sunnuntai;48;31;79;24;26;50
292;03.06.2018;2018;06;15;Sunnuntai;49;38;87;10;13;23
292;03.06.2018;2018;06;16;Sunnuntai;48;38;86;17;16;33
292;03.06.2018;2018;06;17;Sunnuntai;37;29;66;19;28;47
292;03.06.2018;2018;06;18;Sunnuntai;40;33;73;11;31;42
292;03.06.2018;2018;06;19;Sunnuntai;29;18;47;9;14;23
292;03.06.2018;2018;06;20;Sunnuntai;17;17;34;8;6;14
292;03.06.2018;2018;06;21;Sunnuntai;16;6;22;4;9;13
292;03.06.2018;2018;06;22;Sunnuntai;2;4;6;3;2;5
292;03.06.2018;2018;06;23;Sunnuntai;1;5;6;1;3;4
292;04.06.2018;2018;06;00;Maanantai;3;4;7;2;3;5
292;04.06.2018;2018;06;01;Maanantai;0;0;0;0;1;1
292;04.06.2018;2018;06;02;Maanantai;7;3;10;4;1;5
292;04.06.2018;2018;06;03;Maanantai;1;0;1;0;0;0
292;04.06.2018;2018;06;04;Maanantai;4;2;6;0;0;0
292;04.06.2018;2018;06;05;Maanantai;5;4;9;0;3;3
292;04.06.2018;2018;06;06;Maanantai;18;8;26;3;9;12
292;04.06.2018;2018;06;07;Maanantai;24;13;37;1;14;15
292;04.06.2018;2018;06;08;Maanantai;18;13;31;9;16;25
292;04.06.2018;2018;06;09;Maanantai;13;9;22;4;13;17
292;04.06.2018;2018;06;10;Maanantai;16;8;24;8;6;14
292;04.06.2018;2018;06;11;Maanantai;17;20;37;3;15;18
292;04.06.2018;2018;06;12;Maanantai;19;28;47;6;12;18
292;04.06.2018;2018;06;13;Maanantai;18;14;32;13;14;27
292;04.06.2018;2018;06;14;Maanantai;27;22;49;12;11;23
292;04.06.2018;2018;06;15;Maanantai;29;29;58;13;22;35
292;04.06.2018;2018;06;16;Maanantai;31;29;60;14;29;43
292;04.06.2018;2018;06;17;Maanantai;21;20;41;19;12;31
292;04.06.2018;2018;06;18;Maanantai;13;11;24;7;9;16
292;04.06.2018;2018;06;19;Maanantai;10;5;15;13;13;26
292;04.06.2018;2018;06;20;Maanantai;12;4;16;7;6;13
292;04.06.2018;2018;06;21;Maanantai;5;2;7;7;8;15
292;04.06.2018;2018;06;22;Maanantai;9;2;11;3;1;4
292;04.06.2018;2018;06;23;Maanantai;1;2;3;1;1;2
292;05.06.2018;2018;06;00;Tiistai;1;1;2;0;0;0
292;05.06.2018;2018;06;01;Tiistai;0;0;0;0;2;2
292;05.06.2018;2018;06;02;Tiistai;0;0;0;0;0;0
292;05.06.2018;2018;06;03;Tiistai;0;0;0;0;0;0
292;05.06.2018;2018;06;04;Tiistai;2;0;2;0;0;0
292;05.06.2018;2018;06;05;Tiistai;6;5;11;0;1;1
292;05.06.2018;2018;06;06;Tiistai;17;9;26;4;5;9
292;05.06.2018;2018;06;07;Tiistai;22;17;39;5;5;10
292;05.06.2018;2018;06;08;Tiistai;17;17;34;12;8;20
292;05.06.2018;2018;06;09;Tiistai;11;12;23;5;10;15
292;05.06.2018;2018;06;10;Tiistai;20;21;41;4;9;13
292;05.06.2018;2018;06;11;Tiistai;21;18;39;7;18;25
292;05.06.2018;2018;06;12;Tiistai;27;29;56;7;26;33
292;05.06.2018;2018;06;13;Tiistai;35;26;61;12;16;28
292;05.06.2018;2018;06;14;Tiistai;35;24;59;14;14;28
292;05.06.2018;2018;06;15;Tiistai;28;47;75;10;16;26
292;05.06.2018;2018;06;16;Tiistai;55;30;85;11;25;36
292;05.06.2018;2018;06;17;Tiistai;32;29;61;10;18;28
292;05.06.2018;2018;06;18;Tiistai;28;24;52;16;25;41
292;05.06.2018;2018;06;19;Tiistai;22;27;49;8;15;23
292;05.06.2018;2018;06;20;Tiistai;26;23;49;14;15;29
292;05.06.2018;2018;06;21;Tiistai;16;11;27;4;6;10
292;05.06.2018;2018;06;22;Tiistai;8;5;13;4;5;9
292;05.06.2018;2018;06;23;Tiistai;0;3;3;1;5;6
292;06.06.2018;2018;06;00;Keskiviikko;0;2;2;0;0;0
292;06.06.2018;2018;06;01;Keskiviikko;1;3;4;0;2;2
292;06.06.2018;2018;06;02;Keskiviikko;2;1;3;1;0;1
292;06.06.2018;2018;06;03;Keskiviikko;0;0;0;0;0;0
292;06.06.2018;2018;06;04;Keskiviikko;1;0;1;0;0;0
292;06.06.2018;2018;06;05;Keskiviikko;5;4;9;2;3;5
292;06.06.2018;2018;06;06;Keskiviikko;21;12;33;2;6;8
292;06.06.2018;2018;06;07;Keskiviikko;33;29;62;2;10;12
292;06.06.2018;2018;06;08;Keskiviikko;23;25;48;9;10;19
292;06.06.2018;2018;06;09;Keskiviikko;16;18;34;16;12;28
292;06.06.2018;2018;06;10;Keskiviikko;28;23;51;8;18;26
292;06.06.2018;2018;06;11;Keskiviikko;31;23;54;12;13;25
292;06.06.2018;2018;06;12;Keskiviikko;28;33;61;6;8;14
292;06.06.2018;2018;06;13;Keskiviikko;45;37;82;8;17;25
292;06.06.2018;2018;06;14;Keskiviikko;35;39;74;12;16;28
292;06.06.2018;2018;06;15;Keskiviikko;54;43;97;17;13;30
292;06.06.2018;2018;06;16;Keskiviikko;54;34;88;8;18;26
292;06.06.2018;2018;06;17;Keskiviikko;32;31;63;12;29;41
292;06.06.2018;2018;06;18;Keskiviikko;38;35;73;11;10;21
292;06.06.2018;2018;06;19;Keskiviikko;34;25;59;4;10;14
292;06.06.2018;2018;06;20;Keskiviikko;16;14;30;10;11;21
292;06.06.2018;2018;06;21;Keskiviikko;16;14;30;7;8;15
292;06.06.2018;2018;06;22;Keskiviikko;7;8;15;3;0;3
292;06.06.2018;2018;06;23;Keskiviikko;0;3;3;1;1;2
292;07.06.2018;2018;06;00;Torstai;0;2;2;0;0;0
292;07.06.2018;2018;06;01;Torstai;0;0;0;0;2;2
292;07.06.2018;2018;06;02;Torstai;1;1;2;0;0;0
292;07.06.2018;2018;06;03;Torstai;1;1;2;0;0;0
292;07.06.2018;2018;06;04;Torstai;2;0;2;0;0;0
292;07.06.2018;2018;06;05;Torstai;5;6;11;0;0;0
292;07.06.2018;2018;06;06;Torstai;10;10;20;2;3;5
292;07.06.2018;2018;06;07;Torstai;18;15;33;2;4;6
292;07.06.2018;2018;06;08;Torstai;13;10;23;5;4;9
292;07.06.2018;2018;06;09;Torstai;6;6;12;2;3;5
292;07.06.2018;2018;06;10;Torstai;10;9;19;2;3;5
292;07.06.2018;2018;06;11;Torstai;8;7;15;3;4;7
292;07.06.2018;2018;06;12;Torstai;14;13;27;2;5;7
292;07.06.2018;2018;06;13;Torstai;15;13;28;7;10;17
292;07.06.2018;2018;06;14;Torstai;20;11;31;11;8;19
292;07.06.2018;2018;06;15;Torstai;25;25;50;4;8;12
292;07.06.2018;2018;06;16;Torstai;23;20;43;5;10;15
292;07.06.2018;2018;06;17;Torstai;30;18;48;16;14;30
292;07.06.2018;2018;06;18;Torstai;27;22;49;8;19;27
292;07.06.2018;2018;06;19;Torstai;28;24;52;18;18;36
292;07.06.2018;2018;06;20;Torstai;25;17;42;4;17;21
292;07.06.2018;2018;06;21;Torstai;17;5;22;13;5;18
292;07.06.2018;2018;06;22;Torstai;4;4;8;2;9;11
292;07.06.2018;2018;06;23;Torstai;1;1;2;2;0;2
292;08.06.2018;2018;06;00;Perjantai;4;2;6;1;1;2
292;08.06.2018;2018;06;01;Perjantai;0;3;3;0;1;1
292;08.06.2018;2018;06;02;Perjantai;1;0;1;1;0;1
292;08.06.2018;2018;06;03;Perjantai;0;0;0;0;0;0
292;08.06.2018;2018;06;04;Perjantai;1;0;1;0;0;0
292;08.06.2018;2018;06;05;Perjantai;5;7;12;2;1;3
292;08.06.2018;2018;06;06;Perjantai;16;7;23;2;10;12
292;08.06.2018;2018;06;07;Perjantai;26;23;49;0;3;3
292;08.06.2018;2018;06;08;Perjantai;24;19;43;6;5;11
292;08.06.2018;2018;06;09;Perjantai;25;19;44;4;10;14
292;08.06.2018;2018;06;10;Perjantai;24;26;50;6;10;16
292;08.06.2018;2018;06;11;Perjantai;30;38;68;9;15;24
292;08.06.2018;2018;06;12;Perjantai;43;25;68;16;23;39
292;08.06.2018;2018;06;13;Perjantai;36;29;65;18;35;53
292;08.06.2018;2018;06;14;Perjantai;44;42;86;9;17;26
292;08.06.2018;2018;06;15;Perjantai;61;30;91;17;23;40
292;08.06.2018;2018;06;16;Perjantai;44;29;73;13;31;44
292;08.06.2018;2018;06;17;Perjantai;41;35;76;13;23;36
292;08.06.2018;2018;06;18;Perjantai;35;23;58;18;32;50
292;08.06.2018;2018;06;19;Perjantai;30;25;55;15;20;35
292;08.06.2018;2018;06;20;Perjantai;20;14;34;7;19;26
292;08.06.2018;2018;06;21;Perjantai;28;12;40;4;7;11
292;08.06.2018;2018;06;22;Perjantai;13;8;21;3;5;8
292;08.06.2018;2018;06;23;Perjantai;7;3;10;3;2;5
292;09.06.2018;2018;06;00;Lauantai;5;3;8;5;4;9
292;09.06.2018;2018;06;01;Lauantai;0;7;7;0;4;4
292;09.06.2018;2018;06;02;Lauantai;4;1;5;8;5;13
292;09.06.2018;2018;06;03;Lauantai;0;2;2;0;3;3
292;09.06.2018;2018;06;04;Lauantai;2;3;5;1;3;4
292;09.06.2018;2018;06;05;Lauantai;2;4;6;2;1;3
292;09.06.2018;2018;06;06;Lauantai;3;1;4;1;2;3
292;09.06.2018;2018;06;07;Lauantai;7;4;11;3;3;6
292;09.06.2018;2018;06;08;Lauantai;16;14;30;6;2;8
292;09.06.2018;2018;06;09;Lauantai;19;16;35;5;9;14
292;09.06.2018;2018;06;10;Lauantai;41;20;61;5;13;18
292;09.06.2018;2018;06;11;Lauantai;21;20;41;4;12;16
292;09.06.2018;2018;06;12;Lauantai;38;41;79;17;19;36
292;09.06.2018;2018;06;13;Lauantai;32;22;54;8;19;27
292;09.06.2018;2018;06;14;Lauantai;34;16;50;8;25;33
292;09.06.2018;2018;06;15;Lauantai;32;28;60;13;13;26
292;09.06.2018;2018;06;16;Lauantai;34;21;55;9;13;22
292;09.06.2018;2018;06;17;Lauantai;32;19;51;10;7;17
292;09.06.2018;2018;06;18;Lauantai;37;17;54;18;25;43
292;09.06.2018;2018;06;19;Lauantai;31;17;48;16;17;33
292;09.06.2018;2018;06;20;Lauantai;13;21;34;5;13;18
292;09.06.2018;2018;06;21;Lauantai;16;6;22;8;4;12
292;09.06.2018;2018;06;22;Lauantai;7;12;19;4;2;6
292;09.06.2018;2018;06;23;Lauantai;10;8;18;5;6;11
292;10.06.2018;2018;06;00;Sunnuntai;6;3;9;1;0;1
292;10.06.2018;2018;06;01;Sunnuntai;3;7;10;6;4;10
292;10.06.2018;2018;06;02;Sunnuntai;2;6;8;2;2;4
292;10.06.2018;2018;06;03;Sunnuntai;4;0;4;1;8;9
292;10.06.2018;2018;06;04;Sunnuntai;1;2;3;1;1;2
292;10.06.2018;2018;06;05;Sunnuntai;1;2;3;1;2;3
292;10.06.2018;2018;06;06;Sunnuntai;4;3;7;0;3;3
292;10.06.2018;2018;06;07;Sunnuntai;2;2;4;1;1;2
292;10.06.2018;2018;06;08;Sunnuntai;9;1;10;5;3;8
292;10.06.2018;2018;06;09;Sunnuntai;15;13;28;11;10;21
292;10.06.2018;2018;06;10;Sunnuntai;20;18;38;7;7;14
292;10.06.2018;2018;06;11;Sunnuntai;25;20;45;11;17;28
292;10.06.2018;2018;06;12;Sunnuntai;55;22;77;9;18;27
292;10.06.2018;2018;06;13;Sunnuntai;39;23;62;4;24;28
292;10.06.2018;2018;06;14;Sunnuntai;54;26;80;18;26;44
292;10.06.2018;2018;06;15;Sunnuntai;80;23;103;9;25;34
292;10.06.2018;2018;06;16;Sunnuntai;68;42;110;18;20;38
292;10.06.2018;2018;06;17;Sunnuntai;40;29;69;10;35;45
292;10.06.2018;2018;06;18;Sunnuntai;39;33;72;16;29;45
292;10.06.2018;2018;06;19;Sunnuntai;42;51;93;15;39;54
292;10.06.2018;2018;06;20;Sunnuntai;26;17;43;9;20;29
292;10.06.2018;2018;06;21;Sunnuntai;10;15;25;6;5;11
292;10.06.2018;2018;06;22;Sunnuntai;8;14;22;4;6;10
292;10.06.2018;2018;06;23;Sunnuntai;2;2;4;0;0;0
292;11.06.2018;2018;06;00;Maanantai;2;8;10;0;1;1
292;11.06.2018;2018;06;01;Maanantai;1;2;3;1;0;1
292;11.06.2018;2018;06;02;Maanantai;5;1;6;1;0;1
292;11.06.2018;2018;06;03;Maanantai;2;0;2;0;0;0
292;11.06.2018;2018;06;04;Maanantai;3;0;3;0;0;0
292;11.06.2018;2018;06;05;Maanantai;12;7;19;1;5;6
292;11.06.2018;2018;06;06;Maanantai;21;15;36;3;3;6
292;11.06.2018;2018;06;07;Maanantai;33;30;63;10;5;15
292;11.06.2018;2018;06;08;Maanantai;27;28;55;12;13;25
292;11.06.2018;2018;06;09;Maanantai;40;32;72;7;10;17
292;11.06.2018;2018;06;10;Maanantai;27;32;59;9;13;22
292;11.06.2018;2018;06;11;Maanantai;36;33;69;11;14;25
292;11.06.2018;2018;06;12;Maanantai;28;32;60;6;19;25
292;11.06.2018;2018;06;13;Maanantai;49;32;81;11;21;32
292;11.06.2018;2018;06;14;Maanantai;47;33;80;5;30;35
292;11.06.2018;2018;06;15;Maanantai;62;36;98;21;38;59
292;11.06.2018;2018;06;16;Maanantai;68;53;121;26;42;68
292;11.06.2018;2018;06;17;Maanantai;66;43;109;17;23;40
292;11.06.2018;2018;06;18;Maanantai;68;63;131;19;28;47
292;11.06.2018;2018;06;19;Maanantai;30;39;69;13;31;44
292;11.06.2018;2018;06;20;Maanantai;31;30;61;21;37;58
292;11.06.2018;2018;06;21;Maanantai;26;22;48;13;11;24
292;11.06.2018;2018;06;22;Maanantai;8;7;15;3;6;9
292;11.06.2018;2018;06;23;Maanantai;5;5;10;5;1;6
292;12.06.2018;2018;06;00;Tiistai;3;2;5;0;0;0
292;12.06.2018;2018;06;01;Tiistai;0;0;0;0;2;2
292;12.06.2018;2018;06;02;Tiistai;0;0;0;0;1;1
292;12.06.2018;2018;06;03;Tiistai;0;0;0;0;0;0
292;12.06.2018;2018;06;04;Tiistai;1;2;3;0;0;0
292;12.06.2018;2018;06;05;Tiistai;7;4;11;1;5;6
292;12.06.2018;2018;06;06;Tiistai;22;20;42;2;2;4
292;12.06.2018;2018;06;07;Tiistai;35;27;62;1;6;7
292;12.06.2018;2018;06;08;Tiistai;29;28;57;16;13;29
292;12.06.2018;2018;06;09;Tiistai;25;28;53;1;7;8
292;12.06.2018;2018;06;10;Tiistai;26;25;51;8;5;13
292;12.06.2018;2018;06;11;Tiistai;19;26;45;2;16;18
292;12.06.2018;2018;06;12;Tiistai;37;32;69;16;24;40
292;12.06.2018;2018;06;13;Tiistai;46;40;86;23;23;46
292;12.06.2018;2018;06;14;Tiistai;42;40;82;35;23;58
292;12.06.2018;2018;06;15;Tiistai;59;39;98;29;30;59
292;12.06.2018;2018;06;16;Tiistai;42;49;91;19;35;54
292;12.06.2018;2018;06;17;Tiistai;54;31;85;17;40;57
292;12.06.2018;2018;06;18;Tiistai;41;34;75;13;35;48
292;12.06.2018;2018;06;19;Tiistai;44;34;78;26;26;52
292;12.06.2018;2018;06;20;Tiistai;30;22;52;15;21;36
292;12.06.2018;2018;06;21;Tiistai;11;15;26;4;10;14
292;12.06.2018;2018;06;22;Tiistai;9;8;17;5;3;8
292;12.06.2018;2018;06;23;Tiistai;0;1;1;2;4;6
292;13.06.2018;2018;06;00;Keskiviikko;0;0;0;0;0;0
292;13.06.2018;2018;06;01;Keskiviikko;2;1;3;0;0;0
292;13.06.2018;2018;06;02;Keskiviikko;0;2;2;0;0;0
292;13.06.2018;2018;06;03;Keskiviikko;0;1;1;1;0;1
292;13.06.2018;2018;06;04;Keskiviikko;2;3;5;0;1;1
292;13.06.2018;2018;06;05;Keskiviikko;8;7;15;0;7;7
292;13.06.2018;2018;06;06;Keskiviikko;20;8;28;6;7;13
292;13.06.2018;2018;06;07;Keskiviikko;40;29;69;5;13;18
292;13.06.2018;2018;06;08;Keskiviikko;36;14;50;3;13;16
292;13.06.2018;2018;06;09;Keskiviikko;39;16;55;19;12;31
292;13.06.2018;2018;06;10;Keskiviikko;27;26;53;6;18;24
292;13.06.2018;2018;06;11;Keskiviikko;42;21;63;8;32;40
292;13.06.2018;2018;06;12;Keskiviikko;41;47;88;14;23;37
292;13.06.2018;2018;06;13;Keskiviikko;49;26;75;16;29;45
292;13.06.2018;2018;06;14;Keskiviikko;49;33;82;9;27;36
292;13.06.2018;2018;06;15;Keskiviikko;51;44;95;26;35;61
292;13.06.2018;2018;06;16;Keskiviikko;69;52;121;26;37;63
292;13.06.2018;2018;06;17;Keskiviikko;48;52;100;19;34;53
292;13.06.2018;2018;06;18;Keskiviikko;41;40;81;25;34;59
292;13.06.2018;2018;06;19;Keskiviikko;55;45;100;8;31;39
292;13.06.2018;2018;06;20;Keskiviikko;23;23;46;13;20;33
292;13.06.2018;2018;06;21;Keskiviikko;20;8;28;5;9;14
292;13.06.2018;2018;06;22;Keskiviikko;7;6;13;2;5;7
292;13.06.2018;2018;06;23;Keskiviikko;2;2;4;3;0;3
292;14.06.2018;2018;06;00;Torstai;2;3;5;0;1;1
292;14.06.2018;2018;06;01;Torstai;4;4;8;6;1;7
292;14.06.2018;2018;06;02;Torstai;0;0;0;1;0;1
292;14.06.2018;2018;06;03;Torstai;0;0;0;0;1;1
292;14.06.2018;2018;06;04;Torstai;1;1;2;0;0;0
292;14.06.2018;2018;06;05;Torstai;7;7;14;1;5;6
292;14.06.2018;2018;06;06;Torstai;26;19;45;5;4;9
292;14.06.2018;2018;06;07;Torstai;36;32;68;4;3;7
292;14.06.2018;2018;06;08;Torstai;36;31;67;6;3;9
292;14.06.2018;2018;06;09;Torstai;29;23;52;8;7;15
292;14.06.2018;2018;06;10;Torstai;30;32;62;4;17;21
292;14.06.2018;2018;06;11;Torstai;49;29;78;18;17;35
292;14.06.2018;2018;06;12;Torstai;44;40;84;15;28;43
292;14.06.2018;2018;06;13;Torstai;41;39;80;14;19;33
292;14.06.2018;2018;06;14;Torstai;60;40;100;15;28;43
292;14.06.2018;2018;06;15;Torstai;75;61;136;15;33;48
292;14.06.2018;2018;06;16;Torstai;53;60;113;18;28;46
292;14.06.2018;2018;06;17;Torstai;56;32;88;23;29;52
292;14.06.2018;2018;06;18;Torstai;42;31;73;9;25;34
292;14.06.2018;2018;06;19;Torstai;35;37;72;13;17;30
292;14.06.2018;2018;06;20;Torstai;31;22;53;16;22;38
292;14.06.2018;2018;06;21;Torstai;9;10;19;8;12;20
292;14.06.2018;2018;06;22;Torstai;10;14;24;2;10;12
292;14.06.2018;2018;06;23;Torstai;2;3;5;3;5;8
292;15.06.2018;2018;06;00;Perjantai;4;3;7;1;0;1
292;15.06.2018;2018;06;01;Perjantai;0;1;1;3;2;5
292;15.06.2018;2018;06;02;Perjantai;2;3;5;3;2;5
292;15.06.2018;2018;06;03;Perjantai;2;0;2;0;0;0
292;15.06.2018;2018;06;04;Perjantai;1;0;1;0;0;0
292;15.06.2018;2018;06;05;Perjantai;9;8;17;4;3;7
292;15.06.2018;2018;06;06;Perjantai;19;8;27;1;8;9
292;15.06.2018;2018;06;07;Perjantai;33;18;51;2;5;7
292;15.06.2018;2018;06;08;Perjantai;42;12;54;1;16;17
292;15.06.2018;2018;06;09;Perjantai;28;11;39;2;8;10
292;15.06.2018;2018;06;10;Perjantai;17;19;36;8;18;26
292;15.06.2018;2018;06;11;Perjantai;36;26;62;13;22;35
292;15.06.2018;2018;06;12;Perjantai;50;20;70;9;26;35
292;15.06.2018;2018;06;13;Perjantai;39;17;56;8;20;28
292;15.06.2018;2018;06;14;Perjantai;45;36;81;10;37;47
292;15.06.2018;2018;06;15;Perjantai;49;31;80;13;32;45
292;15.06.2018;2018;06;16;Perjantai;48;29;77;8;29;37
292;15.06.2018;2018;06;17;Perjantai;35;20;55;9;19;28
292;15.06.2018;2018;06;18;Perjantai;25;24;49;8;22;30
292;15.06.2018;2018;06;19;Perjantai;36;24;60;8;17;25
292;15.06.2018;2018;06;20;Perjantai;26;17;43;10;17;27
292;15.06.2018;2018;06;21;Perjantai;15;8;23;10;7;17
292;15.06.2018;2018;06;22;Perjantai;6;9;15;3;7;10
292;15.06.2018;2018;06;23;Perjantai;8;7;15;3;5;8
292;16.06.2018;2018;06;00;Lauantai;6;4;10;3;4;7
292;16.06.2018;2018;06;01;Lauantai;5;0;5;6;6;12
292;16.06.2018;2018;06;02;Lauantai;1;0;1;2;0;2
292;16.06.2018;2018;06;03;Lauantai;1;9;10;7;11;18
292;16.06.2018;2018;06;04;Lauantai;1;0;1;1;1;2
292;16.06.2018;2018;06;05;Lauantai;3;1;4;2;0;2
292;16.06.2018;2018;06;06;Lauantai;6;3;9;4;3;7
292;16.06.2018;2018;06;07;Lauantai;6;4;10;1;0;1
292;16.06.2018;2018;06;08;Lauantai;15;13;28;6;5;11
292;16.06.2018;2018;06;09;Lauantai;24;13;37;8;16;24
292;16.06.2018;2018;06;10;Lauantai;36;30;66;8;27;35
292;16.06.2018;2018;06;11;Lauantai;48;37;85;16;25;41
292;16.06.2018;2018;06;12;Lauantai;52;44;96;10;25;35
292;16.06.2018;2018;06;13;Lauantai;50;26;76;15;21;36
292;16.06.2018;2018;06;14;Lauantai;59;29;88;10;23;33
292;16.06.2018;2018;06;15;Lauantai;52;33;85;13;26;39
292;16.06.2018;2018;06;16;Lauantai;45;23;68;11;29;40
292;16.06.2018;2018;06;17;Lauantai;53;31;84;12;18;30
292;16.06.2018;2018;06;18;Lauantai;46;37;83;12;27;39
292;16.06.2018;2018;06;19;Lauantai;22;25;47;15;18;33
292;16.06.2018;2018;06;20;Lauantai;17;21;38;8;18;26
292;16.06.2018;2018;06;21;Lauantai;19;10;29;8;9;17
292;16.06.2018;2018;06;22;Lauantai;11;17;28;4;10;14
292;16.06.2018;2018;06;23;Lauantai;13;5;18;7;3;10
292;17.06.2018;2018;06;00;Sunnuntai;7;3;10;3;7;10
292;17.06.2018;2018;06;01;Sunnuntai;3;6;9;6;5;11
292;17.06.2018;2018;06;02;Sunnuntai;4;1;5;3;6;9
292;17.06.2018;2018;06;03;Sunnuntai;3;6;9;1;4;5
292;17.06.2018;2018;06;04;Sunnuntai;0;0;0;0;2;2
292;17.06.2018;2018;06;05;Sunnuntai;2;1;3;2;1;3
292;17.06.2018;2018;06;06;Sunnuntai;6;3;9;0;2;2
292;17.06.2018;2018;06;07;Sunnuntai;4;5;9;8;1;9
292;17.06.2018;2018;06;08;Sunnuntai;8;11;19;8;3;11
292;17.06.2018;2018;06;09;Sunnuntai;28;25;53;7;12;19
292;17.06.2018;2018;06;10;Sunnuntai;38;28;66;30;19;49
292;17.06.2018;2018;06;11;Sunnuntai;51;37;88;10;30;40
292;17.06.2018;2018;06;12;Sunnuntai;44;48;92;19;39;58
292;17.06.2018;2018;06;13;Sunnuntai;75;37;112;20;32;52
292;17.06.2018;2018;06;14;Sunnuntai;59;42;101;16;41;57
292;17.06.2018;2018;06;15;Sunnuntai;60;41;101;16;20;36
292;17.06.2018;2018;06;16;Sunnuntai;85;34;119;11;21;32
292;17.06.2018;2018;06;17;Sunnuntai;55;32;87;12;24;36
292;17.06.2018;2018;06;18;Sunnuntai;55;31;86;11;23;34
292;17.06.2018;2018;06;19;Sunnuntai;40;52;92;12;29;41
292;17.06.2018;2018;06;20;Sunnuntai;24;28;52;13;27;40
292;17.06.2018;2018;06;21;Sunnuntai;21;24;45;13;23;36
292;17.06.2018;2018;06;22;Sunnuntai;7;11;18;4;13;17
292;17.06.2018;2018;06;23;Sunnuntai;8;11;19;1;5;6
292;18.06.2018;2018;06;00;Maanantai;6;3;9;4;4;8
292;18.06.2018;2018;06;01;Maanantai;3;5;8;1;1;2
292;18.06.2018;2018;06;02;Maanantai;3;2;5;1;1;2
292;18.06.2018;2018;06;03;Maanantai;0;0;0;0;0;0
292;18.06.2018;2018;06;04;Maanantai;1;1;2;0;0;0
292;18.06.2018;2018;06;05;Maanantai;8;7;15;2;5;7
292;18.06.2018;2018;06;06;Maanantai;23;3;26;3;10;13
292;18.06.2018;2018;06;07;Maanantai;33;18;51;2;10;12
292;18.06.2018;2018;06;08;Maanantai;19;11;30;4;8;12
292;18.06.2018;2018;06;09;Maanantai;21;17;38;5;13;18
292;18.06.2018;2018;06;10;Maanantai;29;16;45;14;9;23
292;18.06.2018;2018;06;11;Maanantai;25;14;39;15;23;38
292;18.06.2018;2018;06;12;Maanantai;25;12;37;1;12;13
292;18.06.2018;2018;06;13;Maanantai;19;27;46;12;23;35
292;18.06.2018;2018;06;14;Maanantai;42;31;73;33;29;62
292;18.06.2018;2018;06;15;Maanantai;40;39;79;13;27;40
292;18.06.2018;2018;06;16;Maanantai;50;41;91;11;22;33
292;18.06.2018;2018;06;17;Maanantai;48;25;73;11;20;31
292;18.06.2018;2018;06;18;Maanantai;28;34;62;11;30;41
292;18.06.2018;2018;06;19;Maanantai;26;18;44;12;16;28
292;18.06.2018;2018;06;20;Maanantai;26;14;40;10;14;24
292;18.06.2018;2018;06;21;Maanantai;9;15;24;2;5;7
292;18.06.2018;2018;06;22;Maanantai;9;4;13;3;2;5
292;18.06.2018;2018;06;23;Maanantai;2;3;5;2;2;4
292;19.06.2018;2018;06;00;Tiistai;1;3;4;1;1;2
292;19.06.2018;2018;06;01;Tiistai;1;0;1;0;0;0
292;19.06.2018;2018;06;02;Tiistai;0;2;2;1;0;1
292;19.06.2018;2018;06;03;Tiistai;1;3;4;1;0;1
292;19.06.2018;2018;06;04;Tiistai;3;1;4;3;0;3
292;19.06.2018;2018;06;05;Tiistai;6;4;10;0;3;3
292;19.06.2018;2018;06;06;Tiistai;15;15;30;3;1;4
292;19.06.2018;2018;06;07;Tiistai;25;18;43;2;4;6
292;19.06.2018;2018;06;08;Tiistai;21;19;40;7;16;23
292;19.06.2018;2018;06;09;Tiistai;35;16;51;17;21;38
292;19.06.2018;2018;06;10;Tiistai;35;20;55;10;22;32
292;19.06.2018;2018;06;11;Tiistai;21;16;37;5;8;13
292;19.06.2018;2018;06;12;Tiistai;16;16;32;3;4;7
292;19.06.2018;2018;06;13;Tiistai;20;16;36;10;1;11
292;19.06.2018;2018;06;14;Tiistai;15;7;22;1;4;5
292;19.06.2018;2018;06;15;Tiistai;27;24;51;2;4;6
292;19.06.2018;2018;06;16;Tiistai;24;19;43;2;5;7
292;19.06.2018;2018;06;17;Tiistai;16;14;30;5;4;9
292;19.06.2018;2018;06;18;Tiistai;14;14;28;4;4;8
292;19.06.2018;2018;06;19;Tiistai;24;20;44;6;6;12
292;19.06.2018;2018;06;20;Tiistai;23;11;34;4;4;8
292;19.06.2018;2018;06;21;Tiistai;9;3;12;2;2;4
292;19.06.2018;2018;06;22;Tiistai;4;2;6;3;1;4
292;19.06.2018;2018;06;23;Tiistai;2;1;3;0;0;0
292;20.06.2018;2018;06;00;Keskiviikko;1;1;2;0;0;0
292;20.06.2018;2018;06;01;Keskiviikko;1;0;1;1;1;2
292;20.06.2018;2018;06;02;Keskiviikko;0;4;4;0;1;1
292;20.06.2018;2018;06;03;Keskiviikko;0;0;0;0;0;0
292;20.06.2018;2018;06;04;Keskiviikko;2;1;3;1;1;2
292;20.06.2018;2018;06;05;Keskiviikko;5;4;9;1;2;3
292;20.06.2018;2018;06;06;Keskiviikko;19;15;34;1;5;6
292;20.06.2018;2018;06;07;Keskiviikko;24;25;49;5;10;15
292;20.06.2018;2018;06;08;Keskiviikko;18;23;41;12;6;18
292;20.06.2018;2018;06;09;Keskiviikko;26;26;52;5;14;19
292;20.06.2018;2018;06;10;Keskiviikko;21;27;48;23;12;35
292;20.06.2018;2018;06;11;Keskiviikko;24;28;52;26;11;37
292;20.06.2018;2018;06;12;Keskiviikko;28;37;65;15;27;42
292;20.06.2018;2018;06;13;Keskiviikko;30;20;50;27;32;59
292;20.06.2018;2018;06;14;Keskiviikko;30;29;59;40;29;69
292;20.06.2018;2018;06;15;Keskiviikko;39;43;82;19;27;46
292;20.06.2018;2018;06;16;Keskiviikko;45;43;88;14;30;44
292;20.06.2018;2018;06;17;Keskiviikko;54;34;88;20;20;40
292;20.06.2018;2018;06;18;Keskiviikko;44;30;74;8;29;37
292;20.06.2018;2018;06;19;Keskiviikko;39;27;66;20;15;35
292;20.06.2018;2018;06;20;Keskiviikko;47;43;90;17;26;43
292;20.06.2018;2018;06;21;Keskiviikko;24;16;40;9;14;23
292;20.06.2018;2018;06;22;Keskiviikko;11;9;20;2;3;5
292;20.06.2018;2018;06;23;Keskiviikko;2;6;8;1;1;2
292;21.06.2018;2018;06;00;Torstai;10;5;15;4;2;6
292;21.06.2018;2018;06;01;Torstai;3;3;6;0;4;4
292;21.06.2018;2018;06;02;Torstai;0;2;2;0;3;3
292;21.06.2018;2018;06;03;Torstai;0;0;0;3;0;3
292;21.06.2018;2018;06;04;Torstai;2;2;4;1;2;3
292;21.06.2018;2018;06;05;Torstai;3;2;5;0;5;5
292;21.06.2018;2018;06;06;Torstai;14;16;30;1;1;2
292;21.06.2018;2018;06;07;Torstai;25;22;47;4;7;11
292;21.06.2018;2018;06;08;Torstai;22;26;48;5;4;9
292;21.06.2018;2018;06;09;Torstai;29;27;56;3;16;19
292;21.06.2018;2018;06;10;Torstai;29;42;71;9;15;24
292;21.06.2018;2018;06;11;Torstai;40;27;67;6;23;29
292;21.06.2018;2018;06;12;Torstai;42;27;69;11;32;43
292;21.06.2018;2018;06;13;Torstai;40;38;78;13;22;35
292;21.06.2018;2018;06;14;Torstai;46;49;95;14;26;40
292;21.06.2018;2018;06;15;Torstai;37;39;76;14;24;38
292;21.06.2018;2018;06;16;Torstai;53;29;82;12;28;40
292;21.06.2018;2018;06;17;Torstai;35;23;58;2;18;20
292;21.06.2018;2018;06;18;Torstai;38;30;68;7;17;24
292;21.06.2018;2018;06;19;Torstai;30;32;62;15;34;49
292;21.06.2018;2018;06;20;Torstai;35;16;51;14;16;30
292;21.06.2018;2018;06;21;Torstai;19;16;35;9;12;21
292;21.06.2018;2018;06;22;Torstai;13;10;23;7;3;10
292;21.06.2018;2018;06;23;Torstai;4;8;12;5;6;11
292;22.06.2018;2018;06;00;Perjantai;12;6;18;2;2;4
292;22.06.2018;2018;06;01;Perjantai;4;6;10;4;5;9
292;22.06.2018;2018;06;02;Perjantai;4;4;8;1;0;1
292;22.06.2018;2018;06;03;Perjantai;2;2;4;0;0;0
292;22.06.2018;2018;06;04;Perjantai;3;3;6;0;4;4
292;22.06.2018;2018;06;05;Perjantai;0;5;5;0;0;0
292;22.06.2018;2018;06;06;Perjantai;6;1;7;0;4;4
292;22.06.2018;2018;06;07;Perjantai;2;0;2;1;5;6
292;22.06.2018;2018;06;08;Perjantai;1;0;1;1;1;2
292;22.06.2018;2018;06;09;Perjantai;4;1;5;0;2;2
292;22.06.2018;2018;06;10;Perjantai;2;4;6;1;0;1
292;22.06.2018;2018;06;11;Perjantai;3;3;6;0;1;1
292;22.06.2018;2018;06;12;Perjantai;3;2;5;1;0;1
292;22.06.2018;2018;06;13;Perjantai;3;2;5;2;4;6
292;22.06.2018;2018;06;14;Perjantai;7;6;13;8;4;12
292;22.06.2018;2018;06;15;Perjantai;3;3;6;2;3;5
292;22.06.2018;2018;06;16;Perjantai;12;6;18;4;4;8
292;22.06.2018;2018;06;17;Perjantai;6;6;12;5;4;9
292;22.06.2018;2018;06;18;Perjantai;3;1;4;2;1;3
292;22.06.2018;2018;06;19;Perjantai;5;4;9;4;5;9
292;22.06.2018;2018;06;20;Perjantai;6;6;12;4;6;10
292;22.06.2018;2018;06;21;Perjantai;4;3;7;4;5;9
292;22.06.2018;2018;06;22;Perjantai;6;4;10;3;0;3
292;22.06.2018;2018;06;23;Perjantai;6;4;10;5;1;6
292;23.06.2018;2018;06;00;Lauantai;1;3;4;7;5;12
292;23.06.2018;2018;06;01;Lauantai;1;4;5;2;5;7
292;23.06.2018;2018;06;02;Lauantai;0;0;0;1;3;4
292;23.06.2018;2018;06;03;Lauantai;4;1;5;0;9;9
292;23.06.2018;2018;06;04;Lauantai;2;1;3;1;4;5
292;23.06.2018;2018;06;05;Lauantai;1;2;3;4;0;4
292;23.06.2018;2018;06;06;Lauantai;2;2;4;1;0;1
292;23.06.2018;2018;06;07;Lauantai;1;2;3;1;0;1
292;23.06.2018;2018;06;08;Lauantai;3;3;6;0;5;5
292;23.06.2018;2018;06;09;Lauantai;4;4;8;1;1;2
292;23.06.2018;2018;06;10;Lauantai;6;6;12;3;2;5
292;23.06.2018;2018;06;11;Lauantai;5;4;9;2;2;4
292;23.06.2018;2018;06;12;Lauantai;8;6;14;8;5;13
292;23.06.2018;2018;06;13;Lauantai;7;8;15;2;5;7
292;23.06.2018;2018;06;14;Lauantai;16;13;29;8;12;20
292;23.06.2018;2018;06;15;Lauantai;17;17;34;6;7;13
292;23.06.2018;2018;06;16;Lauantai;8;12;20;0;3;3
292;23.06.2018;2018;06;17;Lauantai;14;8;22;4;5;9
292;23.06.2018;2018;06;18;Lauantai;20;20;40;11;6;17
292;23.06.2018;2018;06;19;Lauantai;17;13;30;5;5;10
292;23.06.2018;2018;06;20;Lauantai;9;7;16;5;7;12
292;23.06.2018;2018;06;21;Lauantai;11;10;21;4;7;11
292;23.06.2018;2018;06;22;Lauantai;7;5;12;1;1;2
292;23.06.2018;2018;06;23;Lauantai;7;3;10;0;0;0
292;24.06.2018;2018;06;00;Sunnuntai;4;6;10;1;1;2
292;24.06.2018;2018;06;01;Sunnuntai;6;4;10;3;2;5
292;24.06.2018;2018;06;02;Sunnuntai;2;0;2;1;1;2
292;24.06.2018;2018;06;03;Sunnuntai;2;1;3;0;2;2
292;24.06.2018;2018;06;04;Sunnuntai;0;2;2;1;0;1
292;24.06.2018;2018;06;05;Sunnuntai;2;4;6;0;0;0
292;24.06.2018;2018;06;06;Sunnuntai;2;2;4;1;3;4
292;24.06.2018;2018;06;07;Sunnuntai;2;2;4;0;2;2
292;24.06.2018;2018;06;08;Sunnuntai;11;11;22;3;4;7
292;24.06.2018;2018;06;09;Sunnuntai;25;20;45;3;7;10
292;24.06.2018;2018;06;10;Sunnuntai;32;34;66;13;14;27
292;24.06.2018;2018;06;11;Sunnuntai;45;31;76;13;17;30
292;24.06.2018;2018;06;12;Sunnuntai;40;30;70;15;19;34
292;24.06.2018;2018;06;13;Sunnuntai;56;26;82;11;34;45
292;24.06.2018;2018;06;14;Sunnuntai;47;32;79;17;30;47
292;24.06.2018;2018;06;15;Sunnuntai;47;32;79;17;19;36
292;24.06.2018;2018;06;16;Sunnuntai;58;34;92;9;32;41
292;24.06.2018;2018;06;17;Sunnuntai;49;37;86;14;24;38
292;24.06.2018;2018;06;18;Sunnuntai;55;30;85;15;28;43
292;24.06.2018;2018;06;19;Sunnuntai;50;26;76;14;25;39
292;24.06.2018;2018;06;20;Sunnuntai;35;16;51;17;19;36
292;24.06.2018;2018;06;21;Sunnuntai;19;13;32;9;23;32
292;24.06.2018;2018;06;22;Sunnuntai;8;9;17;11;7;18
292;24.06.2018;2018;06;23;Sunnuntai;8;6;14;1;0;1
292;25.06.2018;2018;06;00;Maanantai;4;3;7;0;0;0
292;25.06.2018;2018;06;01;Maanantai;1;1;2;0;1;1
292;25.06.2018;2018;06;02;Maanantai;0;0;0;0;1;1
292;25.06.2018;2018;06;03;Maanantai;1;0;1;0;0;0
292;25.06.2018;2018;06;04;Maanantai;1;1;2;0;2;2
292;25.06.2018;2018;06;05;Maanantai;8;5;13;1;4;5
292;25.06.2018;2018;06;06;Maanantai;25;16;41;4;3;7
292;25.06.2018;2018;06;07;Maanantai;31;26;57;2;5;7
292;25.06.2018;2018;06;08;Maanantai;22;18;40;1;8;9
292;25.06.2018;2018;06;09;Maanantai;27;29;56;10;15;25
292;25.06.2018;2018;06;10;Maanantai;37;37;74;13;24;37
292;25.06.2018;2018;06;11;Maanantai;47;49;96;11;23;34
292;25.06.2018;2018;06;12;Maanantai;52;42;94;11;38;49
292;25.06.2018;2018;06;13;Maanantai;65;44;109;11;32;43
292;25.06.2018;2018;06;14;Maanantai;84;37;121;19;31;50
292;25.06.2018;2018;06;15;Maanantai;78;53;131;15;30;45
292;25.06.2018;2018;06;16;Maanantai;75;55;130;13;29;42
292;25.06.2018;2018;06;17;Maanantai;66;43;109;10;27;37
292;25.06.2018;2018;06;18;Maanantai;37;48;85;9;29;38
292;25.06.2018;2018;06;19;Maanantai;59;42;101;16;32;48
292;25.06.2018;2018;06;20;Maanantai;47;24;71;16;16;32
292;25.06.2018;2018;06;21;Maanantai;28;10;38;7;14;21
292;25.06.2018;2018;06;22;Maanantai;8;7;15;1;7;8
292;25.06.2018;2018;06;23;Maanantai;3;3;6;1;1;2
292;26.06.2018;2018;06;00;Tiistai;1;2;3;0;1;1
292;26.06.2018;2018;06;01;Tiistai;3;2;5;0;1;1
292;26.06.2018;2018;06;02;Tiistai;2;3;5;0;1;1
292;26.06.2018;2018;06;03;Tiistai;2;0;2;0;0;0
292;26.06.2018;2018;06;04;Tiistai;3;2;5;1;0;1
292;26.06.2018;2018;06;05;Tiistai;6;6;12;1;5;6
292;26.06.2018;2018;06;06;Tiistai;28;23;51;2;2;4
292;26.06.2018;2018;06;07;Tiistai;29;28;57;3;4;7
292;26.06.2018;2018;06;08;Tiistai;31;25;56;5;6;11
292;26.06.2018;2018;06;09;Tiistai;23;12;35;7;16;23
292;26.06.2018;2018;06;10;Tiistai;23;17;40;10;27;37
292;26.06.2018;2018;06;11;Tiistai;54;26;80;9;19;28
292;26.06.2018;2018;06;12;Tiistai;42;35;77;6;32;38
292;26.06.2018;2018;06;13;Tiistai;50;48;98;9;14;23
292;26.06.2018;2018;06;14;Tiistai;67;38;105;13;29;42
292;26.06.2018;2018;06;15;Tiistai;42;39;81;12;41;53
292;26.06.2018;2018;06;16;Tiistai;50;42;92;9;31;40
292;26.06.2018;2018;06;17;Tiistai;57;56;113;20;40;60
292;26.06.2018;2018;06;18;Tiistai;78;28;106;12;31;43
292;26.06.2018;2018;06;19;Tiistai;50;28;78;11;19;30
292;26.06.2018;2018;06;20;Tiistai;31;24;55;11;28;39
292;26.06.2018;2018;06;21;Tiistai;17;16;33;10;9;19
292;26.06.2018;2018;06;22;Tiistai;8;5;13;8;11;19
292;26.06.2018;2018;06;23;Tiistai;4;4;8;3;2;5
292;27.06.2018;2018;06;00;Keskiviikko;0;2;2;1;1;2
292;27.06.2018;2018;06;01;Keskiviikko;2;0;2;0;2;2
292;27.06.2018;2018;06;02;Keskiviikko;0;0;0;0;0;0
292;27.06.2018;2018;06;03;Keskiviikko;0;1;1;1;0;1
292;27.06.2018;2018;06;04;Keskiviikko;2;1;3;1;0;1
292;27.06.2018;2018;06;05;Keskiviikko;8;6;14;1;5;6
292;27.06.2018;2018;06;06;Keskiviikko;27;18;45;2;8;10
292;27.06.2018;2018;06;07;Keskiviikko;26;23;49;11;7;18
292;27.06.2018;2018;06;08;Keskiviikko;26;22;48;2;7;9
292;27.06.2018;2018;06;09;Keskiviikko;36;26;62;6;4;10
292;27.06.2018;2018;06;10;Keskiviikko;31;27;58;6;6;12
292;27.06.2018;2018;06;11;Keskiviikko;36;38;74;14;9;23
292;27.06.2018;2018;06;12;Keskiviikko;53;35;88;8;25;33
292;27.06.2018;2018;06;13;Keskiviikko;45;41;86;24;31;55
292;27.06.2018;2018;06;14;Keskiviikko;60;23;83;22;25;47
292;27.06.2018;2018;06;15;Keskiviikko;50;77;127;20;37;57
292;27.06.2018;2018;06;16;Keskiviikko;55;42;97;8;27;35
292;27.06.2018;2018;06;17;Keskiviikko;60;37;97;23;35;58
292;27.06.2018;2018;06;18;Keskiviikko;39;43;82;14;26;40
292;27.06.2018;2018;06;19;Keskiviikko;59;22;81;22;21;43
292;27.06.2018;2018;06;20;Keskiviikko;34;29;63;14;39;53
292;27.06.2018;2018;06;21;Keskiviikko;17;19;36;7;8;15
292;27.06.2018;2018;06;22;Keskiviikko;9;5;14;0;4;4
292;27.06.2018;2018;06;23;Keskiviikko;2;1;3;1;0;1
292;28.06.2018;2018;06;00;Torstai;1;5;6;0;6;6
292;28.06.2018;2018;06;01;Torstai;0;1;1;2;1;3
292;28.06.2018;2018;06;02;Torstai;0;0;0;0;0;0
292;28.06.2018;2018;06;03;Torstai;1;1;2;2;0;2
292;28.06.2018;2018;06;04;Torstai;3;1;4;0;0;0
292;28.06.2018;2018;06;05;Torstai;5;4;9;2;5;7
292;28.06.2018;2018;06;06;Torstai;10;11;21;2;6;8
292;28.06.2018;2018;06;07;Torstai;22;17;39;4;3;7
292;28.06.2018;2018;06;08;Torstai;15;12;27;1;4;5
292;28.06.2018;2018;06;09;Torstai;11;10;21;2;1;3
292;28.06.2018;2018;06;10;Torstai;7;6;13;3;0;3
292;28.06.2018;2018;06;11;Torstai;8;7;15;2;1;3
292;28.06.2018;2018;06;12;Torstai;13;11;24;1;4;5
292;28.06.2018;2018;06;13;Torstai;11;9;20;6;2;8
292;28.06.2018;2018;06;14;Torstai;20;12;32;4;2;6
292;28.06.2018;2018;06;15;Torstai;16;14;30;5;5;10
292;28.06.2018;2018;06;16;Torstai;15;13;28;6;10;16
292;28.06.2018;2018;06;17;Torstai;10;9;19;1;0;1
292;28.06.2018;2018;06;18;Torstai;9;5;14;3;6;9
292;28.06.2018;2018;06;19;Torstai;5;4;9;2;1;3
292;28.06.2018;2018;06;20;Torstai;10;5;15;3;8;11
292;28.06.2018;2018;06;21;Torstai;2;2;4;5;3;8
292;28.06.2018;2018;06;22;Torstai;3;1;4;0;3;3
292;28.06.2018;2018;06;23;Torstai;1;2;3;0;1;1
292;29.06.2018;2018;06;00;Perjantai;0;0;0;0;0;0
292;29.06.2018;2018;06;01;Perjantai;1;0;1;0;1;1
292;29.06.2018;2018;06;02;Perjantai;0;0;0;0;1;1
292;29.06.2018;2018;06;03;Perjantai;2;2;4;0;1;1
292;29.06.2018;2018;06;04;Perjantai;1;0;1;1;0;1
292;29.06.2018;2018;06;05;Perjantai;2;3;5;1;2;3
292;29.06.2018;2018;06;06;Perjantai;10;10;20;1;3;4
292;29.06.2018;2018;06;07;Perjantai;21;18;39;4;5;9
292;29.06.2018;2018;06;08;Perjantai;13;11;24;1;6;7
292;29.06.2018;2018;06;09;Perjantai;17;13;30;4;9;13
292;29.06.2018;2018;06;10;Perjantai;25;22;47;4;7;11
292;29.06.2018;2018;06;11;Perjantai;29;27;56;5;9;14
292;29.06.2018;2018;06;12;Perjantai;18;19;37;7;10;17
292;29.06.2018;2018;06;13;Perjantai;22;15;37;2;8;10
292;29.06.2018;2018;06;14;Perjantai;29;27;56;8;7;15
292;29.06.2018;2018;06;15;Perjantai;35;35;70;2;14;16
292;29.06.2018;2018;06;16;Perjantai;31;28;59;5;6;11
292;29.06.2018;2018;06;17;Perjantai;23;15;38;8;8;16
292;29.06.2018;2018;06;18;Perjantai;31;17;48;6;12;18
292;29.06.2018;2018;06;19;Perjantai;28;22;50;12;16;28
292;29.06.2018;2018;06;20;Perjantai;28;21;49;9;12;21
292;29.06.2018;2018;06;21;Perjantai;13;14;27;9;13;22
292;29.06.2018;2018;06;22;Perjantai;9;7;16;5;13;18
292;29.06.2018;2018;06;23;Perjantai;11;5;16;3;4;7
292;30.06.2018;2018;06;00;Lauantai;7;7;14;1;0;1
292;30.06.2018;2018;06;01;Lauantai;2;2;4;2;4;6
292;30.06.2018;2018;06;02;Lauantai;2;6;8;0;5;5
292;30.06.2018;2018;06;03;Lauantai;2;5;7;0;4;4
292;30.06.2018;2018;06;04;Lauantai;1;6;7;2;1;3
292;30.06.2018;2018;06;05;Lauantai;1;3;4;0;2;2
292;30.06.2018;2018;06;06;Lauantai;6;4;10;1;2;3
292;30.06.2018;2018;06;07;Lauantai;2;3;5;2;3;5
292;30.06.2018;2018;06;08;Lauantai;15;5;20;7;5;12
292;30.06.2018;2018;06;09;Lauantai;21;10;31;4;5;9
292;30.06.2018;2018;06;10;Lauantai;30;17;47;3;9;12
292;30.06.2018;2018;06;11;Lauantai;25;22;47;4;3;7
292;30.06.2018;2018;06;12;Lauantai;34;30;64;3;6;9
292;30.06.2018;2018;06;13;Lauantai;34;25;59;7;7;14
292;30.06.2018;2018;06;14;Lauantai;28;30;58;7;9;16
292;30.06.2018;2018;06;15;Lauantai;37;31;68;8;2;10
292;30.06.2018;2018;06;16;Lauantai;26;23;49;3;7;10
292;30.06.2018;2018;06;17;Lauantai;26;24;50;5;1;6
292;30.06.2018;2018;06;18;Lauantai;20;16;36;13;14;27
292;30.06.2018;2018;06;19;Lauantai;22;20;42;15;11;26
292;30.06.2018;2018;06;20;Lauantai;28;19;47;18;18;36
292;30.06.2018;2018;06;21;Lauantai;12;5;17;11;8;19
292;30.06.2018;2018;06;22;Lauantai;7;12;19;2;7;9
292;30.06.2018;2018;06;23;Lauantai;7;9;16;2;3;5
292;01.07.2018;2018;07;00;Sunnuntai;4;5;9;1;4;5
292;01.07.2018;2018;07;01;Sunnuntai;3;4;7;0;3;3
292;01.07.2018;2018;07;02;Sunnuntai;3;5;8;4;2;6
292;01.07.2018;2018;07;03;Sunnuntai;3;9;12;1;4;5
292;01.07.2018;2018;07;04;Sunnuntai;3;2;5;0;7;7
292;01.07.2018;2018;07;05;Sunnuntai;2;2;4;0;0;0
292;01.07.2018;2018;07;06;Sunnuntai;10;1;11;0;0;0
292;01.07.2018;2018;07;07;Sunnuntai;3;4;7;3;9;12
292;01.07.2018;2018;07;08;Sunnuntai;15;4;19;5;4;9
292;01.07.2018;2018;07;09;Sunnuntai;27;17;44;4;9;13
292;01.07.2018;2018;07;10;Sunnuntai;34;21;55;7;9;16
292;01.07.2018;2018;07;11;Sunnuntai;35;27;62;8;9;17
292;01.07.2018;2018;07;12;Sunnuntai;56;44;100;6;30;36
292;01.07.2018;2018;07;13;Sunnuntai;62;43;105;10;32;42
292;01.07.2018;2018;07;14;Sunnuntai;68;46;114;17;19;36
292;01.07.2018;2018;07;15;Sunnuntai;43;34;77;12;27;39
292;01.07.2018;2018;07;16;Sunnuntai;59;44;103;19;27;46
292;01.07.2018;2018;07;17;Sunnuntai;69;27;96;23;24;47
292;01.07.2018;2018;07;18;Sunnuntai;59;46;105;18;30;48
292;01.07.2018;2018;07;19;Sunnuntai;27;35;62;14;24;38
292;01.07.2018;2018;07;20;Sunnuntai;26;19;45;11;14;25
292;01.07.2018;2018;07;21;Sunnuntai;9;9;18;5;13;18
292;01.07.2018;2018;07;22;Sunnuntai;8;4;12;5;7;12
292;01.07.2018;2018;07;23;Sunnuntai;6;6;12;3;4;7
292;02.07.2018;2018;07;00;Maanantai;6;2;8;0;1;1
292;02.07.2018;2018;07;01;Maanantai;1;2;3;1;2;3
292;02.07.2018;2018;07;02;Maanantai;0;2;2;2;1;3
292;02.07.2018;2018;07;03;Maanantai;1;1;2;0;0;0
292;02.07.2018;2018;07;04;Maanantai;4;1;5;0;0;0
292;02.07.2018;2018;07;05;Maanantai;2;6;8;1;0;1
292;02.07.2018;2018;07;06;Maanantai;25;11;36;1;2;3
292;02.07.2018;2018;07;07;Maanantai;29;20;49;4;9;13
292;02.07.2018;2018;07;08;Maanantai;24;12;36;5;10;15
292;02.07.2018;2018;07;09;Maanantai;39;16;55;8;11;19
292;02.07.2018;2018;07;10;Maanantai;36;17;53;8;2;10
292;02.07.2018;2018;07;11;Maanantai;39;43;82;7;4;11
292;02.07.2018;2018;07;12;Maanantai;50;34;84;9;27;36
292;02.07.2018;2018;07;13;Maanantai;62;50;112;15;33;48
292;02.07.2018;2018;07;14;Maanantai;53;42;95;24;36;60
292;02.07.2018;2018;07;15;Maanantai;59;53;112;6;42;48
292;02.07.2018;2018;07;16;Maanantai;63;43;106;18;30;48
292;02.07.2018;2018;07;17;Maanantai;60;59;119;16;22;38
292;02.07.2018;2018;07;18;Maanantai;74;45;119;18;24;42
292;02.07.2018;2018;07;19;Maanantai;64;44;108;19;28;47
292;02.07.2018;2018;07;20;Maanantai;48;38;86;15;16;31
292;02.07.2018;2018;07;21;Maanantai;21;12;33;11;15;26
292;02.07.2018;2018;07;22;Maanantai;9;10;19;5;9;14
292;02.07.2018;2018;07;23;Maanantai;5;9;14;1;3;4
292;03.07.2018;2018;07;00;Tiistai;5;3;8;4;3;7
292;03.07.2018;2018;07;01;Tiistai;0;2;2;1;1;2
292;03.07.2018;2018;07;02;Tiistai;2;6;8;1;3;4
292;03.07.2018;2018;07;03;Tiistai;8;1;9;2;0;2
292;03.07.2018;2018;07;04;Tiistai;0;0;0;1;0;1
292;03.07.2018;2018;07;05;Tiistai;6;5;11;1;2;3
292;03.07.2018;2018;07;06;Tiistai;22;19;41;3;3;6
292;03.07.2018;2018;07;07;Tiistai;20;20;40;2;0;2
292;03.07.2018;2018;07;08;Tiistai;19;17;36;1;3;4
292;03.07.2018;2018;07;09;Tiistai;24;22;46;5;2;7
292;03.07.2018;2018;07;10;Tiistai;24;24;48;2;3;5
292;03.07.2018;2018;07;11;Tiistai;41;34;75;5;1;6
292;03.07.2018;2018;07;12;Tiistai;49;46;95;3;5;8
292;03.07.2018;2018;07;13;Tiistai;45;44;89;5;3;8
292;03.07.2018;2018;07;14;Tiistai;44;46;90;6;2;8
292;03.07.2018;2018;07;15;Tiistai;53;50;103;5;3;8
292;03.07.2018;2018;07;16;Tiistai;45;43;88;10;7;17
292;03.07.2018;2018;07;17;Tiistai;47;46;93;4;1;5
292;03.07.2018;2018;07;18;Tiistai;50;49;99;6;2;8
292;03.07.2018;2018;07;19;Tiistai;41;34;75;13;9;22
292;03.07.2018;2018;07;20;Tiistai;28;20;48;4;7;11
292;03.07.2018;2018;07;21;Tiistai;14;9;23;11;5;16
292;03.07.2018;2018;07;22;Tiistai;9;7;16;3;4;7
292;03.07.2018;2018;07;23;Tiistai;2;4;6;0;2;2
292;04.07.2018;2018;07;00;Keskiviikko;1;1;2;3;1;4
292;04.07.2018;2018;07;01;Keskiviikko;0;0;0;0;0;0
292;04.07.2018;2018;07;02;Keskiviikko;0;2;2;0;2;2
292;04.07.2018;2018;07;03;Keskiviikko;0;0;0;0;0;0
292;04.07.2018;2018;07;04;Keskiviikko;0;0;0;1;0;1
292;04.07.2018;2018;07;05;Keskiviikko;2;1;3;1;1;2
292;04.07.2018;2018;07;06;Keskiviikko;6;5;11;4;1;5
292;04.07.2018;2018;07;07;Keskiviikko;12;9;21;3;2;5
292;04.07.2018;2018;07;08;Keskiviikko;5;3;8;6;4;10
292;04.07.2018;2018;07;09;Keskiviikko;7;5;12;3;2;5
292;04.07.2018;2018;07;10;Keskiviikko;4;4;8;3;4;7
292;04.07.2018;2018;07;11;Keskiviikko;8;8;16;1;4;5
292;04.07.2018;2018;07;12;Keskiviikko;12;10;22;3;3;6
292;04.07.2018;2018;07;13;Keskiviikko;15;14;29;3;9;12
292;04.07.2018;2018;07;14;Keskiviikko;16;15;31;5;2;7
292;04.07.2018;2018;07;15;Keskiviikko;17;14;31;0;7;7
292;04.07.2018;2018;07;16;Keskiviikko;36;22;58;9;11;20
292;04.07.2018;2018;07;17;Keskiviikko;52;34;86;18;15;33
292;04.07.2018;2018;07;18;Keskiviikko;60;38;98;12;13;25
292;04.07.2018;2018;07;19;Keskiviikko;51;30;81;16;19;35
292;04.07.2018;2018;07;20;Keskiviikko;38;44;82;6;22;28
292;04.07.2018;2018;07;21;Keskiviikko;16;18;34;15;15;30
292;04.07.2018;2018;07;22;Keskiviikko;15;14;29;11;9;20
292;04.07.2018;2018;07;23;Keskiviikko;8;6;14;1;3;4
292;05.07.2018;2018;07;00;Torstai;3;10;13;0;1;1
292;05.07.2018;2018;07;01;Torstai;2;1;3;0;2;2
292;05.07.2018;2018;07;02;Torstai;3;0;3;1;2;3
292;05.07.2018;2018;07;03;Torstai;1;0;1;1;0;1
292;05.07.2018;2018;07;04;Torstai;0;2;2;0;0;0
292;05.07.2018;2018;07;05;Torstai;4;3;7;0;3;3
292;05.07.2018;2018;07;06;Torstai;16;18;34;1;1;2
292;05.07.2018;2018;07;07;Torstai;19;15;34;2;3;5
292;05.07.2018;2018;07;08;Torstai;17;13;30;3;3;6
292;05.07.2018;2018;07;09;Torstai;26;24;50;5;5;10
292;05.07.2018;2018;07;10;Torstai;33;31;64;3;3;6
292;05.07.2018;2018;07;11;Torstai;37;43;80;4;8;12
292;05.07.2018;2018;07;12;Torstai;56;49;105;5;22;27
292;05.07.2018;2018;07;13;Torstai;42;42;84;1;4;5
292;05.07.2018;2018;07;14;Torstai;46;45;91;4;5;9
292;05.07.2018;2018;07;15;Torstai;42;39;81;7;3;10
292;05.07.2018;2018;07;16;Torstai;48;48;96;7;12;19
292;05.07.2018;2018;07;17;Torstai;34;30;64;10;11;21
292;05.07.2018;2018;07;18;Torstai;34;17;51;14;23;37
292;05.07.2018;2018;07;19;Torstai;28;20;48;7;14;21
292;05.07.2018;2018;07;20;Torstai;26;18;44;8;12;20
292;05.07.2018;2018;07;21;Torstai;15;12;27;5;16;21
292;05.07.2018;2018;07;22;Torstai;8;6;14;4;2;6
292;05.07.2018;2018;07;23;Torstai;0;1;1;3;3;6
292;06.07.2018;2018;07;00;Perjantai;2;6;8;0;5;5
292;06.07.2018;2018;07;01;Perjantai;1;2;3;2;4;6
292;06.07.2018;2018;07;02;Perjantai;2;2;4;1;1;2
292;06.07.2018;2018;07;03;Perjantai;0;4;4;0;1;1
292;06.07.2018;2018;07;04;Perjantai;2;1;3;0;0;0
292;06.07.2018;2018;07;05;Perjantai;5;3;8;4;2;6
292;06.07.2018;2018;07;06;Perjantai;14;10;24;2;1;3
292;06.07.2018;2018;07;07;Perjantai;19;15;34;2;2;4
292;06.07.2018;2018;07;08;Perjantai;19;16;35;3;1;4
292;06.07.2018;2018;07;09;Perjantai;19;19;38;3;1;4
292;06.07.2018;2018;07;10;Perjantai;28;20;48;5;2;7
292;06.07.2018;2018;07;11;Perjantai;36;33;69;3;1;4
292;06.07.2018;2018;07;12;Perjantai;43;46;89;6;11;17
292;06.07.2018;2018;07;13;Perjantai;60;42;102;4;20;24
292;06.07.2018;2018;07;14;Perjantai;67;37;104;7;17;24
292;06.07.2018;2018;07;15;Perjantai;54;36;90;10;20;30
292;06.07.2018;2018;07;16;Perjantai;58;53;111;14;13;27
292;06.07.2018;2018;07;17;Perjantai;58;45;103;11;29;40
292;06.07.2018;2018;07;18;Perjantai;52;28;80;12;25;37
292;06.07.2018;2018;07;19;Perjantai;60;42;102;12;16;28
292;06.07.2018;2018;07;20;Perjantai;37;23;60;12;22;34
292;06.07.2018;2018;07;21;Perjantai;29;13;42;7;12;19
292;06.07.2018;2018;07;22;Perjantai;14;5;19;7;8;15
292;06.07.2018;2018;07;23;Perjantai;7;8;15;13;4;17
292;07.07.2018;2018;07;00;Lauantai;3;4;7;4;2;6
292;07.07.2018;2018;07;01;Lauantai;4;8;12;3;4;7
292;07.07.2018;2018;07;02;Lauantai;0;8;8;0;5;5
292;07.07.2018;2018;07;03;Lauantai;3;4;7;2;3;5
292;07.07.2018;2018;07;04;Lauantai;2;3;5;2;3;5
292;07.07.2018;2018;07;05;Lauantai;1;1;2;1;1;2
292;07.07.2018;2018;07;06;Lauantai;5;3;8;1;4;5
292;07.07.2018;2018;07;07;Lauantai;6;4;10;3;2;5
292;07.07.2018;2018;07;08;Lauantai;17;7;24;13;7;20
292;07.07.2018;2018;07;09;Lauantai;38;13;51;7;10;17
292;07.07.2018;2018;07;10;Lauantai;45;14;59;7;9;16
292;07.07.2018;2018;07;11;Lauantai;48;36;84;4;2;6
292;07.07.2018;2018;07;12;Lauantai;49;38;87;2;8;10
292;07.07.2018;2018;07;13;Lauantai;48;45;93;3;3;6
292;07.07.2018;2018;07;14;Lauantai;45;40;85;3;2;5
292;07.07.2018;2018;07;15;Lauantai;44;39;83;10;6;16
292;07.07.2018;2018;07;16;Lauantai;42;41;83;6;4;10
292;07.07.2018;2018;07;17;Lauantai;42;43;85;6;9;15
292;07.07.2018;2018;07;18;Lauantai;30;31;61;4;9;13
292;07.07.2018;2018;07;19;Lauantai;30;22;52;10;7;17
292;07.07.2018;2018;07;20;Lauantai;22;21;43;8;16;24
292;07.07.2018;2018;07;21;Lauantai;19;18;37;5;4;9
292;07.07.2018;2018;07;22;Lauantai;8;10;18;4;1;5
292;07.07.2018;2018;07;23;Lauantai;12;4;16;4;2;6
292;08.07.2018;2018;07;00;Sunnuntai;4;3;7;2;6;8
292;08.07.2018;2018;07;01;Sunnuntai;4;2;6;3;1;4
292;08.07.2018;2018;07;02;Sunnuntai;1;1;2;0;6;6
292;08.07.2018;2018;07;03;Sunnuntai;7;9;16;5;5;10
292;08.07.2018;2018;07;04;Sunnuntai;1;1;2;1;1;2
292;08.07.2018;2018;07;05;Sunnuntai;2;4;6;0;0;0
292;08.07.2018;2018;07;06;Sunnuntai;5;3;8;2;3;5
292;08.07.2018;2018;07;07;Sunnuntai;4;3;7;1;2;3
292;08.07.2018;2018;07;08;Sunnuntai;5;5;10;6;4;10
292;08.07.2018;2018;07;09;Sunnuntai;18;15;33;5;0;5
292;08.07.2018;2018;07;10;Sunnuntai;30;27;57;4;2;6
292;08.07.2018;2018;07;11;Sunnuntai;48;45;93;3;9;12
292;08.07.2018;2018;07;12;Sunnuntai;44;42;86;2;5;7
292;08.07.2018;2018;07;13;Sunnuntai;52;44;96;1;4;5
292;08.07.2018;2018;07;14;Sunnuntai;56;54;110;8;4;12
292;08.07.2018;2018;07;15;Sunnuntai;56;38;94;5;7;12
292;08.07.2018;2018;07;16;Sunnuntai;96;49;145;18;21;39
292;08.07.2018;2018;07;17;Sunnuntai;66;45;111;13;15;28
292;08.07.2018;2018;07;18;Sunnuntai;51;34;85;28;22;50
292;08.07.2018;2018;07;19;Sunnuntai;54;73;127;11;37;48
292;08.07.2018;2018;07;20;Sunnuntai;40;31;71;13;25;38
292;08.07.2018;2018;07;21;Sunnuntai;20;12;32;8;19;27
292;08.07.2018;2018;07;22;Sunnuntai;10;8;18;5;4;9
292;08.07.2018;2018;07;23;Sunnuntai;5;2;7;2;2;4
292;09.07.2018;2018;07;00;Maanantai;2;1;3;0;0;0
292;09.07.2018;2018;07;01;Maanantai;1;4;5;2;2;4
292;09.07.2018;2018;07;02;Maanantai;4;2;6;1;2;3
292;09.07.2018;2018;07;03;Maanantai;5;0;5;3;2;5
292;09.07.2018;2018;07;04;Maanantai;0;0;0;1;2;3
292;09.07.2018;2018;07;05;Maanantai;10;7;17;3;2;5
292;09.07.2018;2018;07;06;Maanantai;21;11;32;2;2;4
292;09.07.2018;2018;07;07;Maanantai;32;5;37;1;10;11
292;09.07.2018;2018;07;08;Maanantai;24;15;39;4;7;11
292;09.07.2018;2018;07;09;Maanantai;29;20;49;9;7;16
292;09.07.2018;2018;07;10;Maanantai;58;32;90;11;7;18
292;09.07.2018;2018;07;11;Maanantai;41;42;83;2;3;5
292;09.07.2018;2018;07;12;Maanantai;52;40;92;12;18;30
292;09.07.2018;2018;07;13;Maanantai;71;46;117;10;28;38
292;09.07.2018;2018;07;14;Maanantai;50;47;97;7;19;26
292;09.07.2018;2018;07;15;Maanantai;64;45;109;10;26;36
292;09.07.2018;2018;07;16;Maanantai;56;46;102;9;27;36
292;09.07.2018;2018;07;17;Maanantai;62;50;112;22;32;54
292;09.07.2018;2018;07;18;Maanantai;92;33;125;24;30;54
292;09.07.2018;2018;07;19;Maanantai;66;40;106;8;24;32
292;09.07.2018;2018;07;20;Maanantai;43;38;81;18;22;40
292;09.07.2018;2018;07;21;Maanantai;36;26;62;13;15;28
292;09.07.2018;2018;07;22;Maanantai;12;17;29;3;10;13
292;09.07.2018;2018;07;23;Maanantai;8;5;13;1;6;7
292;10.07.2018;2018;07;00;Tiistai;0;3;3;3;3;6
292;10.07.2018;2018;07;01;Tiistai;4;4;8;2;2;4
292;10.07.2018;2018;07;02;Tiistai;3;3;6;0;0;0
292;10.07.2018;2018;07;03;Tiistai;4;0;4;2;3;5
292;10.07.2018;2018;07;04;Tiistai;0;0;0;0;1;1
292;10.07.2018;2018;07;05;Tiistai;4;6;10;1;5;6
292;10.07.2018;2018;07;06;Tiistai;26;14;40;1;7;8
292;10.07.2018;2018;07;07;Tiistai;34;13;47;1;8;9
292;10.07.2018;2018;07;08;Tiistai;36;12;48;5;7;12
292;10.07.2018;2018;07;09;Tiistai;46;13;59;11;6;17
292;10.07.2018;2018;07;10;Tiistai;50;37;87;5;1;6
292;10.07.2018;2018;07;11;Tiistai;44;45;89;6;2;8
292;10.07.2018;2018;07;12;Tiistai;57;39;96;2;22;24
292;10.07.2018;2018;07;13;Tiistai;59;41;100;11;35;46
292;10.07.2018;2018;07;14;Tiistai;52;48;100;19;28;47
292;10.07.2018;2018;07;15;Tiistai;64;49;113;13;25;38
292;10.07.2018;2018;07;16;Tiistai;61;52;113;15;30;45
292;10.07.2018;2018;07;17;Tiistai;63;49;112;7;30;37
292;10.07.2018;2018;07;18;Tiistai;56;49;105;15;20;35
292;10.07.2018;2018;07;19;Tiistai;54;39;93;16;36;52
292;10.07.2018;2018;07;20;Tiistai;62;35;97;14;24;38
292;10.07.2018;2018;07;21;Tiistai;33;22;55;16;12;28
292;10.07.2018;2018;07;22;Tiistai;16;19;35;2;13;15
292;10.07.2018;2018;07;23;Tiistai;1;5;6;1;7;8
292;11.07.2018;2018;07;00;Keskiviikko;3;1;4;3;2;5
292;11.07.2018;2018;07;01;Keskiviikko;1;0;1;0;2;2
292;11.07.2018;2018;07;02;Keskiviikko;0;1;1;1;0;1
292;11.07.2018;2018;07;03;Keskiviikko;1;0;1;2;2;4
292;11.07.2018;2018;07;04;Keskiviikko;3;3;6;3;1;4
292;11.07.2018;2018;07;05;Keskiviikko;4;7;11;0;1;1
292;11.07.2018;2018;07;06;Keskiviikko;25;14;39;4;8;12
292;11.07.2018;2018;07;07;Keskiviikko;33;14;47;4;7;11
292;11.07.2018;2018;07;08;Keskiviikko;17;9;26;7;11;18
292;11.07.2018;2018;07;09;Keskiviikko;56;7;63;6;9;15
292;11.07.2018;2018;07;10;Keskiviikko;47;27;74;5;0;5
292;11.07.2018;2018;07;11;Keskiviikko;57;54;111;4;4;8
292;11.07.2018;2018;07;12;Keskiviikko;46;31;77;13;17;30
292;11.07.2018;2018;07;13;Keskiviikko;44;51;95;11;31;42
292;11.07.2018;2018;07;14;Keskiviikko;60;61;121;16;22;38
292;11.07.2018;2018;07;15;Keskiviikko;66;44;110;15;30;45
292;11.07.2018;2018;07;16;Keskiviikko;48;46;94;15;28;43
292;11.07.2018;2018;07;17;Keskiviikko;68;43;111;12;31;43
292;11.07.2018;2018;07;18;Keskiviikko;87;50;137;14;23;37
292;11.07.2018;2018;07;19;Keskiviikko;69;28;97;18;28;46
292;11.07.2018;2018;07;20;Keskiviikko;49;41;90;13;18;31
292;11.07.2018;2018;07;21;Keskiviikko;27;18;45;11;21;32
292;11.07.2018;2018;07;22;Keskiviikko;12;8;20;7;6;13
292;11.07.2018;2018;07;23;Keskiviikko;5;8;13;2;7;9
292;12.07.2018;2018;07;00;Torstai;3;7;10;0;1;1
292;12.07.2018;2018;07;01;Torstai;1;2;3;1;2;3
292;12.07.2018;2018;07;02;Torstai;4;4;8;2;1;3
292;12.07.2018;2018;07;03;Torstai;0;1;1;2;2;4
292;12.07.2018;2018;07;04;Torstai;1;1;2;0;1;1
292;12.07.2018;2018;07;05;Torstai;6;7;13;2;5;7
292;12.07.2018;2018;07;06;Torstai;23;9;32;3;9;12
292;12.07.2018;2018;07;07;Torstai;28;6;34;5;4;9
292;12.07.2018;2018;07;08;Torstai;22;8;30;3;10;13
292;12.07.2018;2018;07;09;Torstai;52;13;65;6;8;14
292;12.07.2018;2018;07;10;Torstai;29;27;56;2;1;3
292;12.07.2018;2018;07;11;Torstai;39;38;77;5;10;15
292;12.07.2018;2018;07;12;Torstai;55;49;104;15;19;34
292;12.07.2018;2018;07;13;Torstai;56;43;99;5;29;34
292;12.07.2018;2018;07;14;Torstai;45;41;86;13;34;47
292;12.07.2018;2018;07;15;Torstai;63;57;120;14;24;38
292;12.07.2018;2018;07;16;Torstai;48;44;92;11;31;42
292;12.07.2018;2018;07;17;Torstai;65;64;129;13;25;38
292;12.07.2018;2018;07;18;Torstai;63;31;94;15;23;38
292;12.07.2018;2018;07;19;Torstai;59;31;90;13;17;30
292;12.07.2018;2018;07;20;Torstai;60;35;95;11;30;41
292;12.07.2018;2018;07;21;Torstai;26;25;51;12;18;30
292;12.07.2018;2018;07;22;Torstai;7;6;13;4;8;12
292;12.07.2018;2018;07;23;Torstai;3;7;10;5;9;14
292;13.07.2018;2018;07;00;Perjantai;2;2;4;0;1;1
292;13.07.2018;2018;07;01;Perjantai;1;1;2;1;4;5
292;13.07.2018;2018;07;02;Perjantai;1;1;2;2;1;3
292;13.07.2018;2018;07;03;Perjantai;0;2;2;3;1;4
292;13.07.2018;2018;07;04;Perjantai;2;1;3;2;0;2
292;13.07.2018;2018;07;05;Perjantai;7;8;15;0;4;4
292;13.07.2018;2018;07;06;Perjantai;17;11;28;4;4;8
292;13.07.2018;2018;07;07;Perjantai;21;11;32;8;2;10
292;13.07.2018;2018;07;08;Perjantai;26;7;33;4;2;6
292;13.07.2018;2018;07;09;Perjantai;41;13;54;5;0;5
292;13.07.2018;2018;07;10;Perjantai;40;35;75;4;2;6
292;13.07.2018;2018;07;11;Perjantai;37;34;71;5;3;8
292;13.07.2018;2018;07;12;Perjantai;51;43;94;5;26;31
292;13.07.2018;2018;07;13;Perjantai;43;39;82;8;40;48
292;13.07.2018;2018;07;14;Perjantai;63;46;109;11;24;35
292;13.07.2018;2018;07;15;Perjantai;49;52;101;18;21;39
292;13.07.2018;2018;07;16;Perjantai;56;54;110;11;26;37
292;13.07.2018;2018;07;17;Perjantai;88;35;123;16;18;34
292;13.07.2018;2018;07;18;Perjantai;42;33;75;9;26;35
292;13.07.2018;2018;07;19;Perjantai;38;33;71;9;13;22
292;13.07.2018;2018;07;20;Perjantai;32;20;52;7;16;23
292;13.07.2018;2018;07;21;Perjantai;24;21;45;11;12;23
292;13.07.2018;2018;07;22;Perjantai;14;10;24;2;9;11
292;13.07.2018;2018;07;23;Perjantai;9;2;11;1;6;7
292;14.07.2018;2018;07;00;Lauantai;5;5;10;6;4;10
292;14.07.2018;2018;07;01;Lauantai;4;7;11;1;2;3
292;14.07.2018;2018;07;02;Lauantai;3;3;6;1;2;3
292;14.07.2018;2018;07;03;Lauantai;0;3;3;0;3;3
292;14.07.2018;2018;07;04;Lauantai;3;5;8;0;1;1
292;14.07.2018;2018;07;05;Lauantai;2;2;4;0;2;2
292;14.07.2018;2018;07;06;Lauantai;10;7;17;1;3;4
292;14.07.2018;2018;07;07;Lauantai;3;2;5;1;1;2
292;14.07.2018;2018;07;08;Lauantai;8;5;13;2;1;3
292;14.07.2018;2018;07;09;Lauantai;23;10;33;8;4;12
292;14.07.2018;2018;07;10;Lauantai;25;26;51;3;4;7
292;14.07.2018;2018;07;11;Lauantai;36;33;69;2;3;5
292;14.07.2018;2018;07;12;Lauantai;42;37;79;1;5;6
292;14.07.2018;2018;07;13;Lauantai;35;33;68;4;3;7
292;14.07.2018;2018;07;14;Lauantai;44;34;78;9;14;23
292;14.07.2018;2018;07;15;Lauantai;46;28;74;4;20;24
292;14.07.2018;2018;07;16;Lauantai;38;46;84;9;20;29
292;14.07.2018;2018;07;17;Lauantai;49;18;67;11;10;21
292;14.07.2018;2018;07;18;Lauantai;59;28;87;8;15;23
292;14.07.2018;2018;07;19;Lauantai;35;30;65;6;12;18
292;14.07.2018;2018;07;20;Lauantai;34;14;48;7;16;23
292;14.07.2018;2018;07;21;Lauantai;20;19;39;7;16;23
292;14.07.2018;2018;07;22;Lauantai;14;16;30;4;14;18
292;14.07.2018;2018;07;23;Lauantai;8;2;10;9;3;12
292;15.07.2018;2018;07;00;Sunnuntai;3;6;9;1;1;2
292;15.07.2018;2018;07;01;Sunnuntai;4;2;6;4;8;12
292;15.07.2018;2018;07;02;Sunnuntai;1;7;8;1;4;5
292;15.07.2018;2018;07;03;Sunnuntai;4;5;9;1;1;2
292;15.07.2018;2018;07;04;Sunnuntai;1;1;2;1;1;2
292;15.07.2018;2018;07;05;Sunnuntai;1;3;4;1;1;2
292;15.07.2018;2018;07;06;Sunnuntai;8;5;13;0;3;3
292;15.07.2018;2018;07;07;Sunnuntai;7;3;10;1;4;5
292;15.07.2018;2018;07;08;Sunnuntai;16;7;23;5;0;5
292;15.07.2018;2018;07;09;Sunnuntai;38;16;54;5;2;7
292;15.07.2018;2018;07;10;Sunnuntai;37;31;68;2;4;6
292;15.07.2018;2018;07;11;Sunnuntai;54;56;110;5;5;10
292;15.07.2018;2018;07;12;Sunnuntai;65;46;111;9;19;28
292;15.07.2018;2018;07;13;Sunnuntai;60;47;107;6;28;34
292;15.07.2018;2018;07;14;Sunnuntai;55;28;83;7;27;34
292;15.07.2018;2018;07;15;Sunnuntai;48;43;91;8;19;27
292;15.07.2018;2018;07;16;Sunnuntai;50;31;81;9;24;33
292;15.07.2018;2018;07;17;Sunnuntai;59;39;98;7;22;29
292;15.07.2018;2018;07;18;Sunnuntai;43;29;72;7;23;30
292;15.07.2018;2018;07;19;Sunnuntai;39;27;66;5;9;14
292;15.07.2018;2018;07;20;Sunnuntai;44;36;80;9;13;22
292;15.07.2018;2018;07;21;Sunnuntai;12;24;36;6;12;18
292;15.07.2018;2018;07;22;Sunnuntai;11;13;24;5;5;10
292;15.07.2018;2018;07;23;Sunnuntai;7;1;8;4;1;5
292;16.07.2018;2018;07;00;Maanantai;1;2;3;0;1;1
292;16.07.2018;2018;07;01;Maanantai;4;4;8;2;2;4
292;16.07.2018;2018;07;02;Maanantai;0;1;1;0;1;1
292;16.07.2018;2018;07;03;Maanantai;2;2;4;2;1;3
292;16.07.2018;2018;07;04;Maanantai;0;2;2;0;0;0
292;16.07.2018;2018;07;05;Maanantai;5;4;9;0;0;0
292;16.07.2018;2018;07;06;Maanantai;24;12;36;2;3;5
292;16.07.2018;2018;07;07;Maanantai;22;11;33;7;4;11
292;16.07.2018;2018;07;08;Maanantai;31;7;38;10;0;10
292;16.07.2018;2018;07;09;Maanantai;40;24;64;7;0;7
292;16.07.2018;2018;07;10;Maanantai;40;34;74;3;2;5
292;16.07.2018;2018;07;11;Maanantai;34;38;72;7;7;14
292;16.07.2018;2018;07;12;Maanantai;48;38;86;6;20;26
292;16.07.2018;2018;07;13;Maanantai;45;45;90;3;9;12
292;16.07.2018;2018;07;14;Maanantai;66;41;107;10;24;34
292;16.07.2018;2018;07;15;Maanantai;57;59;116;13;38;51
292;16.07.2018;2018;07;16;Maanantai;56;55;111;20;30;50
292;16.07.2018;2018;07;17;Maanantai;68;42;110;9;15;24
292;16.07.2018;2018;07;18;Maanantai;77;39;116;15;17;32
292;16.07.2018;2018;07;19;Maanantai;69;49;118;12;32;44
292;16.07.2018;2018;07;20;Maanantai;40;28;68;15;33;48
292;16.07.2018;2018;07;21;Maanantai;37;18;55;10;16;26
292;16.07.2018;2018;07;22;Maanantai;12;7;19;5;10;15
292;16.07.2018;2018;07;23;Maanantai;2;10;12;3;4;7
292;17.07.2018;2018;07;00;Tiistai;4;5;9;2;1;3
292;17.07.2018;2018;07;01;Tiistai;0;3;3;0;0;0
292;17.07.2018;2018;07;02;Tiistai;0;0;0;1;2;3
292;17.07.2018;2018;07;03;Tiistai;1;0;1;0;2;2
292;17.07.2018;2018;07;04;Tiistai;2;0;2;1;1;2
292;17.07.2018;2018;07;05;Tiistai;4;7;11;0;5;5
292;17.07.2018;2018;07;06;Tiistai;24;10;34;2;5;7
292;17.07.2018;2018;07;07;Tiistai;35;15;50;4;0;4
292;17.07.2018;2018;07;08;Tiistai;26;14;40;4;0;4
292;17.07.2018;2018;07;09;Tiistai;21;19;40;5;1;6
292;17.07.2018;2018;07;10;Tiistai;39;39;78;1;4;5
292;17.07.2018;2018;07;11;Tiistai;42;42;84;6;11;17
292;17.07.2018;2018;07;12;Tiistai;47;24;71;5;25;30
292;17.07.2018;2018;07;13;Tiistai;44;39;83;8;21;29
292;17.07.2018;2018;07;14;Tiistai;40;33;73;8;22;30
292;17.07.2018;2018;07;15;Tiistai;49;45;94;9;37;46
292;17.07.2018;2018;07;16;Tiistai;34;31;65;7;24;31
292;17.07.2018;2018;07;17;Tiistai;51;36;87;7;15;22
292;17.07.2018;2018;07;18;Tiistai;56;36;92;9;26;35
292;17.07.2018;2018;07;19;Tiistai;58;19;77;11;9;20
292;17.07.2018;2018;07;20;Tiistai;49;17;66;14;16;30
292;17.07.2018;2018;07;21;Tiistai;30;27;57;17;27;44
292;17.07.2018;2018;07;22;Tiistai;10;18;28;7;6;13
292;17.07.2018;2018;07;23;Tiistai;9;7;16;3;4;7
292;18.07.2018;2018;07;00;Keskiviikko;0;8;8;3;3;6
292;18.07.2018;2018;07;01;Keskiviikko;1;1;2;3;3;6
292;18.07.2018;2018;07;02;Keskiviikko;4;1;5;0;1;1
292;18.07.2018;2018;07;03;Keskiviikko;3;2;5;1;0;1
292;18.07.2018;2018;07;04;Keskiviikko;1;1;2;0;0;0
292;18.07.2018;2018;07;05;Keskiviikko;3;3;6;0;1;1
292;18.07.2018;2018;07;06;Keskiviikko;17;8;25;3;3;6
292;18.07.2018;2018;07;07;Keskiviikko;21;18;39;3;0;3
292;18.07.2018;2018;07;08;Keskiviikko;30;23;53;8;2;10
292;18.07.2018;2018;07;09;Keskiviikko;30;30;60;2;3;5
292;18.07.2018;2018;07;10;Keskiviikko;36;36;72;2;1;3
292;18.07.2018;2018;07;11;Keskiviikko;46;38;84;4;14;18
292;18.07.2018;2018;07;12;Keskiviikko;51;40;91;5;17;22
292;18.07.2018;2018;07;13;Keskiviikko;39;46;85;7;27;34
292;18.07.2018;2018;07;14;Keskiviikko;54;30;84;13;22;35
292;18.07.2018;2018;07;15;Keskiviikko;44;41;85;14;23;37
292;18.07.2018;2018;07;16;Keskiviikko;44;36;80;8;17;25
292;18.07.2018;2018;07;17;Keskiviikko;61;38;99;9;16;25
292;18.07.2018;2018;07;18;Keskiviikko;59;50;109;8;18;26
292;18.07.2018;2018;07;19;Keskiviikko;56;26;82;13;22;35
292;18.07.2018;2018;07;20;Keskiviikko;33;34;67;6;23;29
292;18.07.2018;2018;07;21;Keskiviikko;54;37;91;17;22;39
292;18.07.2018;2018;07;22;Keskiviikko;19;8;27;1;13;14
292;18.07.2018;2018;07;23;Keskiviikko;8;10;18;1;5;6
292;19.07.2018;2018;07;00;Torstai;7;6;13;2;1;3
292;19.07.2018;2018;07;01;Torstai;3;3;6;3;1;4
292;19.07.2018;2018;07;02;Torstai;4;0;4;3;2;5
292;19.07.2018;2018;07;03;Torstai;0;1;1;1;0;1
292;19.07.2018;2018;07;04;Torstai;1;4;5;1;0;1
292;19.07.2018;2018;07;05;Torstai;5;3;8;1;4;5
292;19.07.2018;2018;07;06;Torstai;23;9;32;3;7;10
292;19.07.2018;2018;07;07;Torstai;20;16;36;3;3;6
292;19.07.2018;2018;07;08;Torstai;27;18;45;2;0;2
292;19.07.2018;2018;07;09;Torstai;32;31;63;0;1;1
292;19.07.2018;2018;07;10;Torstai;24;24;48;1;2;3
292;19.07.2018;2018;07;11;Torstai;43;30;73;2;14;16
292;19.07.2018;2018;07;12;Torstai;35;33;68;9;24;33
292;19.07.2018;2018;07;13;Torstai;59;32;91;3;14;17
292;19.07.2018;2018;07;14;Torstai;44;29;73;6;25;31
292;19.07.2018;2018;07;15;Torstai;50;35;85;10;22;32
292;19.07.2018;2018;07;16;Torstai;55;48;103;10;17;27
292;19.07.2018;2018;07;17;Torstai;91;36;127;11;17;28
292;19.07.2018;2018;07;18;Torstai;64;37;101;11;21;32
292;19.07.2018;2018;07;19;Torstai;45;41;86;12;16;28
292;19.07.2018;2018;07;20;Torstai;46;51;97;11;27;38
292;19.07.2018;2018;07;21;Torstai;41;28;69;16;9;25
292;19.07.2018;2018;07;22;Torstai;18;18;36;9;16;25
292;19.07.2018;2018;07;23;Torstai;4;8;12;3;5;8
292;20.07.2018;2018;07;00;Perjantai;5;6;11;1;3;4
292;20.07.2018;2018;07;01;Perjantai;3;6;9;0;3;3
292;20.07.2018;2018;07;02;Perjantai;1;2;3;2;1;3
292;20.07.2018;2018;07;03;Perjantai;1;3;4;0;3;3
292;20.07.2018;2018;07;04;Perjantai;4;4;8;0;0;0
292;20.07.2018;2018;07;05;Perjantai;6;4;10;3;4;7
292;20.07.2018;2018;07;06;Perjantai;18;13;31;4;10;14
292;20.07.2018;2018;07;07;Perjantai;16;15;31;0;0;0
292;20.07.2018;2018;07;08;Perjantai;25;20;45;1;1;2
292;20.07.2018;2018;07;09;Perjantai;27;26;53;1;2;3
292;20.07.2018;2018;07;10;Perjantai;33;37;70;2;1;3
292;20.07.2018;2018;07;11;Perjantai;42;29;71;5;10;15
292;20.07.2018;2018;07;12;Perjantai;39;32;71;2;11;13
292;20.07.2018;2018;07;13;Perjantai;48;21;69;5;24;29
292;20.07.2018;2018;07;14;Perjantai;47;31;78;5;17;22
292;20.07.2018;2018;07;15;Perjantai;41;46;87;17;29;46
292;20.07.2018;2018;07;16;Perjantai;52;34;86;10;13;23
292;20.07.2018;2018;07;17;Perjantai;54;32;86;12;14;26
292;20.07.2018;2018;07;18;Perjantai;37;27;64;13;9;22
292;20.07.2018;2018;07;19;Perjantai;24;28;52;6;15;21
292;20.07.2018;2018;07;20;Perjantai;38;30;68;11;19;30
292;20.07.2018;2018;07;21;Perjantai;16;12;28;6;8;14
292;20.07.2018;2018;07;22;Perjantai;23;15;38;4;13;17
292;20.07.2018;2018;07;23;Perjantai;9;13;22;2;6;8
292;21.07.2018;2018;07;00;Lauantai;7;13;20;8;1;9
292;21.07.2018;2018;07;01;Lauantai;7;5;12;5;2;7
292;21.07.2018;2018;07;02;Lauantai;3;9;12;4;3;7
292;21.07.2018;2018;07;03;Lauantai;2;13;15;1;11;12
292;21.07.2018;2018;07;04;Lauantai;2;3;5;1;0;1
292;21.07.2018;2018;07;05;Lauantai;2;4;6;0;1;1
292;21.07.2018;2018;07;06;Lauantai;6;4;10;0;0;0
292;21.07.2018;2018;07;07;Lauantai;9;3;12;1;1;2
292;21.07.2018;2018;07;08;Lauantai;15;11;26;2;1;3
292;21.07.2018;2018;07;09;Lauantai;21;20;41;4;3;7
292;21.07.2018;2018;07;10;Lauantai;19;19;38;4;4;8
292;21.07.2018;2018;07;11;Lauantai;30;18;48;10;7;17
292;21.07.2018;2018;07;12;Lauantai;24;19;43;5;4;9
292;21.07.2018;2018;07;13;Lauantai;21;20;41;1;2;3
292;21.07.2018;2018;07;14;Lauantai;40;35;75;3;5;8
292;21.07.2018;2018;07;15;Lauantai;34;17;51;6;4;10
292;21.07.2018;2018;07;16;Lauantai;26;22;48;5;5;10
292;21.07.2018;2018;07;17;Lauantai;40;18;58;8;7;15
292;21.07.2018;2018;07;18;Lauantai;28;24;52;9;8;17
292;21.07.2018;2018;07;19;Lauantai;21;26;47;7;10;17
292;21.07.2018;2018;07;20;Lauantai;20;23;43;5;11;16
292;21.07.2018;2018;07;21;Lauantai;26;16;42;6;6;12
292;21.07.2018;2018;07;22;Lauantai;14;9;23;8;12;20
292;21.07.2018;2018;07;23;Lauantai;12;8;20;8;2;10
292;22.07.2018;2018;07;00;Sunnuntai;9;5;14;4;2;6
292;22.07.2018;2018;07;01;Sunnuntai;3;4;7;3;1;4
292;22.07.2018;2018;07;02;Sunnuntai;1;5;6;1;5;6
292;22.07.2018;2018;07;03;Sunnuntai;1;2;3;2;7;9
292;22.07.2018;2018;07;04;Sunnuntai;2;2;4;3;2;5
292;22.07.2018;2018;07;05;Sunnuntai;4;2;6;0;0;0
292;22.07.2018;2018;07;06;Sunnuntai;7;7;14;1;3;4
292;22.07.2018;2018;07;07;Sunnuntai;4;4;8;0;0;0
292;22.07.2018;2018;07;08;Sunnuntai;12;9;21;2;4;6
292;22.07.2018;2018;07;09;Sunnuntai;14;13;27;3;4;7
292;22.07.2018;2018;07;10;Sunnuntai;15;15;30;1;6;7
292;22.07.2018;2018;07;11;Sunnuntai;28;30;58;5;6;11
292;22.07.2018;2018;07;12;Sunnuntai;52;32;84;1;11;12
292;22.07.2018;2018;07;13;Sunnuntai;39;21;60;3;7;10
292;22.07.2018;2018;07;14;Sunnuntai;48;27;75;7;9;16
292;22.07.2018;2018;07;15;Sunnuntai;29;26;55;11;15;26
292;22.07.2018;2018;07;16;Sunnuntai;51;27;78;4;8;12
292;22.07.2018;2018;07;17;Sunnuntai;32;32;64;10;12;22
292;22.07.2018;2018;07;18;Sunnuntai;54;38;92;17;27;44
292;22.07.2018;2018;07;19;Sunnuntai;35;40;75;7;15;22
292;22.07.2018;2018;07;20;Sunnuntai;22;19;41;9;9;18
292;22.07.2018;2018;07;21;Sunnuntai;18;16;34;3;16;19
292;22.07.2018;2018;07;22;Sunnuntai;14;13;27;1;4;5
292;22.07.2018;2018;07;23;Sunnuntai;1;4;5;1;2;3
292;23.07.2018;2018;07;00;Maanantai;7;5;12;2;1;3
292;23.07.2018;2018;07;01;Maanantai;7;5;12;2;4;6
292;23.07.2018;2018;07;02;Maanantai;1;2;3;1;3;4
292;23.07.2018;2018;07;03;Maanantai;0;1;1;0;2;2
292;23.07.2018;2018;07;04;Maanantai;2;1;3;0;0;0
292;23.07.2018;2018;07;05;Maanantai;5;2;7;1;5;6
292;23.07.2018;2018;07;06;Maanantai;18;16;34;3;1;4
292;23.07.2018;2018;07;07;Maanantai;18;17;35;2;2;4
292;23.07.2018;2018;07;08;Maanantai;18;17;35;3;1;4
292;23.07.2018;2018;07;09;Maanantai;28;26;54;6;5;11
292;23.07.2018;2018;07;10;Maanantai;29;28;57;4;1;5
292;23.07.2018;2018;07;11;Maanantai;33;32;65;5;4;9
292;23.07.2018;2018;07;12;Maanantai;53;38;91;10;21;31
292;23.07.2018;2018;07;13;Maanantai;45;49;94;7;31;38
292;23.07.2018;2018;07;14;Maanantai;61;43;104;20;22;42
292;23.07.2018;2018;07;15;Maanantai;70;47;117;9;26;35
292;23.07.2018;2018;07;16;Maanantai;78;72;150;13;40;53
292;23.07.2018;2018;07;17;Maanantai;68;54;122;17;29;46
292;23.07.2018;2018;07;18;Maanantai;64;55;119;12;31;43
292;23.07.2018;2018;07;19;Maanantai;68;44;112;19;25;44
292;23.07.2018;2018;07;20;Maanantai;72;38;110;10;32;42
292;23.07.2018;2018;07;21;Maanantai;40;25;65;15;22;37
292;23.07.2018;2018;07;22;Maanantai;23;10;33;7;8;15
292;23.07.2018;2018;07;23;Maanantai;11;2;13;4;4;8
292;24.07.2018;2018;07;00;Tiistai;2;3;5;1;2;3
292;24.07.2018;2018;07;01;Tiistai;3;6;9;0;0;0
292;24.07.2018;2018;07;02;Tiistai;0;1;1;2;3;5
292;24.07.2018;2018;07;03;Tiistai;3;1;4;4;0;4
292;24.07.2018;2018;07;04;Tiistai;2;1;3;1;2;3
292;24.07.2018;2018;07;05;Tiistai;6;6;12;3;2;5
292;24.07.2018;2018;07;06;Tiistai;22;11;33;2;5;7
292;24.07.2018;2018;07;07;Tiistai;29;14;43;5;9;14
292;24.07.2018;2018;07;08;Tiistai;21;14;35;7;12;19
292;24.07.2018;2018;07;09;Tiistai;34;12;46;5;5;10
292;24.07.2018;2018;07;10;Tiistai;30;28;58;0;1;1
292;24.07.2018;2018;07;11;Tiistai;52;54;106;1;1;2
292;24.07.2018;2018;07;12;Tiistai;62;36;98;9;13;22
292;24.07.2018;2018;07;13;Tiistai;50;31;81;3;0;3
292;24.07.2018;2018;07;14;Tiistai;52;45;97;6;14;20
292;24.07.2018;2018;07;15;Tiistai;62;52;114;12;30;42
292;24.07.2018;2018;07;16;Tiistai;58;53;111;10;25;35
292;24.07.2018;2018;07;17;Tiistai;65;29;94;2;13;15
292;24.07.2018;2018;07;18;Tiistai;52;35;87;12;18;30
292;24.07.2018;2018;07;19;Tiistai;75;44;119;12;25;37
292;24.07.2018;2018;07;20;Tiistai;42;25;67;13;32;45
292;24.07.2018;2018;07;21;Tiistai;32;30;62;10;14;24
292;24.07.2018;2018;07;22;Tiistai;30;16;46;3;15;18
292;24.07.2018;2018;07;23;Tiistai;8;17;25;2;0;2
292;25.07.2018;2018;07;00;Keskiviikko;6;6;12;1;6;7
292;25.07.2018;2018;07;01;Keskiviikko;4;3;7;2;2;4
292;25.07.2018;2018;07;02;Keskiviikko;2;5;7;2;0;2
292;25.07.2018;2018;07;03;Keskiviikko;0;0;0;2;2;4
292;25.07.2018;2018;07;04;Keskiviikko;0;0;0;1;0;1
292;25.07.2018;2018;07;05;Keskiviikko;6;6;12;0;4;4
292;25.07.2018;2018;07;06;Keskiviikko;23;6;29;3;6;9
292;25.07.2018;2018;07;07;Keskiviikko;29;9;38;1;4;5
292;25.07.2018;2018;07;08;Keskiviikko;30;16;46;5;13;18
292;25.07.2018;2018;07;09;Keskiviikko;44;9;53;13;3;16
292;25.07.2018;2018;07;10;Keskiviikko;47;41;88;3;0;3
292;25.07.2018;2018;07;11;Keskiviikko;50;48;98;1;4;5
292;25.07.2018;2018;07;12;Keskiviikko;42;44;86;5;10;15
292;25.07.2018;2018;07;13;Keskiviikko;63;51;114;9;23;32
292;25.07.2018;2018;07;14;Keskiviikko;58;36;94;8;15;23
292;25.07.2018;2018;07;15;Keskiviikko;60;53;113;3;35;38
292;25.07.2018;2018;07;16;Keskiviikko;53;38;91;5;23;28
292;25.07.2018;2018;07;17;Keskiviikko;52;41;93;11;19;30
292;25.07.2018;2018;07;18;Keskiviikko;52;30;82;8;22;30
292;25.07.2018;2018;07;19;Keskiviikko;64;38;102;10;15;25
292;25.07.2018;2018;07;20;Keskiviikko;52;30;82;10;16;26
292;25.07.2018;2018;07;21;Keskiviikko;27;25;52;10;13;23
292;25.07.2018;2018;07;22;Keskiviikko;20;16;36;1;10;11
292;25.07.2018;2018;07;23;Keskiviikko;8;5;13;1;6;7
292;26.07.2018;2018;07;00;Torstai;7;6;13;2;2;4
292;26.07.2018;2018;07;01;Torstai;1;5;6;0;1;1
292;26.07.2018;2018;07;02;Torstai;2;1;3;2;0;2
292;26.07.2018;2018;07;03;Torstai;1;0;1;0;2;2
292;26.07.2018;2018;07;04;Torstai;1;2;3;0;0;0
292;26.07.2018;2018;07;05;Torstai;7;8;15;1;1;2
292;26.07.2018;2018;07;06;Torstai;19;16;35;5;0;5
292;26.07.2018;2018;07;07;Torstai;23;23;46;2;1;3
292;26.07.2018;2018;07;08;Torstai;17;16;33;2;2;4
292;26.07.2018;2018;07;09;Torstai;27;25;52;1;0;1
292;26.07.2018;2018;07;10;Torstai;33;29;62;3;1;4
292;26.07.2018;2018;07;11;Torstai;42;40;82;1;1;2
292;26.07.2018;2018;07;12;Torstai;32;31;63;6;17;23
292;26.07.2018;2018;07;13;Torstai;46;41;87;1;3;4
292;26.07.2018;2018;07;14;Torstai;29;29;58;1;0;1
292;26.07.2018;2018;07;15;Torstai;49;37;86;8;9;17
292;26.07.2018;2018;07;16;Torstai;60;37;97;4;16;20
292;26.07.2018;2018;07;17;Torstai;75;35;110;12;20;32
292;26.07.2018;2018;07;18;Torstai;68;44;112;6;10;16
292;26.07.2018;2018;07;19;Torstai;62;34;96;11;9;20
292;26.07.2018;2018;07;20;Torstai;52;58;110;8;34;42
292;26.07.2018;2018;07;21;Torstai;20;30;50;6;21;27
292;26.07.2018;2018;07;22;Torstai;21;18;39;7;13;20
292;26.07.2018;2018;07;23;Torstai;9;10;19;2;5;7
292;27.07.2018;2018;07;00;Perjantai;6;3;9;5;2;7
292;27.07.2018;2018;07;01;Perjantai;1;0;1;1;1;2
292;27.07.2018;2018;07;02;Perjantai;2;3;5;0;4;4
292;27.07.2018;2018;07;03;Perjantai;1;3;4;1;3;4
292;27.07.2018;2018;07;04;Perjantai;0;3;3;0;0;0
292;27.07.2018;2018;07;05;Perjantai;3;7;10;1;3;4
292;27.07.2018;2018;07;06;Perjantai;23;14;37;2;3;5
292;27.07.2018;2018;07;07;Perjantai;26;9;35;4;5;9
292;27.07.2018;2018;07;08;Perjantai;31;8;39;7;7;14
292;27.07.2018;2018;07;09;Perjantai;37;15;52;8;0;8
292;27.07.2018;2018;07;10;Perjantai;38;34;72;3;0;3
292;27.07.2018;2018;07;11;Perjantai;44;48;92;6;6;12
292;27.07.2018;2018;07;12;Perjantai;50;40;90;14;19;33
292;27.07.2018;2018;07;13;Perjantai;48;36;84;10;21;31
292;27.07.2018;2018;07;14;Perjantai;53;35;88;12;19;31
292;27.07.2018;2018;07;15;Perjantai;43;30;73;3;21;24
292;27.07.2018;2018;07;16;Perjantai;55;40;95;9;23;32
292;27.07.2018;2018;07;17;Perjantai;60;21;81;25;13;38
292;27.07.2018;2018;07;18;Perjantai;48;39;87;6;15;21
292;27.07.2018;2018;07;19;Perjantai;43;21;64;9;16;25
292;27.07.2018;2018;07;20;Perjantai;34;34;68;9;8;17
292;27.07.2018;2018;07;21;Perjantai;31;14;45;3;11;14
292;27.07.2018;2018;07;22;Perjantai;11;9;20;4;6;10
292;27.07.2018;2018;07;23;Perjantai;8;10;18;9;7;16
292;28.07.2018;2018;07;00;Lauantai;5;3;8;4;0;4
292;28.07.2018;2018;07;01;Lauantai;1;1;2;2;2;4
292;28.07.2018;2018;07;02;Lauantai;1;3;4;0;1;1
292;28.07.2018;2018;07;03;Lauantai;0;4;4;0;6;6
292;28.07.2018;2018;07;04;Lauantai;0;2;2;0;2;2
292;28.07.2018;2018;07;05;Lauantai;2;2;4;0;1;1
292;28.07.2018;2018;07;06;Lauantai;3;5;8;1;1;2
292;28.07.2018;2018;07;07;Lauantai;7;3;10;2;6;8
292;28.07.2018;2018;07;08;Lauantai;15;6;21;4;5;9
292;28.07.2018;2018;07;09;Lauantai;23;8;31;8;2;10
292;28.07.2018;2018;07;10;Lauantai;25;18;43;2;0;2
292;28.07.2018;2018;07;11;Lauantai;30;30;60;7;3;10
292;28.07.2018;2018;07;12;Lauantai;46;48;94;6;16;22
292;28.07.2018;2018;07;13;Lauantai;64;25;89;8;13;21
292;28.07.2018;2018;07;14;Lauantai;38;30;68;9;27;36
292;28.07.2018;2018;07;15;Lauantai;58;40;98;8;18;26
292;28.07.2018;2018;07;16;Lauantai;70;38;108;10;15;25
292;28.07.2018;2018;07;17;Lauantai;58;21;79;6;15;21
292;28.07.2018;2018;07;18;Lauantai;55;25;80;8;10;18
292;28.07.2018;2018;07;19;Lauantai;24;50;74;11;24;35
292;28.07.2018;2018;07;20;Lauantai;30;27;57;9;17;26
292;28.07.2018;2018;07;21;Lauantai;21;14;35;7;8;15
292;28.07.2018;2018;07;22;Lauantai;8;14;22;3;11;14
292;28.07.2018;2018;07;23;Lauantai;3;15;18;7;3;10
292;29.07.2018;2018;07;00;Sunnuntai;4;3;7;1;3;4
292;29.07.2018;2018;07;01;Sunnuntai;5;4;9;0;3;3
292;29.07.2018;2018;07;02;Sunnuntai;3;2;5;3;3;6
292;29.07.2018;2018;07;03;Sunnuntai;0;6;6;3;3;6
292;29.07.2018;2018;07;04;Sunnuntai;0;0;0;0;0;0
292;29.07.2018;2018;07;05;Sunnuntai;2;5;7;2;1;3
292;29.07.2018;2018;07;06;Sunnuntai;5;4;9;0;2;2
292;29.07.2018;2018;07;07;Sunnuntai;6;6;12;2;0;2
292;29.07.2018;2018;07;08;Sunnuntai;12;5;17;7;5;12
292;29.07.2018;2018;07;09;Sunnuntai;20;15;35;2;0;2
292;29.07.2018;2018;07;10;Sunnuntai;31;28;59;0;0;0
292;29.07.2018;2018;07;11;Sunnuntai;42;38;80;6;2;8
292;29.07.2018;2018;07;12;Sunnuntai;41;36;77;10;8;18
292;29.07.2018;2018;07;13;Sunnuntai;58;25;83;8;21;29
292;29.07.2018;2018;07;14;Sunnuntai;39;30;69;7;23;30
292;29.07.2018;2018;07;15;Sunnuntai;44;32;76;12;21;33
292;29.07.2018;2018;07;16;Sunnuntai;37;36;73;14;18;32
292;29.07.2018;2018;07;17;Sunnuntai;51;34;85;13;18;31
292;29.07.2018;2018;07;18;Sunnuntai;66;29;95;8;18;26
292;29.07.2018;2018;07;19;Sunnuntai;49;51;100;16;19;35
292;29.07.2018;2018;07;20;Sunnuntai;27;38;65;16;19;35
292;29.07.2018;2018;07;21;Sunnuntai;30;28;58;6;12;18
292;29.07.2018;2018;07;22;Sunnuntai;12;16;28;17;12;29
292;29.07.2018;2018;07;23;Sunnuntai;9;8;17;2;2;4
292;30.07.2018;2018;07;00;Maanantai;5;1;6;0;2;2
292;30.07.2018;2018;07;01;Maanantai;4;5;9;3;1;4
292;30.07.2018;2018;07;02;Maanantai;1;1;2;0;2;2
292;30.07.2018;2018;07;03;Maanantai;0;0;0;0;0;0
292;30.07.2018;2018;07;04;Maanantai;1;1;2;0;1;1
292;30.07.2018;2018;07;05;Maanantai;10;6;16;0;6;6
292;30.07.2018;2018;07;06;Maanantai;31;16;47;2;4;6
292;30.07.2018;2018;07;07;Maanantai;30;13;43;9;2;11
292;30.07.2018;2018;07;08;Maanantai;37;10;47;2;0;2
292;30.07.2018;2018;07;09;Maanantai;45;34;79;4;0;4
292;30.07.2018;2018;07;10;Maanantai;42;38;80;1;2;3
292;30.07.2018;2018;07;11;Maanantai;35;31;66;6;4;10
292;30.07.2018;2018;07;12;Maanantai;53;47;100;4;18;22
292;30.07.2018;2018;07;13;Maanantai;51;34;85;3;22;25
292;30.07.2018;2018;07;14;Maanantai;47;57;104;12;26;38
292;30.07.2018;2018;07;15;Maanantai;63;59;122;13;25;38
292;30.07.2018;2018;07;16;Maanantai;57;51;108;15;35;50
292;30.07.2018;2018;07;17;Maanantai;71;41;112;20;17;37
292;30.07.2018;2018;07;18;Maanantai;56;40;96;8;18;26
292;30.07.2018;2018;07;19;Maanantai;50;44;94;11;16;27
292;30.07.2018;2018;07;20;Maanantai;39;37;76;17;18;35
292;30.07.2018;2018;07;21;Maanantai;38;19;57;11;16;27
292;30.07.2018;2018;07;22;Maanantai;21;14;35;9;9;18
292;30.07.2018;2018;07;23;Maanantai;12;5;17;5;3;8
292;31.07.2018;2018;07;00;Tiistai;2;5;7;5;7;12
292;31.07.2018;2018;07;01;Tiistai;2;5;7;6;3;9
292;31.07.2018;2018;07;02;Tiistai;3;3;6;2;4;6
292;31.07.2018;2018;07;03;Tiistai;0;1;1;1;0;1
292;31.07.2018;2018;07;04;Tiistai;1;1;2;0;0;0
292;31.07.2018;2018;07;05;Tiistai;11;5;16;1;5;6
292;31.07.2018;2018;07;06;Tiistai;25;16;41;1;7;8
292;31.07.2018;2018;07;07;Tiistai;39;21;60;4;2;6
292;31.07.2018;2018;07;08;Tiistai;35;11;46;5;2;7
292;31.07.2018;2018;07;09;Tiistai;55;28;83;4;1;5
292;31.07.2018;2018;07;10;Tiistai;25;25;50;4;0;4
292;31.07.2018;2018;07;11;Tiistai;46;45;91;0;1;1
292;31.07.2018;2018;07;12;Tiistai;43;37;80;1;6;7
292;31.07.2018;2018;07;13;Tiistai;43;36;79;2;13;15
292;31.07.2018;2018;07;14;Tiistai;49;31;80;4;11;15
292;31.07.2018;2018;07;15;Tiistai;53;40;93;5;5;10
292;31.07.2018;2018;07;16;Tiistai;63;39;102;2;6;8
292;31.07.2018;2018;07;17;Tiistai;56;40;96;15;19;34
292;31.07.2018;2018;07;18;Tiistai;59;40;99;11;18;29
292;31.07.2018;2018;07;19;Tiistai;33;38;71;8;29;37
292;31.07.2018;2018;07;20;Tiistai;44;35;79;14;25;39
292;31.07.2018;2018;07;21;Tiistai;39;26;65;17;22;39
292;31.07.2018;2018;07;22;Tiistai;15;13;28;9;10;19
292;31.07.2018;2018;07;23;Tiistai;9;6;15;4;3;7
292;01.08.2018;2018;08;00;Keskiviikko;5;4;9;7;2;9
292;01.08.2018;2018;08;01;Keskiviikko;2;3;5;2;2;4
292;01.08.2018;2018;08;02;Keskiviikko;1;3;4;0;3;3
292;01.08.2018;2018;08;03;Keskiviikko;0;2;2;0;1;1
292;01.08.2018;2018;08;04;Keskiviikko;2;2;4;0;0;0
292;01.08.2018;2018;08;05;Keskiviikko;8;6;14;2;2;4
292;01.08.2018;2018;08;06;Keskiviikko;24;16;40;3;4;7
292;01.08.2018;2018;08;07;Keskiviikko;30;21;51;6;0;6
292;01.08.2018;2018;08;08;Keskiviikko;30;20;50;10;9;19
292;01.08.2018;2018;08;09;Keskiviikko;51;18;69;6;2;8
292;01.08.2018;2018;08;10;Keskiviikko;38;36;74;1;1;2
292;01.08.2018;2018;08;11;Keskiviikko;35;35;70;1;6;7
292;01.08.2018;2018;08;12;Keskiviikko;37;32;69;5;11;16
292;01.08.2018;2018;08;13;Keskiviikko;45;20;65;7;12;19
292;01.08.2018;2018;08;14;Keskiviikko;56;47;103;4;19;23
292;01.08.2018;2018;08;15;Keskiviikko;44;44;88;10;12;22
292;01.08.2018;2018;08;16;Keskiviikko;50;32;82;1;11;12
292;01.08.2018;2018;08;17;Keskiviikko;55;22;77;6;11;17
292;01.08.2018;2018;08;18;Keskiviikko;49;40;89;6;19;25
292;01.08.2018;2018;08;19;Keskiviikko;72;49;121;10;20;30
292;01.08.2018;2018;08;20;Keskiviikko;42;39;81;8;37;45
292;01.08.2018;2018;08;21;Keskiviikko;42;28;70;6;12;18
292;01.08.2018;2018;08;22;Keskiviikko;16;12;28;7;6;13
292;01.08.2018;2018;08;23;Keskiviikko;7;9;16;1;2;3
292;02.08.2018;2018;08;00;Torstai;3;12;15;3;3;6
292;02.08.2018;2018;08;01;Torstai;5;3;8;0;1;1
292;02.08.2018;2018;08;02;Torstai;6;7;13;5;0;5
292;02.08.2018;2018;08;03;Torstai;4;3;7;2;0;2
292;02.08.2018;2018;08;04;Torstai;3;6;9;1;1;2
292;02.08.2018;2018;08;05;Torstai;6;10;16;0;4;4
292;02.08.2018;2018;08;06;Torstai;23;9;32;5;3;8
292;02.08.2018;2018;08;07;Torstai;34;22;56;2;1;3
292;02.08.2018;2018;08;08;Torstai;48;16;64;6;3;9
292;02.08.2018;2018;08;09;Torstai;41;30;71;0;0;0
292;02.08.2018;2018;08;10;Torstai;45;44;89;1;1;2
292;02.08.2018;2018;08;11;Torstai;44;45;89;1;2;3
292;02.08.2018;2018;08;12;Torstai;50;50;100;0;3;3
292;02.08.2018;2018;08;13;Torstai;39;33;72;3;2;5
292;02.08.2018;2018;08;14;Torstai;56;49;105;7;4;11
292;02.08.2018;2018;08;15;Torstai;56;52;108;9;15;24
292;02.08.2018;2018;08;16;Torstai;75;50;125;13;25;38
292;02.08.2018;2018;08;17;Torstai;98;49;147;13;21;34
292;02.08.2018;2018;08;18;Torstai;57;37;94;7;22;29
292;02.08.2018;2018;08;19;Torstai;62;29;91;5;12;17
292;02.08.2018;2018;08;20;Torstai;51;29;80;8;21;29
292;02.08.2018;2018;08;21;Torstai;28;65;93;15;32;47
292;02.08.2018;2018;08;22;Torstai;16;22;38;9;16;25
292;02.08.2018;2018;08;23;Torstai;8;4;12;3;4;7
292;03.08.2018;2018;08;00;Perjantai;5;4;9;1;1;2
292;03.08.2018;2018;08;01;Perjantai;3;4;7;0;1;1
292;03.08.2018;2018;08;02;Perjantai;1;1;2;3;2;5
292;03.08.2018;2018;08;03;Perjantai;1;0;1;0;1;1
292;03.08.2018;2018;08;04;Perjantai;2;2;4;0;1;1
292;03.08.2018;2018;08;05;Perjantai;6;3;9;1;2;3
292;03.08.2018;2018;08;06;Perjantai;15;11;26;1;3;4
292;03.08.2018;2018;08;07;Perjantai;8;9;17;2;3;5
292;03.08.2018;2018;08;08;Perjantai;15;15;30;6;3;9
292;03.08.2018;2018;08;09;Perjantai;22;20;42;3;5;8
292;03.08.2018;2018;08;10;Perjantai;4;3;7;1;0;1
292;03.08.2018;2018;08;11;Perjantai;5;4;9;1;2;3
292;03.08.2018;2018;08;12;Perjantai;14;13;27;1;4;5
292;03.08.2018;2018;08;13;Perjantai;21;21;42;4;1;5
292;03.08.2018;2018;08;14;Perjantai;34;32;66;4;5;9
292;03.08.2018;2018;08;15;Perjantai;43;55;98;11;16;27
292;03.08.2018;2018;08;16;Perjantai;51;43;94;7;15;22
292;03.08.2018;2018;08;17;Perjantai;75;39;114;11;6;17
292;03.08.2018;2018;08;18;Perjantai;56;37;93;13;23;36
292;03.08.2018;2018;08;19;Perjantai;48;35;83;7;14;21
292;03.08.2018;2018;08;20;Perjantai;49;38;87;3;23;26
292;03.08.2018;2018;08;21;Perjantai;23;27;50;10;5;15
292;03.08.2018;2018;08;22;Perjantai;17;14;31;5;5;10
292;03.08.2018;2018;08;23;Perjantai;3;10;13;4;7;11
292;04.08.2018;2018;08;00;Lauantai;6;8;14;6;5;11
292;04.08.2018;2018;08;01;Lauantai;9;4;13;3;6;9
292;04.08.2018;2018;08;02;Lauantai;0;9;9;3;6;9
292;04.08.2018;2018;08;03;Lauantai;2;4;6;1;8;9
292;04.08.2018;2018;08;04;Lauantai;3;1;4;0;6;6
292;04.08.2018;2018;08;05;Lauantai;2;3;5;2;1;3
292;04.08.2018;2018;08;06;Lauantai;4;3;7;0;3;3
292;04.08.2018;2018;08;07;Lauantai;9;6;15;2;3;5
292;04.08.2018;2018;08;08;Lauantai;18;9;27;6;7;13
292;04.08.2018;2018;08;09;Lauantai;27;30;57;6;3;9
292;04.08.2018;2018;08;10;Lauantai;44;35;79;189;54;243
292;04.08.2018;2018;08;11;Lauantai;38;40;78;59;142;201
292;04.08.2018;2018;08;12;Lauantai;73;53;126;208;49;257
292;04.08.2018;2018;08;13;Lauantai;45;63;108;19;237;256
292;04.08.2018;2018;08;14;Lauantai;60;49;109;9;98;107
292;04.08.2018;2018;08;15;Lauantai;52;47;99;12;25;37
292;04.08.2018;2018;08;16;Lauantai;59;51;110;13;21;34
292;04.08.2018;2018;08;17;Lauantai;57;36;93;13;17;30
292;04.08.2018;2018;08;18;Lauantai;56;34;90;17;25;42
292;04.08.2018;2018;08;19;Lauantai;31;42;73;19;19;38
292;04.08.2018;2018;08;20;Lauantai;42;40;82;10;20;30
292;04.08.2018;2018;08;21;Lauantai;22;22;44;12;19;31
292;04.08.2018;2018;08;22;Lauantai;24;10;34;11;9;20
292;04.08.2018;2018;08;23;Lauantai;11;12;23;4;3;7
292;05.08.2018;2018;08;00;Sunnuntai;5;4;9;5;4;9
292;05.08.2018;2018;08;01;Sunnuntai;7;6;13;2;7;9
292;05.08.2018;2018;08;02;Sunnuntai;8;7;15;4;4;8
292;05.08.2018;2018;08;03;Sunnuntai;2;11;13;4;7;11
292;05.08.2018;2018;08;04;Sunnuntai;5;2;7;2;1;3
292;05.08.2018;2018;08;05;Sunnuntai;3;0;3;3;5;8
292;05.08.2018;2018;08;06;Sunnuntai;6;6;12;0;2;2
292;05.08.2018;2018;08;07;Sunnuntai;8;7;15;1;1;2
292;05.08.2018;2018;08;08;Sunnuntai;13;12;25;6;5;11
292;05.08.2018;2018;08;09;Sunnuntai;22;19;41;3;5;8
292;05.08.2018;2018;08;10;Sunnuntai;41;39;80;3;8;11
292;05.08.2018;2018;08;11;Sunnuntai;57;57;114;8;9;17
292;05.08.2018;2018;08;12;Sunnuntai;27;29;56;5;5;10
292;05.08.2018;2018;08;13;Sunnuntai;28;31;59;5;2;7
292;05.08.2018;2018;08;14;Sunnuntai;42;26;68;15;19;34
292;05.08.2018;2018;08;15;Sunnuntai;36;41;77;6;18;24
292;05.08.2018;2018;08;16;Sunnuntai;47;46;93;2;21;23
292;05.08.2018;2018;08;17;Sunnuntai;66;46;112;16;15;31
292;05.08.2018;2018;08;18;Sunnuntai;72;43;115;10;22;32
292;05.08.2018;2018;08;19;Sunnuntai;49;50;99;7;24;31
292;05.08.2018;2018;08;20;Sunnuntai;42;30;72;15;27;42
292;05.08.2018;2018;08;21;Sunnuntai;20;20;40;9;15;24
292;05.08.2018;2018;08;22;Sunnuntai;11;9;20;5;5;10
292;05.08.2018;2018;08;23;Sunnuntai;6;8;14;2;2;4
292;06.08.2018;2018;08;00;Maanantai;4;2;6;3;3;6
292;06.08.2018;2018;08;01;Maanantai;3;3;6;1;1;2
292;06.08.2018;2018;08;02;Maanantai;3;4;7;2;2;4
292;06.08.2018;2018;08;03;Maanantai;2;4;6;2;0;2
292;06.08.2018;2018;08;04;Maanantai;2;0;2;0;0;0
292;06.08.2018;2018;08;05;Maanantai;5;5;10;1;0;1
292;06.08.2018;2018;08;06;Maanantai;20;11;31;0;4;4
292;06.08.2018;2018;08;07;Maanantai;29;20;49;2;6;8
292;06.08.2018;2018;08;08;Maanantai;16;15;31;6;6;12
292;06.08.2018;2018;08;09;Maanantai;17;15;32;6;4;10
292;06.08.2018;2018;08;10;Maanantai;24;19;43;7;9;16
292;06.08.2018;2018;08;11;Maanantai;16;16;32;8;6;14
292;06.08.2018;2018;08;12;Maanantai;8;7;15;1;6;7
292;06.08.2018;2018;08;13;Maanantai;11;8;19;5;0;5
292;06.08.2018;2018;08;14;Maanantai;14;12;26;1;4;5
292;06.08.2018;2018;08;15;Maanantai;26;25;51;5;1;6
292;06.08.2018;2018;08;16;Maanantai;36;31;67;3;3;6
292;06.08.2018;2018;08;17;Maanantai;41;36;77;3;4;7
292;06.08.2018;2018;08;18;Maanantai;38;39;77;15;17;32
292;06.08.2018;2018;08;19;Maanantai;43;37;80;13;19;32
292;06.08.2018;2018;08;20;Maanantai;31;24;55;15;24;39
292;06.08.2018;2018;08;21;Maanantai;20;14;34;8;12;20
292;06.08.2018;2018;08;22;Maanantai;12;6;18;2;1;3
292;06.08.2018;2018;08;23;Maanantai;4;7;11;3;4;7
292;07.08.2018;2018;08;00;Tiistai;7;0;7;12;0;12
292;07.08.2018;2018;08;01;Tiistai;7;0;7;9;0;9
292;07.08.2018;2018;08;02;Tiistai;6;0;6;6;0;6
292;07.08.2018;2018;08;03;Tiistai;1;0;1;1;0;1
292;07.08.2018;2018;08;04;Tiistai;2;0;2;0;0;0
292;07.08.2018;2018;08;05;Tiistai;16;0;16;6;0;6
292;07.08.2018;2018;08;06;Tiistai;41;0;41;8;0;8
292;07.08.2018;2018;08;07;Tiistai;60;0;60;6;0;6
292;07.08.2018;2018;08;08;Tiistai;46;0;46;7;0;7
292;07.08.2018;2018;08;09;Tiistai;83;0;83;5;0;5
292;07.08.2018;2018;08;10;Tiistai;50;0;50;4;0;4
292;07.08.2018;2018;08;11;Tiistai;91;0;91;1;0;1
292;07.08.2018;2018;08;12;Tiistai;80;0;80;7;0;7
292;07.08.2018;2018;08;13;Tiistai;79;0;79;15;0;15
292;07.08.2018;2018;08;14;Tiistai;80;0;80;15;0;15
292;07.08.2018;2018;08;15;Tiistai;93;0;93;10;0;10
292;07.08.2018;2018;08;16;Tiistai;102;0;102;8;0;8
292;07.08.2018;2018;08;17;Tiistai;96;0;96;34;0;34
292;07.08.2018;2018;08;18;Tiistai;99;0;99;29;0;29
292;07.08.2018;2018;08;19;Tiistai;71;0;71;37;0;37
292;07.08.2018;2018;08;20;Tiistai;79;0;79;39;0;39
292;07.08.2018;2018;08;21;Tiistai;65;0;65;39;0;39
292;07.08.2018;2018;08;22;Tiistai;28;0;28;19;0;19
292;07.08.2018;2018;08;23;Tiistai;15;0;15;7;0;7
292;08.08.2018;2018;08;00;Keskiviikko;2;5;7;2;2;4
292;08.08.2018;2018;08;01;Keskiviikko;1;3;4;1;3;4
292;08.08.2018;2018;08;02;Keskiviikko;2;0;2;0;1;1
292;08.08.2018;2018;08;03;Keskiviikko;0;1;1;0;0;0
292;08.08.2018;2018;08;04;Keskiviikko;3;3;6;0;0;0
292;08.08.2018;2018;08;05;Keskiviikko;3;7;10;1;6;7
292;08.08.2018;2018;08;06;Keskiviikko;30;19;49;2;2;4
292;08.08.2018;2018;08;07;Keskiviikko;38;28;66;5;4;9
292;08.08.2018;2018;08;08;Keskiviikko;39;17;56;8;9;17
292;08.08.2018;2018;08;09;Keskiviikko;28;18;46;5;2;7
292;08.08.2018;2018;08;10;Keskiviikko;36;36;72;7;7;14
292;08.08.2018;2018;08;11;Keskiviikko;48;40;88;7;21;28
292;08.08.2018;2018;08;12;Keskiviikko;52;49;101;7;31;38
292;08.08.2018;2018;08;13;Keskiviikko;53;55;108;10;28;38
292;08.08.2018;2018;08;14;Keskiviikko;79;46;125;21;23;44
292;08.08.2018;2018;08;15;Keskiviikko;83;69;152;27;34;61
292;08.08.2018;2018;08;16;Keskiviikko;80;46;126;12;43;55
292;08.08.2018;2018;08;17;Keskiviikko;84;59;143;14;32;46
292;08.08.2018;2018;08;18;Keskiviikko;88;56;144;17;42;59
292;08.08.2018;2018;08;19;Keskiviikko;80;55;135;17;39;56
292;08.08.2018;2018;08;20;Keskiviikko;54;47;101;10;37;47
292;08.08.2018;2018;08;21;Keskiviikko;23;16;39;2;12;14
292;08.08.2018;2018;08;22;Keskiviikko;5;8;13;2;4;6
292;08.08.2018;2018;08;23;Keskiviikko;5;1;6;0;5;5
292;09.08.2018;2018;08;00;Torstai;0;2;2;3;2;5
292;09.08.2018;2018;08;01;Torstai;0;1;1;2;0;2
292;09.08.2018;2018;08;02;Torstai;2;1;3;0;0;0
292;09.08.2018;2018;08;03;Torstai;0;0;0;0;0;0
292;09.08.2018;2018;08;04;Torstai;2;0;2;0;0;0
292;09.08.2018;2018;08;05;Torstai;4;7;11;1;2;3
292;09.08.2018;2018;08;06;Torstai;27;12;39;6;10;16
292;09.08.2018;2018;08;07;Torstai;49;28;77;5;9;14
292;09.08.2018;2018;08;08;Torstai;83;38;121;13;10;23
292;09.08.2018;2018;08;09;Torstai;21;22;43;6;6;12
292;09.08.2018;2018;08;10;Torstai;25;21;46;10;1;11
292;09.08.2018;2018;08;11;Torstai;26;20;46;3;24;27
292;09.08.2018;2018;08;12;Torstai;36;42;78;3;19;22
292;09.08.2018;2018;08;13;Torstai;43;86;129;13;36;49
292;09.08.2018;2018;08;14;Torstai;48;41;89;18;32;50
292;09.08.2018;2018;08;15;Torstai;63;40;103;9;27;36
292;09.08.2018;2018;08;16;Torstai;57;40;97;12;26;38
292;09.08.2018;2018;08;17;Torstai;58;40;98;6;19;25
292;09.08.2018;2018;08;18;Torstai;59;28;87;24;22;46
292;09.08.2018;2018;08;19;Torstai;36;27;63;11;21;32
292;09.08.2018;2018;08;20;Torstai;33;27;60;13;25;38
292;09.08.2018;2018;08;21;Torstai;16;8;24;6;10;16
292;09.08.2018;2018;08;22;Torstai;4;6;10;3;2;5
292;09.08.2018;2018;08;23;Torstai;1;0;1;2;0;2
292;10.08.2018;2018;08;00;Perjantai;2;1;3;0;0;0
292;10.08.2018;2018;08;01;Perjantai;1;1;2;0;0;0
292;10.08.2018;2018;08;02;Perjantai;0;1;1;0;0;0
292;10.08.2018;2018;08;03;Perjantai;0;0;0;0;0;0
292;10.08.2018;2018;08;04;Perjantai;4;3;7;2;0;2
292;10.08.2018;2018;08;05;Perjantai;5;8;13;2;0;2
292;10.08.2018;2018;08;06;Perjantai;22;19;41;4;2;6
292;10.08.2018;2018;08;07;Perjantai;36;35;71;5;4;9
292;10.08.2018;2018;08;08;Perjantai;77;62;139;5;7;12
292;10.08.2018;2018;08;09;Perjantai;30;32;62;7;7;14
292;10.08.2018;2018;08;10;Perjantai;35;32;67;6;3;9
292;10.08.2018;2018;08;11;Perjantai;38;31;69;5;4;9
292;10.08.2018;2018;08;12;Perjantai;47;44;91;10;23;33
292;10.08.2018;2018;08;13;Perjantai;54;85;139;7;19;26
292;10.08.2018;2018;08;14;Perjantai;75;47;122;15;14;29
292;10.08.2018;2018;08;15;Perjantai;51;36;87;14;19;33
292;10.08.2018;2018;08;16;Perjantai;49;48;97;12;23;35
292;10.08.2018;2018;08;17;Perjantai;74;37;111;12;18;30
292;10.08.2018;2018;08;18;Perjantai;40;42;82;13;16;29
292;10.08.2018;2018;08;19;Perjantai;44;22;66;9;10;19
292;10.08.2018;2018;08;20;Perjantai;29;28;57;6;7;13
292;10.08.2018;2018;08;21;Perjantai;8;7;15;0;1;1
292;10.08.2018;2018;08;22;Perjantai;4;2;6;1;1;2
292;10.08.2018;2018;08;23;Perjantai;6;5;11;2;1;3
292;11.08.2018;2018;08;00;Lauantai;4;3;7;1;0;1
292;11.08.2018;2018;08;01;Lauantai;4;4;8;1;2;3
292;11.08.2018;2018;08;02;Lauantai;0;5;5;1;1;2
292;11.08.2018;2018;08;03;Lauantai;2;0;2;0;2;2
292;11.08.2018;2018;08;04;Lauantai;1;0;1;0;1;1
292;11.08.2018;2018;08;05;Lauantai;2;2;4;0;0;0
292;11.08.2018;2018;08;06;Lauantai;2;2;4;0;0;0
292;11.08.2018;2018;08;07;Lauantai;3;2;5;3;2;5
292;11.08.2018;2018;08;08;Lauantai;11;10;21;2;1;3
292;11.08.2018;2018;08;09;Lauantai;20;19;39;8;9;17
292;11.08.2018;2018;08;10;Lauantai;32;23;55;3;9;12
292;11.08.2018;2018;08;11;Lauantai;47;34;81;8;8;16
292;11.08.2018;2018;08;12;Lauantai;88;53;141;15;15;30
292;11.08.2018;2018;08;13;Lauantai;38;22;60;4;8;12
292;11.08.2018;2018;08;14;Lauantai;39;28;67;7;13;20
292;11.08.2018;2018;08;15;Lauantai;48;44;92;7;18;25
292;11.08.2018;2018;08;16;Lauantai;37;45;82;12;16;28
292;11.08.2018;2018;08;17;Lauantai;32;37;69;9;17;26
292;11.08.2018;2018;08;18;Lauantai;50;18;68;24;16;40
292;11.08.2018;2018;08;19;Lauantai;38;12;50;7;19;26
292;11.08.2018;2018;08;20;Lauantai;19;15;34;5;10;15
292;11.08.2018;2018;08;21;Lauantai;30;30;60;5;12;17
292;11.08.2018;2018;08;22;Lauantai;11;14;25;7;9;16
292;11.08.2018;2018;08;23;Lauantai;12;12;24;9;4;13
292;12.08.2018;2018;08;00;Sunnuntai;7;9;16;7;5;12
292;12.08.2018;2018;08;01;Sunnuntai;5;8;13;4;10;14
292;12.08.2018;2018;08;02;Sunnuntai;1;1;2;1;6;7
292;12.08.2018;2018;08;03;Sunnuntai;1;6;7;0;3;3
292;12.08.2018;2018;08;04;Sunnuntai;4;4;8;1;4;5
292;12.08.2018;2018;08;05;Sunnuntai;2;1;3;2;3;5
292;12.08.2018;2018;08;06;Sunnuntai;5;0;5;0;2;2
292;12.08.2018;2018;08;07;Sunnuntai;5;2;7;3;3;6
292;12.08.2018;2018;08;08;Sunnuntai;8;6;14;4;6;10
292;12.08.2018;2018;08;09;Sunnuntai;18;18;36;5;5;10
292;12.08.2018;2018;08;10;Sunnuntai;30;29;59;5;9;14
292;12.08.2018;2018;08;11;Sunnuntai;30;50;80;4;29;33
292;12.08.2018;2018;08;12;Sunnuntai;50;39;89;9;13;22
292;12.08.2018;2018;08;13;Sunnuntai;52;33;85;18;23;41
292;12.08.2018;2018;08;14;Sunnuntai;71;40;111;5;20;25
292;12.08.2018;2018;08;15;Sunnuntai;62;33;95;7;14;21
292;12.08.2018;2018;08;16;Sunnuntai;45;34;79;16;20;36
292;12.08.2018;2018;08;17;Sunnuntai;68;69;137;19;23;42
292;12.08.2018;2018;08;18;Sunnuntai;34;56;90;14;27;41
292;12.08.2018;2018;08;19;Sunnuntai;50;37;87;15;19;34
292;12.08.2018;2018;08;20;Sunnuntai;30;25;55;8;16;24
292;12.08.2018;2018;08;21;Sunnuntai;16;16;32;7;4;11
292;12.08.2018;2018;08;22;Sunnuntai;7;5;12;3;5;8
292;12.08.2018;2018;08;23;Sunnuntai;4;4;8;2;1;3
292;13.08.2018;2018;08;00;Maanantai;2;0;2;0;0;0
292;13.08.2018;2018;08;01;Maanantai;1;1;2;1;4;5
292;13.08.2018;2018;08;02;Maanantai;1;0;1;0;1;1
292;13.08.2018;2018;08;03;Maanantai;0;0;0;0;0;0
292;13.08.2018;2018;08;04;Maanantai;3;0;3;0;1;1
292;13.08.2018;2018;08;05;Maanantai;2;6;8;0;2;2
292;13.08.2018;2018;08;06;Maanantai;15;11;26;6;4;10
292;13.08.2018;2018;08;07;Maanantai;32;31;63;1;3;4
292;13.08.2018;2018;08;08;Maanantai;22;20;42;7;5;12
292;13.08.2018;2018;08;09;Maanantai;36;32;68;3;4;7
292;13.08.2018;2018;08;10;Maanantai;14;13;27;2;1;3
292;13.08.2018;2018;08;11;Maanantai;24;21;45;0;3;3
292;13.08.2018;2018;08;12;Maanantai;15;13;28;3;6;9
292;13.08.2018;2018;08;13;Maanantai;16;18;34;4;5;9
292;13.08.2018;2018;08;14;Maanantai;35;41;76;5;8;13
292;13.08.2018;2018;08;15;Maanantai;42;63;105;9;26;35
292;13.08.2018;2018;08;16;Maanantai;30;48;78;7;21;28
292;13.08.2018;2018;08;17;Maanantai;34;34;68;6;22;28
292;13.08.2018;2018;08;18;Maanantai;28;25;53;7;19;26
292;13.08.2018;2018;08;19;Maanantai;33;21;54;7;15;22
292;13.08.2018;2018;08;20;Maanantai;33;18;51;9;13;22
292;13.08.2018;2018;08;21;Maanantai;7;11;18;6;12;18
292;13.08.2018;2018;08;22;Maanantai;5;1;6;0;1;1
292;13.08.2018;2018;08;23;Maanantai;3;2;5;2;1;3
292;14.08.2018;2018;08;00;Tiistai;1;6;7;1;0;1
292;14.08.2018;2018;08;01;Tiistai;0;0;0;0;1;1
292;14.08.2018;2018;08;02;Tiistai;0;0;0;1;0;1
292;14.08.2018;2018;08;03;Tiistai;0;0;0;0;0;0
292;14.08.2018;2018;08;04;Tiistai;3;1;4;0;0;0
292;14.08.2018;2018;08;05;Tiistai;3;6;9;2;0;2
292;14.08.2018;2018;08;06;Tiistai;35;18;53;2;9;11
292;14.08.2018;2018;08;07;Tiistai;88;63;151;9;6;15
292;14.08.2018;2018;08;08;Tiistai;49;43;92;7;8;15
292;14.08.2018;2018;08;09;Tiistai;30;30;60;2;4;6
292;14.08.2018;2018;08;10;Tiistai;29;35;64;8;14;22
292;14.08.2018;2018;08;11;Tiistai;21;27;48;6;15;21
292;14.08.2018;2018;08;12;Tiistai;30;25;55;7;23;30
292;14.08.2018;2018;08;13;Tiistai;39;61;100;8;33;41
292;14.08.2018;2018;08;14;Tiistai;42;74;116;18;36;54
292;14.08.2018;2018;08;15;Tiistai;59;63;122;14;24;38
292;14.08.2018;2018;08;16;Tiistai;66;46;112;8;32;40
292;14.08.2018;2018;08;17;Tiistai;43;46;89;16;41;57
292;14.08.2018;2018;08;18;Tiistai;49;34;83;10;35;45
292;14.08.2018;2018;08;19;Tiistai;59;30;89;19;23;42
292;14.08.2018;2018;08;20;Tiistai;43;38;81;14;18;32
292;14.08.2018;2018;08;21;Tiistai;12;17;29;6;7;13
292;14.08.2018;2018;08;22;Tiistai;4;9;13;1;2;3
292;14.08.2018;2018;08;23;Tiistai;2;3;5;0;4;4
292;15.08.2018;2018;08;00;Keskiviikko;0;0;0;0;0;0
292;15.08.2018;2018;08;01;Keskiviikko;0;0;0;0;1;1
292;15.08.2018;2018;08;02;Keskiviikko;0;0;0;0;0;0
292;15.08.2018;2018;08;03;Keskiviikko;0;1;1;0;0;0
292;15.08.2018;2018;08;04;Keskiviikko;2;2;4;0;0;0
292;15.08.2018;2018;08;05;Keskiviikko;4;9;13;0;3;3
292;15.08.2018;2018;08;06;Keskiviikko;35;12;47;4;13;17
292;15.08.2018;2018;08;07;Keskiviikko;85;52;137;2;5;7
292;15.08.2018;2018;08;08;Keskiviikko;65;47;112;8;8;16
292;15.08.2018;2018;08;09;Keskiviikko;30;29;59;1;4;5
292;15.08.2018;2018;08;10;Keskiviikko;29;24;53;10;8;18
292;15.08.2018;2018;08;11;Keskiviikko;34;25;59;9;18;27
292;15.08.2018;2018;08;12;Keskiviikko;25;36;61;15;25;40
292;15.08.2018;2018;08;13;Keskiviikko;31;80;111;14;37;51
292;15.08.2018;2018;08;14;Keskiviikko;66;76;142;26;42;68
292;15.08.2018;2018;08;15;Keskiviikko;52;58;110;16;37;53
292;15.08.2018;2018;08;16;Keskiviikko;56;65;121;17;43;60
292;15.08.2018;2018;08;17;Keskiviikko;75;54;129;14;35;49
292;15.08.2018;2018;08;18;Keskiviikko;53;42;95;12;21;33
292;15.08.2018;2018;08;19;Keskiviikko;62;42;104;14;29;43
292;15.08.2018;2018;08;20;Keskiviikko;34;37;71;10;19;29
292;15.08.2018;2018;08;21;Keskiviikko;15;22;37;4;15;19
292;15.08.2018;2018;08;22;Keskiviikko;8;1;9;1;0;1
292;15.08.2018;2018;08;23;Keskiviikko;0;2;2;0;1;1
292;16.08.2018;2018;08;00;Torstai;0;0;0;1;0;1
292;16.08.2018;2018;08;01;Torstai;0;0;0;0;0;0
292;16.08.2018;2018;08;02;Torstai;0;0;0;0;0;0
292;16.08.2018;2018;08;03;Torstai;0;0;0;0;0;0
292;16.08.2018;2018;08;04;Torstai;2;0;2;0;0;0
292;16.08.2018;2018;08;05;Torstai;5;6;11;3;3;6
292;16.08.2018;2018;08;06;Torstai;28;16;44;5;7;12
292;16.08.2018;2018;08;07;Torstai;64;40;104;5;8;13
292;16.08.2018;2018;08;08;Torstai;47;42;89;7;8;15
292;16.08.2018;2018;08;09;Torstai;51;46;97;7;6;13
292;16.08.2018;2018;08;10;Torstai;29;28;57;7;3;10
292;16.08.2018;2018;08;11;Torstai;66;34;100;4;12;16
292;16.08.2018;2018;08;12;Torstai;42;30;72;8;9;17
292;16.08.2018;2018;08;13;Torstai;53;46;99;7;18;25
292;16.08.2018;2018;08;14;Torstai;51;30;81;12;8;20
292;16.08.2018;2018;08;15;Torstai;54;75;129;9;17;26
292;16.08.2018;2018;08;16;Torstai;58;56;114;16;15;31
292;16.08.2018;2018;08;17;Torstai;60;40;100;19;21;40
292;16.08.2018;2018;08;18;Torstai;54;36;90;14;30;44
292;16.08.2018;2018;08;19;Torstai;50;41;91;16;31;47
292;16.08.2018;2018;08;20;Torstai;26;23;49;16;27;43
292;16.08.2018;2018;08;21;Torstai;15;10;25;9;9;18
292;16.08.2018;2018;08;22;Torstai;4;7;11;1;5;6
292;16.08.2018;2018;08;23;Torstai;5;2;7;4;1;5
292;17.08.2018;2018;08;00;Perjantai;2;1;3;0;1;1
292;17.08.2018;2018;08;01;Perjantai;0;0;0;1;0;1
292;17.08.2018;2018;08;02;Perjantai;0;1;1;0;2;2
292;17.08.2018;2018;08;03;Perjantai;0;0;0;0;0;0
292;17.08.2018;2018;08;04;Perjantai;2;1;3;0;0;0
292;17.08.2018;2018;08;05;Perjantai;6;7;13;1;3;4
292;17.08.2018;2018;08;06;Perjantai;32;12;44;4;12;16
292;17.08.2018;2018;08;07;Perjantai;61;29;90;9;9;18
292;17.08.2018;2018;08;08;Perjantai;87;40;127;3;6;9
292;17.08.2018;2018;08;09;Perjantai;37;32;69;2;6;8
292;17.08.2018;2018;08;10;Perjantai;18;18;36;8;7;15
292;17.08.2018;2018;08;11;Perjantai;28;22;50;5;7;12
292;17.08.2018;2018;08;12;Perjantai;26;24;50;6;4;10
292;17.08.2018;2018;08;13;Perjantai;46;81;127;12;28;40
292;17.08.2018;2018;08;14;Perjantai;58;44;102;14;18;32
292;17.08.2018;2018;08;15;Perjantai;56;50;106;17;17;34
292;17.08.2018;2018;08;16;Perjantai;46;38;84;17;26;43
292;17.08.2018;2018;08;17;Perjantai;39;25;64;15;20;35
292;17.08.2018;2018;08;18;Perjantai;36;34;70;8;22;30
292;17.08.2018;2018;08;19;Perjantai;35;27;62;10;18;28
292;17.08.2018;2018;08;20;Perjantai;28;18;46;7;13;20
292;17.08.2018;2018;08;21;Perjantai;21;19;40;11;13;24
292;17.08.2018;2018;08;22;Perjantai;10;5;15;1;9;10
292;17.08.2018;2018;08;23;Perjantai;4;3;7;1;0;1
292;18.08.2018;2018;08;00;Lauantai;3;0;3;2;0;2
292;18.08.2018;2018;08;01;Lauantai;0;2;2;0;2;2
292;18.08.2018;2018;08;02;Lauantai;1;3;4;3;4;7
292;18.08.2018;2018;08;03;Lauantai;0;0;0;0;1;1
292;18.08.2018;2018;08;04;Lauantai;1;1;2;0;3;3
292;18.08.2018;2018;08;05;Lauantai;1;0;1;1;0;1
292;18.08.2018;2018;08;06;Lauantai;3;3;6;1;3;4
292;18.08.2018;2018;08;07;Lauantai;6;5;11;5;2;7
292;18.08.2018;2018;08;08;Lauantai;7;6;13;3;0;3
292;18.08.2018;2018;08;09;Lauantai;14;14;28;2;2;4
292;18.08.2018;2018;08;10;Lauantai;28;26;54;5;6;11
292;18.08.2018;2018;08;11;Lauantai;33;41;74;8;10;18
292;18.08.2018;2018;08;12;Lauantai;42;40;82;15;21;36
292;18.08.2018;2018;08;13;Lauantai;45;52;97;2;22;24
292;18.08.2018;2018;08;14;Lauantai;54;41;95;14;28;42
292;18.08.2018;2018;08;15;Lauantai;52;56;108;23;24;47
292;18.08.2018;2018;08;16;Lauantai;62;17;79;18;19;37
292;18.08.2018;2018;08;17;Lauantai;66;27;93;12;12;24
292;18.08.2018;2018;08;18;Lauantai;37;22;59;12;27;39
292;18.08.2018;2018;08;19;Lauantai;36;25;61;11;31;42
292;18.08.2018;2018;08;20;Lauantai;33;33;66;6;24;30
292;18.08.2018;2018;08;21;Lauantai;17;17;34;9;4;13
292;18.08.2018;2018;08;22;Lauantai;8;12;20;8;7;15
292;18.08.2018;2018;08;23;Lauantai;9;1;10;5;1;6
292;19.08.2018;2018;08;00;Sunnuntai;2;2;4;0;2;2
292;19.08.2018;2018;08;01;Sunnuntai;1;4;5;3;2;5
292;19.08.2018;2018;08;02;Sunnuntai;4;0;4;3;0;3
292;19.08.2018;2018;08;03;Sunnuntai;0;4;4;0;5;5
292;19.08.2018;2018;08;04;Sunnuntai;0;0;0;0;1;1
292;19.08.2018;2018;08;05;Sunnuntai;2;0;2;2;1;3
292;19.08.2018;2018;08;06;Sunnuntai;4;2;6;0;4;4
292;19.08.2018;2018;08;07;Sunnuntai;3;1;4;0;0;0
292;19.08.2018;2018;08;08;Sunnuntai;5;4;9;5;3;8
292;19.08.2018;2018;08;09;Sunnuntai;16;12;28;1;6;7
292;19.08.2018;2018;08;10;Sunnuntai;16;25;41;8;7;15
292;19.08.2018;2018;08;11;Sunnuntai;31;22;53;13;23;36
292;19.08.2018;2018;08;12;Sunnuntai;44;22;66;10;19;29
292;19.08.2018;2018;08;13;Sunnuntai;27;34;61;10;13;23
292;19.08.2018;2018;08;14;Sunnuntai;43;30;73;9;23;32
292;19.08.2018;2018;08;15;Sunnuntai;53;33;86;4;21;25
292;19.08.2018;2018;08;16;Sunnuntai;49;29;78;9;14;23
292;19.08.2018;2018;08;17;Sunnuntai;41;26;67;20;20;40
292;19.08.2018;2018;08;18;Sunnuntai;36;20;56;20;19;39
292;19.08.2018;2018;08;19;Sunnuntai;29;38;67;13;25;38
292;19.08.2018;2018;08;20;Sunnuntai;22;16;38;12;17;29
292;19.08.2018;2018;08;21;Sunnuntai;15;9;24;4;4;8
292;19.08.2018;2018;08;22;Sunnuntai;1;5;6;1;3;4
292;19.08.2018;2018;08;23;Sunnuntai;1;0;1;0;0;0
292;20.08.2018;2018;08;00;Maanantai;3;0;3;1;0;1
292;20.08.2018;2018;08;01;Maanantai;1;0;1;0;1;1
292;20.08.2018;2018;08;02;Maanantai;0;0;0;0;0;0
292;20.08.2018;2018;08;03;Maanantai;0;0;0;0;1;1
292;20.08.2018;2018;08;04;Maanantai;2;0;2;0;0;0
292;20.08.2018;2018;08;05;Maanantai;8;5;13;0;5;5
292;20.08.2018;2018;08;06;Maanantai;36;12;48;3;9;12
292;20.08.2018;2018;08;07;Maanantai;70;46;116;7;8;15
292;20.08.2018;2018;08;08;Maanantai;42;33;75;7;9;16
292;20.08.2018;2018;08;09;Maanantai;74;42;116;6;9;15
292;20.08.2018;2018;08;10;Maanantai;30;29;59;5;9;14
292;20.08.2018;2018;08;11;Maanantai;40;37;77;5;6;11
292;20.08.2018;2018;08;12;Maanantai;30;18;48;6;18;24
292;20.08.2018;2018;08;13;Maanantai;40;37;77;10;20;30
292;20.08.2018;2018;08;14;Maanantai;43;62;105;14;32;46
292;20.08.2018;2018;08;15;Maanantai;45;90;135;16;42;58
292;20.08.2018;2018;08;16;Maanantai;58;67;125;14;35;49
292;20.08.2018;2018;08;17;Maanantai;66;47;113;26;43;69
292;20.08.2018;2018;08;18;Maanantai;64;33;97;30;42;72
292;20.08.2018;2018;08;19;Maanantai;46;35;81;14;39;53
292;20.08.2018;2018;08;20;Maanantai;44;33;77;15;27;42
292;20.08.2018;2018;08;21;Maanantai;15;11;26;8;8;16
292;20.08.2018;2018;08;22;Maanantai;3;1;4;2;3;5
292;20.08.2018;2018;08;23;Maanantai;2;1;3;0;0;0
292;21.08.2018;2018;08;00;Tiistai;1;0;1;3;0;3
292;21.08.2018;2018;08;01;Tiistai;2;0;2;0;0;0
292;21.08.2018;2018;08;02;Tiistai;0;3;3;0;2;2
292;21.08.2018;2018;08;03;Tiistai;1;0;1;0;0;0
292;21.08.2018;2018;08;04;Tiistai;1;0;1;0;0;0
292;21.08.2018;2018;08;05;Tiistai;8;3;11;3;4;7
292;21.08.2018;2018;08;06;Tiistai;32;23;55;2;10;12
292;21.08.2018;2018;08;07;Tiistai;81;52;133;5;13;18
292;21.08.2018;2018;08;08;Tiistai;56;48;104;12;7;19
292;21.08.2018;2018;08;09;Tiistai;24;20;44;3;6;9
292;21.08.2018;2018;08;10;Tiistai;22;25;47;8;11;19
292;21.08.2018;2018;08;11;Tiistai;24;28;52;8;15;23
292;21.08.2018;2018;08;12;Tiistai;37;23;60;9;21;30
292;21.08.2018;2018;08;13;Tiistai;34;58;92;12;39;51
292;21.08.2018;2018;08;14;Tiistai;47;76;123;22;41;63
292;21.08.2018;2018;08;15;Tiistai;53;61;114;11;37;48
292;21.08.2018;2018;08;16;Tiistai;57;60;117;15;39;54
292;21.08.2018;2018;08;17;Tiistai;59;33;92;10;30;40
292;21.08.2018;2018;08;18;Tiistai;48;33;81;24;36;60
292;21.08.2018;2018;08;19;Tiistai;40;31;71;18;35;53
292;21.08.2018;2018;08;20;Tiistai;33;30;63;7;21;28
292;21.08.2018;2018;08;21;Tiistai;13;10;23;9;7;16
292;21.08.2018;2018;08;22;Tiistai;4;1;5;2;4;6
292;21.08.2018;2018;08;23;Tiistai;1;1;2;3;0;3
292;22.08.2018;2018;08;00;Keskiviikko;0;1;1;0;1;1
292;22.08.2018;2018;08;01;Keskiviikko;0;0;0;1;0;1
292;22.08.2018;2018;08;02;Keskiviikko;0;1;1;0;0;0
292;22.08.2018;2018;08;03;Keskiviikko;0;1;1;0;0;0
292;22.08.2018;2018;08;04;Keskiviikko;1;0;1;0;0;0
292;22.08.2018;2018;08;05;Keskiviikko;6;5;11;1;1;2
292;22.08.2018;2018;08;06;Keskiviikko;33;9;42;8;10;18
292;22.08.2018;2018;08;07;Keskiviikko;69;45;114;3;8;11
292;22.08.2018;2018;08;08;Keskiviikko;47;46;93;8;13;21
292;22.08.2018;2018;08;09;Keskiviikko;33;32;65;7;5;12
292;22.08.2018;2018;08;10;Keskiviikko;24;22;46;6;20;26
292;22.08.2018;2018;08;11;Keskiviikko;28;35;63;10;24;34
292;22.08.2018;2018;08;12;Keskiviikko;26;32;58;7;18;25
292;22.08.2018;2018;08;13;Keskiviikko;39;30;69;13;23;36
292;22.08.2018;2018;08;14;Keskiviikko;47;95;142;10;50;60
292;22.08.2018;2018;08;15;Keskiviikko;47;38;85;12;24;36
292;22.08.2018;2018;08;16;Keskiviikko;48;57;105;12;22;34
292;22.08.2018;2018;08;17;Keskiviikko;49;37;86;10;14;24
292;22.08.2018;2018;08;18;Keskiviikko;60;28;88;21;22;43
292;22.08.2018;2018;08;19;Keskiviikko;24;28;52;9;19;28
292;22.08.2018;2018;08;20;Keskiviikko;25;15;40;5;21;26
292;22.08.2018;2018;08;21;Keskiviikko;9;6;15;4;6;10
292;22.08.2018;2018;08;22;Keskiviikko;7;3;10;3;2;5
292;22.08.2018;2018;08;23;Keskiviikko;2;1;3;1;1;2
292;23.08.2018;2018;08;00;Torstai;1;0;1;1;0;1
292;23.08.2018;2018;08;01;Torstai;1;0;1;0;2;2
292;23.08.2018;2018;08;02;Torstai;1;0;1;0;0;0
292;23.08.2018;2018;08;03;Torstai;1;0;1;0;0;0
292;23.08.2018;2018;08;04;Torstai;1;1;2;0;0;0
292;23.08.2018;2018;08;05;Torstai;5;5;10;0;0;0
292;23.08.2018;2018;08;06;Torstai;20;15;35;6;3;9
292;23.08.2018;2018;08;07;Torstai;40;28;68;6;3;9
292;23.08.2018;2018;08;08;Torstai;24;17;41;2;8;10
292;23.08.2018;2018;08;09;Torstai;29;21;50;2;5;7
292;23.08.2018;2018;08;10;Torstai;7;7;14;1;1;2
292;23.08.2018;2018;08;11;Torstai;6;5;11;3;3;6
292;23.08.2018;2018;08;12;Torstai;12;11;23;2;3;5
292;23.08.2018;2018;08;13;Torstai;31;23;54;12;7;19
292;23.08.2018;2018;08;14;Torstai;46;40;86;9;22;31
292;23.08.2018;2018;08;15;Torstai;43;72;115;6;31;37
292;23.08.2018;2018;08;16;Torstai;52;44;96;17;33;50
292;23.08.2018;2018;08;17;Torstai;53;28;81;17;24;41
292;23.08.2018;2018;08;18;Torstai;33;30;63;17;27;44
292;23.08.2018;2018;08;19;Torstai;47;34;81;12;21;33
292;23.08.2018;2018;08;20;Torstai;26;27;53;9;16;25
292;23.08.2018;2018;08;21;Torstai;15;13;28;9;8;17
292;23.08.2018;2018;08;22;Torstai;8;4;12;9;3;12
292;23.08.2018;2018;08;23;Torstai;1;2;3;0;1;1
292;24.08.2018;2018;08;00;Perjantai;0;1;1;0;0;0
292;24.08.2018;2018;08;01;Perjantai;0;1;1;1;2;3
292;24.08.2018;2018;08;02;Perjantai;0;2;2;0;1;1
292;24.08.2018;2018;08;03;Perjantai;0;0;0;0;0;0
292;24.08.2018;2018;08;04;Perjantai;2;0;2;0;0;0
292;24.08.2018;2018;08;05;Perjantai;5;2;7;0;2;2
292;24.08.2018;2018;08;06;Perjantai;14;10;24;5;7;12
292;24.08.2018;2018;08;07;Perjantai;70;30;100;10;9;19
292;24.08.2018;2018;08;08;Perjantai;54;20;74;6;19;25
292;24.08.2018;2018;08;09;Perjantai;20;13;33;3;6;9
292;24.08.2018;2018;08;10;Perjantai;6;5;11;0;2;2
292;24.08.2018;2018;08;11;Perjantai;7;7;14;0;3;3
292;24.08.2018;2018;08;12;Perjantai;16;15;31;3;4;7
292;24.08.2018;2018;08;13;Perjantai;27;28;55;3;2;5
292;24.08.2018;2018;08;14;Perjantai;26;25;51;6;5;11
292;24.08.2018;2018;08;15;Perjantai;36;20;56;7;8;15
292;24.08.2018;2018;08;16;Perjantai;43;31;74;12;15;27
292;24.08.2018;2018;08;17;Perjantai;56;23;79;12;18;30
292;24.08.2018;2018;08;18;Perjantai;19;19;38;6;16;22
292;24.08.2018;2018;08;19;Perjantai;44;24;68;18;19;37
292;24.08.2018;2018;08;20;Perjantai;30;28;58;14;21;35
292;24.08.2018;2018;08;21;Perjantai;16;11;27;10;11;21
292;24.08.2018;2018;08;22;Perjantai;5;9;14;8;6;14
292;24.08.2018;2018;08;23;Perjantai;13;5;18;3;2;5
292;25.08.2018;2018;08;00;Lauantai;3;3;6;3;8;11
292;25.08.2018;2018;08;01;Lauantai;4;0;4;1;3;4
292;25.08.2018;2018;08;02;Lauantai;0;1;1;0;1;1
292;25.08.2018;2018;08;03;Lauantai;1;0;1;0;1;1
292;25.08.2018;2018;08;04;Lauantai;0;0;0;1;0;1
292;25.08.2018;2018;08;05;Lauantai;1;0;1;0;0;0
292;25.08.2018;2018;08;06;Lauantai;4;1;5;0;1;1
292;25.08.2018;2018;08;07;Lauantai;5;3;8;3;4;7
292;25.08.2018;2018;08;08;Lauantai;8;5;13;7;3;10
292;25.08.2018;2018;08;09;Lauantai;11;9;20;2;5;7
292;25.08.2018;2018;08;10;Lauantai;8;8;16;3;1;4
292;25.08.2018;2018;08;11;Lauantai;20;13;33;6;11;17
292;25.08.2018;2018;08;12;Lauantai;30;19;49;10;23;33
292;25.08.2018;2018;08;13;Lauantai;58;38;96;7;33;40
292;25.08.2018;2018;08;14;Lauantai;36;36;72;8;32;40
292;25.08.2018;2018;08;15;Lauantai;43;36;79;15;21;36
292;25.08.2018;2018;08;16;Lauantai;35;22;57;19;19;38
292;25.08.2018;2018;08;17;Lauantai;46;23;69;13;21;34
292;25.08.2018;2018;08;18;Lauantai;33;30;63;11;22;33
292;25.08.2018;2018;08;19;Lauantai;39;23;62;6;14;20
292;25.08.2018;2018;08;20;Lauantai;22;17;39;7;6;13
292;25.08.2018;2018;08;21;Lauantai;11;3;14;6;9;15
292;25.08.2018;2018;08;22;Lauantai;14;10;24;8;6;14
292;25.08.2018;2018;08;23;Lauantai;5;5;10;1;3;4
292;26.08.2018;2018;08;00;Sunnuntai;2;4;6;2;1;3
292;26.08.2018;2018;08;01;Sunnuntai;0;3;3;3;1;4
292;26.08.2018;2018;08;02;Sunnuntai;0;0;0;3;2;5
292;26.08.2018;2018;08;03;Sunnuntai;1;3;4;0;3;3
292;26.08.2018;2018;08;04;Sunnuntai;1;2;3;3;2;5
292;26.08.2018;2018;08;05;Sunnuntai;0;1;1;1;2;3
292;26.08.2018;2018;08;06;Sunnuntai;5;2;7;0;2;2
292;26.08.2018;2018;08;07;Sunnuntai;3;1;4;2;1;3
292;26.08.2018;2018;08;08;Sunnuntai;8;6;14;6;6;12
292;26.08.2018;2018;08;09;Sunnuntai;23;19;42;11;4;15
292;26.08.2018;2018;08;10;Sunnuntai;23;24;47;3;19;22
292;26.08.2018;2018;08;11;Sunnuntai;37;31;68;11;13;24
292;26.08.2018;2018;08;12;Sunnuntai;51;31;82;6;17;23
292;26.08.2018;2018;08;13;Sunnuntai;46;50;96;8;31;39
292;26.08.2018;2018;08;14;Sunnuntai;29;27;56;11;8;19
292;26.08.2018;2018;08;15;Sunnuntai;36;27;63;3;4;7
292;26.08.2018;2018;08;16;Sunnuntai;19;18;37;11;5;16
292;26.08.2018;2018;08;17;Sunnuntai;23;13;36;11;13;24
292;26.08.2018;2018;08;18;Sunnuntai;32;23;55;13;16;29
292;26.08.2018;2018;08;19;Sunnuntai;21;16;37;15;12;27
292;26.08.2018;2018;08;20;Sunnuntai;13;13;26;10;8;18
292;26.08.2018;2018;08;21;Sunnuntai;11;13;24;4;3;7
292;26.08.2018;2018;08;22;Sunnuntai;4;1;5;1;1;2
292;26.08.2018;2018;08;23;Sunnuntai;0;0;0;0;0;0
292;27.08.2018;2018;08;00;Maanantai;1;1;2;0;0;0
292;27.08.2018;2018;08;01;Maanantai;1;1;2;0;2;2
292;27.08.2018;2018;08;02;Maanantai;0;0;0;0;0;0
292;27.08.2018;2018;08;03;Maanantai;2;0;2;0;0;0
292;27.08.2018;2018;08;04;Maanantai;2;1;3;0;0;0
292;27.08.2018;2018;08;05;Maanantai;3;5;8;0;0;0
292;27.08.2018;2018;08;06;Maanantai;22;15;37;2;5;7
292;27.08.2018;2018;08;07;Maanantai;66;45;111;5;4;9
292;27.08.2018;2018;08;08;Maanantai;36;29;65;6;5;11
292;27.08.2018;2018;08;09;Maanantai;48;42;90;10;6;16
292;27.08.2018;2018;08;10;Maanantai;17;14;31;2;7;9
292;27.08.2018;2018;08;11;Maanantai;25;28;53;12;13;25
292;27.08.2018;2018;08;12;Maanantai;29;24;53;4;8;12
292;27.08.2018;2018;08;13;Maanantai;33;31;64;8;8;16
292;27.08.2018;2018;08;14;Maanantai;43;50;93;13;10;23
292;27.08.2018;2018;08;15;Maanantai;47;72;119;7;30;37
292;27.08.2018;2018;08;16;Maanantai;55;69;124;18;32;50
292;27.08.2018;2018;08;17;Maanantai;70;56;126;14;37;51
292;27.08.2018;2018;08;18;Maanantai;58;53;111;18;26;44
292;27.08.2018;2018;08;19;Maanantai;51;44;95;21;30;51
292;27.08.2018;2018;08;20;Maanantai;38;32;70;26;29;55
292;27.08.2018;2018;08;21;Maanantai;14;11;25;2;7;9
292;27.08.2018;2018;08;22;Maanantai;9;4;13;1;7;8
292;27.08.2018;2018;08;23;Maanantai;2;0;2;1;0;1
292;28.08.2018;2018;08;00;Tiistai;1;1;2;0;0;0
292;28.08.2018;2018;08;01;Tiistai;0;0;0;0;0;0
292;28.08.2018;2018;08;02;Tiistai;0;0;0;0;0;0
292;28.08.2018;2018;08;03;Tiistai;1;0;1;0;0;0
292;28.08.2018;2018;08;04;Tiistai;0;0;0;0;0;0
292;28.08.2018;2018;08;05;Tiistai;6;5;11;0;2;2
292;28.08.2018;2018;08;06;Tiistai;26;14;40;3;10;13
292;28.08.2018;2018;08;07;Tiistai;90;49;139;10;6;16
292;28.08.2018;2018;08;08;Tiistai;63;42;105;11;9;20
292;28.08.2018;2018;08;09;Tiistai;15;16;31;7;4;11
292;28.08.2018;2018;08;10;Tiistai;42;27;69;2;5;7
292;28.08.2018;2018;08;11;Tiistai;34;43;77;1;15;16
292;28.08.2018;2018;08;12;Tiistai;28;40;68;9;24;33
292;28.08.2018;2018;08;13;Tiistai;32;64;96;8;24;32
292;28.08.2018;2018;08;14;Tiistai;66;71;137;12;33;45
292;28.08.2018;2018;08;15;Tiistai;35;75;110;10;30;40
292;28.08.2018;2018;08;16;Tiistai;55;72;127;14;50;64
292;28.08.2018;2018;08;17;Tiistai;59;21;80;12;30;42
292;28.08.2018;2018;08;18;Tiistai;54;34;88;24;24;48
292;28.08.2018;2018;08;19;Tiistai;54;48;102;17;31;48
292;28.08.2018;2018;08;20;Tiistai;36;19;55;12;25;37
292;28.08.2018;2018;08;21;Tiistai;18;13;31;10;11;21
292;28.08.2018;2018;08;22;Tiistai;6;3;9;4;3;7
292;28.08.2018;2018;08;23;Tiistai;0;0;0;0;1;1
292;29.08.2018;2018;08;00;Keskiviikko;0;0;0;1;0;1
292;29.08.2018;2018;08;01;Keskiviikko;0;0;0;0;0;0
292;29.08.2018;2018;08;02;Keskiviikko;0;0;0;0;0;0
292;29.08.2018;2018;08;03;Keskiviikko;0;0;0;0;0;0
292;29.08.2018;2018;08;04;Keskiviikko;1;0;1;0;0;0
292;29.08.2018;2018;08;05;Keskiviikko;9;6;15;1;3;4
292;29.08.2018;2018;08;06;Keskiviikko;31;11;42;4;8;12
292;29.08.2018;2018;08;07;Keskiviikko;82;47;129;9;5;14
292;29.08.2018;2018;08;08;Keskiviikko;62;48;110;7;13;20
292;29.08.2018;2018;08;09;Keskiviikko;31;26;57;12;11;23
292;29.08.2018;2018;08;10;Keskiviikko;33;25;58;9;15;24
292;29.08.2018;2018;08;11;Keskiviikko;41;22;63;11;23;34
292;29.08.2018;2018;08;12;Keskiviikko;31;39;70;8;14;22
292;29.08.2018;2018;08;13;Keskiviikko;44;63;107;8;37;45
292;29.08.2018;2018;08;14;Keskiviikko;54;73;127;13;37;50
292;29.08.2018;2018;08;15;Keskiviikko;64;55;119;17;44;61
292;29.08.2018;2018;08;16;Keskiviikko;63;74;137;17;36;53
292;29.08.2018;2018;08;17;Keskiviikko;70;42;112;17;34;51
292;29.08.2018;2018;08;18;Keskiviikko;60;62;122;15;31;46
292;29.08.2018;2018;08;19;Keskiviikko;62;38;100;23;26;49
292;29.08.2018;2018;08;20;Keskiviikko;52;31;83;18;26;44
292;29.08.2018;2018;08;21;Keskiviikko;16;21;37;6;9;15
292;29.08.2018;2018;08;22;Keskiviikko;4;3;7;1;0;1
292;29.08.2018;2018;08;23;Keskiviikko;0;1;1;0;0;0
292;30.08.2018;2018;08;00;Torstai;1;0;1;0;0;0
292;30.08.2018;2018;08;01;Torstai;0;1;1;0;0;0
292;30.08.2018;2018;08;02;Torstai;0;0;0;0;0;0
292;30.08.2018;2018;08;03;Torstai;0;0;0;0;0;0
292;30.08.2018;2018;08;04;Torstai;0;0;0;1;1;2
292;30.08.2018;2018;08;05;Torstai;8;1;9;0;5;5
292;30.08.2018;2018;08;06;Torstai;29;14;43;4;17;21
292;30.08.2018;2018;08;07;Torstai;76;36;112;8;10;18
292;30.08.2018;2018;08;08;Torstai;34;31;65;6;14;20
292;30.08.2018;2018;08;09;Torstai;66;37;103;15;13;28
292;30.08.2018;2018;08;10;Torstai;39;27;66;12;17;29
292;30.08.2018;2018;08;11;Torstai;43;32;75;7;15;22
292;30.08.2018;2018;08;12;Torstai;39;24;63;5;12;17
292;30.08.2018;2018;08;13;Torstai;32;31;63;8;5;13
292;30.08.2018;2018;08;14;Torstai;45;35;80;14;19;33
292;30.08.2018;2018;08;15;Torstai;72;53;125;5;22;27
292;30.08.2018;2018;08;16;Torstai;50;57;107;8;14;22
292;30.08.2018;2018;08;17;Torstai;48;30;78;12;15;27
292;30.08.2018;2018;08;18;Torstai;40;28;68;15;17;32
292;30.08.2018;2018;08;19;Torstai;36;27;63;8;22;30
292;30.08.2018;2018;08;20;Torstai;31;21;52;8;10;18
292;30.08.2018;2018;08;21;Torstai;14;7;21;6;9;15
292;30.08.2018;2018;08;22;Torstai;5;2;7;0;1;1
292;30.08.2018;2018;08;23;Torstai;1;0;1;1;0;1
292;31.08.2018;2018;08;00;Perjantai;0;1;1;2;1;3
292;31.08.2018;2018;08;01;Perjantai;0;2;2;0;1;1
292;31.08.2018;2018;08;02;Perjantai;0;0;0;0;1;1
292;31.08.2018;2018;08;03;Perjantai;0;0;0;1;0;1
292;31.08.2018;2018;08;04;Perjantai;1;1;2;0;0;0
292;31.08.2018;2018;08;05;Perjantai;5;3;8;0;3;3
292;31.08.2018;2018;08;06;Perjantai;30;18;48;3;8;11
292;31.08.2018;2018;08;07;Perjantai;77;39;116;12;5;17
292;31.08.2018;2018;08;08;Perjantai;50;39;89;8;7;15
292;31.08.2018;2018;08;09;Perjantai;34;26;60;3;3;6
292;31.08.2018;2018;08;10;Perjantai;26;29;55;8;12;20
292;31.08.2018;2018;08;11;Perjantai;23;25;48;9;7;16
292;31.08.2018;2018;08;12;Perjantai;37;34;71;10;29;39
292;31.08.2018;2018;08;13;Perjantai;40;76;116;12;31;43
292;31.08.2018;2018;08;14;Perjantai;46;53;99;8;27;35
292;31.08.2018;2018;08;15;Perjantai;44;40;84;13;22;35
292;31.08.2018;2018;08;16;Perjantai;43;30;73;12;27;39
292;31.08.2018;2018;08;17;Perjantai;37;47;84;18;20;38
292;31.08.2018;2018;08;18;Perjantai;50;25;75;16;33;49
292;31.08.2018;2018;08;19;Perjantai;33;26;59;18;25;43
292;31.08.2018;2018;08;20;Perjantai;34;23;57;10;13;23
292;31.08.2018;2018;08;21;Perjantai;21;17;38;7;8;15
292;31.08.2018;2018;08;22;Perjantai;15;7;22;13;6;19
292;31.08.2018;2018;08;23;Perjantai;8;1;9;9;9;18
292;01.09.2018;2018;09;00;Lauantai;6;5;11;7;2;9
292;01.09.2018;2018;09;01;Lauantai;9;1;10;5;7;12
292;01.09.2018;2018;09;02;Lauantai;2;6;8;5;8;13
292;01.09.2018;2018;09;03;Lauantai;0;7;7;0;8;8
292;01.09.2018;2018;09;04;Lauantai;1;4;5;2;1;3
292;01.09.2018;2018;09;05;Lauantai;0;1;1;0;2;2
292;01.09.2018;2018;09;06;Lauantai;4;6;10;2;3;5
292;01.09.2018;2018;09;07;Lauantai;1;1;2;5;4;9
292;01.09.2018;2018;09;08;Lauantai;11;10;21;8;5;13
292;01.09.2018;2018;09;09;Lauantai;25;15;40;3;8;11
292;01.09.2018;2018;09;10;Lauantai;26;27;53;9;15;24
292;01.09.2018;2018;09;11;Lauantai;33;31;64;12;17;29
292;01.09.2018;2018;09;12;Lauantai;52;37;89;9;24;33
292;01.09.2018;2018;09;13;Lauantai;40;26;66;13;34;47
292;01.09.2018;2018;09;14;Lauantai;62;41;103;18;26;44
292;01.09.2018;2018;09;15;Lauantai;58;30;88;13;22;35
292;01.09.2018;2018;09;16;Lauantai;47;30;77;13;18;31
292;01.09.2018;2018;09;17;Lauantai;51;40;91;17;22;39
292;01.09.2018;2018;09;18;Lauantai;44;35;79;9;31;40
292;01.09.2018;2018;09;19;Lauantai;41;23;64;13;17;30
292;01.09.2018;2018;09;20;Lauantai;26;18;44;18;14;32
292;01.09.2018;2018;09;21;Lauantai;16;20;36;13;12;25
292;01.09.2018;2018;09;22;Lauantai;10;11;21;9;1;10
292;01.09.2018;2018;09;23;Lauantai;6;2;8;1;3;4
292;02.09.2018;2018;09;00;Sunnuntai;4;2;6;4;5;9
292;02.09.2018;2018;09;01;Sunnuntai;4;7;11;3;4;7
292;02.09.2018;2018;09;02;Sunnuntai;2;1;3;0;1;1
292;02.09.2018;2018;09;03;Sunnuntai;0;2;2;0;1;1
292;02.09.2018;2018;09;04;Sunnuntai;0;1;1;1;3;4
292;02.09.2018;2018;09;05;Sunnuntai;1;2;3;1;0;1
292;02.09.2018;2018;09;06;Sunnuntai;5;3;8;2;3;5
292;02.09.2018;2018;09;07;Sunnuntai;4;3;7;4;4;8
292;02.09.2018;2018;09;08;Sunnuntai;3;6;9;4;10;14
292;02.09.2018;2018;09;09;Sunnuntai;16;9;25;8;6;14
292;02.09.2018;2018;09;10;Sunnuntai;21;23;44;5;10;15
292;02.09.2018;2018;09;11;Sunnuntai;27;42;69;10;25;35
292;02.09.2018;2018;09;12;Sunnuntai;52;31;83;12;26;38
292;02.09.2018;2018;09;13;Sunnuntai;54;28;82;10;24;34
292;02.09.2018;2018;09;14;Sunnuntai;47;63;110;18;27;45
292;02.09.2018;2018;09;15;Sunnuntai;77;43;120;13;13;26
292;02.09.2018;2018;09;16;Sunnuntai;49;33;82;18;21;39
292;02.09.2018;2018;09;17;Sunnuntai;48;41;89;20;21;41
292;02.09.2018;2018;09;18;Sunnuntai;45;36;81;21;43;64
292;02.09.2018;2018;09;19;Sunnuntai;43;23;66;16;19;35
292;02.09.2018;2018;09;20;Sunnuntai;30;18;48;12;22;34
292;02.09.2018;2018;09;21;Sunnuntai;18;14;32;7;13;20
292;02.09.2018;2018;09;22;Sunnuntai;5;4;9;1;4;5
292;02.09.2018;2018;09;23;Sunnuntai;0;1;1;1;1;2
292;03.09.2018;2018;09;00;Maanantai;1;4;5;1;0;1
292;03.09.2018;2018;09;01;Maanantai;0;0;0;0;0;0
292;03.09.2018;2018;09;02;Maanantai;1;0;1;0;0;0
292;03.09.2018;2018;09;03;Maanantai;0;1;1;0;0;0
292;03.09.2018;2018;09;04;Maanantai;0;0;0;0;0;0
292;03.09.2018;2018;09;05;Maanantai;4;2;6;0;2;2
292;03.09.2018;2018;09;06;Maanantai;27;13;40;2;11;13
292;03.09.2018;2018;09;07;Maanantai;71;32;103;4;13;17
292;03.09.2018;2018;09;08;Maanantai;46;38;84;5;14;19
292;03.09.2018;2018;09;09;Maanantai;69;50;119;15;10;25
292;03.09.2018;2018;09;10;Maanantai;39;19;58;12;31;43
292;03.09.2018;2018;09;11;Maanantai;57;28;85;16;32;48
292;03.09.2018;2018;09;12;Maanantai;40;28;68;9;28;37
292;03.09.2018;2018;09;13;Maanantai;38;53;91;13;21;34
292;03.09.2018;2018;09;14;Maanantai;49;49;98;10;38;48
292;03.09.2018;2018;09;15;Maanantai;77;81;158;21;44;65
292;03.09.2018;2018;09;16;Maanantai;53;82;135;20;49;69
292;03.09.2018;2018;09;17;Maanantai;77;65;142;19;35;54
292;03.09.2018;2018;09;18;Maanantai;50;48;98;26;35;61
292;03.09.2018;2018;09;19;Maanantai;59;42;101;12;37;49
292;03.09.2018;2018;09;20;Maanantai;46;28;74;14;25;39
292;03.09.2018;2018;09;21;Maanantai;17;8;25;7;10;17
292;03.09.2018;2018;09;22;Maanantai;6;4;10;5;4;9
292;03.09.2018;2018;09;23;Maanantai;4;2;6;0;0;0
292;04.09.2018;2018;09;00;Tiistai;0;1;1;0;0;0
292;04.09.2018;2018;09;01;Tiistai;0;0;0;1;0;1
292;04.09.2018;2018;09;02;Tiistai;0;0;0;1;0;1
292;04.09.2018;2018;09;03;Tiistai;0;0;0;0;1;1
292;04.09.2018;2018;09;04;Tiistai;1;1;2;0;0;0
292;04.09.2018;2018;09;05;Tiistai;6;7;13;2;5;7
292;04.09.2018;2018;09;06;Tiistai;42;14;56;5;16;21
292;04.09.2018;2018;09;07;Tiistai;83;46;129;11;11;22
292;04.09.2018;2018;09;08;Tiistai;55;40;95;6;14;20
292;04.09.2018;2018;09;09;Tiistai;36;30;66;5;14;19
292;04.09.2018;2018;09;10;Tiistai;43;23;66;14;14;28
292;04.09.2018;2018;09;11;Tiistai;36;23;59;6;23;29
292;04.09.2018;2018;09;12;Tiistai;37;31;68;9;28;37
292;04.09.2018;2018;09;13;Tiistai;52;54;106;19;44;63
292;04.09.2018;2018;09;14;Tiistai;46;76;122;20;39;59
292;04.09.2018;2018;09;15;Tiistai;59;81;140;8;41;49
292;04.09.2018;2018;09;16;Tiistai;64;62;126;19;17;36
292;04.09.2018;2018;09;17;Tiistai;84;55;139;22;36;58
292;04.09.2018;2018;09;18;Tiistai;78;75;153;24;25;49
292;04.09.2018;2018;09;19;Tiistai;55;49;104;20;35;55
292;04.09.2018;2018;09;20;Tiistai;39;22;61;11;18;29
292;04.09.2018;2018;09;21;Tiistai;12;8;20;11;8;19
292;04.09.2018;2018;09;22;Tiistai;4;4;8;1;2;3
292;04.09.2018;2018;09;23;Tiistai;1;1;2;1;1;2
292;05.09.2018;2018;09;00;Keskiviikko;1;0;1;0;0;0
292;05.09.2018;2018;09;01;Keskiviikko;1;0;1;0;1;1
292;05.09.2018;2018;09;02;Keskiviikko;0;1;1;0;0;0
292;05.09.2018;2018;09;03;Keskiviikko;1;0;1;0;0;0
292;05.09.2018;2018;09;04;Keskiviikko;2;0;2;0;0;0
292;05.09.2018;2018;09;05;Keskiviikko;8;6;14;0;1;1
292;05.09.2018;2018;09;06;Keskiviikko;25;16;41;4;6;10
292;05.09.2018;2018;09;07;Keskiviikko;67;49;116;8;10;18
292;05.09.2018;2018;09;08;Keskiviikko;70;43;113;9;18;27
292;05.09.2018;2018;09;09;Keskiviikko;37;24;61;9;10;19
292;05.09.2018;2018;09;10;Keskiviikko;28;23;51;4;4;8
292;05.09.2018;2018;09;11;Keskiviikko;25;23;48;3;7;10
292;05.09.2018;2018;09;12;Keskiviikko;29;25;54;6;6;12
292;05.09.2018;2018;09;13;Keskiviikko;53;59;112;13;6;19
292;05.09.2018;2018;09;14;Keskiviikko;66;74;140;11;15;26
292;05.09.2018;2018;09;15;Keskiviikko;64;67;131;15;9;24
292;05.09.2018;2018;09;16;Keskiviikko;56;57;113;12;15;27
292;05.09.2018;2018;09;17;Keskiviikko;47;39;86;10;14;24
292;05.09.2018;2018;09;18;Keskiviikko;48;34;82;13;20;33
292;05.09.2018;2018;09;19;Keskiviikko;46;22;68;17;17;34
292;05.09.2018;2018;09;20;Keskiviikko;37;14;51;16;21;37
292;05.09.2018;2018;09;21;Keskiviikko;17;15;32;9;11;20
292;05.09.2018;2018;09;22;Keskiviikko;2;1;3;0;0;0
292;05.09.2018;2018;09;23;Keskiviikko;4;1;5;0;1;1
292;06.09.2018;2018;09;00;Torstai;1;0;1;0;0;0
292;06.09.2018;2018;09;01;Torstai;1;0;1;0;1;1
292;06.09.2018;2018;09;02;Torstai;0;0;0;0;0;0
292;06.09.2018;2018;09;03;Torstai;0;0;0;0;0;0
292;06.09.2018;2018;09;04;Torstai;1;2;3;0;0;0
292;06.09.2018;2018;09;05;Torstai;9;7;16;1;3;4
292;06.09.2018;2018;09;06;Torstai;22;18;40;1;8;9
292;06.09.2018;2018;09;07;Torstai;58;28;86;6;6;12
292;06.09.2018;2018;09;08;Torstai;54;31;85;14;10;24
292;06.09.2018;2018;09;09;Torstai;70;39;109;8;9;17
292;06.09.2018;2018;09;10;Torstai;40;36;76;8;10;18
292;06.09.2018;2018;09;11;Torstai;28;26;54;7;12;19
292;06.09.2018;2018;09;12;Torstai;39;40;79;8;8;16
292;06.09.2018;2018;09;13;Torstai;42;38;80;9;4;13
292;06.09.2018;2018;09;14;Torstai;60;50;110;13;16;29
292;06.09.2018;2018;09;15;Torstai;67;77;144;6;15;21
292;06.09.2018;2018;09;16;Torstai;53;61;114;13;12;25
292;06.09.2018;2018;09;17;Torstai;64;43;107;11;13;24
292;06.09.2018;2018;09;18;Torstai;40;40;80;19;20;39
292;06.09.2018;2018;09;19;Torstai;24;28;52;8;4;12
292;06.09.2018;2018;09;20;Torstai;25;20;45;8;1;9
292;06.09.2018;2018;09;21;Torstai;12;7;19;5;3;8
292;06.09.2018;2018;09;22;Torstai;3;5;8;1;0;1
292;06.09.2018;2018;09;23;Torstai;0;0;0;0;1;1
292;07.09.2018;2018;09;00;Perjantai;2;0;2;0;0;0
292;07.09.2018;2018;09;01;Perjantai;0;0;0;0;1;1
292;07.09.2018;2018;09;02;Perjantai;0;0;0;0;0;0
292;07.09.2018;2018;09;03;Perjantai;0;0;0;0;0;0
292;07.09.2018;2018;09;04;Perjantai;1;1;2;0;0;0
292;07.09.2018;2018;09;05;Perjantai;9;9;18;1;3;4
292;07.09.2018;2018;09;06;Perjantai;20;13;33;4;4;8
292;07.09.2018;2018;09;07;Perjantai;70;41;111;3;6;9
292;07.09.2018;2018;09;08;Perjantai;49;34;83;9;8;17
292;07.09.2018;2018;09;09;Perjantai;34;31;65;4;7;11
292;07.09.2018;2018;09;10;Perjantai;32;25;57;7;5;12
292;07.09.2018;2018;09;11;Perjantai;29;29;58;3;6;9
292;07.09.2018;2018;09;12;Perjantai;43;29;72;9;16;25
292;07.09.2018;2018;09;13;Perjantai;30;83;113;6;37;43
292;07.09.2018;2018;09;14;Perjantai;51;57;108;15;35;50
292;07.09.2018;2018;09;15;Perjantai;44;57;101;19;37;56
292;07.09.2018;2018;09;16;Perjantai;45;32;77;14;30;44
292;07.09.2018;2018;09;17;Perjantai;55;32;87;7;32;39
292;07.09.2018;2018;09;18;Perjantai;51;34;85;19;33;52
292;07.09.2018;2018;09;19;Perjantai;47;39;86;25;31;56
292;07.09.2018;2018;09;20;Perjantai;43;35;78;12;14;26
292;07.09.2018;2018;09;21;Perjantai;27;11;38;16;16;32
292;07.09.2018;2018;09;22;Perjantai;8;10;18;8;6;14
292;07.09.2018;2018;09;23;Perjantai;13;2;15;6;0;6
292;08.09.2018;2018;09;00;Lauantai;1;8;9;1;2;3
292;08.09.2018;2018;09;01;Lauantai;1;2;3;1;5;6
292;08.09.2018;2018;09;02;Lauantai;4;2;6;0;1;1
292;08.09.2018;2018;09;03;Lauantai;1;2;3;0;5;5
292;08.09.2018;2018;09;04;Lauantai;2;2;4;2;3;5
292;08.09.2018;2018;09;05;Lauantai;1;2;3;0;0;0
292;08.09.2018;2018;09;06;Lauantai;3;2;5;1;3;4
292;08.09.2018;2018;09;07;Lauantai;4;3;7;2;1;3
292;08.09.2018;2018;09;08;Lauantai;11;10;21;7;9;16
292;08.09.2018;2018;09;09;Lauantai;8;22;30;6;12;18
292;08.09.2018;2018;09;10;Lauantai;26;23;49;9;13;22
292;08.09.2018;2018;09;11;Lauantai;30;32;62;15;25;40
292;08.09.2018;2018;09;12;Lauantai;52;33;85;10;24;34
292;08.09.2018;2018;09;13;Lauantai;41;32;73;19;36;55
292;08.09.2018;2018;09;14;Lauantai;30;27;57;20;25;45
292;08.09.2018;2018;09;15;Lauantai;48;34;82;20;26;46
292;08.09.2018;2018;09;16;Lauantai;53;47;100;13;16;29
292;08.09.2018;2018;09;17;Lauantai;47;40;87;16;27;43
292;08.09.2018;2018;09;18;Lauantai;53;32;85;15;13;28
292;08.09.2018;2018;09;19;Lauantai;40;32;72;8;22;30
292;08.09.2018;2018;09;20;Lauantai;23;18;41;4;14;18
292;08.09.2018;2018;09;21;Lauantai;3;9;12;5;5;10
292;08.09.2018;2018;09;22;Lauantai;10;7;17;8;12;20
292;08.09.2018;2018;09;23;Lauantai;8;3;11;5;7;12
292;09.09.2018;2018;09;00;Sunnuntai;2;13;15;3;7;10
292;09.09.2018;2018;09;01;Sunnuntai;2;2;4;1;4;5
292;09.09.2018;2018;09;02;Sunnuntai;2;2;4;0;2;2
292;09.09.2018;2018;09;03;Sunnuntai;0;0;0;0;5;5
292;09.09.2018;2018;09;04;Sunnuntai;1;0;1;1;1;2
292;09.09.2018;2018;09;05;Sunnuntai;0;0;0;0;0;0
292;09.09.2018;2018;09;06;Sunnuntai;3;2;5;2;2;4
292;09.09.2018;2018;09;07;Sunnuntai;2;2;4;1;4;5
292;09.09.2018;2018;09;08;Sunnuntai;5;6;11;2;3;5
292;09.09.2018;2018;09;09;Sunnuntai;17;11;28;4;5;9
292;09.09.2018;2018;09;10;Sunnuntai;29;27;56;8;9;17
292;09.09.2018;2018;09;11;Sunnuntai;38;20;58;16;11;27
292;09.09.2018;2018;09;12;Sunnuntai;34;38;72;13;38;51
292;09.09.2018;2018;09;13;Sunnuntai;49;33;82;22;19;41
292;09.09.2018;2018;09;14;Sunnuntai;62;52;114;26;30;56
292;09.09.2018;2018;09;15;Sunnuntai;42;32;74;14;27;41
292;09.09.2018;2018;09;16;Sunnuntai;44;29;73;15;23;38
292;09.09.2018;2018;09;17;Sunnuntai;52;47;99;17;19;36
292;09.09.2018;2018;09;18;Sunnuntai;50;30;80;14;26;40
292;09.09.2018;2018;09;19;Sunnuntai;27;24;51;11;17;28
292;09.09.2018;2018;09;20;Sunnuntai;21;21;42;10;9;19
292;09.09.2018;2018;09;21;Sunnuntai;15;7;22;5;8;13
292;09.09.2018;2018;09;22;Sunnuntai;0;1;1;2;5;7
292;09.09.2018;2018;09;23;Sunnuntai;0;1;1;0;0;0
292;10.09.2018;2018;09;00;Maanantai;0;0;0;0;1;1
292;10.09.2018;2018;09;01;Maanantai;0;1;1;2;1;3
292;10.09.2018;2018;09;02;Maanantai;0;0;0;0;1;1
292;10.09.2018;2018;09;03;Maanantai;0;0;0;0;0;0
292;10.09.2018;2018;09;04;Maanantai;1;0;1;0;0;0
292;10.09.2018;2018;09;05;Maanantai;10;7;17;2;3;5
292;10.09.2018;2018;09;06;Maanantai;24;11;35;2;11;13
292;10.09.2018;2018;09;07;Maanantai;61;29;90;6;6;12
292;10.09.2018;2018;09;08;Maanantai;46;22;68;9;13;22
292;10.09.2018;2018;09;09;Maanantai;62;29;91;7;6;13
292;10.09.2018;2018;09;10;Maanantai;31;18;49;6;7;13
292;10.09.2018;2018;09;11;Maanantai;44;23;67;8;8;16
292;10.09.2018;2018;09;12;Maanantai;30;21;51;6;17;23
292;10.09.2018;2018;09;13;Maanantai;41;81;122;12;42;54
292;10.09.2018;2018;09;14;Maanantai;52;49;101;15;27;42
292;10.09.2018;2018;09;15;Maanantai;93;86;179;31;18;49
292;10.09.2018;2018;09;16;Maanantai;58;71;129;14;39;53
292;10.09.2018;2018;09;17;Maanantai;67;38;105;22;24;46
292;10.09.2018;2018;09;18;Maanantai;56;37;93;15;32;47
292;10.09.2018;2018;09;19;Maanantai;41;40;81;13;26;39
292;10.09.2018;2018;09;20;Maanantai;45;30;75;15;23;38
292;10.09.2018;2018;09;21;Maanantai;22;13;35;6;5;11
292;10.09.2018;2018;09;22;Maanantai;5;1;6;0;0;0
292;10.09.2018;2018;09;23;Maanantai;0;2;2;1;0;1
292;11.09.2018;2018;09;00;Tiistai;2;1;3;0;0;0
292;11.09.2018;2018;09;01;Tiistai;2;0;2;0;2;2
292;11.09.2018;2018;09;02;Tiistai;0;0;0;0;0;0
292;11.09.2018;2018;09;03;Tiistai;0;0;0;0;0;0
292;11.09.2018;2018;09;04;Tiistai;0;0;0;0;0;0
292;11.09.2018;2018;09;05;Tiistai;9;7;16;0;1;1
292;11.09.2018;2018;09;06;Tiistai;30;18;48;5;4;9
292;11.09.2018;2018;09;07;Tiistai;77;28;105;9;7;16
292;11.09.2018;2018;09;08;Tiistai;70;20;90;8;17;25
292;11.09.2018;2018;09;09;Tiistai;19;10;29;9;6;15
292;11.09.2018;2018;09;10;Tiistai;26;14;40;7;6;13
292;11.09.2018;2018;09;11;Tiistai;25;17;42;2;13;15
292;11.09.2018;2018;09;12;Tiistai;32;14;46;10;3;13
292;11.09.2018;2018;09;13;Tiistai;24;37;61;8;16;24
292;11.09.2018;2018;09;14;Tiistai;47;57;104;14;23;37
292;11.09.2018;2018;09;15;Tiistai;58;38;96;16;20;36
292;11.09.2018;2018;09;16;Tiistai;34;28;62;5;11;16
292;11.09.2018;2018;09;17;Tiistai;19;16;35;1;2;3
292;11.09.2018;2018;09;18;Tiistai;11;9;20;2;3;5
292;11.09.2018;2018;09;19;Tiistai;12;13;25;3;5;8
292;11.09.2018;2018;09;20;Tiistai;15;13;28;7;8;15
292;11.09.2018;2018;09;21;Tiistai;10;9;19;2;4;6
292;11.09.2018;2018;09;22;Tiistai;6;4;10;0;3;3
292;11.09.2018;2018;09;23;Tiistai;1;0;1;0;0;0
292;12.09.2018;2018;09;00;Keskiviikko;1;0;1;0;0;0
292;12.09.2018;2018;09;01;Keskiviikko;1;0;1;0;0;0
292;12.09.2018;2018;09;02;Keskiviikko;0;0;0;0;0;0
292;12.09.2018;2018;09;03;Keskiviikko;0;0;0;0;0;0
292;12.09.2018;2018;09;04;Keskiviikko;1;0;1;0;0;0
292;12.09.2018;2018;09;05;Keskiviikko;4;5;9;1;0;1
292;12.09.2018;2018;09;06;Keskiviikko;18;12;30;3;3;6
292;12.09.2018;2018;09;07;Keskiviikko;45;37;82;2;2;4
292;12.09.2018;2018;09;08;Keskiviikko;48;36;84;7;7;14
292;12.09.2018;2018;09;09;Keskiviikko;23;15;38;4;9;13
292;12.09.2018;2018;09;10;Keskiviikko;8;8;16;6;4;10
292;12.09.2018;2018;09;11;Keskiviikko;12;11;23;4;2;6
292;12.09.2018;2018;09;12;Keskiviikko;14;11;25;1;6;7
292;12.09.2018;2018;09;13;Keskiviikko;30;29;59;3;4;7
292;12.09.2018;2018;09;14;Keskiviikko;25;28;53;8;5;13
292;12.09.2018;2018;09;15;Keskiviikko;33;33;66;7;10;17
292;12.09.2018;2018;09;16;Keskiviikko;27;26;53;8;8;16
292;12.09.2018;2018;09;17;Keskiviikko;16;17;33;3;10;13
292;12.09.2018;2018;09;18;Keskiviikko;18;15;33;12;13;25
292;12.09.2018;2018;09;19;Keskiviikko;24;16;40;17;19;36
292;12.09.2018;2018;09;20;Keskiviikko;22;10;32;9;9;18
292;12.09.2018;2018;09;21;Keskiviikko;11;8;19;3;2;5
292;12.09.2018;2018;09;22;Keskiviikko;1;2;3;2;0;2
292;12.09.2018;2018;09;23;Keskiviikko;2;1;3;0;0;0
292;13.09.2018;2018;09;00;Torstai;0;0;0;3;0;3
292;13.09.2018;2018;09;01;Torstai;1;1;2;0;0;0
292;13.09.2018;2018;09;02;Torstai;0;0;0;0;0;0
292;13.09.2018;2018;09;03;Torstai;0;0;0;0;0;0
292;13.09.2018;2018;09;04;Torstai;1;1;2;0;0;0
292;13.09.2018;2018;09;05;Torstai;7;10;17;1;2;3
292;13.09.2018;2018;09;06;Torstai;24;18;42;4;9;13
292;13.09.2018;2018;09;07;Torstai;77;29;106;9;7;16
292;13.09.2018;2018;09;08;Torstai;33;25;58;42;37;79
292;13.09.2018;2018;09;09;Torstai;56;42;98;10;13;23
292;13.09.2018;2018;09;10;Torstai;32;22;54;14;16;30
292;13.09.2018;2018;09;11;Torstai;33;25;58;9;19;28
292;13.09.2018;2018;09;12;Torstai;29;28;57;9;23;32
292;13.09.2018;2018;09;13;Torstai;31;52;83;12;24;36
292;13.09.2018;2018;09;14;Torstai;47;35;82;16;35;51
292;13.09.2018;2018;09;15;Torstai;50;77;127;23;35;58
292;13.09.2018;2018;09;16;Torstai;53;95;148;20;40;60
292;13.09.2018;2018;09;17;Torstai;58;45;103;9;30;39
292;13.09.2018;2018;09;18;Torstai;52;40;92;18;35;53
292;13.09.2018;2018;09;19;Torstai;49;40;89;23;26;49
292;13.09.2018;2018;09;20;Torstai;49;14;63;17;12;29
292;13.09.2018;2018;09;21;Torstai;14;9;23;3;10;13
292;13.09.2018;2018;09;22;Torstai;1;0;1;3;3;6
292;13.09.2018;2018;09;23;Torstai;2;0;2;0;0;0
292;14.09.2018;2018;09;00;Perjantai;1;0;1;0;0;0
292;14.09.2018;2018;09;01;Perjantai;0;1;1;0;0;0
292;14.09.2018;2018;09;02;Perjantai;0;1;1;0;0;0
292;14.09.2018;2018;09;03;Perjantai;0;1;1;0;0;0
292;14.09.2018;2018;09;04;Perjantai;1;1;2;0;0;0
292;14.09.2018;2018;09;05;Perjantai;4;7;11;1;0;1
292;14.09.2018;2018;09;06;Perjantai;23;5;28;2;14;16
292;14.09.2018;2018;09;07;Perjantai;82;27;109;8;8;16
292;14.09.2018;2018;09;08;Perjantai;70;31;101;8;16;24
292;14.09.2018;2018;09;09;Perjantai;28;24;52;8;16;24
292;14.09.2018;2018;09;10;Perjantai;20;18;38;10;12;22
292;14.09.2018;2018;09;11;Perjantai;25;30;55;3;21;24
292;14.09.2018;2018;09;12;Perjantai;54;42;96;13;16;29
292;14.09.2018;2018;09;13;Perjantai;39;83;122;11;41;52
292;14.09.2018;2018;09;14;Perjantai;62;43;105;9;26;35
292;14.09.2018;2018;09;15;Perjantai;40;31;71;6;9;15
292;14.09.2018;2018;09;16;Perjantai;30;29;59;5;5;10
292;14.09.2018;2018;09;17;Perjantai;32;25;57;8;4;12
292;14.09.2018;2018;09;18;Perjantai;32;22;54;14;20;34
292;14.09.2018;2018;09;19;Perjantai;27;18;45;13;12;25
292;14.09.2018;2018;09;20;Perjantai;24;19;43;9;4;13
292;14.09.2018;2018;09;21;Perjantai;15;16;31;11;9;20
292;14.09.2018;2018;09;22;Perjantai;9;9;18;10;12;22
292;14.09.2018;2018;09;23;Perjantai;8;6;14;5;1;6
292;15.09.2018;2018;09;00;Lauantai;4;0;4;2;2;4
292;15.09.2018;2018;09;01;Lauantai;7;2;9;2;1;3
292;15.09.2018;2018;09;02;Lauantai;0;0;0;0;0;0
292;15.09.2018;2018;09;03;Lauantai;2;1;3;0;2;2
292;15.09.2018;2018;09;04;Lauantai;2;3;5;1;2;3
292;15.09.2018;2018;09;05;Lauantai;0;0;0;0;0;0
292;15.09.2018;2018;09;06;Lauantai;5;1;6;0;4;4
292;15.09.2018;2018;09;07;Lauantai;9;7;16;4;5;9
292;15.09.2018;2018;09;08;Lauantai;6;6;12;4;2;6
292;15.09.2018;2018;09;09;Lauantai;15;14;29;3;0;3
292;15.09.2018;2018;09;10;Lauantai;29;27;56;5;7;12
292;15.09.2018;2018;09;11;Lauantai;29;28;57;3;15;18
292;15.09.2018;2018;09;12;Lauantai;29;24;53;8;9;17
292;15.09.2018;2018;09;13;Lauantai;19;14;33;4;2;6
292;15.09.2018;2018;09;14;Lauantai;13;11;24;2;7;9
292;15.09.2018;2018;09;15;Lauantai;22;13;35;0;4;4
292;15.09.2018;2018;09;16;Lauantai;12;12;24;9;3;12
292;15.09.2018;2018;09;17;Lauantai;20;11;31;4;6;10
292;15.09.2018;2018;09;18;Lauantai;25;21;46;20;6;26
292;15.09.2018;2018;09;19;Lauantai;20;20;40;6;24;30
292;15.09.2018;2018;09;20;Lauantai;22;15;37;12;11;23
292;15.09.2018;2018;09;21;Lauantai;11;11;22;6;4;10
292;15.09.2018;2018;09;22;Lauantai;4;10;14;7;0;7
292;15.09.2018;2018;09;23;Lauantai;7;3;10;7;4;11
292;16.09.2018;2018;09;00;Sunnuntai;3;4;7;1;3;4
292;16.09.2018;2018;09;01;Sunnuntai;1;3;4;0;0;0
292;16.09.2018;2018;09;02;Sunnuntai;1;0;1;0;0;0
292;16.09.2018;2018;09;03;Sunnuntai;0;1;1;6;5;11
292;16.09.2018;2018;09;04;Sunnuntai;1;1;2;3;1;4
292;16.09.2018;2018;09;05;Sunnuntai;0;0;0;1;0;1
292;16.09.2018;2018;09;06;Sunnuntai;5;3;8;2;6;8
292;16.09.2018;2018;09;07;Sunnuntai;4;2;6;7;4;11
292;16.09.2018;2018;09;08;Sunnuntai;6;3;9;3;7;10
292;16.09.2018;2018;09;09;Sunnuntai;12;13;25;3;10;13
292;16.09.2018;2018;09;10;Sunnuntai;20;23;43;9;13;22
292;16.09.2018;2018;09;11;Sunnuntai;31;25;56;11;22;33
292;16.09.2018;2018;09;12;Sunnuntai;45;34;79;10;31;41
292;16.09.2018;2018;09;13;Sunnuntai;40;32;72;17;25;42
292;16.09.2018;2018;09;14;Sunnuntai;39;23;62;10;17;27
292;16.09.2018;2018;09;15;Sunnuntai;48;25;73;12;11;23
292;16.09.2018;2018;09;16;Sunnuntai;33;18;51;11;11;22
292;16.09.2018;2018;09;17;Sunnuntai;35;16;51;10;11;21
292;16.09.2018;2018;09;18;Sunnuntai;23;19;42;16;11;27
292;16.09.2018;2018;09;19;Sunnuntai;20;18;38;10;28;38
292;16.09.2018;2018;09;20;Sunnuntai;11;14;25;3;8;11
292;16.09.2018;2018;09;21;Sunnuntai;9;3;12;0;3;3
292;16.09.2018;2018;09;22;Sunnuntai;3;0;3;0;1;1
292;16.09.2018;2018;09;23;Sunnuntai;1;0;1;0;0;0
292;17.09.2018;2018;09;00;Maanantai;0;0;0;0;0;0
292;17.09.2018;2018;09;01;Maanantai;0;0;0;0;0;0
292;17.09.2018;2018;09;02;Maanantai;0;1;1;0;0;0
292;17.09.2018;2018;09;03;Maanantai;1;0;1;0;0;0
292;17.09.2018;2018;09;04;Maanantai;2;0;2;0;1;1
292;17.09.2018;2018;09;05;Maanantai;9;4;13;0;3;3
292;17.09.2018;2018;09;06;Maanantai;25;9;34;4;10;14
292;17.09.2018;2018;09;07;Maanantai;63;28;91;10;11;21
292;17.09.2018;2018;09;08;Maanantai;37;31;68;3;10;13
292;17.09.2018;2018;09;09;Maanantai;46;41;87;4;4;8
292;17.09.2018;2018;09;10;Maanantai;26;27;53;20;20;40
292;17.09.2018;2018;09;11;Maanantai;42;19;61;11;37;48
292;17.09.2018;2018;09;12;Maanantai;24;38;62;10;25;35
292;17.09.2018;2018;09;13;Maanantai;41;26;67;10;26;36
292;17.09.2018;2018;09;14;Maanantai;49;42;91;17;33;50
292;17.09.2018;2018;09;15;Maanantai;44;76;120;23;36;59
292;17.09.2018;2018;09;16;Maanantai;52;63;115;17;21;38
292;17.09.2018;2018;09;17;Maanantai;63;40;103;19;18;37
292;17.09.2018;2018;09;18;Maanantai;42;29;71;10;19;29
292;17.09.2018;2018;09;19;Maanantai;24;41;65;18;13;31
292;17.09.2018;2018;09;20;Maanantai;21;16;37;6;12;18
292;17.09.2018;2018;09;21;Maanantai;6;3;9;6;7;13
292;17.09.2018;2018;09;22;Maanantai;1;2;3;0;0;0
292;17.09.2018;2018;09;23;Maanantai;2;1;3;0;0;0
292;18.09.2018;2018;09;00;Tiistai;0;0;0;0;2;2
292;18.09.2018;2018;09;01;Tiistai;0;0;0;0;0;0
292;18.09.2018;2018;09;02;Tiistai;0;0;0;0;0;0
292;18.09.2018;2018;09;03;Tiistai;0;1;1;0;0;0
292;18.09.2018;2018;09;04;Tiistai;0;0;0;0;0;0
292;18.09.2018;2018;09;05;Tiistai;5;4;9;1;5;6
292;18.09.2018;2018;09;06;Tiistai;22;13;35;7;11;18
292;18.09.2018;2018;09;07;Tiistai;81;18;99;8;14;22
292;18.09.2018;2018;09;08;Tiistai;57;38;95;8;16;24
292;18.09.2018;2018;09;09;Tiistai;21;20;41;5;1;6
292;18.09.2018;2018;09;10;Tiistai;32;21;53;4;8;12
292;18.09.2018;2018;09;11;Tiistai;36;20;56;14;23;37
292;18.09.2018;2018;09;12;Tiistai;30;25;55;6;13;19
292;18.09.2018;2018;09;13;Tiistai;35;46;81;14;29;43
292;18.09.2018;2018;09;14;Tiistai;43;75;118;30;43;73
292;18.09.2018;2018;09;15;Tiistai;44;43;87;13;28;41
292;18.09.2018;2018;09;16;Tiistai;47;67;114;12;32;44
292;18.09.2018;2018;09;17;Tiistai;54;46;100;23;29;52
292;18.09.2018;2018;09;18;Tiistai;47;31;78;20;35;55
292;18.09.2018;2018;09;19;Tiistai;36;33;69;12;35;47
292;18.09.2018;2018;09;20;Tiistai;31;17;48;9;14;23
292;18.09.2018;2018;09;21;Tiistai;8;12;20;6;5;11
292;18.09.2018;2018;09;22;Tiistai;9;4;13;5;0;5
292;18.09.2018;2018;09;23;Tiistai;1;0;1;1;0;1
292;19.09.2018;2018;09;00;Keskiviikko;0;2;2;0;1;1
292;19.09.2018;2018;09;01;Keskiviikko;0;0;0;0;0;0
292;19.09.2018;2018;09;02;Keskiviikko;0;0;0;0;0;0
292;19.09.2018;2018;09;03;Keskiviikko;0;0;0;0;0;0
292;19.09.2018;2018;09;04;Keskiviikko;2;0;2;0;0;0
292;19.09.2018;2018;09;05;Keskiviikko;8;5;13;1;3;4
292;19.09.2018;2018;09;06;Keskiviikko;24;14;38;5;6;11
292;19.09.2018;2018;09;07;Keskiviikko;84;31;115;4;7;11
292;19.09.2018;2018;09;08;Keskiviikko;70;35;105;11;10;21
292;19.09.2018;2018;09;09;Keskiviikko;25;18;43;7;7;14
292;19.09.2018;2018;09;10;Keskiviikko;30;18;48;5;10;15
292;19.09.2018;2018;09;11;Keskiviikko;20;16;36;5;16;21
292;19.09.2018;2018;09;12;Keskiviikko;14;13;27;5;3;8
292;19.09.2018;2018;09;13;Keskiviikko;36;40;76;8;11;19
292;19.09.2018;2018;09;14;Keskiviikko;31;35;66;8;13;21
292;19.09.2018;2018;09;15;Keskiviikko;45;43;88;6;10;16
292;19.09.2018;2018;09;16;Keskiviikko;31;30;61;2;6;8
292;19.09.2018;2018;09;17;Keskiviikko;23;13;36;6;7;13
292;19.09.2018;2018;09;18;Keskiviikko;21;16;37;5;11;16
292;19.09.2018;2018;09;19;Keskiviikko;22;19;41;7;11;18
292;19.09.2018;2018;09;20;Keskiviikko;24;10;34;4;5;9
292;19.09.2018;2018;09;21;Keskiviikko;9;5;14;4;2;6
292;19.09.2018;2018;09;22;Keskiviikko;5;2;7;0;0;0
292;19.09.2018;2018;09;23;Keskiviikko;0;0;0;0;1;1
292;20.09.2018;2018;09;00;Torstai;1;0;1;1;0;1
292;20.09.2018;2018;09;01;Torstai;0;1;1;0;2;2
292;20.09.2018;2018;09;02;Torstai;0;0;0;1;0;1
292;20.09.2018;2018;09;03;Torstai;0;0;0;0;0;0
292;20.09.2018;2018;09;04;Torstai;1;1;2;0;1;1
292;20.09.2018;2018;09;05;Torstai;6;4;10;0;0;0
292;20.09.2018;2018;09;06;Torstai;21;14;35;2;5;7
292;20.09.2018;2018;09;07;Torstai;76;28;104;5;4;9
292;20.09.2018;2018;09;08;Torstai;40;22;62;4;15;19
292;20.09.2018;2018;09;09;Torstai;52;33;85;11;3;14
292;20.09.2018;2018;09;10;Torstai;29;21;50;4;8;12
292;20.09.2018;2018;09;11;Torstai;38;28;66;7;8;15
292;20.09.2018;2018;09;12;Torstai;33;22;55;2;10;12
292;20.09.2018;2018;09;13;Torstai;33;24;57;11;13;24
292;20.09.2018;2018;09;14;Torstai;24;24;48;8;24;32
292;20.09.2018;2018;09;15;Torstai;41;70;111;10;26;36
292;20.09.2018;2018;09;16;Torstai;41;63;104;7;28;35
292;20.09.2018;2018;09;17;Torstai;42;32;74;8;22;30
292;20.09.2018;2018;09;18;Torstai;43;27;70;12;16;28
292;20.09.2018;2018;09;19;Torstai;24;39;63;16;22;38
292;20.09.2018;2018;09;20;Torstai;32;14;46;11;26;37
292;20.09.2018;2018;09;21;Torstai;9;8;17;9;6;15
292;20.09.2018;2018;09;22;Torstai;10;1;11;1;2;3
292;20.09.2018;2018;09;23;Torstai;2;0;2;2;0;2
292;21.09.2018;2018;09;00;Perjantai;0;0;0;0;0;0
292;21.09.2018;2018;09;01;Perjantai;1;1;2;0;0;0
292;21.09.2018;2018;09;02;Perjantai;2;2;4;1;0;1
292;21.09.2018;2018;09;03;Perjantai;1;2;3;2;0;2
292;21.09.2018;2018;09;04;Perjantai;1;0;1;0;0;0
292;21.09.2018;2018;09;05;Perjantai;7;4;11;2;1;3
292;21.09.2018;2018;09;06;Perjantai;20;10;30;2;7;9
292;21.09.2018;2018;09;07;Perjantai;73;28;101;6;14;20
292;21.09.2018;2018;09;08;Perjantai;70;20;90;8;12;20
292;21.09.2018;2018;09;09;Perjantai;30;20;50;7;13;20
292;21.09.2018;2018;09;10;Perjantai;27;14;41;8;17;25
292;21.09.2018;2018;09;11;Perjantai;27;21;48;12;14;26
292;21.09.2018;2018;09;12;Perjantai;31;42;73;11;29;40
292;21.09.2018;2018;09;13;Perjantai;29;76;105;17;35;52
292;21.09.2018;2018;09;14;Perjantai;44;37;81;9;20;29
292;21.09.2018;2018;09;15;Perjantai;39;40;79;16;28;44
292;21.09.2018;2018;09;16;Perjantai;42;25;67;20;12;32
292;21.09.2018;2018;09;17;Perjantai;48;28;76;9;18;27
292;21.09.2018;2018;09;18;Perjantai;38;39;77;12;12;24
292;21.09.2018;2018;09;19;Perjantai;26;14;40;7;10;17
292;21.09.2018;2018;09;20;Perjantai;17;12;29;14;5;19
292;21.09.2018;2018;09;21;Perjantai;11;9;20;3;2;5
292;21.09.2018;2018;09;22;Perjantai;11;3;14;6;2;8
292;21.09.2018;2018;09;23;Perjantai;12;5;17;6;1;7
292;22.09.2018;2018;09;00;Lauantai;1;4;5;0;3;3
292;22.09.2018;2018;09;01;Lauantai;2;5;7;2;1;3
292;22.09.2018;2018;09;02;Lauantai;1;4;5;4;1;5
292;22.09.2018;2018;09;03;Lauantai;0;0;0;0;3;3
292;22.09.2018;2018;09;04;Lauantai;0;0;0;0;0;0
292;22.09.2018;2018;09;05;Lauantai;1;1;2;3;1;4
292;22.09.2018;2018;09;06;Lauantai;2;4;6;0;6;6
292;22.09.2018;2018;09;07;Lauantai;2;2;4;2;2;4
292;22.09.2018;2018;09;08;Lauantai;3;2;5;3;8;11
292;22.09.2018;2018;09;09;Lauantai;3;2;5;1;1;2
292;22.09.2018;2018;09;10;Lauantai;6;4;10;4;2;6
292;22.09.2018;2018;09;11;Lauantai;8;9;17;2;10;12
292;22.09.2018;2018;09;12;Lauantai;19;13;32;6;10;16
292;22.09.2018;2018;09;13;Lauantai;21;9;30;6;2;8
292;22.09.2018;2018;09;14;Lauantai;23;15;38;9;14;23
292;22.09.2018;2018;09;15;Lauantai;34;18;52;11;10;21
292;22.09.2018;2018;09;16;Lauantai;12;11;23;10;11;21
292;22.09.2018;2018;09;17;Lauantai;18;11;29;11;9;20
292;22.09.2018;2018;09;18;Lauantai;26;16;42;12;10;22
292;22.09.2018;2018;09;19;Lauantai;11;9;20;4;8;12
292;22.09.2018;2018;09;20;Lauantai;13;14;27;7;7;14
292;22.09.2018;2018;09;21;Lauantai;5;6;11;3;5;8
292;22.09.2018;2018;09;22;Lauantai;9;3;12;4;2;6
292;22.09.2018;2018;09;23;Lauantai;4;3;7;2;0;2
292;23.09.2018;2018;09;00;Sunnuntai;3;2;5;5;2;7
292;23.09.2018;2018;09;01;Sunnuntai;3;2;5;5;1;6
292;23.09.2018;2018;09;02;Sunnuntai;0;1;1;0;5;5
292;23.09.2018;2018;09;03;Sunnuntai;0;0;0;0;0;0
292;23.09.2018;2018;09;04;Sunnuntai;0;2;2;0;2;2
292;23.09.2018;2018;09;05;Sunnuntai;2;1;3;1;0;1
292;23.09.2018;2018;09;06;Sunnuntai;5;0;5;0;3;3
292;23.09.2018;2018;09;07;Sunnuntai;4;1;5;3;3;6
292;23.09.2018;2018;09;08;Sunnuntai;6;5;11;4;8;12
292;23.09.2018;2018;09;09;Sunnuntai;9;7;16;2;6;8
292;23.09.2018;2018;09;10;Sunnuntai;18;20;38;8;9;17
292;23.09.2018;2018;09;11;Sunnuntai;16;21;37;14;19;33
292;23.09.2018;2018;09;12;Sunnuntai;23;18;41;10;17;27
292;23.09.2018;2018;09;13;Sunnuntai;33;23;56;6;10;16
292;23.09.2018;2018;09;14;Sunnuntai;19;24;43;11;20;31
292;23.09.2018;2018;09;15;Sunnuntai;53;20;73;20;20;40
292;23.09.2018;2018;09;16;Sunnuntai;25;21;46;11;23;34
292;23.09.2018;2018;09;17;Sunnuntai;28;18;46;11;27;38
292;23.09.2018;2018;09;18;Sunnuntai;28;26;54;18;27;45
292;23.09.2018;2018;09;19;Sunnuntai;21;13;34;12;17;29
292;23.09.2018;2018;09;20;Sunnuntai;11;0;11;13;10;23
292;23.09.2018;2018;09;21;Sunnuntai;5;1;6;6;6;12
292;23.09.2018;2018;09;22;Sunnuntai;3;3;6;2;2;4
292;23.09.2018;2018;09;23;Sunnuntai;0;2;2;2;0;2
292;24.09.2018;2018;09;00;Maanantai;0;2;2;0;0;0
292;24.09.2018;2018;09;01;Maanantai;0;0;0;0;0;0
292;24.09.2018;2018;09;02;Maanantai;0;0;0;0;0;0
292;24.09.2018;2018;09;03;Maanantai;0;0;0;0;0;0
292;24.09.2018;2018;09;04;Maanantai;1;1;2;0;0;0
292;24.09.2018;2018;09;05;Maanantai;6;5;11;0;2;2
292;24.09.2018;2018;09;06;Maanantai;25;16;41;2;4;6
292;24.09.2018;2018;09;07;Maanantai;92;32;124;6;8;14
292;24.09.2018;2018;09;08;Maanantai;49;32;81;3;13;16
292;24.09.2018;2018;09;09;Maanantai;32;30;62;6;14;20
292;24.09.2018;2018;09;10;Maanantai;31;33;64;8;8;16
292;24.09.2018;2018;09;11;Maanantai;25;30;55;6;10;16
292;24.09.2018;2018;09;12;Maanantai;30;24;54;7;13;20
292;24.09.2018;2018;09;13;Maanantai;46;49;95;14;13;27
292;24.09.2018;2018;09;14;Maanantai;44;38;82;9;28;37
292;24.09.2018;2018;09;15;Maanantai;48;48;96;15;25;40
292;24.09.2018;2018;09;16;Maanantai;34;33;67;7;21;28
292;24.09.2018;2018;09;17;Maanantai;35;21;56;11;22;33
292;24.09.2018;2018;09;18;Maanantai;32;18;50;8;13;21
292;24.09.2018;2018;09;19;Maanantai;18;16;34;11;15;26
292;24.09.2018;2018;09;20;Maanantai;15;6;21;9;6;15
292;24.09.2018;2018;09;21;Maanantai;10;4;14;2;2;4
292;24.09.2018;2018;09;22;Maanantai;2;2;4;1;1;2
292;24.09.2018;2018;09;23;Maanantai;0;0;0;2;1;3
292;25.09.2018;2018;09;00;Tiistai;0;0;0;2;0;2
292;25.09.2018;2018;09;01;Tiistai;0;0;0;0;0;0
292;25.09.2018;2018;09;02;Tiistai;0;0;0;0;0;0
292;25.09.2018;2018;09;03;Tiistai;1;0;1;0;0;0
292;25.09.2018;2018;09;04;Tiistai;0;0;0;0;0;0
292;25.09.2018;2018;09;05;Tiistai;8;0;8;6;0;6
292;25.09.2018;2018;09;06;Tiistai;32;0;32;18;0;18
292;25.09.2018;2018;09;07;Tiistai;89;0;89;22;0;22
292;25.09.2018;2018;09;08;Tiistai;86;0;86;24;0;24
292;25.09.2018;2018;09;09;Tiistai;37;0;37;6;0;6
292;25.09.2018;2018;09;10;Tiistai;48;0;48;12;0;12
292;25.09.2018;2018;09;11;Tiistai;50;0;50;37;0;37
292;25.09.2018;2018;09;12;Tiistai;50;0;50;19;0;19
292;25.09.2018;2018;09;13;Tiistai;73;0;73;43;0;43
292;25.09.2018;2018;09;14;Tiistai;106;0;106;73;0;73
292;25.09.2018;2018;09;15;Tiistai;78;0;78;41;0;41
292;25.09.2018;2018;09;16;Tiistai;103;0;103;44;0;44
292;25.09.2018;2018;09;17;Tiistai;90;0;90;52;0;52
292;25.09.2018;2018;09;18;Tiistai;70;0;70;55;0;55
292;25.09.2018;2018;09;19;Tiistai;62;0;62;47;0;47
292;25.09.2018;2018;09;20;Tiistai;43;0;43;23;0;23
292;25.09.2018;2018;09;21;Tiistai;18;0;18;11;0;11
292;25.09.2018;2018;09;22;Tiistai;12;0;12;5;0;5
292;25.09.2018;2018;09;23;Tiistai;1;0;1;1;0;1
292;26.09.2018;2018;09;00;Keskiviikko;0;0;0;0;0;0
292;26.09.2018;2018;09;01;Keskiviikko;0;1;1;0;0;0
292;26.09.2018;2018;09;02;Keskiviikko;0;0;0;0;0;0
292;26.09.2018;2018;09;03;Keskiviikko;0;0;0;0;0;0
292;26.09.2018;2018;09;04;Keskiviikko;1;0;1;0;0;0
292;26.09.2018;2018;09;05;Keskiviikko;5;3;8;0;2;2
292;26.09.2018;2018;09;06;Keskiviikko;17;6;23;2;12;14
292;26.09.2018;2018;09;07;Keskiviikko;79;23;102;10;8;18
292;26.09.2018;2018;09;08;Keskiviikko;48;20;68;15;12;27
292;26.09.2018;2018;09;09;Keskiviikko;16;9;25;5;11;16
292;26.09.2018;2018;09;10;Keskiviikko;13;29;42;9;8;17
292;26.09.2018;2018;09;11;Keskiviikko;18;23;41;2;8;10
292;26.09.2018;2018;09;12;Keskiviikko;12;11;23;3;4;7
292;26.09.2018;2018;09;13;Keskiviikko;16;16;32;5;5;10
292;26.09.2018;2018;09;14;Keskiviikko;19;16;35;6;6;12
292;26.09.2018;2018;09;15;Keskiviikko;21;23;44;6;7;13
292;26.09.2018;2018;09;16;Keskiviikko;17;17;34;1;0;1
292;26.09.2018;2018;09;17;Keskiviikko;16;13;29;4;5;9
292;26.09.2018;2018;09;18;Keskiviikko;15;15;30;10;21;31
292;26.09.2018;2018;09;19;Keskiviikko;22;16;38;8;11;19
292;26.09.2018;2018;09;20;Keskiviikko;17;14;31;3;6;9
292;26.09.2018;2018;09;21;Keskiviikko;4;4;8;2;3;5
292;26.09.2018;2018;09;22;Keskiviikko;2;3;5;2;1;3
292;26.09.2018;2018;09;23;Keskiviikko;0;1;1;0;0;0
292;27.09.2018;2018;09;00;Torstai;0;0;0;0;0;0
292;27.09.2018;2018;09;01;Torstai;0;0;0;0;0;0
292;27.09.2018;2018;09;02;Torstai;0;0;0;0;0;0
292;27.09.2018;2018;09;03;Torstai;0;0;0;0;0;0
292;27.09.2018;2018;09;04;Torstai;1;1;2;0;0;0
292;27.09.2018;2018;09;05;Torstai;4;3;7;1;1;2
292;27.09.2018;2018;09;06;Torstai;16;11;27;1;4;5
292;27.09.2018;2018;09;07;Torstai;58;26;84;10;4;14
292;27.09.2018;2018;09;08;Torstai;25;17;42;4;9;13
292;27.09.2018;2018;09;09;Torstai;11;9;20;6;6;12
292;27.09.2018;2018;09;10;Torstai;20;23;43;7;9;16
292;27.09.2018;2018;09;11;Torstai;10;15;25;1;10;11
292;27.09.2018;2018;09;12;Torstai;14;18;32;7;7;14
292;27.09.2018;2018;09;13;Torstai;38;43;81;8;14;22
292;27.09.2018;2018;09;14;Torstai;32;33;65;12;5;17
292;27.09.2018;2018;09;15;Torstai;34;30;64;8;11;19
292;27.09.2018;2018;09;16;Torstai;34;24;58;13;11;24
292;27.09.2018;2018;09;17;Torstai;28;29;57;14;13;27
292;27.09.2018;2018;09;18;Torstai;32;15;47;18;17;35
292;27.09.2018;2018;09;19;Torstai;20;12;32;11;15;26
292;27.09.2018;2018;09;20;Torstai;20;10;30;11;16;27
292;27.09.2018;2018;09;21;Torstai;6;4;10;5;4;9
292;27.09.2018;2018;09;22;Torstai;3;3;6;1;3;4
292;27.09.2018;2018;09;23;Torstai;2;0;2;1;0;1
292;28.09.2018;2018;09;00;Perjantai;0;0;0;0;0;0
292;28.09.2018;2018;09;01;Perjantai;0;0;0;0;1;1
292;28.09.2018;2018;09;02;Perjantai;1;0;1;0;0;0
292;28.09.2018;2018;09;03;Perjantai;0;1;1;1;2;3
292;28.09.2018;2018;09;04;Perjantai;1;0;1;0;0;0
292;28.09.2018;2018;09;05;Perjantai;4;5;9;2;1;3
292;28.09.2018;2018;09;06;Perjantai;12;8;20;5;11;16
292;28.09.2018;2018;09;07;Perjantai;76;21;97;13;5;18
292;28.09.2018;2018;09;08;Perjantai;49;31;80;8;17;25
292;28.09.2018;2018;09;09;Perjantai;25;37;62;2;10;12
292;28.09.2018;2018;09;10;Perjantai;49;43;92;9;16;25
292;28.09.2018;2018;09;11;Perjantai;60;30;90;7;24;31
292;28.09.2018;2018;09;12;Perjantai;28;42;70;8;28;36
292;28.09.2018;2018;09;13;Perjantai;29;44;73;8;34;42
292;28.09.2018;2018;09;14;Perjantai;32;38;70;22;25;47
292;28.09.2018;2018;09;15;Perjantai;41;32;73;11;27;38
292;28.09.2018;2018;09;16;Perjantai;42;24;66;16;22;38
292;28.09.2018;2018;09;17;Perjantai;37;21;58;14;20;34
292;28.09.2018;2018;09;18;Perjantai;40;18;58;11;26;37
292;28.09.2018;2018;09;19;Perjantai;17;22;39;5;13;18
292;28.09.2018;2018;09;20;Perjantai;15;8;23;7;6;13
292;28.09.2018;2018;09;21;Perjantai;4;8;12;6;4;10
292;28.09.2018;2018;09;22;Perjantai;5;4;9;7;3;10
292;28.09.2018;2018;09;23;Perjantai;2;4;6;2;1;3
292;29.09.2018;2018;09;00;Lauantai;3;2;5;3;2;5
292;29.09.2018;2018;09;01;Lauantai;2;0;2;1;0;1
292;29.09.2018;2018;09;02;Lauantai;0;1;1;0;4;4
292;29.09.2018;2018;09;03;Lauantai;0;1;1;0;2;2
292;29.09.2018;2018;09;04;Lauantai;1;0;1;0;1;1
292;29.09.2018;2018;09;05;Lauantai;1;2;3;1;2;3
292;29.09.2018;2018;09;06;Lauantai;6;1;7;1;3;4
292;29.09.2018;2018;09;07;Lauantai;3;3;6;5;3;8
292;29.09.2018;2018;09;08;Lauantai;28;17;45;4;5;9
292;29.09.2018;2018;09;09;Lauantai;18;10;28;10;6;16
292;29.09.2018;2018;09;10;Lauantai;16;13;29;5;17;22
292;29.09.2018;2018;09;11;Lauantai;13;18;31;11;10;21
292;29.09.2018;2018;09;12;Lauantai;28;13;41;7;11;18
292;29.09.2018;2018;09;13;Lauantai;24;44;68;13;12;25
292;29.09.2018;2018;09;14;Lauantai;22;28;50;7;17;24
292;29.09.2018;2018;09;15;Lauantai;33;29;62;10;15;25
292;29.09.2018;2018;09;16;Lauantai;25;34;59;16;7;23
292;29.09.2018;2018;09;17;Lauantai;21;19;40;9;10;19
292;29.09.2018;2018;09;18;Lauantai;24;13;37;7;4;11
292;29.09.2018;2018;09;19;Lauantai;20;22;42;13;13;26
292;29.09.2018;2018;09;20;Lauantai;8;4;12;2;5;7
292;29.09.2018;2018;09;21;Lauantai;10;7;17;7;3;10
292;29.09.2018;2018;09;22;Lauantai;7;9;16;1;5;6
292;29.09.2018;2018;09;23;Lauantai;2;2;4;0;1;1
292;30.09.2018;2018;09;00;Sunnuntai;2;2;4;4;2;6
292;30.09.2018;2018;09;01;Sunnuntai;2;3;5;2;4;6
292;30.09.2018;2018;09;02;Sunnuntai;0;3;3;0;0;0
292;30.09.2018;2018;09;03;Sunnuntai;3;3;6;0;1;1
292;30.09.2018;2018;09;04;Sunnuntai;0;0;0;1;1;2
292;30.09.2018;2018;09;05;Sunnuntai;0;0;0;0;0;0
292;30.09.2018;2018;09;06;Sunnuntai;5;2;7;1;1;2
292;30.09.2018;2018;09;07;Sunnuntai;0;1;1;2;2;4
292;30.09.2018;2018;09;08;Sunnuntai;5;6;11;4;4;8
292;30.09.2018;2018;09;09;Sunnuntai;9;7;16;7;9;16
292;30.09.2018;2018;09;10;Sunnuntai;14;15;29;4;8;12
292;30.09.2018;2018;09;11;Sunnuntai;10;10;20;6;8;14
292;30.09.2018;2018;09;12;Sunnuntai;19;17;36;8;12;20
292;30.09.2018;2018;09;13;Sunnuntai;23;19;42;7;18;25
292;30.09.2018;2018;09;14;Sunnuntai;31;29;60;13;18;31
292;30.09.2018;2018;09;15;Sunnuntai;36;19;55;17;6;23
292;30.09.2018;2018;09;16;Sunnuntai;38;19;57;18;20;38
292;30.09.2018;2018;09;17;Sunnuntai;29;26;55;13;14;27
292;30.09.2018;2018;09;18;Sunnuntai;28;20;48;18;31;49
292;30.09.2018;2018;09;19;Sunnuntai;26;14;40;14;15;29
292;30.09.2018;2018;09;20;Sunnuntai;6;9;15;6;9;15
292;30.09.2018;2018;09;21;Sunnuntai;10;2;12;7;5;12
292;30.09.2018;2018;09;22;Sunnuntai;3;2;5;1;3;4
292;30.09.2018;2018;09;23;Sunnuntai;0;0;0;1;0;1