MittausID;Pvm;Vuosi;Kuukausi;Tunti;Viikonpäivä;PP_1;PP_2;PP_YHT
95;30.06.2014;2014;06;00;Maanantai;0;1;1
95;30.06.2014;2014;06;01;Maanantai;0;0;0
95;30.06.2014;2014;06;02;Maanantai;0;0;0
95;30.06.2014;2014;06;03;Maanantai;1;1;2
95;30.06.2014;2014;06;04;Maanantai;3;1;4
95;30.06.2014;2014;06;05;Maanantai;7;2;9
95;30.06.2014;2014;06;06;Maanantai;23;15;38
95;30.06.2014;2014;06;07;Maanantai;30;14;44
95;30.06.2014;2014;06;08;Maanantai;18;6;24
95;30.06.2014;2014;06;09;Maanantai;15;9;24
95;30.06.2014;2014;06;10;Maanantai;12;16;28
95;30.06.2014;2014;06;11;Maanantai;16;10;26
95;30.06.2014;2014;06;12;Maanantai;20;16;36
95;30.06.2014;2014;06;13;Maanantai;13;13;26
95;30.06.2014;2014;06;14;Maanantai;11;15;26
95;30.06.2014;2014;06;15;Maanantai;26;23;49
95;30.06.2014;2014;06;16;Maanantai;27;37;64
95;30.06.2014;2014;06;17;Maanantai;14;20;34
95;30.06.2014;2014;06;18;Maanantai;29;18;47
95;30.06.2014;2014;06;19;Maanantai;13;16;29
95;30.06.2014;2014;06;20;Maanantai;7;13;20
95;30.06.2014;2014;06;21;Maanantai;11;10;21
95;30.06.2014;2014;06;22;Maanantai;4;4;8
95;30.06.2014;2014;06;23;Maanantai;0;5;5
95;01.07.2014;2014;07;00;Tiistai;0;0;0
95;01.07.2014;2014;07;01;Tiistai;0;0;0
95;01.07.2014;2014;07;02;Tiistai;0;0;0
95;01.07.2014;2014;07;03;Tiistai;1;0;1
95;01.07.2014;2014;07;04;Tiistai;2;0;2
95;01.07.2014;2014;07;05;Tiistai;15;6;21
95;01.07.2014;2014;07;06;Tiistai;27;12;39
95;01.07.2014;2014;07;07;Tiistai;35;26;61
95;01.07.2014;2014;07;08;Tiistai;26;12;38
95;01.07.2014;2014;07;09;Tiistai;13;14;27
95;01.07.2014;2014;07;10;Tiistai;22;14;36
95;01.07.2014;2014;07;11;Tiistai;30;23;53
95;01.07.2014;2014;07;12;Tiistai;15;16;31
95;01.07.2014;2014;07;13;Tiistai;24;28;52
95;01.07.2014;2014;07;14;Tiistai;31;20;51
95;01.07.2014;2014;07;15;Tiistai;42;41;83
95;01.07.2014;2014;07;16;Tiistai;30;59;89
95;01.07.2014;2014;07;17;Tiistai;26;46;72
95;01.07.2014;2014;07;18;Tiistai;27;35;62
95;01.07.2014;2014;07;19;Tiistai;29;35;64
95;01.07.2014;2014;07;20;Tiistai;18;31;49
95;01.07.2014;2014;07;21;Tiistai;7;5;12
95;01.07.2014;2014;07;22;Tiistai;2;2;4
95;01.07.2014;2014;07;23;Tiistai;2;3;5
95;02.07.2014;2014;07;00;Keskiviikko;0;1;1
95;02.07.2014;2014;07;01;Keskiviikko;0;1;1
95;02.07.2014;2014;07;02;Keskiviikko;0;0;0
95;02.07.2014;2014;07;03;Keskiviikko;1;1;2
95;02.07.2014;2014;07;04;Keskiviikko;2;0;2
95;02.07.2014;2014;07;05;Keskiviikko;8;5;13
95;02.07.2014;2014;07;06;Keskiviikko;15;12;27
95;02.07.2014;2014;07;07;Keskiviikko;18;13;31
95;02.07.2014;2014;07;08;Keskiviikko;6;5;11
95;02.07.2014;2014;07;09;Keskiviikko;2;1;3
95;02.07.2014;2014;07;10;Keskiviikko;1;2;3
95;02.07.2014;2014;07;11;Keskiviikko;1;3;4
95;02.07.2014;2014;07;12;Keskiviikko;5;1;6
95;02.07.2014;2014;07;13;Keskiviikko;2;1;3
95;02.07.2014;2014;07;14;Keskiviikko;3;1;4
95;02.07.2014;2014;07;15;Keskiviikko;4;9;13
95;02.07.2014;2014;07;16;Keskiviikko;13;13;26
95;02.07.2014;2014;07;17;Keskiviikko;2;4;6
95;02.07.2014;2014;07;18;Keskiviikko;5;5;10
95;02.07.2014;2014;07;19;Keskiviikko;4;12;16
95;02.07.2014;2014;07;20;Keskiviikko;6;8;14
95;02.07.2014;2014;07;21;Keskiviikko;6;6;12
95;02.07.2014;2014;07;22;Keskiviikko;2;4;6
95;02.07.2014;2014;07;23;Keskiviikko;0;1;1
95;03.07.2014;2014;07;00;Torstai;0;0;0
95;03.07.2014;2014;07;01;Torstai;0;0;0
95;03.07.2014;2014;07;02;Torstai;1;0;1
95;03.07.2014;2014;07;03;Torstai;0;0;0
95;03.07.2014;2014;07;04;Torstai;1;0;1
95;03.07.2014;2014;07;05;Torstai;7;2;9
95;03.07.2014;2014;07;06;Torstai;16;11;27
95;03.07.2014;2014;07;07;Torstai;13;15;28
95;03.07.2014;2014;07;08;Torstai;14;6;20
95;03.07.2014;2014;07;09;Torstai;6;14;20
95;03.07.2014;2014;07;10;Torstai;3;3;6
95;03.07.2014;2014;07;11;Torstai;5;4;9
95;03.07.2014;2014;07;12;Torstai;11;7;18
95;03.07.2014;2014;07;13;Torstai;11;3;14
95;03.07.2014;2014;07;14;Torstai;19;11;30
95;03.07.2014;2014;07;15;Torstai;12;19;31
95;03.07.2014;2014;07;16;Torstai;19;14;33
95;03.07.2014;2014;07;17;Torstai;8;22;30
95;03.07.2014;2014;07;18;Torstai;5;19;24
95;03.07.2014;2014;07;19;Torstai;14;8;22
95;03.07.2014;2014;07;20;Torstai;17;20;37
95;03.07.2014;2014;07;21;Torstai;6;7;13
95;03.07.2014;2014;07;22;Torstai;3;1;4
95;03.07.2014;2014;07;23;Torstai;1;2;3
95;04.07.2014;2014;07;00;Perjantai;0;0;0
95;04.07.2014;2014;07;01;Perjantai;0;0;0
95;04.07.2014;2014;07;02;Perjantai;0;2;2
95;04.07.2014;2014;07;03;Perjantai;1;0;1
95;04.07.2014;2014;07;04;Perjantai;1;0;1
95;04.07.2014;2014;07;05;Perjantai;8;3;11
95;04.07.2014;2014;07;06;Perjantai;10;9;19
95;04.07.2014;2014;07;07;Perjantai;25;14;39
95;04.07.2014;2014;07;08;Perjantai;12;8;20
95;04.07.2014;2014;07;09;Perjantai;5;4;9
95;04.07.2014;2014;07;10;Perjantai;20;9;29
95;04.07.2014;2014;07;11;Perjantai;15;13;28
95;04.07.2014;2014;07;12;Perjantai;15;15;30
95;04.07.2014;2014;07;13;Perjantai;14;13;27
95;04.07.2014;2014;07;14;Perjantai;26;27;53
95;04.07.2014;2014;07;15;Perjantai;21;12;33
95;04.07.2014;2014;07;16;Perjantai;13;21;34
95;04.07.2014;2014;07;17;Perjantai;13;16;29
95;04.07.2014;2014;07;18;Perjantai;5;9;14
95;04.07.2014;2014;07;19;Perjantai;5;8;13
95;04.07.2014;2014;07;20;Perjantai;4;2;6
95;04.07.2014;2014;07;21;Perjantai;7;6;13
95;04.07.2014;2014;07;22;Perjantai;0;2;2
95;04.07.2014;2014;07;23;Perjantai;1;2;3
95;05.07.2014;2014;07;00;Lauantai;0;1;1
95;05.07.2014;2014;07;01;Lauantai;0;1;1
95;05.07.2014;2014;07;02;Lauantai;0;1;1
95;05.07.2014;2014;07;03;Lauantai;0;1;1
95;05.07.2014;2014;07;04;Lauantai;1;0;1
95;05.07.2014;2014;07;05;Lauantai;2;3;5
95;05.07.2014;2014;07;06;Lauantai;2;1;3
95;05.07.2014;2014;07;07;Lauantai;2;5;7
95;05.07.2014;2014;07;08;Lauantai;5;4;9
95;05.07.2014;2014;07;09;Lauantai;15;7;22
95;05.07.2014;2014;07;10;Lauantai;14;11;25
95;05.07.2014;2014;07;11;Lauantai;20;22;42
95;05.07.2014;2014;07;12;Lauantai;34;14;48
95;05.07.2014;2014;07;13;Lauantai;30;33;63
95;05.07.2014;2014;07;14;Lauantai;35;26;61
95;05.07.2014;2014;07;15;Lauantai;17;20;37
95;05.07.2014;2014;07;16;Lauantai;23;23;46
95;05.07.2014;2014;07;17;Lauantai;14;24;38
95;05.07.2014;2014;07;18;Lauantai;22;18;40
95;05.07.2014;2014;07;19;Lauantai;11;15;26
95;05.07.2014;2014;07;20;Lauantai;19;9;28
95;05.07.2014;2014;07;21;Lauantai;8;3;11
95;05.07.2014;2014;07;22;Lauantai;2;8;10
95;05.07.2014;2014;07;23;Lauantai;3;1;4
95;06.07.2014;2014;07;00;Sunnuntai;0;3;3
95;06.07.2014;2014;07;01;Sunnuntai;0;1;1
95;06.07.2014;2014;07;02;Sunnuntai;0;3;3
95;06.07.2014;2014;07;03;Sunnuntai;3;1;4
95;06.07.2014;2014;07;04;Sunnuntai;1;3;4
95;06.07.2014;2014;07;05;Sunnuntai;2;1;3
95;06.07.2014;2014;07;06;Sunnuntai;3;1;4
95;06.07.2014;2014;07;07;Sunnuntai;4;2;6
95;06.07.2014;2014;07;08;Sunnuntai;14;5;19
95;06.07.2014;2014;07;09;Sunnuntai;17;15;32
95;06.07.2014;2014;07;10;Sunnuntai;26;34;60
95;06.07.2014;2014;07;11;Sunnuntai;38;30;68
95;06.07.2014;2014;07;12;Sunnuntai;24;41;65
95;06.07.2014;2014;07;13;Sunnuntai;26;27;53
95;06.07.2014;2014;07;14;Sunnuntai;31;27;58
95;06.07.2014;2014;07;15;Sunnuntai;22;27;49
95;06.07.2014;2014;07;16;Sunnuntai;27;21;48
95;06.07.2014;2014;07;17;Sunnuntai;17;29;46
95;06.07.2014;2014;07;18;Sunnuntai;26;26;52
95;06.07.2014;2014;07;19;Sunnuntai;35;34;69
95;06.07.2014;2014;07;20;Sunnuntai;11;18;29
95;06.07.2014;2014;07;21;Sunnuntai;14;12;26
95;06.07.2014;2014;07;22;Sunnuntai;1;3;4
95;06.07.2014;2014;07;23;Sunnuntai;0;4;4
95;07.07.2014;2014;07;00;Maanantai;0;3;3
95;07.07.2014;2014;07;01;Maanantai;1;2;3
95;07.07.2014;2014;07;02;Maanantai;0;0;0
95;07.07.2014;2014;07;03;Maanantai;0;1;1
95;07.07.2014;2014;07;04;Maanantai;1;2;3
95;07.07.2014;2014;07;05;Maanantai;14;1;15
95;07.07.2014;2014;07;06;Maanantai;30;18;48
95;07.07.2014;2014;07;07;Maanantai;39;24;63
95;07.07.2014;2014;07;08;Maanantai;19;14;33
95;07.07.2014;2014;07;09;Maanantai;29;10;39
95;07.07.2014;2014;07;10;Maanantai;25;17;42
95;07.07.2014;2014;07;11;Maanantai;23;23;46
95;07.07.2014;2014;07;12;Maanantai;22;28;50
95;07.07.2014;2014;07;13;Maanantai;35;34;69
95;07.07.2014;2014;07;14;Maanantai;31;30;61
95;07.07.2014;2014;07;15;Maanantai;38;38;76
95;07.07.2014;2014;07;16;Maanantai;49;56;105
95;07.07.2014;2014;07;17;Maanantai;42;49;91
95;07.07.2014;2014;07;18;Maanantai;18;51;69
95;07.07.2014;2014;07;19;Maanantai;35;36;71
95;07.07.2014;2014;07;20;Maanantai;15;33;48
95;07.07.2014;2014;07;21;Maanantai;22;17;39
95;07.07.2014;2014;07;22;Maanantai;3;12;15
95;07.07.2014;2014;07;23;Maanantai;1;4;5
95;08.07.2014;2014;07;00;Tiistai;2;3;5
95;08.07.2014;2014;07;01;Tiistai;1;4;5
95;08.07.2014;2014;07;02;Tiistai;0;3;3
95;08.07.2014;2014;07;03;Tiistai;0;0;0
95;08.07.2014;2014;07;04;Tiistai;1;0;1
95;08.07.2014;2014;07;05;Tiistai;15;0;15
95;08.07.2014;2014;07;06;Tiistai;32;20;52
95;08.07.2014;2014;07;07;Tiistai;32;32;64
95;08.07.2014;2014;07;08;Tiistai;30;10;40
95;08.07.2014;2014;07;09;Tiistai;28;21;49
95;08.07.2014;2014;07;10;Tiistai;33;15;48
95;08.07.2014;2014;07;11;Tiistai;30;20;50
95;08.07.2014;2014;07;12;Tiistai;29;29;58
95;08.07.2014;2014;07;13;Tiistai;30;28;58
95;08.07.2014;2014;07;14;Tiistai;29;30;59
95;08.07.2014;2014;07;15;Tiistai;38;53;91
95;08.07.2014;2014;07;16;Tiistai;44;47;91
95;08.07.2014;2014;07;17;Tiistai;32;42;74
95;08.07.2014;2014;07;18;Tiistai;37;44;81
95;08.07.2014;2014;07;19;Tiistai;21;27;48
95;08.07.2014;2014;07;20;Tiistai;13;31;44
95;08.07.2014;2014;07;21;Tiistai;12;22;34
95;08.07.2014;2014;07;22;Tiistai;9;5;14
95;08.07.2014;2014;07;23;Tiistai;2;4;6
95;09.07.2014;2014;07;00;Keskiviikko;0;6;6
95;09.07.2014;2014;07;01;Keskiviikko;1;0;1
95;09.07.2014;2014;07;02;Keskiviikko;0;1;1
95;09.07.2014;2014;07;03;Keskiviikko;0;3;3
95;09.07.2014;2014;07;04;Keskiviikko;2;0;2
95;09.07.2014;2014;07;05;Keskiviikko;12;1;13
95;09.07.2014;2014;07;06;Keskiviikko;21;22;43
95;09.07.2014;2014;07;07;Keskiviikko;41;26;67
95;09.07.2014;2014;07;08;Keskiviikko;26;14;40
95;09.07.2014;2014;07;09;Keskiviikko;19;17;36
95;09.07.2014;2014;07;10;Keskiviikko;24;23;47
95;09.07.2014;2014;07;11;Keskiviikko;23;27;50
95;09.07.2014;2014;07;12;Keskiviikko;19;18;37
95;09.07.2014;2014;07;13;Keskiviikko;38;22;60
95;09.07.2014;2014;07;14;Keskiviikko;22;36;58
95;09.07.2014;2014;07;15;Keskiviikko;36;54;90
95;09.07.2014;2014;07;16;Keskiviikko;32;57;89
95;09.07.2014;2014;07;17;Keskiviikko;32;29;61
95;09.07.2014;2014;07;18;Keskiviikko;19;39;58
95;09.07.2014;2014;07;19;Keskiviikko;23;21;44
95;09.07.2014;2014;07;20;Keskiviikko;27;26;53
95;09.07.2014;2014;07;21;Keskiviikko;14;14;28
95;09.07.2014;2014;07;22;Keskiviikko;5;11;16
95;09.07.2014;2014;07;23;Keskiviikko;0;5;5
95;10.07.2014;2014;07;00;Torstai;2;3;5
95;10.07.2014;2014;07;01;Torstai;2;6;8
95;10.07.2014;2014;07;02;Torstai;0;2;2
95;10.07.2014;2014;07;03;Torstai;1;0;1
95;10.07.2014;2014;07;04;Torstai;3;0;3
95;10.07.2014;2014;07;05;Torstai;11;2;13
95;10.07.2014;2014;07;06;Torstai;19;17;36
95;10.07.2014;2014;07;07;Torstai;31;18;49
95;10.07.2014;2014;07;08;Torstai;17;8;25
95;10.07.2014;2014;07;09;Torstai;7;18;25
95;10.07.2014;2014;07;10;Torstai;23;8;31
95;10.07.2014;2014;07;11;Torstai;27;12;39
95;10.07.2014;2014;07;12;Torstai;23;21;44
95;10.07.2014;2014;07;13;Torstai;18;15;33
95;10.07.2014;2014;07;14;Torstai;21;22;43
95;10.07.2014;2014;07;15;Torstai;34;28;62
95;10.07.2014;2014;07;16;Torstai;36;47;83
95;10.07.2014;2014;07;17;Torstai;26;27;53
95;10.07.2014;2014;07;18;Torstai;29;35;64
95;10.07.2014;2014;07;19;Torstai;26;27;53
95;10.07.2014;2014;07;20;Torstai;20;28;48
95;10.07.2014;2014;07;21;Torstai;8;15;23
95;10.07.2014;2014;07;22;Torstai;3;8;11
95;10.07.2014;2014;07;23;Torstai;2;3;5
95;11.07.2014;2014;07;00;Perjantai;1;1;2
95;11.07.2014;2014;07;01;Perjantai;0;2;2
95;11.07.2014;2014;07;02;Perjantai;0;0;0
95;11.07.2014;2014;07;03;Perjantai;0;0;0
95;11.07.2014;2014;07;04;Perjantai;2;1;3
95;11.07.2014;2014;07;05;Perjantai;11;0;11
95;11.07.2014;2014;07;06;Perjantai;23;13;36
95;11.07.2014;2014;07;07;Perjantai;28;20;48
95;11.07.2014;2014;07;08;Perjantai;21;6;27
95;11.07.2014;2014;07;09;Perjantai;20;17;37
95;11.07.2014;2014;07;10;Perjantai;27;20;47
95;11.07.2014;2014;07;11;Perjantai;20;23;43
95;11.07.2014;2014;07;12;Perjantai;24;15;39
95;11.07.2014;2014;07;13;Perjantai;22;22;44
95;11.07.2014;2014;07;14;Perjantai;29;31;60
95;11.07.2014;2014;07;15;Perjantai;33;49;82
95;11.07.2014;2014;07;16;Perjantai;39;21;60
95;11.07.2014;2014;07;17;Perjantai;25;36;61
95;11.07.2014;2014;07;18;Perjantai;22;26;48
95;11.07.2014;2014;07;19;Perjantai;20;20;40
95;11.07.2014;2014;07;20;Perjantai;25;20;45
95;11.07.2014;2014;07;21;Perjantai;11;12;23
95;11.07.2014;2014;07;22;Perjantai;7;8;15
95;11.07.2014;2014;07;23;Perjantai;0;14;14
95;12.07.2014;2014;07;00;Lauantai;1;7;8
95;12.07.2014;2014;07;01;Lauantai;0;2;2
95;12.07.2014;2014;07;02;Lauantai;0;6;6
95;12.07.2014;2014;07;03;Lauantai;0;4;4
95;12.07.2014;2014;07;04;Lauantai;2;1;3
95;12.07.2014;2014;07;05;Lauantai;2;0;2
95;12.07.2014;2014;07;06;Lauantai;1;5;6
95;12.07.2014;2014;07;07;Lauantai;7;6;13
95;12.07.2014;2014;07;08;Lauantai;10;10;20
95;12.07.2014;2014;07;09;Lauantai;18;17;35
95;12.07.2014;2014;07;10;Lauantai;10;18;28
95;12.07.2014;2014;07;11;Lauantai;29;24;53
95;12.07.2014;2014;07;12;Lauantai;29;26;55
95;12.07.2014;2014;07;13;Lauantai;19;26;45
95;12.07.2014;2014;07;14;Lauantai;25;32;57
95;12.07.2014;2014;07;15;Lauantai;29;29;58
95;12.07.2014;2014;07;16;Lauantai;22;25;47
95;12.07.2014;2014;07;17;Lauantai;12;14;26
95;12.07.2014;2014;07;18;Lauantai;24;20;44
95;12.07.2014;2014;07;19;Lauantai;28;17;45
95;12.07.2014;2014;07;20;Lauantai;9;17;26
95;12.07.2014;2014;07;21;Lauantai;16;13;29
95;12.07.2014;2014;07;22;Lauantai;1;5;6
95;12.07.2014;2014;07;23;Lauantai;3;8;11
95;13.07.2014;2014;07;00;Sunnuntai;1;2;3
95;13.07.2014;2014;07;01;Sunnuntai;2;3;5
95;13.07.2014;2014;07;02;Sunnuntai;0;7;7
95;13.07.2014;2014;07;03;Sunnuntai;0;3;3
95;13.07.2014;2014;07;04;Sunnuntai;0;1;1
95;13.07.2014;2014;07;05;Sunnuntai;2;3;5
95;13.07.2014;2014;07;06;Sunnuntai;1;3;4
95;13.07.2014;2014;07;07;Sunnuntai;5;4;9
95;13.07.2014;2014;07;08;Sunnuntai;4;7;11
95;13.07.2014;2014;07;09;Sunnuntai;10;14;24
95;13.07.2014;2014;07;10;Sunnuntai;18;16;34
95;13.07.2014;2014;07;11;Sunnuntai;34;26;60
95;13.07.2014;2014;07;12;Sunnuntai;34;28;62
95;13.07.2014;2014;07;13;Sunnuntai;27;24;51
95;13.07.2014;2014;07;14;Sunnuntai;20;25;45
95;13.07.2014;2014;07;15;Sunnuntai;28;33;61
95;13.07.2014;2014;07;16;Sunnuntai;17;27;44
95;13.07.2014;2014;07;17;Sunnuntai;18;22;40
95;13.07.2014;2014;07;18;Sunnuntai;34;20;54
95;13.07.2014;2014;07;19;Sunnuntai;36;23;59
95;13.07.2014;2014;07;20;Sunnuntai;28;24;52
95;13.07.2014;2014;07;21;Sunnuntai;8;15;23
95;13.07.2014;2014;07;22;Sunnuntai;2;6;8
95;13.07.2014;2014;07;23;Sunnuntai;2;0;2
95;14.07.2014;2014;07;00;Maanantai;2;0;2
95;14.07.2014;2014;07;01;Maanantai;0;1;1
95;14.07.2014;2014;07;02;Maanantai;0;0;0
95;14.07.2014;2014;07;03;Maanantai;1;0;1
95;14.07.2014;2014;07;04;Maanantai;1;0;1
95;14.07.2014;2014;07;05;Maanantai;8;2;10
95;14.07.2014;2014;07;06;Maanantai;19;14;33
95;14.07.2014;2014;07;07;Maanantai;23;23;46
95;14.07.2014;2014;07;08;Maanantai;16;17;33
95;14.07.2014;2014;07;09;Maanantai;14;17;31
95;14.07.2014;2014;07;10;Maanantai;20;11;31
95;14.07.2014;2014;07;11;Maanantai;20;29;49
95;14.07.2014;2014;07;12;Maanantai;37;19;56
95;14.07.2014;2014;07;13;Maanantai;36;31;67
95;14.07.2014;2014;07;14;Maanantai;17;20;37
95;14.07.2014;2014;07;15;Maanantai;31;44;75
95;14.07.2014;2014;07;16;Maanantai;43;34;77
95;14.07.2014;2014;07;17;Maanantai;30;37;67
95;14.07.2014;2014;07;18;Maanantai;18;28;46
95;14.07.2014;2014;07;19;Maanantai;6;9;15
95;14.07.2014;2014;07;20;Maanantai;11;18;29
95;14.07.2014;2014;07;21;Maanantai;11;10;21
95;14.07.2014;2014;07;22;Maanantai;1;4;5
95;14.07.2014;2014;07;23;Maanantai;0;3;3
95;15.07.2014;2014;07;00;Tiistai;1;0;1
95;15.07.2014;2014;07;01;Tiistai;0;2;2
95;15.07.2014;2014;07;02;Tiistai;0;0;0
95;15.07.2014;2014;07;03;Tiistai;2;0;2
95;15.07.2014;2014;07;04;Tiistai;2;0;2
95;15.07.2014;2014;07;05;Tiistai;7;5;12
95;15.07.2014;2014;07;06;Tiistai;22;12;34
95;15.07.2014;2014;07;07;Tiistai;26;16;42
95;15.07.2014;2014;07;08;Tiistai;14;3;17
95;15.07.2014;2014;07;09;Tiistai;18;11;29
95;15.07.2014;2014;07;10;Tiistai;18;16;34
95;15.07.2014;2014;07;11;Tiistai;13;19;32
95;15.07.2014;2014;07;12;Tiistai;18;28;46
95;15.07.2014;2014;07;13;Tiistai;35;20;55
95;15.07.2014;2014;07;14;Tiistai;17;36;53
95;15.07.2014;2014;07;15;Tiistai;34;36;70
95;15.07.2014;2014;07;16;Tiistai;33;33;66
95;15.07.2014;2014;07;17;Tiistai;43;35;78
95;15.07.2014;2014;07;18;Tiistai;28;44;72
95;15.07.2014;2014;07;19;Tiistai;24;33;57
95;15.07.2014;2014;07;20;Tiistai;9;11;20
95;15.07.2014;2014;07;21;Tiistai;10;13;23
95;15.07.2014;2014;07;22;Tiistai;4;1;5
95;15.07.2014;2014;07;23;Tiistai;0;1;1
95;16.07.2014;2014;07;00;Keskiviikko;0;2;2
95;16.07.2014;2014;07;01;Keskiviikko;0;2;2
95;16.07.2014;2014;07;02;Keskiviikko;0;3;3
95;16.07.2014;2014;07;03;Keskiviikko;0;0;0
95;16.07.2014;2014;07;04;Keskiviikko;4;0;4
95;16.07.2014;2014;07;05;Keskiviikko;6;1;7
95;16.07.2014;2014;07;06;Keskiviikko;24;17;41
95;16.07.2014;2014;07;07;Keskiviikko;29;16;45
95;16.07.2014;2014;07;08;Keskiviikko;17;10;27
95;16.07.2014;2014;07;09;Keskiviikko;22;12;34
95;16.07.2014;2014;07;10;Keskiviikko;25;23;48
95;16.07.2014;2014;07;11;Keskiviikko;21;26;47
95;16.07.2014;2014;07;12;Keskiviikko;20;19;39
95;16.07.2014;2014;07;13;Keskiviikko;25;21;46
95;16.07.2014;2014;07;14;Keskiviikko;10;17;27
95;16.07.2014;2014;07;15;Keskiviikko;15;24;39
95;16.07.2014;2014;07;16;Keskiviikko;28;24;52
95;16.07.2014;2014;07;17;Keskiviikko;12;25;37
95;16.07.2014;2014;07;18;Keskiviikko;15;17;32
95;16.07.2014;2014;07;19;Keskiviikko;12;11;23
95;16.07.2014;2014;07;20;Keskiviikko;13;16;29
95;16.07.2014;2014;07;21;Keskiviikko;9;10;19
95;16.07.2014;2014;07;22;Keskiviikko;4;1;5
95;16.07.2014;2014;07;23;Keskiviikko;3;4;7
95;17.07.2014;2014;07;00;Torstai;2;3;5
95;17.07.2014;2014;07;01;Torstai;2;0;2
95;17.07.2014;2014;07;02;Torstai;0;1;1
95;17.07.2014;2014;07;03;Torstai;2;1;3
95;17.07.2014;2014;07;04;Torstai;1;1;2
95;17.07.2014;2014;07;05;Torstai;7;2;9
95;17.07.2014;2014;07;06;Torstai;17;10;27
95;17.07.2014;2014;07;07;Torstai;25;13;38
95;17.07.2014;2014;07;08;Torstai;19;11;30
95;17.07.2014;2014;07;09;Torstai;20;20;40
95;17.07.2014;2014;07;10;Torstai;27;13;40
95;17.07.2014;2014;07;11;Torstai;27;14;41
95;17.07.2014;2014;07;12;Torstai;17;31;48
95;17.07.2014;2014;07;13;Torstai;22;21;43
95;17.07.2014;2014;07;14;Torstai;19;15;34
95;17.07.2014;2014;07;15;Torstai;28;38;66
95;17.07.2014;2014;07;16;Torstai;24;38;62
95;17.07.2014;2014;07;17;Torstai;14;24;38
95;17.07.2014;2014;07;18;Torstai;13;20;33
95;17.07.2014;2014;07;19;Torstai;26;16;42
95;17.07.2014;2014;07;20;Torstai;9;3;12
95;17.07.2014;2014;07;21;Torstai;3;8;11
95;17.07.2014;2014;07;22;Torstai;0;8;8
95;17.07.2014;2014;07;23;Torstai;3;1;4
95;18.07.2014;2014;07;00;Perjantai;0;1;1
95;18.07.2014;2014;07;01;Perjantai;0;0;0
95;18.07.2014;2014;07;02;Perjantai;0;0;0
95;18.07.2014;2014;07;03;Perjantai;1;0;1
95;18.07.2014;2014;07;04;Perjantai;3;2;5
95;18.07.2014;2014;07;05;Perjantai;6;1;7
95;18.07.2014;2014;07;06;Perjantai;15;15;30
95;18.07.2014;2014;07;07;Perjantai;22;12;34
95;18.07.2014;2014;07;08;Perjantai;22;10;32
95;18.07.2014;2014;07;09;Perjantai;13;13;26
95;18.07.2014;2014;07;10;Perjantai;17;17;34
95;18.07.2014;2014;07;11;Perjantai;25;22;47
95;18.07.2014;2014;07;12;Perjantai;19;14;33
95;18.07.2014;2014;07;13;Perjantai;2;4;6
95;18.07.2014;2014;07;14;Perjantai;16;10;26
95;18.07.2014;2014;07;15;Perjantai;16;16;32
95;18.07.2014;2014;07;16;Perjantai;18;16;34
95;18.07.2014;2014;07;17;Perjantai;27;15;42
95;18.07.2014;2014;07;18;Perjantai;14;21;35
95;18.07.2014;2014;07;19;Perjantai;14;15;29
95;18.07.2014;2014;07;20;Perjantai;7;15;22
95;18.07.2014;2014;07;21;Perjantai;4;12;16
95;18.07.2014;2014;07;22;Perjantai;5;7;12
95;18.07.2014;2014;07;23;Perjantai;2;3;5
95;19.07.2014;2014;07;00;Lauantai;0;3;3
95;19.07.2014;2014;07;01;Lauantai;0;0;0
95;19.07.2014;2014;07;02;Lauantai;3;1;4
95;19.07.2014;2014;07;03;Lauantai;0;4;4
95;19.07.2014;2014;07;04;Lauantai;1;3;4
95;19.07.2014;2014;07;05;Lauantai;1;1;2
95;19.07.2014;2014;07;06;Lauantai;5;1;6
95;19.07.2014;2014;07;07;Lauantai;4;4;8
95;19.07.2014;2014;07;08;Lauantai;4;7;11
95;19.07.2014;2014;07;09;Lauantai;14;18;32
95;19.07.2014;2014;07;10;Lauantai;22;22;44
95;19.07.2014;2014;07;11;Lauantai;27;16;43
95;19.07.2014;2014;07;12;Lauantai;21;20;41
95;19.07.2014;2014;07;13;Lauantai;26;26;52
95;19.07.2014;2014;07;14;Lauantai;14;25;39
95;19.07.2014;2014;07;15;Lauantai;6;19;25
95;19.07.2014;2014;07;16;Lauantai;5;7;12
95;19.07.2014;2014;07;17;Lauantai;5;11;16
95;19.07.2014;2014;07;18;Lauantai;5;5;10
95;19.07.2014;2014;07;19;Lauantai;7;6;13
95;19.07.2014;2014;07;20;Lauantai;12;12;24
95;19.07.2014;2014;07;21;Lauantai;10;12;22
95;19.07.2014;2014;07;22;Lauantai;5;5;10
95;19.07.2014;2014;07;23;Lauantai;0;3;3
95;20.07.2014;2014;07;00;Sunnuntai;1;3;4
95;20.07.2014;2014;07;01;Sunnuntai;0;0;0
95;20.07.2014;2014;07;02;Sunnuntai;0;1;1
95;20.07.2014;2014;07;03;Sunnuntai;3;0;3
95;20.07.2014;2014;07;04;Sunnuntai;1;3;4
95;20.07.2014;2014;07;05;Sunnuntai;1;1;2
95;20.07.2014;2014;07;06;Sunnuntai;5;3;8
95;20.07.2014;2014;07;07;Sunnuntai;6;5;11
95;20.07.2014;2014;07;08;Sunnuntai;10;9;19
95;20.07.2014;2014;07;09;Sunnuntai;11;19;30
95;20.07.2014;2014;07;10;Sunnuntai;29;17;46
95;20.07.2014;2014;07;11;Sunnuntai;35;36;71
95;20.07.2014;2014;07;12;Sunnuntai;39;22;61
95;20.07.2014;2014;07;13;Sunnuntai;38;27;65
95;20.07.2014;2014;07;14;Sunnuntai;24;32;56
95;20.07.2014;2014;07;15;Sunnuntai;11;19;30
95;20.07.2014;2014;07;16;Sunnuntai;30;33;63
95;20.07.2014;2014;07;17;Sunnuntai;23;21;44
95;20.07.2014;2014;07;18;Sunnuntai;19;21;40
95;20.07.2014;2014;07;19;Sunnuntai;16;20;36
95;20.07.2014;2014;07;20;Sunnuntai;23;22;45
95;20.07.2014;2014;07;21;Sunnuntai;10;10;20
95;20.07.2014;2014;07;22;Sunnuntai;4;9;13
95;20.07.2014;2014;07;23;Sunnuntai;2;4;6
95;21.07.2014;2014;07;00;Maanantai;0;0;0
95;21.07.2014;2014;07;01;Maanantai;0;1;1
95;21.07.2014;2014;07;02;Maanantai;1;2;3
95;21.07.2014;2014;07;03;Maanantai;2;0;2
95;21.07.2014;2014;07;04;Maanantai;2;0;2
95;21.07.2014;2014;07;05;Maanantai;7;2;9
95;21.07.2014;2014;07;06;Maanantai;25;21;46
95;21.07.2014;2014;07;07;Maanantai;25;23;48
95;21.07.2014;2014;07;08;Maanantai;23;14;37
95;21.07.2014;2014;07;09;Maanantai;21;11;32
95;21.07.2014;2014;07;10;Maanantai;22;9;31
95;21.07.2014;2014;07;11;Maanantai;24;26;50
95;21.07.2014;2014;07;12;Maanantai;22;21;43
95;21.07.2014;2014;07;13;Maanantai;24;30;54
95;21.07.2014;2014;07;14;Maanantai;19;24;43
95;21.07.2014;2014;07;15;Maanantai;47;51;98
95;21.07.2014;2014;07;16;Maanantai;41;56;97
95;21.07.2014;2014;07;17;Maanantai;26;37;63
95;21.07.2014;2014;07;18;Maanantai;40;34;74
95;21.07.2014;2014;07;19;Maanantai;25;46;71
95;21.07.2014;2014;07;20;Maanantai;45;33;78
95;21.07.2014;2014;07;21;Maanantai;19;21;40
95;21.07.2014;2014;07;22;Maanantai;8;12;20
95;21.07.2014;2014;07;23;Maanantai;1;4;5
95;22.07.2014;2014;07;00;Tiistai;0;3;3
95;22.07.2014;2014;07;01;Tiistai;1;0;1
95;22.07.2014;2014;07;02;Tiistai;2;0;2
95;22.07.2014;2014;07;03;Tiistai;0;0;0
95;22.07.2014;2014;07;04;Tiistai;2;1;3
95;22.07.2014;2014;07;05;Tiistai;3;2;5
95;22.07.2014;2014;07;06;Tiistai;31;25;56
95;22.07.2014;2014;07;07;Tiistai;30;18;48
95;22.07.2014;2014;07;08;Tiistai;18;15;33
95;22.07.2014;2014;07;09;Tiistai;25;12;37
95;22.07.2014;2014;07;10;Tiistai;29;18;47
95;22.07.2014;2014;07;11;Tiistai;29;28;57
95;22.07.2014;2014;07;12;Tiistai;14;24;38
95;22.07.2014;2014;07;13;Tiistai;18;23;41
95;22.07.2014;2014;07;14;Tiistai;20;29;49
95;22.07.2014;2014;07;15;Tiistai;36;39;75
95;22.07.2014;2014;07;16;Tiistai;33;45;78
95;22.07.2014;2014;07;17;Tiistai;27;29;56
95;22.07.2014;2014;07;18;Tiistai;17;40;57
95;22.07.2014;2014;07;19;Tiistai;20;26;46
95;22.07.2014;2014;07;20;Tiistai;30;25;55
95;22.07.2014;2014;07;21;Tiistai;24;14;38
95;22.07.2014;2014;07;22;Tiistai;7;16;23
95;22.07.2014;2014;07;23;Tiistai;4;6;10
95;23.07.2014;2014;07;00;Keskiviikko;1;5;6
95;23.07.2014;2014;07;01;Keskiviikko;0;1;1
95;23.07.2014;2014;07;02;Keskiviikko;0;0;0
95;23.07.2014;2014;07;03;Keskiviikko;1;0;1
95;23.07.2014;2014;07;04;Keskiviikko;4;1;5
95;23.07.2014;2014;07;05;Keskiviikko;6;1;7
95;23.07.2014;2014;07;06;Keskiviikko;26;20;46
95;23.07.2014;2014;07;07;Keskiviikko;33;20;53
95;23.07.2014;2014;07;08;Keskiviikko;21;15;36
95;23.07.2014;2014;07;09;Keskiviikko;19;19;38
95;23.07.2014;2014;07;10;Keskiviikko;25;14;39
95;23.07.2014;2014;07;11;Keskiviikko;31;31;62
95;23.07.2014;2014;07;12;Keskiviikko;23;17;40
95;23.07.2014;2014;07;13;Keskiviikko;24;30;54
95;23.07.2014;2014;07;14;Keskiviikko;19;36;55
95;23.07.2014;2014;07;15;Keskiviikko;44;36;80
95;23.07.2014;2014;07;16;Keskiviikko;38;32;70
95;23.07.2014;2014;07;17;Keskiviikko;24;40;64
95;23.07.2014;2014;07;18;Keskiviikko;24;26;50
95;23.07.2014;2014;07;19;Keskiviikko;18;20;38
95;23.07.2014;2014;07;20;Keskiviikko;19;26;45
95;23.07.2014;2014;07;21;Keskiviikko;12;20;32
95;23.07.2014;2014;07;22;Keskiviikko;15;16;31
95;23.07.2014;2014;07;23;Keskiviikko;0;7;7
95;24.07.2014;2014;07;00;Torstai;0;2;2
95;24.07.2014;2014;07;01;Torstai;0;0;0
95;24.07.2014;2014;07;02;Torstai;0;1;1
95;24.07.2014;2014;07;03;Torstai;2;2;4
95;24.07.2014;2014;07;04;Torstai;1;1;2
95;24.07.2014;2014;07;05;Torstai;4;2;6
95;24.07.2014;2014;07;06;Torstai;22;19;41
95;24.07.2014;2014;07;07;Torstai;28;22;50
95;24.07.2014;2014;07;08;Torstai;17;13;30
95;24.07.2014;2014;07;09;Torstai;21;14;35
95;24.07.2014;2014;07;10;Torstai;22;13;35
95;24.07.2014;2014;07;11;Torstai;17;17;34
95;24.07.2014;2014;07;12;Torstai;20;24;44
95;24.07.2014;2014;07;13;Torstai;30;31;61
95;24.07.2014;2014;07;14;Torstai;18;33;51
95;24.07.2014;2014;07;15;Torstai;47;38;85
95;24.07.2014;2014;07;16;Torstai;44;45;89
95;24.07.2014;2014;07;17;Torstai;25;39;64
95;24.07.2014;2014;07;18;Torstai;26;22;48
95;24.07.2014;2014;07;19;Torstai;25;34;59
95;24.07.2014;2014;07;20;Torstai;34;24;58
95;24.07.2014;2014;07;21;Torstai;13;23;36
95;24.07.2014;2014;07;22;Torstai;4;8;12
95;24.07.2014;2014;07;23;Torstai;4;4;8
95;25.07.2014;2014;07;00;Perjantai;0;2;2
95;25.07.2014;2014;07;01;Perjantai;0;3;3
95;25.07.2014;2014;07;02;Perjantai;0;4;4
95;25.07.2014;2014;07;03;Perjantai;1;0;1
95;25.07.2014;2014;07;04;Perjantai;2;2;4
95;25.07.2014;2014;07;05;Perjantai;3;6;9
95;25.07.2014;2014;07;06;Perjantai;16;12;28
95;25.07.2014;2014;07;07;Perjantai;22;20;42
95;25.07.2014;2014;07;08;Perjantai;16;14;30
95;25.07.2014;2014;07;09;Perjantai;20;17;37
95;25.07.2014;2014;07;10;Perjantai;20;20;40
95;25.07.2014;2014;07;11;Perjantai;20;15;35
95;25.07.2014;2014;07;12;Perjantai;21;21;42
95;25.07.2014;2014;07;13;Perjantai;28;22;50
95;25.07.2014;2014;07;14;Perjantai;37;25;62
95;25.07.2014;2014;07;15;Perjantai;38;30;68
95;25.07.2014;2014;07;16;Perjantai;37;30;67
95;25.07.2014;2014;07;17;Perjantai;25;23;48
95;25.07.2014;2014;07;18;Perjantai;17;10;27
95;25.07.2014;2014;07;19;Perjantai;19;14;33
95;25.07.2014;2014;07;20;Perjantai;22;19;41
95;25.07.2014;2014;07;21;Perjantai;17;14;31
95;25.07.2014;2014;07;22;Perjantai;3;7;10
95;25.07.2014;2014;07;23;Perjantai;1;6;7
95;26.07.2014;2014;07;00;Lauantai;2;11;13
95;26.07.2014;2014;07;01;Lauantai;1;14;15
95;26.07.2014;2014;07;02;Lauantai;0;27;27
95;26.07.2014;2014;07;03;Lauantai;0;12;12
95;26.07.2014;2014;07;04;Lauantai;1;5;6
95;26.07.2014;2014;07;05;Lauantai;2;1;3
95;26.07.2014;2014;07;06;Lauantai;4;5;9
95;26.07.2014;2014;07;07;Lauantai;14;2;16
95;26.07.2014;2014;07;08;Lauantai;8;10;18
95;26.07.2014;2014;07;09;Lauantai;23;11;34
95;26.07.2014;2014;07;10;Lauantai;20;18;38
95;26.07.2014;2014;07;11;Lauantai;42;15;57
95;26.07.2014;2014;07;12;Lauantai;15;25;40
95;26.07.2014;2014;07;13;Lauantai;29;32;61
95;26.07.2014;2014;07;14;Lauantai;27;23;50
95;26.07.2014;2014;07;15;Lauantai;26;17;43
95;26.07.2014;2014;07;16;Lauantai;27;16;43
95;26.07.2014;2014;07;17;Lauantai;25;16;41
95;26.07.2014;2014;07;18;Lauantai;19;13;32
95;26.07.2014;2014;07;19;Lauantai;21;14;35
95;26.07.2014;2014;07;20;Lauantai;13;16;29
95;26.07.2014;2014;07;21;Lauantai;16;15;31
95;26.07.2014;2014;07;22;Lauantai;11;7;18
95;26.07.2014;2014;07;23;Lauantai;2;16;18
95;27.07.2014;2014;07;00;Sunnuntai;7;15;22
95;27.07.2014;2014;07;01;Sunnuntai;0;20;20
95;27.07.2014;2014;07;02;Sunnuntai;2;9;11
95;27.07.2014;2014;07;03;Sunnuntai;1;16;17
95;27.07.2014;2014;07;04;Sunnuntai;1;9;10
95;27.07.2014;2014;07;05;Sunnuntai;1;4;5
95;27.07.2014;2014;07;06;Sunnuntai;1;7;8
95;27.07.2014;2014;07;07;Sunnuntai;3;4;7
95;27.07.2014;2014;07;08;Sunnuntai;6;4;10
95;27.07.2014;2014;07;09;Sunnuntai;17;14;31
95;27.07.2014;2014;07;10;Sunnuntai;19;41;60
95;27.07.2014;2014;07;11;Sunnuntai;38;25;63
95;27.07.2014;2014;07;12;Sunnuntai;30;25;55
95;27.07.2014;2014;07;13;Sunnuntai;22;14;36
95;27.07.2014;2014;07;14;Sunnuntai;20;21;41
95;27.07.2014;2014;07;15;Sunnuntai;16;19;35
95;27.07.2014;2014;07;16;Sunnuntai;22;29;51
95;27.07.2014;2014;07;17;Sunnuntai;25;16;41
95;27.07.2014;2014;07;18;Sunnuntai;19;21;40
95;27.07.2014;2014;07;19;Sunnuntai;32;28;60
95;27.07.2014;2014;07;20;Sunnuntai;9;9;18
95;27.07.2014;2014;07;21;Sunnuntai;9;10;19
95;27.07.2014;2014;07;22;Sunnuntai;3;8;11
95;27.07.2014;2014;07;23;Sunnuntai;2;3;5
95;28.07.2014;2014;07;00;Maanantai;0;2;2
95;28.07.2014;2014;07;01;Maanantai;0;2;2
95;28.07.2014;2014;07;02;Maanantai;2;0;2
95;28.07.2014;2014;07;03;Maanantai;0;0;0
95;28.07.2014;2014;07;04;Maanantai;0;0;0
95;28.07.2014;2014;07;05;Maanantai;6;5;11
95;28.07.2014;2014;07;06;Maanantai;26;13;39
95;28.07.2014;2014;07;07;Maanantai;20;17;37
95;28.07.2014;2014;07;08;Maanantai;11;4;15
95;28.07.2014;2014;07;09;Maanantai;6;3;9
95;28.07.2014;2014;07;10;Maanantai;4;2;6
95;28.07.2014;2014;07;11;Maanantai;2;3;5
95;28.07.2014;2014;07;12;Maanantai;7;6;13
95;28.07.2014;2014;07;13;Maanantai;12;9;21
95;28.07.2014;2014;07;14;Maanantai;7;8;15
95;28.07.2014;2014;07;15;Maanantai;7;16;23
95;28.07.2014;2014;07;16;Maanantai;17;25;42
95;28.07.2014;2014;07;17;Maanantai;9;13;22
95;28.07.2014;2014;07;18;Maanantai;22;22;44
95;28.07.2014;2014;07;19;Maanantai;15;27;42
95;28.07.2014;2014;07;20;Maanantai;6;14;20
95;28.07.2014;2014;07;21;Maanantai;11;8;19
95;28.07.2014;2014;07;22;Maanantai;2;2;4
95;28.07.2014;2014;07;23;Maanantai;0;0;0
95;29.07.2014;2014;07;00;Tiistai;0;1;1
95;29.07.2014;2014;07;01;Tiistai;0;3;3
95;29.07.2014;2014;07;02;Tiistai;1;0;1
95;29.07.2014;2014;07;03;Tiistai;0;0;0
95;29.07.2014;2014;07;04;Tiistai;1;1;2
95;29.07.2014;2014;07;05;Tiistai;5;4;9
95;29.07.2014;2014;07;06;Tiistai;27;14;41
95;29.07.2014;2014;07;07;Tiistai;29;16;45
95;29.07.2014;2014;07;08;Tiistai;15;13;28
95;29.07.2014;2014;07;09;Tiistai;15;16;31
95;29.07.2014;2014;07;10;Tiistai;28;13;41
95;29.07.2014;2014;07;11;Tiistai;30;15;45
95;29.07.2014;2014;07;12;Tiistai;18;27;45
95;29.07.2014;2014;07;13;Tiistai;17;22;39
95;29.07.2014;2014;07;14;Tiistai;17;18;35
95;29.07.2014;2014;07;15;Tiistai;27;32;59
95;29.07.2014;2014;07;16;Tiistai;29;39;68
95;29.07.2014;2014;07;17;Tiistai;35;35;70
95;29.07.2014;2014;07;18;Tiistai;21;37;58
95;29.07.2014;2014;07;19;Tiistai;30;36;66
95;29.07.2014;2014;07;20;Tiistai;11;21;32
95;29.07.2014;2014;07;21;Tiistai;19;11;30
95;29.07.2014;2014;07;22;Tiistai;6;6;12
95;29.07.2014;2014;07;23;Tiistai;1;2;3
95;30.07.2014;2014;07;00;Keskiviikko;1;5;6
95;30.07.2014;2014;07;01;Keskiviikko;2;3;5
95;30.07.2014;2014;07;02;Keskiviikko;0;2;2
95;30.07.2014;2014;07;03;Keskiviikko;0;0;0
95;30.07.2014;2014;07;04;Keskiviikko;2;1;3
95;30.07.2014;2014;07;05;Keskiviikko;5;8;13
95;30.07.2014;2014;07;06;Keskiviikko;29;12;41
95;30.07.2014;2014;07;07;Keskiviikko;39;21;60
95;30.07.2014;2014;07;08;Keskiviikko;14;25;39
95;30.07.2014;2014;07;09;Keskiviikko;7;10;17
95;30.07.2014;2014;07;10;Keskiviikko;24;9;33
95;30.07.2014;2014;07;11;Keskiviikko;14;10;24
95;30.07.2014;2014;07;12;Keskiviikko;18;19;37
95;30.07.2014;2014;07;13;Keskiviikko;24;21;45
95;30.07.2014;2014;07;14;Keskiviikko;23;9;32
95;30.07.2014;2014;07;15;Keskiviikko;20;43;63
95;30.07.2014;2014;07;16;Keskiviikko;36;55;91
95;30.07.2014;2014;07;17;Keskiviikko;31;29;60
95;30.07.2014;2014;07;18;Keskiviikko;30;33;63
95;30.07.2014;2014;07;19;Keskiviikko;25;34;59
95;30.07.2014;2014;07;20;Keskiviikko;30;27;57
95;30.07.2014;2014;07;21;Keskiviikko;16;13;29
95;30.07.2014;2014;07;22;Keskiviikko;1;4;5
95;30.07.2014;2014;07;23;Keskiviikko;2;5;7
95;31.07.2014;2014;07;00;Torstai;3;1;4
95;31.07.2014;2014;07;01;Torstai;0;0;0
95;31.07.2014;2014;07;02;Torstai;0;0;0
95;31.07.2014;2014;07;03;Torstai;0;1;1
95;31.07.2014;2014;07;04;Torstai;1;1;2
95;31.07.2014;2014;07;05;Torstai;2;1;3
95;31.07.2014;2014;07;06;Torstai;14;8;22
95;31.07.2014;2014;07;07;Torstai;13;10;23
95;31.07.2014;2014;07;08;Torstai;10;8;18
95;31.07.2014;2014;07;09;Torstai;3;4;7
95;31.07.2014;2014;07;10;Torstai;7;5;12
95;31.07.2014;2014;07;11;Torstai;9;5;14
95;31.07.2014;2014;07;12;Torstai;7;5;12
95;31.07.2014;2014;07;13;Torstai;5;3;8
95;31.07.2014;2014;07;14;Torstai;1;2;3
95;31.07.2014;2014;07;15;Torstai;4;6;10
95;31.07.2014;2014;07;16;Torstai;5;8;13
95;31.07.2014;2014;07;17;Torstai;1;6;7
95;31.07.2014;2014;07;18;Torstai;3;1;4
95;31.07.2014;2014;07;19;Torstai;5;9;14
95;31.07.2014;2014;07;20;Torstai;12;9;21
95;31.07.2014;2014;07;21;Torstai;5;9;14
95;31.07.2014;2014;07;22;Torstai;2;5;7
95;31.07.2014;2014;07;23;Torstai;2;1;3
95;01.08.2014;2014;08;00;Perjantai;1;3;4
95;01.08.2014;2014;08;01;Perjantai;0;0;0
95;01.08.2014;2014;08;02;Perjantai;0;0;0
95;01.08.2014;2014;08;03;Perjantai;0;0;0
95;01.08.2014;2014;08;04;Perjantai;0;1;1
95;01.08.2014;2014;08;05;Perjantai;5;5;10
95;01.08.2014;2014;08;06;Perjantai;23;11;34
95;01.08.2014;2014;08;07;Perjantai;26;13;39
95;01.08.2014;2014;08;08;Perjantai;17;17;34
95;01.08.2014;2014;08;09;Perjantai;18;13;31
95;01.08.2014;2014;08;10;Perjantai;19;19;38
95;01.08.2014;2014;08;11;Perjantai;16;15;31
95;01.08.2014;2014;08;12;Perjantai;37;23;60
95;01.08.2014;2014;08;13;Perjantai;29;22;51
95;01.08.2014;2014;08;14;Perjantai;20;26;46
95;01.08.2014;2014;08;15;Perjantai;35;35;70
95;01.08.2014;2014;08;16;Perjantai;25;31;56
95;01.08.2014;2014;08;17;Perjantai;21;31;52
95;01.08.2014;2014;08;18;Perjantai;14;20;34
95;01.08.2014;2014;08;19;Perjantai;18;16;34
95;01.08.2014;2014;08;20;Perjantai;15;18;33
95;01.08.2014;2014;08;21;Perjantai;8;11;19
95;01.08.2014;2014;08;22;Perjantai;2;5;7
95;01.08.2014;2014;08;23;Perjantai;1;0;1
95;02.08.2014;2014;08;00;Lauantai;2;3;5
95;02.08.2014;2014;08;01;Lauantai;1;1;2
95;02.08.2014;2014;08;02;Lauantai;0;1;1
95;02.08.2014;2014;08;03;Lauantai;0;3;3
95;02.08.2014;2014;08;04;Lauantai;0;0;0
95;02.08.2014;2014;08;05;Lauantai;0;1;1
95;02.08.2014;2014;08;06;Lauantai;1;3;4
95;02.08.2014;2014;08;07;Lauantai;3;4;7
95;02.08.2014;2014;08;08;Lauantai;16;4;20
95;02.08.2014;2014;08;09;Lauantai;10;13;23
95;02.08.2014;2014;08;10;Lauantai;16;10;26
95;02.08.2014;2014;08;11;Lauantai;20;22;42
95;02.08.2014;2014;08;12;Lauantai;25;22;47
95;02.08.2014;2014;08;13;Lauantai;20;18;38
95;02.08.2014;2014;08;14;Lauantai;27;23;50
95;02.08.2014;2014;08;15;Lauantai;29;25;54
95;02.08.2014;2014;08;16;Lauantai;27;26;53
95;02.08.2014;2014;08;17;Lauantai;29;29;58
95;02.08.2014;2014;08;18;Lauantai;18;23;41
95;02.08.2014;2014;08;19;Lauantai;22;15;37
95;02.08.2014;2014;08;20;Lauantai;3;13;16
95;02.08.2014;2014;08;21;Lauantai;13;4;17
95;02.08.2014;2014;08;22;Lauantai;6;7;13
95;02.08.2014;2014;08;23;Lauantai;1;7;8
95;03.08.2014;2014;08;00;Sunnuntai;1;3;4
95;03.08.2014;2014;08;01;Sunnuntai;1;6;7
95;03.08.2014;2014;08;02;Sunnuntai;0;5;5
95;03.08.2014;2014;08;03;Sunnuntai;0;3;3
95;03.08.2014;2014;08;04;Sunnuntai;0;3;3
95;03.08.2014;2014;08;05;Sunnuntai;1;2;3
95;03.08.2014;2014;08;06;Sunnuntai;3;4;7
95;03.08.2014;2014;08;07;Sunnuntai;3;3;6
95;03.08.2014;2014;08;08;Sunnuntai;8;7;15
95;03.08.2014;2014;08;09;Sunnuntai;19;16;35
95;03.08.2014;2014;08;10;Sunnuntai;22;24;46
95;03.08.2014;2014;08;11;Sunnuntai;30;26;56
95;03.08.2014;2014;08;12;Sunnuntai;19;27;46
95;03.08.2014;2014;08;13;Sunnuntai;23;32;55
95;03.08.2014;2014;08;14;Sunnuntai;31;32;63
95;03.08.2014;2014;08;15;Sunnuntai;28;31;59
95;03.08.2014;2014;08;16;Sunnuntai;42;21;63
95;03.08.2014;2014;08;17;Sunnuntai;15;24;39
95;03.08.2014;2014;08;18;Sunnuntai;32;29;61
95;03.08.2014;2014;08;19;Sunnuntai;35;26;61
95;03.08.2014;2014;08;20;Sunnuntai;22;32;54
95;03.08.2014;2014;08;21;Sunnuntai;22;20;42
95;03.08.2014;2014;08;22;Sunnuntai;7;10;17
95;03.08.2014;2014;08;23;Sunnuntai;5;7;12
95;04.08.2014;2014;08;00;Maanantai;0;1;1
95;04.08.2014;2014;08;01;Maanantai;0;2;2
95;04.08.2014;2014;08;02;Maanantai;0;0;0
95;04.08.2014;2014;08;03;Maanantai;1;1;2
95;04.08.2014;2014;08;04;Maanantai;5;2;7
95;04.08.2014;2014;08;05;Maanantai;6;4;10
95;04.08.2014;2014;08;06;Maanantai;28;16;44
95;04.08.2014;2014;08;07;Maanantai;46;29;75
95;04.08.2014;2014;08;08;Maanantai;28;19;47
95;04.08.2014;2014;08;09;Maanantai;14;12;26
95;04.08.2014;2014;08;10;Maanantai;26;10;36
95;04.08.2014;2014;08;11;Maanantai;9;14;23
95;04.08.2014;2014;08;12;Maanantai;13;8;21
95;04.08.2014;2014;08;13;Maanantai;26;17;43
95;04.08.2014;2014;08;14;Maanantai;26;22;48
95;04.08.2014;2014;08;15;Maanantai;40;33;73
95;04.08.2014;2014;08;16;Maanantai;34;61;95
95;04.08.2014;2014;08;17;Maanantai;35;43;78
95;04.08.2014;2014;08;18;Maanantai;23;31;54
95;04.08.2014;2014;08;19;Maanantai;30;35;65
95;04.08.2014;2014;08;20;Maanantai;49;30;79
95;04.08.2014;2014;08;21;Maanantai;17;17;34
95;04.08.2014;2014;08;22;Maanantai;8;9;17
95;04.08.2014;2014;08;23;Maanantai;2;3;5
95;05.08.2014;2014;08;00;Tiistai;0;1;1
95;05.08.2014;2014;08;01;Tiistai;2;1;3
95;05.08.2014;2014;08;02;Tiistai;2;0;2
95;05.08.2014;2014;08;03;Tiistai;4;1;5
95;05.08.2014;2014;08;04;Tiistai;3;0;3
95;05.08.2014;2014;08;05;Tiistai;6;5;11
95;05.08.2014;2014;08;06;Tiistai;46;20;66
95;05.08.2014;2014;08;07;Tiistai;53;43;96
95;05.08.2014;2014;08;08;Tiistai;20;16;36
95;05.08.2014;2014;08;09;Tiistai;15;16;31
95;05.08.2014;2014;08;10;Tiistai;22;27;49
95;05.08.2014;2014;08;11;Tiistai;28;11;39
95;05.08.2014;2014;08;12;Tiistai;20;13;33
95;05.08.2014;2014;08;13;Tiistai;16;16;32
95;05.08.2014;2014;08;14;Tiistai;27;29;56
95;05.08.2014;2014;08;15;Tiistai;57;51;108
95;05.08.2014;2014;08;16;Tiistai;37;73;110
95;05.08.2014;2014;08;17;Tiistai;27;40;67
95;05.08.2014;2014;08;18;Tiistai;29;33;62
95;05.08.2014;2014;08;19;Tiistai;37;31;68
95;05.08.2014;2014;08;20;Tiistai;21;19;40
95;05.08.2014;2014;08;21;Tiistai;17;12;29
95;05.08.2014;2014;08;22;Tiistai;3;6;9
95;05.08.2014;2014;08;23;Tiistai;2;4;6
95;06.08.2014;2014;08;00;Keskiviikko;1;8;9
95;06.08.2014;2014;08;01;Keskiviikko;0;0;0
95;06.08.2014;2014;08;02;Keskiviikko;0;0;0
95;06.08.2014;2014;08;03;Keskiviikko;0;0;0
95;06.08.2014;2014;08;04;Keskiviikko;2;0;2
95;06.08.2014;2014;08;05;Keskiviikko;5;10;15
95;06.08.2014;2014;08;06;Keskiviikko;39;15;54
95;06.08.2014;2014;08;07;Keskiviikko;41;40;81
95;06.08.2014;2014;08;08;Keskiviikko;30;21;51
95;06.08.2014;2014;08;09;Keskiviikko;30;13;43
95;06.08.2014;2014;08;10;Keskiviikko;19;18;37
95;06.08.2014;2014;08;11;Keskiviikko;20;20;40
95;06.08.2014;2014;08;12;Keskiviikko;27;23;50
95;06.08.2014;2014;08;13;Keskiviikko;26;29;55
95;06.08.2014;2014;08;14;Keskiviikko;28;18;46
95;06.08.2014;2014;08;15;Keskiviikko;46;42;88
95;06.08.2014;2014;08;16;Keskiviikko;46;64;110
95;06.08.2014;2014;08;17;Keskiviikko;32;37;69
95;06.08.2014;2014;08;18;Keskiviikko;28;39;67
95;06.08.2014;2014;08;19;Keskiviikko;31;37;68
95;06.08.2014;2014;08;20;Keskiviikko;38;28;66
95;06.08.2014;2014;08;21;Keskiviikko;8;19;27
95;06.08.2014;2014;08;22;Keskiviikko;8;4;12
95;06.08.2014;2014;08;23;Keskiviikko;3;1;4
95;07.08.2014;2014;08;00;Torstai;0;2;2
95;07.08.2014;2014;08;01;Torstai;0;0;0
95;07.08.2014;2014;08;02;Torstai;0;0;0
95;07.08.2014;2014;08;03;Torstai;0;0;0
95;07.08.2014;2014;08;04;Torstai;2;1;3
95;07.08.2014;2014;08;05;Torstai;11;4;15
95;07.08.2014;2014;08;06;Torstai;29;21;50
95;07.08.2014;2014;08;07;Torstai;46;39;85
95;07.08.2014;2014;08;08;Torstai;26;12;38
95;07.08.2014;2014;08;09;Torstai;18;15;33
95;07.08.2014;2014;08;10;Torstai;22;15;37
95;07.08.2014;2014;08;11;Torstai;21;22;43
95;07.08.2014;2014;08;12;Torstai;28;26;54
95;07.08.2014;2014;08;13;Torstai;24;22;46
95;07.08.2014;2014;08;14;Torstai;29;31;60
95;07.08.2014;2014;08;15;Torstai;43;44;87
95;07.08.2014;2014;08;16;Torstai;48;53;101
95;07.08.2014;2014;08;17;Torstai;32;42;74
95;07.08.2014;2014;08;18;Torstai;23;24;47
95;07.08.2014;2014;08;19;Torstai;32;59;91
95;07.08.2014;2014;08;20;Torstai;16;25;41
95;07.08.2014;2014;08;21;Torstai;6;16;22
95;07.08.2014;2014;08;22;Torstai;5;6;11
95;07.08.2014;2014;08;23;Torstai;0;0;0
95;08.08.2014;2014;08;00;Perjantai;0;1;1
95;08.08.2014;2014;08;01;Perjantai;0;1;1
95;08.08.2014;2014;08;02;Perjantai;1;0;1
95;08.08.2014;2014;08;03;Perjantai;0;1;1
95;08.08.2014;2014;08;04;Perjantai;2;0;2
95;08.08.2014;2014;08;05;Perjantai;2;4;6
95;08.08.2014;2014;08;06;Perjantai;13;13;26
95;08.08.2014;2014;08;07;Perjantai;25;28;53
95;08.08.2014;2014;08;08;Perjantai;11;16;27
95;08.08.2014;2014;08;09;Perjantai;18;7;25
95;08.08.2014;2014;08;10;Perjantai;29;18;47
95;08.08.2014;2014;08;11;Perjantai;11;17;28
95;08.08.2014;2014;08;12;Perjantai;13;13;26
95;08.08.2014;2014;08;13;Perjantai;19;9;28
95;08.08.2014;2014;08;14;Perjantai;14;18;32
95;08.08.2014;2014;08;15;Perjantai;25;23;48
95;08.08.2014;2014;08;16;Perjantai;27;31;58
95;08.08.2014;2014;08;17;Perjantai;16;13;29
95;08.08.2014;2014;08;18;Perjantai;23;17;40
95;08.08.2014;2014;08;19;Perjantai;20;22;42
95;08.08.2014;2014;08;20;Perjantai;16;19;35
95;08.08.2014;2014;08;21;Perjantai;11;12;23
95;08.08.2014;2014;08;22;Perjantai;1;9;10
95;08.08.2014;2014;08;23;Perjantai;1;0;1
95;09.08.2014;2014;08;00;Lauantai;0;2;2
95;09.08.2014;2014;08;01;Lauantai;0;2;2
95;09.08.2014;2014;08;02;Lauantai;1;0;1
95;09.08.2014;2014;08;03;Lauantai;0;1;1
95;09.08.2014;2014;08;04;Lauantai;0;1;1
95;09.08.2014;2014;08;05;Lauantai;1;1;2
95;09.08.2014;2014;08;06;Lauantai;3;4;7
95;09.08.2014;2014;08;07;Lauantai;6;7;13
95;09.08.2014;2014;08;08;Lauantai;7;7;14
95;09.08.2014;2014;08;09;Lauantai;10;16;26
95;09.08.2014;2014;08;10;Lauantai;16;16;32
95;09.08.2014;2014;08;11;Lauantai;17;30;47
95;09.08.2014;2014;08;12;Lauantai;25;35;60
95;09.08.2014;2014;08;13;Lauantai;21;23;44
95;09.08.2014;2014;08;14;Lauantai;21;48;69
95;09.08.2014;2014;08;15;Lauantai;16;25;41
95;09.08.2014;2014;08;16;Lauantai;6;4;10
95;09.08.2014;2014;08;17;Lauantai;1;4;5
95;09.08.2014;2014;08;18;Lauantai;3;5;8
95;09.08.2014;2014;08;19;Lauantai;2;5;7
95;09.08.2014;2014;08;20;Lauantai;3;1;4
95;09.08.2014;2014;08;21;Lauantai;1;0;1
95;09.08.2014;2014;08;22;Lauantai;0;0;0
95;09.08.2014;2014;08;23;Lauantai;0;0;0
95;10.08.2014;2014;08;00;Sunnuntai;1;0;1
95;10.08.2014;2014;08;01;Sunnuntai;0;0;0
95;10.08.2014;2014;08;02;Sunnuntai;0;0;0
95;10.08.2014;2014;08;03;Sunnuntai;1;0;1
95;10.08.2014;2014;08;04;Sunnuntai;0;0;0
95;10.08.2014;2014;08;05;Sunnuntai;0;0;0
95;10.08.2014;2014;08;06;Sunnuntai;1;0;1
95;10.08.2014;2014;08;07;Sunnuntai;6;2;8
95;10.08.2014;2014;08;08;Sunnuntai;1;3;4
95;10.08.2014;2014;08;09;Sunnuntai;1;8;9
95;10.08.2014;2014;08;10;Sunnuntai;9;3;12
95;10.08.2014;2014;08;11;Sunnuntai;14;13;27
95;10.08.2014;2014;08;12;Sunnuntai;18;19;37
95;10.08.2014;2014;08;13;Sunnuntai;16;18;34
95;10.08.2014;2014;08;14;Sunnuntai;15;18;33
95;10.08.2014;2014;08;15;Sunnuntai;29;16;45
95;10.08.2014;2014;08;16;Sunnuntai;25;22;47
95;10.08.2014;2014;08;17;Sunnuntai;20;22;42
95;10.08.2014;2014;08;18;Sunnuntai;29;29;58
95;10.08.2014;2014;08;19;Sunnuntai;31;25;56
95;10.08.2014;2014;08;20;Sunnuntai;22;14;36
95;10.08.2014;2014;08;21;Sunnuntai;4;13;17
95;10.08.2014;2014;08;22;Sunnuntai;0;1;1
95;10.08.2014;2014;08;23;Sunnuntai;2;1;3
95;11.08.2014;2014;08;00;Maanantai;0;0;0
95;11.08.2014;2014;08;01;Maanantai;3;0;3
95;11.08.2014;2014;08;02;Maanantai;0;0;0
95;11.08.2014;2014;08;03;Maanantai;0;0;0
95;11.08.2014;2014;08;04;Maanantai;3;0;3
95;11.08.2014;2014;08;05;Maanantai;8;4;12
95;11.08.2014;2014;08;06;Maanantai;35;15;50
95;11.08.2014;2014;08;07;Maanantai;51;35;86
95;11.08.2014;2014;08;08;Maanantai;18;17;35
95;11.08.2014;2014;08;09;Maanantai;23;9;32
95;11.08.2014;2014;08;10;Maanantai;15;12;27
95;11.08.2014;2014;08;11;Maanantai;14;22;36
95;11.08.2014;2014;08;12;Maanantai;13;28;41
95;11.08.2014;2014;08;13;Maanantai;28;17;45
95;11.08.2014;2014;08;14;Maanantai;17;23;40
95;11.08.2014;2014;08;15;Maanantai;45;45;90
95;11.08.2014;2014;08;16;Maanantai;39;55;94
95;11.08.2014;2014;08;17;Maanantai;21;41;62
95;11.08.2014;2014;08;18;Maanantai;32;42;74
95;11.08.2014;2014;08;19;Maanantai;35;31;66
95;11.08.2014;2014;08;20;Maanantai;36;31;67
95;11.08.2014;2014;08;21;Maanantai;9;23;32
95;11.08.2014;2014;08;22;Maanantai;4;7;11
95;11.08.2014;2014;08;23;Maanantai;1;2;3
95;12.08.2014;2014;08;00;Tiistai;1;1;2
95;12.08.2014;2014;08;01;Tiistai;0;0;0
95;12.08.2014;2014;08;02;Tiistai;0;0;0
95;12.08.2014;2014;08;03;Tiistai;0;0;0
95;12.08.2014;2014;08;04;Tiistai;0;0;0
95;12.08.2014;2014;08;05;Tiistai;8;8;16
95;12.08.2014;2014;08;06;Tiistai;22;19;41
95;12.08.2014;2014;08;07;Tiistai;24;24;48
95;12.08.2014;2014;08;08;Tiistai;8;12;20
95;12.08.2014;2014;08;09;Tiistai;13;7;20
95;12.08.2014;2014;08;10;Tiistai;3;6;9
95;12.08.2014;2014;08;11;Tiistai;3;1;4
95;12.08.2014;2014;08;12;Tiistai;4;3;7
95;12.08.2014;2014;08;13;Tiistai;5;0;5
95;12.08.2014;2014;08;14;Tiistai;23;11;34
95;12.08.2014;2014;08;15;Tiistai;25;23;48
95;12.08.2014;2014;08;16;Tiistai;29;22;51
95;12.08.2014;2014;08;17;Tiistai;18;22;40
95;12.08.2014;2014;08;18;Tiistai;6;21;27
95;12.08.2014;2014;08;19;Tiistai;21;23;44
95;12.08.2014;2014;08;20;Tiistai;16;16;32
95;12.08.2014;2014;08;21;Tiistai;2;7;9
95;12.08.2014;2014;08;22;Tiistai;2;3;5
95;12.08.2014;2014;08;23;Tiistai;1;0;1
95;13.08.2014;2014;08;00;Keskiviikko;0;1;1
95;13.08.2014;2014;08;01;Keskiviikko;0;1;1
95;13.08.2014;2014;08;02;Keskiviikko;0;0;0
95;13.08.2014;2014;08;03;Keskiviikko;0;0;0
95;13.08.2014;2014;08;04;Keskiviikko;0;0;0
95;13.08.2014;2014;08;05;Keskiviikko;13;6;19
95;13.08.2014;2014;08;06;Keskiviikko;27;14;41
95;13.08.2014;2014;08;07;Keskiviikko;37;30;67
95;13.08.2014;2014;08;08;Keskiviikko;21;16;37
95;13.08.2014;2014;08;09;Keskiviikko;14;9;23
95;13.08.2014;2014;08;10;Keskiviikko;16;17;33
95;13.08.2014;2014;08;11;Keskiviikko;22;11;33
95;13.08.2014;2014;08;12;Keskiviikko;17;20;37
95;13.08.2014;2014;08;13;Keskiviikko;11;16;27
95;13.08.2014;2014;08;14;Keskiviikko;20;8;28
95;13.08.2014;2014;08;15;Keskiviikko;40;34;74
95;13.08.2014;2014;08;16;Keskiviikko;34;33;67
95;13.08.2014;2014;08;17;Keskiviikko;15;27;42
95;13.08.2014;2014;08;18;Keskiviikko;15;34;49
95;13.08.2014;2014;08;19;Keskiviikko;20;24;44
95;13.08.2014;2014;08;20;Keskiviikko;17;19;36
95;13.08.2014;2014;08;21;Keskiviikko;9;12;21
95;13.08.2014;2014;08;22;Keskiviikko;3;6;9
95;13.08.2014;2014;08;23;Keskiviikko;1;1;2
95;14.08.2014;2014;08;00;Torstai;2;0;2
95;14.08.2014;2014;08;01;Torstai;0;0;0
95;14.08.2014;2014;08;02;Torstai;0;1;1
95;14.08.2014;2014;08;03;Torstai;0;0;0
95;14.08.2014;2014;08;04;Torstai;2;0;2
95;14.08.2014;2014;08;05;Torstai;5;4;9
95;14.08.2014;2014;08;06;Torstai;32;13;45
95;14.08.2014;2014;08;07;Torstai;30;22;52
95;14.08.2014;2014;08;08;Torstai;16;16;32
95;14.08.2014;2014;08;09;Torstai;11;8;19
95;14.08.2014;2014;08;10;Torstai;12;10;22
95;14.08.2014;2014;08;11;Torstai;16;21;37
95;14.08.2014;2014;08;12;Torstai;18;9;27
95;14.08.2014;2014;08;13;Torstai;10;15;25
95;14.08.2014;2014;08;14;Torstai;18;11;29
95;14.08.2014;2014;08;15;Torstai;18;31;49
95;14.08.2014;2014;08;16;Torstai;25;39;64
95;14.08.2014;2014;08;17;Torstai;18;16;34
95;14.08.2014;2014;08;18;Torstai;9;18;27
95;14.08.2014;2014;08;19;Torstai;13;16;29
95;14.08.2014;2014;08;20;Torstai;9;14;23
95;14.08.2014;2014;08;21;Torstai;8;6;14
95;14.08.2014;2014;08;22;Torstai;4;4;8
95;14.08.2014;2014;08;23;Torstai;1;1;2
95;15.08.2014;2014;08;00;Perjantai;1;1;2
95;15.08.2014;2014;08;01;Perjantai;0;1;1
95;15.08.2014;2014;08;02;Perjantai;0;2;2
95;15.08.2014;2014;08;03;Perjantai;0;0;0
95;15.08.2014;2014;08;04;Perjantai;1;0;1
95;15.08.2014;2014;08;05;Perjantai;6;4;10
95;15.08.2014;2014;08;06;Perjantai;22;13;35
95;15.08.2014;2014;08;07;Perjantai;23;26;49
95;15.08.2014;2014;08;08;Perjantai;12;13;25
95;15.08.2014;2014;08;09;Perjantai;11;37;48
95;15.08.2014;2014;08;10;Perjantai;8;6;14
95;15.08.2014;2014;08;11;Perjantai;10;11;21
95;15.08.2014;2014;08;12;Perjantai;11;9;20
95;15.08.2014;2014;08;13;Perjantai;12;9;21
95;15.08.2014;2014;08;14;Perjantai;22;11;33
95;15.08.2014;2014;08;15;Perjantai;18;35;53
95;15.08.2014;2014;08;16;Perjantai;22;18;40
95;15.08.2014;2014;08;17;Perjantai;22;21;43
95;15.08.2014;2014;08;18;Perjantai;14;11;25
95;15.08.2014;2014;08;19;Perjantai;8;14;22
95;15.08.2014;2014;08;20;Perjantai;21;14;35
95;15.08.2014;2014;08;21;Perjantai;6;3;9
95;15.08.2014;2014;08;22;Perjantai;5;6;11
95;15.08.2014;2014;08;23;Perjantai;0;3;3
95;16.08.2014;2014;08;00;Lauantai;1;2;3
95;16.08.2014;2014;08;01;Lauantai;0;0;0
95;16.08.2014;2014;08;02;Lauantai;0;3;3
95;16.08.2014;2014;08;03;Lauantai;0;0;0
95;16.08.2014;2014;08;04;Lauantai;0;1;1
95;16.08.2014;2014;08;05;Lauantai;0;0;0
95;16.08.2014;2014;08;06;Lauantai;0;2;2
95;16.08.2014;2014;08;07;Lauantai;9;6;15
95;16.08.2014;2014;08;08;Lauantai;11;10;21
95;16.08.2014;2014;08;09;Lauantai;11;17;28
95;16.08.2014;2014;08;10;Lauantai;19;9;28
95;16.08.2014;2014;08;11;Lauantai;17;17;34
95;16.08.2014;2014;08;12;Lauantai;29;20;49
95;16.08.2014;2014;08;13;Lauantai;11;23;34
95;16.08.2014;2014;08;14;Lauantai;13;19;32
95;16.08.2014;2014;08;15;Lauantai;23;21;44
95;16.08.2014;2014;08;16;Lauantai;18;11;29
95;16.08.2014;2014;08;17;Lauantai;13;27;40
95;16.08.2014;2014;08;18;Lauantai;22;18;40
95;16.08.2014;2014;08;19;Lauantai;10;15;25
95;16.08.2014;2014;08;20;Lauantai;5;12;17
95;16.08.2014;2014;08;21;Lauantai;4;3;7
95;16.08.2014;2014;08;22;Lauantai;1;3;4
95;16.08.2014;2014;08;23;Lauantai;2;4;6
95;17.08.2014;2014;08;00;Sunnuntai;2;1;3
95;17.08.2014;2014;08;01;Sunnuntai;1;3;4
95;17.08.2014;2014;08;02;Sunnuntai;2;0;2
95;17.08.2014;2014;08;03;Sunnuntai;0;3;3
95;17.08.2014;2014;08;04;Sunnuntai;0;0;0
95;17.08.2014;2014;08;05;Sunnuntai;0;0;0
95;17.08.2014;2014;08;06;Sunnuntai;2;1;3
95;17.08.2014;2014;08;07;Sunnuntai;3;1;4
95;17.08.2014;2014;08;08;Sunnuntai;5;1;6
95;17.08.2014;2014;08;09;Sunnuntai;8;8;16
95;17.08.2014;2014;08;10;Sunnuntai;16;18;34
95;17.08.2014;2014;08;11;Sunnuntai;30;13;43
95;17.08.2014;2014;08;12;Sunnuntai;33;16;49
95;17.08.2014;2014;08;13;Sunnuntai;21;27;48
95;17.08.2014;2014;08;14;Sunnuntai;25;30;55
95;17.08.2014;2014;08;15;Sunnuntai;21;21;42
95;17.08.2014;2014;08;16;Sunnuntai;15;18;33
95;17.08.2014;2014;08;17;Sunnuntai;17;8;25
95;17.08.2014;2014;08;18;Sunnuntai;11;15;26
95;17.08.2014;2014;08;19;Sunnuntai;26;23;49
95;17.08.2014;2014;08;20;Sunnuntai;21;11;32
95;17.08.2014;2014;08;21;Sunnuntai;4;2;6
95;17.08.2014;2014;08;22;Sunnuntai;1;2;3
95;17.08.2014;2014;08;23;Sunnuntai;0;0;0
95;18.08.2014;2014;08;00;Maanantai;0;2;2
95;18.08.2014;2014;08;01;Maanantai;0;0;0
95;18.08.2014;2014;08;02;Maanantai;0;0;0
95;18.08.2014;2014;08;03;Maanantai;1;0;1
95;18.08.2014;2014;08;04;Maanantai;3;0;3
95;18.08.2014;2014;08;05;Maanantai;5;2;7
95;18.08.2014;2014;08;06;Maanantai;42;12;54
95;18.08.2014;2014;08;07;Maanantai;36;30;66
95;18.08.2014;2014;08;08;Maanantai;20;12;32
95;18.08.2014;2014;08;09;Maanantai;18;11;29
95;18.08.2014;2014;08;10;Maanantai;8;6;14
95;18.08.2014;2014;08;11;Maanantai;13;10;23
95;18.08.2014;2014;08;12;Maanantai;19;15;34
95;18.08.2014;2014;08;13;Maanantai;21;21;42
95;18.08.2014;2014;08;14;Maanantai;22;19;41
95;18.08.2014;2014;08;15;Maanantai;24;43;67
95;18.08.2014;2014;08;16;Maanantai;23;38;61
95;18.08.2014;2014;08;17;Maanantai;9;16;25
95;18.08.2014;2014;08;18;Maanantai;3;4;7
95;18.08.2014;2014;08;19;Maanantai;10;8;18
95;18.08.2014;2014;08;20;Maanantai;2;6;8
95;18.08.2014;2014;08;21;Maanantai;2;4;6
95;18.08.2014;2014;08;22;Maanantai;2;5;7
95;18.08.2014;2014;08;23;Maanantai;0;1;1
95;19.08.2014;2014;08;00;Tiistai;1;0;1
95;19.08.2014;2014;08;01;Tiistai;0;0;0
95;19.08.2014;2014;08;02;Tiistai;0;0;0
95;19.08.2014;2014;08;03;Tiistai;0;0;0
95;19.08.2014;2014;08;04;Tiistai;3;1;4
95;19.08.2014;2014;08;05;Tiistai;9;3;12
95;19.08.2014;2014;08;06;Tiistai;21;8;29
95;19.08.2014;2014;08;07;Tiistai;31;28;59
95;19.08.2014;2014;08;08;Tiistai;14;10;24
95;19.08.2014;2014;08;09;Tiistai;10;6;16
95;19.08.2014;2014;08;10;Tiistai;7;11;18
95;19.08.2014;2014;08;11;Tiistai;6;2;8
95;19.08.2014;2014;08;12;Tiistai;7;4;11
95;19.08.2014;2014;08;13;Tiistai;9;8;17
95;19.08.2014;2014;08;14;Tiistai;17;15;32
95;19.08.2014;2014;08;15;Tiistai;22;40;62
95;19.08.2014;2014;08;16;Tiistai;30;29;59
95;19.08.2014;2014;08;17;Tiistai;14;19;33
95;19.08.2014;2014;08;18;Tiistai;13;17;30
95;19.08.2014;2014;08;19;Tiistai;9;14;23
95;19.08.2014;2014;08;20;Tiistai;12;8;20
95;19.08.2014;2014;08;21;Tiistai;3;4;7
95;19.08.2014;2014;08;22;Tiistai;2;3;5
95;19.08.2014;2014;08;23;Tiistai;1;0;1
95;20.08.2014;2014;08;00;Keskiviikko;0;0;0
95;20.08.2014;2014;08;01;Keskiviikko;0;0;0
95;20.08.2014;2014;08;02;Keskiviikko;0;0;0
95;20.08.2014;2014;08;03;Keskiviikko;0;0;0
95;20.08.2014;2014;08;04;Keskiviikko;2;0;2
95;20.08.2014;2014;08;05;Keskiviikko;8;5;13
95;20.08.2014;2014;08;06;Keskiviikko;35;17;52
95;20.08.2014;2014;08;07;Keskiviikko;24;34;58
95;20.08.2014;2014;08;08;Keskiviikko;11;11;22
95;20.08.2014;2014;08;09;Keskiviikko;11;12;23
95;20.08.2014;2014;08;10;Keskiviikko;10;13;23
95;20.08.2014;2014;08;11;Keskiviikko;11;11;22
95;20.08.2014;2014;08;12;Keskiviikko;15;11;26
95;20.08.2014;2014;08;13;Keskiviikko;16;13;29
95;20.08.2014;2014;08;14;Keskiviikko;28;11;39
95;20.08.2014;2014;08;15;Keskiviikko;18;32;50
95;20.08.2014;2014;08;16;Keskiviikko;37;33;70
95;20.08.2014;2014;08;17;Keskiviikko;17;39;56
95;20.08.2014;2014;08;18;Keskiviikko;15;17;32
95;20.08.2014;2014;08;19;Keskiviikko;10;9;19
95;20.08.2014;2014;08;20;Keskiviikko;4;5;9
95;20.08.2014;2014;08;21;Keskiviikko;3;4;7
95;20.08.2014;2014;08;22;Keskiviikko;1;3;4
95;20.08.2014;2014;08;23;Keskiviikko;1;1;2
95;21.08.2014;2014;08;00;Torstai;0;0;0
95;21.08.2014;2014;08;01;Torstai;0;0;0
95;21.08.2014;2014;08;02;Torstai;0;0;0
95;21.08.2014;2014;08;03;Torstai;0;0;0
95;21.08.2014;2014;08;04;Torstai;1;0;1
95;21.08.2014;2014;08;05;Torstai;10;2;12
95;21.08.2014;2014;08;06;Torstai;15;12;27
95;21.08.2014;2014;08;07;Torstai;35;23;58
95;21.08.2014;2014;08;08;Torstai;11;14;25
95;21.08.2014;2014;08;09;Torstai;10;11;21
95;21.08.2014;2014;08;10;Torstai;8;6;14
95;21.08.2014;2014;08;11;Torstai;12;10;22
95;21.08.2014;2014;08;12;Torstai;14;12;26
95;21.08.2014;2014;08;13;Torstai;16;15;31
95;21.08.2014;2014;08;14;Torstai;11;20;31
95;21.08.2014;2014;08;15;Torstai;24;30;54
95;21.08.2014;2014;08;16;Torstai;24;31;55
95;21.08.2014;2014;08;17;Torstai;6;13;19
95;21.08.2014;2014;08;18;Torstai;13;16;29
95;21.08.2014;2014;08;19;Torstai;20;13;33
95;21.08.2014;2014;08;20;Torstai;10;11;21
95;21.08.2014;2014;08;21;Torstai;9;8;17
95;21.08.2014;2014;08;22;Torstai;6;3;9
95;21.08.2014;2014;08;23;Torstai;2;1;3
95;22.08.2014;2014;08;00;Perjantai;0;1;1
95;22.08.2014;2014;08;01;Perjantai;0;0;0
95;22.08.2014;2014;08;02;Perjantai;0;1;1
95;22.08.2014;2014;08;03;Perjantai;0;0;0
95;22.08.2014;2014;08;04;Perjantai;1;0;1
95;22.08.2014;2014;08;05;Perjantai;6;3;9
95;22.08.2014;2014;08;06;Perjantai;13;11;24
95;22.08.2014;2014;08;07;Perjantai;25;32;57
95;22.08.2014;2014;08;08;Perjantai;12;11;23
95;22.08.2014;2014;08;09;Perjantai;5;5;10
95;22.08.2014;2014;08;10;Perjantai;11;12;23
95;22.08.2014;2014;08;11;Perjantai;7;9;16
95;22.08.2014;2014;08;12;Perjantai;9;8;17
95;22.08.2014;2014;08;13;Perjantai;13;10;23
95;22.08.2014;2014;08;14;Perjantai;19;13;32
95;22.08.2014;2014;08;15;Perjantai;23;29;52
95;22.08.2014;2014;08;16;Perjantai;24;22;46
95;22.08.2014;2014;08;17;Perjantai;17;16;33
95;22.08.2014;2014;08;18;Perjantai;18;28;46
95;22.08.2014;2014;08;19;Perjantai;19;26;45
95;22.08.2014;2014;08;20;Perjantai;6;14;20
95;22.08.2014;2014;08;21;Perjantai;12;7;19
95;22.08.2014;2014;08;22;Perjantai;4;1;5
95;22.08.2014;2014;08;23;Perjantai;1;0;1
95;23.08.2014;2014;08;00;Lauantai;0;2;2
95;23.08.2014;2014;08;01;Lauantai;0;1;1
95;23.08.2014;2014;08;02;Lauantai;1;0;1
95;23.08.2014;2014;08;03;Lauantai;0;0;0
95;23.08.2014;2014;08;04;Lauantai;0;0;0
95;23.08.2014;2014;08;05;Lauantai;1;0;1
95;23.08.2014;2014;08;06;Lauantai;1;4;5
95;23.08.2014;2014;08;07;Lauantai;3;5;8
95;23.08.2014;2014;08;08;Lauantai;7;5;12
95;23.08.2014;2014;08;09;Lauantai;13;11;24
95;23.08.2014;2014;08;10;Lauantai;23;5;28
95;23.08.2014;2014;08;11;Lauantai;14;10;24
95;23.08.2014;2014;08;12;Lauantai;17;18;35
95;23.08.2014;2014;08;13;Lauantai;10;20;30
95;23.08.2014;2014;08;14;Lauantai;16;22;38
95;23.08.2014;2014;08;15;Lauantai;19;17;36
95;23.08.2014;2014;08;16;Lauantai;18;15;33
95;23.08.2014;2014;08;17;Lauantai;4;16;20
95;23.08.2014;2014;08;18;Lauantai;11;16;27
95;23.08.2014;2014;08;19;Lauantai;8;9;17
95;23.08.2014;2014;08;20;Lauantai;3;8;11
95;23.08.2014;2014;08;21;Lauantai;5;6;11
95;23.08.2014;2014;08;22;Lauantai;0;1;1
95;23.08.2014;2014;08;23;Lauantai;2;1;3
95;24.08.2014;2014;08;00;Sunnuntai;0;0;0
95;24.08.2014;2014;08;01;Sunnuntai;1;0;1
95;24.08.2014;2014;08;02;Sunnuntai;0;0;0
95;24.08.2014;2014;08;03;Sunnuntai;0;0;0
95;24.08.2014;2014;08;04;Sunnuntai;1;0;1
95;24.08.2014;2014;08;05;Sunnuntai;1;0;1
95;24.08.2014;2014;08;06;Sunnuntai;1;2;3
95;24.08.2014;2014;08;07;Sunnuntai;4;4;8
95;24.08.2014;2014;08;08;Sunnuntai;3;6;9
95;24.08.2014;2014;08;09;Sunnuntai;14;5;19
95;24.08.2014;2014;08;10;Sunnuntai;14;28;42
95;24.08.2014;2014;08;11;Sunnuntai;21;23;44
95;24.08.2014;2014;08;12;Sunnuntai;24;23;47
95;24.08.2014;2014;08;13;Sunnuntai;20;22;42
95;24.08.2014;2014;08;14;Sunnuntai;15;16;31
95;24.08.2014;2014;08;15;Sunnuntai;24;4;28
95;24.08.2014;2014;08;16;Sunnuntai;12;12;24
95;24.08.2014;2014;08;17;Sunnuntai;11;12;23
95;24.08.2014;2014;08;18;Sunnuntai;19;14;33
95;24.08.2014;2014;08;19;Sunnuntai;13;12;25
95;24.08.2014;2014;08;20;Sunnuntai;4;3;7
95;24.08.2014;2014;08;21;Sunnuntai;4;3;7
95;24.08.2014;2014;08;22;Sunnuntai;3;4;7
95;24.08.2014;2014;08;23;Sunnuntai;0;0;0
95;25.08.2014;2014;08;00;Maanantai;0;0;0
95;25.08.2014;2014;08;01;Maanantai;0;0;0
95;25.08.2014;2014;08;02;Maanantai;0;0;0
95;25.08.2014;2014;08;03;Maanantai;0;0;0
95;25.08.2014;2014;08;04;Maanantai;4;0;4
95;25.08.2014;2014;08;05;Maanantai;7;3;10
95;25.08.2014;2014;08;06;Maanantai;31;16;47
95;25.08.2014;2014;08;07;Maanantai;41;25;66
95;25.08.2014;2014;08;08;Maanantai;19;17;36
95;25.08.2014;2014;08;09;Maanantai;13;5;18
95;25.08.2014;2014;08;10;Maanantai;25;17;42
95;25.08.2014;2014;08;11;Maanantai;14;18;32
95;25.08.2014;2014;08;12;Maanantai;20;18;38
95;25.08.2014;2014;08;13;Maanantai;15;12;27
95;25.08.2014;2014;08;14;Maanantai;14;15;29
95;25.08.2014;2014;08;15;Maanantai;36;41;77
95;25.08.2014;2014;08;16;Maanantai;39;47;86
95;25.08.2014;2014;08;17;Maanantai;16;30;46
95;25.08.2014;2014;08;18;Maanantai;10;28;38
95;25.08.2014;2014;08;19;Maanantai;16;11;27
95;25.08.2014;2014;08;20;Maanantai;15;11;26
95;25.08.2014;2014;08;21;Maanantai;9;11;20
95;25.08.2014;2014;08;22;Maanantai;2;1;3
95;25.08.2014;2014;08;23;Maanantai;0;2;2
95;26.08.2014;2014;08;00;Tiistai;1;1;2
95;26.08.2014;2014;08;01;Tiistai;0;0;0
95;26.08.2014;2014;08;02;Tiistai;1;0;1
95;26.08.2014;2014;08;03;Tiistai;1;0;1
95;26.08.2014;2014;08;04;Tiistai;2;0;2
95;26.08.2014;2014;08;05;Tiistai;6;5;11
95;26.08.2014;2014;08;06;Tiistai;21;12;33
95;26.08.2014;2014;08;07;Tiistai;26;26;52
95;26.08.2014;2014;08;08;Tiistai;8;12;20
95;26.08.2014;2014;08;09;Tiistai;14;3;17
95;26.08.2014;2014;08;10;Tiistai;11;5;16
95;26.08.2014;2014;08;11;Tiistai;13;9;22
95;26.08.2014;2014;08;12;Tiistai;13;12;25
95;26.08.2014;2014;08;13;Tiistai;10;12;22
95;26.08.2014;2014;08;14;Tiistai;16;10;26
95;26.08.2014;2014;08;15;Tiistai;16;29;45
95;26.08.2014;2014;08;16;Tiistai;20;28;48
95;26.08.2014;2014;08;17;Tiistai;10;13;23
95;26.08.2014;2014;08;18;Tiistai;7;10;17
95;26.08.2014;2014;08;19;Tiistai;6;10;16
95;26.08.2014;2014;08;20;Tiistai;5;4;9
95;26.08.2014;2014;08;21;Tiistai;1;3;4
95;26.08.2014;2014;08;22;Tiistai;3;4;7
95;26.08.2014;2014;08;23;Tiistai;0;1;1
95;27.08.2014;2014;08;00;Keskiviikko;0;1;1
95;27.08.2014;2014;08;01;Keskiviikko;0;1;1
95;27.08.2014;2014;08;02;Keskiviikko;0;0;0
95;27.08.2014;2014;08;03;Keskiviikko;1;0;1
95;27.08.2014;2014;08;04;Keskiviikko;2;0;2
95;27.08.2014;2014;08;05;Keskiviikko;3;3;6
95;27.08.2014;2014;08;06;Keskiviikko;15;12;27
95;27.08.2014;2014;08;07;Keskiviikko;22;23;45
95;27.08.2014;2014;08;08;Keskiviikko;10;10;20
95;27.08.2014;2014;08;09;Keskiviikko;1;3;4
95;27.08.2014;2014;08;10;Keskiviikko;6;4;10
95;27.08.2014;2014;08;11;Keskiviikko;1;2;3
95;27.08.2014;2014;08;12;Keskiviikko;6;4;10
95;27.08.2014;2014;08;13;Keskiviikko;11;5;16
95;27.08.2014;2014;08;14;Keskiviikko;15;7;22
95;27.08.2014;2014;08;15;Keskiviikko;27;25;52
95;27.08.2014;2014;08;16;Keskiviikko;28;23;51
95;27.08.2014;2014;08;17;Keskiviikko;7;27;34
95;27.08.2014;2014;08;18;Keskiviikko;11;9;20
95;27.08.2014;2014;08;19;Keskiviikko;13;9;22
95;27.08.2014;2014;08;20;Keskiviikko;7;4;11
95;27.08.2014;2014;08;21;Keskiviikko;5;4;9
95;27.08.2014;2014;08;22;Keskiviikko;1;1;2
95;27.08.2014;2014;08;23;Keskiviikko;0;0;0
95;28.08.2014;2014;08;00;Torstai;0;1;1
95;28.08.2014;2014;08;01;Torstai;1;1;2
95;28.08.2014;2014;08;02;Torstai;0;0;0
95;28.08.2014;2014;08;03;Torstai;0;0;0
95;28.08.2014;2014;08;04;Torstai;4;0;4
95;28.08.2014;2014;08;05;Torstai;4;6;10
95;28.08.2014;2014;08;06;Torstai;17;18;35
95;28.08.2014;2014;08;07;Torstai;22;17;39
95;28.08.2014;2014;08;08;Torstai;12;18;30
95;28.08.2014;2014;08;09;Torstai;13;10;23
95;28.08.2014;2014;08;10;Torstai;10;15;25
95;28.08.2014;2014;08;11;Torstai;10;7;17
95;28.08.2014;2014;08;12;Torstai;5;7;12
95;28.08.2014;2014;08;13;Torstai;11;9;20
95;28.08.2014;2014;08;14;Torstai;10;10;20
95;28.08.2014;2014;08;15;Torstai;11;22;33
95;28.08.2014;2014;08;16;Torstai;26;25;51
95;28.08.2014;2014;08;17;Torstai;11;13;24
95;28.08.2014;2014;08;18;Torstai;13;11;24
95;28.08.2014;2014;08;19;Torstai;9;11;20
95;28.08.2014;2014;08;20;Torstai;7;9;16
95;28.08.2014;2014;08;21;Torstai;5;4;9
95;28.08.2014;2014;08;22;Torstai;3;2;5
95;28.08.2014;2014;08;23;Torstai;0;0;0
95;29.08.2014;2014;08;00;Perjantai;1;0;1
95;29.08.2014;2014;08;01;Perjantai;0;0;0
95;29.08.2014;2014;08;02;Perjantai;0;0;0
95;29.08.2014;2014;08;03;Perjantai;0;0;0
95;29.08.2014;2014;08;04;Perjantai;3;0;3
95;29.08.2014;2014;08;05;Perjantai;9;6;15
95;29.08.2014;2014;08;06;Perjantai;20;9;29
95;29.08.2014;2014;08;07;Perjantai;30;27;57
95;29.08.2014;2014;08;08;Perjantai;12;8;20
95;29.08.2014;2014;08;09;Perjantai;10;8;18
95;29.08.2014;2014;08;10;Perjantai;11;7;18
95;29.08.2014;2014;08;11;Perjantai;13;9;22
95;29.08.2014;2014;08;12;Perjantai;3;16;19
95;29.08.2014;2014;08;13;Perjantai;15;21;36
95;29.08.2014;2014;08;14;Perjantai;24;13;37
95;29.08.2014;2014;08;15;Perjantai;20;26;46
95;29.08.2014;2014;08;16;Perjantai;18;37;55
95;29.08.2014;2014;08;17;Perjantai;17;15;32
95;29.08.2014;2014;08;18;Perjantai;16;18;34
95;29.08.2014;2014;08;19;Perjantai;12;11;23
95;29.08.2014;2014;08;20;Perjantai;11;9;20
95;29.08.2014;2014;08;21;Perjantai;2;4;6
95;29.08.2014;2014;08;22;Perjantai;0;1;1
95;29.08.2014;2014;08;23;Perjantai;0;0;0
95;30.08.2014;2014;08;00;Lauantai;0;0;0
95;30.08.2014;2014;08;01;Lauantai;0;2;2
95;30.08.2014;2014;08;02;Lauantai;0;3;3
95;30.08.2014;2014;08;03;Lauantai;1;0;1
95;30.08.2014;2014;08;04;Lauantai;1;2;3
95;30.08.2014;2014;08;05;Lauantai;1;0;1
95;30.08.2014;2014;08;06;Lauantai;2;2;4
95;30.08.2014;2014;08;07;Lauantai;4;4;8
95;30.08.2014;2014;08;08;Lauantai;9;9;18
95;30.08.2014;2014;08;09;Lauantai;7;2;9
95;30.08.2014;2014;08;10;Lauantai;13;10;23
95;30.08.2014;2014;08;11;Lauantai;8;17;25
95;30.08.2014;2014;08;12;Lauantai;19;12;31
95;30.08.2014;2014;08;13;Lauantai;9;13;22
95;30.08.2014;2014;08;14;Lauantai;14;13;27
95;30.08.2014;2014;08;15;Lauantai;16;14;30
95;30.08.2014;2014;08;16;Lauantai;22;9;31
95;30.08.2014;2014;08;17;Lauantai;12;11;23
95;30.08.2014;2014;08;18;Lauantai;11;18;29
95;30.08.2014;2014;08;19;Lauantai;14;15;29
95;30.08.2014;2014;08;20;Lauantai;6;6;12
95;30.08.2014;2014;08;21;Lauantai;6;5;11
95;30.08.2014;2014;08;22;Lauantai;2;1;3
95;30.08.2014;2014;08;23;Lauantai;1;0;1
95;31.08.2014;2014;08;00;Sunnuntai;1;1;2
95;31.08.2014;2014;08;01;Sunnuntai;0;1;1
95;31.08.2014;2014;08;02;Sunnuntai;1;1;2
95;31.08.2014;2014;08;03;Sunnuntai;0;1;1
95;31.08.2014;2014;08;04;Sunnuntai;0;1;1
95;31.08.2014;2014;08;05;Sunnuntai;0;1;1
95;31.08.2014;2014;08;06;Sunnuntai;0;2;2
95;31.08.2014;2014;08;07;Sunnuntai;5;1;6
95;31.08.2014;2014;08;08;Sunnuntai;3;4;7
95;31.08.2014;2014;08;09;Sunnuntai;4;5;9
95;31.08.2014;2014;08;10;Sunnuntai;14;21;35
95;31.08.2014;2014;08;11;Sunnuntai;13;15;28
95;31.08.2014;2014;08;12;Sunnuntai;20;9;29
95;31.08.2014;2014;08;13;Sunnuntai;17;15;32
95;31.08.2014;2014;08;14;Sunnuntai;17;20;37
95;31.08.2014;2014;08;15;Sunnuntai;17;27;44
95;31.08.2014;2014;08;16;Sunnuntai;16;11;27
95;31.08.2014;2014;08;17;Sunnuntai;18;16;34
95;31.08.2014;2014;08;18;Sunnuntai;10;14;24
95;31.08.2014;2014;08;19;Sunnuntai;14;15;29
95;31.08.2014;2014;08;20;Sunnuntai;5;5;10
95;31.08.2014;2014;08;21;Sunnuntai;6;5;11
95;31.08.2014;2014;08;22;Sunnuntai;1;1;2
95;31.08.2014;2014;08;23;Sunnuntai;0;0;0
95;01.09.2014;2014;09;00;Maanantai;0;0;0
95;01.09.2014;2014;09;01;Maanantai;0;0;0
95;01.09.2014;2014;09;02;Maanantai;0;0;0
95;01.09.2014;2014;09;03;Maanantai;0;0;0
95;01.09.2014;2014;09;04;Maanantai;1;0;1
95;01.09.2014;2014;09;05;Maanantai;8;2;10
95;01.09.2014;2014;09;06;Maanantai;30;9;39
95;01.09.2014;2014;09;07;Maanantai;27;28;55
95;01.09.2014;2014;09;08;Maanantai;10;10;20
95;01.09.2014;2014;09;09;Maanantai;10;11;21
95;01.09.2014;2014;09;10;Maanantai;12;5;17
95;01.09.2014;2014;09;11;Maanantai;10;10;20
95;01.09.2014;2014;09;12;Maanantai;15;12;27
95;01.09.2014;2014;09;13;Maanantai;8;16;24
95;01.09.2014;2014;09;14;Maanantai;15;12;27
95;01.09.2014;2014;09;15;Maanantai;19;37;56
95;01.09.2014;2014;09;16;Maanantai;39;38;77
95;01.09.2014;2014;09;17;Maanantai;18;20;38
95;01.09.2014;2014;09;18;Maanantai;8;21;29
95;01.09.2014;2014;09;19;Maanantai;12;13;25
95;01.09.2014;2014;09;20;Maanantai;6;6;12
95;01.09.2014;2014;09;21;Maanantai;5;8;13
95;01.09.2014;2014;09;22;Maanantai;3;1;4
95;01.09.2014;2014;09;23;Maanantai;1;0;1
95;02.09.2014;2014;09;00;Tiistai;0;0;0
95;02.09.2014;2014;09;01;Tiistai;0;0;0
95;02.09.2014;2014;09;02;Tiistai;0;0;0
95;02.09.2014;2014;09;03;Tiistai;1;1;2
95;02.09.2014;2014;09;04;Tiistai;1;0;1
95;02.09.2014;2014;09;05;Tiistai;8;3;11
95;02.09.2014;2014;09;06;Tiistai;30;16;46
95;02.09.2014;2014;09;07;Tiistai;37;24;61
95;02.09.2014;2014;09;08;Tiistai;19;12;31
95;02.09.2014;2014;09;09;Tiistai;6;7;13
95;02.09.2014;2014;09;10;Tiistai;13;5;18
95;02.09.2014;2014;09;11;Tiistai;17;55;72
95;02.09.2014;2014;09;12;Tiistai;9;9;18
95;02.09.2014;2014;09;13;Tiistai;10;18;28
95;02.09.2014;2014;09;14;Tiistai;19;15;34
95;02.09.2014;2014;09;15;Tiistai;25;37;62
95;02.09.2014;2014;09;16;Tiistai;21;37;58
95;02.09.2014;2014;09;17;Tiistai;27;30;57
95;02.09.2014;2014;09;18;Tiistai;12;31;43
95;02.09.2014;2014;09;19;Tiistai;12;26;38
95;02.09.2014;2014;09;20;Tiistai;9;20;29
95;02.09.2014;2014;09;21;Tiistai;6;3;9
95;02.09.2014;2014;09;22;Tiistai;2;1;3
95;02.09.2014;2014;09;23;Tiistai;0;0;0
95;03.09.2014;2014;09;00;Keskiviikko;0;0;0
95;03.09.2014;2014;09;01;Keskiviikko;0;0;0
95;03.09.2014;2014;09;02;Keskiviikko;0;1;1
95;03.09.2014;2014;09;03;Keskiviikko;2;0;2
95;03.09.2014;2014;09;04;Keskiviikko;2;1;3
95;03.09.2014;2014;09;05;Keskiviikko;13;4;17
95;03.09.2014;2014;09;06;Keskiviikko;23;14;37
95;03.09.2014;2014;09;07;Keskiviikko;31;28;59
95;03.09.2014;2014;09;08;Keskiviikko;15;17;32
95;03.09.2014;2014;09;09;Keskiviikko;16;18;34
95;03.09.2014;2014;09;10;Keskiviikko;13;11;24
95;03.09.2014;2014;09;11;Keskiviikko;19;8;27
95;03.09.2014;2014;09;12;Keskiviikko;12;8;20
95;03.09.2014;2014;09;13;Keskiviikko;15;12;27
95;03.09.2014;2014;09;14;Keskiviikko;11;12;23
95;03.09.2014;2014;09;15;Keskiviikko;17;30;47
95;03.09.2014;2014;09;16;Keskiviikko;28;41;69
95;03.09.2014;2014;09;17;Keskiviikko;14;25;39
95;03.09.2014;2014;09;18;Keskiviikko;13;17;30
95;03.09.2014;2014;09;19;Keskiviikko;15;19;34
95;03.09.2014;2014;09;20;Keskiviikko;10;5;15
95;03.09.2014;2014;09;21;Keskiviikko;2;3;5
95;03.09.2014;2014;09;22;Keskiviikko;2;2;4
95;03.09.2014;2014;09;23;Keskiviikko;1;0;1
95;04.09.2014;2014;09;00;Torstai;1;0;1
95;04.09.2014;2014;09;01;Torstai;0;0;0
95;04.09.2014;2014;09;02;Torstai;0;0;0
95;04.09.2014;2014;09;03;Torstai;0;0;0
95;04.09.2014;2014;09;04;Torstai;2;1;3
95;04.09.2014;2014;09;05;Torstai;9;3;12
95;04.09.2014;2014;09;06;Torstai;27;14;41
95;04.09.2014;2014;09;07;Torstai;36;21;57
95;04.09.2014;2014;09;08;Torstai;21;15;36
95;04.09.2014;2014;09;09;Torstai;9;8;17
95;04.09.2014;2014;09;10;Torstai;14;10;24
95;04.09.2014;2014;09;11;Torstai;4;4;8
95;04.09.2014;2014;09;12;Torstai;8;13;21
95;04.09.2014;2014;09;13;Torstai;8;16;24
95;04.09.2014;2014;09;14;Torstai;15;16;31
95;04.09.2014;2014;09;15;Torstai;16;34;50
95;04.09.2014;2014;09;16;Torstai;40;47;87
95;04.09.2014;2014;09;17;Torstai;17;22;39
95;04.09.2014;2014;09;18;Torstai;8;24;32
95;04.09.2014;2014;09;19;Torstai;14;22;36
95;04.09.2014;2014;09;20;Torstai;17;6;23
95;04.09.2014;2014;09;21;Torstai;1;8;9
95;04.09.2014;2014;09;22;Torstai;1;2;3
95;04.09.2014;2014;09;23;Torstai;2;0;2
95;05.09.2014;2014;09;00;Perjantai;0;0;0
95;05.09.2014;2014;09;01;Perjantai;0;0;0
95;05.09.2014;2014;09;02;Perjantai;0;0;0
95;05.09.2014;2014;09;03;Perjantai;0;0;0
95;05.09.2014;2014;09;04;Perjantai;1;0;1
95;05.09.2014;2014;09;05;Perjantai;6;5;11
95;05.09.2014;2014;09;06;Perjantai;20;10;30
95;05.09.2014;2014;09;07;Perjantai;31;18;49
95;05.09.2014;2014;09;08;Perjantai;7;13;20
95;05.09.2014;2014;09;09;Perjantai;7;10;17
95;05.09.2014;2014;09;10;Perjantai;14;11;25
95;05.09.2014;2014;09;11;Perjantai;12;9;21
95;05.09.2014;2014;09;12;Perjantai;12;7;19
95;05.09.2014;2014;09;13;Perjantai;18;18;36
95;05.09.2014;2014;09;14;Perjantai;19;19;38
95;05.09.2014;2014;09;15;Perjantai;21;41;62
95;05.09.2014;2014;09;16;Perjantai;25;24;49
95;05.09.2014;2014;09;17;Perjantai;10;22;32
95;05.09.2014;2014;09;18;Perjantai;11;14;25
95;05.09.2014;2014;09;19;Perjantai;8;9;17
95;05.09.2014;2014;09;20;Perjantai;10;8;18
95;05.09.2014;2014;09;21;Perjantai;4;2;6
95;05.09.2014;2014;09;22;Perjantai;2;3;5
95;05.09.2014;2014;09;23;Perjantai;0;2;2
95;06.09.2014;2014;09;00;Lauantai;0;0;0
95;06.09.2014;2014;09;01;Lauantai;1;1;2
95;06.09.2014;2014;09;02;Lauantai;0;0;0
95;06.09.2014;2014;09;03;Lauantai;2;0;2
95;06.09.2014;2014;09;04;Lauantai;1;0;1
95;06.09.2014;2014;09;05;Lauantai;0;0;0
95;06.09.2014;2014;09;06;Lauantai;2;1;3
95;06.09.2014;2014;09;07;Lauantai;1;3;4
95;06.09.2014;2014;09;08;Lauantai;1;7;8
95;06.09.2014;2014;09;09;Lauantai;15;6;21
95;06.09.2014;2014;09;10;Lauantai;3;6;9
95;06.09.2014;2014;09;11;Lauantai;22;13;35
95;06.09.2014;2014;09;12;Lauantai;16;21;37
95;06.09.2014;2014;09;13;Lauantai;14;15;29
95;06.09.2014;2014;09;14;Lauantai;18;26;44
95;06.09.2014;2014;09;15;Lauantai;10;16;26
95;06.09.2014;2014;09;16;Lauantai;14;17;31
95;06.09.2014;2014;09;17;Lauantai;26;17;43
95;06.09.2014;2014;09;18;Lauantai;17;14;31
95;06.09.2014;2014;09;19;Lauantai;13;12;25
95;06.09.2014;2014;09;20;Lauantai;4;4;8
95;06.09.2014;2014;09;21;Lauantai;8;3;11
95;06.09.2014;2014;09;22;Lauantai;1;4;5
95;06.09.2014;2014;09;23;Lauantai;2;0;2
95;07.09.2014;2014;09;00;Sunnuntai;1;3;4
95;07.09.2014;2014;09;01;Sunnuntai;0;0;0
95;07.09.2014;2014;09;02;Sunnuntai;0;0;0
95;07.09.2014;2014;09;03;Sunnuntai;0;0;0
95;07.09.2014;2014;09;04;Sunnuntai;1;0;1
95;07.09.2014;2014;09;05;Sunnuntai;2;0;2
95;07.09.2014;2014;09;06;Sunnuntai;5;1;6
95;07.09.2014;2014;09;07;Sunnuntai;3;6;9
95;07.09.2014;2014;09;08;Sunnuntai;3;4;7
95;07.09.2014;2014;09;09;Sunnuntai;6;9;15
95;07.09.2014;2014;09;10;Sunnuntai;7;22;29
95;07.09.2014;2014;09;11;Sunnuntai;12;9;21
95;07.09.2014;2014;09;12;Sunnuntai;17;24;41
95;07.09.2014;2014;09;13;Sunnuntai;26;24;50
95;07.09.2014;2014;09;14;Sunnuntai;31;20;51
95;07.09.2014;2014;09;15;Sunnuntai;9;27;36
95;07.09.2014;2014;09;16;Sunnuntai;20;17;37
95;07.09.2014;2014;09;17;Sunnuntai;23;19;42
95;07.09.2014;2014;09;18;Sunnuntai;24;18;42
95;07.09.2014;2014;09;19;Sunnuntai;15;17;32
95;07.09.2014;2014;09;20;Sunnuntai;8;7;15
95;07.09.2014;2014;09;21;Sunnuntai;4;3;7
95;07.09.2014;2014;09;22;Sunnuntai;3;4;7
95;07.09.2014;2014;09;23;Sunnuntai;1;0;1
95;08.09.2014;2014;09;00;Maanantai;0;1;1
95;08.09.2014;2014;09;01;Maanantai;0;1;1
95;08.09.2014;2014;09;02;Maanantai;0;0;0
95;08.09.2014;2014;09;03;Maanantai;0;0;0
95;08.09.2014;2014;09;04;Maanantai;1;0;1
95;08.09.2014;2014;09;05;Maanantai;7;7;14
95;08.09.2014;2014;09;06;Maanantai;28;12;40
95;08.09.2014;2014;09;07;Maanantai;30;28;58
95;08.09.2014;2014;09;08;Maanantai;17;16;33
95;08.09.2014;2014;09;09;Maanantai;10;11;21
95;08.09.2014;2014;09;10;Maanantai;10;4;14
95;08.09.2014;2014;09;11;Maanantai;7;7;14
95;08.09.2014;2014;09;12;Maanantai;11;15;26
95;08.09.2014;2014;09;13;Maanantai;14;12;26
95;08.09.2014;2014;09;14;Maanantai;18;12;30
95;08.09.2014;2014;09;15;Maanantai;28;30;58
95;08.09.2014;2014;09;16;Maanantai;37;47;84
95;08.09.2014;2014;09;17;Maanantai;16;24;40
95;08.09.2014;2014;09;18;Maanantai;11;30;41
95;08.09.2014;2014;09;19;Maanantai;19;17;36
95;08.09.2014;2014;09;20;Maanantai;7;4;11
95;08.09.2014;2014;09;21;Maanantai;4;6;10
95;08.09.2014;2014;09;22;Maanantai;2;4;6
95;08.09.2014;2014;09;23;Maanantai;0;3;3
95;09.09.2014;2014;09;00;Tiistai;0;1;1
95;09.09.2014;2014;09;01;Tiistai;0;0;0
95;09.09.2014;2014;09;02;Tiistai;0;0;0
95;09.09.2014;2014;09;03;Tiistai;0;1;1
95;09.09.2014;2014;09;04;Tiistai;1;0;1
95;09.09.2014;2014;09;05;Tiistai;9;2;11
95;09.09.2014;2014;09;06;Tiistai;27;13;40
95;09.09.2014;2014;09;07;Tiistai;31;26;57
95;09.09.2014;2014;09;08;Tiistai;15;14;29
95;09.09.2014;2014;09;09;Tiistai;11;15;26
95;09.09.2014;2014;09;10;Tiistai;18;9;27
95;09.09.2014;2014;09;11;Tiistai;17;12;29
95;09.09.2014;2014;09;12;Tiistai;14;9;23
95;09.09.2014;2014;09;13;Tiistai;8;11;19
95;09.09.2014;2014;09;14;Tiistai;15;21;36
95;09.09.2014;2014;09;15;Tiistai;26;38;64
95;09.09.2014;2014;09;16;Tiistai;22;41;63
95;09.09.2014;2014;09;17;Tiistai;14;17;31
95;09.09.2014;2014;09;18;Tiistai;15;19;34
95;09.09.2014;2014;09;19;Tiistai;14;29;43
95;09.09.2014;2014;09;20;Tiistai;16;9;25
95;09.09.2014;2014;09;21;Tiistai;2;4;6
95;09.09.2014;2014;09;22;Tiistai;3;3;6
95;09.09.2014;2014;09;23;Tiistai;1;0;1
95;10.09.2014;2014;09;00;Keskiviikko;0;1;1
95;10.09.2014;2014;09;01;Keskiviikko;0;0;0
95;10.09.2014;2014;09;02;Keskiviikko;0;1;1
95;10.09.2014;2014;09;03;Keskiviikko;0;0;0
95;10.09.2014;2014;09;04;Keskiviikko;1;0;1
95;10.09.2014;2014;09;05;Keskiviikko;8;5;13
95;10.09.2014;2014;09;06;Keskiviikko;27;13;40
95;10.09.2014;2014;09;07;Keskiviikko;31;17;48
95;10.09.2014;2014;09;08;Keskiviikko;13;14;27
95;10.09.2014;2014;09;09;Keskiviikko;6;10;16
95;10.09.2014;2014;09;10;Keskiviikko;12;3;15
95;10.09.2014;2014;09;11;Keskiviikko;9;12;21
95;10.09.2014;2014;09;12;Keskiviikko;11;6;17
95;10.09.2014;2014;09;13;Keskiviikko;12;11;23
95;10.09.2014;2014;09;14;Keskiviikko;22;18;40
95;10.09.2014;2014;09;15;Keskiviikko;24;28;52
95;10.09.2014;2014;09;16;Keskiviikko;25;46;71
95;10.09.2014;2014;09;17;Keskiviikko;20;24;44
95;10.09.2014;2014;09;18;Keskiviikko;12;13;25
95;10.09.2014;2014;09;19;Keskiviikko;10;17;27
95;10.09.2014;2014;09;20;Keskiviikko;6;8;14
95;10.09.2014;2014;09;21;Keskiviikko;3;2;5
95;10.09.2014;2014;09;22;Keskiviikko;0;2;2
95;10.09.2014;2014;09;23;Keskiviikko;0;2;2
95;11.09.2014;2014;09;00;Torstai;1;0;1
95;11.09.2014;2014;09;01;Torstai;0;0;0
95;11.09.2014;2014;09;02;Torstai;0;0;0
95;11.09.2014;2014;09;03;Torstai;0;0;0
95;11.09.2014;2014;09;04;Torstai;1;0;1
95;11.09.2014;2014;09;05;Torstai;10;3;13
95;11.09.2014;2014;09;06;Torstai;28;18;46
95;11.09.2014;2014;09;07;Torstai;36;20;56
95;11.09.2014;2014;09;08;Torstai;16;17;33
95;11.09.2014;2014;09;09;Torstai;12;10;22
95;11.09.2014;2014;09;10;Torstai;10;5;15
95;11.09.2014;2014;09;11;Torstai;14;7;21
95;11.09.2014;2014;09;12;Torstai;14;9;23
95;11.09.2014;2014;09;13;Torstai;11;8;19
95;11.09.2014;2014;09;14;Torstai;16;18;34
95;11.09.2014;2014;09;15;Torstai;18;33;51
95;11.09.2014;2014;09;16;Torstai;25;32;57
95;11.09.2014;2014;09;17;Torstai;14;19;33
95;11.09.2014;2014;09;18;Torstai;10;21;31
95;11.09.2014;2014;09;19;Torstai;6;14;20
95;11.09.2014;2014;09;20;Torstai;11;2;13
95;11.09.2014;2014;09;21;Torstai;3;4;7
95;11.09.2014;2014;09;22;Torstai;2;2;4
95;11.09.2014;2014;09;23;Torstai;0;2;2
95;12.09.2014;2014;09;00;Perjantai;0;0;0
95;12.09.2014;2014;09;01;Perjantai;0;0;0
95;12.09.2014;2014;09;02;Perjantai;0;0;0
95;12.09.2014;2014;09;03;Perjantai;0;0;0
95;12.09.2014;2014;09;04;Perjantai;2;0;2
95;12.09.2014;2014;09;05;Perjantai;7;3;10
95;12.09.2014;2014;09;06;Perjantai;14;9;23
95;12.09.2014;2014;09;07;Perjantai;19;16;35
95;12.09.2014;2014;09;08;Perjantai;12;10;22
95;12.09.2014;2014;09;09;Perjantai;7;4;11
95;12.09.2014;2014;09;10;Perjantai;5;5;10
95;12.09.2014;2014;09;11;Perjantai;10;4;14
95;12.09.2014;2014;09;12;Perjantai;8;18;26
95;12.09.2014;2014;09;13;Perjantai;20;7;27
95;12.09.2014;2014;09;14;Perjantai;9;21;30
95;12.09.2014;2014;09;15;Perjantai;21;29;50
95;12.09.2014;2014;09;16;Perjantai;18;24;42
95;12.09.2014;2014;09;17;Perjantai;4;17;21
95;12.09.2014;2014;09;18;Perjantai;13;13;26
95;12.09.2014;2014;09;19;Perjantai;16;10;26
95;12.09.2014;2014;09;20;Perjantai;7;9;16
95;12.09.2014;2014;09;21;Perjantai;8;4;12
95;12.09.2014;2014;09;22;Perjantai;0;10;10
95;12.09.2014;2014;09;23;Perjantai;0;0;0
95;13.09.2014;2014;09;00;Lauantai;1;3;4
95;13.09.2014;2014;09;01;Lauantai;1;0;1
95;13.09.2014;2014;09;02;Lauantai;1;0;1
95;13.09.2014;2014;09;03;Lauantai;0;0;0
95;13.09.2014;2014;09;04;Lauantai;2;0;2
95;13.09.2014;2014;09;05;Lauantai;1;1;2
95;13.09.2014;2014;09;06;Lauantai;0;7;7
95;13.09.2014;2014;09;07;Lauantai;5;4;9
95;13.09.2014;2014;09;08;Lauantai;1;8;9
95;13.09.2014;2014;09;09;Lauantai;11;7;18
95;13.09.2014;2014;09;10;Lauantai;8;9;17
95;13.09.2014;2014;09;11;Lauantai;16;11;27
95;13.09.2014;2014;09;12;Lauantai;15;18;33
95;13.09.2014;2014;09;13;Lauantai;27;19;46
95;13.09.2014;2014;09;14;Lauantai;12;13;25
95;13.09.2014;2014;09;15;Lauantai;22;13;35
95;13.09.2014;2014;09;16;Lauantai;11;15;26
95;13.09.2014;2014;09;17;Lauantai;10;18;28
95;13.09.2014;2014;09;18;Lauantai;6;19;25
95;13.09.2014;2014;09;19;Lauantai;5;8;13
95;13.09.2014;2014;09;20;Lauantai;6;8;14
95;13.09.2014;2014;09;21;Lauantai;6;6;12
95;13.09.2014;2014;09;22;Lauantai;2;0;2
95;13.09.2014;2014;09;23;Lauantai;1;0;1
95;14.09.2014;2014;09;00;Sunnuntai;0;2;2
95;14.09.2014;2014;09;01;Sunnuntai;0;1;1
95;14.09.2014;2014;09;02;Sunnuntai;1;1;2
95;14.09.2014;2014;09;03;Sunnuntai;0;0;0
95;14.09.2014;2014;09;04;Sunnuntai;1;0;1
95;14.09.2014;2014;09;05;Sunnuntai;1;0;1
95;14.09.2014;2014;09;06;Sunnuntai;4;1;5
95;14.09.2014;2014;09;07;Sunnuntai;2;2;4
95;14.09.2014;2014;09;08;Sunnuntai;5;1;6
95;14.09.2014;2014;09;09;Sunnuntai;5;10;15
95;14.09.2014;2014;09;10;Sunnuntai;9;17;26
95;14.09.2014;2014;09;11;Sunnuntai;11;15;26
95;14.09.2014;2014;09;12;Sunnuntai;14;21;35
95;14.09.2014;2014;09;13;Sunnuntai;12;20;32
95;14.09.2014;2014;09;14;Sunnuntai;18;17;35
95;14.09.2014;2014;09;15;Sunnuntai;5;19;24
95;14.09.2014;2014;09;16;Sunnuntai;11;7;18
95;14.09.2014;2014;09;17;Sunnuntai;3;17;20
95;14.09.2014;2014;09;18;Sunnuntai;15;12;27
95;14.09.2014;2014;09;19;Sunnuntai;12;13;25
95;14.09.2014;2014;09;20;Sunnuntai;3;6;9
95;14.09.2014;2014;09;21;Sunnuntai;2;5;7
95;14.09.2014;2014;09;22;Sunnuntai;3;1;4
95;14.09.2014;2014;09;23;Sunnuntai;1;1;2
95;15.09.2014;2014;09;00;Maanantai;0;1;1
95;15.09.2014;2014;09;01;Maanantai;0;0;0
95;15.09.2014;2014;09;02;Maanantai;0;0;0
95;15.09.2014;2014;09;03;Maanantai;0;0;0
95;15.09.2014;2014;09;04;Maanantai;2;0;2
95;15.09.2014;2014;09;05;Maanantai;7;3;10
95;15.09.2014;2014;09;06;Maanantai;21;11;32
95;15.09.2014;2014;09;07;Maanantai;38;26;64
95;15.09.2014;2014;09;08;Maanantai;16;12;28
95;15.09.2014;2014;09;09;Maanantai;11;10;21
95;15.09.2014;2014;09;10;Maanantai;8;6;14
95;15.09.2014;2014;09;11;Maanantai;8;8;16
95;15.09.2014;2014;09;12;Maanantai;15;7;22
95;15.09.2014;2014;09;13;Maanantai;16;12;28
95;15.09.2014;2014;09;14;Maanantai;22;21;43
95;15.09.2014;2014;09;15;Maanantai;34;27;61
95;15.09.2014;2014;09;16;Maanantai;33;42;75
95;15.09.2014;2014;09;17;Maanantai;10;28;38
95;15.09.2014;2014;09;18;Maanantai;8;12;20
95;15.09.2014;2014;09;19;Maanantai;9;17;26
95;15.09.2014;2014;09;20;Maanantai;7;4;11
95;15.09.2014;2014;09;21;Maanantai;1;4;5
95;15.09.2014;2014;09;22;Maanantai;2;2;4
95;15.09.2014;2014;09;23;Maanantai;0;1;1
95;16.09.2014;2014;09;00;Tiistai;0;2;2
95;16.09.2014;2014;09;01;Tiistai;0;0;0
95;16.09.2014;2014;09;02;Tiistai;0;0;0
95;16.09.2014;2014;09;03;Tiistai;0;0;0
95;16.09.2014;2014;09;04;Tiistai;2;0;2
95;16.09.2014;2014;09;05;Tiistai;9;5;14
95;16.09.2014;2014;09;06;Tiistai;22;9;31
95;16.09.2014;2014;09;07;Tiistai;31;24;55
95;16.09.2014;2014;09;08;Tiistai;20;16;36
95;16.09.2014;2014;09;09;Tiistai;7;12;19
95;16.09.2014;2014;09;10;Tiistai;8;15;23
95;16.09.2014;2014;09;11;Tiistai;14;9;23
95;16.09.2014;2014;09;12;Tiistai;14;10;24
95;16.09.2014;2014;09;13;Tiistai;11;12;23
95;16.09.2014;2014;09;14;Tiistai;16;14;30
95;16.09.2014;2014;09;15;Tiistai;27;34;61
95;16.09.2014;2014;09;16;Tiistai;32;38;70
95;16.09.2014;2014;09;17;Tiistai;20;28;48
95;16.09.2014;2014;09;18;Tiistai;15;16;31
95;16.09.2014;2014;09;19;Tiistai;17;16;33
95;16.09.2014;2014;09;20;Tiistai;8;4;12
95;16.09.2014;2014;09;21;Tiistai;1;9;10
95;16.09.2014;2014;09;22;Tiistai;1;2;3
95;16.09.2014;2014;09;23;Tiistai;0;1;1
95;17.09.2014;2014;09;00;Keskiviikko;0;3;3
95;17.09.2014;2014;09;01;Keskiviikko;0;0;0
95;17.09.2014;2014;09;02;Keskiviikko;1;0;1
95;17.09.2014;2014;09;03;Keskiviikko;0;0;0
95;17.09.2014;2014;09;04;Keskiviikko;4;0;4
95;17.09.2014;2014;09;05;Keskiviikko;6;4;10
95;17.09.2014;2014;09;06;Keskiviikko;17;11;28
95;17.09.2014;2014;09;07;Keskiviikko;28;25;53
95;17.09.2014;2014;09;08;Keskiviikko;17;13;30
95;17.09.2014;2014;09;09;Keskiviikko;8;11;19
95;17.09.2014;2014;09;10;Keskiviikko;14;7;21
95;17.09.2014;2014;09;11;Keskiviikko;9;11;20
95;17.09.2014;2014;09;12;Keskiviikko;9;3;12
95;17.09.2014;2014;09;13;Keskiviikko;15;17;32
95;17.09.2014;2014;09;14;Keskiviikko;12;13;25
95;17.09.2014;2014;09;15;Keskiviikko;29;23;52
95;17.09.2014;2014;09;16;Keskiviikko;22;30;52
95;17.09.2014;2014;09;17;Keskiviikko;16;20;36
95;17.09.2014;2014;09;18;Keskiviikko;8;15;23
95;17.09.2014;2014;09;19;Keskiviikko;8;14;22
95;17.09.2014;2014;09;20;Keskiviikko;10;11;21
95;17.09.2014;2014;09;21;Keskiviikko;3;3;6
95;17.09.2014;2014;09;22;Keskiviikko;0;4;4
95;17.09.2014;2014;09;23;Keskiviikko;0;1;1
95;18.09.2014;2014;09;00;Torstai;0;0;0
95;18.09.2014;2014;09;01;Torstai;0;0;0
95;18.09.2014;2014;09;02;Torstai;0;0;0
95;18.09.2014;2014;09;03;Torstai;0;0;0
95;18.09.2014;2014;09;04;Torstai;3;0;3
95;18.09.2014;2014;09;05;Torstai;5;4;9
95;18.09.2014;2014;09;06;Torstai;19;10;29
95;18.09.2014;2014;09;07;Torstai;29;18;47
95;18.09.2014;2014;09;08;Torstai;15;10;25
95;18.09.2014;2014;09;09;Torstai;12;8;20
95;18.09.2014;2014;09;10;Torstai;4;6;10
95;18.09.2014;2014;09;11;Torstai;12;7;19
95;18.09.2014;2014;09;12;Torstai;15;8;23
95;18.09.2014;2014;09;13;Torstai;6;13;19
95;18.09.2014;2014;09;14;Torstai;13;13;26
95;18.09.2014;2014;09;15;Torstai;23;28;51
95;18.09.2014;2014;09;16;Torstai;25;31;56
95;18.09.2014;2014;09;17;Torstai;7;21;28
95;18.09.2014;2014;09;18;Torstai;14;19;33
95;18.09.2014;2014;09;19;Torstai;15;10;25
95;18.09.2014;2014;09;20;Torstai;7;2;9
95;18.09.2014;2014;09;21;Torstai;1;3;4
95;18.09.2014;2014;09;22;Torstai;0;3;3
95;18.09.2014;2014;09;23;Torstai;0;2;2
95;19.09.2014;2014;09;00;Perjantai;0;0;0
95;19.09.2014;2014;09;01;Perjantai;0;2;2
95;19.09.2014;2014;09;02;Perjantai;0;0;0
95;19.09.2014;2014;09;03;Perjantai;0;0;0
95;19.09.2014;2014;09;04;Perjantai;2;0;2
95;19.09.2014;2014;09;05;Perjantai;5;3;8
95;19.09.2014;2014;09;06;Perjantai;22;8;30
95;19.09.2014;2014;09;07;Perjantai;23;19;42
95;19.09.2014;2014;09;08;Perjantai;16;9;25
95;19.09.2014;2014;09;09;Perjantai;7;9;16
95;19.09.2014;2014;09;10;Perjantai;13;7;20
95;19.09.2014;2014;09;11;Perjantai;9;7;16
95;19.09.2014;2014;09;12;Perjantai;6;7;13
95;19.09.2014;2014;09;13;Perjantai;14;11;25
95;19.09.2014;2014;09;14;Perjantai;16;10;26
95;19.09.2014;2014;09;15;Perjantai;21;23;44
95;19.09.2014;2014;09;16;Perjantai;10;34;44
95;19.09.2014;2014;09;17;Perjantai;8;6;14
95;19.09.2014;2014;09;18;Perjantai;11;20;31
95;19.09.2014;2014;09;19;Perjantai;10;9;19
95;19.09.2014;2014;09;20;Perjantai;5;7;12
95;19.09.2014;2014;09;21;Perjantai;8;8;16
95;19.09.2014;2014;09;22;Perjantai;1;1;2
95;19.09.2014;2014;09;23;Perjantai;4;0;4
95;20.09.2014;2014;09;00;Lauantai;4;0;4
95;20.09.2014;2014;09;01;Lauantai;0;0;0
95;20.09.2014;2014;09;02;Lauantai;0;0;0
95;20.09.2014;2014;09;03;Lauantai;0;0;0
95;20.09.2014;2014;09;04;Lauantai;1;0;1
95;20.09.2014;2014;09;05;Lauantai;0;0;0
95;20.09.2014;2014;09;06;Lauantai;1;1;2
95;20.09.2014;2014;09;07;Lauantai;2;4;6
95;20.09.2014;2014;09;08;Lauantai;4;5;9
95;20.09.2014;2014;09;09;Lauantai;7;6;13
95;20.09.2014;2014;09;10;Lauantai;13;6;19
95;20.09.2014;2014;09;11;Lauantai;5;8;13
95;20.09.2014;2014;09;12;Lauantai;15;3;18
95;20.09.2014;2014;09;13;Lauantai;6;12;18
95;20.09.2014;2014;09;14;Lauantai;20;14;34
95;20.09.2014;2014;09;15;Lauantai;7;8;15
95;20.09.2014;2014;09;16;Lauantai;8;8;16
95;20.09.2014;2014;09;17;Lauantai;13;9;22
95;20.09.2014;2014;09;18;Lauantai;8;5;13
95;20.09.2014;2014;09;19;Lauantai;1;8;9
95;20.09.2014;2014;09;20;Lauantai;9;9;18
95;20.09.2014;2014;09;21;Lauantai;3;1;4
95;20.09.2014;2014;09;22;Lauantai;4;3;7
95;20.09.2014;2014;09;23;Lauantai;0;0;0
95;21.09.2014;2014;09;00;Sunnuntai;0;0;0
95;21.09.2014;2014;09;01;Sunnuntai;0;0;0
95;21.09.2014;2014;09;02;Sunnuntai;0;2;2
95;21.09.2014;2014;09;03;Sunnuntai;0;2;2
95;21.09.2014;2014;09;04;Sunnuntai;0;0;0
95;21.09.2014;2014;09;05;Sunnuntai;0;0;0
95;21.09.2014;2014;09;06;Sunnuntai;1;0;1
95;21.09.2014;2014;09;07;Sunnuntai;3;2;5
95;21.09.2014;2014;09;08;Sunnuntai;5;3;8
95;21.09.2014;2014;09;09;Sunnuntai;10;12;22
95;21.09.2014;2014;09;10;Sunnuntai;8;15;23
95;21.09.2014;2014;09;11;Sunnuntai;7;13;20
95;21.09.2014;2014;09;12;Sunnuntai;11;5;16
95;21.09.2014;2014;09;13;Sunnuntai;5;10;15
95;21.09.2014;2014;09;14;Sunnuntai;14;21;35
95;21.09.2014;2014;09;15;Sunnuntai;10;9;19
95;21.09.2014;2014;09;16;Sunnuntai;9;10;19
95;21.09.2014;2014;09;17;Sunnuntai;12;15;27
95;21.09.2014;2014;09;18;Sunnuntai;7;8;15
95;21.09.2014;2014;09;19;Sunnuntai;5;2;7
95;21.09.2014;2014;09;20;Sunnuntai;6;3;9
95;21.09.2014;2014;09;21;Sunnuntai;3;1;4
95;21.09.2014;2014;09;22;Sunnuntai;0;0;0
95;21.09.2014;2014;09;23;Sunnuntai;0;0;0
95;22.09.2014;2014;09;00;Maanantai;0;0;0
95;22.09.2014;2014;09;01;Maanantai;0;0;0
95;22.09.2014;2014;09;02;Maanantai;0;0;0
95;22.09.2014;2014;09;03;Maanantai;0;0;0
95;22.09.2014;2014;09;04;Maanantai;0;0;0
95;22.09.2014;2014;09;05;Maanantai;6;3;9
95;22.09.2014;2014;09;06;Maanantai;19;9;28
95;22.09.2014;2014;09;07;Maanantai;22;24;46
95;22.09.2014;2014;09;08;Maanantai;9;10;19
95;22.09.2014;2014;09;09;Maanantai;10;6;16
95;22.09.2014;2014;09;10;Maanantai;4;3;7
95;22.09.2014;2014;09;11;Maanantai;8;4;12
95;22.09.2014;2014;09;12;Maanantai;6;6;12
95;22.09.2014;2014;09;13;Maanantai;7;7;14
95;22.09.2014;2014;09;14;Maanantai;6;10;16
95;22.09.2014;2014;09;15;Maanantai;12;25;37
95;22.09.2014;2014;09;16;Maanantai;26;26;52
95;22.09.2014;2014;09;17;Maanantai;13;14;27
95;22.09.2014;2014;09;18;Maanantai;7;14;21
95;22.09.2014;2014;09;19;Maanantai;7;3;10
95;22.09.2014;2014;09;20;Maanantai;9;4;13
95;22.09.2014;2014;09;21;Maanantai;5;3;8
95;22.09.2014;2014;09;22;Maanantai;0;1;1
95;22.09.2014;2014;09;23;Maanantai;0;1;1
95;23.09.2014;2014;09;00;Tiistai;0;0;0
95;23.09.2014;2014;09;01;Tiistai;0;1;1
95;23.09.2014;2014;09;02;Tiistai;0;0;0
95;23.09.2014;2014;09;03;Tiistai;0;0;0
95;23.09.2014;2014;09;04;Tiistai;1;0;1
95;23.09.2014;2014;09;05;Tiistai;3;4;7
95;23.09.2014;2014;09;06;Tiistai;22;13;35
95;23.09.2014;2014;09;07;Tiistai;18;15;33
95;23.09.2014;2014;09;08;Tiistai;10;13;23
95;23.09.2014;2014;09;09;Tiistai;4;4;8
95;23.09.2014;2014;09;10;Tiistai;10;2;12
95;23.09.2014;2014;09;11;Tiistai;11;4;15
95;23.09.2014;2014;09;12;Tiistai;6;4;10
95;23.09.2014;2014;09;13;Tiistai;14;6;20
95;23.09.2014;2014;09;14;Tiistai;5;7;12
95;23.09.2014;2014;09;15;Tiistai;18;19;37
95;23.09.2014;2014;09;16;Tiistai;14;23;37
95;23.09.2014;2014;09;17;Tiistai;8;13;21
95;23.09.2014;2014;09;18;Tiistai;10;9;19
95;23.09.2014;2014;09;19;Tiistai;5;10;15
95;23.09.2014;2014;09;20;Tiistai;0;3;3
95;23.09.2014;2014;09;21;Tiistai;3;0;3
95;23.09.2014;2014;09;22;Tiistai;0;1;1
95;23.09.2014;2014;09;23;Tiistai;0;1;1
95;24.09.2014;2014;09;00;Keskiviikko;0;0;0
95;24.09.2014;2014;09;01;Keskiviikko;0;0;0
95;24.09.2014;2014;09;02;Keskiviikko;0;0;0
95;24.09.2014;2014;09;03;Keskiviikko;0;0;0
95;24.09.2014;2014;09;04;Keskiviikko;2;0;2
95;24.09.2014;2014;09;05;Keskiviikko;5;3;8
95;24.09.2014;2014;09;06;Keskiviikko;14;7;21
95;24.09.2014;2014;09;07;Keskiviikko;7;11;18
95;24.09.2014;2014;09;08;Keskiviikko;7;10;17
95;24.09.2014;2014;09;09;Keskiviikko;3;5;8
95;24.09.2014;2014;09;10;Keskiviikko;1;1;2
95;24.09.2014;2014;09;11;Keskiviikko;2;1;3
95;24.09.2014;2014;09;12;Keskiviikko;3;0;3
95;24.09.2014;2014;09;13;Keskiviikko;3;3;6
95;24.09.2014;2014;09;14;Keskiviikko;4;9;13
95;24.09.2014;2014;09;15;Keskiviikko;8;8;16
95;24.09.2014;2014;09;16;Keskiviikko;12;8;20
95;24.09.2014;2014;09;17;Keskiviikko;5;7;12
95;24.09.2014;2014;09;18;Keskiviikko;4;1;5
95;24.09.2014;2014;09;19;Keskiviikko;1;4;5
95;24.09.2014;2014;09;20;Keskiviikko;1;2;3
95;24.09.2014;2014;09;21;Keskiviikko;0;1;1
95;24.09.2014;2014;09;22;Keskiviikko;1;0;1
95;24.09.2014;2014;09;23;Keskiviikko;0;1;1
95;25.09.2014;2014;09;00;Torstai;0;0;0
95;25.09.2014;2014;09;01;Torstai;0;0;0
95;25.09.2014;2014;09;02;Torstai;0;0;0
95;25.09.2014;2014;09;03;Torstai;0;0;0
95;25.09.2014;2014;09;04;Torstai;0;0;0
95;25.09.2014;2014;09;05;Torstai;3;4;7
95;25.09.2014;2014;09;06;Torstai;16;8;24
95;25.09.2014;2014;09;07;Torstai;16;15;31
95;25.09.2014;2014;09;08;Torstai;8;7;15
95;25.09.2014;2014;09;09;Torstai;6;9;15
95;25.09.2014;2014;09;10;Torstai;8;2;10
95;25.09.2014;2014;09;11;Torstai;5;5;10
95;25.09.2014;2014;09;12;Torstai;5;4;9
95;25.09.2014;2014;09;13;Torstai;11;11;22
95;25.09.2014;2014;09;14;Torstai;9;7;16
95;25.09.2014;2014;09;15;Torstai;11;18;29
95;25.09.2014;2014;09;16;Torstai;17;23;40
95;25.09.2014;2014;09;17;Torstai;9;14;23
95;25.09.2014;2014;09;18;Torstai;5;10;15
95;25.09.2014;2014;09;19;Torstai;11;7;18
95;25.09.2014;2014;09;20;Torstai;4;2;6
95;25.09.2014;2014;09;21;Torstai;4;0;4
95;25.09.2014;2014;09;22;Torstai;0;2;2
95;25.09.2014;2014;09;23;Torstai;0;1;1
95;26.09.2014;2014;09;00;Perjantai;0;0;0
95;26.09.2014;2014;09;01;Perjantai;0;0;0
95;26.09.2014;2014;09;02;Perjantai;0;0;0
95;26.09.2014;2014;09;03;Perjantai;0;0;0
95;26.09.2014;2014;09;04;Perjantai;0;0;0
95;26.09.2014;2014;09;05;Perjantai;3;6;9
95;26.09.2014;2014;09;06;Perjantai;14;10;24
95;26.09.2014;2014;09;07;Perjantai;14;12;26
95;26.09.2014;2014;09;08;Perjantai;6;9;15
95;26.09.2014;2014;09;09;Perjantai;7;6;13
95;26.09.2014;2014;09;10;Perjantai;3;2;5
95;26.09.2014;2014;09;11;Perjantai;6;4;10
95;26.09.2014;2014;09;12;Perjantai;8;1;9
95;26.09.2014;2014;09;13;Perjantai;6;6;12
95;26.09.2014;2014;09;14;Perjantai;8;4;12
95;26.09.2014;2014;09;15;Perjantai;14;24;38
95;26.09.2014;2014;09;16;Perjantai;19;13;32
95;26.09.2014;2014;09;17;Perjantai;7;9;16
95;26.09.2014;2014;09;18;Perjantai;2;6;8
95;26.09.2014;2014;09;19;Perjantai;3;2;5
95;26.09.2014;2014;09;20;Perjantai;1;1;2
95;26.09.2014;2014;09;21;Perjantai;1;3;4
95;26.09.2014;2014;09;22;Perjantai;0;3;3
95;26.09.2014;2014;09;23;Perjantai;0;0;0
95;27.09.2014;2014;09;00;Lauantai;0;0;0
95;27.09.2014;2014;09;01;Lauantai;0;0;0
95;27.09.2014;2014;09;02;Lauantai;0;0;0
95;27.09.2014;2014;09;03;Lauantai;0;0;0
95;27.09.2014;2014;09;04;Lauantai;1;1;2
95;27.09.2014;2014;09;05;Lauantai;1;0;1
95;27.09.2014;2014;09;06;Lauantai;0;1;1
95;27.09.2014;2014;09;07;Lauantai;4;3;7
95;27.09.2014;2014;09;08;Lauantai;5;5;10
95;27.09.2014;2014;09;09;Lauantai;5;5;10
95;27.09.2014;2014;09;10;Lauantai;5;3;8
95;27.09.2014;2014;09;11;Lauantai;9;12;21
95;27.09.2014;2014;09;12;Lauantai;4;7;11
95;27.09.2014;2014;09;13;Lauantai;7;7;14
95;27.09.2014;2014;09;14;Lauantai;4;3;7
95;27.09.2014;2014;09;15;Lauantai;5;3;8
95;27.09.2014;2014;09;16;Lauantai;7;5;12
95;27.09.2014;2014;09;17;Lauantai;1;4;5
95;27.09.2014;2014;09;18;Lauantai;4;7;11
95;27.09.2014;2014;09;19;Lauantai;2;2;4
95;27.09.2014;2014;09;20;Lauantai;0;1;1
95;27.09.2014;2014;09;21;Lauantai;2;3;5
95;27.09.2014;2014;09;22;Lauantai;0;2;2
95;27.09.2014;2014;09;23;Lauantai;0;0;0
95;28.09.2014;2014;09;00;Sunnuntai;1;1;2
95;28.09.2014;2014;09;01;Sunnuntai;0;0;0
95;28.09.2014;2014;09;02;Sunnuntai;0;0;0
95;28.09.2014;2014;09;03;Sunnuntai;1;0;1
95;28.09.2014;2014;09;04;Sunnuntai;2;0;2
95;28.09.2014;2014;09;05;Sunnuntai;0;0;0
95;28.09.2014;2014;09;06;Sunnuntai;1;1;2
95;28.09.2014;2014;09;07;Sunnuntai;2;0;2
95;28.09.2014;2014;09;08;Sunnuntai;7;5;12
95;28.09.2014;2014;09;09;Sunnuntai;14;7;21
95;28.09.2014;2014;09;10;Sunnuntai;11;12;23
95;28.09.2014;2014;09;11;Sunnuntai;8;18;26
95;28.09.2014;2014;09;12;Sunnuntai;20;5;25
95;28.09.2014;2014;09;13;Sunnuntai;11;15;26
95;28.09.2014;2014;09;14;Sunnuntai;18;10;28
95;28.09.2014;2014;09;15;Sunnuntai;14;14;28
95;28.09.2014;2014;09;16;Sunnuntai;11;7;18
95;28.09.2014;2014;09;17;Sunnuntai;6;5;11
95;28.09.2014;2014;09;18;Sunnuntai;0;7;7
95;28.09.2014;2014;09;19;Sunnuntai;1;4;5
95;28.09.2014;2014;09;20;Sunnuntai;4;3;7
95;28.09.2014;2014;09;21;Sunnuntai;4;1;5
95;28.09.2014;2014;09;22;Sunnuntai;1;2;3
95;28.09.2014;2014;09;23;Sunnuntai;0;1;1
95;29.09.2014;2014;09;00;Maanantai;0;0;0
95;29.09.2014;2014;09;01;Maanantai;0;0;0
95;29.09.2014;2014;09;02;Maanantai;0;0;0
95;29.09.2014;2014;09;03;Maanantai;0;0;0
95;29.09.2014;2014;09;04;Maanantai;2;0;2
95;29.09.2014;2014;09;05;Maanantai;7;1;8
95;29.09.2014;2014;09;06;Maanantai;16;17;33
95;29.09.2014;2014;09;07;Maanantai;22;15;37
95;29.09.2014;2014;09;08;Maanantai;15;9;24
95;29.09.2014;2014;09;09;Maanantai;7;7;14
95;29.09.2014;2014;09;10;Maanantai;14;5;19
95;29.09.2014;2014;09;11;Maanantai;2;10;12
95;29.09.2014;2014;09;12;Maanantai;12;6;18
95;29.09.2014;2014;09;13;Maanantai;12;8;20
95;29.09.2014;2014;09;14;Maanantai;11;10;21
95;29.09.2014;2014;09;15;Maanantai;15;20;35
95;29.09.2014;2014;09;16;Maanantai;14;28;42
95;29.09.2014;2014;09;17;Maanantai;11;16;27
95;29.09.2014;2014;09;18;Maanantai;13;10;23
95;29.09.2014;2014;09;19;Maanantai;7;9;16
95;29.09.2014;2014;09;20;Maanantai;4;0;4
95;29.09.2014;2014;09;21;Maanantai;0;3;3
95;29.09.2014;2014;09;22;Maanantai;1;1;2
95;29.09.2014;2014;09;23;Maanantai;0;1;1
95;30.09.2014;2014;09;00;Tiistai;0;2;2
95;30.09.2014;2014;09;01;Tiistai;0;0;0
95;30.09.2014;2014;09;02;Tiistai;0;0;0
95;30.09.2014;2014;09;03;Tiistai;0;0;0
95;30.09.2014;2014;09;04;Tiistai;1;0;1
95;30.09.2014;2014;09;05;Tiistai;4;2;6
95;30.09.2014;2014;09;06;Tiistai;16;12;28
95;30.09.2014;2014;09;07;Tiistai;19;21;40
95;30.09.2014;2014;09;08;Tiistai;10;8;18
95;30.09.2014;2014;09;09;Tiistai;9;9;18
95;30.09.2014;2014;09;10;Tiistai;8;7;15
95;30.09.2014;2014;09;11;Tiistai;9;8;17
95;30.09.2014;2014;09;12;Tiistai;10;2;12
95;30.09.2014;2014;09;13;Tiistai;13;10;23
95;30.09.2014;2014;09;14;Tiistai;10;11;21
95;30.09.2014;2014;09;15;Tiistai;11;27;38
95;30.09.2014;2014;09;16;Tiistai;25;30;55
95;30.09.2014;2014;09;17;Tiistai;17;8;25
95;30.09.2014;2014;09;18;Tiistai;11;10;21
95;30.09.2014;2014;09;19;Tiistai;8;11;19
95;30.09.2014;2014;09;20;Tiistai;2;4;6
95;30.09.2014;2014;09;21;Tiistai;0;6;6
95;30.09.2014;2014;09;22;Tiistai;1;7;8
95;30.09.2014;2014;09;23;Tiistai;0;1;1
95;01.10.2014;2014;10;00;Keskiviikko;0;1;1
95;01.10.2014;2014;10;01;Keskiviikko;0;0;0
95;01.10.2014;2014;10;02;Keskiviikko;0;0;0
95;01.10.2014;2014;10;03;Keskiviikko;0;0;0
95;01.10.2014;2014;10;04;Keskiviikko;1;1;2
95;01.10.2014;2014;10;05;Keskiviikko;9;4;13
95;01.10.2014;2014;10;06;Keskiviikko;16;10;26
95;01.10.2014;2014;10;07;Keskiviikko;13;15;28
95;01.10.2014;2014;10;08;Keskiviikko;13;10;23
95;01.10.2014;2014;10;09;Keskiviikko;6;3;9
95;01.10.2014;2014;10;10;Keskiviikko;9;8;17
95;01.10.2014;2014;10;11;Keskiviikko;7;6;13
95;01.10.2014;2014;10;12;Keskiviikko;19;14;33
95;01.10.2014;2014;10;13;Keskiviikko;10;8;18
95;01.10.2014;2014;10;14;Keskiviikko;18;10;28
95;01.10.2014;2014;10;15;Keskiviikko;18;27;45
95;01.10.2014;2014;10;16;Keskiviikko;17;25;42
95;01.10.2014;2014;10;17;Keskiviikko;10;18;28
95;01.10.2014;2014;10;18;Keskiviikko;14;13;27
95;01.10.2014;2014;10;19;Keskiviikko;5;9;14
95;01.10.2014;2014;10;20;Keskiviikko;1;1;2
95;01.10.2014;2014;10;21;Keskiviikko;2;4;6
95;01.10.2014;2014;10;22;Keskiviikko;1;4;5
95;01.10.2014;2014;10;23;Keskiviikko;1;2;3
95;02.10.2014;2014;10;00;Torstai;1;0;1
95;02.10.2014;2014;10;01;Torstai;0;1;1
95;02.10.2014;2014;10;02;Torstai;0;0;0
95;02.10.2014;2014;10;03;Torstai;1;0;1
95;02.10.2014;2014;10;04;Torstai;1;0;1
95;02.10.2014;2014;10;05;Torstai;8;2;10
95;02.10.2014;2014;10;06;Torstai;15;13;28
95;02.10.2014;2014;10;07;Torstai;17;13;30
95;02.10.2014;2014;10;08;Torstai;14;9;23
95;02.10.2014;2014;10;09;Torstai;7;7;14
95;02.10.2014;2014;10;10;Torstai;5;7;12
95;02.10.2014;2014;10;11;Torstai;8;4;12
95;02.10.2014;2014;10;12;Torstai;6;2;8
95;02.10.2014;2014;10;13;Torstai;2;5;7
95;02.10.2014;2014;10;14;Torstai;3;4;7
95;02.10.2014;2014;10;15;Torstai;10;23;33
95;02.10.2014;2014;10;16;Torstai;21;15;36
95;02.10.2014;2014;10;17;Torstai;9;17;26
95;02.10.2014;2014;10;18;Torstai;6;13;19
95;02.10.2014;2014;10;19;Torstai;6;6;12
95;02.10.2014;2014;10;20;Torstai;3;2;5
95;02.10.2014;2014;10;21;Torstai;1;1;2
95;02.10.2014;2014;10;22;Torstai;1;3;4
95;02.10.2014;2014;10;23;Torstai;0;0;0
95;03.10.2014;2014;10;00;Perjantai;0;0;0
95;03.10.2014;2014;10;01;Perjantai;0;0;0
95;03.10.2014;2014;10;02;Perjantai;0;0;0
95;03.10.2014;2014;10;03;Perjantai;0;0;0
95;03.10.2014;2014;10;04;Perjantai;2;0;2
95;03.10.2014;2014;10;05;Perjantai;3;3;6
95;03.10.2014;2014;10;06;Perjantai;12;6;18
95;03.10.2014;2014;10;07;Perjantai;14;13;27
95;03.10.2014;2014;10;08;Perjantai;9;7;16
95;03.10.2014;2014;10;09;Perjantai;7;4;11
95;03.10.2014;2014;10;10;Perjantai;4;7;11
95;03.10.2014;2014;10;11;Perjantai;17;6;23
95;03.10.2014;2014;10;12;Perjantai;8;5;13
95;03.10.2014;2014;10;13;Perjantai;9;16;25
95;03.10.2014;2014;10;14;Perjantai;15;20;35
95;03.10.2014;2014;10;15;Perjantai;15;20;35
95;03.10.2014;2014;10;16;Perjantai;9;21;30
95;03.10.2014;2014;10;17;Perjantai;10;16;26
95;03.10.2014;2014;10;18;Perjantai;2;10;12
95;03.10.2014;2014;10;19;Perjantai;7;4;11
95;03.10.2014;2014;10;20;Perjantai;5;1;6
95;03.10.2014;2014;10;21;Perjantai;0;3;3
95;03.10.2014;2014;10;22;Perjantai;0;0;0
95;03.10.2014;2014;10;23;Perjantai;1;0;1
95;04.10.2014;2014;10;00;Lauantai;0;3;3
95;04.10.2014;2014;10;01;Lauantai;2;0;2
95;04.10.2014;2014;10;02;Lauantai;0;0;0
95;04.10.2014;2014;10;03;Lauantai;0;0;0
95;04.10.2014;2014;10;04;Lauantai;0;0;0
95;04.10.2014;2014;10;05;Lauantai;0;0;0
95;04.10.2014;2014;10;06;Lauantai;2;1;3
95;04.10.2014;2014;10;07;Lauantai;2;4;6
95;04.10.2014;2014;10;08;Lauantai;2;0;2
95;04.10.2014;2014;10;09;Lauantai;10;5;15
95;04.10.2014;2014;10;10;Lauantai;14;7;21
95;04.10.2014;2014;10;11;Lauantai;8;3;11
95;04.10.2014;2014;10;12;Lauantai;12;7;19
95;04.10.2014;2014;10;13;Lauantai;7;10;17
95;04.10.2014;2014;10;14;Lauantai;6;6;12
95;04.10.2014;2014;10;15;Lauantai;2;7;9
95;04.10.2014;2014;10;16;Lauantai;9;10;19
95;04.10.2014;2014;10;17;Lauantai;8;12;20
95;04.10.2014;2014;10;18;Lauantai;5;4;9
95;04.10.2014;2014;10;19;Lauantai;3;2;5
95;04.10.2014;2014;10;20;Lauantai;0;1;1
95;04.10.2014;2014;10;21;Lauantai;2;3;5
95;04.10.2014;2014;10;22;Lauantai;2;0;2
95;04.10.2014;2014;10;23;Lauantai;0;1;1
95;05.10.2014;2014;10;00;Sunnuntai;0;0;0
95;05.10.2014;2014;10;01;Sunnuntai;0;0;0
95;05.10.2014;2014;10;02;Sunnuntai;0;0;0
95;05.10.2014;2014;10;03;Sunnuntai;0;0;0
95;05.10.2014;2014;10;04;Sunnuntai;0;0;0
95;05.10.2014;2014;10;05;Sunnuntai;0;1;1
95;05.10.2014;2014;10;06;Sunnuntai;0;2;2
95;05.10.2014;2014;10;07;Sunnuntai;2;2;4
95;05.10.2014;2014;10;08;Sunnuntai;2;3;5
95;05.10.2014;2014;10;09;Sunnuntai;7;3;10
95;05.10.2014;2014;10;10;Sunnuntai;7;9;16
95;05.10.2014;2014;10;11;Sunnuntai;12;4;16
95;05.10.2014;2014;10;12;Sunnuntai;4;11;15
95;05.10.2014;2014;10;13;Sunnuntai;14;8;22
95;05.10.2014;2014;10;14;Sunnuntai;7;9;16
95;05.10.2014;2014;10;15;Sunnuntai;6;6;12
95;05.10.2014;2014;10;16;Sunnuntai;7;6;13
95;05.10.2014;2014;10;17;Sunnuntai;10;11;21
95;05.10.2014;2014;10;18;Sunnuntai;10;7;17
95;05.10.2014;2014;10;19;Sunnuntai;4;3;7
95;05.10.2014;2014;10;20;Sunnuntai;3;0;3
95;05.10.2014;2014;10;21;Sunnuntai;2;1;3
95;05.10.2014;2014;10;22;Sunnuntai;1;2;3
95;05.10.2014;2014;10;23;Sunnuntai;0;0;0
95;06.10.2014;2014;10;00;Maanantai;0;0;0
95;06.10.2014;2014;10;01;Maanantai;0;0;0
95;06.10.2014;2014;10;02;Maanantai;0;0;0
95;06.10.2014;2014;10;03;Maanantai;0;0;0
95;06.10.2014;2014;10;04;Maanantai;1;0;1
95;06.10.2014;2014;10;05;Maanantai;7;4;11
95;06.10.2014;2014;10;06;Maanantai;12;10;22
95;06.10.2014;2014;10;07;Maanantai;18;14;32
95;06.10.2014;2014;10;08;Maanantai;11;13;24
95;06.10.2014;2014;10;09;Maanantai;8;6;14
95;06.10.2014;2014;10;10;Maanantai;6;8;14
95;06.10.2014;2014;10;11;Maanantai;5;6;11
95;06.10.2014;2014;10;12;Maanantai;6;4;10
95;06.10.2014;2014;10;13;Maanantai;12;6;18
95;06.10.2014;2014;10;14;Maanantai;15;11;26
95;06.10.2014;2014;10;15;Maanantai;15;14;29
95;06.10.2014;2014;10;16;Maanantai;18;23;41
95;06.10.2014;2014;10;17;Maanantai;10;12;22
95;06.10.2014;2014;10;18;Maanantai;8;9;17
95;06.10.2014;2014;10;19;Maanantai;2;4;6
95;06.10.2014;2014;10;20;Maanantai;5;4;9
95;06.10.2014;2014;10;21;Maanantai;2;3;5
95;06.10.2014;2014;10;22;Maanantai;0;2;2
95;06.10.2014;2014;10;23;Maanantai;0;0;0
95;07.10.2014;2014;10;00;Tiistai;0;0;0
95;07.10.2014;2014;10;01;Tiistai;0;0;0
95;07.10.2014;2014;10;02;Tiistai;1;0;1
95;07.10.2014;2014;10;03;Tiistai;0;0;0
95;07.10.2014;2014;10;04;Tiistai;3;0;3
95;07.10.2014;2014;10;05;Tiistai;3;3;6
95;07.10.2014;2014;10;06;Tiistai;15;14;29
95;07.10.2014;2014;10;07;Tiistai;15;15;30
95;07.10.2014;2014;10;08;Tiistai;13;11;24
95;07.10.2014;2014;10;09;Tiistai;6;3;9
95;07.10.2014;2014;10;10;Tiistai;5;8;13
95;07.10.2014;2014;10;11;Tiistai;5;2;7
95;07.10.2014;2014;10;12;Tiistai;8;7;15
95;07.10.2014;2014;10;13;Tiistai;9;8;17
95;07.10.2014;2014;10;14;Tiistai;10;6;16
95;07.10.2014;2014;10;15;Tiistai;13;13;26
95;07.10.2014;2014;10;16;Tiistai;17;28;45
95;07.10.2014;2014;10;17;Tiistai;7;14;21
95;07.10.2014;2014;10;18;Tiistai;13;6;19
95;07.10.2014;2014;10;19;Tiistai;7;4;11
95;07.10.2014;2014;10;20;Tiistai;1;2;3
95;07.10.2014;2014;10;21;Tiistai;3;3;6
95;07.10.2014;2014;10;22;Tiistai;1;1;2
95;07.10.2014;2014;10;23;Tiistai;2;3;5
95;08.10.2014;2014;10;00;Keskiviikko;0;1;1
95;08.10.2014;2014;10;01;Keskiviikko;0;0;0
95;08.10.2014;2014;10;02;Keskiviikko;0;0;0
95;08.10.2014;2014;10;03;Keskiviikko;0;0;0
95;08.10.2014;2014;10;04;Keskiviikko;2;1;3
95;08.10.2014;2014;10;05;Keskiviikko;4;3;7
95;08.10.2014;2014;10;06;Keskiviikko;17;14;31
95;08.10.2014;2014;10;07;Keskiviikko;19;17;36
95;08.10.2014;2014;10;08;Keskiviikko;4;8;12
95;08.10.2014;2014;10;09;Keskiviikko;8;9;17
95;08.10.2014;2014;10;10;Keskiviikko;13;5;18
95;08.10.2014;2014;10;11;Keskiviikko;14;7;21
95;08.10.2014;2014;10;12;Keskiviikko;4;4;8
95;08.10.2014;2014;10;13;Keskiviikko;13;7;20
95;08.10.2014;2014;10;14;Keskiviikko;12;10;22
95;08.10.2014;2014;10;15;Keskiviikko;16;18;34
95;08.10.2014;2014;10;16;Keskiviikko;20;27;47
95;08.10.2014;2014;10;17;Keskiviikko;9;16;25
95;08.10.2014;2014;10;18;Keskiviikko;6;7;13
95;08.10.2014;2014;10;19;Keskiviikko;7;4;11
95;08.10.2014;2014;10;20;Keskiviikko;1;1;2
95;08.10.2014;2014;10;21;Keskiviikko;0;4;4
95;08.10.2014;2014;10;22;Keskiviikko;1;1;2
95;08.10.2014;2014;10;23;Keskiviikko;0;0;0
95;09.10.2014;2014;10;00;Torstai;0;0;0
95;09.10.2014;2014;10;01;Torstai;0;0;0
95;09.10.2014;2014;10;02;Torstai;0;0;0
95;09.10.2014;2014;10;03;Torstai;0;1;1
95;09.10.2014;2014;10;04;Torstai;1;2;3
95;09.10.2014;2014;10;05;Torstai;4;4;8
95;09.10.2014;2014;10;06;Torstai;7;7;14
95;09.10.2014;2014;10;07;Torstai;9;10;19
95;09.10.2014;2014;10;08;Torstai;6;8;14
95;09.10.2014;2014;10;09;Torstai;5;4;9
95;09.10.2014;2014;10;10;Torstai;3;1;4
95;09.10.2014;2014;10;11;Torstai;4;6;10
95;09.10.2014;2014;10;12;Torstai;5;1;6
95;09.10.2014;2014;10;13;Torstai;4;2;6
95;09.10.2014;2014;10;14;Torstai;4;7;11
95;09.10.2014;2014;10;15;Torstai;10;13;23
95;09.10.2014;2014;10;16;Torstai;10;15;25
95;09.10.2014;2014;10;17;Torstai;2;0;2
95;09.10.2014;2014;10;18;Torstai;6;2;8
95;09.10.2014;2014;10;19;Torstai;2;5;7
95;09.10.2014;2014;10;20;Torstai;2;3;5
95;09.10.2014;2014;10;21;Torstai;1;3;4
95;09.10.2014;2014;10;22;Torstai;0;0;0
95;09.10.2014;2014;10;23;Torstai;0;1;1
95;10.10.2014;2014;10;00;Perjantai;0;0;0
95;10.10.2014;2014;10;01;Perjantai;0;0;0
95;10.10.2014;2014;10;02;Perjantai;0;0;0
95;10.10.2014;2014;10;03;Perjantai;0;0;0
95;10.10.2014;2014;10;04;Perjantai;2;0;2
95;10.10.2014;2014;10;05;Perjantai;3;4;7
95;10.10.2014;2014;10;06;Perjantai;4;5;9
95;10.10.2014;2014;10;07;Perjantai;6;7;13
95;10.10.2014;2014;10;08;Perjantai;6;5;11
95;10.10.2014;2014;10;09;Perjantai;1;1;2
95;10.10.2014;2014;10;10;Perjantai;2;1;3
95;10.10.2014;2014;10;11;Perjantai;2;0;2
95;10.10.2014;2014;10;12;Perjantai;4;1;5
95;10.10.2014;2014;10;13;Perjantai;4;7;11
95;10.10.2014;2014;10;14;Perjantai;5;5;10
95;10.10.2014;2014;10;15;Perjantai;9;9;18
95;10.10.2014;2014;10;16;Perjantai;7;5;12
95;10.10.2014;2014;10;17;Perjantai;1;5;6
95;10.10.2014;2014;10;18;Perjantai;4;4;8
95;10.10.2014;2014;10;19;Perjantai;1;3;4
95;10.10.2014;2014;10;20;Perjantai;2;1;3
95;10.10.2014;2014;10;21;Perjantai;0;4;4
95;10.10.2014;2014;10;22;Perjantai;0;1;1
95;10.10.2014;2014;10;23;Perjantai;1;0;1
95;11.10.2014;2014;10;00;Lauantai;0;1;1
95;11.10.2014;2014;10;01;Lauantai;3;0;3
95;11.10.2014;2014;10;02;Lauantai;0;0;0
95;11.10.2014;2014;10;03;Lauantai;0;0;0
95;11.10.2014;2014;10;04;Lauantai;1;1;2
95;11.10.2014;2014;10;05;Lauantai;0;0;0
95;11.10.2014;2014;10;06;Lauantai;1;0;1
95;11.10.2014;2014;10;07;Lauantai;0;1;1
95;11.10.2014;2014;10;08;Lauantai;3;2;5
95;11.10.2014;2014;10;09;Lauantai;6;3;9
95;11.10.2014;2014;10;10;Lauantai;1;0;1
95;11.10.2014;2014;10;11;Lauantai;3;4;7
95;11.10.2014;2014;10;12;Lauantai;5;4;9
95;11.10.2014;2014;10;13;Lauantai;8;3;11
95;11.10.2014;2014;10;14;Lauantai;6;3;9
95;11.10.2014;2014;10;15;Lauantai;8;5;13
95;11.10.2014;2014;10;16;Lauantai;6;4;10
95;11.10.2014;2014;10;17;Lauantai;5;11;16
95;11.10.2014;2014;10;18;Lauantai;4;5;9
95;11.10.2014;2014;10;19;Lauantai;1;1;2
95;11.10.2014;2014;10;20;Lauantai;4;1;5
95;11.10.2014;2014;10;21;Lauantai;1;0;1
95;11.10.2014;2014;10;22;Lauantai;1;2;3
95;11.10.2014;2014;10;23;Lauantai;1;1;2
95;12.10.2014;2014;10;00;Sunnuntai;0;0;0
95;12.10.2014;2014;10;01;Sunnuntai;0;0;0
95;12.10.2014;2014;10;02;Sunnuntai;0;0;0
95;12.10.2014;2014;10;03;Sunnuntai;0;0;0
95;12.10.2014;2014;10;04;Sunnuntai;1;2;3
95;12.10.2014;2014;10;05;Sunnuntai;0;0;0
95;12.10.2014;2014;10;06;Sunnuntai;0;1;1
95;12.10.2014;2014;10;07;Sunnuntai;3;1;4
95;12.10.2014;2014;10;08;Sunnuntai;1;3;4
95;12.10.2014;2014;10;09;Sunnuntai;10;10;20
95;12.10.2014;2014;10;10;Sunnuntai;10;6;16
95;12.10.2014;2014;10;11;Sunnuntai;8;7;15
95;12.10.2014;2014;10;12;Sunnuntai;6;14;20
95;12.10.2014;2014;10;13;Sunnuntai;13;11;24
95;12.10.2014;2014;10;14;Sunnuntai;6;9;15
95;12.10.2014;2014;10;15;Sunnuntai;9;4;13
95;12.10.2014;2014;10;16;Sunnuntai;3;2;5
95;12.10.2014;2014;10;17;Sunnuntai;7;5;12
95;12.10.2014;2014;10;18;Sunnuntai;4;5;9
95;12.10.2014;2014;10;19;Sunnuntai;1;1;2
95;12.10.2014;2014;10;20;Sunnuntai;1;1;2
95;12.10.2014;2014;10;21;Sunnuntai;3;1;4
95;12.10.2014;2014;10;22;Sunnuntai;1;1;2
95;12.10.2014;2014;10;23;Sunnuntai;0;1;1
95;13.10.2014;2014;10;00;Maanantai;0;0;0
95;13.10.2014;2014;10;01;Maanantai;0;0;0
95;13.10.2014;2014;10;02;Maanantai;0;1;1
95;13.10.2014;2014;10;03;Maanantai;1;1;2
95;13.10.2014;2014;10;04;Maanantai;2;1;3
95;13.10.2014;2014;10;05;Maanantai;6;3;9
95;13.10.2014;2014;10;06;Maanantai;12;5;17
95;13.10.2014;2014;10;07;Maanantai;13;16;29
95;13.10.2014;2014;10;08;Maanantai;9;6;15
95;13.10.2014;2014;10;09;Maanantai;2;6;8
95;13.10.2014;2014;10;10;Maanantai;6;3;9
95;13.10.2014;2014;10;11;Maanantai;5;4;9
95;13.10.2014;2014;10;12;Maanantai;7;4;11
95;13.10.2014;2014;10;13;Maanantai;8;3;11
95;13.10.2014;2014;10;14;Maanantai;16;7;23
95;13.10.2014;2014;10;15;Maanantai;10;11;21
95;13.10.2014;2014;10;16;Maanantai;13;22;35
95;13.10.2014;2014;10;17;Maanantai;4;12;16
95;13.10.2014;2014;10;18;Maanantai;4;5;9
95;13.10.2014;2014;10;19;Maanantai;1;1;2
95;13.10.2014;2014;10;20;Maanantai;5;4;9
95;13.10.2014;2014;10;21;Maanantai;2;5;7
95;13.10.2014;2014;10;22;Maanantai;0;0;0
95;13.10.2014;2014;10;23;Maanantai;1;1;2
95;14.10.2014;2014;10;00;Tiistai;0;0;0
95;14.10.2014;2014;10;01;Tiistai;0;0;0
95;14.10.2014;2014;10;02;Tiistai;0;0;0
95;14.10.2014;2014;10;03;Tiistai;2;0;2
95;14.10.2014;2014;10;04;Tiistai;2;0;2
95;14.10.2014;2014;10;05;Tiistai;3;2;5
95;14.10.2014;2014;10;06;Tiistai;13;3;16
95;14.10.2014;2014;10;07;Tiistai;11;12;23
95;14.10.2014;2014;10;08;Tiistai;6;4;10
95;14.10.2014;2014;10;09;Tiistai;3;4;7
95;14.10.2014;2014;10;10;Tiistai;4;2;6
95;14.10.2014;2014;10;11;Tiistai;2;3;5
95;14.10.2014;2014;10;12;Tiistai;5;0;5
95;14.10.2014;2014;10;13;Tiistai;5;6;11
95;14.10.2014;2014;10;14;Tiistai;9;6;15
95;14.10.2014;2014;10;15;Tiistai;8;20;28
95;14.10.2014;2014;10;16;Tiistai;11;18;29
95;14.10.2014;2014;10;17;Tiistai;8;6;14
95;14.10.2014;2014;10;18;Tiistai;5;6;11
95;14.10.2014;2014;10;19;Tiistai;3;2;5
95;14.10.2014;2014;10;20;Tiistai;5;2;7
95;14.10.2014;2014;10;21;Tiistai;0;3;3
95;14.10.2014;2014;10;22;Tiistai;2;2;4
95;14.10.2014;2014;10;23;Tiistai;2;1;3
95;15.10.2014;2014;10;00;Keskiviikko;0;0;0
95;15.10.2014;2014;10;01;Keskiviikko;0;0;0
95;15.10.2014;2014;10;02;Keskiviikko;0;0;0
95;15.10.2014;2014;10;03;Keskiviikko;0;0;0
95;15.10.2014;2014;10;04;Keskiviikko;1;0;1
95;15.10.2014;2014;10;05;Keskiviikko;4;2;6
95;15.10.2014;2014;10;06;Keskiviikko;9;6;15
95;15.10.2014;2014;10;07;Keskiviikko;10;8;18
95;15.10.2014;2014;10;08;Keskiviikko;7;9;16
95;15.10.2014;2014;10;09;Keskiviikko;4;2;6
95;15.10.2014;2014;10;10;Keskiviikko;7;2;9
95;15.10.2014;2014;10;11;Keskiviikko;2;2;4
95;15.10.2014;2014;10;12;Keskiviikko;4;3;7
95;15.10.2014;2014;10;13;Keskiviikko;9;7;16
95;15.10.2014;2014;10;14;Keskiviikko;9;11;20
95;15.10.2014;2014;10;15;Keskiviikko;11;18;29
95;15.10.2014;2014;10;16;Keskiviikko;13;17;30
95;15.10.2014;2014;10;17;Keskiviikko;8;14;22
95;15.10.2014;2014;10;18;Keskiviikko;6;6;12
95;15.10.2014;2014;10;19;Keskiviikko;1;2;3
95;15.10.2014;2014;10;20;Keskiviikko;3;3;6
95;15.10.2014;2014;10;21;Keskiviikko;2;3;5
95;15.10.2014;2014;10;22;Keskiviikko;1;1;2
95;15.10.2014;2014;10;23;Keskiviikko;2;1;3
95;16.10.2014;2014;10;00;Torstai;0;0;0
95;16.10.2014;2014;10;01;Torstai;0;0;0
95;16.10.2014;2014;10;02;Torstai;0;0;0
95;16.10.2014;2014;10;03;Torstai;0;0;0
95;16.10.2014;2014;10;04;Torstai;1;0;1
95;16.10.2014;2014;10;05;Torstai;4;2;6
95;16.10.2014;2014;10;06;Torstai;8;6;14
95;16.10.2014;2014;10;07;Torstai;12;11;23
95;16.10.2014;2014;10;08;Torstai;3;6;9
95;16.10.2014;2014;10;09;Torstai;4;3;7
95;16.10.2014;2014;10;10;Torstai;4;3;7
95;16.10.2014;2014;10;11;Torstai;7;2;9
95;16.10.2014;2014;10;12;Torstai;8;2;10
95;16.10.2014;2014;10;13;Torstai;1;8;9
95;16.10.2014;2014;10;14;Torstai;8;7;15
95;16.10.2014;2014;10;15;Torstai;15;12;27
95;16.10.2014;2014;10;16;Torstai;15;13;28
95;16.10.2014;2014;10;17;Torstai;11;7;18
95;16.10.2014;2014;10;18;Torstai;5;10;15
95;16.10.2014;2014;10;19;Torstai;5;6;11
95;16.10.2014;2014;10;20;Torstai;4;5;9
95;16.10.2014;2014;10;21;Torstai;0;2;2
95;16.10.2014;2014;10;22;Torstai;3;5;8
95;16.10.2014;2014;10;23;Torstai;1;1;2
95;17.10.2014;2014;10;00;Perjantai;0;0;0
95;17.10.2014;2014;10;01;Perjantai;0;0;0
95;17.10.2014;2014;10;02;Perjantai;0;0;0
95;17.10.2014;2014;10;03;Perjantai;0;0;0
95;17.10.2014;2014;10;04;Perjantai;3;1;4
95;17.10.2014;2014;10;05;Perjantai;2;2;4
95;17.10.2014;2014;10;06;Perjantai;10;6;16
95;17.10.2014;2014;10;07;Perjantai;4;9;13
95;17.10.2014;2014;10;08;Perjantai;8;6;14
95;17.10.2014;2014;10;09;Perjantai;5;3;8
95;17.10.2014;2014;10;10;Perjantai;4;7;11
95;17.10.2014;2014;10;11;Perjantai;1;4;5
95;17.10.2014;2014;10;12;Perjantai;5;1;6
95;17.10.2014;2014;10;13;Perjantai;10;10;20
95;17.10.2014;2014;10;14;Perjantai;11;11;22
95;17.10.2014;2014;10;15;Perjantai;14;12;26
95;17.10.2014;2014;10;16;Perjantai;8;12;20
95;17.10.2014;2014;10;17;Perjantai;5;8;13
95;17.10.2014;2014;10;18;Perjantai;5;4;9
95;17.10.2014;2014;10;19;Perjantai;6;3;9
95;17.10.2014;2014;10;20;Perjantai;1;1;2
95;17.10.2014;2014;10;21;Perjantai;2;2;4
95;17.10.2014;2014;10;22;Perjantai;0;1;1
95;17.10.2014;2014;10;23;Perjantai;1;2;3
95;18.10.2014;2014;10;00;Lauantai;0;0;0
95;18.10.2014;2014;10;01;Lauantai;0;0;0
95;18.10.2014;2014;10;02;Lauantai;0;0;0
95;18.10.2014;2014;10;03;Lauantai;0;0;0
95;18.10.2014;2014;10;04;Lauantai;1;0;1
95;18.10.2014;2014;10;05;Lauantai;1;0;1
95;18.10.2014;2014;10;06;Lauantai;2;2;4
95;18.10.2014;2014;10;07;Lauantai;2;1;3
95;18.10.2014;2014;10;08;Lauantai;1;1;2
95;18.10.2014;2014;10;09;Lauantai;3;4;7
95;18.10.2014;2014;10;10;Lauantai;3;5;8
95;18.10.2014;2014;10;11;Lauantai;2;2;4
95;18.10.2014;2014;10;12;Lauantai;3;5;8
95;18.10.2014;2014;10;13;Lauantai;5;5;10
95;18.10.2014;2014;10;14;Lauantai;6;4;10
95;18.10.2014;2014;10;15;Lauantai;2;7;9
95;18.10.2014;2014;10;16;Lauantai;7;3;10
95;18.10.2014;2014;10;17;Lauantai;0;4;4
95;18.10.2014;2014;10;18;Lauantai;3;2;5
95;18.10.2014;2014;10;19;Lauantai;2;1;3
95;18.10.2014;2014;10;20;Lauantai;0;1;1
95;18.10.2014;2014;10;21;Lauantai;1;0;1
95;18.10.2014;2014;10;22;Lauantai;1;1;2
95;18.10.2014;2014;10;23;Lauantai;2;0;2
95;19.10.2014;2014;10;00;Sunnuntai;0;1;1
95;19.10.2014;2014;10;01;Sunnuntai;0;0;0
95;19.10.2014;2014;10;02;Sunnuntai;0;0;0
95;19.10.2014;2014;10;03;Sunnuntai;0;0;0
95;19.10.2014;2014;10;04;Sunnuntai;0;0;0
95;19.10.2014;2014;10;05;Sunnuntai;0;0;0
95;19.10.2014;2014;10;06;Sunnuntai;2;0;2
95;19.10.2014;2014;10;07;Sunnuntai;1;0;1
95;19.10.2014;2014;10;08;Sunnuntai;1;1;2
95;19.10.2014;2014;10;09;Sunnuntai;0;0;0
95;19.10.2014;2014;10;10;Sunnuntai;1;1;2
95;19.10.2014;2014;10;11;Sunnuntai;1;0;1
95;19.10.2014;2014;10;12;Sunnuntai;0;2;2
95;19.10.2014;2014;10;13;Sunnuntai;0;2;2
95;19.10.2014;2014;10;14;Sunnuntai;0;0;0
95;19.10.2014;2014;10;15;Sunnuntai;0;6;6
95;19.10.2014;2014;10;16;Sunnuntai;1;0;1
95;19.10.2014;2014;10;17;Sunnuntai;2;1;3
95;19.10.2014;2014;10;18;Sunnuntai;0;3;3
95;19.10.2014;2014;10;19;Sunnuntai;2;3;5
95;19.10.2014;2014;10;20;Sunnuntai;2;1;3
95;19.10.2014;2014;10;21;Sunnuntai;1;1;2
95;19.10.2014;2014;10;22;Sunnuntai;1;0;1
95;19.10.2014;2014;10;23;Sunnuntai;0;0;0
95;20.10.2014;2014;10;00;Maanantai;0;0;0
95;20.10.2014;2014;10;01;Maanantai;0;0;0
95;20.10.2014;2014;10;02;Maanantai;0;0;0
95;20.10.2014;2014;10;03;Maanantai;0;0;0
95;20.10.2014;2014;10;04;Maanantai;1;0;1
95;20.10.2014;2014;10;05;Maanantai;1;3;4
95;20.10.2014;2014;10;06;Maanantai;8;6;14
95;20.10.2014;2014;10;07;Maanantai;4;7;11
95;20.10.2014;2014;10;08;Maanantai;5;3;8
95;20.10.2014;2014;10;09;Maanantai;2;1;3
95;20.10.2014;2014;10;10;Maanantai;6;2;8
95;20.10.2014;2014;10;11;Maanantai;2;4;6
95;20.10.2014;2014;10;12;Maanantai;9;8;17
95;20.10.2014;2014;10;13;Maanantai;7;4;11
95;20.10.2014;2014;10;14;Maanantai;7;4;11
95;20.10.2014;2014;10;15;Maanantai;6;9;15
95;20.10.2014;2014;10;16;Maanantai;19;9;28
95;20.10.2014;2014;10;17;Maanantai;3;5;8
95;20.10.2014;2014;10;18;Maanantai;5;5;10
95;20.10.2014;2014;10;19;Maanantai;1;2;3
95;20.10.2014;2014;10;20;Maanantai;2;1;3
95;20.10.2014;2014;10;21;Maanantai;1;4;5
95;20.10.2014;2014;10;22;Maanantai;0;3;3
95;20.10.2014;2014;10;23;Maanantai;0;1;1
95;21.10.2014;2014;10;00;Tiistai;1;1;2
95;21.10.2014;2014;10;01;Tiistai;0;0;0
95;21.10.2014;2014;10;02;Tiistai;0;0;0
95;21.10.2014;2014;10;03;Tiistai;0;0;0
95;21.10.2014;2014;10;04;Tiistai;1;0;1
95;21.10.2014;2014;10;05;Tiistai;4;2;6
95;21.10.2014;2014;10;06;Tiistai;9;10;19
95;21.10.2014;2014;10;07;Tiistai;6;6;12
95;21.10.2014;2014;10;08;Tiistai;6;2;8
95;21.10.2014;2014;10;09;Tiistai;4;0;4
95;21.10.2014;2014;10;10;Tiistai;1;0;1
95;21.10.2014;2014;10;11;Tiistai;5;3;8
95;21.10.2014;2014;10;12;Tiistai;3;0;3
95;21.10.2014;2014;10;13;Tiistai;4;5;9
95;21.10.2014;2014;10;14;Tiistai;6;3;9
95;21.10.2014;2014;10;15;Tiistai;11;9;20
95;21.10.2014;2014;10;16;Tiistai;9;9;18
95;21.10.2014;2014;10;17;Tiistai;7;8;15
95;21.10.2014;2014;10;18;Tiistai;1;6;7
95;21.10.2014;2014;10;19;Tiistai;3;5;8
95;21.10.2014;2014;10;20;Tiistai;1;1;2
95;21.10.2014;2014;10;21;Tiistai;2;2;4
95;21.10.2014;2014;10;22;Tiistai;0;3;3
95;21.10.2014;2014;10;23;Tiistai;0;1;1
95;22.10.2014;2014;10;00;Keskiviikko;0;0;0
95;22.10.2014;2014;10;01;Keskiviikko;0;0;0
95;22.10.2014;2014;10;02;Keskiviikko;0;0;0
95;22.10.2014;2014;10;03;Keskiviikko;0;0;0
95;22.10.2014;2014;10;04;Keskiviikko;1;0;1
95;22.10.2014;2014;10;05;Keskiviikko;1;2;3
95;22.10.2014;2014;10;06;Keskiviikko;6;5;11
95;22.10.2014;2014;10;07;Keskiviikko;6;2;8
95;22.10.2014;2014;10;08;Keskiviikko;5;5;10
95;22.10.2014;2014;10;09;Keskiviikko;2;3;5
95;22.10.2014;2014;10;10;Keskiviikko;7;6;13
95;22.10.2014;2014;10;11;Keskiviikko;4;3;7
95;22.10.2014;2014;10;12;Keskiviikko;7;2;9
95;22.10.2014;2014;10;13;Keskiviikko;1;8;9
95;22.10.2014;2014;10;14;Keskiviikko;7;4;11
95;22.10.2014;2014;10;15;Keskiviikko;12;8;20
95;22.10.2014;2014;10;16;Keskiviikko;10;11;21
95;22.10.2014;2014;10;17;Keskiviikko;6;10;16
95;22.10.2014;2014;10;18;Keskiviikko;7;3;10
95;22.10.2014;2014;10;19;Keskiviikko;3;3;6
95;22.10.2014;2014;10;20;Keskiviikko;2;2;4
95;22.10.2014;2014;10;21;Keskiviikko;2;1;3
95;22.10.2014;2014;10;22;Keskiviikko;1;3;4
95;22.10.2014;2014;10;23;Keskiviikko;0;1;1
95;23.10.2014;2014;10;00;Torstai;0;0;0
95;23.10.2014;2014;10;01;Torstai;0;0;0
95;23.10.2014;2014;10;02;Torstai;0;0;0
95;23.10.2014;2014;10;03;Torstai;0;0;0
95;23.10.2014;2014;10;04;Torstai;2;0;2
95;23.10.2014;2014;10;05;Torstai;3;3;6
95;23.10.2014;2014;10;06;Torstai;8;7;15
95;23.10.2014;2014;10;07;Torstai;4;4;8
95;23.10.2014;2014;10;08;Torstai;3;3;6
95;23.10.2014;2014;10;09;Torstai;4;1;5
95;23.10.2014;2014;10;10;Torstai;1;2;3
95;23.10.2014;2014;10;11;Torstai;1;2;3
95;23.10.2014;2014;10;12;Torstai;5;3;8
95;23.10.2014;2014;10;13;Torstai;3;4;7
95;23.10.2014;2014;10;14;Torstai;5;2;7
95;23.10.2014;2014;10;15;Torstai;7;7;14
95;23.10.2014;2014;10;16;Torstai;6;7;13
95;23.10.2014;2014;10;17;Torstai;3;7;10
95;23.10.2014;2014;10;18;Torstai;4;3;7
95;23.10.2014;2014;10;19;Torstai;4;5;9
95;23.10.2014;2014;10;20;Torstai;2;2;4
95;23.10.2014;2014;10;21;Torstai;0;0;0
95;23.10.2014;2014;10;22;Torstai;0;1;1
95;23.10.2014;2014;10;23;Torstai;1;1;2
95;24.10.2014;2014;10;00;Perjantai;0;0;0
95;24.10.2014;2014;10;01;Perjantai;0;0;0
95;24.10.2014;2014;10;02;Perjantai;0;0;0
95;24.10.2014;2014;10;03;Perjantai;0;0;0
95;24.10.2014;2014;10;04;Perjantai;2;0;2
95;24.10.2014;2014;10;05;Perjantai;2;3;5
95;24.10.2014;2014;10;06;Perjantai;8;3;11
95;24.10.2014;2014;10;07;Perjantai;3;2;5
95;24.10.2014;2014;10;08;Perjantai;4;0;4
95;24.10.2014;2014;10;09;Perjantai;1;0;1
95;24.10.2014;2014;10;10;Perjantai;1;0;1
95;24.10.2014;2014;10;11;Perjantai;0;1;1
95;24.10.2014;2014;10;12;Perjantai;2;0;2
95;24.10.2014;2014;10;13;Perjantai;0;3;3
95;24.10.2014;2014;10;14;Perjantai;6;4;10
95;24.10.2014;2014;10;15;Perjantai;2;5;7
95;24.10.2014;2014;10;16;Perjantai;3;5;8
95;24.10.2014;2014;10;17;Perjantai;1;1;2
95;24.10.2014;2014;10;18;Perjantai;1;0;1
95;24.10.2014;2014;10;19;Perjantai;0;0;0
95;24.10.2014;2014;10;20;Perjantai;0;1;1
95;24.10.2014;2014;10;21;Perjantai;1;0;1
95;24.10.2014;2014;10;22;Perjantai;1;0;1
95;24.10.2014;2014;10;23;Perjantai;0;0;0
95;25.10.2014;2014;10;00;Lauantai;0;0;0
95;25.10.2014;2014;10;01;Lauantai;0;0;0
95;25.10.2014;2014;10;02;Lauantai;0;0;0
95;25.10.2014;2014;10;03;Lauantai;0;0;0
95;25.10.2014;2014;10;04;Lauantai;1;0;1
95;25.10.2014;2014;10;05;Lauantai;0;0;0
95;25.10.2014;2014;10;06;Lauantai;0;2;2
95;25.10.2014;2014;10;07;Lauantai;0;1;1
95;25.10.2014;2014;10;08;Lauantai;1;0;1
95;25.10.2014;2014;10;09;Lauantai;0;3;3
95;25.10.2014;2014;10;10;Lauantai;0;0;0
95;25.10.2014;2014;10;11;Lauantai;3;2;5
95;25.10.2014;2014;10;12;Lauantai;0;0;0
95;25.10.2014;2014;10;13;Lauantai;3;2;5
95;25.10.2014;2014;10;14;Lauantai;0;2;2
95;25.10.2014;2014;10;15;Lauantai;0;0;0
95;25.10.2014;2014;10;16;Lauantai;0;0;0
95;25.10.2014;2014;10;17;Lauantai;0;3;3
95;25.10.2014;2014;10;18;Lauantai;1;0;1
95;25.10.2014;2014;10;19;Lauantai;1;1;2
95;25.10.2014;2014;10;20;Lauantai;0;0;0
95;25.10.2014;2014;10;21;Lauantai;1;0;1
95;25.10.2014;2014;10;22;Lauantai;0;0;0
95;25.10.2014;2014;10;23;Lauantai;0;0;0
95;26.10.2014;2014;10;00;Sunnuntai;0;1;1
95;26.10.2014;2014;10;01;Sunnuntai;0;0;0
95;26.10.2014;2014;10;02;Sunnuntai;0;0;0
95;26.10.2014;2014;10;03;Sunnuntai;1;0;1
95;26.10.2014;2014;10;04;Sunnuntai;0;0;0
95;26.10.2014;2014;10;05;Sunnuntai;0;0;0
95;26.10.2014;2014;10;06;Sunnuntai;1;0;1
95;26.10.2014;2014;10;07;Sunnuntai;2;0;2
95;26.10.2014;2014;10;08;Sunnuntai;2;4;6
95;26.10.2014;2014;10;09;Sunnuntai;3;3;6
95;26.10.2014;2014;10;10;Sunnuntai;4;2;6
95;26.10.2014;2014;10;11;Sunnuntai;4;3;7
95;26.10.2014;2014;10;12;Sunnuntai;5;4;9
95;26.10.2014;2014;10;13;Sunnuntai;3;3;6
95;26.10.2014;2014;10;14;Sunnuntai;2;4;6
95;26.10.2014;2014;10;15;Sunnuntai;3;3;6
95;26.10.2014;2014;10;16;Sunnuntai;5;3;8
95;26.10.2014;2014;10;17;Sunnuntai;2;2;4
95;26.10.2014;2014;10;18;Sunnuntai;3;6;9
95;26.10.2014;2014;10;19;Sunnuntai;0;1;1
95;26.10.2014;2014;10;20;Sunnuntai;1;1;2
95;26.10.2014;2014;10;21;Sunnuntai;4;1;5
95;26.10.2014;2014;10;22;Sunnuntai;0;0;0
95;26.10.2014;2014;10;23;Sunnuntai;0;0;0
95;27.10.2014;2014;10;00;Maanantai;0;0;0
95;27.10.2014;2014;10;01;Maanantai;0;0;0
95;27.10.2014;2014;10;02;Maanantai;0;0;0
95;27.10.2014;2014;10;03;Maanantai;0;0;0
95;27.10.2014;2014;10;04;Maanantai;2;0;2
95;27.10.2014;2014;10;05;Maanantai;3;1;4
95;27.10.2014;2014;10;06;Maanantai;12;7;19
95;27.10.2014;2014;10;07;Maanantai;11;9;20
95;27.10.2014;2014;10;08;Maanantai;9;11;20
95;27.10.2014;2014;10;09;Maanantai;4;3;7
95;27.10.2014;2014;10;10;Maanantai;9;0;9
95;27.10.2014;2014;10;11;Maanantai;4;3;7
95;27.10.2014;2014;10;12;Maanantai;8;4;12
95;27.10.2014;2014;10;13;Maanantai;10;9;19
95;27.10.2014;2014;10;14;Maanantai;13;10;23
95;27.10.2014;2014;10;15;Maanantai;13;14;27
95;27.10.2014;2014;10;16;Maanantai;12;15;27
95;27.10.2014;2014;10;17;Maanantai;9;13;22
95;27.10.2014;2014;10;18;Maanantai;8;6;14
95;27.10.2014;2014;10;19;Maanantai;1;9;10
95;27.10.2014;2014;10;20;Maanantai;2;1;3
95;27.10.2014;2014;10;21;Maanantai;1;5;6
95;27.10.2014;2014;10;22;Maanantai;3;1;4
95;27.10.2014;2014;10;23;Maanantai;0;1;1
95;28.10.2014;2014;10;00;Tiistai;0;0;0
95;28.10.2014;2014;10;01;Tiistai;0;0;0
95;28.10.2014;2014;10;02;Tiistai;0;0;0
95;28.10.2014;2014;10;03;Tiistai;0;0;0
95;28.10.2014;2014;10;04;Tiistai;2;0;2
95;28.10.2014;2014;10;05;Tiistai;3;1;4
95;28.10.2014;2014;10;06;Tiistai;10;8;18
95;28.10.2014;2014;10;07;Tiistai;12;16;28
95;28.10.2014;2014;10;08;Tiistai;6;11;17
95;28.10.2014;2014;10;09;Tiistai;7;3;10
95;28.10.2014;2014;10;10;Tiistai;2;7;9
95;28.10.2014;2014;10;11;Tiistai;12;5;17
95;28.10.2014;2014;10;12;Tiistai;6;1;7
95;28.10.2014;2014;10;13;Tiistai;7;9;16
95;28.10.2014;2014;10;14;Tiistai;10;1;11
95;28.10.2014;2014;10;15;Tiistai;11;17;28
95;28.10.2014;2014;10;16;Tiistai;13;13;26
95;28.10.2014;2014;10;17;Tiistai;11;7;18
95;28.10.2014;2014;10;18;Tiistai;0;3;3
95;28.10.2014;2014;10;19;Tiistai;5;3;8
95;28.10.2014;2014;10;20;Tiistai;0;3;3
95;28.10.2014;2014;10;21;Tiistai;1;3;4
95;28.10.2014;2014;10;22;Tiistai;3;2;5
95;28.10.2014;2014;10;23;Tiistai;0;1;1
95;29.10.2014;2014;10;00;Keskiviikko;0;0;0
95;29.10.2014;2014;10;01;Keskiviikko;0;0;0
95;29.10.2014;2014;10;02;Keskiviikko;0;0;0
95;29.10.2014;2014;10;03;Keskiviikko;0;0;0
95;29.10.2014;2014;10;04;Keskiviikko;1;0;1
95;29.10.2014;2014;10;05;Keskiviikko;2;1;3
95;29.10.2014;2014;10;06;Keskiviikko;6;4;10
95;29.10.2014;2014;10;07;Keskiviikko;9;7;16
95;29.10.2014;2014;10;08;Keskiviikko;5;5;10
95;29.10.2014;2014;10;09;Keskiviikko;5;3;8
95;29.10.2014;2014;10;10;Keskiviikko;3;2;5
95;29.10.2014;2014;10;11;Keskiviikko;10;5;15
95;29.10.2014;2014;10;12;Keskiviikko;7;8;15
95;29.10.2014;2014;10;13;Keskiviikko;7;6;13
95;29.10.2014;2014;10;14;Keskiviikko;4;5;9
95;29.10.2014;2014;10;15;Keskiviikko;5;9;14
95;29.10.2014;2014;10;16;Keskiviikko;7;8;15
95;29.10.2014;2014;10;17;Keskiviikko;8;5;13
95;29.10.2014;2014;10;18;Keskiviikko;2;6;8
95;29.10.2014;2014;10;19;Keskiviikko;3;7;10
95;29.10.2014;2014;10;20;Keskiviikko;3;2;5
95;29.10.2014;2014;10;21;Keskiviikko;2;3;5
95;29.10.2014;2014;10;22;Keskiviikko;1;2;3
95;29.10.2014;2014;10;23;Keskiviikko;1;1;2
95;30.10.2014;2014;10;00;Torstai;0;1;1
95;30.10.2014;2014;10;01;Torstai;0;0;0
95;30.10.2014;2014;10;02;Torstai;0;0;0
95;30.10.2014;2014;10;03;Torstai;0;0;0
95;30.10.2014;2014;10;04;Torstai;1;1;2
95;30.10.2014;2014;10;05;Torstai;3;1;4
95;30.10.2014;2014;10;06;Torstai;16;7;23
95;30.10.2014;2014;10;07;Torstai;11;7;18
95;30.10.2014;2014;10;08;Torstai;7;7;14
95;30.10.2014;2014;10;09;Torstai;7;5;12
95;30.10.2014;2014;10;10;Torstai;9;4;13
95;30.10.2014;2014;10;11;Torstai;6;7;13
95;30.10.2014;2014;10;12;Torstai;9;6;15
95;30.10.2014;2014;10;13;Torstai;6;15;21
95;30.10.2014;2014;10;14;Torstai;5;4;9
95;30.10.2014;2014;10;15;Torstai;8;11;19
95;30.10.2014;2014;10;16;Torstai;11;13;24
95;30.10.2014;2014;10;17;Torstai;12;13;25
95;30.10.2014;2014;10;18;Torstai;3;6;9
95;30.10.2014;2014;10;19;Torstai;0;1;1
95;30.10.2014;2014;10;20;Torstai;5;9;14
95;30.10.2014;2014;10;21;Torstai;3;4;7
95;30.10.2014;2014;10;22;Torstai;2;2;4
95;30.10.2014;2014;10;23;Torstai;0;1;1
95;31.10.2014;2014;10;00;Perjantai;0;0;0
95;31.10.2014;2014;10;01;Perjantai;0;0;0
95;31.10.2014;2014;10;02;Perjantai;0;0;0
95;31.10.2014;2014;10;03;Perjantai;0;0;0
95;31.10.2014;2014;10;04;Perjantai;1;0;1
95;31.10.2014;2014;10;05;Perjantai;3;1;4
95;31.10.2014;2014;10;06;Perjantai;12;5;17
95;31.10.2014;2014;10;07;Perjantai;7;6;13
95;31.10.2014;2014;10;08;Perjantai;5;7;12
95;31.10.2014;2014;10;09;Perjantai;4;2;6
95;31.10.2014;2014;10;10;Perjantai;3;4;7
95;31.10.2014;2014;10;11;Perjantai;6;1;7
95;31.10.2014;2014;10;12;Perjantai;3;5;8
95;31.10.2014;2014;10;13;Perjantai;12;10;22
95;31.10.2014;2014;10;14;Perjantai;7;8;15
95;31.10.2014;2014;10;15;Perjantai;17;11;28
95;31.10.2014;2014;10;16;Perjantai;4;17;21
95;31.10.2014;2014;10;17;Perjantai;7;4;11
95;31.10.2014;2014;10;18;Perjantai;4;2;6
95;31.10.2014;2014;10;19;Perjantai;4;2;6
95;31.10.2014;2014;10;20;Perjantai;3;8;11
95;31.10.2014;2014;10;21;Perjantai;5;2;7
95;31.10.2014;2014;10;22;Perjantai;1;1;2
95;31.10.2014;2014;10;23;Perjantai;0;2;2
95;01.11.2014;2014;11;00;Lauantai;0;0;0
95;01.11.2014;2014;11;01;Lauantai;0;0;0
95;01.11.2014;2014;11;02;Lauantai;0;1;1
95;01.11.2014;2014;11;03;Lauantai;0;1;1
95;01.11.2014;2014;11;04;Lauantai;0;0;0
95;01.11.2014;2014;11;05;Lauantai;0;0;0
95;01.11.2014;2014;11;06;Lauantai;0;1;1
95;01.11.2014;2014;11;07;Lauantai;0;2;2
95;01.11.2014;2014;11;08;Lauantai;1;0;1
95;01.11.2014;2014;11;09;Lauantai;2;3;5
95;01.11.2014;2014;11;10;Lauantai;5;3;8
95;01.11.2014;2014;11;11;Lauantai;1;3;4
95;01.11.2014;2014;11;12;Lauantai;3;6;9
95;01.11.2014;2014;11;13;Lauantai;4;4;8
95;01.11.2014;2014;11;14;Lauantai;6;5;11
95;01.11.2014;2014;11;15;Lauantai;6;4;10
95;01.11.2014;2014;11;16;Lauantai;6;3;9
95;01.11.2014;2014;11;17;Lauantai;3;4;7
95;01.11.2014;2014;11;18;Lauantai;0;0;0
95;01.11.2014;2014;11;19;Lauantai;0;1;1
95;01.11.2014;2014;11;20;Lauantai;0;0;0
95;01.11.2014;2014;11;21;Lauantai;5;2;7
95;01.11.2014;2014;11;22;Lauantai;0;1;1
95;01.11.2014;2014;11;23;Lauantai;0;0;0
95;02.11.2014;2014;11;00;Sunnuntai;0;0;0
95;02.11.2014;2014;11;01;Sunnuntai;0;0;0
95;02.11.2014;2014;11;02;Sunnuntai;0;0;0
95;02.11.2014;2014;11;03;Sunnuntai;0;0;0
95;02.11.2014;2014;11;04;Sunnuntai;0;0;0
95;02.11.2014;2014;11;05;Sunnuntai;0;0;0
95;02.11.2014;2014;11;06;Sunnuntai;0;0;0
95;02.11.2014;2014;11;07;Sunnuntai;0;1;1
95;02.11.2014;2014;11;08;Sunnuntai;3;1;4
95;02.11.2014;2014;11;09;Sunnuntai;0;0;0
95;02.11.2014;2014;11;10;Sunnuntai;0;3;3
95;02.11.2014;2014;11;11;Sunnuntai;5;0;5
95;02.11.2014;2014;11;12;Sunnuntai;1;1;2
95;02.11.2014;2014;11;13;Sunnuntai;1;1;2
95;02.11.2014;2014;11;14;Sunnuntai;1;2;3
95;02.11.2014;2014;11;15;Sunnuntai;3;1;4
95;02.11.2014;2014;11;16;Sunnuntai;2;1;3
95;02.11.2014;2014;11;17;Sunnuntai;1;0;1
95;02.11.2014;2014;11;18;Sunnuntai;3;7;10
95;02.11.2014;2014;11;19;Sunnuntai;2;1;3
95;02.11.2014;2014;11;20;Sunnuntai;2;0;2
95;02.11.2014;2014;11;21;Sunnuntai;0;0;0
95;02.11.2014;2014;11;22;Sunnuntai;0;0;0
95;02.11.2014;2014;11;23;Sunnuntai;0;0;0
95;03.11.2014;2014;11;00;Maanantai;0;0;0
95;03.11.2014;2014;11;01;Maanantai;0;0;0
95;03.11.2014;2014;11;02;Maanantai;0;0;0
95;03.11.2014;2014;11;03;Maanantai;0;1;1
95;03.11.2014;2014;11;04;Maanantai;2;0;2
95;03.11.2014;2014;11;05;Maanantai;3;2;5
95;03.11.2014;2014;11;06;Maanantai;9;4;13
95;03.11.2014;2014;11;07;Maanantai;8;6;14
95;03.11.2014;2014;11;08;Maanantai;5;7;12
95;03.11.2014;2014;11;09;Maanantai;2;1;3
95;03.11.2014;2014;11;10;Maanantai;4;3;7
95;03.11.2014;2014;11;11;Maanantai;0;1;1
95;03.11.2014;2014;11;12;Maanantai;2;1;3
95;03.11.2014;2014;11;13;Maanantai;1;3;4
95;03.11.2014;2014;11;14;Maanantai;5;4;9
95;03.11.2014;2014;11;15;Maanantai;8;9;17
95;03.11.2014;2014;11;16;Maanantai;9;11;20
95;03.11.2014;2014;11;17;Maanantai;3;9;12
95;03.11.2014;2014;11;18;Maanantai;3;6;9
95;03.11.2014;2014;11;19;Maanantai;2;5;7
95;03.11.2014;2014;11;20;Maanantai;2;0;2
95;03.11.2014;2014;11;21;Maanantai;3;5;8
95;03.11.2014;2014;11;22;Maanantai;1;0;1
95;03.11.2014;2014;11;23;Maanantai;1;0;1
95;04.11.2014;2014;11;00;Tiistai;0;0;0
95;04.11.2014;2014;11;01;Tiistai;0;0;0
95;04.11.2014;2014;11;02;Tiistai;0;0;0
95;04.11.2014;2014;11;03;Tiistai;0;0;0
95;04.11.2014;2014;11;04;Tiistai;1;1;2
95;04.11.2014;2014;11;05;Tiistai;3;1;4
95;04.11.2014;2014;11;06;Tiistai;10;7;17
95;04.11.2014;2014;11;07;Tiistai;8;10;18
95;04.11.2014;2014;11;08;Tiistai;6;4;10
95;04.11.2014;2014;11;09;Tiistai;8;4;12
95;04.11.2014;2014;11;10;Tiistai;6;5;11
95;04.11.2014;2014;11;11;Tiistai;2;8;10
95;04.11.2014;2014;11;12;Tiistai;10;2;12
95;04.11.2014;2014;11;13;Tiistai;1;7;8
95;04.11.2014;2014;11;14;Tiistai;6;4;10
95;04.11.2014;2014;11;15;Tiistai;7;17;24
95;04.11.2014;2014;11;16;Tiistai;12;12;24
95;04.11.2014;2014;11;17;Tiistai;7;5;12
95;04.11.2014;2014;11;18;Tiistai;6;6;12
95;04.11.2014;2014;11;19;Tiistai;0;2;2
95;04.11.2014;2014;11;20;Tiistai;0;2;2
95;04.11.2014;2014;11;21;Tiistai;4;3;7
95;04.11.2014;2014;11;22;Tiistai;0;2;2
95;04.11.2014;2014;11;23;Tiistai;1;0;1
95;05.11.2014;2014;11;00;Keskiviikko;1;1;2
95;05.11.2014;2014;11;01;Keskiviikko;0;0;0
95;05.11.2014;2014;11;02;Keskiviikko;0;0;0
95;05.11.2014;2014;11;03;Keskiviikko;0;0;0
95;05.11.2014;2014;11;04;Keskiviikko;1;0;1
95;05.11.2014;2014;11;05;Keskiviikko;2;1;3
95;05.11.2014;2014;11;06;Keskiviikko;8;6;14
95;05.11.2014;2014;11;07;Keskiviikko;6;9;15
95;05.11.2014;2014;11;08;Keskiviikko;7;4;11
95;05.11.2014;2014;11;09;Keskiviikko;1;2;3
95;05.11.2014;2014;11;10;Keskiviikko;1;0;1
95;05.11.2014;2014;11;11;Keskiviikko;3;3;6
95;05.11.2014;2014;11;12;Keskiviikko;2;2;4
95;05.11.2014;2014;11;13;Keskiviikko;4;3;7
95;05.11.2014;2014;11;14;Keskiviikko;4;2;6
95;05.11.2014;2014;11;15;Keskiviikko;6;4;10
95;05.11.2014;2014;11;16;Keskiviikko;9;12;21
95;05.11.2014;2014;11;17;Keskiviikko;3;4;7
95;05.11.2014;2014;11;18;Keskiviikko;1;6;7
95;05.11.2014;2014;11;19;Keskiviikko;0;1;1
95;05.11.2014;2014;11;20;Keskiviikko;0;2;2
95;05.11.2014;2014;11;21;Keskiviikko;0;4;4
95;05.11.2014;2014;11;22;Keskiviikko;1;0;1
95;05.11.2014;2014;11;23;Keskiviikko;1;2;3
95;06.11.2014;2014;11;00;Torstai;0;0;0
95;06.11.2014;2014;11;01;Torstai;0;0;0
95;06.11.2014;2014;11;02;Torstai;0;0;0
95;06.11.2014;2014;11;03;Torstai;0;0;0
95;06.11.2014;2014;11;04;Torstai;1;0;1
95;06.11.2014;2014;11;05;Torstai;1;3;4
95;06.11.2014;2014;11;06;Torstai;7;3;10
95;06.11.2014;2014;11;07;Torstai;2;11;13
95;06.11.2014;2014;11;08;Torstai;5;3;8
95;06.11.2014;2014;11;09;Torstai;3;2;5
95;06.11.2014;2014;11;10;Torstai;1;0;1
95;06.11.2014;2014;11;11;Torstai;2;4;6
95;06.11.2014;2014;11;12;Torstai;1;1;2
95;06.11.2014;2014;11;13;Torstai;2;4;6
95;06.11.2014;2014;11;14;Torstai;3;4;7
95;06.11.2014;2014;11;15;Torstai;3;4;7
95;06.11.2014;2014;11;16;Torstai;14;7;21
95;06.11.2014;2014;11;17;Torstai;5;5;10
95;06.11.2014;2014;11;18;Torstai;0;0;0
95;06.11.2014;2014;11;19;Torstai;1;1;2
95;06.11.2014;2014;11;20;Torstai;4;4;8
95;06.11.2014;2014;11;21;Torstai;1;3;4
95;06.11.2014;2014;11;22;Torstai;1;1;2
95;06.11.2014;2014;11;23;Torstai;0;0;0
95;07.11.2014;2014;11;00;Perjantai;0;0;0
95;07.11.2014;2014;11;01;Perjantai;0;0;0
95;07.11.2014;2014;11;02;Perjantai;0;0;0
95;07.11.2014;2014;11;03;Perjantai;0;0;0
95;07.11.2014;2014;11;04;Perjantai;1;0;1
95;07.11.2014;2014;11;05;Perjantai;0;2;2
95;07.11.2014;2014;11;06;Perjantai;6;2;8
95;07.11.2014;2014;11;07;Perjantai;0;6;6
95;07.11.2014;2014;11;08;Perjantai;8;2;10
95;07.11.2014;2014;11;09;Perjantai;3;2;5
95;07.11.2014;2014;11;10;Perjantai;2;3;5
95;07.11.2014;2014;11;11;Perjantai;1;2;3
95;07.11.2014;2014;11;12;Perjantai;4;0;4
95;07.11.2014;2014;11;13;Perjantai;9;6;15
95;07.11.2014;2014;11;14;Perjantai;7;4;11
95;07.11.2014;2014;11;15;Perjantai;9;9;18
95;07.11.2014;2014;11;16;Perjantai;4;9;13
95;07.11.2014;2014;11;17;Perjantai;1;4;5
95;07.11.2014;2014;11;18;Perjantai;2;1;3
95;07.11.2014;2014;11;19;Perjantai;0;1;1
95;07.11.2014;2014;11;20;Perjantai;1;1;2
95;07.11.2014;2014;11;21;Perjantai;0;1;1
95;07.11.2014;2014;11;22;Perjantai;1;2;3
95;07.11.2014;2014;11;23;Perjantai;1;1;2
95;08.11.2014;2014;11;00;Lauantai;0;0;0
95;08.11.2014;2014;11;01;Lauantai;0;0;0
95;08.11.2014;2014;11;02;Lauantai;1;0;1
95;08.11.2014;2014;11;03;Lauantai;0;0;0
95;08.11.2014;2014;11;04;Lauantai;1;2;3
95;08.11.2014;2014;11;05;Lauantai;1;0;1
95;08.11.2014;2014;11;06;Lauantai;2;1;3
95;08.11.2014;2014;11;07;Lauantai;0;0;0
95;08.11.2014;2014;11;08;Lauantai;2;0;2
95;08.11.2014;2014;11;09;Lauantai;3;2;5
95;08.11.2014;2014;11;10;Lauantai;1;5;6
95;08.11.2014;2014;11;11;Lauantai;2;3;5
95;08.11.2014;2014;11;12;Lauantai;2;2;4
95;08.11.2014;2014;11;13;Lauantai;3;2;5
95;08.11.2014;2014;11;14;Lauantai;5;5;10
95;08.11.2014;2014;11;15;Lauantai;1;3;4
95;08.11.2014;2014;11;16;Lauantai;2;1;3
95;08.11.2014;2014;11;17;Lauantai;2;3;5
95;08.11.2014;2014;11;18;Lauantai;4;4;8
95;08.11.2014;2014;11;19;Lauantai;0;2;2
95;08.11.2014;2014;11;20;Lauantai;0;1;1
95;08.11.2014;2014;11;21;Lauantai;2;1;3
95;08.11.2014;2014;11;22;Lauantai;0;1;1
95;08.11.2014;2014;11;23;Lauantai;0;0;0
95;09.11.2014;2014;11;00;Sunnuntai;0;0;0
95;09.11.2014;2014;11;01;Sunnuntai;0;0;0
95;09.11.2014;2014;11;02;Sunnuntai;0;0;0
95;09.11.2014;2014;11;03;Sunnuntai;0;0;0
95;09.11.2014;2014;11;04;Sunnuntai;0;0;0
95;09.11.2014;2014;11;05;Sunnuntai;0;0;0
95;09.11.2014;2014;11;06;Sunnuntai;2;0;2
95;09.11.2014;2014;11;07;Sunnuntai;1;3;4
95;09.11.2014;2014;11;08;Sunnuntai;1;0;1
95;09.11.2014;2014;11;09;Sunnuntai;3;2;5
95;09.11.2014;2014;11;10;Sunnuntai;0;0;0
95;09.11.2014;2014;11;11;Sunnuntai;1;2;3
95;09.11.2014;2014;11;12;Sunnuntai;2;0;2
95;09.11.2014;2014;11;13;Sunnuntai;0;3;3
95;09.11.2014;2014;11;14;Sunnuntai;3;2;5
95;09.11.2014;2014;11;15;Sunnuntai;3;1;4
95;09.11.2014;2014;11;16;Sunnuntai;0;4;4
95;09.11.2014;2014;11;17;Sunnuntai;2;1;3
95;09.11.2014;2014;11;18;Sunnuntai;2;3;5
95;09.11.2014;2014;11;19;Sunnuntai;2;1;3
95;09.11.2014;2014;11;20;Sunnuntai;0;1;1
95;09.11.2014;2014;11;21;Sunnuntai;1;0;1
95;09.11.2014;2014;11;22;Sunnuntai;0;2;2
95;09.11.2014;2014;11;23;Sunnuntai;0;0;0
95;10.11.2014;2014;11;00;Maanantai;1;0;1
95;10.11.2014;2014;11;01;Maanantai;0;0;0
95;10.11.2014;2014;11;02;Maanantai;0;0;0
95;10.11.2014;2014;11;03;Maanantai;0;0;0
95;10.11.2014;2014;11;04;Maanantai;1;0;1
95;10.11.2014;2014;11;05;Maanantai;1;2;3
95;10.11.2014;2014;11;06;Maanantai;6;5;11
95;10.11.2014;2014;11;07;Maanantai;5;9;14
95;10.11.2014;2014;11;08;Maanantai;5;5;10
95;10.11.2014;2014;11;09;Maanantai;6;3;9
95;10.11.2014;2014;11;10;Maanantai;6;3;9
95;10.11.2014;2014;11;11;Maanantai;2;4;6
95;10.11.2014;2014;11;12;Maanantai;2;6;8
95;10.11.2014;2014;11;13;Maanantai;6;9;15
95;10.11.2014;2014;11;14;Maanantai;9;8;17
95;10.11.2014;2014;11;15;Maanantai;12;7;19
95;10.11.2014;2014;11;16;Maanantai;16;13;29
95;10.11.2014;2014;11;17;Maanantai;3;7;10
95;10.11.2014;2014;11;18;Maanantai;2;6;8
95;10.11.2014;2014;11;19;Maanantai;4;1;5
95;10.11.2014;2014;11;20;Maanantai;4;7;11
95;10.11.2014;2014;11;21;Maanantai;1;0;1
95;10.11.2014;2014;11;22;Maanantai;2;2;4
95;10.11.2014;2014;11;23;Maanantai;2;0;2
95;11.11.2014;2014;11;00;Tiistai;0;0;0
95;11.11.2014;2014;11;01;Tiistai;0;0;0
95;11.11.2014;2014;11;02;Tiistai;0;0;0
95;11.11.2014;2014;11;03;Tiistai;0;0;0
95;11.11.2014;2014;11;04;Tiistai;0;0;0
95;11.11.2014;2014;11;05;Tiistai;2;2;4
95;11.11.2014;2014;11;06;Tiistai;6;5;11
95;11.11.2014;2014;11;07;Tiistai;5;11;16
95;11.11.2014;2014;11;08;Tiistai;3;4;7
95;11.11.2014;2014;11;09;Tiistai;3;1;4
95;11.11.2014;2014;11;10;Tiistai;0;0;0
95;11.11.2014;2014;11;11;Tiistai;2;1;3
95;11.11.2014;2014;11;12;Tiistai;2;0;2
95;11.11.2014;2014;11;13;Tiistai;2;2;4
95;11.11.2014;2014;11;14;Tiistai;5;3;8
95;11.11.2014;2014;11;15;Tiistai;5;4;9
95;11.11.2014;2014;11;16;Tiistai;13;10;23
95;11.11.2014;2014;11;17;Tiistai;2;3;5
95;11.11.2014;2014;11;18;Tiistai;2;2;4
95;11.11.2014;2014;11;19;Tiistai;1;5;6
95;11.11.2014;2014;11;20;Tiistai;1;3;4
95;11.11.2014;2014;11;21;Tiistai;1;1;2
95;11.11.2014;2014;11;22;Tiistai;1;1;2
95;11.11.2014;2014;11;23;Tiistai;1;0;1
95;12.11.2014;2014;11;00;Keskiviikko;4;0;4
95;12.11.2014;2014;11;01;Keskiviikko;0;0;0
95;12.11.2014;2014;11;02;Keskiviikko;0;0;0
95;12.11.2014;2014;11;03;Keskiviikko;0;0;0
95;12.11.2014;2014;11;04;Keskiviikko;2;0;2
95;12.11.2014;2014;11;05;Keskiviikko;2;3;5
95;12.11.2014;2014;11;06;Keskiviikko;8;7;15
95;12.11.2014;2014;11;07;Keskiviikko;9;9;18
95;12.11.2014;2014;11;08;Keskiviikko;3;5;8
95;12.11.2014;2014;11;09;Keskiviikko;0;6;6
95;12.11.2014;2014;11;10;Keskiviikko;7;1;8
95;12.11.2014;2014;11;11;Keskiviikko;7;2;9
95;12.11.2014;2014;11;12;Keskiviikko;6;3;9
95;12.11.2014;2014;11;13;Keskiviikko;3;8;11
95;12.11.2014;2014;11;14;Keskiviikko;6;5;11
95;12.11.2014;2014;11;15;Keskiviikko;8;11;19
95;12.11.2014;2014;11;16;Keskiviikko;13;14;27
95;12.11.2014;2014;11;17;Keskiviikko;7;6;13
95;12.11.2014;2014;11;18;Keskiviikko;2;1;3
95;12.11.2014;2014;11;19;Keskiviikko;1;3;4
95;12.11.2014;2014;11;20;Keskiviikko;1;2;3
95;12.11.2014;2014;11;21;Keskiviikko;1;1;2
95;12.11.2014;2014;11;22;Keskiviikko;1;2;3
95;12.11.2014;2014;11;23;Keskiviikko;0;0;0
95;13.11.2014;2014;11;00;Torstai;1;0;1
95;13.11.2014;2014;11;01;Torstai;0;0;0
95;13.11.2014;2014;11;02;Torstai;0;0;0
95;13.11.2014;2014;11;03;Torstai;0;0;0
95;13.11.2014;2014;11;04;Torstai;2;0;2
95;13.11.2014;2014;11;05;Torstai;3;2;5
95;13.11.2014;2014;11;06;Torstai;14;8;22
95;13.11.2014;2014;11;07;Torstai;7;13;20
95;13.11.2014;2014;11;08;Torstai;5;4;9
95;13.11.2014;2014;11;09;Torstai;1;2;3
95;13.11.2014;2014;11;10;Torstai;4;3;7
95;13.11.2014;2014;11;11;Torstai;0;3;3
95;13.11.2014;2014;11;12;Torstai;4;3;7
95;13.11.2014;2014;11;13;Torstai;5;5;10
95;13.11.2014;2014;11;14;Torstai;5;7;12
95;13.11.2014;2014;11;15;Torstai;7;8;15
95;13.11.2014;2014;11;16;Torstai;12;7;19
95;13.11.2014;2014;11;17;Torstai;5;6;11
95;13.11.2014;2014;11;18;Torstai;3;4;7
95;13.11.2014;2014;11;19;Torstai;2;3;5
95;13.11.2014;2014;11;20;Torstai;4;0;4
95;13.11.2014;2014;11;21;Torstai;1;3;4
95;13.11.2014;2014;11;22;Torstai;1;1;2
95;13.11.2014;2014;11;23;Torstai;0;0;0
95;14.11.2014;2014;11;00;Perjantai;3;0;3
95;14.11.2014;2014;11;01;Perjantai;0;0;0
95;14.11.2014;2014;11;02;Perjantai;0;0;0
95;14.11.2014;2014;11;03;Perjantai;0;0;0
95;14.11.2014;2014;11;04;Perjantai;1;0;1
95;14.11.2014;2014;11;05;Perjantai;1;1;2
95;14.11.2014;2014;11;06;Perjantai;5;4;9
95;14.11.2014;2014;11;07;Perjantai;5;11;16
95;14.11.2014;2014;11;08;Perjantai;7;2;9
95;14.11.2014;2014;11;09;Perjantai;8;1;9
95;14.11.2014;2014;11;10;Perjantai;5;4;9
95;14.11.2014;2014;11;11;Perjantai;1;5;6
95;14.11.2014;2014;11;12;Perjantai;3;2;5
95;14.11.2014;2014;11;13;Perjantai;7;5;12
95;14.11.2014;2014;11;14;Perjantai;5;10;15
95;14.11.2014;2014;11;15;Perjantai;5;5;10
95;14.11.2014;2014;11;16;Perjantai;4;9;13
95;14.11.2014;2014;11;17;Perjantai;6;3;9
95;14.11.2014;2014;11;18;Perjantai;0;6;6
95;14.11.2014;2014;11;19;Perjantai;2;2;4
95;14.11.2014;2014;11;20;Perjantai;5;0;5
95;14.11.2014;2014;11;21;Perjantai;1;5;6
95;14.11.2014;2014;11;22;Perjantai;0;0;0
95;14.11.2014;2014;11;23;Perjantai;0;0;0
95;15.11.2014;2014;11;00;Lauantai;2;0;2
95;15.11.2014;2014;11;01;Lauantai;0;0;0
95;15.11.2014;2014;11;02;Lauantai;0;0;0
95;15.11.2014;2014;11;03;Lauantai;0;0;0
95;15.11.2014;2014;11;04;Lauantai;1;0;1
95;15.11.2014;2014;11;05;Lauantai;0;0;0
95;15.11.2014;2014;11;06;Lauantai;0;1;1
95;15.11.2014;2014;11;07;Lauantai;0;1;1
95;15.11.2014;2014;11;08;Lauantai;4;1;5
95;15.11.2014;2014;11;09;Lauantai;3;2;5
95;15.11.2014;2014;11;10;Lauantai;1;4;5
95;15.11.2014;2014;11;11;Lauantai;3;3;6
95;15.11.2014;2014;11;12;Lauantai;3;2;5
95;15.11.2014;2014;11;13;Lauantai;1;3;4
95;15.11.2014;2014;11;14;Lauantai;4;2;6
95;15.11.2014;2014;11;15;Lauantai;3;2;5
95;15.11.2014;2014;11;16;Lauantai;4;4;8
95;15.11.2014;2014;11;17;Lauantai;1;8;9
95;15.11.2014;2014;11;18;Lauantai;5;5;10
95;15.11.2014;2014;11;19;Lauantai;1;1;2
95;15.11.2014;2014;11;20;Lauantai;0;0;0
95;15.11.2014;2014;11;21;Lauantai;2;0;2
95;15.11.2014;2014;11;22;Lauantai;1;0;1
95;15.11.2014;2014;11;23;Lauantai;0;0;0
95;16.11.2014;2014;11;00;Sunnuntai;1;0;1
95;16.11.2014;2014;11;01;Sunnuntai;0;0;0
95;16.11.2014;2014;11;02;Sunnuntai;0;0;0
95;16.11.2014;2014;11;03;Sunnuntai;0;0;0
95;16.11.2014;2014;11;04;Sunnuntai;0;0;0
95;16.11.2014;2014;11;05;Sunnuntai;0;0;0
95;16.11.2014;2014;11;06;Sunnuntai;0;1;1
95;16.11.2014;2014;11;07;Sunnuntai;1;0;1
95;16.11.2014;2014;11;08;Sunnuntai;1;2;3
95;16.11.2014;2014;11;09;Sunnuntai;3;2;5
95;16.11.2014;2014;11;10;Sunnuntai;0;0;0
95;16.11.2014;2014;11;11;Sunnuntai;2;2;4
95;16.11.2014;2014;11;12;Sunnuntai;3;3;6
95;16.11.2014;2014;11;13;Sunnuntai;3;5;8
95;16.11.2014;2014;11;14;Sunnuntai;4;1;5
95;16.11.2014;2014;11;15;Sunnuntai;2;3;5
95;16.11.2014;2014;11;16;Sunnuntai;3;3;6
95;16.11.2014;2014;11;17;Sunnuntai;7;4;11
95;16.11.2014;2014;11;18;Sunnuntai;5;5;10
95;16.11.2014;2014;11;19;Sunnuntai;1;3;4
95;16.11.2014;2014;11;20;Sunnuntai;0;1;1
95;16.11.2014;2014;11;21;Sunnuntai;1;0;1
95;16.11.2014;2014;11;22;Sunnuntai;1;1;2
95;16.11.2014;2014;11;23;Sunnuntai;0;0;0
95;17.11.2014;2014;11;00;Maanantai;0;0;0
95;17.11.2014;2014;11;01;Maanantai;0;0;0
95;17.11.2014;2014;11;02;Maanantai;0;0;0
95;17.11.2014;2014;11;03;Maanantai;0;0;0
95;17.11.2014;2014;11;04;Maanantai;1;0;1
95;17.11.2014;2014;11;05;Maanantai;1;3;4
95;17.11.2014;2014;11;06;Maanantai;7;3;10
95;17.11.2014;2014;11;07;Maanantai;11;7;18
95;17.11.2014;2014;11;08;Maanantai;5;5;10
95;17.11.2014;2014;11;09;Maanantai;3;3;6
95;17.11.2014;2014;11;10;Maanantai;4;2;6
95;17.11.2014;2014;11;11;Maanantai;3;5;8
95;17.11.2014;2014;11;12;Maanantai;1;2;3
95;17.11.2014;2014;11;13;Maanantai;4;4;8
95;17.11.2014;2014;11;14;Maanantai;6;2;8
95;17.11.2014;2014;11;15;Maanantai;16;6;22
95;17.11.2014;2014;11;16;Maanantai;7;9;16
95;17.11.2014;2014;11;17;Maanantai;4;9;13
95;17.11.2014;2014;11;18;Maanantai;2;8;10
95;17.11.2014;2014;11;19;Maanantai;3;0;3
95;17.11.2014;2014;11;20;Maanantai;3;3;6
95;17.11.2014;2014;11;21;Maanantai;0;2;2
95;17.11.2014;2014;11;22;Maanantai;3;2;5
95;17.11.2014;2014;11;23;Maanantai;0;2;2
95;18.11.2014;2014;11;00;Tiistai;0;1;1
95;18.11.2014;2014;11;01;Tiistai;0;0;0
95;18.11.2014;2014;11;02;Tiistai;0;0;0
95;18.11.2014;2014;11;03;Tiistai;0;0;0
95;18.11.2014;2014;11;04;Tiistai;0;0;0
95;18.11.2014;2014;11;05;Tiistai;0;4;4
95;18.11.2014;2014;11;06;Tiistai;11;3;14
95;18.11.2014;2014;11;07;Tiistai;7;9;16
95;18.11.2014;2014;11;08;Tiistai;6;3;9
95;18.11.2014;2014;11;09;Tiistai;1;1;2
95;18.11.2014;2014;11;10;Tiistai;2;4;6
95;18.11.2014;2014;11;11;Tiistai;3;4;7
95;18.11.2014;2014;11;12;Tiistai;5;4;9
95;18.11.2014;2014;11;13;Tiistai;6;4;10
95;18.11.2014;2014;11;14;Tiistai;8;3;11
95;18.11.2014;2014;11;15;Tiistai;7;3;10
95;18.11.2014;2014;11;16;Tiistai;13;11;24
95;18.11.2014;2014;11;17;Tiistai;3;3;6
95;18.11.2014;2014;11;18;Tiistai;1;5;6
95;18.11.2014;2014;11;19;Tiistai;1;2;3
95;18.11.2014;2014;11;20;Tiistai;0;3;3
95;18.11.2014;2014;11;21;Tiistai;1;2;3
95;18.11.2014;2014;11;22;Tiistai;1;2;3
95;18.11.2014;2014;11;23;Tiistai;1;1;2
95;19.11.2014;2014;11;00;Keskiviikko;0;0;0
95;19.11.2014;2014;11;01;Keskiviikko;0;0;0
95;19.11.2014;2014;11;02;Keskiviikko;0;0;0
95;19.11.2014;2014;11;03;Keskiviikko;0;0;0
95;19.11.2014;2014;11;04;Keskiviikko;1;2;3
95;19.11.2014;2014;11;05;Keskiviikko;1;3;4
95;19.11.2014;2014;11;06;Keskiviikko;5;4;9
95;19.11.2014;2014;11;07;Keskiviikko;15;10;25
95;19.11.2014;2014;11;08;Keskiviikko;4;7;11
95;19.11.2014;2014;11;09;Keskiviikko;7;5;12
95;19.11.2014;2014;11;10;Keskiviikko;5;10;15
95;19.11.2014;2014;11;11;Keskiviikko;6;5;11
95;19.11.2014;2014;11;12;Keskiviikko;3;2;5
95;19.11.2014;2014;11;13;Keskiviikko;4;6;10
95;19.11.2014;2014;11;14;Keskiviikko;6;12;18
95;19.11.2014;2014;11;15;Keskiviikko;10;4;14
95;19.11.2014;2014;11;16;Keskiviikko;13;15;28
95;19.11.2014;2014;11;17;Keskiviikko;3;10;13
95;19.11.2014;2014;11;18;Keskiviikko;4;5;9
95;19.11.2014;2014;11;19;Keskiviikko;6;6;12
95;19.11.2014;2014;11;20;Keskiviikko;11;3;14
95;19.11.2014;2014;11;21;Keskiviikko;5;4;9
95;19.11.2014;2014;11;22;Keskiviikko;2;0;2
95;19.11.2014;2014;11;23;Keskiviikko;0;2;2
95;20.11.2014;2014;11;00;Torstai;0;0;0
95;20.11.2014;2014;11;01;Torstai;0;0;0
95;20.11.2014;2014;11;02;Torstai;0;0;0
95;20.11.2014;2014;11;03;Torstai;0;0;0
95;20.11.2014;2014;11;04;Torstai;0;0;0
95;20.11.2014;2014;11;05;Torstai;6;3;9
95;20.11.2014;2014;11;06;Torstai;8;5;13
95;20.11.2014;2014;11;07;Torstai;13;9;22
95;20.11.2014;2014;11;08;Torstai;8;7;15
95;20.11.2014;2014;11;09;Torstai;1;3;4
95;20.11.2014;2014;11;10;Torstai;5;3;8
95;20.11.2014;2014;11;11;Torstai;2;6;8
95;20.11.2014;2014;11;12;Torstai;3;2;5
95;20.11.2014;2014;11;13;Torstai;5;3;8
95;20.11.2014;2014;11;14;Torstai;8;6;14
95;20.11.2014;2014;11;15;Torstai;11;7;18
95;20.11.2014;2014;11;16;Torstai;11;12;23
95;20.11.2014;2014;11;17;Torstai;2;8;10
95;20.11.2014;2014;11;18;Torstai;3;0;3
95;20.11.2014;2014;11;19;Torstai;1;5;6
95;20.11.2014;2014;11;20;Torstai;3;2;5
95;20.11.2014;2014;11;21;Torstai;0;1;1
95;20.11.2014;2014;11;22;Torstai;1;0;1
95;20.11.2014;2014;11;23;Torstai;0;1;1
95;21.11.2014;2014;11;00;Perjantai;0;0;0
95;21.11.2014;2014;11;01;Perjantai;0;0;0
95;21.11.2014;2014;11;02;Perjantai;0;0;0
95;21.11.2014;2014;11;03;Perjantai;0;0;0
95;21.11.2014;2014;11;04;Perjantai;1;0;1
95;21.11.2014;2014;11;05;Perjantai;2;3;5
95;21.11.2014;2014;11;06;Perjantai;6;3;9
95;21.11.2014;2014;11;07;Perjantai;6;11;17
95;21.11.2014;2014;11;08;Perjantai;4;4;8
95;21.11.2014;2014;11;09;Perjantai;5;0;5
95;21.11.2014;2014;11;10;Perjantai;3;2;5
95;21.11.2014;2014;11;11;Perjantai;4;3;7
95;21.11.2014;2014;11;12;Perjantai;2;1;3
95;21.11.2014;2014;11;13;Perjantai;5;5;10
95;21.11.2014;2014;11;14;Perjantai;10;5;15
95;21.11.2014;2014;11;15;Perjantai;10;8;18
95;21.11.2014;2014;11;16;Perjantai;4;7;11
95;21.11.2014;2014;11;17;Perjantai;3;7;10
95;21.11.2014;2014;11;18;Perjantai;1;4;5
95;21.11.2014;2014;11;19;Perjantai;2;2;4
95;21.11.2014;2014;11;20;Perjantai;0;1;1
95;21.11.2014;2014;11;21;Perjantai;0;0;0
95;21.11.2014;2014;11;22;Perjantai;1;0;1
95;21.11.2014;2014;11;23;Perjantai;0;2;2
95;22.11.2014;2014;11;00;Lauantai;0;0;0
95;22.11.2014;2014;11;01;Lauantai;0;0;0
95;22.11.2014;2014;11;02;Lauantai;0;0;0
95;22.11.2014;2014;11;03;Lauantai;0;0;0
95;22.11.2014;2014;11;04;Lauantai;0;0;0
95;22.11.2014;2014;11;05;Lauantai;0;0;0
95;22.11.2014;2014;11;06;Lauantai;0;0;0
95;22.11.2014;2014;11;07;Lauantai;1;0;1
95;22.11.2014;2014;11;08;Lauantai;2;2;4
95;22.11.2014;2014;11;09;Lauantai;1;3;4
95;22.11.2014;2014;11;10;Lauantai;3;0;3
95;22.11.2014;2014;11;11;Lauantai;2;5;7
95;22.11.2014;2014;11;12;Lauantai;4;0;4
95;22.11.2014;2014;11;13;Lauantai;3;2;5
95;22.11.2014;2014;11;14;Lauantai;10;1;11
95;22.11.2014;2014;11;15;Lauantai;2;3;5
95;22.11.2014;2014;11;16;Lauantai;2;1;3
95;22.11.2014;2014;11;17;Lauantai;0;3;3
95;22.11.2014;2014;11;18;Lauantai;2;4;6
95;22.11.2014;2014;11;19;Lauantai;1;0;1
95;22.11.2014;2014;11;20;Lauantai;1;1;2
95;22.11.2014;2014;11;21;Lauantai;1;0;1
95;22.11.2014;2014;11;22;Lauantai;2;0;2
95;22.11.2014;2014;11;23;Lauantai;0;0;0
95;23.11.2014;2014;11;00;Sunnuntai;0;0;0
95;23.11.2014;2014;11;01;Sunnuntai;0;0;0
95;23.11.2014;2014;11;02;Sunnuntai;0;0;0
95;23.11.2014;2014;11;03;Sunnuntai;0;1;1
95;23.11.2014;2014;11;04;Sunnuntai;0;0;0
95;23.11.2014;2014;11;05;Sunnuntai;0;0;0
95;23.11.2014;2014;11;06;Sunnuntai;0;1;1
95;23.11.2014;2014;11;07;Sunnuntai;1;0;1
95;23.11.2014;2014;11;08;Sunnuntai;1;2;3
95;23.11.2014;2014;11;09;Sunnuntai;4;5;9
95;23.11.2014;2014;11;10;Sunnuntai;0;2;2
95;23.11.2014;2014;11;11;Sunnuntai;2;0;2
95;23.11.2014;2014;11;12;Sunnuntai;2;4;6
95;23.11.2014;2014;11;13;Sunnuntai;3;5;8
95;23.11.2014;2014;11;14;Sunnuntai;6;3;9
95;23.11.2014;2014;11;15;Sunnuntai;1;1;2
95;23.11.2014;2014;11;16;Sunnuntai;1;3;4
95;23.11.2014;2014;11;17;Sunnuntai;2;3;5
95;23.11.2014;2014;11;18;Sunnuntai;2;0;2
95;23.11.2014;2014;11;19;Sunnuntai;1;4;5
95;23.11.2014;2014;11;20;Sunnuntai;0;1;1
95;23.11.2014;2014;11;21;Sunnuntai;1;0;1
95;23.11.2014;2014;11;22;Sunnuntai;0;0;0
95;23.11.2014;2014;11;23;Sunnuntai;0;0;0
95;24.11.2014;2014;11;00;Maanantai;0;0;0
95;24.11.2014;2014;11;01;Maanantai;0;0;0
95;24.11.2014;2014;11;02;Maanantai;0;0;0
95;24.11.2014;2014;11;03;Maanantai;0;0;0
95;24.11.2014;2014;11;04;Maanantai;1;0;1
95;24.11.2014;2014;11;05;Maanantai;1;3;4
95;24.11.2014;2014;11;06;Maanantai;10;5;15
95;24.11.2014;2014;11;07;Maanantai;10;8;18
95;24.11.2014;2014;11;08;Maanantai;3;4;7
95;24.11.2014;2014;11;09;Maanantai;2;2;4
95;24.11.2014;2014;11;10;Maanantai;5;0;5
95;24.11.2014;2014;11;11;Maanantai;3;3;6
95;24.11.2014;2014;11;12;Maanantai;1;0;1
95;24.11.2014;2014;11;13;Maanantai;2;3;5
95;24.11.2014;2014;11;14;Maanantai;9;6;15
95;24.11.2014;2014;11;15;Maanantai;6;5;11
95;24.11.2014;2014;11;16;Maanantai;10;11;21
95;24.11.2014;2014;11;17;Maanantai;5;9;14
95;24.11.2014;2014;11;18;Maanantai;1;2;3
95;24.11.2014;2014;11;19;Maanantai;2;6;8
95;24.11.2014;2014;11;20;Maanantai;0;0;0
95;24.11.2014;2014;11;21;Maanantai;0;1;1
95;24.11.2014;2014;11;22;Maanantai;1;2;3
95;24.11.2014;2014;11;23;Maanantai;0;0;0
95;25.11.2014;2014;11;00;Tiistai;0;0;0
95;25.11.2014;2014;11;01;Tiistai;0;0;0
95;25.11.2014;2014;11;02;Tiistai;0;0;0
95;25.11.2014;2014;11;03;Tiistai;0;0;0
95;25.11.2014;2014;11;04;Tiistai;1;0;1
95;25.11.2014;2014;11;05;Tiistai;2;3;5
95;25.11.2014;2014;11;06;Tiistai;9;7;16
95;25.11.2014;2014;11;07;Tiistai;8;11;19
95;25.11.2014;2014;11;08;Tiistai;4;5;9
95;25.11.2014;2014;11;09;Tiistai;3;4;7
95;25.11.2014;2014;11;10;Tiistai;1;0;1
95;25.11.2014;2014;11;11;Tiistai;2;1;3
95;25.11.2014;2014;11;12;Tiistai;6;2;8
95;25.11.2014;2014;11;13;Tiistai;4;5;9
95;25.11.2014;2014;11;14;Tiistai;3;6;9
95;25.11.2014;2014;11;15;Tiistai;11;6;17
95;25.11.2014;2014;11;16;Tiistai;7;10;17
95;25.11.2014;2014;11;17;Tiistai;5;9;14
95;25.11.2014;2014;11;18;Tiistai;2;4;6
95;25.11.2014;2014;11;19;Tiistai;2;2;4
95;25.11.2014;2014;11;20;Tiistai;0;1;1
95;25.11.2014;2014;11;21;Tiistai;1;2;3
95;25.11.2014;2014;11;22;Tiistai;4;2;6
95;25.11.2014;2014;11;23;Tiistai;0;0;0
95;26.11.2014;2014;11;00;Keskiviikko;0;0;0
95;26.11.2014;2014;11;01;Keskiviikko;0;0;0
95;26.11.2014;2014;11;02;Keskiviikko;0;0;0
95;26.11.2014;2014;11;03;Keskiviikko;0;0;0
95;26.11.2014;2014;11;04;Keskiviikko;1;0;1
95;26.11.2014;2014;11;05;Keskiviikko;3;3;6
95;26.11.2014;2014;11;06;Keskiviikko;7;2;9
95;26.11.2014;2014;11;07;Keskiviikko;11;9;20
95;26.11.2014;2014;11;08;Keskiviikko;6;3;9
95;26.11.2014;2014;11;09;Keskiviikko;4;4;8
95;26.11.2014;2014;11;10;Keskiviikko;4;2;6
95;26.11.2014;2014;11;11;Keskiviikko;6;6;12
95;26.11.2014;2014;11;12;Keskiviikko;3;3;6
95;26.11.2014;2014;11;13;Keskiviikko;3;7;10
95;26.11.2014;2014;11;14;Keskiviikko;6;4;10
95;26.11.2014;2014;11;15;Keskiviikko;10;12;22
95;26.11.2014;2014;11;16;Keskiviikko;11;8;19
95;26.11.2014;2014;11;17;Keskiviikko;3;4;7
95;26.11.2014;2014;11;18;Keskiviikko;4;3;7
95;26.11.2014;2014;11;19;Keskiviikko;3;1;4
95;26.11.2014;2014;11;20;Keskiviikko;4;1;5
95;26.11.2014;2014;11;21;Keskiviikko;2;1;3
95;26.11.2014;2014;11;22;Keskiviikko;1;1;2
95;26.11.2014;2014;11;23;Keskiviikko;0;0;0
95;27.11.2014;2014;11;00;Torstai;0;1;1
95;27.11.2014;2014;11;01;Torstai;0;0;0
95;27.11.2014;2014;11;02;Torstai;1;0;1
95;27.11.2014;2014;11;03;Torstai;0;0;0
95;27.11.2014;2014;11;04;Torstai;1;0;1
95;27.11.2014;2014;11;05;Torstai;1;3;4
95;27.11.2014;2014;11;06;Torstai;8;5;13
95;27.11.2014;2014;11;07;Torstai;15;11;26
95;27.11.2014;2014;11;08;Torstai;9;4;13
95;27.11.2014;2014;11;09;Torstai;2;3;5
95;27.11.2014;2014;11;10;Torstai;5;3;8
95;27.11.2014;2014;11;11;Torstai;1;3;4
95;27.11.2014;2014;11;12;Torstai;5;4;9
95;27.11.2014;2014;11;13;Torstai;8;5;13
95;27.11.2014;2014;11;14;Torstai;6;3;9
95;27.11.2014;2014;11;15;Torstai;7;8;15
95;27.11.2014;2014;11;16;Torstai;8;12;20
95;27.11.2014;2014;11;17;Torstai;6;8;14
95;27.11.2014;2014;11;18;Torstai;2;2;4
95;27.11.2014;2014;11;19;Torstai;4;8;12
95;27.11.2014;2014;11;20;Torstai;0;0;0
95;27.11.2014;2014;11;21;Torstai;0;2;2
95;27.11.2014;2014;11;22;Torstai;1;1;2
95;27.11.2014;2014;11;23;Torstai;1;0;1
95;28.11.2014;2014;11;00;Perjantai;0;0;0
95;28.11.2014;2014;11;01;Perjantai;0;1;1
95;28.11.2014;2014;11;02;Perjantai;0;0;0
95;28.11.2014;2014;11;03;Perjantai;0;0;0
95;28.11.2014;2014;11;04;Perjantai;2;0;2
95;28.11.2014;2014;11;05;Perjantai;1;2;3
95;28.11.2014;2014;11;06;Perjantai;7;3;10
95;28.11.2014;2014;11;07;Perjantai;6;9;15
95;28.11.2014;2014;11;08;Perjantai;7;3;10
95;28.11.2014;2014;11;09;Perjantai;2;3;5
95;28.11.2014;2014;11;10;Perjantai;4;2;6
95;28.11.2014;2014;11;11;Perjantai;4;1;5
95;28.11.2014;2014;11;12;Perjantai;3;5;8
95;28.11.2014;2014;11;13;Perjantai;7;8;15
95;28.11.2014;2014;11;14;Perjantai;6;9;15
95;28.11.2014;2014;11;15;Perjantai;12;8;20
95;28.11.2014;2014;11;16;Perjantai;5;4;9
95;28.11.2014;2014;11;17;Perjantai;2;1;3
95;28.11.2014;2014;11;18;Perjantai;6;3;9
95;28.11.2014;2014;11;19;Perjantai;2;3;5
95;28.11.2014;2014;11;20;Perjantai;0;0;0
95;28.11.2014;2014;11;21;Perjantai;0;1;1
95;28.11.2014;2014;11;22;Perjantai;0;0;0
95;28.11.2014;2014;11;23;Perjantai;0;1;1
95;29.11.2014;2014;11;00;Lauantai;0;0;0
95;29.11.2014;2014;11;01;Lauantai;0;1;1
95;29.11.2014;2014;11;02;Lauantai;0;1;1
95;29.11.2014;2014;11;03;Lauantai;0;0;0
95;29.11.2014;2014;11;04;Lauantai;1;0;1
95;29.11.2014;2014;11;05;Lauantai;0;0;0
95;29.11.2014;2014;11;06;Lauantai;0;1;1
95;29.11.2014;2014;11;07;Lauantai;1;2;3
95;29.11.2014;2014;11;08;Lauantai;3;0;3
95;29.11.2014;2014;11;09;Lauantai;4;1;5
95;29.11.2014;2014;11;10;Lauantai;3;8;11
95;29.11.2014;2014;11;11;Lauantai;1;4;5
95;29.11.2014;2014;11;12;Lauantai;1;3;4
95;29.11.2014;2014;11;13;Lauantai;1;2;3
95;29.11.2014;2014;11;14;Lauantai;7;5;12
95;29.11.2014;2014;11;15;Lauantai;1;8;9
95;29.11.2014;2014;11;16;Lauantai;3;2;5
95;29.11.2014;2014;11;17;Lauantai;5;3;8
95;29.11.2014;2014;11;18;Lauantai;2;4;6
95;29.11.2014;2014;11;19;Lauantai;1;3;4
95;29.11.2014;2014;11;20;Lauantai;0;1;1
95;29.11.2014;2014;11;21;Lauantai;2;0;2
95;29.11.2014;2014;11;22;Lauantai;0;2;2
95;29.11.2014;2014;11;23;Lauantai;0;0;0
95;30.11.2014;2014;11;00;Sunnuntai;1;0;1
95;30.11.2014;2014;11;01;Sunnuntai;0;0;0
95;30.11.2014;2014;11;02;Sunnuntai;1;0;1
95;30.11.2014;2014;11;03;Sunnuntai;0;0;0
95;30.11.2014;2014;11;04;Sunnuntai;0;0;0
95;30.11.2014;2014;11;05;Sunnuntai;0;0;0
95;30.11.2014;2014;11;06;Sunnuntai;0;0;0
95;30.11.2014;2014;11;07;Sunnuntai;1;0;1
95;30.11.2014;2014;11;08;Sunnuntai;4;1;5
95;30.11.2014;2014;11;09;Sunnuntai;3;3;6
95;30.11.2014;2014;11;10;Sunnuntai;0;3;3
95;30.11.2014;2014;11;11;Sunnuntai;5;1;6
95;30.11.2014;2014;11;12;Sunnuntai;9;3;12
95;30.11.2014;2014;11;13;Sunnuntai;3;6;9
95;30.11.2014;2014;11;14;Sunnuntai;4;4;8
95;30.11.2014;2014;11;15;Sunnuntai;2;3;5
95;30.11.2014;2014;11;16;Sunnuntai;3;2;5
95;30.11.2014;2014;11;17;Sunnuntai;2;2;4
95;30.11.2014;2014;11;18;Sunnuntai;3;7;10
95;30.11.2014;2014;11;19;Sunnuntai;0;1;1
95;30.11.2014;2014;11;20;Sunnuntai;0;0;0
95;30.11.2014;2014;11;21;Sunnuntai;3;0;3
95;30.11.2014;2014;11;22;Sunnuntai;0;0;0
95;30.11.2014;2014;11;23;Sunnuntai;2;0;2
95;01.12.2014;2014;12;00;Maanantai;0;0;0
95;01.12.2014;2014;12;01;Maanantai;0;0;0
95;01.12.2014;2014;12;02;Maanantai;0;0;0
95;01.12.2014;2014;12;03;Maanantai;0;0;0
95;01.12.2014;2014;12;04;Maanantai;1;0;1
95;01.12.2014;2014;12;05;Maanantai;3;4;7
95;01.12.2014;2014;12;06;Maanantai;6;5;11
95;01.12.2014;2014;12;07;Maanantai;13;9;22
95;01.12.2014;2014;12;08;Maanantai;4;6;10
95;01.12.2014;2014;12;09;Maanantai;2;3;5
95;01.12.2014;2014;12;10;Maanantai;5;3;8
95;01.12.2014;2014;12;11;Maanantai;7;2;9
95;01.12.2014;2014;12;12;Maanantai;4;3;7
95;01.12.2014;2014;12;13;Maanantai;8;4;12
95;01.12.2014;2014;12;14;Maanantai;5;9;14
95;01.12.2014;2014;12;15;Maanantai;9;8;17
95;01.12.2014;2014;12;16;Maanantai;8;10;18
95;01.12.2014;2014;12;17;Maanantai;5;11;16
95;01.12.2014;2014;12;18;Maanantai;6;6;12
95;01.12.2014;2014;12;19;Maanantai;3;5;8
95;01.12.2014;2014;12;20;Maanantai;0;6;6
95;01.12.2014;2014;12;21;Maanantai;0;1;1
95;01.12.2014;2014;12;22;Maanantai;2;1;3
95;01.12.2014;2014;12;23;Maanantai;0;1;1
95;02.12.2014;2014;12;00;Tiistai;0;0;0
95;02.12.2014;2014;12;01;Tiistai;1;0;1
95;02.12.2014;2014;12;02;Tiistai;0;0;0
95;02.12.2014;2014;12;03;Tiistai;0;0;0
95;02.12.2014;2014;12;04;Tiistai;2;0;2
95;02.12.2014;2014;12;05;Tiistai;0;2;2
95;02.12.2014;2014;12;06;Tiistai;5;7;12
95;02.12.2014;2014;12;07;Tiistai;12;9;21
95;02.12.2014;2014;12;08;Tiistai;4;6;10
95;02.12.2014;2014;12;09;Tiistai;3;5;8
95;02.12.2014;2014;12;10;Tiistai;2;2;4
95;02.12.2014;2014;12;11;Tiistai;5;3;8
95;02.12.2014;2014;12;12;Tiistai;3;3;6
95;02.12.2014;2014;12;13;Tiistai;4;4;8
95;02.12.2014;2014;12;14;Tiistai;11;4;15
95;02.12.2014;2014;12;15;Tiistai;11;1;12
95;02.12.2014;2014;12;16;Tiistai;9;7;16
95;02.12.2014;2014;12;17;Tiistai;0;10;10
95;02.12.2014;2014;12;18;Tiistai;6;1;7
95;02.12.2014;2014;12;19;Tiistai;5;3;8
95;02.12.2014;2014;12;20;Tiistai;0;6;6
95;02.12.2014;2014;12;21;Tiistai;0;2;2
95;02.12.2014;2014;12;22;Tiistai;1;1;2
95;02.12.2014;2014;12;23;Tiistai;0;0;0
95;03.12.2014;2014;12;00;Keskiviikko;0;1;1
95;03.12.2014;2014;12;01;Keskiviikko;0;0;0
95;03.12.2014;2014;12;02;Keskiviikko;0;0;0
95;03.12.2014;2014;12;03;Keskiviikko;0;0;0
95;03.12.2014;2014;12;04;Keskiviikko;2;0;2
95;03.12.2014;2014;12;05;Keskiviikko;0;2;2
95;03.12.2014;2014;12;06;Keskiviikko;6;8;14
95;03.12.2014;2014;12;07;Keskiviikko;5;7;12
95;03.12.2014;2014;12;08;Keskiviikko;5;0;5
95;03.12.2014;2014;12;09;Keskiviikko;4;5;9
95;03.12.2014;2014;12;10;Keskiviikko;3;3;6
95;03.12.2014;2014;12;11;Keskiviikko;3;1;4
95;03.12.2014;2014;12;12;Keskiviikko;2;2;4
95;03.12.2014;2014;12;13;Keskiviikko;6;4;10
95;03.12.2014;2014;12;14;Keskiviikko;8;5;13
95;03.12.2014;2014;12;15;Keskiviikko;9;2;11
95;03.12.2014;2014;12;16;Keskiviikko;2;8;10
95;03.12.2014;2014;12;17;Keskiviikko;1;5;6
95;03.12.2014;2014;12;18;Keskiviikko;1;5;6
95;03.12.2014;2014;12;19;Keskiviikko;1;3;4
95;03.12.2014;2014;12;20;Keskiviikko;2;3;5
95;03.12.2014;2014;12;21;Keskiviikko;0;0;0
95;03.12.2014;2014;12;22;Keskiviikko;1;1;2
95;03.12.2014;2014;12;23;Keskiviikko;0;0;0
95;04.12.2014;2014;12;00;Torstai;1;1;2
95;04.12.2014;2014;12;01;Torstai;0;0;0
95;04.12.2014;2014;12;02;Torstai;0;0;0
95;04.12.2014;2014;12;03;Torstai;0;0;0
95;04.12.2014;2014;12;04;Torstai;1;0;1
95;04.12.2014;2014;12;05;Torstai;1;2;3
95;04.12.2014;2014;12;06;Torstai;5;3;8
95;04.12.2014;2014;12;07;Torstai;5;11;16
95;04.12.2014;2014;12;08;Torstai;7;5;12
95;04.12.2014;2014;12;09;Torstai;4;4;8
95;04.12.2014;2014;12;10;Torstai;2;0;2
95;04.12.2014;2014;12;11;Torstai;3;7;10
95;04.12.2014;2014;12;12;Torstai;7;3;10
95;04.12.2014;2014;12;13;Torstai;6;5;11
95;04.12.2014;2014;12;14;Torstai;4;5;9
95;04.12.2014;2014;12;15;Torstai;8;4;12
95;04.12.2014;2014;12;16;Torstai;7;12;19
95;04.12.2014;2014;12;17;Torstai;4;4;8
95;04.12.2014;2014;12;18;Torstai;2;1;3
95;04.12.2014;2014;12;19;Torstai;0;3;3
95;04.12.2014;2014;12;20;Torstai;2;3;5
95;04.12.2014;2014;12;21;Torstai;1;0;1
95;04.12.2014;2014;12;22;Torstai;2;2;4
95;04.12.2014;2014;12;23;Torstai;0;1;1
95;05.12.2014;2014;12;00;Perjantai;0;0;0
95;05.12.2014;2014;12;01;Perjantai;0;0;0
95;05.12.2014;2014;12;02;Perjantai;0;0;0
95;05.12.2014;2014;12;03;Perjantai;0;0;0
95;05.12.2014;2014;12;04;Perjantai;1;0;1
95;05.12.2014;2014;12;05;Perjantai;0;1;1
95;05.12.2014;2014;12;06;Perjantai;5;1;6
95;05.12.2014;2014;12;07;Perjantai;4;5;9
95;05.12.2014;2014;12;08;Perjantai;3;4;7
95;05.12.2014;2014;12;09;Perjantai;4;3;7
95;05.12.2014;2014;12;10;Perjantai;6;1;7
95;05.12.2014;2014;12;11;Perjantai;1;2;3
95;05.12.2014;2014;12;12;Perjantai;3;1;4
95;05.12.2014;2014;12;13;Perjantai;7;13;20
95;05.12.2014;2014;12;14;Perjantai;4;2;6
95;05.12.2014;2014;12;15;Perjantai;4;9;13
95;05.12.2014;2014;12;16;Perjantai;4;5;9
95;05.12.2014;2014;12;17;Perjantai;4;4;8
95;05.12.2014;2014;12;18;Perjantai;2;1;3
95;05.12.2014;2014;12;19;Perjantai;1;0;1
95;05.12.2014;2014;12;20;Perjantai;1;2;3
95;05.12.2014;2014;12;21;Perjantai;1;1;2
95;05.12.2014;2014;12;22;Perjantai;0;0;0
95;05.12.2014;2014;12;23;Perjantai;0;0;0
95;06.12.2014;2014;12;00;Lauantai;1;1;2
95;06.12.2014;2014;12;01;Lauantai;0;0;0
95;06.12.2014;2014;12;02;Lauantai;0;0;0
95;06.12.2014;2014;12;03;Lauantai;0;0;0
95;06.12.2014;2014;12;04;Lauantai;0;0;0
95;06.12.2014;2014;12;05;Lauantai;0;1;1
95;06.12.2014;2014;12;06;Lauantai;0;1;1
95;06.12.2014;2014;12;07;Lauantai;2;0;2
95;06.12.2014;2014;12;08;Lauantai;1;0;1
95;06.12.2014;2014;12;09;Lauantai;0;2;2
95;06.12.2014;2014;12;10;Lauantai;0;3;3
95;06.12.2014;2014;12;11;Lauantai;2;1;3
95;06.12.2014;2014;12;12;Lauantai;3;0;3
95;06.12.2014;2014;12;13;Lauantai;1;0;1
95;06.12.2014;2014;12;14;Lauantai;5;1;6
95;06.12.2014;2014;12;15;Lauantai;1;3;4
95;06.12.2014;2014;12;16;Lauantai;0;1;1
95;06.12.2014;2014;12;17;Lauantai;2;1;3
95;06.12.2014;2014;12;18;Lauantai;0;0;0
95;06.12.2014;2014;12;19;Lauantai;1;0;1
95;06.12.2014;2014;12;20;Lauantai;0;0;0
95;06.12.2014;2014;12;21;Lauantai;0;0;0
95;06.12.2014;2014;12;22;Lauantai;0;2;2
95;06.12.2014;2014;12;23;Lauantai;1;0;1
95;07.12.2014;2014;12;00;Sunnuntai;0;2;2
95;07.12.2014;2014;12;01;Sunnuntai;0;0;0
95;07.12.2014;2014;12;02;Sunnuntai;0;1;1
95;07.12.2014;2014;12;03;Sunnuntai;0;0;0
95;07.12.2014;2014;12;04;Sunnuntai;0;0;0
95;07.12.2014;2014;12;05;Sunnuntai;0;0;0
95;07.12.2014;2014;12;06;Sunnuntai;1;0;1
95;07.12.2014;2014;12;07;Sunnuntai;0;1;1
95;07.12.2014;2014;12;08;Sunnuntai;0;0;0
95;07.12.2014;2014;12;09;Sunnuntai;2;0;2
95;07.12.2014;2014;12;10;Sunnuntai;0;3;3
95;07.12.2014;2014;12;11;Sunnuntai;17;2;19
95;07.12.2014;2014;12;12;Sunnuntai;1;2;3
95;07.12.2014;2014;12;13;Sunnuntai;5;1;6
95;07.12.2014;2014;12;14;Sunnuntai;0;0;0
95;07.12.2014;2014;12;15;Sunnuntai;1;4;5
95;07.12.2014;2014;12;16;Sunnuntai;0;0;0
95;07.12.2014;2014;12;17;Sunnuntai;0;0;0
95;07.12.2014;2014;12;18;Sunnuntai;1;1;2
95;07.12.2014;2014;12;19;Sunnuntai;0;1;1
95;07.12.2014;2014;12;20;Sunnuntai;1;0;1
95;07.12.2014;2014;12;21;Sunnuntai;0;1;1
95;07.12.2014;2014;12;22;Sunnuntai;0;1;1
95;07.12.2014;2014;12;23;Sunnuntai;0;0;0
95;08.12.2014;2014;12;00;Maanantai;0;0;0
95;08.12.2014;2014;12;01;Maanantai;0;0;0
95;08.12.2014;2014;12;02;Maanantai;0;0;0
95;08.12.2014;2014;12;03;Maanantai;0;0;0
95;08.12.2014;2014;12;04;Maanantai;2;1;3
95;08.12.2014;2014;12;05;Maanantai;0;2;2
95;08.12.2014;2014;12;06;Maanantai;8;2;10
95;08.12.2014;2014;12;07;Maanantai;9;6;15
95;08.12.2014;2014;12;08;Maanantai;4;6;10
95;08.12.2014;2014;12;09;Maanantai;3;1;4
95;08.12.2014;2014;12;10;Maanantai;4;2;6
95;08.12.2014;2014;12;11;Maanantai;6;2;8
95;08.12.2014;2014;12;12;Maanantai;3;2;5
95;08.12.2014;2014;12;13;Maanantai;2;4;6
95;08.12.2014;2014;12;14;Maanantai;7;6;13
95;08.12.2014;2014;12;15;Maanantai;8;10;18
95;08.12.2014;2014;12;16;Maanantai;11;7;18
95;08.12.2014;2014;12;17;Maanantai;4;4;8
95;08.12.2014;2014;12;18;Maanantai;2;6;8
95;08.12.2014;2014;12;19;Maanantai;3;1;4
95;08.12.2014;2014;12;20;Maanantai;0;3;3
95;08.12.2014;2014;12;21;Maanantai;1;1;2
95;08.12.2014;2014;12;22;Maanantai;0;0;0
95;08.12.2014;2014;12;23;Maanantai;0;1;1
95;09.12.2014;2014;12;00;Tiistai;1;0;1
95;09.12.2014;2014;12;01;Tiistai;0;0;0
95;09.12.2014;2014;12;02;Tiistai;0;0;0
95;09.12.2014;2014;12;03;Tiistai;0;0;0
95;09.12.2014;2014;12;04;Tiistai;0;0;0
95;09.12.2014;2014;12;05;Tiistai;1;3;4
95;09.12.2014;2014;12;06;Tiistai;10;4;14
95;09.12.2014;2014;12;07;Tiistai;6;12;18
95;09.12.2014;2014;12;08;Tiistai;6;4;10
95;09.12.2014;2014;12;09;Tiistai;1;1;2
95;09.12.2014;2014;12;10;Tiistai;4;1;5
95;09.12.2014;2014;12;11;Tiistai;2;2;4
95;09.12.2014;2014;12;12;Tiistai;2;4;6
95;09.12.2014;2014;12;13;Tiistai;11;5;16
95;09.12.2014;2014;12;14;Tiistai;8;5;13
95;09.12.2014;2014;12;15;Tiistai;13;7;20
95;09.12.2014;2014;12;16;Tiistai;11;9;20
95;09.12.2014;2014;12;17;Tiistai;2;10;12
95;09.12.2014;2014;12;18;Tiistai;3;4;7
95;09.12.2014;2014;12;19;Tiistai;2;5;7
95;09.12.2014;2014;12;20;Tiistai;2;2;4
95;09.12.2014;2014;12;21;Tiistai;1;4;5
95;09.12.2014;2014;12;22;Tiistai;0;0;0
95;09.12.2014;2014;12;23;Tiistai;1;1;2
95;10.12.2014;2014;12;00;Keskiviikko;0;0;0
95;10.12.2014;2014;12;01;Keskiviikko;0;0;0
95;10.12.2014;2014;12;02;Keskiviikko;1;0;1
95;10.12.2014;2014;12;03;Keskiviikko;0;0;0
95;10.12.2014;2014;12;04;Keskiviikko;0;0;0
95;10.12.2014;2014;12;05;Keskiviikko;1;2;3
95;10.12.2014;2014;12;06;Keskiviikko;8;5;13
95;10.12.2014;2014;12;07;Keskiviikko;9;10;19
95;10.12.2014;2014;12;08;Keskiviikko;4;6;10
95;10.12.2014;2014;12;09;Keskiviikko;3;3;6
95;10.12.2014;2014;12;10;Keskiviikko;1;2;3
95;10.12.2014;2014;12;11;Keskiviikko;3;2;5
95;10.12.2014;2014;12;12;Keskiviikko;4;4;8
95;10.12.2014;2014;12;13;Keskiviikko;5;4;9
95;10.12.2014;2014;12;14;Keskiviikko;6;5;11
95;10.12.2014;2014;12;15;Keskiviikko;10;4;14
95;10.12.2014;2014;12;16;Keskiviikko;10;14;24
95;10.12.2014;2014;12;17;Keskiviikko;5;2;7
95;10.12.2014;2014;12;18;Keskiviikko;2;5;7
95;10.12.2014;2014;12;19;Keskiviikko;1;2;3
95;10.12.2014;2014;12;20;Keskiviikko;1;1;2
95;10.12.2014;2014;12;21;Keskiviikko;1;0;1
95;10.12.2014;2014;12;22;Keskiviikko;0;1;1
95;10.12.2014;2014;12;23;Keskiviikko;0;0;0
95;11.12.2014;2014;12;00;Torstai;1;1;2
95;11.12.2014;2014;12;01;Torstai;1;0;1
95;11.12.2014;2014;12;02;Torstai;0;0;0
95;11.12.2014;2014;12;03;Torstai;0;0;0
95;11.12.2014;2014;12;04;Torstai;0;2;2
95;11.12.2014;2014;12;05;Torstai;1;2;3
95;11.12.2014;2014;12;06;Torstai;7;6;13
95;11.12.2014;2014;12;07;Torstai;3;9;12
95;11.12.2014;2014;12;08;Torstai;4;4;8
95;11.12.2014;2014;12;09;Torstai;3;2;5
95;11.12.2014;2014;12;10;Torstai;3;1;4
95;11.12.2014;2014;12;11;Torstai;3;2;5
95;11.12.2014;2014;12;12;Torstai;3;3;6
95;11.12.2014;2014;12;13;Torstai;5;7;12
95;11.12.2014;2014;12;14;Torstai;5;2;7
95;11.12.2014;2014;12;15;Torstai;6;3;9
95;11.12.2014;2014;12;16;Torstai;14;9;23
95;11.12.2014;2014;12;17;Torstai;4;1;5
95;11.12.2014;2014;12;18;Torstai;1;0;1
95;11.12.2014;2014;12;19;Torstai;1;1;2
95;11.12.2014;2014;12;20;Torstai;1;2;3
95;11.12.2014;2014;12;21;Torstai;1;1;2
95;11.12.2014;2014;12;22;Torstai;0;3;3
95;11.12.2014;2014;12;23;Torstai;0;1;1
95;12.12.2014;2014;12;00;Perjantai;0;0;0
95;12.12.2014;2014;12;01;Perjantai;1;0;1
95;12.12.2014;2014;12;02;Perjantai;0;0;0
95;12.12.2014;2014;12;03;Perjantai;0;0;0
95;12.12.2014;2014;12;04;Perjantai;0;0;0
95;12.12.2014;2014;12;05;Perjantai;0;2;2
95;12.12.2014;2014;12;06;Perjantai;8;2;10
95;12.12.2014;2014;12;07;Perjantai;6;9;15
95;12.12.2014;2014;12;08;Perjantai;7;4;11
95;12.12.2014;2014;12;09;Perjantai;0;5;5
95;12.12.2014;2014;12;10;Perjantai;0;1;1
95;12.12.2014;2014;12;11;Perjantai;3;3;6
95;12.12.2014;2014;12;12;Perjantai;2;3;5
95;12.12.2014;2014;12;13;Perjantai;1;3;4
95;12.12.2014;2014;12;14;Perjantai;6;2;8
95;12.12.2014;2014;12;15;Perjantai;9;5;14
95;12.12.2014;2014;12;16;Perjantai;5;8;13
95;12.12.2014;2014;12;17;Perjantai;5;3;8
95;12.12.2014;2014;12;18;Perjantai;1;1;2
95;12.12.2014;2014;12;19;Perjantai;2;1;3
95;12.12.2014;2014;12;20;Perjantai;3;0;3
95;12.12.2014;2014;12;21;Perjantai;1;0;1
95;12.12.2014;2014;12;22;Perjantai;2;0;2
95;12.12.2014;2014;12;23;Perjantai;2;2;4
95;13.12.2014;2014;12;00;Lauantai;0;0;0
95;13.12.2014;2014;12;01;Lauantai;0;0;0
95;13.12.2014;2014;12;02;Lauantai;1;0;1
95;13.12.2014;2014;12;03;Lauantai;0;0;0
95;13.12.2014;2014;12;04;Lauantai;2;2;4
95;13.12.2014;2014;12;05;Lauantai;0;0;0
95;13.12.2014;2014;12;06;Lauantai;2;0;2
95;13.12.2014;2014;12;07;Lauantai;0;1;1
95;13.12.2014;2014;12;08;Lauantai;3;3;6
95;13.12.2014;2014;12;09;Lauantai;1;0;1
95;13.12.2014;2014;12;10;Lauantai;9;3;12
95;13.12.2014;2014;12;11;Lauantai;2;3;5
95;13.12.2014;2014;12;12;Lauantai;2;1;3
95;13.12.2014;2014;12;13;Lauantai;1;4;5
95;13.12.2014;2014;12;14;Lauantai;3;4;7
95;13.12.2014;2014;12;15;Lauantai;1;3;4
95;13.12.2014;2014;12;16;Lauantai;2;2;4
95;13.12.2014;2014;12;17;Lauantai;1;1;2
95;13.12.2014;2014;12;18;Lauantai;3;2;5
95;13.12.2014;2014;12;19;Lauantai;0;0;0
95;13.12.2014;2014;12;20;Lauantai;6;0;6
95;13.12.2014;2014;12;21;Lauantai;0;0;0
95;13.12.2014;2014;12;22;Lauantai;0;0;0
95;13.12.2014;2014;12;23;Lauantai;1;1;2
95;14.12.2014;2014;12;00;Sunnuntai;0;0;0
95;14.12.2014;2014;12;01;Sunnuntai;0;1;1
95;14.12.2014;2014;12;02;Sunnuntai;0;0;0
95;14.12.2014;2014;12;03;Sunnuntai;0;0;0
95;14.12.2014;2014;12;04;Sunnuntai;0;0;0
95;14.12.2014;2014;12;05;Sunnuntai;0;0;0
95;14.12.2014;2014;12;06;Sunnuntai;1;0;1
95;14.12.2014;2014;12;07;Sunnuntai;0;2;2
95;14.12.2014;2014;12;08;Sunnuntai;1;0;1
95;14.12.2014;2014;12;09;Sunnuntai;1;5;6
95;14.12.2014;2014;12;10;Sunnuntai;3;5;8
95;14.12.2014;2014;12;11;Sunnuntai;5;2;7
95;14.12.2014;2014;12;12;Sunnuntai;4;2;6
95;14.12.2014;2014;12;13;Sunnuntai;4;6;10
95;14.12.2014;2014;12;14;Sunnuntai;2;1;3
95;14.12.2014;2014;12;15;Sunnuntai;2;2;4
95;14.12.2014;2014;12;16;Sunnuntai;1;2;3
95;14.12.2014;2014;12;17;Sunnuntai;0;0;0
95;14.12.2014;2014;12;18;Sunnuntai;5;5;10
95;14.12.2014;2014;12;19;Sunnuntai;1;5;6
95;14.12.2014;2014;12;20;Sunnuntai;0;2;2
95;14.12.2014;2014;12;21;Sunnuntai;1;1;2
95;14.12.2014;2014;12;22;Sunnuntai;1;1;2
95;14.12.2014;2014;12;23;Sunnuntai;1;0;1
95;15.12.2014;2014;12;00;Maanantai;0;0;0
95;15.12.2014;2014;12;01;Maanantai;0;0;0
95;15.12.2014;2014;12;02;Maanantai;0;0;0
95;15.12.2014;2014;12;03;Maanantai;0;0;0
95;15.12.2014;2014;12;04;Maanantai;3;2;5
95;15.12.2014;2014;12;05;Maanantai;1;1;2
95;15.12.2014;2014;12;06;Maanantai;6;4;10
95;15.12.2014;2014;12;07;Maanantai;3;11;14
95;15.12.2014;2014;12;08;Maanantai;5;3;8
95;15.12.2014;2014;12;09;Maanantai;2;2;4
95;15.12.2014;2014;12;10;Maanantai;4;3;7
95;15.12.2014;2014;12;11;Maanantai;3;4;7
95;15.12.2014;2014;12;12;Maanantai;3;5;8
95;15.12.2014;2014;12;13;Maanantai;6;5;11
95;15.12.2014;2014;12;14;Maanantai;8;6;14
95;15.12.2014;2014;12;15;Maanantai;7;5;12
95;15.12.2014;2014;12;16;Maanantai;8;9;17
95;15.12.2014;2014;12;17;Maanantai;5;5;10
95;15.12.2014;2014;12;18;Maanantai;4;4;8
95;15.12.2014;2014;12;19;Maanantai;1;3;4
95;15.12.2014;2014;12;20;Maanantai;2;0;2
95;15.12.2014;2014;12;21;Maanantai;2;1;3
95;15.12.2014;2014;12;22;Maanantai;1;1;2
95;15.12.2014;2014;12;23;Maanantai;0;1;1
95;16.12.2014;2014;12;00;Tiistai;0;0;0
95;16.12.2014;2014;12;01;Tiistai;0;0;0
95;16.12.2014;2014;12;02;Tiistai;0;0;0
95;16.12.2014;2014;12;03;Tiistai;0;0;0
95;16.12.2014;2014;12;04;Tiistai;1;1;2
95;16.12.2014;2014;12;05;Tiistai;0;1;1
95;16.12.2014;2014;12;06;Tiistai;7;2;9
95;16.12.2014;2014;12;07;Tiistai;4;11;15
95;16.12.2014;2014;12;08;Tiistai;5;3;8
95;16.12.2014;2014;12;09;Tiistai;1;1;2
95;16.12.2014;2014;12;10;Tiistai;3;4;7
95;16.12.2014;2014;12;11;Tiistai;1;1;2
95;16.12.2014;2014;12;12;Tiistai;5;0;5
95;16.12.2014;2014;12;13;Tiistai;6;2;8
95;16.12.2014;2014;12;14;Tiistai;6;2;8
95;16.12.2014;2014;12;15;Tiistai;8;6;14
95;16.12.2014;2014;12;16;Tiistai;8;11;19
95;16.12.2014;2014;12;17;Tiistai;4;2;6
95;16.12.2014;2014;12;18;Tiistai;0;2;2
95;16.12.2014;2014;12;19;Tiistai;4;1;5
95;16.12.2014;2014;12;20;Tiistai;2;3;5
95;16.12.2014;2014;12;21;Tiistai;0;2;2
95;16.12.2014;2014;12;22;Tiistai;1;1;2
95;16.12.2014;2014;12;23;Tiistai;0;1;1
95;17.12.2014;2014;12;00;Keskiviikko;0;0;0
95;17.12.2014;2014;12;01;Keskiviikko;0;1;1
95;17.12.2014;2014;12;02;Keskiviikko;0;0;0
95;17.12.2014;2014;12;03;Keskiviikko;0;0;0
95;17.12.2014;2014;12;04;Keskiviikko;2;2;4
95;17.12.2014;2014;12;05;Keskiviikko;0;1;1
95;17.12.2014;2014;12;06;Keskiviikko;7;4;11
95;17.12.2014;2014;12;07;Keskiviikko;6;7;13
95;17.12.2014;2014;12;08;Keskiviikko;4;4;8
95;17.12.2014;2014;12;09;Keskiviikko;3;4;7
95;17.12.2014;2014;12;10;Keskiviikko;3;0;3
95;17.12.2014;2014;12;11;Keskiviikko;3;2;5
95;17.12.2014;2014;12;12;Keskiviikko;4;2;6
95;17.12.2014;2014;12;13;Keskiviikko;5;6;11
95;17.12.2014;2014;12;14;Keskiviikko;6;2;8
95;17.12.2014;2014;12;15;Keskiviikko;7;8;15
95;17.12.2014;2014;12;16;Keskiviikko;7;5;12
95;17.12.2014;2014;12;17;Keskiviikko;7;6;13
95;17.12.2014;2014;12;18;Keskiviikko;5;2;7
95;17.12.2014;2014;12;19;Keskiviikko;0;5;5
95;17.12.2014;2014;12;20;Keskiviikko;2;2;4
95;17.12.2014;2014;12;21;Keskiviikko;0;1;1
95;17.12.2014;2014;12;22;Keskiviikko;1;1;2
95;17.12.2014;2014;12;23;Keskiviikko;0;2;2
95;18.12.2014;2014;12;00;Torstai;0;0;0
95;18.12.2014;2014;12;01;Torstai;0;0;0
95;18.12.2014;2014;12;02;Torstai;0;0;0
95;18.12.2014;2014;12;03;Torstai;0;0;0
95;18.12.2014;2014;12;04;Torstai;1;0;1
95;18.12.2014;2014;12;05;Torstai;0;1;1
95;18.12.2014;2014;12;06;Torstai;8;3;11
95;18.12.2014;2014;12;07;Torstai;8;7;15
95;18.12.2014;2014;12;08;Torstai;7;5;12
95;18.12.2014;2014;12;09;Torstai;4;2;6
95;18.12.2014;2014;12;10;Torstai;6;2;8
95;18.12.2014;2014;12;11;Torstai;0;2;2
95;18.12.2014;2014;12;12;Torstai;2;1;3
95;18.12.2014;2014;12;13;Torstai;7;4;11
95;18.12.2014;2014;12;14;Torstai;3;9;12
95;18.12.2014;2014;12;15;Torstai;4;2;6
95;18.12.2014;2014;12;16;Torstai;8;10;18
95;18.12.2014;2014;12;17;Torstai;4;4;8
95;18.12.2014;2014;12;18;Torstai;1;1;2
95;18.12.2014;2014;12;19;Torstai;5;4;9
95;18.12.2014;2014;12;20;Torstai;1;2;3
95;18.12.2014;2014;12;21;Torstai;2;0;2
95;18.12.2014;2014;12;22;Torstai;1;2;3
95;18.12.2014;2014;12;23;Torstai;0;1;1
95;19.12.2014;2014;12;00;Perjantai;0;0;0
95;19.12.2014;2014;12;01;Perjantai;0;0;0
95;19.12.2014;2014;12;02;Perjantai;0;0;0
95;19.12.2014;2014;12;03;Perjantai;0;0;0
95;19.12.2014;2014;12;04;Perjantai;2;1;3
95;19.12.2014;2014;12;05;Perjantai;3;2;5
95;19.12.2014;2014;12;06;Perjantai;7;1;8
95;19.12.2014;2014;12;07;Perjantai;3;8;11
95;19.12.2014;2014;12;08;Perjantai;5;1;6
95;19.12.2014;2014;12;09;Perjantai;2;3;5
95;19.12.2014;2014;12;10;Perjantai;2;1;3
95;19.12.2014;2014;12;11;Perjantai;5;1;6
95;19.12.2014;2014;12;12;Perjantai;2;1;3
95;19.12.2014;2014;12;13;Perjantai;4;1;5
95;19.12.2014;2014;12;14;Perjantai;8;4;12
95;19.12.2014;2014;12;15;Perjantai;4;4;8
95;19.12.2014;2014;12;16;Perjantai;5;7;12
95;19.12.2014;2014;12;17;Perjantai;1;4;5
95;19.12.2014;2014;12;18;Perjantai;0;2;2
95;19.12.2014;2014;12;19;Perjantai;1;2;3
95;19.12.2014;2014;12;20;Perjantai;2;2;4
95;19.12.2014;2014;12;21;Perjantai;0;1;1
95;19.12.2014;2014;12;22;Perjantai;0;1;1
95;19.12.2014;2014;12;23;Perjantai;0;0;0
95;20.12.2014;2014;12;00;Lauantai;0;1;1
95;20.12.2014;2014;12;01;Lauantai;0;0;0
95;20.12.2014;2014;12;02;Lauantai;0;0;0
95;20.12.2014;2014;12;03;Lauantai;1;0;1
95;20.12.2014;2014;12;04;Lauantai;0;0;0
95;20.12.2014;2014;12;05;Lauantai;0;0;0
95;20.12.2014;2014;12;06;Lauantai;1;0;1
95;20.12.2014;2014;12;07;Lauantai;0;2;2
95;20.12.2014;2014;12;08;Lauantai;1;1;2
95;20.12.2014;2014;12;09;Lauantai;1;1;2
95;20.12.2014;2014;12;10;Lauantai;2;2;4
95;20.12.2014;2014;12;11;Lauantai;2;3;5
95;20.12.2014;2014;12;12;Lauantai;2;2;4
95;20.12.2014;2014;12;13;Lauantai;0;1;1
95;20.12.2014;2014;12;14;Lauantai;0;1;1
95;20.12.2014;2014;12;15;Lauantai;2;0;2
95;20.12.2014;2014;12;16;Lauantai;5;0;5
95;20.12.2014;2014;12;17;Lauantai;0;3;3
95;20.12.2014;2014;12;18;Lauantai;0;2;2
95;20.12.2014;2014;12;19;Lauantai;3;0;3
95;20.12.2014;2014;12;20;Lauantai;1;2;3
95;20.12.2014;2014;12;21;Lauantai;2;2;4
95;20.12.2014;2014;12;22;Lauantai;0;0;0
95;20.12.2014;2014;12;23;Lauantai;0;0;0
95;21.12.2014;2014;12;00;Sunnuntai;0;0;0
95;21.12.2014;2014;12;01;Sunnuntai;0;0;0
95;21.12.2014;2014;12;02;Sunnuntai;0;0;0
95;21.12.2014;2014;12;03;Sunnuntai;0;0;0
95;21.12.2014;2014;12;04;Sunnuntai;1;1;2
95;21.12.2014;2014;12;05;Sunnuntai;0;0;0
95;21.12.2014;2014;12;06;Sunnuntai;1;0;1
95;21.12.2014;2014;12;07;Sunnuntai;0;0;0
95;21.12.2014;2014;12;08;Sunnuntai;2;1;3
95;21.12.2014;2014;12;09;Sunnuntai;8;1;9
95;21.12.2014;2014;12;10;Sunnuntai;1;2;3
95;21.12.2014;2014;12;11;Sunnuntai;1;2;3
95;21.12.2014;2014;12;12;Sunnuntai;0;2;2
95;21.12.2014;2014;12;13;Sunnuntai;5;1;6
95;21.12.2014;2014;12;14;Sunnuntai;1;2;3
95;21.12.2014;2014;12;15;Sunnuntai;2;1;3
95;21.12.2014;2014;12;16;Sunnuntai;0;2;2
95;21.12.2014;2014;12;17;Sunnuntai;1;1;2
95;21.12.2014;2014;12;18;Sunnuntai;3;5;8
95;21.12.2014;2014;12;19;Sunnuntai;5;4;9
95;21.12.2014;2014;12;20;Sunnuntai;4;0;4
95;21.12.2014;2014;12;21;Sunnuntai;1;0;1
95;21.12.2014;2014;12;22;Sunnuntai;0;0;0
95;21.12.2014;2014;12;23;Sunnuntai;0;0;0
95;22.12.2014;2014;12;00;Maanantai;0;0;0
95;22.12.2014;2014;12;01;Maanantai;0;0;0
95;22.12.2014;2014;12;02;Maanantai;0;0;0
95;22.12.2014;2014;12;03;Maanantai;0;0;0
95;22.12.2014;2014;12;04;Maanantai;2;0;2
95;22.12.2014;2014;12;05;Maanantai;3;1;4
95;22.12.2014;2014;12;06;Maanantai;6;5;11
95;22.12.2014;2014;12;07;Maanantai;4;2;6
95;22.12.2014;2014;12;08;Maanantai;4;0;4
95;22.12.2014;2014;12;09;Maanantai;3;2;5
95;22.12.2014;2014;12;10;Maanantai;1;1;2
95;22.12.2014;2014;12;11;Maanantai;0;1;1
95;22.12.2014;2014;12;12;Maanantai;2;2;4
95;22.12.2014;2014;12;13;Maanantai;4;0;4
95;22.12.2014;2014;12;14;Maanantai;2;3;5
95;22.12.2014;2014;12;15;Maanantai;4;6;10
95;22.12.2014;2014;12;16;Maanantai;2;5;7
95;22.12.2014;2014;12;17;Maanantai;1;4;5
95;22.12.2014;2014;12;18;Maanantai;2;2;4
95;22.12.2014;2014;12;19;Maanantai;1;2;3
95;22.12.2014;2014;12;20;Maanantai;2;1;3
95;22.12.2014;2014;12;21;Maanantai;0;2;2
95;22.12.2014;2014;12;22;Maanantai;0;0;0
95;22.12.2014;2014;12;23;Maanantai;0;0;0
95;23.12.2014;2014;12;00;Tiistai;0;0;0
95;23.12.2014;2014;12;01;Tiistai;0;0;0
95;23.12.2014;2014;12;02;Tiistai;0;0;0
95;23.12.2014;2014;12;03;Tiistai;0;0;0
95;23.12.2014;2014;12;04;Tiistai;2;0;2
95;23.12.2014;2014;12;05;Tiistai;3;0;3
95;23.12.2014;2014;12;06;Tiistai;3;2;5
95;23.12.2014;2014;12;07;Tiistai;3;1;4
95;23.12.2014;2014;12;08;Tiistai;1;1;2
95;23.12.2014;2014;12;09;Tiistai;0;1;1
95;23.12.2014;2014;12;10;Tiistai;4;2;6
95;23.12.2014;2014;12;11;Tiistai;1;0;1
95;23.12.2014;2014;12;12;Tiistai;1;5;6
95;23.12.2014;2014;12;13;Tiistai;1;3;4
95;23.12.2014;2014;12;14;Tiistai;0;6;6
95;23.12.2014;2014;12;15;Tiistai;4;2;6
95;23.12.2014;2014;12;16;Tiistai;0;1;1
95;23.12.2014;2014;12;17;Tiistai;1;0;1
95;23.12.2014;2014;12;18;Tiistai;1;1;2
95;23.12.2014;2014;12;19;Tiistai;0;2;2
95;23.12.2014;2014;12;20;Tiistai;1;1;2
95;23.12.2014;2014;12;21;Tiistai;0;1;1
95;23.12.2014;2014;12;22;Tiistai;0;0;0
95;23.12.2014;2014;12;23;Tiistai;0;0;0
95;24.12.2014;2014;12;00;Keskiviikko;0;0;0
95;24.12.2014;2014;12;01;Keskiviikko;0;0;0
95;24.12.2014;2014;12;02;Keskiviikko;0;0;0
95;24.12.2014;2014;12;03;Keskiviikko;0;0;0
95;24.12.2014;2014;12;04;Keskiviikko;0;0;0
95;24.12.2014;2014;12;05;Keskiviikko;0;0;0
95;24.12.2014;2014;12;06;Keskiviikko;0;0;0
95;24.12.2014;2014;12;07;Keskiviikko;0;1;1
95;24.12.2014;2014;12;08;Keskiviikko;0;0;0
95;24.12.2014;2014;12;09;Keskiviikko;0;0;0
95;24.12.2014;2014;12;10;Keskiviikko;1;0;1
95;24.12.2014;2014;12;11;Keskiviikko;0;0;0
95;24.12.2014;2014;12;12;Keskiviikko;0;0;0
95;24.12.2014;2014;12;13;Keskiviikko;0;0;0
95;24.12.2014;2014;12;14;Keskiviikko;2;0;2
95;24.12.2014;2014;12;15;Keskiviikko;0;0;0
95;24.12.2014;2014;12;16;Keskiviikko;0;0;0
95;24.12.2014;2014;12;17;Keskiviikko;0;0;0
95;24.12.2014;2014;12;18;Keskiviikko;0;2;2
95;24.12.2014;2014;12;19;Keskiviikko;0;0;0
95;24.12.2014;2014;12;20;Keskiviikko;0;0;0
95;24.12.2014;2014;12;21;Keskiviikko;0;0;0
95;24.12.2014;2014;12;22;Keskiviikko;0;0;0
95;24.12.2014;2014;12;23;Keskiviikko;0;0;0
95;25.12.2014;2014;12;00;Torstai;0;0;0
95;25.12.2014;2014;12;01;Torstai;0;0;0
95;25.12.2014;2014;12;02;Torstai;0;0;0
95;25.12.2014;2014;12;03;Torstai;0;0;0
95;25.12.2014;2014;12;04;Torstai;0;0;0
95;25.12.2014;2014;12;05;Torstai;0;0;0
95;25.12.2014;2014;12;06;Torstai;0;0;0
95;25.12.2014;2014;12;07;Torstai;0;0;0
95;25.12.2014;2014;12;08;Torstai;2;0;2
95;25.12.2014;2014;12;09;Torstai;0;0;0
95;25.12.2014;2014;12;10;Torstai;0;0;0
95;25.12.2014;2014;12;11;Torstai;0;0;0
95;25.12.2014;2014;12;12;Torstai;0;0;0
95;25.12.2014;2014;12;13;Torstai;1;1;2
95;25.12.2014;2014;12;14;Torstai;2;1;3
95;25.12.2014;2014;12;15;Torstai;0;0;0
95;25.12.2014;2014;12;16;Torstai;0;0;0
95;25.12.2014;2014;12;17;Torstai;0;1;1
95;25.12.2014;2014;12;18;Torstai;0;0;0
95;25.12.2014;2014;12;19;Torstai;1;1;2
95;25.12.2014;2014;12;20;Torstai;0;0;0
95;25.12.2014;2014;12;21;Torstai;0;0;0
95;25.12.2014;2014;12;22;Torstai;0;0;0
95;25.12.2014;2014;12;23;Torstai;0;2;2
95;26.12.2014;2014;12;00;Perjantai;0;0;0
95;26.12.2014;2014;12;01;Perjantai;0;0;0
95;26.12.2014;2014;12;02;Perjantai;0;0;0
95;26.12.2014;2014;12;03;Perjantai;0;0;0
95;26.12.2014;2014;12;04;Perjantai;0;0;0
95;26.12.2014;2014;12;05;Perjantai;0;0;0
95;26.12.2014;2014;12;06;Perjantai;0;0;0
95;26.12.2014;2014;12;07;Perjantai;1;0;1
95;26.12.2014;2014;12;08;Perjantai;0;0;0
95;26.12.2014;2014;12;09;Perjantai;2;3;5
95;26.12.2014;2014;12;10;Perjantai;0;0;0
95;26.12.2014;2014;12;11;Perjantai;2;0;2
95;26.12.2014;2014;12;12;Perjantai;2;6;8
95;26.12.2014;2014;12;13;Perjantai;0;1;1
95;26.12.2014;2014;12;14;Perjantai;0;1;1
95;26.12.2014;2014;12;15;Perjantai;1;1;2
95;26.12.2014;2014;12;16;Perjantai;1;1;2
95;26.12.2014;2014;12;17;Perjantai;0;0;0
95;26.12.2014;2014;12;18;Perjantai;0;0;0
95;26.12.2014;2014;12;19;Perjantai;1;1;2
95;26.12.2014;2014;12;20;Perjantai;0;1;1
95;26.12.2014;2014;12;21;Perjantai;0;0;0
95;26.12.2014;2014;12;22;Perjantai;0;0;0
95;26.12.2014;2014;12;23;Perjantai;0;2;2
95;27.12.2014;2014;12;00;Lauantai;0;0;0
95;27.12.2014;2014;12;01;Lauantai;0;0;0
95;27.12.2014;2014;12;02;Lauantai;0;0;0
95;27.12.2014;2014;12;03;Lauantai;0;0;0
95;27.12.2014;2014;12;04;Lauantai;2;0;2
95;27.12.2014;2014;12;05;Lauantai;0;0;0
95;27.12.2014;2014;12;06;Lauantai;1;1;2
95;27.12.2014;2014;12;07;Lauantai;0;1;1
95;27.12.2014;2014;12;08;Lauantai;1;0;1
95;27.12.2014;2014;12;09;Lauantai;1;2;3
95;27.12.2014;2014;12;10;Lauantai;0;3;3
95;27.12.2014;2014;12;11;Lauantai;2;1;3
95;27.12.2014;2014;12;12;Lauantai;0;1;1
95;27.12.2014;2014;12;13;Lauantai;1;7;8
95;27.12.2014;2014;12;14;Lauantai;3;2;5
95;27.12.2014;2014;12;15;Lauantai;0;5;5
95;27.12.2014;2014;12;16;Lauantai;4;2;6
95;27.12.2014;2014;12;17;Lauantai;3;4;7
95;27.12.2014;2014;12;18;Lauantai;0;0;0
95;27.12.2014;2014;12;19;Lauantai;1;0;1
95;27.12.2014;2014;12;20;Lauantai;0;0;0
95;27.12.2014;2014;12;21;Lauantai;0;0;0
95;27.12.2014;2014;12;22;Lauantai;2;1;3
95;27.12.2014;2014;12;23;Lauantai;0;0;0
95;28.12.2014;2014;12;00;Sunnuntai;0;0;0
95;28.12.2014;2014;12;01;Sunnuntai;0;0;0
95;28.12.2014;2014;12;02;Sunnuntai;0;0;0
95;28.12.2014;2014;12;03;Sunnuntai;0;0;0
95;28.12.2014;2014;12;04;Sunnuntai;2;0;2
95;28.12.2014;2014;12;05;Sunnuntai;0;0;0
95;28.12.2014;2014;12;06;Sunnuntai;0;0;0
95;28.12.2014;2014;12;07;Sunnuntai;0;1;1
95;28.12.2014;2014;12;08;Sunnuntai;0;0;0
95;28.12.2014;2014;12;09;Sunnuntai;0;0;0
95;28.12.2014;2014;12;10;Sunnuntai;1;1;2
95;28.12.2014;2014;12;11;Sunnuntai;2;0;2
95;28.12.2014;2014;12;12;Sunnuntai;0;0;0
95;28.12.2014;2014;12;13;Sunnuntai;0;3;3
95;28.12.2014;2014;12;14;Sunnuntai;0;1;1
95;28.12.2014;2014;12;15;Sunnuntai;0;1;1
95;28.12.2014;2014;12;16;Sunnuntai;3;1;4
95;28.12.2014;2014;12;17;Sunnuntai;1;0;1
95;28.12.2014;2014;12;18;Sunnuntai;2;1;3
95;28.12.2014;2014;12;19;Sunnuntai;0;1;1
95;28.12.2014;2014;12;20;Sunnuntai;0;0;0
95;28.12.2014;2014;12;21;Sunnuntai;0;0;0
95;28.12.2014;2014;12;22;Sunnuntai;0;0;0
95;28.12.2014;2014;12;23;Sunnuntai;0;0;0
95;29.12.2014;2014;12;00;Maanantai;0;0;0
95;29.12.2014;2014;12;01;Maanantai;0;0;0
95;29.12.2014;2014;12;02;Maanantai;0;0;0
95;29.12.2014;2014;12;03;Maanantai;0;0;0
95;29.12.2014;2014;12;04;Maanantai;0;0;0
95;29.12.2014;2014;12;05;Maanantai;1;2;3
95;29.12.2014;2014;12;06;Maanantai;5;0;5
95;29.12.2014;2014;12;07;Maanantai;2;2;4
95;29.12.2014;2014;12;08;Maanantai;3;1;4
95;29.12.2014;2014;12;09;Maanantai;2;1;3
95;29.12.2014;2014;12;10;Maanantai;1;2;3
95;29.12.2014;2014;12;11;Maanantai;1;4;5
95;29.12.2014;2014;12;12;Maanantai;3;0;3
95;29.12.2014;2014;12;13;Maanantai;3;6;9
95;29.12.2014;2014;12;14;Maanantai;4;0;4
95;29.12.2014;2014;12;15;Maanantai;3;2;5
95;29.12.2014;2014;12;16;Maanantai;1;3;4
95;29.12.2014;2014;12;17;Maanantai;6;1;7
95;29.12.2014;2014;12;18;Maanantai;1;4;5
95;29.12.2014;2014;12;19;Maanantai;2;2;4
95;29.12.2014;2014;12;20;Maanantai;1;2;3
95;29.12.2014;2014;12;21;Maanantai;0;5;5
95;29.12.2014;2014;12;22;Maanantai;5;0;5
95;29.12.2014;2014;12;23;Maanantai;0;0;0
95;30.12.2014;2014;12;00;Tiistai;0;0;0
95;30.12.2014;2014;12;01;Tiistai;1;0;1
95;30.12.2014;2014;12;02;Tiistai;0;0;0
95;30.12.2014;2014;12;03;Tiistai;0;0;0
95;30.12.2014;2014;12;04;Tiistai;0;0;0
95;30.12.2014;2014;12;05;Tiistai;4;1;5
95;30.12.2014;2014;12;06;Tiistai;4;1;5
95;30.12.2014;2014;12;07;Tiistai;3;2;5
95;30.12.2014;2014;12;08;Tiistai;5;0;5
95;30.12.2014;2014;12;09;Tiistai;1;2;3
95;30.12.2014;2014;12;10;Tiistai;8;2;10
95;30.12.2014;2014;12;11;Tiistai;2;1;3
95;30.12.2014;2014;12;12;Tiistai;5;5;10
95;30.12.2014;2014;12;13;Tiistai;3;2;5
95;30.12.2014;2014;12;14;Tiistai;1;2;3
95;30.12.2014;2014;12;15;Tiistai;8;2;10
95;30.12.2014;2014;12;16;Tiistai;0;6;6
95;30.12.2014;2014;12;17;Tiistai;1;5;6
95;30.12.2014;2014;12;18;Tiistai;1;3;4
95;30.12.2014;2014;12;19;Tiistai;0;0;0
95;30.12.2014;2014;12;20;Tiistai;1;0;1
95;30.12.2014;2014;12;21;Tiistai;0;2;2
95;30.12.2014;2014;12;22;Tiistai;2;1;3
95;30.12.2014;2014;12;23;Tiistai;0;0;0
95;31.12.2014;2014;12;00;Keskiviikko;0;1;1
95;31.12.2014;2014;12;01;Keskiviikko;1;0;1
95;31.12.2014;2014;12;02;Keskiviikko;0;0;0
95;31.12.2014;2014;12;03;Keskiviikko;0;0;0
95;31.12.2014;2014;12;04;Keskiviikko;1;0;1
95;31.12.2014;2014;12;05;Keskiviikko;3;2;5
95;31.12.2014;2014;12;06;Keskiviikko;1;0;1
95;31.12.2014;2014;12;07;Keskiviikko;4;4;8
95;31.12.2014;2014;12;08;Keskiviikko;6;3;9
95;31.12.2014;2014;12;09;Keskiviikko;3;1;4
95;31.12.2014;2014;12;10;Keskiviikko;2;3;5
95;31.12.2014;2014;12;11;Keskiviikko;1;2;3
95;31.12.2014;2014;12;12;Keskiviikko;2;1;3
95;31.12.2014;2014;12;13;Keskiviikko;2;5;7
95;31.12.2014;2014;12;14;Keskiviikko;12;5;17
95;31.12.2014;2014;12;15;Keskiviikko;4;5;9
95;31.12.2014;2014;12;16;Keskiviikko;4;0;4
95;31.12.2014;2014;12;17;Keskiviikko;4;3;7
95;31.12.2014;2014;12;18;Keskiviikko;2;1;3
95;31.12.2014;2014;12;19;Keskiviikko;0;2;2
95;31.12.2014;2014;12;20;Keskiviikko;0;2;2
95;31.12.2014;2014;12;21;Keskiviikko;1;0;1
95;31.12.2014;2014;12;22;Keskiviikko;2;1;3
95;31.12.2014;2014;12;23;Keskiviikko;1;0;1
95;01.01.2015;2015;01;00;Torstai;0;0;0
95;01.01.2015;2015;01;01;Torstai;0;0;0
95;01.01.2015;2015;01;02;Torstai;0;0;0
95;01.01.2015;2015;01;03;Torstai;0;1;1
95;01.01.2015;2015;01;04;Torstai;0;2;2
95;01.01.2015;2015;01;05;Torstai;0;0;0
95;01.01.2015;2015;01;06;Torstai;1;0;1
95;01.01.2015;2015;01;07;Torstai;0;1;1
95;01.01.2015;2015;01;08;Torstai;2;0;2
95;01.01.2015;2015;01;09;Torstai;1;0;1
95;01.01.2015;2015;01;10;Torstai;1;3;4
95;01.01.2015;2015;01;11;Torstai;3;0;3
95;01.01.2015;2015;01;12;Torstai;2;2;4
95;01.01.2015;2015;01;13;Torstai;3;6;9
95;01.01.2015;2015;01;14;Torstai;3;5;8
95;01.01.2015;2015;01;15;Torstai;1;3;4
95;01.01.2015;2015;01;16;Torstai;4;5;9
95;01.01.2015;2015;01;17;Torstai;0;2;2
95;01.01.2015;2015;01;18;Torstai;3;0;3
95;01.01.2015;2015;01;19;Torstai;0;1;1
95;01.01.2015;2015;01;20;Torstai;0;0;0
95;01.01.2015;2015;01;21;Torstai;0;0;0
95;01.01.2015;2015;01;22;Torstai;0;0;0
95;01.01.2015;2015;01;23;Torstai;0;0;0
95;02.01.2015;2015;01;00;Perjantai;0;0;0
95;02.01.2015;2015;01;01;Perjantai;0;0;0
95;02.01.2015;2015;01;02;Perjantai;0;0;0
95;02.01.2015;2015;01;03;Perjantai;0;0;0
95;02.01.2015;2015;01;04;Perjantai;1;0;1
95;02.01.2015;2015;01;05;Perjantai;1;2;3
95;02.01.2015;2015;01;06;Perjantai;2;0;2
95;02.01.2015;2015;01;07;Perjantai;2;1;3
95;02.01.2015;2015;01;08;Perjantai;3;3;6
95;02.01.2015;2015;01;09;Perjantai;1;0;1
95;02.01.2015;2015;01;10;Perjantai;1;3;4
95;02.01.2015;2015;01;11;Perjantai;2;1;3
95;02.01.2015;2015;01;12;Perjantai;3;3;6
95;02.01.2015;2015;01;13;Perjantai;0;3;3
95;02.01.2015;2015;01;14;Perjantai;5;3;8
95;02.01.2015;2015;01;15;Perjantai;1;0;1
95;02.01.2015;2015;01;16;Perjantai;2;3;5
95;02.01.2015;2015;01;17;Perjantai;0;0;0
95;02.01.2015;2015;01;18;Perjantai;1;5;6
95;02.01.2015;2015;01;19;Perjantai;1;0;1
95;02.01.2015;2015;01;20;Perjantai;0;0;0
95;02.01.2015;2015;01;21;Perjantai;0;0;0
95;02.01.2015;2015;01;22;Perjantai;0;1;1
95;02.01.2015;2015;01;23;Perjantai;0;0;0
95;03.01.2015;2015;01;00;Lauantai;1;0;1
95;03.01.2015;2015;01;01;Lauantai;0;0;0
95;03.01.2015;2015;01;02;Lauantai;0;0;0
95;03.01.2015;2015;01;03;Lauantai;0;0;0
95;03.01.2015;2015;01;04;Lauantai;0;0;0
95;03.01.2015;2015;01;05;Lauantai;0;0;0
95;03.01.2015;2015;01;06;Lauantai;0;0;0
95;03.01.2015;2015;01;07;Lauantai;0;0;0
95;03.01.2015;2015;01;08;Lauantai;1;0;1
95;03.01.2015;2015;01;09;Lauantai;0;0;0
95;03.01.2015;2015;01;10;Lauantai;2;1;3
95;03.01.2015;2015;01;11;Lauantai;3;0;3
95;03.01.2015;2015;01;12;Lauantai;0;0;0
95;03.01.2015;2015;01;13;Lauantai;3;3;6
95;03.01.2015;2015;01;14;Lauantai;0;2;2
95;03.01.2015;2015;01;15;Lauantai;1;0;1
95;03.01.2015;2015;01;16;Lauantai;2;3;5
95;03.01.2015;2015;01;17;Lauantai;2;2;4
95;03.01.2015;2015;01;18;Lauantai;0;2;2
95;03.01.2015;2015;01;19;Lauantai;0;0;0
95;03.01.2015;2015;01;20;Lauantai;2;0;2
95;03.01.2015;2015;01;21;Lauantai;0;0;0
95;03.01.2015;2015;01;22;Lauantai;1;0;1
95;03.01.2015;2015;01;23;Lauantai;1;0;1
95;04.01.2015;2015;01;00;Sunnuntai;0;0;0
95;04.01.2015;2015;01;01;Sunnuntai;0;0;0
95;04.01.2015;2015;01;02;Sunnuntai;0;0;0
95;04.01.2015;2015;01;03;Sunnuntai;0;0;0
95;04.01.2015;2015;01;04;Sunnuntai;0;0;0
95;04.01.2015;2015;01;05;Sunnuntai;0;0;0
95;04.01.2015;2015;01;06;Sunnuntai;0;1;1
95;04.01.2015;2015;01;07;Sunnuntai;0;0;0
95;04.01.2015;2015;01;08;Sunnuntai;0;6;6
95;04.01.2015;2015;01;09;Sunnuntai;1;2;3
95;04.01.2015;2015;01;10;Sunnuntai;0;1;1
95;04.01.2015;2015;01;11;Sunnuntai;0;0;0
95;04.01.2015;2015;01;12;Sunnuntai;1;2;3
95;04.01.2015;2015;01;13;Sunnuntai;2;2;4
95;04.01.2015;2015;01;14;Sunnuntai;1;0;1
95;04.01.2015;2015;01;15;Sunnuntai;0;1;1
95;04.01.2015;2015;01;16;Sunnuntai;0;3;3
95;04.01.2015;2015;01;17;Sunnuntai;1;1;2
95;04.01.2015;2015;01;18;Sunnuntai;1;1;2
95;04.01.2015;2015;01;19;Sunnuntai;0;2;2
95;04.01.2015;2015;01;20;Sunnuntai;0;0;0
95;04.01.2015;2015;01;21;Sunnuntai;1;0;1
95;04.01.2015;2015;01;22;Sunnuntai;2;0;2
95;04.01.2015;2015;01;23;Sunnuntai;2;0;2
95;05.01.2015;2015;01;00;Maanantai;0;0;0
95;05.01.2015;2015;01;01;Maanantai;0;0;0
95;05.01.2015;2015;01;02;Maanantai;0;0;0
95;05.01.2015;2015;01;03;Maanantai;0;0;0
95;05.01.2015;2015;01;04;Maanantai;2;1;3
95;05.01.2015;2015;01;05;Maanantai;0;1;1
95;05.01.2015;2015;01;06;Maanantai;5;1;6
95;05.01.2015;2015;01;07;Maanantai;5;2;7
95;05.01.2015;2015;01;08;Maanantai;4;0;4
95;05.01.2015;2015;01;09;Maanantai;1;1;2
95;05.01.2015;2015;01;10;Maanantai;0;0;0
95;05.01.2015;2015;01;11;Maanantai;1;2;3
95;05.01.2015;2015;01;12;Maanantai;0;2;2
95;05.01.2015;2015;01;13;Maanantai;2;2;4
95;05.01.2015;2015;01;14;Maanantai;1;5;6
95;05.01.2015;2015;01;15;Maanantai;3;2;5
95;05.01.2015;2015;01;16;Maanantai;1;5;6
95;05.01.2015;2015;01;17;Maanantai;1;2;3
95;05.01.2015;2015;01;18;Maanantai;2;1;3
95;05.01.2015;2015;01;19;Maanantai;0;1;1
95;05.01.2015;2015;01;20;Maanantai;0;0;0
95;05.01.2015;2015;01;21;Maanantai;0;1;1
95;05.01.2015;2015;01;22;Maanantai;0;0;0
95;05.01.2015;2015;01;23;Maanantai;0;0;0
95;06.01.2015;2015;01;00;Tiistai;0;0;0
95;06.01.2015;2015;01;01;Tiistai;0;0;0
95;06.01.2015;2015;01;02;Tiistai;0;0;0
95;06.01.2015;2015;01;03;Tiistai;0;0;0
95;06.01.2015;2015;01;04;Tiistai;2;0;2
95;06.01.2015;2015;01;05;Tiistai;0;1;1
95;06.01.2015;2015;01;06;Tiistai;1;0;1
95;06.01.2015;2015;01;07;Tiistai;1;0;1
95;06.01.2015;2015;01;08;Tiistai;1;0;1
95;06.01.2015;2015;01;09;Tiistai;0;1;1
95;06.01.2015;2015;01;10;Tiistai;0;0;0
95;06.01.2015;2015;01;11;Tiistai;0;0;0
95;06.01.2015;2015;01;12;Tiistai;1;0;1
95;06.01.2015;2015;01;13;Tiistai;0;1;1
95;06.01.2015;2015;01;14;Tiistai;2;1;3
95;06.01.2015;2015;01;15;Tiistai;3;1;4
95;06.01.2015;2015;01;16;Tiistai;0;2;2
95;06.01.2015;2015;01;17;Tiistai;0;0;0
95;06.01.2015;2015;01;18;Tiistai;1;1;2
95;06.01.2015;2015;01;19;Tiistai;0;0;0
95;06.01.2015;2015;01;20;Tiistai;0;1;1
95;06.01.2015;2015;01;21;Tiistai;0;0;0
95;06.01.2015;2015;01;22;Tiistai;0;0;0
95;06.01.2015;2015;01;23;Tiistai;0;0;0
95;07.01.2015;2015;01;00;Keskiviikko;0;1;1
95;07.01.2015;2015;01;01;Keskiviikko;0;0;0
95;07.01.2015;2015;01;02;Keskiviikko;0;0;0
95;07.01.2015;2015;01;03;Keskiviikko;0;0;0
95;07.01.2015;2015;01;04;Keskiviikko;1;0;1
95;07.01.2015;2015;01;05;Keskiviikko;3;2;5
95;07.01.2015;2015;01;06;Keskiviikko;8;4;12
95;07.01.2015;2015;01;07;Keskiviikko;10;7;17
95;07.01.2015;2015;01;08;Keskiviikko;1;3;4
95;07.01.2015;2015;01;09;Keskiviikko;5;3;8
95;07.01.2015;2015;01;10;Keskiviikko;0;3;3
95;07.01.2015;2015;01;11;Keskiviikko;2;2;4
95;07.01.2015;2015;01;12;Keskiviikko;2;4;6
95;07.01.2015;2015;01;13;Keskiviikko;3;3;6
95;07.01.2015;2015;01;14;Keskiviikko;5;2;7
95;07.01.2015;2015;01;15;Keskiviikko;6;5;11
95;07.01.2015;2015;01;16;Keskiviikko;2;10;12
95;07.01.2015;2015;01;17;Keskiviikko;1;7;8
95;07.01.2015;2015;01;18;Keskiviikko;0;4;4
95;07.01.2015;2015;01;19;Keskiviikko;2;1;3
95;07.01.2015;2015;01;20;Keskiviikko;0;0;0
95;07.01.2015;2015;01;21;Keskiviikko;1;0;1
95;07.01.2015;2015;01;22;Keskiviikko;1;0;1
95;07.01.2015;2015;01;23;Keskiviikko;0;0;0
95;08.01.2015;2015;01;00;Torstai;0;0;0
95;08.01.2015;2015;01;01;Torstai;0;0;0
95;08.01.2015;2015;01;02;Torstai;0;0;0
95;08.01.2015;2015;01;03;Torstai;0;0;0
95;08.01.2015;2015;01;04;Torstai;0;0;0
95;08.01.2015;2015;01;05;Torstai;2;1;3
95;08.01.2015;2015;01;06;Torstai;4;3;7
95;08.01.2015;2015;01;07;Torstai;6;6;12
95;08.01.2015;2015;01;08;Torstai;6;3;9
95;08.01.2015;2015;01;09;Torstai;2;3;5
95;08.01.2015;2015;01;10;Torstai;5;4;9
95;08.01.2015;2015;01;11;Torstai;0;2;2
95;08.01.2015;2015;01;12;Torstai;7;0;7
95;08.01.2015;2015;01;13;Torstai;0;2;2
95;08.01.2015;2015;01;14;Torstai;6;2;8
95;08.01.2015;2015;01;15;Torstai;5;4;9
95;08.01.2015;2015;01;16;Torstai;9;5;14
95;08.01.2015;2015;01;17;Torstai;0;3;3
95;08.01.2015;2015;01;18;Torstai;0;5;5
95;08.01.2015;2015;01;19;Torstai;1;2;3
95;08.01.2015;2015;01;20;Torstai;1;1;2
95;08.01.2015;2015;01;21;Torstai;2;1;3
95;08.01.2015;2015;01;22;Torstai;1;0;1
95;08.01.2015;2015;01;23;Torstai;0;0;0
95;09.01.2015;2015;01;00;Perjantai;0;0;0
95;09.01.2015;2015;01;01;Perjantai;0;0;0
95;09.01.2015;2015;01;02;Perjantai;0;0;0
95;09.01.2015;2015;01;03;Perjantai;0;0;0
95;09.01.2015;2015;01;04;Perjantai;1;0;1
95;09.01.2015;2015;01;05;Perjantai;2;2;4
95;09.01.2015;2015;01;06;Perjantai;3;2;5
95;09.01.2015;2015;01;07;Perjantai;9;9;18
95;09.01.2015;2015;01;08;Perjantai;4;2;6
95;09.01.2015;2015;01;09;Perjantai;2;3;5
95;09.01.2015;2015;01;10;Perjantai;1;0;1
95;09.01.2015;2015;01;11;Perjantai;3;2;5
95;09.01.2015;2015;01;12;Perjantai;1;0;1
95;09.01.2015;2015;01;13;Perjantai;2;3;5
95;09.01.2015;2015;01;14;Perjantai;5;4;9
95;09.01.2015;2015;01;15;Perjantai;11;5;16
95;09.01.2015;2015;01;16;Perjantai;4;7;11
95;09.01.2015;2015;01;17;Perjantai;1;2;3
95;09.01.2015;2015;01;18;Perjantai;5;2;7
95;09.01.2015;2015;01;19;Perjantai;3;2;5
95;09.01.2015;2015;01;20;Perjantai;0;1;1
95;09.01.2015;2015;01;21;Perjantai;0;1;1
95;09.01.2015;2015;01;22;Perjantai;0;0;0
95;09.01.2015;2015;01;23;Perjantai;0;0;0
95;10.01.2015;2015;01;00;Lauantai;0;0;0
95;10.01.2015;2015;01;01;Lauantai;0;1;1
95;10.01.2015;2015;01;02;Lauantai;0;0;0
95;10.01.2015;2015;01;03;Lauantai;0;0;0
95;10.01.2015;2015;01;04;Lauantai;1;0;1
95;10.01.2015;2015;01;05;Lauantai;0;1;1
95;10.01.2015;2015;01;06;Lauantai;3;0;3
95;10.01.2015;2015;01;07;Lauantai;1;0;1
95;10.01.2015;2015;01;08;Lauantai;1;0;1
95;10.01.2015;2015;01;09;Lauantai;3;2;5
95;10.01.2015;2015;01;10;Lauantai;1;0;1
95;10.01.2015;2015;01;11;Lauantai;0;1;1
95;10.01.2015;2015;01;12;Lauantai;0;0;0
95;10.01.2015;2015;01;13;Lauantai;2;2;4
95;10.01.2015;2015;01;14;Lauantai;3;2;5
95;10.01.2015;2015;01;15;Lauantai;0;4;4
95;10.01.2015;2015;01;16;Lauantai;0;1;1
95;10.01.2015;2015;01;17;Lauantai;0;0;0
95;10.01.2015;2015;01;18;Lauantai;1;2;3
95;10.01.2015;2015;01;19;Lauantai;0;0;0
95;10.01.2015;2015;01;20;Lauantai;1;0;1
95;10.01.2015;2015;01;21;Lauantai;1;0;1
95;10.01.2015;2015;01;22;Lauantai;0;0;0
95;10.01.2015;2015;01;23;Lauantai;0;0;0
95;11.01.2015;2015;01;00;Sunnuntai;1;0;1
95;11.01.2015;2015;01;01;Sunnuntai;0;0;0
95;11.01.2015;2015;01;02;Sunnuntai;0;0;0
95;11.01.2015;2015;01;03;Sunnuntai;0;0;0
95;11.01.2015;2015;01;04;Sunnuntai;0;0;0
95;11.01.2015;2015;01;05;Sunnuntai;0;0;0
95;11.01.2015;2015;01;06;Sunnuntai;1;1;2
95;11.01.2015;2015;01;07;Sunnuntai;2;1;3
95;11.01.2015;2015;01;08;Sunnuntai;0;0;0
95;11.01.2015;2015;01;09;Sunnuntai;1;0;1
95;11.01.2015;2015;01;10;Sunnuntai;0;0;0
95;11.01.2015;2015;01;11;Sunnuntai;1;0;1
95;11.01.2015;2015;01;12;Sunnuntai;0;1;1
95;11.01.2015;2015;01;13;Sunnuntai;0;0;0
95;11.01.2015;2015;01;14;Sunnuntai;3;2;5
95;11.01.2015;2015;01;15;Sunnuntai;0;0;0
95;11.01.2015;2015;01;16;Sunnuntai;1;1;2
95;11.01.2015;2015;01;17;Sunnuntai;0;0;0
95;11.01.2015;2015;01;18;Sunnuntai;0;0;0
95;11.01.2015;2015;01;19;Sunnuntai;1;1;2
95;11.01.2015;2015;01;20;Sunnuntai;0;0;0
95;11.01.2015;2015;01;21;Sunnuntai;0;0;0
95;11.01.2015;2015;01;22;Sunnuntai;0;0;0
95;11.01.2015;2015;01;23;Sunnuntai;0;1;1
95;12.01.2015;2015;01;00;Maanantai;1;0;1
95;12.01.2015;2015;01;01;Maanantai;0;0;0
95;12.01.2015;2015;01;02;Maanantai;0;0;0
95;12.01.2015;2015;01;03;Maanantai;0;0;0
95;12.01.2015;2015;01;04;Maanantai;1;0;1
95;12.01.2015;2015;01;05;Maanantai;0;2;2
95;12.01.2015;2015;01;06;Maanantai;7;3;10
95;12.01.2015;2015;01;07;Maanantai;3;5;8
95;12.01.2015;2015;01;08;Maanantai;4;2;6
95;12.01.2015;2015;01;09;Maanantai;0;2;2
95;12.01.2015;2015;01;10;Maanantai;2;2;4
95;12.01.2015;2015;01;11;Maanantai;1;1;2
95;12.01.2015;2015;01;12;Maanantai;1;0;1
95;12.01.2015;2015;01;13;Maanantai;1;5;6
95;12.01.2015;2015;01;14;Maanantai;3;4;7
95;12.01.2015;2015;01;15;Maanantai;6;1;7
95;12.01.2015;2015;01;16;Maanantai;4;6;10
95;12.01.2015;2015;01;17;Maanantai;2;2;4
95;12.01.2015;2015;01;18;Maanantai;0;1;1
95;12.01.2015;2015;01;19;Maanantai;0;0;0
95;12.01.2015;2015;01;20;Maanantai;1;0;1
95;12.01.2015;2015;01;21;Maanantai;0;0;0
95;12.01.2015;2015;01;22;Maanantai;2;1;3
95;12.01.2015;2015;01;23;Maanantai;0;0;0
95;13.01.2015;2015;01;00;Tiistai;0;0;0
95;13.01.2015;2015;01;01;Tiistai;1;0;1
95;13.01.2015;2015;01;02;Tiistai;0;0;0
95;13.01.2015;2015;01;03;Tiistai;0;0;0
95;13.01.2015;2015;01;04;Tiistai;1;0;1
95;13.01.2015;2015;01;05;Tiistai;0;2;2
95;13.01.2015;2015;01;06;Tiistai;9;2;11
95;13.01.2015;2015;01;07;Tiistai;5;10;15
95;13.01.2015;2015;01;08;Tiistai;3;2;5
95;13.01.2015;2015;01;09;Tiistai;0;0;0
95;13.01.2015;2015;01;10;Tiistai;0;1;1
95;13.01.2015;2015;01;11;Tiistai;3;1;4
95;13.01.2015;2015;01;12;Tiistai;2;0;2
95;13.01.2015;2015;01;13;Tiistai;1;3;4
95;13.01.2015;2015;01;14;Tiistai;2;0;2
95;13.01.2015;2015;01;15;Tiistai;7;6;13
95;13.01.2015;2015;01;16;Tiistai;5;4;9
95;13.01.2015;2015;01;17;Tiistai;6;3;9
95;13.01.2015;2015;01;18;Tiistai;1;2;3
95;13.01.2015;2015;01;19;Tiistai;0;1;1
95;13.01.2015;2015;01;20;Tiistai;0;4;4
95;13.01.2015;2015;01;21;Tiistai;0;0;0
95;13.01.2015;2015;01;22;Tiistai;2;0;2
95;13.01.2015;2015;01;23;Tiistai;0;0;0
95;14.01.2015;2015;01;00;Keskiviikko;1;0;1
95;14.01.2015;2015;01;01;Keskiviikko;1;1;2
95;14.01.2015;2015;01;02;Keskiviikko;0;0;0
95;14.01.2015;2015;01;03;Keskiviikko;0;0;0
95;14.01.2015;2015;01;04;Keskiviikko;0;0;0
95;14.01.2015;2015;01;05;Keskiviikko;2;2;4
95;14.01.2015;2015;01;06;Keskiviikko;7;4;11
95;14.01.2015;2015;01;07;Keskiviikko;5;5;10
95;14.01.2015;2015;01;08;Keskiviikko;9;1;10
95;14.01.2015;2015;01;09;Keskiviikko;2;2;4
95;14.01.2015;2015;01;10;Keskiviikko;2;2;4
95;14.01.2015;2015;01;11;Keskiviikko;0;3;3
95;14.01.2015;2015;01;12;Keskiviikko;6;4;10
95;14.01.2015;2015;01;13;Keskiviikko;0;2;2
95;14.01.2015;2015;01;14;Keskiviikko;8;0;8
95;14.01.2015;2015;01;15;Keskiviikko;4;5;9
95;14.01.2015;2015;01;16;Keskiviikko;2;7;9
95;14.01.2015;2015;01;17;Keskiviikko;2;3;5
95;14.01.2015;2015;01;18;Keskiviikko;0;7;7
95;14.01.2015;2015;01;19;Keskiviikko;1;1;2
95;14.01.2015;2015;01;20;Keskiviikko;0;0;0
95;14.01.2015;2015;01;21;Keskiviikko;1;0;1
95;14.01.2015;2015;01;22;Keskiviikko;1;0;1
95;14.01.2015;2015;01;23;Keskiviikko;0;0;0
95;15.01.2015;2015;01;00;Torstai;0;0;0
95;15.01.2015;2015;01;01;Torstai;1;0;1
95;15.01.2015;2015;01;02;Torstai;0;0;0
95;15.01.2015;2015;01;03;Torstai;2;0;2
95;15.01.2015;2015;01;04;Torstai;2;0;2
95;15.01.2015;2015;01;05;Torstai;2;2;4
95;15.01.2015;2015;01;06;Torstai;9;4;13
95;15.01.2015;2015;01;07;Torstai;7;7;14
95;15.01.2015;2015;01;08;Torstai;7;0;7
95;15.01.2015;2015;01;09;Torstai;3;2;5
95;15.01.2015;2015;01;10;Torstai;3;2;5
95;15.01.2015;2015;01;11;Torstai;1;4;5
95;15.01.2015;2015;01;12;Torstai;5;1;6
95;15.01.2015;2015;01;13;Torstai;1;5;6
95;15.01.2015;2015;01;14;Torstai;6;2;8
95;15.01.2015;2015;01;15;Torstai;4;9;13
95;15.01.2015;2015;01;16;Torstai;12;7;19
95;15.01.2015;2015;01;17;Torstai;4;9;13
95;15.01.2015;2015;01;18;Torstai;2;7;9
95;15.01.2015;2015;01;19;Torstai;4;2;6
95;15.01.2015;2015;01;20;Torstai;2;1;3
95;15.01.2015;2015;01;21;Torstai;3;1;4
95;15.01.2015;2015;01;22;Torstai;1;2;3
95;15.01.2015;2015;01;23;Torstai;0;0;0
95;16.01.2015;2015;01;00;Perjantai;0;0;0
95;16.01.2015;2015;01;01;Perjantai;0;0;0
95;16.01.2015;2015;01;02;Perjantai;0;0;0
95;16.01.2015;2015;01;03;Perjantai;0;0;0
95;16.01.2015;2015;01;04;Perjantai;1;0;1
95;16.01.2015;2015;01;05;Perjantai;3;2;5
95;16.01.2015;2015;01;06;Perjantai;11;3;14
95;16.01.2015;2015;01;07;Perjantai;11;8;19
95;16.01.2015;2015;01;08;Perjantai;2;1;3
95;16.01.2015;2015;01;09;Perjantai;1;2;3
95;16.01.2015;2015;01;10;Perjantai;1;1;2
95;16.01.2015;2015;01;11;Perjantai;3;0;3
95;16.01.2015;2015;01;12;Perjantai;0;0;0
95;16.01.2015;2015;01;13;Perjantai;2;2;4
95;16.01.2015;2015;01;14;Perjantai;7;4;11
95;16.01.2015;2015;01;15;Perjantai;4;4;8
95;16.01.2015;2015;01;16;Perjantai;2;7;9
95;16.01.2015;2015;01;17;Perjantai;2;5;7
95;16.01.2015;2015;01;18;Perjantai;0;3;3
95;16.01.2015;2015;01;19;Perjantai;1;0;1
95;16.01.2015;2015;01;20;Perjantai;3;1;4
95;16.01.2015;2015;01;21;Perjantai;1;1;2
95;16.01.2015;2015;01;22;Perjantai;2;0;2
95;16.01.2015;2015;01;23;Perjantai;0;0;0
95;17.01.2015;2015;01;00;Lauantai;0;0;0
95;17.01.2015;2015;01;01;Lauantai;0;0;0
95;17.01.2015;2015;01;02;Lauantai;0;0;0
95;17.01.2015;2015;01;03;Lauantai;0;0;0
95;17.01.2015;2015;01;04;Lauantai;1;0;1
95;17.01.2015;2015;01;05;Lauantai;1;0;1
95;17.01.2015;2015;01;06;Lauantai;0;0;0
95;17.01.2015;2015;01;07;Lauantai;1;3;4
95;17.01.2015;2015;01;08;Lauantai;4;0;4
95;17.01.2015;2015;01;09;Lauantai;0;1;1
95;17.01.2015;2015;01;10;Lauantai;0;2;2
95;17.01.2015;2015;01;11;Lauantai;6;1;7
95;17.01.2015;2015;01;12;Lauantai;0;0;0
95;17.01.2015;2015;01;13;Lauantai;2;0;2
95;17.01.2015;2015;01;14;Lauantai;2;1;3
95;17.01.2015;2015;01;15;Lauantai;3;3;6
95;17.01.2015;2015;01;16;Lauantai;3;2;5
95;17.01.2015;2015;01;17;Lauantai;2;1;3
95;17.01.2015;2015;01;18;Lauantai;0;3;3
95;17.01.2015;2015;01;19;Lauantai;1;0;1
95;17.01.2015;2015;01;20;Lauantai;1;1;2
95;17.01.2015;2015;01;21;Lauantai;1;0;1
95;17.01.2015;2015;01;22;Lauantai;0;0;0
95;17.01.2015;2015;01;23;Lauantai;0;0;0
95;18.01.2015;2015;01;00;Sunnuntai;0;0;0
95;18.01.2015;2015;01;01;Sunnuntai;0;0;0
95;18.01.2015;2015;01;02;Sunnuntai;0;0;0
95;18.01.2015;2015;01;03;Sunnuntai;0;0;0
95;18.01.2015;2015;01;04;Sunnuntai;0;1;1
95;18.01.2015;2015;01;05;Sunnuntai;0;0;0
95;18.01.2015;2015;01;06;Sunnuntai;0;0;0
95;18.01.2015;2015;01;07;Sunnuntai;0;0;0
95;18.01.2015;2015;01;08;Sunnuntai;1;1;2
95;18.01.2015;2015;01;09;Sunnuntai;2;1;3
95;18.01.2015;2015;01;10;Sunnuntai;0;2;2
95;18.01.2015;2015;01;11;Sunnuntai;1;2;3
95;18.01.2015;2015;01;12;Sunnuntai;1;1;2
95;18.01.2015;2015;01;13;Sunnuntai;0;2;2
95;18.01.2015;2015;01;14;Sunnuntai;2;1;3
95;18.01.2015;2015;01;15;Sunnuntai;1;1;2
95;18.01.2015;2015;01;16;Sunnuntai;1;0;1
95;18.01.2015;2015;01;17;Sunnuntai;0;0;0
95;18.01.2015;2015;01;18;Sunnuntai;0;1;1
95;18.01.2015;2015;01;19;Sunnuntai;4;2;6
95;18.01.2015;2015;01;20;Sunnuntai;0;0;0
95;18.01.2015;2015;01;21;Sunnuntai;0;1;1
95;18.01.2015;2015;01;22;Sunnuntai;0;0;0
95;18.01.2015;2015;01;23;Sunnuntai;0;0;0
95;19.01.2015;2015;01;00;Maanantai;0;0;0
95;19.01.2015;2015;01;01;Maanantai;0;0;0
95;19.01.2015;2015;01;02;Maanantai;0;0;0
95;19.01.2015;2015;01;03;Maanantai;0;0;0
95;19.01.2015;2015;01;04;Maanantai;1;0;1
95;19.01.2015;2015;01;05;Maanantai;1;2;3
95;19.01.2015;2015;01;06;Maanantai;8;3;11
95;19.01.2015;2015;01;07;Maanantai;6;5;11
95;19.01.2015;2015;01;08;Maanantai;3;1;4
95;19.01.2015;2015;01;09;Maanantai;2;1;3
95;19.01.2015;2015;01;10;Maanantai;2;1;3
95;19.01.2015;2015;01;11;Maanantai;5;1;6
95;19.01.2015;2015;01;12;Maanantai;3;3;6
95;19.01.2015;2015;01;13;Maanantai;2;4;6
95;19.01.2015;2015;01;14;Maanantai;4;5;9
95;19.01.2015;2015;01;15;Maanantai;3;1;4
95;19.01.2015;2015;01;16;Maanantai;4;11;15
95;19.01.2015;2015;01;17;Maanantai;1;4;5
95;19.01.2015;2015;01;18;Maanantai;0;4;4
95;19.01.2015;2015;01;19;Maanantai;0;0;0
95;19.01.2015;2015;01;20;Maanantai;1;0;1
95;19.01.2015;2015;01;21;Maanantai;2;2;4
95;19.01.2015;2015;01;22;Maanantai;1;0;1
95;19.01.2015;2015;01;23;Maanantai;0;0;0
95;20.01.2015;2015;01;00;Tiistai;0;0;0
95;20.01.2015;2015;01;01;Tiistai;0;0;0
95;20.01.2015;2015;01;02;Tiistai;0;0;0
95;20.01.2015;2015;01;03;Tiistai;0;0;0
95;20.01.2015;2015;01;04;Tiistai;0;0;0
95;20.01.2015;2015;01;05;Tiistai;0;2;2
95;20.01.2015;2015;01;06;Tiistai;8;2;10
95;20.01.2015;2015;01;07;Tiistai;4;7;11
95;20.01.2015;2015;01;08;Tiistai;2;2;4
95;20.01.2015;2015;01;09;Tiistai;1;1;2
95;20.01.2015;2015;01;10;Tiistai;0;0;0
95;20.01.2015;2015;01;11;Tiistai;2;1;3
95;20.01.2015;2015;01;12;Tiistai;4;0;4
95;20.01.2015;2015;01;13;Tiistai;1;1;2
95;20.01.2015;2015;01;14;Tiistai;3;1;4
95;20.01.2015;2015;01;15;Tiistai;4;1;5
95;20.01.2015;2015;01;16;Tiistai;1;4;5
95;20.01.2015;2015;01;17;Tiistai;4;5;9
95;20.01.2015;2015;01;18;Tiistai;0;3;3
95;20.01.2015;2015;01;19;Tiistai;0;0;0
95;20.01.2015;2015;01;20;Tiistai;1;0;1
95;20.01.2015;2015;01;21;Tiistai;1;1;2
95;20.01.2015;2015;01;22;Tiistai;1;0;1
95;20.01.2015;2015;01;23;Tiistai;0;0;0
95;21.01.2015;2015;01;00;Keskiviikko;0;0;0
95;21.01.2015;2015;01;01;Keskiviikko;0;0;0
95;21.01.2015;2015;01;02;Keskiviikko;0;0;0
95;21.01.2015;2015;01;03;Keskiviikko;0;0;0
95;21.01.2015;2015;01;04;Keskiviikko;0;0;0
95;21.01.2015;2015;01;05;Keskiviikko;0;3;3
95;21.01.2015;2015;01;06;Keskiviikko;9;3;12
95;21.01.2015;2015;01;07;Keskiviikko;2;8;10
95;21.01.2015;2015;01;08;Keskiviikko;4;2;6
95;21.01.2015;2015;01;09;Keskiviikko;1;2;3
95;21.01.2015;2015;01;10;Keskiviikko;0;0;0
95;21.01.2015;2015;01;11;Keskiviikko;2;0;2
95;21.01.2015;2015;01;12;Keskiviikko;4;0;4
95;21.01.2015;2015;01;13;Keskiviikko;0;4;4
95;21.01.2015;2015;01;14;Keskiviikko;4;3;7
95;21.01.2015;2015;01;15;Keskiviikko;10;6;16
95;21.01.2015;2015;01;16;Keskiviikko;0;11;11
95;21.01.2015;2015;01;17;Keskiviikko;5;0;5
95;21.01.2015;2015;01;18;Keskiviikko;1;3;4
95;21.01.2015;2015;01;19;Keskiviikko;0;0;0
95;21.01.2015;2015;01;20;Keskiviikko;2;3;5
95;21.01.2015;2015;01;21;Keskiviikko;0;0;0
95;21.01.2015;2015;01;22;Keskiviikko;2;0;2
95;21.01.2015;2015;01;23;Keskiviikko;0;0;0
95;22.01.2015;2015;01;00;Torstai;0;0;0
95;22.01.2015;2015;01;01;Torstai;0;0;0
95;22.01.2015;2015;01;02;Torstai;0;0;0
95;22.01.2015;2015;01;03;Torstai;0;0;0
95;22.01.2015;2015;01;04;Torstai;0;0;0
95;22.01.2015;2015;01;05;Torstai;1;2;3
95;22.01.2015;2015;01;06;Torstai;7;1;8
95;22.01.2015;2015;01;07;Torstai;3;4;7
95;22.01.2015;2015;01;08;Torstai;7;2;9
95;22.01.2015;2015;01;09;Torstai;0;1;1
95;22.01.2015;2015;01;10;Torstai;1;0;1
95;22.01.2015;2015;01;11;Torstai;3;4;7
95;22.01.2015;2015;01;12;Torstai;0;0;0
95;22.01.2015;2015;01;13;Torstai;2;5;7
95;22.01.2015;2015;01;14;Torstai;4;4;8
95;22.01.2015;2015;01;15;Torstai;4;7;11
95;22.01.2015;2015;01;16;Torstai;2;9;11
95;22.01.2015;2015;01;17;Torstai;5;1;6
95;22.01.2015;2015;01;18;Torstai;1;1;2
95;22.01.2015;2015;01;19;Torstai;0;1;1
95;22.01.2015;2015;01;20;Torstai;1;1;2
95;22.01.2015;2015;01;21;Torstai;1;0;1
95;22.01.2015;2015;01;22;Torstai;2;0;2
95;22.01.2015;2015;01;23;Torstai;0;0;0
95;23.01.2015;2015;01;00;Perjantai;0;0;0
95;23.01.2015;2015;01;01;Perjantai;0;0;0
95;23.01.2015;2015;01;02;Perjantai;0;0;0
95;23.01.2015;2015;01;03;Perjantai;0;0;0
95;23.01.2015;2015;01;04;Perjantai;1;0;1
95;23.01.2015;2015;01;05;Perjantai;0;2;2
95;23.01.2015;2015;01;06;Perjantai;8;2;10
95;23.01.2015;2015;01;07;Perjantai;0;1;1
95;23.01.2015;2015;01;08;Perjantai;4;1;5
95;23.01.2015;2015;01;09;Perjantai;0;1;1
95;23.01.2015;2015;01;10;Perjantai;1;0;1
95;23.01.2015;2015;01;11;Perjantai;1;0;1
95;23.01.2015;2015;01;12;Perjantai;1;1;2
95;23.01.2015;2015;01;13;Perjantai;2;3;5
95;23.01.2015;2015;01;14;Perjantai;1;3;4
95;23.01.2015;2015;01;15;Perjantai;2;0;2
95;23.01.2015;2015;01;16;Perjantai;0;5;5
95;23.01.2015;2015;01;17;Perjantai;0;1;1
95;23.01.2015;2015;01;18;Perjantai;0;1;1
95;23.01.2015;2015;01;19;Perjantai;2;0;2
95;23.01.2015;2015;01;20;Perjantai;2;2;4
95;23.01.2015;2015;01;21;Perjantai;0;0;0
95;23.01.2015;2015;01;22;Perjantai;0;0;0
95;23.01.2015;2015;01;23;Perjantai;0;0;0
95;24.01.2015;2015;01;00;Lauantai;0;0;0
95;24.01.2015;2015;01;01;Lauantai;0;0;0
95;24.01.2015;2015;01;02;Lauantai;0;0;0
95;24.01.2015;2015;01;03;Lauantai;0;0;0
95;24.01.2015;2015;01;04;Lauantai;0;0;0
95;24.01.2015;2015;01;05;Lauantai;0;1;1
95;24.01.2015;2015;01;06;Lauantai;0;1;1
95;24.01.2015;2015;01;07;Lauantai;0;2;2
95;24.01.2015;2015;01;08;Lauantai;0;0;0
95;24.01.2015;2015;01;09;Lauantai;3;2;5
95;24.01.2015;2015;01;10;Lauantai;3;1;4
95;24.01.2015;2015;01;11;Lauantai;0;0;0
95;24.01.2015;2015;01;12;Lauantai;3;1;4
95;24.01.2015;2015;01;13;Lauantai;2;2;4
95;24.01.2015;2015;01;14;Lauantai;2;1;3
95;24.01.2015;2015;01;15;Lauantai;0;3;3
95;24.01.2015;2015;01;16;Lauantai;1;3;4
95;24.01.2015;2015;01;17;Lauantai;1;1;2
95;24.01.2015;2015;01;18;Lauantai;0;2;2
95;24.01.2015;2015;01;19;Lauantai;1;0;1
95;24.01.2015;2015;01;20;Lauantai;0;0;0
95;24.01.2015;2015;01;21;Lauantai;0;0;0
95;24.01.2015;2015;01;22;Lauantai;0;1;1
95;24.01.2015;2015;01;23;Lauantai;0;0;0
95;25.01.2015;2015;01;00;Sunnuntai;0;0;0
95;25.01.2015;2015;01;01;Sunnuntai;0;1;1
95;25.01.2015;2015;01;02;Sunnuntai;0;0;0
95;25.01.2015;2015;01;03;Sunnuntai;0;0;0
95;25.01.2015;2015;01;04;Sunnuntai;0;0;0
95;25.01.2015;2015;01;05;Sunnuntai;0;0;0
95;25.01.2015;2015;01;06;Sunnuntai;0;0;0
95;25.01.2015;2015;01;07;Sunnuntai;0;0;0
95;25.01.2015;2015;01;08;Sunnuntai;0;0;0
95;25.01.2015;2015;01;09;Sunnuntai;3;1;4
95;25.01.2015;2015;01;10;Sunnuntai;0;1;1
95;25.01.2015;2015;01;11;Sunnuntai;1;0;1
95;25.01.2015;2015;01;12;Sunnuntai;5;2;7
95;25.01.2015;2015;01;13;Sunnuntai;0;5;5
95;25.01.2015;2015;01;14;Sunnuntai;3;2;5
95;25.01.2015;2015;01;15;Sunnuntai;4;0;4
95;25.01.2015;2015;01;16;Sunnuntai;2;2;4
95;25.01.2015;2015;01;17;Sunnuntai;4;4;8
95;25.01.2015;2015;01;18;Sunnuntai;1;5;6
95;25.01.2015;2015;01;19;Sunnuntai;1;2;3
95;25.01.2015;2015;01;20;Sunnuntai;0;0;0
95;25.01.2015;2015;01;21;Sunnuntai;2;2;4
95;25.01.2015;2015;01;22;Sunnuntai;1;0;1
95;25.01.2015;2015;01;23;Sunnuntai;1;0;1
95;26.01.2015;2015;01;00;Maanantai;0;0;0
95;26.01.2015;2015;01;01;Maanantai;0;0;0
95;26.01.2015;2015;01;02;Maanantai;0;0;0
95;26.01.2015;2015;01;03;Maanantai;0;0;0
95;26.01.2015;2015;01;04;Maanantai;0;0;0
95;26.01.2015;2015;01;05;Maanantai;2;2;4
95;26.01.2015;2015;01;06;Maanantai;8;5;13
95;26.01.2015;2015;01;07;Maanantai;9;8;17
95;26.01.2015;2015;01;08;Maanantai;8;4;12
95;26.01.2015;2015;01;09;Maanantai;3;1;4
95;26.01.2015;2015;01;10;Maanantai;6;4;10
95;26.01.2015;2015;01;11;Maanantai;1;2;3
95;26.01.2015;2015;01;12;Maanantai;0;1;1
95;26.01.2015;2015;01;13;Maanantai;2;3;5
95;26.01.2015;2015;01;14;Maanantai;5;2;7
95;26.01.2015;2015;01;15;Maanantai;7;8;15
95;26.01.2015;2015;01;16;Maanantai;8;7;15
95;26.01.2015;2015;01;17;Maanantai;0;10;10
95;26.01.2015;2015;01;18;Maanantai;3;4;7
95;26.01.2015;2015;01;19;Maanantai;1;1;2
95;26.01.2015;2015;01;20;Maanantai;1;0;1
95;26.01.2015;2015;01;21;Maanantai;2;2;4
95;26.01.2015;2015;01;22;Maanantai;1;1;2
95;26.01.2015;2015;01;23;Maanantai;0;0;0
95;27.01.2015;2015;01;00;Tiistai;0;0;0
95;27.01.2015;2015;01;01;Tiistai;1;0;1
95;27.01.2015;2015;01;02;Tiistai;0;0;0
95;27.01.2015;2015;01;03;Tiistai;0;0;0
95;27.01.2015;2015;01;04;Tiistai;0;0;0
95;27.01.2015;2015;01;05;Tiistai;6;2;8
95;27.01.2015;2015;01;06;Tiistai;8;1;9
95;27.01.2015;2015;01;07;Tiistai;8;8;16
95;27.01.2015;2015;01;08;Tiistai;3;1;4
95;27.01.2015;2015;01;09;Tiistai;3;1;4
95;27.01.2015;2015;01;10;Tiistai;3;1;4
95;27.01.2015;2015;01;11;Tiistai;4;1;5
95;27.01.2015;2015;01;12;Tiistai;2;2;4
95;27.01.2015;2015;01;13;Tiistai;2;4;6
95;27.01.2015;2015;01;14;Tiistai;6;4;10
95;27.01.2015;2015;01;15;Tiistai;4;11;15
95;27.01.2015;2015;01;16;Tiistai;3;7;10
95;27.01.2015;2015;01;17;Tiistai;5;5;10
95;27.01.2015;2015;01;18;Tiistai;4;5;9
95;27.01.2015;2015;01;19;Tiistai;2;4;6
95;27.01.2015;2015;01;20;Tiistai;1;3;4
95;27.01.2015;2015;01;21;Tiistai;2;1;3
95;27.01.2015;2015;01;22;Tiistai;2;0;2
95;27.01.2015;2015;01;23;Tiistai;0;0;0
95;28.01.2015;2015;01;00;Keskiviikko;0;0;0
95;28.01.2015;2015;01;01;Keskiviikko;1;0;1
95;28.01.2015;2015;01;02;Keskiviikko;0;0;0
95;28.01.2015;2015;01;03;Keskiviikko;0;0;0
95;28.01.2015;2015;01;04;Keskiviikko;0;0;0
95;28.01.2015;2015;01;05;Keskiviikko;2;2;4
95;28.01.2015;2015;01;06;Keskiviikko;9;2;11
95;28.01.2015;2015;01;07;Keskiviikko;7;5;12
95;28.01.2015;2015;01;08;Keskiviikko;8;0;8
95;28.01.2015;2015;01;09;Keskiviikko;3;2;5
95;28.01.2015;2015;01;10;Keskiviikko;3;0;3
95;28.01.2015;2015;01;11;Keskiviikko;0;2;2
95;28.01.2015;2015;01;12;Keskiviikko;2;3;5
95;28.01.2015;2015;01;13;Keskiviikko;3;3;6
95;28.01.2015;2015;01;14;Keskiviikko;3;3;6
95;28.01.2015;2015;01;15;Keskiviikko;7;8;15
95;28.01.2015;2015;01;16;Keskiviikko;1;11;12
95;28.01.2015;2015;01;17;Keskiviikko;3;8;11
95;28.01.2015;2015;01;18;Keskiviikko;1;5;6
95;28.01.2015;2015;01;19;Keskiviikko;1;0;1
95;28.01.2015;2015;01;20;Keskiviikko;3;1;4
95;28.01.2015;2015;01;21;Keskiviikko;1;2;3
95;28.01.2015;2015;01;22;Keskiviikko;2;0;2
95;28.01.2015;2015;01;23;Keskiviikko;0;0;0
95;29.01.2015;2015;01;00;Torstai;0;0;0
95;29.01.2015;2015;01;01;Torstai;0;0;0
95;29.01.2015;2015;01;02;Torstai;1;0;1
95;29.01.2015;2015;01;03;Torstai;0;0;0
95;29.01.2015;2015;01;04;Torstai;0;0;0
95;29.01.2015;2015;01;05;Torstai;0;1;1
95;29.01.2015;2015;01;06;Torstai;8;2;10
95;29.01.2015;2015;01;07;Torstai;1;3;4
95;29.01.2015;2015;01;08;Torstai;7;3;10
95;29.01.2015;2015;01;09;Torstai;1;2;3
95;29.01.2015;2015;01;10;Torstai;0;0;0
95;29.01.2015;2015;01;11;Torstai;2;1;3
95;29.01.2015;2015;01;12;Torstai;0;2;2
95;29.01.2015;2015;01;13;Torstai;1;4;5
95;29.01.2015;2015;01;14;Torstai;3;3;6
95;29.01.2015;2015;01;15;Torstai;7;5;12
95;29.01.2015;2015;01;16;Torstai;1;2;3
95;29.01.2015;2015;01;17;Torstai;0;3;3
95;29.01.2015;2015;01;18;Torstai;1;1;2
95;29.01.2015;2015;01;19;Torstai;0;2;2
95;29.01.2015;2015;01;20;Torstai;1;1;2
95;29.01.2015;2015;01;21;Torstai;0;1;1
95;29.01.2015;2015;01;22;Torstai;2;0;2
95;29.01.2015;2015;01;23;Torstai;0;0;0
95;30.01.2015;2015;01;00;Perjantai;0;0;0
95;30.01.2015;2015;01;01;Perjantai;0;0;0
95;30.01.2015;2015;01;02;Perjantai;0;0;0
95;30.01.2015;2015;01;03;Perjantai;0;0;0
95;30.01.2015;2015;01;04;Perjantai;0;0;0
95;30.01.2015;2015;01;05;Perjantai;0;1;1
95;30.01.2015;2015;01;06;Perjantai;5;3;8
95;30.01.2015;2015;01;07;Perjantai;4;4;8
95;30.01.2015;2015;01;08;Perjantai;6;0;6
95;30.01.2015;2015;01;09;Perjantai;0;3;3
95;30.01.2015;2015;01;10;Perjantai;2;1;3
95;30.01.2015;2015;01;11;Perjantai;9;4;13
95;30.01.2015;2015;01;12;Perjantai;2;0;2
95;30.01.2015;2015;01;13;Perjantai;6;5;11
95;30.01.2015;2015;01;14;Perjantai;5;1;6
95;30.01.2015;2015;01;15;Perjantai;3;0;3
95;30.01.2015;2015;01;16;Perjantai;5;5;10
95;30.01.2015;2015;01;17;Perjantai;3;3;6
95;30.01.2015;2015;01;18;Perjantai;1;4;5
95;30.01.2015;2015;01;19;Perjantai;3;2;5
95;30.01.2015;2015;01;20;Perjantai;0;0;0
95;30.01.2015;2015;01;21;Perjantai;1;1;2
95;30.01.2015;2015;01;22;Perjantai;1;0;1
95;30.01.2015;2015;01;23;Perjantai;0;1;1
95;31.01.2015;2015;01;00;Lauantai;0;0;0
95;31.01.2015;2015;01;01;Lauantai;0;0;0
95;31.01.2015;2015;01;02;Lauantai;0;0;0
95;31.01.2015;2015;01;03;Lauantai;0;0;0
95;31.01.2015;2015;01;04;Lauantai;0;0;0
95;31.01.2015;2015;01;05;Lauantai;0;0;0
95;31.01.2015;2015;01;06;Lauantai;2;1;3
95;31.01.2015;2015;01;07;Lauantai;0;0;0
95;31.01.2015;2015;01;08;Lauantai;1;1;2
95;31.01.2015;2015;01;09;Lauantai;1;5;6
95;31.01.2015;2015;01;10;Lauantai;0;0;0
95;31.01.2015;2015;01;11;Lauantai;2;1;3
95;31.01.2015;2015;01;12;Lauantai;3;6;9
95;31.01.2015;2015;01;13;Lauantai;1;3;4
95;31.01.2015;2015;01;14;Lauantai;0;0;0
95;31.01.2015;2015;01;15;Lauantai;4;6;10
95;31.01.2015;2015;01;16;Lauantai;4;0;4
95;31.01.2015;2015;01;17;Lauantai;1;1;2
95;31.01.2015;2015;01;18;Lauantai;3;3;6
95;31.01.2015;2015;01;19;Lauantai;0;2;2
95;31.01.2015;2015;01;20;Lauantai;4;2;6
95;31.01.2015;2015;01;21;Lauantai;3;0;3
95;31.01.2015;2015;01;22;Lauantai;0;0;0
95;31.01.2015;2015;01;23;Lauantai;0;0;0
95;01.02.2015;2015;02;00;Sunnuntai;0;0;0
95;01.02.2015;2015;02;01;Sunnuntai;0;0;0
95;01.02.2015;2015;02;02;Sunnuntai;0;0;0
95;01.02.2015;2015;02;03;Sunnuntai;0;1;1
95;01.02.2015;2015;02;04;Sunnuntai;0;0;0
95;01.02.2015;2015;02;05;Sunnuntai;0;0;0
95;01.02.2015;2015;02;06;Sunnuntai;1;1;2
95;01.02.2015;2015;02;07;Sunnuntai;0;1;1
95;01.02.2015;2015;02;08;Sunnuntai;2;0;2
95;01.02.2015;2015;02;09;Sunnuntai;0;0;0
95;01.02.2015;2015;02;10;Sunnuntai;0;0;0
95;01.02.2015;2015;02;11;Sunnuntai;0;0;0
95;01.02.2015;2015;02;12;Sunnuntai;1;5;6
95;01.02.2015;2015;02;13;Sunnuntai;1;1;2
95;01.02.2015;2015;02;14;Sunnuntai;1;1;2
95;01.02.2015;2015;02;15;Sunnuntai;2;0;2
95;01.02.2015;2015;02;16;Sunnuntai;1;1;2
95;01.02.2015;2015;02;17;Sunnuntai;3;2;5
95;01.02.2015;2015;02;18;Sunnuntai;0;0;0
95;01.02.2015;2015;02;19;Sunnuntai;0;0;0
95;01.02.2015;2015;02;20;Sunnuntai;1;0;1
95;01.02.2015;2015;02;21;Sunnuntai;0;0;0
95;01.02.2015;2015;02;22;Sunnuntai;0;0;0
95;01.02.2015;2015;02;23;Sunnuntai;0;0;0
95;02.02.2015;2015;02;00;Maanantai;0;0;0
95;02.02.2015;2015;02;01;Maanantai;0;0;0
95;02.02.2015;2015;02;02;Maanantai;0;0;0
95;02.02.2015;2015;02;03;Maanantai;0;0;0
95;02.02.2015;2015;02;04;Maanantai;1;0;1
95;02.02.2015;2015;02;05;Maanantai;1;2;3
95;02.02.2015;2015;02;06;Maanantai;10;3;13
95;02.02.2015;2015;02;07;Maanantai;9;7;16
95;02.02.2015;2015;02;08;Maanantai;5;1;6
95;02.02.2015;2015;02;09;Maanantai;1;1;2
95;02.02.2015;2015;02;10;Maanantai;1;2;3
95;02.02.2015;2015;02;11;Maanantai;3;1;4
95;02.02.2015;2015;02;12;Maanantai;2;1;3
95;02.02.2015;2015;02;13;Maanantai;4;3;7
95;02.02.2015;2015;02;14;Maanantai;3;3;6
95;02.02.2015;2015;02;15;Maanantai;4;5;9
95;02.02.2015;2015;02;16;Maanantai;5;7;12
95;02.02.2015;2015;02;17;Maanantai;3;7;10
95;02.02.2015;2015;02;18;Maanantai;4;5;9
95;02.02.2015;2015;02;19;Maanantai;1;2;3
95;02.02.2015;2015;02;20;Maanantai;1;1;2
95;02.02.2015;2015;02;21;Maanantai;1;0;1
95;02.02.2015;2015;02;22;Maanantai;2;0;2
95;02.02.2015;2015;02;23;Maanantai;0;0;0
95;03.02.2015;2015;02;00;Tiistai;1;0;1
95;03.02.2015;2015;02;01;Tiistai;1;0;1
95;03.02.2015;2015;02;02;Tiistai;0;0;0
95;03.02.2015;2015;02;03;Tiistai;0;0;0
95;03.02.2015;2015;02;04;Tiistai;0;1;1
95;03.02.2015;2015;02;05;Tiistai;3;3;6
95;03.02.2015;2015;02;06;Tiistai;10;5;15
95;03.02.2015;2015;02;07;Tiistai;5;5;10
95;03.02.2015;2015;02;08;Tiistai;3;2;5
95;03.02.2015;2015;02;09;Tiistai;2;1;3
95;03.02.2015;2015;02;10;Tiistai;1;1;2
95;03.02.2015;2015;02;11;Tiistai;2;1;3
95;03.02.2015;2015;02;12;Tiistai;0;1;1
95;03.02.2015;2015;02;13;Tiistai;2;2;4
95;03.02.2015;2015;02;14;Tiistai;4;1;5
95;03.02.2015;2015;02;15;Tiistai;6;4;10
95;03.02.2015;2015;02;16;Tiistai;2;2;4
95;03.02.2015;2015;02;17;Tiistai;1;5;6
95;03.02.2015;2015;02;18;Tiistai;3;3;6
95;03.02.2015;2015;02;19;Tiistai;1;2;3
95;03.02.2015;2015;02;20;Tiistai;0;3;3
95;03.02.2015;2015;02;21;Tiistai;0;0;0
95;03.02.2015;2015;02;22;Tiistai;2;0;2
95;03.02.2015;2015;02;23;Tiistai;0;0;0
95;04.02.2015;2015;02;00;Keskiviikko;0;0;0
95;04.02.2015;2015;02;01;Keskiviikko;0;0;0
95;04.02.2015;2015;02;02;Keskiviikko;0;0;0
95;04.02.2015;2015;02;03;Keskiviikko;0;0;0
95;04.02.2015;2015;02;04;Keskiviikko;0;0;0
95;04.02.2015;2015;02;05;Keskiviikko;2;2;4
95;04.02.2015;2015;02;06;Keskiviikko;7;2;9
95;04.02.2015;2015;02;07;Keskiviikko;5;4;9
95;04.02.2015;2015;02;08;Keskiviikko;4;4;8
95;04.02.2015;2015;02;09;Keskiviikko;2;2;4
95;04.02.2015;2015;02;10;Keskiviikko;1;4;5
95;04.02.2015;2015;02;11;Keskiviikko;1;2;3
95;04.02.2015;2015;02;12;Keskiviikko;2;2;4
95;04.02.2015;2015;02;13;Keskiviikko;3;2;5
95;04.02.2015;2015;02;14;Keskiviikko;6;4;10
95;04.02.2015;2015;02;15;Keskiviikko;5;5;10
95;04.02.2015;2015;02;16;Keskiviikko;5;10;15
95;04.02.2015;2015;02;17;Keskiviikko;4;5;9
95;04.02.2015;2015;02;18;Keskiviikko;1;2;3
95;04.02.2015;2015;02;19;Keskiviikko;2;2;4
95;04.02.2015;2015;02;20;Keskiviikko;0;1;1
95;04.02.2015;2015;02;21;Keskiviikko;1;0;1
95;04.02.2015;2015;02;22;Keskiviikko;1;1;2
95;04.02.2015;2015;02;23;Keskiviikko;1;0;1
95;05.02.2015;2015;02;00;Torstai;0;0;0
95;05.02.2015;2015;02;01;Torstai;0;0;0
95;05.02.2015;2015;02;02;Torstai;1;0;1
95;05.02.2015;2015;02;03;Torstai;0;0;0
95;05.02.2015;2015;02;04;Torstai;1;0;1
95;05.02.2015;2015;02;05;Torstai;3;3;6
95;05.02.2015;2015;02;06;Torstai;7;4;11
95;05.02.2015;2015;02;07;Torstai;3;5;8
95;05.02.2015;2015;02;08;Torstai;3;3;6
95;05.02.2015;2015;02;09;Torstai;1;2;3
95;05.02.2015;2015;02;10;Torstai;0;1;1
95;05.02.2015;2015;02;11;Torstai;3;1;4
95;05.02.2015;2015;02;12;Torstai;2;2;4
95;05.02.2015;2015;02;13;Torstai;2;4;6
95;05.02.2015;2015;02;14;Torstai;4;3;7
95;05.02.2015;2015;02;15;Torstai;6;7;13
95;05.02.2015;2015;02;16;Torstai;6;6;12
95;05.02.2015;2015;02;17;Torstai;2;3;5
95;05.02.2015;2015;02;18;Torstai;1;6;7
95;05.02.2015;2015;02;19;Torstai;2;2;4
95;05.02.2015;2015;02;20;Torstai;1;0;1
95;05.02.2015;2015;02;21;Torstai;0;0;0
95;05.02.2015;2015;02;22;Torstai;2;1;3
95;05.02.2015;2015;02;23;Torstai;2;0;2
95;06.02.2015;2015;02;00;Perjantai;0;0;0
95;06.02.2015;2015;02;01;Perjantai;0;0;0
95;06.02.2015;2015;02;02;Perjantai;0;0;0
95;06.02.2015;2015;02;03;Perjantai;0;0;0
95;06.02.2015;2015;02;04;Perjantai;0;0;0
95;06.02.2015;2015;02;05;Perjantai;2;0;2
95;06.02.2015;2015;02;06;Perjantai;7;2;9
95;06.02.2015;2015;02;07;Perjantai;7;8;15
95;06.02.2015;2015;02;08;Perjantai;8;6;14
95;06.02.2015;2015;02;09;Perjantai;1;2;3
95;06.02.2015;2015;02;10;Perjantai;2;1;3
95;06.02.2015;2015;02;11;Perjantai;2;2;4
95;06.02.2015;2015;02;12;Perjantai;7;6;13
95;06.02.2015;2015;02;13;Perjantai;4;7;11
95;06.02.2015;2015;02;14;Perjantai;5;6;11
95;06.02.2015;2015;02;15;Perjantai;4;3;7
95;06.02.2015;2015;02;16;Perjantai;3;5;8
95;06.02.2015;2015;02;17;Perjantai;1;8;9
95;06.02.2015;2015;02;18;Perjantai;2;1;3
95;06.02.2015;2015;02;19;Perjantai;1;0;1
95;06.02.2015;2015;02;20;Perjantai;1;0;1
95;06.02.2015;2015;02;21;Perjantai;1;1;2
95;06.02.2015;2015;02;22;Perjantai;0;1;1
95;06.02.2015;2015;02;23;Perjantai;0;0;0
95;07.02.2015;2015;02;00;Lauantai;0;0;0
95;07.02.2015;2015;02;01;Lauantai;0;0;0
95;07.02.2015;2015;02;02;Lauantai;0;0;0
95;07.02.2015;2015;02;03;Lauantai;0;0;0
95;07.02.2015;2015;02;04;Lauantai;0;0;0
95;07.02.2015;2015;02;05;Lauantai;0;0;0
95;07.02.2015;2015;02;06;Lauantai;0;1;1
95;07.02.2015;2015;02;07;Lauantai;0;0;0
95;07.02.2015;2015;02;08;Lauantai;3;0;3
95;07.02.2015;2015;02;09;Lauantai;0;0;0
95;07.02.2015;2015;02;10;Lauantai;4;1;5
95;07.02.2015;2015;02;11;Lauantai;1;4;5
95;07.02.2015;2015;02;12;Lauantai;1;2;3
95;07.02.2015;2015;02;13;Lauantai;4;1;5
95;07.02.2015;2015;02;14;Lauantai;4;4;8
95;07.02.2015;2015;02;15;Lauantai;2;1;3
95;07.02.2015;2015;02;16;Lauantai;0;3;3
95;07.02.2015;2015;02;17;Lauantai;5;0;5
95;07.02.2015;2015;02;18;Lauantai;1;0;1
95;07.02.2015;2015;02;19;Lauantai;0;1;1
95;07.02.2015;2015;02;20;Lauantai;0;0;0
95;07.02.2015;2015;02;21;Lauantai;0;0;0
95;07.02.2015;2015;02;22;Lauantai;0;0;0
95;07.02.2015;2015;02;23;Lauantai;0;0;0
95;08.02.2015;2015;02;00;Sunnuntai;0;0;0
95;08.02.2015;2015;02;01;Sunnuntai;0;0;0
95;08.02.2015;2015;02;02;Sunnuntai;0;0;0
95;08.02.2015;2015;02;03;Sunnuntai;0;0;0
95;08.02.2015;2015;02;04;Sunnuntai;0;0;0
95;08.02.2015;2015;02;05;Sunnuntai;0;0;0
95;08.02.2015;2015;02;06;Sunnuntai;0;0;0
95;08.02.2015;2015;02;07;Sunnuntai;0;1;1
95;08.02.2015;2015;02;08;Sunnuntai;0;0;0
95;08.02.2015;2015;02;09;Sunnuntai;0;0;0
95;08.02.2015;2015;02;10;Sunnuntai;0;1;1
95;08.02.2015;2015;02;11;Sunnuntai;0;1;1
95;08.02.2015;2015;02;12;Sunnuntai;2;3;5
95;08.02.2015;2015;02;13;Sunnuntai;4;2;6
95;08.02.2015;2015;02;14;Sunnuntai;1;2;3
95;08.02.2015;2015;02;15;Sunnuntai;1;3;4
95;08.02.2015;2015;02;16;Sunnuntai;6;1;7
95;08.02.2015;2015;02;17;Sunnuntai;1;4;5
95;08.02.2015;2015;02;18;Sunnuntai;0;4;4
95;08.02.2015;2015;02;19;Sunnuntai;0;0;0
95;08.02.2015;2015;02;20;Sunnuntai;1;0;1
95;08.02.2015;2015;02;21;Sunnuntai;0;0;0
95;08.02.2015;2015;02;22;Sunnuntai;1;0;1
95;08.02.2015;2015;02;23;Sunnuntai;0;0;0
95;09.02.2015;2015;02;00;Maanantai;0;0;0
95;09.02.2015;2015;02;01;Maanantai;0;0;0
95;09.02.2015;2015;02;02;Maanantai;0;0;0
95;09.02.2015;2015;02;03;Maanantai;0;0;0
95;09.02.2015;2015;02;04;Maanantai;1;1;2
95;09.02.2015;2015;02;05;Maanantai;3;2;5
95;09.02.2015;2015;02;06;Maanantai;8;6;14
95;09.02.2015;2015;02;07;Maanantai;5;6;11
95;09.02.2015;2015;02;08;Maanantai;6;2;8
95;09.02.2015;2015;02;09;Maanantai;3;1;4
95;09.02.2015;2015;02;10;Maanantai;3;3;6
95;09.02.2015;2015;02;11;Maanantai;1;5;6
95;09.02.2015;2015;02;12;Maanantai;4;5;9
95;09.02.2015;2015;02;13;Maanantai;2;3;5
95;09.02.2015;2015;02;14;Maanantai;6;1;7
95;09.02.2015;2015;02;15;Maanantai;3;9;12
95;09.02.2015;2015;02;16;Maanantai;5;10;15
95;09.02.2015;2015;02;17;Maanantai;8;4;12
95;09.02.2015;2015;02;18;Maanantai;4;1;5
95;09.02.2015;2015;02;19;Maanantai;1;4;5
95;09.02.2015;2015;02;20;Maanantai;2;1;3
95;09.02.2015;2015;02;21;Maanantai;3;1;4
95;09.02.2015;2015;02;22;Maanantai;2;0;2
95;09.02.2015;2015;02;23;Maanantai;1;1;2
95;10.02.2015;2015;02;00;Tiistai;0;0;0
95;10.02.2015;2015;02;01;Tiistai;0;0;0
95;10.02.2015;2015;02;02;Tiistai;0;0;0
95;10.02.2015;2015;02;03;Tiistai;0;0;0
95;10.02.2015;2015;02;04;Tiistai;1;0;1
95;10.02.2015;2015;02;05;Tiistai;1;2;3
95;10.02.2015;2015;02;06;Tiistai;7;1;8
95;10.02.2015;2015;02;07;Tiistai;4;7;11
95;10.02.2015;2015;02;08;Tiistai;8;2;10
95;10.02.2015;2015;02;09;Tiistai;3;1;4
95;10.02.2015;2015;02;10;Tiistai;2;0;2
95;10.02.2015;2015;02;11;Tiistai;1;4;5
95;10.02.2015;2015;02;12;Tiistai;1;0;1
95;10.02.2015;2015;02;13;Tiistai;5;4;9
95;10.02.2015;2015;02;14;Tiistai;5;4;9
95;10.02.2015;2015;02;15;Tiistai;9;5;14
95;10.02.2015;2015;02;16;Tiistai;2;5;7
95;10.02.2015;2015;02;17;Tiistai;4;6;10
95;10.02.2015;2015;02;18;Tiistai;1;1;2
95;10.02.2015;2015;02;19;Tiistai;0;1;1
95;10.02.2015;2015;02;20;Tiistai;0;0;0
95;10.02.2015;2015;02;21;Tiistai;1;1;2
95;10.02.2015;2015;02;22;Tiistai;1;1;2
95;10.02.2015;2015;02;23;Tiistai;0;0;0
95;11.02.2015;2015;02;00;Keskiviikko;0;0;0
95;11.02.2015;2015;02;01;Keskiviikko;0;0;0
95;11.02.2015;2015;02;02;Keskiviikko;0;0;0
95;11.02.2015;2015;02;03;Keskiviikko;0;0;0
95;11.02.2015;2015;02;04;Keskiviikko;3;2;5
95;11.02.2015;2015;02;05;Keskiviikko;0;2;2
95;11.02.2015;2015;02;06;Keskiviikko;3;3;6
95;11.02.2015;2015;02;07;Keskiviikko;3;5;8
95;11.02.2015;2015;02;08;Keskiviikko;9;3;12
95;11.02.2015;2015;02;09;Keskiviikko;1;2;3
95;11.02.2015;2015;02;10;Keskiviikko;1;0;1
95;11.02.2015;2015;02;11;Keskiviikko;4;0;4
95;11.02.2015;2015;02;12;Keskiviikko;5;1;6
95;11.02.2015;2015;02;13;Keskiviikko;1;2;3
95;11.02.2015;2015;02;14;Keskiviikko;2;4;6
95;11.02.2015;2015;02;15;Keskiviikko;3;1;4
95;11.02.2015;2015;02;16;Keskiviikko;3;6;9
95;11.02.2015;2015;02;17;Keskiviikko;4;8;12
95;11.02.2015;2015;02;18;Keskiviikko;0;4;4
95;11.02.2015;2015;02;19;Keskiviikko;3;0;3
95;11.02.2015;2015;02;20;Keskiviikko;0;2;2
95;11.02.2015;2015;02;21;Keskiviikko;2;0;2
95;11.02.2015;2015;02;22;Keskiviikko;6;0;6
95;11.02.2015;2015;02;23;Keskiviikko;0;0;0
95;12.02.2015;2015;02;00;Torstai;0;0;0
95;12.02.2015;2015;02;01;Torstai;0;0;0
95;12.02.2015;2015;02;02;Torstai;0;0;0
95;12.02.2015;2015;02;03;Torstai;0;0;0
95;12.02.2015;2015;02;04;Torstai;0;0;0
95;12.02.2015;2015;02;05;Torstai;0;1;1
95;12.02.2015;2015;02;06;Torstai;5;0;5
95;12.02.2015;2015;02;07;Torstai;6;1;7
95;12.02.2015;2015;02;08;Torstai;6;3;9
95;12.02.2015;2015;02;09;Torstai;0;7;7
95;12.02.2015;2015;02;10;Torstai;0;0;0
95;12.02.2015;2015;02;11;Torstai;1;0;1
95;12.02.2015;2015;02;12;Torstai;0;3;3
95;12.02.2015;2015;02;13;Torstai;3;1;4
95;12.02.2015;2015;02;14;Torstai;5;1;6
95;12.02.2015;2015;02;15;Torstai;3;4;7
95;12.02.2015;2015;02;16;Torstai;2;5;7
95;12.02.2015;2015;02;17;Torstai;2;5;7
95;12.02.2015;2015;02;18;Torstai;2;3;5
95;12.02.2015;2015;02;19;Torstai;2;1;3
95;12.02.2015;2015;02;20;Torstai;1;1;2
95;12.02.2015;2015;02;21;Torstai;0;0;0
95;12.02.2015;2015;02;22;Torstai;1;0;1
95;12.02.2015;2015;02;23;Torstai;1;0;1
95;13.02.2015;2015;02;00;Perjantai;0;0;0
95;13.02.2015;2015;02;01;Perjantai;1;0;1
95;13.02.2015;2015;02;02;Perjantai;0;0;0
95;13.02.2015;2015;02;03;Perjantai;0;0;0
95;13.02.2015;2015;02;04;Perjantai;1;0;1
95;13.02.2015;2015;02;05;Perjantai;0;0;0
95;13.02.2015;2015;02;06;Perjantai;2;0;2
95;13.02.2015;2015;02;07;Perjantai;5;6;11
95;13.02.2015;2015;02;08;Perjantai;5;1;6
95;13.02.2015;2015;02;09;Perjantai;0;1;1
95;13.02.2015;2015;02;10;Perjantai;6;3;9
95;13.02.2015;2015;02;11;Perjantai;6;3;9
95;13.02.2015;2015;02;12;Perjantai;1;3;4
95;13.02.2015;2015;02;13;Perjantai;4;4;8
95;13.02.2015;2015;02;14;Perjantai;3;2;5
95;13.02.2015;2015;02;15;Perjantai;3;2;5
95;13.02.2015;2015;02;16;Perjantai;1;7;8
95;13.02.2015;2015;02;17;Perjantai;0;3;3
95;13.02.2015;2015;02;18;Perjantai;2;2;4
95;13.02.2015;2015;02;19;Perjantai;1;1;2
95;13.02.2015;2015;02;20;Perjantai;0;0;0
95;13.02.2015;2015;02;21;Perjantai;1;1;2
95;13.02.2015;2015;02;22;Perjantai;0;0;0
95;13.02.2015;2015;02;23;Perjantai;0;0;0
95;14.02.2015;2015;02;00;Lauantai;0;0;0
95;14.02.2015;2015;02;01;Lauantai;0;0;0
95;14.02.2015;2015;02;02;Lauantai;1;0;1
95;14.02.2015;2015;02;03;Lauantai;0;0;0
95;14.02.2015;2015;02;04;Lauantai;1;0;1
95;14.02.2015;2015;02;05;Lauantai;1;1;2
95;14.02.2015;2015;02;06;Lauantai;0;0;0
95;14.02.2015;2015;02;07;Lauantai;1;0;1
95;14.02.2015;2015;02;08;Lauantai;2;0;2
95;14.02.2015;2015;02;09;Lauantai;1;1;2
95;14.02.2015;2015;02;10;Lauantai;0;0;0
95;14.02.2015;2015;02;11;Lauantai;3;3;6
95;14.02.2015;2015;02;12;Lauantai;0;0;0
95;14.02.2015;2015;02;13;Lauantai;0;2;2
95;14.02.2015;2015;02;14;Lauantai;1;2;3
95;14.02.2015;2015;02;15;Lauantai;0;0;0
95;14.02.2015;2015;02;16;Lauantai;0;1;1
95;14.02.2015;2015;02;17;Lauantai;2;1;3
95;14.02.2015;2015;02;18;Lauantai;1;3;4
95;14.02.2015;2015;02;19;Lauantai;0;0;0
95;14.02.2015;2015;02;20;Lauantai;0;1;1
95;14.02.2015;2015;02;21;Lauantai;0;1;1
95;14.02.2015;2015;02;22;Lauantai;0;0;0
95;14.02.2015;2015;02;23;Lauantai;1;0;1
95;15.02.2015;2015;02;00;Sunnuntai;0;0;0
95;15.02.2015;2015;02;01;Sunnuntai;0;0;0
95;15.02.2015;2015;02;02;Sunnuntai;0;0;0
95;15.02.2015;2015;02;03;Sunnuntai;0;0;0
95;15.02.2015;2015;02;04;Sunnuntai;0;0;0
95;15.02.2015;2015;02;05;Sunnuntai;0;0;0
95;15.02.2015;2015;02;06;Sunnuntai;1;0;1
95;15.02.2015;2015;02;07;Sunnuntai;1;1;2
95;15.02.2015;2015;02;08;Sunnuntai;0;0;0
95;15.02.2015;2015;02;09;Sunnuntai;0;0;0
95;15.02.2015;2015;02;10;Sunnuntai;0;0;0
95;15.02.2015;2015;02;11;Sunnuntai;0;0;0
95;15.02.2015;2015;02;12;Sunnuntai;1;0;1
95;15.02.2015;2015;02;13;Sunnuntai;1;3;4
95;15.02.2015;2015;02;14;Sunnuntai;0;2;2
95;15.02.2015;2015;02;15;Sunnuntai;1;4;5
95;15.02.2015;2015;02;16;Sunnuntai;2;5;7
95;15.02.2015;2015;02;17;Sunnuntai;3;2;5
95;15.02.2015;2015;02;18;Sunnuntai;2;0;2
95;15.02.2015;2015;02;19;Sunnuntai;1;2;3
95;15.02.2015;2015;02;20;Sunnuntai;0;1;1
95;15.02.2015;2015;02;21;Sunnuntai;0;0;0
95;15.02.2015;2015;02;22;Sunnuntai;0;2;2
95;15.02.2015;2015;02;23;Sunnuntai;1;0;1
95;16.02.2015;2015;02;00;Maanantai;0;0;0
95;16.02.2015;2015;02;01;Maanantai;0;0;0
95;16.02.2015;2015;02;02;Maanantai;0;0;0
95;16.02.2015;2015;02;03;Maanantai;0;0;0
95;16.02.2015;2015;02;04;Maanantai;4;0;4
95;16.02.2015;2015;02;05;Maanantai;0;2;2
95;16.02.2015;2015;02;06;Maanantai;10;3;13
95;16.02.2015;2015;02;07;Maanantai;6;5;11
95;16.02.2015;2015;02;08;Maanantai;8;1;9
95;16.02.2015;2015;02;09;Maanantai;0;1;1
95;16.02.2015;2015;02;10;Maanantai;4;1;5
95;16.02.2015;2015;02;11;Maanantai;2;2;4
95;16.02.2015;2015;02;12;Maanantai;4;7;11
95;16.02.2015;2015;02;13;Maanantai;5;5;10
95;16.02.2015;2015;02;14;Maanantai;6;4;10
95;16.02.2015;2015;02;15;Maanantai;10;6;16
95;16.02.2015;2015;02;16;Maanantai;7;8;15
95;16.02.2015;2015;02;17;Maanantai;2;5;7
95;16.02.2015;2015;02;18;Maanantai;0;4;4
95;16.02.2015;2015;02;19;Maanantai;0;0;0
95;16.02.2015;2015;02;20;Maanantai;3;4;7
95;16.02.2015;2015;02;21;Maanantai;2;1;3
95;16.02.2015;2015;02;22;Maanantai;2;2;4
95;16.02.2015;2015;02;23;Maanantai;0;0;0
95;17.02.2015;2015;02;00;Tiistai;0;0;0
95;17.02.2015;2015;02;01;Tiistai;0;0;0
95;17.02.2015;2015;02;02;Tiistai;0;0;0
95;17.02.2015;2015;02;03;Tiistai;0;0;0
95;17.02.2015;2015;02;04;Tiistai;2;0;2
95;17.02.2015;2015;02;05;Tiistai;0;4;4
95;17.02.2015;2015;02;06;Tiistai;14;4;18
95;17.02.2015;2015;02;07;Tiistai;13;9;22
95;17.02.2015;2015;02;08;Tiistai;3;3;6
95;17.02.2015;2015;02;09;Tiistai;4;1;5
95;17.02.2015;2015;02;10;Tiistai;5;2;7
95;17.02.2015;2015;02;11;Tiistai;2;1;3
95;17.02.2015;2015;02;12;Tiistai;3;1;4
95;17.02.2015;2015;02;13;Tiistai;2;5;7
95;17.02.2015;2015;02;14;Tiistai;3;3;6
95;17.02.2015;2015;02;15;Tiistai;13;5;18
95;17.02.2015;2015;02;16;Tiistai;4;8;12
95;17.02.2015;2015;02;17;Tiistai;1;5;6
95;17.02.2015;2015;02;18;Tiistai;2;3;5
95;17.02.2015;2015;02;19;Tiistai;4;1;5
95;17.02.2015;2015;02;20;Tiistai;0;4;4
95;17.02.2015;2015;02;21;Tiistai;0;2;2
95;17.02.2015;2015;02;22;Tiistai;3;1;4
95;17.02.2015;2015;02;23;Tiistai;0;0;0
95;18.02.2015;2015;02;00;Keskiviikko;0;0;0
95;18.02.2015;2015;02;01;Keskiviikko;0;0;0
95;18.02.2015;2015;02;02;Keskiviikko;0;0;0
95;18.02.2015;2015;02;03;Keskiviikko;0;0;0
95;18.02.2015;2015;02;04;Keskiviikko;1;0;1
95;18.02.2015;2015;02;05;Keskiviikko;0;2;2
95;18.02.2015;2015;02;06;Keskiviikko;5;0;5
95;18.02.2015;2015;02;07;Keskiviikko;8;14;22
95;18.02.2015;2015;02;08;Keskiviikko;6;4;10
95;18.02.2015;2015;02;09;Keskiviikko;2;2;4
95;18.02.2015;2015;02;10;Keskiviikko;3;1;4
95;18.02.2015;2015;02;11;Keskiviikko;6;7;13
95;18.02.2015;2015;02;12;Keskiviikko;6;1;7
95;18.02.2015;2015;02;13;Keskiviikko;0;4;4
95;18.02.2015;2015;02;14;Keskiviikko;6;5;11
95;18.02.2015;2015;02;15;Keskiviikko;9;6;15
95;18.02.2015;2015;02;16;Keskiviikko;11;8;19
95;18.02.2015;2015;02;17;Keskiviikko;7;9;16
95;18.02.2015;2015;02;18;Keskiviikko;0;6;6
95;18.02.2015;2015;02;19;Keskiviikko;1;0;1
95;18.02.2015;2015;02;20;Keskiviikko;0;4;4
95;18.02.2015;2015;02;21;Keskiviikko;2;0;2
95;18.02.2015;2015;02;22;Keskiviikko;2;0;2
95;18.02.2015;2015;02;23;Keskiviikko;1;0;1
95;19.02.2015;2015;02;00;Torstai;1;0;1
95;19.02.2015;2015;02;01;Torstai;0;0;0
95;19.02.2015;2015;02;02;Torstai;0;0;0
95;19.02.2015;2015;02;03;Torstai;0;0;0
95;19.02.2015;2015;02;04;Torstai;1;1;2
95;19.02.2015;2015;02;05;Torstai;2;2;4
95;19.02.2015;2015;02;06;Torstai;9;3;12
95;19.02.2015;2015;02;07;Torstai;8;6;14
95;19.02.2015;2015;02;08;Torstai;5;5;10
95;19.02.2015;2015;02;09;Torstai;6;1;7
95;19.02.2015;2015;02;10;Torstai;2;3;5
95;19.02.2015;2015;02;11;Torstai;6;1;7
95;19.02.2015;2015;02;12;Torstai;0;0;0
95;19.02.2015;2015;02;13;Torstai;0;3;3
95;19.02.2015;2015;02;14;Torstai;2;1;3
95;19.02.2015;2015;02;15;Torstai;6;4;10
95;19.02.2015;2015;02;16;Torstai;9;9;18
95;19.02.2015;2015;02;17;Torstai;1;1;2
95;19.02.2015;2015;02;18;Torstai;0;1;1
95;19.02.2015;2015;02;19;Torstai;0;3;3
95;19.02.2015;2015;02;20;Torstai;3;0;3
95;19.02.2015;2015;02;21;Torstai;1;0;1
95;19.02.2015;2015;02;22;Torstai;2;0;2
95;19.02.2015;2015;02;23;Torstai;0;0;0
95;20.02.2015;2015;02;00;Perjantai;0;0;0
95;20.02.2015;2015;02;01;Perjantai;1;1;2
95;20.02.2015;2015;02;02;Perjantai;0;0;0
95;20.02.2015;2015;02;03;Perjantai;0;0;0
95;20.02.2015;2015;02;04;Perjantai;0;0;0
95;20.02.2015;2015;02;05;Perjantai;0;1;1
95;20.02.2015;2015;02;06;Perjantai;4;2;6
95;20.02.2015;2015;02;07;Perjantai;3;2;5
95;20.02.2015;2015;02;08;Perjantai;1;1;2
95;20.02.2015;2015;02;09;Perjantai;2;1;3
95;20.02.2015;2015;02;10;Perjantai;1;1;2
95;20.02.2015;2015;02;11;Perjantai;2;1;3
95;20.02.2015;2015;02;12;Perjantai;0;1;1
95;20.02.2015;2015;02;13;Perjantai;4;1;5
95;20.02.2015;2015;02;14;Perjantai;5;4;9
95;20.02.2015;2015;02;15;Perjantai;1;8;9
95;20.02.2015;2015;02;16;Perjantai;5;0;5
95;20.02.2015;2015;02;17;Perjantai;1;2;3
95;20.02.2015;2015;02;18;Perjantai;0;2;2
95;20.02.2015;2015;02;19;Perjantai;2;3;5
95;20.02.2015;2015;02;20;Perjantai;0;2;2
95;20.02.2015;2015;02;21;Perjantai;0;0;0
95;20.02.2015;2015;02;22;Perjantai;0;0;0
95;20.02.2015;2015;02;23;Perjantai;0;0;0
95;21.02.2015;2015;02;00;Lauantai;0;0;0
95;21.02.2015;2015;02;01;Lauantai;0;0;0
95;21.02.2015;2015;02;02;Lauantai;0;0;0
95;21.02.2015;2015;02;03;Lauantai;0;1;1
95;21.02.2015;2015;02;04;Lauantai;2;0;2
95;21.02.2015;2015;02;05;Lauantai;0;0;0
95;21.02.2015;2015;02;06;Lauantai;1;0;1
95;21.02.2015;2015;02;07;Lauantai;1;2;3
95;21.02.2015;2015;02;08;Lauantai;1;1;2
95;21.02.2015;2015;02;09;Lauantai;0;0;0
95;21.02.2015;2015;02;10;Lauantai;1;1;2
95;21.02.2015;2015;02;11;Lauantai;1;3;4
95;21.02.2015;2015;02;12;Lauantai;5;0;5
95;21.02.2015;2015;02;13;Lauantai;0;2;2
95;21.02.2015;2015;02;14;Lauantai;2;1;3
95;21.02.2015;2015;02;15;Lauantai;2;3;5
95;21.02.2015;2015;02;16;Lauantai;0;2;2
95;21.02.2015;2015;02;17;Lauantai;2;5;7
95;21.02.2015;2015;02;18;Lauantai;3;3;6
95;21.02.2015;2015;02;19;Lauantai;3;1;4
95;21.02.2015;2015;02;20;Lauantai;1;2;3
95;21.02.2015;2015;02;21;Lauantai;0;1;1
95;21.02.2015;2015;02;22;Lauantai;1;0;1
95;21.02.2015;2015;02;23;Lauantai;0;0;0
95;22.02.2015;2015;02;00;Sunnuntai;0;1;1
95;22.02.2015;2015;02;01;Sunnuntai;0;0;0
95;22.02.2015;2015;02;02;Sunnuntai;0;3;3
95;22.02.2015;2015;02;03;Sunnuntai;0;0;0
95;22.02.2015;2015;02;04;Sunnuntai;2;0;2
95;22.02.2015;2015;02;05;Sunnuntai;0;0;0
95;22.02.2015;2015;02;06;Sunnuntai;2;0;2
95;22.02.2015;2015;02;07;Sunnuntai;0;3;3
95;22.02.2015;2015;02;08;Sunnuntai;2;0;2
95;22.02.2015;2015;02;09;Sunnuntai;2;1;3
95;22.02.2015;2015;02;10;Sunnuntai;1;0;1
95;22.02.2015;2015;02;11;Sunnuntai;2;3;5
95;22.02.2015;2015;02;12;Sunnuntai;1;1;2
95;22.02.2015;2015;02;13;Sunnuntai;0;5;5
95;22.02.2015;2015;02;14;Sunnuntai;1;2;3
95;22.02.2015;2015;02;15;Sunnuntai;5;2;7
95;22.02.2015;2015;02;16;Sunnuntai;1;4;5
95;22.02.2015;2015;02;17;Sunnuntai;4;4;8
95;22.02.2015;2015;02;18;Sunnuntai;2;1;3
95;22.02.2015;2015;02;19;Sunnuntai;1;1;2
95;22.02.2015;2015;02;20;Sunnuntai;0;1;1
95;22.02.2015;2015;02;21;Sunnuntai;1;0;1
95;22.02.2015;2015;02;22;Sunnuntai;0;0;0
95;22.02.2015;2015;02;23;Sunnuntai;1;0;1
95;23.02.2015;2015;02;00;Maanantai;0;0;0
95;23.02.2015;2015;02;01;Maanantai;0;0;0
95;23.02.2015;2015;02;02;Maanantai;0;0;0
95;23.02.2015;2015;02;03;Maanantai;0;0;0
95;23.02.2015;2015;02;04;Maanantai;2;0;2
95;23.02.2015;2015;02;05;Maanantai;3;1;4
95;23.02.2015;2015;02;06;Maanantai;3;3;6
95;23.02.2015;2015;02;07;Maanantai;8;8;16
95;23.02.2015;2015;02;08;Maanantai;8;5;13
95;23.02.2015;2015;02;09;Maanantai;2;2;4
95;23.02.2015;2015;02;10;Maanantai;5;1;6
95;23.02.2015;2015;02;11;Maanantai;3;3;6
95;23.02.2015;2015;02;12;Maanantai;5;4;9
95;23.02.2015;2015;02;13;Maanantai;4;8;12
95;23.02.2015;2015;02;14;Maanantai;6;7;13
95;23.02.2015;2015;02;15;Maanantai;6;2;8
95;23.02.2015;2015;02;16;Maanantai;12;6;18
95;23.02.2015;2015;02;17;Maanantai;3;8;11
95;23.02.2015;2015;02;18;Maanantai;4;2;6
95;23.02.2015;2015;02;19;Maanantai;0;0;0
95;23.02.2015;2015;02;20;Maanantai;3;0;3
95;23.02.2015;2015;02;21;Maanantai;4;1;5
95;23.02.2015;2015;02;22;Maanantai;3;1;4
95;23.02.2015;2015;02;23;Maanantai;0;0;0
95;24.02.2015;2015;02;00;Tiistai;0;1;1
95;24.02.2015;2015;02;01;Tiistai;0;0;0
95;24.02.2015;2015;02;02;Tiistai;0;0;0
95;24.02.2015;2015;02;03;Tiistai;0;0;0
95;24.02.2015;2015;02;04;Tiistai;1;1;2
95;24.02.2015;2015;02;05;Tiistai;2;3;5
95;24.02.2015;2015;02;06;Tiistai;2;0;2
95;24.02.2015;2015;02;07;Tiistai;5;7;12
95;24.02.2015;2015;02;08;Tiistai;4;3;7
95;24.02.2015;2015;02;09;Tiistai;2;1;3
95;24.02.2015;2015;02;10;Tiistai;1;0;1
95;24.02.2015;2015;02;11;Tiistai;2;3;5
95;24.02.2015;2015;02;12;Tiistai;0;1;1
95;24.02.2015;2015;02;13;Tiistai;1;4;5
95;24.02.2015;2015;02;14;Tiistai;8;3;11
95;24.02.2015;2015;02;15;Tiistai;2;5;7
95;24.02.2015;2015;02;16;Tiistai;7;4;11
95;24.02.2015;2015;02;17;Tiistai;3;8;11
95;24.02.2015;2015;02;18;Tiistai;5;6;11
95;24.02.2015;2015;02;19;Tiistai;3;3;6
95;24.02.2015;2015;02;20;Tiistai;2;3;5
95;24.02.2015;2015;02;21;Tiistai;0;4;4
95;24.02.2015;2015;02;22;Tiistai;1;0;1
95;24.02.2015;2015;02;23;Tiistai;0;1;1
95;25.02.2015;2015;02;00;Keskiviikko;0;0;0
95;25.02.2015;2015;02;01;Keskiviikko;0;0;0
95;25.02.2015;2015;02;02;Keskiviikko;0;0;0
95;25.02.2015;2015;02;03;Keskiviikko;0;0;0
95;25.02.2015;2015;02;04;Keskiviikko;2;0;2
95;25.02.2015;2015;02;05;Keskiviikko;0;3;3
95;25.02.2015;2015;02;06;Keskiviikko;5;6;11
95;25.02.2015;2015;02;07;Keskiviikko;5;8;13
95;25.02.2015;2015;02;08;Keskiviikko;5;2;7
95;25.02.2015;2015;02;09;Keskiviikko;0;2;2
95;25.02.2015;2015;02;10;Keskiviikko;6;2;8
95;25.02.2015;2015;02;11;Keskiviikko;6;1;7
95;25.02.2015;2015;02;12;Keskiviikko;3;1;4
95;25.02.2015;2015;02;13;Keskiviikko;4;6;10
95;25.02.2015;2015;02;14;Keskiviikko;3;3;6
95;25.02.2015;2015;02;15;Keskiviikko;9;6;15
95;25.02.2015;2015;02;16;Keskiviikko;10;7;17
95;25.02.2015;2015;02;17;Keskiviikko;5;6;11
95;25.02.2015;2015;02;18;Keskiviikko;7;8;15
95;25.02.2015;2015;02;19;Keskiviikko;1;4;5
95;25.02.2015;2015;02;20;Keskiviikko;2;0;2
95;25.02.2015;2015;02;21;Keskiviikko;0;0;0
95;25.02.2015;2015;02;22;Keskiviikko;1;1;2
95;25.02.2015;2015;02;23;Keskiviikko;0;0;0
95;26.02.2015;2015;02;00;Torstai;0;1;1
95;26.02.2015;2015;02;01;Torstai;0;0;0
95;26.02.2015;2015;02;02;Torstai;0;0;0
95;26.02.2015;2015;02;03;Torstai;0;0;0
95;26.02.2015;2015;02;04;Torstai;3;0;3
95;26.02.2015;2015;02;05;Torstai;2;3;5
95;26.02.2015;2015;02;06;Torstai;4;1;5
95;26.02.2015;2015;02;07;Torstai;3;3;6
95;26.02.2015;2015;02;08;Torstai;6;3;9
95;26.02.2015;2015;02;09;Torstai;1;1;2
95;26.02.2015;2015;02;10;Torstai;3;6;9
95;26.02.2015;2015;02;11;Torstai;1;4;5
95;26.02.2015;2015;02;12;Torstai;1;1;2
95;26.02.2015;2015;02;13;Torstai;1;2;3
95;26.02.2015;2015;02;14;Torstai;6;5;11
95;26.02.2015;2015;02;15;Torstai;2;8;10
95;26.02.2015;2015;02;16;Torstai;6;3;9
95;26.02.2015;2015;02;17;Torstai;3;2;5
95;26.02.2015;2015;02;18;Torstai;2;4;6
95;26.02.2015;2015;02;19;Torstai;0;0;0
95;26.02.2015;2015;02;20;Torstai;0;3;3
95;26.02.2015;2015;02;21;Torstai;1;1;2
95;26.02.2015;2015;02;22;Torstai;1;0;1
95;26.02.2015;2015;02;23;Torstai;0;1;1
95;27.02.2015;2015;02;00;Perjantai;0;0;0
95;27.02.2015;2015;02;01;Perjantai;1;0;1
95;27.02.2015;2015;02;02;Perjantai;0;0;0
95;27.02.2015;2015;02;03;Perjantai;0;0;0
95;27.02.2015;2015;02;04;Perjantai;0;0;0
95;27.02.2015;2015;02;05;Perjantai;1;2;3
95;27.02.2015;2015;02;06;Perjantai;5;0;5
95;27.02.2015;2015;02;07;Perjantai;4;4;8
95;27.02.2015;2015;02;08;Perjantai;8;1;9
95;27.02.2015;2015;02;09;Perjantai;2;1;3
95;27.02.2015;2015;02;10;Perjantai;2;2;4
95;27.02.2015;2015;02;11;Perjantai;5;0;5
95;27.02.2015;2015;02;12;Perjantai;2;2;4
95;27.02.2015;2015;02;13;Perjantai;6;3;9
95;27.02.2015;2015;02;14;Perjantai;3;4;7
95;27.02.2015;2015;02;15;Perjantai;3;1;4
95;27.02.2015;2015;02;16;Perjantai;1;3;4
95;27.02.2015;2015;02;17;Perjantai;1;8;9
95;27.02.2015;2015;02;18;Perjantai;1;5;6
95;27.02.2015;2015;02;19;Perjantai;2;1;3
95;27.02.2015;2015;02;20;Perjantai;0;2;2
95;27.02.2015;2015;02;21;Perjantai;1;1;2
95;27.02.2015;2015;02;22;Perjantai;2;1;3
95;27.02.2015;2015;02;23;Perjantai;0;0;0
95;28.02.2015;2015;02;00;Lauantai;1;0;1
95;28.02.2015;2015;02;01;Lauantai;0;0;0
95;28.02.2015;2015;02;02;Lauantai;0;0;0
95;28.02.2015;2015;02;03;Lauantai;1;0;1
95;28.02.2015;2015;02;04;Lauantai;0;1;1
95;28.02.2015;2015;02;05;Lauantai;0;0;0
95;28.02.2015;2015;02;06;Lauantai;1;1;2
95;28.02.2015;2015;02;07;Lauantai;2;0;2
95;28.02.2015;2015;02;08;Lauantai;0;1;1
95;28.02.2015;2015;02;09;Lauantai;4;1;5
95;28.02.2015;2015;02;10;Lauantai;1;1;2
95;28.02.2015;2015;02;11;Lauantai;2;5;7
95;28.02.2015;2015;02;12;Lauantai;2;0;2
95;28.02.2015;2015;02;13;Lauantai;1;2;3
95;28.02.2015;2015;02;14;Lauantai;2;1;3
95;28.02.2015;2015;02;15;Lauantai;0;2;2
95;28.02.2015;2015;02;16;Lauantai;1;1;2
95;28.02.2015;2015;02;17;Lauantai;1;3;4
95;28.02.2015;2015;02;18;Lauantai;2;1;3
95;28.02.2015;2015;02;19;Lauantai;0;0;0
95;28.02.2015;2015;02;20;Lauantai;0;2;2
95;28.02.2015;2015;02;21;Lauantai;0;1;1
95;28.02.2015;2015;02;22;Lauantai;1;1;2
95;28.02.2015;2015;02;23;Lauantai;1;0;1
95;01.03.2015;2015;03;00;Sunnuntai;0;0;0
95;01.03.2015;2015;03;01;Sunnuntai;0;0;0
95;01.03.2015;2015;03;02;Sunnuntai;0;0;0
95;01.03.2015;2015;03;03;Sunnuntai;1;0;1
95;01.03.2015;2015;03;04;Sunnuntai;0;0;0
95;01.03.2015;2015;03;05;Sunnuntai;0;0;0
95;01.03.2015;2015;03;06;Sunnuntai;0;0;0
95;01.03.2015;2015;03;07;Sunnuntai;0;0;0
95;01.03.2015;2015;03;08;Sunnuntai;0;1;1
95;01.03.2015;2015;03;09;Sunnuntai;1;2;3
95;01.03.2015;2015;03;10;Sunnuntai;3;2;5
95;01.03.2015;2015;03;11;Sunnuntai;13;1;14
95;01.03.2015;2015;03;12;Sunnuntai;0;3;3
95;01.03.2015;2015;03;13;Sunnuntai;1;5;6
95;01.03.2015;2015;03;14;Sunnuntai;1;3;4
95;01.03.2015;2015;03;15;Sunnuntai;4;2;6
95;01.03.2015;2015;03;16;Sunnuntai;1;3;4
95;01.03.2015;2015;03;17;Sunnuntai;3;1;4
95;01.03.2015;2015;03;18;Sunnuntai;2;2;4
95;01.03.2015;2015;03;19;Sunnuntai;1;0;1
95;01.03.2015;2015;03;20;Sunnuntai;0;0;0
95;01.03.2015;2015;03;21;Sunnuntai;0;0;0
95;01.03.2015;2015;03;22;Sunnuntai;0;0;0
95;01.03.2015;2015;03;23;Sunnuntai;1;0;1
95;02.03.2015;2015;03;00;Maanantai;0;0;0
95;02.03.2015;2015;03;01;Maanantai;0;0;0
95;02.03.2015;2015;03;02;Maanantai;0;0;0
95;02.03.2015;2015;03;03;Maanantai;0;0;0
95;02.03.2015;2015;03;04;Maanantai;1;0;1
95;02.03.2015;2015;03;05;Maanantai;1;3;4
95;02.03.2015;2015;03;06;Maanantai;9;3;12
95;02.03.2015;2015;03;07;Maanantai;5;5;10
95;02.03.2015;2015;03;08;Maanantai;5;2;7
95;02.03.2015;2015;03;09;Maanantai;4;2;6
95;02.03.2015;2015;03;10;Maanantai;5;1;6
95;02.03.2015;2015;03;11;Maanantai;0;2;2
95;02.03.2015;2015;03;12;Maanantai;5;2;7
95;02.03.2015;2015;03;13;Maanantai;3;2;5
95;02.03.2015;2015;03;14;Maanantai;9;3;12
95;02.03.2015;2015;03;15;Maanantai;4;5;9
95;02.03.2015;2015;03;16;Maanantai;3;5;8
95;02.03.2015;2015;03;17;Maanantai;1;6;7
95;02.03.2015;2015;03;18;Maanantai;1;4;5
95;02.03.2015;2015;03;19;Maanantai;0;3;3
95;02.03.2015;2015;03;20;Maanantai;1;1;2
95;02.03.2015;2015;03;21;Maanantai;2;1;3
95;02.03.2015;2015;03;22;Maanantai;0;0;0
95;02.03.2015;2015;03;23;Maanantai;1;0;1
95;03.03.2015;2015;03;00;Tiistai;0;1;1
95;03.03.2015;2015;03;01;Tiistai;0;0;0
95;03.03.2015;2015;03;02;Tiistai;0;0;0
95;03.03.2015;2015;03;03;Tiistai;0;0;0
95;03.03.2015;2015;03;04;Tiistai;1;0;1
95;03.03.2015;2015;03;05;Tiistai;0;3;3
95;03.03.2015;2015;03;06;Tiistai;9;2;11
95;03.03.2015;2015;03;07;Tiistai;3;3;6
95;03.03.2015;2015;03;08;Tiistai;4;2;6
95;03.03.2015;2015;03;09;Tiistai;3;3;6
95;03.03.2015;2015;03;10;Tiistai;2;2;4
95;03.03.2015;2015;03;11;Tiistai;1;3;4
95;03.03.2015;2015;03;12;Tiistai;6;2;8
95;03.03.2015;2015;03;13;Tiistai;3;4;7
95;03.03.2015;2015;03;14;Tiistai;4;1;5
95;03.03.2015;2015;03;15;Tiistai;5;3;8
95;03.03.2015;2015;03;16;Tiistai;4;9;13
95;03.03.2015;2015;03;17;Tiistai;0;4;4
95;03.03.2015;2015;03;18;Tiistai;2;3;5
95;03.03.2015;2015;03;19;Tiistai;2;2;4
95;03.03.2015;2015;03;20;Tiistai;1;1;2
95;03.03.2015;2015;03;21;Tiistai;1;2;3
95;03.03.2015;2015;03;22;Tiistai;1;1;2
95;03.03.2015;2015;03;23;Tiistai;0;3;3
95;04.03.2015;2015;03;00;Keskiviikko;0;0;0
95;04.03.2015;2015;03;01;Keskiviikko;0;0;0
95;04.03.2015;2015;03;02;Keskiviikko;0;0;0
95;04.03.2015;2015;03;03;Keskiviikko;0;0;0
95;04.03.2015;2015;03;04;Keskiviikko;0;0;0
95;04.03.2015;2015;03;05;Keskiviikko;1;4;5
95;04.03.2015;2015;03;06;Keskiviikko;6;1;7
95;04.03.2015;2015;03;07;Keskiviikko;7;2;9
95;04.03.2015;2015;03;08;Keskiviikko;3;2;5
95;04.03.2015;2015;03;09;Keskiviikko;1;1;2
95;04.03.2015;2015;03;10;Keskiviikko;0;1;1
95;04.03.2015;2015;03;11;Keskiviikko;0;0;0
95;04.03.2015;2015;03;12;Keskiviikko;1;3;4
95;04.03.2015;2015;03;13;Keskiviikko;3;2;5
95;04.03.2015;2015;03;14;Keskiviikko;4;1;5
95;04.03.2015;2015;03;15;Keskiviikko;4;4;8
95;04.03.2015;2015;03;16;Keskiviikko;1;7;8
95;04.03.2015;2015;03;17;Keskiviikko;1;6;7
95;04.03.2015;2015;03;18;Keskiviikko;1;3;4
95;04.03.2015;2015;03;19;Keskiviikko;2;1;3
95;04.03.2015;2015;03;20;Keskiviikko;1;2;3
95;04.03.2015;2015;03;21;Keskiviikko;1;0;1
95;04.03.2015;2015;03;22;Keskiviikko;0;0;0
95;04.03.2015;2015;03;23;Keskiviikko;0;0;0
95;05.03.2015;2015;03;00;Torstai;0;0;0
95;05.03.2015;2015;03;01;Torstai;0;0;0
95;05.03.2015;2015;03;02;Torstai;0;0;0
95;05.03.2015;2015;03;03;Torstai;0;0;0
95;05.03.2015;2015;03;04;Torstai;1;0;1
95;05.03.2015;2015;03;05;Torstai;0;2;2
95;05.03.2015;2015;03;06;Torstai;7;3;10
95;05.03.2015;2015;03;07;Torstai;3;3;6
95;05.03.2015;2015;03;08;Torstai;5;3;8
95;05.03.2015;2015;03;09;Torstai;4;4;8
95;05.03.2015;2015;03;10;Torstai;2;0;2
95;05.03.2015;2015;03;11;Torstai;1;4;5
95;05.03.2015;2015;03;12;Torstai;1;5;6
95;05.03.2015;2015;03;13;Torstai;3;2;5
95;05.03.2015;2015;03;14;Torstai;5;4;9
95;05.03.2015;2015;03;15;Torstai;4;11;15
95;05.03.2015;2015;03;16;Torstai;4;5;9
95;05.03.2015;2015;03;17;Torstai;3;3;6
95;05.03.2015;2015;03;18;Torstai;1;6;7
95;05.03.2015;2015;03;19;Torstai;1;2;3
95;05.03.2015;2015;03;20;Torstai;1;1;2
95;05.03.2015;2015;03;21;Torstai;0;1;1
95;05.03.2015;2015;03;22;Torstai;0;0;0
95;05.03.2015;2015;03;23;Torstai;0;1;1
95;06.03.2015;2015;03;00;Perjantai;2;0;2
95;06.03.2015;2015;03;01;Perjantai;0;0;0
95;06.03.2015;2015;03;02;Perjantai;0;0;0
95;06.03.2015;2015;03;03;Perjantai;0;0;0
95;06.03.2015;2015;03;04;Perjantai;0;0;0
95;06.03.2015;2015;03;05;Perjantai;0;2;2
95;06.03.2015;2015;03;06;Perjantai;4;1;5
95;06.03.2015;2015;03;07;Perjantai;4;4;8
95;06.03.2015;2015;03;08;Perjantai;5;1;6
95;06.03.2015;2015;03;09;Perjantai;3;1;4
95;06.03.2015;2015;03;10;Perjantai;0;0;0
95;06.03.2015;2015;03;11;Perjantai;2;2;4
95;06.03.2015;2015;03;12;Perjantai;2;3;5
95;06.03.2015;2015;03;13;Perjantai;5;4;9
95;06.03.2015;2015;03;14;Perjantai;3;3;6
95;06.03.2015;2015;03;15;Perjantai;4;5;9
95;06.03.2015;2015;03;16;Perjantai;1;5;6
95;06.03.2015;2015;03;17;Perjantai;0;4;4
95;06.03.2015;2015;03;18;Perjantai;1;3;4
95;06.03.2015;2015;03;19;Perjantai;1;2;3
95;06.03.2015;2015;03;20;Perjantai;2;0;2
95;06.03.2015;2015;03;21;Perjantai;1;1;2
95;06.03.2015;2015;03;22;Perjantai;1;1;2
95;06.03.2015;2015;03;23;Perjantai;0;0;0
95;07.03.2015;2015;03;00;Lauantai;1;0;1
95;07.03.2015;2015;03;01;Lauantai;0;0;0
95;07.03.2015;2015;03;02;Lauantai;0;0;0
95;07.03.2015;2015;03;03;Lauantai;1;0;1
95;07.03.2015;2015;03;04;Lauantai;0;0;0
95;07.03.2015;2015;03;05;Lauantai;0;0;0
95;07.03.2015;2015;03;06;Lauantai;1;0;1
95;07.03.2015;2015;03;07;Lauantai;1;0;1
95;07.03.2015;2015;03;08;Lauantai;2;1;3
95;07.03.2015;2015;03;09;Lauantai;1;0;1
95;07.03.2015;2015;03;10;Lauantai;4;1;5
95;07.03.2015;2015;03;11;Lauantai;2;4;6
95;07.03.2015;2015;03;12;Lauantai;1;0;1
95;07.03.2015;2015;03;13;Lauantai;2;3;5
95;07.03.2015;2015;03;14;Lauantai;1;4;5
95;07.03.2015;2015;03;15;Lauantai;0;0;0
95;07.03.2015;2015;03;16;Lauantai;3;0;3
95;07.03.2015;2015;03;17;Lauantai;0;4;4
95;07.03.2015;2015;03;18;Lauantai;0;0;0
95;07.03.2015;2015;03;19;Lauantai;0;0;0
95;07.03.2015;2015;03;20;Lauantai;1;0;1
95;07.03.2015;2015;03;21;Lauantai;0;0;0
95;07.03.2015;2015;03;22;Lauantai;0;1;1
95;07.03.2015;2015;03;23;Lauantai;1;0;1
95;08.03.2015;2015;03;00;Sunnuntai;0;0;0
95;08.03.2015;2015;03;01;Sunnuntai;0;0;0
95;08.03.2015;2015;03;02;Sunnuntai;0;0;0
95;08.03.2015;2015;03;03;Sunnuntai;0;0;0
95;08.03.2015;2015;03;04;Sunnuntai;0;0;0
95;08.03.2015;2015;03;05;Sunnuntai;0;0;0
95;08.03.2015;2015;03;06;Sunnuntai;1;0;1
95;08.03.2015;2015;03;07;Sunnuntai;0;0;0
95;08.03.2015;2015;03;08;Sunnuntai;0;0;0
95;08.03.2015;2015;03;09;Sunnuntai;0;0;0
95;08.03.2015;2015;03;10;Sunnuntai;1;1;2
95;08.03.2015;2015;03;11;Sunnuntai;1;1;2
95;08.03.2015;2015;03;12;Sunnuntai;1;4;5
95;08.03.2015;2015;03;13;Sunnuntai;1;4;5
95;08.03.2015;2015;03;14;Sunnuntai;1;3;4
95;08.03.2015;2015;03;15;Sunnuntai;4;3;7
95;08.03.2015;2015;03;16;Sunnuntai;5;4;9
95;08.03.2015;2015;03;17;Sunnuntai;2;5;7
95;08.03.2015;2015;03;18;Sunnuntai;1;4;5
95;08.03.2015;2015;03;19;Sunnuntai;3;1;4
95;08.03.2015;2015;03;20;Sunnuntai;3;0;3
95;08.03.2015;2015;03;21;Sunnuntai;1;0;1
95;08.03.2015;2015;03;22;Sunnuntai;0;1;1
95;08.03.2015;2015;03;23;Sunnuntai;0;0;0
95;09.03.2015;2015;03;00;Maanantai;0;0;0
95;09.03.2015;2015;03;01;Maanantai;0;0;0
95;09.03.2015;2015;03;02;Maanantai;0;0;0
95;09.03.2015;2015;03;03;Maanantai;0;0;0
95;09.03.2015;2015;03;04;Maanantai;1;0;1
95;09.03.2015;2015;03;05;Maanantai;2;2;4
95;09.03.2015;2015;03;06;Maanantai;11;2;13
95;09.03.2015;2015;03;07;Maanantai;8;7;15
95;09.03.2015;2015;03;08;Maanantai;10;6;16
95;09.03.2015;2015;03;09;Maanantai;3;4;7
95;09.03.2015;2015;03;10;Maanantai;4;0;4
95;09.03.2015;2015;03;11;Maanantai;4;4;8
95;09.03.2015;2015;03;12;Maanantai;8;4;12
95;09.03.2015;2015;03;13;Maanantai;3;7;10
95;09.03.2015;2015;03;14;Maanantai;7;4;11
95;09.03.2015;2015;03;15;Maanantai;6;12;18
95;09.03.2015;2015;03;16;Maanantai;10;12;22
95;09.03.2015;2015;03;17;Maanantai;5;4;9
95;09.03.2015;2015;03;18;Maanantai;2;13;15
95;09.03.2015;2015;03;19;Maanantai;3;3;6
95;09.03.2015;2015;03;20;Maanantai;1;1;2
95;09.03.2015;2015;03;21;Maanantai;1;0;1
95;09.03.2015;2015;03;22;Maanantai;2;0;2
95;09.03.2015;2015;03;23;Maanantai;0;1;1
95;10.03.2015;2015;03;00;Tiistai;1;0;1
95;10.03.2015;2015;03;01;Tiistai;0;0;0
95;10.03.2015;2015;03;02;Tiistai;0;0;0
95;10.03.2015;2015;03;03;Tiistai;0;0;0
95;10.03.2015;2015;03;04;Tiistai;1;0;1
95;10.03.2015;2015;03;05;Tiistai;0;2;2
95;10.03.2015;2015;03;06;Tiistai;10;6;16
95;10.03.2015;2015;03;07;Tiistai;8;10;18
95;10.03.2015;2015;03;08;Tiistai;5;3;8
95;10.03.2015;2015;03;09;Tiistai;5;0;5
95;10.03.2015;2015;03;10;Tiistai;4;2;6
95;10.03.2015;2015;03;11;Tiistai;3;4;7
95;10.03.2015;2015;03;12;Tiistai;4;4;8
95;10.03.2015;2015;03;13;Tiistai;2;4;6
95;10.03.2015;2015;03;14;Tiistai;4;3;7
95;10.03.2015;2015;03;15;Tiistai;8;4;12
95;10.03.2015;2015;03;16;Tiistai;1;8;9
95;10.03.2015;2015;03;17;Tiistai;5;7;12
95;10.03.2015;2015;03;18;Tiistai;1;4;5
95;10.03.2015;2015;03;19;Tiistai;0;1;1
95;10.03.2015;2015;03;20;Tiistai;0;6;6
95;10.03.2015;2015;03;21;Tiistai;1;2;3
95;10.03.2015;2015;03;22;Tiistai;2;0;2
95;10.03.2015;2015;03;23;Tiistai;0;1;1
95;11.03.2015;2015;03;00;Keskiviikko;0;0;0
95;11.03.2015;2015;03;01;Keskiviikko;0;0;0
95;11.03.2015;2015;03;02;Keskiviikko;0;0;0
95;11.03.2015;2015;03;03;Keskiviikko;0;0;0
95;11.03.2015;2015;03;04;Keskiviikko;1;0;1
95;11.03.2015;2015;03;05;Keskiviikko;2;2;4
95;11.03.2015;2015;03;06;Keskiviikko;5;3;8
95;11.03.2015;2015;03;07;Keskiviikko;6;8;14
95;11.03.2015;2015;03;08;Keskiviikko;8;2;10
95;11.03.2015;2015;03;09;Keskiviikko;2;4;6
95;11.03.2015;2015;03;10;Keskiviikko;4;6;10
95;11.03.2015;2015;03;11;Keskiviikko;5;4;9
95;11.03.2015;2015;03;12;Keskiviikko;2;3;5
95;11.03.2015;2015;03;13;Keskiviikko;6;7;13
95;11.03.2015;2015;03;14;Keskiviikko;4;8;12
95;11.03.2015;2015;03;15;Keskiviikko;9;8;17
95;11.03.2015;2015;03;16;Keskiviikko;9;10;19
95;11.03.2015;2015;03;17;Keskiviikko;6;9;15
95;11.03.2015;2015;03;18;Keskiviikko;2;4;6
95;11.03.2015;2015;03;19;Keskiviikko;0;2;2
95;11.03.2015;2015;03;20;Keskiviikko;1;2;3
95;11.03.2015;2015;03;21;Keskiviikko;0;0;0
95;11.03.2015;2015;03;22;Keskiviikko;1;1;2
95;11.03.2015;2015;03;23;Keskiviikko;0;1;1
95;12.03.2015;2015;03;00;Torstai;1;0;1
95;12.03.2015;2015;03;01;Torstai;1;0;1
95;12.03.2015;2015;03;02;Torstai;0;0;0
95;12.03.2015;2015;03;03;Torstai;0;0;0
95;12.03.2015;2015;03;04;Torstai;1;0;1
95;12.03.2015;2015;03;05;Torstai;1;2;3
95;12.03.2015;2015;03;06;Torstai;5;3;8
95;12.03.2015;2015;03;07;Torstai;7;7;14
95;12.03.2015;2015;03;08;Torstai;5;6;11
95;12.03.2015;2015;03;09;Torstai;1;4;5
95;12.03.2015;2015;03;10;Torstai;2;3;5
95;12.03.2015;2015;03;11;Torstai;6;4;10
95;12.03.2015;2015;03;12;Torstai;8;1;9
95;12.03.2015;2015;03;13;Torstai;2;3;5
95;12.03.2015;2015;03;14;Torstai;8;6;14
95;12.03.2015;2015;03;15;Torstai;10;11;21
95;12.03.2015;2015;03;16;Torstai;7;4;11
95;12.03.2015;2015;03;17;Torstai;3;11;14
95;12.03.2015;2015;03;18;Torstai;1;3;4
95;12.03.2015;2015;03;19;Torstai;3;1;4
95;12.03.2015;2015;03;20;Torstai;2;4;6
95;12.03.2015;2015;03;21;Torstai;1;0;1
95;12.03.2015;2015;03;22;Torstai;1;0;1
95;12.03.2015;2015;03;23;Torstai;0;1;1
95;13.03.2015;2015;03;00;Perjantai;0;0;0
95;13.03.2015;2015;03;01;Perjantai;0;1;1
95;13.03.2015;2015;03;02;Perjantai;0;0;0
95;13.03.2015;2015;03;03;Perjantai;0;0;0
95;13.03.2015;2015;03;04;Perjantai;1;0;1
95;13.03.2015;2015;03;05;Perjantai;3;2;5
95;13.03.2015;2015;03;06;Perjantai;3;3;6
95;13.03.2015;2015;03;07;Perjantai;7;4;11
95;13.03.2015;2015;03;08;Perjantai;5;4;9
95;13.03.2015;2015;03;09;Perjantai;1;3;4
95;13.03.2015;2015;03;10;Perjantai;9;3;12
95;13.03.2015;2015;03;11;Perjantai;2;6;8
95;13.03.2015;2015;03;12;Perjantai;4;1;5
95;13.03.2015;2015;03;13;Perjantai;11;9;20
95;13.03.2015;2015;03;14;Perjantai;9;8;17
95;13.03.2015;2015;03;15;Perjantai;3;4;7
95;13.03.2015;2015;03;16;Perjantai;2;5;7
95;13.03.2015;2015;03;17;Perjantai;7;9;16
95;13.03.2015;2015;03;18;Perjantai;4;7;11
95;13.03.2015;2015;03;19;Perjantai;1;2;3
95;13.03.2015;2015;03;20;Perjantai;4;2;6
95;13.03.2015;2015;03;21;Perjantai;1;1;2
95;13.03.2015;2015;03;22;Perjantai;0;1;1
95;13.03.2015;2015;03;23;Perjantai;0;1;1
95;14.03.2015;2015;03;00;Lauantai;0;0;0
95;14.03.2015;2015;03;01;Lauantai;0;0;0
95;14.03.2015;2015;03;02;Lauantai;0;0;0
95;14.03.2015;2015;03;03;Lauantai;0;1;1
95;14.03.2015;2015;03;04;Lauantai;1;0;1
95;14.03.2015;2015;03;05;Lauantai;1;0;1
95;14.03.2015;2015;03;06;Lauantai;1;0;1
95;14.03.2015;2015;03;07;Lauantai;0;1;1
95;14.03.2015;2015;03;08;Lauantai;1;0;1
95;14.03.2015;2015;03;09;Lauantai;2;0;2
95;14.03.2015;2015;03;10;Lauantai;4;4;8
95;14.03.2015;2015;03;11;Lauantai;6;8;14
95;14.03.2015;2015;03;12;Lauantai;8;11;19
95;14.03.2015;2015;03;13;Lauantai;6;4;10
95;14.03.2015;2015;03;14;Lauantai;10;6;16
95;14.03.2015;2015;03;15;Lauantai;7;11;18
95;14.03.2015;2015;03;16;Lauantai;8;6;14
95;14.03.2015;2015;03;17;Lauantai;12;5;17
95;14.03.2015;2015;03;18;Lauantai;3;2;5
95;14.03.2015;2015;03;19;Lauantai;6;6;12
95;14.03.2015;2015;03;20;Lauantai;1;1;2
95;14.03.2015;2015;03;21;Lauantai;2;0;2
95;14.03.2015;2015;03;22;Lauantai;0;2;2
95;14.03.2015;2015;03;23;Lauantai;0;1;1
95;15.03.2015;2015;03;00;Sunnuntai;0;0;0
95;15.03.2015;2015;03;01;Sunnuntai;0;0;0
95;15.03.2015;2015;03;02;Sunnuntai;0;0;0
95;15.03.2015;2015;03;03;Sunnuntai;0;0;0
95;15.03.2015;2015;03;04;Sunnuntai;0;0;0
95;15.03.2015;2015;03;05;Sunnuntai;2;0;2
95;15.03.2015;2015;03;06;Sunnuntai;2;0;2
95;15.03.2015;2015;03;07;Sunnuntai;0;1;1
95;15.03.2015;2015;03;08;Sunnuntai;2;0;2
95;15.03.2015;2015;03;09;Sunnuntai;0;5;5
95;15.03.2015;2015;03;10;Sunnuntai;5;6;11
95;15.03.2015;2015;03;11;Sunnuntai;8;15;23
95;15.03.2015;2015;03;12;Sunnuntai;11;10;21
95;15.03.2015;2015;03;13;Sunnuntai;9;16;25
95;15.03.2015;2015;03;14;Sunnuntai;14;10;24
95;15.03.2015;2015;03;15;Sunnuntai;7;9;16
95;15.03.2015;2015;03;16;Sunnuntai;12;8;20
95;15.03.2015;2015;03;17;Sunnuntai;2;2;4
95;15.03.2015;2015;03;18;Sunnuntai;5;7;12
95;15.03.2015;2015;03;19;Sunnuntai;3;1;4
95;15.03.2015;2015;03;20;Sunnuntai;2;4;6
95;15.03.2015;2015;03;21;Sunnuntai;5;4;9
95;15.03.2015;2015;03;22;Sunnuntai;2;1;3
95;15.03.2015;2015;03;23;Sunnuntai;0;0;0
95;16.03.2015;2015;03;00;Maanantai;0;0;0
95;16.03.2015;2015;03;01;Maanantai;0;0;0
95;16.03.2015;2015;03;02;Maanantai;0;0;0
95;16.03.2015;2015;03;03;Maanantai;0;0;0
95;16.03.2015;2015;03;04;Maanantai;1;0;1
95;16.03.2015;2015;03;05;Maanantai;2;3;5
95;16.03.2015;2015;03;06;Maanantai;8;2;10
95;16.03.2015;2015;03;07;Maanantai;10;9;19
95;16.03.2015;2015;03;08;Maanantai;5;4;9
95;16.03.2015;2015;03;09;Maanantai;6;6;12
95;16.03.2015;2015;03;10;Maanantai;6;3;9
95;16.03.2015;2015;03;11;Maanantai;11;6;17
95;16.03.2015;2015;03;12;Maanantai;11;3;14
95;16.03.2015;2015;03;13;Maanantai;6;11;17
95;16.03.2015;2015;03;14;Maanantai;10;9;19
95;16.03.2015;2015;03;15;Maanantai;7;10;17
95;16.03.2015;2015;03;16;Maanantai;16;15;31
95;16.03.2015;2015;03;17;Maanantai;5;7;12
95;16.03.2015;2015;03;18;Maanantai;7;10;17
95;16.03.2015;2015;03;19;Maanantai;3;8;11
95;16.03.2015;2015;03;20;Maanantai;2;2;4
95;16.03.2015;2015;03;21;Maanantai;1;3;4
95;16.03.2015;2015;03;22;Maanantai;2;2;4
95;16.03.2015;2015;03;23;Maanantai;0;1;1
95;17.03.2015;2015;03;00;Tiistai;0;0;0
95;17.03.2015;2015;03;01;Tiistai;0;0;0
95;17.03.2015;2015;03;02;Tiistai;0;0;0
95;17.03.2015;2015;03;03;Tiistai;0;1;1
95;17.03.2015;2015;03;04;Tiistai;1;0;1
95;17.03.2015;2015;03;05;Tiistai;4;2;6
95;17.03.2015;2015;03;06;Tiistai;13;7;20
95;17.03.2015;2015;03;07;Tiistai;12;11;23
95;17.03.2015;2015;03;08;Tiistai;5;5;10
95;17.03.2015;2015;03;09;Tiistai;2;5;7
95;17.03.2015;2015;03;10;Tiistai;8;5;13
95;17.03.2015;2015;03;11;Tiistai;10;6;16
95;17.03.2015;2015;03;12;Tiistai;4;12;16
95;17.03.2015;2015;03;13;Tiistai;11;6;17
95;17.03.2015;2015;03;14;Tiistai;10;5;15
95;17.03.2015;2015;03;15;Tiistai;13;19;32
95;17.03.2015;2015;03;16;Tiistai;6;11;17
95;17.03.2015;2015;03;17;Tiistai;6;13;19
95;17.03.2015;2015;03;18;Tiistai;3;13;16
95;17.03.2015;2015;03;19;Tiistai;1;4;5
95;17.03.2015;2015;03;20;Tiistai;1;1;2
95;17.03.2015;2015;03;21;Tiistai;1;1;2
95;17.03.2015;2015;03;22;Tiistai;2;3;5
95;17.03.2015;2015;03;23;Tiistai;0;1;1
95;18.03.2015;2015;03;00;Keskiviikko;0;0;0
95;18.03.2015;2015;03;01;Keskiviikko;0;0;0
95;18.03.2015;2015;03;02;Keskiviikko;0;0;0
95;18.03.2015;2015;03;03;Keskiviikko;0;0;0
95;18.03.2015;2015;03;04;Keskiviikko;0;0;0
95;18.03.2015;2015;03;05;Keskiviikko;3;2;5
95;18.03.2015;2015;03;06;Keskiviikko;10;5;15
95;18.03.2015;2015;03;07;Keskiviikko;8;8;16
95;18.03.2015;2015;03;08;Keskiviikko;3;7;10
95;18.03.2015;2015;03;09;Keskiviikko;3;2;5
95;18.03.2015;2015;03;10;Keskiviikko;7;3;10
95;18.03.2015;2015;03;11;Keskiviikko;5;3;8
95;18.03.2015;2015;03;12;Keskiviikko;4;3;7
95;18.03.2015;2015;03;13;Keskiviikko;11;10;21
95;18.03.2015;2015;03;14;Keskiviikko;11;9;20
95;18.03.2015;2015;03;15;Keskiviikko;6;18;24
95;18.03.2015;2015;03;16;Keskiviikko;15;11;26
95;18.03.2015;2015;03;17;Keskiviikko;2;8;10
95;18.03.2015;2015;03;18;Keskiviikko;1;2;3
95;18.03.2015;2015;03;19;Keskiviikko;2;4;6
95;18.03.2015;2015;03;20;Keskiviikko;1;4;5
95;18.03.2015;2015;03;21;Keskiviikko;1;0;1
95;18.03.2015;2015;03;22;Keskiviikko;1;3;4
95;18.03.2015;2015;03;23;Keskiviikko;1;0;1
95;19.03.2015;2015;03;00;Torstai;0;0;0
95;19.03.2015;2015;03;01;Torstai;0;1;1
95;19.03.2015;2015;03;02;Torstai;0;1;1
95;19.03.2015;2015;03;03;Torstai;0;1;1
95;19.03.2015;2015;03;04;Torstai;1;0;1
95;19.03.2015;2015;03;05;Torstai;1;2;3
95;19.03.2015;2015;03;06;Torstai;7;5;12
95;19.03.2015;2015;03;07;Torstai;8;9;17
95;19.03.2015;2015;03;08;Torstai;8;4;12
95;19.03.2015;2015;03;09;Torstai;3;3;6
95;19.03.2015;2015;03;10;Torstai;3;2;5
95;19.03.2015;2015;03;11;Torstai;11;5;16
95;19.03.2015;2015;03;12;Torstai;6;5;11
95;19.03.2015;2015;03;13;Torstai;4;4;8
95;19.03.2015;2015;03;14;Torstai;7;2;9
95;19.03.2015;2015;03;15;Torstai;5;7;12
95;19.03.2015;2015;03;16;Torstai;11;11;22
95;19.03.2015;2015;03;17;Torstai;3;7;10
95;19.03.2015;2015;03;18;Torstai;6;7;13
95;19.03.2015;2015;03;19;Torstai;1;3;4
95;19.03.2015;2015;03;20;Torstai;3;5;8
95;19.03.2015;2015;03;21;Torstai;0;2;2
95;19.03.2015;2015;03;22;Torstai;2;1;3
95;19.03.2015;2015;03;23;Torstai;0;0;0
95;20.03.2015;2015;03;00;Perjantai;0;1;1
95;20.03.2015;2015;03;01;Perjantai;0;0;0
95;20.03.2015;2015;03;02;Perjantai;0;0;0
95;20.03.2015;2015;03;03;Perjantai;0;0;0
95;20.03.2015;2015;03;04;Perjantai;1;0;1
95;20.03.2015;2015;03;05;Perjantai;2;3;5
95;20.03.2015;2015;03;06;Perjantai;7;4;11
95;20.03.2015;2015;03;07;Perjantai;4;7;11
95;20.03.2015;2015;03;08;Perjantai;5;6;11
95;20.03.2015;2015;03;09;Perjantai;4;1;5
95;20.03.2015;2015;03;10;Perjantai;6;1;7
95;20.03.2015;2015;03;11;Perjantai;6;5;11
95;20.03.2015;2015;03;12;Perjantai;6;9;15
95;20.03.2015;2015;03;13;Perjantai;4;9;13
95;20.03.2015;2015;03;14;Perjantai;10;8;18
95;20.03.2015;2015;03;15;Perjantai;10;7;17
95;20.03.2015;2015;03;16;Perjantai;8;4;12
95;20.03.2015;2015;03;17;Perjantai;1;8;9
95;20.03.2015;2015;03;18;Perjantai;6;4;10
95;20.03.2015;2015;03;19;Perjantai;2;2;4
95;20.03.2015;2015;03;20;Perjantai;3;4;7
95;20.03.2015;2015;03;21;Perjantai;3;3;6
95;20.03.2015;2015;03;22;Perjantai;0;2;2
95;20.03.2015;2015;03;23;Perjantai;0;0;0
95;21.03.2015;2015;03;00;Lauantai;1;0;1
95;21.03.2015;2015;03;01;Lauantai;0;0;0
95;21.03.2015;2015;03;02;Lauantai;0;0;0
95;21.03.2015;2015;03;03;Lauantai;0;1;1
95;21.03.2015;2015;03;04;Lauantai;0;0;0
95;21.03.2015;2015;03;05;Lauantai;0;0;0
95;21.03.2015;2015;03;06;Lauantai;1;1;2
95;21.03.2015;2015;03;07;Lauantai;0;0;0
95;21.03.2015;2015;03;08;Lauantai;1;0;1
95;21.03.2015;2015;03;09;Lauantai;2;3;5
95;21.03.2015;2015;03;10;Lauantai;3;3;6
95;21.03.2015;2015;03;11;Lauantai;3;4;7
95;21.03.2015;2015;03;12;Lauantai;2;1;3
95;21.03.2015;2015;03;13;Lauantai;5;9;14
95;21.03.2015;2015;03;14;Lauantai;6;2;8
95;21.03.2015;2015;03;15;Lauantai;2;5;7
95;21.03.2015;2015;03;16;Lauantai;2;4;6
95;21.03.2015;2015;03;17;Lauantai;4;4;8
95;21.03.2015;2015;03;18;Lauantai;4;1;5
95;21.03.2015;2015;03;19;Lauantai;1;0;1
95;21.03.2015;2015;03;20;Lauantai;0;1;1
95;21.03.2015;2015;03;21;Lauantai;1;1;2
95;21.03.2015;2015;03;22;Lauantai;0;2;2
95;21.03.2015;2015;03;23;Lauantai;0;0;0
95;22.03.2015;2015;03;00;Sunnuntai;0;1;1
95;22.03.2015;2015;03;01;Sunnuntai;0;0;0
95;22.03.2015;2015;03;02;Sunnuntai;0;0;0
95;22.03.2015;2015;03;03;Sunnuntai;0;0;0
95;22.03.2015;2015;03;04;Sunnuntai;0;0;0
95;22.03.2015;2015;03;05;Sunnuntai;0;0;0
95;22.03.2015;2015;03;06;Sunnuntai;2;0;2
95;22.03.2015;2015;03;07;Sunnuntai;0;2;2
95;22.03.2015;2015;03;08;Sunnuntai;0;2;2
95;22.03.2015;2015;03;09;Sunnuntai;0;0;0
95;22.03.2015;2015;03;10;Sunnuntai;1;2;3
95;22.03.2015;2015;03;11;Sunnuntai;2;2;4
95;22.03.2015;2015;03;12;Sunnuntai;7;1;8
95;22.03.2015;2015;03;13;Sunnuntai;4;5;9
95;22.03.2015;2015;03;14;Sunnuntai;3;3;6
95;22.03.2015;2015;03;15;Sunnuntai;0;1;1
95;22.03.2015;2015;03;16;Sunnuntai;0;1;1
95;22.03.2015;2015;03;17;Sunnuntai;3;2;5
95;22.03.2015;2015;03;18;Sunnuntai;0;0;0
95;22.03.2015;2015;03;19;Sunnuntai;0;0;0
95;22.03.2015;2015;03;20;Sunnuntai;0;1;1
95;22.03.2015;2015;03;21;Sunnuntai;2;0;2
95;22.03.2015;2015;03;22;Sunnuntai;0;2;2
95;22.03.2015;2015;03;23;Sunnuntai;1;0;1
95;23.03.2015;2015;03;00;Maanantai;0;0;0
95;23.03.2015;2015;03;01;Maanantai;0;0;0
95;23.03.2015;2015;03;02;Maanantai;1;0;1
95;23.03.2015;2015;03;03;Maanantai;0;1;1
95;23.03.2015;2015;03;04;Maanantai;2;0;2
95;23.03.2015;2015;03;05;Maanantai;2;3;5
95;23.03.2015;2015;03;06;Maanantai;4;2;6
95;23.03.2015;2015;03;07;Maanantai;8;7;15
95;23.03.2015;2015;03;08;Maanantai;6;5;11
95;23.03.2015;2015;03;09;Maanantai;1;5;6
95;23.03.2015;2015;03;10;Maanantai;5;1;6
95;23.03.2015;2015;03;11;Maanantai;3;3;6
95;23.03.2015;2015;03;12;Maanantai;6;4;10
95;23.03.2015;2015;03;13;Maanantai;4;8;12
95;23.03.2015;2015;03;14;Maanantai;3;4;7
95;23.03.2015;2015;03;15;Maanantai;6;3;9
95;23.03.2015;2015;03;16;Maanantai;9;8;17
95;23.03.2015;2015;03;17;Maanantai;3;6;9
95;23.03.2015;2015;03;18;Maanantai;1;2;3
95;23.03.2015;2015;03;19;Maanantai;1;1;2
95;23.03.2015;2015;03;20;Maanantai;2;3;5
95;23.03.2015;2015;03;21;Maanantai;2;1;3
95;23.03.2015;2015;03;22;Maanantai;2;0;2
95;23.03.2015;2015;03;23;Maanantai;0;0;0
95;24.03.2015;2015;03;00;Tiistai;1;1;2
95;24.03.2015;2015;03;01;Tiistai;0;0;0
95;24.03.2015;2015;03;02;Tiistai;1;0;1
95;24.03.2015;2015;03;03;Tiistai;0;0;0
95;24.03.2015;2015;03;04;Tiistai;1;0;1
95;24.03.2015;2015;03;05;Tiistai;1;3;4
95;24.03.2015;2015;03;06;Tiistai;4;2;6
95;24.03.2015;2015;03;07;Tiistai;6;6;12
95;24.03.2015;2015;03;08;Tiistai;6;4;10
95;24.03.2015;2015;03;09;Tiistai;3;0;3
95;24.03.2015;2015;03;10;Tiistai;5;1;6
95;24.03.2015;2015;03;11;Tiistai;1;0;1
95;24.03.2015;2015;03;12;Tiistai;2;2;4
95;24.03.2015;2015;03;13;Tiistai;1;2;3
95;24.03.2015;2015;03;14;Tiistai;2;2;4
95;24.03.2015;2015;03;15;Tiistai;7;4;11
95;24.03.2015;2015;03;16;Tiistai;4;7;11
95;24.03.2015;2015;03;17;Tiistai;0;6;6
95;24.03.2015;2015;03;18;Tiistai;2;3;5
95;24.03.2015;2015;03;19;Tiistai;1;1;2
95;24.03.2015;2015;03;20;Tiistai;1;2;3
95;24.03.2015;2015;03;21;Tiistai;1;1;2
95;24.03.2015;2015;03;22;Tiistai;2;1;3
95;24.03.2015;2015;03;23;Tiistai;0;0;0
95;25.03.2015;2015;03;00;Keskiviikko;0;0;0
95;25.03.2015;2015;03;01;Keskiviikko;0;1;1
95;25.03.2015;2015;03;02;Keskiviikko;0;0;0
95;25.03.2015;2015;03;03;Keskiviikko;0;0;0
95;25.03.2015;2015;03;04;Keskiviikko;1;0;1
95;25.03.2015;2015;03;05;Keskiviikko;0;3;3
95;25.03.2015;2015;03;06;Keskiviikko;9;3;12
95;25.03.2015;2015;03;07;Keskiviikko;3;5;8
95;25.03.2015;2015;03;08;Keskiviikko;7;1;8
95;25.03.2015;2015;03;09;Keskiviikko;2;1;3
95;25.03.2015;2015;03;10;Keskiviikko;2;2;4
95;25.03.2015;2015;03;11;Keskiviikko;4;3;7
95;25.03.2015;2015;03;12;Keskiviikko;1;6;7
95;25.03.2015;2015;03;13;Keskiviikko;1;4;5
95;25.03.2015;2015;03;14;Keskiviikko;5;6;11
95;25.03.2015;2015;03;15;Keskiviikko;9;5;14
95;25.03.2015;2015;03;16;Keskiviikko;6;13;19
95;25.03.2015;2015;03;17;Keskiviikko;2;8;10
95;25.03.2015;2015;03;18;Keskiviikko;4;5;9
95;25.03.2015;2015;03;19;Keskiviikko;3;1;4
95;25.03.2015;2015;03;20;Keskiviikko;1;4;5
95;25.03.2015;2015;03;21;Keskiviikko;1;0;1
95;25.03.2015;2015;03;22;Keskiviikko;1;3;4
95;25.03.2015;2015;03;23;Keskiviikko;1;0;1
95;26.03.2015;2015;03;00;Torstai;0;0;0
95;26.03.2015;2015;03;01;Torstai;0;0;0
95;26.03.2015;2015;03;02;Torstai;0;0;0
95;26.03.2015;2015;03;03;Torstai;0;0;0
95;26.03.2015;2015;03;04;Torstai;1;1;2
95;26.03.2015;2015;03;05;Torstai;2;2;4
95;26.03.2015;2015;03;06;Torstai;7;3;10
95;26.03.2015;2015;03;07;Torstai;10;9;19
95;26.03.2015;2015;03;08;Torstai;3;2;5
95;26.03.2015;2015;03;09;Torstai;0;4;4
95;26.03.2015;2015;03;10;Torstai;1;0;1
95;26.03.2015;2015;03;11;Torstai;6;3;9
95;26.03.2015;2015;03;12;Torstai;7;2;9
95;26.03.2015;2015;03;13;Torstai;6;5;11
95;26.03.2015;2015;03;14;Torstai;5;8;13
95;26.03.2015;2015;03;15;Torstai;5;13;18
95;26.03.2015;2015;03;16;Torstai;8;7;15
95;26.03.2015;2015;03;17;Torstai;1;9;10
95;26.03.2015;2015;03;18;Torstai;3;5;8
95;26.03.2015;2015;03;19;Torstai;6;1;7
95;26.03.2015;2015;03;20;Torstai;3;3;6
95;26.03.2015;2015;03;21;Torstai;2;2;4
95;26.03.2015;2015;03;22;Torstai;5;1;6
95;26.03.2015;2015;03;23;Torstai;0;0;0
95;27.03.2015;2015;03;00;Perjantai;0;0;0
95;27.03.2015;2015;03;01;Perjantai;0;0;0
95;27.03.2015;2015;03;02;Perjantai;0;0;0
95;27.03.2015;2015;03;03;Perjantai;0;0;0
95;27.03.2015;2015;03;04;Perjantai;1;0;1
95;27.03.2015;2015;03;05;Perjantai;1;1;2
95;27.03.2015;2015;03;06;Perjantai;6;4;10
95;27.03.2015;2015;03;07;Perjantai;5;4;9
95;27.03.2015;2015;03;08;Perjantai;8;4;12
95;27.03.2015;2015;03;09;Perjantai;4;4;8
95;27.03.2015;2015;03;10;Perjantai;6;3;9
95;27.03.2015;2015;03;11;Perjantai;2;2;4
95;27.03.2015;2015;03;12;Perjantai;7;1;8
95;27.03.2015;2015;03;13;Perjantai;8;3;11
95;27.03.2015;2015;03;14;Perjantai;9;7;16
95;27.03.2015;2015;03;15;Perjantai;5;7;12
95;27.03.2015;2015;03;16;Perjantai;1;6;7
95;27.03.2015;2015;03;17;Perjantai;6;3;9
95;27.03.2015;2015;03;18;Perjantai;2;3;5
95;27.03.2015;2015;03;19;Perjantai;0;3;3
95;27.03.2015;2015;03;20;Perjantai;3;0;3
95;27.03.2015;2015;03;21;Perjantai;0;2;2
95;27.03.2015;2015;03;22;Perjantai;0;2;2
95;27.03.2015;2015;03;23;Perjantai;0;1;1
95;28.03.2015;2015;03;00;Lauantai;0;0;0
95;28.03.2015;2015;03;01;Lauantai;0;0;0
95;28.03.2015;2015;03;02;Lauantai;0;0;0
95;28.03.2015;2015;03;03;Lauantai;0;0;0
95;28.03.2015;2015;03;04;Lauantai;4;1;5
95;28.03.2015;2015;03;05;Lauantai;0;0;0
95;28.03.2015;2015;03;06;Lauantai;2;1;3
95;28.03.2015;2015;03;07;Lauantai;0;1;1
95;28.03.2015;2015;03;08;Lauantai;0;0;0
95;28.03.2015;2015;03;09;Lauantai;0;3;3
95;28.03.2015;2015;03;10;Lauantai;0;1;1
95;28.03.2015;2015;03;11;Lauantai;1;0;1
95;28.03.2015;2015;03;12;Lauantai;2;1;3
95;28.03.2015;2015;03;13;Lauantai;2;3;5
95;28.03.2015;2015;03;14;Lauantai;1;0;1
95;28.03.2015;2015;03;15;Lauantai;0;1;1
95;28.03.2015;2015;03;16;Lauantai;1;1;2
95;28.03.2015;2015;03;17;Lauantai;1;2;3
95;28.03.2015;2015;03;18;Lauantai;1;1;2
95;28.03.2015;2015;03;19;Lauantai;0;1;1
95;28.03.2015;2015;03;20;Lauantai;1;2;3
95;28.03.2015;2015;03;21;Lauantai;0;0;0
95;28.03.2015;2015;03;22;Lauantai;0;0;0
95;28.03.2015;2015;03;23;Lauantai;0;0;0
95;29.03.2015;2015;03;00;Sunnuntai;0;1;1
95;29.03.2015;2015;03;01;Sunnuntai;0;0;0
95;29.03.2015;2015;03;02;Sunnuntai;0;0;0
95;29.03.2015;2015;03;03;Sunnuntai;0;0;0
95;29.03.2015;2015;03;04;Sunnuntai;0;0;0
95;29.03.2015;2015;03;05;Sunnuntai;1;0;1
95;29.03.2015;2015;03;06;Sunnuntai;0;0;0
95;29.03.2015;2015;03;07;Sunnuntai;1;1;2
95;29.03.2015;2015;03;08;Sunnuntai;2;6;8
95;29.03.2015;2015;03;09;Sunnuntai;0;2;2
95;29.03.2015;2015;03;10;Sunnuntai;0;7;7
95;29.03.2015;2015;03;11;Sunnuntai;8;3;11
95;29.03.2015;2015;03;12;Sunnuntai;3;8;11
95;29.03.2015;2015;03;13;Sunnuntai;9;1;10
95;29.03.2015;2015;03;14;Sunnuntai;4;6;10
95;29.03.2015;2015;03;15;Sunnuntai;7;5;12
95;29.03.2015;2015;03;16;Sunnuntai;1;0;1
95;29.03.2015;2015;03;17;Sunnuntai;2;1;3
95;29.03.2015;2015;03;18;Sunnuntai;1;2;3
95;29.03.2015;2015;03;19;Sunnuntai;1;2;3
95;29.03.2015;2015;03;20;Sunnuntai;3;0;3
95;29.03.2015;2015;03;21;Sunnuntai;1;2;3
95;29.03.2015;2015;03;22;Sunnuntai;1;1;2
95;29.03.2015;2015;03;23;Sunnuntai;0;0;0
95;30.03.2015;2015;03;00;Maanantai;0;0;0
95;30.03.2015;2015;03;01;Maanantai;0;0;0
95;30.03.2015;2015;03;02;Maanantai;0;0;0
95;30.03.2015;2015;03;03;Maanantai;0;0;0
95;30.03.2015;2015;03;04;Maanantai;1;0;1
95;30.03.2015;2015;03;05;Maanantai;0;1;1
95;30.03.2015;2015;03;06;Maanantai;6;2;8
95;30.03.2015;2015;03;07;Maanantai;11;6;17
95;30.03.2015;2015;03;08;Maanantai;5;2;7
95;30.03.2015;2015;03;09;Maanantai;0;4;4
95;30.03.2015;2015;03;10;Maanantai;2;2;4
95;30.03.2015;2015;03;11;Maanantai;5;1;6
95;30.03.2015;2015;03;12;Maanantai;6;4;10
95;30.03.2015;2015;03;13;Maanantai;4;2;6
95;30.03.2015;2015;03;14;Maanantai;3;3;6
95;30.03.2015;2015;03;15;Maanantai;7;8;15
95;30.03.2015;2015;03;16;Maanantai;3;5;8
95;30.03.2015;2015;03;17;Maanantai;2;8;10
95;30.03.2015;2015;03;18;Maanantai;2;3;5
95;30.03.2015;2015;03;19;Maanantai;6;0;6
95;30.03.2015;2015;03;20;Maanantai;4;4;8
95;30.03.2015;2015;03;21;Maanantai;0;0;0
95;30.03.2015;2015;03;22;Maanantai;1;0;1
95;30.03.2015;2015;03;23;Maanantai;0;0;0
95;31.03.2015;2015;03;00;Tiistai;0;0;0
95;31.03.2015;2015;03;01;Tiistai;0;0;0
95;31.03.2015;2015;03;02;Tiistai;0;0;0
95;31.03.2015;2015;03;03;Tiistai;0;0;0
95;31.03.2015;2015;03;04;Tiistai;0;0;0
95;31.03.2015;2015;03;05;Tiistai;3;3;6
95;31.03.2015;2015;03;06;Tiistai;4;1;5
95;31.03.2015;2015;03;07;Tiistai;4;5;9
95;31.03.2015;2015;03;08;Tiistai;5;3;8
95;31.03.2015;2015;03;09;Tiistai;3;1;4
95;31.03.2015;2015;03;10;Tiistai;2;1;3
95;31.03.2015;2015;03;11;Tiistai;3;2;5
95;31.03.2015;2015;03;12;Tiistai;3;1;4
95;31.03.2015;2015;03;13;Tiistai;2;2;4
95;31.03.2015;2015;03;14;Tiistai;4;2;6
95;31.03.2015;2015;03;15;Tiistai;7;8;15
95;31.03.2015;2015;03;16;Tiistai;5;6;11
95;31.03.2015;2015;03;17;Tiistai;5;4;9
95;31.03.2015;2015;03;18;Tiistai;4;10;14
95;31.03.2015;2015;03;19;Tiistai;7;2;9
95;31.03.2015;2015;03;20;Tiistai;0;4;4
95;31.03.2015;2015;03;21;Tiistai;2;2;4
95;31.03.2015;2015;03;22;Tiistai;1;1;2
95;31.03.2015;2015;03;23;Tiistai;0;0;0
95;01.04.2015;2015;04;00;Keskiviikko;0;0;0
95;01.04.2015;2015;04;01;Keskiviikko;0;0;0
95;01.04.2015;2015;04;02;Keskiviikko;0;0;0
95;01.04.2015;2015;04;03;Keskiviikko;0;0;0
95;01.04.2015;2015;04;04;Keskiviikko;1;0;1
95;01.04.2015;2015;04;05;Keskiviikko;2;3;5
95;01.04.2015;2015;04;06;Keskiviikko;3;3;6
95;01.04.2015;2015;04;07;Keskiviikko;2;4;6
95;01.04.2015;2015;04;08;Keskiviikko;7;3;10
95;01.04.2015;2015;04;09;Keskiviikko;2;3;5
95;01.04.2015;2015;04;10;Keskiviikko;6;5;11
95;01.04.2015;2015;04;11;Keskiviikko;4;4;8
95;01.04.2015;2015;04;12;Keskiviikko;9;4;13
95;01.04.2015;2015;04;13;Keskiviikko;3;5;8
95;01.04.2015;2015;04;14;Keskiviikko;12;3;15
95;01.04.2015;2015;04;15;Keskiviikko;7;3;10
95;01.04.2015;2015;04;16;Keskiviikko;8;12;20
95;01.04.2015;2015;04;17;Keskiviikko;2;4;6
95;01.04.2015;2015;04;18;Keskiviikko;4;11;15
95;01.04.2015;2015;04;19;Keskiviikko;1;5;6
95;01.04.2015;2015;04;20;Keskiviikko;5;5;10
95;01.04.2015;2015;04;21;Keskiviikko;0;1;1
95;01.04.2015;2015;04;22;Keskiviikko;1;1;2
95;01.04.2015;2015;04;23;Keskiviikko;0;0;0
95;02.04.2015;2015;04;00;Torstai;0;1;1
95;02.04.2015;2015;04;01;Torstai;0;1;1
95;02.04.2015;2015;04;02;Torstai;1;0;1
95;02.04.2015;2015;04;03;Torstai;0;0;0
95;02.04.2015;2015;04;04;Torstai;1;0;1
95;02.04.2015;2015;04;05;Torstai;2;2;4
95;02.04.2015;2015;04;06;Torstai;4;6;10
95;02.04.2015;2015;04;07;Torstai;4;5;9
95;02.04.2015;2015;04;08;Torstai;5;4;9
95;02.04.2015;2015;04;09;Torstai;3;2;5
95;02.04.2015;2015;04;10;Torstai;4;9;13
95;02.04.2015;2015;04;11;Torstai;5;6;11
95;02.04.2015;2015;04;12;Torstai;2;6;8
95;02.04.2015;2015;04;13;Torstai;5;3;8
95;02.04.2015;2015;04;14;Torstai;1;4;5
95;02.04.2015;2015;04;15;Torstai;9;6;15
95;02.04.2015;2015;04;16;Torstai;5;5;10
95;02.04.2015;2015;04;17;Torstai;3;3;6
95;02.04.2015;2015;04;18;Torstai;6;6;12
95;02.04.2015;2015;04;19;Torstai;12;10;22
95;02.04.2015;2015;04;20;Torstai;2;3;5
95;02.04.2015;2015;04;21;Torstai;2;0;2
95;02.04.2015;2015;04;22;Torstai;1;1;2
95;02.04.2015;2015;04;23;Torstai;0;0;0
95;03.04.2015;2015;04;00;Perjantai;0;0;0
95;03.04.2015;2015;04;01;Perjantai;0;0;0
95;03.04.2015;2015;04;02;Perjantai;0;0;0
95;03.04.2015;2015;04;03;Perjantai;1;0;1
95;03.04.2015;2015;04;04;Perjantai;0;1;1
95;03.04.2015;2015;04;05;Perjantai;0;0;0
95;03.04.2015;2015;04;06;Perjantai;1;0;1
95;03.04.2015;2015;04;07;Perjantai;0;1;1
95;03.04.2015;2015;04;08;Perjantai;2;1;3
95;03.04.2015;2015;04;09;Perjantai;0;7;7
95;03.04.2015;2015;04;10;Perjantai;1;3;4
95;03.04.2015;2015;04;11;Perjantai;2;1;3
95;03.04.2015;2015;04;12;Perjantai;8;5;13
95;03.04.2015;2015;04;13;Perjantai;8;5;13
95;03.04.2015;2015;04;14;Perjantai;5;9;14
95;03.04.2015;2015;04;15;Perjantai;3;6;9
95;03.04.2015;2015;04;16;Perjantai;6;4;10
95;03.04.2015;2015;04;17;Perjantai;5;5;10
95;03.04.2015;2015;04;18;Perjantai;4;7;11
95;03.04.2015;2015;04;19;Perjantai;4;3;7
95;03.04.2015;2015;04;20;Perjantai;1;3;4
95;03.04.2015;2015;04;21;Perjantai;3;2;5
95;03.04.2015;2015;04;22;Perjantai;4;5;9
95;03.04.2015;2015;04;23;Perjantai;0;0;0
95;04.04.2015;2015;04;00;Lauantai;0;0;0
95;04.04.2015;2015;04;01;Lauantai;0;0;0
95;04.04.2015;2015;04;02;Lauantai;0;0;0
95;04.04.2015;2015;04;03;Lauantai;0;0;0
95;04.04.2015;2015;04;04;Lauantai;0;1;1
95;04.04.2015;2015;04;05;Lauantai;1;0;1
95;04.04.2015;2015;04;06;Lauantai;1;1;2
95;04.04.2015;2015;04;07;Lauantai;3;0;3
95;04.04.2015;2015;04;08;Lauantai;2;2;4
95;04.04.2015;2015;04;09;Lauantai;6;1;7
95;04.04.2015;2015;04;10;Lauantai;4;4;8
95;04.04.2015;2015;04;11;Lauantai;1;4;5
95;04.04.2015;2015;04;12;Lauantai;9;4;13
95;04.04.2015;2015;04;13;Lauantai;11;9;20
95;04.04.2015;2015;04;14;Lauantai;5;8;13
95;04.04.2015;2015;04;15;Lauantai;11;13;24
95;04.04.2015;2015;04;16;Lauantai;11;8;19
95;04.04.2015;2015;04;17;Lauantai;3;8;11
95;04.04.2015;2015;04;18;Lauantai;3;6;9
95;04.04.2015;2015;04;19;Lauantai;3;4;7
95;04.04.2015;2015;04;20;Lauantai;1;4;5
95;04.04.2015;2015;04;21;Lauantai;3;6;9
95;04.04.2015;2015;04;22;Lauantai;2;1;3
95;04.04.2015;2015;04;23;Lauantai;0;0;0
95;05.04.2015;2015;04;00;Sunnuntai;0;0;0
95;05.04.2015;2015;04;01;Sunnuntai;1;0;1
95;05.04.2015;2015;04;02;Sunnuntai;0;0;0
95;05.04.2015;2015;04;03;Sunnuntai;0;0;0
95;05.04.2015;2015;04;04;Sunnuntai;0;0;0
95;05.04.2015;2015;04;05;Sunnuntai;3;0;3
95;05.04.2015;2015;04;06;Sunnuntai;1;0;1
95;05.04.2015;2015;04;07;Sunnuntai;0;0;0
95;05.04.2015;2015;04;08;Sunnuntai;1;7;8
95;05.04.2015;2015;04;09;Sunnuntai;7;1;8
95;05.04.2015;2015;04;10;Sunnuntai;6;8;14
95;05.04.2015;2015;04;11;Sunnuntai;17;9;26
95;05.04.2015;2015;04;12;Sunnuntai;29;8;37
95;05.04.2015;2015;04;13;Sunnuntai;15;18;33
95;05.04.2015;2015;04;14;Sunnuntai;12;18;30
95;05.04.2015;2015;04;15;Sunnuntai;14;18;32
95;05.04.2015;2015;04;16;Sunnuntai;12;4;16
95;05.04.2015;2015;04;17;Sunnuntai;22;10;32
95;05.04.2015;2015;04;18;Sunnuntai;10;11;21
95;05.04.2015;2015;04;19;Sunnuntai;13;12;25
95;05.04.2015;2015;04;20;Sunnuntai;3;1;4
95;05.04.2015;2015;04;21;Sunnuntai;2;3;5
95;05.04.2015;2015;04;22;Sunnuntai;1;1;2
95;05.04.2015;2015;04;23;Sunnuntai;1;1;2
95;06.04.2015;2015;04;00;Maanantai;0;0;0
95;06.04.2015;2015;04;01;Maanantai;0;0;0
95;06.04.2015;2015;04;02;Maanantai;0;0;0
95;06.04.2015;2015;04;03;Maanantai;0;0;0
95;06.04.2015;2015;04;04;Maanantai;1;0;1
95;06.04.2015;2015;04;05;Maanantai;2;1;3
95;06.04.2015;2015;04;06;Maanantai;1;0;1
95;06.04.2015;2015;04;07;Maanantai;1;2;3
95;06.04.2015;2015;04;08;Maanantai;5;1;6
95;06.04.2015;2015;04;09;Maanantai;2;4;6
95;06.04.2015;2015;04;10;Maanantai;9;3;12
95;06.04.2015;2015;04;11;Maanantai;5;5;10
95;06.04.2015;2015;04;12;Maanantai;5;9;14
95;06.04.2015;2015;04;13;Maanantai;3;4;7
95;06.04.2015;2015;04;14;Maanantai;5;7;12
95;06.04.2015;2015;04;15;Maanantai;5;1;6
95;06.04.2015;2015;04;16;Maanantai;0;2;2
95;06.04.2015;2015;04;17;Maanantai;4;7;11
95;06.04.2015;2015;04;18;Maanantai;2;12;14
95;06.04.2015;2015;04;19;Maanantai;9;2;11
95;06.04.2015;2015;04;20;Maanantai;4;2;6
95;06.04.2015;2015;04;21;Maanantai;0;3;3
95;06.04.2015;2015;04;22;Maanantai;3;2;5
95;06.04.2015;2015;04;23;Maanantai;1;0;1
95;07.04.2015;2015;04;00;Tiistai;0;0;0
95;07.04.2015;2015;04;01;Tiistai;0;0;0
95;07.04.2015;2015;04;02;Tiistai;0;0;0
95;07.04.2015;2015;04;03;Tiistai;0;0;0
95;07.04.2015;2015;04;04;Tiistai;1;0;1
95;07.04.2015;2015;04;05;Tiistai;1;5;6
95;07.04.2015;2015;04;06;Tiistai;9;5;14
95;07.04.2015;2015;04;07;Tiistai;8;16;24
95;07.04.2015;2015;04;08;Tiistai;8;5;13
95;07.04.2015;2015;04;09;Tiistai;3;6;9
95;07.04.2015;2015;04;10;Tiistai;4;5;9
95;07.04.2015;2015;04;11;Tiistai;5;5;10
95;07.04.2015;2015;04;12;Tiistai;16;4;20
95;07.04.2015;2015;04;13;Tiistai;8;11;19
95;07.04.2015;2015;04;14;Tiistai;15;10;25
95;07.04.2015;2015;04;15;Tiistai;10;9;19
95;07.04.2015;2015;04;16;Tiistai;19;17;36
95;07.04.2015;2015;04;17;Tiistai;13;12;25
95;07.04.2015;2015;04;18;Tiistai;7;13;20
95;07.04.2015;2015;04;19;Tiistai;12;18;30
95;07.04.2015;2015;04;20;Tiistai;5;4;9
95;07.04.2015;2015;04;21;Tiistai;3;5;8
95;07.04.2015;2015;04;22;Tiistai;1;2;3
95;07.04.2015;2015;04;23;Tiistai;1;0;1
95;08.04.2015;2015;04;00;Keskiviikko;0;0;0
95;08.04.2015;2015;04;01;Keskiviikko;0;0;0
95;08.04.2015;2015;04;02;Keskiviikko;0;0;0
95;08.04.2015;2015;04;03;Keskiviikko;0;0;0
95;08.04.2015;2015;04;04;Keskiviikko;0;0;0
95;08.04.2015;2015;04;05;Keskiviikko;0;2;2
95;08.04.2015;2015;04;06;Keskiviikko;6;4;10
95;08.04.2015;2015;04;07;Keskiviikko;8;8;16
95;08.04.2015;2015;04;08;Keskiviikko;6;7;13
95;08.04.2015;2015;04;09;Keskiviikko;2;2;4
95;08.04.2015;2015;04;10;Keskiviikko;4;2;6
95;08.04.2015;2015;04;11;Keskiviikko;5;4;9
95;08.04.2015;2015;04;12;Keskiviikko;6;7;13
95;08.04.2015;2015;04;13;Keskiviikko;5;5;10
95;08.04.2015;2015;04;14;Keskiviikko;6;0;6
95;08.04.2015;2015;04;15;Keskiviikko;10;11;21
95;08.04.2015;2015;04;16;Keskiviikko;3;10;13
95;08.04.2015;2015;04;17;Keskiviikko;2;2;4
95;08.04.2015;2015;04;18;Keskiviikko;1;9;10
95;08.04.2015;2015;04;19;Keskiviikko;4;3;7
95;08.04.2015;2015;04;20;Keskiviikko;1;5;6
95;08.04.2015;2015;04;21;Keskiviikko;2;2;4
95;08.04.2015;2015;04;22;Keskiviikko;2;2;4
95;08.04.2015;2015;04;23;Keskiviikko;0;1;1
95;09.04.2015;2015;04;00;Torstai;0;0;0
95;09.04.2015;2015;04;01;Torstai;1;0;1
95;09.04.2015;2015;04;02;Torstai;0;0;0
95;09.04.2015;2015;04;03;Torstai;0;0;0
95;09.04.2015;2015;04;04;Torstai;0;0;0
95;09.04.2015;2015;04;05;Torstai;1;2;3
95;09.04.2015;2015;04;06;Torstai;9;3;12
95;09.04.2015;2015;04;07;Torstai;10;12;22
95;09.04.2015;2015;04;08;Torstai;4;7;11
95;09.04.2015;2015;04;09;Torstai;6;3;9
95;09.04.2015;2015;04;10;Torstai;6;3;9
95;09.04.2015;2015;04;11;Torstai;5;6;11
95;09.04.2015;2015;04;12;Torstai;3;4;7
95;09.04.2015;2015;04;13;Torstai;5;6;11
95;09.04.2015;2015;04;14;Torstai;11;5;16
95;09.04.2015;2015;04;15;Torstai;7;9;16
95;09.04.2015;2015;04;16;Torstai;5;14;19
95;09.04.2015;2015;04;17;Torstai;7;6;13
95;09.04.2015;2015;04;18;Torstai;5;14;19
95;09.04.2015;2015;04;19;Torstai;4;2;6
95;09.04.2015;2015;04;20;Torstai;10;1;11
95;09.04.2015;2015;04;21;Torstai;3;3;6
95;09.04.2015;2015;04;22;Torstai;3;2;5
95;09.04.2015;2015;04;23;Torstai;0;0;0
95;10.04.2015;2015;04;00;Perjantai;0;0;0
95;10.04.2015;2015;04;01;Perjantai;1;0;1
95;10.04.2015;2015;04;02;Perjantai;0;0;0
95;10.04.2015;2015;04;03;Perjantai;0;0;0
95;10.04.2015;2015;04;04;Perjantai;0;0;0
95;10.04.2015;2015;04;05;Perjantai;2;2;4
95;10.04.2015;2015;04;06;Perjantai;10;2;12
95;10.04.2015;2015;04;07;Perjantai;6;16;22
95;10.04.2015;2015;04;08;Perjantai;5;3;8
95;10.04.2015;2015;04;09;Perjantai;5;10;15
95;10.04.2015;2015;04;10;Perjantai;6;4;10
95;10.04.2015;2015;04;11;Perjantai;7;5;12
95;10.04.2015;2015;04;12;Perjantai;5;5;10
95;10.04.2015;2015;04;13;Perjantai;8;3;11
95;10.04.2015;2015;04;14;Perjantai;6;0;6
95;10.04.2015;2015;04;15;Perjantai;5;6;11
95;10.04.2015;2015;04;16;Perjantai;5;6;11
95;10.04.2015;2015;04;17;Perjantai;3;9;12
95;10.04.2015;2015;04;18;Perjantai;6;5;11
95;10.04.2015;2015;04;19;Perjantai;6;3;9
95;10.04.2015;2015;04;20;Perjantai;4;6;10
95;10.04.2015;2015;04;21;Perjantai;4;4;8
95;10.04.2015;2015;04;22;Perjantai;2;3;5
95;10.04.2015;2015;04;23;Perjantai;0;0;0
95;11.04.2015;2015;04;00;Lauantai;2;1;3
95;11.04.2015;2015;04;01;Lauantai;0;0;0
95;11.04.2015;2015;04;02;Lauantai;0;1;1
95;11.04.2015;2015;04;03;Lauantai;0;0;0
95;11.04.2015;2015;04;04;Lauantai;0;2;2
95;11.04.2015;2015;04;05;Lauantai;0;1;1
95;11.04.2015;2015;04;06;Lauantai;1;2;3
95;11.04.2015;2015;04;07;Lauantai;4;2;6
95;11.04.2015;2015;04;08;Lauantai;6;2;8
95;11.04.2015;2015;04;09;Lauantai;7;7;14
95;11.04.2015;2015;04;10;Lauantai;11;10;21
95;11.04.2015;2015;04;11;Lauantai;9;14;23
95;11.04.2015;2015;04;12;Lauantai;19;15;34
95;11.04.2015;2015;04;13;Lauantai;24;5;29
95;11.04.2015;2015;04;14;Lauantai;11;19;30
95;11.04.2015;2015;04;15;Lauantai;10;19;29
95;11.04.2015;2015;04;16;Lauantai;17;23;40
95;11.04.2015;2015;04;17;Lauantai;18;17;35
95;11.04.2015;2015;04;18;Lauantai;7;10;17
95;11.04.2015;2015;04;19;Lauantai;7;2;9
95;11.04.2015;2015;04;20;Lauantai;4;10;14
95;11.04.2015;2015;04;21;Lauantai;2;1;3
95;11.04.2015;2015;04;22;Lauantai;1;7;8
95;11.04.2015;2015;04;23;Lauantai;3;2;5
95;12.04.2015;2015;04;00;Sunnuntai;0;0;0
95;12.04.2015;2015;04;01;Sunnuntai;0;0;0
95;12.04.2015;2015;04;02;Sunnuntai;0;0;0
95;12.04.2015;2015;04;03;Sunnuntai;0;0;0
95;12.04.2015;2015;04;04;Sunnuntai;0;0;0
95;12.04.2015;2015;04;05;Sunnuntai;1;1;2
95;12.04.2015;2015;04;06;Sunnuntai;0;2;2
95;12.04.2015;2015;04;07;Sunnuntai;2;0;2
95;12.04.2015;2015;04;08;Sunnuntai;5;4;9
95;12.04.2015;2015;04;09;Sunnuntai;8;8;16
95;12.04.2015;2015;04;10;Sunnuntai;12;15;27
95;12.04.2015;2015;04;11;Sunnuntai;26;19;45
95;12.04.2015;2015;04;12;Sunnuntai;24;18;42
95;12.04.2015;2015;04;13;Sunnuntai;23;22;45
95;12.04.2015;2015;04;14;Sunnuntai;26;21;47
95;12.04.2015;2015;04;15;Sunnuntai;16;17;33
95;12.04.2015;2015;04;16;Sunnuntai;20;13;33
95;12.04.2015;2015;04;17;Sunnuntai;15;13;28
95;12.04.2015;2015;04;18;Sunnuntai;16;21;37
95;12.04.2015;2015;04;19;Sunnuntai;9;20;29
95;12.04.2015;2015;04;20;Sunnuntai;6;4;10
95;12.04.2015;2015;04;21;Sunnuntai;1;3;4
95;12.04.2015;2015;04;22;Sunnuntai;2;2;4
95;12.04.2015;2015;04;23;Sunnuntai;1;0;1
95;13.04.2015;2015;04;00;Maanantai;0;0;0
95;13.04.2015;2015;04;01;Maanantai;0;0;0
95;13.04.2015;2015;04;02;Maanantai;0;0;0
95;13.04.2015;2015;04;03;Maanantai;0;0;0
95;13.04.2015;2015;04;04;Maanantai;1;0;1
95;13.04.2015;2015;04;05;Maanantai;3;3;6
95;13.04.2015;2015;04;06;Maanantai;13;5;18
95;13.04.2015;2015;04;07;Maanantai;14;9;23
95;13.04.2015;2015;04;08;Maanantai;8;7;15
95;13.04.2015;2015;04;09;Maanantai;4;4;8
95;13.04.2015;2015;04;10;Maanantai;5;4;9
95;13.04.2015;2015;04;11;Maanantai;7;3;10
95;13.04.2015;2015;04;12;Maanantai;6;10;16
95;13.04.2015;2015;04;13;Maanantai;5;7;12
95;13.04.2015;2015;04;14;Maanantai;11;4;15
95;13.04.2015;2015;04;15;Maanantai;8;15;23
95;13.04.2015;2015;04;16;Maanantai;12;14;26
95;13.04.2015;2015;04;17;Maanantai;9;10;19
95;13.04.2015;2015;04;18;Maanantai;11;10;21
95;13.04.2015;2015;04;19;Maanantai;4;2;6
95;13.04.2015;2015;04;20;Maanantai;3;3;6
95;13.04.2015;2015;04;21;Maanantai;3;5;8
95;13.04.2015;2015;04;22;Maanantai;1;1;2
95;13.04.2015;2015;04;23;Maanantai;1;1;2
95;14.04.2015;2015;04;00;Tiistai;0;0;0
95;14.04.2015;2015;04;01;Tiistai;0;0;0
95;14.04.2015;2015;04;02;Tiistai;0;0;0
95;14.04.2015;2015;04;03;Tiistai;0;0;0
95;14.04.2015;2015;04;04;Tiistai;0;1;1
95;14.04.2015;2015;04;05;Tiistai;2;5;7
95;14.04.2015;2015;04;06;Tiistai;11;12;23
95;14.04.2015;2015;04;07;Tiistai;12;19;31
95;14.04.2015;2015;04;08;Tiistai;12;4;16
95;14.04.2015;2015;04;09;Tiistai;6;6;12
95;14.04.2015;2015;04;10;Tiistai;9;6;15
95;14.04.2015;2015;04;11;Tiistai;11;2;13
95;14.04.2015;2015;04;12;Tiistai;10;8;18
95;14.04.2015;2015;04;13;Tiistai;7;5;12
95;14.04.2015;2015;04;14;Tiistai;10;4;14
95;14.04.2015;2015;04;15;Tiistai;12;13;25
95;14.04.2015;2015;04;16;Tiistai;19;22;41
95;14.04.2015;2015;04;17;Tiistai;5;14;19
95;14.04.2015;2015;04;18;Tiistai;11;16;27
95;14.04.2015;2015;04;19;Tiistai;8;10;18
95;14.04.2015;2015;04;20;Tiistai;4;11;15
95;14.04.2015;2015;04;21;Tiistai;2;5;7
95;14.04.2015;2015;04;22;Tiistai;4;2;6
95;14.04.2015;2015;04;23;Tiistai;0;1;1
95;15.04.2015;2015;04;00;Keskiviikko;0;0;0
95;15.04.2015;2015;04;01;Keskiviikko;0;0;0
95;15.04.2015;2015;04;02;Keskiviikko;1;0;1
95;15.04.2015;2015;04;03;Keskiviikko;0;1;1
95;15.04.2015;2015;04;04;Keskiviikko;1;1;2
95;15.04.2015;2015;04;05;Keskiviikko;3;3;6
95;15.04.2015;2015;04;06;Keskiviikko;11;9;20
95;15.04.2015;2015;04;07;Keskiviikko;11;14;25
95;15.04.2015;2015;04;08;Keskiviikko;6;10;16
95;15.04.2015;2015;04;09;Keskiviikko;4;2;6
95;15.04.2015;2015;04;10;Keskiviikko;6;7;13
95;15.04.2015;2015;04;11;Keskiviikko;5;2;7
95;15.04.2015;2015;04;12;Keskiviikko;6;3;9
95;15.04.2015;2015;04;13;Keskiviikko;5;6;11
95;15.04.2015;2015;04;14;Keskiviikko;4;5;9
95;15.04.2015;2015;04;15;Keskiviikko;12;17;29
95;15.04.2015;2015;04;16;Keskiviikko;15;12;27
95;15.04.2015;2015;04;17;Keskiviikko;10;3;13
95;15.04.2015;2015;04;18;Keskiviikko;4;11;15
95;15.04.2015;2015;04;19;Keskiviikko;1;1;2
95;15.04.2015;2015;04;20;Keskiviikko;5;0;5
95;15.04.2015;2015;04;21;Keskiviikko;1;3;4
95;15.04.2015;2015;04;22;Keskiviikko;2;2;4
95;15.04.2015;2015;04;23;Keskiviikko;0;1;1
95;16.04.2015;2015;04;00;Torstai;0;0;0
95;16.04.2015;2015;04;01;Torstai;0;0;0
95;16.04.2015;2015;04;02;Torstai;0;0;0
95;16.04.2015;2015;04;03;Torstai;0;0;0
95;16.04.2015;2015;04;04;Torstai;1;1;2
95;16.04.2015;2015;04;05;Torstai;5;2;7
95;16.04.2015;2015;04;06;Torstai;9;7;16
95;16.04.2015;2015;04;07;Torstai;11;10;21
95;16.04.2015;2015;04;08;Torstai;10;9;19
95;16.04.2015;2015;04;09;Torstai;2;6;8
95;16.04.2015;2015;04;10;Torstai;7;2;9
95;16.04.2015;2015;04;11;Torstai;4;4;8
95;16.04.2015;2015;04;12;Torstai;5;4;9
95;16.04.2015;2015;04;13;Torstai;4;6;10
95;16.04.2015;2015;04;14;Torstai;10;11;21
95;16.04.2015;2015;04;15;Torstai;16;16;32
95;16.04.2015;2015;04;16;Torstai;12;17;29
95;16.04.2015;2015;04;17;Torstai;8;11;19
95;16.04.2015;2015;04;18;Torstai;6;9;15
95;16.04.2015;2015;04;19;Torstai;5;8;13
95;16.04.2015;2015;04;20;Torstai;4;2;6
95;16.04.2015;2015;04;21;Torstai;3;3;6
95;16.04.2015;2015;04;22;Torstai;2;1;3
95;16.04.2015;2015;04;23;Torstai;0;0;0
95;17.04.2015;2015;04;00;Perjantai;0;1;1
95;17.04.2015;2015;04;01;Perjantai;0;0;0
95;17.04.2015;2015;04;02;Perjantai;0;0;0
95;17.04.2015;2015;04;03;Perjantai;0;0;0
95;17.04.2015;2015;04;04;Perjantai;1;1;2
95;17.04.2015;2015;04;05;Perjantai;5;3;8
95;17.04.2015;2015;04;06;Perjantai;8;6;14
95;17.04.2015;2015;04;07;Perjantai;8;9;17
95;17.04.2015;2015;04;08;Perjantai;9;11;20
95;17.04.2015;2015;04;09;Perjantai;5;10;15
95;17.04.2015;2015;04;10;Perjantai;2;6;8
95;17.04.2015;2015;04;11;Perjantai;7;5;12
95;17.04.2015;2015;04;12;Perjantai;11;7;18
95;17.04.2015;2015;04;13;Perjantai;19;16;35
95;17.04.2015;2015;04;14;Perjantai;17;13;30
95;17.04.2015;2015;04;15;Perjantai;12;20;32
95;17.04.2015;2015;04;16;Perjantai;14;18;32
95;17.04.2015;2015;04;17;Perjantai;16;19;35
95;17.04.2015;2015;04;18;Perjantai;7;18;25
95;17.04.2015;2015;04;19;Perjantai;8;6;14
95;17.04.2015;2015;04;20;Perjantai;3;1;4
95;17.04.2015;2015;04;21;Perjantai;5;2;7
95;17.04.2015;2015;04;22;Perjantai;3;1;4
95;17.04.2015;2015;04;23;Perjantai;1;0;1
95;18.04.2015;2015;04;00;Lauantai;0;0;0
95;18.04.2015;2015;04;01;Lauantai;0;0;0
95;18.04.2015;2015;04;02;Lauantai;0;2;2
95;18.04.2015;2015;04;03;Lauantai;0;1;1
95;18.04.2015;2015;04;04;Lauantai;0;0;0
95;18.04.2015;2015;04;05;Lauantai;1;0;1
95;18.04.2015;2015;04;06;Lauantai;0;1;1
95;18.04.2015;2015;04;07;Lauantai;0;3;3
95;18.04.2015;2015;04;08;Lauantai;4;9;13
95;18.04.2015;2015;04;09;Lauantai;6;6;12
95;18.04.2015;2015;04;10;Lauantai;11;10;21
95;18.04.2015;2015;04;11;Lauantai;13;7;20
95;18.04.2015;2015;04;12;Lauantai;13;13;26
95;18.04.2015;2015;04;13;Lauantai;10;10;20
95;18.04.2015;2015;04;14;Lauantai;14;16;30
95;18.04.2015;2015;04;15;Lauantai;18;19;37
95;18.04.2015;2015;04;16;Lauantai;7;5;12
95;18.04.2015;2015;04;17;Lauantai;9;8;17
95;18.04.2015;2015;04;18;Lauantai;8;5;13
95;18.04.2015;2015;04;19;Lauantai;5;6;11
95;18.04.2015;2015;04;20;Lauantai;5;8;13
95;18.04.2015;2015;04;21;Lauantai;0;2;2
95;18.04.2015;2015;04;22;Lauantai;4;2;6
95;18.04.2015;2015;04;23;Lauantai;0;0;0
95;19.04.2015;2015;04;00;Sunnuntai;1;1;2
95;19.04.2015;2015;04;01;Sunnuntai;1;0;1
95;19.04.2015;2015;04;02;Sunnuntai;0;0;0
95;19.04.2015;2015;04;03;Sunnuntai;0;1;1
95;19.04.2015;2015;04;04;Sunnuntai;0;1;1
95;19.04.2015;2015;04;05;Sunnuntai;0;1;1
95;19.04.2015;2015;04;06;Sunnuntai;3;0;3
95;19.04.2015;2015;04;07;Sunnuntai;0;1;1
95;19.04.2015;2015;04;08;Sunnuntai;2;2;4
95;19.04.2015;2015;04;09;Sunnuntai;3;10;13
95;19.04.2015;2015;04;10;Sunnuntai;7;13;20
95;19.04.2015;2015;04;11;Sunnuntai;8;7;15
95;19.04.2015;2015;04;12;Sunnuntai;20;11;31
95;19.04.2015;2015;04;13;Sunnuntai;14;15;29
95;19.04.2015;2015;04;14;Sunnuntai;15;15;30
95;19.04.2015;2015;04;15;Sunnuntai;6;10;16
95;19.04.2015;2015;04;16;Sunnuntai;6;7;13
95;19.04.2015;2015;04;17;Sunnuntai;5;10;15
95;19.04.2015;2015;04;18;Sunnuntai;6;14;20
95;19.04.2015;2015;04;19;Sunnuntai;12;3;15
95;19.04.2015;2015;04;20;Sunnuntai;4;7;11
95;19.04.2015;2015;04;21;Sunnuntai;4;6;10
95;19.04.2015;2015;04;22;Sunnuntai;0;1;1
95;19.04.2015;2015;04;23;Sunnuntai;1;0;1
95;20.04.2015;2015;04;00;Maanantai;0;0;0
95;20.04.2015;2015;04;01;Maanantai;0;0;0
95;20.04.2015;2015;04;02;Maanantai;0;0;0
95;20.04.2015;2015;04;03;Maanantai;0;0;0
95;20.04.2015;2015;04;04;Maanantai;0;1;1
95;20.04.2015;2015;04;05;Maanantai;4;3;7
95;20.04.2015;2015;04;06;Maanantai;15;9;24
95;20.04.2015;2015;04;07;Maanantai;16;18;34
95;20.04.2015;2015;04;08;Maanantai;13;7;20
95;20.04.2015;2015;04;09;Maanantai;7;2;9
95;20.04.2015;2015;04;10;Maanantai;2;11;13
95;20.04.2015;2015;04;11;Maanantai;9;11;20
95;20.04.2015;2015;04;12;Maanantai;11;8;19
95;20.04.2015;2015;04;13;Maanantai;5;8;13
95;20.04.2015;2015;04;14;Maanantai;13;11;24
95;20.04.2015;2015;04;15;Maanantai;22;15;37
95;20.04.2015;2015;04;16;Maanantai;23;32;55
95;20.04.2015;2015;04;17;Maanantai;11;20;31
95;20.04.2015;2015;04;18;Maanantai;13;13;26
95;20.04.2015;2015;04;19;Maanantai;6;11;17
95;20.04.2015;2015;04;20;Maanantai;8;7;15
95;20.04.2015;2015;04;21;Maanantai;4;6;10
95;20.04.2015;2015;04;22;Maanantai;2;2;4
95;20.04.2015;2015;04;23;Maanantai;0;1;1
95;21.04.2015;2015;04;00;Tiistai;0;0;0
95;21.04.2015;2015;04;01;Tiistai;0;0;0
95;21.04.2015;2015;04;02;Tiistai;0;0;0
95;21.04.2015;2015;04;03;Tiistai;0;0;0
95;21.04.2015;2015;04;04;Tiistai;0;1;1
95;21.04.2015;2015;04;05;Tiistai;7;3;10
95;21.04.2015;2015;04;06;Tiistai;16;9;25
95;21.04.2015;2015;04;07;Tiistai;18;24;42
95;21.04.2015;2015;04;08;Tiistai;7;9;16
95;21.04.2015;2015;04;09;Tiistai;10;10;20
95;21.04.2015;2015;04;10;Tiistai;12;4;16
95;21.04.2015;2015;04;11;Tiistai;13;4;17
95;21.04.2015;2015;04;12;Tiistai;9;10;19
95;21.04.2015;2015;04;13;Tiistai;12;12;24
95;21.04.2015;2015;04;14;Tiistai;16;16;32
95;21.04.2015;2015;04;15;Tiistai;18;24;42
95;21.04.2015;2015;04;16;Tiistai;27;36;63
95;21.04.2015;2015;04;17;Tiistai;14;16;30
95;21.04.2015;2015;04;18;Tiistai;5;24;29
95;21.04.2015;2015;04;19;Tiistai;30;12;42
95;21.04.2015;2015;04;20;Tiistai;11;7;18
95;21.04.2015;2015;04;21;Tiistai;4;8;12
95;21.04.2015;2015;04;22;Tiistai;6;2;8
95;21.04.2015;2015;04;23;Tiistai;0;1;1
95;22.04.2015;2015;04;00;Keskiviikko;0;0;0
95;22.04.2015;2015;04;01;Keskiviikko;0;0;0
95;22.04.2015;2015;04;02;Keskiviikko;0;0;0
95;22.04.2015;2015;04;03;Keskiviikko;1;0;1
95;22.04.2015;2015;04;04;Keskiviikko;0;0;0
95;22.04.2015;2015;04;05;Keskiviikko;5;3;8
95;22.04.2015;2015;04;06;Keskiviikko;16;9;25
95;22.04.2015;2015;04;07;Keskiviikko;17;22;39
95;22.04.2015;2015;04;08;Keskiviikko;7;9;16
95;22.04.2015;2015;04;09;Keskiviikko;7;9;16
95;22.04.2015;2015;04;10;Keskiviikko;8;4;12
95;22.04.2015;2015;04;11;Keskiviikko;11;5;16
95;22.04.2015;2015;04;12;Keskiviikko;4;6;10
95;22.04.2015;2015;04;13;Keskiviikko;12;1;13
95;22.04.2015;2015;04;14;Keskiviikko;13;6;19
95;22.04.2015;2015;04;15;Keskiviikko;21;19;40
95;22.04.2015;2015;04;16;Keskiviikko;20;20;40
95;22.04.2015;2015;04;17;Keskiviikko;12;22;34
95;22.04.2015;2015;04;18;Keskiviikko;8;11;19
95;22.04.2015;2015;04;19;Keskiviikko;6;13;19
95;22.04.2015;2015;04;20;Keskiviikko;5;6;11
95;22.04.2015;2015;04;21;Keskiviikko;5;10;15
95;22.04.2015;2015;04;22;Keskiviikko;3;1;4
95;22.04.2015;2015;04;23;Keskiviikko;1;1;2
95;23.04.2015;2015;04;00;Torstai;0;0;0
95;23.04.2015;2015;04;01;Torstai;1;0;1
95;23.04.2015;2015;04;02;Torstai;0;0;0
95;23.04.2015;2015;04;03;Torstai;1;1;2
95;23.04.2015;2015;04;04;Torstai;1;0;1
95;23.04.2015;2015;04;05;Torstai;4;2;6
95;23.04.2015;2015;04;06;Torstai;12;7;19
95;23.04.2015;2015;04;07;Torstai;16;16;32
95;23.04.2015;2015;04;08;Torstai;9;7;16
95;23.04.2015;2015;04;09;Torstai;4;4;8
95;23.04.2015;2015;04;10;Torstai;6;2;8
95;23.04.2015;2015;04;11;Torstai;6;5;11
95;23.04.2015;2015;04;12;Torstai;8;13;21
95;23.04.2015;2015;04;13;Torstai;8;8;16
95;23.04.2015;2015;04;14;Torstai;8;6;14
95;23.04.2015;2015;04;15;Torstai;13;19;32
95;23.04.2015;2015;04;16;Torstai;14;21;35
95;23.04.2015;2015;04;17;Torstai;4;16;20
95;23.04.2015;2015;04;18;Torstai;17;15;32
95;23.04.2015;2015;04;19;Torstai;6;10;16
95;23.04.2015;2015;04;20;Torstai;8;5;13
95;23.04.2015;2015;04;21;Torstai;8;4;12
95;23.04.2015;2015;04;22;Torstai;3;0;3
95;23.04.2015;2015;04;23;Torstai;0;1;1
95;24.04.2015;2015;04;00;Perjantai;0;1;1
95;24.04.2015;2015;04;01;Perjantai;0;0;0
95;24.04.2015;2015;04;02;Perjantai;0;0;0
95;24.04.2015;2015;04;03;Perjantai;0;0;0
95;24.04.2015;2015;04;04;Perjantai;0;0;0
95;24.04.2015;2015;04;05;Perjantai;5;1;6
95;24.04.2015;2015;04;06;Perjantai;9;8;17
95;24.04.2015;2015;04;07;Perjantai;14;20;34
95;24.04.2015;2015;04;08;Perjantai;7;11;18
95;24.04.2015;2015;04;09;Perjantai;2;6;8
95;24.04.2015;2015;04;10;Perjantai;7;5;12
95;24.04.2015;2015;04;11;Perjantai;8;10;18
95;24.04.2015;2015;04;12;Perjantai;9;8;17
95;24.04.2015;2015;04;13;Perjantai;16;6;22
95;24.04.2015;2015;04;14;Perjantai;15;11;26
95;24.04.2015;2015;04;15;Perjantai;15;21;36
95;24.04.2015;2015;04;16;Perjantai;15;18;33
95;24.04.2015;2015;04;17;Perjantai;10;9;19
95;24.04.2015;2015;04;18;Perjantai;7;10;17
95;24.04.2015;2015;04;19;Perjantai;9;7;16
95;24.04.2015;2015;04;20;Perjantai;4;6;10
95;24.04.2015;2015;04;21;Perjantai;8;5;13
95;24.04.2015;2015;04;22;Perjantai;1;3;4
95;24.04.2015;2015;04;23;Perjantai;0;1;1
95;25.04.2015;2015;04;00;Lauantai;2;1;3
95;25.04.2015;2015;04;01;Lauantai;3;0;3
95;25.04.2015;2015;04;02;Lauantai;0;0;0
95;25.04.2015;2015;04;03;Lauantai;0;1;1
95;25.04.2015;2015;04;04;Lauantai;1;0;1
95;25.04.2015;2015;04;05;Lauantai;2;1;3
95;25.04.2015;2015;04;06;Lauantai;2;0;2
95;25.04.2015;2015;04;07;Lauantai;4;3;7
95;25.04.2015;2015;04;08;Lauantai;4;8;12
95;25.04.2015;2015;04;09;Lauantai;7;6;13
95;25.04.2015;2015;04;10;Lauantai;5;6;11
95;25.04.2015;2015;04;11;Lauantai;12;13;25
95;25.04.2015;2015;04;12;Lauantai;9;11;20
95;25.04.2015;2015;04;13;Lauantai;9;15;24
95;25.04.2015;2015;04;14;Lauantai;5;9;14
95;25.04.2015;2015;04;15;Lauantai;9;10;19
95;25.04.2015;2015;04;16;Lauantai;6;4;10
95;25.04.2015;2015;04;17;Lauantai;5;6;11
95;25.04.2015;2015;04;18;Lauantai;6;7;13
95;25.04.2015;2015;04;19;Lauantai;6;7;13
95;25.04.2015;2015;04;20;Lauantai;4;3;7
95;25.04.2015;2015;04;21;Lauantai;2;3;5
95;25.04.2015;2015;04;22;Lauantai;8;3;11
95;25.04.2015;2015;04;23;Lauantai;1;2;3
95;26.04.2015;2015;04;00;Sunnuntai;0;2;2
95;26.04.2015;2015;04;01;Sunnuntai;1;0;1
95;26.04.2015;2015;04;02;Sunnuntai;0;2;2
95;26.04.2015;2015;04;03;Sunnuntai;0;1;1
95;26.04.2015;2015;04;04;Sunnuntai;3;0;3
95;26.04.2015;2015;04;05;Sunnuntai;0;0;0
95;26.04.2015;2015;04;06;Sunnuntai;1;0;1
95;26.04.2015;2015;04;07;Sunnuntai;0;0;0
95;26.04.2015;2015;04;08;Sunnuntai;5;2;7
95;26.04.2015;2015;04;09;Sunnuntai;9;15;24
95;26.04.2015;2015;04;10;Sunnuntai;14;2;16
95;26.04.2015;2015;04;11;Sunnuntai;17;9;26
95;26.04.2015;2015;04;12;Sunnuntai;17;16;33
95;26.04.2015;2015;04;13;Sunnuntai;16;26;42
95;26.04.2015;2015;04;14;Sunnuntai;14;24;38
95;26.04.2015;2015;04;15;Sunnuntai;20;17;37
95;26.04.2015;2015;04;16;Sunnuntai;13;10;23
95;26.04.2015;2015;04;17;Sunnuntai;9;9;18
95;26.04.2015;2015;04;18;Sunnuntai;9;6;15
95;26.04.2015;2015;04;19;Sunnuntai;17;6;23
95;26.04.2015;2015;04;20;Sunnuntai;4;5;9
95;26.04.2015;2015;04;21;Sunnuntai;4;2;6
95;26.04.2015;2015;04;22;Sunnuntai;1;1;2
95;26.04.2015;2015;04;23;Sunnuntai;1;1;2
95;27.04.2015;2015;04;00;Maanantai;1;0;1
95;27.04.2015;2015;04;01;Maanantai;0;0;0
95;27.04.2015;2015;04;02;Maanantai;0;0;0
95;27.04.2015;2015;04;03;Maanantai;0;1;1
95;27.04.2015;2015;04;04;Maanantai;2;0;2
95;27.04.2015;2015;04;05;Maanantai;6;3;9
95;27.04.2015;2015;04;06;Maanantai;11;3;14
95;27.04.2015;2015;04;07;Maanantai;8;11;19
95;27.04.2015;2015;04;08;Maanantai;6;8;14
95;27.04.2015;2015;04;09;Maanantai;4;3;7
95;27.04.2015;2015;04;10;Maanantai;4;2;6
95;27.04.2015;2015;04;11;Maanantai;5;3;8
95;27.04.2015;2015;04;12;Maanantai;8;8;16
95;27.04.2015;2015;04;13;Maanantai;5;5;10
95;27.04.2015;2015;04;14;Maanantai;6;8;14
95;27.04.2015;2015;04;15;Maanantai;15;18;33
95;27.04.2015;2015;04;16;Maanantai;12;11;23
95;27.04.2015;2015;04;17;Maanantai;9;16;25
95;27.04.2015;2015;04;18;Maanantai;11;7;18
95;27.04.2015;2015;04;19;Maanantai;5;14;19
95;27.04.2015;2015;04;20;Maanantai;10;8;18
95;27.04.2015;2015;04;21;Maanantai;3;5;8
95;27.04.2015;2015;04;22;Maanantai;3;7;10
95;27.04.2015;2015;04;23;Maanantai;0;1;1
95;28.04.2015;2015;04;00;Tiistai;0;1;1
95;28.04.2015;2015;04;01;Tiistai;0;0;0
95;28.04.2015;2015;04;02;Tiistai;0;0;0
95;28.04.2015;2015;04;03;Tiistai;0;0;0
95;28.04.2015;2015;04;04;Tiistai;0;1;1
95;28.04.2015;2015;04;05;Tiistai;7;1;8
95;28.04.2015;2015;04;06;Tiistai;21;14;35
95;28.04.2015;2015;04;07;Tiistai;21;21;42
95;28.04.2015;2015;04;08;Tiistai;12;12;24
95;28.04.2015;2015;04;09;Tiistai;13;8;21
95;28.04.2015;2015;04;10;Tiistai;12;14;26
95;28.04.2015;2015;04;11;Tiistai;10;5;15
95;28.04.2015;2015;04;12;Tiistai;11;7;18
95;28.04.2015;2015;04;13;Tiistai;11;19;30
95;28.04.2015;2015;04;14;Tiistai;16;9;25
95;28.04.2015;2015;04;15;Tiistai;23;23;46
95;28.04.2015;2015;04;16;Tiistai;23;34;57
95;28.04.2015;2015;04;17;Tiistai;9;23;32
95;28.04.2015;2015;04;18;Tiistai;17;22;39
95;28.04.2015;2015;04;19;Tiistai;13;16;29
95;28.04.2015;2015;04;20;Tiistai;13;12;25
95;28.04.2015;2015;04;21;Tiistai;6;5;11
95;28.04.2015;2015;04;22;Tiistai;0;3;3
95;28.04.2015;2015;04;23;Tiistai;1;1;2
95;29.04.2015;2015;04;00;Keskiviikko;1;0;1
95;29.04.2015;2015;04;01;Keskiviikko;0;0;0
95;29.04.2015;2015;04;02;Keskiviikko;0;0;0
95;29.04.2015;2015;04;03;Keskiviikko;0;0;0
95;29.04.2015;2015;04;04;Keskiviikko;0;3;3
95;29.04.2015;2015;04;05;Keskiviikko;4;3;7
95;29.04.2015;2015;04;06;Keskiviikko;16;12;28
95;29.04.2015;2015;04;07;Keskiviikko;13;14;27
95;29.04.2015;2015;04;08;Keskiviikko;5;11;16
95;29.04.2015;2015;04;09;Keskiviikko;6;8;14
95;29.04.2015;2015;04;10;Keskiviikko;4;2;6
95;29.04.2015;2015;04;11;Keskiviikko;6;3;9
95;29.04.2015;2015;04;12;Keskiviikko;16;6;22
95;29.04.2015;2015;04;13;Keskiviikko;18;8;26
95;29.04.2015;2015;04;14;Keskiviikko;11;9;20
95;29.04.2015;2015;04;15;Keskiviikko;16;14;30
95;29.04.2015;2015;04;16;Keskiviikko;25;23;48
95;29.04.2015;2015;04;17;Keskiviikko;10;9;19
95;29.04.2015;2015;04;18;Keskiviikko;12;11;23
95;29.04.2015;2015;04;19;Keskiviikko;11;15;26
95;29.04.2015;2015;04;20;Keskiviikko;11;4;15
95;29.04.2015;2015;04;21;Keskiviikko;5;6;11
95;29.04.2015;2015;04;22;Keskiviikko;2;6;8
95;29.04.2015;2015;04;23;Keskiviikko;0;1;1
95;30.04.2015;2015;04;00;Torstai;0;1;1
95;30.04.2015;2015;04;01;Torstai;0;0;0
95;30.04.2015;2015;04;02;Torstai;0;0;0
95;30.04.2015;2015;04;03;Torstai;0;0;0
95;30.04.2015;2015;04;04;Torstai;1;1;2
95;30.04.2015;2015;04;05;Torstai;4;2;6
95;30.04.2015;2015;04;06;Torstai;9;5;14
95;30.04.2015;2015;04;07;Torstai;11;12;23
95;30.04.2015;2015;04;08;Torstai;8;6;14
95;30.04.2015;2015;04;09;Torstai;5;7;12
95;30.04.2015;2015;04;10;Torstai;6;5;11
95;30.04.2015;2015;04;11;Torstai;13;4;17
95;30.04.2015;2015;04;12;Torstai;4;7;11
95;30.04.2015;2015;04;13;Torstai;11;11;22
95;30.04.2015;2015;04;14;Torstai;8;16;24
95;30.04.2015;2015;04;15;Torstai;18;15;33
95;30.04.2015;2015;04;16;Torstai;11;20;31
95;30.04.2015;2015;04;17;Torstai;11;13;24
95;30.04.2015;2015;04;18;Torstai;10;7;17
95;30.04.2015;2015;04;19;Torstai;14;9;23
95;30.04.2015;2015;04;20;Torstai;9;5;14
95;30.04.2015;2015;04;21;Torstai;10;3;13
95;30.04.2015;2015;04;22;Torstai;0;3;3
95;30.04.2015;2015;04;23;Torstai;0;1;1
95;01.05.2015;2015;05;00;Perjantai;0;1;1
95;01.05.2015;2015;05;01;Perjantai;0;2;2
95;01.05.2015;2015;05;02;Perjantai;1;1;2
95;01.05.2015;2015;05;03;Perjantai;0;0;0
95;01.05.2015;2015;05;04;Perjantai;0;1;1
95;01.05.2015;2015;05;05;Perjantai;0;2;2
95;01.05.2015;2015;05;06;Perjantai;2;3;5
95;01.05.2015;2015;05;07;Perjantai;3;3;6
95;01.05.2015;2015;05;08;Perjantai;0;3;3
95;01.05.2015;2015;05;09;Perjantai;6;7;13
95;01.05.2015;2015;05;10;Perjantai;5;7;12
95;01.05.2015;2015;05;11;Perjantai;16;2;18
95;01.05.2015;2015;05;12;Perjantai;31;10;41
95;01.05.2015;2015;05;13;Perjantai;11;17;28
95;01.05.2015;2015;05;14;Perjantai;12;20;32
95;01.05.2015;2015;05;15;Perjantai;4;5;9
95;01.05.2015;2015;05;16;Perjantai;4;6;10
95;01.05.2015;2015;05;17;Perjantai;8;5;13
95;01.05.2015;2015;05;18;Perjantai;4;4;8
95;01.05.2015;2015;05;19;Perjantai;5;3;8
95;01.05.2015;2015;05;20;Perjantai;2;2;4
95;01.05.2015;2015;05;21;Perjantai;4;3;7
95;01.05.2015;2015;05;22;Perjantai;7;6;13
95;01.05.2015;2015;05;23;Perjantai;0;0;0
95;02.05.2015;2015;05;00;Lauantai;0;0;0
95;02.05.2015;2015;05;01;Lauantai;0;0;0
95;02.05.2015;2015;05;02;Lauantai;0;0;0
95;02.05.2015;2015;05;03;Lauantai;0;1;1
95;02.05.2015;2015;05;04;Lauantai;1;1;2
95;02.05.2015;2015;05;05;Lauantai;2;0;2
95;02.05.2015;2015;05;06;Lauantai;0;0;0
95;02.05.2015;2015;05;07;Lauantai;4;3;7
95;02.05.2015;2015;05;08;Lauantai;6;9;15
95;02.05.2015;2015;05;09;Lauantai;10;9;19
95;02.05.2015;2015;05;10;Lauantai;11;17;28
95;02.05.2015;2015;05;11;Lauantai;12;15;27
95;02.05.2015;2015;05;12;Lauantai;22;12;34
95;02.05.2015;2015;05;13;Lauantai;10;10;20
95;02.05.2015;2015;05;14;Lauantai;11;22;33
95;02.05.2015;2015;05;15;Lauantai;13;12;25
95;02.05.2015;2015;05;16;Lauantai;20;19;39
95;02.05.2015;2015;05;17;Lauantai;14;16;30
95;02.05.2015;2015;05;18;Lauantai;10;10;20
95;02.05.2015;2015;05;19;Lauantai;8;8;16
95;02.05.2015;2015;05;20;Lauantai;1;1;2
95;02.05.2015;2015;05;21;Lauantai;4;3;7
95;02.05.2015;2015;05;22;Lauantai;0;1;1
95;02.05.2015;2015;05;23;Lauantai;1;0;1
95;03.05.2015;2015;05;00;Sunnuntai;0;1;1
95;03.05.2015;2015;05;01;Sunnuntai;0;0;0
95;03.05.2015;2015;05;02;Sunnuntai;0;0;0
95;03.05.2015;2015;05;03;Sunnuntai;0;0;0
95;03.05.2015;2015;05;04;Sunnuntai;1;0;1
95;03.05.2015;2015;05;05;Sunnuntai;0;0;0
95;03.05.2015;2015;05;06;Sunnuntai;3;0;3
95;03.05.2015;2015;05;07;Sunnuntai;0;0;0
95;03.05.2015;2015;05;08;Sunnuntai;0;1;1
95;03.05.2015;2015;05;09;Sunnuntai;1;1;2
95;03.05.2015;2015;05;10;Sunnuntai;2;18;20
95;03.05.2015;2015;05;11;Sunnuntai;2;0;2
95;03.05.2015;2015;05;12;Sunnuntai;15;6;21
95;03.05.2015;2015;05;13;Sunnuntai;5;13;18
95;03.05.2015;2015;05;14;Sunnuntai;9;16;25
95;03.05.2015;2015;05;15;Sunnuntai;8;9;17
95;03.05.2015;2015;05;16;Sunnuntai;7;5;12
95;03.05.2015;2015;05;17;Sunnuntai;7;4;11
95;03.05.2015;2015;05;18;Sunnuntai;2;5;7
95;03.05.2015;2015;05;19;Sunnuntai;8;7;15
95;03.05.2015;2015;05;20;Sunnuntai;2;5;7
95;03.05.2015;2015;05;21;Sunnuntai;5;6;11
95;03.05.2015;2015;05;22;Sunnuntai;1;1;2
95;03.05.2015;2015;05;23;Sunnuntai;1;0;1
95;04.05.2015;2015;05;00;Maanantai;0;1;1
95;04.05.2015;2015;05;01;Maanantai;0;0;0
95;04.05.2015;2015;05;02;Maanantai;0;0;0
95;04.05.2015;2015;05;03;Maanantai;0;0;0
95;04.05.2015;2015;05;04;Maanantai;1;0;1
95;04.05.2015;2015;05;05;Maanantai;7;2;9
95;04.05.2015;2015;05;06;Maanantai;24;11;35
95;04.05.2015;2015;05;07;Maanantai;18;25;43
95;04.05.2015;2015;05;08;Maanantai;14;8;22
95;04.05.2015;2015;05;09;Maanantai;6;5;11
95;04.05.2015;2015;05;10;Maanantai;4;8;12
95;04.05.2015;2015;05;11;Maanantai;6;13;19
95;04.05.2015;2015;05;12;Maanantai;10;16;26
95;04.05.2015;2015;05;13;Maanantai;9;12;21
95;04.05.2015;2015;05;14;Maanantai;17;13;30
95;04.05.2015;2015;05;15;Maanantai;25;23;48
95;04.05.2015;2015;05;16;Maanantai;34;38;72
95;04.05.2015;2015;05;17;Maanantai;12;21;33
95;04.05.2015;2015;05;18;Maanantai;14;21;35
95;04.05.2015;2015;05;19;Maanantai;18;15;33
95;04.05.2015;2015;05;20;Maanantai;16;12;28
95;04.05.2015;2015;05;21;Maanantai;10;9;19
95;04.05.2015;2015;05;22;Maanantai;3;4;7
95;04.05.2015;2015;05;23;Maanantai;0;2;2
95;05.05.2015;2015;05;00;Tiistai;0;1;1
95;05.05.2015;2015;05;01;Tiistai;0;0;0
95;05.05.2015;2015;05;02;Tiistai;0;0;0
95;05.05.2015;2015;05;03;Tiistai;1;0;1
95;05.05.2015;2015;05;04;Tiistai;1;0;1
95;05.05.2015;2015;05;05;Tiistai;8;1;9
95;05.05.2015;2015;05;06;Tiistai;26;14;40
95;05.05.2015;2015;05;07;Tiistai;30;24;54
95;05.05.2015;2015;05;08;Tiistai;8;15;23
95;05.05.2015;2015;05;09;Tiistai;8;7;15
95;05.05.2015;2015;05;10;Tiistai;7;5;12
95;05.05.2015;2015;05;11;Tiistai;12;7;19
95;05.05.2015;2015;05;12;Tiistai;7;12;19
95;05.05.2015;2015;05;13;Tiistai;12;10;22
95;05.05.2015;2015;05;14;Tiistai;9;9;18
95;05.05.2015;2015;05;15;Tiistai;20;27;47
95;05.05.2015;2015;05;16;Tiistai;32;28;60
95;05.05.2015;2015;05;17;Tiistai;18;22;40
95;05.05.2015;2015;05;18;Tiistai;17;21;38
95;05.05.2015;2015;05;19;Tiistai;14;21;35
95;05.05.2015;2015;05;20;Tiistai;11;15;26
95;05.05.2015;2015;05;21;Tiistai;3;3;6
95;05.05.2015;2015;05;22;Tiistai;2;7;9
95;05.05.2015;2015;05;23;Tiistai;0;3;3
95;06.05.2015;2015;05;00;Keskiviikko;1;1;2
95;06.05.2015;2015;05;01;Keskiviikko;0;0;0
95;06.05.2015;2015;05;02;Keskiviikko;1;0;1
95;06.05.2015;2015;05;03;Keskiviikko;1;0;1
95;06.05.2015;2015;05;04;Keskiviikko;4;0;4
95;06.05.2015;2015;05;05;Keskiviikko;3;4;7
95;06.05.2015;2015;05;06;Keskiviikko;25;13;38
95;06.05.2015;2015;05;07;Keskiviikko;21;23;44
95;06.05.2015;2015;05;08;Keskiviikko;10;9;19
95;06.05.2015;2015;05;09;Keskiviikko;6;4;10
95;06.05.2015;2015;05;10;Keskiviikko;3;3;6
95;06.05.2015;2015;05;11;Keskiviikko;10;5;15
95;06.05.2015;2015;05;12;Keskiviikko;13;7;20
95;06.05.2015;2015;05;13;Keskiviikko;10;8;18
95;06.05.2015;2015;05;14;Keskiviikko;9;10;19
95;06.05.2015;2015;05;15;Keskiviikko;26;24;50
95;06.05.2015;2015;05;16;Keskiviikko;26;30;56
95;06.05.2015;2015;05;17;Keskiviikko;8;17;25
95;06.05.2015;2015;05;18;Keskiviikko;15;17;32
95;06.05.2015;2015;05;19;Keskiviikko;10;8;18
95;06.05.2015;2015;05;20;Keskiviikko;6;10;16
95;06.05.2015;2015;05;21;Keskiviikko;6;3;9
95;06.05.2015;2015;05;22;Keskiviikko;3;2;5
95;06.05.2015;2015;05;23;Keskiviikko;1;1;2
95;07.05.2015;2015;05;00;Torstai;0;1;1
95;07.05.2015;2015;05;01;Torstai;0;1;1
95;07.05.2015;2015;05;02;Torstai;0;0;0
95;07.05.2015;2015;05;03;Torstai;1;0;1
95;07.05.2015;2015;05;04;Torstai;1;0;1
95;07.05.2015;2015;05;05;Torstai;7;1;8
95;07.05.2015;2015;05;06;Torstai;21;8;29
95;07.05.2015;2015;05;07;Torstai;14;16;30
95;07.05.2015;2015;05;08;Torstai;8;9;17
95;07.05.2015;2015;05;09;Torstai;12;6;18
95;07.05.2015;2015;05;10;Torstai;8;6;14
95;07.05.2015;2015;05;11;Torstai;8;6;14
95;07.05.2015;2015;05;12;Torstai;10;11;21
95;07.05.2015;2015;05;13;Torstai;6;11;17
95;07.05.2015;2015;05;14;Torstai;15;9;24
95;07.05.2015;2015;05;15;Torstai;17;24;41
95;07.05.2015;2015;05;16;Torstai;18;20;38
95;07.05.2015;2015;05;17;Torstai;8;16;24
95;07.05.2015;2015;05;18;Torstai;14;23;37
95;07.05.2015;2015;05;19;Torstai;10;9;19
95;07.05.2015;2015;05;20;Torstai;11;5;16
95;07.05.2015;2015;05;21;Torstai;6;6;12
95;07.05.2015;2015;05;22;Torstai;1;1;2
95;07.05.2015;2015;05;23;Torstai;1;1;2
95;08.05.2015;2015;05;00;Perjantai;0;1;1
95;08.05.2015;2015;05;01;Perjantai;2;0;2
95;08.05.2015;2015;05;02;Perjantai;0;0;0
95;08.05.2015;2015;05;03;Perjantai;1;0;1
95;08.05.2015;2015;05;04;Perjantai;0;1;1
95;08.05.2015;2015;05;05;Perjantai;7;0;7
95;08.05.2015;2015;05;06;Perjantai;15;10;25
95;08.05.2015;2015;05;07;Perjantai;16;18;34
95;08.05.2015;2015;05;08;Perjantai;8;9;17
95;08.05.2015;2015;05;09;Perjantai;9;2;11
95;08.05.2015;2015;05;10;Perjantai;4;8;12
95;08.05.2015;2015;05;11;Perjantai;3;3;6
95;08.05.2015;2015;05;12;Perjantai;8;9;17
95;08.05.2015;2015;05;13;Perjantai;9;12;21
95;08.05.2015;2015;05;14;Perjantai;11;12;23
95;08.05.2015;2015;05;15;Perjantai;15;19;34
95;08.05.2015;2015;05;16;Perjantai;16;23;39
95;08.05.2015;2015;05;17;Perjantai;17;10;27
95;08.05.2015;2015;05;18;Perjantai;16;14;30
95;08.05.2015;2015;05;19;Perjantai;13;12;25
95;08.05.2015;2015;05;20;Perjantai;10;3;13
95;08.05.2015;2015;05;21;Perjantai;5;5;10
95;08.05.2015;2015;05;22;Perjantai;1;2;3
95;08.05.2015;2015;05;23;Perjantai;2;0;2
95;09.05.2015;2015;05;00;Lauantai;0;1;1
95;09.05.2015;2015;05;01;Lauantai;1;0;1
95;09.05.2015;2015;05;02;Lauantai;0;0;0
95;09.05.2015;2015;05;03;Lauantai;0;0;0
95;09.05.2015;2015;05;04;Lauantai;0;1;1
95;09.05.2015;2015;05;05;Lauantai;1;2;3
95;09.05.2015;2015;05;06;Lauantai;0;0;0
95;09.05.2015;2015;05;07;Lauantai;0;2;2
95;09.05.2015;2015;05;08;Lauantai;6;4;10
95;09.05.2015;2015;05;09;Lauantai;8;5;13
95;09.05.2015;2015;05;10;Lauantai;8;4;12
95;09.05.2015;2015;05;11;Lauantai;3;8;11
95;09.05.2015;2015;05;12;Lauantai;7;10;17
95;09.05.2015;2015;05;13;Lauantai;8;5;13
95;09.05.2015;2015;05;14;Lauantai;9;4;13
95;09.05.2015;2015;05;15;Lauantai;7;9;16
95;09.05.2015;2015;05;16;Lauantai;4;3;7
95;09.05.2015;2015;05;17;Lauantai;2;4;6
95;09.05.2015;2015;05;18;Lauantai;3;4;7
95;09.05.2015;2015;05;19;Lauantai;2;3;5
95;09.05.2015;2015;05;20;Lauantai;3;1;4
95;09.05.2015;2015;05;21;Lauantai;2;3;5
95;09.05.2015;2015;05;22;Lauantai;4;1;5
95;09.05.2015;2015;05;23;Lauantai;2;0;2
95;10.05.2015;2015;05;00;Sunnuntai;0;0;0
95;10.05.2015;2015;05;01;Sunnuntai;0;0;0
95;10.05.2015;2015;05;02;Sunnuntai;0;0;0
95;10.05.2015;2015;05;03;Sunnuntai;0;0;0
95;10.05.2015;2015;05;04;Sunnuntai;0;0;0
95;10.05.2015;2015;05;05;Sunnuntai;0;0;0
95;10.05.2015;2015;05;06;Sunnuntai;0;1;1
95;10.05.2015;2015;05;07;Sunnuntai;2;3;5
95;10.05.2015;2015;05;08;Sunnuntai;10;7;17
95;10.05.2015;2015;05;09;Sunnuntai;8;14;22
95;10.05.2015;2015;05;10;Sunnuntai;23;52;75
95;10.05.2015;2015;05;11;Sunnuntai;31;19;50
95;10.05.2015;2015;05;12;Sunnuntai;35;24;59
95;10.05.2015;2015;05;13;Sunnuntai;12;17;29
95;10.05.2015;2015;05;14;Sunnuntai;19;16;35
95;10.05.2015;2015;05;15;Sunnuntai;19;13;32
95;10.05.2015;2015;05;16;Sunnuntai;18;16;34
95;10.05.2015;2015;05;17;Sunnuntai;20;21;41
95;10.05.2015;2015;05;18;Sunnuntai;20;26;46
95;10.05.2015;2015;05;19;Sunnuntai;20;11;31
95;10.05.2015;2015;05;20;Sunnuntai;21;8;29
95;10.05.2015;2015;05;21;Sunnuntai;3;3;6
95;10.05.2015;2015;05;22;Sunnuntai;1;0;1
95;10.05.2015;2015;05;23;Sunnuntai;1;0;1
95;11.05.2015;2015;05;00;Maanantai;0;0;0
95;11.05.2015;2015;05;01;Maanantai;0;2;2
95;11.05.2015;2015;05;02;Maanantai;0;0;0
95;11.05.2015;2015;05;03;Maanantai;0;1;1
95;11.05.2015;2015;05;04;Maanantai;1;0;1
95;11.05.2015;2015;05;05;Maanantai;5;1;6
95;11.05.2015;2015;05;06;Maanantai;16;10;26
95;11.05.2015;2015;05;07;Maanantai;9;15;24
95;11.05.2015;2015;05;08;Maanantai;12;6;18
95;11.05.2015;2015;05;09;Maanantai;7;9;16
95;11.05.2015;2015;05;10;Maanantai;12;11;23
95;11.05.2015;2015;05;11;Maanantai;9;11;20
95;11.05.2015;2015;05;12;Maanantai;11;6;17
95;11.05.2015;2015;05;13;Maanantai;10;9;19
95;11.05.2015;2015;05;14;Maanantai;9;16;25
95;11.05.2015;2015;05;15;Maanantai;20;22;42
95;11.05.2015;2015;05;16;Maanantai;28;30;58
95;11.05.2015;2015;05;17;Maanantai;19;21;40
95;11.05.2015;2015;05;18;Maanantai;17;20;37
95;11.05.2015;2015;05;19;Maanantai;10;14;24
95;11.05.2015;2015;05;20;Maanantai;14;15;29
95;11.05.2015;2015;05;21;Maanantai;7;8;15
95;11.05.2015;2015;05;22;Maanantai;1;4;5
95;11.05.2015;2015;05;23;Maanantai;1;1;2
95;12.05.2015;2015;05;00;Tiistai;0;0;0
95;12.05.2015;2015;05;01;Tiistai;0;0;0
95;12.05.2015;2015;05;02;Tiistai;1;0;1
95;12.05.2015;2015;05;03;Tiistai;1;1;2
95;12.05.2015;2015;05;04;Tiistai;2;1;3
95;12.05.2015;2015;05;05;Tiistai;6;3;9
95;12.05.2015;2015;05;06;Tiistai;19;6;25
95;12.05.2015;2015;05;07;Tiistai;16;18;34
95;12.05.2015;2015;05;08;Tiistai;7;10;17
95;12.05.2015;2015;05;09;Tiistai;3;5;8
95;12.05.2015;2015;05;10;Tiistai;2;2;4
95;12.05.2015;2015;05;11;Tiistai;3;3;6
95;12.05.2015;2015;05;12;Tiistai;7;3;10
95;12.05.2015;2015;05;13;Tiistai;8;6;14
95;12.05.2015;2015;05;14;Tiistai;12;6;18
95;12.05.2015;2015;05;15;Tiistai;9;13;22
95;12.05.2015;2015;05;16;Tiistai;14;20;34
95;12.05.2015;2015;05;17;Tiistai;7;13;20
95;12.05.2015;2015;05;18;Tiistai;11;13;24
95;12.05.2015;2015;05;19;Tiistai;2;10;12
95;12.05.2015;2015;05;20;Tiistai;4;4;8
95;12.05.2015;2015;05;21;Tiistai;3;4;7
95;12.05.2015;2015;05;22;Tiistai;1;1;2
95;12.05.2015;2015;05;23;Tiistai;0;0;0
95;13.05.2015;2015;05;00;Keskiviikko;0;0;0
95;13.05.2015;2015;05;01;Keskiviikko;0;0;0
95;13.05.2015;2015;05;02;Keskiviikko;0;0;0
95;13.05.2015;2015;05;03;Keskiviikko;1;1;2
95;13.05.2015;2015;05;04;Keskiviikko;0;1;1
95;13.05.2015;2015;05;05;Keskiviikko;10;1;11
95;13.05.2015;2015;05;06;Keskiviikko;15;5;20
95;13.05.2015;2015;05;07;Keskiviikko;10;14;24
95;13.05.2015;2015;05;08;Keskiviikko;8;10;18
95;13.05.2015;2015;05;09;Keskiviikko;4;4;8
95;13.05.2015;2015;05;10;Keskiviikko;3;2;5
95;13.05.2015;2015;05;11;Keskiviikko;5;1;6
95;13.05.2015;2015;05;12;Keskiviikko;3;5;8
95;13.05.2015;2015;05;13;Keskiviikko;0;1;1
95;13.05.2015;2015;05;14;Keskiviikko;9;3;12
95;13.05.2015;2015;05;15;Keskiviikko;7;17;24
95;13.05.2015;2015;05;16;Keskiviikko;8;4;12
95;13.05.2015;2015;05;17;Keskiviikko;3;5;8
95;13.05.2015;2015;05;18;Keskiviikko;1;2;3
95;13.05.2015;2015;05;19;Keskiviikko;7;4;11
95;13.05.2015;2015;05;20;Keskiviikko;2;6;8
95;13.05.2015;2015;05;21;Keskiviikko;1;2;3
95;13.05.2015;2015;05;22;Keskiviikko;0;0;0
95;13.05.2015;2015;05;23;Keskiviikko;0;1;1
95;14.05.2015;2015;05;00;Torstai;1;0;1
95;14.05.2015;2015;05;01;Torstai;0;0;0
95;14.05.2015;2015;05;02;Torstai;0;1;1
95;14.05.2015;2015;05;03;Torstai;0;0;0
95;14.05.2015;2015;05;04;Torstai;1;1;2
95;14.05.2015;2015;05;05;Torstai;2;0;2
95;14.05.2015;2015;05;06;Torstai;1;1;2
95;14.05.2015;2015;05;07;Torstai;3;2;5
95;14.05.2015;2015;05;08;Torstai;5;2;7
95;14.05.2015;2015;05;09;Torstai;1;6;7
95;14.05.2015;2015;05;10;Torstai;4;2;6
95;14.05.2015;2015;05;11;Torstai;8;5;13
95;14.05.2015;2015;05;12;Torstai;7;9;16
95;14.05.2015;2015;05;13;Torstai;5;6;11
95;14.05.2015;2015;05;14;Torstai;10;6;16
95;14.05.2015;2015;05;15;Torstai;14;12;26
95;14.05.2015;2015;05;16;Torstai;3;7;10
95;14.05.2015;2015;05;17;Torstai;6;10;16
95;14.05.2015;2015;05;18;Torstai;7;8;15
95;14.05.2015;2015;05;19;Torstai;16;7;23
95;14.05.2015;2015;05;20;Torstai;2;2;4
95;14.05.2015;2015;05;21;Torstai;2;2;4
95;14.05.2015;2015;05;22;Torstai;0;3;3
95;14.05.2015;2015;05;23;Torstai;0;0;0
95;15.05.2015;2015;05;00;Perjantai;0;0;0
95;15.05.2015;2015;05;01;Perjantai;0;0;0
95;15.05.2015;2015;05;02;Perjantai;0;0;0
95;15.05.2015;2015;05;03;Perjantai;0;1;1
95;15.05.2015;2015;05;04;Perjantai;0;1;1
95;15.05.2015;2015;05;05;Perjantai;3;2;5
95;15.05.2015;2015;05;06;Perjantai;9;2;11
95;15.05.2015;2015;05;07;Perjantai;7;7;14
95;15.05.2015;2015;05;08;Perjantai;2;0;2
95;15.05.2015;2015;05;09;Perjantai;4;0;4
95;15.05.2015;2015;05;10;Perjantai;2;4;6
95;15.05.2015;2015;05;11;Perjantai;9;3;12
95;15.05.2015;2015;05;12;Perjantai;3;5;8
95;15.05.2015;2015;05;13;Perjantai;9;7;16
95;15.05.2015;2015;05;14;Perjantai;3;8;11
95;15.05.2015;2015;05;15;Perjantai;5;5;10
95;15.05.2015;2015;05;16;Perjantai;2;11;13
95;15.05.2015;2015;05;17;Perjantai;2;12;14
95;15.05.2015;2015;05;18;Perjantai;5;7;12
95;15.05.2015;2015;05;19;Perjantai;1;9;10
95;15.05.2015;2015;05;20;Perjantai;9;7;16
95;15.05.2015;2015;05;21;Perjantai;4;8;12
95;15.05.2015;2015;05;22;Perjantai;1;2;3
95;15.05.2015;2015;05;23;Perjantai;0;1;1
95;16.05.2015;2015;05;00;Lauantai;1;0;1
95;16.05.2015;2015;05;01;Lauantai;0;0;0
95;16.05.2015;2015;05;02;Lauantai;1;0;1
95;16.05.2015;2015;05;03;Lauantai;1;0;1
95;16.05.2015;2015;05;04;Lauantai;1;0;1
95;16.05.2015;2015;05;05;Lauantai;1;1;2
95;16.05.2015;2015;05;06;Lauantai;3;2;5
95;16.05.2015;2015;05;07;Lauantai;4;3;7
95;16.05.2015;2015;05;08;Lauantai;5;11;16
95;16.05.2015;2015;05;09;Lauantai;14;8;22
95;16.05.2015;2015;05;10;Lauantai;12;10;22
95;16.05.2015;2015;05;11;Lauantai;11;18;29
95;16.05.2015;2015;05;12;Lauantai;17;19;36
95;16.05.2015;2015;05;13;Lauantai;14;11;25
95;16.05.2015;2015;05;14;Lauantai;13;25;38
95;16.05.2015;2015;05;15;Lauantai;13;13;26
95;16.05.2015;2015;05;16;Lauantai;14;21;35
95;16.05.2015;2015;05;17;Lauantai;11;14;25
95;16.05.2015;2015;05;18;Lauantai;13;8;21
95;16.05.2015;2015;05;19;Lauantai;7;9;16
95;16.05.2015;2015;05;20;Lauantai;6;9;15
95;16.05.2015;2015;05;21;Lauantai;6;3;9
95;16.05.2015;2015;05;22;Lauantai;1;7;8
95;16.05.2015;2015;05;23;Lauantai;0;0;0
95;17.05.2015;2015;05;00;Sunnuntai;1;1;2
95;17.05.2015;2015;05;01;Sunnuntai;0;1;1
95;17.05.2015;2015;05;02;Sunnuntai;0;0;0
95;17.05.2015;2015;05;03;Sunnuntai;1;0;1
95;17.05.2015;2015;05;04;Sunnuntai;1;0;1
95;17.05.2015;2015;05;05;Sunnuntai;0;0;0
95;17.05.2015;2015;05;06;Sunnuntai;2;0;2
95;17.05.2015;2015;05;07;Sunnuntai;2;4;6
95;17.05.2015;2015;05;08;Sunnuntai;4;9;13
95;17.05.2015;2015;05;09;Sunnuntai;7;11;18
95;17.05.2015;2015;05;10;Sunnuntai;19;38;57
95;17.05.2015;2015;05;11;Sunnuntai;13;11;24
95;17.05.2015;2015;05;12;Sunnuntai;21;18;39
95;17.05.2015;2015;05;13;Sunnuntai;16;18;34
95;17.05.2015;2015;05;14;Sunnuntai;12;17;29
95;17.05.2015;2015;05;15;Sunnuntai;12;6;18
95;17.05.2015;2015;05;16;Sunnuntai;14;15;29
95;17.05.2015;2015;05;17;Sunnuntai;14;12;26
95;17.05.2015;2015;05;18;Sunnuntai;16;18;34
95;17.05.2015;2015;05;19;Sunnuntai;17;11;28
95;17.05.2015;2015;05;20;Sunnuntai;3;14;17
95;17.05.2015;2015;05;21;Sunnuntai;11;2;13
95;17.05.2015;2015;05;22;Sunnuntai;2;3;5
95;17.05.2015;2015;05;23;Sunnuntai;1;0;1
95;18.05.2015;2015;05;00;Maanantai;0;0;0
95;18.05.2015;2015;05;01;Maanantai;1;0;1
95;18.05.2015;2015;05;02;Maanantai;1;0;1
95;18.05.2015;2015;05;03;Maanantai;0;0;0
95;18.05.2015;2015;05;04;Maanantai;3;0;3
95;18.05.2015;2015;05;05;Maanantai;7;5;12
95;18.05.2015;2015;05;06;Maanantai;21;14;35
95;18.05.2015;2015;05;07;Maanantai;20;21;41
95;18.05.2015;2015;05;08;Maanantai;18;12;30
95;18.05.2015;2015;05;09;Maanantai;10;10;20
95;18.05.2015;2015;05;10;Maanantai;2;7;9
95;18.05.2015;2015;05;11;Maanantai;15;7;22
95;18.05.2015;2015;05;12;Maanantai;11;11;22
95;18.05.2015;2015;05;13;Maanantai;11;10;21
95;18.05.2015;2015;05;14;Maanantai;12;18;30
95;18.05.2015;2015;05;15;Maanantai;21;18;39
95;18.05.2015;2015;05;16;Maanantai;28;27;55
95;18.05.2015;2015;05;17;Maanantai;14;28;42
95;18.05.2015;2015;05;18;Maanantai;4;17;21
95;18.05.2015;2015;05;19;Maanantai;13;10;23
95;18.05.2015;2015;05;20;Maanantai;8;9;17
95;18.05.2015;2015;05;21;Maanantai;5;3;8
95;18.05.2015;2015;05;22;Maanantai;5;3;8
95;18.05.2015;2015;05;23;Maanantai;0;1;1
95;19.05.2015;2015;05;00;Tiistai;0;1;1
95;19.05.2015;2015;05;01;Tiistai;0;0;0
95;19.05.2015;2015;05;02;Tiistai;1;0;1
95;19.05.2015;2015;05;03;Tiistai;0;0;0
95;19.05.2015;2015;05;04;Tiistai;3;1;4
95;19.05.2015;2015;05;05;Tiistai;8;2;10
95;19.05.2015;2015;05;06;Tiistai;13;11;24
95;19.05.2015;2015;05;07;Tiistai;19;14;33
95;19.05.2015;2015;05;08;Tiistai;7;15;22
95;19.05.2015;2015;05;09;Tiistai;2;4;6
95;19.05.2015;2015;05;10;Tiistai;8;3;11
95;19.05.2015;2015;05;11;Tiistai;7;3;10
95;19.05.2015;2015;05;12;Tiistai;8;12;20
95;19.05.2015;2015;05;13;Tiistai;6;10;16
95;19.05.2015;2015;05;14;Tiistai;21;13;34
95;19.05.2015;2015;05;15;Tiistai;20;16;36
95;19.05.2015;2015;05;16;Tiistai;20;28;48
95;19.05.2015;2015;05;17;Tiistai;11;25;36
95;19.05.2015;2015;05;18;Tiistai;15;21;36
95;19.05.2015;2015;05;19;Tiistai;9;8;17
95;19.05.2015;2015;05;20;Tiistai;5;9;14
95;19.05.2015;2015;05;21;Tiistai;5;1;6
95;19.05.2015;2015;05;22;Tiistai;3;4;7
95;19.05.2015;2015;05;23;Tiistai;0;1;1
95;20.05.2015;2015;05;00;Keskiviikko;0;0;0
95;20.05.2015;2015;05;01;Keskiviikko;1;1;2
95;20.05.2015;2015;05;02;Keskiviikko;2;0;2
95;20.05.2015;2015;05;03;Keskiviikko;0;0;0
95;20.05.2015;2015;05;04;Keskiviikko;1;0;1
95;20.05.2015;2015;05;05;Keskiviikko;7;4;11
95;20.05.2015;2015;05;06;Keskiviikko;14;9;23
95;20.05.2015;2015;05;07;Keskiviikko;17;14;31
95;20.05.2015;2015;05;08;Keskiviikko;6;9;15
95;20.05.2015;2015;05;09;Keskiviikko;15;7;22
95;20.05.2015;2015;05;10;Keskiviikko;4;4;8
95;20.05.2015;2015;05;11;Keskiviikko;4;3;7
95;20.05.2015;2015;05;12;Keskiviikko;4;2;6
95;20.05.2015;2015;05;13;Keskiviikko;0;4;4
95;20.05.2015;2015;05;14;Keskiviikko;4;4;8
95;20.05.2015;2015;05;15;Keskiviikko;17;13;30
95;20.05.2015;2015;05;16;Keskiviikko;15;20;35
95;20.05.2015;2015;05;17;Keskiviikko;9;13;22
95;20.05.2015;2015;05;18;Keskiviikko;8;15;23
95;20.05.2015;2015;05;19;Keskiviikko;8;20;28
95;20.05.2015;2015;05;20;Keskiviikko;5;6;11
95;20.05.2015;2015;05;21;Keskiviikko;7;5;12
95;20.05.2015;2015;05;22;Keskiviikko;2;1;3
95;20.05.2015;2015;05;23;Keskiviikko;0;1;1
95;21.05.2015;2015;05;00;Torstai;0;0;0
95;21.05.2015;2015;05;01;Torstai;1;0;1
95;21.05.2015;2015;05;02;Torstai;0;0;0
95;21.05.2015;2015;05;03;Torstai;0;0;0
95;21.05.2015;2015;05;04;Torstai;3;0;3
95;21.05.2015;2015;05;05;Torstai;10;1;11
95;21.05.2015;2015;05;06;Torstai;24;10;34
95;21.05.2015;2015;05;07;Torstai;27;20;47
95;21.05.2015;2015;05;08;Torstai;14;13;27
95;21.05.2015;2015;05;09;Torstai;16;4;20
95;21.05.2015;2015;05;10;Torstai;19;9;28
95;21.05.2015;2015;05;11;Torstai;12;14;26
95;21.05.2015;2015;05;12;Torstai;21;12;33
95;21.05.2015;2015;05;13;Torstai;6;10;16
95;21.05.2015;2015;05;14;Torstai;9;10;19
95;21.05.2015;2015;05;15;Torstai;20;36;56
95;21.05.2015;2015;05;16;Torstai;28;33;61
95;21.05.2015;2015;05;17;Torstai;13;26;39
95;21.05.2015;2015;05;18;Torstai;13;23;36
95;21.05.2015;2015;05;19;Torstai;21;23;44
95;21.05.2015;2015;05;20;Torstai;15;18;33
95;21.05.2015;2015;05;21;Torstai;10;13;23
95;21.05.2015;2015;05;22;Torstai;2;9;11
95;21.05.2015;2015;05;23;Torstai;0;6;6
95;22.05.2015;2015;05;00;Perjantai;0;0;0
95;22.05.2015;2015;05;01;Perjantai;1;0;1
95;22.05.2015;2015;05;02;Perjantai;0;0;0
95;22.05.2015;2015;05;03;Perjantai;0;0;0
95;22.05.2015;2015;05;04;Perjantai;2;0;2
95;22.05.2015;2015;05;05;Perjantai;10;2;12
95;22.05.2015;2015;05;06;Perjantai;18;9;27
95;22.05.2015;2015;05;07;Perjantai;28;24;52
95;22.05.2015;2015;05;08;Perjantai;18;11;29
95;22.05.2015;2015;05;09;Perjantai;17;7;24
95;22.05.2015;2015;05;10;Perjantai;13;18;31
95;22.05.2015;2015;05;11;Perjantai;17;12;29
95;22.05.2015;2015;05;12;Perjantai;18;12;30
95;22.05.2015;2015;05;13;Perjantai;10;12;22
95;22.05.2015;2015;05;14;Perjantai;6;12;18
95;22.05.2015;2015;05;15;Perjantai;15;20;35
95;22.05.2015;2015;05;16;Perjantai;18;24;42
95;22.05.2015;2015;05;17;Perjantai;20;32;52
95;22.05.2015;2015;05;18;Perjantai;10;15;25
95;22.05.2015;2015;05;19;Perjantai;18;12;30
95;22.05.2015;2015;05;20;Perjantai;6;4;10
95;22.05.2015;2015;05;21;Perjantai;4;7;11
95;22.05.2015;2015;05;22;Perjantai;2;0;2
95;22.05.2015;2015;05;23;Perjantai;1;3;4
95;23.05.2015;2015;05;00;Lauantai;1;1;2
95;23.05.2015;2015;05;01;Lauantai;3;1;4
95;23.05.2015;2015;05;02;Lauantai;0;2;2
95;23.05.2015;2015;05;03;Lauantai;0;0;0
95;23.05.2015;2015;05;04;Lauantai;0;2;2
95;23.05.2015;2015;05;05;Lauantai;1;2;3
95;23.05.2015;2015;05;06;Lauantai;2;3;5
95;23.05.2015;2015;05;07;Lauantai;1;1;2
95;23.05.2015;2015;05;08;Lauantai;4;0;4
95;23.05.2015;2015;05;09;Lauantai;1;9;10
95;23.05.2015;2015;05;10;Lauantai;3;3;6
95;23.05.2015;2015;05;11;Lauantai;2;3;5
95;23.05.2015;2015;05;12;Lauantai;3;1;4
95;23.05.2015;2015;05;13;Lauantai;0;0;0
95;23.05.2015;2015;05;14;Lauantai;3;2;5
95;23.05.2015;2015;05;15;Lauantai;6;7;13
95;23.05.2015;2015;05;16;Lauantai;2;2;4
95;23.05.2015;2015;05;17;Lauantai;3;2;5
95;23.05.2015;2015;05;18;Lauantai;1;1;2
95;23.05.2015;2015;05;19;Lauantai;2;2;4
95;23.05.2015;2015;05;20;Lauantai;3;4;7
95;23.05.2015;2015;05;21;Lauantai;4;2;6
95;23.05.2015;2015;05;22;Lauantai;0;0;0
95;23.05.2015;2015;05;23;Lauantai;1;0;1
95;24.05.2015;2015;05;00;Sunnuntai;0;0;0
95;24.05.2015;2015;05;01;Sunnuntai;0;0;0
95;24.05.2015;2015;05;02;Sunnuntai;0;0;0
95;24.05.2015;2015;05;03;Sunnuntai;0;0;0
95;24.05.2015;2015;05;04;Sunnuntai;0;1;1
95;24.05.2015;2015;05;05;Sunnuntai;2;0;2
95;24.05.2015;2015;05;06;Sunnuntai;0;1;1
95;24.05.2015;2015;05;07;Sunnuntai;2;2;4
95;24.05.2015;2015;05;08;Sunnuntai;3;2;5
95;24.05.2015;2015;05;09;Sunnuntai;11;4;15
95;24.05.2015;2015;05;10;Sunnuntai;10;46;56
95;24.05.2015;2015;05;11;Sunnuntai;17;12;29
95;24.05.2015;2015;05;12;Sunnuntai;21;30;51
95;24.05.2015;2015;05;13;Sunnuntai;20;19;39
95;24.05.2015;2015;05;14;Sunnuntai;16;25;41
95;24.05.2015;2015;05;15;Sunnuntai;18;20;38
95;24.05.2015;2015;05;16;Sunnuntai;10;8;18
95;24.05.2015;2015;05;17;Sunnuntai;12;22;34
95;24.05.2015;2015;05;18;Sunnuntai;17;20;37
95;24.05.2015;2015;05;19;Sunnuntai;19;21;40
95;24.05.2015;2015;05;20;Sunnuntai;4;9;13
95;24.05.2015;2015;05;21;Sunnuntai;3;8;11
95;24.05.2015;2015;05;22;Sunnuntai;1;2;3
95;24.05.2015;2015;05;23;Sunnuntai;1;1;2
95;25.05.2015;2015;05;00;Maanantai;0;1;1
95;25.05.2015;2015;05;01;Maanantai;1;0;1
95;25.05.2015;2015;05;02;Maanantai;1;1;2
95;25.05.2015;2015;05;03;Maanantai;0;0;0
95;25.05.2015;2015;05;04;Maanantai;1;1;2
95;25.05.2015;2015;05;05;Maanantai;12;3;15
95;25.05.2015;2015;05;06;Maanantai;24;12;36
95;25.05.2015;2015;05;07;Maanantai;39;26;65
95;25.05.2015;2015;05;08;Maanantai;17;9;26
95;25.05.2015;2015;05;09;Maanantai;11;9;20
95;25.05.2015;2015;05;10;Maanantai;14;8;22
95;25.05.2015;2015;05;11;Maanantai;9;8;17
95;25.05.2015;2015;05;12;Maanantai;20;9;29
95;25.05.2015;2015;05;13;Maanantai;14;15;29
95;25.05.2015;2015;05;14;Maanantai;11;12;23
95;25.05.2015;2015;05;15;Maanantai;14;28;42
95;25.05.2015;2015;05;16;Maanantai;37;49;86
95;25.05.2015;2015;05;17;Maanantai;20;27;47
95;25.05.2015;2015;05;18;Maanantai;19;11;30
95;25.05.2015;2015;05;19;Maanantai;8;21;29
95;25.05.2015;2015;05;20;Maanantai;10;8;18
95;25.05.2015;2015;05;21;Maanantai;6;8;14
95;25.05.2015;2015;05;22;Maanantai;3;7;10
95;25.05.2015;2015;05;23;Maanantai;0;2;2
95;26.05.2015;2015;05;00;Tiistai;1;0;1
95;26.05.2015;2015;05;01;Tiistai;1;0;1
95;26.05.2015;2015;05;02;Tiistai;0;0;0
95;26.05.2015;2015;05;03;Tiistai;0;1;1
95;26.05.2015;2015;05;04;Tiistai;2;1;3
95;26.05.2015;2015;05;05;Tiistai;8;1;9
95;26.05.2015;2015;05;06;Tiistai;21;10;31
95;26.05.2015;2015;05;07;Tiistai;22;26;48
95;26.05.2015;2015;05;08;Tiistai;6;11;17
95;26.05.2015;2015;05;09;Tiistai;8;3;11
95;26.05.2015;2015;05;10;Tiistai;8;10;18
95;26.05.2015;2015;05;11;Tiistai;9;3;12
95;26.05.2015;2015;05;12;Tiistai;16;9;25
95;26.05.2015;2015;05;13;Tiistai;9;18;27
95;26.05.2015;2015;05;14;Tiistai;10;12;22
95;26.05.2015;2015;05;15;Tiistai;20;23;43
95;26.05.2015;2015;05;16;Tiistai;27;35;62
95;26.05.2015;2015;05;17;Tiistai;20;35;55
95;26.05.2015;2015;05;18;Tiistai;16;24;40
95;26.05.2015;2015;05;19;Tiistai;20;23;43
95;26.05.2015;2015;05;20;Tiistai;12;11;23
95;26.05.2015;2015;05;21;Tiistai;13;1;14
95;26.05.2015;2015;05;22;Tiistai;2;3;5
95;26.05.2015;2015;05;23;Tiistai;1;1;2
95;27.05.2015;2015;05;00;Keskiviikko;1;0;1
95;27.05.2015;2015;05;01;Keskiviikko;0;1;1
95;27.05.2015;2015;05;02;Keskiviikko;0;0;0
95;27.05.2015;2015;05;03;Keskiviikko;0;0;0
95;27.05.2015;2015;05;04;Keskiviikko;2;1;3
95;27.05.2015;2015;05;05;Keskiviikko;9;2;11
95;27.05.2015;2015;05;06;Keskiviikko;16;12;28
95;27.05.2015;2015;05;07;Keskiviikko;12;18;30
95;27.05.2015;2015;05;08;Keskiviikko;2;10;12
95;27.05.2015;2015;05;09;Keskiviikko;5;5;10
95;27.05.2015;2015;05;10;Keskiviikko;4;3;7
95;27.05.2015;2015;05;11;Keskiviikko;7;2;9
95;27.05.2015;2015;05;12;Keskiviikko;2;1;3
95;27.05.2015;2015;05;13;Keskiviikko;4;4;8
95;27.05.2015;2015;05;14;Keskiviikko;8;7;15
95;27.05.2015;2015;05;15;Keskiviikko;15;12;27
95;27.05.2015;2015;05;16;Keskiviikko;25;28;53
95;27.05.2015;2015;05;17;Keskiviikko;15;17;32
95;27.05.2015;2015;05;18;Keskiviikko;9;20;29
95;27.05.2015;2015;05;19;Keskiviikko;11;18;29
95;27.05.2015;2015;05;20;Keskiviikko;5;15;20
95;27.05.2015;2015;05;21;Keskiviikko;2;4;6
95;27.05.2015;2015;05;22;Keskiviikko;1;1;2
95;27.05.2015;2015;05;23;Keskiviikko;1;1;2
95;28.05.2015;2015;05;00;Torstai;0;0;0
95;28.05.2015;2015;05;01;Torstai;0;1;1
95;28.05.2015;2015;05;02;Torstai;0;0;0
95;28.05.2015;2015;05;03;Torstai;0;1;1
95;28.05.2015;2015;05;04;Torstai;4;0;4
95;28.05.2015;2015;05;05;Torstai;8;3;11
95;28.05.2015;2015;05;06;Torstai;30;15;45
95;28.05.2015;2015;05;07;Torstai;34;18;52
95;28.05.2015;2015;05;08;Torstai;9;8;17
95;28.05.2015;2015;05;09;Torstai;16;8;24
95;28.05.2015;2015;05;10;Torstai;5;14;19
95;28.05.2015;2015;05;11;Torstai;10;7;17
95;28.05.2015;2015;05;12;Torstai;13;15;28
95;28.05.2015;2015;05;13;Torstai;15;16;31
95;28.05.2015;2015;05;14;Torstai;18;20;38
95;28.05.2015;2015;05;15;Torstai;19;26;45
95;28.05.2015;2015;05;16;Torstai;19;41;60
95;28.05.2015;2015;05;17;Torstai;8;25;33
95;28.05.2015;2015;05;18;Torstai;18;21;39
95;28.05.2015;2015;05;19;Torstai;17;17;34
95;28.05.2015;2015;05;20;Torstai;15;11;26
95;28.05.2015;2015;05;21;Torstai;4;6;10
95;28.05.2015;2015;05;22;Torstai;4;3;7
95;28.05.2015;2015;05;23;Torstai;0;1;1
95;29.05.2015;2015;05;00;Perjantai;0;1;1
95;29.05.2015;2015;05;01;Perjantai;1;0;1
95;29.05.2015;2015;05;02;Perjantai;1;1;2
95;29.05.2015;2015;05;03;Perjantai;0;0;0
95;29.05.2015;2015;05;04;Perjantai;1;0;1
95;29.05.2015;2015;05;05;Perjantai;9;3;12
95;29.05.2015;2015;05;06;Perjantai;26;12;38
95;29.05.2015;2015;05;07;Perjantai;23;24;47
95;29.05.2015;2015;05;08;Perjantai;10;17;27
95;29.05.2015;2015;05;09;Perjantai;12;3;15
95;29.05.2015;2015;05;10;Perjantai;11;11;22
95;29.05.2015;2015;05;11;Perjantai;20;6;26
95;29.05.2015;2015;05;12;Perjantai;17;9;26
95;29.05.2015;2015;05;13;Perjantai;20;13;33
95;29.05.2015;2015;05;14;Perjantai;13;24;37
95;29.05.2015;2015;05;15;Perjantai;18;24;42
95;29.05.2015;2015;05;16;Perjantai;16;16;32
95;29.05.2015;2015;05;17;Perjantai;9;21;30
95;29.05.2015;2015;05;18;Perjantai;9;8;17
95;29.05.2015;2015;05;19;Perjantai;0;4;4
95;29.05.2015;2015;05;20;Perjantai;7;4;11
95;29.05.2015;2015;05;21;Perjantai;0;5;5
95;29.05.2015;2015;05;22;Perjantai;1;2;3
95;29.05.2015;2015;05;23;Perjantai;0;2;2
95;30.05.2015;2015;05;00;Lauantai;2;0;2
95;30.05.2015;2015;05;01;Lauantai;0;2;2
95;30.05.2015;2015;05;02;Lauantai;1;1;2
95;30.05.2015;2015;05;03;Lauantai;0;0;0
95;30.05.2015;2015;05;04;Lauantai;0;0;0
95;30.05.2015;2015;05;05;Lauantai;0;1;1
95;30.05.2015;2015;05;06;Lauantai;1;2;3
95;30.05.2015;2015;05;07;Lauantai;2;6;8
95;30.05.2015;2015;05;08;Lauantai;11;3;14
95;30.05.2015;2015;05;09;Lauantai;16;13;29
95;30.05.2015;2015;05;10;Lauantai;16;17;33
95;30.05.2015;2015;05;11;Lauantai;18;15;33
95;30.05.2015;2015;05;12;Lauantai;19;19;38
95;30.05.2015;2015;05;13;Lauantai;9;16;25
95;30.05.2015;2015;05;14;Lauantai;18;15;33
95;30.05.2015;2015;05;15;Lauantai;17;18;35
95;30.05.2015;2015;05;16;Lauantai;8;17;25
95;30.05.2015;2015;05;17;Lauantai;19;7;26
95;30.05.2015;2015;05;18;Lauantai;10;23;33
95;30.05.2015;2015;05;19;Lauantai;6;14;20
95;30.05.2015;2015;05;20;Lauantai;9;10;19
95;30.05.2015;2015;05;21;Lauantai;6;4;10
95;30.05.2015;2015;05;22;Lauantai;2;7;9
95;30.05.2015;2015;05;23;Lauantai;2;1;3
95;31.05.2015;2015;05;00;Sunnuntai;0;0;0
95;31.05.2015;2015;05;01;Sunnuntai;1;1;2
95;31.05.2015;2015;05;02;Sunnuntai;2;3;5
95;31.05.2015;2015;05;03;Sunnuntai;2;3;5
95;31.05.2015;2015;05;04;Sunnuntai;0;1;1
95;31.05.2015;2015;05;05;Sunnuntai;1;0;1
95;31.05.2015;2015;05;06;Sunnuntai;1;2;3
95;31.05.2015;2015;05;07;Sunnuntai;11;3;14
95;31.05.2015;2015;05;08;Sunnuntai;5;9;14
95;31.05.2015;2015;05;09;Sunnuntai;16;15;31
95;31.05.2015;2015;05;10;Sunnuntai;15;20;35
95;31.05.2015;2015;05;11;Sunnuntai;6;2;8
95;31.05.2015;2015;05;12;Sunnuntai;10;6;16
95;31.05.2015;2015;05;13;Sunnuntai;3;6;9
95;31.05.2015;2015;05;14;Sunnuntai;2;3;5
95;31.05.2015;2015;05;15;Sunnuntai;1;7;8
95;31.05.2015;2015;05;16;Sunnuntai;9;3;12
95;31.05.2015;2015;05;17;Sunnuntai;12;18;30
95;31.05.2015;2015;05;18;Sunnuntai;10;7;17
95;31.05.2015;2015;05;19;Sunnuntai;10;7;17
95;31.05.2015;2015;05;20;Sunnuntai;3;3;6
95;31.05.2015;2015;05;21;Sunnuntai;3;6;9
95;31.05.2015;2015;05;22;Sunnuntai;2;1;3
95;31.05.2015;2015;05;23;Sunnuntai;4;1;5
95;01.06.2015;2015;06;00;Maanantai;0;0;0
95;01.06.2015;2015;06;01;Maanantai;0;0;0
95;01.06.2015;2015;06;02;Maanantai;0;0;0
95;01.06.2015;2015;06;03;Maanantai;0;0;0
95;01.06.2015;2015;06;04;Maanantai;1;1;2
95;01.06.2015;2015;06;05;Maanantai;10;5;15
95;01.06.2015;2015;06;06;Maanantai;25;21;46
95;01.06.2015;2015;06;07;Maanantai;14;17;31
95;01.06.2015;2015;06;08;Maanantai;13;12;25
95;01.06.2015;2015;06;09;Maanantai;8;3;11
95;01.06.2015;2015;06;10;Maanantai;6;3;9
95;01.06.2015;2015;06;11;Maanantai;3;3;6
95;01.06.2015;2015;06;12;Maanantai;12;1;13
95;01.06.2015;2015;06;13;Maanantai;6;14;20
95;01.06.2015;2015;06;14;Maanantai;19;12;31
95;01.06.2015;2015;06;15;Maanantai;24;25;49
95;01.06.2015;2015;06;16;Maanantai;18;23;41
95;01.06.2015;2015;06;17;Maanantai;8;15;23
95;01.06.2015;2015;06;18;Maanantai;4;6;10
95;01.06.2015;2015;06;19;Maanantai;4;7;11
95;01.06.2015;2015;06;20;Maanantai;1;2;3
95;01.06.2015;2015;06;21;Maanantai;8;7;15
95;01.06.2015;2015;06;22;Maanantai;5;1;6
95;01.06.2015;2015;06;23;Maanantai;0;4;4
95;02.06.2015;2015;06;00;Tiistai;2;0;2
95;02.06.2015;2015;06;01;Tiistai;0;0;0
95;02.06.2015;2015;06;02;Tiistai;0;0;0
95;02.06.2015;2015;06;03;Tiistai;0;1;1
95;02.06.2015;2015;06;04;Tiistai;3;1;4
95;02.06.2015;2015;06;05;Tiistai;7;3;10
95;02.06.2015;2015;06;06;Tiistai;34;16;50
95;02.06.2015;2015;06;07;Tiistai;27;26;53
95;02.06.2015;2015;06;08;Tiistai;22;14;36
95;02.06.2015;2015;06;09;Tiistai;11;6;17
95;02.06.2015;2015;06;10;Tiistai;5;7;12
95;02.06.2015;2015;06;11;Tiistai;16;7;23
95;02.06.2015;2015;06;12;Tiistai;10;8;18
95;02.06.2015;2015;06;13;Tiistai;11;16;27
95;02.06.2015;2015;06;14;Tiistai;16;12;28
95;02.06.2015;2015;06;15;Tiistai;26;24;50
95;02.06.2015;2015;06;16;Tiistai;26;30;56
95;02.06.2015;2015;06;17;Tiistai;22;40;62
95;02.06.2015;2015;06;18;Tiistai;17;30;47
95;02.06.2015;2015;06;19;Tiistai;24;21;45
95;02.06.2015;2015;06;20;Tiistai;14;20;34
95;02.06.2015;2015;06;21;Tiistai;6;16;22
95;02.06.2015;2015;06;22;Tiistai;7;3;10
95;02.06.2015;2015;06;23;Tiistai;0;3;3
95;03.06.2015;2015;06;00;Keskiviikko;0;1;1
95;03.06.2015;2015;06;01;Keskiviikko;0;1;1
95;03.06.2015;2015;06;02;Keskiviikko;3;0;3
95;03.06.2015;2015;06;03;Keskiviikko;0;0;0
95;03.06.2015;2015;06;04;Keskiviikko;0;1;1
95;03.06.2015;2015;06;05;Keskiviikko;7;1;8
95;03.06.2015;2015;06;06;Keskiviikko;12;15;27
95;03.06.2015;2015;06;07;Keskiviikko;13;11;24
95;03.06.2015;2015;06;08;Keskiviikko;5;3;8
95;03.06.2015;2015;06;09;Keskiviikko;5;1;6
95;03.06.2015;2015;06;10;Keskiviikko;1;1;2
95;03.06.2015;2015;06;11;Keskiviikko;3;1;4
95;03.06.2015;2015;06;12;Keskiviikko;7;6;13
95;03.06.2015;2015;06;13;Keskiviikko;7;6;13
95;03.06.2015;2015;06;14;Keskiviikko;9;11;20
95;03.06.2015;2015;06;15;Keskiviikko;17;14;31
95;03.06.2015;2015;06;16;Keskiviikko;14;12;26
95;03.06.2015;2015;06;17;Keskiviikko;10;19;29
95;03.06.2015;2015;06;18;Keskiviikko;10;9;19
95;03.06.2015;2015;06;19;Keskiviikko;3;13;16
95;03.06.2015;2015;06;20;Keskiviikko;8;12;20
95;03.06.2015;2015;06;21;Keskiviikko;3;9;12
95;03.06.2015;2015;06;22;Keskiviikko;2;3;5
95;03.06.2015;2015;06;23;Keskiviikko;0;1;1
95;04.06.2015;2015;06;00;Torstai;0;0;0
95;04.06.2015;2015;06;01;Torstai;0;1;1
95;04.06.2015;2015;06;02;Torstai;1;0;1
95;04.06.2015;2015;06;03;Torstai;0;1;1
95;04.06.2015;2015;06;04;Torstai;2;2;4
95;04.06.2015;2015;06;05;Torstai;6;3;9
95;04.06.2015;2015;06;06;Torstai;23;12;35
95;04.06.2015;2015;06;07;Torstai;16;15;31
95;04.06.2015;2015;06;08;Torstai;11;8;19
95;04.06.2015;2015;06;09;Torstai;6;7;13
95;04.06.2015;2015;06;10;Torstai;27;7;34
95;04.06.2015;2015;06;11;Torstai;16;10;26
95;04.06.2015;2015;06;12;Torstai;16;10;26
95;04.06.2015;2015;06;13;Torstai;12;13;25
95;04.06.2015;2015;06;14;Torstai;11;21;32
95;04.06.2015;2015;06;15;Torstai;25;25;50
95;04.06.2015;2015;06;16;Torstai;19;34;53
95;04.06.2015;2015;06;17;Torstai;22;19;41
95;04.06.2015;2015;06;18;Torstai;13;21;34
95;04.06.2015;2015;06;19;Torstai;11;20;31
95;04.06.2015;2015;06;20;Torstai;13;13;26
95;04.06.2015;2015;06;21;Torstai;4;8;12
95;04.06.2015;2015;06;22;Torstai;7;7;14
95;04.06.2015;2015;06;23;Torstai;2;2;4
95;05.06.2015;2015;06;00;Perjantai;1;1;2
95;05.06.2015;2015;06;01;Perjantai;0;1;1
95;05.06.2015;2015;06;02;Perjantai;0;0;0
95;05.06.2015;2015;06;03;Perjantai;2;1;3
95;05.06.2015;2015;06;04;Perjantai;3;2;5
95;05.06.2015;2015;06;05;Perjantai;10;2;12
95;05.06.2015;2015;06;06;Perjantai;27;10;37
95;05.06.2015;2015;06;07;Perjantai;34;12;46
95;05.06.2015;2015;06;08;Perjantai;10;9;19
95;05.06.2015;2015;06;09;Perjantai;7;10;17
95;05.06.2015;2015;06;10;Perjantai;12;8;20
95;05.06.2015;2015;06;11;Perjantai;8;13;21
95;05.06.2015;2015;06;12;Perjantai;11;9;20
95;05.06.2015;2015;06;13;Perjantai;13;18;31
95;05.06.2015;2015;06;14;Perjantai;13;18;31
95;05.06.2015;2015;06;15;Perjantai;22;32;54
95;05.06.2015;2015;06;16;Perjantai;10;24;34
95;05.06.2015;2015;06;17;Perjantai;11;15;26
95;05.06.2015;2015;06;18;Perjantai;8;19;27
95;05.06.2015;2015;06;19;Perjantai;7;12;19
95;05.06.2015;2015;06;20;Perjantai;7;12;19
95;05.06.2015;2015;06;21;Perjantai;8;12;20
95;05.06.2015;2015;06;22;Perjantai;6;7;13
95;05.06.2015;2015;06;23;Perjantai;2;0;2
95;06.06.2015;2015;06;00;Lauantai;3;1;4
95;06.06.2015;2015;06;01;Lauantai;0;2;2
95;06.06.2015;2015;06;02;Lauantai;2;0;2
95;06.06.2015;2015;06;03;Lauantai;1;3;4
95;06.06.2015;2015;06;04;Lauantai;1;2;3
95;06.06.2015;2015;06;05;Lauantai;3;0;3
95;06.06.2015;2015;06;06;Lauantai;1;3;4
95;06.06.2015;2015;06;07;Lauantai;4;4;8
95;06.06.2015;2015;06;08;Lauantai;6;11;17
95;06.06.2015;2015;06;09;Lauantai;10;10;20
95;06.06.2015;2015;06;10;Lauantai;15;15;30
95;06.06.2015;2015;06;11;Lauantai;24;18;42
95;06.06.2015;2015;06;12;Lauantai;17;34;51
95;06.06.2015;2015;06;13;Lauantai;20;16;36
95;06.06.2015;2015;06;14;Lauantai;21;15;36
95;06.06.2015;2015;06;15;Lauantai;10;9;19
95;06.06.2015;2015;06;16;Lauantai;4;13;17
95;06.06.2015;2015;06;17;Lauantai;6;19;25
95;06.06.2015;2015;06;18;Lauantai;8;2;10
95;06.06.2015;2015;06;19;Lauantai;5;2;7
95;06.06.2015;2015;06;20;Lauantai;0;2;2
95;06.06.2015;2015;06;21;Lauantai;2;0;2
95;06.06.2015;2015;06;22;Lauantai;2;0;2
95;06.06.2015;2015;06;23;Lauantai;0;0;0
95;07.06.2015;2015;06;00;Sunnuntai;0;0;0
95;07.06.2015;2015;06;01;Sunnuntai;0;0;0
95;07.06.2015;2015;06;02;Sunnuntai;0;2;2
95;07.06.2015;2015;06;03;Sunnuntai;2;2;4
95;07.06.2015;2015;06;04;Sunnuntai;0;0;0
95;07.06.2015;2015;06;05;Sunnuntai;0;0;0
95;07.06.2015;2015;06;06;Sunnuntai;0;0;0
95;07.06.2015;2015;06;07;Sunnuntai;2;1;3
95;07.06.2015;2015;06;08;Sunnuntai;2;1;3
95;07.06.2015;2015;06;09;Sunnuntai;2;1;3
95;07.06.2015;2015;06;10;Sunnuntai;2;0;2
95;07.06.2015;2015;06;11;Sunnuntai;1;3;4
95;07.06.2015;2015;06;12;Sunnuntai;3;2;5
95;07.06.2015;2015;06;13;Sunnuntai;0;0;0
95;07.06.2015;2015;06;14;Sunnuntai;2;2;4
95;07.06.2015;2015;06;15;Sunnuntai;0;0;0
95;07.06.2015;2015;06;16;Sunnuntai;0;1;1
95;07.06.2015;2015;06;17;Sunnuntai;7;2;9
95;07.06.2015;2015;06;18;Sunnuntai;3;3;6
95;07.06.2015;2015;06;19;Sunnuntai;2;0;2
95;07.06.2015;2015;06;20;Sunnuntai;1;2;3
95;07.06.2015;2015;06;21;Sunnuntai;0;1;1
95;07.06.2015;2015;06;22;Sunnuntai;1;1;2
95;07.06.2015;2015;06;23;Sunnuntai;0;0;0
95;08.06.2015;2015;06;00;Maanantai;0;1;1
95;08.06.2015;2015;06;01;Maanantai;0;0;0
95;08.06.2015;2015;06;02;Maanantai;0;0;0
95;08.06.2015;2015;06;03;Maanantai;0;0;0
95;08.06.2015;2015;06;04;Maanantai;1;0;1
95;08.06.2015;2015;06;05;Maanantai;7;3;10
95;08.06.2015;2015;06;06;Maanantai;29;13;42
95;08.06.2015;2015;06;07;Maanantai;25;16;41
95;08.06.2015;2015;06;08;Maanantai;16;8;24
95;08.06.2015;2015;06;09;Maanantai;11;10;21
95;08.06.2015;2015;06;10;Maanantai;13;9;22
95;08.06.2015;2015;06;11;Maanantai;13;8;21
95;08.06.2015;2015;06;12;Maanantai;17;14;31
95;08.06.2015;2015;06;13;Maanantai;12;14;26
95;08.06.2015;2015;06;14;Maanantai;15;20;35
95;08.06.2015;2015;06;15;Maanantai;32;30;62
95;08.06.2015;2015;06;16;Maanantai;21;46;67
95;08.06.2015;2015;06;17;Maanantai;19;22;41
95;08.06.2015;2015;06;18;Maanantai;18;22;40
95;08.06.2015;2015;06;19;Maanantai;15;23;38
95;08.06.2015;2015;06;20;Maanantai;22;14;36
95;08.06.2015;2015;06;21;Maanantai;11;9;20
95;08.06.2015;2015;06;22;Maanantai;4;5;9
95;08.06.2015;2015;06;23;Maanantai;3;1;4
95;09.06.2015;2015;06;00;Tiistai;0;0;0
95;09.06.2015;2015;06;01;Tiistai;0;0;0
95;09.06.2015;2015;06;02;Tiistai;0;0;0
95;09.06.2015;2015;06;03;Tiistai;0;0;0
95;09.06.2015;2015;06;04;Tiistai;1;0;1
95;09.06.2015;2015;06;05;Tiistai;10;4;14
95;09.06.2015;2015;06;06;Tiistai;35;14;49
95;09.06.2015;2015;06;07;Tiistai;36;18;54
95;09.06.2015;2015;06;08;Tiistai;13;12;25
95;09.06.2015;2015;06;09;Tiistai;15;9;24
95;09.06.2015;2015;06;10;Tiistai;14;12;26
95;09.06.2015;2015;06;11;Tiistai;14;20;34
95;09.06.2015;2015;06;12;Tiistai;14;20;34
95;09.06.2015;2015;06;13;Tiistai;15;16;31
95;09.06.2015;2015;06;14;Tiistai;17;18;35
95;09.06.2015;2015;06;15;Tiistai;25;25;50
95;09.06.2015;2015;06;16;Tiistai;25;41;66
95;09.06.2015;2015;06;17;Tiistai;24;44;68
95;09.06.2015;2015;06;18;Tiistai;13;23;36
95;09.06.2015;2015;06;19;Tiistai;18;23;41
95;09.06.2015;2015;06;20;Tiistai;9;10;19
95;09.06.2015;2015;06;21;Tiistai;8;9;17
95;09.06.2015;2015;06;22;Tiistai;1;6;7
95;09.06.2015;2015;06;23;Tiistai;2;3;5
95;10.06.2015;2015;06;00;Keskiviikko;0;3;3
95;10.06.2015;2015;06;01;Keskiviikko;1;0;1
95;10.06.2015;2015;06;02;Keskiviikko;0;0;0
95;10.06.2015;2015;06;03;Keskiviikko;2;0;2
95;10.06.2015;2015;06;04;Keskiviikko;1;0;1
95;10.06.2015;2015;06;05;Keskiviikko;6;1;7
95;10.06.2015;2015;06;06;Keskiviikko;29;14;43
95;10.06.2015;2015;06;07;Keskiviikko;36;17;53
95;10.06.2015;2015;06;08;Keskiviikko;2;3;5
95;10.06.2015;2015;06;09;Keskiviikko;4;4;8
95;10.06.2015;2015;06;10;Keskiviikko;7;2;9
95;10.06.2015;2015;06;11;Keskiviikko;3;8;11
95;10.06.2015;2015;06;12;Keskiviikko;6;1;7
95;10.06.2015;2015;06;13;Keskiviikko;9;8;17
95;10.06.2015;2015;06;14;Keskiviikko;8;13;21
95;10.06.2015;2015;06;15;Keskiviikko;19;25;44
95;10.06.2015;2015;06;16;Keskiviikko;22;32;54
95;10.06.2015;2015;06;17;Keskiviikko;9;17;26
95;10.06.2015;2015;06;18;Keskiviikko;17;14;31
95;10.06.2015;2015;06;19;Keskiviikko;6;12;18
95;10.06.2015;2015;06;20;Keskiviikko;17;14;31
95;10.06.2015;2015;06;21;Keskiviikko;4;10;14
95;10.06.2015;2015;06;22;Keskiviikko;8;2;10
95;10.06.2015;2015;06;23;Keskiviikko;3;3;6
95;11.06.2015;2015;06;00;Torstai;0;3;3
95;11.06.2015;2015;06;01;Torstai;0;0;0
95;11.06.2015;2015;06;02;Torstai;0;0;0
95;11.06.2015;2015;06;03;Torstai;0;1;1
95;11.06.2015;2015;06;04;Torstai;3;1;4
95;11.06.2015;2015;06;05;Torstai;11;2;13
95;11.06.2015;2015;06;06;Torstai;28;16;44
95;11.06.2015;2015;06;07;Torstai;22;17;39
95;11.06.2015;2015;06;08;Torstai;15;11;26
95;11.06.2015;2015;06;09;Torstai;12;6;18
95;11.06.2015;2015;06;10;Torstai;7;13;20
95;11.06.2015;2015;06;11;Torstai;15;15;30
95;11.06.2015;2015;06;12;Torstai;13;14;27
95;11.06.2015;2015;06;13;Torstai;21;17;38
95;11.06.2015;2015;06;14;Torstai;28;33;61
95;11.06.2015;2015;06;15;Torstai;18;29;47
95;11.06.2015;2015;06;16;Torstai;29;29;58
95;11.06.2015;2015;06;17;Torstai;13;26;39
95;11.06.2015;2015;06;18;Torstai;8;20;28
95;11.06.2015;2015;06;19;Torstai;12;20;32
95;11.06.2015;2015;06;20;Torstai;11;7;18
95;11.06.2015;2015;06;21;Torstai;12;4;16
95;11.06.2015;2015;06;22;Torstai;7;8;15
95;11.06.2015;2015;06;23;Torstai;1;3;4
95;12.06.2015;2015;06;00;Perjantai;0;4;4
95;12.06.2015;2015;06;01;Perjantai;0;0;0
95;12.06.2015;2015;06;02;Perjantai;2;0;2
95;12.06.2015;2015;06;03;Perjantai;0;0;0
95;12.06.2015;2015;06;04;Perjantai;1;0;1
95;12.06.2015;2015;06;05;Perjantai;7;2;9
95;12.06.2015;2015;06;06;Perjantai;22;10;32
95;12.06.2015;2015;06;07;Perjantai;28;14;42
95;12.06.2015;2015;06;08;Perjantai;16;9;25
95;12.06.2015;2015;06;09;Perjantai;9;11;20
95;12.06.2015;2015;06;10;Perjantai;7;5;12
95;12.06.2015;2015;06;11;Perjantai;10;5;15
95;12.06.2015;2015;06;12;Perjantai;11;8;19
95;12.06.2015;2015;06;13;Perjantai;11;13;24
95;12.06.2015;2015;06;14;Perjantai;19;23;42
95;12.06.2015;2015;06;15;Perjantai;24;27;51
95;12.06.2015;2015;06;16;Perjantai;18;26;44
95;12.06.2015;2015;06;17;Perjantai;11;25;36
95;12.06.2015;2015;06;18;Perjantai;8;18;26
95;12.06.2015;2015;06;19;Perjantai;9;22;31
95;12.06.2015;2015;06;20;Perjantai;6;11;17
95;12.06.2015;2015;06;21;Perjantai;10;5;15
95;12.06.2015;2015;06;22;Perjantai;6;5;11
95;12.06.2015;2015;06;23;Perjantai;1;3;4
95;13.06.2015;2015;06;00;Lauantai;2;2;4
95;13.06.2015;2015;06;01;Lauantai;0;1;1
95;13.06.2015;2015;06;02;Lauantai;1;2;3
95;13.06.2015;2015;06;03;Lauantai;0;0;0
95;13.06.2015;2015;06;04;Lauantai;1;2;3
95;13.06.2015;2015;06;05;Lauantai;3;1;4
95;13.06.2015;2015;06;06;Lauantai;1;2;3
95;13.06.2015;2015;06;07;Lauantai;4;4;8
95;13.06.2015;2015;06;08;Lauantai;6;2;8
95;13.06.2015;2015;06;09;Lauantai;7;14;21
95;13.06.2015;2015;06;10;Lauantai;2;5;7
95;13.06.2015;2015;06;11;Lauantai;1;2;3
95;13.06.2015;2015;06;12;Lauantai;9;5;14
95;13.06.2015;2015;06;13;Lauantai;13;4;17
95;13.06.2015;2015;06;14;Lauantai;5;11;16
95;13.06.2015;2015;06;15;Lauantai;18;22;40
95;13.06.2015;2015;06;16;Lauantai;18;10;28
95;13.06.2015;2015;06;17;Lauantai;13;25;38
95;13.06.2015;2015;06;18;Lauantai;17;14;31
95;13.06.2015;2015;06;19;Lauantai;11;10;21
95;13.06.2015;2015;06;20;Lauantai;9;15;24
95;13.06.2015;2015;06;21;Lauantai;4;7;11
95;13.06.2015;2015;06;22;Lauantai;4;7;11
95;13.06.2015;2015;06;23;Lauantai;0;5;5
95;14.06.2015;2015;06;00;Sunnuntai;0;0;0
95;14.06.2015;2015;06;01;Sunnuntai;2;1;3
95;14.06.2015;2015;06;02;Sunnuntai;0;1;1
95;14.06.2015;2015;06;03;Sunnuntai;0;0;0
95;14.06.2015;2015;06;04;Sunnuntai;0;1;1
95;14.06.2015;2015;06;05;Sunnuntai;3;0;3
95;14.06.2015;2015;06;06;Sunnuntai;2;3;5
95;14.06.2015;2015;06;07;Sunnuntai;5;4;9
95;14.06.2015;2015;06;08;Sunnuntai;5;5;10
95;14.06.2015;2015;06;09;Sunnuntai;22;14;36
95;14.06.2015;2015;06;10;Sunnuntai;15;45;60
95;14.06.2015;2015;06;11;Sunnuntai;27;27;54
95;14.06.2015;2015;06;12;Sunnuntai;38;26;64
95;14.06.2015;2015;06;13;Sunnuntai;25;24;49
95;14.06.2015;2015;06;14;Sunnuntai;16;26;42
95;14.06.2015;2015;06;15;Sunnuntai;22;18;40
95;14.06.2015;2015;06;16;Sunnuntai;27;16;43
95;14.06.2015;2015;06;17;Sunnuntai;19;13;32
95;14.06.2015;2015;06;18;Sunnuntai;15;15;30
95;14.06.2015;2015;06;19;Sunnuntai;15;21;36
95;14.06.2015;2015;06;20;Sunnuntai;13;9;22
95;14.06.2015;2015;06;21;Sunnuntai;3;4;7
95;14.06.2015;2015;06;22;Sunnuntai;3;3;6
95;14.06.2015;2015;06;23;Sunnuntai;2;0;2
95;15.06.2015;2015;06;00;Maanantai;0;1;1
95;15.06.2015;2015;06;01;Maanantai;0;1;1
95;15.06.2015;2015;06;02;Maanantai;0;0;0
95;15.06.2015;2015;06;03;Maanantai;0;1;1
95;15.06.2015;2015;06;04;Maanantai;1;0;1
95;15.06.2015;2015;06;05;Maanantai;4;1;5
95;15.06.2015;2015;06;06;Maanantai;5;5;10
95;15.06.2015;2015;06;07;Maanantai;8;6;14
95;15.06.2015;2015;06;08;Maanantai;9;2;11
95;15.06.2015;2015;06;09;Maanantai;3;3;6
95;15.06.2015;2015;06;10;Maanantai;2;2;4
95;15.06.2015;2015;06;11;Maanantai;1;2;3
95;15.06.2015;2015;06;12;Maanantai;2;2;4
95;15.06.2015;2015;06;13;Maanantai;8;4;12
95;15.06.2015;2015;06;14;Maanantai;2;8;10
95;15.06.2015;2015;06;15;Maanantai;4;5;9
95;15.06.2015;2015;06;16;Maanantai;6;7;13
95;15.06.2015;2015;06;17;Maanantai;6;6;12
95;15.06.2015;2015;06;18;Maanantai;1;5;6
95;15.06.2015;2015;06;19;Maanantai;1;1;2
95;15.06.2015;2015;06;20;Maanantai;4;2;6
95;15.06.2015;2015;06;21;Maanantai;0;2;2
95;15.06.2015;2015;06;22;Maanantai;2;3;5
95;15.06.2015;2015;06;23;Maanantai;1;0;1
95;16.06.2015;2015;06;00;Tiistai;0;0;0
95;16.06.2015;2015;06;01;Tiistai;0;0;0
95;16.06.2015;2015;06;02;Tiistai;0;0;0
95;16.06.2015;2015;06;03;Tiistai;0;0;0
95;16.06.2015;2015;06;04;Tiistai;2;0;2
95;16.06.2015;2015;06;05;Tiistai;6;1;7
95;16.06.2015;2015;06;06;Tiistai;21;11;32
95;16.06.2015;2015;06;07;Tiistai;15;10;25
95;16.06.2015;2015;06;08;Tiistai;3;5;8
95;16.06.2015;2015;06;09;Tiistai;2;1;3
95;16.06.2015;2015;06;10;Tiistai;5;5;10
95;16.06.2015;2015;06;11;Tiistai;8;7;15
95;16.06.2015;2015;06;12;Tiistai;4;2;6
95;16.06.2015;2015;06;13;Tiistai;7;9;16
95;16.06.2015;2015;06;14;Tiistai;15;3;18
95;16.06.2015;2015;06;15;Tiistai;11;14;25
95;16.06.2015;2015;06;16;Tiistai;12;12;24
95;16.06.2015;2015;06;17;Tiistai;7;11;18
95;16.06.2015;2015;06;18;Tiistai;3;5;8
95;16.06.2015;2015;06;19;Tiistai;4;4;8
95;16.06.2015;2015;06;20;Tiistai;2;2;4
95;16.06.2015;2015;06;21;Tiistai;3;5;8
95;16.06.2015;2015;06;22;Tiistai;1;6;7
95;16.06.2015;2015;06;23;Tiistai;5;0;5
95;17.06.2015;2015;06;00;Keskiviikko;0;1;1
95;17.06.2015;2015;06;01;Keskiviikko;0;0;0
95;17.06.2015;2015;06;02;Keskiviikko;0;0;0
95;17.06.2015;2015;06;03;Keskiviikko;1;0;1
95;17.06.2015;2015;06;04;Keskiviikko;1;0;1
95;17.06.2015;2015;06;05;Keskiviikko;4;1;5
95;17.06.2015;2015;06;06;Keskiviikko;15;17;32
95;17.06.2015;2015;06;07;Keskiviikko;17;16;33
95;17.06.2015;2015;06;08;Keskiviikko;11;11;22
95;17.06.2015;2015;06;09;Keskiviikko;14;6;20
95;17.06.2015;2015;06;10;Keskiviikko;12;6;18
95;17.06.2015;2015;06;11;Keskiviikko;15;5;20
95;17.06.2015;2015;06;12;Keskiviikko;7;12;19
95;17.06.2015;2015;06;13;Keskiviikko;14;11;25
95;17.06.2015;2015;06;14;Keskiviikko;11;19;30
95;17.06.2015;2015;06;15;Keskiviikko;28;19;47
95;17.06.2015;2015;06;16;Keskiviikko;25;26;51
95;17.06.2015;2015;06;17;Keskiviikko;17;29;46
95;17.06.2015;2015;06;18;Keskiviikko;14;17;31
95;17.06.2015;2015;06;19;Keskiviikko;16;21;37
95;17.06.2015;2015;06;20;Keskiviikko;14;17;31
95;17.06.2015;2015;06;21;Keskiviikko;7;14;21
95;17.06.2015;2015;06;22;Keskiviikko;3;2;5
95;17.06.2015;2015;06;23;Keskiviikko;0;1;1
95;18.06.2015;2015;06;00;Torstai;1;0;1
95;18.06.2015;2015;06;01;Torstai;0;0;0
95;18.06.2015;2015;06;02;Torstai;0;1;1
95;18.06.2015;2015;06;03;Torstai;0;0;0
95;18.06.2015;2015;06;04;Torstai;2;0;2
95;18.06.2015;2015;06;05;Torstai;3;0;3
95;18.06.2015;2015;06;06;Torstai;20;9;29
95;18.06.2015;2015;06;07;Torstai;20;21;41
95;18.06.2015;2015;06;08;Torstai;16;15;31
95;18.06.2015;2015;06;09;Torstai;11;9;20
95;18.06.2015;2015;06;10;Torstai;9;10;19
95;18.06.2015;2015;06;11;Torstai;9;12;21
95;18.06.2015;2015;06;12;Torstai;10;12;22
95;18.06.2015;2015;06;13;Torstai;14;14;28
95;18.06.2015;2015;06;14;Torstai;14;20;34
95;18.06.2015;2015;06;15;Torstai;17;28;45
95;18.06.2015;2015;06;16;Torstai;25;29;54
95;18.06.2015;2015;06;17;Torstai;26;16;42
95;18.06.2015;2015;06;18;Torstai;19;15;34
95;18.06.2015;2015;06;19;Torstai;13;10;23
95;18.06.2015;2015;06;20;Torstai;5;12;17
95;18.06.2015;2015;06;21;Torstai;7;12;19
95;18.06.2015;2015;06;22;Torstai;0;5;5
95;18.06.2015;2015;06;23;Torstai;1;0;1
95;19.06.2015;2015;06;00;Perjantai;0;2;2
95;19.06.2015;2015;06;01;Perjantai;2;1;3
95;19.06.2015;2015;06;02;Perjantai;0;0;0
95;19.06.2015;2015;06;03;Perjantai;1;0;1
95;19.06.2015;2015;06;04;Perjantai;0;0;0
95;19.06.2015;2015;06;05;Perjantai;0;1;1
95;19.06.2015;2015;06;06;Perjantai;2;3;5
95;19.06.2015;2015;06;07;Perjantai;1;5;6
95;19.06.2015;2015;06;08;Perjantai;5;9;14
95;19.06.2015;2015;06;09;Perjantai;8;7;15
95;19.06.2015;2015;06;10;Perjantai;12;10;22
95;19.06.2015;2015;06;11;Perjantai;12;15;27
95;19.06.2015;2015;06;12;Perjantai;11;16;27
95;19.06.2015;2015;06;13;Perjantai;13;18;31
95;19.06.2015;2015;06;14;Perjantai;13;2;15
95;19.06.2015;2015;06;15;Perjantai;12;21;33
95;19.06.2015;2015;06;16;Perjantai;22;7;29
95;19.06.2015;2015;06;17;Perjantai;8;15;23
95;19.06.2015;2015;06;18;Perjantai;11;13;24
95;19.06.2015;2015;06;19;Perjantai;12;17;29
95;19.06.2015;2015;06;20;Perjantai;5;5;10
95;19.06.2015;2015;06;21;Perjantai;7;1;8
95;19.06.2015;2015;06;22;Perjantai;5;11;16
95;19.06.2015;2015;06;23;Perjantai;4;5;9
95;20.06.2015;2015;06;00;Lauantai;0;5;5
95;20.06.2015;2015;06;01;Lauantai;0;0;0
95;20.06.2015;2015;06;02;Lauantai;1;1;2
95;20.06.2015;2015;06;03;Lauantai;1;0;1
95;20.06.2015;2015;06;04;Lauantai;1;2;3
95;20.06.2015;2015;06;05;Lauantai;0;0;0
95;20.06.2015;2015;06;06;Lauantai;1;4;5
95;20.06.2015;2015;06;07;Lauantai;0;1;1
95;20.06.2015;2015;06;08;Lauantai;4;3;7
95;20.06.2015;2015;06;09;Lauantai;7;9;16
95;20.06.2015;2015;06;10;Lauantai;12;13;25
95;20.06.2015;2015;06;11;Lauantai;19;14;33
95;20.06.2015;2015;06;12;Lauantai;20;14;34
95;20.06.2015;2015;06;13;Lauantai;26;10;36
95;20.06.2015;2015;06;14;Lauantai;13;23;36
95;20.06.2015;2015;06;15;Lauantai;15;15;30
95;20.06.2015;2015;06;16;Lauantai;13;19;32
95;20.06.2015;2015;06;17;Lauantai;22;20;42
95;20.06.2015;2015;06;18;Lauantai;12;12;24
95;20.06.2015;2015;06;19;Lauantai;15;21;36
95;20.06.2015;2015;06;20;Lauantai;18;12;30
95;20.06.2015;2015;06;21;Lauantai;6;6;12
95;20.06.2015;2015;06;22;Lauantai;6;12;18
95;20.06.2015;2015;06;23;Lauantai;0;5;5
95;21.06.2015;2015;06;00;Sunnuntai;4;1;5
95;21.06.2015;2015;06;01;Sunnuntai;1;2;3
95;21.06.2015;2015;06;02;Sunnuntai;0;2;2
95;21.06.2015;2015;06;03;Sunnuntai;0;3;3
95;21.06.2015;2015;06;04;Sunnuntai;1;0;1
95;21.06.2015;2015;06;05;Sunnuntai;0;0;0
95;21.06.2015;2015;06;06;Sunnuntai;1;2;3
95;21.06.2015;2015;06;07;Sunnuntai;0;3;3
95;21.06.2015;2015;06;08;Sunnuntai;1;0;1
95;21.06.2015;2015;06;09;Sunnuntai;5;3;8
95;21.06.2015;2015;06;10;Sunnuntai;2;5;7
95;21.06.2015;2015;06;11;Sunnuntai;4;4;8
95;21.06.2015;2015;06;12;Sunnuntai;11;7;18
95;21.06.2015;2015;06;13;Sunnuntai;11;11;22
95;21.06.2015;2015;06;14;Sunnuntai;13;9;22
95;21.06.2015;2015;06;15;Sunnuntai;7;23;30
95;21.06.2015;2015;06;16;Sunnuntai;13;10;23
95;21.06.2015;2015;06;17;Sunnuntai;32;22;54
95;21.06.2015;2015;06;18;Sunnuntai;17;24;41
95;21.06.2015;2015;06;19;Sunnuntai;27;28;55
95;21.06.2015;2015;06;20;Sunnuntai;12;11;23
95;21.06.2015;2015;06;21;Sunnuntai;9;6;15
95;21.06.2015;2015;06;22;Sunnuntai;5;4;9
95;21.06.2015;2015;06;23;Sunnuntai;1;4;5
95;22.06.2015;2015;06;00;Maanantai;2;0;2
95;22.06.2015;2015;06;01;Maanantai;0;2;2
95;22.06.2015;2015;06;02;Maanantai;0;0;0
95;22.06.2015;2015;06;03;Maanantai;0;0;0
95;22.06.2015;2015;06;04;Maanantai;2;1;3
95;22.06.2015;2015;06;05;Maanantai;8;3;11
95;22.06.2015;2015;06;06;Maanantai;26;17;43
95;22.06.2015;2015;06;07;Maanantai;33;22;55
95;22.06.2015;2015;06;08;Maanantai;28;20;48
95;22.06.2015;2015;06;09;Maanantai;16;13;29
95;22.06.2015;2015;06;10;Maanantai;15;20;35
95;22.06.2015;2015;06;11;Maanantai;28;18;46
95;22.06.2015;2015;06;12;Maanantai;28;18;46
95;22.06.2015;2015;06;13;Maanantai;23;25;48
95;22.06.2015;2015;06;14;Maanantai;24;35;59
95;22.06.2015;2015;06;15;Maanantai;35;34;69
95;22.06.2015;2015;06;16;Maanantai;24;48;72
95;22.06.2015;2015;06;17;Maanantai;28;36;64
95;22.06.2015;2015;06;18;Maanantai;24;27;51
95;22.06.2015;2015;06;19;Maanantai;21;25;46
95;22.06.2015;2015;06;20;Maanantai;12;7;19
95;22.06.2015;2015;06;21;Maanantai;5;2;7
95;22.06.2015;2015;06;22;Maanantai;2;1;3
95;22.06.2015;2015;06;23;Maanantai;1;1;2
95;23.06.2015;2015;06;00;Tiistai;0;2;2
95;23.06.2015;2015;06;01;Tiistai;1;0;1
95;23.06.2015;2015;06;02;Tiistai;0;0;0
95;23.06.2015;2015;06;03;Tiistai;0;0;0
95;23.06.2015;2015;06;04;Tiistai;0;1;1
95;23.06.2015;2015;06;05;Tiistai;6;3;9
95;23.06.2015;2015;06;06;Tiistai;13;12;25
95;23.06.2015;2015;06;07;Tiistai;14;7;21
95;23.06.2015;2015;06;08;Tiistai;7;10;17
95;23.06.2015;2015;06;09;Tiistai;4;3;7
95;23.06.2015;2015;06;10;Tiistai;2;4;6
95;23.06.2015;2015;06;11;Tiistai;3;1;4
95;23.06.2015;2015;06;12;Tiistai;0;2;2
95;23.06.2015;2015;06;13;Tiistai;1;1;2
95;23.06.2015;2015;06;14;Tiistai;5;3;8
95;23.06.2015;2015;06;15;Tiistai;9;5;14
95;23.06.2015;2015;06;16;Tiistai;11;10;21
95;23.06.2015;2015;06;17;Tiistai;5;11;16
95;23.06.2015;2015;06;18;Tiistai;2;6;8
95;23.06.2015;2015;06;19;Tiistai;3;4;7
95;23.06.2015;2015;06;20;Tiistai;5;5;10
95;23.06.2015;2015;06;21;Tiistai;0;2;2
95;23.06.2015;2015;06;22;Tiistai;0;0;0
95;23.06.2015;2015;06;23;Tiistai;0;2;2
95;24.06.2015;2015;06;00;Keskiviikko;0;0;0
95;24.06.2015;2015;06;01;Keskiviikko;0;0;0
95;24.06.2015;2015;06;02;Keskiviikko;0;0;0
95;24.06.2015;2015;06;03;Keskiviikko;0;0;0
95;24.06.2015;2015;06;04;Keskiviikko;2;0;2
95;24.06.2015;2015;06;05;Keskiviikko;4;1;5
95;24.06.2015;2015;06;06;Keskiviikko;13;14;27
95;24.06.2015;2015;06;07;Keskiviikko;18;10;28
95;24.06.2015;2015;06;08;Keskiviikko;9;9;18
95;24.06.2015;2015;06;09;Keskiviikko;18;9;27
95;24.06.2015;2015;06;10;Keskiviikko;13;13;26
95;24.06.2015;2015;06;11;Keskiviikko;9;8;17
95;24.06.2015;2015;06;12;Keskiviikko;9;10;19
95;24.06.2015;2015;06;13;Keskiviikko;7;5;12
95;24.06.2015;2015;06;14;Keskiviikko;11;5;16
95;24.06.2015;2015;06;15;Keskiviikko;15;9;24
95;24.06.2015;2015;06;16;Keskiviikko;5;6;11
95;24.06.2015;2015;06;17;Keskiviikko;5;12;17
95;24.06.2015;2015;06;18;Keskiviikko;1;5;6
95;24.06.2015;2015;06;19;Keskiviikko;6;14;20
95;24.06.2015;2015;06;20;Keskiviikko;6;5;11
95;24.06.2015;2015;06;21;Keskiviikko;2;1;3
95;24.06.2015;2015;06;22;Keskiviikko;1;8;9
95;24.06.2015;2015;06;23;Keskiviikko;1;0;1
95;25.06.2015;2015;06;00;Torstai;1;1;2
95;25.06.2015;2015;06;01;Torstai;0;1;1
95;25.06.2015;2015;06;02;Torstai;0;1;1
95;25.06.2015;2015;06;03;Torstai;0;0;0
95;25.06.2015;2015;06;04;Torstai;2;1;3
95;25.06.2015;2015;06;05;Torstai;2;3;5
95;25.06.2015;2015;06;06;Torstai;11;8;19
95;25.06.2015;2015;06;07;Torstai;11;7;18
95;25.06.2015;2015;06;08;Torstai;6;1;7
95;25.06.2015;2015;06;09;Torstai;6;4;10
95;25.06.2015;2015;06;10;Torstai;1;4;5
95;25.06.2015;2015;06;11;Torstai;2;2;4
95;25.06.2015;2015;06;12;Torstai;1;2;3
95;25.06.2015;2015;06;13;Torstai;1;4;5
95;25.06.2015;2015;06;14;Torstai;5;4;9
95;25.06.2015;2015;06;15;Torstai;9;6;15
95;25.06.2015;2015;06;16;Torstai;9;11;20
95;25.06.2015;2015;06;17;Torstai;6;10;16
95;25.06.2015;2015;06;18;Torstai;12;11;23
95;25.06.2015;2015;06;19;Torstai;8;12;20
95;25.06.2015;2015;06;20;Torstai;6;11;17
95;25.06.2015;2015;06;21;Torstai;7;3;10
95;25.06.2015;2015;06;22;Torstai;1;1;2
95;25.06.2015;2015;06;23;Torstai;0;0;0
95;26.06.2015;2015;06;00;Perjantai;0;0;0
95;26.06.2015;2015;06;01;Perjantai;0;0;0
95;26.06.2015;2015;06;02;Perjantai;0;0;0
95;26.06.2015;2015;06;03;Perjantai;0;0;0
95;26.06.2015;2015;06;04;Perjantai;3;0;3
95;26.06.2015;2015;06;05;Perjantai;5;2;7
95;26.06.2015;2015;06;06;Perjantai;12;11;23
95;26.06.2015;2015;06;07;Perjantai;23;10;33
95;26.06.2015;2015;06;08;Perjantai;7;3;10
95;26.06.2015;2015;06;09;Perjantai;13;5;18
95;26.06.2015;2015;06;10;Perjantai;14;7;21
95;26.06.2015;2015;06;11;Perjantai;3;14;17
95;26.06.2015;2015;06;12;Perjantai;11;6;17
95;26.06.2015;2015;06;13;Perjantai;9;11;20
95;26.06.2015;2015;06;14;Perjantai;16;21;37
95;26.06.2015;2015;06;15;Perjantai;15;20;35
95;26.06.2015;2015;06;16;Perjantai;12;19;31
95;26.06.2015;2015;06;17;Perjantai;10;27;37
95;26.06.2015;2015;06;18;Perjantai;17;16;33
95;26.06.2015;2015;06;19;Perjantai;13;12;25
95;26.06.2015;2015;06;20;Perjantai;10;4;14
95;26.06.2015;2015;06;21;Perjantai;6;2;8
95;26.06.2015;2015;06;22;Perjantai;4;8;12
95;26.06.2015;2015;06;23;Perjantai;0;4;4
95;27.06.2015;2015;06;00;Lauantai;0;2;2
95;27.06.2015;2015;06;01;Lauantai;0;2;2
95;27.06.2015;2015;06;02;Lauantai;3;0;3
95;27.06.2015;2015;06;03;Lauantai;1;0;1
95;27.06.2015;2015;06;04;Lauantai;2;0;2
95;27.06.2015;2015;06;05;Lauantai;0;1;1
95;27.06.2015;2015;06;06;Lauantai;1;3;4
95;27.06.2015;2015;06;07;Lauantai;1;3;4
95;27.06.2015;2015;06;08;Lauantai;9;3;12
95;27.06.2015;2015;06;09;Lauantai;6;5;11
95;27.06.2015;2015;06;10;Lauantai;4;7;11
95;27.06.2015;2015;06;11;Lauantai;6;19;25
95;27.06.2015;2015;06;12;Lauantai;7;3;10
95;27.06.2015;2015;06;13;Lauantai;11;4;15
95;27.06.2015;2015;06;14;Lauantai;13;16;29
95;27.06.2015;2015;06;15;Lauantai;2;11;13
95;27.06.2015;2015;06;16;Lauantai;11;7;18
95;27.06.2015;2015;06;17;Lauantai;10;16;26
95;27.06.2015;2015;06;18;Lauantai;7;12;19
95;27.06.2015;2015;06;19;Lauantai;11;4;15
95;27.06.2015;2015;06;20;Lauantai;4;3;7
95;27.06.2015;2015;06;21;Lauantai;2;7;9
95;27.06.2015;2015;06;22;Lauantai;0;0;0
95;27.06.2015;2015;06;23;Lauantai;3;2;5
95;28.06.2015;2015;06;00;Sunnuntai;0;0;0
95;28.06.2015;2015;06;01;Sunnuntai;0;0;0
95;28.06.2015;2015;06;02;Sunnuntai;0;1;1
95;28.06.2015;2015;06;03;Sunnuntai;0;1;1
95;28.06.2015;2015;06;04;Sunnuntai;2;0;2
95;28.06.2015;2015;06;05;Sunnuntai;2;1;3
95;28.06.2015;2015;06;06;Sunnuntai;2;2;4
95;28.06.2015;2015;06;07;Sunnuntai;4;6;10
95;28.06.2015;2015;06;08;Sunnuntai;5;9;14
95;28.06.2015;2015;06;09;Sunnuntai;12;13;25
95;28.06.2015;2015;06;10;Sunnuntai;19;16;35
95;28.06.2015;2015;06;11;Sunnuntai;29;30;59
95;28.06.2015;2015;06;12;Sunnuntai;28;21;49
95;28.06.2015;2015;06;13;Sunnuntai;27;20;47
95;28.06.2015;2015;06;14;Sunnuntai;27;21;48
95;28.06.2015;2015;06;15;Sunnuntai;16;24;40
95;28.06.2015;2015;06;16;Sunnuntai;16;29;45
95;28.06.2015;2015;06;17;Sunnuntai;28;33;61
95;28.06.2015;2015;06;18;Sunnuntai;20;32;52
95;28.06.2015;2015;06;19;Sunnuntai;21;24;45
95;28.06.2015;2015;06;20;Sunnuntai;24;24;48
95;28.06.2015;2015;06;21;Sunnuntai;3;5;8
95;28.06.2015;2015;06;22;Sunnuntai;2;4;6
95;28.06.2015;2015;06;23;Sunnuntai;1;1;2
95;29.06.2015;2015;06;00;Maanantai;0;0;0
95;29.06.2015;2015;06;01;Maanantai;0;0;0
95;29.06.2015;2015;06;02;Maanantai;0;0;0
95;29.06.2015;2015;06;03;Maanantai;0;0;0
95;29.06.2015;2015;06;04;Maanantai;1;0;1
95;29.06.2015;2015;06;05;Maanantai;5;2;7
95;29.06.2015;2015;06;06;Maanantai;19;15;34
95;29.06.2015;2015;06;07;Maanantai;41;19;60
95;29.06.2015;2015;06;08;Maanantai;21;8;29
95;29.06.2015;2015;06;09;Maanantai;15;12;27
95;29.06.2015;2015;06;10;Maanantai;12;23;35
95;29.06.2015;2015;06;11;Maanantai;19;15;34
95;29.06.2015;2015;06;12;Maanantai;22;21;43
95;29.06.2015;2015;06;13;Maanantai;16;16;32
95;29.06.2015;2015;06;14;Maanantai;19;29;48
95;29.06.2015;2015;06;15;Maanantai;28;34;62
95;29.06.2015;2015;06;16;Maanantai;35;50;85
95;29.06.2015;2015;06;17;Maanantai;21;27;48
95;29.06.2015;2015;06;18;Maanantai;27;40;67
95;29.06.2015;2015;06;19;Maanantai;19;32;51
95;29.06.2015;2015;06;20;Maanantai;11;10;21
95;29.06.2015;2015;06;21;Maanantai;11;13;24
95;29.06.2015;2015;06;22;Maanantai;3;7;10
95;29.06.2015;2015;06;23;Maanantai;0;0;0
95;30.06.2015;2015;06;00;Tiistai;1;4;5
95;30.06.2015;2015;06;01;Tiistai;0;1;1
95;30.06.2015;2015;06;02;Tiistai;0;0;0
95;30.06.2015;2015;06;03;Tiistai;0;0;0
95;30.06.2015;2015;06;04;Tiistai;0;1;1
95;30.06.2015;2015;06;05;Tiistai;3;2;5
95;30.06.2015;2015;06;06;Tiistai;13;12;25
95;30.06.2015;2015;06;07;Tiistai;22;10;32
95;30.06.2015;2015;06;08;Tiistai;9;4;13
95;30.06.2015;2015;06;09;Tiistai;6;5;11
95;30.06.2015;2015;06;10;Tiistai;7;16;23
95;30.06.2015;2015;06;11;Tiistai;14;10;24
95;30.06.2015;2015;06;12;Tiistai;8;12;20
95;30.06.2015;2015;06;13;Tiistai;4;8;12
95;30.06.2015;2015;06;14;Tiistai;9;10;19
95;30.06.2015;2015;06;15;Tiistai;12;13;25
95;30.06.2015;2015;06;16;Tiistai;16;33;49
95;30.06.2015;2015;06;17;Tiistai;9;15;24
95;30.06.2015;2015;06;18;Tiistai;17;14;31
95;30.06.2015;2015;06;19;Tiistai;15;16;31
95;30.06.2015;2015;06;20;Tiistai;10;13;23
95;30.06.2015;2015;06;21;Tiistai;5;8;13
95;30.06.2015;2015;06;22;Tiistai;3;8;11
95;30.06.2015;2015;06;23;Tiistai;0;1;1
95;01.07.2015;2015;07;00;Keskiviikko;1;1;2
95;01.07.2015;2015;07;01;Keskiviikko;0;2;2
95;01.07.2015;2015;07;02;Keskiviikko;1;0;1
95;01.07.2015;2015;07;03;Keskiviikko;0;0;0
95;01.07.2015;2015;07;04;Keskiviikko;3;1;4
95;01.07.2015;2015;07;05;Keskiviikko;7;4;11
95;01.07.2015;2015;07;06;Keskiviikko;23;17;40
95;01.07.2015;2015;07;07;Keskiviikko;39;12;51
95;01.07.2015;2015;07;08;Keskiviikko;25;19;44
95;01.07.2015;2015;07;09;Keskiviikko;22;13;35
95;01.07.2015;2015;07;10;Keskiviikko;18;23;41
95;01.07.2015;2015;07;11;Keskiviikko;31;19;50
95;01.07.2015;2015;07;12;Keskiviikko;39;23;62
95;01.07.2015;2015;07;13;Keskiviikko;44;27;71
95;01.07.2015;2015;07;14;Keskiviikko;27;25;52
95;01.07.2015;2015;07;15;Keskiviikko;33;43;76
95;01.07.2015;2015;07;16;Keskiviikko;30;61;91
95;01.07.2015;2015;07;17;Keskiviikko;31;46;77
95;01.07.2015;2015;07;18;Keskiviikko;26;41;67
95;01.07.2015;2015;07;19;Keskiviikko;37;40;77
95;01.07.2015;2015;07;20;Keskiviikko;27;27;54
95;01.07.2015;2015;07;21;Keskiviikko;16;12;28
95;01.07.2015;2015;07;22;Keskiviikko;7;6;13
95;01.07.2015;2015;07;23;Keskiviikko;2;1;3
95;02.07.2015;2015;07;00;Torstai;0;6;6
95;02.07.2015;2015;07;01;Torstai;1;2;3
95;02.07.2015;2015;07;02;Torstai;1;1;2
95;02.07.2015;2015;07;03;Torstai;0;1;1
95;02.07.2015;2015;07;04;Torstai;5;0;5
95;02.07.2015;2015;07;05;Torstai;8;3;11
95;02.07.2015;2015;07;06;Torstai;19;10;29
95;02.07.2015;2015;07;07;Torstai;24;12;36
95;02.07.2015;2015;07;08;Torstai;18;14;32
95;02.07.2015;2015;07;09;Torstai;12;4;16
95;02.07.2015;2015;07;10;Torstai;16;21;37
95;02.07.2015;2015;07;11;Torstai;22;18;40
95;02.07.2015;2015;07;12;Torstai;18;21;39
95;02.07.2015;2015;07;13;Torstai;20;18;38
95;02.07.2015;2015;07;14;Torstai;20;21;41
95;02.07.2015;2015;07;15;Torstai;25;37;62
95;02.07.2015;2015;07;16;Torstai;17;30;47
95;02.07.2015;2015;07;17;Torstai;17;35;52
95;02.07.2015;2015;07;18;Torstai;11;18;29
95;02.07.2015;2015;07;19;Torstai;4;9;13
95;02.07.2015;2015;07;20;Torstai;3;4;7
95;02.07.2015;2015;07;21;Torstai;3;9;12
95;02.07.2015;2015;07;22;Torstai;3;1;4
95;02.07.2015;2015;07;23;Torstai;1;0;1
95;03.07.2015;2015;07;00;Perjantai;1;2;3
95;03.07.2015;2015;07;01;Perjantai;0;1;1
95;03.07.2015;2015;07;02;Perjantai;1;0;1
95;03.07.2015;2015;07;03;Perjantai;0;1;1
95;03.07.2015;2015;07;04;Perjantai;0;0;0
95;03.07.2015;2015;07;05;Perjantai;6;0;6
95;03.07.2015;2015;07;06;Perjantai;18;11;29
95;03.07.2015;2015;07;07;Perjantai;19;14;33
95;03.07.2015;2015;07;08;Perjantai;13;11;24
95;03.07.2015;2015;07;09;Perjantai;11;13;24
95;03.07.2015;2015;07;10;Perjantai;25;18;43
95;03.07.2015;2015;07;11;Perjantai;20;21;41
95;03.07.2015;2015;07;12;Perjantai;32;19;51
95;03.07.2015;2015;07;13;Perjantai;25;22;47
95;03.07.2015;2015;07;14;Perjantai;27;25;52
95;03.07.2015;2015;07;15;Perjantai;30;27;57
95;03.07.2015;2015;07;16;Perjantai;30;26;56
95;03.07.2015;2015;07;17;Perjantai;26;26;52
95;03.07.2015;2015;07;18;Perjantai;8;26;34
95;03.07.2015;2015;07;19;Perjantai;16;19;35
95;03.07.2015;2015;07;20;Perjantai;5;10;15
95;03.07.2015;2015;07;21;Perjantai;3;9;12
95;03.07.2015;2015;07;22;Perjantai;0;3;3
95;03.07.2015;2015;07;23;Perjantai;0;3;3
95;04.07.2015;2015;07;00;Lauantai;1;0;1
95;04.07.2015;2015;07;01;Lauantai;0;3;3
95;04.07.2015;2015;07;02;Lauantai;0;0;0
95;04.07.2015;2015;07;03;Lauantai;0;2;2
95;04.07.2015;2015;07;04;Lauantai;0;1;1
95;04.07.2015;2015;07;05;Lauantai;2;1;3
95;04.07.2015;2015;07;06;Lauantai;2;2;4
95;04.07.2015;2015;07;07;Lauantai;1;3;4
95;04.07.2015;2015;07;08;Lauantai;1;4;5
95;04.07.2015;2015;07;09;Lauantai;3;3;6
95;04.07.2015;2015;07;10;Lauantai;4;2;6
95;04.07.2015;2015;07;11;Lauantai;4;4;8
95;04.07.2015;2015;07;12;Lauantai;2;3;5
95;04.07.2015;2015;07;13;Lauantai;3;6;9
95;04.07.2015;2015;07;14;Lauantai;5;7;12
95;04.07.2015;2015;07;15;Lauantai;13;11;24
95;04.07.2015;2015;07;16;Lauantai;17;17;34
95;04.07.2015;2015;07;17;Lauantai;10;15;25
95;04.07.2015;2015;07;18;Lauantai;13;15;28
95;04.07.2015;2015;07;19;Lauantai;5;11;16
95;04.07.2015;2015;07;20;Lauantai;4;5;9
95;04.07.2015;2015;07;21;Lauantai;8;9;17
95;04.07.2015;2015;07;22;Lauantai;3;1;4
95;04.07.2015;2015;07;23;Lauantai;0;2;2
95;05.07.2015;2015;07;00;Sunnuntai;1;1;2
95;05.07.2015;2015;07;01;Sunnuntai;2;2;4
95;05.07.2015;2015;07;02;Sunnuntai;0;1;1
95;05.07.2015;2015;07;03;Sunnuntai;0;0;0
95;05.07.2015;2015;07;04;Sunnuntai;3;0;3
95;05.07.2015;2015;07;05;Sunnuntai;0;0;0
95;05.07.2015;2015;07;06;Sunnuntai;3;3;6
95;05.07.2015;2015;07;07;Sunnuntai;4;2;6
95;05.07.2015;2015;07;08;Sunnuntai;12;4;16
95;05.07.2015;2015;07;09;Sunnuntai;15;8;23
95;05.07.2015;2015;07;10;Sunnuntai;15;27;42
95;05.07.2015;2015;07;11;Sunnuntai;15;29;44
95;05.07.2015;2015;07;12;Sunnuntai;29;26;55
95;05.07.2015;2015;07;13;Sunnuntai;23;28;51
95;05.07.2015;2015;07;14;Sunnuntai;15;24;39
95;05.07.2015;2015;07;15;Sunnuntai;24;17;41
95;05.07.2015;2015;07;16;Sunnuntai;21;17;38
95;05.07.2015;2015;07;17;Sunnuntai;9;16;25
95;05.07.2015;2015;07;18;Sunnuntai;15;15;30
95;05.07.2015;2015;07;19;Sunnuntai;27;16;43
95;05.07.2015;2015;07;20;Sunnuntai;13;12;25
95;05.07.2015;2015;07;21;Sunnuntai;12;6;18
95;05.07.2015;2015;07;22;Sunnuntai;3;3;6
95;05.07.2015;2015;07;23;Sunnuntai;1;2;3
95;06.07.2015;2015;07;00;Maanantai;0;1;1
95;06.07.2015;2015;07;01;Maanantai;0;0;0
95;06.07.2015;2015;07;02;Maanantai;0;0;0
95;06.07.2015;2015;07;03;Maanantai;0;0;0
95;06.07.2015;2015;07;04;Maanantai;0;0;0
95;06.07.2015;2015;07;05;Maanantai;6;4;10
95;06.07.2015;2015;07;06;Maanantai;22;10;32
95;06.07.2015;2015;07;07;Maanantai;26;15;41
95;06.07.2015;2015;07;08;Maanantai;18;16;34
95;06.07.2015;2015;07;09;Maanantai;23;13;36
95;06.07.2015;2015;07;10;Maanantai;17;16;33
95;06.07.2015;2015;07;11;Maanantai;16;26;42
95;06.07.2015;2015;07;12;Maanantai;29;20;49
95;06.07.2015;2015;07;13;Maanantai;26;24;50
95;06.07.2015;2015;07;14;Maanantai;44;23;67
95;06.07.2015;2015;07;15;Maanantai;28;40;68
95;06.07.2015;2015;07;16;Maanantai;37;50;87
95;06.07.2015;2015;07;17;Maanantai;39;32;71
95;06.07.2015;2015;07;18;Maanantai;29;49;78
95;06.07.2015;2015;07;19;Maanantai;24;27;51
95;06.07.2015;2015;07;20;Maanantai;18;26;44
95;06.07.2015;2015;07;21;Maanantai;14;9;23
95;06.07.2015;2015;07;22;Maanantai;3;2;5
95;06.07.2015;2015;07;23;Maanantai;5;0;5
95;07.07.2015;2015;07;00;Tiistai;2;4;6
95;07.07.2015;2015;07;01;Tiistai;3;1;4
95;07.07.2015;2015;07;02;Tiistai;0;0;0
95;07.07.2015;2015;07;03;Tiistai;0;0;0
95;07.07.2015;2015;07;04;Tiistai;0;0;0
95;07.07.2015;2015;07;05;Tiistai;8;3;11
95;07.07.2015;2015;07;06;Tiistai;18;15;33
95;07.07.2015;2015;07;07;Tiistai;23;15;38
95;07.07.2015;2015;07;08;Tiistai;16;10;26
95;07.07.2015;2015;07;09;Tiistai;11;14;25
95;07.07.2015;2015;07;10;Tiistai;16;11;27
95;07.07.2015;2015;07;11;Tiistai;25;22;47
95;07.07.2015;2015;07;12;Tiistai;18;16;34
95;07.07.2015;2015;07;13;Tiistai;19;12;31
95;07.07.2015;2015;07;14;Tiistai;29;10;39
95;07.07.2015;2015;07;15;Tiistai;25;24;49
95;07.07.2015;2015;07;16;Tiistai;25;30;55
95;07.07.2015;2015;07;17;Tiistai;25;45;70
95;07.07.2015;2015;07;18;Tiistai;23;34;57
95;07.07.2015;2015;07;19;Tiistai;17;21;38
95;07.07.2015;2015;07;20;Tiistai;19;14;33
95;07.07.2015;2015;07;21;Tiistai;10;8;18
95;07.07.2015;2015;07;22;Tiistai;4;2;6
95;07.07.2015;2015;07;23;Tiistai;1;0;1
95;08.07.2015;2015;07;00;Keskiviikko;1;1;2
95;08.07.2015;2015;07;01;Keskiviikko;0;1;1
95;08.07.2015;2015;07;02;Keskiviikko;0;0;0
95;08.07.2015;2015;07;03;Keskiviikko;0;0;0
95;08.07.2015;2015;07;04;Keskiviikko;1;0;1
95;08.07.2015;2015;07;05;Keskiviikko;3;4;7
95;08.07.2015;2015;07;06;Keskiviikko;18;14;32
95;08.07.2015;2015;07;07;Keskiviikko;27;12;39
95;08.07.2015;2015;07;08;Keskiviikko;20;8;28
95;08.07.2015;2015;07;09;Keskiviikko;16;9;25
95;08.07.2015;2015;07;10;Keskiviikko;16;10;26
95;08.07.2015;2015;07;11;Keskiviikko;14;11;25
95;08.07.2015;2015;07;12;Keskiviikko;14;12;26
95;08.07.2015;2015;07;13;Keskiviikko;13;9;22
95;08.07.2015;2015;07;14;Keskiviikko;17;22;39
95;08.07.2015;2015;07;15;Keskiviikko;19;23;42
95;08.07.2015;2015;07;16;Keskiviikko;19;37;56
95;08.07.2015;2015;07;17;Keskiviikko;28;28;56
95;08.07.2015;2015;07;18;Keskiviikko;17;24;41
95;08.07.2015;2015;07;19;Keskiviikko;21;21;42
95;08.07.2015;2015;07;20;Keskiviikko;15;11;26
95;08.07.2015;2015;07;21;Keskiviikko;9;4;13
95;08.07.2015;2015;07;22;Keskiviikko;2;4;6
95;08.07.2015;2015;07;23;Keskiviikko;1;0;1
95;09.07.2015;2015;07;00;Torstai;1;4;5
95;09.07.2015;2015;07;01;Torstai;0;3;3
95;09.07.2015;2015;07;02;Torstai;4;0;4
95;09.07.2015;2015;07;03;Torstai;0;0;0
95;09.07.2015;2015;07;04;Torstai;0;1;1
95;09.07.2015;2015;07;05;Torstai;4;3;7
95;09.07.2015;2015;07;06;Torstai;6;7;13
95;09.07.2015;2015;07;07;Torstai;8;7;15
95;09.07.2015;2015;07;08;Torstai;11;4;15
95;09.07.2015;2015;07;09;Torstai;6;4;10
95;09.07.2015;2015;07;10;Torstai;7;4;11
95;09.07.2015;2015;07;11;Torstai;1;2;3
95;09.07.2015;2015;07;12;Torstai;4;4;8
95;09.07.2015;2015;07;13;Torstai;4;2;6
95;09.07.2015;2015;07;14;Torstai;3;1;4
95;09.07.2015;2015;07;15;Torstai;6;8;14
95;09.07.2015;2015;07;16;Torstai;8;11;19
95;09.07.2015;2015;07;17;Torstai;12;6;18
95;09.07.2015;2015;07;18;Torstai;7;15;22
95;09.07.2015;2015;07;19;Torstai;14;7;21
95;09.07.2015;2015;07;20;Torstai;1;8;9
95;09.07.2015;2015;07;21;Torstai;3;6;9
95;09.07.2015;2015;07;22;Torstai;0;0;0
95;09.07.2015;2015;07;23;Torstai;1;0;1
95;10.07.2015;2015;07;00;Perjantai;0;1;1
95;10.07.2015;2015;07;01;Perjantai;0;0;0
95;10.07.2015;2015;07;02;Perjantai;0;2;2
95;10.07.2015;2015;07;03;Perjantai;1;0;1
95;10.07.2015;2015;07;04;Perjantai;1;1;2
95;10.07.2015;2015;07;05;Perjantai;4;3;7
95;10.07.2015;2015;07;06;Perjantai;8;7;15
95;10.07.2015;2015;07;07;Perjantai;9;3;12
95;10.07.2015;2015;07;08;Perjantai;5;8;13
95;10.07.2015;2015;07;09;Perjantai;5;3;8
95;10.07.2015;2015;07;10;Perjantai;7;7;14
95;10.07.2015;2015;07;11;Perjantai;8;10;18
95;10.07.2015;2015;07;12;Perjantai;8;10;18
95;10.07.2015;2015;07;13;Perjantai;11;10;21
95;10.07.2015;2015;07;14;Perjantai;18;17;35
95;10.07.2015;2015;07;15;Perjantai;17;18;35
95;10.07.2015;2015;07;16;Perjantai;17;11;28
95;10.07.2015;2015;07;17;Perjantai;10;18;28
95;10.07.2015;2015;07;18;Perjantai;17;23;40
95;10.07.2015;2015;07;19;Perjantai;19;10;29
95;10.07.2015;2015;07;20;Perjantai;13;12;25
95;10.07.2015;2015;07;21;Perjantai;5;6;11
95;10.07.2015;2015;07;22;Perjantai;3;1;4
95;10.07.2015;2015;07;23;Perjantai;3;0;3
95;11.07.2015;2015;07;00;Lauantai;1;2;3
95;11.07.2015;2015;07;01;Lauantai;0;3;3
95;11.07.2015;2015;07;02;Lauantai;1;3;4
95;11.07.2015;2015;07;03;Lauantai;0;2;2
95;11.07.2015;2015;07;04;Lauantai;0;1;1
95;11.07.2015;2015;07;05;Lauantai;0;2;2
95;11.07.2015;2015;07;06;Lauantai;0;1;1
95;11.07.2015;2015;07;07;Lauantai;3;1;4
95;11.07.2015;2015;07;08;Lauantai;11;9;20
95;11.07.2015;2015;07;09;Lauantai;12;12;24
95;11.07.2015;2015;07;10;Lauantai;25;17;42
95;11.07.2015;2015;07;11;Lauantai;15;21;36
95;11.07.2015;2015;07;12;Lauantai;19;25;44
95;11.07.2015;2015;07;13;Lauantai;18;16;34
95;11.07.2015;2015;07;14;Lauantai;18;29;47
95;11.07.2015;2015;07;15;Lauantai;11;22;33
95;11.07.2015;2015;07;16;Lauantai;26;18;44
95;11.07.2015;2015;07;17;Lauantai;11;19;30
95;11.07.2015;2015;07;18;Lauantai;9;18;27
95;11.07.2015;2015;07;19;Lauantai;24;13;37
95;11.07.2015;2015;07;20;Lauantai;6;12;18
95;11.07.2015;2015;07;21;Lauantai;3;3;6
95;11.07.2015;2015;07;22;Lauantai;5;0;5
95;11.07.2015;2015;07;23;Lauantai;0;1;1
95;12.07.2015;2015;07;00;Sunnuntai;0;0;0
95;12.07.2015;2015;07;01;Sunnuntai;0;2;2
95;12.07.2015;2015;07;02;Sunnuntai;0;4;4
95;12.07.2015;2015;07;03;Sunnuntai;0;0;0
95;12.07.2015;2015;07;04;Sunnuntai;0;0;0
95;12.07.2015;2015;07;05;Sunnuntai;1;2;3
95;12.07.2015;2015;07;06;Sunnuntai;3;2;5
95;12.07.2015;2015;07;07;Sunnuntai;2;4;6
95;12.07.2015;2015;07;08;Sunnuntai;10;6;16
95;12.07.2015;2015;07;09;Sunnuntai;10;7;17
95;12.07.2015;2015;07;10;Sunnuntai;13;36;49
95;12.07.2015;2015;07;11;Sunnuntai;12;17;29
95;12.07.2015;2015;07;12;Sunnuntai;38;29;67
95;12.07.2015;2015;07;13;Sunnuntai;20;25;45
95;12.07.2015;2015;07;14;Sunnuntai;19;24;43
95;12.07.2015;2015;07;15;Sunnuntai;24;66;90
95;12.07.2015;2015;07;16;Sunnuntai;25;20;45
95;12.07.2015;2015;07;17;Sunnuntai;32;21;53
95;12.07.2015;2015;07;18;Sunnuntai;27;23;50
95;12.07.2015;2015;07;19;Sunnuntai;51;19;70
95;12.07.2015;2015;07;20;Sunnuntai;18;17;35
95;12.07.2015;2015;07;21;Sunnuntai;6;8;14
95;12.07.2015;2015;07;22;Sunnuntai;5;3;8
95;12.07.2015;2015;07;23;Sunnuntai;2;1;3
95;13.07.2015;2015;07;00;Maanantai;0;0;0
95;13.07.2015;2015;07;01;Maanantai;0;0;0
95;13.07.2015;2015;07;02;Maanantai;0;0;0
95;13.07.2015;2015;07;03;Maanantai;0;0;0
95;13.07.2015;2015;07;04;Maanantai;1;0;1
95;13.07.2015;2015;07;05;Maanantai;5;2;7
95;13.07.2015;2015;07;06;Maanantai;17;13;30
95;13.07.2015;2015;07;07;Maanantai;31;23;54
95;13.07.2015;2015;07;08;Maanantai;14;13;27
95;13.07.2015;2015;07;09;Maanantai;10;5;15
95;13.07.2015;2015;07;10;Maanantai;21;11;32
95;13.07.2015;2015;07;11;Maanantai;13;12;25
95;13.07.2015;2015;07;12;Maanantai;18;16;34
95;13.07.2015;2015;07;13;Maanantai;19;22;41
95;13.07.2015;2015;07;14;Maanantai;22;12;34
95;13.07.2015;2015;07;15;Maanantai;15;37;52
95;13.07.2015;2015;07;16;Maanantai;38;36;74
95;13.07.2015;2015;07;17;Maanantai;23;38;61
95;13.07.2015;2015;07;18;Maanantai;16;31;47
95;13.07.2015;2015;07;19;Maanantai;27;36;63
95;13.07.2015;2015;07;20;Maanantai;17;18;35
95;13.07.2015;2015;07;21;Maanantai;8;10;18
95;13.07.2015;2015;07;22;Maanantai;9;3;12
95;13.07.2015;2015;07;23;Maanantai;0;2;2
95;14.07.2015;2015;07;00;Tiistai;2;0;2
95;14.07.2015;2015;07;01;Tiistai;0;0;0
95;14.07.2015;2015;07;02;Tiistai;0;1;1
95;14.07.2015;2015;07;03;Tiistai;0;0;0
95;14.07.2015;2015;07;04;Tiistai;1;0;1
95;14.07.2015;2015;07;05;Tiistai;9;2;11
95;14.07.2015;2015;07;06;Tiistai;22;10;32
95;14.07.2015;2015;07;07;Tiistai;31;12;43
95;14.07.2015;2015;07;08;Tiistai;15;7;22
95;14.07.2015;2015;07;09;Tiistai;11;13;24
95;14.07.2015;2015;07;10;Tiistai;13;10;23
95;14.07.2015;2015;07;11;Tiistai;15;19;34
95;14.07.2015;2015;07;12;Tiistai;16;23;39
95;14.07.2015;2015;07;13;Tiistai;25;24;49
95;14.07.2015;2015;07;14;Tiistai;19;25;44
95;14.07.2015;2015;07;15;Tiistai;28;38;66
95;14.07.2015;2015;07;16;Tiistai;36;41;77
95;14.07.2015;2015;07;17;Tiistai;14;30;44
95;14.07.2015;2015;07;18;Tiistai;23;25;48
95;14.07.2015;2015;07;19;Tiistai;20;30;50
95;14.07.2015;2015;07;20;Tiistai;15;21;36
95;14.07.2015;2015;07;21;Tiistai;6;13;19
95;14.07.2015;2015;07;22;Tiistai;4;3;7
95;14.07.2015;2015;07;23;Tiistai;1;1;2
95;15.07.2015;2015;07;00;Keskiviikko;2;1;3
95;15.07.2015;2015;07;01;Keskiviikko;1;0;1
95;15.07.2015;2015;07;02;Keskiviikko;1;1;2
95;15.07.2015;2015;07;03;Keskiviikko;1;0;1
95;15.07.2015;2015;07;04;Keskiviikko;1;0;1
95;15.07.2015;2015;07;05;Keskiviikko;3;2;5
95;15.07.2015;2015;07;06;Keskiviikko;11;10;21
95;15.07.2015;2015;07;07;Keskiviikko;20;19;39
95;15.07.2015;2015;07;08;Keskiviikko;13;13;26
95;15.07.2015;2015;07;09;Keskiviikko;10;9;19
95;15.07.2015;2015;07;10;Keskiviikko;13;13;26
95;15.07.2015;2015;07;11;Keskiviikko;14;14;28
95;15.07.2015;2015;07;12;Keskiviikko;16;16;32
95;15.07.2015;2015;07;13;Keskiviikko;16;16;32
95;15.07.2015;2015;07;14;Keskiviikko;19;19;38
95;15.07.2015;2015;07;15;Keskiviikko;29;28;57
95;15.07.2015;2015;07;16;Keskiviikko;32;32;64
95;15.07.2015;2015;07;17;Keskiviikko;26;26;52
95;15.07.2015;2015;07;18;Keskiviikko;24;24;48
95;15.07.2015;2015;07;19;Keskiviikko;24;24;48
95;15.07.2015;2015;07;20;Keskiviikko;18;17;35
95;15.07.2015;2015;07;21;Keskiviikko;10;10;20
95;15.07.2015;2015;07;22;Keskiviikko;7;6;13
95;15.07.2015;2015;07;23;Keskiviikko;4;3;7
95;16.07.2015;2015;07;00;Torstai;1;1;2
95;16.07.2015;2015;07;01;Torstai;1;0;1
95;16.07.2015;2015;07;02;Torstai;1;0;1
95;16.07.2015;2015;07;03;Torstai;1;0;1
95;16.07.2015;2015;07;04;Torstai;1;0;1
95;16.07.2015;2015;07;05;Torstai;2;2;4
95;16.07.2015;2015;07;06;Torstai;7;7;14
95;16.07.2015;2015;07;07;Torstai;13;13;26
95;16.07.2015;2015;07;08;Torstai;9;9;18
95;16.07.2015;2015;07;09;Torstai;7;6;13
95;16.07.2015;2015;07;10;Torstai;9;8;17
95;16.07.2015;2015;07;11;Torstai;10;9;19
95;16.07.2015;2015;07;12;Torstai;11;10;21
95;16.07.2015;2015;07;13;Torstai;11;10;21
95;16.07.2015;2015;07;14;Torstai;13;12;25
95;16.07.2015;2015;07;15;Torstai;19;19;38
95;16.07.2015;2015;07;16;Torstai;22;21;43
95;16.07.2015;2015;07;17;Torstai;18;17;35
95;16.07.2015;2015;07;18;Torstai;16;16;32
95;16.07.2015;2015;07;19;Torstai;16;16;32
95;16.07.2015;2015;07;20;Torstai;12;12;24
95;16.07.2015;2015;07;21;Torstai;7;6;13
95;16.07.2015;2015;07;22;Torstai;5;4;9
95;16.07.2015;2015;07;23;Torstai;2;2;4
95;17.07.2015;2015;07;00;Perjantai;2;2;4
95;17.07.2015;2015;07;01;Perjantai;1;0;1
95;17.07.2015;2015;07;02;Perjantai;1;1;2
95;17.07.2015;2015;07;03;Perjantai;1;0;1
95;17.07.2015;2015;07;04;Perjantai;1;0;1
95;17.07.2015;2015;07;05;Perjantai;3;2;5
95;17.07.2015;2015;07;06;Perjantai;11;10;21
95;17.07.2015;2015;07;07;Perjantai;20;20;40
95;17.07.2015;2015;07;08;Perjantai;14;13;27
95;17.07.2015;2015;07;09;Perjantai;10;9;19
95;17.07.2015;2015;07;10;Perjantai;13;13;26
95;17.07.2015;2015;07;11;Perjantai;15;14;29
95;17.07.2015;2015;07;12;Perjantai;16;16;32
95;17.07.2015;2015;07;13;Perjantai;17;16;33
95;17.07.2015;2015;07;14;Perjantai;20;19;39
95;17.07.2015;2015;07;15;Perjantai;29;29;58
95;17.07.2015;2015;07;16;Perjantai;33;32;65
95;17.07.2015;2015;07;17;Perjantai;27;26;53
95;17.07.2015;2015;07;18;Perjantai;25;24;49
95;17.07.2015;2015;07;19;Perjantai;25;24;49
95;17.07.2015;2015;07;20;Perjantai;18;18;36
95;17.07.2015;2015;07;21;Perjantai;10;10;20
95;17.07.2015;2015;07;22;Perjantai;7;6;13
95;17.07.2015;2015;07;23;Perjantai;4;3;7
95;18.07.2015;2015;07;00;Lauantai;7;7;14
95;18.07.2015;2015;07;01;Lauantai;4;4;8
95;18.07.2015;2015;07;02;Lauantai;4;3;7
95;18.07.2015;2015;07;03;Lauantai;2;1;3
95;18.07.2015;2015;07;04;Lauantai;3;2;5
95;18.07.2015;2015;07;05;Lauantai;1;1;2
95;18.07.2015;2015;07;06;Lauantai;3;2;5
95;18.07.2015;2015;07;07;Lauantai;5;4;9
95;18.07.2015;2015;07;08;Lauantai;5;5;10
95;18.07.2015;2015;07;09;Lauantai;10;10;20
95;18.07.2015;2015;07;10;Lauantai;15;15;30
95;18.07.2015;2015;07;11;Lauantai;24;23;47
95;18.07.2015;2015;07;12;Lauantai;25;24;49
95;18.07.2015;2015;07;13;Lauantai;28;28;56
95;18.07.2015;2015;07;14;Lauantai;31;30;61
95;18.07.2015;2015;07;15;Lauantai;22;22;44
95;18.07.2015;2015;07;16;Lauantai;24;23;47
95;18.07.2015;2015;07;17;Lauantai;24;23;47
95;18.07.2015;2015;07;18;Lauantai;24;23;47
95;18.07.2015;2015;07;19;Lauantai;22;21;43
95;18.07.2015;2015;07;20;Lauantai;16;16;32
95;18.07.2015;2015;07;21;Lauantai;11;11;22
95;18.07.2015;2015;07;22;Lauantai;8;7;15
95;18.07.2015;2015;07;23;Lauantai;5;5;10
95;19.07.2015;2015;07;00;Sunnuntai;4;3;7
95;19.07.2015;2015;07;01;Sunnuntai;2;2;4
95;19.07.2015;2015;07;02;Sunnuntai;2;2;4
95;19.07.2015;2015;07;03;Sunnuntai;1;1;2
95;19.07.2015;2015;07;04;Sunnuntai;2;1;3
95;19.07.2015;2015;07;05;Sunnuntai;1;0;1
95;19.07.2015;2015;07;06;Sunnuntai;2;1;3
95;19.07.2015;2015;07;07;Sunnuntai;2;2;4
95;19.07.2015;2015;07;08;Sunnuntai;3;2;5
95;19.07.2015;2015;07;09;Sunnuntai;5;5;10
95;19.07.2015;2015;07;10;Sunnuntai;8;8;16
95;19.07.2015;2015;07;11;Sunnuntai;13;12;25
95;19.07.2015;2015;07;12;Sunnuntai;13;12;25
95;19.07.2015;2015;07;13;Sunnuntai;15;14;29
95;19.07.2015;2015;07;14;Sunnuntai;16;16;32
95;19.07.2015;2015;07;15;Sunnuntai;12;11;23
95;19.07.2015;2015;07;16;Sunnuntai;12;12;24
95;19.07.2015;2015;07;17;Sunnuntai;12;12;24
95;19.07.2015;2015;07;18;Sunnuntai;12;12;24
95;19.07.2015;2015;07;19;Sunnuntai;11;11;22
95;19.07.2015;2015;07;20;Sunnuntai;9;8;17
95;19.07.2015;2015;07;21;Sunnuntai;6;5;11
95;19.07.2015;2015;07;22;Sunnuntai;4;4;8
95;19.07.2015;2015;07;23;Sunnuntai;3;2;5
95;20.07.2015;2015;07;00;Maanantai;2;2;4
95;20.07.2015;2015;07;01;Maanantai;1;1;2
95;20.07.2015;2015;07;02;Maanantai;1;1;2
95;20.07.2015;2015;07;03;Maanantai;1;0;1
95;20.07.2015;2015;07;04;Maanantai;1;1;2
95;20.07.2015;2015;07;05;Maanantai;4;3;7
95;20.07.2015;2015;07;06;Maanantai;14;13;27
95;20.07.2015;2015;07;07;Maanantai;25;24;49
95;20.07.2015;2015;07;08;Maanantai;17;16;33
95;20.07.2015;2015;07;09;Maanantai;12;12;24
95;20.07.2015;2015;07;10;Maanantai;17;16;33
95;20.07.2015;2015;07;11;Maanantai;18;18;36
95;20.07.2015;2015;07;12;Maanantai;20;20;40
95;20.07.2015;2015;07;13;Maanantai;21;20;41
95;20.07.2015;2015;07;14;Maanantai;24;24;48
95;20.07.2015;2015;07;15;Maanantai;36;36;72
95;20.07.2015;2015;07;16;Maanantai;41;40;81
95;20.07.2015;2015;07;17;Maanantai;34;33;67
95;20.07.2015;2015;07;18;Maanantai;31;30;61
95;20.07.2015;2015;07;19;Maanantai;31;31;62
95;20.07.2015;2015;07;20;Maanantai;23;22;45
95;20.07.2015;2015;07;21;Maanantai;13;12;25
95;20.07.2015;2015;07;22;Maanantai;8;8;16
95;20.07.2015;2015;07;23;Maanantai;4;4;8
95;21.07.2015;2015;07;00;Tiistai;2;2;4
95;21.07.2015;2015;07;01;Tiistai;1;0;1
95;21.07.2015;2015;07;02;Tiistai;1;1;2
95;21.07.2015;2015;07;03;Tiistai;1;0;1
95;21.07.2015;2015;07;04;Tiistai;1;0;1
95;21.07.2015;2015;07;05;Tiistai;3;2;5
95;21.07.2015;2015;07;06;Tiistai;11;10;21
95;21.07.2015;2015;07;07;Tiistai;20;19;39
95;21.07.2015;2015;07;08;Tiistai;14;13;27
95;21.07.2015;2015;07;09;Tiistai;10;9;19
95;21.07.2015;2015;07;10;Tiistai;13;13;26
95;21.07.2015;2015;07;11;Tiistai;15;14;29
95;21.07.2015;2015;07;12;Tiistai;16;16;32
95;21.07.2015;2015;07;13;Tiistai;16;16;32
95;21.07.2015;2015;07;14;Tiistai;19;19;38
95;21.07.2015;2015;07;15;Tiistai;29;28;57
95;21.07.2015;2015;07;16;Tiistai;33;32;65
95;21.07.2015;2015;07;17;Tiistai;27;26;53
95;21.07.2015;2015;07;18;Tiistai;24;24;48
95;21.07.2015;2015;07;19;Tiistai;25;24;49
95;21.07.2015;2015;07;20;Tiistai;18;17;35
95;21.07.2015;2015;07;21;Tiistai;10;10;20
95;21.07.2015;2015;07;22;Tiistai;7;6;13
95;21.07.2015;2015;07;23;Tiistai;4;3;7
95;22.07.2015;2015;07;00;Keskiviikko;2;2;4
95;22.07.2015;2015;07;01;Keskiviikko;1;0;1
95;22.07.2015;2015;07;02;Keskiviikko;1;1;2
95;22.07.2015;2015;07;03;Keskiviikko;1;0;1
95;22.07.2015;2015;07;04;Keskiviikko;1;0;1
95;22.07.2015;2015;07;05;Keskiviikko;3;3;6
95;22.07.2015;2015;07;06;Keskiviikko;12;11;23
95;22.07.2015;2015;07;07;Keskiviikko;21;21;42
95;22.07.2015;2015;07;08;Keskiviikko;15;14;29
95;22.07.2015;2015;07;09;Keskiviikko;11;10;21
95;22.07.2015;2015;07;10;Keskiviikko;14;14;28
95;22.07.2015;2015;07;11;Keskiviikko;16;15;31
95;22.07.2015;2015;07;12;Keskiviikko;18;17;35
95;22.07.2015;2015;07;13;Keskiviikko;18;17;35
95;22.07.2015;2015;07;14;Keskiviikko;21;21;42
95;22.07.2015;2015;07;15;Keskiviikko;31;31;62
95;22.07.2015;2015;07;16;Keskiviikko;35;35;70
95;22.07.2015;2015;07;17;Keskiviikko;29;28;57
95;22.07.2015;2015;07;18;Keskiviikko;26;26;52
95;22.07.2015;2015;07;19;Keskiviikko;27;26;53
95;22.07.2015;2015;07;20;Keskiviikko;19;19;38
95;22.07.2015;2015;07;21;Keskiviikko;11;10;21
95;22.07.2015;2015;07;22;Keskiviikko;7;7;14
95;22.07.2015;2015;07;23;Keskiviikko;4;3;7
95;23.07.2015;2015;07;00;Torstai;2;1;3
95;23.07.2015;2015;07;01;Torstai;1;0;1
95;23.07.2015;2015;07;02;Torstai;1;1;2
95;23.07.2015;2015;07;03;Torstai;1;0;1
95;23.07.2015;2015;07;04;Torstai;1;0;1
95;23.07.2015;2015;07;05;Torstai;3;2;5
95;23.07.2015;2015;07;06;Torstai;11;10;21
95;23.07.2015;2015;07;07;Torstai;19;19;38
95;23.07.2015;2015;07;08;Torstai;13;13;26
95;23.07.2015;2015;07;09;Torstai;10;9;19
95;23.07.2015;2015;07;10;Torstai;13;12;25
95;23.07.2015;2015;07;11;Torstai;14;14;28
95;23.07.2015;2015;07;12;Torstai;16;15;31
95;23.07.2015;2015;07;13;Torstai;16;16;32
95;23.07.2015;2015;07;14;Torstai;19;18;37
95;23.07.2015;2015;07;15;Torstai;28;28;56
95;23.07.2015;2015;07;16;Torstai;32;31;63
95;23.07.2015;2015;07;17;Torstai;26;25;51
95;23.07.2015;2015;07;18;Torstai;24;23;47
95;23.07.2015;2015;07;19;Torstai;24;24;48
95;23.07.2015;2015;07;20;Torstai;18;17;35
95;23.07.2015;2015;07;21;Torstai;10;9;19
95;23.07.2015;2015;07;22;Torstai;7;6;13
95;23.07.2015;2015;07;23;Torstai;3;3;6
95;24.07.2015;2015;07;00;Perjantai;1;1;2
95;24.07.2015;2015;07;01;Perjantai;1;0;1
95;24.07.2015;2015;07;02;Perjantai;1;0;1
95;24.07.2015;2015;07;03;Perjantai;0;0;0
95;24.07.2015;2015;07;04;Perjantai;1;0;1
95;24.07.2015;2015;07;05;Perjantai;1;1;2
95;24.07.2015;2015;07;06;Perjantai;5;4;9
95;24.07.2015;2015;07;07;Perjantai;9;8;17
95;24.07.2015;2015;07;08;Perjantai;6;5;11
95;24.07.2015;2015;07;09;Perjantai;4;4;8
95;24.07.2015;2015;07;10;Perjantai;6;5;11
95;24.07.2015;2015;07;11;Perjantai;6;6;12
95;24.07.2015;2015;07;12;Perjantai;7;7;14
95;24.07.2015;2015;07;13;Perjantai;7;7;14
95;24.07.2015;2015;07;14;Perjantai;8;8;16
95;24.07.2015;2015;07;15;Perjantai;12;12;24
95;24.07.2015;2015;07;16;Perjantai;14;14;28
95;24.07.2015;2015;07;17;Perjantai;12;11;23
95;24.07.2015;2015;07;18;Perjantai;11;10;21
95;24.07.2015;2015;07;19;Perjantai;11;10;21
95;24.07.2015;2015;07;20;Perjantai;8;7;15
95;24.07.2015;2015;07;21;Perjantai;4;4;8
95;24.07.2015;2015;07;22;Perjantai;3;3;6
95;24.07.2015;2015;07;23;Perjantai;2;1;3
95;25.07.2015;2015;07;00;Lauantai;6;6;12
95;25.07.2015;2015;07;01;Lauantai;4;3;7
95;25.07.2015;2015;07;02;Lauantai;3;3;6
95;25.07.2015;2015;07;03;Lauantai;2;1;3
95;25.07.2015;2015;07;04;Lauantai;2;2;4
95;25.07.2015;2015;07;05;Lauantai;1;1;2
95;25.07.2015;2015;07;06;Lauantai;2;2;4
95;25.07.2015;2015;07;07;Lauantai;4;3;7
95;25.07.2015;2015;07;08;Lauantai;5;4;9
95;25.07.2015;2015;07;09;Lauantai;9;8;17
95;25.07.2015;2015;07;10;Lauantai;13;13;26
95;25.07.2015;2015;07;11;Lauantai;21;21;42
95;25.07.2015;2015;07;12;Lauantai;22;21;43
95;25.07.2015;2015;07;13;Lauantai;25;24;49
95;25.07.2015;2015;07;14;Lauantai;27;27;54
95;25.07.2015;2015;07;15;Lauantai;20;19;39
95;25.07.2015;2015;07;16;Lauantai;21;20;41
95;25.07.2015;2015;07;17;Lauantai;21;20;41
95;25.07.2015;2015;07;18;Lauantai;21;20;41
95;25.07.2015;2015;07;19;Lauantai;19;18;37
95;25.07.2015;2015;07;20;Lauantai;14;14;28
95;25.07.2015;2015;07;21;Lauantai;10;9;19
95;25.07.2015;2015;07;22;Lauantai;7;6;13
95;25.07.2015;2015;07;23;Lauantai;4;4;8
95;26.07.2015;2015;07;00;Sunnuntai;4;4;8
95;26.07.2015;2015;07;01;Sunnuntai;3;2;5
95;26.07.2015;2015;07;02;Sunnuntai;2;2;4
95;26.07.2015;2015;07;03;Sunnuntai;1;1;2
95;26.07.2015;2015;07;04;Sunnuntai;2;1;3
95;26.07.2015;2015;07;05;Sunnuntai;1;0;1
95;26.07.2015;2015;07;06;Sunnuntai;2;1;3
95;26.07.2015;2015;07;07;Sunnuntai;3;2;5
95;26.07.2015;2015;07;08;Sunnuntai;3;3;6
95;26.07.2015;2015;07;09;Sunnuntai;6;6;12
95;26.07.2015;2015;07;10;Sunnuntai;9;9;18
95;26.07.2015;2015;07;11;Sunnuntai;14;14;28
95;26.07.2015;2015;07;12;Sunnuntai;15;14;29
95;26.07.2015;2015;07;13;Sunnuntai;17;16;33
95;26.07.2015;2015;07;14;Sunnuntai;18;18;36
95;26.07.2015;2015;07;15;Sunnuntai;13;13;26
95;26.07.2015;2015;07;16;Sunnuntai;14;14;28
95;26.07.2015;2015;07;17;Sunnuntai;14;14;28
95;26.07.2015;2015;07;18;Sunnuntai;14;14;28
95;26.07.2015;2015;07;19;Sunnuntai;13;12;25
95;26.07.2015;2015;07;20;Sunnuntai;10;9;19
95;26.07.2015;2015;07;21;Sunnuntai;7;6;13
95;26.07.2015;2015;07;22;Sunnuntai;5;4;9
95;26.07.2015;2015;07;23;Sunnuntai;3;3;6
95;27.07.2015;2015;07;00;Maanantai;0;0;0
95;27.07.2015;2015;07;01;Maanantai;0;0;0
95;27.07.2015;2015;07;02;Maanantai;0;0;0
95;27.07.2015;2015;07;03;Maanantai;0;1;1
95;27.07.2015;2015;07;04;Maanantai;0;0;0
95;27.07.2015;2015;07;05;Maanantai;3;4;7
95;27.07.2015;2015;07;06;Maanantai;28;12;40
95;27.07.2015;2015;07;07;Maanantai;27;10;37
95;27.07.2015;2015;07;08;Maanantai;11;14;25
95;27.07.2015;2015;07;09;Maanantai;12;16;28
95;27.07.2015;2015;07;10;Maanantai;16;14;30
95;27.07.2015;2015;07;11;Maanantai;16;13;29
95;27.07.2015;2015;07;12;Maanantai;22;13;35
95;27.07.2015;2015;07;13;Maanantai;15;16;31
95;27.07.2015;2015;07;14;Maanantai;23;21;44
95;27.07.2015;2015;07;15;Maanantai;12;32;44
95;27.07.2015;2015;07;16;Maanantai;18;38;56
95;27.07.2015;2015;07;17;Maanantai;10;18;28
95;27.07.2015;2015;07;18;Maanantai;2;14;16
95;27.07.2015;2015;07;19;Maanantai;7;5;12
95;27.07.2015;2015;07;20;Maanantai;8;2;10
95;27.07.2015;2015;07;21;Maanantai;5;3;8
95;27.07.2015;2015;07;22;Maanantai;2;1;3
95;27.07.2015;2015;07;23;Maanantai;0;1;1
95;28.07.2015;2015;07;00;Tiistai;0;0;0
95;28.07.2015;2015;07;01;Tiistai;0;0;0
95;28.07.2015;2015;07;02;Tiistai;0;0;0
95;28.07.2015;2015;07;03;Tiistai;0;0;0
95;28.07.2015;2015;07;04;Tiistai;0;0;0
95;28.07.2015;2015;07;05;Tiistai;0;0;0
95;28.07.2015;2015;07;06;Tiistai;0;0;0
95;28.07.2015;2015;07;07;Tiistai;10;10;20
95;28.07.2015;2015;07;08;Tiistai;15;15;30
95;28.07.2015;2015;07;09;Tiistai;20;20;40
95;28.07.2015;2015;07;10;Tiistai;23;23;46
95;28.07.2015;2015;07;11;Tiistai;20;20;40
95;28.07.2015;2015;07;12;Tiistai;15;14;29
95;28.07.2015;2015;07;13;Tiistai;20;35;55
95;28.07.2015;2015;07;14;Tiistai;25;40;65
95;28.07.2015;2015;07;15;Tiistai;15;39;54
95;28.07.2015;2015;07;16;Tiistai;26;44;70
95;28.07.2015;2015;07;17;Tiistai;34;19;53
95;28.07.2015;2015;07;18;Tiistai;29;31;60
95;28.07.2015;2015;07;19;Tiistai;26;30;56
95;28.07.2015;2015;07;20;Tiistai;12;16;28
95;28.07.2015;2015;07;21;Tiistai;7;8;15
95;28.07.2015;2015;07;22;Tiistai;8;10;18
95;28.07.2015;2015;07;23;Tiistai;3;3;6
95;29.07.2015;2015;07;00;Keskiviikko;0;0;0
95;29.07.2015;2015;07;01;Keskiviikko;0;0;0
95;29.07.2015;2015;07;02;Keskiviikko;0;0;0
95;29.07.2015;2015;07;03;Keskiviikko;0;1;1
95;29.07.2015;2015;07;04;Keskiviikko;0;0;0
95;29.07.2015;2015;07;05;Keskiviikko;3;4;7
95;29.07.2015;2015;07;06;Keskiviikko;28;12;40
95;29.07.2015;2015;07;07;Keskiviikko;27;10;37
95;29.07.2015;2015;07;08;Keskiviikko;11;14;25
95;29.07.2015;2015;07;09;Keskiviikko;12;16;28
95;29.07.2015;2015;07;10;Keskiviikko;16;14;30
95;29.07.2015;2015;07;11;Keskiviikko;16;13;29
95;29.07.2015;2015;07;12;Keskiviikko;22;13;35
95;29.07.2015;2015;07;13;Keskiviikko;15;16;31
95;29.07.2015;2015;07;14;Keskiviikko;23;21;44
95;29.07.2015;2015;07;15;Keskiviikko;12;32;44
95;29.07.2015;2015;07;16;Keskiviikko;18;38;56
95;29.07.2015;2015;07;17;Keskiviikko;10;18;28
95;29.07.2015;2015;07;18;Keskiviikko;2;14;16
95;29.07.2015;2015;07;19;Keskiviikko;7;5;12
95;29.07.2015;2015;07;20;Keskiviikko;8;2;10
95;29.07.2015;2015;07;21;Keskiviikko;5;3;8
95;29.07.2015;2015;07;22;Keskiviikko;2;1;3
95;29.07.2015;2015;07;23;Keskiviikko;0;1;1
95;30.07.2015;2015;07;00;Torstai;0;0;0
95;30.07.2015;2015;07;01;Torstai;0;0;0
95;30.07.2015;2015;07;02;Torstai;1;0;1
95;30.07.2015;2015;07;03;Torstai;0;1;1
95;30.07.2015;2015;07;04;Torstai;0;0;0
95;30.07.2015;2015;07;05;Torstai;6;6;12
95;30.07.2015;2015;07;06;Torstai;14;5;19
95;30.07.2015;2015;07;07;Torstai;16;10;26
95;30.07.2015;2015;07;08;Torstai;7;6;13
95;30.07.2015;2015;07;09;Torstai;11;6;17
95;30.07.2015;2015;07;10;Torstai;12;9;21
95;30.07.2015;2015;07;11;Torstai;25;26;51
95;30.07.2015;2015;07;12;Torstai;20;15;35
95;30.07.2015;2015;07;13;Torstai;17;29;46
95;30.07.2015;2015;07;14;Torstai;21;20;41
95;30.07.2015;2015;07;15;Torstai;18;35;53
95;30.07.2015;2015;07;16;Torstai;31;31;62
95;30.07.2015;2015;07;17;Torstai;34;35;69
95;30.07.2015;2015;07;18;Torstai;38;33;71
95;30.07.2015;2015;07;19;Torstai;28;29;57
95;30.07.2015;2015;07;20;Torstai;15;18;33
95;30.07.2015;2015;07;21;Torstai;11;8;19
95;30.07.2015;2015;07;22;Torstai;2;11;13
95;30.07.2015;2015;07;23;Torstai;1;5;6
95;31.07.2015;2015;07;00;Perjantai;0;0;0
95;31.07.2015;2015;07;01;Perjantai;0;0;0
95;31.07.2015;2015;07;02;Perjantai;1;1;2
95;31.07.2015;2015;07;03;Perjantai;0;1;1
95;31.07.2015;2015;07;04;Perjantai;1;0;1
95;31.07.2015;2015;07;05;Perjantai;2;2;4
95;31.07.2015;2015;07;06;Perjantai;23;7;30
95;31.07.2015;2015;07;07;Perjantai;13;9;22
95;31.07.2015;2015;07;08;Perjantai;8;8;16
95;31.07.2015;2015;07;09;Perjantai;16;5;21
95;31.07.2015;2015;07;10;Perjantai;24;18;42
95;31.07.2015;2015;07;11;Perjantai;15;17;32
95;31.07.2015;2015;07;12;Perjantai;25;22;47
95;31.07.2015;2015;07;13;Perjantai;3;12;15
95;31.07.2015;2015;07;14;Perjantai;13;24;37
95;31.07.2015;2015;07;15;Perjantai;19;28;47
95;31.07.2015;2015;07;16;Perjantai;16;20;36
95;31.07.2015;2015;07;17;Perjantai;23;19;42
95;31.07.2015;2015;07;18;Perjantai;8;15;23
95;31.07.2015;2015;07;19;Perjantai;26;14;40
95;31.07.2015;2015;07;20;Perjantai;10;15;25
95;31.07.2015;2015;07;21;Perjantai;10;10;20
95;31.07.2015;2015;07;22;Perjantai;4;11;15
95;31.07.2015;2015;07;23;Perjantai;3;1;4
95;01.08.2015;2015;08;00;Lauantai;1;0;1
95;01.08.2015;2015;08;01;Lauantai;2;2;4
95;01.08.2015;2015;08;02;Lauantai;1;2;3
95;01.08.2015;2015;08;03;Lauantai;2;1;3
95;01.08.2015;2015;08;04;Lauantai;1;2;3
95;01.08.2015;2015;08;05;Lauantai;0;3;3
95;01.08.2015;2015;08;06;Lauantai;1;2;3
95;01.08.2015;2015;08;07;Lauantai;4;5;9
95;01.08.2015;2015;08;08;Lauantai;3;1;4
95;01.08.2015;2015;08;09;Lauantai;7;8;15
95;01.08.2015;2015;08;10;Lauantai;5;6;11
95;01.08.2015;2015;08;11;Lauantai;4;5;9
95;01.08.2015;2015;08;12;Lauantai;7;6;13
95;01.08.2015;2015;08;13;Lauantai;8;12;20
95;01.08.2015;2015;08;14;Lauantai;6;7;13
95;01.08.2015;2015;08;15;Lauantai;5;3;8
95;01.08.2015;2015;08;16;Lauantai;5;3;8
95;01.08.2015;2015;08;17;Lauantai;6;5;11
95;01.08.2015;2015;08;18;Lauantai;9;7;16
95;01.08.2015;2015;08;19;Lauantai;9;1;10
95;01.08.2015;2015;08;20;Lauantai;4;7;11
95;01.08.2015;2015;08;21;Lauantai;5;4;9
95;01.08.2015;2015;08;22;Lauantai;4;4;8
95;01.08.2015;2015;08;23;Lauantai;1;1;2
95;02.08.2015;2015;08;00;Sunnuntai;2;2;4
95;02.08.2015;2015;08;01;Sunnuntai;0;1;1
95;02.08.2015;2015;08;02;Sunnuntai;1;1;2
95;02.08.2015;2015;08;03;Sunnuntai;0;2;2
95;02.08.2015;2015;08;04;Sunnuntai;0;0;0
95;02.08.2015;2015;08;05;Sunnuntai;2;2;4
95;02.08.2015;2015;08;06;Sunnuntai;0;0;0
95;02.08.2015;2015;08;07;Sunnuntai;1;1;2
95;02.08.2015;2015;08;08;Sunnuntai;1;4;5
95;02.08.2015;2015;08;09;Sunnuntai;8;9;17
95;02.08.2015;2015;08;10;Sunnuntai;11;14;25
95;02.08.2015;2015;08;11;Sunnuntai;11;10;21
95;02.08.2015;2015;08;12;Sunnuntai;13;19;32
95;02.08.2015;2015;08;13;Sunnuntai;11;17;28
95;02.08.2015;2015;08;14;Sunnuntai;8;12;20
95;02.08.2015;2015;08;15;Sunnuntai;17;14;31
95;02.08.2015;2015;08;16;Sunnuntai;8;8;16
95;02.08.2015;2015;08;17;Sunnuntai;13;14;27
95;02.08.2015;2015;08;18;Sunnuntai;6;21;27
95;02.08.2015;2015;08;19;Sunnuntai;16;8;24
95;02.08.2015;2015;08;20;Sunnuntai;8;6;14
95;02.08.2015;2015;08;21;Sunnuntai;3;2;5
95;02.08.2015;2015;08;22;Sunnuntai;2;2;4
95;02.08.2015;2015;08;23;Sunnuntai;0;4;4
95;03.08.2015;2015;08;00;Maanantai;2;0;2
95;03.08.2015;2015;08;01;Maanantai;2;2;4
95;03.08.2015;2015;08;02;Maanantai;0;0;0
95;03.08.2015;2015;08;03;Maanantai;1;1;2
95;03.08.2015;2015;08;04;Maanantai;2;1;3
95;03.08.2015;2015;08;05;Maanantai;6;3;9
95;03.08.2015;2015;08;06;Maanantai;28;6;34
95;03.08.2015;2015;08;07;Maanantai;21;8;29
95;03.08.2015;2015;08;08;Maanantai;8;14;22
95;03.08.2015;2015;08;09;Maanantai;9;5;14
95;03.08.2015;2015;08;10;Maanantai;4;5;9
95;03.08.2015;2015;08;11;Maanantai;11;7;18
95;03.08.2015;2015;08;12;Maanantai;15;8;23
95;03.08.2015;2015;08;13;Maanantai;16;21;37
95;03.08.2015;2015;08;14;Maanantai;7;14;21
95;03.08.2015;2015;08;15;Maanantai;28;25;53
95;03.08.2015;2015;08;16;Maanantai;28;44;72
95;03.08.2015;2015;08;17;Maanantai;21;26;47
95;03.08.2015;2015;08;18;Maanantai;14;17;31
95;03.08.2015;2015;08;19;Maanantai;13;26;39
95;03.08.2015;2015;08;20;Maanantai;22;18;40
95;03.08.2015;2015;08;21;Maanantai;3;3;6
95;03.08.2015;2015;08;22;Maanantai;4;5;9
95;03.08.2015;2015;08;23;Maanantai;1;3;4
95;04.08.2015;2015;08;00;Tiistai;1;0;1
95;04.08.2015;2015;08;01;Tiistai;0;0;0
95;04.08.2015;2015;08;02;Tiistai;0;0;0
95;04.08.2015;2015;08;03;Tiistai;0;1;1
95;04.08.2015;2015;08;04;Tiistai;4;1;5
95;04.08.2015;2015;08;05;Tiistai;5;2;7
95;04.08.2015;2015;08;06;Tiistai;30;13;43
95;04.08.2015;2015;08;07;Tiistai;37;20;57
95;04.08.2015;2015;08;08;Tiistai;12;16;28
95;04.08.2015;2015;08;09;Tiistai;10;8;18
95;04.08.2015;2015;08;10;Tiistai;14;16;30
95;04.08.2015;2015;08;11;Tiistai;24;6;30
95;04.08.2015;2015;08;12;Tiistai;18;23;41
95;04.08.2015;2015;08;13;Tiistai;33;23;56
95;04.08.2015;2015;08;14;Tiistai;25;16;41
95;04.08.2015;2015;08;15;Tiistai;23;36;59
95;04.08.2015;2015;08;16;Tiistai;29;57;86
95;04.08.2015;2015;08;17;Tiistai;32;36;68
95;04.08.2015;2015;08;18;Tiistai;27;28;55
95;04.08.2015;2015;08;19;Tiistai;18;37;55
95;04.08.2015;2015;08;20;Tiistai;20;24;44
95;04.08.2015;2015;08;21;Tiistai;11;18;29
95;04.08.2015;2015;08;22;Tiistai;1;8;9
95;04.08.2015;2015;08;23;Tiistai;2;2;4
95;05.08.2015;2015;08;00;Keskiviikko;0;0;0
95;05.08.2015;2015;08;01;Keskiviikko;1;1;2
95;05.08.2015;2015;08;02;Keskiviikko;0;1;1
95;05.08.2015;2015;08;03;Keskiviikko;0;3;3
95;05.08.2015;2015;08;04;Keskiviikko;3;1;4
95;05.08.2015;2015;08;05;Keskiviikko;6;2;8
95;05.08.2015;2015;08;06;Keskiviikko;28;13;41
95;05.08.2015;2015;08;07;Keskiviikko;35;23;58
95;05.08.2015;2015;08;08;Keskiviikko;13;16;29
95;05.08.2015;2015;08;09;Keskiviikko;16;9;25
95;05.08.2015;2015;08;10;Keskiviikko;12;18;30
95;05.08.2015;2015;08;11;Keskiviikko;26;15;41
95;05.08.2015;2015;08;12;Keskiviikko;31;21;52
95;05.08.2015;2015;08;13;Keskiviikko;24;24;48
95;05.08.2015;2015;08;14;Keskiviikko;22;31;53
95;05.08.2015;2015;08;15;Keskiviikko;40;38;78
95;05.08.2015;2015;08;16;Keskiviikko;30;53;83
95;05.08.2015;2015;08;17;Keskiviikko;32;40;72
95;05.08.2015;2015;08;18;Keskiviikko;24;38;62
95;05.08.2015;2015;08;19;Keskiviikko;28;28;56
95;05.08.2015;2015;08;20;Keskiviikko;16;20;36
95;05.08.2015;2015;08;21;Keskiviikko;10;13;23
95;05.08.2015;2015;08;22;Keskiviikko;8;7;15
95;05.08.2015;2015;08;23;Keskiviikko;0;4;4
95;06.08.2015;2015;08;00;Torstai;0;0;0
95;06.08.2015;2015;08;01;Torstai;0;0;0
95;06.08.2015;2015;08;02;Torstai;0;0;0
95;06.08.2015;2015;08;03;Torstai;0;1;1
95;06.08.2015;2015;08;04;Torstai;2;1;3
95;06.08.2015;2015;08;05;Torstai;5;3;8
95;06.08.2015;2015;08;06;Torstai;27;15;42
95;06.08.2015;2015;08;07;Torstai;19;11;30
95;06.08.2015;2015;08;08;Torstai;4;13;17
95;06.08.2015;2015;08;09;Torstai;11;4;15
95;06.08.2015;2015;08;10;Torstai;3;2;5
95;06.08.2015;2015;08;11;Torstai;8;4;12
95;06.08.2015;2015;08;12;Torstai;9;7;16
95;06.08.2015;2015;08;13;Torstai;12;14;26
95;06.08.2015;2015;08;14;Torstai;13;11;24
95;06.08.2015;2015;08;15;Torstai;7;16;23
95;06.08.2015;2015;08;16;Torstai;13;16;29
95;06.08.2015;2015;08;17;Torstai;8;11;19
95;06.08.2015;2015;08;18;Torstai;4;10;14
95;06.08.2015;2015;08;19;Torstai;7;5;12
95;06.08.2015;2015;08;20;Torstai;5;4;9
95;06.08.2015;2015;08;21;Torstai;3;6;9
95;06.08.2015;2015;08;22;Torstai;1;2;3
95;06.08.2015;2015;08;23;Torstai;2;2;4
95;07.08.2015;2015;08;00;Perjantai;0;1;1
95;07.08.2015;2015;08;01;Perjantai;0;0;0
95;07.08.2015;2015;08;02;Perjantai;0;0;0
95;07.08.2015;2015;08;03;Perjantai;0;1;1
95;07.08.2015;2015;08;04;Perjantai;3;2;5
95;07.08.2015;2015;08;05;Perjantai;4;3;7
95;07.08.2015;2015;08;06;Perjantai;23;7;30
95;07.08.2015;2015;08;07;Perjantai;11;7;18
95;07.08.2015;2015;08;08;Perjantai;7;11;18
95;07.08.2015;2015;08;09;Perjantai;0;5;5
95;07.08.2015;2015;08;10;Perjantai;11;8;19
95;07.08.2015;2015;08;11;Perjantai;12;9;21
95;07.08.2015;2015;08;12;Perjantai;17;9;26
95;07.08.2015;2015;08;13;Perjantai;12;10;22
95;07.08.2015;2015;08;14;Perjantai;16;19;35
95;07.08.2015;2015;08;15;Perjantai;18;24;42
95;07.08.2015;2015;08;16;Perjantai;19;29;48
95;07.08.2015;2015;08;17;Perjantai;16;31;47
95;07.08.2015;2015;08;18;Perjantai;23;22;45
95;07.08.2015;2015;08;19;Perjantai;18;23;41
95;07.08.2015;2015;08;20;Perjantai;16;17;33
95;07.08.2015;2015;08;21;Perjantai;9;14;23
95;07.08.2015;2015;08;22;Perjantai;3;5;8
95;07.08.2015;2015;08;23;Perjantai;1;0;1
95;08.08.2015;2015;08;00;Lauantai;1;1;2
95;08.08.2015;2015;08;01;Lauantai;0;1;1
95;08.08.2015;2015;08;02;Lauantai;2;2;4
95;08.08.2015;2015;08;03;Lauantai;0;2;2
95;08.08.2015;2015;08;04;Lauantai;0;0;0
95;08.08.2015;2015;08;05;Lauantai;2;1;3
95;08.08.2015;2015;08;06;Lauantai;3;2;5
95;08.08.2015;2015;08;07;Lauantai;4;3;7
95;08.08.2015;2015;08;08;Lauantai;10;5;15
95;08.08.2015;2015;08;09;Lauantai;12;12;24
95;08.08.2015;2015;08;10;Lauantai;12;15;27
95;08.08.2015;2015;08;11;Lauantai;14;13;27
95;08.08.2015;2015;08;12;Lauantai;10;19;29
95;08.08.2015;2015;08;13;Lauantai;22;17;39
95;08.08.2015;2015;08;14;Lauantai;21;28;49
95;08.08.2015;2015;08;15;Lauantai;10;19;29
95;08.08.2015;2015;08;16;Lauantai;4;10;14
95;08.08.2015;2015;08;17;Lauantai;19;18;37
95;08.08.2015;2015;08;18;Lauantai;17;20;37
95;08.08.2015;2015;08;19;Lauantai;9;17;26
95;08.08.2015;2015;08;20;Lauantai;14;14;28
95;08.08.2015;2015;08;21;Lauantai;4;8;12
95;08.08.2015;2015;08;22;Lauantai;5;3;8
95;08.08.2015;2015;08;23;Lauantai;0;3;3
95;09.08.2015;2015;08;00;Sunnuntai;1;3;4
95;09.08.2015;2015;08;01;Sunnuntai;0;0;0
95;09.08.2015;2015;08;02;Sunnuntai;0;1;1
95;09.08.2015;2015;08;03;Sunnuntai;4;3;7
95;09.08.2015;2015;08;04;Sunnuntai;0;1;1
95;09.08.2015;2015;08;05;Sunnuntai;1;0;1
95;09.08.2015;2015;08;06;Sunnuntai;3;2;5
95;09.08.2015;2015;08;07;Sunnuntai;2;0;2
95;09.08.2015;2015;08;08;Sunnuntai;3;4;7
95;09.08.2015;2015;08;09;Sunnuntai;15;13;28
95;09.08.2015;2015;08;10;Sunnuntai;12;31;43
95;09.08.2015;2015;08;11;Sunnuntai;19;16;35
95;09.08.2015;2015;08;12;Sunnuntai;43;20;63
95;09.08.2015;2015;08;13;Sunnuntai;27;27;54
95;09.08.2015;2015;08;14;Sunnuntai;20;24;44
95;09.08.2015;2015;08;15;Sunnuntai;22;25;47
95;09.08.2015;2015;08;16;Sunnuntai;21;19;40
95;09.08.2015;2015;08;17;Sunnuntai;22;24;46
95;09.08.2015;2015;08;18;Sunnuntai;9;27;36
95;09.08.2015;2015;08;19;Sunnuntai;15;17;32
95;09.08.2015;2015;08;20;Sunnuntai;18;17;35
95;09.08.2015;2015;08;21;Sunnuntai;4;18;22
95;09.08.2015;2015;08;22;Sunnuntai;0;2;2
95;09.08.2015;2015;08;23;Sunnuntai;0;1;1
95;10.08.2015;2015;08;00;Maanantai;0;4;4
95;10.08.2015;2015;08;01;Maanantai;0;0;0
95;10.08.2015;2015;08;02;Maanantai;0;0;0
95;10.08.2015;2015;08;03;Maanantai;0;0;0
95;10.08.2015;2015;08;04;Maanantai;2;0;2
95;10.08.2015;2015;08;05;Maanantai;6;3;9
95;10.08.2015;2015;08;06;Maanantai;39;18;57
95;10.08.2015;2015;08;07;Maanantai;42;20;62
95;10.08.2015;2015;08;08;Maanantai;22;14;36
95;10.08.2015;2015;08;09;Maanantai;15;8;23
95;10.08.2015;2015;08;10;Maanantai;13;16;29
95;10.08.2015;2015;08;11;Maanantai;22;29;51
95;10.08.2015;2015;08;12;Maanantai;18;19;37
95;10.08.2015;2015;08;13;Maanantai;27;17;44
95;10.08.2015;2015;08;14;Maanantai;24;29;53
95;10.08.2015;2015;08;15;Maanantai;35;50;85
95;10.08.2015;2015;08;16;Maanantai;33;63;96
95;10.08.2015;2015;08;17;Maanantai;18;41;59
95;10.08.2015;2015;08;18;Maanantai;22;35;57
95;10.08.2015;2015;08;19;Maanantai;21;26;47
95;10.08.2015;2015;08;20;Maanantai;18;29;47
95;10.08.2015;2015;08;21;Maanantai;11;14;25
95;10.08.2015;2015;08;22;Maanantai;7;1;8
95;10.08.2015;2015;08;23;Maanantai;0;2;2
95;11.08.2015;2015;08;00;Tiistai;0;0;0
95;11.08.2015;2015;08;01;Tiistai;0;0;0
95;11.08.2015;2015;08;02;Tiistai;0;0;0
95;11.08.2015;2015;08;03;Tiistai;1;1;2
95;11.08.2015;2015;08;04;Tiistai;3;0;3
95;11.08.2015;2015;08;05;Tiistai;7;1;8
95;11.08.2015;2015;08;06;Tiistai;38;16;54
95;11.08.2015;2015;08;07;Tiistai;38;26;64
95;11.08.2015;2015;08;08;Tiistai;20;14;34
95;11.08.2015;2015;08;09;Tiistai;27;11;38
95;11.08.2015;2015;08;10;Tiistai;20;14;34
95;11.08.2015;2015;08;11;Tiistai;14;33;47
95;11.08.2015;2015;08;12;Tiistai;26;20;46
95;11.08.2015;2015;08;13;Tiistai;14;27;41
95;11.08.2015;2015;08;14;Tiistai;25;21;46
95;11.08.2015;2015;08;15;Tiistai;30;45;75
95;11.08.2015;2015;08;16;Tiistai;37;53;90
95;11.08.2015;2015;08;17;Tiistai;20;37;57
95;11.08.2015;2015;08;18;Tiistai;17;20;37
95;11.08.2015;2015;08;19;Tiistai;8;14;22
95;11.08.2015;2015;08;20;Tiistai;10;13;23
95;11.08.2015;2015;08;21;Tiistai;12;12;24
95;11.08.2015;2015;08;22;Tiistai;12;5;17
95;11.08.2015;2015;08;23;Tiistai;2;1;3
95;12.08.2015;2015;08;00;Keskiviikko;0;1;1
95;12.08.2015;2015;08;01;Keskiviikko;1;0;1
95;12.08.2015;2015;08;02;Keskiviikko;0;0;0
95;12.08.2015;2015;08;03;Keskiviikko;0;1;1
95;12.08.2015;2015;08;04;Keskiviikko;2;0;2
95;12.08.2015;2015;08;05;Keskiviikko;6;3;9
95;12.08.2015;2015;08;06;Keskiviikko;22;9;31
95;12.08.2015;2015;08;07;Keskiviikko;28;20;48
95;12.08.2015;2015;08;08;Keskiviikko;9;16;25
95;12.08.2015;2015;08;09;Keskiviikko;9;12;21
95;12.08.2015;2015;08;10;Keskiviikko;7;10;17
95;12.08.2015;2015;08;11;Keskiviikko;11;14;25
95;12.08.2015;2015;08;12;Keskiviikko;15;8;23
95;12.08.2015;2015;08;13;Keskiviikko;12;13;25
95;12.08.2015;2015;08;14;Keskiviikko;21;12;33
95;12.08.2015;2015;08;15;Keskiviikko;23;26;49
95;12.08.2015;2015;08;16;Keskiviikko;28;41;69
95;12.08.2015;2015;08;17;Keskiviikko;25;30;55
95;12.08.2015;2015;08;18;Keskiviikko;24;39;63
95;12.08.2015;2015;08;19;Keskiviikko;17;28;45
95;12.08.2015;2015;08;20;Keskiviikko;26;19;45
95;12.08.2015;2015;08;21;Keskiviikko;11;6;17
95;12.08.2015;2015;08;22;Keskiviikko;4;3;7
95;12.08.2015;2015;08;23;Keskiviikko;0;1;1
95;13.08.2015;2015;08;00;Torstai;0;1;1
95;13.08.2015;2015;08;01;Torstai;2;1;3
95;13.08.2015;2015;08;02;Torstai;2;2;4
95;13.08.2015;2015;08;03;Torstai;0;1;1
95;13.08.2015;2015;08;04;Torstai;2;0;2
95;13.08.2015;2015;08;05;Torstai;4;3;7
95;13.08.2015;2015;08;06;Torstai;32;12;44
95;13.08.2015;2015;08;07;Torstai;37;27;64
95;13.08.2015;2015;08;08;Torstai;20;29;49
95;13.08.2015;2015;08;09;Torstai;15;10;25
95;13.08.2015;2015;08;10;Torstai;13;16;29
95;13.08.2015;2015;08;11;Torstai;9;19;28
95;13.08.2015;2015;08;12;Torstai;22;12;34
95;13.08.2015;2015;08;13;Torstai;27;11;38
95;13.08.2015;2015;08;14;Torstai;19;23;42
95;13.08.2015;2015;08;15;Torstai;28;35;63
95;13.08.2015;2015;08;16;Torstai;39;43;82
95;13.08.2015;2015;08;17;Torstai;23;34;57
95;13.08.2015;2015;08;18;Torstai;16;21;37
95;13.08.2015;2015;08;19;Torstai;18;28;46
95;13.08.2015;2015;08;20;Torstai;17;13;30
95;13.08.2015;2015;08;21;Torstai;7;13;20
95;13.08.2015;2015;08;22;Torstai;8;1;9
95;13.08.2015;2015;08;23;Torstai;0;3;3
95;14.08.2015;2015;08;00;Perjantai;0;1;1
95;14.08.2015;2015;08;01;Perjantai;2;0;2
95;14.08.2015;2015;08;02;Perjantai;0;0;0
95;14.08.2015;2015;08;03;Perjantai;1;0;1
95;14.08.2015;2015;08;04;Perjantai;4;0;4
95;14.08.2015;2015;08;05;Perjantai;5;4;9
95;14.08.2015;2015;08;06;Perjantai;24;17;41
95;14.08.2015;2015;08;07;Perjantai;35;31;66
95;14.08.2015;2015;08;08;Perjantai;14;15;29
95;14.08.2015;2015;08;09;Perjantai;7;6;13
95;14.08.2015;2015;08;10;Perjantai;5;7;12
95;14.08.2015;2015;08;11;Perjantai;9;6;15
95;14.08.2015;2015;08;12;Perjantai;14;10;24
95;14.08.2015;2015;08;13;Perjantai;18;13;31
95;14.08.2015;2015;08;14;Perjantai;22;21;43
95;14.08.2015;2015;08;15;Perjantai;26;29;55
95;14.08.2015;2015;08;16;Perjantai;27;37;64
95;14.08.2015;2015;08;17;Perjantai;20;24;44
95;14.08.2015;2015;08;18;Perjantai;17;18;35
95;14.08.2015;2015;08;19;Perjantai;16;17;33
95;14.08.2015;2015;08;20;Perjantai;11;14;25
95;14.08.2015;2015;08;21;Perjantai;5;13;18
95;14.08.2015;2015;08;22;Perjantai;4;3;7
95;14.08.2015;2015;08;23;Perjantai;0;1;1
95;15.08.2015;2015;08;00;Lauantai;1;2;3
95;15.08.2015;2015;08;01;Lauantai;0;0;0
95;15.08.2015;2015;08;02;Lauantai;0;3;3
95;15.08.2015;2015;08;03;Lauantai;0;0;0
95;15.08.2015;2015;08;04;Lauantai;2;0;2
95;15.08.2015;2015;08;05;Lauantai;2;0;2
95;15.08.2015;2015;08;06;Lauantai;2;1;3
95;15.08.2015;2015;08;07;Lauantai;2;3;5
95;15.08.2015;2015;08;08;Lauantai;7;7;14
95;15.08.2015;2015;08;09;Lauantai;12;8;20
95;15.08.2015;2015;08;10;Lauantai;26;21;47
95;15.08.2015;2015;08;11;Lauantai;17;18;35
95;15.08.2015;2015;08;12;Lauantai;35;21;56
95;15.08.2015;2015;08;13;Lauantai;9;27;36
95;15.08.2015;2015;08;14;Lauantai;28;26;54
95;15.08.2015;2015;08;15;Lauantai;12;18;30
95;15.08.2015;2015;08;16;Lauantai;21;22;43
95;15.08.2015;2015;08;17;Lauantai;18;17;35
95;15.08.2015;2015;08;18;Lauantai;15;26;41
95;15.08.2015;2015;08;19;Lauantai;11;15;26
95;15.08.2015;2015;08;20;Lauantai;8;9;17
95;15.08.2015;2015;08;21;Lauantai;8;11;19
95;15.08.2015;2015;08;22;Lauantai;4;4;8
95;15.08.2015;2015;08;23;Lauantai;0;3;3
95;16.08.2015;2015;08;00;Sunnuntai;0;3;3
95;16.08.2015;2015;08;01;Sunnuntai;3;0;3
95;16.08.2015;2015;08;02;Sunnuntai;1;0;1
95;16.08.2015;2015;08;03;Sunnuntai;0;0;0
95;16.08.2015;2015;08;04;Sunnuntai;0;2;2
95;16.08.2015;2015;08;05;Sunnuntai;2;1;3
95;16.08.2015;2015;08;06;Sunnuntai;3;3;6
95;16.08.2015;2015;08;07;Sunnuntai;3;6;9
95;16.08.2015;2015;08;08;Sunnuntai;2;4;6
95;16.08.2015;2015;08;09;Sunnuntai;14;4;18
95;16.08.2015;2015;08;10;Sunnuntai;22;41;63
95;16.08.2015;2015;08;11;Sunnuntai;25;21;46
95;16.08.2015;2015;08;12;Sunnuntai;20;32;52
95;16.08.2015;2015;08;13;Sunnuntai;44;40;84
95;16.08.2015;2015;08;14;Sunnuntai;33;25;58
95;16.08.2015;2015;08;15;Sunnuntai;26;37;63
95;16.08.2015;2015;08;16;Sunnuntai;22;36;58
95;16.08.2015;2015;08;17;Sunnuntai;20;28;48
95;16.08.2015;2015;08;18;Sunnuntai;13;33;46
95;16.08.2015;2015;08;19;Sunnuntai;20;13;33
95;16.08.2015;2015;08;20;Sunnuntai;25;15;40
95;16.08.2015;2015;08;21;Sunnuntai;7;10;17
95;16.08.2015;2015;08;22;Sunnuntai;0;2;2
95;16.08.2015;2015;08;23;Sunnuntai;1;1;2
95;17.08.2015;2015;08;00;Maanantai;0;0;0
95;17.08.2015;2015;08;01;Maanantai;0;0;0
95;17.08.2015;2015;08;02;Maanantai;0;0;0
95;17.08.2015;2015;08;03;Maanantai;0;0;0
95;17.08.2015;2015;08;04;Maanantai;0;1;1
95;17.08.2015;2015;08;05;Maanantai;8;2;10
95;17.08.2015;2015;08;06;Maanantai;40;20;60
95;17.08.2015;2015;08;07;Maanantai;40;27;67
95;17.08.2015;2015;08;08;Maanantai;13;20;33
95;17.08.2015;2015;08;09;Maanantai;25;16;41
95;17.08.2015;2015;08;10;Maanantai;16;17;33
95;17.08.2015;2015;08;11;Maanantai;19;17;36
95;17.08.2015;2015;08;12;Maanantai;33;23;56
95;17.08.2015;2015;08;13;Maanantai;22;23;45
95;17.08.2015;2015;08;14;Maanantai;30;18;48
95;17.08.2015;2015;08;15;Maanantai;35;46;81
95;17.08.2015;2015;08;16;Maanantai;38;52;90
95;17.08.2015;2015;08;17;Maanantai;26;47;73
95;17.08.2015;2015;08;18;Maanantai;35;39;74
95;17.08.2015;2015;08;19;Maanantai;23;20;43
95;17.08.2015;2015;08;20;Maanantai;27;20;47
95;17.08.2015;2015;08;21;Maanantai;13;19;32
95;17.08.2015;2015;08;22;Maanantai;6;3;9
95;17.08.2015;2015;08;23;Maanantai;1;3;4
95;18.08.2015;2015;08;00;Tiistai;0;2;2
95;18.08.2015;2015;08;01;Tiistai;0;0;0
95;18.08.2015;2015;08;02;Tiistai;0;1;1
95;18.08.2015;2015;08;03;Tiistai;0;0;0
95;18.08.2015;2015;08;04;Tiistai;4;1;5
95;18.08.2015;2015;08;05;Tiistai;12;1;13
95;18.08.2015;2015;08;06;Tiistai;41;17;58
95;18.08.2015;2015;08;07;Tiistai;42;40;82
95;18.08.2015;2015;08;08;Tiistai;14;19;33
95;18.08.2015;2015;08;09;Tiistai;14;12;26
95;18.08.2015;2015;08;10;Tiistai;26;12;38
95;18.08.2015;2015;08;11;Tiistai;43;18;61
95;18.08.2015;2015;08;12;Tiistai;17;14;31
95;18.08.2015;2015;08;13;Tiistai;24;34;58
95;18.08.2015;2015;08;14;Tiistai;25;21;46
95;18.08.2015;2015;08;15;Tiistai;37;40;77
95;18.08.2015;2015;08;16;Tiistai;45;74;119
95;18.08.2015;2015;08;17;Tiistai;29;48;77
95;18.08.2015;2015;08;18;Tiistai;23;24;47
95;18.08.2015;2015;08;19;Tiistai;24;45;69
95;18.08.2015;2015;08;20;Tiistai;12;23;35
95;18.08.2015;2015;08;21;Tiistai;12;8;20
95;18.08.2015;2015;08;22;Tiistai;3;6;9
95;18.08.2015;2015;08;23;Tiistai;2;3;5
95;19.08.2015;2015;08;00;Keskiviikko;0;2;2
95;19.08.2015;2015;08;01;Keskiviikko;0;0;0
95;19.08.2015;2015;08;02;Keskiviikko;0;0;0
95;19.08.2015;2015;08;03;Keskiviikko;0;0;0
95;19.08.2015;2015;08;04;Keskiviikko;2;2;4
95;19.08.2015;2015;08;05;Keskiviikko;14;3;17
95;19.08.2015;2015;08;06;Keskiviikko;32;19;51
95;19.08.2015;2015;08;07;Keskiviikko;48;34;82
95;19.08.2015;2015;08;08;Keskiviikko;20;14;34
95;19.08.2015;2015;08;09;Keskiviikko;15;16;31
95;19.08.2015;2015;08;10;Keskiviikko;20;16;36
95;19.08.2015;2015;08;11;Keskiviikko;20;12;32
95;19.08.2015;2015;08;12;Keskiviikko;27;20;47
95;19.08.2015;2015;08;13;Keskiviikko;24;22;46
95;19.08.2015;2015;08;14;Keskiviikko;31;35;66
95;19.08.2015;2015;08;15;Keskiviikko;26;47;73
95;19.08.2015;2015;08;16;Keskiviikko;34;73;107
95;19.08.2015;2015;08;17;Keskiviikko;41;47;88
95;19.08.2015;2015;08;18;Keskiviikko;23;37;60
95;19.08.2015;2015;08;19;Keskiviikko;22;33;55
95;19.08.2015;2015;08;20;Keskiviikko;25;18;43
95;19.08.2015;2015;08;21;Keskiviikko;12;11;23
95;19.08.2015;2015;08;22;Keskiviikko;2;5;7
95;19.08.2015;2015;08;23;Keskiviikko;0;1;1
95;20.08.2015;2015;08;00;Torstai;0;0;0
95;20.08.2015;2015;08;01;Torstai;0;0;0
95;20.08.2015;2015;08;02;Torstai;0;0;0
95;20.08.2015;2015;08;03;Torstai;0;0;0
95;20.08.2015;2015;08;04;Torstai;4;1;5
95;20.08.2015;2015;08;05;Torstai;10;1;11
95;20.08.2015;2015;08;06;Torstai;37;15;52
95;20.08.2015;2015;08;07;Torstai;42;26;68
95;20.08.2015;2015;08;08;Torstai;23;17;40
95;20.08.2015;2015;08;09;Torstai;10;12;22
95;20.08.2015;2015;08;10;Torstai;26;10;36
95;20.08.2015;2015;08;11;Torstai;19;21;40
95;20.08.2015;2015;08;12;Torstai;18;19;37
95;20.08.2015;2015;08;13;Torstai;18;17;35
95;20.08.2015;2015;08;14;Torstai;20;23;43
95;20.08.2015;2015;08;15;Torstai;46;50;96
95;20.08.2015;2015;08;16;Torstai;34;63;97
95;20.08.2015;2015;08;17;Torstai;30;45;75
95;20.08.2015;2015;08;18;Torstai;18;29;47
95;20.08.2015;2015;08;19;Torstai;24;29;53
95;20.08.2015;2015;08;20;Torstai;21;15;36
95;20.08.2015;2015;08;21;Torstai;14;10;24
95;20.08.2015;2015;08;22;Torstai;5;10;15
95;20.08.2015;2015;08;23;Torstai;1;2;3
95;21.08.2015;2015;08;00;Perjantai;0;2;2
95;21.08.2015;2015;08;01;Perjantai;0;2;2
95;21.08.2015;2015;08;02;Perjantai;0;1;1
95;21.08.2015;2015;08;03;Perjantai;0;0;0
95;21.08.2015;2015;08;04;Perjantai;3;1;4
95;21.08.2015;2015;08;05;Perjantai;6;2;8
95;21.08.2015;2015;08;06;Perjantai;27;8;35
95;21.08.2015;2015;08;07;Perjantai;32;36;68
95;21.08.2015;2015;08;08;Perjantai;10;14;24
95;21.08.2015;2015;08;09;Perjantai;9;5;14
95;21.08.2015;2015;08;10;Perjantai;10;8;18
95;21.08.2015;2015;08;11;Perjantai;14;11;25
95;21.08.2015;2015;08;12;Perjantai;18;13;31
95;21.08.2015;2015;08;13;Perjantai;24;18;42
95;21.08.2015;2015;08;14;Perjantai;18;33;51
95;21.08.2015;2015;08;15;Perjantai;28;37;65
95;21.08.2015;2015;08;16;Perjantai;25;37;62
95;21.08.2015;2015;08;17;Perjantai;15;38;53
95;21.08.2015;2015;08;18;Perjantai;19;15;34
95;21.08.2015;2015;08;19;Perjantai;20;18;38
95;21.08.2015;2015;08;20;Perjantai;13;11;24
95;21.08.2015;2015;08;21;Perjantai;6;8;14
95;21.08.2015;2015;08;22;Perjantai;3;3;6
95;21.08.2015;2015;08;23;Perjantai;0;2;2
95;22.08.2015;2015;08;00;Lauantai;1;1;2
95;22.08.2015;2015;08;01;Lauantai;1;2;3
95;22.08.2015;2015;08;02;Lauantai;1;0;1
95;22.08.2015;2015;08;03;Lauantai;0;0;0
95;22.08.2015;2015;08;04;Lauantai;1;0;1
95;22.08.2015;2015;08;05;Lauantai;2;2;4
95;22.08.2015;2015;08;06;Lauantai;1;0;1
95;22.08.2015;2015;08;07;Lauantai;4;5;9
95;22.08.2015;2015;08;08;Lauantai;6;5;11
95;22.08.2015;2015;08;09;Lauantai;8;4;12
95;22.08.2015;2015;08;10;Lauantai;14;21;35
95;22.08.2015;2015;08;11;Lauantai;30;11;41
95;22.08.2015;2015;08;12;Lauantai;26;26;52
95;22.08.2015;2015;08;13;Lauantai;17;11;28
95;22.08.2015;2015;08;14;Lauantai;15;26;41
95;22.08.2015;2015;08;15;Lauantai;18;26;44
95;22.08.2015;2015;08;16;Lauantai;27;30;57
95;22.08.2015;2015;08;17;Lauantai;26;24;50
95;22.08.2015;2015;08;18;Lauantai;16;21;37
95;22.08.2015;2015;08;19;Lauantai;24;17;41
95;22.08.2015;2015;08;20;Lauantai;16;8;24
95;22.08.2015;2015;08;21;Lauantai;5;9;14
95;22.08.2015;2015;08;22;Lauantai;2;3;5
95;22.08.2015;2015;08;23;Lauantai;1;0;1
95;23.08.2015;2015;08;00;Sunnuntai;0;3;3
95;23.08.2015;2015;08;01;Sunnuntai;0;2;2
95;23.08.2015;2015;08;02;Sunnuntai;1;1;2
95;23.08.2015;2015;08;03;Sunnuntai;0;1;1
95;23.08.2015;2015;08;04;Sunnuntai;0;0;0
95;23.08.2015;2015;08;05;Sunnuntai;3;0;3
95;23.08.2015;2015;08;06;Sunnuntai;5;1;6
95;23.08.2015;2015;08;07;Sunnuntai;5;2;7
95;23.08.2015;2015;08;08;Sunnuntai;11;5;16
95;23.08.2015;2015;08;09;Sunnuntai;9;14;23
95;23.08.2015;2015;08;10;Sunnuntai;21;23;44
95;23.08.2015;2015;08;11;Sunnuntai;24;24;48
95;23.08.2015;2015;08;12;Sunnuntai;50;32;82
95;23.08.2015;2015;08;13;Sunnuntai;32;30;62
95;23.08.2015;2015;08;14;Sunnuntai;35;23;58
95;23.08.2015;2015;08;15;Sunnuntai;30;48;78
95;23.08.2015;2015;08;16;Sunnuntai;17;38;55
95;23.08.2015;2015;08;17;Sunnuntai;35;33;68
95;23.08.2015;2015;08;18;Sunnuntai;24;34;58
95;23.08.2015;2015;08;19;Sunnuntai;22;17;39
95;23.08.2015;2015;08;20;Sunnuntai;14;13;27
95;23.08.2015;2015;08;21;Sunnuntai;1;7;8
95;23.08.2015;2015;08;22;Sunnuntai;2;1;3
95;23.08.2015;2015;08;23;Sunnuntai;1;2;3
95;24.08.2015;2015;08;00;Maanantai;0;0;0
95;24.08.2015;2015;08;01;Maanantai;2;1;3
95;24.08.2015;2015;08;02;Maanantai;1;0;1
95;24.08.2015;2015;08;03;Maanantai;0;0;0
95;24.08.2015;2015;08;04;Maanantai;3;0;3
95;24.08.2015;2015;08;05;Maanantai;10;1;11
95;24.08.2015;2015;08;06;Maanantai;36;12;48
95;24.08.2015;2015;08;07;Maanantai;47;31;78
95;24.08.2015;2015;08;08;Maanantai;19;20;39
95;24.08.2015;2015;08;09;Maanantai;20;15;35
95;24.08.2015;2015;08;10;Maanantai;25;14;39
95;24.08.2015;2015;08;11;Maanantai;19;25;44
95;24.08.2015;2015;08;12;Maanantai;28;20;48
95;24.08.2015;2015;08;13;Maanantai;29;26;55
95;24.08.2015;2015;08;14;Maanantai;24;17;41
95;24.08.2015;2015;08;15;Maanantai;23;36;59
95;24.08.2015;2015;08;16;Maanantai;49;49;98
95;24.08.2015;2015;08;17;Maanantai;28;56;84
95;24.08.2015;2015;08;18;Maanantai;17;43;60
95;24.08.2015;2015;08;19;Maanantai;21;33;54
95;24.08.2015;2015;08;20;Maanantai;22;16;38
95;24.08.2015;2015;08;21;Maanantai;5;12;17
95;24.08.2015;2015;08;22;Maanantai;1;1;2
95;24.08.2015;2015;08;23;Maanantai;0;1;1
95;25.08.2015;2015;08;00;Tiistai;1;0;1
95;25.08.2015;2015;08;01;Tiistai;0;0;0
95;25.08.2015;2015;08;02;Tiistai;0;0;0
95;25.08.2015;2015;08;03;Tiistai;0;1;1
95;25.08.2015;2015;08;04;Tiistai;4;2;6
95;25.08.2015;2015;08;05;Tiistai;5;2;7
95;25.08.2015;2015;08;06;Tiistai;47;11;58
95;25.08.2015;2015;08;07;Tiistai;44;34;78
95;25.08.2015;2015;08;08;Tiistai;21;19;40
95;25.08.2015;2015;08;09;Tiistai;22;8;30
95;25.08.2015;2015;08;10;Tiistai;27;12;39
95;25.08.2015;2015;08;11;Tiistai;25;19;44
95;25.08.2015;2015;08;12;Tiistai;23;18;41
95;25.08.2015;2015;08;13;Tiistai;23;32;55
95;25.08.2015;2015;08;14;Tiistai;32;23;55
95;25.08.2015;2015;08;15;Tiistai;24;43;67
95;25.08.2015;2015;08;16;Tiistai;43;67;110
95;25.08.2015;2015;08;17;Tiistai;29;59;88
95;25.08.2015;2015;08;18;Tiistai;31;26;57
95;25.08.2015;2015;08;19;Tiistai;25;32;57
95;25.08.2015;2015;08;20;Tiistai;17;20;37
95;25.08.2015;2015;08;21;Tiistai;14;19;33
95;25.08.2015;2015;08;22;Tiistai;3;2;5
95;25.08.2015;2015;08;23;Tiistai;0;0;0
95;26.08.2015;2015;08;00;Keskiviikko;1;0;1
95;26.08.2015;2015;08;01;Keskiviikko;0;0;0
95;26.08.2015;2015;08;02;Keskiviikko;0;0;0
95;26.08.2015;2015;08;03;Keskiviikko;0;1;1
95;26.08.2015;2015;08;04;Keskiviikko;1;0;1
95;26.08.2015;2015;08;05;Keskiviikko;6;2;8
95;26.08.2015;2015;08;06;Keskiviikko;39;8;47
95;26.08.2015;2015;08;07;Keskiviikko;41;40;81
95;26.08.2015;2015;08;08;Keskiviikko;27;23;50
95;26.08.2015;2015;08;09;Keskiviikko;13;20;33
95;26.08.2015;2015;08;10;Keskiviikko;20;8;28
95;26.08.2015;2015;08;11;Keskiviikko;15;8;23
95;26.08.2015;2015;08;12;Keskiviikko;17;16;33
95;26.08.2015;2015;08;13;Keskiviikko;22;19;41
95;26.08.2015;2015;08;14;Keskiviikko;16;19;35
95;26.08.2015;2015;08;15;Keskiviikko;29;26;55
95;26.08.2015;2015;08;16;Keskiviikko;34;46;80
95;26.08.2015;2015;08;17;Keskiviikko;39;36;75
95;26.08.2015;2015;08;18;Keskiviikko;25;36;61
95;26.08.2015;2015;08;19;Keskiviikko;15;37;52
95;26.08.2015;2015;08;20;Keskiviikko;17;19;36
95;26.08.2015;2015;08;21;Keskiviikko;5;11;16
95;26.08.2015;2015;08;22;Keskiviikko;5;2;7
95;26.08.2015;2015;08;23;Keskiviikko;0;2;2
95;27.08.2015;2015;08;00;Torstai;0;1;1
95;27.08.2015;2015;08;01;Torstai;1;0;1
95;27.08.2015;2015;08;02;Torstai;0;0;0
95;27.08.2015;2015;08;03;Torstai;0;0;0
95;27.08.2015;2015;08;04;Torstai;0;0;0
95;27.08.2015;2015;08;05;Torstai;9;2;11
95;27.08.2015;2015;08;06;Torstai;23;9;32
95;27.08.2015;2015;08;07;Torstai;27;17;44
95;27.08.2015;2015;08;08;Torstai;15;12;27
95;27.08.2015;2015;08;09;Torstai;10;10;20
95;27.08.2015;2015;08;10;Torstai;12;11;23
95;27.08.2015;2015;08;11;Torstai;16;12;28
95;27.08.2015;2015;08;12;Torstai;14;14;28
95;27.08.2015;2015;08;13;Torstai;7;17;24
95;27.08.2015;2015;08;14;Torstai;18;11;29
95;27.08.2015;2015;08;15;Torstai;23;27;50
95;27.08.2015;2015;08;16;Torstai;24;28;52
95;27.08.2015;2015;08;17;Torstai;7;17;24
95;27.08.2015;2015;08;18;Torstai;16;13;29
95;27.08.2015;2015;08;19;Torstai;6;14;20
95;27.08.2015;2015;08;20;Torstai;19;15;34
95;27.08.2015;2015;08;21;Torstai;9;9;18
95;27.08.2015;2015;08;22;Torstai;2;3;5
95;27.08.2015;2015;08;23;Torstai;0;2;2
95;28.08.2015;2015;08;00;Perjantai;1;0;1
95;28.08.2015;2015;08;01;Perjantai;0;0;0
95;28.08.2015;2015;08;02;Perjantai;1;0;1
95;28.08.2015;2015;08;03;Perjantai;0;0;0
95;28.08.2015;2015;08;04;Perjantai;1;0;1
95;28.08.2015;2015;08;05;Perjantai;5;2;7
95;28.08.2015;2015;08;06;Perjantai;11;6;17
95;28.08.2015;2015;08;07;Perjantai;10;18;28
95;28.08.2015;2015;08;08;Perjantai;5;8;13
95;28.08.2015;2015;08;09;Perjantai;1;2;3
95;28.08.2015;2015;08;10;Perjantai;2;0;2
95;28.08.2015;2015;08;11;Perjantai;2;2;4
95;28.08.2015;2015;08;12;Perjantai;4;5;9
95;28.08.2015;2015;08;13;Perjantai;5;5;10
95;28.08.2015;2015;08;14;Perjantai;4;6;10
95;28.08.2015;2015;08;15;Perjantai;9;11;20
95;28.08.2015;2015;08;16;Perjantai;11;8;19
95;28.08.2015;2015;08;17;Perjantai;4;3;7
95;28.08.2015;2015;08;18;Perjantai;3;7;10
95;28.08.2015;2015;08;19;Perjantai;1;2;3
95;28.08.2015;2015;08;20;Perjantai;2;3;5
95;28.08.2015;2015;08;21;Perjantai;2;1;3
95;28.08.2015;2015;08;22;Perjantai;0;2;2
95;28.08.2015;2015;08;23;Perjantai;1;0;1
95;29.08.2015;2015;08;00;Lauantai;0;0;0
95;29.08.2015;2015;08;01;Lauantai;0;0;0
95;29.08.2015;2015;08;02;Lauantai;0;0;0
95;29.08.2015;2015;08;03;Lauantai;0;2;2
95;29.08.2015;2015;08;04;Lauantai;1;0;1
95;29.08.2015;2015;08;05;Lauantai;0;0;0
95;29.08.2015;2015;08;06;Lauantai;3;3;6
95;29.08.2015;2015;08;07;Lauantai;0;2;2
95;29.08.2015;2015;08;08;Lauantai;11;5;16
95;29.08.2015;2015;08;09;Lauantai;11;6;17
95;29.08.2015;2015;08;10;Lauantai;9;14;23
95;29.08.2015;2015;08;11;Lauantai;16;8;24
95;29.08.2015;2015;08;12;Lauantai;23;14;37
95;29.08.2015;2015;08;13;Lauantai;20;9;29
95;29.08.2015;2015;08;14;Lauantai;15;11;26
95;29.08.2015;2015;08;15;Lauantai;14;9;23
95;29.08.2015;2015;08;16;Lauantai;4;16;20
95;29.08.2015;2015;08;17;Lauantai;23;10;33
95;29.08.2015;2015;08;18;Lauantai;15;27;42
95;29.08.2015;2015;08;19;Lauantai;8;22;30
95;29.08.2015;2015;08;20;Lauantai;14;11;25
95;29.08.2015;2015;08;21;Lauantai;3;5;8
95;29.08.2015;2015;08;22;Lauantai;0;2;2
95;29.08.2015;2015;08;23;Lauantai;3;0;3
95;30.08.2015;2015;08;00;Sunnuntai;0;1;1
95;30.08.2015;2015;08;01;Sunnuntai;0;1;1
95;30.08.2015;2015;08;02;Sunnuntai;1;3;4
95;30.08.2015;2015;08;03;Sunnuntai;0;0;0
95;30.08.2015;2015;08;04;Sunnuntai;1;0;1
95;30.08.2015;2015;08;05;Sunnuntai;2;0;2
95;30.08.2015;2015;08;06;Sunnuntai;1;1;2
95;30.08.2015;2015;08;07;Sunnuntai;3;5;8
95;30.08.2015;2015;08;08;Sunnuntai;5;7;12
95;30.08.2015;2015;08;09;Sunnuntai;5;5;10
95;30.08.2015;2015;08;10;Sunnuntai;14;19;33
95;30.08.2015;2015;08;11;Sunnuntai;28;19;47
95;30.08.2015;2015;08;12;Sunnuntai;29;25;54
95;30.08.2015;2015;08;13;Sunnuntai;23;31;54
95;30.08.2015;2015;08;14;Sunnuntai;21;21;42
95;30.08.2015;2015;08;15;Sunnuntai;16;18;34
95;30.08.2015;2015;08;16;Sunnuntai;28;28;56
95;30.08.2015;2015;08;17;Sunnuntai;25;18;43
95;30.08.2015;2015;08;18;Sunnuntai;22;25;47
95;30.08.2015;2015;08;19;Sunnuntai;21;20;41
95;30.08.2015;2015;08;20;Sunnuntai;15;11;26
95;30.08.2015;2015;08;21;Sunnuntai;4;3;7
95;30.08.2015;2015;08;22;Sunnuntai;0;2;2
95;30.08.2015;2015;08;23;Sunnuntai;0;0;0
95;31.08.2015;2015;08;00;Maanantai;0;0;0
95;31.08.2015;2015;08;01;Maanantai;0;0;0
95;31.08.2015;2015;08;02;Maanantai;0;0;0
95;31.08.2015;2015;08;03;Maanantai;0;1;1
95;31.08.2015;2015;08;04;Maanantai;3;0;3
95;31.08.2015;2015;08;05;Maanantai;6;3;9
95;31.08.2015;2015;08;06;Maanantai;39;7;46
95;31.08.2015;2015;08;07;Maanantai;48;30;78
95;31.08.2015;2015;08;08;Maanantai;19;19;38
95;31.08.2015;2015;08;09;Maanantai;14;10;24
95;31.08.2015;2015;08;10;Maanantai;14;11;25
95;31.08.2015;2015;08;11;Maanantai;5;17;22
95;31.08.2015;2015;08;12;Maanantai;22;20;42
95;31.08.2015;2015;08;13;Maanantai;27;17;44
95;31.08.2015;2015;08;14;Maanantai;29;13;42
95;31.08.2015;2015;08;15;Maanantai;25;43;68
95;31.08.2015;2015;08;16;Maanantai;37;57;94
95;31.08.2015;2015;08;17;Maanantai;18;39;57
95;31.08.2015;2015;08;18;Maanantai;11;23;34
95;31.08.2015;2015;08;19;Maanantai;14;21;35
95;31.08.2015;2015;08;20;Maanantai;11;18;29
95;31.08.2015;2015;08;21;Maanantai;8;5;13
95;31.08.2015;2015;08;22;Maanantai;2;4;6
95;31.08.2015;2015;08;23;Maanantai;1;1;2
95;01.09.2015;2015;09;00;Tiistai;0;2;2
95;01.09.2015;2015;09;01;Tiistai;0;0;0
95;01.09.2015;2015;09;02;Tiistai;0;0;0
95;01.09.2015;2015;09;03;Tiistai;0;2;2
95;01.09.2015;2015;09;04;Tiistai;4;1;5
95;01.09.2015;2015;09;05;Tiistai;3;1;4
95;01.09.2015;2015;09;06;Tiistai;41;9;50
95;01.09.2015;2015;09;07;Tiistai;43;28;71
95;01.09.2015;2015;09;08;Tiistai;17;15;32
95;01.09.2015;2015;09;09;Tiistai;14;11;25
95;01.09.2015;2015;09;10;Tiistai;11;4;15
95;01.09.2015;2015;09;11;Tiistai;8;14;22
95;01.09.2015;2015;09;12;Tiistai;17;19;36
95;01.09.2015;2015;09;13;Tiistai;20;20;40
95;01.09.2015;2015;09;14;Tiistai;19;26;45
95;01.09.2015;2015;09;15;Tiistai;18;35;53
95;01.09.2015;2015;09;16;Tiistai;35;51;86
95;01.09.2015;2015;09;17;Tiistai;14;34;48
95;01.09.2015;2015;09;18;Tiistai;17;27;44
95;01.09.2015;2015;09;19;Tiistai;13;20;33
95;01.09.2015;2015;09;20;Tiistai;12;11;23
95;01.09.2015;2015;09;21;Tiistai;9;11;20
95;01.09.2015;2015;09;22;Tiistai;3;3;6
95;01.09.2015;2015;09;23;Tiistai;1;3;4
95;02.09.2015;2015;09;00;Keskiviikko;0;0;0
95;02.09.2015;2015;09;01;Keskiviikko;0;0;0
95;02.09.2015;2015;09;02;Keskiviikko;0;0;0
95;02.09.2015;2015;09;03;Keskiviikko;0;1;1
95;02.09.2015;2015;09;04;Keskiviikko;2;1;3
95;02.09.2015;2015;09;05;Keskiviikko;4;1;5
95;02.09.2015;2015;09;06;Keskiviikko;38;18;56
95;02.09.2015;2015;09;07;Keskiviikko;35;28;63
95;02.09.2015;2015;09;08;Keskiviikko;26;8;34
95;02.09.2015;2015;09;09;Keskiviikko;9;8;17
95;02.09.2015;2015;09;10;Keskiviikko;15;7;22
95;02.09.2015;2015;09;11;Keskiviikko;11;3;14
95;02.09.2015;2015;09;12;Keskiviikko;17;12;29
95;02.09.2015;2015;09;13;Keskiviikko;11;14;25
95;02.09.2015;2015;09;14;Keskiviikko;17;8;25
95;02.09.2015;2015;09;15;Keskiviikko;29;34;63
95;02.09.2015;2015;09;16;Keskiviikko;18;43;61
95;02.09.2015;2015;09;17;Keskiviikko;14;30;44
95;02.09.2015;2015;09;18;Keskiviikko;11;20;31
95;02.09.2015;2015;09;19;Keskiviikko;9;18;27
95;02.09.2015;2015;09;20;Keskiviikko;6;15;21
95;02.09.2015;2015;09;21;Keskiviikko;8;6;14
95;02.09.2015;2015;09;22;Keskiviikko;1;3;4
95;02.09.2015;2015;09;23;Keskiviikko;1;4;5
95;03.09.2015;2015;09;00;Torstai;0;1;1
95;03.09.2015;2015;09;01;Torstai;0;0;0
95;03.09.2015;2015;09;02;Torstai;0;1;1
95;03.09.2015;2015;09;03;Torstai;0;0;0
95;03.09.2015;2015;09;04;Torstai;4;0;4
95;03.09.2015;2015;09;05;Torstai;3;2;5
95;03.09.2015;2015;09;06;Torstai;38;8;46
95;03.09.2015;2015;09;07;Torstai;37;24;61
95;03.09.2015;2015;09;08;Torstai;13;8;21
95;03.09.2015;2015;09;09;Torstai;5;11;16
95;03.09.2015;2015;09;10;Torstai;13;9;22
95;03.09.2015;2015;09;11;Torstai;13;13;26
95;03.09.2015;2015;09;12;Torstai;11;12;23
95;03.09.2015;2015;09;13;Torstai;22;16;38
95;03.09.2015;2015;09;14;Torstai;19;15;34
95;03.09.2015;2015;09;15;Torstai;25;30;55
95;03.09.2015;2015;09;16;Torstai;24;49;73
95;03.09.2015;2015;09;17;Torstai;10;33;43
95;03.09.2015;2015;09;18;Torstai;16;25;41
95;03.09.2015;2015;09;19;Torstai;11;21;32
95;03.09.2015;2015;09;20;Torstai;12;9;21
95;03.09.2015;2015;09;21;Torstai;4;11;15
95;03.09.2015;2015;09;22;Torstai;1;4;5
95;03.09.2015;2015;09;23;Torstai;2;2;4
95;04.09.2015;2015;09;00;Perjantai;1;2;3
95;04.09.2015;2015;09;01;Perjantai;0;1;1
95;04.09.2015;2015;09;02;Perjantai;0;1;1
95;04.09.2015;2015;09;03;Perjantai;0;0;0
95;04.09.2015;2015;09;04;Perjantai;5;1;6
95;04.09.2015;2015;09;05;Perjantai;3;2;5
95;04.09.2015;2015;09;06;Perjantai;22;7;29
95;04.09.2015;2015;09;07;Perjantai;28;21;49
95;04.09.2015;2015;09;08;Perjantai;14;10;24
95;04.09.2015;2015;09;09;Perjantai;5;10;15
95;04.09.2015;2015;09;10;Perjantai;12;5;17
95;04.09.2015;2015;09;11;Perjantai;7;11;18
95;04.09.2015;2015;09;12;Perjantai;19;22;41
95;04.09.2015;2015;09;13;Perjantai;20;17;37
95;04.09.2015;2015;09;14;Perjantai;20;19;39
95;04.09.2015;2015;09;15;Perjantai;18;31;49
95;04.09.2015;2015;09;16;Perjantai;17;28;45
95;04.09.2015;2015;09;17;Perjantai;12;12;24
95;04.09.2015;2015;09;18;Perjantai;12;17;29
95;04.09.2015;2015;09;19;Perjantai;8;13;21
95;04.09.2015;2015;09;20;Perjantai;4;7;11
95;04.09.2015;2015;09;21;Perjantai;5;6;11
95;04.09.2015;2015;09;22;Perjantai;1;0;1
95;04.09.2015;2015;09;23;Perjantai;0;2;2
95;05.09.2015;2015;09;00;Lauantai;4;1;5
95;05.09.2015;2015;09;01;Lauantai;4;0;4
95;05.09.2015;2015;09;02;Lauantai;0;1;1
95;05.09.2015;2015;09;03;Lauantai;0;0;0
95;05.09.2015;2015;09;04;Lauantai;0;1;1
95;05.09.2015;2015;09;05;Lauantai;1;1;2
95;05.09.2015;2015;09;06;Lauantai;2;1;3
95;05.09.2015;2015;09;07;Lauantai;0;4;4
95;05.09.2015;2015;09;08;Lauantai;4;5;9
95;05.09.2015;2015;09;09;Lauantai;8;9;17
95;05.09.2015;2015;09;10;Lauantai;8;3;11
95;05.09.2015;2015;09;11;Lauantai;10;7;17
95;05.09.2015;2015;09;12;Lauantai;17;13;30
95;05.09.2015;2015;09;13;Lauantai;10;8;18
95;05.09.2015;2015;09;14;Lauantai;7;14;21
95;05.09.2015;2015;09;15;Lauantai;6;8;14
95;05.09.2015;2015;09;16;Lauantai;10;16;26
95;05.09.2015;2015;09;17;Lauantai;11;17;28
95;05.09.2015;2015;09;18;Lauantai;10;15;25
95;05.09.2015;2015;09;19;Lauantai;3;7;10
95;05.09.2015;2015;09;20;Lauantai;5;3;8
95;05.09.2015;2015;09;21;Lauantai;7;2;9
95;05.09.2015;2015;09;22;Lauantai;0;4;4
95;05.09.2015;2015;09;23;Lauantai;0;1;1
95;06.09.2015;2015;09;00;Sunnuntai;0;0;0
95;06.09.2015;2015;09;01;Sunnuntai;1;0;1
95;06.09.2015;2015;09;02;Sunnuntai;2;0;2
95;06.09.2015;2015;09;03;Sunnuntai;0;0;0
95;06.09.2015;2015;09;04;Sunnuntai;0;0;0
95;06.09.2015;2015;09;05;Sunnuntai;1;0;1
95;06.09.2015;2015;09;06;Sunnuntai;4;0;4
95;06.09.2015;2015;09;07;Sunnuntai;3;2;5
95;06.09.2015;2015;09;08;Sunnuntai;1;4;5
95;06.09.2015;2015;09;09;Sunnuntai;5;3;8
95;06.09.2015;2015;09;10;Sunnuntai;3;2;5
95;06.09.2015;2015;09;11;Sunnuntai;2;3;5
95;06.09.2015;2015;09;12;Sunnuntai;7;2;9
95;06.09.2015;2015;09;13;Sunnuntai;7;10;17
95;06.09.2015;2015;09;14;Sunnuntai;4;8;12
95;06.09.2015;2015;09;15;Sunnuntai;6;7;13
95;06.09.2015;2015;09;16;Sunnuntai;11;8;19
95;06.09.2015;2015;09;17;Sunnuntai;5;13;18
95;06.09.2015;2015;09;18;Sunnuntai;9;3;12
95;06.09.2015;2015;09;19;Sunnuntai;4;3;7
95;06.09.2015;2015;09;20;Sunnuntai;4;3;7
95;06.09.2015;2015;09;21;Sunnuntai;4;3;7
95;06.09.2015;2015;09;22;Sunnuntai;1;4;5
95;06.09.2015;2015;09;23;Sunnuntai;0;0;0
95;07.09.2015;2015;09;00;Maanantai;1;0;1
95;07.09.2015;2015;09;01;Maanantai;0;0;0
95;07.09.2015;2015;09;02;Maanantai;0;0;0
95;07.09.2015;2015;09;03;Maanantai;0;0;0
95;07.09.2015;2015;09;04;Maanantai;1;0;1
95;07.09.2015;2015;09;05;Maanantai;5;2;7
95;07.09.2015;2015;09;06;Maanantai;19;11;30
95;07.09.2015;2015;09;07;Maanantai;25;24;49
95;07.09.2015;2015;09;08;Maanantai;12;12;24
95;07.09.2015;2015;09;09;Maanantai;14;15;29
95;07.09.2015;2015;09;10;Maanantai;3;7;10
95;07.09.2015;2015;09;11;Maanantai;7;5;12
95;07.09.2015;2015;09;12;Maanantai;8;8;16
95;07.09.2015;2015;09;13;Maanantai;11;10;21
95;07.09.2015;2015;09;14;Maanantai;14;6;20
95;07.09.2015;2015;09;15;Maanantai;21;20;41
95;07.09.2015;2015;09;16;Maanantai;25;33;58
95;07.09.2015;2015;09;17;Maanantai;10;25;35
95;07.09.2015;2015;09;18;Maanantai;12;13;25
95;07.09.2015;2015;09;19;Maanantai;12;7;19
95;07.09.2015;2015;09;20;Maanantai;11;15;26
95;07.09.2015;2015;09;21;Maanantai;5;2;7
95;07.09.2015;2015;09;22;Maanantai;1;3;4
95;07.09.2015;2015;09;23;Maanantai;0;2;2
95;08.09.2015;2015;09;00;Tiistai;0;0;0
95;08.09.2015;2015;09;01;Tiistai;1;0;1
95;08.09.2015;2015;09;02;Tiistai;0;0;0
95;08.09.2015;2015;09;03;Tiistai;0;1;1
95;08.09.2015;2015;09;04;Tiistai;1;0;1
95;08.09.2015;2015;09;05;Tiistai;6;4;10
95;08.09.2015;2015;09;06;Tiistai;21;14;35
95;08.09.2015;2015;09;07;Tiistai;34;27;61
95;08.09.2015;2015;09;08;Tiistai;9;12;21
95;08.09.2015;2015;09;09;Tiistai;10;8;18
95;08.09.2015;2015;09;10;Tiistai;7;12;19
95;08.09.2015;2015;09;11;Tiistai;8;13;21
95;08.09.2015;2015;09;12;Tiistai;17;6;23
95;08.09.2015;2015;09;13;Tiistai;14;11;25
95;08.09.2015;2015;09;14;Tiistai;15;10;25
95;08.09.2015;2015;09;15;Tiistai;22;23;45
95;08.09.2015;2015;09;16;Tiistai;31;44;75
95;08.09.2015;2015;09;17;Tiistai;12;28;40
95;08.09.2015;2015;09;18;Tiistai;21;17;38
95;08.09.2015;2015;09;19;Tiistai;9;16;25
95;08.09.2015;2015;09;20;Tiistai;7;8;15
95;08.09.2015;2015;09;21;Tiistai;3;6;9
95;08.09.2015;2015;09;22;Tiistai;2;2;4
95;08.09.2015;2015;09;23;Tiistai;1;0;1
95;09.09.2015;2015;09;00;Keskiviikko;0;0;0
95;09.09.2015;2015;09;01;Keskiviikko;0;0;0
95;09.09.2015;2015;09;02;Keskiviikko;0;0;0
95;09.09.2015;2015;09;03;Keskiviikko;0;0;0
95;09.09.2015;2015;09;04;Keskiviikko;3;0;3
95;09.09.2015;2015;09;05;Keskiviikko;4;2;6
95;09.09.2015;2015;09;06;Keskiviikko;28;14;42
95;09.09.2015;2015;09;07;Keskiviikko;26;27;53
95;09.09.2015;2015;09;08;Keskiviikko;13;17;30
95;09.09.2015;2015;09;09;Keskiviikko;15;11;26
95;09.09.2015;2015;09;10;Keskiviikko;15;12;27
95;09.09.2015;2015;09;11;Keskiviikko;8;7;15
95;09.09.2015;2015;09;12;Keskiviikko;14;16;30
95;09.09.2015;2015;09;13;Keskiviikko;20;17;37
95;09.09.2015;2015;09;14;Keskiviikko;29;10;39
95;09.09.2015;2015;09;15;Keskiviikko;28;24;52
95;09.09.2015;2015;09;16;Keskiviikko;23;49;72
95;09.09.2015;2015;09;17;Keskiviikko;14;28;42
95;09.09.2015;2015;09;18;Keskiviikko;12;20;32
95;09.09.2015;2015;09;19;Keskiviikko;14;20;34
95;09.09.2015;2015;09;20;Keskiviikko;11;9;20
95;09.09.2015;2015;09;21;Keskiviikko;7;10;17
95;09.09.2015;2015;09;22;Keskiviikko;2;2;4
95;09.09.2015;2015;09;23;Keskiviikko;2;1;3
95;10.09.2015;2015;09;00;Torstai;1;0;1
95;10.09.2015;2015;09;01;Torstai;2;1;3
95;10.09.2015;2015;09;02;Torstai;0;0;0
95;10.09.2015;2015;09;03;Torstai;0;0;0
95;10.09.2015;2015;09;04;Torstai;3;1;4
95;10.09.2015;2015;09;05;Torstai;7;3;10
95;10.09.2015;2015;09;06;Torstai;28;11;39
95;10.09.2015;2015;09;07;Torstai;32;29;61
95;10.09.2015;2015;09;08;Torstai;12;16;28
95;10.09.2015;2015;09;09;Torstai;15;6;21
95;10.09.2015;2015;09;10;Torstai;6;12;18
95;10.09.2015;2015;09;11;Torstai;16;10;26
95;10.09.2015;2015;09;12;Torstai;25;12;37
95;10.09.2015;2015;09;13;Torstai;14;20;34
95;10.09.2015;2015;09;14;Torstai;25;23;48
95;10.09.2015;2015;09;15;Torstai;29;34;63
95;10.09.2015;2015;09;16;Torstai;32;33;65
95;10.09.2015;2015;09;17;Torstai;14;34;48
95;10.09.2015;2015;09;18;Torstai;9;24;33
95;10.09.2015;2015;09;19;Torstai;13;16;29
95;10.09.2015;2015;09;20;Torstai;10;12;22
95;10.09.2015;2015;09;21;Torstai;6;7;13
95;10.09.2015;2015;09;22;Torstai;3;1;4
95;10.09.2015;2015;09;23;Torstai;0;2;2
95;11.09.2015;2015;09;00;Perjantai;2;1;3
95;11.09.2015;2015;09;01;Perjantai;1;0;1
95;11.09.2015;2015;09;02;Perjantai;0;0;0
95;11.09.2015;2015;09;03;Perjantai;0;0;0
95;11.09.2015;2015;09;04;Perjantai;2;0;2
95;11.09.2015;2015;09;05;Perjantai;6;4;10
95;11.09.2015;2015;09;06;Perjantai;26;12;38
95;11.09.2015;2015;09;07;Perjantai;20;26;46
95;11.09.2015;2015;09;08;Perjantai;11;12;23
95;11.09.2015;2015;09;09;Perjantai;10;8;18
95;11.09.2015;2015;09;10;Perjantai;6;10;16
95;11.09.2015;2015;09;11;Perjantai;13;11;24
95;11.09.2015;2015;09;12;Perjantai;29;13;42
95;11.09.2015;2015;09;13;Perjantai;24;16;40
95;11.09.2015;2015;09;14;Perjantai;19;22;41
95;11.09.2015;2015;09;15;Perjantai;26;26;52
95;11.09.2015;2015;09;16;Perjantai;25;26;51
95;11.09.2015;2015;09;17;Perjantai;24;22;46
95;11.09.2015;2015;09;18;Perjantai;10;26;36
95;11.09.2015;2015;09;19;Perjantai;13;9;22
95;11.09.2015;2015;09;20;Perjantai;4;11;15
95;11.09.2015;2015;09;21;Perjantai;1;5;6
95;11.09.2015;2015;09;22;Perjantai;1;5;6
95;11.09.2015;2015;09;23;Perjantai;0;0;0
95;12.09.2015;2015;09;00;Lauantai;3;0;3
95;12.09.2015;2015;09;01;Lauantai;1;1;2
95;12.09.2015;2015;09;02;Lauantai;0;0;0
95;12.09.2015;2015;09;03;Lauantai;0;0;0
95;12.09.2015;2015;09;04;Lauantai;0;1;1
95;12.09.2015;2015;09;05;Lauantai;2;0;2
95;12.09.2015;2015;09;06;Lauantai;2;2;4
95;12.09.2015;2015;09;07;Lauantai;2;2;4
95;12.09.2015;2015;09;08;Lauantai;6;3;9
95;12.09.2015;2015;09;09;Lauantai;8;6;14
95;12.09.2015;2015;09;10;Lauantai;10;13;23
95;12.09.2015;2015;09;11;Lauantai;14;12;26
95;12.09.2015;2015;09;12;Lauantai;19;14;33
95;12.09.2015;2015;09;13;Lauantai;22;20;42
95;12.09.2015;2015;09;14;Lauantai;26;30;56
95;12.09.2015;2015;09;15;Lauantai;23;19;42
95;12.09.2015;2015;09;16;Lauantai;14;18;32
95;12.09.2015;2015;09;17;Lauantai;7;14;21
95;12.09.2015;2015;09;18;Lauantai;8;17;25
95;12.09.2015;2015;09;19;Lauantai;13;6;19
95;12.09.2015;2015;09;20;Lauantai;0;8;8
95;12.09.2015;2015;09;21;Lauantai;2;3;5
95;12.09.2015;2015;09;22;Lauantai;1;2;3
95;12.09.2015;2015;09;23;Lauantai;0;1;1
95;13.09.2015;2015;09;00;Sunnuntai;0;0;0
95;13.09.2015;2015;09;01;Sunnuntai;0;3;3
95;13.09.2015;2015;09;02;Sunnuntai;0;0;0
95;13.09.2015;2015;09;03;Sunnuntai;0;0;0
95;13.09.2015;2015;09;04;Sunnuntai;2;2;4
95;13.09.2015;2015;09;05;Sunnuntai;2;1;3
95;13.09.2015;2015;09;06;Sunnuntai;2;1;3
95;13.09.2015;2015;09;07;Sunnuntai;5;4;9
95;13.09.2015;2015;09;08;Sunnuntai;7;5;12
95;13.09.2015;2015;09;09;Sunnuntai;8;6;14
95;13.09.2015;2015;09;10;Sunnuntai;11;13;24
95;13.09.2015;2015;09;11;Sunnuntai;10;23;33
95;13.09.2015;2015;09;12;Sunnuntai;19;15;34
95;13.09.2015;2015;09;13;Sunnuntai;27;22;49
95;13.09.2015;2015;09;14;Sunnuntai;25;29;54
95;13.09.2015;2015;09;15;Sunnuntai;19;14;33
95;13.09.2015;2015;09;16;Sunnuntai;17;13;30
95;13.09.2015;2015;09;17;Sunnuntai;10;5;15
95;13.09.2015;2015;09;18;Sunnuntai;13;14;27
95;13.09.2015;2015;09;19;Sunnuntai;5;13;18
95;13.09.2015;2015;09;20;Sunnuntai;7;7;14
95;13.09.2015;2015;09;21;Sunnuntai;2;1;3
95;13.09.2015;2015;09;22;Sunnuntai;0;2;2
95;13.09.2015;2015;09;23;Sunnuntai;0;0;0
95;14.09.2015;2015;09;00;Maanantai;0;1;1
95;14.09.2015;2015;09;01;Maanantai;0;0;0
95;14.09.2015;2015;09;02;Maanantai;0;0;0
95;14.09.2015;2015;09;03;Maanantai;0;1;1
95;14.09.2015;2015;09;04;Maanantai;3;0;3
95;14.09.2015;2015;09;05;Maanantai;5;4;9
95;14.09.2015;2015;09;06;Maanantai;22;13;35
95;14.09.2015;2015;09;07;Maanantai;33;26;59
95;14.09.2015;2015;09;08;Maanantai;15;11;26
95;14.09.2015;2015;09;09;Maanantai;10;14;24
95;14.09.2015;2015;09;10;Maanantai;11;12;23
95;14.09.2015;2015;09;11;Maanantai;17;12;29
95;14.09.2015;2015;09;12;Maanantai;18;13;31
95;14.09.2015;2015;09;13;Maanantai;21;21;42
95;14.09.2015;2015;09;14;Maanantai;13;15;28
95;14.09.2015;2015;09;15;Maanantai;29;37;66
95;14.09.2015;2015;09;16;Maanantai;45;42;87
95;14.09.2015;2015;09;17;Maanantai;21;25;46
95;14.09.2015;2015;09;18;Maanantai;17;23;40
95;14.09.2015;2015;09;19;Maanantai;8;15;23
95;14.09.2015;2015;09;20;Maanantai;12;15;27
95;14.09.2015;2015;09;21;Maanantai;4;3;7
95;14.09.2015;2015;09;22;Maanantai;4;3;7
95;14.09.2015;2015;09;23;Maanantai;0;2;2
95;15.09.2015;2015;09;00;Tiistai;0;0;0
95;15.09.2015;2015;09;01;Tiistai;0;0;0
95;15.09.2015;2015;09;02;Tiistai;0;0;0
95;15.09.2015;2015;09;03;Tiistai;0;1;1
95;15.09.2015;2015;09;04;Tiistai;1;0;1
95;15.09.2015;2015;09;05;Tiistai;7;6;13
95;15.09.2015;2015;09;06;Tiistai;21;12;33
95;15.09.2015;2015;09;07;Tiistai;41;30;71
95;15.09.2015;2015;09;08;Tiistai;14;15;29
95;15.09.2015;2015;09;09;Tiistai;10;8;18
95;15.09.2015;2015;09;10;Tiistai;8;10;18
95;15.09.2015;2015;09;11;Tiistai;22;7;29
95;15.09.2015;2015;09;12;Tiistai;15;14;29
95;15.09.2015;2015;09;13;Tiistai;15;13;28
95;15.09.2015;2015;09;14;Tiistai;25;13;38
95;15.09.2015;2015;09;15;Tiistai;25;18;43
95;15.09.2015;2015;09;16;Tiistai;38;57;95
95;15.09.2015;2015;09;17;Tiistai;17;32;49
95;15.09.2015;2015;09;18;Tiistai;13;14;27
95;15.09.2015;2015;09;19;Tiistai;10;14;24
95;15.09.2015;2015;09;20;Tiistai;3;9;12
95;15.09.2015;2015;09;21;Tiistai;5;5;10
95;15.09.2015;2015;09;22;Tiistai;2;5;7
95;15.09.2015;2015;09;23;Tiistai;0;1;1
95;16.09.2015;2015;09;00;Keskiviikko;0;0;0
95;16.09.2015;2015;09;01;Keskiviikko;0;1;1
95;16.09.2015;2015;09;02;Keskiviikko;0;0;0
95;16.09.2015;2015;09;03;Keskiviikko;0;1;1
95;16.09.2015;2015;09;04;Keskiviikko;0;0;0
95;16.09.2015;2015;09;05;Keskiviikko;5;4;9
95;16.09.2015;2015;09;06;Keskiviikko;19;7;26
95;16.09.2015;2015;09;07;Keskiviikko;14;24;38
95;16.09.2015;2015;09;08;Keskiviikko;10;10;20
95;16.09.2015;2015;09;09;Keskiviikko;5;4;9
95;16.09.2015;2015;09;10;Keskiviikko;5;6;11
95;16.09.2015;2015;09;11;Keskiviikko;9;1;10
95;16.09.2015;2015;09;12;Keskiviikko;4;5;9
95;16.09.2015;2015;09;13;Keskiviikko;12;4;16
95;16.09.2015;2015;09;14;Keskiviikko;14;11;25
95;16.09.2015;2015;09;15;Keskiviikko;20;17;37
95;16.09.2015;2015;09;16;Keskiviikko;28;20;48
95;16.09.2015;2015;09;17;Keskiviikko;14;23;37
95;16.09.2015;2015;09;18;Keskiviikko;10;21;31
95;16.09.2015;2015;09;19;Keskiviikko;9;10;19
95;16.09.2015;2015;09;20;Keskiviikko;4;4;8
95;16.09.2015;2015;09;21;Keskiviikko;2;5;7
95;16.09.2015;2015;09;22;Keskiviikko;2;1;3
95;16.09.2015;2015;09;23;Keskiviikko;0;1;1
95;17.09.2015;2015;09;00;Torstai;0;0;0
95;17.09.2015;2015;09;01;Torstai;0;2;2
95;17.09.2015;2015;09;02;Torstai;0;0;0
95;17.09.2015;2015;09;03;Torstai;2;1;3
95;17.09.2015;2015;09;04;Torstai;0;1;1
95;17.09.2015;2015;09;05;Torstai;6;2;8
95;17.09.2015;2015;09;06;Torstai;19;14;33
95;17.09.2015;2015;09;07;Torstai;33;18;51
95;17.09.2015;2015;09;08;Torstai;12;13;25
95;17.09.2015;2015;09;09;Torstai;5;13;18
95;17.09.2015;2015;09;10;Torstai;5;6;11
95;17.09.2015;2015;09;11;Torstai;13;8;21
95;17.09.2015;2015;09;12;Torstai;14;8;22
95;17.09.2015;2015;09;13;Torstai;11;12;23
95;17.09.2015;2015;09;14;Torstai;8;16;24
95;17.09.2015;2015;09;15;Torstai;32;25;57
95;17.09.2015;2015;09;16;Torstai;18;29;47
95;17.09.2015;2015;09;17;Torstai;12;19;31
95;17.09.2015;2015;09;18;Torstai;4;15;19
95;17.09.2015;2015;09;19;Torstai;7;9;16
95;17.09.2015;2015;09;20;Torstai;2;6;8
95;17.09.2015;2015;09;21;Torstai;3;6;9
95;17.09.2015;2015;09;22;Torstai;1;2;3
95;17.09.2015;2015;09;23;Torstai;2;0;2
95;18.09.2015;2015;09;00;Perjantai;1;0;1
95;18.09.2015;2015;09;01;Perjantai;0;1;1
95;18.09.2015;2015;09;02;Perjantai;0;0;0
95;18.09.2015;2015;09;03;Perjantai;0;1;1
95;18.09.2015;2015;09;04;Perjantai;0;0;0
95;18.09.2015;2015;09;05;Perjantai;3;2;5
95;18.09.2015;2015;09;06;Perjantai;2;2;4
95;18.09.2015;2015;09;07;Perjantai;10;13;23
95;18.09.2015;2015;09;08;Perjantai;2;2;4
95;18.09.2015;2015;09;09;Perjantai;1;1;2
95;18.09.2015;2015;09;10;Perjantai;0;1;1
95;18.09.2015;2015;09;11;Perjantai;3;1;4
95;18.09.2015;2015;09;12;Perjantai;3;0;3
95;18.09.2015;2015;09;13;Perjantai;6;1;7
95;18.09.2015;2015;09;14;Perjantai;8;4;12
95;18.09.2015;2015;09;15;Perjantai;6;3;9
95;18.09.2015;2015;09;16;Perjantai;5;1;6
95;18.09.2015;2015;09;17;Perjantai;2;3;5
95;18.09.2015;2015;09;18;Perjantai;1;5;6
95;18.09.2015;2015;09;19;Perjantai;1;6;7
95;18.09.2015;2015;09;20;Perjantai;2;2;4
95;18.09.2015;2015;09;21;Perjantai;0;1;1
95;18.09.2015;2015;09;22;Perjantai;1;1;2
95;18.09.2015;2015;09;23;Perjantai;1;0;1
95;19.09.2015;2015;09;00;Lauantai;0;1;1
95;19.09.2015;2015;09;01;Lauantai;0;0;0
95;19.09.2015;2015;09;02;Lauantai;2;0;2
95;19.09.2015;2015;09;03;Lauantai;1;1;2
95;19.09.2015;2015;09;04;Lauantai;0;0;0
95;19.09.2015;2015;09;05;Lauantai;0;0;0
95;19.09.2015;2015;09;06;Lauantai;2;0;2
95;19.09.2015;2015;09;07;Lauantai;1;1;2
95;19.09.2015;2015;09;08;Lauantai;4;7;11
95;19.09.2015;2015;09;09;Lauantai;10;2;12
95;19.09.2015;2015;09;10;Lauantai;9;11;20
95;19.09.2015;2015;09;11;Lauantai;4;5;9
95;19.09.2015;2015;09;12;Lauantai;9;11;20
95;19.09.2015;2015;09;13;Lauantai;9;10;19
95;19.09.2015;2015;09;14;Lauantai;6;7;13
95;19.09.2015;2015;09;15;Lauantai;2;4;6
95;19.09.2015;2015;09;16;Lauantai;5;4;9
95;19.09.2015;2015;09;17;Lauantai;4;14;18
95;19.09.2015;2015;09;18;Lauantai;4;8;12
95;19.09.2015;2015;09;19;Lauantai;7;6;13
95;19.09.2015;2015;09;20;Lauantai;5;5;10
95;19.09.2015;2015;09;21;Lauantai;3;4;7
95;19.09.2015;2015;09;22;Lauantai;0;0;0
95;19.09.2015;2015;09;23;Lauantai;2;1;3
95;20.09.2015;2015;09;00;Sunnuntai;0;2;2
95;20.09.2015;2015;09;01;Sunnuntai;1;1;2
95;20.09.2015;2015;09;02;Sunnuntai;1;0;1
95;20.09.2015;2015;09;03;Sunnuntai;0;0;0
95;20.09.2015;2015;09;04;Sunnuntai;1;1;2
95;20.09.2015;2015;09;05;Sunnuntai;0;0;0
95;20.09.2015;2015;09;06;Sunnuntai;2;0;2
95;20.09.2015;2015;09;07;Sunnuntai;1;5;6
95;20.09.2015;2015;09;08;Sunnuntai;10;6;16
95;20.09.2015;2015;09;09;Sunnuntai;9;11;20
95;20.09.2015;2015;09;10;Sunnuntai;11;8;19
95;20.09.2015;2015;09;11;Sunnuntai;15;15;30
95;20.09.2015;2015;09;12;Sunnuntai;13;26;39
95;20.09.2015;2015;09;13;Sunnuntai;11;16;27
95;20.09.2015;2015;09;14;Sunnuntai;16;31;47
95;20.09.2015;2015;09;15;Sunnuntai;14;16;30
95;20.09.2015;2015;09;16;Sunnuntai;12;7;19
95;20.09.2015;2015;09;17;Sunnuntai;13;9;22
95;20.09.2015;2015;09;18;Sunnuntai;6;7;13
95;20.09.2015;2015;09;19;Sunnuntai;10;3;13
95;20.09.2015;2015;09;20;Sunnuntai;3;7;10
95;20.09.2015;2015;09;21;Sunnuntai;3;1;4
95;20.09.2015;2015;09;22;Sunnuntai;1;2;3
95;20.09.2015;2015;09;23;Sunnuntai;2;1;3
95;21.09.2015;2015;09;00;Maanantai;0;0;0
95;21.09.2015;2015;09;01;Maanantai;0;0;0
95;21.09.2015;2015;09;02;Maanantai;0;0;0
95;21.09.2015;2015;09;03;Maanantai;0;0;0
95;21.09.2015;2015;09;04;Maanantai;1;0;1
95;21.09.2015;2015;09;05;Maanantai;12;2;14
95;21.09.2015;2015;09;06;Maanantai;21;15;36
95;21.09.2015;2015;09;07;Maanantai;24;27;51
95;21.09.2015;2015;09;08;Maanantai;15;17;32
95;21.09.2015;2015;09;09;Maanantai;19;10;29
95;21.09.2015;2015;09;10;Maanantai;8;10;18
95;21.09.2015;2015;09;11;Maanantai;5;7;12
95;21.09.2015;2015;09;12;Maanantai;11;4;15
95;21.09.2015;2015;09;13;Maanantai;15;8;23
95;21.09.2015;2015;09;14;Maanantai;11;8;19
95;21.09.2015;2015;09;15;Maanantai;25;23;48
95;21.09.2015;2015;09;16;Maanantai;37;30;67
95;21.09.2015;2015;09;17;Maanantai;10;23;33
95;21.09.2015;2015;09;18;Maanantai;9;18;27
95;21.09.2015;2015;09;19;Maanantai;20;14;34
95;21.09.2015;2015;09;20;Maanantai;9;8;17
95;21.09.2015;2015;09;21;Maanantai;1;3;4
95;21.09.2015;2015;09;22;Maanantai;3;4;7
95;21.09.2015;2015;09;23;Maanantai;1;2;3
95;22.09.2015;2015;09;00;Tiistai;0;0;0
95;22.09.2015;2015;09;01;Tiistai;0;0;0
95;22.09.2015;2015;09;02;Tiistai;0;0;0
95;22.09.2015;2015;09;03;Tiistai;0;1;1
95;22.09.2015;2015;09;04;Tiistai;1;1;2
95;22.09.2015;2015;09;05;Tiistai;7;6;13
95;22.09.2015;2015;09;06;Tiistai;8;10;18
95;22.09.2015;2015;09;07;Tiistai;16;14;30
95;22.09.2015;2015;09;08;Tiistai;8;10;18
95;22.09.2015;2015;09;09;Tiistai;4;5;9
95;22.09.2015;2015;09;10;Tiistai;2;2;4
95;22.09.2015;2015;09;11;Tiistai;3;2;5
95;22.09.2015;2015;09;12;Tiistai;8;2;10
95;22.09.2015;2015;09;13;Tiistai;9;5;14
95;22.09.2015;2015;09;14;Tiistai;13;10;23
95;22.09.2015;2015;09;15;Tiistai;17;16;33
95;22.09.2015;2015;09;16;Tiistai;18;18;36
95;22.09.2015;2015;09;17;Tiistai;7;9;16
95;22.09.2015;2015;09;18;Tiistai;4;10;14
95;22.09.2015;2015;09;19;Tiistai;0;5;5
95;22.09.2015;2015;09;20;Tiistai;2;3;5
95;22.09.2015;2015;09;21;Tiistai;2;3;5
95;22.09.2015;2015;09;22;Tiistai;2;5;7
95;22.09.2015;2015;09;23;Tiistai;0;0;0
95;23.09.2015;2015;09;00;Keskiviikko;0;0;0
95;23.09.2015;2015;09;01;Keskiviikko;0;0;0
95;23.09.2015;2015;09;02;Keskiviikko;0;0;0
95;23.09.2015;2015;09;03;Keskiviikko;0;1;1
95;23.09.2015;2015;09;04;Keskiviikko;2;0;2
95;23.09.2015;2015;09;05;Keskiviikko;8;7;15
95;23.09.2015;2015;09;06;Keskiviikko;14;8;22
95;23.09.2015;2015;09;07;Keskiviikko;18;19;37
95;23.09.2015;2015;09;08;Keskiviikko;8;12;20
95;23.09.2015;2015;09;09;Keskiviikko;6;8;14
95;23.09.2015;2015;09;10;Keskiviikko;7;10;17
95;23.09.2015;2015;09;11;Keskiviikko;8;5;13
95;23.09.2015;2015;09;12;Keskiviikko;3;4;7
95;23.09.2015;2015;09;13;Keskiviikko;9;4;13
95;23.09.2015;2015;09;14;Keskiviikko;14;9;23
95;23.09.2015;2015;09;15;Keskiviikko;15;13;28
95;23.09.2015;2015;09;16;Keskiviikko;22;18;40
95;23.09.2015;2015;09;17;Keskiviikko;16;10;26
95;23.09.2015;2015;09;18;Keskiviikko;9;10;19
95;23.09.2015;2015;09;19;Keskiviikko;6;10;16
95;23.09.2015;2015;09;20;Keskiviikko;5;2;7
95;23.09.2015;2015;09;21;Keskiviikko;1;2;3
95;23.09.2015;2015;09;22;Keskiviikko;1;3;4
95;23.09.2015;2015;09;23;Keskiviikko;0;0;0
95;24.09.2015;2015;09;00;Torstai;0;0;0
95;24.09.2015;2015;09;01;Torstai;1;0;1
95;24.09.2015;2015;09;02;Torstai;0;0;0
95;24.09.2015;2015;09;03;Torstai;0;1;1
95;24.09.2015;2015;09;04;Torstai;2;0;2
95;24.09.2015;2015;09;05;Torstai;6;3;9
95;24.09.2015;2015;09;06;Torstai;23;8;31
95;24.09.2015;2015;09;07;Torstai;17;15;32
95;24.09.2015;2015;09;08;Torstai;9;12;21
95;24.09.2015;2015;09;09;Torstai;5;11;16
95;24.09.2015;2015;09;10;Torstai;7;6;13
95;24.09.2015;2015;09;11;Torstai;8;7;15
95;24.09.2015;2015;09;12;Torstai;15;4;19
95;24.09.2015;2015;09;13;Torstai;8;7;15
95;24.09.2015;2015;09;14;Torstai;21;10;31
95;24.09.2015;2015;09;15;Torstai;18;28;46
95;24.09.2015;2015;09;16;Torstai;21;27;48
95;24.09.2015;2015;09;17;Torstai;8;19;27
95;24.09.2015;2015;09;18;Torstai;15;15;30
95;24.09.2015;2015;09;19;Torstai;9;8;17
95;24.09.2015;2015;09;20;Torstai;9;8;17
95;24.09.2015;2015;09;21;Torstai;0;3;3
95;24.09.2015;2015;09;22;Torstai;2;3;5
95;24.09.2015;2015;09;23;Torstai;0;1;1
95;25.09.2015;2015;09;00;Perjantai;0;0;0
95;25.09.2015;2015;09;01;Perjantai;0;0;0
95;25.09.2015;2015;09;02;Perjantai;1;0;1
95;25.09.2015;2015;09;03;Perjantai;0;0;0
95;25.09.2015;2015;09;04;Perjantai;0;0;0
95;25.09.2015;2015;09;05;Perjantai;4;3;7
95;25.09.2015;2015;09;06;Perjantai;19;7;26
95;25.09.2015;2015;09;07;Perjantai;15;22;37
95;25.09.2015;2015;09;08;Perjantai;6;12;18
95;25.09.2015;2015;09;09;Perjantai;7;2;9
95;25.09.2015;2015;09;10;Perjantai;4;7;11
95;25.09.2015;2015;09;11;Perjantai;9;3;12
95;25.09.2015;2015;09;12;Perjantai;6;6;12
95;25.09.2015;2015;09;13;Perjantai;19;8;27
95;25.09.2015;2015;09;14;Perjantai;11;13;24
95;25.09.2015;2015;09;15;Perjantai;9;28;37
95;25.09.2015;2015;09;16;Perjantai;9;16;25
95;25.09.2015;2015;09;17;Perjantai;6;11;17
95;25.09.2015;2015;09;18;Perjantai;6;10;16
95;25.09.2015;2015;09;19;Perjantai;2;6;8
95;25.09.2015;2015;09;20;Perjantai;11;3;14
95;25.09.2015;2015;09;21;Perjantai;4;2;6
95;25.09.2015;2015;09;22;Perjantai;1;1;2
95;25.09.2015;2015;09;23;Perjantai;0;0;0
95;26.09.2015;2015;09;00;Lauantai;0;0;0
95;26.09.2015;2015;09;01;Lauantai;0;0;0
95;26.09.2015;2015;09;02;Lauantai;0;0;0
95;26.09.2015;2015;09;03;Lauantai;0;0;0
95;26.09.2015;2015;09;04;Lauantai;0;0;0
95;26.09.2015;2015;09;05;Lauantai;1;1;2
95;26.09.2015;2015;09;06;Lauantai;1;2;3
95;26.09.2015;2015;09;07;Lauantai;1;5;6
95;26.09.2015;2015;09;08;Lauantai;5;12;17
95;26.09.2015;2015;09;09;Lauantai;6;7;13
95;26.09.2015;2015;09;10;Lauantai;19;14;33
95;26.09.2015;2015;09;11;Lauantai;8;10;18
95;26.09.2015;2015;09;12;Lauantai;11;2;13
95;26.09.2015;2015;09;13;Lauantai;8;10;18
95;26.09.2015;2015;09;14;Lauantai;5;15;20
95;26.09.2015;2015;09;15;Lauantai;15;15;30
95;26.09.2015;2015;09;16;Lauantai;12;15;27
95;26.09.2015;2015;09;17;Lauantai;12;13;25
95;26.09.2015;2015;09;18;Lauantai;12;14;26
95;26.09.2015;2015;09;19;Lauantai;3;7;10
95;26.09.2015;2015;09;20;Lauantai;8;10;18
95;26.09.2015;2015;09;21;Lauantai;1;4;5
95;26.09.2015;2015;09;22;Lauantai;1;0;1
95;26.09.2015;2015;09;23;Lauantai;2;0;2
95;27.09.2015;2015;09;00;Sunnuntai;1;0;1
95;27.09.2015;2015;09;01;Sunnuntai;1;2;3
95;27.09.2015;2015;09;02;Sunnuntai;0;0;0
95;27.09.2015;2015;09;03;Sunnuntai;0;0;0
95;27.09.2015;2015;09;04;Sunnuntai;0;0;0
95;27.09.2015;2015;09;05;Sunnuntai;0;1;1
95;27.09.2015;2015;09;06;Sunnuntai;0;1;1
95;27.09.2015;2015;09;07;Sunnuntai;3;1;4
95;27.09.2015;2015;09;08;Sunnuntai;2;2;4
95;27.09.2015;2015;09;09;Sunnuntai;6;0;6
95;27.09.2015;2015;09;10;Sunnuntai;3;7;10
95;27.09.2015;2015;09;11;Sunnuntai;3;8;11
95;27.09.2015;2015;09;12;Sunnuntai;12;9;21
95;27.09.2015;2015;09;13;Sunnuntai;8;12;20
95;27.09.2015;2015;09;14;Sunnuntai;17;12;29
95;27.09.2015;2015;09;15;Sunnuntai;15;17;32
95;27.09.2015;2015;09;16;Sunnuntai;13;8;21
95;27.09.2015;2015;09;17;Sunnuntai;7;13;20
95;27.09.2015;2015;09;18;Sunnuntai;12;10;22
95;27.09.2015;2015;09;19;Sunnuntai;6;5;11
95;27.09.2015;2015;09;20;Sunnuntai;4;6;10
95;27.09.2015;2015;09;21;Sunnuntai;2;1;3
95;27.09.2015;2015;09;22;Sunnuntai;1;2;3
95;27.09.2015;2015;09;23;Sunnuntai;0;0;0
95;28.09.2015;2015;09;00;Maanantai;0;0;0
95;28.09.2015;2015;09;01;Maanantai;0;1;1
95;28.09.2015;2015;09;02;Maanantai;0;0;0
95;28.09.2015;2015;09;03;Maanantai;0;0;0
95;28.09.2015;2015;09;04;Maanantai;2;0;2
95;28.09.2015;2015;09;05;Maanantai;9;2;11
95;28.09.2015;2015;09;06;Maanantai;19;14;33
95;28.09.2015;2015;09;07;Maanantai;27;30;57
95;28.09.2015;2015;09;08;Maanantai;15;21;36
95;28.09.2015;2015;09;09;Maanantai;19;7;26
95;28.09.2015;2015;09;10;Maanantai;12;7;19
95;28.09.2015;2015;09;11;Maanantai;9;4;13
95;28.09.2015;2015;09;12;Maanantai;17;4;21
95;28.09.2015;2015;09;13;Maanantai;17;19;36
95;28.09.2015;2015;09;14;Maanantai;22;15;37
95;28.09.2015;2015;09;15;Maanantai;27;30;57
95;28.09.2015;2015;09;16;Maanantai;20;32;52
95;28.09.2015;2015;09;17;Maanantai;13;23;36
95;28.09.2015;2015;09;18;Maanantai;18;21;39
95;28.09.2015;2015;09;19;Maanantai;6;13;19
95;28.09.2015;2015;09;20;Maanantai;7;8;15
95;28.09.2015;2015;09;21;Maanantai;3;1;4
95;28.09.2015;2015;09;22;Maanantai;3;2;5
95;28.09.2015;2015;09;23;Maanantai;0;2;2
95;29.09.2015;2015;09;00;Tiistai;0;1;1
95;29.09.2015;2015;09;01;Tiistai;0;2;2
95;29.09.2015;2015;09;02;Tiistai;1;0;1
95;29.09.2015;2015;09;03;Tiistai;2;0;2
95;29.09.2015;2015;09;04;Tiistai;2;0;2
95;29.09.2015;2015;09;05;Tiistai;5;3;8
95;29.09.2015;2015;09;06;Tiistai;22;12;34
95;29.09.2015;2015;09;07;Tiistai;21;28;49
95;29.09.2015;2015;09;08;Tiistai;12;11;23
95;29.09.2015;2015;09;09;Tiistai;8;3;11
95;29.09.2015;2015;09;10;Tiistai;12;9;21
95;29.09.2015;2015;09;11;Tiistai;13;9;22
95;29.09.2015;2015;09;12;Tiistai;8;10;18
95;29.09.2015;2015;09;13;Tiistai;13;15;28
95;29.09.2015;2015;09;14;Tiistai;17;9;26
95;29.09.2015;2015;09;15;Tiistai;16;21;37
95;29.09.2015;2015;09;16;Tiistai;29;22;51
95;29.09.2015;2015;09;17;Tiistai;14;13;27
95;29.09.2015;2015;09;18;Tiistai;9;17;26
95;29.09.2015;2015;09;19;Tiistai;8;7;15
95;29.09.2015;2015;09;20;Tiistai;2;7;9
95;29.09.2015;2015;09;21;Tiistai;3;6;9
95;29.09.2015;2015;09;22;Tiistai;2;2;4
95;29.09.2015;2015;09;23;Tiistai;1;3;4
95;30.09.2015;2015;09;00;Keskiviikko;0;1;1
95;30.09.2015;2015;09;01;Keskiviikko;0;0;0
95;30.09.2015;2015;09;02;Keskiviikko;0;0;0
95;30.09.2015;2015;09;03;Keskiviikko;0;0;0
95;30.09.2015;2015;09;04;Keskiviikko;0;0;0
95;30.09.2015;2015;09;05;Keskiviikko;10;1;11
95;30.09.2015;2015;09;06;Keskiviikko;24;11;35
95;30.09.2015;2015;09;07;Keskiviikko;26;23;49
95;30.09.2015;2015;09;08;Keskiviikko;11;8;19
95;30.09.2015;2015;09;09;Keskiviikko;12;9;21
95;30.09.2015;2015;09;10;Keskiviikko;16;9;25
95;30.09.2015;2015;09;11;Keskiviikko;16;7;23
95;30.09.2015;2015;09;12;Keskiviikko;13;16;29
95;30.09.2015;2015;09;13;Keskiviikko;10;8;18
95;30.09.2015;2015;09;14;Keskiviikko;11;16;27
95;30.09.2015;2015;09;15;Keskiviikko;19;32;51
95;30.09.2015;2015;09;16;Keskiviikko;25;27;52
95;30.09.2015;2015;09;17;Keskiviikko;10;21;31
95;30.09.2015;2015;09;18;Keskiviikko;11;19;30
95;30.09.2015;2015;09;19;Keskiviikko;4;13;17
95;30.09.2015;2015;09;20;Keskiviikko;2;6;8
95;30.09.2015;2015;09;21;Keskiviikko;1;3;4
95;30.09.2015;2015;09;22;Keskiviikko;3;0;3
95;30.09.2015;2015;09;23;Keskiviikko;0;1;1
95;01.10.2015;2015;10;00;Torstai;0;1;1
95;01.10.2015;2015;10;01;Torstai;0;2;2
95;01.10.2015;2015;10;02;Torstai;0;0;0
95;01.10.2015;2015;10;03;Torstai;0;0;0
95;01.10.2015;2015;10;04;Torstai;2;1;3
95;01.10.2015;2015;10;05;Torstai;8;1;9
95;01.10.2015;2015;10;06;Torstai;20;11;31
95;01.10.2015;2015;10;07;Torstai;20;20;40
95;01.10.2015;2015;10;08;Torstai;6;12;18
95;01.10.2015;2015;10;09;Torstai;11;4;15
95;01.10.2015;2015;10;10;Torstai;12;10;22
95;01.10.2015;2015;10;11;Torstai;5;4;9
95;01.10.2015;2015;10;12;Torstai;13;1;14
95;01.10.2015;2015;10;13;Torstai;5;14;19
95;01.10.2015;2015;10;14;Torstai;17;11;28
95;01.10.2015;2015;10;15;Torstai;17;28;45
95;01.10.2015;2015;10;16;Torstai;11;21;32
95;01.10.2015;2015;10;17;Torstai;9;8;17
95;01.10.2015;2015;10;18;Torstai;4;10;14
95;01.10.2015;2015;10;19;Torstai;2;3;5
95;01.10.2015;2015;10;20;Torstai;5;4;9
95;01.10.2015;2015;10;21;Torstai;1;1;2
95;01.10.2015;2015;10;22;Torstai;2;1;3
95;01.10.2015;2015;10;23;Torstai;0;0;0
95;02.10.2015;2015;10;00;Perjantai;0;0;0
95;02.10.2015;2015;10;01;Perjantai;0;0;0
95;02.10.2015;2015;10;02;Perjantai;0;0;0
95;02.10.2015;2015;10;03;Perjantai;0;0;0
95;02.10.2015;2015;10;04;Perjantai;1;0;1
95;02.10.2015;2015;10;05;Perjantai;4;1;5
95;02.10.2015;2015;10;06;Perjantai;11;4;15
95;02.10.2015;2015;10;07;Perjantai;4;6;10
95;02.10.2015;2015;10;08;Perjantai;2;5;7
95;02.10.2015;2015;10;09;Perjantai;2;1;3
95;02.10.2015;2015;10;10;Perjantai;5;3;8
95;02.10.2015;2015;10;11;Perjantai;2;2;4
95;02.10.2015;2015;10;12;Perjantai;3;2;5
95;02.10.2015;2015;10;13;Perjantai;3;3;6
95;02.10.2015;2015;10;14;Perjantai;6;4;10
95;02.10.2015;2015;10;15;Perjantai;4;7;11
95;02.10.2015;2015;10;16;Perjantai;3;4;7
95;02.10.2015;2015;10;17;Perjantai;3;1;4
95;02.10.2015;2015;10;18;Perjantai;0;4;4
95;02.10.2015;2015;10;19;Perjantai;2;1;3
95;02.10.2015;2015;10;20;Perjantai;1;2;3
95;02.10.2015;2015;10;21;Perjantai;0;2;2
95;02.10.2015;2015;10;22;Perjantai;0;0;0
95;02.10.2015;2015;10;23;Perjantai;1;0;1
95;03.10.2015;2015;10;00;Lauantai;0;0;0
95;03.10.2015;2015;10;01;Lauantai;0;0;0
95;03.10.2015;2015;10;02;Lauantai;0;1;1
95;03.10.2015;2015;10;03;Lauantai;1;0;1
95;03.10.2015;2015;10;04;Lauantai;1;0;1
95;03.10.2015;2015;10;05;Lauantai;0;0;0
95;03.10.2015;2015;10;06;Lauantai;1;1;2
95;03.10.2015;2015;10;07;Lauantai;2;2;4
95;03.10.2015;2015;10;08;Lauantai;3;3;6
95;03.10.2015;2015;10;09;Lauantai;4;3;7
95;03.10.2015;2015;10;10;Lauantai;7;3;10
95;03.10.2015;2015;10;11;Lauantai;5;3;8
95;03.10.2015;2015;10;12;Lauantai;9;10;19
95;03.10.2015;2015;10;13;Lauantai;4;9;13
95;03.10.2015;2015;10;14;Lauantai;16;13;29
95;03.10.2015;2015;10;15;Lauantai;17;15;32
95;03.10.2015;2015;10;16;Lauantai;6;10;16
95;03.10.2015;2015;10;17;Lauantai;6;11;17
95;03.10.2015;2015;10;18;Lauantai;10;12;22
95;03.10.2015;2015;10;19;Lauantai;1;5;6
95;03.10.2015;2015;10;20;Lauantai;1;5;6
95;03.10.2015;2015;10;21;Lauantai;6;7;13
95;03.10.2015;2015;10;22;Lauantai;1;3;4
95;03.10.2015;2015;10;23;Lauantai;3;2;5
95;04.10.2015;2015;10;00;Sunnuntai;1;0;1
95;04.10.2015;2015;10;01;Sunnuntai;0;0;0
95;04.10.2015;2015;10;02;Sunnuntai;0;1;1
95;04.10.2015;2015;10;03;Sunnuntai;0;0;0
95;04.10.2015;2015;10;04;Sunnuntai;2;0;2
95;04.10.2015;2015;10;05;Sunnuntai;0;0;0
95;04.10.2015;2015;10;06;Sunnuntai;0;0;0
95;04.10.2015;2015;10;07;Sunnuntai;3;3;6
95;04.10.2015;2015;10;08;Sunnuntai;2;3;5
95;04.10.2015;2015;10;09;Sunnuntai;6;4;10
95;04.10.2015;2015;10;10;Sunnuntai;8;5;13
95;04.10.2015;2015;10;11;Sunnuntai;10;7;17
95;04.10.2015;2015;10;12;Sunnuntai;6;10;16
95;04.10.2015;2015;10;13;Sunnuntai;7;5;12
95;04.10.2015;2015;10;14;Sunnuntai;10;7;17
95;04.10.2015;2015;10;15;Sunnuntai;10;9;19
95;04.10.2015;2015;10;16;Sunnuntai;9;6;15
95;04.10.2015;2015;10;17;Sunnuntai;3;7;10
95;04.10.2015;2015;10;18;Sunnuntai;7;6;13
95;04.10.2015;2015;10;19;Sunnuntai;5;2;7
95;04.10.2015;2015;10;20;Sunnuntai;1;3;4
95;04.10.2015;2015;10;21;Sunnuntai;1;2;3
95;04.10.2015;2015;10;22;Sunnuntai;0;2;2
95;04.10.2015;2015;10;23;Sunnuntai;0;0;0
95;05.10.2015;2015;10;00;Maanantai;2;0;2
95;05.10.2015;2015;10;01;Maanantai;0;0;0
95;05.10.2015;2015;10;02;Maanantai;0;0;0
95;05.10.2015;2015;10;03;Maanantai;0;0;0
95;05.10.2015;2015;10;04;Maanantai;3;0;3
95;05.10.2015;2015;10;05;Maanantai;5;3;8
95;05.10.2015;2015;10;06;Maanantai;21;6;27
95;05.10.2015;2015;10;07;Maanantai;22;14;36
95;05.10.2015;2015;10;08;Maanantai;11;10;21
95;05.10.2015;2015;10;09;Maanantai;10;12;22
95;05.10.2015;2015;10;10;Maanantai;3;7;10
95;05.10.2015;2015;10;11;Maanantai;3;6;9
95;05.10.2015;2015;10;12;Maanantai;10;4;14
95;05.10.2015;2015;10;13;Maanantai;7;12;19
95;05.10.2015;2015;10;14;Maanantai;17;8;25
95;05.10.2015;2015;10;15;Maanantai;13;21;34
95;05.10.2015;2015;10;16;Maanantai;29;22;51
95;05.10.2015;2015;10;17;Maanantai;8;17;25
95;05.10.2015;2015;10;18;Maanantai;9;18;27
95;05.10.2015;2015;10;19;Maanantai;3;3;6
95;05.10.2015;2015;10;20;Maanantai;5;2;7
95;05.10.2015;2015;10;21;Maanantai;1;6;7
95;05.10.2015;2015;10;22;Maanantai;2;4;6
95;05.10.2015;2015;10;23;Maanantai;0;1;1
95;06.10.2015;2015;10;00;Tiistai;0;2;2
95;06.10.2015;2015;10;01;Tiistai;0;0;0
95;06.10.2015;2015;10;02;Tiistai;0;0;0
95;06.10.2015;2015;10;03;Tiistai;0;1;1
95;06.10.2015;2015;10;04;Tiistai;0;0;0
95;06.10.2015;2015;10;05;Tiistai;3;4;7
95;06.10.2015;2015;10;06;Tiistai;18;7;25
95;06.10.2015;2015;10;07;Tiistai;24;18;42
95;06.10.2015;2015;10;08;Tiistai;9;13;22
95;06.10.2015;2015;10;09;Tiistai;5;6;11
95;06.10.2015;2015;10;10;Tiistai;10;2;12
95;06.10.2015;2015;10;11;Tiistai;5;6;11
95;06.10.2015;2015;10;12;Tiistai;11;3;14
95;06.10.2015;2015;10;13;Tiistai;7;7;14
95;06.10.2015;2015;10;14;Tiistai;16;11;27
95;06.10.2015;2015;10;15;Tiistai;13;20;33
95;06.10.2015;2015;10;16;Tiistai;27;25;52
95;06.10.2015;2015;10;17;Tiistai;8;15;23
95;06.10.2015;2015;10;18;Tiistai;5;9;14
95;06.10.2015;2015;10;19;Tiistai;2;9;11
95;06.10.2015;2015;10;20;Tiistai;6;1;7
95;06.10.2015;2015;10;21;Tiistai;2;6;8
95;06.10.2015;2015;10;22;Tiistai;2;4;6
95;06.10.2015;2015;10;23;Tiistai;0;1;1
95;07.10.2015;2015;10;00;Keskiviikko;0;0;0
95;07.10.2015;2015;10;01;Keskiviikko;0;0;0
95;07.10.2015;2015;10;02;Keskiviikko;0;0;0
95;07.10.2015;2015;10;03;Keskiviikko;0;1;1
95;07.10.2015;2015;10;04;Keskiviikko;3;0;3
95;07.10.2015;2015;10;05;Keskiviikko;3;2;5
95;07.10.2015;2015;10;06;Keskiviikko;18;9;27
95;07.10.2015;2015;10;07;Keskiviikko;13;17;30
95;07.10.2015;2015;10;08;Keskiviikko;9;8;17
95;07.10.2015;2015;10;09;Keskiviikko;5;4;9
95;07.10.2015;2015;10;10;Keskiviikko;4;8;12
95;07.10.2015;2015;10;11;Keskiviikko;3;5;8
95;07.10.2015;2015;10;12;Keskiviikko;10;3;13
95;07.10.2015;2015;10;13;Keskiviikko;13;12;25
95;07.10.2015;2015;10;14;Keskiviikko;20;16;36
95;07.10.2015;2015;10;15;Keskiviikko;12;15;27
95;07.10.2015;2015;10;16;Keskiviikko;21;18;39
95;07.10.2015;2015;10;17;Keskiviikko;13;12;25
95;07.10.2015;2015;10;18;Keskiviikko;7;15;22
95;07.10.2015;2015;10;19;Keskiviikko;2;9;11
95;07.10.2015;2015;10;20;Keskiviikko;3;4;7
95;07.10.2015;2015;10;21;Keskiviikko;5;3;8
95;07.10.2015;2015;10;22;Keskiviikko;1;1;2
95;07.10.2015;2015;10;23;Keskiviikko;0;1;1
95;08.10.2015;2015;10;00;Torstai;0;0;0
95;08.10.2015;2015;10;01;Torstai;0;0;0
95;08.10.2015;2015;10;02;Torstai;0;0;0
95;08.10.2015;2015;10;03;Torstai;0;0;0
95;08.10.2015;2015;10;04;Torstai;2;0;2
95;08.10.2015;2015;10;05;Torstai;7;2;9
95;08.10.2015;2015;10;06;Torstai;12;10;22
95;08.10.2015;2015;10;07;Torstai;21;8;29
95;08.10.2015;2015;10;08;Torstai;7;10;17
95;08.10.2015;2015;10;09;Torstai;6;9;15
95;08.10.2015;2015;10;10;Torstai;1;4;5
95;08.10.2015;2015;10;11;Torstai;8;3;11
95;08.10.2015;2015;10;12;Torstai;6;6;12
95;08.10.2015;2015;10;13;Torstai;11;12;23
95;08.10.2015;2015;10;14;Torstai;10;13;23
95;08.10.2015;2015;10;15;Torstai;18;21;39
95;08.10.2015;2015;10;16;Torstai;21;17;38
95;08.10.2015;2015;10;17;Torstai;4;12;16
95;08.10.2015;2015;10;18;Torstai;7;8;15
95;08.10.2015;2015;10;19;Torstai;5;2;7
95;08.10.2015;2015;10;20;Torstai;5;3;8
95;08.10.2015;2015;10;21;Torstai;2;1;3
95;08.10.2015;2015;10;22;Torstai;2;2;4
95;08.10.2015;2015;10;23;Torstai;0;1;1
95;09.10.2015;2015;10;00;Perjantai;0;0;0
95;09.10.2015;2015;10;01;Perjantai;0;0;0
95;09.10.2015;2015;10;02;Perjantai;0;0;0
95;09.10.2015;2015;10;03;Perjantai;0;0;0
95;09.10.2015;2015;10;04;Perjantai;1;0;1
95;09.10.2015;2015;10;05;Perjantai;6;1;7
95;09.10.2015;2015;10;06;Perjantai;11;7;18
95;09.10.2015;2015;10;07;Perjantai;7;10;17
95;09.10.2015;2015;10;08;Perjantai;6;13;19
95;09.10.2015;2015;10;09;Perjantai;5;7;12
95;09.10.2015;2015;10;10;Perjantai;6;4;10
95;09.10.2015;2015;10;11;Perjantai;5;2;7
95;09.10.2015;2015;10;12;Perjantai;9;7;16
95;09.10.2015;2015;10;13;Perjantai;14;5;19
95;09.10.2015;2015;10;14;Perjantai;9;13;22
95;09.10.2015;2015;10;15;Perjantai;12;13;25
95;09.10.2015;2015;10;16;Perjantai;8;16;24
95;09.10.2015;2015;10;17;Perjantai;15;11;26
95;09.10.2015;2015;10;18;Perjantai;5;4;9
95;09.10.2015;2015;10;19;Perjantai;4;9;13
95;09.10.2015;2015;10;20;Perjantai;2;3;5
95;09.10.2015;2015;10;21;Perjantai;2;0;2
95;09.10.2015;2015;10;22;Perjantai;1;0;1
95;09.10.2015;2015;10;23;Perjantai;0;1;1
95;10.10.2015;2015;10;00;Lauantai;0;0;0
95;10.10.2015;2015;10;01;Lauantai;0;0;0
95;10.10.2015;2015;10;02;Lauantai;0;0;0
95;10.10.2015;2015;10;03;Lauantai;0;0;0
95;10.10.2015;2015;10;04;Lauantai;0;1;1
95;10.10.2015;2015;10;05;Lauantai;0;0;0
95;10.10.2015;2015;10;06;Lauantai;4;0;4
95;10.10.2015;2015;10;07;Lauantai;4;1;5
95;10.10.2015;2015;10;08;Lauantai;5;2;7
95;10.10.2015;2015;10;09;Lauantai;6;3;9
95;10.10.2015;2015;10;10;Lauantai;7;2;9
95;10.10.2015;2015;10;11;Lauantai;13;7;20
95;10.10.2015;2015;10;12;Lauantai;10;5;15
95;10.10.2015;2015;10;13;Lauantai;6;8;14
95;10.10.2015;2015;10;14;Lauantai;6;10;16
95;10.10.2015;2015;10;15;Lauantai;4;9;13
95;10.10.2015;2015;10;16;Lauantai;12;12;24
95;10.10.2015;2015;10;17;Lauantai;5;11;16
95;10.10.2015;2015;10;18;Lauantai;7;6;13
95;10.10.2015;2015;10;19;Lauantai;0;5;5
95;10.10.2015;2015;10;20;Lauantai;4;4;8
95;10.10.2015;2015;10;21;Lauantai;1;2;3
95;10.10.2015;2015;10;22;Lauantai;1;3;4
95;10.10.2015;2015;10;23;Lauantai;1;0;1
95;11.10.2015;2015;10;00;Sunnuntai;0;0;0
95;11.10.2015;2015;10;01;Sunnuntai;0;0;0
95;11.10.2015;2015;10;02;Sunnuntai;0;1;1
95;11.10.2015;2015;10;03;Sunnuntai;0;1;1
95;11.10.2015;2015;10;04;Sunnuntai;0;1;1
95;11.10.2015;2015;10;05;Sunnuntai;1;1;2
95;11.10.2015;2015;10;06;Sunnuntai;4;0;4
95;11.10.2015;2015;10;07;Sunnuntai;1;0;1
95;11.10.2015;2015;10;08;Sunnuntai;2;4;6
95;11.10.2015;2015;10;09;Sunnuntai;3;2;5
95;11.10.2015;2015;10;10;Sunnuntai;6;3;9
95;11.10.2015;2015;10;11;Sunnuntai;5;11;16
95;11.10.2015;2015;10;12;Sunnuntai;16;13;29
95;11.10.2015;2015;10;13;Sunnuntai;14;5;19
95;11.10.2015;2015;10;14;Sunnuntai;10;12;22
95;11.10.2015;2015;10;15;Sunnuntai;9;11;20
95;11.10.2015;2015;10;16;Sunnuntai;7;11;18
95;11.10.2015;2015;10;17;Sunnuntai;14;10;24
95;11.10.2015;2015;10;18;Sunnuntai;9;7;16
95;11.10.2015;2015;10;19;Sunnuntai;3;0;3
95;11.10.2015;2015;10;20;Sunnuntai;1;4;5
95;11.10.2015;2015;10;21;Sunnuntai;2;4;6
95;11.10.2015;2015;10;22;Sunnuntai;0;1;1
95;11.10.2015;2015;10;23;Sunnuntai;0;0;0
95;12.10.2015;2015;10;00;Maanantai;0;0;0
95;12.10.2015;2015;10;01;Maanantai;0;0;0
95;12.10.2015;2015;10;02;Maanantai;0;1;1
95;12.10.2015;2015;10;03;Maanantai;0;0;0
95;12.10.2015;2015;10;04;Maanantai;1;0;1
95;12.10.2015;2015;10;05;Maanantai;7;3;10
95;12.10.2015;2015;10;06;Maanantai;16;10;26
95;12.10.2015;2015;10;07;Maanantai;23;9;32
95;12.10.2015;2015;10;08;Maanantai;13;10;23
95;12.10.2015;2015;10;09;Maanantai;9;14;23
95;12.10.2015;2015;10;10;Maanantai;3;7;10
95;12.10.2015;2015;10;11;Maanantai;5;4;9
95;12.10.2015;2015;10;12;Maanantai;8;6;14
95;12.10.2015;2015;10;13;Maanantai;8;2;10
95;12.10.2015;2015;10;14;Maanantai;18;11;29
95;12.10.2015;2015;10;15;Maanantai;19;15;34
95;12.10.2015;2015;10;16;Maanantai;21;23;44
95;12.10.2015;2015;10;17;Maanantai;8;9;17
95;12.10.2015;2015;10;18;Maanantai;4;11;15
95;12.10.2015;2015;10;19;Maanantai;2;5;7
95;12.10.2015;2015;10;20;Maanantai;1;2;3
95;12.10.2015;2015;10;21;Maanantai;2;3;5
95;12.10.2015;2015;10;22;Maanantai;1;2;3
95;12.10.2015;2015;10;23;Maanantai;0;0;0
95;13.10.2015;2015;10;00;Tiistai;0;0;0
95;13.10.2015;2015;10;01;Tiistai;0;0;0
95;13.10.2015;2015;10;02;Tiistai;0;0;0
95;13.10.2015;2015;10;03;Tiistai;0;0;0
95;13.10.2015;2015;10;04;Tiistai;4;3;7
95;13.10.2015;2015;10;05;Tiistai;9;3;12
95;13.10.2015;2015;10;06;Tiistai;17;12;29
95;13.10.2015;2015;10;07;Tiistai;24;16;40
95;13.10.2015;2015;10;08;Tiistai;7;17;24
95;13.10.2015;2015;10;09;Tiistai;4;11;15
95;13.10.2015;2015;10;10;Tiistai;8;5;13
95;13.10.2015;2015;10;11;Tiistai;6;5;11
95;13.10.2015;2015;10;12;Tiistai;8;6;14
95;13.10.2015;2015;10;13;Tiistai;16;8;24
95;13.10.2015;2015;10;14;Tiistai;22;11;33
95;13.10.2015;2015;10;15;Tiistai;25;20;45
95;13.10.2015;2015;10;16;Tiistai;32;26;58
95;13.10.2015;2015;10;17;Tiistai;9;14;23
95;13.10.2015;2015;10;18;Tiistai;7;10;17
95;13.10.2015;2015;10;19;Tiistai;2;8;10
95;13.10.2015;2015;10;20;Tiistai;4;1;5
95;13.10.2015;2015;10;21;Tiistai;2;2;4
95;13.10.2015;2015;10;22;Tiistai;3;4;7
95;13.10.2015;2015;10;23;Tiistai;1;0;1
95;14.10.2015;2015;10;00;Keskiviikko;0;3;3
95;14.10.2015;2015;10;01;Keskiviikko;0;0;0
95;14.10.2015;2015;10;02;Keskiviikko;0;0;0
95;14.10.2015;2015;10;03;Keskiviikko;0;1;1
95;14.10.2015;2015;10;04;Keskiviikko;1;1;2
95;14.10.2015;2015;10;05;Keskiviikko;7;1;8
95;14.10.2015;2015;10;06;Keskiviikko;14;6;20
95;14.10.2015;2015;10;07;Keskiviikko;16;20;36
95;14.10.2015;2015;10;08;Keskiviikko;10;17;27
95;14.10.2015;2015;10;09;Keskiviikko;6;5;11
95;14.10.2015;2015;10;10;Keskiviikko;7;11;18
95;14.10.2015;2015;10;11;Keskiviikko;6;5;11
95;14.10.2015;2015;10;12;Keskiviikko;15;7;22
95;14.10.2015;2015;10;13;Keskiviikko;13;10;23
95;14.10.2015;2015;10;14;Keskiviikko;17;10;27
95;14.10.2015;2015;10;15;Keskiviikko;12;18;30
95;14.10.2015;2015;10;16;Keskiviikko;29;27;56
95;14.10.2015;2015;10;17;Keskiviikko;7;20;27
95;14.10.2015;2015;10;18;Keskiviikko;4;4;8
95;14.10.2015;2015;10;19;Keskiviikko;3;6;9
95;14.10.2015;2015;10;20;Keskiviikko;2;7;9
95;14.10.2015;2015;10;21;Keskiviikko;2;3;5
95;14.10.2015;2015;10;22;Keskiviikko;1;1;2
95;14.10.2015;2015;10;23;Keskiviikko;2;2;4
95;15.10.2015;2015;10;00;Torstai;0;0;0
95;15.10.2015;2015;10;01;Torstai;0;0;0
95;15.10.2015;2015;10;02;Torstai;0;1;1
95;15.10.2015;2015;10;03;Torstai;0;0;0
95;15.10.2015;2015;10;04;Torstai;0;0;0
95;15.10.2015;2015;10;05;Torstai;7;2;9
95;15.10.2015;2015;10;06;Torstai;17;7;24
95;15.10.2015;2015;10;07;Torstai;14;19;33
95;15.10.2015;2015;10;08;Torstai;9;9;18
95;15.10.2015;2015;10;09;Torstai;9;7;16
95;15.10.2015;2015;10;10;Torstai;3;8;11
95;15.10.2015;2015;10;11;Torstai;6;6;12
95;15.10.2015;2015;10;12;Torstai;16;10;26
95;15.10.2015;2015;10;13;Torstai;8;10;18
95;15.10.2015;2015;10;14;Torstai;11;10;21
95;15.10.2015;2015;10;15;Torstai;17;17;34
95;15.10.2015;2015;10;16;Torstai;25;21;46
95;15.10.2015;2015;10;17;Torstai;10;5;15
95;15.10.2015;2015;10;18;Torstai;5;10;15
95;15.10.2015;2015;10;19;Torstai;3;6;9
95;15.10.2015;2015;10;20;Torstai;3;3;6
95;15.10.2015;2015;10;21;Torstai;3;2;5
95;15.10.2015;2015;10;22;Torstai;2;1;3
95;15.10.2015;2015;10;23;Torstai;0;0;0
95;16.10.2015;2015;10;00;Perjantai;1;0;1
95;16.10.2015;2015;10;01;Perjantai;0;0;0
95;16.10.2015;2015;10;02;Perjantai;0;0;0
95;16.10.2015;2015;10;03;Perjantai;0;1;1
95;16.10.2015;2015;10;04;Perjantai;1;0;1
95;16.10.2015;2015;10;05;Perjantai;7;2;9
95;16.10.2015;2015;10;06;Perjantai;10;9;19
95;16.10.2015;2015;10;07;Perjantai;16;14;30
95;16.10.2015;2015;10;08;Perjantai;6;12;18
95;16.10.2015;2015;10;09;Perjantai;6;6;12
95;16.10.2015;2015;10;10;Perjantai;8;9;17
95;16.10.2015;2015;10;11;Perjantai;8;7;15
95;16.10.2015;2015;10;12;Perjantai;13;8;21
95;16.10.2015;2015;10;13;Perjantai;10;6;16
95;16.10.2015;2015;10;14;Perjantai;14;9;23
95;16.10.2015;2015;10;15;Perjantai;16;14;30
95;16.10.2015;2015;10;16;Perjantai;10;17;27
95;16.10.2015;2015;10;17;Perjantai;13;13;26
95;16.10.2015;2015;10;18;Perjantai;3;8;11
95;16.10.2015;2015;10;19;Perjantai;4;2;6
95;16.10.2015;2015;10;20;Perjantai;2;2;4
95;16.10.2015;2015;10;21;Perjantai;1;1;2
95;16.10.2015;2015;10;22;Perjantai;2;2;4
95;16.10.2015;2015;10;23;Perjantai;0;1;1
95;17.10.2015;2015;10;00;Lauantai;0;0;0
95;17.10.2015;2015;10;01;Lauantai;1;0;1
95;17.10.2015;2015;10;02;Lauantai;0;0;0
95;17.10.2015;2015;10;03;Lauantai;0;0;0
95;17.10.2015;2015;10;04;Lauantai;1;0;1
95;17.10.2015;2015;10;05;Lauantai;1;3;4
95;17.10.2015;2015;10;06;Lauantai;2;0;2
95;17.10.2015;2015;10;07;Lauantai;1;3;4
95;17.10.2015;2015;10;08;Lauantai;4;1;5
95;17.10.2015;2015;10;09;Lauantai;3;4;7
95;17.10.2015;2015;10;10;Lauantai;8;8;16
95;17.10.2015;2015;10;11;Lauantai;7;6;13
95;17.10.2015;2015;10;12;Lauantai;16;5;21
95;17.10.2015;2015;10;13;Lauantai;14;11;25
95;17.10.2015;2015;10;14;Lauantai;13;18;31
95;17.10.2015;2015;10;15;Lauantai;7;6;13
95;17.10.2015;2015;10;16;Lauantai;13;6;19
95;17.10.2015;2015;10;17;Lauantai;6;11;17
95;17.10.2015;2015;10;18;Lauantai;3;6;9
95;17.10.2015;2015;10;19;Lauantai;4;5;9
95;17.10.2015;2015;10;20;Lauantai;4;2;6
95;17.10.2015;2015;10;21;Lauantai;1;2;3
95;17.10.2015;2015;10;22;Lauantai;0;2;2
95;17.10.2015;2015;10;23;Lauantai;0;0;0
95;18.10.2015;2015;10;00;Sunnuntai;0;0;0
95;18.10.2015;2015;10;01;Sunnuntai;0;0;0
95;18.10.2015;2015;10;02;Sunnuntai;0;1;1
95;18.10.2015;2015;10;03;Sunnuntai;0;0;0
95;18.10.2015;2015;10;04;Sunnuntai;0;0;0
95;18.10.2015;2015;10;05;Sunnuntai;1;0;1
95;18.10.2015;2015;10;06;Sunnuntai;3;1;4
95;18.10.2015;2015;10;07;Sunnuntai;2;0;2
95;18.10.2015;2015;10;08;Sunnuntai;7;3;10
95;18.10.2015;2015;10;09;Sunnuntai;5;6;11
95;18.10.2015;2015;10;10;Sunnuntai;6;5;11
95;18.10.2015;2015;10;11;Sunnuntai;9;2;11
95;18.10.2015;2015;10;12;Sunnuntai;17;4;21
95;18.10.2015;2015;10;13;Sunnuntai;5;15;20
95;18.10.2015;2015;10;14;Sunnuntai;1;12;13
95;18.10.2015;2015;10;15;Sunnuntai;2;5;7
95;18.10.2015;2015;10;16;Sunnuntai;17;7;24
95;18.10.2015;2015;10;17;Sunnuntai;9;9;18
95;18.10.2015;2015;10;18;Sunnuntai;8;6;14
95;18.10.2015;2015;10;19;Sunnuntai;2;5;7
95;18.10.2015;2015;10;20;Sunnuntai;5;4;9
95;18.10.2015;2015;10;21;Sunnuntai;1;2;3
95;18.10.2015;2015;10;22;Sunnuntai;0;0;0
95;18.10.2015;2015;10;23;Sunnuntai;0;0;0
95;19.10.2015;2015;10;00;Maanantai;0;0;0
95;19.10.2015;2015;10;01;Maanantai;0;0;0
95;19.10.2015;2015;10;02;Maanantai;0;0;0
95;19.10.2015;2015;10;03;Maanantai;0;0;0
95;19.10.2015;2015;10;04;Maanantai;4;1;5
95;19.10.2015;2015;10;05;Maanantai;6;2;8
95;19.10.2015;2015;10;06;Maanantai;18;7;25
95;19.10.2015;2015;10;07;Maanantai;16;6;22
95;19.10.2015;2015;10;08;Maanantai;7;7;14
95;19.10.2015;2015;10;09;Maanantai;7;2;9
95;19.10.2015;2015;10;10;Maanantai;7;9;16
95;19.10.2015;2015;10;11;Maanantai;14;5;19
95;19.10.2015;2015;10;12;Maanantai;9;10;19
95;19.10.2015;2015;10;13;Maanantai;4;12;16
95;19.10.2015;2015;10;14;Maanantai;6;12;18
95;19.10.2015;2015;10;15;Maanantai;13;21;34
95;19.10.2015;2015;10;16;Maanantai;19;32;51
95;19.10.2015;2015;10;17;Maanantai;9;11;20
95;19.10.2015;2015;10;18;Maanantai;4;15;19
95;19.10.2015;2015;10;19;Maanantai;5;10;15
95;19.10.2015;2015;10;20;Maanantai;5;0;5
95;19.10.2015;2015;10;21;Maanantai;1;3;4
95;19.10.2015;2015;10;22;Maanantai;2;3;5
95;19.10.2015;2015;10;23;Maanantai;1;1;2
95;20.10.2015;2015;10;00;Tiistai;0;0;0
95;20.10.2015;2015;10;01;Tiistai;0;0;0
95;20.10.2015;2015;10;02;Tiistai;0;0;0
95;20.10.2015;2015;10;03;Tiistai;0;0;0
95;20.10.2015;2015;10;04;Tiistai;2;1;3
95;20.10.2015;2015;10;05;Tiistai;7;2;9
95;20.10.2015;2015;10;06;Tiistai;10;7;17
95;20.10.2015;2015;10;07;Tiistai;14;7;21
95;20.10.2015;2015;10;08;Tiistai;6;8;14
95;20.10.2015;2015;10;09;Tiistai;7;3;10
95;20.10.2015;2015;10;10;Tiistai;4;7;11
95;20.10.2015;2015;10;11;Tiistai;4;6;10
95;20.10.2015;2015;10;12;Tiistai;3;5;8
95;20.10.2015;2015;10;13;Tiistai;0;4;4
95;20.10.2015;2015;10;14;Tiistai;2;6;8
95;20.10.2015;2015;10;15;Tiistai;13;17;30
95;20.10.2015;2015;10;16;Tiistai;16;12;28
95;20.10.2015;2015;10;17;Tiistai;3;9;12
95;20.10.2015;2015;10;18;Tiistai;6;3;9
95;20.10.2015;2015;10;19;Tiistai;4;2;6
95;20.10.2015;2015;10;20;Tiistai;0;1;1
95;20.10.2015;2015;10;21;Tiistai;3;1;4
95;20.10.2015;2015;10;22;Tiistai;1;1;2
95;20.10.2015;2015;10;23;Tiistai;1;0;1
95;21.10.2015;2015;10;00;Keskiviikko;1;0;1
95;21.10.2015;2015;10;01;Keskiviikko;1;0;1
95;21.10.2015;2015;10;02;Keskiviikko;0;0;0
95;21.10.2015;2015;10;03;Keskiviikko;0;1;1
95;21.10.2015;2015;10;04;Keskiviikko;0;0;0
95;21.10.2015;2015;10;05;Keskiviikko;6;2;8
95;21.10.2015;2015;10;06;Keskiviikko;16;4;20
95;21.10.2015;2015;10;07;Keskiviikko;9;5;14
95;21.10.2015;2015;10;08;Keskiviikko;6;6;12
95;21.10.2015;2015;10;09;Keskiviikko;6;2;8
95;21.10.2015;2015;10;10;Keskiviikko;3;3;6
95;21.10.2015;2015;10;11;Keskiviikko;4;4;8
95;21.10.2015;2015;10;12;Keskiviikko;8;4;12
95;21.10.2015;2015;10;13;Keskiviikko;3;7;10
95;21.10.2015;2015;10;14;Keskiviikko;9;6;15
95;21.10.2015;2015;10;15;Keskiviikko;8;10;18
95;21.10.2015;2015;10;16;Keskiviikko;7;15;22
95;21.10.2015;2015;10;17;Keskiviikko;3;8;11
95;21.10.2015;2015;10;18;Keskiviikko;4;2;6
95;21.10.2015;2015;10;19;Keskiviikko;2;1;3
95;21.10.2015;2015;10;20;Keskiviikko;2;1;3
95;21.10.2015;2015;10;21;Keskiviikko;1;4;5
95;21.10.2015;2015;10;22;Keskiviikko;2;2;4
95;21.10.2015;2015;10;23;Keskiviikko;0;0;0
95;22.10.2015;2015;10;00;Torstai;1;1;2
95;22.10.2015;2015;10;01;Torstai;0;0;0
95;22.10.2015;2015;10;02;Torstai;0;0;0
95;22.10.2015;2015;10;03;Torstai;0;0;0
95;22.10.2015;2015;10;04;Torstai;0;0;0
95;22.10.2015;2015;10;05;Torstai;4;2;6
95;22.10.2015;2015;10;06;Torstai;11;3;14
95;22.10.2015;2015;10;07;Torstai;18;1;19
95;22.10.2015;2015;10;08;Torstai;5;4;9
95;22.10.2015;2015;10;09;Torstai;4;3;7
95;22.10.2015;2015;10;10;Torstai;3;3;6
95;22.10.2015;2015;10;11;Torstai;6;5;11
95;22.10.2015;2015;10;12;Torstai;11;7;18
95;22.10.2015;2015;10;13;Torstai;12;7;19
95;22.10.2015;2015;10;14;Torstai;7;12;19
95;22.10.2015;2015;10;15;Torstai;7;16;23
95;22.10.2015;2015;10;16;Torstai;8;18;26
95;22.10.2015;2015;10;17;Torstai;7;9;16
95;22.10.2015;2015;10;18;Torstai;8;5;13
95;22.10.2015;2015;10;19;Torstai;4;6;10
95;22.10.2015;2015;10;20;Torstai;3;2;5
95;22.10.2015;2015;10;21;Torstai;2;1;3
95;22.10.2015;2015;10;22;Torstai;3;2;5
95;22.10.2015;2015;10;23;Torstai;0;1;1
95;23.10.2015;2015;10;00;Perjantai;0;0;0
95;23.10.2015;2015;10;01;Perjantai;0;0;0
95;23.10.2015;2015;10;02;Perjantai;0;0;0
95;23.10.2015;2015;10;03;Perjantai;0;0;0
95;23.10.2015;2015;10;04;Perjantai;1;0;1
95;23.10.2015;2015;10;05;Perjantai;6;4;10
95;23.10.2015;2015;10;06;Perjantai;8;3;11
95;23.10.2015;2015;10;07;Perjantai;7;3;10
95;23.10.2015;2015;10;08;Perjantai;7;7;14
95;23.10.2015;2015;10;09;Perjantai;2;2;4
95;23.10.2015;2015;10;10;Perjantai;2;4;6
95;23.10.2015;2015;10;11;Perjantai;4;4;8
95;23.10.2015;2015;10;12;Perjantai;6;5;11
95;23.10.2015;2015;10;13;Perjantai;5;3;8
95;23.10.2015;2015;10;14;Perjantai;6;7;13
95;23.10.2015;2015;10;15;Perjantai;8;12;20
95;23.10.2015;2015;10;16;Perjantai;5;6;11
95;23.10.2015;2015;10;17;Perjantai;6;6;12
95;23.10.2015;2015;10;18;Perjantai;4;6;10
95;23.10.2015;2015;10;19;Perjantai;4;3;7
95;23.10.2015;2015;10;20;Perjantai;3;1;4
95;23.10.2015;2015;10;21;Perjantai;0;4;4
95;23.10.2015;2015;10;22;Perjantai;1;4;5
95;23.10.2015;2015;10;23;Perjantai;0;0;0
95;24.10.2015;2015;10;00;Lauantai;1;0;1
95;24.10.2015;2015;10;01;Lauantai;0;0;0
95;24.10.2015;2015;10;02;Lauantai;0;0;0
95;24.10.2015;2015;10;03;Lauantai;0;1;1
95;24.10.2015;2015;10;04;Lauantai;2;0;2
95;24.10.2015;2015;10;05;Lauantai;2;0;2
95;24.10.2015;2015;10;06;Lauantai;0;0;0
95;24.10.2015;2015;10;07;Lauantai;2;0;2
95;24.10.2015;2015;10;08;Lauantai;4;3;7
95;24.10.2015;2015;10;09;Lauantai;5;4;9
95;24.10.2015;2015;10;10;Lauantai;3;0;3
95;24.10.2015;2015;10;11;Lauantai;4;0;4
95;24.10.2015;2015;10;12;Lauantai;7;6;13
95;24.10.2015;2015;10;13;Lauantai;12;13;25
95;24.10.2015;2015;10;14;Lauantai;5;7;12
95;24.10.2015;2015;10;15;Lauantai;7;7;14
95;24.10.2015;2015;10;16;Lauantai;7;8;15
95;24.10.2015;2015;10;17;Lauantai;3;9;12
95;24.10.2015;2015;10;18;Lauantai;6;4;10
95;24.10.2015;2015;10;19;Lauantai;4;2;6
95;24.10.2015;2015;10;20;Lauantai;2;3;5
95;24.10.2015;2015;10;21;Lauantai;0;1;1
95;24.10.2015;2015;10;22;Lauantai;0;2;2
95;24.10.2015;2015;10;23;Lauantai;0;1;1
95;25.10.2015;2015;10;00;Sunnuntai;0;0;0
95;25.10.2015;2015;10;01;Sunnuntai;0;0;0
95;25.10.2015;2015;10;02;Sunnuntai;1;0;1
95;25.10.2015;2015;10;03;Sunnuntai;0;0;0
95;25.10.2015;2015;10;04;Sunnuntai;0;0;0
95;25.10.2015;2015;10;05;Sunnuntai;0;0;0
95;25.10.2015;2015;10;06;Sunnuntai;1;0;1
95;25.10.2015;2015;10;07;Sunnuntai;0;0;0
95;25.10.2015;2015;10;08;Sunnuntai;3;2;5
95;25.10.2015;2015;10;09;Sunnuntai;1;3;4
95;25.10.2015;2015;10;10;Sunnuntai;4;2;6
95;25.10.2015;2015;10;11;Sunnuntai;3;8;11
95;25.10.2015;2015;10;12;Sunnuntai;3;4;7
95;25.10.2015;2015;10;13;Sunnuntai;2;2;4
95;25.10.2015;2015;10;14;Sunnuntai;1;2;3
95;25.10.2015;2015;10;15;Sunnuntai;2;1;3
95;25.10.2015;2015;10;16;Sunnuntai;3;3;6
95;25.10.2015;2015;10;17;Sunnuntai;2;2;4
95;25.10.2015;2015;10;18;Sunnuntai;5;1;6
95;25.10.2015;2015;10;19;Sunnuntai;5;4;9
95;25.10.2015;2015;10;20;Sunnuntai;0;1;1
95;25.10.2015;2015;10;21;Sunnuntai;1;0;1
95;25.10.2015;2015;10;22;Sunnuntai;0;2;2
95;25.10.2015;2015;10;23;Sunnuntai;0;0;0
95;26.10.2015;2015;10;00;Maanantai;0;0;0
95;26.10.2015;2015;10;01;Maanantai;0;1;1
95;26.10.2015;2015;10;02;Maanantai;0;0;0
95;26.10.2015;2015;10;03;Maanantai;0;0;0
95;26.10.2015;2015;10;04;Maanantai;1;1;2
95;26.10.2015;2015;10;05;Maanantai;6;2;8
95;26.10.2015;2015;10;06;Maanantai;13;9;22
95;26.10.2015;2015;10;07;Maanantai;21;10;31
95;26.10.2015;2015;10;08;Maanantai;5;12;17
95;26.10.2015;2015;10;09;Maanantai;9;12;21
95;26.10.2015;2015;10;10;Maanantai;5;7;12
95;26.10.2015;2015;10;11;Maanantai;5;10;15
95;26.10.2015;2015;10;12;Maanantai;17;8;25
95;26.10.2015;2015;10;13;Maanantai;12;16;28
95;26.10.2015;2015;10;14;Maanantai;8;8;16
95;26.10.2015;2015;10;15;Maanantai;16;17;33
95;26.10.2015;2015;10;16;Maanantai;22;23;45
95;26.10.2015;2015;10;17;Maanantai;8;16;24
95;26.10.2015;2015;10;18;Maanantai;3;6;9
95;26.10.2015;2015;10;19;Maanantai;2;3;5
95;26.10.2015;2015;10;20;Maanantai;5;7;12
95;26.10.2015;2015;10;21;Maanantai;4;1;5
95;26.10.2015;2015;10;22;Maanantai;2;3;5
95;26.10.2015;2015;10;23;Maanantai;0;1;1
95;27.10.2015;2015;10;00;Tiistai;0;1;1
95;27.10.2015;2015;10;01;Tiistai;0;0;0
95;27.10.2015;2015;10;02;Tiistai;1;0;1
95;27.10.2015;2015;10;03;Tiistai;0;1;1
95;27.10.2015;2015;10;04;Tiistai;0;0;0
95;27.10.2015;2015;10;05;Tiistai;1;2;3
95;27.10.2015;2015;10;06;Tiistai;19;8;27
95;27.10.2015;2015;10;07;Tiistai;13;16;29
95;27.10.2015;2015;10;08;Tiistai;1;15;16
95;27.10.2015;2015;10;09;Tiistai;2;3;5
95;27.10.2015;2015;10;10;Tiistai;3;2;5
95;27.10.2015;2015;10;11;Tiistai;2;2;4
95;27.10.2015;2015;10;12;Tiistai;6;2;8
95;27.10.2015;2015;10;13;Tiistai;10;6;16
95;27.10.2015;2015;10;14;Tiistai;14;4;18
95;27.10.2015;2015;10;15;Tiistai;9;15;24
95;27.10.2015;2015;10;16;Tiistai;17;10;27
95;27.10.2015;2015;10;17;Tiistai;14;10;24
95;27.10.2015;2015;10;18;Tiistai;5;9;14
95;27.10.2015;2015;10;19;Tiistai;4;4;8
95;27.10.2015;2015;10;20;Tiistai;3;5;8
95;27.10.2015;2015;10;21;Tiistai;2;4;6
95;27.10.2015;2015;10;22;Tiistai;1;1;2
95;27.10.2015;2015;10;23;Tiistai;1;4;5
95;28.10.2015;2015;10;00;Keskiviikko;0;0;0
95;28.10.2015;2015;10;01;Keskiviikko;0;1;1
95;28.10.2015;2015;10;02;Keskiviikko;0;0;0
95;28.10.2015;2015;10;03;Keskiviikko;0;1;1
95;28.10.2015;2015;10;04;Keskiviikko;1;0;1
95;28.10.2015;2015;10;05;Keskiviikko;5;2;7
95;28.10.2015;2015;10;06;Keskiviikko;14;7;21
95;28.10.2015;2015;10;07;Keskiviikko;11;17;28
95;28.10.2015;2015;10;08;Keskiviikko;9;8;17
95;28.10.2015;2015;10;09;Keskiviikko;7;4;11
95;28.10.2015;2015;10;10;Keskiviikko;1;4;5
95;28.10.2015;2015;10;11;Keskiviikko;11;4;15
95;28.10.2015;2015;10;12;Keskiviikko;10;6;16
95;28.10.2015;2015;10;13;Keskiviikko;8;6;14
95;28.10.2015;2015;10;14;Keskiviikko;13;10;23
95;28.10.2015;2015;10;15;Keskiviikko;13;9;22
95;28.10.2015;2015;10;16;Keskiviikko;9;22;31
95;28.10.2015;2015;10;17;Keskiviikko;1;11;12
95;28.10.2015;2015;10;18;Keskiviikko;5;4;9
95;28.10.2015;2015;10;19;Keskiviikko;1;5;6
95;28.10.2015;2015;10;20;Keskiviikko;1;5;6
95;28.10.2015;2015;10;21;Keskiviikko;1;1;2
95;28.10.2015;2015;10;22;Keskiviikko;3;0;3
95;28.10.2015;2015;10;23;Keskiviikko;1;1;2
95;29.10.2015;2015;10;00;Torstai;0;0;0
95;29.10.2015;2015;10;01;Torstai;0;0;0
95;29.10.2015;2015;10;02;Torstai;0;0;0
95;29.10.2015;2015;10;03;Torstai;0;2;2
95;29.10.2015;2015;10;04;Torstai;1;0;1
95;29.10.2015;2015;10;05;Torstai;3;2;5
95;29.10.2015;2015;10;06;Torstai;13;4;17
95;29.10.2015;2015;10;07;Torstai;17;17;34
95;29.10.2015;2015;10;08;Torstai;4;6;10
95;29.10.2015;2015;10;09;Torstai;3;3;6
95;29.10.2015;2015;10;10;Torstai;1;5;6
95;29.10.2015;2015;10;11;Torstai;4;2;6
95;29.10.2015;2015;10;12;Torstai;8;7;15
95;29.10.2015;2015;10;13;Torstai;8;7;15
95;29.10.2015;2015;10;14;Torstai;12;13;25
95;29.10.2015;2015;10;15;Torstai;10;17;27
95;29.10.2015;2015;10;16;Torstai;27;13;40
95;29.10.2015;2015;10;17;Torstai;7;13;20
95;29.10.2015;2015;10;18;Torstai;3;4;7
95;29.10.2015;2015;10;19;Torstai;6;3;9
95;29.10.2015;2015;10;20;Torstai;3;1;4
95;29.10.2015;2015;10;21;Torstai;0;1;1
95;29.10.2015;2015;10;22;Torstai;2;0;2
95;29.10.2015;2015;10;23;Torstai;1;1;2
95;30.10.2015;2015;10;00;Perjantai;0;0;0
95;30.10.2015;2015;10;01;Perjantai;0;1;1
95;30.10.2015;2015;10;02;Perjantai;0;0;0
95;30.10.2015;2015;10;03;Perjantai;0;0;0
95;30.10.2015;2015;10;04;Perjantai;0;0;0
95;30.10.2015;2015;10;05;Perjantai;4;2;6
95;30.10.2015;2015;10;06;Perjantai;8;3;11
95;30.10.2015;2015;10;07;Perjantai;9;12;21
95;30.10.2015;2015;10;08;Perjantai;6;8;14
95;30.10.2015;2015;10;09;Perjantai;2;1;3
95;30.10.2015;2015;10;10;Perjantai;2;2;4
95;30.10.2015;2015;10;11;Perjantai;5;2;7
95;30.10.2015;2015;10;12;Perjantai;4;3;7
95;30.10.2015;2015;10;13;Perjantai;17;8;25
95;30.10.2015;2015;10;14;Perjantai;5;10;15
95;30.10.2015;2015;10;15;Perjantai;15;8;23
95;30.10.2015;2015;10;16;Perjantai;9;18;27
95;30.10.2015;2015;10;17;Perjantai;7;5;12
95;30.10.2015;2015;10;18;Perjantai;1;2;3
95;30.10.2015;2015;10;19;Perjantai;2;4;6
95;30.10.2015;2015;10;20;Perjantai;0;2;2
95;30.10.2015;2015;10;21;Perjantai;1;2;3
95;30.10.2015;2015;10;22;Perjantai;0;0;0
95;30.10.2015;2015;10;23;Perjantai;0;2;2
95;31.10.2015;2015;10;00;Lauantai;2;0;2
95;31.10.2015;2015;10;01;Lauantai;0;0;0
95;31.10.2015;2015;10;02;Lauantai;0;0;0
95;31.10.2015;2015;10;03;Lauantai;0;0;0
95;31.10.2015;2015;10;04;Lauantai;0;0;0
95;31.10.2015;2015;10;05;Lauantai;0;1;1
95;31.10.2015;2015;10;06;Lauantai;1;0;1
95;31.10.2015;2015;10;07;Lauantai;1;3;4
95;31.10.2015;2015;10;08;Lauantai;1;1;2
95;31.10.2015;2015;10;09;Lauantai;4;3;7
95;31.10.2015;2015;10;10;Lauantai;1;7;8
95;31.10.2015;2015;10;11;Lauantai;9;4;13
95;31.10.2015;2015;10;12;Lauantai;2;4;6
95;31.10.2015;2015;10;13;Lauantai;5;5;10
95;31.10.2015;2015;10;14;Lauantai;8;6;14
95;31.10.2015;2015;10;15;Lauantai;4;2;6
95;31.10.2015;2015;10;16;Lauantai;7;4;11
95;31.10.2015;2015;10;17;Lauantai;8;3;11
95;31.10.2015;2015;10;18;Lauantai;4;4;8
95;31.10.2015;2015;10;19;Lauantai;3;1;4
95;31.10.2015;2015;10;20;Lauantai;0;4;4
95;31.10.2015;2015;10;21;Lauantai;2;2;4
95;31.10.2015;2015;10;22;Lauantai;0;1;1
95;31.10.2015;2015;10;23;Lauantai;1;2;3
95;01.11.2015;2015;11;00;Sunnuntai;0;0;0
95;01.11.2015;2015;11;01;Sunnuntai;0;0;0
95;01.11.2015;2015;11;02;Sunnuntai;0;0;0
95;01.11.2015;2015;11;03;Sunnuntai;0;0;0
95;01.11.2015;2015;11;04;Sunnuntai;0;0;0
95;01.11.2015;2015;11;05;Sunnuntai;0;0;0
95;01.11.2015;2015;11;06;Sunnuntai;1;0;1
95;01.11.2015;2015;11;07;Sunnuntai;1;3;4
95;01.11.2015;2015;11;08;Sunnuntai;2;1;3
95;01.11.2015;2015;11;09;Sunnuntai;1;0;1
95;01.11.2015;2015;11;10;Sunnuntai;4;3;7
95;01.11.2015;2015;11;11;Sunnuntai;7;7;14
95;01.11.2015;2015;11;12;Sunnuntai;10;9;19
95;01.11.2015;2015;11;13;Sunnuntai;16;10;26
95;01.11.2015;2015;11;14;Sunnuntai;5;15;20
95;01.11.2015;2015;11;15;Sunnuntai;6;8;14
95;01.11.2015;2015;11;16;Sunnuntai;5;2;7
95;01.11.2015;2015;11;17;Sunnuntai;5;4;9
95;01.11.2015;2015;11;18;Sunnuntai;9;7;16
95;01.11.2015;2015;11;19;Sunnuntai;3;4;7
95;01.11.2015;2015;11;20;Sunnuntai;1;1;2
95;01.11.2015;2015;11;21;Sunnuntai;1;2;3
95;01.11.2015;2015;11;22;Sunnuntai;0;4;4
95;01.11.2015;2015;11;23;Sunnuntai;0;1;1
95;02.11.2015;2015;11;00;Maanantai;0;0;0
95;02.11.2015;2015;11;01;Maanantai;0;0;0
95;02.11.2015;2015;11;02;Maanantai;0;0;0
95;02.11.2015;2015;11;03;Maanantai;0;0;0
95;02.11.2015;2015;11;04;Maanantai;0;0;0
95;02.11.2015;2015;11;05;Maanantai;6;3;9
95;02.11.2015;2015;11;06;Maanantai;11;7;18
95;02.11.2015;2015;11;07;Maanantai;14;8;22
95;02.11.2015;2015;11;08;Maanantai;3;12;15
95;02.11.2015;2015;11;09;Maanantai;6;5;11
95;02.11.2015;2015;11;10;Maanantai;6;5;11
95;02.11.2015;2015;11;11;Maanantai;10;9;19
95;02.11.2015;2015;11;12;Maanantai;9;5;14
95;02.11.2015;2015;11;13;Maanantai;7;6;13
95;02.11.2015;2015;11;14;Maanantai;5;5;10
95;02.11.2015;2015;11;15;Maanantai;15;14;29
95;02.11.2015;2015;11;16;Maanantai;19;21;40
95;02.11.2015;2015;11;17;Maanantai;7;8;15
95;02.11.2015;2015;11;18;Maanantai;3;6;9
95;02.11.2015;2015;11;19;Maanantai;3;4;7
95;02.11.2015;2015;11;20;Maanantai;2;3;5
95;02.11.2015;2015;11;21;Maanantai;5;3;8
95;02.11.2015;2015;11;22;Maanantai;1;4;5
95;02.11.2015;2015;11;23;Maanantai;0;1;1
95;03.11.2015;2015;11;00;Tiistai;0;0;0
95;03.11.2015;2015;11;01;Tiistai;0;0;0
95;03.11.2015;2015;11;02;Tiistai;0;1;1
95;03.11.2015;2015;11;03;Tiistai;0;0;0
95;03.11.2015;2015;11;04;Tiistai;2;0;2
95;03.11.2015;2015;11;05;Tiistai;8;2;10
95;03.11.2015;2015;11;06;Tiistai;15;14;29
95;03.11.2015;2015;11;07;Tiistai;13;19;32
95;03.11.2015;2015;11;08;Tiistai;4;15;19
95;03.11.2015;2015;11;09;Tiistai;12;7;19
95;03.11.2015;2015;11;10;Tiistai;9;7;16
95;03.11.2015;2015;11;11;Tiistai;4;13;17
95;03.11.2015;2015;11;12;Tiistai;6;12;18
95;03.11.2015;2015;11;13;Tiistai;15;8;23
95;03.11.2015;2015;11;14;Tiistai;12;8;20
95;03.11.2015;2015;11;15;Tiistai;24;15;39
95;03.11.2015;2015;11;16;Tiistai;24;19;43
95;03.11.2015;2015;11;17;Tiistai;8;10;18
95;03.11.2015;2015;11;18;Tiistai;5;8;13
95;03.11.2015;2015;11;19;Tiistai;3;6;9
95;03.11.2015;2015;11;20;Tiistai;2;6;8
95;03.11.2015;2015;11;21;Tiistai;3;2;5
95;03.11.2015;2015;11;22;Tiistai;1;3;4
95;03.11.2015;2015;11;23;Tiistai;2;2;4
95;04.11.2015;2015;11;00;Keskiviikko;0;0;0
95;04.11.2015;2015;11;01;Keskiviikko;0;0;0
95;04.11.2015;2015;11;02;Keskiviikko;0;0;0
95;04.11.2015;2015;11;03;Keskiviikko;0;0;0
95;04.11.2015;2015;11;04;Keskiviikko;1;2;3
95;04.11.2015;2015;11;05;Keskiviikko;4;2;6
95;04.11.2015;2015;11;06;Keskiviikko;19;9;28
95;04.11.2015;2015;11;07;Keskiviikko;17;18;35
95;04.11.2015;2015;11;08;Keskiviikko;8;17;25
95;04.11.2015;2015;11;09;Keskiviikko;8;5;13
95;04.11.2015;2015;11;10;Keskiviikko;4;8;12
95;04.11.2015;2015;11;11;Keskiviikko;12;6;18
95;04.11.2015;2015;11;12;Keskiviikko;11;7;18
95;04.11.2015;2015;11;13;Keskiviikko;6;11;17
95;04.11.2015;2015;11;14;Keskiviikko;14;10;24
95;04.11.2015;2015;11;15;Keskiviikko;13;25;38
95;04.11.2015;2015;11;16;Keskiviikko;23;25;48
95;04.11.2015;2015;11;17;Keskiviikko;7;9;16
95;04.11.2015;2015;11;18;Keskiviikko;5;6;11
95;04.11.2015;2015;11;19;Keskiviikko;3;9;12
95;04.11.2015;2015;11;20;Keskiviikko;2;2;4
95;04.11.2015;2015;11;21;Keskiviikko;1;3;4
95;04.11.2015;2015;11;22;Keskiviikko;1;3;4
95;04.11.2015;2015;11;23;Keskiviikko;1;1;2
95;05.11.2015;2015;11;00;Torstai;1;0;1
95;05.11.2015;2015;11;01;Torstai;0;0;0
95;05.11.2015;2015;11;02;Torstai;0;0;0
95;05.11.2015;2015;11;03;Torstai;0;0;0
95;05.11.2015;2015;11;04;Torstai;2;1;3
95;05.11.2015;2015;11;05;Torstai;4;2;6
95;05.11.2015;2015;11;06;Torstai;16;7;23
95;05.11.2015;2015;11;07;Torstai;12;15;27
95;05.11.2015;2015;11;08;Torstai;8;6;14
95;05.11.2015;2015;11;09;Torstai;6;7;13
95;05.11.2015;2015;11;10;Torstai;4;7;11
95;05.11.2015;2015;11;11;Torstai;6;7;13
95;05.11.2015;2015;11;12;Torstai;8;1;9
95;05.11.2015;2015;11;13;Torstai;7;7;14
95;05.11.2015;2015;11;14;Torstai;8;9;17
95;05.11.2015;2015;11;15;Torstai;11;20;31
95;05.11.2015;2015;11;16;Torstai;22;15;37
95;05.11.2015;2015;11;17;Torstai;5;11;16
95;05.11.2015;2015;11;18;Torstai;1;7;8
95;05.11.2015;2015;11;19;Torstai;5;2;7
95;05.11.2015;2015;11;20;Torstai;3;1;4
95;05.11.2015;2015;11;21;Torstai;0;1;1
95;05.11.2015;2015;11;22;Torstai;2;2;4
95;05.11.2015;2015;11;23;Torstai;0;1;1
95;06.11.2015;2015;11;00;Perjantai;0;0;0
95;06.11.2015;2015;11;01;Perjantai;0;0;0
95;06.11.2015;2015;11;02;Perjantai;0;0;0
95;06.11.2015;2015;11;03;Perjantai;0;0;0
95;06.11.2015;2015;11;04;Perjantai;1;0;1
95;06.11.2015;2015;11;05;Perjantai;4;4;8
95;06.11.2015;2015;11;06;Perjantai;9;7;16
95;06.11.2015;2015;11;07;Perjantai;11;15;26
95;06.11.2015;2015;11;08;Perjantai;0;9;9
95;06.11.2015;2015;11;09;Perjantai;1;2;3
95;06.11.2015;2015;11;10;Perjantai;4;3;7
95;06.11.2015;2015;11;11;Perjantai;7;4;11
95;06.11.2015;2015;11;12;Perjantai;4;4;8
95;06.11.2015;2015;11;13;Perjantai;7;4;11
95;06.11.2015;2015;11;14;Perjantai;8;9;17
95;06.11.2015;2015;11;15;Perjantai;12;12;24
95;06.11.2015;2015;11;16;Perjantai;11;8;19
95;06.11.2015;2015;11;17;Perjantai;2;4;6
95;06.11.2015;2015;11;18;Perjantai;4;0;4
95;06.11.2015;2015;11;19;Perjantai;2;3;5
95;06.11.2015;2015;11;20;Perjantai;0;1;1
95;06.11.2015;2015;11;21;Perjantai;0;2;2
95;06.11.2015;2015;11;22;Perjantai;0;0;0
95;06.11.2015;2015;11;23;Perjantai;1;1;2
95;07.11.2015;2015;11;00;Lauantai;0;0;0
95;07.11.2015;2015;11;01;Lauantai;0;0;0
95;07.11.2015;2015;11;02;Lauantai;0;0;0
95;07.11.2015;2015;11;03;Lauantai;1;0;1
95;07.11.2015;2015;11;04;Lauantai;0;0;0
95;07.11.2015;2015;11;05;Lauantai;0;0;0
95;07.11.2015;2015;11;06;Lauantai;3;1;4
95;07.11.2015;2015;11;07;Lauantai;3;0;3
95;07.11.2015;2015;11;08;Lauantai;1;2;3
95;07.11.2015;2015;11;09;Lauantai;3;1;4
95;07.11.2015;2015;11;10;Lauantai;3;2;5
95;07.11.2015;2015;11;11;Lauantai;3;1;4
95;07.11.2015;2015;11;12;Lauantai;3;4;7
95;07.11.2015;2015;11;13;Lauantai;7;2;9
95;07.11.2015;2015;11;14;Lauantai;6;4;10
95;07.11.2015;2015;11;15;Lauantai;3;5;8
95;07.11.2015;2015;11;16;Lauantai;4;2;6
95;07.11.2015;2015;11;17;Lauantai;2;2;4
95;07.11.2015;2015;11;18;Lauantai;5;3;8
95;07.11.2015;2015;11;19;Lauantai;1;6;7
95;07.11.2015;2015;11;20;Lauantai;5;4;9
95;07.11.2015;2015;11;21;Lauantai;0;1;1
95;07.11.2015;2015;11;22;Lauantai;0;2;2
95;07.11.2015;2015;11;23;Lauantai;2;3;5
95;08.11.2015;2015;11;00;Sunnuntai;2;0;2
95;08.11.2015;2015;11;01;Sunnuntai;0;0;0
95;08.11.2015;2015;11;02;Sunnuntai;0;0;0
95;08.11.2015;2015;11;03;Sunnuntai;0;0;0
95;08.11.2015;2015;11;04;Sunnuntai;1;1;2
95;08.11.2015;2015;11;05;Sunnuntai;0;0;0
95;08.11.2015;2015;11;06;Sunnuntai;2;1;3
95;08.11.2015;2015;11;07;Sunnuntai;1;2;3
95;08.11.2015;2015;11;08;Sunnuntai;1;0;1
95;08.11.2015;2015;11;09;Sunnuntai;1;7;8
95;08.11.2015;2015;11;10;Sunnuntai;3;3;6
95;08.11.2015;2015;11;11;Sunnuntai;8;6;14
95;08.11.2015;2015;11;12;Sunnuntai;5;5;10
95;08.11.2015;2015;11;13;Sunnuntai;10;7;17
95;08.11.2015;2015;11;14;Sunnuntai;4;5;9
95;08.11.2015;2015;11;15;Sunnuntai;7;6;13
95;08.11.2015;2015;11;16;Sunnuntai;4;6;10
95;08.11.2015;2015;11;17;Sunnuntai;3;2;5
95;08.11.2015;2015;11;18;Sunnuntai;3;2;5
95;08.11.2015;2015;11;19;Sunnuntai;3;1;4
95;08.11.2015;2015;11;20;Sunnuntai;0;3;3
95;08.11.2015;2015;11;21;Sunnuntai;0;2;2
95;08.11.2015;2015;11;22;Sunnuntai;2;0;2
95;08.11.2015;2015;11;23;Sunnuntai;0;0;0
95;09.11.2015;2015;11;00;Maanantai;0;0;0
95;09.11.2015;2015;11;01;Maanantai;0;0;0
95;09.11.2015;2015;11;02;Maanantai;0;0;0
95;09.11.2015;2015;11;03;Maanantai;0;0;0
95;09.11.2015;2015;11;04;Maanantai;2;1;3
95;09.11.2015;2015;11;05;Maanantai;2;1;3
95;09.11.2015;2015;11;06;Maanantai;8;7;15
95;09.11.2015;2015;11;07;Maanantai;16;9;25
95;09.11.2015;2015;11;08;Maanantai;4;12;16
95;09.11.2015;2015;11;09;Maanantai;7;6;13
95;09.11.2015;2015;11;10;Maanantai;10;10;20
95;09.11.2015;2015;11;11;Maanantai;3;7;10
95;09.11.2015;2015;11;12;Maanantai;11;5;16
95;09.11.2015;2015;11;13;Maanantai;9;7;16
95;09.11.2015;2015;11;14;Maanantai;9;10;19
95;09.11.2015;2015;11;15;Maanantai;14;11;25
95;09.11.2015;2015;11;16;Maanantai;19;8;27
95;09.11.2015;2015;11;17;Maanantai;6;7;13
95;09.11.2015;2015;11;18;Maanantai;4;7;11
95;09.11.2015;2015;11;19;Maanantai;1;6;7
95;09.11.2015;2015;11;20;Maanantai;3;2;5
95;09.11.2015;2015;11;21;Maanantai;0;3;3
95;09.11.2015;2015;11;22;Maanantai;2;2;4
95;09.11.2015;2015;11;23;Maanantai;0;2;2
95;10.11.2015;2015;11;00;Tiistai;0;0;0
95;10.11.2015;2015;11;01;Tiistai;0;0;0
95;10.11.2015;2015;11;02;Tiistai;0;0;0
95;10.11.2015;2015;11;03;Tiistai;0;0;0
95;10.11.2015;2015;11;04;Tiistai;0;0;0
95;10.11.2015;2015;11;05;Tiistai;6;2;8
95;10.11.2015;2015;11;06;Tiistai;8;7;15
95;10.11.2015;2015;11;07;Tiistai;10;11;21
95;10.11.2015;2015;11;08;Tiistai;4;7;11
95;10.11.2015;2015;11;09;Tiistai;2;1;3
95;10.11.2015;2015;11;10;Tiistai;1;4;5
95;10.11.2015;2015;11;11;Tiistai;2;13;15
95;10.11.2015;2015;11;12;Tiistai;5;2;7
95;10.11.2015;2015;11;13;Tiistai;2;1;3
95;10.11.2015;2015;11;14;Tiistai;7;2;9
95;10.11.2015;2015;11;15;Tiistai;11;9;20
95;10.11.2015;2015;11;16;Tiistai;7;8;15
95;10.11.2015;2015;11;17;Tiistai;2;5;7
95;10.11.2015;2015;11;18;Tiistai;5;5;10
95;10.11.2015;2015;11;19;Tiistai;4;1;5
95;10.11.2015;2015;11;20;Tiistai;2;1;3
95;10.11.2015;2015;11;21;Tiistai;1;0;1
95;10.11.2015;2015;11;22;Tiistai;1;1;2
95;10.11.2015;2015;11;23;Tiistai;0;0;0
95;11.11.2015;2015;11;00;Keskiviikko;0;0;0
95;11.11.2015;2015;11;01;Keskiviikko;0;0;0
95;11.11.2015;2015;11;02;Keskiviikko;0;1;1
95;11.11.2015;2015;11;03;Keskiviikko;1;0;1
95;11.11.2015;2015;11;04;Keskiviikko;1;2;3
95;11.11.2015;2015;11;05;Keskiviikko;5;2;7
95;11.11.2015;2015;11;06;Keskiviikko;9;9;18
95;11.11.2015;2015;11;07;Keskiviikko;10;13;23
95;11.11.2015;2015;11;08;Keskiviikko;8;8;16
95;11.11.2015;2015;11;09;Keskiviikko;2;3;5
95;11.11.2015;2015;11;10;Keskiviikko;9;6;15
95;11.11.2015;2015;11;11;Keskiviikko;7;7;14
95;11.11.2015;2015;11;12;Keskiviikko;6;2;8
95;11.11.2015;2015;11;13;Keskiviikko;15;5;20
95;11.11.2015;2015;11;14;Keskiviikko;10;8;18
95;11.11.2015;2015;11;15;Keskiviikko;13;11;24
95;11.11.2015;2015;11;16;Keskiviikko;15;12;27
95;11.11.2015;2015;11;17;Keskiviikko;3;8;11
95;11.11.2015;2015;11;18;Keskiviikko;7;4;11
95;11.11.2015;2015;11;19;Keskiviikko;1;4;5
95;11.11.2015;2015;11;20;Keskiviikko;2;5;7
95;11.11.2015;2015;11;21;Keskiviikko;3;2;5
95;11.11.2015;2015;11;22;Keskiviikko;1;2;3
95;11.11.2015;2015;11;23;Keskiviikko;0;2;2
95;12.11.2015;2015;11;00;Torstai;1;0;1
95;12.11.2015;2015;11;01;Torstai;0;0;0
95;12.11.2015;2015;11;02;Torstai;0;0;0
95;12.11.2015;2015;11;03;Torstai;0;0;0
95;12.11.2015;2015;11;04;Torstai;3;1;4
95;12.11.2015;2015;11;05;Torstai;4;3;7
95;12.11.2015;2015;11;06;Torstai;10;10;20
95;12.11.2015;2015;11;07;Torstai;14;9;23
95;12.11.2015;2015;11;08;Torstai;4;8;12
95;12.11.2015;2015;11;09;Torstai;2;3;5
95;12.11.2015;2015;11;10;Torstai;3;3;6
95;12.11.2015;2015;11;11;Torstai;6;1;7
95;12.11.2015;2015;11;12;Torstai;5;3;8
95;12.11.2015;2015;11;13;Torstai;8;11;19
95;12.11.2015;2015;11;14;Torstai;6;6;12
95;12.11.2015;2015;11;15;Torstai;17;10;27
95;12.11.2015;2015;11;16;Torstai;12;16;28
95;12.11.2015;2015;11;17;Torstai;1;5;6
95;12.11.2015;2015;11;18;Torstai;2;8;10
95;12.11.2015;2015;11;19;Torstai;1;1;2
95;12.11.2015;2015;11;20;Torstai;2;3;5
95;12.11.2015;2015;11;21;Torstai;1;1;2
95;12.11.2015;2015;11;22;Torstai;1;2;3
95;12.11.2015;2015;11;23;Torstai;1;1;2
95;13.11.2015;2015;11;00;Perjantai;0;1;1
95;13.11.2015;2015;11;01;Perjantai;0;0;0
95;13.11.2015;2015;11;02;Perjantai;0;0;0
95;13.11.2015;2015;11;03;Perjantai;0;0;0
95;13.11.2015;2015;11;04;Perjantai;2;1;3
95;13.11.2015;2015;11;05;Perjantai;3;3;6
95;13.11.2015;2015;11;06;Perjantai;7;7;14
95;13.11.2015;2015;11;07;Perjantai;8;15;23
95;13.11.2015;2015;11;08;Perjantai;3;5;8
95;13.11.2015;2015;11;09;Perjantai;6;4;10
95;13.11.2015;2015;11;10;Perjantai;5;5;10
95;13.11.2015;2015;11;11;Perjantai;3;3;6
95;13.11.2015;2015;11;12;Perjantai;7;3;10
95;13.11.2015;2015;11;13;Perjantai;9;6;15
95;13.11.2015;2015;11;14;Perjantai;14;10;24
95;13.11.2015;2015;11;15;Perjantai;10;5;15
95;13.11.2015;2015;11;16;Perjantai;6;7;13
95;13.11.2015;2015;11;17;Perjantai;2;4;6
95;13.11.2015;2015;11;18;Perjantai;3;3;6
95;13.11.2015;2015;11;19;Perjantai;2;4;6
95;13.11.2015;2015;11;20;Perjantai;1;2;3
95;13.11.2015;2015;11;21;Perjantai;1;1;2
95;13.11.2015;2015;11;22;Perjantai;1;2;3
95;13.11.2015;2015;11;23;Perjantai;0;3;3
95;14.11.2015;2015;11;00;Lauantai;0;2;2
95;14.11.2015;2015;11;01;Lauantai;0;0;0
95;14.11.2015;2015;11;02;Lauantai;0;0;0
95;14.11.2015;2015;11;03;Lauantai;0;1;1
95;14.11.2015;2015;11;04;Lauantai;0;0;0
95;14.11.2015;2015;11;05;Lauantai;0;1;1
95;14.11.2015;2015;11;06;Lauantai;0;0;0
95;14.11.2015;2015;11;07;Lauantai;0;0;0
95;14.11.2015;2015;11;08;Lauantai;0;2;2
95;14.11.2015;2015;11;09;Lauantai;1;1;2
95;14.11.2015;2015;11;10;Lauantai;2;2;4
95;14.11.2015;2015;11;11;Lauantai;1;2;3
95;14.11.2015;2015;11;12;Lauantai;4;2;6
95;14.11.2015;2015;11;13;Lauantai;5;3;8
95;14.11.2015;2015;11;14;Lauantai;3;3;6
95;14.11.2015;2015;11;15;Lauantai;2;3;5
95;14.11.2015;2015;11;16;Lauantai;2;4;6
95;14.11.2015;2015;11;17;Lauantai;1;2;3
95;14.11.2015;2015;11;18;Lauantai;2;1;3
95;14.11.2015;2015;11;19;Lauantai;2;0;2
95;14.11.2015;2015;11;20;Lauantai;2;0;2
95;14.11.2015;2015;11;21;Lauantai;2;0;2
95;14.11.2015;2015;11;22;Lauantai;1;2;3
95;14.11.2015;2015;11;23;Lauantai;0;0;0
95;15.11.2015;2015;11;00;Sunnuntai;0;0;0
95;15.11.2015;2015;11;01;Sunnuntai;0;1;1
95;15.11.2015;2015;11;02;Sunnuntai;0;0;0
95;15.11.2015;2015;11;03;Sunnuntai;0;0;0
95;15.11.2015;2015;11;04;Sunnuntai;0;0;0
95;15.11.2015;2015;11;05;Sunnuntai;0;0;0
95;15.11.2015;2015;11;06;Sunnuntai;2;0;2
95;15.11.2015;2015;11;07;Sunnuntai;0;1;1
95;15.11.2015;2015;11;08;Sunnuntai;1;1;2
95;15.11.2015;2015;11;09;Sunnuntai;2;4;6
95;15.11.2015;2015;11;10;Sunnuntai;3;4;7
95;15.11.2015;2015;11;11;Sunnuntai;7;5;12
95;15.11.2015;2015;11;12;Sunnuntai;5;7;12
95;15.11.2015;2015;11;13;Sunnuntai;5;6;11
95;15.11.2015;2015;11;14;Sunnuntai;3;3;6
95;15.11.2015;2015;11;15;Sunnuntai;4;1;5
95;15.11.2015;2015;11;16;Sunnuntai;5;3;8
95;15.11.2015;2015;11;17;Sunnuntai;6;1;7
95;15.11.2015;2015;11;18;Sunnuntai;6;1;7
95;15.11.2015;2015;11;19;Sunnuntai;2;3;5
95;15.11.2015;2015;11;20;Sunnuntai;2;2;4
95;15.11.2015;2015;11;21;Sunnuntai;1;1;2
95;15.11.2015;2015;11;22;Sunnuntai;0;1;1
95;15.11.2015;2015;11;23;Sunnuntai;2;0;2
95;16.11.2015;2015;11;00;Maanantai;0;2;2
95;16.11.2015;2015;11;01;Maanantai;0;0;0
95;16.11.2015;2015;11;02;Maanantai;0;0;0
95;16.11.2015;2015;11;03;Maanantai;0;0;0
95;16.11.2015;2015;11;04;Maanantai;3;0;3
95;16.11.2015;2015;11;05;Maanantai;5;3;8
95;16.11.2015;2015;11;06;Maanantai;12;8;20
95;16.11.2015;2015;11;07;Maanantai;14;10;24
95;16.11.2015;2015;11;08;Maanantai;3;8;11
95;16.11.2015;2015;11;09;Maanantai;2;7;9
95;16.11.2015;2015;11;10;Maanantai;5;3;8
95;16.11.2015;2015;11;11;Maanantai;4;3;7
95;16.11.2015;2015;11;12;Maanantai;5;6;11
95;16.11.2015;2015;11;13;Maanantai;7;8;15
95;16.11.2015;2015;11;14;Maanantai;13;8;21
95;16.11.2015;2015;11;15;Maanantai;10;12;22
95;16.11.2015;2015;11;16;Maanantai;15;18;33
95;16.11.2015;2015;11;17;Maanantai;8;9;17
95;16.11.2015;2015;11;18;Maanantai;6;5;11
95;16.11.2015;2015;11;19;Maanantai;1;8;9
95;16.11.2015;2015;11;20;Maanantai;3;2;5
95;16.11.2015;2015;11;21;Maanantai;2;3;5
95;16.11.2015;2015;11;22;Maanantai;1;0;1
95;16.11.2015;2015;11;23;Maanantai;1;3;4
95;17.11.2015;2015;11;00;Tiistai;0;0;0
95;17.11.2015;2015;11;01;Tiistai;0;0;0
95;17.11.2015;2015;11;02;Tiistai;0;0;0
95;17.11.2015;2015;11;03;Tiistai;0;0;0
95;17.11.2015;2015;11;04;Tiistai;1;0;1
95;17.11.2015;2015;11;05;Tiistai;5;3;8
95;17.11.2015;2015;11;06;Tiistai;10;8;18
95;17.11.2015;2015;11;07;Tiistai;10;13;23
95;17.11.2015;2015;11;08;Tiistai;8;8;16
95;17.11.2015;2015;11;09;Tiistai;4;2;6
95;17.11.2015;2015;11;10;Tiistai;4;4;8
95;17.11.2015;2015;11;11;Tiistai;3;3;6
95;17.11.2015;2015;11;12;Tiistai;3;9;12
95;17.11.2015;2015;11;13;Tiistai;9;3;12
95;17.11.2015;2015;11;14;Tiistai;9;6;15
95;17.11.2015;2015;11;15;Tiistai;11;10;21
95;17.11.2015;2015;11;16;Tiistai;10;6;16
95;17.11.2015;2015;11;17;Tiistai;2;6;8
95;17.11.2015;2015;11;18;Tiistai;2;5;7
95;17.11.2015;2015;11;19;Tiistai;1;4;5
95;17.11.2015;2015;11;20;Tiistai;1;4;5
95;17.11.2015;2015;11;21;Tiistai;2;1;3
95;17.11.2015;2015;11;22;Tiistai;2;2;4
95;17.11.2015;2015;11;23;Tiistai;0;2;2
95;18.11.2015;2015;11;00;Keskiviikko;1;0;1
95;18.11.2015;2015;11;01;Keskiviikko;1;0;1
95;18.11.2015;2015;11;02;Keskiviikko;0;0;0
95;18.11.2015;2015;11;03;Keskiviikko;0;1;1
95;18.11.2015;2015;11;04;Keskiviikko;3;2;5
95;18.11.2015;2015;11;05;Keskiviikko;4;3;7
95;18.11.2015;2015;11;06;Keskiviikko;12;11;23
95;18.11.2015;2015;11;07;Keskiviikko;13;13;26
95;18.11.2015;2015;11;08;Keskiviikko;6;9;15
95;18.11.2015;2015;11;09;Keskiviikko;4;3;7
95;18.11.2015;2015;11;10;Keskiviikko;10;1;11
95;18.11.2015;2015;11;11;Keskiviikko;5;4;9
95;18.11.2015;2015;11;12;Keskiviikko;6;5;11
95;18.11.2015;2015;11;13;Keskiviikko;11;8;19
95;18.11.2015;2015;11;14;Keskiviikko;9;7;16
95;18.11.2015;2015;11;15;Keskiviikko;9;7;16
95;18.11.2015;2015;11;16;Keskiviikko;8;15;23
95;18.11.2015;2015;11;17;Keskiviikko;5;16;21
95;18.11.2015;2015;11;18;Keskiviikko;4;4;8
95;18.11.2015;2015;11;19;Keskiviikko;2;4;6
95;18.11.2015;2015;11;20;Keskiviikko;3;3;6
95;18.11.2015;2015;11;21;Keskiviikko;1;0;1
95;18.11.2015;2015;11;22;Keskiviikko;1;0;1
95;18.11.2015;2015;11;23;Keskiviikko;0;1;1
95;19.11.2015;2015;11;00;Torstai;0;0;0
95;19.11.2015;2015;11;01;Torstai;1;0;1
95;19.11.2015;2015;11;02;Torstai;0;0;0
95;19.11.2015;2015;11;03;Torstai;0;0;0
95;19.11.2015;2015;11;04;Torstai;2;0;2
95;19.11.2015;2015;11;05;Torstai;6;4;10
95;19.11.2015;2015;11;06;Torstai;8;7;15
95;19.11.2015;2015;11;07;Torstai;16;12;28
95;19.11.2015;2015;11;08;Torstai;4;10;14
95;19.11.2015;2015;11;09;Torstai;5;5;10
95;19.11.2015;2015;11;10;Torstai;2;3;5
95;19.11.2015;2015;11;11;Torstai;12;4;16
95;19.11.2015;2015;11;12;Torstai;3;7;10
95;19.11.2015;2015;11;13;Torstai;13;7;20
95;19.11.2015;2015;11;14;Torstai;9;11;20
95;19.11.2015;2015;11;15;Torstai;14;16;30
95;19.11.2015;2015;11;16;Torstai;20;15;35
95;19.11.2015;2015;11;17;Torstai;3;15;18
95;19.11.2015;2015;11;18;Torstai;2;4;6
95;19.11.2015;2015;11;19;Torstai;4;7;11
95;19.11.2015;2015;11;20;Torstai;4;1;5
95;19.11.2015;2015;11;21;Torstai;5;3;8
95;19.11.2015;2015;11;22;Torstai;2;4;6
95;19.11.2015;2015;11;23;Torstai;0;1;1
95;20.11.2015;2015;11;00;Perjantai;0;0;0
95;20.11.2015;2015;11;01;Perjantai;1;0;1
95;20.11.2015;2015;11;02;Perjantai;0;0;0
95;20.11.2015;2015;11;03;Perjantai;0;0;0
95;20.11.2015;2015;11;04;Perjantai;1;0;1
95;20.11.2015;2015;11;05;Perjantai;4;3;7
95;20.11.2015;2015;11;06;Perjantai;9;8;17
95;20.11.2015;2015;11;07;Perjantai;8;9;17
95;20.11.2015;2015;11;08;Perjantai;3;5;8
95;20.11.2015;2015;11;09;Perjantai;3;6;9
95;20.11.2015;2015;11;10;Perjantai;5;2;7
95;20.11.2015;2015;11;11;Perjantai;0;3;3
95;20.11.2015;2015;11;12;Perjantai;8;3;11
95;20.11.2015;2015;11;13;Perjantai;6;6;12
95;20.11.2015;2015;11;14;Perjantai;13;6;19
95;20.11.2015;2015;11;15;Perjantai;8;6;14
95;20.11.2015;2015;11;16;Perjantai;12;13;25
95;20.11.2015;2015;11;17;Perjantai;3;7;10
95;20.11.2015;2015;11;18;Perjantai;2;4;6
95;20.11.2015;2015;11;19;Perjantai;2;1;3
95;20.11.2015;2015;11;20;Perjantai;2;3;5
95;20.11.2015;2015;11;21;Perjantai;1;0;1
95;20.11.2015;2015;11;22;Perjantai;0;1;1
95;20.11.2015;2015;11;23;Perjantai;0;2;2
95;21.11.2015;2015;11;00;Lauantai;0;0;0
95;21.11.2015;2015;11;01;Lauantai;0;0;0
95;21.11.2015;2015;11;02;Lauantai;0;0;0
95;21.11.2015;2015;11;03;Lauantai;0;1;1
95;21.11.2015;2015;11;04;Lauantai;0;0;0
95;21.11.2015;2015;11;05;Lauantai;0;0;0
95;21.11.2015;2015;11;06;Lauantai;0;1;1
95;21.11.2015;2015;11;07;Lauantai;0;2;2
95;21.11.2015;2015;11;08;Lauantai;2;1;3
95;21.11.2015;2015;11;09;Lauantai;1;3;4
95;21.11.2015;2015;11;10;Lauantai;1;1;2
95;21.11.2015;2015;11;11;Lauantai;4;1;5
95;21.11.2015;2015;11;12;Lauantai;4;2;6
95;21.11.2015;2015;11;13;Lauantai;0;1;1
95;21.11.2015;2015;11;14;Lauantai;5;2;7
95;21.11.2015;2015;11;15;Lauantai;5;3;8
95;21.11.2015;2015;11;16;Lauantai;1;3;4
95;21.11.2015;2015;11;17;Lauantai;1;0;1
95;21.11.2015;2015;11;18;Lauantai;3;3;6
95;21.11.2015;2015;11;19;Lauantai;2;1;3
95;21.11.2015;2015;11;20;Lauantai;0;0;0
95;21.11.2015;2015;11;21;Lauantai;1;1;2
95;21.11.2015;2015;11;22;Lauantai;3;4;7
95;21.11.2015;2015;11;23;Lauantai;3;3;6
95;22.11.2015;2015;11;00;Sunnuntai;0;1;1
95;22.11.2015;2015;11;01;Sunnuntai;2;0;2
95;22.11.2015;2015;11;02;Sunnuntai;0;0;0
95;22.11.2015;2015;11;03;Sunnuntai;0;0;0
95;22.11.2015;2015;11;04;Sunnuntai;2;0;2
95;22.11.2015;2015;11;05;Sunnuntai;0;0;0
95;22.11.2015;2015;11;06;Sunnuntai;1;0;1
95;22.11.2015;2015;11;07;Sunnuntai;0;1;1
95;22.11.2015;2015;11;08;Sunnuntai;0;1;1
95;22.11.2015;2015;11;09;Sunnuntai;0;0;0
95;22.11.2015;2015;11;10;Sunnuntai;4;2;6
95;22.11.2015;2015;11;11;Sunnuntai;5;1;6
95;22.11.2015;2015;11;12;Sunnuntai;3;7;10
95;22.11.2015;2015;11;13;Sunnuntai;3;5;8
95;22.11.2015;2015;11;14;Sunnuntai;5;6;11
95;22.11.2015;2015;11;15;Sunnuntai;1;2;3
95;22.11.2015;2015;11;16;Sunnuntai;2;0;2
95;22.11.2015;2015;11;17;Sunnuntai;0;2;2
95;22.11.2015;2015;11;18;Sunnuntai;1;1;2
95;22.11.2015;2015;11;19;Sunnuntai;0;0;0
95;22.11.2015;2015;11;20;Sunnuntai;2;2;4
95;22.11.2015;2015;11;21;Sunnuntai;1;1;2
95;22.11.2015;2015;11;22;Sunnuntai;0;3;3
95;22.11.2015;2015;11;23;Sunnuntai;0;0;0
95;23.11.2015;2015;11;00;Maanantai;0;0;0
95;23.11.2015;2015;11;01;Maanantai;0;0;0
95;23.11.2015;2015;11;02;Maanantai;0;0;0
95;23.11.2015;2015;11;03;Maanantai;0;0;0
95;23.11.2015;2015;11;04;Maanantai;2;1;3
95;23.11.2015;2015;11;05;Maanantai;10;3;13
95;23.11.2015;2015;11;06;Maanantai;7;6;13
95;23.11.2015;2015;11;07;Maanantai;6;7;13
95;23.11.2015;2015;11;08;Maanantai;8;9;17
95;23.11.2015;2015;11;09;Maanantai;5;9;14
95;23.11.2015;2015;11;10;Maanantai;4;3;7
95;23.11.2015;2015;11;11;Maanantai;3;2;5
95;23.11.2015;2015;11;12;Maanantai;7;4;11
95;23.11.2015;2015;11;13;Maanantai;8;9;17
95;23.11.2015;2015;11;14;Maanantai;8;10;18
95;23.11.2015;2015;11;15;Maanantai;17;14;31
95;23.11.2015;2015;11;16;Maanantai;17;15;32
95;23.11.2015;2015;11;17;Maanantai;4;4;8
95;23.11.2015;2015;11;18;Maanantai;4;0;4
95;23.11.2015;2015;11;19;Maanantai;0;4;4
95;23.11.2015;2015;11;20;Maanantai;4;4;8
95;23.11.2015;2015;11;21;Maanantai;2;0;2
95;23.11.2015;2015;11;22;Maanantai;1;6;7
95;23.11.2015;2015;11;23;Maanantai;0;2;2
95;24.11.2015;2015;11;00;Tiistai;0;0;0
95;24.11.2015;2015;11;01;Tiistai;0;0;0
95;24.11.2015;2015;11;02;Tiistai;0;0;0
95;24.11.2015;2015;11;03;Tiistai;0;0;0
95;24.11.2015;2015;11;04;Tiistai;1;1;2
95;24.11.2015;2015;11;05;Tiistai;8;2;10
95;24.11.2015;2015;11;06;Tiistai;13;12;25
95;24.11.2015;2015;11;07;Tiistai;12;19;31
95;24.11.2015;2015;11;08;Tiistai;2;10;12
95;24.11.2015;2015;11;09;Tiistai;2;3;5
95;24.11.2015;2015;11;10;Tiistai;6;3;9
95;24.11.2015;2015;11;11;Tiistai;9;2;11
95;24.11.2015;2015;11;12;Tiistai;6;6;12
95;24.11.2015;2015;11;13;Tiistai;12;2;14
95;24.11.2015;2015;11;14;Tiistai;21;9;30
95;24.11.2015;2015;11;15;Tiistai;12;9;21
95;24.11.2015;2015;11;16;Tiistai;15;6;21
95;24.11.2015;2015;11;17;Tiistai;1;6;7
95;24.11.2015;2015;11;18;Tiistai;1;2;3
95;24.11.2015;2015;11;19;Tiistai;3;4;7
95;24.11.2015;2015;11;20;Tiistai;0;3;3
95;24.11.2015;2015;11;21;Tiistai;0;0;0
95;24.11.2015;2015;11;22;Tiistai;1;1;2
95;24.11.2015;2015;11;23;Tiistai;0;0;0
95;25.11.2015;2015;11;00;Keskiviikko;0;1;1
95;25.11.2015;2015;11;01;Keskiviikko;0;0;0
95;25.11.2015;2015;11;02;Keskiviikko;0;0;0
95;25.11.2015;2015;11;03;Keskiviikko;1;0;1
95;25.11.2015;2015;11;04;Keskiviikko;0;1;1
95;25.11.2015;2015;11;05;Keskiviikko;7;2;9
95;25.11.2015;2015;11;06;Keskiviikko;6;8;14
95;25.11.2015;2015;11;07;Keskiviikko;7;13;20
95;25.11.2015;2015;11;08;Keskiviikko;3;7;10
95;25.11.2015;2015;11;09;Keskiviikko;1;1;2
95;25.11.2015;2015;11;10;Keskiviikko;4;2;6
95;25.11.2015;2015;11;11;Keskiviikko;4;0;4
95;25.11.2015;2015;11;12;Keskiviikko;4;0;4
95;25.11.2015;2015;11;13;Keskiviikko;8;5;13
95;25.11.2015;2015;11;14;Keskiviikko;12;5;17
95;25.11.2015;2015;11;15;Keskiviikko;12;5;17
95;25.11.2015;2015;11;16;Keskiviikko;9;15;24
95;25.11.2015;2015;11;17;Keskiviikko;5;8;13
95;25.11.2015;2015;11;18;Keskiviikko;3;1;4
95;25.11.2015;2015;11;19;Keskiviikko;0;4;4
95;25.11.2015;2015;11;20;Keskiviikko;2;3;5
95;25.11.2015;2015;11;21;Keskiviikko;0;2;2
95;25.11.2015;2015;11;22;Keskiviikko;2;0;2
95;25.11.2015;2015;11;23;Keskiviikko;2;0;2
95;26.11.2015;2015;11;00;Torstai;0;2;2
95;26.11.2015;2015;11;01;Torstai;0;0;0
95;26.11.2015;2015;11;02;Torstai;0;0;0
95;26.11.2015;2015;11;03;Torstai;0;0;0
95;26.11.2015;2015;11;04;Torstai;0;0;0
95;26.11.2015;2015;11;05;Torstai;4;2;6
95;26.11.2015;2015;11;06;Torstai;18;6;24
95;26.11.2015;2015;11;07;Torstai;10;14;24
95;26.11.2015;2015;11;08;Torstai;8;8;16
95;26.11.2015;2015;11;09;Torstai;6;4;10
95;26.11.2015;2015;11;10;Torstai;7;4;11
95;26.11.2015;2015;11;11;Torstai;5;2;7
95;26.11.2015;2015;11;12;Torstai;5;2;7
95;26.11.2015;2015;11;13;Torstai;6;6;12
95;26.11.2015;2015;11;14;Torstai;2;4;6
95;26.11.2015;2015;11;15;Torstai;11;16;27
95;26.11.2015;2015;11;16;Torstai;9;12;21
95;26.11.2015;2015;11;17;Torstai;3;8;11
95;26.11.2015;2015;11;18;Torstai;3;5;8
95;26.11.2015;2015;11;19;Torstai;2;3;5
95;26.11.2015;2015;11;20;Torstai;2;3;5
95;26.11.2015;2015;11;21;Torstai;1;1;2
95;26.11.2015;2015;11;22;Torstai;1;1;2
95;26.11.2015;2015;11;23;Torstai;1;1;2
95;27.11.2015;2015;11;00;Perjantai;0;0;0
95;27.11.2015;2015;11;01;Perjantai;0;0;0
95;27.11.2015;2015;11;02;Perjantai;0;0;0
95;27.11.2015;2015;11;03;Perjantai;0;0;0
95;27.11.2015;2015;11;04;Perjantai;0;0;0
95;27.11.2015;2015;11;05;Perjantai;6;2;8
95;27.11.2015;2015;11;06;Perjantai;8;4;12
95;27.11.2015;2015;11;07;Perjantai;7;8;15
95;27.11.2015;2015;11;08;Perjantai;1;3;4
95;27.11.2015;2015;11;09;Perjantai;0;3;3
95;27.11.2015;2015;11;10;Perjantai;4;2;6
95;27.11.2015;2015;11;11;Perjantai;6;3;9
95;27.11.2015;2015;11;12;Perjantai;5;2;7
95;27.11.2015;2015;11;13;Perjantai;9;6;15
95;27.11.2015;2015;11;14;Perjantai;5;8;13
95;27.11.2015;2015;11;15;Perjantai;3;3;6
95;27.11.2015;2015;11;16;Perjantai;2;9;11
95;27.11.2015;2015;11;17;Perjantai;3;7;10
95;27.11.2015;2015;11;18;Perjantai;4;3;7
95;27.11.2015;2015;11;19;Perjantai;6;5;11
95;27.11.2015;2015;11;20;Perjantai;2;0;2
95;27.11.2015;2015;11;21;Perjantai;0;1;1
95;27.11.2015;2015;11;22;Perjantai;0;0;0
95;27.11.2015;2015;11;23;Perjantai;0;1;1
95;28.11.2015;2015;11;00;Lauantai;0;0;0
95;28.11.2015;2015;11;01;Lauantai;1;1;2
95;28.11.2015;2015;11;02;Lauantai;0;0;0
95;28.11.2015;2015;11;03;Lauantai;0;0;0
95;28.11.2015;2015;11;04;Lauantai;0;0;0
95;28.11.2015;2015;11;05;Lauantai;0;1;1
95;28.11.2015;2015;11;06;Lauantai;2;0;2
95;28.11.2015;2015;11;07;Lauantai;3;3;6
95;28.11.2015;2015;11;08;Lauantai;1;5;6
95;28.11.2015;2015;11;09;Lauantai;6;1;7
95;28.11.2015;2015;11;10;Lauantai;2;2;4
95;28.11.2015;2015;11;11;Lauantai;0;3;3
95;28.11.2015;2015;11;12;Lauantai;0;0;0
95;28.11.2015;2015;11;13;Lauantai;0;2;2
95;28.11.2015;2015;11;14;Lauantai;7;2;9
95;28.11.2015;2015;11;15;Lauantai;3;4;7
95;28.11.2015;2015;11;16;Lauantai;1;3;4
95;28.11.2015;2015;11;17;Lauantai;0;2;2
95;28.11.2015;2015;11;18;Lauantai;2;2;4
95;28.11.2015;2015;11;19;Lauantai;4;1;5
95;28.11.2015;2015;11;20;Lauantai;2;2;4
95;28.11.2015;2015;11;21;Lauantai;2;0;2
95;28.11.2015;2015;11;22;Lauantai;0;2;2
95;28.11.2015;2015;11;23;Lauantai;0;0;0
95;29.11.2015;2015;11;00;Sunnuntai;0;0;0
95;29.11.2015;2015;11;01;Sunnuntai;0;0;0
95;29.11.2015;2015;11;02;Sunnuntai;0;0;0
95;29.11.2015;2015;11;03;Sunnuntai;0;0;0
95;29.11.2015;2015;11;04;Sunnuntai;0;0;0
95;29.11.2015;2015;11;05;Sunnuntai;0;0;0
95;29.11.2015;2015;11;06;Sunnuntai;1;0;1
95;29.11.2015;2015;11;07;Sunnuntai;2;0;2
95;29.11.2015;2015;11;08;Sunnuntai;2;4;6
95;29.11.2015;2015;11;09;Sunnuntai;0;2;2
95;29.11.2015;2015;11;10;Sunnuntai;1;2;3
95;29.11.2015;2015;11;11;Sunnuntai;5;5;10
95;29.11.2015;2015;11;12;Sunnuntai;5;5;10
95;29.11.2015;2015;11;13;Sunnuntai;2;4;6
95;29.11.2015;2015;11;14;Sunnuntai;5;10;15
95;29.11.2015;2015;11;15;Sunnuntai;4;2;6
95;29.11.2015;2015;11;16;Sunnuntai;0;3;3
95;29.11.2015;2015;11;17;Sunnuntai;3;4;7
95;29.11.2015;2015;11;18;Sunnuntai;2;6;8
95;29.11.2015;2015;11;19;Sunnuntai;3;2;5
95;29.11.2015;2015;11;20;Sunnuntai;2;1;3
95;29.11.2015;2015;11;21;Sunnuntai;1;0;1
95;29.11.2015;2015;11;22;Sunnuntai;1;1;2
95;29.11.2015;2015;11;23;Sunnuntai;1;0;1
95;30.11.2015;2015;11;00;Maanantai;0;0;0
95;30.11.2015;2015;11;01;Maanantai;0;0;0
95;30.11.2015;2015;11;02;Maanantai;0;0;0
95;30.11.2015;2015;11;03;Maanantai;0;0;0
95;30.11.2015;2015;11;04;Maanantai;1;0;1
95;30.11.2015;2015;11;05;Maanantai;6;2;8
95;30.11.2015;2015;11;06;Maanantai;6;6;12
95;30.11.2015;2015;11;07;Maanantai;11;7;18
95;30.11.2015;2015;11;08;Maanantai;4;5;9
95;30.11.2015;2015;11;09;Maanantai;7;3;10
95;30.11.2015;2015;11;10;Maanantai;7;2;9
95;30.11.2015;2015;11;11;Maanantai;13;1;14
95;30.11.2015;2015;11;12;Maanantai;9;3;12
95;30.11.2015;2015;11;13;Maanantai;4;4;8
95;30.11.2015;2015;11;14;Maanantai;5;13;18
95;30.11.2015;2015;11;15;Maanantai;6;8;14
95;30.11.2015;2015;11;16;Maanantai;11;11;22
95;30.11.2015;2015;11;17;Maanantai;3;4;7
95;30.11.2015;2015;11;18;Maanantai;2;5;7
95;30.11.2015;2015;11;19;Maanantai;4;3;7
95;30.11.2015;2015;11;20;Maanantai;4;3;7
95;30.11.2015;2015;11;21;Maanantai;2;2;4
95;30.11.2015;2015;11;22;Maanantai;3;5;8
95;30.11.2015;2015;11;23;Maanantai;0;2;2
95;01.12.2015;2015;12;00;Tiistai;0;0;0
95;01.12.2015;2015;12;01;Tiistai;0;0;0
95;01.12.2015;2015;12;02;Tiistai;0;0;0
95;01.12.2015;2015;12;03;Tiistai;0;0;0
95;01.12.2015;2015;12;04;Tiistai;1;0;1
95;01.12.2015;2015;12;05;Tiistai;5;3;8
95;01.12.2015;2015;12;06;Tiistai;7;4;11
95;01.12.2015;2015;12;07;Tiistai;10;15;25
95;01.12.2015;2015;12;08;Tiistai;3;9;12
95;01.12.2015;2015;12;09;Tiistai;1;3;4
95;01.12.2015;2015;12;10;Tiistai;7;1;8
95;01.12.2015;2015;12;11;Tiistai;7;5;12
95;01.12.2015;2015;12;12;Tiistai;5;2;7
95;01.12.2015;2015;12;13;Tiistai;4;6;10
95;01.12.2015;2015;12;14;Tiistai;7;4;11
95;01.12.2015;2015;12;15;Tiistai;9;8;17
95;01.12.2015;2015;12;16;Tiistai;11;9;20
95;01.12.2015;2015;12;17;Tiistai;2;8;10
95;01.12.2015;2015;12;18;Tiistai;1;5;6
95;01.12.2015;2015;12;19;Tiistai;2;3;5
95;01.12.2015;2015;12;20;Tiistai;3;6;9
95;01.12.2015;2015;12;21;Tiistai;2;1;3
95;01.12.2015;2015;12;22;Tiistai;1;2;3
95;01.12.2015;2015;12;23;Tiistai;0;1;1
95;02.12.2015;2015;12;00;Keskiviikko;0;0;0
95;02.12.2015;2015;12;01;Keskiviikko;0;0;0
95;02.12.2015;2015;12;02;Keskiviikko;0;0;0
95;02.12.2015;2015;12;03;Keskiviikko;0;0;0
95;02.12.2015;2015;12;04;Keskiviikko;2;0;2
95;02.12.2015;2015;12;05;Keskiviikko;5;2;7
95;02.12.2015;2015;12;06;Keskiviikko;12;11;23
95;02.12.2015;2015;12;07;Keskiviikko;9;16;25
95;02.12.2015;2015;12;08;Keskiviikko;4;5;9
95;02.12.2015;2015;12;09;Keskiviikko;5;4;9
95;02.12.2015;2015;12;10;Keskiviikko;5;3;8
95;02.12.2015;2015;12;11;Keskiviikko;2;2;4
95;02.12.2015;2015;12;12;Keskiviikko;2;22;24
95;02.12.2015;2015;12;13;Keskiviikko;4;6;10
95;02.12.2015;2015;12;14;Keskiviikko;30;8;38
95;02.12.2015;2015;12;15;Keskiviikko;9;13;22
95;02.12.2015;2015;12;16;Keskiviikko;5;14;19
95;02.12.2015;2015;12;17;Keskiviikko;5;3;8
95;02.12.2015;2015;12;18;Keskiviikko;5;6;11
95;02.12.2015;2015;12;19;Keskiviikko;0;6;6
95;02.12.2015;2015;12;20;Keskiviikko;2;3;5
95;02.12.2015;2015;12;21;Keskiviikko;2;0;2
95;02.12.2015;2015;12;22;Keskiviikko;1;2;3
95;02.12.2015;2015;12;23;Keskiviikko;0;1;1
95;03.12.2015;2015;12;00;Torstai;0;0;0
95;03.12.2015;2015;12;01;Torstai;0;0;0
95;03.12.2015;2015;12;02;Torstai;0;0;0
95;03.12.2015;2015;12;03;Torstai;0;0;0
95;03.12.2015;2015;12;04;Torstai;2;0;2
95;03.12.2015;2015;12;05;Torstai;5;2;7
95;03.12.2015;2015;12;06;Torstai;9;7;16
95;03.12.2015;2015;12;07;Torstai;11;11;22
95;03.12.2015;2015;12;08;Torstai;5;4;9
95;03.12.2015;2015;12;09;Torstai;3;7;10
95;03.12.2015;2015;12;10;Torstai;0;2;2
95;03.12.2015;2015;12;11;Torstai;0;3;3
95;03.12.2015;2015;12;12;Torstai;2;2;4
95;03.12.2015;2015;12;13;Torstai;7;1;8
95;03.12.2015;2015;12;14;Torstai;3;3;6
95;03.12.2015;2015;12;15;Torstai;10;8;18
95;03.12.2015;2015;12;16;Torstai;13;9;22
95;03.12.2015;2015;12;17;Torstai;5;11;16
95;03.12.2015;2015;12;18;Torstai;2;1;3
95;03.12.2015;2015;12;19;Torstai;3;4;7
95;03.12.2015;2015;12;20;Torstai;2;1;3
95;03.12.2015;2015;12;21;Torstai;1;1;2
95;03.12.2015;2015;12;22;Torstai;1;1;2
95;03.12.2015;2015;12;23;Torstai;0;0;0
95;04.12.2015;2015;12;00;Perjantai;0;0;0
95;04.12.2015;2015;12;01;Perjantai;0;0;0
95;04.12.2015;2015;12;02;Perjantai;0;0;0
95;04.12.2015;2015;12;03;Perjantai;0;0;0
95;04.12.2015;2015;12;04;Perjantai;0;0;0
95;04.12.2015;2015;12;05;Perjantai;5;5;10
95;04.12.2015;2015;12;06;Perjantai;7;5;12
95;04.12.2015;2015;12;07;Perjantai;9;9;18
95;04.12.2015;2015;12;08;Perjantai;3;4;7
95;04.12.2015;2015;12;09;Perjantai;1;7;8
95;04.12.2015;2015;12;10;Perjantai;4;1;5
95;04.12.2015;2015;12;11;Perjantai;5;3;8
95;04.12.2015;2015;12;12;Perjantai;4;1;5
95;04.12.2015;2015;12;13;Perjantai;9;4;13
95;04.12.2015;2015;12;14;Perjantai;8;4;12
95;04.12.2015;2015;12;15;Perjantai;7;7;14
95;04.12.2015;2015;12;16;Perjantai;6;11;17
95;04.12.2015;2015;12;17;Perjantai;1;6;7
95;04.12.2015;2015;12;18;Perjantai;0;1;1
95;04.12.2015;2015;12;19;Perjantai;2;0;2
95;04.12.2015;2015;12;20;Perjantai;1;1;2
95;04.12.2015;2015;12;21;Perjantai;0;0;0
95;04.12.2015;2015;12;22;Perjantai;0;2;2
95;04.12.2015;2015;12;23;Perjantai;0;0;0
95;05.12.2015;2015;12;00;Lauantai;0;0;0
95;05.12.2015;2015;12;01;Lauantai;0;0;0
95;05.12.2015;2015;12;02;Lauantai;1;0;1
95;05.12.2015;2015;12;03;Lauantai;0;0;0
95;05.12.2015;2015;12;04;Lauantai;0;0;0
95;05.12.2015;2015;12;05;Lauantai;0;0;0
95;05.12.2015;2015;12;06;Lauantai;1;0;1
95;05.12.2015;2015;12;07;Lauantai;3;1;4
95;05.12.2015;2015;12;08;Lauantai;1;1;2
95;05.12.2015;2015;12;09;Lauantai;0;1;1
95;05.12.2015;2015;12;10;Lauantai;1;1;2
95;05.12.2015;2015;12;11;Lauantai;1;1;2
95;05.12.2015;2015;12;12;Lauantai;2;7;9
95;05.12.2015;2015;12;13;Lauantai;7;2;9
95;05.12.2015;2015;12;14;Lauantai;2;3;5
95;05.12.2015;2015;12;15;Lauantai;2;1;3
95;05.12.2015;2015;12;16;Lauantai;1;2;3
95;05.12.2015;2015;12;17;Lauantai;0;3;3
95;05.12.2015;2015;12;18;Lauantai;2;2;4
95;05.12.2015;2015;12;19;Lauantai;2;0;2
95;05.12.2015;2015;12;20;Lauantai;0;2;2
95;05.12.2015;2015;12;21;Lauantai;0;0;0
95;05.12.2015;2015;12;22;Lauantai;2;1;3
95;05.12.2015;2015;12;23;Lauantai;0;1;1
95;06.12.2015;2015;12;00;Sunnuntai;1;0;1
95;06.12.2015;2015;12;01;Sunnuntai;0;0;0
95;06.12.2015;2015;12;02;Sunnuntai;0;0;0
95;06.12.2015;2015;12;03;Sunnuntai;0;1;1
95;06.12.2015;2015;12;04;Sunnuntai;0;0;0
95;06.12.2015;2015;12;05;Sunnuntai;0;0;0
95;06.12.2015;2015;12;06;Sunnuntai;4;0;4
95;06.12.2015;2015;12;07;Sunnuntai;1;0;1
95;06.12.2015;2015;12;08;Sunnuntai;0;1;1
95;06.12.2015;2015;12;09;Sunnuntai;2;0;2
95;06.12.2015;2015;12;10;Sunnuntai;1;0;1
95;06.12.2015;2015;12;11;Sunnuntai;0;2;2
95;06.12.2015;2015;12;12;Sunnuntai;2;3;5
95;06.12.2015;2015;12;13;Sunnuntai;2;0;2
95;06.12.2015;2015;12;14;Sunnuntai;1;3;4
95;06.12.2015;2015;12;15;Sunnuntai;0;1;1
95;06.12.2015;2015;12;16;Sunnuntai;2;0;2
95;06.12.2015;2015;12;17;Sunnuntai;3;1;4
95;06.12.2015;2015;12;18;Sunnuntai;2;1;3
95;06.12.2015;2015;12;19;Sunnuntai;1;0;1
95;06.12.2015;2015;12;20;Sunnuntai;1;1;2
95;06.12.2015;2015;12;21;Sunnuntai;1;1;2
95;06.12.2015;2015;12;22;Sunnuntai;0;0;0
95;06.12.2015;2015;12;23;Sunnuntai;0;0;0
95;07.12.2015;2015;12;00;Maanantai;0;0;0
95;07.12.2015;2015;12;01;Maanantai;0;0;0
95;07.12.2015;2015;12;02;Maanantai;0;0;0
95;07.12.2015;2015;12;03;Maanantai;0;0;0
95;07.12.2015;2015;12;04;Maanantai;1;0;1
95;07.12.2015;2015;12;05;Maanantai;5;2;7
95;07.12.2015;2015;12;06;Maanantai;6;7;13
95;07.12.2015;2015;12;07;Maanantai;11;9;20
95;07.12.2015;2015;12;08;Maanantai;8;5;13
95;07.12.2015;2015;12;09;Maanantai;0;3;3
95;07.12.2015;2015;12;10;Maanantai;0;4;4
95;07.12.2015;2015;12;11;Maanantai;6;2;8
95;07.12.2015;2015;12;12;Maanantai;4;0;4
95;07.12.2015;2015;12;13;Maanantai;0;5;5
95;07.12.2015;2015;12;14;Maanantai;9;3;12
95;07.12.2015;2015;12;15;Maanantai;18;12;30
95;07.12.2015;2015;12;16;Maanantai;10;12;22
95;07.12.2015;2015;12;17;Maanantai;2;7;9
95;07.12.2015;2015;12;18;Maanantai;3;3;6
95;07.12.2015;2015;12;19;Maanantai;1;1;2
95;07.12.2015;2015;12;20;Maanantai;1;4;5
95;07.12.2015;2015;12;21;Maanantai;1;1;2
95;07.12.2015;2015;12;22;Maanantai;1;0;1
95;07.12.2015;2015;12;23;Maanantai;0;0;0
95;08.12.2015;2015;12;00;Tiistai;1;0;1
95;08.12.2015;2015;12;01;Tiistai;0;0;0
95;08.12.2015;2015;12;02;Tiistai;0;0;0
95;08.12.2015;2015;12;03;Tiistai;0;0;0
95;08.12.2015;2015;12;04;Tiistai;2;0;2
95;08.12.2015;2015;12;05;Tiistai;3;2;5
95;08.12.2015;2015;12;06;Tiistai;9;10;19
95;08.12.2015;2015;12;07;Tiistai;9;11;20
95;08.12.2015;2015;12;08;Tiistai;2;11;13
95;08.12.2015;2015;12;09;Tiistai;2;0;2
95;08.12.2015;2015;12;10;Tiistai;1;1;2
95;08.12.2015;2015;12;11;Tiistai;6;1;7
95;08.12.2015;2015;12;12;Tiistai;2;2;4
95;08.12.2015;2015;12;13;Tiistai;2;4;6
95;08.12.2015;2015;12;14;Tiistai;8;4;12
95;08.12.2015;2015;12;15;Tiistai;14;7;21
95;08.12.2015;2015;12;16;Tiistai;8;7;15
95;08.12.2015;2015;12;17;Tiistai;7;3;10
95;08.12.2015;2015;12;18;Tiistai;1;2;3
95;08.12.2015;2015;12;19;Tiistai;1;5;6
95;08.12.2015;2015;12;20;Tiistai;1;1;2
95;08.12.2015;2015;12;21;Tiistai;1;2;3
95;08.12.2015;2015;12;22;Tiistai;1;0;1
95;08.12.2015;2015;12;23;Tiistai;0;0;0
95;09.12.2015;2015;12;00;Keskiviikko;0;0;0
95;09.12.2015;2015;12;01;Keskiviikko;0;0;0
95;09.12.2015;2015;12;02;Keskiviikko;0;0;0
95;09.12.2015;2015;12;03;Keskiviikko;0;0;0
95;09.12.2015;2015;12;04;Keskiviikko;0;0;0
95;09.12.2015;2015;12;05;Keskiviikko;1;1;2
95;09.12.2015;2015;12;06;Keskiviikko;9;8;17
95;09.12.2015;2015;12;07;Keskiviikko;6;14;20
95;09.12.2015;2015;12;08;Keskiviikko;3;4;7
95;09.12.2015;2015;12;09;Keskiviikko;1;4;5
95;09.12.2015;2015;12;10;Keskiviikko;3;2;5
95;09.12.2015;2015;12;11;Keskiviikko;0;1;1
95;09.12.2015;2015;12;12;Keskiviikko;2;4;6
95;09.12.2015;2015;12;13;Keskiviikko;11;7;18
95;09.12.2015;2015;12;14;Keskiviikko;4;2;6
95;09.12.2015;2015;12;15;Keskiviikko;12;7;19
95;09.12.2015;2015;12;16;Keskiviikko;9;5;14
95;09.12.2015;2015;12;17;Keskiviikko;3;3;6
95;09.12.2015;2015;12;18;Keskiviikko;1;3;4
95;09.12.2015;2015;12;19;Keskiviikko;0;1;1
95;09.12.2015;2015;12;20;Keskiviikko;1;1;2
95;09.12.2015;2015;12;21;Keskiviikko;1;1;2
95;09.12.2015;2015;12;22;Keskiviikko;1;0;1
95;09.12.2015;2015;12;23;Keskiviikko;1;0;1
95;10.12.2015;2015;12;00;Torstai;0;0;0
95;10.12.2015;2015;12;01;Torstai;0;0;0
95;10.12.2015;2015;12;02;Torstai;0;0;0
95;10.12.2015;2015;12;03;Torstai;0;0;0
95;10.12.2015;2015;12;04;Torstai;0;0;0
95;10.12.2015;2015;12;05;Torstai;2;2;4
95;10.12.2015;2015;12;06;Torstai;8;6;14
95;10.12.2015;2015;12;07;Torstai;5;10;15
95;10.12.2015;2015;12;08;Torstai;3;9;12
95;10.12.2015;2015;12;09;Torstai;2;6;8
95;10.12.2015;2015;12;10;Torstai;6;3;9
95;10.12.2015;2015;12;11;Torstai;1;1;2
95;10.12.2015;2015;12;12;Torstai;3;2;5
95;10.12.2015;2015;12;13;Torstai;4;2;6
95;10.12.2015;2015;12;14;Torstai;7;4;11
95;10.12.2015;2015;12;15;Torstai;5;5;10
95;10.12.2015;2015;12;16;Torstai;12;9;21
95;10.12.2015;2015;12;17;Torstai;4;7;11
95;10.12.2015;2015;12;18;Torstai;1;3;4
95;10.12.2015;2015;12;19;Torstai;2;2;4
95;10.12.2015;2015;12;20;Torstai;1;1;2
95;10.12.2015;2015;12;21;Torstai;2;1;3
95;10.12.2015;2015;12;22;Torstai;1;1;2
95;10.12.2015;2015;12;23;Torstai;0;0;0
95;11.12.2015;2015;12;00;Perjantai;0;0;0
95;11.12.2015;2015;12;01;Perjantai;0;0;0
95;11.12.2015;2015;12;02;Perjantai;0;0;0
95;11.12.2015;2015;12;03;Perjantai;0;0;0
95;11.12.2015;2015;12;04;Perjantai;0;0;0
95;11.12.2015;2015;12;05;Perjantai;1;1;2
95;11.12.2015;2015;12;06;Perjantai;9;4;13
95;11.12.2015;2015;12;07;Perjantai;12;3;15
95;11.12.2015;2015;12;08;Perjantai;1;6;7
95;11.12.2015;2015;12;09;Perjantai;1;2;3
95;11.12.2015;2015;12;10;Perjantai;1;1;2
95;11.12.2015;2015;12;11;Perjantai;2;4;6
95;11.12.2015;2015;12;12;Perjantai;1;4;5
95;11.12.2015;2015;12;13;Perjantai;9;2;11
95;11.12.2015;2015;12;14;Perjantai;6;6;12
95;11.12.2015;2015;12;15;Perjantai;3;2;5
95;11.12.2015;2015;12;16;Perjantai;3;6;9
95;11.12.2015;2015;12;17;Perjantai;4;5;9
95;11.12.2015;2015;12;18;Perjantai;1;4;5
95;11.12.2015;2015;12;19;Perjantai;4;4;8
95;11.12.2015;2015;12;20;Perjantai;2;1;3
95;11.12.2015;2015;12;21;Perjantai;0;2;2
95;11.12.2015;2015;12;22;Perjantai;0;2;2
95;11.12.2015;2015;12;23;Perjantai;1;0;1
95;12.12.2015;2015;12;00;Lauantai;0;0;0
95;12.12.2015;2015;12;01;Lauantai;0;0;0
95;12.12.2015;2015;12;02;Lauantai;0;0;0
95;12.12.2015;2015;12;03;Lauantai;0;0;0
95;12.12.2015;2015;12;04;Lauantai;3;0;3
95;12.12.2015;2015;12;05;Lauantai;0;0;0
95;12.12.2015;2015;12;06;Lauantai;1;0;1
95;12.12.2015;2015;12;07;Lauantai;2;0;2
95;12.12.2015;2015;12;08;Lauantai;1;0;1
95;12.12.2015;2015;12;09;Lauantai;2;0;2
95;12.12.2015;2015;12;10;Lauantai;4;2;6
95;12.12.2015;2015;12;11;Lauantai;4;1;5
95;12.12.2015;2015;12;12;Lauantai;1;2;3
95;12.12.2015;2015;12;13;Lauantai;3;2;5
95;12.12.2015;2015;12;14;Lauantai;1;1;2
95;12.12.2015;2015;12;15;Lauantai;2;4;6
95;12.12.2015;2015;12;16;Lauantai;1;4;5
95;12.12.2015;2015;12;17;Lauantai;2;7;9
95;12.12.2015;2015;12;18;Lauantai;2;0;2
95;12.12.2015;2015;12;19;Lauantai;2;0;2
95;12.12.2015;2015;12;20;Lauantai;0;0;0
95;12.12.2015;2015;12;21;Lauantai;1;0;1
95;12.12.2015;2015;12;22;Lauantai;1;2;3
95;12.12.2015;2015;12;23;Lauantai;0;0;0
95;13.12.2015;2015;12;00;Sunnuntai;0;0;0
95;13.12.2015;2015;12;01;Sunnuntai;0;0;0
95;13.12.2015;2015;12;02;Sunnuntai;0;0;0
95;13.12.2015;2015;12;03;Sunnuntai;0;0;0
95;13.12.2015;2015;12;04;Sunnuntai;2;0;2
95;13.12.2015;2015;12;05;Sunnuntai;0;0;0
95;13.12.2015;2015;12;06;Sunnuntai;1;1;2
95;13.12.2015;2015;12;07;Sunnuntai;2;0;2
95;13.12.2015;2015;12;08;Sunnuntai;1;1;2
95;13.12.2015;2015;12;09;Sunnuntai;2;1;3
95;13.12.2015;2015;12;10;Sunnuntai;0;0;0
95;13.12.2015;2015;12;11;Sunnuntai;2;0;2
95;13.12.2015;2015;12;12;Sunnuntai;1;0;1
95;13.12.2015;2015;12;13;Sunnuntai;4;2;6
95;13.12.2015;2015;12;14;Sunnuntai;2;4;6
95;13.12.2015;2015;12;15;Sunnuntai;3;3;6
95;13.12.2015;2015;12;16;Sunnuntai;0;0;0
95;13.12.2015;2015;12;17;Sunnuntai;0;0;0
95;13.12.2015;2015;12;18;Sunnuntai;0;0;0
95;13.12.2015;2015;12;19;Sunnuntai;0;0;0
95;13.12.2015;2015;12;20;Sunnuntai;0;2;2
95;13.12.2015;2015;12;21;Sunnuntai;1;0;1
95;13.12.2015;2015;12;22;Sunnuntai;0;2;2
95;13.12.2015;2015;12;23;Sunnuntai;0;0;0
95;14.12.2015;2015;12;00;Maanantai;0;0;0
95;14.12.2015;2015;12;01;Maanantai;1;0;1
95;14.12.2015;2015;12;02;Maanantai;0;0;0
95;14.12.2015;2015;12;03;Maanantai;0;0;0
95;14.12.2015;2015;12;04;Maanantai;1;0;1
95;14.12.2015;2015;12;05;Maanantai;2;2;4
95;14.12.2015;2015;12;06;Maanantai;8;7;15
95;14.12.2015;2015;12;07;Maanantai;6;8;14
95;14.12.2015;2015;12;08;Maanantai;4;10;14
95;14.12.2015;2015;12;09;Maanantai;1;3;4
95;14.12.2015;2015;12;10;Maanantai;0;1;1
95;14.12.2015;2015;12;11;Maanantai;4;4;8
95;14.12.2015;2015;12;12;Maanantai;6;2;8
95;14.12.2015;2015;12;13;Maanantai;4;3;7
95;14.12.2015;2015;12;14;Maanantai;6;4;10
95;14.12.2015;2015;12;15;Maanantai;13;5;18
95;14.12.2015;2015;12;16;Maanantai;12;10;22
95;14.12.2015;2015;12;17;Maanantai;4;5;9
95;14.12.2015;2015;12;18;Maanantai;0;4;4
95;14.12.2015;2015;12;19;Maanantai;0;2;2
95;14.12.2015;2015;12;20;Maanantai;0;1;1
95;14.12.2015;2015;12;21;Maanantai;1;2;3
95;14.12.2015;2015;12;22;Maanantai;3;1;4
95;14.12.2015;2015;12;23;Maanantai;0;0;0
95;15.12.2015;2015;12;00;Tiistai;0;0;0
95;15.12.2015;2015;12;01;Tiistai;0;0;0
95;15.12.2015;2015;12;02;Tiistai;0;0;0
95;15.12.2015;2015;12;03;Tiistai;0;0;0
95;15.12.2015;2015;12;04;Tiistai;1;0;1
95;15.12.2015;2015;12;05;Tiistai;1;2;3
95;15.12.2015;2015;12;06;Tiistai;10;10;20
95;15.12.2015;2015;12;07;Tiistai;11;7;18
95;15.12.2015;2015;12;08;Tiistai;2;11;13
95;15.12.2015;2015;12;09;Tiistai;0;3;3
95;15.12.2015;2015;12;10;Tiistai;1;3;4
95;15.12.2015;2015;12;11;Tiistai;1;1;2
95;15.12.2015;2015;12;12;Tiistai;4;0;4
95;15.12.2015;2015;12;13;Tiistai;6;4;10
95;15.12.2015;2015;12;14;Tiistai;6;2;8
95;15.12.2015;2015;12;15;Tiistai;13;5;18
95;15.12.2015;2015;12;16;Tiistai;10;12;22
95;15.12.2015;2015;12;17;Tiistai;3;4;7
95;15.12.2015;2015;12;18;Tiistai;2;1;3
95;15.12.2015;2015;12;19;Tiistai;1;1;2
95;15.12.2015;2015;12;20;Tiistai;0;1;1
95;15.12.2015;2015;12;21;Tiistai;3;1;4
95;15.12.2015;2015;12;22;Tiistai;3;2;5
95;15.12.2015;2015;12;23;Tiistai;0;0;0
95;16.12.2015;2015;12;00;Keskiviikko;0;0;0
95;16.12.2015;2015;12;01;Keskiviikko;0;0;0
95;16.12.2015;2015;12;02;Keskiviikko;0;0;0
95;16.12.2015;2015;12;03;Keskiviikko;0;0;0
95;16.12.2015;2015;12;04;Keskiviikko;1;0;1
95;16.12.2015;2015;12;05;Keskiviikko;2;2;4
95;16.12.2015;2015;12;06;Keskiviikko;13;6;19
95;16.12.2015;2015;12;07;Keskiviikko;10;7;17
95;16.12.2015;2015;12;08;Keskiviikko;1;6;7
95;16.12.2015;2015;12;09;Keskiviikko;0;4;4
95;16.12.2015;2015;12;10;Keskiviikko;2;0;2
95;16.12.2015;2015;12;11;Keskiviikko;4;2;6
95;16.12.2015;2015;12;12;Keskiviikko;3;0;3
95;16.12.2015;2015;12;13;Keskiviikko;7;2;9
95;16.12.2015;2015;12;14;Keskiviikko;7;5;12
95;16.12.2015;2015;12;15;Keskiviikko;7;4;11
95;16.12.2015;2015;12;16;Keskiviikko;9;13;22
95;16.12.2015;2015;12;17;Keskiviikko;2;6;8
95;16.12.2015;2015;12;18;Keskiviikko;2;3;5
95;16.12.2015;2015;12;19;Keskiviikko;0;2;2
95;16.12.2015;2015;12;20;Keskiviikko;0;0;0
95;16.12.2015;2015;12;21;Keskiviikko;0;1;1
95;16.12.2015;2015;12;22;Keskiviikko;2;1;3
95;16.12.2015;2015;12;23;Keskiviikko;1;0;1
95;17.12.2015;2015;12;00;Torstai;0;0;0
95;17.12.2015;2015;12;01;Torstai;1;1;2
95;17.12.2015;2015;12;02;Torstai;0;0;0
95;17.12.2015;2015;12;03;Torstai;0;0;0
95;17.12.2015;2015;12;04;Torstai;1;0;1
95;17.12.2015;2015;12;05;Torstai;1;2;3
95;17.12.2015;2015;12;06;Torstai;9;6;15
95;17.12.2015;2015;12;07;Torstai;8;5;13
95;17.12.2015;2015;12;08;Torstai;4;3;7
95;17.12.2015;2015;12;09;Torstai;4;9;13
95;17.12.2015;2015;12;10;Torstai;3;0;3
95;17.12.2015;2015;12;11;Torstai;0;1;1
95;17.12.2015;2015;12;12;Torstai;4;3;7
95;17.12.2015;2015;12;13;Torstai;0;3;3
95;17.12.2015;2015;12;14;Torstai;8;3;11
95;17.12.2015;2015;12;15;Torstai;8;8;16
95;17.12.2015;2015;12;16;Torstai;9;11;20
95;17.12.2015;2015;12;17;Torstai;3;3;6
95;17.12.2015;2015;12;18;Torstai;3;5;8
95;17.12.2015;2015;12;19;Torstai;3;3;6
95;17.12.2015;2015;12;20;Torstai;0;1;1
95;17.12.2015;2015;12;21;Torstai;1;2;3
95;17.12.2015;2015;12;22;Torstai;3;0;3
95;17.12.2015;2015;12;23;Torstai;0;0;0
95;18.12.2015;2015;12;00;Perjantai;0;0;0
95;18.12.2015;2015;12;01;Perjantai;0;0;0
95;18.12.2015;2015;12;02;Perjantai;0;0;0
95;18.12.2015;2015;12;03;Perjantai;0;0;0
95;18.12.2015;2015;12;04;Perjantai;0;0;0
95;18.12.2015;2015;12;05;Perjantai;4;3;7
95;18.12.2015;2015;12;06;Perjantai;7;4;11
95;18.12.2015;2015;12;07;Perjantai;8;8;16
95;18.12.2015;2015;12;08;Perjantai;3;6;9
95;18.12.2015;2015;12;09;Perjantai;2;0;2
95;18.12.2015;2015;12;10;Perjantai;1;4;5
95;18.12.2015;2015;12;11;Perjantai;2;2;4
95;18.12.2015;2015;12;12;Perjantai;4;5;9
95;18.12.2015;2015;12;13;Perjantai;3;4;7
95;18.12.2015;2015;12;14;Perjantai;11;3;14
95;18.12.2015;2015;12;15;Perjantai;8;5;13
95;18.12.2015;2015;12;16;Perjantai;5;11;16
95;18.12.2015;2015;12;17;Perjantai;0;4;4
95;18.12.2015;2015;12;18;Perjantai;0;1;1
95;18.12.2015;2015;12;19;Perjantai;2;0;2
95;18.12.2015;2015;12;20;Perjantai;0;1;1
95;18.12.2015;2015;12;21;Perjantai;1;0;1
95;18.12.2015;2015;12;22;Perjantai;0;1;1
95;18.12.2015;2015;12;23;Perjantai;0;0;0
95;19.12.2015;2015;12;00;Lauantai;0;0;0
95;19.12.2015;2015;12;01;Lauantai;0;0;0
95;19.12.2015;2015;12;02;Lauantai;0;0;0
95;19.12.2015;2015;12;03;Lauantai;0;0;0
95;19.12.2015;2015;12;04;Lauantai;0;0;0
95;19.12.2015;2015;12;05;Lauantai;0;0;0
95;19.12.2015;2015;12;06;Lauantai;2;1;3
95;19.12.2015;2015;12;07;Lauantai;3;0;3
95;19.12.2015;2015;12;08;Lauantai;0;0;0
95;19.12.2015;2015;12;09;Lauantai;0;0;0
95;19.12.2015;2015;12;10;Lauantai;2;1;3
95;19.12.2015;2015;12;11;Lauantai;4;1;5
95;19.12.2015;2015;12;12;Lauantai;2;5;7
95;19.12.2015;2015;12;13;Lauantai;6;4;10
95;19.12.2015;2015;12;14;Lauantai;5;0;5
95;19.12.2015;2015;12;15;Lauantai;1;8;9
95;19.12.2015;2015;12;16;Lauantai;4;0;4
95;19.12.2015;2015;12;17;Lauantai;6;3;9
95;19.12.2015;2015;12;18;Lauantai;1;4;5
95;19.12.2015;2015;12;19;Lauantai;1;1;2
95;19.12.2015;2015;12;20;Lauantai;0;2;2
95;19.12.2015;2015;12;21;Lauantai;0;0;0
95;19.12.2015;2015;12;22;Lauantai;2;0;2
95;19.12.2015;2015;12;23;Lauantai;0;0;0
95;20.12.2015;2015;12;00;Sunnuntai;0;0;0
95;20.12.2015;2015;12;01;Sunnuntai;0;0;0
95;20.12.2015;2015;12;02;Sunnuntai;0;0;0
95;20.12.2015;2015;12;03;Sunnuntai;0;0;0
95;20.12.2015;2015;12;04;Sunnuntai;1;0;1
95;20.12.2015;2015;12;05;Sunnuntai;0;1;1
95;20.12.2015;2015;12;06;Sunnuntai;0;2;2
95;20.12.2015;2015;12;07;Sunnuntai;0;0;0
95;20.12.2015;2015;12;08;Sunnuntai;0;0;0
95;20.12.2015;2015;12;09;Sunnuntai;5;0;5
95;20.12.2015;2015;12;10;Sunnuntai;1;1;2
95;20.12.2015;2015;12;11;Sunnuntai;2;1;3
95;20.12.2015;2015;12;12;Sunnuntai;2;2;4
95;20.12.2015;2015;12;13;Sunnuntai;1;0;1
95;20.12.2015;2015;12;14;Sunnuntai;3;2;5
95;20.12.2015;2015;12;15;Sunnuntai;3;0;3
95;20.12.2015;2015;12;16;Sunnuntai;1;1;2
95;20.12.2015;2015;12;17;Sunnuntai;2;2;4
95;20.12.2015;2015;12;18;Sunnuntai;0;0;0
95;20.12.2015;2015;12;19;Sunnuntai;1;1;2
95;20.12.2015;2015;12;20;Sunnuntai;0;0;0
95;20.12.2015;2015;12;21;Sunnuntai;0;0;0
95;20.12.2015;2015;12;22;Sunnuntai;0;0;0
95;20.12.2015;2015;12;23;Sunnuntai;0;0;0
95;21.12.2015;2015;12;00;Maanantai;0;0;0
95;21.12.2015;2015;12;01;Maanantai;0;0;0
95;21.12.2015;2015;12;02;Maanantai;0;0;0
95;21.12.2015;2015;12;03;Maanantai;0;0;0
95;21.12.2015;2015;12;04;Maanantai;0;1;1
95;21.12.2015;2015;12;05;Maanantai;3;2;5
95;21.12.2015;2015;12;06;Maanantai;3;3;6
95;21.12.2015;2015;12;07;Maanantai;5;4;9
95;21.12.2015;2015;12;08;Maanantai;3;3;6
95;21.12.2015;2015;12;09;Maanantai;0;1;1
95;21.12.2015;2015;12;10;Maanantai;1;0;1
95;21.12.2015;2015;12;11;Maanantai;3;0;3
95;21.12.2015;2015;12;12;Maanantai;4;1;5
95;21.12.2015;2015;12;13;Maanantai;2;2;4
95;21.12.2015;2015;12;14;Maanantai;4;3;7
95;21.12.2015;2015;12;15;Maanantai;3;5;8
95;21.12.2015;2015;12;16;Maanantai;3;3;6
95;21.12.2015;2015;12;17;Maanantai;3;6;9
95;21.12.2015;2015;12;18;Maanantai;1;5;6
95;21.12.2015;2015;12;19;Maanantai;2;3;5
95;21.12.2015;2015;12;20;Maanantai;2;1;3
95;21.12.2015;2015;12;21;Maanantai;2;1;3
95;21.12.2015;2015;12;22;Maanantai;0;0;0
95;21.12.2015;2015;12;23;Maanantai;0;0;0
95;22.12.2015;2015;12;00;Tiistai;0;0;0
95;22.12.2015;2015;12;01;Tiistai;0;0;0
95;22.12.2015;2015;12;02;Tiistai;0;0;0
95;22.12.2015;2015;12;03;Tiistai;0;0;0
95;22.12.2015;2015;12;04;Tiistai;1;0;1
95;22.12.2015;2015;12;05;Tiistai;2;4;6
95;22.12.2015;2015;12;06;Tiistai;5;3;8
95;22.12.2015;2015;12;07;Tiistai;5;3;8
95;22.12.2015;2015;12;08;Tiistai;4;4;8
95;22.12.2015;2015;12;09;Tiistai;0;1;1
95;22.12.2015;2015;12;10;Tiistai;3;0;3
95;22.12.2015;2015;12;11;Tiistai;2;2;4
95;22.12.2015;2015;12;12;Tiistai;0;4;4
95;22.12.2015;2015;12;13;Tiistai;3;0;3
95;22.12.2015;2015;12;14;Tiistai;5;5;10
95;22.12.2015;2015;12;15;Tiistai;2;8;10
95;22.12.2015;2015;12;16;Tiistai;2;8;10
95;22.12.2015;2015;12;17;Tiistai;4;4;8
95;22.12.2015;2015;12;18;Tiistai;1;3;4
95;22.12.2015;2015;12;19;Tiistai;0;0;0
95;22.12.2015;2015;12;20;Tiistai;1;0;1
95;22.12.2015;2015;12;21;Tiistai;2;0;2
95;22.12.2015;2015;12;22;Tiistai;0;1;1
95;22.12.2015;2015;12;23;Tiistai;0;0;0
95;23.12.2015;2015;12;00;Keskiviikko;0;0;0
95;23.12.2015;2015;12;01;Keskiviikko;0;0;0
95;23.12.2015;2015;12;02;Keskiviikko;0;0;0
95;23.12.2015;2015;12;03;Keskiviikko;0;0;0
95;23.12.2015;2015;12;04;Keskiviikko;2;1;3
95;23.12.2015;2015;12;05;Keskiviikko;2;2;4
95;23.12.2015;2015;12;06;Keskiviikko;0;4;4
95;23.12.2015;2015;12;07;Keskiviikko;4;3;7
95;23.12.2015;2015;12;08;Keskiviikko;5;2;7
95;23.12.2015;2015;12;09;Keskiviikko;1;0;1
95;23.12.2015;2015;12;10;Keskiviikko;1;1;2
95;23.12.2015;2015;12;11;Keskiviikko;3;2;5
95;23.12.2015;2015;12;12;Keskiviikko;5;4;9
95;23.12.2015;2015;12;13;Keskiviikko;7;6;13
95;23.12.2015;2015;12;14;Keskiviikko;3;4;7
95;23.12.2015;2015;12;15;Keskiviikko;4;4;8
95;23.12.2015;2015;12;16;Keskiviikko;5;4;9
95;23.12.2015;2015;12;17;Keskiviikko;0;2;2
95;23.12.2015;2015;12;18;Keskiviikko;0;0;0
95;23.12.2015;2015;12;19;Keskiviikko;3;1;4
95;23.12.2015;2015;12;20;Keskiviikko;0;0;0
95;23.12.2015;2015;12;21;Keskiviikko;1;0;1
95;23.12.2015;2015;12;22;Keskiviikko;1;3;4
95;23.12.2015;2015;12;23;Keskiviikko;0;1;1
95;24.12.2015;2015;12;00;Torstai;0;0;0
95;24.12.2015;2015;12;01;Torstai;0;0;0
95;24.12.2015;2015;12;02;Torstai;0;0;0
95;24.12.2015;2015;12;03;Torstai;0;0;0
95;24.12.2015;2015;12;04;Torstai;0;0;0
95;24.12.2015;2015;12;05;Torstai;0;0;0
95;24.12.2015;2015;12;06;Torstai;0;0;0
95;24.12.2015;2015;12;07;Torstai;0;0;0
95;24.12.2015;2015;12;08;Torstai;0;0;0
95;24.12.2015;2015;12;09;Torstai;0;0;0
95;24.12.2015;2015;12;10;Torstai;1;1;2
95;24.12.2015;2015;12;11;Torstai;1;2;3
95;24.12.2015;2015;12;12;Torstai;3;4;7
95;24.12.2015;2015;12;13;Torstai;3;0;3
95;24.12.2015;2015;12;14;Torstai;0;0;0
95;24.12.2015;2015;12;15;Torstai;0;2;2
95;24.12.2015;2015;12;16;Torstai;2;1;3
95;24.12.2015;2015;12;17;Torstai;0;2;2
95;24.12.2015;2015;12;18;Torstai;0;1;1
95;24.12.2015;2015;12;19;Torstai;1;3;4
95;24.12.2015;2015;12;20;Torstai;0;0;0
95;24.12.2015;2015;12;21;Torstai;0;0;0
95;24.12.2015;2015;12;22;Torstai;2;0;2
95;24.12.2015;2015;12;23;Torstai;0;0;0
95;25.12.2015;2015;12;00;Perjantai;0;0;0
95;25.12.2015;2015;12;01;Perjantai;0;0;0
95;25.12.2015;2015;12;02;Perjantai;0;0;0
95;25.12.2015;2015;12;03;Perjantai;2;0;2
95;25.12.2015;2015;12;04;Perjantai;0;0;0
95;25.12.2015;2015;12;05;Perjantai;0;0;0
95;25.12.2015;2015;12;06;Perjantai;5;1;6
95;25.12.2015;2015;12;07;Perjantai;1;0;1
95;25.12.2015;2015;12;08;Perjantai;0;0;0
95;25.12.2015;2015;12;09;Perjantai;0;0;0
95;25.12.2015;2015;12;10;Perjantai;1;0;1
95;25.12.2015;2015;12;11;Perjantai;1;0;1
95;25.12.2015;2015;12;12;Perjantai;2;1;3
95;25.12.2015;2015;12;13;Perjantai;0;0;0
95;25.12.2015;2015;12;14;Perjantai;1;1;2
95;25.12.2015;2015;12;15;Perjantai;0;1;1
95;25.12.2015;2015;12;16;Perjantai;0;1;1
95;25.12.2015;2015;12;17;Perjantai;1;1;2
95;25.12.2015;2015;12;18;Perjantai;0;0;0
95;25.12.2015;2015;12;19;Perjantai;0;0;0
95;25.12.2015;2015;12;20;Perjantai;0;1;1
95;25.12.2015;2015;12;21;Perjantai;0;1;1
95;25.12.2015;2015;12;22;Perjantai;0;1;1
95;25.12.2015;2015;12;23;Perjantai;0;0;0
95;26.12.2015;2015;12;00;Lauantai;0;0;0
95;26.12.2015;2015;12;01;Lauantai;0;0;0
95;26.12.2015;2015;12;02;Lauantai;0;0;0
95;26.12.2015;2015;12;03;Lauantai;0;0;0
95;26.12.2015;2015;12;04;Lauantai;0;0;0
95;26.12.2015;2015;12;05;Lauantai;1;1;2
95;26.12.2015;2015;12;06;Lauantai;1;0;1
95;26.12.2015;2015;12;07;Lauantai;1;0;1
95;26.12.2015;2015;12;08;Lauantai;0;1;1
95;26.12.2015;2015;12;09;Lauantai;0;0;0
95;26.12.2015;2015;12;10;Lauantai;1;5;6
95;26.12.2015;2015;12;11;Lauantai;0;0;0
95;26.12.2015;2015;12;12;Lauantai;4;0;4
95;26.12.2015;2015;12;13;Lauantai;1;2;3
95;26.12.2015;2015;12;14;Lauantai;1;2;3
95;26.12.2015;2015;12;15;Lauantai;0;0;0
95;26.12.2015;2015;12;16;Lauantai;1;0;1
95;26.12.2015;2015;12;17;Lauantai;0;0;0
95;26.12.2015;2015;12;18;Lauantai;2;1;3
95;26.12.2015;2015;12;19;Lauantai;0;0;0
95;26.12.2015;2015;12;20;Lauantai;2;2;4
95;26.12.2015;2015;12;21;Lauantai;0;2;2
95;26.12.2015;2015;12;22;Lauantai;0;1;1
95;26.12.2015;2015;12;23;Lauantai;0;0;0
95;27.12.2015;2015;12;00;Sunnuntai;0;1;1
95;27.12.2015;2015;12;01;Sunnuntai;0;0;0
95;27.12.2015;2015;12;02;Sunnuntai;0;0;0
95;27.12.2015;2015;12;03;Sunnuntai;0;0;0
95;27.12.2015;2015;12;04;Sunnuntai;0;0;0
95;27.12.2015;2015;12;05;Sunnuntai;0;1;1
95;27.12.2015;2015;12;06;Sunnuntai;1;0;1
95;27.12.2015;2015;12;07;Sunnuntai;0;0;0
95;27.12.2015;2015;12;08;Sunnuntai;0;0;0
95;27.12.2015;2015;12;09;Sunnuntai;2;0;2
95;27.12.2015;2015;12;10;Sunnuntai;1;1;2
95;27.12.2015;2015;12;11;Sunnuntai;1;3;4
95;27.12.2015;2015;12;12;Sunnuntai;3;1;4
95;27.12.2015;2015;12;13;Sunnuntai;1;1;2
95;27.12.2015;2015;12;14;Sunnuntai;2;2;4
95;27.12.2015;2015;12;15;Sunnuntai;1;2;3
95;27.12.2015;2015;12;16;Sunnuntai;2;4;6
95;27.12.2015;2015;12;17;Sunnuntai;0;0;0
95;27.12.2015;2015;12;18;Sunnuntai;1;2;3
95;27.12.2015;2015;12;19;Sunnuntai;3;2;5
95;27.12.2015;2015;12;20;Sunnuntai;1;1;2
95;27.12.2015;2015;12;21;Sunnuntai;0;1;1
95;27.12.2015;2015;12;22;Sunnuntai;1;0;1
95;27.12.2015;2015;12;23;Sunnuntai;0;0;0
95;28.12.2015;2015;12;00;Maanantai;1;0;1
95;28.12.2015;2015;12;01;Maanantai;0;0;0
95;28.12.2015;2015;12;02;Maanantai;0;0;0
95;28.12.2015;2015;12;03;Maanantai;0;0;0
95;28.12.2015;2015;12;04;Maanantai;1;1;2
95;28.12.2015;2015;12;05;Maanantai;2;2;4
95;28.12.2015;2015;12;06;Maanantai;5;2;7
95;28.12.2015;2015;12;07;Maanantai;2;3;5
95;28.12.2015;2015;12;08;Maanantai;6;1;7
95;28.12.2015;2015;12;09;Maanantai;2;0;2
95;28.12.2015;2015;12;10;Maanantai;1;0;1
95;28.12.2015;2015;12;11;Maanantai;1;2;3
95;28.12.2015;2015;12;12;Maanantai;3;0;3
95;28.12.2015;2015;12;13;Maanantai;2;1;3
95;28.12.2015;2015;12;14;Maanantai;6;5;11
95;28.12.2015;2015;12;15;Maanantai;3;4;7
95;28.12.2015;2015;12;16;Maanantai;2;4;6
95;28.12.2015;2015;12;17;Maanantai;1;1;2
95;28.12.2015;2015;12;18;Maanantai;1;0;1
95;28.12.2015;2015;12;19;Maanantai;0;3;3
95;28.12.2015;2015;12;20;Maanantai;0;2;2
95;28.12.2015;2015;12;21;Maanantai;0;0;0
95;28.12.2015;2015;12;22;Maanantai;1;2;3
95;28.12.2015;2015;12;23;Maanantai;0;0;0
95;29.12.2015;2015;12;00;Tiistai;0;0;0
95;29.12.2015;2015;12;01;Tiistai;0;0;0
95;29.12.2015;2015;12;02;Tiistai;0;0;0
95;29.12.2015;2015;12;03;Tiistai;0;0;0
95;29.12.2015;2015;12;04;Tiistai;0;0;0
95;29.12.2015;2015;12;05;Tiistai;2;2;4
95;29.12.2015;2015;12;06;Tiistai;3;2;5
95;29.12.2015;2015;12;07;Tiistai;7;3;10
95;29.12.2015;2015;12;08;Tiistai;2;1;3
95;29.12.2015;2015;12;09;Tiistai;2;1;3
95;29.12.2015;2015;12;10;Tiistai;1;1;2
95;29.12.2015;2015;12;11;Tiistai;1;2;3
95;29.12.2015;2015;12;12;Tiistai;5;1;6
95;29.12.2015;2015;12;13;Tiistai;4;1;5
95;29.12.2015;2015;12;14;Tiistai;4;0;4
95;29.12.2015;2015;12;15;Tiistai;6;6;12
95;29.12.2015;2015;12;16;Tiistai;3;9;12
95;29.12.2015;2015;12;17;Tiistai;2;3;5
95;29.12.2015;2015;12;18;Tiistai;1;4;5
95;29.12.2015;2015;12;19;Tiistai;0;0;0
95;29.12.2015;2015;12;20;Tiistai;2;3;5
95;29.12.2015;2015;12;21;Tiistai;0;1;1
95;29.12.2015;2015;12;22;Tiistai;0;1;1
95;29.12.2015;2015;12;23;Tiistai;0;0;0
95;30.12.2015;2015;12;00;Keskiviikko;0;0;0
95;30.12.2015;2015;12;01;Keskiviikko;0;0;0
95;30.12.2015;2015;12;02;Keskiviikko;0;0;0
95;30.12.2015;2015;12;03;Keskiviikko;0;0;0
95;30.12.2015;2015;12;04;Keskiviikko;0;0;0
95;30.12.2015;2015;12;05;Keskiviikko;5;3;8
95;30.12.2015;2015;12;06;Keskiviikko;6;2;8
95;30.12.2015;2015;12;07;Keskiviikko;4;0;4
95;30.12.2015;2015;12;08;Keskiviikko;2;1;3
95;30.12.2015;2015;12;09;Keskiviikko;1;1;2
95;30.12.2015;2015;12;10;Keskiviikko;3;2;5
95;30.12.2015;2015;12;11;Keskiviikko;2;1;3
95;30.12.2015;2015;12;12;Keskiviikko;3;2;5
95;30.12.2015;2015;12;13;Keskiviikko;6;4;10
95;30.12.2015;2015;12;14;Keskiviikko;2;3;5
95;30.12.2015;2015;12;15;Keskiviikko;3;12;15
95;30.12.2015;2015;12;16;Keskiviikko;1;5;6
95;30.12.2015;2015;12;17;Keskiviikko;1;4;5
95;30.12.2015;2015;12;18;Keskiviikko;1;1;2
95;30.12.2015;2015;12;19;Keskiviikko;1;2;3
95;30.12.2015;2015;12;20;Keskiviikko;2;1;3
95;30.12.2015;2015;12;21;Keskiviikko;0;2;2
95;30.12.2015;2015;12;22;Keskiviikko;1;2;3
95;30.12.2015;2015;12;23;Keskiviikko;0;0;0
95;31.12.2015;2015;12;00;Torstai;0;0;0
95;31.12.2015;2015;12;01;Torstai;0;0;0
95;31.12.2015;2015;12;02;Torstai;0;0;0
95;31.12.2015;2015;12;03;Torstai;0;0;0
95;31.12.2015;2015;12;04;Torstai;0;0;0
95;31.12.2015;2015;12;05;Torstai;5;2;7
95;31.12.2015;2015;12;06;Torstai;7;3;10
95;31.12.2015;2015;12;07;Torstai;1;1;2
95;31.12.2015;2015;12;08;Torstai;1;0;1
95;31.12.2015;2015;12;09;Torstai;2;1;3
95;31.12.2015;2015;12;10;Torstai;5;6;11
95;31.12.2015;2015;12;11;Torstai;2;3;5
95;31.12.2015;2015;12;12;Torstai;6;2;8
95;31.12.2015;2015;12;13;Torstai;6;2;8
95;31.12.2015;2015;12;14;Torstai;3;11;14
95;31.12.2015;2015;12;15;Torstai;2;4;6
95;31.12.2015;2015;12;16;Torstai;1;2;3
95;31.12.2015;2015;12;17;Torstai;3;0;3
95;31.12.2015;2015;12;18;Torstai;0;6;6
95;31.12.2015;2015;12;19;Torstai;0;1;1
95;31.12.2015;2015;12;20;Torstai;0;1;1
95;31.12.2015;2015;12;21;Torstai;0;0;0
95;31.12.2015;2015;12;22;Torstai;0;2;2
95;31.12.2015;2015;12;23;Torstai;1;0;1
95;01.01.2016;2016;01;00;Perjantai;0;0;0
95;01.01.2016;2016;01;01;Perjantai;0;0;0
95;01.01.2016;2016;01;02;Perjantai;0;0;0
95;01.01.2016;2016;01;03;Perjantai;1;0;1
95;01.01.2016;2016;01;04;Perjantai;0;0;0
95;01.01.2016;2016;01;05;Perjantai;0;0;0
95;01.01.2016;2016;01;06;Perjantai;1;0;1
95;01.01.2016;2016;01;07;Perjantai;0;0;0
95;01.01.2016;2016;01;08;Perjantai;0;0;0
95;01.01.2016;2016;01;09;Perjantai;3;1;4
95;01.01.2016;2016;01;10;Perjantai;0;0;0
95;01.01.2016;2016;01;11;Perjantai;0;1;1
95;01.01.2016;2016;01;12;Perjantai;1;2;3
95;01.01.2016;2016;01;13;Perjantai;3;1;4
95;01.01.2016;2016;01;14;Perjantai;0;2;2
95;01.01.2016;2016;01;15;Perjantai;4;4;8
95;01.01.2016;2016;01;16;Perjantai;0;4;4
95;01.01.2016;2016;01;17;Perjantai;2;1;3
95;01.01.2016;2016;01;18;Perjantai;2;0;2
95;01.01.2016;2016;01;19;Perjantai;1;2;3
95;01.01.2016;2016;01;20;Perjantai;1;0;1
95;01.01.2016;2016;01;21;Perjantai;0;0;0
95;01.01.2016;2016;01;22;Perjantai;0;0;0
95;01.01.2016;2016;01;23;Perjantai;0;0;0
95;02.01.2016;2016;01;00;Lauantai;0;0;0
95;02.01.2016;2016;01;01;Lauantai;0;0;0
95;02.01.2016;2016;01;02;Lauantai;0;0;0
95;02.01.2016;2016;01;03;Lauantai;0;0;0
95;02.01.2016;2016;01;04;Lauantai;1;0;1
95;02.01.2016;2016;01;05;Lauantai;0;0;0
95;02.01.2016;2016;01;06;Lauantai;3;0;3
95;02.01.2016;2016;01;07;Lauantai;0;0;0
95;02.01.2016;2016;01;08;Lauantai;1;2;3
95;02.01.2016;2016;01;09;Lauantai;0;0;0
95;02.01.2016;2016;01;10;Lauantai;2;2;4
95;02.01.2016;2016;01;11;Lauantai;0;1;1
95;02.01.2016;2016;01;12;Lauantai;3;0;3
95;02.01.2016;2016;01;13;Lauantai;0;1;1
95;02.01.2016;2016;01;14;Lauantai;1;0;1
95;02.01.2016;2016;01;15;Lauantai;1;1;2
95;02.01.2016;2016;01;16;Lauantai;1;4;5
95;02.01.2016;2016;01;17;Lauantai;0;0;0
95;02.01.2016;2016;01;18;Lauantai;0;1;1
95;02.01.2016;2016;01;19;Lauantai;1;1;2
95;02.01.2016;2016;01;20;Lauantai;0;0;0
95;02.01.2016;2016;01;21;Lauantai;0;0;0
95;02.01.2016;2016;01;22;Lauantai;0;1;1
95;02.01.2016;2016;01;23;Lauantai;0;0;0
95;03.01.2016;2016;01;00;Sunnuntai;0;0;0
95;03.01.2016;2016;01;01;Sunnuntai;0;0;0
95;03.01.2016;2016;01;02;Sunnuntai;0;0;0
95;03.01.2016;2016;01;03;Sunnuntai;0;0;0
95;03.01.2016;2016;01;04;Sunnuntai;2;0;2
95;03.01.2016;2016;01;05;Sunnuntai;0;0;0
95;03.01.2016;2016;01;06;Sunnuntai;1;0;1
95;03.01.2016;2016;01;07;Sunnuntai;0;2;2
95;03.01.2016;2016;01;08;Sunnuntai;0;1;1
95;03.01.2016;2016;01;09;Sunnuntai;1;0;1
95;03.01.2016;2016;01;10;Sunnuntai;2;1;3
95;03.01.2016;2016;01;11;Sunnuntai;4;3;7
95;03.01.2016;2016;01;12;Sunnuntai;4;2;6
95;03.01.2016;2016;01;13;Sunnuntai;2;3;5
95;03.01.2016;2016;01;14;Sunnuntai;1;5;6
95;03.01.2016;2016;01;15;Sunnuntai;2;4;6
95;03.01.2016;2016;01;16;Sunnuntai;0;2;2
95;03.01.2016;2016;01;17;Sunnuntai;3;0;3
95;03.01.2016;2016;01;18;Sunnuntai;1;2;3
95;03.01.2016;2016;01;19;Sunnuntai;0;0;0
95;03.01.2016;2016;01;20;Sunnuntai;0;2;2
95;03.01.2016;2016;01;21;Sunnuntai;2;0;2
95;03.01.2016;2016;01;22;Sunnuntai;0;0;0
95;03.01.2016;2016;01;23;Sunnuntai;0;0;0
95;04.01.2016;2016;01;00;Maanantai;0;0;0
95;04.01.2016;2016;01;01;Maanantai;0;0;0
95;04.01.2016;2016;01;02;Maanantai;1;0;1
95;04.01.2016;2016;01;03;Maanantai;0;0;0
95;04.01.2016;2016;01;04;Maanantai;1;1;2
95;04.01.2016;2016;01;05;Maanantai;4;4;8
95;04.01.2016;2016;01;06;Maanantai;5;6;11
95;04.01.2016;2016;01;07;Maanantai;6;4;10
95;04.01.2016;2016;01;08;Maanantai;2;4;6
95;04.01.2016;2016;01;09;Maanantai;2;1;3
95;04.01.2016;2016;01;10;Maanantai;1;0;1
95;04.01.2016;2016;01;11;Maanantai;1;1;2
95;04.01.2016;2016;01;12;Maanantai;1;2;3
95;04.01.2016;2016;01;13;Maanantai;3;3;6
95;04.01.2016;2016;01;14;Maanantai;8;2;10
95;04.01.2016;2016;01;15;Maanantai;6;3;9
95;04.01.2016;2016;01;16;Maanantai;2;8;10
95;04.01.2016;2016;01;17;Maanantai;1;4;5
95;04.01.2016;2016;01;18;Maanantai;0;1;1
95;04.01.2016;2016;01;19;Maanantai;0;1;1
95;04.01.2016;2016;01;20;Maanantai;0;0;0
95;04.01.2016;2016;01;21;Maanantai;0;1;1
95;04.01.2016;2016;01;22;Maanantai;1;0;1
95;04.01.2016;2016;01;23;Maanantai;0;0;0
95;05.01.2016;2016;01;00;Tiistai;0;0;0
95;05.01.2016;2016;01;01;Tiistai;0;0;0
95;05.01.2016;2016;01;02;Tiistai;0;0;0
95;05.01.2016;2016;01;03;Tiistai;0;0;0
95;05.01.2016;2016;01;04;Tiistai;0;0;0
95;05.01.2016;2016;01;05;Tiistai;2;6;8
95;05.01.2016;2016;01;06;Tiistai;6;3;9
95;05.01.2016;2016;01;07;Tiistai;5;4;9
95;05.01.2016;2016;01;08;Tiistai;1;2;3
95;05.01.2016;2016;01;09;Tiistai;1;2;3
95;05.01.2016;2016;01;10;Tiistai;0;1;1
95;05.01.2016;2016;01;11;Tiistai;1;0;1
95;05.01.2016;2016;01;12;Tiistai;3;0;3
95;05.01.2016;2016;01;13;Tiistai;1;1;2
95;05.01.2016;2016;01;14;Tiistai;4;3;7
95;05.01.2016;2016;01;15;Tiistai;5;3;8
95;05.01.2016;2016;01;16;Tiistai;3;3;6
95;05.01.2016;2016;01;17;Tiistai;0;3;3
95;05.01.2016;2016;01;18;Tiistai;1;5;6
95;05.01.2016;2016;01;19;Tiistai;0;1;1
95;05.01.2016;2016;01;20;Tiistai;0;1;1
95;05.01.2016;2016;01;21;Tiistai;0;1;1
95;05.01.2016;2016;01;22;Tiistai;0;0;0
95;05.01.2016;2016;01;23;Tiistai;0;0;0
95;06.01.2016;2016;01;00;Keskiviikko;0;0;0
95;06.01.2016;2016;01;01;Keskiviikko;0;0;0
95;06.01.2016;2016;01;02;Keskiviikko;0;0;0
95;06.01.2016;2016;01;03;Keskiviikko;0;0;0
95;06.01.2016;2016;01;04;Keskiviikko;0;0;0
95;06.01.2016;2016;01;05;Keskiviikko;0;2;2
95;06.01.2016;2016;01;06;Keskiviikko;0;0;0
95;06.01.2016;2016;01;07;Keskiviikko;1;0;1
95;06.01.2016;2016;01;08;Keskiviikko;0;0;0
95;06.01.2016;2016;01;09;Keskiviikko;0;0;0
95;06.01.2016;2016;01;10;Keskiviikko;0;0;0
95;06.01.2016;2016;01;11;Keskiviikko;1;0;1
95;06.01.2016;2016;01;12;Keskiviikko;0;0;0
95;06.01.2016;2016;01;13;Keskiviikko;0;1;1
95;06.01.2016;2016;01;14;Keskiviikko;3;0;3
95;06.01.2016;2016;01;15;Keskiviikko;0;0;0
95;06.01.2016;2016;01;16;Keskiviikko;1;0;1
95;06.01.2016;2016;01;17;Keskiviikko;1;1;2
95;06.01.2016;2016;01;18;Keskiviikko;0;0;0
95;06.01.2016;2016;01;19;Keskiviikko;0;0;0
95;06.01.2016;2016;01;20;Keskiviikko;0;1;1
95;06.01.2016;2016;01;21;Keskiviikko;0;0;0
95;06.01.2016;2016;01;22;Keskiviikko;0;1;1
95;06.01.2016;2016;01;23;Keskiviikko;0;0;0
95;07.01.2016;2016;01;00;Torstai;0;0;0
95;07.01.2016;2016;01;01;Torstai;0;0;0
95;07.01.2016;2016;01;02;Torstai;0;0;0
95;07.01.2016;2016;01;03;Torstai;0;0;0
95;07.01.2016;2016;01;04;Torstai;1;0;1
95;07.01.2016;2016;01;05;Torstai;1;4;5
95;07.01.2016;2016;01;06;Torstai;2;2;4
95;07.01.2016;2016;01;07;Torstai;2;5;7
95;07.01.2016;2016;01;08;Torstai;1;1;2
95;07.01.2016;2016;01;09;Torstai;1;0;1
95;07.01.2016;2016;01;10;Torstai;1;0;1
95;07.01.2016;2016;01;11;Torstai;0;0;0
95;07.01.2016;2016;01;12;Torstai;0;0;0
95;07.01.2016;2016;01;13;Torstai;0;1;1
95;07.01.2016;2016;01;14;Torstai;4;2;6
95;07.01.2016;2016;01;15;Torstai;5;1;6
95;07.01.2016;2016;01;16;Torstai;2;2;4
95;07.01.2016;2016;01;17;Torstai;0;2;2
95;07.01.2016;2016;01;18;Torstai;1;0;1
95;07.01.2016;2016;01;19;Torstai;1;0;1
95;07.01.2016;2016;01;20;Torstai;0;0;0
95;07.01.2016;2016;01;21;Torstai;0;1;1
95;07.01.2016;2016;01;22;Torstai;0;1;1
95;07.01.2016;2016;01;23;Torstai;0;0;0
95;08.01.2016;2016;01;00;Perjantai;0;0;0
95;08.01.2016;2016;01;01;Perjantai;0;0;0
95;08.01.2016;2016;01;02;Perjantai;0;0;0
95;08.01.2016;2016;01;03;Perjantai;0;0;0
95;08.01.2016;2016;01;04;Perjantai;1;0;1
95;08.01.2016;2016;01;05;Perjantai;3;3;6
95;08.01.2016;2016;01;06;Perjantai;1;2;3
95;08.01.2016;2016;01;07;Perjantai;1;1;2
95;08.01.2016;2016;01;08;Perjantai;1;2;3
95;08.01.2016;2016;01;09;Perjantai;2;0;2
95;08.01.2016;2016;01;10;Perjantai;0;1;1
95;08.01.2016;2016;01;11;Perjantai;0;0;0
95;08.01.2016;2016;01;12;Perjantai;1;0;1
95;08.01.2016;2016;01;13;Perjantai;2;2;4
95;08.01.2016;2016;01;14;Perjantai;7;1;8
95;08.01.2016;2016;01;15;Perjantai;0;0;0
95;08.01.2016;2016;01;16;Perjantai;3;3;6
95;08.01.2016;2016;01;17;Perjantai;0;0;0
95;08.01.2016;2016;01;18;Perjantai;0;2;2
95;08.01.2016;2016;01;19;Perjantai;1;0;1
95;08.01.2016;2016;01;20;Perjantai;0;2;2
95;08.01.2016;2016;01;21;Perjantai;0;1;1
95;08.01.2016;2016;01;22;Perjantai;2;0;2
95;08.01.2016;2016;01;23;Perjantai;0;0;0
95;09.01.2016;2016;01;00;Lauantai;0;0;0
95;09.01.2016;2016;01;01;Lauantai;0;0;0
95;09.01.2016;2016;01;02;Lauantai;0;0;0
95;09.01.2016;2016;01;03;Lauantai;0;0;0
95;09.01.2016;2016;01;04;Lauantai;0;0;0
95;09.01.2016;2016;01;05;Lauantai;0;0;0
95;09.01.2016;2016;01;06;Lauantai;0;0;0
95;09.01.2016;2016;01;07;Lauantai;2;1;3
95;09.01.2016;2016;01;08;Lauantai;1;0;1
95;09.01.2016;2016;01;09;Lauantai;0;0;0
95;09.01.2016;2016;01;10;Lauantai;0;0;0
95;09.01.2016;2016;01;11;Lauantai;0;0;0
95;09.01.2016;2016;01;12;Lauantai;0;1;1
95;09.01.2016;2016;01;13;Lauantai;0;0;0
95;09.01.2016;2016;01;14;Lauantai;0;1;1
95;09.01.2016;2016;01;15;Lauantai;0;0;0
95;09.01.2016;2016;01;16;Lauantai;0;2;2
95;09.01.2016;2016;01;17;Lauantai;0;1;1
95;09.01.2016;2016;01;18;Lauantai;1;2;3
95;09.01.2016;2016;01;19;Lauantai;1;2;3
95;09.01.2016;2016;01;20;Lauantai;0;0;0
95;09.01.2016;2016;01;21;Lauantai;4;0;4
95;09.01.2016;2016;01;22;Lauantai;1;0;1
95;09.01.2016;2016;01;23;Lauantai;0;2;2
95;10.01.2016;2016;01;00;Sunnuntai;0;0;0
95;10.01.2016;2016;01;01;Sunnuntai;0;0;0
95;10.01.2016;2016;01;02;Sunnuntai;0;0;0
95;10.01.2016;2016;01;03;Sunnuntai;0;0;0
95;10.01.2016;2016;01;04;Sunnuntai;0;0;0
95;10.01.2016;2016;01;05;Sunnuntai;0;0;0
95;10.01.2016;2016;01;06;Sunnuntai;0;0;0
95;10.01.2016;2016;01;07;Sunnuntai;0;0;0
95;10.01.2016;2016;01;08;Sunnuntai;0;0;0
95;10.01.2016;2016;01;09;Sunnuntai;2;0;2
95;10.01.2016;2016;01;10;Sunnuntai;1;1;2
95;10.01.2016;2016;01;11;Sunnuntai;1;0;1
95;10.01.2016;2016;01;12;Sunnuntai;3;5;8
95;10.01.2016;2016;01;13;Sunnuntai;0;1;1
95;10.01.2016;2016;01;14;Sunnuntai;4;3;7
95;10.01.2016;2016;01;15;Sunnuntai;0;1;1
95;10.01.2016;2016;01;16;Sunnuntai;1;1;2
95;10.01.2016;2016;01;17;Sunnuntai;3;2;5
95;10.01.2016;2016;01;18;Sunnuntai;0;5;5
95;10.01.2016;2016;01;19;Sunnuntai;1;0;1
95;10.01.2016;2016;01;20;Sunnuntai;1;0;1
95;10.01.2016;2016;01;21;Sunnuntai;1;2;3
95;10.01.2016;2016;01;22;Sunnuntai;1;0;1
95;10.01.2016;2016;01;23;Sunnuntai;0;0;0
95;11.01.2016;2016;01;00;Maanantai;0;0;0
95;11.01.2016;2016;01;01;Maanantai;0;0;0
95;11.01.2016;2016;01;02;Maanantai;0;0;0
95;11.01.2016;2016;01;03;Maanantai;0;0;0
95;11.01.2016;2016;01;04;Maanantai;1;0;1
95;11.01.2016;2016;01;05;Maanantai;2;2;4
95;11.01.2016;2016;01;06;Maanantai;5;3;8
95;11.01.2016;2016;01;07;Maanantai;8;7;15
95;11.01.2016;2016;01;08;Maanantai;1;5;6
95;11.01.2016;2016;01;09;Maanantai;2;3;5
95;11.01.2016;2016;01;10;Maanantai;2;3;5
95;11.01.2016;2016;01;11;Maanantai;1;1;2
95;11.01.2016;2016;01;12;Maanantai;1;0;1
95;11.01.2016;2016;01;13;Maanantai;1;3;4
95;11.01.2016;2016;01;14;Maanantai;8;3;11
95;11.01.2016;2016;01;15;Maanantai;11;2;13
95;11.01.2016;2016;01;16;Maanantai;6;8;14
95;11.01.2016;2016;01;17;Maanantai;1;4;5
95;11.01.2016;2016;01;18;Maanantai;3;2;5
95;11.01.2016;2016;01;19;Maanantai;1;0;1
95;11.01.2016;2016;01;20;Maanantai;1;1;2
95;11.01.2016;2016;01;21;Maanantai;0;0;0
95;11.01.2016;2016;01;22;Maanantai;3;2;5
95;11.01.2016;2016;01;23;Maanantai;0;0;0
95;12.01.2016;2016;01;00;Tiistai;0;0;0
95;12.01.2016;2016;01;01;Tiistai;0;0;0
95;12.01.2016;2016;01;02;Tiistai;0;0;0
95;12.01.2016;2016;01;03;Tiistai;0;0;0
95;12.01.2016;2016;01;04;Tiistai;1;0;1
95;12.01.2016;2016;01;05;Tiistai;1;2;3
95;12.01.2016;2016;01;06;Tiistai;8;3;11
95;12.01.2016;2016;01;07;Tiistai;7;4;11
95;12.01.2016;2016;01;08;Tiistai;3;4;7
95;12.01.2016;2016;01;09;Tiistai;2;4;6
95;12.01.2016;2016;01;10;Tiistai;1;0;1
95;12.01.2016;2016;01;11;Tiistai;0;0;0
95;12.01.2016;2016;01;12;Tiistai;2;1;3
95;12.01.2016;2016;01;13;Tiistai;3;5;8
95;12.01.2016;2016;01;14;Tiistai;0;2;2
95;12.01.2016;2016;01;15;Tiistai;7;2;9
95;12.01.2016;2016;01;16;Tiistai;5;8;13
95;12.01.2016;2016;01;17;Tiistai;0;6;6
95;12.01.2016;2016;01;18;Tiistai;1;2;3
95;12.01.2016;2016;01;19;Tiistai;0;1;1
95;12.01.2016;2016;01;20;Tiistai;1;2;3
95;12.01.2016;2016;01;21;Tiistai;1;0;1
95;12.01.2016;2016;01;22;Tiistai;3;1;4
95;12.01.2016;2016;01;23;Tiistai;0;0;0
95;13.01.2016;2016;01;00;Keskiviikko;0;0;0
95;13.01.2016;2016;01;01;Keskiviikko;0;0;0
95;13.01.2016;2016;01;02;Keskiviikko;0;0;0
95;13.01.2016;2016;01;03;Keskiviikko;0;0;0
95;13.01.2016;2016;01;04;Keskiviikko;1;0;1
95;13.01.2016;2016;01;05;Keskiviikko;1;0;1
95;13.01.2016;2016;01;06;Keskiviikko;6;2;8
95;13.01.2016;2016;01;07;Keskiviikko;3;6;9
95;13.01.2016;2016;01;08;Keskiviikko;4;4;8
95;13.01.2016;2016;01;09;Keskiviikko;2;3;5
95;13.01.2016;2016;01;10;Keskiviikko;1;0;1
95;13.01.2016;2016;01;11;Keskiviikko;6;1;7
95;13.01.2016;2016;01;12;Keskiviikko;0;2;2
95;13.01.2016;2016;01;13;Keskiviikko;1;5;6
95;13.01.2016;2016;01;14;Keskiviikko;2;1;3
95;13.01.2016;2016;01;15;Keskiviikko;4;4;8
95;13.01.2016;2016;01;16;Keskiviikko;3;5;8
95;13.01.2016;2016;01;17;Keskiviikko;2;5;7
95;13.01.2016;2016;01;18;Keskiviikko;0;1;1
95;13.01.2016;2016;01;19;Keskiviikko;0;3;3
95;13.01.2016;2016;01;20;Keskiviikko;2;1;3
95;13.01.2016;2016;01;21;Keskiviikko;1;0;1
95;13.01.2016;2016;01;22;Keskiviikko;3;0;3
95;13.01.2016;2016;01;23;Keskiviikko;0;0;0
95;14.01.2016;2016;01;00;Torstai;0;0;0
95;14.01.2016;2016;01;01;Torstai;0;0;0
95;14.01.2016;2016;01;02;Torstai;1;1;2
95;14.01.2016;2016;01;03;Torstai;0;0;0
95;14.01.2016;2016;01;04;Torstai;1;0;1
95;14.01.2016;2016;01;05;Torstai;1;0;1
95;14.01.2016;2016;01;06;Torstai;4;1;5
95;14.01.2016;2016;01;07;Torstai;3;5;8
95;14.01.2016;2016;01;08;Torstai;2;5;7
95;14.01.2016;2016;01;09;Torstai;3;1;4
95;14.01.2016;2016;01;10;Torstai;2;2;4
95;14.01.2016;2016;01;11;Torstai;2;4;6
95;14.01.2016;2016;01;12;Torstai;2;1;3
95;14.01.2016;2016;01;13;Torstai;2;4;6
95;14.01.2016;2016;01;14;Torstai;1;7;8
95;14.01.2016;2016;01;15;Torstai;8;0;8
95;14.01.2016;2016;01;16;Torstai;6;8;14
95;14.01.2016;2016;01;17;Torstai;1;2;3
95;14.01.2016;2016;01;18;Torstai;2;0;2
95;14.01.2016;2016;01;19;Torstai;1;0;1
95;14.01.2016;2016;01;20;Torstai;3;4;7
95;14.01.2016;2016;01;21;Torstai;1;2;3
95;14.01.2016;2016;01;22;Torstai;2;2;4
95;14.01.2016;2016;01;23;Torstai;0;0;0
95;15.01.2016;2016;01;00;Perjantai;0;0;0
95;15.01.2016;2016;01;01;Perjantai;0;0;0
95;15.01.2016;2016;01;02;Perjantai;0;0;0
95;15.01.2016;2016;01;03;Perjantai;0;0;0
95;15.01.2016;2016;01;04;Perjantai;1;0;1
95;15.01.2016;2016;01;05;Perjantai;1;2;3
95;15.01.2016;2016;01;06;Perjantai;6;3;9
95;15.01.2016;2016;01;07;Perjantai;4;4;8
95;15.01.2016;2016;01;08;Perjantai;1;5;6
95;15.01.2016;2016;01;09;Perjantai;0;0;0
95;15.01.2016;2016;01;10;Perjantai;2;2;4
95;15.01.2016;2016;01;11;Perjantai;1;1;2
95;15.01.2016;2016;01;12;Perjantai;2;2;4
95;15.01.2016;2016;01;13;Perjantai;1;2;3
95;15.01.2016;2016;01;14;Perjantai;7;3;10
95;15.01.2016;2016;01;15;Perjantai;3;2;5
95;15.01.2016;2016;01;16;Perjantai;3;5;8
95;15.01.2016;2016;01;17;Perjantai;2;4;6
95;15.01.2016;2016;01;18;Perjantai;0;0;0
95;15.01.2016;2016;01;19;Perjantai;2;0;2
95;15.01.2016;2016;01;20;Perjantai;1;1;2
95;15.01.2016;2016;01;21;Perjantai;0;1;1
95;15.01.2016;2016;01;22;Perjantai;1;3;4
95;15.01.2016;2016;01;23;Perjantai;0;0;0
95;16.01.2016;2016;01;00;Lauantai;0;0;0
95;16.01.2016;2016;01;01;Lauantai;0;0;0
95;16.01.2016;2016;01;02;Lauantai;0;0;0
95;16.01.2016;2016;01;03;Lauantai;0;0;0
95;16.01.2016;2016;01;04;Lauantai;0;0;0
95;16.01.2016;2016;01;05;Lauantai;0;1;1
95;16.01.2016;2016;01;06;Lauantai;1;0;1
95;16.01.2016;2016;01;07;Lauantai;0;0;0
95;16.01.2016;2016;01;08;Lauantai;1;1;2
95;16.01.2016;2016;01;09;Lauantai;0;0;0
95;16.01.2016;2016;01;10;Lauantai;1;2;3
95;16.01.2016;2016;01;11;Lauantai;1;1;2
95;16.01.2016;2016;01;12;Lauantai;1;0;1
95;16.01.2016;2016;01;13;Lauantai;2;1;3
95;16.01.2016;2016;01;14;Lauantai;2;4;6
95;16.01.2016;2016;01;15;Lauantai;2;0;2
95;16.01.2016;2016;01;16;Lauantai;1;2;3
95;16.01.2016;2016;01;17;Lauantai;1;3;4
95;16.01.2016;2016;01;18;Lauantai;1;1;2
95;16.01.2016;2016;01;19;Lauantai;2;1;3
95;16.01.2016;2016;01;20;Lauantai;0;0;0
95;16.01.2016;2016;01;21;Lauantai;0;1;1
95;16.01.2016;2016;01;22;Lauantai;0;0;0
95;16.01.2016;2016;01;23;Lauantai;0;0;0
95;17.01.2016;2016;01;00;Sunnuntai;0;0;0
95;17.01.2016;2016;01;01;Sunnuntai;0;0;0
95;17.01.2016;2016;01;02;Sunnuntai;0;0;0
95;17.01.2016;2016;01;03;Sunnuntai;0;0;0
95;17.01.2016;2016;01;04;Sunnuntai;0;0;0
95;17.01.2016;2016;01;05;Sunnuntai;0;0;0
95;17.01.2016;2016;01;06;Sunnuntai;1;1;2
95;17.01.2016;2016;01;07;Sunnuntai;1;1;2
95;17.01.2016;2016;01;08;Sunnuntai;0;1;1
95;17.01.2016;2016;01;09;Sunnuntai;0;0;0
95;17.01.2016;2016;01;10;Sunnuntai;0;0;0
95;17.01.2016;2016;01;11;Sunnuntai;0;0;0
95;17.01.2016;2016;01;12;Sunnuntai;0;1;1
95;17.01.2016;2016;01;13;Sunnuntai;0;2;2
95;17.01.2016;2016;01;14;Sunnuntai;1;0;1
95;17.01.2016;2016;01;15;Sunnuntai;0;1;1
95;17.01.2016;2016;01;16;Sunnuntai;0;0;0
95;17.01.2016;2016;01;17;Sunnuntai;0;0;0
95;17.01.2016;2016;01;18;Sunnuntai;0;1;1
95;17.01.2016;2016;01;19;Sunnuntai;2;0;2
95;17.01.2016;2016;01;20;Sunnuntai;0;0;0
95;17.01.2016;2016;01;21;Sunnuntai;0;0;0
95;17.01.2016;2016;01;22;Sunnuntai;1;0;1
95;17.01.2016;2016;01;23;Sunnuntai;0;0;0
95;18.01.2016;2016;01;00;Maanantai;0;0;0
95;18.01.2016;2016;01;01;Maanantai;0;0;0
95;18.01.2016;2016;01;02;Maanantai;0;0;0
95;18.01.2016;2016;01;03;Maanantai;0;0;0
95;18.01.2016;2016;01;04;Maanantai;1;0;1
95;18.01.2016;2016;01;05;Maanantai;1;4;5
95;18.01.2016;2016;01;06;Maanantai;5;2;7
95;18.01.2016;2016;01;07;Maanantai;4;1;5
95;18.01.2016;2016;01;08;Maanantai;0;4;4
95;18.01.2016;2016;01;09;Maanantai;1;0;1
95;18.01.2016;2016;01;10;Maanantai;0;2;2
95;18.01.2016;2016;01;11;Maanantai;0;1;1
95;18.01.2016;2016;01;12;Maanantai;0;0;0
95;18.01.2016;2016;01;13;Maanantai;0;0;0
95;18.01.2016;2016;01;14;Maanantai;7;3;10
95;18.01.2016;2016;01;15;Maanantai;2;3;5
95;18.01.2016;2016;01;16;Maanantai;2;5;7
95;18.01.2016;2016;01;17;Maanantai;1;1;2
95;18.01.2016;2016;01;18;Maanantai;1;1;2
95;18.01.2016;2016;01;19;Maanantai;0;0;0
95;18.01.2016;2016;01;20;Maanantai;1;1;2
95;18.01.2016;2016;01;21;Maanantai;1;0;1
95;18.01.2016;2016;01;22;Maanantai;1;0;1
95;18.01.2016;2016;01;23;Maanantai;0;0;0
95;19.01.2016;2016;01;00;Tiistai;0;0;0
95;19.01.2016;2016;01;01;Tiistai;0;0;0
95;19.01.2016;2016;01;02;Tiistai;0;0;0
95;19.01.2016;2016;01;03;Tiistai;0;0;0
95;19.01.2016;2016;01;04;Tiistai;1;0;1
95;19.01.2016;2016;01;05;Tiistai;1;4;5
95;19.01.2016;2016;01;06;Tiistai;2;0;2
95;19.01.2016;2016;01;07;Tiistai;1;2;3
95;19.01.2016;2016;01;08;Tiistai;0;1;1
95;19.01.2016;2016;01;09;Tiistai;2;1;3
95;19.01.2016;2016;01;10;Tiistai;0;0;0
95;19.01.2016;2016;01;11;Tiistai;0;0;0
95;19.01.2016;2016;01;12;Tiistai;1;0;1
95;19.01.2016;2016;01;13;Tiistai;1;0;1
95;19.01.2016;2016;01;14;Tiistai;6;2;8
95;19.01.2016;2016;01;15;Tiistai;0;2;2
95;19.01.2016;2016;01;16;Tiistai;1;1;2
95;19.01.2016;2016;01;17;Tiistai;0;2;2
95;19.01.2016;2016;01;18;Tiistai;0;0;0
95;19.01.2016;2016;01;19;Tiistai;0;0;0
95;19.01.2016;2016;01;20;Tiistai;0;0;0
95;19.01.2016;2016;01;21;Tiistai;0;0;0
95;19.01.2016;2016;01;22;Tiistai;0;0;0
95;19.01.2016;2016;01;23;Tiistai;0;0;0
95;20.01.2016;2016;01;00;Keskiviikko;0;0;0
95;20.01.2016;2016;01;01;Keskiviikko;0;0;0
95;20.01.2016;2016;01;02;Keskiviikko;0;0;0
95;20.01.2016;2016;01;03;Keskiviikko;0;0;0
95;20.01.2016;2016;01;04;Keskiviikko;1;0;1
95;20.01.2016;2016;01;05;Keskiviikko;1;5;6
95;20.01.2016;2016;01;06;Keskiviikko;3;1;4
95;20.01.2016;2016;01;07;Keskiviikko;1;3;4
95;20.01.2016;2016;01;08;Keskiviikko;2;2;4
95;20.01.2016;2016;01;09;Keskiviikko;1;1;2
95;20.01.2016;2016;01;10;Keskiviikko;0;0;0
95;20.01.2016;2016;01;11;Keskiviikko;0;0;0
95;20.01.2016;2016;01;12;Keskiviikko;0;0;0
95;20.01.2016;2016;01;13;Keskiviikko;2;1;3
95;20.01.2016;2016;01;14;Keskiviikko;6;1;7
95;20.01.2016;2016;01;15;Keskiviikko;3;1;4
95;20.01.2016;2016;01;16;Keskiviikko;2;2;4
95;20.01.2016;2016;01;17;Keskiviikko;2;1;3
95;20.01.2016;2016;01;18;Keskiviikko;0;2;2
95;20.01.2016;2016;01;19;Keskiviikko;0;1;1
95;20.01.2016;2016;01;20;Keskiviikko;0;0;0
95;20.01.2016;2016;01;21;Keskiviikko;0;0;0
95;20.01.2016;2016;01;22;Keskiviikko;0;0;0
95;20.01.2016;2016;01;23;Keskiviikko;0;0;0
95;21.01.2016;2016;01;00;Torstai;0;0;0
95;21.01.2016;2016;01;01;Torstai;0;0;0
95;21.01.2016;2016;01;02;Torstai;0;0;0
95;21.01.2016;2016;01;03;Torstai;0;0;0
95;21.01.2016;2016;01;04;Torstai;1;0;1
95;21.01.2016;2016;01;05;Torstai;1;4;5
95;21.01.2016;2016;01;06;Torstai;2;2;4
95;21.01.2016;2016;01;07;Torstai;3;2;5
95;21.01.2016;2016;01;08;Torstai;1;3;4
95;21.01.2016;2016;01;09;Torstai;0;0;0
95;21.01.2016;2016;01;10;Torstai;0;0;0
95;21.01.2016;2016;01;11;Torstai;0;0;0
95;21.01.2016;2016;01;12;Torstai;0;0;0
95;21.01.2016;2016;01;13;Torstai;0;0;0
95;21.01.2016;2016;01;14;Torstai;8;2;10
95;21.01.2016;2016;01;15;Torstai;2;1;3
95;21.01.2016;2016;01;16;Torstai;4;3;7
95;21.01.2016;2016;01;17;Torstai;0;2;2
95;21.01.2016;2016;01;18;Torstai;1;0;1
95;21.01.2016;2016;01;19;Torstai;0;0;0
95;21.01.2016;2016;01;20;Torstai;0;0;0
95;21.01.2016;2016;01;21;Torstai;0;0;0
95;21.01.2016;2016;01;22;Torstai;0;0;0
95;21.01.2016;2016;01;23;Torstai;0;0;0
95;22.01.2016;2016;01;00;Perjantai;0;0;0
95;22.01.2016;2016;01;01;Perjantai;0;0;0
95;22.01.2016;2016;01;02;Perjantai;0;0;0
95;22.01.2016;2016;01;03;Perjantai;0;0;0
95;22.01.2016;2016;01;04;Perjantai;1;0;1
95;22.01.2016;2016;01;05;Perjantai;2;6;8
95;22.01.2016;2016;01;06;Perjantai;6;0;6
95;22.01.2016;2016;01;07;Perjantai;3;1;4
95;22.01.2016;2016;01;08;Perjantai;4;3;7
95;22.01.2016;2016;01;09;Perjantai;2;0;2
95;22.01.2016;2016;01;10;Perjantai;1;4;5
95;22.01.2016;2016;01;11;Perjantai;2;0;2
95;22.01.2016;2016;01;12;Perjantai;3;2;5
95;22.01.2016;2016;01;13;Perjantai;1;0;1
95;22.01.2016;2016;01;14;Perjantai;5;3;8
95;22.01.2016;2016;01;15;Perjantai;1;3;4
95;22.01.2016;2016;01;16;Perjantai;2;6;8
95;22.01.2016;2016;01;17;Perjantai;2;4;6
95;22.01.2016;2016;01;18;Perjantai;1;2;3
95;22.01.2016;2016;01;19;Perjantai;0;1;1
95;22.01.2016;2016;01;20;Perjantai;1;2;3
95;22.01.2016;2016;01;21;Perjantai;3;0;3
95;22.01.2016;2016;01;22;Perjantai;0;3;3
95;22.01.2016;2016;01;23;Perjantai;0;0;0
95;23.01.2016;2016;01;00;Lauantai;1;0;1
95;23.01.2016;2016;01;01;Lauantai;0;0;0
95;23.01.2016;2016;01;02;Lauantai;0;0;0
95;23.01.2016;2016;01;03;Lauantai;0;0;0
95;23.01.2016;2016;01;04;Lauantai;2;0;2
95;23.01.2016;2016;01;05;Lauantai;0;3;3
95;23.01.2016;2016;01;06;Lauantai;2;0;2
95;23.01.2016;2016;01;07;Lauantai;1;1;2
95;23.01.2016;2016;01;08;Lauantai;0;0;0
95;23.01.2016;2016;01;09;Lauantai;3;0;3
95;23.01.2016;2016;01;10;Lauantai;2;1;3
95;23.01.2016;2016;01;11;Lauantai;1;7;8
95;23.01.2016;2016;01;12;Lauantai;2;3;5
95;23.01.2016;2016;01;13;Lauantai;7;2;9
95;23.01.2016;2016;01;14;Lauantai;5;6;11
95;23.01.2016;2016;01;15;Lauantai;3;4;7
95;23.01.2016;2016;01;16;Lauantai;1;7;8
95;23.01.2016;2016;01;17;Lauantai;2;1;3
95;23.01.2016;2016;01;18;Lauantai;5;3;8
95;23.01.2016;2016;01;19;Lauantai;0;1;1
95;23.01.2016;2016;01;20;Lauantai;2;2;4
95;23.01.2016;2016;01;21;Lauantai;1;0;1
95;23.01.2016;2016;01;22;Lauantai;1;1;2
95;23.01.2016;2016;01;23;Lauantai;1;0;1
95;24.01.2016;2016;01;00;Sunnuntai;0;0;0
95;24.01.2016;2016;01;01;Sunnuntai;1;0;1
95;24.01.2016;2016;01;02;Sunnuntai;0;0;0
95;24.01.2016;2016;01;03;Sunnuntai;0;0;0
95;24.01.2016;2016;01;04;Sunnuntai;1;0;1
95;24.01.2016;2016;01;05;Sunnuntai;0;2;2
95;24.01.2016;2016;01;06;Sunnuntai;1;1;2
95;24.01.2016;2016;01;07;Sunnuntai;1;1;2
95;24.01.2016;2016;01;08;Sunnuntai;2;2;4
95;24.01.2016;2016;01;09;Sunnuntai;1;1;2
95;24.01.2016;2016;01;10;Sunnuntai;2;1;3
95;24.01.2016;2016;01;11;Sunnuntai;7;2;9
95;24.01.2016;2016;01;12;Sunnuntai;6;1;7
95;24.01.2016;2016;01;13;Sunnuntai;1;1;2
95;24.01.2016;2016;01;14;Sunnuntai;4;2;6
95;24.01.2016;2016;01;15;Sunnuntai;1;1;2
95;24.01.2016;2016;01;16;Sunnuntai;1;3;4
95;24.01.2016;2016;01;17;Sunnuntai;0;0;0
95;24.01.2016;2016;01;18;Sunnuntai;1;1;2
95;24.01.2016;2016;01;19;Sunnuntai;2;1;3
95;24.01.2016;2016;01;20;Sunnuntai;1;2;3
95;24.01.2016;2016;01;21;Sunnuntai;0;1;1
95;24.01.2016;2016;01;22;Sunnuntai;0;2;2
95;24.01.2016;2016;01;23;Sunnuntai;0;0;0
95;25.01.2016;2016;01;00;Maanantai;0;0;0
95;25.01.2016;2016;01;01;Maanantai;0;0;0
95;25.01.2016;2016;01;02;Maanantai;0;0;0
95;25.01.2016;2016;01;03;Maanantai;0;0;0
95;25.01.2016;2016;01;04;Maanantai;2;0;2
95;25.01.2016;2016;01;05;Maanantai;5;3;8
95;25.01.2016;2016;01;06;Maanantai;10;6;16
95;25.01.2016;2016;01;07;Maanantai;4;8;12
95;25.01.2016;2016;01;08;Maanantai;6;5;11
95;25.01.2016;2016;01;09;Maanantai;1;6;7
95;25.01.2016;2016;01;10;Maanantai;4;4;8
95;25.01.2016;2016;01;11;Maanantai;3;2;5
95;25.01.2016;2016;01;12;Maanantai;4;1;5
95;25.01.2016;2016;01;13;Maanantai;5;4;9
95;25.01.2016;2016;01;14;Maanantai;9;10;19
95;25.01.2016;2016;01;15;Maanantai;12;7;19
95;25.01.2016;2016;01;16;Maanantai;16;13;29
95;25.01.2016;2016;01;17;Maanantai;5;4;9
95;25.01.2016;2016;01;18;Maanantai;3;1;4
95;25.01.2016;2016;01;19;Maanantai;3;4;7
95;25.01.2016;2016;01;20;Maanantai;5;2;7
95;25.01.2016;2016;01;21;Maanantai;0;1;1
95;25.01.2016;2016;01;22;Maanantai;2;2;4
95;25.01.2016;2016;01;23;Maanantai;0;1;1
95;26.01.2016;2016;01;00;Tiistai;0;0;0
95;26.01.2016;2016;01;01;Tiistai;0;0;0
95;26.01.2016;2016;01;02;Tiistai;0;0;0
95;26.01.2016;2016;01;03;Tiistai;0;0;0
95;26.01.2016;2016;01;04;Tiistai;0;0;0
95;26.01.2016;2016;01;05;Tiistai;2;2;4
95;26.01.2016;2016;01;06;Tiistai;6;7;13
95;26.01.2016;2016;01;07;Tiistai;9;11;20
95;26.01.2016;2016;01;08;Tiistai;2;1;3
95;26.01.2016;2016;01;09;Tiistai;3;1;4
95;26.01.2016;2016;01;10;Tiistai;0;0;0
95;26.01.2016;2016;01;11;Tiistai;2;3;5
95;26.01.2016;2016;01;12;Tiistai;2;0;2
95;26.01.2016;2016;01;13;Tiistai;3;0;3
95;26.01.2016;2016;01;14;Tiistai;3;3;6
95;26.01.2016;2016;01;15;Tiistai;3;4;7
95;26.01.2016;2016;01;16;Tiistai;3;7;10
95;26.01.2016;2016;01;17;Tiistai;5;5;10
95;26.01.2016;2016;01;18;Tiistai;0;0;0
95;26.01.2016;2016;01;19;Tiistai;1;0;1
95;26.01.2016;2016;01;20;Tiistai;2;2;4
95;26.01.2016;2016;01;21;Tiistai;0;0;0
95;26.01.2016;2016;01;22;Tiistai;1;3;4
95;26.01.2016;2016;01;23;Tiistai;0;0;0
95;27.01.2016;2016;01;00;Keskiviikko;0;0;0
95;27.01.2016;2016;01;01;Keskiviikko;0;0;0
95;27.01.2016;2016;01;02;Keskiviikko;0;0;0
95;27.01.2016;2016;01;03;Keskiviikko;0;0;0
95;27.01.2016;2016;01;04;Keskiviikko;0;0;0
95;27.01.2016;2016;01;05;Keskiviikko;4;2;6
95;27.01.2016;2016;01;06;Keskiviikko;9;5;14
95;27.01.2016;2016;01;07;Keskiviikko;8;12;20
95;27.01.2016;2016;01;08;Keskiviikko;4;8;12
95;27.01.2016;2016;01;09;Keskiviikko;7;4;11
95;27.01.2016;2016;01;10;Keskiviikko;2;4;6
95;27.01.2016;2016;01;11;Keskiviikko;2;1;3
95;27.01.2016;2016;01;12;Keskiviikko;7;2;9
95;27.01.2016;2016;01;13;Keskiviikko;8;5;13
95;27.01.2016;2016;01;14;Keskiviikko;5;4;9
95;27.01.2016;2016;01;15;Keskiviikko;7;6;13
95;27.01.2016;2016;01;16;Keskiviikko;8;13;21
95;27.01.2016;2016;01;17;Keskiviikko;6;12;18
95;27.01.2016;2016;01;18;Keskiviikko;6;3;9
95;27.01.2016;2016;01;19;Keskiviikko;1;1;2
95;27.01.2016;2016;01;20;Keskiviikko;1;2;3
95;27.01.2016;2016;01;21;Keskiviikko;2;2;4
95;27.01.2016;2016;01;22;Keskiviikko;2;2;4
95;27.01.2016;2016;01;23;Keskiviikko;0;0;0
95;28.01.2016;2016;01;00;Torstai;0;0;0
95;28.01.2016;2016;01;01;Torstai;0;0;0
95;28.01.2016;2016;01;02;Torstai;0;0;0
95;28.01.2016;2016;01;03;Torstai;0;1;1
95;28.01.2016;2016;01;04;Torstai;0;0;0
95;28.01.2016;2016;01;05;Torstai;2;1;3
95;28.01.2016;2016;01;06;Torstai;11;5;16
95;28.01.2016;2016;01;07;Torstai;6;8;14
95;28.01.2016;2016;01;08;Torstai;9;1;10
95;28.01.2016;2016;01;09;Torstai;2;3;5
95;28.01.2016;2016;01;10;Torstai;0;1;1
95;28.01.2016;2016;01;11;Torstai;4;1;5
95;28.01.2016;2016;01;12;Torstai;4;3;7
95;28.01.2016;2016;01;13;Torstai;0;1;1
95;28.01.2016;2016;01;14;Torstai;9;5;14
95;28.01.2016;2016;01;15;Torstai;7;6;13
95;28.01.2016;2016;01;16;Torstai;15;9;24
95;28.01.2016;2016;01;17;Torstai;3;7;10
95;28.01.2016;2016;01;18;Torstai;3;2;5
95;28.01.2016;2016;01;19;Torstai;1;2;3
95;28.01.2016;2016;01;20;Torstai;1;2;3
95;28.01.2016;2016;01;21;Torstai;4;2;6
95;28.01.2016;2016;01;22;Torstai;1;1;2
95;28.01.2016;2016;01;23;Torstai;0;0;0
95;29.01.2016;2016;01;00;Perjantai;0;0;0
95;29.01.2016;2016;01;01;Perjantai;0;0;0
95;29.01.2016;2016;01;02;Perjantai;0;0;0
95;29.01.2016;2016;01;03;Perjantai;0;0;0
95;29.01.2016;2016;01;04;Perjantai;2;0;2
95;29.01.2016;2016;01;05;Perjantai;3;5;8
95;29.01.2016;2016;01;06;Perjantai;5;3;8
95;29.01.2016;2016;01;07;Perjantai;4;9;13
95;29.01.2016;2016;01;08;Perjantai;2;3;5
95;29.01.2016;2016;01;09;Perjantai;0;2;2
95;29.01.2016;2016;01;10;Perjantai;9;0;9
95;29.01.2016;2016;01;11;Perjantai;3;4;7
95;29.01.2016;2016;01;12;Perjantai;1;1;2
95;29.01.2016;2016;01;13;Perjantai;4;5;9
95;29.01.2016;2016;01;14;Perjantai;11;8;19
95;29.01.2016;2016;01;15;Perjantai;6;2;8
95;29.01.2016;2016;01;16;Perjantai;10;6;16
95;29.01.2016;2016;01;17;Perjantai;3;4;7
95;29.01.2016;2016;01;18;Perjantai;0;1;1
95;29.01.2016;2016;01;19;Perjantai;6;3;9
95;29.01.2016;2016;01;20;Perjantai;1;1;2
95;29.01.2016;2016;01;21;Perjantai;0;0;0
95;29.01.2016;2016;01;22;Perjantai;0;2;2
95;29.01.2016;2016;01;23;Perjantai;0;0;0
95;30.01.2016;2016;01;00;Lauantai;0;0;0
95;30.01.2016;2016;01;01;Lauantai;0;1;1
95;30.01.2016;2016;01;02;Lauantai;0;0;0
95;30.01.2016;2016;01;03;Lauantai;0;0;0
95;30.01.2016;2016;01;04;Lauantai;0;0;0
95;30.01.2016;2016;01;05;Lauantai;1;1;2
95;30.01.2016;2016;01;06;Lauantai;1;2;3
95;30.01.2016;2016;01;07;Lauantai;1;0;1
95;30.01.2016;2016;01;08;Lauantai;1;0;1
95;30.01.2016;2016;01;09;Lauantai;0;2;2
95;30.01.2016;2016;01;10;Lauantai;1;2;3
95;30.01.2016;2016;01;11;Lauantai;2;4;6
95;30.01.2016;2016;01;12;Lauantai;5;6;11
95;30.01.2016;2016;01;13;Lauantai;2;1;3
95;30.01.2016;2016;01;14;Lauantai;5;5;10
95;30.01.2016;2016;01;15;Lauantai;7;5;12
95;30.01.2016;2016;01;16;Lauantai;0;2;2
95;30.01.2016;2016;01;17;Lauantai;4;4;8
95;30.01.2016;2016;01;18;Lauantai;1;0;1
95;30.01.2016;2016;01;19;Lauantai;1;2;3
95;30.01.2016;2016;01;20;Lauantai;0;0;0
95;30.01.2016;2016;01;21;Lauantai;1;0;1
95;30.01.2016;2016;01;22;Lauantai;0;3;3
95;30.01.2016;2016;01;23;Lauantai;0;0;0
95;31.01.2016;2016;01;00;Sunnuntai;1;0;1
95;31.01.2016;2016;01;01;Sunnuntai;0;0;0
95;31.01.2016;2016;01;02;Sunnuntai;0;0;0
95;31.01.2016;2016;01;03;Sunnuntai;4;1;5
95;31.01.2016;2016;01;04;Sunnuntai;0;0;0
95;31.01.2016;2016;01;05;Sunnuntai;1;1;2
95;31.01.2016;2016;01;06;Sunnuntai;0;1;1
95;31.01.2016;2016;01;07;Sunnuntai;0;0;0
95;31.01.2016;2016;01;08;Sunnuntai;2;2;4
95;31.01.2016;2016;01;09;Sunnuntai;1;3;4
95;31.01.2016;2016;01;10;Sunnuntai;0;2;2
95;31.01.2016;2016;01;11;Sunnuntai;1;1;2
95;31.01.2016;2016;01;12;Sunnuntai;3;2;5
95;31.01.2016;2016;01;13;Sunnuntai;2;1;3
95;31.01.2016;2016;01;14;Sunnuntai;5;6;11
95;31.01.2016;2016;01;15;Sunnuntai;2;6;8
95;31.01.2016;2016;01;16;Sunnuntai;5;2;7
95;31.01.2016;2016;01;17;Sunnuntai;2;1;3
95;31.01.2016;2016;01;18;Sunnuntai;1;0;1
95;31.01.2016;2016;01;19;Sunnuntai;1;0;1
95;31.01.2016;2016;01;20;Sunnuntai;2;3;5
95;31.01.2016;2016;01;21;Sunnuntai;2;0;2
95;31.01.2016;2016;01;22;Sunnuntai;1;3;4
95;31.01.2016;2016;01;23;Sunnuntai;0;0;0
95;01.02.2016;2016;02;00;Maanantai;0;0;0
95;01.02.2016;2016;02;01;Maanantai;1;0;1
95;01.02.2016;2016;02;02;Maanantai;0;0;0
95;01.02.2016;2016;02;03;Maanantai;0;0;0
95;01.02.2016;2016;02;04;Maanantai;1;1;2
95;01.02.2016;2016;02;05;Maanantai;4;3;7
95;01.02.2016;2016;02;06;Maanantai;6;6;12
95;01.02.2016;2016;02;07;Maanantai;8;4;12
95;01.02.2016;2016;02;08;Maanantai;3;3;6
95;01.02.2016;2016;02;09;Maanantai;3;3;6
95;01.02.2016;2016;02;10;Maanantai;1;2;3
95;01.02.2016;2016;02;11;Maanantai;4;0;4
95;01.02.2016;2016;02;12;Maanantai;4;2;6
95;01.02.2016;2016;02;13;Maanantai;2;3;5
95;01.02.2016;2016;02;14;Maanantai;8;3;11
95;01.02.2016;2016;02;15;Maanantai;8;3;11
95;01.02.2016;2016;02;16;Maanantai;7;9;16
95;01.02.2016;2016;02;17;Maanantai;2;8;10
95;01.02.2016;2016;02;18;Maanantai;2;3;5
95;01.02.2016;2016;02;19;Maanantai;0;1;1
95;01.02.2016;2016;02;20;Maanantai;2;0;2
95;01.02.2016;2016;02;21;Maanantai;0;0;0
95;01.02.2016;2016;02;22;Maanantai;0;1;1
95;01.02.2016;2016;02;23;Maanantai;0;0;0
95;02.02.2016;2016;02;00;Tiistai;0;0;0
95;02.02.2016;2016;02;01;Tiistai;1;0;1
95;02.02.2016;2016;02;02;Tiistai;0;0;0
95;02.02.2016;2016;02;03;Tiistai;0;0;0
95;02.02.2016;2016;02;04;Tiistai;2;0;2
95;02.02.2016;2016;02;05;Tiistai;6;3;9
95;02.02.2016;2016;02;06;Tiistai;3;6;9
95;02.02.2016;2016;02;07;Tiistai;11;9;20
95;02.02.2016;2016;02;08;Tiistai;4;3;7
95;02.02.2016;2016;02;09;Tiistai;1;2;3
95;02.02.2016;2016;02;10;Tiistai;1;2;3
95;02.02.2016;2016;02;11;Tiistai;3;2;5
95;02.02.2016;2016;02;12;Tiistai;0;1;1
95;02.02.2016;2016;02;13;Tiistai;1;3;4
95;02.02.2016;2016;02;14;Tiistai;8;2;10
95;02.02.2016;2016;02;15;Tiistai;8;5;13
95;02.02.2016;2016;02;16;Tiistai;10;10;20
95;02.02.2016;2016;02;17;Tiistai;4;9;13
95;02.02.2016;2016;02;18;Tiistai;0;4;4
95;02.02.2016;2016;02;19;Tiistai;1;3;4
95;02.02.2016;2016;02;20;Tiistai;1;2;3
95;02.02.2016;2016;02;21;Tiistai;0;1;1
95;02.02.2016;2016;02;22;Tiistai;0;2;2
95;02.02.2016;2016;02;23;Tiistai;0;0;0
95;03.02.2016;2016;02;00;Keskiviikko;0;0;0
95;03.02.2016;2016;02;01;Keskiviikko;0;0;0
95;03.02.2016;2016;02;02;Keskiviikko;0;0;0
95;03.02.2016;2016;02;03;Keskiviikko;0;0;0
95;03.02.2016;2016;02;04;Keskiviikko;4;1;5
95;03.02.2016;2016;02;05;Keskiviikko;6;3;9
95;03.02.2016;2016;02;06;Keskiviikko;4;5;9
95;03.02.2016;2016;02;07;Keskiviikko;8;11;19
95;03.02.2016;2016;02;08;Keskiviikko;9;8;17
95;03.02.2016;2016;02;09;Keskiviikko;3;2;5
95;03.02.2016;2016;02;10;Keskiviikko;4;1;5
95;03.02.2016;2016;02;11;Keskiviikko;3;0;3
95;03.02.2016;2016;02;12;Keskiviikko;2;3;5
95;03.02.2016;2016;02;13;Keskiviikko;4;5;9
95;03.02.2016;2016;02;14;Keskiviikko;4;4;8
95;03.02.2016;2016;02;15;Keskiviikko;12;12;24
95;03.02.2016;2016;02;16;Keskiviikko;11;12;23
95;03.02.2016;2016;02;17;Keskiviikko;4;4;8
95;03.02.2016;2016;02;18;Keskiviikko;1;2;3
95;03.02.2016;2016;02;19;Keskiviikko;0;1;1
95;03.02.2016;2016;02;20;Keskiviikko;0;2;2
95;03.02.2016;2016;02;21;Keskiviikko;1;0;1
95;03.02.2016;2016;02;22;Keskiviikko;0;1;1
95;03.02.2016;2016;02;23;Keskiviikko;2;0;2
95;04.02.2016;2016;02;00;Torstai;1;0;1
95;04.02.2016;2016;02;01;Torstai;0;0;0
95;04.02.2016;2016;02;02;Torstai;0;0;0
95;04.02.2016;2016;02;03;Torstai;0;0;0
95;04.02.2016;2016;02;04;Torstai;1;0;1
95;04.02.2016;2016;02;05;Torstai;3;3;6
95;04.02.2016;2016;02;06;Torstai;10;6;16
95;04.02.2016;2016;02;07;Torstai;8;8;16
95;04.02.2016;2016;02;08;Torstai;4;6;10
95;04.02.2016;2016;02;09;Torstai;3;2;5
95;04.02.2016;2016;02;10;Torstai;1;0;1
95;04.02.2016;2016;02;11;Torstai;3;1;4
95;04.02.2016;2016;02;12;Torstai;8;4;12
95;04.02.2016;2016;02;13;Torstai;2;5;7
95;04.02.2016;2016;02;14;Torstai;5;6;11
95;04.02.2016;2016;02;15;Torstai;7;8;15
95;04.02.2016;2016;02;16;Torstai;8;14;22
95;04.02.2016;2016;02;17;Torstai;4;5;9
95;04.02.2016;2016;02;18;Torstai;4;1;5
95;04.02.2016;2016;02;19;Torstai;1;1;2
95;04.02.2016;2016;02;20;Torstai;1;1;2
95;04.02.2016;2016;02;21;Torstai;1;1;2
95;04.02.2016;2016;02;22;Torstai;0;1;1
95;04.02.2016;2016;02;23;Torstai;0;0;0
95;05.02.2016;2016;02;00;Perjantai;0;1;1
95;05.02.2016;2016;02;01;Perjantai;0;0;0
95;05.02.2016;2016;02;02;Perjantai;0;0;0
95;05.02.2016;2016;02;03;Perjantai;0;0;0
95;05.02.2016;2016;02;04;Perjantai;1;0;1
95;05.02.2016;2016;02;05;Perjantai;3;5;8
95;05.02.2016;2016;02;06;Perjantai;8;3;11
95;05.02.2016;2016;02;07;Perjantai;10;6;16
95;05.02.2016;2016;02;08;Perjantai;2;1;3
95;05.02.2016;2016;02;09;Perjantai;3;3;6
95;05.02.2016;2016;02;10;Perjantai;2;0;2
95;05.02.2016;2016;02;11;Perjantai;3;0;3
95;05.02.2016;2016;02;12;Perjantai;1;2;3
95;05.02.2016;2016;02;13;Perjantai;2;2;4
95;05.02.2016;2016;02;14;Perjantai;6;7;13
95;05.02.2016;2016;02;15;Perjantai;3;8;11
95;05.02.2016;2016;02;16;Perjantai;8;9;17
95;05.02.2016;2016;02;17;Perjantai;0;5;5
95;05.02.2016;2016;02;18;Perjantai;0;3;3
95;05.02.2016;2016;02;19;Perjantai;0;2;2
95;05.02.2016;2016;02;20;Perjantai;0;1;1
95;05.02.2016;2016;02;21;Perjantai;1;1;2
95;05.02.2016;2016;02;22;Perjantai;0;1;1
95;05.02.2016;2016;02;23;Perjantai;0;0;0
95;06.02.2016;2016;02;00;Lauantai;0;0;0
95;06.02.2016;2016;02;01;Lauantai;0;0;0
95;06.02.2016;2016;02;02;Lauantai;0;0;0
95;06.02.2016;2016;02;03;Lauantai;0;0;0
95;06.02.2016;2016;02;04;Lauantai;0;0;0
95;06.02.2016;2016;02;05;Lauantai;0;0;0
95;06.02.2016;2016;02;06;Lauantai;3;1;4
95;06.02.2016;2016;02;07;Lauantai;1;0;1
95;06.02.2016;2016;02;08;Lauantai;0;2;2
95;06.02.2016;2016;02;09;Lauantai;3;3;6
95;06.02.2016;2016;02;10;Lauantai;2;2;4
95;06.02.2016;2016;02;11;Lauantai;4;3;7
95;06.02.2016;2016;02;12;Lauantai;5;6;11
95;06.02.2016;2016;02;13;Lauantai;5;0;5
95;06.02.2016;2016;02;14;Lauantai;2;6;8
95;06.02.2016;2016;02;15;Lauantai;2;2;4
95;06.02.2016;2016;02;16;Lauantai;2;2;4
95;06.02.2016;2016;02;17;Lauantai;1;3;4
95;06.02.2016;2016;02;18;Lauantai;2;3;5
95;06.02.2016;2016;02;19;Lauantai;0;1;1
95;06.02.2016;2016;02;20;Lauantai;0;0;0
95;06.02.2016;2016;02;21;Lauantai;0;0;0
95;06.02.2016;2016;02;22;Lauantai;1;1;2
95;06.02.2016;2016;02;23;Lauantai;0;0;0
95;07.02.2016;2016;02;00;Sunnuntai;0;0;0
95;07.02.2016;2016;02;01;Sunnuntai;0;0;0
95;07.02.2016;2016;02;02;Sunnuntai;0;0;0
95;07.02.2016;2016;02;03;Sunnuntai;0;0;0
95;07.02.2016;2016;02;04;Sunnuntai;0;0;0
95;07.02.2016;2016;02;05;Sunnuntai;0;0;0
95;07.02.2016;2016;02;06;Sunnuntai;0;1;1
95;07.02.2016;2016;02;07;Sunnuntai;0;0;0
95;07.02.2016;2016;02;08;Sunnuntai;0;0;0
95;07.02.2016;2016;02;09;Sunnuntai;0;2;2
95;07.02.2016;2016;02;10;Sunnuntai;1;3;4
95;07.02.2016;2016;02;11;Sunnuntai;5;0;5
95;07.02.2016;2016;02;12;Sunnuntai;5;0;5
95;07.02.2016;2016;02;13;Sunnuntai;6;8;14
95;07.02.2016;2016;02;14;Sunnuntai;4;5;9
95;07.02.2016;2016;02;15;Sunnuntai;3;5;8
95;07.02.2016;2016;02;16;Sunnuntai;1;0;1
95;07.02.2016;2016;02;17;Sunnuntai;1;0;1
95;07.02.2016;2016;02;18;Sunnuntai;2;2;4
95;07.02.2016;2016;02;19;Sunnuntai;2;1;3
95;07.02.2016;2016;02;20;Sunnuntai;1;0;1
95;07.02.2016;2016;02;21;Sunnuntai;1;2;3
95;07.02.2016;2016;02;22;Sunnuntai;0;1;1
95;07.02.2016;2016;02;23;Sunnuntai;0;0;0
95;08.02.2016;2016;02;00;Maanantai;0;0;0
95;08.02.2016;2016;02;01;Maanantai;0;0;0
95;08.02.2016;2016;02;02;Maanantai;0;0;0
95;08.02.2016;2016;02;03;Maanantai;0;0;0
95;08.02.2016;2016;02;04;Maanantai;1;0;1
95;08.02.2016;2016;02;05;Maanantai;0;1;1
95;08.02.2016;2016;02;06;Maanantai;7;4;11
95;08.02.2016;2016;02;07;Maanantai;5;7;12
95;08.02.2016;2016;02;08;Maanantai;2;2;4
95;08.02.2016;2016;02;09;Maanantai;1;1;2
95;08.02.2016;2016;02;10;Maanantai;1;0;1
95;08.02.2016;2016;02;11;Maanantai;1;2;3
95;08.02.2016;2016;02;12;Maanantai;5;0;5
95;08.02.2016;2016;02;13;Maanantai;3;1;4
95;08.02.2016;2016;02;14;Maanantai;3;4;7
95;08.02.2016;2016;02;15;Maanantai;6;2;8
95;08.02.2016;2016;02;16;Maanantai;6;8;14
95;08.02.2016;2016;02;17;Maanantai;1;4;5
95;08.02.2016;2016;02;18;Maanantai;1;2;3
95;08.02.2016;2016;02;19;Maanantai;0;0;0
95;08.02.2016;2016;02;20;Maanantai;1;1;2
95;08.02.2016;2016;02;21;Maanantai;1;1;2
95;08.02.2016;2016;02;22;Maanantai;1;3;4
95;08.02.2016;2016;02;23;Maanantai;1;0;1
95;09.02.2016;2016;02;00;Tiistai;1;0;1
95;09.02.2016;2016;02;01;Tiistai;0;0;0
95;09.02.2016;2016;02;02;Tiistai;0;0;0
95;09.02.2016;2016;02;03;Tiistai;0;0;0
95;09.02.2016;2016;02;04;Tiistai;0;0;0
95;09.02.2016;2016;02;05;Tiistai;0;1;1
95;09.02.2016;2016;02;06;Tiistai;8;6;14
95;09.02.2016;2016;02;07;Tiistai;8;7;15
95;09.02.2016;2016;02;08;Tiistai;5;4;9
95;09.02.2016;2016;02;09;Tiistai;1;2;3
95;09.02.2016;2016;02;10;Tiistai;1;1;2
95;09.02.2016;2016;02;11;Tiistai;2;2;4
95;09.02.2016;2016;02;12;Tiistai;5;0;5
95;09.02.2016;2016;02;13;Tiistai;1;2;3
95;09.02.2016;2016;02;14;Tiistai;6;1;7
95;09.02.2016;2016;02;15;Tiistai;7;1;8
95;09.02.2016;2016;02;16;Tiistai;4;6;10
95;09.02.2016;2016;02;17;Tiistai;5;3;8
95;09.02.2016;2016;02;18;Tiistai;1;2;3
95;09.02.2016;2016;02;19;Tiistai;0;1;1
95;09.02.2016;2016;02;20;Tiistai;1;2;3
95;09.02.2016;2016;02;21;Tiistai;1;2;3
95;09.02.2016;2016;02;22;Tiistai;1;0;1
95;09.02.2016;2016;02;23;Tiistai;0;0;0
95;10.02.2016;2016;02;00;Keskiviikko;0;0;0
95;10.02.2016;2016;02;01;Keskiviikko;0;0;0
95;10.02.2016;2016;02;02;Keskiviikko;0;0;0
95;10.02.2016;2016;02;03;Keskiviikko;0;0;0
95;10.02.2016;2016;02;04;Keskiviikko;0;0;0
95;10.02.2016;2016;02;05;Keskiviikko;2;1;3
95;10.02.2016;2016;02;06;Keskiviikko;7;4;11
95;10.02.2016;2016;02;07;Keskiviikko;7;5;12
95;10.02.2016;2016;02;08;Keskiviikko;1;6;7
95;10.02.2016;2016;02;09;Keskiviikko;2;1;3
95;10.02.2016;2016;02;10;Keskiviikko;0;0;0
95;10.02.2016;2016;02;11;Keskiviikko;3;0;3
95;10.02.2016;2016;02;12;Keskiviikko;1;1;2
95;10.02.2016;2016;02;13;Keskiviikko;2;1;3
95;10.02.2016;2016;02;14;Keskiviikko;5;3;8
95;10.02.2016;2016;02;15;Keskiviikko;7;4;11
95;10.02.2016;2016;02;16;Keskiviikko;3;12;15
95;10.02.2016;2016;02;17;Keskiviikko;8;8;16
95;10.02.2016;2016;02;18;Keskiviikko;1;1;2
95;10.02.2016;2016;02;19;Keskiviikko;2;0;2
95;10.02.2016;2016;02;20;Keskiviikko;0;1;1
95;10.02.2016;2016;02;21;Keskiviikko;0;1;1
95;10.02.2016;2016;02;22;Keskiviikko;0;0;0
95;10.02.2016;2016;02;23;Keskiviikko;0;0;0
95;11.02.2016;2016;02;00;Torstai;0;0;0
95;11.02.2016;2016;02;01;Torstai;0;0;0
95;11.02.2016;2016;02;02;Torstai;0;0;0
95;11.02.2016;2016;02;03;Torstai;0;0;0
95;11.02.2016;2016;02;04;Torstai;0;0;0
95;11.02.2016;2016;02;05;Torstai;0;2;2
95;11.02.2016;2016;02;06;Torstai;8;7;15
95;11.02.2016;2016;02;07;Torstai;4;6;10
95;11.02.2016;2016;02;08;Torstai;3;3;6
95;11.02.2016;2016;02;09;Torstai;4;2;6
95;11.02.2016;2016;02;10;Torstai;0;0;0
95;11.02.2016;2016;02;11;Torstai;6;2;8
95;11.02.2016;2016;02;12;Torstai;3;3;6
95;11.02.2016;2016;02;13;Torstai;1;1;2
95;11.02.2016;2016;02;14;Torstai;6;2;8
95;11.02.2016;2016;02;15;Torstai;5;1;6
95;11.02.2016;2016;02;16;Torstai;7;11;18
95;11.02.2016;2016;02;17;Torstai;3;4;7
95;11.02.2016;2016;02;18;Torstai;3;3;6
95;11.02.2016;2016;02;19;Torstai;2;2;4
95;11.02.2016;2016;02;20;Torstai;3;3;6
95;11.02.2016;2016;02;21;Torstai;1;2;3
95;11.02.2016;2016;02;22;Torstai;0;1;1
95;11.02.2016;2016;02;23;Torstai;0;0;0
95;12.02.2016;2016;02;00;Perjantai;0;0;0
95;12.02.2016;2016;02;01;Perjantai;0;0;0
95;12.02.2016;2016;02;02;Perjantai;0;0;0
95;12.02.2016;2016;02;03;Perjantai;0;0;0
95;12.02.2016;2016;02;04;Perjantai;2;0;2
95;12.02.2016;2016;02;05;Perjantai;1;3;4
95;12.02.2016;2016;02;06;Perjantai;8;1;9
95;12.02.2016;2016;02;07;Perjantai;6;5;11
95;12.02.2016;2016;02;08;Perjantai;1;0;1
95;12.02.2016;2016;02;09;Perjantai;1;2;3
95;12.02.2016;2016;02;10;Perjantai;1;1;2
95;12.02.2016;2016;02;11;Perjantai;2;1;3
95;12.02.2016;2016;02;12;Perjantai;1;1;2
95;12.02.2016;2016;02;13;Perjantai;2;3;5
95;12.02.2016;2016;02;14;Perjantai;4;2;6
95;12.02.2016;2016;02;15;Perjantai;2;1;3
95;12.02.2016;2016;02;16;Perjantai;4;5;9
95;12.02.2016;2016;02;17;Perjantai;1;5;6
95;12.02.2016;2016;02;18;Perjantai;0;2;2
95;12.02.2016;2016;02;19;Perjantai;0;1;1
95;12.02.2016;2016;02;20;Perjantai;0;0;0
95;12.02.2016;2016;02;21;Perjantai;0;0;0
95;12.02.2016;2016;02;22;Perjantai;0;1;1
95;12.02.2016;2016;02;23;Perjantai;0;0;0
95;13.02.2016;2016;02;00;Lauantai;0;0;0
95;13.02.2016;2016;02;01;Lauantai;0;0;0
95;13.02.2016;2016;02;02;Lauantai;0;0;0
95;13.02.2016;2016;02;03;Lauantai;0;0;0
95;13.02.2016;2016;02;04;Lauantai;1;0;1
95;13.02.2016;2016;02;05;Lauantai;0;0;0
95;13.02.2016;2016;02;06;Lauantai;1;0;1
95;13.02.2016;2016;02;07;Lauantai;0;0;0
95;13.02.2016;2016;02;08;Lauantai;1;0;1
95;13.02.2016;2016;02;09;Lauantai;2;0;2
95;13.02.2016;2016;02;10;Lauantai;3;2;5
95;13.02.2016;2016;02;11;Lauantai;1;2;3
95;13.02.2016;2016;02;12;Lauantai;0;4;4
95;13.02.2016;2016;02;13;Lauantai;8;3;11
95;13.02.2016;2016;02;14;Lauantai;1;6;7
95;13.02.2016;2016;02;15;Lauantai;6;0;6
95;13.02.2016;2016;02;16;Lauantai;1;4;5
95;13.02.2016;2016;02;17;Lauantai;0;1;1
95;13.02.2016;2016;02;18;Lauantai;2;4;6
95;13.02.2016;2016;02;19;Lauantai;0;1;1
95;13.02.2016;2016;02;20;Lauantai;1;3;4
95;13.02.2016;2016;02;21;Lauantai;1;1;2
95;13.02.2016;2016;02;22;Lauantai;0;2;2
95;13.02.2016;2016;02;23;Lauantai;1;0;1
95;14.02.2016;2016;02;00;Sunnuntai;0;1;1
95;14.02.2016;2016;02;01;Sunnuntai;0;0;0
95;14.02.2016;2016;02;02;Sunnuntai;0;1;1
95;14.02.2016;2016;02;03;Sunnuntai;0;0;0
95;14.02.2016;2016;02;04;Sunnuntai;0;0;0
95;14.02.2016;2016;02;05;Sunnuntai;0;0;0
95;14.02.2016;2016;02;06;Sunnuntai;1;0;1
95;14.02.2016;2016;02;07;Sunnuntai;0;0;0
95;14.02.2016;2016;02;08;Sunnuntai;0;0;0
95;14.02.2016;2016;02;09;Sunnuntai;0;1;1
95;14.02.2016;2016;02;10;Sunnuntai;0;0;0
95;14.02.2016;2016;02;11;Sunnuntai;1;0;1
95;14.02.2016;2016;02;12;Sunnuntai;2;2;4
95;14.02.2016;2016;02;13;Sunnuntai;5;5;10
95;14.02.2016;2016;02;14;Sunnuntai;0;0;0
95;14.02.2016;2016;02;15;Sunnuntai;3;2;5
95;14.02.2016;2016;02;16;Sunnuntai;1;0;1
95;14.02.2016;2016;02;17;Sunnuntai;0;2;2
95;14.02.2016;2016;02;18;Sunnuntai;1;0;1
95;14.02.2016;2016;02;19;Sunnuntai;3;2;5
95;14.02.2016;2016;02;20;Sunnuntai;0;0;0
95;14.02.2016;2016;02;21;Sunnuntai;1;1;2
95;14.02.2016;2016;02;22;Sunnuntai;0;0;0
95;14.02.2016;2016;02;23;Sunnuntai;0;0;0
95;15.02.2016;2016;02;00;Maanantai;0;0;0
95;15.02.2016;2016;02;01;Maanantai;0;0;0
95;15.02.2016;2016;02;02;Maanantai;0;0;0
95;15.02.2016;2016;02;03;Maanantai;1;0;1
95;15.02.2016;2016;02;04;Maanantai;1;0;1
95;15.02.2016;2016;02;05;Maanantai;3;2;5
95;15.02.2016;2016;02;06;Maanantai;7;5;12
95;15.02.2016;2016;02;07;Maanantai;9;7;16
95;15.02.2016;2016;02;08;Maanantai;2;3;5
95;15.02.2016;2016;02;09;Maanantai;3;6;9
95;15.02.2016;2016;02;10;Maanantai;1;2;3
95;15.02.2016;2016;02;11;Maanantai;3;2;5
95;15.02.2016;2016;02;12;Maanantai;2;1;3
95;15.02.2016;2016;02;13;Maanantai;3;2;5
95;15.02.2016;2016;02;14;Maanantai;6;8;14
95;15.02.2016;2016;02;15;Maanantai;5;7;12
95;15.02.2016;2016;02;16;Maanantai;13;5;18
95;15.02.2016;2016;02;17;Maanantai;4;9;13
95;15.02.2016;2016;02;18;Maanantai;2;1;3
95;15.02.2016;2016;02;19;Maanantai;3;5;8
95;15.02.2016;2016;02;20;Maanantai;1;0;1
95;15.02.2016;2016;02;21;Maanantai;1;2;3
95;15.02.2016;2016;02;22;Maanantai;0;0;0
95;15.02.2016;2016;02;23;Maanantai;0;0;0
95;16.02.2016;2016;02;00;Tiistai;0;0;0
95;16.02.2016;2016;02;01;Tiistai;1;0;1
95;16.02.2016;2016;02;02;Tiistai;0;0;0
95;16.02.2016;2016;02;03;Tiistai;0;0;0
95;16.02.2016;2016;02;04;Tiistai;0;0;0
95;16.02.2016;2016;02;05;Tiistai;9;2;11
95;16.02.2016;2016;02;06;Tiistai;13;4;17
95;16.02.2016;2016;02;07;Tiistai;11;14;25
95;16.02.2016;2016;02;08;Tiistai;4;5;9
95;16.02.2016;2016;02;09;Tiistai;0;2;2
95;16.02.2016;2016;02;10;Tiistai;2;0;2
95;16.02.2016;2016;02;11;Tiistai;5;2;7
95;16.02.2016;2016;02;12;Tiistai;6;0;6
95;16.02.2016;2016;02;13;Tiistai;4;5;9
95;16.02.2016;2016;02;14;Tiistai;6;3;9
95;16.02.2016;2016;02;15;Tiistai;7;12;19
95;16.02.2016;2016;02;16;Tiistai;3;8;11
95;16.02.2016;2016;02;17;Tiistai;2;10;12
95;16.02.2016;2016;02;18;Tiistai;4;4;8
95;16.02.2016;2016;02;19;Tiistai;1;2;3
95;16.02.2016;2016;02;20;Tiistai;1;5;6
95;16.02.2016;2016;02;21;Tiistai;1;0;1
95;16.02.2016;2016;02;22;Tiistai;2;1;3
95;16.02.2016;2016;02;23;Tiistai;0;0;0
95;17.02.2016;2016;02;00;Keskiviikko;0;0;0
95;17.02.2016;2016;02;01;Keskiviikko;1;1;2
95;17.02.2016;2016;02;02;Keskiviikko;0;0;0
95;17.02.2016;2016;02;03;Keskiviikko;0;0;0
95;17.02.2016;2016;02;04;Keskiviikko;1;1;2
95;17.02.2016;2016;02;05;Keskiviikko;4;3;7
95;17.02.2016;2016;02;06;Keskiviikko;7;7;14
95;17.02.2016;2016;02;07;Keskiviikko;11;9;20
95;17.02.2016;2016;02;08;Keskiviikko;9;8;17
95;17.02.2016;2016;02;09;Keskiviikko;4;4;8
95;17.02.2016;2016;02;10;Keskiviikko;2;5;7
95;17.02.2016;2016;02;11;Keskiviikko;2;5;7
95;17.02.2016;2016;02;12;Keskiviikko;3;5;8
95;17.02.2016;2016;02;13;Keskiviikko;7;5;12
95;17.02.2016;2016;02;14;Keskiviikko;5;2;7
95;17.02.2016;2016;02;15;Keskiviikko;7;8;15
95;17.02.2016;2016;02;16;Keskiviikko;10;13;23
95;17.02.2016;2016;02;17;Keskiviikko;6;11;17
95;17.02.2016;2016;02;18;Keskiviikko;1;2;3
95;17.02.2016;2016;02;19;Keskiviikko;1;4;5
95;17.02.2016;2016;02;20;Keskiviikko;2;3;5
95;17.02.2016;2016;02;21;Keskiviikko;4;3;7
95;17.02.2016;2016;02;22;Keskiviikko;2;0;2
95;17.02.2016;2016;02;23;Keskiviikko;1;2;3
95;18.02.2016;2016;02;00;Torstai;0;0;0
95;18.02.2016;2016;02;01;Torstai;0;0;0
95;18.02.2016;2016;02;02;Torstai;0;0;0
95;18.02.2016;2016;02;03;Torstai;0;0;0
95;18.02.2016;2016;02;04;Torstai;3;1;4
95;18.02.2016;2016;02;05;Torstai;3;4;7
95;18.02.2016;2016;02;06;Torstai;11;6;17
95;18.02.2016;2016;02;07;Torstai;9;13;22
95;18.02.2016;2016;02;08;Torstai;5;1;6
95;18.02.2016;2016;02;09;Torstai;3;5;8
95;18.02.2016;2016;02;10;Torstai;1;4;5
95;18.02.2016;2016;02;11;Torstai;4;3;7
95;18.02.2016;2016;02;12;Torstai;4;2;6
95;18.02.2016;2016;02;13;Torstai;7;2;9
95;18.02.2016;2016;02;14;Torstai;7;8;15
95;18.02.2016;2016;02;15;Torstai;3;6;9
95;18.02.2016;2016;02;16;Torstai;6;12;18
95;18.02.2016;2016;02;17;Torstai;7;9;16
95;18.02.2016;2016;02;18;Torstai;6;5;11
95;18.02.2016;2016;02;19;Torstai;1;7;8
95;18.02.2016;2016;02;20;Torstai;1;1;2
95;18.02.2016;2016;02;21;Torstai;2;1;3
95;18.02.2016;2016;02;22;Torstai;3;0;3
95;18.02.2016;2016;02;23;Torstai;0;0;0
95;19.02.2016;2016;02;00;Perjantai;0;1;1
95;19.02.2016;2016;02;01;Perjantai;0;0;0
95;19.02.2016;2016;02;02;Perjantai;0;0;0
95;19.02.2016;2016;02;03;Perjantai;0;0;0
95;19.02.2016;2016;02;04;Perjantai;0;0;0
95;19.02.2016;2016;02;05;Perjantai;3;5;8
95;19.02.2016;2016;02;06;Perjantai;7;2;9
95;19.02.2016;2016;02;07;Perjantai;10;9;19
95;19.02.2016;2016;02;08;Perjantai;6;3;9
95;19.02.2016;2016;02;09;Perjantai;0;0;0
95;19.02.2016;2016;02;10;Perjantai;1;0;1
95;19.02.2016;2016;02;11;Perjantai;6;3;9
95;19.02.2016;2016;02;12;Perjantai;1;1;2
95;19.02.2016;2016;02;13;Perjantai;3;1;4
95;19.02.2016;2016;02;14;Perjantai;7;5;12
95;19.02.2016;2016;02;15;Perjantai;0;5;5
95;19.02.2016;2016;02;16;Perjantai;3;8;11
95;19.02.2016;2016;02;17;Perjantai;1;8;9
95;19.02.2016;2016;02;18;Perjantai;6;1;7
95;19.02.2016;2016;02;19;Perjantai;0;0;0
95;19.02.2016;2016;02;20;Perjantai;0;2;2
95;19.02.2016;2016;02;21;Perjantai;0;1;1
95;19.02.2016;2016;02;22;Perjantai;0;1;1
95;19.02.2016;2016;02;23;Perjantai;0;0;0
95;20.02.2016;2016;02;00;Lauantai;0;0;0
95;20.02.2016;2016;02;01;Lauantai;0;0;0
95;20.02.2016;2016;02;02;Lauantai;1;0;1
95;20.02.2016;2016;02;03;Lauantai;0;0;0
95;20.02.2016;2016;02;04;Lauantai;1;0;1
95;20.02.2016;2016;02;05;Lauantai;0;1;1
95;20.02.2016;2016;02;06;Lauantai;0;0;0
95;20.02.2016;2016;02;07;Lauantai;1;2;3
95;20.02.2016;2016;02;08;Lauantai;0;2;2
95;20.02.2016;2016;02;09;Lauantai;0;0;0
95;20.02.2016;2016;02;10;Lauantai;3;1;4
95;20.02.2016;2016;02;11;Lauantai;2;5;7
95;20.02.2016;2016;02;12;Lauantai;4;5;9
95;20.02.2016;2016;02;13;Lauantai;5;4;9
95;20.02.2016;2016;02;14;Lauantai;2;1;3
95;20.02.2016;2016;02;15;Lauantai;1;1;2
95;20.02.2016;2016;02;16;Lauantai;1;2;3
95;20.02.2016;2016;02;17;Lauantai;1;1;2
95;20.02.2016;2016;02;18;Lauantai;0;1;1
95;20.02.2016;2016;02;19;Lauantai;3;0;3
95;20.02.2016;2016;02;20;Lauantai;2;1;3
95;20.02.2016;2016;02;21;Lauantai;0;0;0
95;20.02.2016;2016;02;22;Lauantai;0;0;0
95;20.02.2016;2016;02;23;Lauantai;0;0;0
95;21.02.2016;2016;02;00;Sunnuntai;0;0;0
95;21.02.2016;2016;02;01;Sunnuntai;0;0;0
95;21.02.2016;2016;02;02;Sunnuntai;0;0;0
95;21.02.2016;2016;02;03;Sunnuntai;0;0;0
95;21.02.2016;2016;02;04;Sunnuntai;0;0;0
95;21.02.2016;2016;02;05;Sunnuntai;0;1;1
95;21.02.2016;2016;02;06;Sunnuntai;1;0;1
95;21.02.2016;2016;02;07;Sunnuntai;0;1;1
95;21.02.2016;2016;02;08;Sunnuntai;2;0;2
95;21.02.2016;2016;02;09;Sunnuntai;0;1;1
95;21.02.2016;2016;02;10;Sunnuntai;0;1;1
95;21.02.2016;2016;02;11;Sunnuntai;0;0;0
95;21.02.2016;2016;02;12;Sunnuntai;0;1;1
95;21.02.2016;2016;02;13;Sunnuntai;1;0;1
95;21.02.2016;2016;02;14;Sunnuntai;0;3;3
95;21.02.2016;2016;02;15;Sunnuntai;5;0;5
95;21.02.2016;2016;02;16;Sunnuntai;0;2;2
95;21.02.2016;2016;02;17;Sunnuntai;2;3;5
95;21.02.2016;2016;02;18;Sunnuntai;0;1;1
95;21.02.2016;2016;02;19;Sunnuntai;1;0;1
95;21.02.2016;2016;02;20;Sunnuntai;3;1;4
95;21.02.2016;2016;02;21;Sunnuntai;2;1;3
95;21.02.2016;2016;02;22;Sunnuntai;0;0;0
95;21.02.2016;2016;02;23;Sunnuntai;0;0;0
95;22.02.2016;2016;02;00;Maanantai;0;0;0
95;22.02.2016;2016;02;01;Maanantai;0;0;0
95;22.02.2016;2016;02;02;Maanantai;0;0;0
95;22.02.2016;2016;02;03;Maanantai;0;0;0
95;22.02.2016;2016;02;04;Maanantai;2;0;2
95;22.02.2016;2016;02;05;Maanantai;3;3;6
95;22.02.2016;2016;02;06;Maanantai;5;7;12
95;22.02.2016;2016;02;07;Maanantai;11;8;19
95;22.02.2016;2016;02;08;Maanantai;8;6;14
95;22.02.2016;2016;02;09;Maanantai;2;4;6
95;22.02.2016;2016;02;10;Maanantai;0;2;2
95;22.02.2016;2016;02;11;Maanantai;2;2;4
95;22.02.2016;2016;02;12;Maanantai;1;4;5
95;22.02.2016;2016;02;13;Maanantai;10;7;17
95;22.02.2016;2016;02;14;Maanantai;7;4;11
95;22.02.2016;2016;02;15;Maanantai;2;6;8
95;22.02.2016;2016;02;16;Maanantai;17;7;24
95;22.02.2016;2016;02;17;Maanantai;9;7;16
95;22.02.2016;2016;02;18;Maanantai;2;3;5
95;22.02.2016;2016;02;19;Maanantai;4;1;5
95;22.02.2016;2016;02;20;Maanantai;3;3;6
95;22.02.2016;2016;02;21;Maanantai;1;0;1
95;22.02.2016;2016;02;22;Maanantai;1;3;4
95;22.02.2016;2016;02;23;Maanantai;0;0;0
95;23.02.2016;2016;02;00;Tiistai;0;0;0
95;23.02.2016;2016;02;01;Tiistai;1;0;1
95;23.02.2016;2016;02;02;Tiistai;0;0;0
95;23.02.2016;2016;02;03;Tiistai;0;0;0
95;23.02.2016;2016;02;04;Tiistai;1;0;1
95;23.02.2016;2016;02;05;Tiistai;3;3;6
95;23.02.2016;2016;02;06;Tiistai;9;6;15
95;23.02.2016;2016;02;07;Tiistai;10;14;24
95;23.02.2016;2016;02;08;Tiistai;3;8;11
95;23.02.2016;2016;02;09;Tiistai;0;0;0
95;23.02.2016;2016;02;10;Tiistai;5;5;10
95;23.02.2016;2016;02;11;Tiistai;3;5;8
95;23.02.2016;2016;02;12;Tiistai;6;2;8
95;23.02.2016;2016;02;13;Tiistai;3;3;6
95;23.02.2016;2016;02;14;Tiistai;3;5;8
95;23.02.2016;2016;02;15;Tiistai;12;11;23
95;23.02.2016;2016;02;16;Tiistai;15;10;25
95;23.02.2016;2016;02;17;Tiistai;6;4;10
95;23.02.2016;2016;02;18;Tiistai;4;6;10
95;23.02.2016;2016;02;19;Tiistai;2;3;5
95;23.02.2016;2016;02;20;Tiistai;0;5;5
95;23.02.2016;2016;02;21;Tiistai;0;0;0
95;23.02.2016;2016;02;22;Tiistai;1;1;2
95;23.02.2016;2016;02;23;Tiistai;2;0;2
95;24.02.2016;2016;02;00;Keskiviikko;0;0;0
95;24.02.2016;2016;02;01;Keskiviikko;1;0;1
95;24.02.2016;2016;02;02;Keskiviikko;0;0;0
95;24.02.2016;2016;02;03;Keskiviikko;0;0;0
95;24.02.2016;2016;02;04;Keskiviikko;1;0;1
95;24.02.2016;2016;02;05;Keskiviikko;4;4;8
95;24.02.2016;2016;02;06;Keskiviikko;13;6;19
95;24.02.2016;2016;02;07;Keskiviikko;8;6;14
95;24.02.2016;2016;02;08;Keskiviikko;5;3;8
95;24.02.2016;2016;02;09;Keskiviikko;1;2;3
95;24.02.2016;2016;02;10;Keskiviikko;5;0;5
95;24.02.2016;2016;02;11;Keskiviikko;5;1;6
95;24.02.2016;2016;02;12;Keskiviikko;1;3;4
95;24.02.2016;2016;02;13;Keskiviikko;3;6;9
95;24.02.2016;2016;02;14;Keskiviikko;6;6;12
95;24.02.2016;2016;02;15;Keskiviikko;8;8;16
95;24.02.2016;2016;02;16;Keskiviikko;8;12;20
95;24.02.2016;2016;02;17;Keskiviikko;7;6;13
95;24.02.2016;2016;02;18;Keskiviikko;2;2;4
95;24.02.2016;2016;02;19;Keskiviikko;0;1;1
95;24.02.2016;2016;02;20;Keskiviikko;2;4;6
95;24.02.2016;2016;02;21;Keskiviikko;2;1;3
95;24.02.2016;2016;02;22;Keskiviikko;2;1;3
95;24.02.2016;2016;02;23;Keskiviikko;1;0;1
95;25.02.2016;2016;02;00;Torstai;0;0;0
95;25.02.2016;2016;02;01;Torstai;0;0;0
95;25.02.2016;2016;02;02;Torstai;0;0;0
95;25.02.2016;2016;02;03;Torstai;0;0;0
95;25.02.2016;2016;02;04;Torstai;1;0;1
95;25.02.2016;2016;02;05;Torstai;3;4;7
95;25.02.2016;2016;02;06;Torstai;6;3;9
95;25.02.2016;2016;02;07;Torstai;6;5;11
95;25.02.2016;2016;02;08;Torstai;3;5;8
95;25.02.2016;2016;02;09;Torstai;1;1;2
95;25.02.2016;2016;02;10;Torstai;1;2;3
95;25.02.2016;2016;02;11;Torstai;1;0;1
95;25.02.2016;2016;02;12;Torstai;4;2;6
95;25.02.2016;2016;02;13;Torstai;4;4;8
95;25.02.2016;2016;02;14;Torstai;3;3;6
95;25.02.2016;2016;02;15;Torstai;8;5;13
95;25.02.2016;2016;02;16;Torstai;9;12;21
95;25.02.2016;2016;02;17;Torstai;4;3;7
95;25.02.2016;2016;02;18;Torstai;3;1;4
95;25.02.2016;2016;02;19;Torstai;1;3;4
95;25.02.2016;2016;02;20;Torstai;3;1;4
95;25.02.2016;2016;02;21;Torstai;0;3;3
95;25.02.2016;2016;02;22;Torstai;0;1;1
95;25.02.2016;2016;02;23;Torstai;0;0;0
95;26.02.2016;2016;02;00;Perjantai;0;0;0
95;26.02.2016;2016;02;01;Perjantai;0;0;0
95;26.02.2016;2016;02;02;Perjantai;0;0;0
95;26.02.2016;2016;02;03;Perjantai;0;0;0
95;26.02.2016;2016;02;04;Perjantai;1;0;1
95;26.02.2016;2016;02;05;Perjantai;2;5;7
95;26.02.2016;2016;02;06;Perjantai;10;4;14
95;26.02.2016;2016;02;07;Perjantai;3;4;7
95;26.02.2016;2016;02;08;Perjantai;4;6;10
95;26.02.2016;2016;02;09;Perjantai;1;2;3
95;26.02.2016;2016;02;10;Perjantai;2;1;3
95;26.02.2016;2016;02;11;Perjantai;5;1;6
95;26.02.2016;2016;02;12;Perjantai;1;2;3
95;26.02.2016;2016;02;13;Perjantai;4;4;8
95;26.02.2016;2016;02;14;Perjantai;3;4;7
95;26.02.2016;2016;02;15;Perjantai;7;5;12
95;26.02.2016;2016;02;16;Perjantai;3;5;8
95;26.02.2016;2016;02;17;Perjantai;1;3;4
95;26.02.2016;2016;02;18;Perjantai;1;4;5
95;26.02.2016;2016;02;19;Perjantai;1;0;1
95;26.02.2016;2016;02;20;Perjantai;0;1;1
95;26.02.2016;2016;02;21;Perjantai;3;1;4
95;26.02.2016;2016;02;22;Perjantai;1;2;3
95;26.02.2016;2016;02;23;Perjantai;1;0;1
95;27.02.2016;2016;02;00;Lauantai;0;0;0
95;27.02.2016;2016;02;01;Lauantai;0;0;0
95;27.02.2016;2016;02;02;Lauantai;0;0;0
95;27.02.2016;2016;02;03;Lauantai;0;0;0
95;27.02.2016;2016;02;04;Lauantai;0;0;0
95;27.02.2016;2016;02;05;Lauantai;0;0;0
95;27.02.2016;2016;02;06;Lauantai;1;0;1
95;27.02.2016;2016;02;07;Lauantai;0;0;0
95;27.02.2016;2016;02;08;Lauantai;1;1;2
95;27.02.2016;2016;02;09;Lauantai;2;1;3
95;27.02.2016;2016;02;10;Lauantai;2;1;3
95;27.02.2016;2016;02;11;Lauantai;1;1;2
95;27.02.2016;2016;02;12;Lauantai;3;2;5
95;27.02.2016;2016;02;13;Lauantai;3;4;7
95;27.02.2016;2016;02;14;Lauantai;2;0;2
95;27.02.2016;2016;02;15;Lauantai;8;6;14
95;27.02.2016;2016;02;16;Lauantai;2;0;2
95;27.02.2016;2016;02;17;Lauantai;4;6;10
95;27.02.2016;2016;02;18;Lauantai;2;0;2
95;27.02.2016;2016;02;19;Lauantai;2;0;2
95;27.02.2016;2016;02;20;Lauantai;2;3;5
95;27.02.2016;2016;02;21;Lauantai;2;1;3
95;27.02.2016;2016;02;22;Lauantai;0;1;1
95;27.02.2016;2016;02;23;Lauantai;0;0;0
95;28.02.2016;2016;02;00;Sunnuntai;0;0;0
95;28.02.2016;2016;02;01;Sunnuntai;0;0;0
95;28.02.2016;2016;02;02;Sunnuntai;0;0;0
95;28.02.2016;2016;02;03;Sunnuntai;0;0;0
95;28.02.2016;2016;02;04;Sunnuntai;3;1;4
95;28.02.2016;2016;02;05;Sunnuntai;0;0;0
95;28.02.2016;2016;02;06;Sunnuntai;1;0;1
95;28.02.2016;2016;02;07;Sunnuntai;1;1;2
95;28.02.2016;2016;02;08;Sunnuntai;0;3;3
95;28.02.2016;2016;02;09;Sunnuntai;0;1;1
95;28.02.2016;2016;02;10;Sunnuntai;1;1;2
95;28.02.2016;2016;02;11;Sunnuntai;2;0;2
95;28.02.2016;2016;02;12;Sunnuntai;2;0;2
95;28.02.2016;2016;02;13;Sunnuntai;1;1;2
95;28.02.2016;2016;02;14;Sunnuntai;2;2;4
95;28.02.2016;2016;02;15;Sunnuntai;3;4;7
95;28.02.2016;2016;02;16;Sunnuntai;1;3;4
95;28.02.2016;2016;02;17;Sunnuntai;0;1;1
95;28.02.2016;2016;02;18;Sunnuntai;0;0;0
95;28.02.2016;2016;02;19;Sunnuntai;2;1;3
95;28.02.2016;2016;02;20;Sunnuntai;0;1;1
95;28.02.2016;2016;02;21;Sunnuntai;0;1;1
95;28.02.2016;2016;02;22;Sunnuntai;0;1;1
95;28.02.2016;2016;02;23;Sunnuntai;0;0;0
95;29.02.2016;2016;02;00;Maanantai;0;0;0
95;29.02.2016;2016;02;01;Maanantai;0;0;0
95;29.02.2016;2016;02;02;Maanantai;0;0;0
95;29.02.2016;2016;02;03;Maanantai;0;0;0
95;29.02.2016;2016;02;04;Maanantai;1;0;1
95;29.02.2016;2016;02;05;Maanantai;4;3;7
95;29.02.2016;2016;02;06;Maanantai;5;5;10
95;29.02.2016;2016;02;07;Maanantai;6;3;9
95;29.02.2016;2016;02;08;Maanantai;2;5;7
95;29.02.2016;2016;02;09;Maanantai;1;1;2
95;29.02.2016;2016;02;10;Maanantai;2;1;3
95;29.02.2016;2016;02;11;Maanantai;0;0;0
95;29.02.2016;2016;02;12;Maanantai;1;1;2
95;29.02.2016;2016;02;13;Maanantai;4;6;10
95;29.02.2016;2016;02;14;Maanantai;4;5;9
95;29.02.2016;2016;02;15;Maanantai;9;2;11
95;29.02.2016;2016;02;16;Maanantai;12;9;21
95;29.02.2016;2016;02;17;Maanantai;2;4;6
95;29.02.2016;2016;02;18;Maanantai;4;5;9
95;29.02.2016;2016;02;19;Maanantai;1;1;2
95;29.02.2016;2016;02;20;Maanantai;2;0;2
95;29.02.2016;2016;02;21;Maanantai;1;0;1
95;29.02.2016;2016;02;22;Maanantai;2;0;2
95;29.02.2016;2016;02;23;Maanantai;0;0;0
95;01.03.2016;2016;03;00;Tiistai;0;0;0
95;01.03.2016;2016;03;01;Tiistai;0;0;0
95;01.03.2016;2016;03;02;Tiistai;0;0;0
95;01.03.2016;2016;03;03;Tiistai;0;0;0
95;01.03.2016;2016;03;04;Tiistai;0;0;0
95;01.03.2016;2016;03;05;Tiistai;6;3;9
95;01.03.2016;2016;03;06;Tiistai;12;6;18
95;01.03.2016;2016;03;07;Tiistai;19;11;30
95;01.03.2016;2016;03;08;Tiistai;2;4;6
95;01.03.2016;2016;03;09;Tiistai;2;1;3
95;01.03.2016;2016;03;10;Tiistai;2;2;4
95;01.03.2016;2016;03;11;Tiistai;1;2;3
95;01.03.2016;2016;03;12;Tiistai;7;4;11
95;01.03.2016;2016;03;13;Tiistai;3;3;6
95;01.03.2016;2016;03;14;Tiistai;10;5;15
95;01.03.2016;2016;03;15;Tiistai;15;9;24
95;01.03.2016;2016;03;16;Tiistai;13;10;23
95;01.03.2016;2016;03;17;Tiistai;7;5;12
95;01.03.2016;2016;03;18;Tiistai;5;5;10
95;01.03.2016;2016;03;19;Tiistai;2;4;6
95;01.03.2016;2016;03;20;Tiistai;4;3;7
95;01.03.2016;2016;03;21;Tiistai;4;0;4
95;01.03.2016;2016;03;22;Tiistai;2;0;2
95;01.03.2016;2016;03;23;Tiistai;0;0;0
95;02.03.2016;2016;03;00;Keskiviikko;0;0;0
95;02.03.2016;2016;03;01;Keskiviikko;0;0;0
95;02.03.2016;2016;03;02;Keskiviikko;0;0;0
95;02.03.2016;2016;03;03;Keskiviikko;0;0;0
95;02.03.2016;2016;03;04;Keskiviikko;2;0;2
95;02.03.2016;2016;03;05;Keskiviikko;7;2;9
95;02.03.2016;2016;03;06;Keskiviikko;15;7;22
95;02.03.2016;2016;03;07;Keskiviikko;18;7;25
95;02.03.2016;2016;03;08;Keskiviikko;2;6;8
95;02.03.2016;2016;03;09;Keskiviikko;2;6;8
95;02.03.2016;2016;03;10;Keskiviikko;5;0;5
95;02.03.2016;2016;03;11;Keskiviikko;6;3;9
95;02.03.2016;2016;03;12;Keskiviikko;9;3;12
95;02.03.2016;2016;03;13;Keskiviikko;7;3;10
95;02.03.2016;2016;03;14;Keskiviikko;11;6;17
95;02.03.2016;2016;03;15;Keskiviikko;9;5;14
95;02.03.2016;2016;03;16;Keskiviikko;5;12;17
95;02.03.2016;2016;03;17;Keskiviikko;8;7;15
95;02.03.2016;2016;03;18;Keskiviikko;0;4;4
95;02.03.2016;2016;03;19;Keskiviikko;0;3;3
95;02.03.2016;2016;03;20;Keskiviikko;0;1;1
95;02.03.2016;2016;03;21;Keskiviikko;1;0;1
95;02.03.2016;2016;03;22;Keskiviikko;2;1;3
95;02.03.2016;2016;03;23;Keskiviikko;1;1;2
95;03.03.2016;2016;03;00;Torstai;0;0;0
95;03.03.2016;2016;03;01;Torstai;0;0;0
95;03.03.2016;2016;03;02;Torstai;0;0;0
95;03.03.2016;2016;03;03;Torstai;0;0;0
95;03.03.2016;2016;03;04;Torstai;2;0;2
95;03.03.2016;2016;03;05;Torstai;6;3;9
95;03.03.2016;2016;03;06;Torstai;8;7;15
95;03.03.2016;2016;03;07;Torstai;9;5;14
95;03.03.2016;2016;03;08;Torstai;12;5;17
95;03.03.2016;2016;03;09;Torstai;3;3;6
95;03.03.2016;2016;03;10;Torstai;5;0;5
95;03.03.2016;2016;03;11;Torstai;5;3;8
95;03.03.2016;2016;03;12;Torstai;7;1;8
95;03.03.2016;2016;03;13;Torstai;5;6;11
95;03.03.2016;2016;03;14;Torstai;5;5;10
95;03.03.2016;2016;03;15;Torstai;11;6;17
95;03.03.2016;2016;03;16;Torstai;8;6;14
95;03.03.2016;2016;03;17;Torstai;0;8;8
95;03.03.2016;2016;03;18;Torstai;3;4;7
95;03.03.2016;2016;03;19;Torstai;1;1;2
95;03.03.2016;2016;03;20;Torstai;1;2;3
95;03.03.2016;2016;03;21;Torstai;2;0;2
95;03.03.2016;2016;03;22;Torstai;1;2;3
95;03.03.2016;2016;03;23;Torstai;0;0;0
95;04.03.2016;2016;03;00;Perjantai;0;1;1
95;04.03.2016;2016;03;01;Perjantai;0;0;0
95;04.03.2016;2016;03;02;Perjantai;0;0;0
95;04.03.2016;2016;03;03;Perjantai;0;0;0
95;04.03.2016;2016;03;04;Perjantai;3;0;3
95;04.03.2016;2016;03;05;Perjantai;4;3;7
95;04.03.2016;2016;03;06;Perjantai;8;2;10
95;04.03.2016;2016;03;07;Perjantai;12;5;17
95;04.03.2016;2016;03;08;Perjantai;2;5;7
95;04.03.2016;2016;03;09;Perjantai;1;2;3
95;04.03.2016;2016;03;10;Perjantai;4;3;7
95;04.03.2016;2016;03;11;Perjantai;1;0;1
95;04.03.2016;2016;03;12;Perjantai;6;0;6
95;04.03.2016;2016;03;13;Perjantai;8;3;11
95;04.03.2016;2016;03;14;Perjantai;14;6;20
95;04.03.2016;2016;03;15;Perjantai;2;5;7
95;04.03.2016;2016;03;16;Perjantai;3;8;11
95;04.03.2016;2016;03;17;Perjantai;1;4;5
95;04.03.2016;2016;03;18;Perjantai;1;2;3
95;04.03.2016;2016;03;19;Perjantai;1;0;1
95;04.03.2016;2016;03;20;Perjantai;1;2;3
95;04.03.2016;2016;03;21;Perjantai;1;0;1
95;04.03.2016;2016;03;22;Perjantai;0;5;5
95;04.03.2016;2016;03;23;Perjantai;0;0;0
95;05.03.2016;2016;03;00;Lauantai;0;0;0
95;05.03.2016;2016;03;01;Lauantai;0;0;0
95;05.03.2016;2016;03;02;Lauantai;0;0;0
95;05.03.2016;2016;03;03;Lauantai;0;0;0
95;05.03.2016;2016;03;04;Lauantai;0;0;0
95;05.03.2016;2016;03;05;Lauantai;0;1;1
95;05.03.2016;2016;03;06;Lauantai;1;1;2
95;05.03.2016;2016;03;07;Lauantai;2;0;2
95;05.03.2016;2016;03;08;Lauantai;0;0;0
95;05.03.2016;2016;03;09;Lauantai;2;0;2
95;05.03.2016;2016;03;10;Lauantai;1;1;2
95;05.03.2016;2016;03;11;Lauantai;3;1;4
95;05.03.2016;2016;03;12;Lauantai;3;1;4
95;05.03.2016;2016;03;13;Lauantai;4;3;7
95;05.03.2016;2016;03;14;Lauantai;4;3;7
95;05.03.2016;2016;03;15;Lauantai;2;2;4
95;05.03.2016;2016;03;16;Lauantai;2;3;5
95;05.03.2016;2016;03;17;Lauantai;2;4;6
95;05.03.2016;2016;03;18;Lauantai;4;4;8
95;05.03.2016;2016;03;19;Lauantai;1;2;3
95;05.03.2016;2016;03;20;Lauantai;0;1;1
95;05.03.2016;2016;03;21;Lauantai;1;0;1
95;05.03.2016;2016;03;22;Lauantai;2;2;4
95;05.03.2016;2016;03;23;Lauantai;1;0;1
95;06.03.2016;2016;03;00;Sunnuntai;0;0;0
95;06.03.2016;2016;03;01;Sunnuntai;0;0;0
95;06.03.2016;2016;03;02;Sunnuntai;0;1;1
95;06.03.2016;2016;03;03;Sunnuntai;0;0;0
95;06.03.2016;2016;03;04;Sunnuntai;0;0;0
95;06.03.2016;2016;03;05;Sunnuntai;0;1;1
95;06.03.2016;2016;03;06;Sunnuntai;2;0;2
95;06.03.2016;2016;03;07;Sunnuntai;1;0;1
95;06.03.2016;2016;03;08;Sunnuntai;0;1;1
95;06.03.2016;2016;03;09;Sunnuntai;1;0;1
95;06.03.2016;2016;03;10;Sunnuntai;5;1;6
95;06.03.2016;2016;03;11;Sunnuntai;4;0;4
95;06.03.2016;2016;03;12;Sunnuntai;2;4;6
95;06.03.2016;2016;03;13;Sunnuntai;5;2;7
95;06.03.2016;2016;03;14;Sunnuntai;10;0;10
95;06.03.2016;2016;03;15;Sunnuntai;0;0;0
95;06.03.2016;2016;03;16;Sunnuntai;3;4;7
95;06.03.2016;2016;03;17;Sunnuntai;1;2;3
95;06.03.2016;2016;03;18;Sunnuntai;3;2;5
95;06.03.2016;2016;03;19;Sunnuntai;0;1;1
95;06.03.2016;2016;03;20;Sunnuntai;0;0;0
95;06.03.2016;2016;03;21;Sunnuntai;0;2;2
95;06.03.2016;2016;03;22;Sunnuntai;1;1;2
95;06.03.2016;2016;03;23;Sunnuntai;1;1;2
95;07.03.2016;2016;03;00;Maanantai;0;0;0
95;07.03.2016;2016;03;01;Maanantai;1;1;2
95;07.03.2016;2016;03;02;Maanantai;0;0;0
95;07.03.2016;2016;03;03;Maanantai;0;0;0
95;07.03.2016;2016;03;04;Maanantai;1;0;1
95;07.03.2016;2016;03;05;Maanantai;3;2;5
95;07.03.2016;2016;03;06;Maanantai;4;5;9
95;07.03.2016;2016;03;07;Maanantai;9;3;12
95;07.03.2016;2016;03;08;Maanantai;1;4;5
95;07.03.2016;2016;03;09;Maanantai;5;2;7
95;07.03.2016;2016;03;10;Maanantai;2;0;2
95;07.03.2016;2016;03;11;Maanantai;1;0;1
95;07.03.2016;2016;03;12;Maanantai;4;2;6
95;07.03.2016;2016;03;13;Maanantai;5;5;10
95;07.03.2016;2016;03;14;Maanantai;5;1;6
95;07.03.2016;2016;03;15;Maanantai;5;4;9
95;07.03.2016;2016;03;16;Maanantai;6;3;9
95;07.03.2016;2016;03;17;Maanantai;5;7;12
95;07.03.2016;2016;03;18;Maanantai;2;9;11
95;07.03.2016;2016;03;19;Maanantai;0;1;1
95;07.03.2016;2016;03;20;Maanantai;1;0;1
95;07.03.2016;2016;03;21;Maanantai;2;2;4
95;07.03.2016;2016;03;22;Maanantai;2;6;8
95;07.03.2016;2016;03;23;Maanantai;1;0;1
95;08.03.2016;2016;03;00;Tiistai;0;0;0
95;08.03.2016;2016;03;01;Tiistai;0;1;1
95;08.03.2016;2016;03;02;Tiistai;0;0;0
95;08.03.2016;2016;03;03;Tiistai;0;0;0
95;08.03.2016;2016;03;04;Tiistai;0;0;0
95;08.03.2016;2016;03;05;Tiistai;4;3;7
95;08.03.2016;2016;03;06;Tiistai;5;5;10
95;08.03.2016;2016;03;07;Tiistai;10;4;14
95;08.03.2016;2016;03;08;Tiistai;3;1;4
95;08.03.2016;2016;03;09;Tiistai;2;4;6
95;08.03.2016;2016;03;10;Tiistai;9;2;11
95;08.03.2016;2016;03;11;Tiistai;4;2;6
95;08.03.2016;2016;03;12;Tiistai;5;5;10
95;08.03.2016;2016;03;13;Tiistai;2;2;4
95;08.03.2016;2016;03;14;Tiistai;6;5;11
95;08.03.2016;2016;03;15;Tiistai;11;8;19
95;08.03.2016;2016;03;16;Tiistai;1;2;3
95;08.03.2016;2016;03;17;Tiistai;5;5;10
95;08.03.2016;2016;03;18;Tiistai;2;1;3
95;08.03.2016;2016;03;19;Tiistai;1;2;3
95;08.03.2016;2016;03;20;Tiistai;0;0;0
95;08.03.2016;2016;03;21;Tiistai;0;1;1
95;08.03.2016;2016;03;22;Tiistai;2;3;5
95;08.03.2016;2016;03;23;Tiistai;0;0;0
95;09.03.2016;2016;03;00;Keskiviikko;0;0;0
95;09.03.2016;2016;03;01;Keskiviikko;0;0;0
95;09.03.2016;2016;03;02;Keskiviikko;0;0;0
95;09.03.2016;2016;03;03;Keskiviikko;0;0;0
95;09.03.2016;2016;03;04;Keskiviikko;0;0;0
95;09.03.2016;2016;03;05;Keskiviikko;5;3;8
95;09.03.2016;2016;03;06;Keskiviikko;4;6;10
95;09.03.2016;2016;03;07;Keskiviikko;5;3;8
95;09.03.2016;2016;03;08;Keskiviikko;1;3;4
95;09.03.2016;2016;03;09;Keskiviikko;1;2;3
95;09.03.2016;2016;03;10;Keskiviikko;2;2;4
95;09.03.2016;2016;03;11;Keskiviikko;4;0;4
95;09.03.2016;2016;03;12;Keskiviikko;3;3;6
95;09.03.2016;2016;03;13;Keskiviikko;1;4;5
95;09.03.2016;2016;03;14;Keskiviikko;5;2;7
95;09.03.2016;2016;03;15;Keskiviikko;5;6;11
95;09.03.2016;2016;03;16;Keskiviikko;6;4;10
95;09.03.2016;2016;03;17;Keskiviikko;3;6;9
95;09.03.2016;2016;03;18;Keskiviikko;2;5;7
95;09.03.2016;2016;03;19;Keskiviikko;3;4;7
95;09.03.2016;2016;03;20;Keskiviikko;1;0;1
95;09.03.2016;2016;03;21;Keskiviikko;0;1;1
95;09.03.2016;2016;03;22;Keskiviikko;2;1;3
95;09.03.2016;2016;03;23;Keskiviikko;0;0;0
95;10.03.2016;2016;03;00;Torstai;0;1;1
95;10.03.2016;2016;03;01;Torstai;0;0;0
95;10.03.2016;2016;03;02;Torstai;0;0;0
95;10.03.2016;2016;03;03;Torstai;0;0;0
95;10.03.2016;2016;03;04;Torstai;2;0;2
95;10.03.2016;2016;03;05;Torstai;3;3;6
95;10.03.2016;2016;03;06;Torstai;3;5;8
95;10.03.2016;2016;03;07;Torstai;4;1;5
95;10.03.2016;2016;03;08;Torstai;3;3;6
95;10.03.2016;2016;03;09;Torstai;0;3;3
95;10.03.2016;2016;03;10;Torstai;3;1;4
95;10.03.2016;2016;03;11;Torstai;0;4;4
95;10.03.2016;2016;03;12;Torstai;3;1;4
95;10.03.2016;2016;03;13;Torstai;1;3;4
95;10.03.2016;2016;03;14;Torstai;5;6;11
95;10.03.2016;2016;03;15;Torstai;4;4;8
95;10.03.2016;2016;03;16;Torstai;1;2;3
95;10.03.2016;2016;03;17;Torstai;7;3;10
95;10.03.2016;2016;03;18;Torstai;4;4;8
95;10.03.2016;2016;03;19;Torstai;0;2;2
95;10.03.2016;2016;03;20;Torstai;2;2;4
95;10.03.2016;2016;03;21;Torstai;4;1;5
95;10.03.2016;2016;03;22;Torstai;1;0;1
95;10.03.2016;2016;03;23;Torstai;0;0;0
95;11.03.2016;2016;03;00;Perjantai;0;0;0
95;11.03.2016;2016;03;01;Perjantai;0;0;0
95;11.03.2016;2016;03;02;Perjantai;1;0;1
95;11.03.2016;2016;03;03;Perjantai;0;0;0
95;11.03.2016;2016;03;04;Perjantai;1;0;1
95;11.03.2016;2016;03;05;Perjantai;3;3;6
95;11.03.2016;2016;03;06;Perjantai;3;5;8
95;11.03.2016;2016;03;07;Perjantai;3;3;6
95;11.03.2016;2016;03;08;Perjantai;1;1;2
95;11.03.2016;2016;03;09;Perjantai;1;0;1
95;11.03.2016;2016;03;10;Perjantai;3;3;6
95;11.03.2016;2016;03;11;Perjantai;3;3;6
95;11.03.2016;2016;03;12;Perjantai;1;2;3
95;11.03.2016;2016;03;13;Perjantai;1;2;3
95;11.03.2016;2016;03;14;Perjantai;6;4;10
95;11.03.2016;2016;03;15;Perjantai;3;1;4
95;11.03.2016;2016;03;16;Perjantai;4;3;7
95;11.03.2016;2016;03;17;Perjantai;1;3;4
95;11.03.2016;2016;03;18;Perjantai;0;4;4
95;11.03.2016;2016;03;19;Perjantai;3;2;5
95;11.03.2016;2016;03;20;Perjantai;0;1;1
95;11.03.2016;2016;03;21;Perjantai;0;0;0
95;11.03.2016;2016;03;22;Perjantai;1;1;2
95;11.03.2016;2016;03;23;Perjantai;0;0;0
95;12.03.2016;2016;03;00;Lauantai;0;0;0
95;12.03.2016;2016;03;01;Lauantai;0;0;0
95;12.03.2016;2016;03;02;Lauantai;0;0;0
95;12.03.2016;2016;03;03;Lauantai;0;0;0
95;12.03.2016;2016;03;04;Lauantai;0;0;0
95;12.03.2016;2016;03;05;Lauantai;1;0;1
95;12.03.2016;2016;03;06;Lauantai;0;0;0
95;12.03.2016;2016;03;07;Lauantai;0;1;1
95;12.03.2016;2016;03;08;Lauantai;4;1;5
95;12.03.2016;2016;03;09;Lauantai;2;1;3
95;12.03.2016;2016;03;10;Lauantai;0;2;2
95;12.03.2016;2016;03;11;Lauantai;1;1;2
95;12.03.2016;2016;03;12;Lauantai;5;1;6
95;12.03.2016;2016;03;13;Lauantai;0;5;5
95;12.03.2016;2016;03;14;Lauantai;4;4;8
95;12.03.2016;2016;03;15;Lauantai;2;1;3
95;12.03.2016;2016;03;16;Lauantai;0;2;2
95;12.03.2016;2016;03;17;Lauantai;3;2;5
95;12.03.2016;2016;03;18;Lauantai;1;4;5
95;12.03.2016;2016;03;19;Lauantai;3;1;4
95;12.03.2016;2016;03;20;Lauantai;0;1;1
95;12.03.2016;2016;03;21;Lauantai;0;1;1
95;12.03.2016;2016;03;22;Lauantai;0;1;1
95;12.03.2016;2016;03;23;Lauantai;0;0;0
95;13.03.2016;2016;03;00;Sunnuntai;0;0;0
95;13.03.2016;2016;03;01;Sunnuntai;0;0;0
95;13.03.2016;2016;03;02;Sunnuntai;0;0;0
95;13.03.2016;2016;03;03;Sunnuntai;0;0;0
95;13.03.2016;2016;03;04;Sunnuntai;1;0;1
95;13.03.2016;2016;03;05;Sunnuntai;1;0;1
95;13.03.2016;2016;03;06;Sunnuntai;1;0;1
95;13.03.2016;2016;03;07;Sunnuntai;0;2;2
95;13.03.2016;2016;03;08;Sunnuntai;0;3;3
95;13.03.2016;2016;03;09;Sunnuntai;1;1;2
95;13.03.2016;2016;03;10;Sunnuntai;0;2;2
95;13.03.2016;2016;03;11;Sunnuntai;2;0;2
95;13.03.2016;2016;03;12;Sunnuntai;4;4;8
95;13.03.2016;2016;03;13;Sunnuntai;2;6;8
95;13.03.2016;2016;03;14;Sunnuntai;2;5;7
95;13.03.2016;2016;03;15;Sunnuntai;5;1;6
95;13.03.2016;2016;03;16;Sunnuntai;1;1;2
95;13.03.2016;2016;03;17;Sunnuntai;4;0;4
95;13.03.2016;2016;03;18;Sunnuntai;1;2;3
95;13.03.2016;2016;03;19;Sunnuntai;0;1;1
95;13.03.2016;2016;03;20;Sunnuntai;1;2;3
95;13.03.2016;2016;03;21;Sunnuntai;3;0;3
95;13.03.2016;2016;03;22;Sunnuntai;0;2;2
95;13.03.2016;2016;03;23;Sunnuntai;0;0;0
95;14.03.2016;2016;03;00;Maanantai;0;0;0
95;14.03.2016;2016;03;01;Maanantai;0;0;0
95;14.03.2016;2016;03;02;Maanantai;0;0;0
95;14.03.2016;2016;03;03;Maanantai;0;0;0
95;14.03.2016;2016;03;04;Maanantai;1;0;1
95;14.03.2016;2016;03;05;Maanantai;2;3;5
95;14.03.2016;2016;03;06;Maanantai;7;4;11
95;14.03.2016;2016;03;07;Maanantai;10;7;17
95;14.03.2016;2016;03;08;Maanantai;3;4;7
95;14.03.2016;2016;03;09;Maanantai;3;4;7
95;14.03.2016;2016;03;10;Maanantai;4;1;5
95;14.03.2016;2016;03;11;Maanantai;3;2;5
95;14.03.2016;2016;03;12;Maanantai;4;7;11
95;14.03.2016;2016;03;13;Maanantai;4;2;6
95;14.03.2016;2016;03;14;Maanantai;6;8;14
95;14.03.2016;2016;03;15;Maanantai;12;4;16
95;14.03.2016;2016;03;16;Maanantai;13;3;16
95;14.03.2016;2016;03;17;Maanantai;4;8;12
95;14.03.2016;2016;03;18;Maanantai;5;8;13
95;14.03.2016;2016;03;19;Maanantai;0;4;4
95;14.03.2016;2016;03;20;Maanantai;2;1;3
95;14.03.2016;2016;03;21;Maanantai;6;1;7
95;14.03.2016;2016;03;22;Maanantai;0;2;2
95;14.03.2016;2016;03;23;Maanantai;0;0;0
95;15.03.2016;2016;03;00;Tiistai;1;0;1
95;15.03.2016;2016;03;01;Tiistai;1;0;1
95;15.03.2016;2016;03;02;Tiistai;0;0;0
95;15.03.2016;2016;03;03;Tiistai;0;0;0
95;15.03.2016;2016;03;04;Tiistai;1;1;2
95;15.03.2016;2016;03;05;Tiistai;3;2;5
95;15.03.2016;2016;03;06;Tiistai;8;5;13
95;15.03.2016;2016;03;07;Tiistai;8;13;21
95;15.03.2016;2016;03;08;Tiistai;3;7;10
95;15.03.2016;2016;03;09;Tiistai;2;1;3
95;15.03.2016;2016;03;10;Tiistai;6;5;11
95;15.03.2016;2016;03;11;Tiistai;5;6;11
95;15.03.2016;2016;03;12;Tiistai;14;2;16
95;15.03.2016;2016;03;13;Tiistai;2;7;9
95;15.03.2016;2016;03;14;Tiistai;8;3;11
95;15.03.2016;2016;03;15;Tiistai;13;12;25
95;15.03.2016;2016;03;16;Tiistai;12;7;19
95;15.03.2016;2016;03;17;Tiistai;6;12;18
95;15.03.2016;2016;03;18;Tiistai;2;7;9
95;15.03.2016;2016;03;19;Tiistai;3;2;5
95;15.03.2016;2016;03;20;Tiistai;1;1;2
95;15.03.2016;2016;03;21;Tiistai;3;1;4
95;15.03.2016;2016;03;22;Tiistai;1;1;2
95;15.03.2016;2016;03;23;Tiistai;0;0;0
95;16.03.2016;2016;03;00;Keskiviikko;1;0;1
95;16.03.2016;2016;03;01;Keskiviikko;1;0;1
95;16.03.2016;2016;03;02;Keskiviikko;0;0;0
95;16.03.2016;2016;03;03;Keskiviikko;0;0;0
95;16.03.2016;2016;03;04;Keskiviikko;0;0;0
95;16.03.2016;2016;03;05;Keskiviikko;4;2;6
95;16.03.2016;2016;03;06;Keskiviikko;9;8;17
95;16.03.2016;2016;03;07;Keskiviikko;9;9;18
95;16.03.2016;2016;03;08;Keskiviikko;3;7;10
95;16.03.2016;2016;03;09;Keskiviikko;4;2;6
95;16.03.2016;2016;03;10;Keskiviikko;4;3;7
95;16.03.2016;2016;03;11;Keskiviikko;6;3;9
95;16.03.2016;2016;03;12;Keskiviikko;6;2;8
95;16.03.2016;2016;03;13;Keskiviikko;7;6;13
95;16.03.2016;2016;03;14;Keskiviikko;7;3;10
95;16.03.2016;2016;03;15;Keskiviikko;9;7;16
95;16.03.2016;2016;03;16;Keskiviikko;8;3;11
95;16.03.2016;2016;03;17;Keskiviikko;4;5;9
95;16.03.2016;2016;03;18;Keskiviikko;2;6;8
95;16.03.2016;2016;03;19;Keskiviikko;3;6;9
95;16.03.2016;2016;03;20;Keskiviikko;1;0;1
95;16.03.2016;2016;03;21;Keskiviikko;2;2;4
95;16.03.2016;2016;03;22;Keskiviikko;1;1;2
95;16.03.2016;2016;03;23;Keskiviikko;0;0;0
95;17.03.2016;2016;03;00;Torstai;0;0;0
95;17.03.2016;2016;03;01;Torstai;0;0;0
95;17.03.2016;2016;03;02;Torstai;0;0;0
95;17.03.2016;2016;03;03;Torstai;0;0;0
95;17.03.2016;2016;03;04;Torstai;1;0;1
95;17.03.2016;2016;03;05;Torstai;3;1;4
95;17.03.2016;2016;03;06;Torstai;10;7;17
95;17.03.2016;2016;03;07;Torstai;11;6;17
95;17.03.2016;2016;03;08;Torstai;2;8;10
95;17.03.2016;2016;03;09;Torstai;0;2;2
95;17.03.2016;2016;03;10;Torstai;1;0;1
95;17.03.2016;2016;03;11;Torstai;4;0;4
95;17.03.2016;2016;03;12;Torstai;3;1;4
95;17.03.2016;2016;03;13;Torstai;1;5;6
95;17.03.2016;2016;03;14;Torstai;5;3;8
95;17.03.2016;2016;03;15;Torstai;6;11;17
95;17.03.2016;2016;03;16;Torstai;11;5;16
95;17.03.2016;2016;03;17;Torstai;0;5;5
95;17.03.2016;2016;03;18;Torstai;3;5;8
95;17.03.2016;2016;03;19;Torstai;1;1;2
95;17.03.2016;2016;03;20;Torstai;2;0;2
95;17.03.2016;2016;03;21;Torstai;1;2;3
95;17.03.2016;2016;03;22;Torstai;1;2;3
95;17.03.2016;2016;03;23;Torstai;0;0;0
95;18.03.2016;2016;03;00;Perjantai;1;0;1
95;18.03.2016;2016;03;01;Perjantai;0;0;0
95;18.03.2016;2016;03;02;Perjantai;0;0;0
95;18.03.2016;2016;03;03;Perjantai;0;0;0
95;18.03.2016;2016;03;04;Perjantai;1;0;1
95;18.03.2016;2016;03;05;Perjantai;2;4;6
95;18.03.2016;2016;03;06;Perjantai;4;3;7
95;18.03.2016;2016;03;07;Perjantai;7;7;14
95;18.03.2016;2016;03;08;Perjantai;1;3;4
95;18.03.2016;2016;03;09;Perjantai;3;3;6
95;18.03.2016;2016;03;10;Perjantai;1;0;1
95;18.03.2016;2016;03;11;Perjantai;6;0;6
95;18.03.2016;2016;03;12;Perjantai;4;5;9
95;18.03.2016;2016;03;13;Perjantai;3;4;7
95;18.03.2016;2016;03;14;Perjantai;7;5;12
95;18.03.2016;2016;03;15;Perjantai;4;3;7
95;18.03.2016;2016;03;16;Perjantai;4;5;9
95;18.03.2016;2016;03;17;Perjantai;2;5;7
95;18.03.2016;2016;03;18;Perjantai;1;5;6
95;18.03.2016;2016;03;19;Perjantai;10;1;11
95;18.03.2016;2016;03;20;Perjantai;1;0;1
95;18.03.2016;2016;03;21;Perjantai;2;2;4
95;18.03.2016;2016;03;22;Perjantai;0;1;1
95;18.03.2016;2016;03;23;Perjantai;0;0;0
95;19.03.2016;2016;03;00;Lauantai;0;0;0
95;19.03.2016;2016;03;01;Lauantai;2;0;2
95;19.03.2016;2016;03;02;Lauantai;0;0;0
95;19.03.2016;2016;03;03;Lauantai;0;0;0
95;19.03.2016;2016;03;04;Lauantai;0;0;0
95;19.03.2016;2016;03;05;Lauantai;0;0;0
95;19.03.2016;2016;03;06;Lauantai;6;1;7
95;19.03.2016;2016;03;07;Lauantai;1;0;1
95;19.03.2016;2016;03;08;Lauantai;1;1;2
95;19.03.2016;2016;03;09;Lauantai;2;3;5
95;19.03.2016;2016;03;10;Lauantai;0;0;0
95;19.03.2016;2016;03;11;Lauantai;0;0;0
95;19.03.2016;2016;03;12;Lauantai;1;3;4
95;19.03.2016;2016;03;13;Lauantai;4;4;8
95;19.03.2016;2016;03;14;Lauantai;3;3;6
95;19.03.2016;2016;03;15;Lauantai;2;5;7
95;19.03.2016;2016;03;16;Lauantai;2;3;5
95;19.03.2016;2016;03;17;Lauantai;0;4;4
95;19.03.2016;2016;03;18;Lauantai;1;1;2
95;19.03.2016;2016;03;19;Lauantai;4;1;5
95;19.03.2016;2016;03;20;Lauantai;1;1;2
95;19.03.2016;2016;03;21;Lauantai;3;0;3
95;19.03.2016;2016;03;22;Lauantai;0;1;1
95;19.03.2016;2016;03;23;Lauantai;0;0;0
95;20.03.2016;2016;03;00;Sunnuntai;0;0;0
95;20.03.2016;2016;03;01;Sunnuntai;0;0;0
95;20.03.2016;2016;03;02;Sunnuntai;0;0;0
95;20.03.2016;2016;03;03;Sunnuntai;0;0;0
95;20.03.2016;2016;03;04;Sunnuntai;0;0;0
95;20.03.2016;2016;03;05;Sunnuntai;0;0;0
95;20.03.2016;2016;03;06;Sunnuntai;1;0;1
95;20.03.2016;2016;03;07;Sunnuntai;0;0;0
95;20.03.2016;2016;03;08;Sunnuntai;2;1;3
95;20.03.2016;2016;03;09;Sunnuntai;0;3;3
95;20.03.2016;2016;03;10;Sunnuntai;1;0;1
95;20.03.2016;2016;03;11;Sunnuntai;5;5;10
95;20.03.2016;2016;03;12;Sunnuntai;4;2;6
95;20.03.2016;2016;03;13;Sunnuntai;7;6;13
95;20.03.2016;2016;03;14;Sunnuntai;3;7;10
95;20.03.2016;2016;03;15;Sunnuntai;2;5;7
95;20.03.2016;2016;03;16;Sunnuntai;4;5;9
95;20.03.2016;2016;03;17;Sunnuntai;2;2;4
95;20.03.2016;2016;03;18;Sunnuntai;3;0;3
95;20.03.2016;2016;03;19;Sunnuntai;5;0;5
95;20.03.2016;2016;03;20;Sunnuntai;0;0;0
95;20.03.2016;2016;03;21;Sunnuntai;2;0;2
95;20.03.2016;2016;03;22;Sunnuntai;1;1;2
95;20.03.2016;2016;03;23;Sunnuntai;1;0;1
95;21.03.2016;2016;03;00;Maanantai;0;0;0
95;21.03.2016;2016;03;01;Maanantai;0;0;0
95;21.03.2016;2016;03;02;Maanantai;0;0;0
95;21.03.2016;2016;03;03;Maanantai;0;0;0
95;21.03.2016;2016;03;04;Maanantai;1;0;1
95;21.03.2016;2016;03;05;Maanantai;3;1;4
95;21.03.2016;2016;03;06;Maanantai;6;5;11
95;21.03.2016;2016;03;07;Maanantai;4;9;13
95;21.03.2016;2016;03;08;Maanantai;4;4;8
95;21.03.2016;2016;03;09;Maanantai;0;2;2
95;21.03.2016;2016;03;10;Maanantai;3;0;3
95;21.03.2016;2016;03;11;Maanantai;4;2;6
95;21.03.2016;2016;03;12;Maanantai;5;7;12
95;21.03.2016;2016;03;13;Maanantai;3;7;10
95;21.03.2016;2016;03;14;Maanantai;5;5;10
95;21.03.2016;2016;03;15;Maanantai;6;5;11
95;21.03.2016;2016;03;16;Maanantai;10;3;13
95;21.03.2016;2016;03;17;Maanantai;4;7;11
95;21.03.2016;2016;03;18;Maanantai;3;6;9
95;21.03.2016;2016;03;19;Maanantai;4;5;9
95;21.03.2016;2016;03;20;Maanantai;2;1;3
95;21.03.2016;2016;03;21;Maanantai;0;1;1
95;21.03.2016;2016;03;22;Maanantai;2;1;3
95;21.03.2016;2016;03;23;Maanantai;0;0;0
95;22.03.2016;2016;03;00;Tiistai;0;0;0
95;22.03.2016;2016;03;01;Tiistai;0;0;0
95;22.03.2016;2016;03;02;Tiistai;0;0;0
95;22.03.2016;2016;03;03;Tiistai;0;0;0
95;22.03.2016;2016;03;04;Tiistai;1;0;1
95;22.03.2016;2016;03;05;Tiistai;7;1;8
95;22.03.2016;2016;03;06;Tiistai;4;5;9
95;22.03.2016;2016;03;07;Tiistai;10;6;16
95;22.03.2016;2016;03;08;Tiistai;3;6;9
95;22.03.2016;2016;03;09;Tiistai;1;2;3
95;22.03.2016;2016;03;10;Tiistai;3;1;4
95;22.03.2016;2016;03;11;Tiistai;6;3;9
95;22.03.2016;2016;03;12;Tiistai;2;3;5
95;22.03.2016;2016;03;13;Tiistai;3;7;10
95;22.03.2016;2016;03;14;Tiistai;5;9;14
95;22.03.2016;2016;03;15;Tiistai;8;8;16
95;22.03.2016;2016;03;16;Tiistai;3;9;12
95;22.03.2016;2016;03;17;Tiistai;5;5;10
95;22.03.2016;2016;03;18;Tiistai;1;5;6
95;22.03.2016;2016;03;19;Tiistai;1;2;3
95;22.03.2016;2016;03;20;Tiistai;1;2;3
95;22.03.2016;2016;03;21;Tiistai;1;1;2
95;22.03.2016;2016;03;22;Tiistai;2;0;2
95;22.03.2016;2016;03;23;Tiistai;0;0;0
95;23.03.2016;2016;03;00;Keskiviikko;0;0;0
95;23.03.2016;2016;03;01;Keskiviikko;1;0;1
95;23.03.2016;2016;03;02;Keskiviikko;0;0;0
95;23.03.2016;2016;03;03;Keskiviikko;0;0;0
95;23.03.2016;2016;03;04;Keskiviikko;1;0;1
95;23.03.2016;2016;03;05;Keskiviikko;4;1;5
95;23.03.2016;2016;03;06;Keskiviikko;5;6;11
95;23.03.2016;2016;03;07;Keskiviikko;8;6;14
95;23.03.2016;2016;03;08;Keskiviikko;3;6;9
95;23.03.2016;2016;03;09;Keskiviikko;1;3;4
95;23.03.2016;2016;03;10;Keskiviikko;1;3;4
95;23.03.2016;2016;03;11;Keskiviikko;3;1;4
95;23.03.2016;2016;03;12;Keskiviikko;6;3;9
95;23.03.2016;2016;03;13;Keskiviikko;6;5;11
95;23.03.2016;2016;03;14;Keskiviikko;5;3;8
95;23.03.2016;2016;03;15;Keskiviikko;5;10;15
95;23.03.2016;2016;03;16;Keskiviikko;6;4;10
95;23.03.2016;2016;03;17;Keskiviikko;4;10;14
95;23.03.2016;2016;03;18;Keskiviikko;2;2;4
95;23.03.2016;2016;03;19;Keskiviikko;3;3;6
95;23.03.2016;2016;03;20;Keskiviikko;1;1;2
95;23.03.2016;2016;03;21;Keskiviikko;1;4;5
95;23.03.2016;2016;03;22;Keskiviikko;3;1;4
95;23.03.2016;2016;03;23;Keskiviikko;0;0;0
95;24.03.2016;2016;03;00;Torstai;0;0;0
95;24.03.2016;2016;03;01;Torstai;0;0;0
95;24.03.2016;2016;03;02;Torstai;0;0;0
95;24.03.2016;2016;03;03;Torstai;0;0;0
95;24.03.2016;2016;03;04;Torstai;0;0;0
95;24.03.2016;2016;03;05;Torstai;2;2;4
95;24.03.2016;2016;03;06;Torstai;7;8;15
95;24.03.2016;2016;03;07;Torstai;6;4;10
95;24.03.2016;2016;03;08;Torstai;4;3;7
95;24.03.2016;2016;03;09;Torstai;1;3;4
95;24.03.2016;2016;03;10;Torstai;4;0;4
95;24.03.2016;2016;03;11;Torstai;3;2;5
95;24.03.2016;2016;03;12;Torstai;6;4;10
95;24.03.2016;2016;03;13;Torstai;2;4;6
95;24.03.2016;2016;03;14;Torstai;10;8;18
95;24.03.2016;2016;03;15;Torstai;2;4;6
95;24.03.2016;2016;03;16;Torstai;7;2;9
95;24.03.2016;2016;03;17;Torstai;0;1;1
95;24.03.2016;2016;03;18;Torstai;4;2;6
95;24.03.2016;2016;03;19;Torstai;0;3;3
95;24.03.2016;2016;03;20;Torstai;1;0;1
95;24.03.2016;2016;03;21;Torstai;1;1;2
95;24.03.2016;2016;03;22;Torstai;0;4;4
95;24.03.2016;2016;03;23;Torstai;0;0;0
95;25.03.2016;2016;03;00;Perjantai;1;0;1
95;25.03.2016;2016;03;01;Perjantai;0;0;0
95;25.03.2016;2016;03;02;Perjantai;0;0;0
95;25.03.2016;2016;03;03;Perjantai;0;0;0
95;25.03.2016;2016;03;04;Perjantai;0;0;0
95;25.03.2016;2016;03;05;Perjantai;0;0;0
95;25.03.2016;2016;03;06;Perjantai;1;0;1
95;25.03.2016;2016;03;07;Perjantai;0;0;0
95;25.03.2016;2016;03;08;Perjantai;0;0;0
95;25.03.2016;2016;03;09;Perjantai;0;0;0
95;25.03.2016;2016;03;10;Perjantai;2;2;4
95;25.03.2016;2016;03;11;Perjantai;2;0;2
95;25.03.2016;2016;03;12;Perjantai;1;2;3
95;25.03.2016;2016;03;13;Perjantai;2;3;5
95;25.03.2016;2016;03;14;Perjantai;1;1;2
95;25.03.2016;2016;03;15;Perjantai;2;0;2
95;25.03.2016;2016;03;16;Perjantai;2;4;6
95;25.03.2016;2016;03;17;Perjantai;2;1;3
95;25.03.2016;2016;03;18;Perjantai;1;1;2
95;25.03.2016;2016;03;19;Perjantai;1;1;2
95;25.03.2016;2016;03;20;Perjantai;0;0;0
95;25.03.2016;2016;03;21;Perjantai;3;1;4
95;25.03.2016;2016;03;22;Perjantai;0;3;3
95;25.03.2016;2016;03;23;Perjantai;0;0;0
95;26.03.2016;2016;03;00;Lauantai;0;0;0
95;26.03.2016;2016;03;01;Lauantai;0;0;0
95;26.03.2016;2016;03;02;Lauantai;0;0;0
95;26.03.2016;2016;03;03;Lauantai;0;0;0
95;26.03.2016;2016;03;04;Lauantai;0;0;0
95;26.03.2016;2016;03;05;Lauantai;3;0;3
95;26.03.2016;2016;03;06;Lauantai;2;0;2
95;26.03.2016;2016;03;07;Lauantai;0;0;0
95;26.03.2016;2016;03;08;Lauantai;0;2;2
95;26.03.2016;2016;03;09;Lauantai;2;1;3
95;26.03.2016;2016;03;10;Lauantai;4;2;6
95;26.03.2016;2016;03;11;Lauantai;1;3;4
95;26.03.2016;2016;03;12;Lauantai;2;4;6
95;26.03.2016;2016;03;13;Lauantai;2;4;6
95;26.03.2016;2016;03;14;Lauantai;2;5;7
95;26.03.2016;2016;03;15;Lauantai;2;4;6
95;26.03.2016;2016;03;16;Lauantai;2;5;7
95;26.03.2016;2016;03;17;Lauantai;4;5;9
95;26.03.2016;2016;03;18;Lauantai;6;3;9
95;26.03.2016;2016;03;19;Lauantai;2;2;4
95;26.03.2016;2016;03;20;Lauantai;1;0;1
95;26.03.2016;2016;03;21;Lauantai;1;1;2
95;26.03.2016;2016;03;22;Lauantai;0;1;1
95;26.03.2016;2016;03;23;Lauantai;0;0;0
95;27.03.2016;2016;03;00;Sunnuntai;0;0;0
95;27.03.2016;2016;03;01;Sunnuntai;0;0;0
95;27.03.2016;2016;03;02;Sunnuntai;0;0;0
95;27.03.2016;2016;03;03;Sunnuntai;0;0;0
95;27.03.2016;2016;03;04;Sunnuntai;0;0;0
95;27.03.2016;2016;03;05;Sunnuntai;2;1;3
95;27.03.2016;2016;03;06;Sunnuntai;1;1;2
95;27.03.2016;2016;03;07;Sunnuntai;0;1;1
95;27.03.2016;2016;03;08;Sunnuntai;1;2;3
95;27.03.2016;2016;03;09;Sunnuntai;1;1;2
95;27.03.2016;2016;03;10;Sunnuntai;1;6;7
95;27.03.2016;2016;03;11;Sunnuntai;2;3;5
95;27.03.2016;2016;03;12;Sunnuntai;4;2;6
95;27.03.2016;2016;03;13;Sunnuntai;4;11;15
95;27.03.2016;2016;03;14;Sunnuntai;12;8;20
95;27.03.2016;2016;03;15;Sunnuntai;5;9;14
95;27.03.2016;2016;03;16;Sunnuntai;4;3;7
95;27.03.2016;2016;03;17;Sunnuntai;1;4;5
95;27.03.2016;2016;03;18;Sunnuntai;8;6;14
95;27.03.2016;2016;03;19;Sunnuntai;3;4;7
95;27.03.2016;2016;03;20;Sunnuntai;2;2;4
95;27.03.2016;2016;03;21;Sunnuntai;0;1;1
95;27.03.2016;2016;03;22;Sunnuntai;1;3;4
95;27.03.2016;2016;03;23;Sunnuntai;0;0;0
95;28.03.2016;2016;03;00;Maanantai;0;0;0
95;28.03.2016;2016;03;01;Maanantai;0;0;0
95;28.03.2016;2016;03;02;Maanantai;0;0;0
95;28.03.2016;2016;03;03;Maanantai;0;0;0
95;28.03.2016;2016;03;04;Maanantai;1;0;1
95;28.03.2016;2016;03;05;Maanantai;1;2;3
95;28.03.2016;2016;03;06;Maanantai;2;1;3
95;28.03.2016;2016;03;07;Maanantai;2;1;3
95;28.03.2016;2016;03;08;Maanantai;1;0;1
95;28.03.2016;2016;03;09;Maanantai;1;2;3
95;28.03.2016;2016;03;10;Maanantai;5;10;15
95;28.03.2016;2016;03;11;Maanantai;2;1;3
95;28.03.2016;2016;03;12;Maanantai;12;2;14
95;28.03.2016;2016;03;13;Maanantai;2;13;15
95;28.03.2016;2016;03;14;Maanantai;3;11;14
95;28.03.2016;2016;03;15;Maanantai;6;15;21
95;28.03.2016;2016;03;16;Maanantai;15;13;28
95;28.03.2016;2016;03;17;Maanantai;12;12;24
95;28.03.2016;2016;03;18;Maanantai;15;6;21
95;28.03.2016;2016;03;19;Maanantai;7;2;9
95;28.03.2016;2016;03;20;Maanantai;4;3;7
95;28.03.2016;2016;03;21;Maanantai;1;1;2
95;28.03.2016;2016;03;22;Maanantai;0;5;5
95;28.03.2016;2016;03;23;Maanantai;1;0;1
95;29.03.2016;2016;03;00;Tiistai;0;0;0
95;29.03.2016;2016;03;01;Tiistai;0;0;0
95;29.03.2016;2016;03;02;Tiistai;0;0;0
95;29.03.2016;2016;03;03;Tiistai;0;0;0
95;29.03.2016;2016;03;04;Tiistai;2;0;2
95;29.03.2016;2016;03;05;Tiistai;6;3;9
95;29.03.2016;2016;03;06;Tiistai;14;6;20
95;29.03.2016;2016;03;07;Tiistai;11;9;20
95;29.03.2016;2016;03;08;Tiistai;5;7;12
95;29.03.2016;2016;03;09;Tiistai;2;6;8
95;29.03.2016;2016;03;10;Tiistai;3;6;9
95;29.03.2016;2016;03;11;Tiistai;7;4;11
95;29.03.2016;2016;03;12;Tiistai;8;6;14
95;29.03.2016;2016;03;13;Tiistai;7;13;20
95;29.03.2016;2016;03;14;Tiistai;9;12;21
95;29.03.2016;2016;03;15;Tiistai;11;22;33
95;29.03.2016;2016;03;16;Tiistai;22;18;40
95;29.03.2016;2016;03;17;Tiistai;15;11;26
95;29.03.2016;2016;03;18;Tiistai;8;23;31
95;29.03.2016;2016;03;19;Tiistai;12;15;27
95;29.03.2016;2016;03;20;Tiistai;0;4;4
95;29.03.2016;2016;03;21;Tiistai;4;1;5
95;29.03.2016;2016;03;22;Tiistai;2;0;2
95;29.03.2016;2016;03;23;Tiistai;0;1;1
95;30.03.2016;2016;03;00;Keskiviikko;2;1;3
95;30.03.2016;2016;03;01;Keskiviikko;0;0;0
95;30.03.2016;2016;03;02;Keskiviikko;0;0;0
95;30.03.2016;2016;03;03;Keskiviikko;0;0;0
95;30.03.2016;2016;03;04;Keskiviikko;1;0;1
95;30.03.2016;2016;03;05;Keskiviikko;6;3;9
95;30.03.2016;2016;03;06;Keskiviikko;9;7;16
95;30.03.2016;2016;03;07;Keskiviikko;11;14;25
95;30.03.2016;2016;03;08;Keskiviikko;6;4;10
95;30.03.2016;2016;03;09;Keskiviikko;1;4;5
95;30.03.2016;2016;03;10;Keskiviikko;2;2;4
95;30.03.2016;2016;03;11;Keskiviikko;6;5;11
95;30.03.2016;2016;03;12;Keskiviikko;6;4;10
95;30.03.2016;2016;03;13;Keskiviikko;3;6;9
95;30.03.2016;2016;03;14;Keskiviikko;13;11;24
95;30.03.2016;2016;03;15;Keskiviikko;15;14;29
95;30.03.2016;2016;03;16;Keskiviikko;13;16;29
95;30.03.2016;2016;03;17;Keskiviikko;10;17;27
95;30.03.2016;2016;03;18;Keskiviikko;8;11;19
95;30.03.2016;2016;03;19;Keskiviikko;5;6;11
95;30.03.2016;2016;03;20;Keskiviikko;0;2;2
95;30.03.2016;2016;03;21;Keskiviikko;2;1;3
95;30.03.2016;2016;03;22;Keskiviikko;2;1;3
95;30.03.2016;2016;03;23;Keskiviikko;0;0;0
95;31.03.2016;2016;03;00;Torstai;0;0;0
95;31.03.2016;2016;03;01;Torstai;0;0;0
95;31.03.2016;2016;03;02;Torstai;0;0;0
95;31.03.2016;2016;03;03;Torstai;1;0;1
95;31.03.2016;2016;03;04;Torstai;1;0;1
95;31.03.2016;2016;03;05;Torstai;4;2;6
95;31.03.2016;2016;03;06;Torstai;10;10;20
95;31.03.2016;2016;03;07;Torstai;9;14;23
95;31.03.2016;2016;03;08;Torstai;8;9;17
95;31.03.2016;2016;03;09;Torstai;5;4;9
95;31.03.2016;2016;03;10;Torstai;4;1;5
95;31.03.2016;2016;03;11;Torstai;4;3;7
95;31.03.2016;2016;03;12;Torstai;12;8;20
95;31.03.2016;2016;03;13;Torstai;8;6;14
95;31.03.2016;2016;03;14;Torstai;4;10;14
95;31.03.2016;2016;03;15;Torstai;18;15;33
95;31.03.2016;2016;03;16;Torstai;15;12;27
95;31.03.2016;2016;03;17;Torstai;8;11;19
95;31.03.2016;2016;03;18;Torstai;6;13;19
95;31.03.2016;2016;03;19;Torstai;4;10;14
95;31.03.2016;2016;03;20;Torstai;4;3;7
95;31.03.2016;2016;03;21;Torstai;2;2;4
95;31.03.2016;2016;03;22;Torstai;1;3;4
95;31.03.2016;2016;03;23;Torstai;0;0;0
95;01.04.2016;2016;04;00;Perjantai;0;0;0
95;01.04.2016;2016;04;01;Perjantai;0;0;0
95;01.04.2016;2016;04;02;Perjantai;0;0;0
95;01.04.2016;2016;04;03;Perjantai;0;0;0
95;01.04.2016;2016;04;04;Perjantai;1;0;1
95;01.04.2016;2016;04;05;Perjantai;4;5;9
95;01.04.2016;2016;04;06;Perjantai;9;3;12
95;01.04.2016;2016;04;07;Perjantai;11;10;21
95;01.04.2016;2016;04;08;Perjantai;7;7;14
95;01.04.2016;2016;04;09;Perjantai;3;1;4
95;01.04.2016;2016;04;10;Perjantai;3;4;7
95;01.04.2016;2016;04;11;Perjantai;10;4;14
95;01.04.2016;2016;04;12;Perjantai;4;8;12
95;01.04.2016;2016;04;13;Perjantai;6;5;11
95;01.04.2016;2016;04;14;Perjantai;8;18;26
95;01.04.2016;2016;04;15;Perjantai;11;8;19
95;01.04.2016;2016;04;16;Perjantai;18;13;31
95;01.04.2016;2016;04;17;Perjantai;3;12;15
95;01.04.2016;2016;04;18;Perjantai;4;4;8
95;01.04.2016;2016;04;19;Perjantai;4;12;16
95;01.04.2016;2016;04;20;Perjantai;3;1;4
95;01.04.2016;2016;04;21;Perjantai;4;1;5
95;01.04.2016;2016;04;22;Perjantai;0;2;2
95;01.04.2016;2016;04;23;Perjantai;3;4;7
95;02.04.2016;2016;04;00;Lauantai;1;0;1
95;02.04.2016;2016;04;01;Lauantai;0;0;0
95;02.04.2016;2016;04;02;Lauantai;0;0;0
95;02.04.2016;2016;04;03;Lauantai;0;0;0
95;02.04.2016;2016;04;04;Lauantai;2;0;2
95;02.04.2016;2016;04;05;Lauantai;1;0;1
95;02.04.2016;2016;04;06;Lauantai;3;2;5
95;02.04.2016;2016;04;07;Lauantai;2;3;5
95;02.04.2016;2016;04;08;Lauantai;3;4;7
95;02.04.2016;2016;04;09;Lauantai;0;5;5
95;02.04.2016;2016;04;10;Lauantai;4;4;8
95;02.04.2016;2016;04;11;Lauantai;4;6;10
95;02.04.2016;2016;04;12;Lauantai;4;8;12
95;02.04.2016;2016;04;13;Lauantai;9;13;22
95;02.04.2016;2016;04;14;Lauantai;8;10;18
95;02.04.2016;2016;04;15;Lauantai;8;15;23
95;02.04.2016;2016;04;16;Lauantai;9;9;18
95;02.04.2016;2016;04;17;Lauantai;1;6;7
95;02.04.2016;2016;04;18;Lauantai;2;6;8
95;02.04.2016;2016;04;19;Lauantai;2;3;5
95;02.04.2016;2016;04;20;Lauantai;4;3;7
95;02.04.2016;2016;04;21;Lauantai;1;0;1
95;02.04.2016;2016;04;22;Lauantai;0;0;0
95;02.04.2016;2016;04;23;Lauantai;0;0;0
95;03.04.2016;2016;04;00;Sunnuntai;0;0;0
95;03.04.2016;2016;04;01;Sunnuntai;0;0;0
95;03.04.2016;2016;04;02;Sunnuntai;0;0;0
95;03.04.2016;2016;04;03;Sunnuntai;0;0;0
95;03.04.2016;2016;04;04;Sunnuntai;1;0;1
95;03.04.2016;2016;04;05;Sunnuntai;0;0;0
95;03.04.2016;2016;04;06;Sunnuntai;2;1;3
95;03.04.2016;2016;04;07;Sunnuntai;1;1;2
95;03.04.2016;2016;04;08;Sunnuntai;2;6;8
95;03.04.2016;2016;04;09;Sunnuntai;5;2;7
95;03.04.2016;2016;04;10;Sunnuntai;10;14;24
95;03.04.2016;2016;04;11;Sunnuntai;4;11;15
95;03.04.2016;2016;04;12;Sunnuntai;19;16;35
95;03.04.2016;2016;04;13;Sunnuntai;17;13;30
95;03.04.2016;2016;04;14;Sunnuntai;6;21;27
95;03.04.2016;2016;04;15;Sunnuntai;16;11;27
95;03.04.2016;2016;04;16;Sunnuntai;12;15;27
95;03.04.2016;2016;04;17;Sunnuntai;11;6;17
95;03.04.2016;2016;04;18;Sunnuntai;19;12;31
95;03.04.2016;2016;04;19;Sunnuntai;12;6;18
95;03.04.2016;2016;04;20;Sunnuntai;3;1;4
95;03.04.2016;2016;04;21;Sunnuntai;3;5;8
95;03.04.2016;2016;04;22;Sunnuntai;0;1;1
95;03.04.2016;2016;04;23;Sunnuntai;0;0;0
95;04.04.2016;2016;04;00;Maanantai;0;0;0
95;04.04.2016;2016;04;01;Maanantai;0;0;0
95;04.04.2016;2016;04;02;Maanantai;0;0;0
95;04.04.2016;2016;04;03;Maanantai;0;0;0
95;04.04.2016;2016;04;04;Maanantai;1;0;1
95;04.04.2016;2016;04;05;Maanantai;6;5;11
95;04.04.2016;2016;04;06;Maanantai;19;7;26
95;04.04.2016;2016;04;07;Maanantai;11;10;21
95;04.04.2016;2016;04;08;Maanantai;7;7;14
95;04.04.2016;2016;04;09;Maanantai;6;7;13
95;04.04.2016;2016;04;10;Maanantai;4;7;11
95;04.04.2016;2016;04;11;Maanantai;11;8;19
95;04.04.2016;2016;04;12;Maanantai;11;8;19
95;04.04.2016;2016;04;13;Maanantai;8;9;17
95;04.04.2016;2016;04;14;Maanantai;9;7;16
95;04.04.2016;2016;04;15;Maanantai;19;24;43
95;04.04.2016;2016;04;16;Maanantai;22;29;51
95;04.04.2016;2016;04;17;Maanantai;17;18;35
95;04.04.2016;2016;04;18;Maanantai;17;26;43
95;04.04.2016;2016;04;19;Maanantai;8;13;21
95;04.04.2016;2016;04;20;Maanantai;8;11;19
95;04.04.2016;2016;04;21;Maanantai;2;3;5
95;04.04.2016;2016;04;22;Maanantai;3;1;4
95;04.04.2016;2016;04;23;Maanantai;0;1;1
95;05.04.2016;2016;04;00;Tiistai;0;0;0
95;05.04.2016;2016;04;01;Tiistai;0;0;0
95;05.04.2016;2016;04;02;Tiistai;0;0;0
95;05.04.2016;2016;04;03;Tiistai;0;0;0
95;05.04.2016;2016;04;04;Tiistai;0;0;0
95;05.04.2016;2016;04;05;Tiistai;8;3;11
95;05.04.2016;2016;04;06;Tiistai;10;7;17
95;05.04.2016;2016;04;07;Tiistai;10;10;20
95;05.04.2016;2016;04;08;Tiistai;8;7;15
95;05.04.2016;2016;04;09;Tiistai;5;0;5
95;05.04.2016;2016;04;10;Tiistai;6;5;11
95;05.04.2016;2016;04;11;Tiistai;3;4;7
95;05.04.2016;2016;04;12;Tiistai;4;2;6
95;05.04.2016;2016;04;13;Tiistai;1;1;2
95;05.04.2016;2016;04;14;Tiistai;9;5;14
95;05.04.2016;2016;04;15;Tiistai;8;11;19
95;05.04.2016;2016;04;16;Tiistai;9;8;17
95;05.04.2016;2016;04;17;Tiistai;5;16;21
95;05.04.2016;2016;04;18;Tiistai;7;7;14
95;05.04.2016;2016;04;19;Tiistai;5;6;11
95;05.04.2016;2016;04;20;Tiistai;4;2;6
95;05.04.2016;2016;04;21;Tiistai;2;1;3
95;05.04.2016;2016;04;22;Tiistai;2;2;4
95;05.04.2016;2016;04;23;Tiistai;0;0;0
95;06.04.2016;2016;04;00;Keskiviikko;0;0;0
95;06.04.2016;2016;04;01;Keskiviikko;0;0;0
95;06.04.2016;2016;04;02;Keskiviikko;0;0;0
95;06.04.2016;2016;04;03;Keskiviikko;0;0;0
95;06.04.2016;2016;04;04;Keskiviikko;0;0;0
95;06.04.2016;2016;04;05;Keskiviikko;5;4;9
95;06.04.2016;2016;04;06;Keskiviikko;8;7;15
95;06.04.2016;2016;04;07;Keskiviikko;5;6;11
95;06.04.2016;2016;04;08;Keskiviikko;4;9;13
95;06.04.2016;2016;04;09;Keskiviikko;3;3;6
95;06.04.2016;2016;04;10;Keskiviikko;7;2;9
95;06.04.2016;2016;04;11;Keskiviikko;3;7;10
95;06.04.2016;2016;04;12;Keskiviikko;5;6;11
95;06.04.2016;2016;04;13;Keskiviikko;8;5;13
95;06.04.2016;2016;04;14;Keskiviikko;8;7;15
95;06.04.2016;2016;04;15;Keskiviikko;17;10;27
95;06.04.2016;2016;04;16;Keskiviikko;7;10;17
95;06.04.2016;2016;04;17;Keskiviikko;2;7;9
95;06.04.2016;2016;04;18;Keskiviikko;2;4;6
95;06.04.2016;2016;04;19;Keskiviikko;2;3;5
95;06.04.2016;2016;04;20;Keskiviikko;1;2;3
95;06.04.2016;2016;04;21;Keskiviikko;3;2;5
95;06.04.2016;2016;04;22;Keskiviikko;5;0;5
95;06.04.2016;2016;04;23;Keskiviikko;0;1;1
95;07.04.2016;2016;04;00;Torstai;0;0;0
95;07.04.2016;2016;04;01;Torstai;1;0;1
95;07.04.2016;2016;04;02;Torstai;0;0;0
95;07.04.2016;2016;04;03;Torstai;0;0;0
95;07.04.2016;2016;04;04;Torstai;0;0;0
95;07.04.2016;2016;04;05;Torstai;6;5;11
95;07.04.2016;2016;04;06;Torstai;10;5;15
95;07.04.2016;2016;04;07;Torstai;8;7;15
95;07.04.2016;2016;04;08;Torstai;4;6;10
95;07.04.2016;2016;04;09;Torstai;4;4;8
95;07.04.2016;2016;04;10;Torstai;8;3;11
95;07.04.2016;2016;04;11;Torstai;1;0;1
95;07.04.2016;2016;04;12;Torstai;2;1;3
95;07.04.2016;2016;04;13;Torstai;2;4;6
95;07.04.2016;2016;04;14;Torstai;7;13;20
95;07.04.2016;2016;04;15;Torstai;13;11;24
95;07.04.2016;2016;04;16;Torstai;14;17;31
95;07.04.2016;2016;04;17;Torstai;8;16;24
95;07.04.2016;2016;04;18;Torstai;8;9;17
95;07.04.2016;2016;04;19;Torstai;10;4;14
95;07.04.2016;2016;04;20;Torstai;2;6;8
95;07.04.2016;2016;04;21;Torstai;0;2;2
95;07.04.2016;2016;04;22;Torstai;2;0;2
95;07.04.2016;2016;04;23;Torstai;0;0;0
95;08.04.2016;2016;04;00;Perjantai;0;0;0
95;08.04.2016;2016;04;01;Perjantai;0;0;0
95;08.04.2016;2016;04;02;Perjantai;0;0;0
95;08.04.2016;2016;04;03;Perjantai;0;0;0
95;08.04.2016;2016;04;04;Perjantai;1;1;2
95;08.04.2016;2016;04;05;Perjantai;5;3;8
95;08.04.2016;2016;04;06;Perjantai;9;2;11
95;08.04.2016;2016;04;07;Perjantai;7;9;16
95;08.04.2016;2016;04;08;Perjantai;4;6;10
95;08.04.2016;2016;04;09;Perjantai;3;4;7
95;08.04.2016;2016;04;10;Perjantai;6;1;7
95;08.04.2016;2016;04;11;Perjantai;4;0;4
95;08.04.2016;2016;04;12;Perjantai;4;2;6
95;08.04.2016;2016;04;13;Perjantai;6;4;10
95;08.04.2016;2016;04;14;Perjantai;15;7;22
95;08.04.2016;2016;04;15;Perjantai;7;9;16
95;08.04.2016;2016;04;16;Perjantai;8;15;23
95;08.04.2016;2016;04;17;Perjantai;5;13;18
95;08.04.2016;2016;04;18;Perjantai;6;7;13
95;08.04.2016;2016;04;19;Perjantai;6;1;7
95;08.04.2016;2016;04;20;Perjantai;1;2;3
95;08.04.2016;2016;04;21;Perjantai;1;1;2
95;08.04.2016;2016;04;22;Perjantai;2;1;3
95;08.04.2016;2016;04;23;Perjantai;1;0;1
95;09.04.2016;2016;04;00;Lauantai;0;0;0
95;09.04.2016;2016;04;01;Lauantai;1;0;1
95;09.04.2016;2016;04;02;Lauantai;0;0;0
95;09.04.2016;2016;04;03;Lauantai;0;0;0
95;09.04.2016;2016;04;04;Lauantai;2;0;2
95;09.04.2016;2016;04;05;Lauantai;2;1;3
95;09.04.2016;2016;04;06;Lauantai;2;1;3
95;09.04.2016;2016;04;07;Lauantai;1;5;6
95;09.04.2016;2016;04;08;Lauantai;5;3;8
95;09.04.2016;2016;04;09;Lauantai;9;7;16
95;09.04.2016;2016;04;10;Lauantai;12;12;24
95;09.04.2016;2016;04;11;Lauantai;14;12;26
95;09.04.2016;2016;04;12;Lauantai;18;15;33
95;09.04.2016;2016;04;13;Lauantai;16;15;31
95;09.04.2016;2016;04;14;Lauantai;9;20;29
95;09.04.2016;2016;04;15;Lauantai;13;18;31
95;09.04.2016;2016;04;16;Lauantai;15;17;32
95;09.04.2016;2016;04;17;Lauantai;14;13;27
95;09.04.2016;2016;04;18;Lauantai;7;8;15
95;09.04.2016;2016;04;19;Lauantai;8;7;15
95;09.04.2016;2016;04;20;Lauantai;3;8;11
95;09.04.2016;2016;04;21;Lauantai;2;3;5
95;09.04.2016;2016;04;22;Lauantai;0;4;4
95;09.04.2016;2016;04;23;Lauantai;0;0;0
95;10.04.2016;2016;04;00;Sunnuntai;0;1;1
95;10.04.2016;2016;04;01;Sunnuntai;0;0;0
95;10.04.2016;2016;04;02;Sunnuntai;0;0;0
95;10.04.2016;2016;04;03;Sunnuntai;0;0;0
95;10.04.2016;2016;04;04;Sunnuntai;0;0;0
95;10.04.2016;2016;04;05;Sunnuntai;2;0;2
95;10.04.2016;2016;04;06;Sunnuntai;4;1;5
95;10.04.2016;2016;04;07;Sunnuntai;2;0;2
95;10.04.2016;2016;04;08;Sunnuntai;2;5;7
95;10.04.2016;2016;04;09;Sunnuntai;5;5;10
95;10.04.2016;2016;04;10;Sunnuntai;11;6;17
95;10.04.2016;2016;04;11;Sunnuntai;19;9;28
95;10.04.2016;2016;04;12;Sunnuntai;28;19;47
95;10.04.2016;2016;04;13;Sunnuntai;22;21;43
95;10.04.2016;2016;04;14;Sunnuntai;13;31;44
95;10.04.2016;2016;04;15;Sunnuntai;17;13;30
95;10.04.2016;2016;04;16;Sunnuntai;20;12;32
95;10.04.2016;2016;04;17;Sunnuntai;18;6;24
95;10.04.2016;2016;04;18;Sunnuntai;5;18;23
95;10.04.2016;2016;04;19;Sunnuntai;8;13;21
95;10.04.2016;2016;04;20;Sunnuntai;4;3;7
95;10.04.2016;2016;04;21;Sunnuntai;2;2;4
95;10.04.2016;2016;04;22;Sunnuntai;1;3;4
95;10.04.2016;2016;04;23;Sunnuntai;0;0;0
95;11.04.2016;2016;04;00;Maanantai;1;0;1
95;11.04.2016;2016;04;01;Maanantai;0;0;0
95;11.04.2016;2016;04;02;Maanantai;0;0;0
95;11.04.2016;2016;04;03;Maanantai;0;0;0
95;11.04.2016;2016;04;04;Maanantai;0;1;1
95;11.04.2016;2016;04;05;Maanantai;4;5;9
95;11.04.2016;2016;04;06;Maanantai;22;7;29
95;11.04.2016;2016;04;07;Maanantai;10;16;26
95;11.04.2016;2016;04;08;Maanantai;8;12;20
95;11.04.2016;2016;04;09;Maanantai;6;3;9
95;11.04.2016;2016;04;10;Maanantai;5;3;8
95;11.04.2016;2016;04;11;Maanantai;6;6;12
95;11.04.2016;2016;04;12;Maanantai;18;1;19
95;11.04.2016;2016;04;13;Maanantai;18;5;23
95;11.04.2016;2016;04;14;Maanantai;11;18;29
95;11.04.2016;2016;04;15;Maanantai;25;32;57
95;11.04.2016;2016;04;16;Maanantai;41;24;65
95;11.04.2016;2016;04;17;Maanantai;13;26;39
95;11.04.2016;2016;04;18;Maanantai;15;21;36
95;11.04.2016;2016;04;19;Maanantai;3;12;15
95;11.04.2016;2016;04;20;Maanantai;5;5;10
95;11.04.2016;2016;04;21;Maanantai;2;4;6
95;11.04.2016;2016;04;22;Maanantai;3;4;7
95;11.04.2016;2016;04;23;Maanantai;0;0;0
95;12.04.2016;2016;04;00;Tiistai;0;0;0
95;12.04.2016;2016;04;01;Tiistai;0;0;0
95;12.04.2016;2016;04;02;Tiistai;0;0;0
95;12.04.2016;2016;04;03;Tiistai;0;0;0
95;12.04.2016;2016;04;04;Tiistai;3;0;3
95;12.04.2016;2016;04;05;Tiistai;5;3;8
95;12.04.2016;2016;04;06;Tiistai;21;9;30
95;12.04.2016;2016;04;07;Tiistai;16;19;35
95;12.04.2016;2016;04;08;Tiistai;13;9;22
95;12.04.2016;2016;04;09;Tiistai;7;7;14
95;12.04.2016;2016;04;10;Tiistai;6;2;8
95;12.04.2016;2016;04;11;Tiistai;8;12;20
95;12.04.2016;2016;04;12;Tiistai;7;14;21
95;12.04.2016;2016;04;13;Tiistai;9;12;21
95;12.04.2016;2016;04;14;Tiistai;11;10;21
95;12.04.2016;2016;04;15;Tiistai;18;17;35
95;12.04.2016;2016;04;16;Tiistai;26;24;50
95;12.04.2016;2016;04;17;Tiistai;12;16;28
95;12.04.2016;2016;04;18;Tiistai;9;18;27
95;12.04.2016;2016;04;19;Tiistai;6;10;16
95;12.04.2016;2016;04;20;Tiistai;0;6;6
95;12.04.2016;2016;04;21;Tiistai;5;8;13
95;12.04.2016;2016;04;22;Tiistai;1;2;3
95;12.04.2016;2016;04;23;Tiistai;0;0;0
95;13.04.2016;2016;04;00;Keskiviikko;0;1;1
95;13.04.2016;2016;04;01;Keskiviikko;0;0;0
95;13.04.2016;2016;04;02;Keskiviikko;0;0;0
95;13.04.2016;2016;04;03;Keskiviikko;0;0;0
95;13.04.2016;2016;04;04;Keskiviikko;3;0;3
95;13.04.2016;2016;04;05;Keskiviikko;9;6;15
95;13.04.2016;2016;04;06;Keskiviikko;18;6;24
95;13.04.2016;2016;04;07;Keskiviikko;12;15;27
95;13.04.2016;2016;04;08;Keskiviikko;12;12;24
95;13.04.2016;2016;04;09;Keskiviikko;10;5;15
95;13.04.2016;2016;04;10;Keskiviikko;5;6;11
95;13.04.2016;2016;04;11;Keskiviikko;9;8;17
95;13.04.2016;2016;04;12;Keskiviikko;8;5;13
95;13.04.2016;2016;04;13;Keskiviikko;11;13;24
95;13.04.2016;2016;04;14;Keskiviikko;8;11;19
95;13.04.2016;2016;04;15;Keskiviikko;10;16;26
95;13.04.2016;2016;04;16;Keskiviikko;15;20;35
95;13.04.2016;2016;04;17;Keskiviikko;7;13;20
95;13.04.2016;2016;04;18;Keskiviikko;3;4;7
95;13.04.2016;2016;04;19;Keskiviikko;4;3;7
95;13.04.2016;2016;04;20;Keskiviikko;3;5;8
95;13.04.2016;2016;04;21;Keskiviikko;3;1;4
95;13.04.2016;2016;04;22;Keskiviikko;4;2;6
95;13.04.2016;2016;04;23;Keskiviikko;0;0;0
95;14.04.2016;2016;04;00;Torstai;0;0;0
95;14.04.2016;2016;04;01;Torstai;0;0;0
95;14.04.2016;2016;04;02;Torstai;0;0;0
95;14.04.2016;2016;04;03;Torstai;0;0;0
95;14.04.2016;2016;04;04;Torstai;2;0;2
95;14.04.2016;2016;04;05;Torstai;7;5;12
95;14.04.2016;2016;04;06;Torstai;17;3;20
95;14.04.2016;2016;04;07;Torstai;11;11;22
95;14.04.2016;2016;04;08;Torstai;3;6;9
95;14.04.2016;2016;04;09;Torstai;5;5;10
95;14.04.2016;2016;04;10;Torstai;9;10;19
95;14.04.2016;2016;04;11;Torstai;10;10;20
95;14.04.2016;2016;04;12;Torstai;9;7;16
95;14.04.2016;2016;04;13;Torstai;5;16;21
95;14.04.2016;2016;04;14;Torstai;14;11;25
95;14.04.2016;2016;04;15;Torstai;10;22;32
95;14.04.2016;2016;04;16;Torstai;21;27;48
95;14.04.2016;2016;04;17;Torstai;8;13;21
95;14.04.2016;2016;04;18;Torstai;8;7;15
95;14.04.2016;2016;04;19;Torstai;3;12;15
95;14.04.2016;2016;04;20;Torstai;3;11;14
95;14.04.2016;2016;04;21;Torstai;3;3;6
95;14.04.2016;2016;04;22;Torstai;3;1;4
95;14.04.2016;2016;04;23;Torstai;0;0;0
95;15.04.2016;2016;04;00;Perjantai;1;0;1
95;15.04.2016;2016;04;01;Perjantai;0;0;0
95;15.04.2016;2016;04;02;Perjantai;0;0;0
95;15.04.2016;2016;04;03;Perjantai;0;0;0
95;15.04.2016;2016;04;04;Perjantai;2;0;2
95;15.04.2016;2016;04;05;Perjantai;5;5;10
95;15.04.2016;2016;04;06;Perjantai;14;2;16
95;15.04.2016;2016;04;07;Perjantai;12;13;25
95;15.04.2016;2016;04;08;Perjantai;12;11;23
95;15.04.2016;2016;04;09;Perjantai;2;5;7
95;15.04.2016;2016;04;10;Perjantai;7;5;12
95;15.04.2016;2016;04;11;Perjantai;5;6;11
95;15.04.2016;2016;04;12;Perjantai;7;3;10
95;15.04.2016;2016;04;13;Perjantai;18;16;34
95;15.04.2016;2016;04;14;Perjantai;15;11;26
95;15.04.2016;2016;04;15;Perjantai;20;15;35
95;15.04.2016;2016;04;16;Perjantai;10;21;31
95;15.04.2016;2016;04;17;Perjantai;7;23;30
95;15.04.2016;2016;04;18;Perjantai;9;11;20
95;15.04.2016;2016;04;19;Perjantai;6;6;12
95;15.04.2016;2016;04;20;Perjantai;4;6;10
95;15.04.2016;2016;04;21;Perjantai;3;2;5
95;15.04.2016;2016;04;22;Perjantai;4;0;4
95;15.04.2016;2016;04;23;Perjantai;0;0;0
95;16.04.2016;2016;04;00;Lauantai;0;1;1
95;16.04.2016;2016;04;01;Lauantai;0;0;0
95;16.04.2016;2016;04;02;Lauantai;0;0;0
95;16.04.2016;2016;04;03;Lauantai;0;0;0
95;16.04.2016;2016;04;04;Lauantai;0;0;0
95;16.04.2016;2016;04;05;Lauantai;1;1;2
95;16.04.2016;2016;04;06;Lauantai;5;0;5
95;16.04.2016;2016;04;07;Lauantai;1;1;2
95;16.04.2016;2016;04;08;Lauantai;2;1;3
95;16.04.2016;2016;04;09;Lauantai;2;9;11
95;16.04.2016;2016;04;10;Lauantai;7;12;19
95;16.04.2016;2016;04;11;Lauantai;15;11;26
95;16.04.2016;2016;04;12;Lauantai;28;10;38
95;16.04.2016;2016;04;13;Lauantai;11;10;21
95;16.04.2016;2016;04;14;Lauantai;14;17;31
95;16.04.2016;2016;04;15;Lauantai;4;5;9
95;16.04.2016;2016;04;16;Lauantai;2;8;10
95;16.04.2016;2016;04;17;Lauantai;10;2;12
95;16.04.2016;2016;04;18;Lauantai;6;8;14
95;16.04.2016;2016;04;19;Lauantai;5;11;16
95;16.04.2016;2016;04;20;Lauantai;1;10;11
95;16.04.2016;2016;04;21;Lauantai;5;4;9
95;16.04.2016;2016;04;22;Lauantai;1;2;3
95;16.04.2016;2016;04;23;Lauantai;3;0;3
95;17.04.2016;2016;04;00;Sunnuntai;2;1;3
95;17.04.2016;2016;04;01;Sunnuntai;0;0;0
95;17.04.2016;2016;04;02;Sunnuntai;0;0;0
95;17.04.2016;2016;04;03;Sunnuntai;0;0;0
95;17.04.2016;2016;04;04;Sunnuntai;0;0;0
95;17.04.2016;2016;04;05;Sunnuntai;0;0;0
95;17.04.2016;2016;04;06;Sunnuntai;0;0;0
95;17.04.2016;2016;04;07;Sunnuntai;0;3;3
95;17.04.2016;2016;04;08;Sunnuntai;3;3;6
95;17.04.2016;2016;04;09;Sunnuntai;2;2;4
95;17.04.2016;2016;04;10;Sunnuntai;1;4;5
95;17.04.2016;2016;04;11;Sunnuntai;3;4;7
95;17.04.2016;2016;04;12;Sunnuntai;5;5;10
95;17.04.2016;2016;04;13;Sunnuntai;4;7;11
95;17.04.2016;2016;04;14;Sunnuntai;5;7;12
95;17.04.2016;2016;04;15;Sunnuntai;6;9;15
95;17.04.2016;2016;04;16;Sunnuntai;6;7;13
95;17.04.2016;2016;04;17;Sunnuntai;9;6;15
95;17.04.2016;2016;04;18;Sunnuntai;8;7;15
95;17.04.2016;2016;04;19;Sunnuntai;5;8;13
95;17.04.2016;2016;04;20;Sunnuntai;6;3;9
95;17.04.2016;2016;04;21;Sunnuntai;2;2;4
95;17.04.2016;2016;04;22;Sunnuntai;0;1;1
95;17.04.2016;2016;04;23;Sunnuntai;0;0;0
95;18.04.2016;2016;04;00;Maanantai;0;0;0
95;18.04.2016;2016;04;01;Maanantai;0;0;0
95;18.04.2016;2016;04;02;Maanantai;0;0;0
95;18.04.2016;2016;04;03;Maanantai;0;0;0
95;18.04.2016;2016;04;04;Maanantai;3;0;3
95;18.04.2016;2016;04;05;Maanantai;5;3;8
95;18.04.2016;2016;04;06;Maanantai;12;9;21
95;18.04.2016;2016;04;07;Maanantai;9;15;24
95;18.04.2016;2016;04;08;Maanantai;14;11;25
95;18.04.2016;2016;04;09;Maanantai;3;8;11
95;18.04.2016;2016;04;10;Maanantai;5;4;9
95;18.04.2016;2016;04;11;Maanantai;7;11;18
95;18.04.2016;2016;04;12;Maanantai;10;4;14
95;18.04.2016;2016;04;13;Maanantai;9;10;19
95;18.04.2016;2016;04;14;Maanantai;13;9;22
95;18.04.2016;2016;04;15;Maanantai;20;17;37
95;18.04.2016;2016;04;16;Maanantai;21;19;40
95;18.04.2016;2016;04;17;Maanantai;15;23;38
95;18.04.2016;2016;04;18;Maanantai;14;10;24
95;18.04.2016;2016;04;19;Maanantai;12;12;24
95;18.04.2016;2016;04;20;Maanantai;1;6;7
95;18.04.2016;2016;04;21;Maanantai;2;5;7
95;18.04.2016;2016;04;22;Maanantai;6;1;7
95;18.04.2016;2016;04;23;Maanantai;0;0;0
95;19.04.2016;2016;04;00;Tiistai;0;0;0
95;19.04.2016;2016;04;01;Tiistai;0;0;0
95;19.04.2016;2016;04;02;Tiistai;0;0;0
95;19.04.2016;2016;04;03;Tiistai;0;2;2
95;19.04.2016;2016;04;04;Tiistai;1;1;2
95;19.04.2016;2016;04;05;Tiistai;6;2;8
95;19.04.2016;2016;04;06;Tiistai;9;13;22
95;19.04.2016;2016;04;07;Tiistai;17;15;32
95;19.04.2016;2016;04;08;Tiistai;9;12;21
95;19.04.2016;2016;04;09;Tiistai;5;3;8
95;19.04.2016;2016;04;10;Tiistai;8;5;13
95;19.04.2016;2016;04;11;Tiistai;7;7;14
95;19.04.2016;2016;04;12;Tiistai;11;3;14
95;19.04.2016;2016;04;13;Tiistai;3;9;12
95;19.04.2016;2016;04;14;Tiistai;14;7;21
95;19.04.2016;2016;04;15;Tiistai;19;22;41
95;19.04.2016;2016;04;16;Tiistai;15;22;37
95;19.04.2016;2016;04;17;Tiistai;6;13;19
95;19.04.2016;2016;04;18;Tiistai;1;3;4
95;19.04.2016;2016;04;19;Tiistai;2;1;3
95;19.04.2016;2016;04;20;Tiistai;2;5;7
95;19.04.2016;2016;04;21;Tiistai;1;2;3
95;19.04.2016;2016;04;22;Tiistai;3;0;3
95;19.04.2016;2016;04;23;Tiistai;0;0;0
95;20.04.2016;2016;04;00;Keskiviikko;1;0;1
95;20.04.2016;2016;04;01;Keskiviikko;0;0;0
95;20.04.2016;2016;04;02;Keskiviikko;0;0;0
95;20.04.2016;2016;04;03;Keskiviikko;0;0;0
95;20.04.2016;2016;04;04;Keskiviikko;0;0;0
95;20.04.2016;2016;04;05;Keskiviikko;8;4;12
95;20.04.2016;2016;04;06;Keskiviikko;12;11;23
95;20.04.2016;2016;04;07;Keskiviikko;13;16;29
95;20.04.2016;2016;04;08;Keskiviikko;3;11;14
95;20.04.2016;2016;04;09;Keskiviikko;3;2;5
95;20.04.2016;2016;04;10;Keskiviikko;5;4;9
95;20.04.2016;2016;04;11;Keskiviikko;3;4;7
95;20.04.2016;2016;04;12;Keskiviikko;7;1;8
95;20.04.2016;2016;04;13;Keskiviikko;9;8;17
95;20.04.2016;2016;04;14;Keskiviikko;12;11;23
95;20.04.2016;2016;04;15;Keskiviikko;10;15;25
95;20.04.2016;2016;04;16;Keskiviikko;18;15;33
95;20.04.2016;2016;04;17;Keskiviikko;5;7;12
95;20.04.2016;2016;04;18;Keskiviikko;3;1;4
95;20.04.2016;2016;04;19;Keskiviikko;5;5;10
95;20.04.2016;2016;04;20;Keskiviikko;2;3;5
95;20.04.2016;2016;04;21;Keskiviikko;2;4;6
95;20.04.2016;2016;04;22;Keskiviikko;4;2;6
95;20.04.2016;2016;04;23;Keskiviikko;0;1;1
95;21.04.2016;2016;04;00;Torstai;0;0;0
95;21.04.2016;2016;04;01;Torstai;1;0;1
95;21.04.2016;2016;04;02;Torstai;0;0;0
95;21.04.2016;2016;04;03;Torstai;0;0;0
95;21.04.2016;2016;04;04;Torstai;0;0;0
95;21.04.2016;2016;04;05;Torstai;4;3;7
95;21.04.2016;2016;04;06;Torstai;10;9;19
95;21.04.2016;2016;04;07;Torstai;10;16;26
95;21.04.2016;2016;04;08;Torstai;10;13;23
95;21.04.2016;2016;04;09;Torstai;3;4;7
95;21.04.2016;2016;04;10;Torstai;5;4;9
95;21.04.2016;2016;04;11;Torstai;10;3;13
95;21.04.2016;2016;04;12;Torstai;10;4;14
95;21.04.2016;2016;04;13;Torstai;9;11;20
95;21.04.2016;2016;04;14;Torstai;10;3;13
95;21.04.2016;2016;04;15;Torstai;22;21;43
95;21.04.2016;2016;04;16;Torstai;25;15;40
95;21.04.2016;2016;04;17;Torstai;13;12;25
95;21.04.2016;2016;04;18;Torstai;7;5;12
95;21.04.2016;2016;04;19;Torstai;8;7;15
95;21.04.2016;2016;04;20;Torstai;6;6;12
95;21.04.2016;2016;04;21;Torstai;3;3;6
95;21.04.2016;2016;04;22;Torstai;4;2;6
95;21.04.2016;2016;04;23;Torstai;1;0;1
95;22.04.2016;2016;04;00;Perjantai;1;0;1
95;22.04.2016;2016;04;01;Perjantai;0;0;0
95;22.04.2016;2016;04;02;Perjantai;0;0;0
95;22.04.2016;2016;04;03;Perjantai;0;0;0
95;22.04.2016;2016;04;04;Perjantai;1;0;1
95;22.04.2016;2016;04;05;Perjantai;4;3;7
95;22.04.2016;2016;04;06;Perjantai;10;6;16
95;22.04.2016;2016;04;07;Perjantai;10;14;24
95;22.04.2016;2016;04;08;Perjantai;8;12;20
95;22.04.2016;2016;04;09;Perjantai;5;7;12
95;22.04.2016;2016;04;10;Perjantai;9;6;15
95;22.04.2016;2016;04;11;Perjantai;5;4;9
95;22.04.2016;2016;04;12;Perjantai;8;5;13
95;22.04.2016;2016;04;13;Perjantai;11;9;20
95;22.04.2016;2016;04;14;Perjantai;14;10;24
95;22.04.2016;2016;04;15;Perjantai;15;14;29
95;22.04.2016;2016;04;16;Perjantai;5;17;22
95;22.04.2016;2016;04;17;Perjantai;9;11;20
95;22.04.2016;2016;04;18;Perjantai;3;15;18
95;22.04.2016;2016;04;19;Perjantai;9;3;12
95;22.04.2016;2016;04;20;Perjantai;1;3;4
95;22.04.2016;2016;04;21;Perjantai;5;4;9
95;22.04.2016;2016;04;22;Perjantai;2;3;5
95;22.04.2016;2016;04;23;Perjantai;1;0;1
95;23.04.2016;2016;04;00;Lauantai;0;0;0
95;23.04.2016;2016;04;01;Lauantai;0;0;0
95;23.04.2016;2016;04;02;Lauantai;0;0;0
95;23.04.2016;2016;04;03;Lauantai;0;1;1
95;23.04.2016;2016;04;04;Lauantai;2;1;3
95;23.04.2016;2016;04;05;Lauantai;0;0;0
95;23.04.2016;2016;04;06;Lauantai;4;1;5
95;23.04.2016;2016;04;07;Lauantai;3;2;5
95;23.04.2016;2016;04;08;Lauantai;5;3;8
95;23.04.2016;2016;04;09;Lauantai;7;5;12
95;23.04.2016;2016;04;10;Lauantai;5;12;17
95;23.04.2016;2016;04;11;Lauantai;17;6;23
95;23.04.2016;2016;04;12;Lauantai;16;19;35
95;23.04.2016;2016;04;13;Lauantai;15;18;33
95;23.04.2016;2016;04;14;Lauantai;9;5;14
95;23.04.2016;2016;04;15;Lauantai;13;14;27
95;23.04.2016;2016;04;16;Lauantai;11;9;20
95;23.04.2016;2016;04;17;Lauantai;5;14;19
95;23.04.2016;2016;04;18;Lauantai;8;9;17
95;23.04.2016;2016;04;19;Lauantai;5;5;10
95;23.04.2016;2016;04;20;Lauantai;1;5;6
95;23.04.2016;2016;04;21;Lauantai;3;5;8
95;23.04.2016;2016;04;22;Lauantai;1;1;2
95;23.04.2016;2016;04;23;Lauantai;0;0;0
95;24.04.2016;2016;04;00;Sunnuntai;0;1;1
95;24.04.2016;2016;04;01;Sunnuntai;0;0;0
95;24.04.2016;2016;04;02;Sunnuntai;0;0;0
95;24.04.2016;2016;04;03;Sunnuntai;0;0;0
95;24.04.2016;2016;04;04;Sunnuntai;0;0;0
95;24.04.2016;2016;04;05;Sunnuntai;0;0;0
95;24.04.2016;2016;04;06;Sunnuntai;4;2;6
95;24.04.2016;2016;04;07;Sunnuntai;1;2;3
95;24.04.2016;2016;04;08;Sunnuntai;3;5;8
95;24.04.2016;2016;04;09;Sunnuntai;5;9;14
95;24.04.2016;2016;04;10;Sunnuntai;10;14;24
95;24.04.2016;2016;04;11;Sunnuntai;18;13;31
95;24.04.2016;2016;04;12;Sunnuntai;20;15;35
95;24.04.2016;2016;04;13;Sunnuntai;9;20;29
95;24.04.2016;2016;04;14;Sunnuntai;13;14;27
95;24.04.2016;2016;04;15;Sunnuntai;6;14;20
95;24.04.2016;2016;04;16;Sunnuntai;9;11;20
95;24.04.2016;2016;04;17;Sunnuntai;9;9;18
95;24.04.2016;2016;04;18;Sunnuntai;8;4;12
95;24.04.2016;2016;04;19;Sunnuntai;7;12;19
95;24.04.2016;2016;04;20;Sunnuntai;4;5;9
95;24.04.2016;2016;04;21;Sunnuntai;1;5;6
95;24.04.2016;2016;04;22;Sunnuntai;2;0;2
95;24.04.2016;2016;04;23;Sunnuntai;1;0;1
95;25.04.2016;2016;04;00;Maanantai;2;0;2
95;25.04.2016;2016;04;01;Maanantai;0;0;0
95;25.04.2016;2016;04;02;Maanantai;0;0;0
95;25.04.2016;2016;04;03;Maanantai;0;0;0
95;25.04.2016;2016;04;04;Maanantai;0;0;0
95;25.04.2016;2016;04;05;Maanantai;5;4;9
95;25.04.2016;2016;04;06;Maanantai;13;9;22
95;25.04.2016;2016;04;07;Maanantai;13;14;27
95;25.04.2016;2016;04;08;Maanantai;9;9;18
95;25.04.2016;2016;04;09;Maanantai;2;6;8
95;25.04.2016;2016;04;10;Maanantai;15;6;21
95;25.04.2016;2016;04;11;Maanantai;5;4;9
95;25.04.2016;2016;04;12;Maanantai;6;2;8
95;25.04.2016;2016;04;13;Maanantai;5;4;9
95;25.04.2016;2016;04;14;Maanantai;11;6;17
95;25.04.2016;2016;04;15;Maanantai;10;9;19
95;25.04.2016;2016;04;16;Maanantai;11;6;17
95;25.04.2016;2016;04;17;Maanantai;3;10;13
95;25.04.2016;2016;04;18;Maanantai;4;5;9
95;25.04.2016;2016;04;19;Maanantai;2;4;6
95;25.04.2016;2016;04;20;Maanantai;2;4;6
95;25.04.2016;2016;04;21;Maanantai;1;4;5
95;25.04.2016;2016;04;22;Maanantai;3;2;5
95;25.04.2016;2016;04;23;Maanantai;1;0;1
95;26.04.2016;2016;04;00;Tiistai;0;0;0
95;26.04.2016;2016;04;01;Tiistai;0;0;0
95;26.04.2016;2016;04;02;Tiistai;0;0;0
95;26.04.2016;2016;04;03;Tiistai;0;0;0
95;26.04.2016;2016;04;04;Tiistai;0;0;0
95;26.04.2016;2016;04;05;Tiistai;4;4;8
95;26.04.2016;2016;04;06;Tiistai;17;8;25
95;26.04.2016;2016;04;07;Tiistai;10;16;26
95;26.04.2016;2016;04;08;Tiistai;3;9;12
95;26.04.2016;2016;04;09;Tiistai;5;2;7
95;26.04.2016;2016;04;10;Tiistai;1;3;4
95;26.04.2016;2016;04;11;Tiistai;2;1;3
95;26.04.2016;2016;04;12;Tiistai;5;4;9
95;26.04.2016;2016;04;13;Tiistai;3;4;7
95;26.04.2016;2016;04;14;Tiistai;16;7;23
95;26.04.2016;2016;04;15;Tiistai;12;17;29
95;26.04.2016;2016;04;16;Tiistai;11;11;22
95;26.04.2016;2016;04;17;Tiistai;2;12;14
95;26.04.2016;2016;04;18;Tiistai;1;7;8
95;26.04.2016;2016;04;19;Tiistai;4;3;7
95;26.04.2016;2016;04;20;Tiistai;7;4;11
95;26.04.2016;2016;04;21;Tiistai;0;1;1
95;26.04.2016;2016;04;22;Tiistai;1;0;1
95;26.04.2016;2016;04;23;Tiistai;0;0;0
95;27.04.2016;2016;04;00;Keskiviikko;0;0;0
95;27.04.2016;2016;04;01;Keskiviikko;0;0;0
95;27.04.2016;2016;04;02;Keskiviikko;0;0;0
95;27.04.2016;2016;04;03;Keskiviikko;1;0;1
95;27.04.2016;2016;04;04;Keskiviikko;0;0;0
95;27.04.2016;2016;04;05;Keskiviikko;6;3;9
95;27.04.2016;2016;04;06;Keskiviikko;13;9;22
95;27.04.2016;2016;04;07;Keskiviikko;12;17;29
95;27.04.2016;2016;04;08;Keskiviikko;7;7;14
95;27.04.2016;2016;04;09;Keskiviikko;4;3;7
95;27.04.2016;2016;04;10;Keskiviikko;10;2;12
95;27.04.2016;2016;04;11;Keskiviikko;5;2;7
95;27.04.2016;2016;04;12;Keskiviikko;2;9;11
95;27.04.2016;2016;04;13;Keskiviikko;6;7;13
95;27.04.2016;2016;04;14;Keskiviikko;9;8;17
95;27.04.2016;2016;04;15;Keskiviikko;9;14;23
95;27.04.2016;2016;04;16;Keskiviikko;21;10;31
95;27.04.2016;2016;04;17;Keskiviikko;5;14;19
95;27.04.2016;2016;04;18;Keskiviikko;2;5;7
95;27.04.2016;2016;04;19;Keskiviikko;6;1;7
95;27.04.2016;2016;04;20;Keskiviikko;2;7;9
95;27.04.2016;2016;04;21;Keskiviikko;1;2;3
95;27.04.2016;2016;04;22;Keskiviikko;2;1;3
95;27.04.2016;2016;04;23;Keskiviikko;1;0;1
95;28.04.2016;2016;04;00;Torstai;0;0;0
95;28.04.2016;2016;04;01;Torstai;0;0;0
95;28.04.2016;2016;04;02;Torstai;0;1;1
95;28.04.2016;2016;04;03;Torstai;0;0;0
95;28.04.2016;2016;04;04;Torstai;0;0;0
95;28.04.2016;2016;04;05;Torstai;7;3;10
95;28.04.2016;2016;04;06;Torstai;20;13;33
95;28.04.2016;2016;04;07;Torstai;17;15;32
95;28.04.2016;2016;04;08;Torstai;5;18;23
95;28.04.2016;2016;04;09;Torstai;7;13;20
95;28.04.2016;2016;04;10;Torstai;10;5;15
95;28.04.2016;2016;04;11;Torstai;11;9;20
95;28.04.2016;2016;04;12;Torstai;15;9;24
95;28.04.2016;2016;04;13;Torstai;9;6;15
95;28.04.2016;2016;04;14;Torstai;13;13;26
95;28.04.2016;2016;04;15;Torstai;17;17;34
95;28.04.2016;2016;04;16;Torstai;33;31;64
95;28.04.2016;2016;04;17;Torstai;9;26;35
95;28.04.2016;2016;04;18;Torstai;25;12;37
95;28.04.2016;2016;04;19;Torstai;11;12;23
95;28.04.2016;2016;04;20;Torstai;7;11;18
95;28.04.2016;2016;04;21;Torstai;8;5;13
95;28.04.2016;2016;04;22;Torstai;2;1;3
95;28.04.2016;2016;04;23;Torstai;0;1;1
95;29.04.2016;2016;04;00;Perjantai;0;0;0
95;29.04.2016;2016;04;01;Perjantai;0;1;1
95;29.04.2016;2016;04;02;Perjantai;0;0;0
95;29.04.2016;2016;04;03;Perjantai;0;1;1
95;29.04.2016;2016;04;04;Perjantai;0;0;0
95;29.04.2016;2016;04;05;Perjantai;4;5;9
95;29.04.2016;2016;04;06;Perjantai;14;9;23
95;29.04.2016;2016;04;07;Perjantai;9;18;27
95;29.04.2016;2016;04;08;Perjantai;17;13;30
95;29.04.2016;2016;04;09;Perjantai;13;12;25
95;29.04.2016;2016;04;10;Perjantai;8;4;12
95;29.04.2016;2016;04;11;Perjantai;14;7;21
95;29.04.2016;2016;04;12;Perjantai;5;8;13
95;29.04.2016;2016;04;13;Perjantai;16;5;21
95;29.04.2016;2016;04;14;Perjantai;12;7;19
95;29.04.2016;2016;04;15;Perjantai;15;12;27
95;29.04.2016;2016;04;16;Perjantai;10;12;22
95;29.04.2016;2016;04;17;Perjantai;5;11;16
95;29.04.2016;2016;04;18;Perjantai;3;9;12
95;29.04.2016;2016;04;19;Perjantai;4;12;16
95;29.04.2016;2016;04;20;Perjantai;4;6;10
95;29.04.2016;2016;04;21;Perjantai;4;5;9
95;29.04.2016;2016;04;22;Perjantai;1;3;4
95;29.04.2016;2016;04;23;Perjantai;2;0;2
95;30.04.2016;2016;04;00;Lauantai;0;0;0
95;30.04.2016;2016;04;01;Lauantai;0;0;0
95;30.04.2016;2016;04;02;Lauantai;0;0;0
95;30.04.2016;2016;04;03;Lauantai;0;0;0
95;30.04.2016;2016;04;04;Lauantai;0;1;1
95;30.04.2016;2016;04;05;Lauantai;1;0;1
95;30.04.2016;2016;04;06;Lauantai;1;3;4
95;30.04.2016;2016;04;07;Lauantai;2;1;3
95;30.04.2016;2016;04;08;Lauantai;7;5;12
95;30.04.2016;2016;04;09;Lauantai;10;10;20
95;30.04.2016;2016;04;10;Lauantai;19;13;32
95;30.04.2016;2016;04;11;Lauantai;20;9;29
95;30.04.2016;2016;04;12;Lauantai;21;20;41
95;30.04.2016;2016;04;13;Lauantai;22;18;40
95;30.04.2016;2016;04;14;Lauantai;13;29;42
95;30.04.2016;2016;04;15;Lauantai;10;16;26
95;30.04.2016;2016;04;16;Lauantai;11;17;28
95;30.04.2016;2016;04;17;Lauantai;11;10;21
95;30.04.2016;2016;04;18;Lauantai;13;6;19
95;30.04.2016;2016;04;19;Lauantai;9;7;16
95;30.04.2016;2016;04;20;Lauantai;10;10;20
95;30.04.2016;2016;04;21;Lauantai;2;1;3
95;30.04.2016;2016;04;22;Lauantai;1;5;6
95;30.04.2016;2016;04;23;Lauantai;0;3;3
95;01.05.2016;2016;05;00;Sunnuntai;0;2;2
95;01.05.2016;2016;05;01;Sunnuntai;0;4;4
95;01.05.2016;2016;05;02;Sunnuntai;0;1;1
95;01.05.2016;2016;05;03;Sunnuntai;2;1;3
95;01.05.2016;2016;05;04;Sunnuntai;0;0;0
95;01.05.2016;2016;05;05;Sunnuntai;1;1;2
95;01.05.2016;2016;05;06;Sunnuntai;1;0;1
95;01.05.2016;2016;05;07;Sunnuntai;1;1;2
95;01.05.2016;2016;05;08;Sunnuntai;3;4;7
95;01.05.2016;2016;05;09;Sunnuntai;8;12;20
95;01.05.2016;2016;05;10;Sunnuntai;20;8;28
95;01.05.2016;2016;05;11;Sunnuntai;33;11;44
95;01.05.2016;2016;05;12;Sunnuntai;59;23;82
95;01.05.2016;2016;05;13;Sunnuntai;32;42;74
95;01.05.2016;2016;05;14;Sunnuntai;25;45;70
95;01.05.2016;2016;05;15;Sunnuntai;9;18;27
95;01.05.2016;2016;05;16;Sunnuntai;16;20;36
95;01.05.2016;2016;05;17;Sunnuntai;19;18;37
95;01.05.2016;2016;05;18;Sunnuntai;14;12;26
95;01.05.2016;2016;05;19;Sunnuntai;14;21;35
95;01.05.2016;2016;05;20;Sunnuntai;6;5;11
95;01.05.2016;2016;05;21;Sunnuntai;5;3;8
95;01.05.2016;2016;05;22;Sunnuntai;0;5;5
95;01.05.2016;2016;05;23;Sunnuntai;2;0;2
95;02.05.2016;2016;05;00;Maanantai;1;1;2
95;02.05.2016;2016;05;01;Maanantai;0;0;0
95;02.05.2016;2016;05;02;Maanantai;0;0;0
95;02.05.2016;2016;05;03;Maanantai;0;1;1
95;02.05.2016;2016;05;04;Maanantai;2;0;2
95;02.05.2016;2016;05;05;Maanantai;4;4;8
95;02.05.2016;2016;05;06;Maanantai;32;12;44
95;02.05.2016;2016;05;07;Maanantai;24;23;47
95;02.05.2016;2016;05;08;Maanantai;6;25;31
95;02.05.2016;2016;05;09;Maanantai;10;8;18
95;02.05.2016;2016;05;10;Maanantai;8;44;52
95;02.05.2016;2016;05;11;Maanantai;7;11;18
95;02.05.2016;2016;05;12;Maanantai;10;6;16
95;02.05.2016;2016;05;13;Maanantai;11;10;21
95;02.05.2016;2016;05;14;Maanantai;17;7;24
95;02.05.2016;2016;05;15;Maanantai;26;25;51
95;02.05.2016;2016;05;16;Maanantai;41;37;78
95;02.05.2016;2016;05;17;Maanantai;16;21;37
95;02.05.2016;2016;05;18;Maanantai;18;23;41
95;02.05.2016;2016;05;19;Maanantai;18;21;39
95;02.05.2016;2016;05;20;Maanantai;12;10;22
95;02.05.2016;2016;05;21;Maanantai;6;6;12
95;02.05.2016;2016;05;22;Maanantai;5;2;7
95;02.05.2016;2016;05;23;Maanantai;0;1;1
95;03.05.2016;2016;05;00;Tiistai;0;1;1
95;03.05.2016;2016;05;01;Tiistai;0;0;0
95;03.05.2016;2016;05;02;Tiistai;0;0;0
95;03.05.2016;2016;05;03;Tiistai;0;0;0
95;03.05.2016;2016;05;04;Tiistai;2;0;2
95;03.05.2016;2016;05;05;Tiistai;7;3;10
95;03.05.2016;2016;05;06;Tiistai;21;14;35
95;03.05.2016;2016;05;07;Tiistai;35;35;70
95;03.05.2016;2016;05;08;Tiistai;16;16;32
95;03.05.2016;2016;05;09;Tiistai;10;8;18
95;03.05.2016;2016;05;10;Tiistai;5;14;19
95;03.05.2016;2016;05;11;Tiistai;13;11;24
95;03.05.2016;2016;05;12;Tiistai;16;15;31
95;03.05.2016;2016;05;13;Tiistai;13;13;26
95;03.05.2016;2016;05;14;Tiistai;21;16;37
95;03.05.2016;2016;05;15;Tiistai;24;37;61
95;03.05.2016;2016;05;16;Tiistai;40;34;74
95;03.05.2016;2016;05;17;Tiistai;22;26;48
95;03.05.2016;2016;05;18;Tiistai;16;28;44
95;03.05.2016;2016;05;19;Tiistai;9;10;19
95;03.05.2016;2016;05;20;Tiistai;4;12;16
95;03.05.2016;2016;05;21;Tiistai;11;7;18
95;03.05.2016;2016;05;22;Tiistai;2;5;7
95;03.05.2016;2016;05;23;Tiistai;1;0;1
95;04.05.2016;2016;05;00;Keskiviikko;0;1;1
95;04.05.2016;2016;05;01;Keskiviikko;0;0;0
95;04.05.2016;2016;05;02;Keskiviikko;0;0;0
95;04.05.2016;2016;05;03;Keskiviikko;0;0;0
95;04.05.2016;2016;05;04;Keskiviikko;0;0;0
95;04.05.2016;2016;05;05;Keskiviikko;7;5;12
95;04.05.2016;2016;05;06;Keskiviikko;26;13;39
95;04.05.2016;2016;05;07;Keskiviikko;21;36;57
95;04.05.2016;2016;05;08;Keskiviikko;16;12;28
95;04.05.2016;2016;05;09;Keskiviikko;11;10;21
95;04.05.2016;2016;05;10;Keskiviikko;12;14;26
95;04.05.2016;2016;05;11;Keskiviikko;13;10;23
95;04.05.2016;2016;05;12;Keskiviikko;13;5;18
95;04.05.2016;2016;05;13;Keskiviikko;13;8;21
95;04.05.2016;2016;05;14;Keskiviikko;15;11;26
95;04.05.2016;2016;05;15;Keskiviikko;39;31;70
95;04.05.2016;2016;05;16;Keskiviikko;36;36;72
95;04.05.2016;2016;05;17;Keskiviikko;16;30;46
95;04.05.2016;2016;05;18;Keskiviikko;16;18;34
95;04.05.2016;2016;05;19;Keskiviikko;19;20;39
95;04.05.2016;2016;05;20;Keskiviikko;10;12;22
95;04.05.2016;2016;05;21;Keskiviikko;7;7;14
95;04.05.2016;2016;05;22;Keskiviikko;1;3;4
95;04.05.2016;2016;05;23;Keskiviikko;0;0;0
95;05.05.2016;2016;05;00;Torstai;3;0;3
95;05.05.2016;2016;05;01;Torstai;0;2;2
95;05.05.2016;2016;05;02;Torstai;0;0;0
95;05.05.2016;2016;05;03;Torstai;0;0;0
95;05.05.2016;2016;05;04;Torstai;1;0;1
95;05.05.2016;2016;05;05;Torstai;2;2;4
95;05.05.2016;2016;05;06;Torstai;3;1;4
95;05.05.2016;2016;05;07;Torstai;2;7;9
95;05.05.2016;2016;05;08;Torstai;10;8;18
95;05.05.2016;2016;05;09;Torstai;16;14;30
95;05.05.2016;2016;05;10;Torstai;8;22;30
95;05.05.2016;2016;05;11;Torstai;32;14;46
95;05.05.2016;2016;05;12;Torstai;33;30;63
95;05.05.2016;2016;05;13;Torstai;32;33;65
95;05.05.2016;2016;05;14;Torstai;20;28;48
95;05.05.2016;2016;05;15;Torstai;25;22;47
95;05.05.2016;2016;05;16;Torstai;18;29;47
95;05.05.2016;2016;05;17;Torstai;15;11;26
95;05.05.2016;2016;05;18;Torstai;26;15;41
95;05.05.2016;2016;05;19;Torstai;15;11;26
95;05.05.2016;2016;05;20;Torstai;9;10;19
95;05.05.2016;2016;05;21;Torstai;3;5;8
95;05.05.2016;2016;05;22;Torstai;0;6;6
95;05.05.2016;2016;05;23;Torstai;1;1;2
95;06.05.2016;2016;05;00;Perjantai;0;1;1
95;06.05.2016;2016;05;01;Perjantai;1;1;2
95;06.05.2016;2016;05;02;Perjantai;0;0;0
95;06.05.2016;2016;05;03;Perjantai;0;1;1
95;06.05.2016;2016;05;04;Perjantai;1;0;1
95;06.05.2016;2016;05;05;Perjantai;6;2;8
95;06.05.2016;2016;05;06;Perjantai;18;4;22
95;06.05.2016;2016;05;07;Perjantai;18;12;30
95;06.05.2016;2016;05;08;Perjantai;15;6;21
95;06.05.2016;2016;05;09;Perjantai;7;9;16
95;06.05.2016;2016;05;10;Perjantai;14;11;25
95;06.05.2016;2016;05;11;Perjantai;7;12;19
95;06.05.2016;2016;05;12;Perjantai;8;20;28
95;06.05.2016;2016;05;13;Perjantai;22;13;35
95;06.05.2016;2016;05;14;Perjantai;15;17;32
95;06.05.2016;2016;05;15;Perjantai;31;34;65
95;06.05.2016;2016;05;16;Perjantai;30;36;66
95;06.05.2016;2016;05;17;Perjantai;19;20;39
95;06.05.2016;2016;05;18;Perjantai;17;31;48
95;06.05.2016;2016;05;19;Perjantai;10;17;27
95;06.05.2016;2016;05;20;Perjantai;13;5;18
95;06.05.2016;2016;05;21;Perjantai;2;7;9
95;06.05.2016;2016;05;22;Perjantai;2;4;6
95;06.05.2016;2016;05;23;Perjantai;2;3;5
95;07.05.2016;2016;05;00;Lauantai;0;1;1
95;07.05.2016;2016;05;01;Lauantai;0;1;1
95;07.05.2016;2016;05;02;Lauantai;0;0;0
95;07.05.2016;2016;05;03;Lauantai;1;1;2
95;07.05.2016;2016;05;04;Lauantai;1;0;1
95;07.05.2016;2016;05;05;Lauantai;1;0;1
95;07.05.2016;2016;05;06;Lauantai;3;0;3
95;07.05.2016;2016;05;07;Lauantai;9;2;11
95;07.05.2016;2016;05;08;Lauantai;6;4;10
95;07.05.2016;2016;05;09;Lauantai;11;7;18
95;07.05.2016;2016;05;10;Lauantai;12;13;25
95;07.05.2016;2016;05;11;Lauantai;16;15;31
95;07.05.2016;2016;05;12;Lauantai;17;20;37
95;07.05.2016;2016;05;13;Lauantai;23;23;46
95;07.05.2016;2016;05;14;Lauantai;24;22;46
95;07.05.2016;2016;05;15;Lauantai;14;24;38
95;07.05.2016;2016;05;16;Lauantai;27;22;49
95;07.05.2016;2016;05;17;Lauantai;25;35;60
95;07.05.2016;2016;05;18;Lauantai;24;17;41
95;07.05.2016;2016;05;19;Lauantai;15;19;34
95;07.05.2016;2016;05;20;Lauantai;10;7;17
95;07.05.2016;2016;05;21;Lauantai;5;11;16
95;07.05.2016;2016;05;22;Lauantai;1;4;5
95;07.05.2016;2016;05;23;Lauantai;1;4;5
95;08.05.2016;2016;05;00;Sunnuntai;2;0;2
95;08.05.2016;2016;05;01;Sunnuntai;0;0;0
95;08.05.2016;2016;05;02;Sunnuntai;0;0;0
95;08.05.2016;2016;05;03;Sunnuntai;0;0;0
95;08.05.2016;2016;05;04;Sunnuntai;1;0;1
95;08.05.2016;2016;05;05;Sunnuntai;2;0;2
95;08.05.2016;2016;05;06;Sunnuntai;0;0;0
95;08.05.2016;2016;05;07;Sunnuntai;4;4;8
95;08.05.2016;2016;05;08;Sunnuntai;7;11;18
95;08.05.2016;2016;05;09;Sunnuntai;21;11;32
95;08.05.2016;2016;05;10;Sunnuntai;26;67;93
95;08.05.2016;2016;05;11;Sunnuntai;23;37;60
95;08.05.2016;2016;05;12;Sunnuntai;63;21;84
95;08.05.2016;2016;05;13;Sunnuntai;19;13;32
95;08.05.2016;2016;05;14;Sunnuntai;22;29;51
95;08.05.2016;2016;05;15;Sunnuntai;14;11;25
95;08.05.2016;2016;05;16;Sunnuntai;18;14;32
95;08.05.2016;2016;05;17;Sunnuntai;9;13;22
95;08.05.2016;2016;05;18;Sunnuntai;16;14;30
95;08.05.2016;2016;05;19;Sunnuntai;24;15;39
95;08.05.2016;2016;05;20;Sunnuntai;14;11;25
95;08.05.2016;2016;05;21;Sunnuntai;0;6;6
95;08.05.2016;2016;05;22;Sunnuntai;2;3;5
95;08.05.2016;2016;05;23;Sunnuntai;1;1;2
95;09.05.2016;2016;05;00;Maanantai;0;1;1
95;09.05.2016;2016;05;01;Maanantai;0;0;0
95;09.05.2016;2016;05;02;Maanantai;0;0;0
95;09.05.2016;2016;05;03;Maanantai;0;0;0
95;09.05.2016;2016;05;04;Maanantai;2;0;2
95;09.05.2016;2016;05;05;Maanantai;4;7;11
95;09.05.2016;2016;05;06;Maanantai;35;19;54
95;09.05.2016;2016;05;07;Maanantai;34;34;68
95;09.05.2016;2016;05;08;Maanantai;27;24;51
95;09.05.2016;2016;05;09;Maanantai;7;8;15
95;09.05.2016;2016;05;10;Maanantai;4;5;9
95;09.05.2016;2016;05;11;Maanantai;10;8;18
95;09.05.2016;2016;05;12;Maanantai;19;20;39
95;09.05.2016;2016;05;13;Maanantai;10;17;27
95;09.05.2016;2016;05;14;Maanantai;23;14;37
95;09.05.2016;2016;05;15;Maanantai;33;38;71
95;09.05.2016;2016;05;16;Maanantai;40;45;85
95;09.05.2016;2016;05;17;Maanantai;18;31;49
95;09.05.2016;2016;05;18;Maanantai;15;19;34
95;09.05.2016;2016;05;19;Maanantai;22;25;47
95;09.05.2016;2016;05;20;Maanantai;11;15;26
95;09.05.2016;2016;05;21;Maanantai;6;6;12
95;09.05.2016;2016;05;22;Maanantai;2;3;5
95;09.05.2016;2016;05;23;Maanantai;0;2;2
95;10.05.2016;2016;05;00;Tiistai;0;0;0
95;10.05.2016;2016;05;01;Tiistai;0;0;0
95;10.05.2016;2016;05;02;Tiistai;0;0;0
95;10.05.2016;2016;05;03;Tiistai;0;0;0
95;10.05.2016;2016;05;04;Tiistai;1;1;2
95;10.05.2016;2016;05;05;Tiistai;7;3;10
95;10.05.2016;2016;05;06;Tiistai;10;10;20
95;10.05.2016;2016;05;07;Tiistai;10;14;24
95;10.05.2016;2016;05;08;Tiistai;7;9;16
95;10.05.2016;2016;05;09;Tiistai;0;3;3
95;10.05.2016;2016;05;10;Tiistai;0;1;1
95;10.05.2016;2016;05;11;Tiistai;4;1;5
95;10.05.2016;2016;05;12;Tiistai;4;1;5
95;10.05.2016;2016;05;13;Tiistai;4;6;10
95;10.05.2016;2016;05;14;Tiistai;6;5;11
95;10.05.2016;2016;05;15;Tiistai;10;17;27
95;10.05.2016;2016;05;16;Tiistai;16;14;30
95;10.05.2016;2016;05;17;Tiistai;3;4;7
95;10.05.2016;2016;05;18;Tiistai;5;8;13
95;10.05.2016;2016;05;19;Tiistai;12;14;26
95;10.05.2016;2016;05;20;Tiistai;10;7;17
95;10.05.2016;2016;05;21;Tiistai;3;5;8
95;10.05.2016;2016;05;22;Tiistai;2;3;5
95;10.05.2016;2016;05;23;Tiistai;0;0;0
95;11.05.2016;2016;05;00;Keskiviikko;1;0;1
95;11.05.2016;2016;05;01;Keskiviikko;0;0;0
95;11.05.2016;2016;05;02;Keskiviikko;0;0;0
95;11.05.2016;2016;05;03;Keskiviikko;0;0;0
95;11.05.2016;2016;05;04;Keskiviikko;1;0;1
95;11.05.2016;2016;05;05;Keskiviikko;6;4;10
95;11.05.2016;2016;05;06;Keskiviikko;26;23;49
95;11.05.2016;2016;05;07;Keskiviikko;27;33;60
95;11.05.2016;2016;05;08;Keskiviikko;15;16;31
95;11.05.2016;2016;05;09;Keskiviikko;9;11;20
95;11.05.2016;2016;05;10;Keskiviikko;4;7;11
95;11.05.2016;2016;05;11;Keskiviikko;9;8;17
95;11.05.2016;2016;05;12;Keskiviikko;11;9;20
95;11.05.2016;2016;05;13;Keskiviikko;22;19;41
95;11.05.2016;2016;05;14;Keskiviikko;9;11;20
95;11.05.2016;2016;05;15;Keskiviikko;25;28;53
95;11.05.2016;2016;05;16;Keskiviikko;31;35;66
95;11.05.2016;2016;05;17;Keskiviikko;13;27;40
95;11.05.2016;2016;05;18;Keskiviikko;14;22;36
95;11.05.2016;2016;05;19;Keskiviikko;16;18;34
95;11.05.2016;2016;05;20;Keskiviikko;6;10;16
95;11.05.2016;2016;05;21;Keskiviikko;3;4;7
95;11.05.2016;2016;05;22;Keskiviikko;4;7;11
95;11.05.2016;2016;05;23;Keskiviikko;2;2;4
95;12.05.2016;2016;05;00;Torstai;0;0;0
95;12.05.2016;2016;05;01;Torstai;0;0;0
95;12.05.2016;2016;05;02;Torstai;0;0;0
95;12.05.2016;2016;05;03;Torstai;0;1;1
95;12.05.2016;2016;05;04;Torstai;4;0;4
95;12.05.2016;2016;05;05;Torstai;6;2;8
95;12.05.2016;2016;05;06;Torstai;30;24;54
95;12.05.2016;2016;05;07;Torstai;31;36;67
95;12.05.2016;2016;05;08;Torstai;14;18;32
95;12.05.2016;2016;05;09;Torstai;10;11;21
95;12.05.2016;2016;05;10;Torstai;7;10;17
95;12.05.2016;2016;05;11;Torstai;11;13;24
95;12.05.2016;2016;05;12;Torstai;14;12;26
95;12.05.2016;2016;05;13;Torstai;14;20;34
95;12.05.2016;2016;05;14;Torstai;17;14;31
95;12.05.2016;2016;05;15;Torstai;33;37;70
95;12.05.2016;2016;05;16;Torstai;40;25;65
95;12.05.2016;2016;05;17;Torstai;13;30;43
95;12.05.2016;2016;05;18;Torstai;18;19;37
95;12.05.2016;2016;05;19;Torstai;13;22;35
95;12.05.2016;2016;05;20;Torstai;5;14;19
95;12.05.2016;2016;05;21;Torstai;3;5;8
95;12.05.2016;2016;05;22;Torstai;2;4;6
95;12.05.2016;2016;05;23;Torstai;2;1;3
95;13.05.2016;2016;05;00;Perjantai;0;0;0
95;13.05.2016;2016;05;01;Perjantai;0;0;0
95;13.05.2016;2016;05;02;Perjantai;0;0;0
95;13.05.2016;2016;05;03;Perjantai;0;0;0
95;13.05.2016;2016;05;04;Perjantai;3;0;3
95;13.05.2016;2016;05;05;Perjantai;4;6;10
95;13.05.2016;2016;05;06;Perjantai;14;11;25
95;13.05.2016;2016;05;07;Perjantai;17;26;43
95;13.05.2016;2016;05;08;Perjantai;14;18;32
95;13.05.2016;2016;05;09;Perjantai;6;7;13
95;13.05.2016;2016;05;10;Perjantai;10;8;18
95;13.05.2016;2016;05;11;Perjantai;8;6;14
95;13.05.2016;2016;05;12;Perjantai;4;8;12
95;13.05.2016;2016;05;13;Perjantai;11;10;21
95;13.05.2016;2016;05;14;Perjantai;18;11;29
95;13.05.2016;2016;05;15;Perjantai;16;12;28
95;13.05.2016;2016;05;16;Perjantai;24;14;38
95;13.05.2016;2016;05;17;Perjantai;8;17;25
95;13.05.2016;2016;05;18;Perjantai;6;11;17
95;13.05.2016;2016;05;19;Perjantai;6;6;12
95;13.05.2016;2016;05;20;Perjantai;7;3;10
95;13.05.2016;2016;05;21;Perjantai;9;1;10
95;13.05.2016;2016;05;22;Perjantai;0;4;4
95;13.05.2016;2016;05;23;Perjantai;0;0;0
95;14.05.2016;2016;05;00;Lauantai;0;1;1
95;14.05.2016;2016;05;01;Lauantai;1;0;1
95;14.05.2016;2016;05;02;Lauantai;1;0;1
95;14.05.2016;2016;05;03;Lauantai;0;0;0
95;14.05.2016;2016;05;04;Lauantai;1;0;1
95;14.05.2016;2016;05;05;Lauantai;1;1;2
95;14.05.2016;2016;05;06;Lauantai;0;1;1
95;14.05.2016;2016;05;07;Lauantai;1;3;4
95;14.05.2016;2016;05;08;Lauantai;3;6;9
95;14.05.2016;2016;05;09;Lauantai;7;5;12
95;14.05.2016;2016;05;10;Lauantai;5;18;23
95;14.05.2016;2016;05;11;Lauantai;4;6;10
95;14.05.2016;2016;05;12;Lauantai;11;3;14
95;14.05.2016;2016;05;13;Lauantai;13;9;22
95;14.05.2016;2016;05;14;Lauantai;10;9;19
95;14.05.2016;2016;05;15;Lauantai;7;11;18
95;14.05.2016;2016;05;16;Lauantai;10;10;20
95;14.05.2016;2016;05;17;Lauantai;4;11;15
95;14.05.2016;2016;05;18;Lauantai;4;13;17
95;14.05.2016;2016;05;19;Lauantai;5;6;11
95;14.05.2016;2016;05;20;Lauantai;4;1;5
95;14.05.2016;2016;05;21;Lauantai;3;1;4
95;14.05.2016;2016;05;22;Lauantai;0;1;1
95;14.05.2016;2016;05;23;Lauantai;0;0;0
95;15.05.2016;2016;05;00;Sunnuntai;0;0;0
95;15.05.2016;2016;05;01;Sunnuntai;0;0;0
95;15.05.2016;2016;05;02;Sunnuntai;0;1;1
95;15.05.2016;2016;05;03;Sunnuntai;0;0;0
95;15.05.2016;2016;05;04;Sunnuntai;0;0;0
95;15.05.2016;2016;05;05;Sunnuntai;1;0;1
95;15.05.2016;2016;05;06;Sunnuntai;0;1;1
95;15.05.2016;2016;05;07;Sunnuntai;1;3;4
95;15.05.2016;2016;05;08;Sunnuntai;5;0;5
95;15.05.2016;2016;05;09;Sunnuntai;9;10;19
95;15.05.2016;2016;05;10;Sunnuntai;15;10;25
95;15.05.2016;2016;05;11;Sunnuntai;15;3;18
95;15.05.2016;2016;05;12;Sunnuntai;12;13;25
95;15.05.2016;2016;05;13;Sunnuntai;12;7;19
95;15.05.2016;2016;05;14;Sunnuntai;4;18;22
95;15.05.2016;2016;05;15;Sunnuntai;13;9;22
95;15.05.2016;2016;05;16;Sunnuntai;4;8;12
95;15.05.2016;2016;05;17;Sunnuntai;4;6;10
95;15.05.2016;2016;05;18;Sunnuntai;4;7;11
95;15.05.2016;2016;05;19;Sunnuntai;3;3;6
95;15.05.2016;2016;05;20;Sunnuntai;1;2;3
95;15.05.2016;2016;05;21;Sunnuntai;3;2;5
95;15.05.2016;2016;05;22;Sunnuntai;1;2;3
95;15.05.2016;2016;05;23;Sunnuntai;0;0;0
95;16.05.2016;2016;05;00;Maanantai;0;1;1
95;16.05.2016;2016;05;01;Maanantai;1;0;1
95;16.05.2016;2016;05;02;Maanantai;0;0;0
95;16.05.2016;2016;05;03;Maanantai;0;0;0
95;16.05.2016;2016;05;04;Maanantai;1;0;1
95;16.05.2016;2016;05;05;Maanantai;8;3;11
95;16.05.2016;2016;05;06;Maanantai;29;17;46
95;16.05.2016;2016;05;07;Maanantai;25;37;62
95;16.05.2016;2016;05;08;Maanantai;19;15;34
95;16.05.2016;2016;05;09;Maanantai;21;17;38
95;16.05.2016;2016;05;10;Maanantai;13;14;27
95;16.05.2016;2016;05;11;Maanantai;12;14;26
95;16.05.2016;2016;05;12;Maanantai;15;16;31
95;16.05.2016;2016;05;13;Maanantai;15;15;30
95;16.05.2016;2016;05;14;Maanantai;17;19;36
95;16.05.2016;2016;05;15;Maanantai;28;33;61
95;16.05.2016;2016;05;16;Maanantai;41;48;89
95;16.05.2016;2016;05;17;Maanantai;22;31;53
95;16.05.2016;2016;05;18;Maanantai;29;24;53
95;16.05.2016;2016;05;19;Maanantai;26;27;53
95;16.05.2016;2016;05;20;Maanantai;10;18;28
95;16.05.2016;2016;05;21;Maanantai;10;12;22
95;16.05.2016;2016;05;22;Maanantai;2;5;7
95;16.05.2016;2016;05;23;Maanantai;1;0;1
95;17.05.2016;2016;05;00;Tiistai;1;0;1
95;17.05.2016;2016;05;01;Tiistai;0;0;0
95;17.05.2016;2016;05;02;Tiistai;0;0;0
95;17.05.2016;2016;05;03;Tiistai;0;0;0
95;17.05.2016;2016;05;04;Tiistai;1;1;2
95;17.05.2016;2016;05;05;Tiistai;6;3;9
95;17.05.2016;2016;05;06;Tiistai;18;14;32
95;17.05.2016;2016;05;07;Tiistai;21;27;48
95;17.05.2016;2016;05;08;Tiistai;10;10;20
95;17.05.2016;2016;05;09;Tiistai;7;3;10
95;17.05.2016;2016;05;10;Tiistai;2;3;5
95;17.05.2016;2016;05;11;Tiistai;3;4;7
95;17.05.2016;2016;05;12;Tiistai;4;1;5
95;17.05.2016;2016;05;13;Tiistai;5;7;12
95;17.05.2016;2016;05;14;Tiistai;11;9;20
95;17.05.2016;2016;05;15;Tiistai;23;18;41
95;17.05.2016;2016;05;16;Tiistai;16;16;32
95;17.05.2016;2016;05;17;Tiistai;10;23;33
95;17.05.2016;2016;05;18;Tiistai;8;18;26
95;17.05.2016;2016;05;19;Tiistai;11;15;26
95;17.05.2016;2016;05;20;Tiistai;5;4;9
95;17.05.2016;2016;05;21;Tiistai;4;1;5
95;17.05.2016;2016;05;22;Tiistai;1;2;3
95;17.05.2016;2016;05;23;Tiistai;1;1;2
95;18.05.2016;2016;05;00;Keskiviikko;1;0;1
95;18.05.2016;2016;05;01;Keskiviikko;0;0;0
95;18.05.2016;2016;05;02;Keskiviikko;0;0;0
95;18.05.2016;2016;05;03;Keskiviikko;0;0;0
95;18.05.2016;2016;05;04;Keskiviikko;4;0;4
95;18.05.2016;2016;05;05;Keskiviikko;8;4;12
95;18.05.2016;2016;05;06;Keskiviikko;26;16;42
95;18.05.2016;2016;05;07;Keskiviikko;29;35;64
95;18.05.2016;2016;05;08;Keskiviikko;18;28;46
95;18.05.2016;2016;05;09;Keskiviikko;14;9;23
95;18.05.2016;2016;05;10;Keskiviikko;16;9;25
95;18.05.2016;2016;05;11;Keskiviikko;9;21;30
95;18.05.2016;2016;05;12;Keskiviikko;17;7;24
95;18.05.2016;2016;05;13;Keskiviikko;22;21;43
95;18.05.2016;2016;05;14;Keskiviikko;13;13;26
95;18.05.2016;2016;05;15;Keskiviikko;20;19;39
95;18.05.2016;2016;05;16;Keskiviikko;21;25;46
95;18.05.2016;2016;05;17;Keskiviikko;11;13;24
95;18.05.2016;2016;05;18;Keskiviikko;5;6;11
95;18.05.2016;2016;05;19;Keskiviikko;5;7;12
95;18.05.2016;2016;05;20;Keskiviikko;4;2;6
95;18.05.2016;2016;05;21;Keskiviikko;2;5;7
95;18.05.2016;2016;05;22;Keskiviikko;2;3;5
95;18.05.2016;2016;05;23;Keskiviikko;0;0;0
95;19.05.2016;2016;05;00;Torstai;0;0;0
95;19.05.2016;2016;05;01;Torstai;0;0;0
95;19.05.2016;2016;05;02;Torstai;1;0;1
95;19.05.2016;2016;05;03;Torstai;0;0;0
95;19.05.2016;2016;05;04;Torstai;1;0;1
95;19.05.2016;2016;05;05;Torstai;5;6;11
95;19.05.2016;2016;05;06;Torstai;15;10;25
95;19.05.2016;2016;05;07;Torstai;9;17;26
95;19.05.2016;2016;05;08;Torstai;3;8;11
95;19.05.2016;2016;05;09;Torstai;4;5;9
95;19.05.2016;2016;05;10;Torstai;5;3;8
95;19.05.2016;2016;05;11;Torstai;5;8;13
95;19.05.2016;2016;05;12;Torstai;6;5;11
95;19.05.2016;2016;05;13;Torstai;9;19;28
95;19.05.2016;2016;05;14;Torstai;14;17;31
95;19.05.2016;2016;05;15;Torstai;26;28;54
95;19.05.2016;2016;05;16;Torstai;14;11;25
95;19.05.2016;2016;05;17;Torstai;13;18;31
95;19.05.2016;2016;05;18;Torstai;7;7;14
95;19.05.2016;2016;05;19;Torstai;9;9;18
95;19.05.2016;2016;05;20;Torstai;10;4;14
95;19.05.2016;2016;05;21;Torstai;3;3;6
95;19.05.2016;2016;05;22;Torstai;4;4;8
95;19.05.2016;2016;05;23;Torstai;2;1;3
95;20.05.2016;2016;05;00;Perjantai;0;0;0
95;20.05.2016;2016;05;01;Perjantai;0;0;0
95;20.05.2016;2016;05;02;Perjantai;0;0;0
95;20.05.2016;2016;05;03;Perjantai;0;2;2
95;20.05.2016;2016;05;04;Perjantai;1;0;1
95;20.05.2016;2016;05;05;Perjantai;6;4;10
95;20.05.2016;2016;05;06;Perjantai;22;17;39
95;20.05.2016;2016;05;07;Perjantai;31;29;60
95;20.05.2016;2016;05;08;Perjantai;14;20;34
95;20.05.2016;2016;05;09;Perjantai;19;10;29
95;20.05.2016;2016;05;10;Perjantai;9;13;22
95;20.05.2016;2016;05;11;Perjantai;12;10;22
95;20.05.2016;2016;05;12;Perjantai;24;15;39
95;20.05.2016;2016;05;13;Perjantai;27;16;43
95;20.05.2016;2016;05;14;Perjantai;14;26;40
95;20.05.2016;2016;05;15;Perjantai;40;34;74
95;20.05.2016;2016;05;16;Perjantai;27;41;68
95;20.05.2016;2016;05;17;Perjantai;13;27;40
95;20.05.2016;2016;05;18;Perjantai;8;18;26
95;20.05.2016;2016;05;19;Perjantai;16;23;39
95;20.05.2016;2016;05;20;Perjantai;12;13;25
95;20.05.2016;2016;05;21;Perjantai;11;11;22
95;20.05.2016;2016;05;22;Perjantai;4;6;10
95;20.05.2016;2016;05;23;Perjantai;7;0;7
95;21.05.2016;2016;05;00;Lauantai;0;0;0
95;21.05.2016;2016;05;01;Lauantai;0;0;0
95;21.05.2016;2016;05;02;Lauantai;0;1;1
95;21.05.2016;2016;05;03;Lauantai;0;1;1
95;21.05.2016;2016;05;04;Lauantai;0;1;1
95;21.05.2016;2016;05;05;Lauantai;1;1;2
95;21.05.2016;2016;05;06;Lauantai;3;1;4
95;21.05.2016;2016;05;07;Lauantai;5;7;12
95;21.05.2016;2016;05;08;Lauantai;10;6;16
95;21.05.2016;2016;05;09;Lauantai;17;8;25
95;21.05.2016;2016;05;10;Lauantai;20;19;39
95;21.05.2016;2016;05;11;Lauantai;23;22;45
95;21.05.2016;2016;05;12;Lauantai;29;17;46
95;21.05.2016;2016;05;13;Lauantai;25;18;43
95;21.05.2016;2016;05;14;Lauantai;15;22;37
95;21.05.2016;2016;05;15;Lauantai;16;18;34
95;21.05.2016;2016;05;16;Lauantai;5;12;17
95;21.05.2016;2016;05;17;Lauantai;11;14;25
95;21.05.2016;2016;05;18;Lauantai;10;7;17
95;21.05.2016;2016;05;19;Lauantai;11;12;23
95;21.05.2016;2016;05;20;Lauantai;2;2;4
95;21.05.2016;2016;05;21;Lauantai;7;6;13
95;21.05.2016;2016;05;22;Lauantai;2;5;7
95;21.05.2016;2016;05;23;Lauantai;1;1;2
95;22.05.2016;2016;05;00;Sunnuntai;0;2;2
95;22.05.2016;2016;05;01;Sunnuntai;0;0;0
95;22.05.2016;2016;05;02;Sunnuntai;0;0;0
95;22.05.2016;2016;05;03;Sunnuntai;0;0;0
95;22.05.2016;2016;05;04;Sunnuntai;2;0;2
95;22.05.2016;2016;05;05;Sunnuntai;0;0;0
95;22.05.2016;2016;05;06;Sunnuntai;0;1;1
95;22.05.2016;2016;05;07;Sunnuntai;1;1;2
95;22.05.2016;2016;05;08;Sunnuntai;2;3;5
95;22.05.2016;2016;05;09;Sunnuntai;12;6;18
95;22.05.2016;2016;05;10;Sunnuntai;15;7;22
95;22.05.2016;2016;05;11;Sunnuntai;19;25;44
95;22.05.2016;2016;05;12;Sunnuntai;19;22;41
95;22.05.2016;2016;05;13;Sunnuntai;23;20;43
95;22.05.2016;2016;05;14;Sunnuntai;35;28;63
95;22.05.2016;2016;05;15;Sunnuntai;17;14;31
95;22.05.2016;2016;05;16;Sunnuntai;18;23;41
95;22.05.2016;2016;05;17;Sunnuntai;14;19;33
95;22.05.2016;2016;05;18;Sunnuntai;24;21;45
95;22.05.2016;2016;05;19;Sunnuntai;25;13;38
95;22.05.2016;2016;05;20;Sunnuntai;5;8;13
95;22.05.2016;2016;05;21;Sunnuntai;1;8;9
95;22.05.2016;2016;05;22;Sunnuntai;0;3;3
95;22.05.2016;2016;05;23;Sunnuntai;0;0;0
95;23.05.2016;2016;05;00;Maanantai;0;0;0
95;23.05.2016;2016;05;01;Maanantai;0;0;0
95;23.05.2016;2016;05;02;Maanantai;1;0;1
95;23.05.2016;2016;05;03;Maanantai;0;0;0
95;23.05.2016;2016;05;04;Maanantai;2;0;2
95;23.05.2016;2016;05;05;Maanantai;6;5;11
95;23.05.2016;2016;05;06;Maanantai;27;17;44
95;23.05.2016;2016;05;07;Maanantai;38;30;68
95;23.05.2016;2016;05;08;Maanantai;23;26;49
95;23.05.2016;2016;05;09;Maanantai;13;21;34
95;23.05.2016;2016;05;10;Maanantai;14;9;23
95;23.05.2016;2016;05;11;Maanantai;18;18;36
95;23.05.2016;2016;05;12;Maanantai;18;14;32
95;23.05.2016;2016;05;13;Maanantai;17;15;32
95;23.05.2016;2016;05;14;Maanantai;21;12;33
95;23.05.2016;2016;05;15;Maanantai;38;40;78
95;23.05.2016;2016;05;16;Maanantai;50;38;88
95;23.05.2016;2016;05;17;Maanantai;23;56;79
95;23.05.2016;2016;05;18;Maanantai;27;31;58
95;23.05.2016;2016;05;19;Maanantai;25;32;57
95;23.05.2016;2016;05;20;Maanantai;22;22;44
95;23.05.2016;2016;05;21;Maanantai;4;21;25
95;23.05.2016;2016;05;22;Maanantai;4;7;11
95;23.05.2016;2016;05;23;Maanantai;2;0;2
95;24.05.2016;2016;05;00;Tiistai;0;1;1
95;24.05.2016;2016;05;01;Tiistai;0;0;0
95;24.05.2016;2016;05;02;Tiistai;0;0;0
95;24.05.2016;2016;05;03;Tiistai;0;0;0
95;24.05.2016;2016;05;04;Tiistai;1;2;3
95;24.05.2016;2016;05;05;Tiistai;10;4;14
95;24.05.2016;2016;05;06;Tiistai;32;14;46
95;24.05.2016;2016;05;07;Tiistai;33;38;71
95;24.05.2016;2016;05;08;Tiistai;14;14;28
95;24.05.2016;2016;05;09;Tiistai;16;14;30
95;24.05.2016;2016;05;10;Tiistai;11;13;24
95;24.05.2016;2016;05;11;Tiistai;16;12;28
95;24.05.2016;2016;05;12;Tiistai;20;16;36
95;24.05.2016;2016;05;13;Tiistai;17;17;34
95;24.05.2016;2016;05;14;Tiistai;17;10;27
95;24.05.2016;2016;05;15;Tiistai;34;43;77
95;24.05.2016;2016;05;16;Tiistai;35;29;64
95;24.05.2016;2016;05;17;Tiistai;9;14;23
95;24.05.2016;2016;05;18;Tiistai;3;11;14
95;24.05.2016;2016;05;19;Tiistai;4;8;12
95;24.05.2016;2016;05;20;Tiistai;4;14;18
95;24.05.2016;2016;05;21;Tiistai;7;3;10
95;24.05.2016;2016;05;22;Tiistai;5;6;11
95;24.05.2016;2016;05;23;Tiistai;1;2;3
95;25.05.2016;2016;05;00;Keskiviikko;0;0;0
95;25.05.2016;2016;05;01;Keskiviikko;0;1;1
95;25.05.2016;2016;05;02;Keskiviikko;0;0;0
95;25.05.2016;2016;05;03;Keskiviikko;0;1;1
95;25.05.2016;2016;05;04;Keskiviikko;1;0;1
95;25.05.2016;2016;05;05;Keskiviikko;6;3;9
95;25.05.2016;2016;05;06;Keskiviikko;15;10;25
95;25.05.2016;2016;05;07;Keskiviikko;16;22;38
95;25.05.2016;2016;05;08;Keskiviikko;11;22;33
95;25.05.2016;2016;05;09;Keskiviikko;5;8;13
95;25.05.2016;2016;05;10;Keskiviikko;8;4;12
95;25.05.2016;2016;05;11;Keskiviikko;3;2;5
95;25.05.2016;2016;05;12;Keskiviikko;7;9;16
95;25.05.2016;2016;05;13;Keskiviikko;14;10;24
95;25.05.2016;2016;05;14;Keskiviikko;10;13;23
95;25.05.2016;2016;05;15;Keskiviikko;19;17;36
95;25.05.2016;2016;05;16;Keskiviikko;21;22;43
95;25.05.2016;2016;05;17;Keskiviikko;10;11;21
95;25.05.2016;2016;05;18;Keskiviikko;3;7;10
95;25.05.2016;2016;05;19;Keskiviikko;7;10;17
95;25.05.2016;2016;05;20;Keskiviikko;7;7;14
95;25.05.2016;2016;05;21;Keskiviikko;4;6;10
95;25.05.2016;2016;05;22;Keskiviikko;1;3;4
95;25.05.2016;2016;05;23;Keskiviikko;1;0;1
95;26.05.2016;2016;05;00;Torstai;0;0;0
95;26.05.2016;2016;05;01;Torstai;0;0;0
95;26.05.2016;2016;05;02;Torstai;0;0;0
95;26.05.2016;2016;05;03;Torstai;0;1;1
95;26.05.2016;2016;05;04;Torstai;1;0;1
95;26.05.2016;2016;05;05;Torstai;7;2;9
95;26.05.2016;2016;05;06;Torstai;21;12;33
95;26.05.2016;2016;05;07;Torstai;24;22;46
95;26.05.2016;2016;05;08;Torstai;15;12;27
95;26.05.2016;2016;05;09;Torstai;9;10;19
95;26.05.2016;2016;05;10;Torstai;13;8;21
95;26.05.2016;2016;05;11;Torstai;11;14;25
95;26.05.2016;2016;05;12;Torstai;9;7;16
95;26.05.2016;2016;05;13;Torstai;12;16;28
95;26.05.2016;2016;05;14;Torstai;6;12;18
95;26.05.2016;2016;05;15;Torstai;19;24;43
95;26.05.2016;2016;05;16;Torstai;30;25;55
95;26.05.2016;2016;05;17;Torstai;14;24;38
95;26.05.2016;2016;05;18;Torstai;20;13;33
95;26.05.2016;2016;05;19;Torstai;19;7;26
95;26.05.2016;2016;05;20;Torstai;13;15;28
95;26.05.2016;2016;05;21;Torstai;3;7;10
95;26.05.2016;2016;05;22;Torstai;2;1;3
95;26.05.2016;2016;05;23;Torstai;2;1;3
95;27.05.2016;2016;05;00;Perjantai;1;2;3
95;27.05.2016;2016;05;01;Perjantai;0;0;0
95;27.05.2016;2016;05;02;Perjantai;0;0;0
95;27.05.2016;2016;05;03;Perjantai;0;0;0
95;27.05.2016;2016;05;04;Perjantai;1;0;1
95;27.05.2016;2016;05;05;Perjantai;6;3;9
95;27.05.2016;2016;05;06;Perjantai;17;15;32
95;27.05.2016;2016;05;07;Perjantai;38;28;66
95;27.05.2016;2016;05;08;Perjantai;17;15;32
95;27.05.2016;2016;05;09;Perjantai;15;9;24
95;27.05.2016;2016;05;10;Perjantai;13;8;21
95;27.05.2016;2016;05;11;Perjantai;8;8;16
95;27.05.2016;2016;05;12;Perjantai;25;11;36
95;27.05.2016;2016;05;13;Perjantai;16;13;29
95;27.05.2016;2016;05;14;Perjantai;21;19;40
95;27.05.2016;2016;05;15;Perjantai;31;32;63
95;27.05.2016;2016;05;16;Perjantai;19;40;59
95;27.05.2016;2016;05;17;Perjantai;16;25;41
95;27.05.2016;2016;05;18;Perjantai;12;25;37
95;27.05.2016;2016;05;19;Perjantai;24;10;34
95;27.05.2016;2016;05;20;Perjantai;11;16;27
95;27.05.2016;2016;05;21;Perjantai;7;16;23
95;27.05.2016;2016;05;22;Perjantai;7;10;17
95;27.05.2016;2016;05;23;Perjantai;1;0;1
95;28.05.2016;2016;05;00;Lauantai;2;7;9
95;28.05.2016;2016;05;01;Lauantai;1;4;5
95;28.05.2016;2016;05;02;Lauantai;2;1;3
95;28.05.2016;2016;05;03;Lauantai;0;2;2
95;28.05.2016;2016;05;04;Lauantai;1;0;1
95;28.05.2016;2016;05;05;Lauantai;3;0;3
95;28.05.2016;2016;05;06;Lauantai;5;4;9
95;28.05.2016;2016;05;07;Lauantai;4;4;8
95;28.05.2016;2016;05;08;Lauantai;7;4;11
95;28.05.2016;2016;05;09;Lauantai;11;16;27
95;28.05.2016;2016;05;10;Lauantai;14;15;29
95;28.05.2016;2016;05;11;Lauantai;21;21;42
95;28.05.2016;2016;05;12;Lauantai;25;31;56
95;28.05.2016;2016;05;13;Lauantai;29;23;52
95;28.05.2016;2016;05;14;Lauantai;26;39;65
95;28.05.2016;2016;05;15;Lauantai;33;35;68
95;28.05.2016;2016;05;16;Lauantai;17;25;42
95;28.05.2016;2016;05;17;Lauantai;22;17;39
95;28.05.2016;2016;05;18;Lauantai;13;13;26
95;28.05.2016;2016;05;19;Lauantai;14;17;31
95;28.05.2016;2016;05;20;Lauantai;16;12;28
95;28.05.2016;2016;05;21;Lauantai;6;22;28
95;28.05.2016;2016;05;22;Lauantai;2;3;5
95;28.05.2016;2016;05;23;Lauantai;3;2;5
95;29.05.2016;2016;05;00;Sunnuntai;5;4;9
95;29.05.2016;2016;05;01;Sunnuntai;1;4;5
95;29.05.2016;2016;05;02;Sunnuntai;1;0;1
95;29.05.2016;2016;05;03;Sunnuntai;1;2;3
95;29.05.2016;2016;05;04;Sunnuntai;1;0;1
95;29.05.2016;2016;05;05;Sunnuntai;3;2;5
95;29.05.2016;2016;05;06;Sunnuntai;6;1;7
95;29.05.2016;2016;05;07;Sunnuntai;1;6;7
95;29.05.2016;2016;05;08;Sunnuntai;5;9;14
95;29.05.2016;2016;05;09;Sunnuntai;22;17;39
95;29.05.2016;2016;05;10;Sunnuntai;47;33;80
95;29.05.2016;2016;05;11;Sunnuntai;27;33;60
95;29.05.2016;2016;05;12;Sunnuntai;25;39;64
95;29.05.2016;2016;05;13;Sunnuntai;33;35;68
95;29.05.2016;2016;05;14;Sunnuntai;34;41;75
95;29.05.2016;2016;05;15;Sunnuntai;34;39;73
95;29.05.2016;2016;05;16;Sunnuntai;39;37;76
95;29.05.2016;2016;05;17;Sunnuntai;15;29;44
95;29.05.2016;2016;05;18;Sunnuntai;25;25;50
95;29.05.2016;2016;05;19;Sunnuntai;32;23;55
95;29.05.2016;2016;05;20;Sunnuntai;17;15;32
95;29.05.2016;2016;05;21;Sunnuntai;6;11;17
95;29.05.2016;2016;05;22;Sunnuntai;4;2;6
95;29.05.2016;2016;05;23;Sunnuntai;3;1;4
95;30.05.2016;2016;05;00;Maanantai;1;1;2
95;30.05.2016;2016;05;01;Maanantai;1;1;2
95;30.05.2016;2016;05;02;Maanantai;0;0;0
95;30.05.2016;2016;05;03;Maanantai;1;0;1
95;30.05.2016;2016;05;04;Maanantai;1;0;1
95;30.05.2016;2016;05;05;Maanantai;12;3;15
95;30.05.2016;2016;05;06;Maanantai;38;18;56
95;30.05.2016;2016;05;07;Maanantai;49;45;94
95;30.05.2016;2016;05;08;Maanantai;21;24;45
95;30.05.2016;2016;05;09;Maanantai;15;7;22
95;30.05.2016;2016;05;10;Maanantai;24;6;30
95;30.05.2016;2016;05;11;Maanantai;26;15;41
95;30.05.2016;2016;05;12;Maanantai;19;25;44
95;30.05.2016;2016;05;13;Maanantai;15;27;42
95;30.05.2016;2016;05;14;Maanantai;34;29;63
95;30.05.2016;2016;05;15;Maanantai;45;45;90
95;30.05.2016;2016;05;16;Maanantai;42;68;110
95;30.05.2016;2016;05;17;Maanantai;32;40;72
95;30.05.2016;2016;05;18;Maanantai;32;22;54
95;30.05.2016;2016;05;19;Maanantai;26;25;51
95;30.05.2016;2016;05;20;Maanantai;20;25;45
95;30.05.2016;2016;05;21;Maanantai;6;7;13
95;30.05.2016;2016;05;22;Maanantai;4;9;13
95;30.05.2016;2016;05;23;Maanantai;1;3;4
95;31.05.2016;2016;05;00;Tiistai;0;0;0
95;31.05.2016;2016;05;01;Tiistai;1;0;1
95;31.05.2016;2016;05;02;Tiistai;0;1;1
95;31.05.2016;2016;05;03;Tiistai;0;0;0
95;31.05.2016;2016;05;04;Tiistai;3;0;3
95;31.05.2016;2016;05;05;Tiistai;9;2;11
95;31.05.2016;2016;05;06;Tiistai;37;22;59
95;31.05.2016;2016;05;07;Tiistai;49;34;83
95;31.05.2016;2016;05;08;Tiistai;22;28;50
95;31.05.2016;2016;05;09;Tiistai;16;11;27
95;31.05.2016;2016;05;10;Tiistai;30;11;41
95;31.05.2016;2016;05;11;Tiistai;25;19;44
95;31.05.2016;2016;05;12;Tiistai;18;14;32
95;31.05.2016;2016;05;13;Tiistai;19;20;39
95;31.05.2016;2016;05;14;Tiistai;28;24;52
95;31.05.2016;2016;05;15;Tiistai;38;53;91
95;31.05.2016;2016;05;16;Tiistai;43;62;105
95;31.05.2016;2016;05;17;Tiistai;34;64;98
95;31.05.2016;2016;05;18;Tiistai;27;37;64
95;31.05.2016;2016;05;19;Tiistai;18;38;56
95;31.05.2016;2016;05;20;Tiistai;30;24;54
95;31.05.2016;2016;05;21;Tiistai;15;11;26
95;31.05.2016;2016;05;22;Tiistai;5;5;10
95;31.05.2016;2016;05;23;Tiistai;0;0;0
95;01.06.2016;2016;06;00;Keskiviikko;0;1;1
95;01.06.2016;2016;06;01;Keskiviikko;0;0;0
95;01.06.2016;2016;06;02;Keskiviikko;0;0;0
95;01.06.2016;2016;06;03;Keskiviikko;2;0;2
95;01.06.2016;2016;06;04;Keskiviikko;4;0;4
95;01.06.2016;2016;06;05;Keskiviikko;10;6;16
95;01.06.2016;2016;06;06;Keskiviikko;42;15;57
95;01.06.2016;2016;06;07;Keskiviikko;42;31;73
95;01.06.2016;2016;06;08;Keskiviikko;24;19;43
95;01.06.2016;2016;06;09;Keskiviikko;17;10;27
95;01.06.2016;2016;06;10;Keskiviikko;8;8;16
95;01.06.2016;2016;06;11;Keskiviikko;2;7;9
95;01.06.2016;2016;06;12;Keskiviikko;12;9;21
95;01.06.2016;2016;06;13;Keskiviikko;9;17;26
95;01.06.2016;2016;06;14;Keskiviikko;18;21;39
95;01.06.2016;2016;06;15;Keskiviikko;32;37;69
95;01.06.2016;2016;06;16;Keskiviikko;38;60;98
95;01.06.2016;2016;06;17;Keskiviikko;20;36;56
95;01.06.2016;2016;06;18;Keskiviikko;29;20;49
95;01.06.2016;2016;06;19;Keskiviikko;29;25;54
95;01.06.2016;2016;06;20;Keskiviikko;15;14;29
95;01.06.2016;2016;06;21;Keskiviikko;9;7;16
95;01.06.2016;2016;06;22;Keskiviikko;5;6;11
95;01.06.2016;2016;06;23;Keskiviikko;0;1;1
95;02.06.2016;2016;06;00;Torstai;0;2;2
95;02.06.2016;2016;06;01;Torstai;1;1;2
95;02.06.2016;2016;06;02;Torstai;0;0;0
95;02.06.2016;2016;06;03;Torstai;1;0;1
95;02.06.2016;2016;06;04;Torstai;5;0;5
95;02.06.2016;2016;06;05;Torstai;10;10;20
95;02.06.2016;2016;06;06;Torstai;43;16;59
95;02.06.2016;2016;06;07;Torstai;34;25;59
95;02.06.2016;2016;06;08;Torstai;33;27;60
95;02.06.2016;2016;06;09;Torstai;15;8;23
95;02.06.2016;2016;06;10;Torstai;22;17;39
95;02.06.2016;2016;06;11;Torstai;13;23;36
95;02.06.2016;2016;06;12;Torstai;19;17;36
95;02.06.2016;2016;06;13;Torstai;12;26;38
95;02.06.2016;2016;06;14;Torstai;32;21;53
95;02.06.2016;2016;06;15;Torstai;30;42;72
95;02.06.2016;2016;06;16;Torstai;35;60;95
95;02.06.2016;2016;06;17;Torstai;25;32;57
95;02.06.2016;2016;06;18;Torstai;21;39;60
95;02.06.2016;2016;06;19;Torstai;20;23;43
95;02.06.2016;2016;06;20;Torstai;18;19;37
95;02.06.2016;2016;06;21;Torstai;9;10;19
95;02.06.2016;2016;06;22;Torstai;3;11;14
95;02.06.2016;2016;06;23;Torstai;1;0;1
95;03.06.2016;2016;06;00;Perjantai;0;0;0
95;03.06.2016;2016;06;01;Perjantai;0;0;0
95;03.06.2016;2016;06;02;Perjantai;0;0;0
95;03.06.2016;2016;06;03;Perjantai;1;0;1
95;03.06.2016;2016;06;04;Perjantai;2;0;2
95;03.06.2016;2016;06;05;Perjantai;9;4;13
95;03.06.2016;2016;06;06;Perjantai;29;7;36
95;03.06.2016;2016;06;07;Perjantai;17;11;28
95;03.06.2016;2016;06;08;Perjantai;12;13;25
95;03.06.2016;2016;06;09;Perjantai;8;17;25
95;03.06.2016;2016;06;10;Perjantai;8;9;17
95;03.06.2016;2016;06;11;Perjantai;19;10;29
95;03.06.2016;2016;06;12;Perjantai;18;11;29
95;03.06.2016;2016;06;13;Perjantai;12;12;24
95;03.06.2016;2016;06;14;Perjantai;8;16;24
95;03.06.2016;2016;06;15;Perjantai;19;24;43
95;03.06.2016;2016;06;16;Perjantai;23;23;46
95;03.06.2016;2016;06;17;Perjantai;4;20;24
95;03.06.2016;2016;06;18;Perjantai;7;15;22
95;03.06.2016;2016;06;19;Perjantai;10;9;19
95;03.06.2016;2016;06;20;Perjantai;8;11;19
95;03.06.2016;2016;06;21;Perjantai;0;3;3
95;03.06.2016;2016;06;22;Perjantai;3;4;7
95;03.06.2016;2016;06;23;Perjantai;0;0;0
95;04.06.2016;2016;06;00;Lauantai;1;0;1
95;04.06.2016;2016;06;01;Lauantai;0;1;1
95;04.06.2016;2016;06;02;Lauantai;0;0;0
95;04.06.2016;2016;06;03;Lauantai;1;0;1
95;04.06.2016;2016;06;04;Lauantai;0;0;0
95;04.06.2016;2016;06;05;Lauantai;1;2;3
95;04.06.2016;2016;06;06;Lauantai;2;2;4
95;04.06.2016;2016;06;07;Lauantai;7;3;10
95;04.06.2016;2016;06;08;Lauantai;2;4;6
95;04.06.2016;2016;06;09;Lauantai;3;10;13
95;04.06.2016;2016;06;10;Lauantai;5;6;11
95;04.06.2016;2016;06;11;Lauantai;7;9;16
95;04.06.2016;2016;06;12;Lauantai;11;10;21
95;04.06.2016;2016;06;13;Lauantai;4;3;7
95;04.06.2016;2016;06;14;Lauantai;6;10;16
95;04.06.2016;2016;06;15;Lauantai;13;8;21
95;04.06.2016;2016;06;16;Lauantai;3;9;12
95;04.06.2016;2016;06;17;Lauantai;3;7;10
95;04.06.2016;2016;06;18;Lauantai;4;7;11
95;04.06.2016;2016;06;19;Lauantai;2;7;9
95;04.06.2016;2016;06;20;Lauantai;9;9;18
95;04.06.2016;2016;06;21;Lauantai;5;4;9
95;04.06.2016;2016;06;22;Lauantai;2;4;6
95;04.06.2016;2016;06;23;Lauantai;0;0;0
95;05.06.2016;2016;06;00;Sunnuntai;0;1;1
95;05.06.2016;2016;06;01;Sunnuntai;0;2;2
95;05.06.2016;2016;06;02;Sunnuntai;0;2;2
95;05.06.2016;2016;06;03;Sunnuntai;0;1;1
95;05.06.2016;2016;06;04;Sunnuntai;1;0;1
95;05.06.2016;2016;06;05;Sunnuntai;0;1;1
95;05.06.2016;2016;06;06;Sunnuntai;1;0;1
95;05.06.2016;2016;06;07;Sunnuntai;2;4;6
95;05.06.2016;2016;06;08;Sunnuntai;3;6;9
95;05.06.2016;2016;06;09;Sunnuntai;13;5;18
95;05.06.2016;2016;06;10;Sunnuntai;6;18;24
95;05.06.2016;2016;06;11;Sunnuntai;12;12;24
95;05.06.2016;2016;06;12;Sunnuntai;11;12;23
95;05.06.2016;2016;06;13;Sunnuntai;5;13;18
95;05.06.2016;2016;06;14;Sunnuntai;10;9;19
95;05.06.2016;2016;06;15;Sunnuntai;5;9;14
95;05.06.2016;2016;06;16;Sunnuntai;10;8;18
95;05.06.2016;2016;06;17;Sunnuntai;10;8;18
95;05.06.2016;2016;06;18;Sunnuntai;10;4;14
95;05.06.2016;2016;06;19;Sunnuntai;14;9;23
95;05.06.2016;2016;06;20;Sunnuntai;3;5;8
95;05.06.2016;2016;06;21;Sunnuntai;7;1;8
95;05.06.2016;2016;06;22;Sunnuntai;0;6;6
95;05.06.2016;2016;06;23;Sunnuntai;0;1;1
95;06.06.2016;2016;06;00;Maanantai;1;0;1
95;06.06.2016;2016;06;01;Maanantai;0;0;0
95;06.06.2016;2016;06;02;Maanantai;0;0;0
95;06.06.2016;2016;06;03;Maanantai;0;0;0
95;06.06.2016;2016;06;04;Maanantai;2;0;2
95;06.06.2016;2016;06;05;Maanantai;6;3;9
95;06.06.2016;2016;06;06;Maanantai;18;12;30
95;06.06.2016;2016;06;07;Maanantai;36;29;65
95;06.06.2016;2016;06;08;Maanantai;16;17;33
95;06.06.2016;2016;06;09;Maanantai;12;12;24
95;06.06.2016;2016;06;10;Maanantai;9;6;15
95;06.06.2016;2016;06;11;Maanantai;9;19;28
95;06.06.2016;2016;06;12;Maanantai;18;5;23
95;06.06.2016;2016;06;13;Maanantai;21;18;39
95;06.06.2016;2016;06;14;Maanantai;9;6;15
95;06.06.2016;2016;06;15;Maanantai;26;37;63
95;06.06.2016;2016;06;16;Maanantai;41;39;80
95;06.06.2016;2016;06;17;Maanantai;18;40;58
95;06.06.2016;2016;06;18;Maanantai;18;26;44
95;06.06.2016;2016;06;19;Maanantai;17;21;38
95;06.06.2016;2016;06;20;Maanantai;8;16;24
95;06.06.2016;2016;06;21;Maanantai;15;11;26
95;06.06.2016;2016;06;22;Maanantai;6;2;8
95;06.06.2016;2016;06;23;Maanantai;0;1;1
95;07.06.2016;2016;06;00;Tiistai;0;0;0
95;07.06.2016;2016;06;01;Tiistai;0;0;0
95;07.06.2016;2016;06;02;Tiistai;0;0;0
95;07.06.2016;2016;06;03;Tiistai;0;0;0
95;07.06.2016;2016;06;04;Tiistai;3;0;3
95;07.06.2016;2016;06;05;Tiistai;7;1;8
95;07.06.2016;2016;06;06;Tiistai;31;10;41
95;07.06.2016;2016;06;07;Tiistai;21;16;37
95;07.06.2016;2016;06;08;Tiistai;18;22;40
95;07.06.2016;2016;06;09;Tiistai;16;11;27
95;07.06.2016;2016;06;10;Tiistai;12;9;21
95;07.06.2016;2016;06;11;Tiistai;9;10;19
95;07.06.2016;2016;06;12;Tiistai;14;13;27
95;07.06.2016;2016;06;13;Tiistai;14;17;31
95;07.06.2016;2016;06;14;Tiistai;21;17;38
95;07.06.2016;2016;06;15;Tiistai;23;29;52
95;07.06.2016;2016;06;16;Tiistai;32;48;80
95;07.06.2016;2016;06;17;Tiistai;18;30;48
95;07.06.2016;2016;06;18;Tiistai;12;35;47
95;07.06.2016;2016;06;19;Tiistai;15;19;34
95;07.06.2016;2016;06;20;Tiistai;12;14;26
95;07.06.2016;2016;06;21;Tiistai;9;14;23
95;07.06.2016;2016;06;22;Tiistai;4;1;5
95;07.06.2016;2016;06;23;Tiistai;1;0;1
95;08.06.2016;2016;06;00;Keskiviikko;1;0;1
95;08.06.2016;2016;06;01;Keskiviikko;0;0;0
95;08.06.2016;2016;06;02;Keskiviikko;0;0;0
95;08.06.2016;2016;06;03;Keskiviikko;0;1;1
95;08.06.2016;2016;06;04;Keskiviikko;1;0;1
95;08.06.2016;2016;06;05;Keskiviikko;2;2;4
95;08.06.2016;2016;06;06;Keskiviikko;8;4;12
95;08.06.2016;2016;06;07;Keskiviikko;5;5;10
95;08.06.2016;2016;06;08;Keskiviikko;4;7;11
95;08.06.2016;2016;06;09;Keskiviikko;5;4;9
95;08.06.2016;2016;06;10;Keskiviikko;2;3;5
95;08.06.2016;2016;06;11;Keskiviikko;7;3;10
95;08.06.2016;2016;06;12;Keskiviikko;2;1;3
95;08.06.2016;2016;06;13;Keskiviikko;1;6;7
95;08.06.2016;2016;06;14;Keskiviikko;2;0;2
95;08.06.2016;2016;06;15;Keskiviikko;3;5;8
95;08.06.2016;2016;06;16;Keskiviikko;2;7;9
95;08.06.2016;2016;06;17;Keskiviikko;1;7;8
95;08.06.2016;2016;06;18;Keskiviikko;1;1;2
95;08.06.2016;2016;06;19;Keskiviikko;0;0;0
95;08.06.2016;2016;06;20;Keskiviikko;0;1;1
95;08.06.2016;2016;06;21;Keskiviikko;1;4;5
95;08.06.2016;2016;06;22;Keskiviikko;3;2;5
95;08.06.2016;2016;06;23;Keskiviikko;0;0;0
95;09.06.2016;2016;06;00;Torstai;0;0;0
95;09.06.2016;2016;06;01;Torstai;0;0;0
95;09.06.2016;2016;06;02;Torstai;0;0;0
95;09.06.2016;2016;06;03;Torstai;1;0;1
95;09.06.2016;2016;06;04;Torstai;1;1;2
95;09.06.2016;2016;06;05;Torstai;1;1;2
95;09.06.2016;2016;06;06;Torstai;7;6;13
95;09.06.2016;2016;06;07;Torstai;5;5;10
95;09.06.2016;2016;06;08;Torstai;4;6;10
95;09.06.2016;2016;06;09;Torstai;7;12;19
95;09.06.2016;2016;06;10;Torstai;6;1;7
95;09.06.2016;2016;06;11;Torstai;2;7;9
95;09.06.2016;2016;06;12;Torstai;11;7;18
95;09.06.2016;2016;06;13;Torstai;5;8;13
95;09.06.2016;2016;06;14;Torstai;8;6;14
95;09.06.2016;2016;06;15;Torstai;9;13;22
95;09.06.2016;2016;06;16;Torstai;14;15;29
95;09.06.2016;2016;06;17;Torstai;6;14;20
95;09.06.2016;2016;06;18;Torstai;13;6;19
95;09.06.2016;2016;06;19;Torstai;7;10;17
95;09.06.2016;2016;06;20;Torstai;6;9;15
95;09.06.2016;2016;06;21;Torstai;8;8;16
95;09.06.2016;2016;06;22;Torstai;2;4;6
95;09.06.2016;2016;06;23;Torstai;1;2;3
95;10.06.2016;2016;06;00;Perjantai;0;0;0
95;10.06.2016;2016;06;01;Perjantai;2;0;2
95;10.06.2016;2016;06;02;Perjantai;0;0;0
95;10.06.2016;2016;06;03;Perjantai;0;1;1
95;10.06.2016;2016;06;04;Perjantai;1;0;1
95;10.06.2016;2016;06;05;Perjantai;4;0;4
95;10.06.2016;2016;06;06;Perjantai;12;6;18
95;10.06.2016;2016;06;07;Perjantai;14;7;21
95;10.06.2016;2016;06;08;Perjantai;11;9;20
95;10.06.2016;2016;06;09;Perjantai;6;6;12
95;10.06.2016;2016;06;10;Perjantai;5;7;12
95;10.06.2016;2016;06;11;Perjantai;0;5;5
95;10.06.2016;2016;06;12;Perjantai;8;21;29
95;10.06.2016;2016;06;13;Perjantai;7;8;15
95;10.06.2016;2016;06;14;Perjantai;9;12;21
95;10.06.2016;2016;06;15;Perjantai;14;12;26
95;10.06.2016;2016;06;16;Perjantai;7;13;20
95;10.06.2016;2016;06;17;Perjantai;9;6;15
95;10.06.2016;2016;06;18;Perjantai;4;14;18
95;10.06.2016;2016;06;19;Perjantai;6;5;11
95;10.06.2016;2016;06;20;Perjantai;7;6;13
95;10.06.2016;2016;06;21;Perjantai;10;4;14
95;10.06.2016;2016;06;22;Perjantai;3;1;4
95;10.06.2016;2016;06;23;Perjantai;3;0;3
95;11.06.2016;2016;06;00;Lauantai;1;0;1
95;11.06.2016;2016;06;01;Lauantai;0;2;2
95;11.06.2016;2016;06;02;Lauantai;0;0;0
95;11.06.2016;2016;06;03;Lauantai;1;0;1
95;11.06.2016;2016;06;04;Lauantai;1;1;2
95;11.06.2016;2016;06;05;Lauantai;2;0;2
95;11.06.2016;2016;06;06;Lauantai;2;1;3
95;11.06.2016;2016;06;07;Lauantai;3;4;7
95;11.06.2016;2016;06;08;Lauantai;10;4;14
95;11.06.2016;2016;06;09;Lauantai;16;3;19
95;11.06.2016;2016;06;10;Lauantai;3;10;13
95;11.06.2016;2016;06;11;Lauantai;13;8;21
95;11.06.2016;2016;06;12;Lauantai;9;16;25
95;11.06.2016;2016;06;13;Lauantai;16;14;30
95;11.06.2016;2016;06;14;Lauantai;11;13;24
95;11.06.2016;2016;06;15;Lauantai;12;17;29
95;11.06.2016;2016;06;16;Lauantai;4;11;15
95;11.06.2016;2016;06;17;Lauantai;3;11;14
95;11.06.2016;2016;06;18;Lauantai;9;16;25
95;11.06.2016;2016;06;19;Lauantai;15;9;24
95;11.06.2016;2016;06;20;Lauantai;5;9;14
95;11.06.2016;2016;06;21;Lauantai;4;7;11
95;11.06.2016;2016;06;22;Lauantai;1;1;2
95;11.06.2016;2016;06;23;Lauantai;0;1;1
95;12.06.2016;2016;06;00;Sunnuntai;2;1;3
95;12.06.2016;2016;06;01;Sunnuntai;0;0;0
95;12.06.2016;2016;06;02;Sunnuntai;0;0;0
95;12.06.2016;2016;06;03;Sunnuntai;0;0;0
95;12.06.2016;2016;06;04;Sunnuntai;3;0;3
95;12.06.2016;2016;06;05;Sunnuntai;1;1;2
95;12.06.2016;2016;06;06;Sunnuntai;3;1;4
95;12.06.2016;2016;06;07;Sunnuntai;7;3;10
95;12.06.2016;2016;06;08;Sunnuntai;3;3;6
95;12.06.2016;2016;06;09;Sunnuntai;14;16;30
95;12.06.2016;2016;06;10;Sunnuntai;14;41;55
95;12.06.2016;2016;06;11;Sunnuntai;31;14;45
95;12.06.2016;2016;06;12;Sunnuntai;25;24;49
95;12.06.2016;2016;06;13;Sunnuntai;11;33;44
95;12.06.2016;2016;06;14;Sunnuntai;11;14;25
95;12.06.2016;2016;06;15;Sunnuntai;18;33;51
95;12.06.2016;2016;06;16;Sunnuntai;24;25;49
95;12.06.2016;2016;06;17;Sunnuntai;19;13;32
95;12.06.2016;2016;06;18;Sunnuntai;18;26;44
95;12.06.2016;2016;06;19;Sunnuntai;29;16;45
95;12.06.2016;2016;06;20;Sunnuntai;23;9;32
95;12.06.2016;2016;06;21;Sunnuntai;5;8;13
95;12.06.2016;2016;06;22;Sunnuntai;5;3;8
95;12.06.2016;2016;06;23;Sunnuntai;1;1;2
95;13.06.2016;2016;06;00;Maanantai;0;1;1
95;13.06.2016;2016;06;01;Maanantai;1;0;1
95;13.06.2016;2016;06;02;Maanantai;0;0;0
95;13.06.2016;2016;06;03;Maanantai;2;0;2
95;13.06.2016;2016;06;04;Maanantai;3;0;3
95;13.06.2016;2016;06;05;Maanantai;11;3;14
95;13.06.2016;2016;06;06;Maanantai;23;20;43
95;13.06.2016;2016;06;07;Maanantai;32;17;49
95;13.06.2016;2016;06;08;Maanantai;15;18;33
95;13.06.2016;2016;06;09;Maanantai;12;10;22
95;13.06.2016;2016;06;10;Maanantai;23;13;36
95;13.06.2016;2016;06;11;Maanantai;13;16;29
95;13.06.2016;2016;06;12;Maanantai;17;12;29
95;13.06.2016;2016;06;13;Maanantai;12;19;31
95;13.06.2016;2016;06;14;Maanantai;19;20;39
95;13.06.2016;2016;06;15;Maanantai;22;27;49
95;13.06.2016;2016;06;16;Maanantai;30;51;81
95;13.06.2016;2016;06;17;Maanantai;38;20;58
95;13.06.2016;2016;06;18;Maanantai;15;32;47
95;13.06.2016;2016;06;19;Maanantai;11;34;45
95;13.06.2016;2016;06;20;Maanantai;15;13;28
95;13.06.2016;2016;06;21;Maanantai;11;14;25
95;13.06.2016;2016;06;22;Maanantai;5;4;9
95;13.06.2016;2016;06;23;Maanantai;0;0;0
95;14.06.2016;2016;06;00;Tiistai;1;1;2
95;14.06.2016;2016;06;01;Tiistai;0;0;0
95;14.06.2016;2016;06;02;Tiistai;0;0;0
95;14.06.2016;2016;06;03;Tiistai;0;0;0
95;14.06.2016;2016;06;04;Tiistai;2;0;2
95;14.06.2016;2016;06;05;Tiistai;11;3;14
95;14.06.2016;2016;06;06;Tiistai;33;16;49
95;14.06.2016;2016;06;07;Tiistai;37;17;54
95;14.06.2016;2016;06;08;Tiistai;15;21;36
95;14.06.2016;2016;06;09;Tiistai;16;15;31
95;14.06.2016;2016;06;10;Tiistai;10;11;21
95;14.06.2016;2016;06;11;Tiistai;24;5;29
95;14.06.2016;2016;06;12;Tiistai;14;16;30
95;14.06.2016;2016;06;13;Tiistai;15;10;25
95;14.06.2016;2016;06;14;Tiistai;17;20;37
95;14.06.2016;2016;06;15;Tiistai;33;44;77
95;14.06.2016;2016;06;16;Tiistai;27;46;73
95;14.06.2016;2016;06;17;Tiistai;20;40;60
95;14.06.2016;2016;06;18;Tiistai;18;21;39
95;14.06.2016;2016;06;19;Tiistai;8;30;38
95;14.06.2016;2016;06;20;Tiistai;19;20;39
95;14.06.2016;2016;06;21;Tiistai;6;12;18
95;14.06.2016;2016;06;22;Tiistai;3;4;7
95;14.06.2016;2016;06;23;Tiistai;0;5;5
95;15.06.2016;2016;06;00;Keskiviikko;3;1;4
95;15.06.2016;2016;06;01;Keskiviikko;0;0;0
95;15.06.2016;2016;06;02;Keskiviikko;0;0;0
95;15.06.2016;2016;06;03;Keskiviikko;0;1;1
95;15.06.2016;2016;06;04;Keskiviikko;1;0;1
95;15.06.2016;2016;06;05;Keskiviikko;9;1;10
95;15.06.2016;2016;06;06;Keskiviikko;34;17;51
95;15.06.2016;2016;06;07;Keskiviikko;42;17;59
95;15.06.2016;2016;06;08;Keskiviikko;13;14;27
95;15.06.2016;2016;06;09;Keskiviikko;15;13;28
95;15.06.2016;2016;06;10;Keskiviikko;15;20;35
95;15.06.2016;2016;06;11;Keskiviikko;20;25;45
95;15.06.2016;2016;06;12;Keskiviikko;22;15;37
95;15.06.2016;2016;06;13;Keskiviikko;17;18;35
95;15.06.2016;2016;06;14;Keskiviikko;17;18;35
95;15.06.2016;2016;06;15;Keskiviikko;27;46;73
95;15.06.2016;2016;06;16;Keskiviikko;29;48;77
95;15.06.2016;2016;06;17;Keskiviikko;28;30;58
95;15.06.2016;2016;06;18;Keskiviikko;27;28;55
95;15.06.2016;2016;06;19;Keskiviikko;21;29;50
95;15.06.2016;2016;06;20;Keskiviikko;14;17;31
95;15.06.2016;2016;06;21;Keskiviikko;15;11;26
95;15.06.2016;2016;06;22;Keskiviikko;4;11;15
95;15.06.2016;2016;06;23;Keskiviikko;0;1;1
95;16.06.2016;2016;06;00;Torstai;1;0;1
95;16.06.2016;2016;06;01;Torstai;1;0;1
95;16.06.2016;2016;06;02;Torstai;0;2;2
95;16.06.2016;2016;06;03;Torstai;0;1;1
95;16.06.2016;2016;06;04;Torstai;1;1;2
95;16.06.2016;2016;06;05;Torstai;6;3;9
95;16.06.2016;2016;06;06;Torstai;17;19;36
95;16.06.2016;2016;06;07;Torstai;31;14;45
95;16.06.2016;2016;06;08;Torstai;12;12;24
95;16.06.2016;2016;06;09;Torstai;23;10;33
95;16.06.2016;2016;06;10;Torstai;18;4;22
95;16.06.2016;2016;06;11;Torstai;16;11;27
95;16.06.2016;2016;06;12;Torstai;14;12;26
95;16.06.2016;2016;06;13;Torstai;2;10;12
95;16.06.2016;2016;06;14;Torstai;2;8;10
95;16.06.2016;2016;06;15;Torstai;12;20;32
95;16.06.2016;2016;06;16;Torstai;11;15;26
95;16.06.2016;2016;06;17;Torstai;4;11;15
95;16.06.2016;2016;06;18;Torstai;3;4;7
95;16.06.2016;2016;06;19;Torstai;2;3;5
95;16.06.2016;2016;06;20;Torstai;2;6;8
95;16.06.2016;2016;06;21;Torstai;2;3;5
95;16.06.2016;2016;06;22;Torstai;2;2;4
95;16.06.2016;2016;06;23;Torstai;0;1;1
95;17.06.2016;2016;06;00;Perjantai;0;0;0
95;17.06.2016;2016;06;01;Perjantai;0;0;0
95;17.06.2016;2016;06;02;Perjantai;0;0;0
95;17.06.2016;2016;06;03;Perjantai;0;0;0
95;17.06.2016;2016;06;04;Perjantai;0;0;0
95;17.06.2016;2016;06;05;Perjantai;4;2;6
95;17.06.2016;2016;06;06;Perjantai;2;6;8
95;17.06.2016;2016;06;07;Perjantai;7;6;13
95;17.06.2016;2016;06;08;Perjantai;2;4;6
95;17.06.2016;2016;06;09;Perjantai;5;4;9
95;17.06.2016;2016;06;10;Perjantai;6;3;9
95;17.06.2016;2016;06;11;Perjantai;6;6;12
95;17.06.2016;2016;06;12;Perjantai;7;7;14
95;17.06.2016;2016;06;13;Perjantai;4;3;7
95;17.06.2016;2016;06;14;Perjantai;7;4;11
95;17.06.2016;2016;06;15;Perjantai;7;6;13
95;17.06.2016;2016;06;16;Perjantai;13;11;24
95;17.06.2016;2016;06;17;Perjantai;10;10;20
95;17.06.2016;2016;06;18;Perjantai;11;10;21
95;17.06.2016;2016;06;19;Perjantai;22;16;38
95;17.06.2016;2016;06;20;Perjantai;7;14;21
95;17.06.2016;2016;06;21;Perjantai;4;2;6
95;17.06.2016;2016;06;22;Perjantai;4;6;10
95;17.06.2016;2016;06;23;Perjantai;3;1;4
95;18.06.2016;2016;06;00;Lauantai;2;2;4
95;18.06.2016;2016;06;01;Lauantai;3;6;9
95;18.06.2016;2016;06;02;Lauantai;0;2;2
95;18.06.2016;2016;06;03;Lauantai;0;0;0
95;18.06.2016;2016;06;04;Lauantai;1;1;2
95;18.06.2016;2016;06;05;Lauantai;2;0;2
95;18.06.2016;2016;06;06;Lauantai;2;4;6
95;18.06.2016;2016;06;07;Lauantai;4;5;9
95;18.06.2016;2016;06;08;Lauantai;18;7;25
95;18.06.2016;2016;06;09;Lauantai;16;13;29
95;18.06.2016;2016;06;10;Lauantai;10;15;25
95;18.06.2016;2016;06;11;Lauantai;9;9;18
95;18.06.2016;2016;06;12;Lauantai;2;2;4
95;18.06.2016;2016;06;13;Lauantai;3;4;7
95;18.06.2016;2016;06;14;Lauantai;3;5;8
95;18.06.2016;2016;06;15;Lauantai;2;6;8
95;18.06.2016;2016;06;16;Lauantai;5;10;15
95;18.06.2016;2016;06;17;Lauantai;5;11;16
95;18.06.2016;2016;06;18;Lauantai;6;7;13
95;18.06.2016;2016;06;19;Lauantai;4;1;5
95;18.06.2016;2016;06;20;Lauantai;4;1;5
95;18.06.2016;2016;06;21;Lauantai;5;1;6
95;18.06.2016;2016;06;22;Lauantai;0;2;2
95;18.06.2016;2016;06;23;Lauantai;0;3;3
95;19.06.2016;2016;06;00;Sunnuntai;2;1;3
95;19.06.2016;2016;06;01;Sunnuntai;0;0;0
95;19.06.2016;2016;06;02;Sunnuntai;0;1;1
95;19.06.2016;2016;06;03;Sunnuntai;1;0;1
95;19.06.2016;2016;06;04;Sunnuntai;1;0;1
95;19.06.2016;2016;06;05;Sunnuntai;0;0;0
95;19.06.2016;2016;06;06;Sunnuntai;2;0;2
95;19.06.2016;2016;06;07;Sunnuntai;1;2;3
95;19.06.2016;2016;06;08;Sunnuntai;7;3;10
95;19.06.2016;2016;06;09;Sunnuntai;8;9;17
95;19.06.2016;2016;06;10;Sunnuntai;11;10;21
95;19.06.2016;2016;06;11;Sunnuntai;22;12;34
95;19.06.2016;2016;06;12;Sunnuntai;26;20;46
95;19.06.2016;2016;06;13;Sunnuntai;18;19;37
95;19.06.2016;2016;06;14;Sunnuntai;15;12;27
95;19.06.2016;2016;06;15;Sunnuntai;6;12;18
95;19.06.2016;2016;06;16;Sunnuntai;6;8;14
95;19.06.2016;2016;06;17;Sunnuntai;4;7;11
95;19.06.2016;2016;06;18;Sunnuntai;6;2;8
95;19.06.2016;2016;06;19;Sunnuntai;9;3;12
95;19.06.2016;2016;06;20;Sunnuntai;5;3;8
95;19.06.2016;2016;06;21;Sunnuntai;4;3;7
95;19.06.2016;2016;06;22;Sunnuntai;0;4;4
95;19.06.2016;2016;06;23;Sunnuntai;3;2;5
95;20.06.2016;2016;06;00;Maanantai;0;1;1
95;20.06.2016;2016;06;01;Maanantai;0;1;1
95;20.06.2016;2016;06;02;Maanantai;0;1;1
95;20.06.2016;2016;06;03;Maanantai;3;0;3
95;20.06.2016;2016;06;04;Maanantai;1;2;3
95;20.06.2016;2016;06;05;Maanantai;7;1;8
95;20.06.2016;2016;06;06;Maanantai;31;15;46
95;20.06.2016;2016;06;07;Maanantai;29;19;48
95;20.06.2016;2016;06;08;Maanantai;16;12;28
95;20.06.2016;2016;06;09;Maanantai;10;9;19
95;20.06.2016;2016;06;10;Maanantai;15;12;27
95;20.06.2016;2016;06;11;Maanantai;12;8;20
95;20.06.2016;2016;06;12;Maanantai;17;17;34
95;20.06.2016;2016;06;13;Maanantai;10;14;24
95;20.06.2016;2016;06;14;Maanantai;18;23;41
95;20.06.2016;2016;06;15;Maanantai;23;29;52
95;20.06.2016;2016;06;16;Maanantai;21;43;64
95;20.06.2016;2016;06;17;Maanantai;13;33;46
95;20.06.2016;2016;06;18;Maanantai;9;10;19
95;20.06.2016;2016;06;19;Maanantai;13;19;32
95;20.06.2016;2016;06;20;Maanantai;16;12;28
95;20.06.2016;2016;06;21;Maanantai;18;9;27
95;20.06.2016;2016;06;22;Maanantai;5;13;18
95;20.06.2016;2016;06;23;Maanantai;1;1;2
95;21.06.2016;2016;06;00;Tiistai;1;0;1
95;21.06.2016;2016;06;01;Tiistai;3;0;3
95;21.06.2016;2016;06;02;Tiistai;0;0;0
95;21.06.2016;2016;06;03;Tiistai;0;0;0
95;21.06.2016;2016;06;04;Tiistai;3;0;3
95;21.06.2016;2016;06;05;Tiistai;7;3;10
95;21.06.2016;2016;06;06;Tiistai;33;12;45
95;21.06.2016;2016;06;07;Tiistai;33;12;45
95;21.06.2016;2016;06;08;Tiistai;9;19;28
95;21.06.2016;2016;06;09;Tiistai;16;18;34
95;21.06.2016;2016;06;10;Tiistai;15;21;36
95;21.06.2016;2016;06;11;Tiistai;24;12;36
95;21.06.2016;2016;06;12;Tiistai;23;17;40
95;21.06.2016;2016;06;13;Tiistai;20;20;40
95;21.06.2016;2016;06;14;Tiistai;14;22;36
95;21.06.2016;2016;06;15;Tiistai;29;48;77
95;21.06.2016;2016;06;16;Tiistai;37;48;85
95;21.06.2016;2016;06;17;Tiistai;23;29;52
95;21.06.2016;2016;06;18;Tiistai;14;26;40
95;21.06.2016;2016;06;19;Tiistai;22;29;51
95;21.06.2016;2016;06;20;Tiistai;15;13;28
95;21.06.2016;2016;06;21;Tiistai;7;18;25
95;21.06.2016;2016;06;22;Tiistai;5;7;12
95;21.06.2016;2016;06;23;Tiistai;3;1;4
95;22.06.2016;2016;06;00;Keskiviikko;0;2;2
95;22.06.2016;2016;06;01;Keskiviikko;0;1;1
95;22.06.2016;2016;06;02;Keskiviikko;3;0;3
95;22.06.2016;2016;06;03;Keskiviikko;0;0;0
95;22.06.2016;2016;06;04;Keskiviikko;3;0;3
95;22.06.2016;2016;06;05;Keskiviikko;6;3;9
95;22.06.2016;2016;06;06;Keskiviikko;26;9;35
95;22.06.2016;2016;06;07;Keskiviikko;24;8;32
95;22.06.2016;2016;06;08;Keskiviikko;17;12;29
95;22.06.2016;2016;06;09;Keskiviikko;13;20;33
95;22.06.2016;2016;06;10;Keskiviikko;22;13;35
95;22.06.2016;2016;06;11;Keskiviikko;16;13;29
95;22.06.2016;2016;06;12;Keskiviikko;15;20;35
95;22.06.2016;2016;06;13;Keskiviikko;9;16;25
95;22.06.2016;2016;06;14;Keskiviikko;23;21;44
95;22.06.2016;2016;06;15;Keskiviikko;16;29;45
95;22.06.2016;2016;06;16;Keskiviikko;21;33;54
95;22.06.2016;2016;06;17;Keskiviikko;23;31;54
95;22.06.2016;2016;06;18;Keskiviikko;15;20;35
95;22.06.2016;2016;06;19;Keskiviikko;22;22;44
95;22.06.2016;2016;06;20;Keskiviikko;13;14;27
95;22.06.2016;2016;06;21;Keskiviikko;14;11;25
95;22.06.2016;2016;06;22;Keskiviikko;3;10;13
95;22.06.2016;2016;06;23;Keskiviikko;2;3;5
95;23.06.2016;2016;06;00;Torstai;0;0;0
95;23.06.2016;2016;06;01;Torstai;0;1;1
95;23.06.2016;2016;06;02;Torstai;0;0;0
95;23.06.2016;2016;06;03;Torstai;1;0;1
95;23.06.2016;2016;06;04;Torstai;0;1;1
95;23.06.2016;2016;06;05;Torstai;7;3;10
95;23.06.2016;2016;06;06;Torstai;15;5;20
95;23.06.2016;2016;06;07;Torstai;26;11;37
95;23.06.2016;2016;06;08;Torstai;12;13;25
95;23.06.2016;2016;06;09;Torstai;6;4;10
95;23.06.2016;2016;06;10;Torstai;17;15;32
95;23.06.2016;2016;06;11;Torstai;21;18;39
95;23.06.2016;2016;06;12;Torstai;23;16;39
95;23.06.2016;2016;06;13;Torstai;21;29;50
95;23.06.2016;2016;06;14;Torstai;23;31;54
95;23.06.2016;2016;06;15;Torstai;20;29;49
95;23.06.2016;2016;06;16;Torstai;16;33;49
95;23.06.2016;2016;06;17;Torstai;12;22;34
95;23.06.2016;2016;06;18;Torstai;15;16;31
95;23.06.2016;2016;06;19;Torstai;16;13;29
95;23.06.2016;2016;06;20;Torstai;12;13;25
95;23.06.2016;2016;06;21;Torstai;2;8;10
95;23.06.2016;2016;06;22;Torstai;4;4;8
95;23.06.2016;2016;06;23;Torstai;7;1;8
95;24.06.2016;2016;06;00;Perjantai;4;3;7
95;24.06.2016;2016;06;01;Perjantai;0;3;3
95;24.06.2016;2016;06;02;Perjantai;0;1;1
95;24.06.2016;2016;06;03;Perjantai;0;1;1
95;24.06.2016;2016;06;04;Perjantai;0;0;0
95;24.06.2016;2016;06;05;Perjantai;0;0;0
95;24.06.2016;2016;06;06;Perjantai;5;2;7
95;24.06.2016;2016;06;07;Perjantai;6;5;11
95;24.06.2016;2016;06;08;Perjantai;6;7;13
95;24.06.2016;2016;06;09;Perjantai;9;8;17
95;24.06.2016;2016;06;10;Perjantai;15;17;32
95;24.06.2016;2016;06;11;Perjantai;7;12;19
95;24.06.2016;2016;06;12;Perjantai;10;18;28
95;24.06.2016;2016;06;13;Perjantai;13;24;37
95;24.06.2016;2016;06;14;Perjantai;12;17;29
95;24.06.2016;2016;06;15;Perjantai;14;16;30
95;24.06.2016;2016;06;16;Perjantai;8;15;23
95;24.06.2016;2016;06;17;Perjantai;8;11;19
95;24.06.2016;2016;06;18;Perjantai;7;12;19
95;24.06.2016;2016;06;19;Perjantai;4;4;8
95;24.06.2016;2016;06;20;Perjantai;5;4;9
95;24.06.2016;2016;06;21;Perjantai;5;6;11
95;24.06.2016;2016;06;22;Perjantai;5;3;8
95;24.06.2016;2016;06;23;Perjantai;6;2;8
95;25.06.2016;2016;06;00;Lauantai;0;2;2
95;25.06.2016;2016;06;01;Lauantai;4;6;10
95;25.06.2016;2016;06;02;Lauantai;4;1;5
95;25.06.2016;2016;06;03;Lauantai;4;1;5
95;25.06.2016;2016;06;04;Lauantai;0;1;1
95;25.06.2016;2016;06;05;Lauantai;1;3;4
95;25.06.2016;2016;06;06;Lauantai;0;2;2
95;25.06.2016;2016;06;07;Lauantai;2;0;2
95;25.06.2016;2016;06;08;Lauantai;4;7;11
95;25.06.2016;2016;06;09;Lauantai;17;5;22
95;25.06.2016;2016;06;10;Lauantai;17;13;30
95;25.06.2016;2016;06;11;Lauantai;6;12;18
95;25.06.2016;2016;06;12;Lauantai;3;2;5
95;25.06.2016;2016;06;13;Lauantai;0;2;2
95;25.06.2016;2016;06;14;Lauantai;1;0;1
95;25.06.2016;2016;06;15;Lauantai;2;2;4
95;25.06.2016;2016;06;16;Lauantai;5;2;7
95;25.06.2016;2016;06;17;Lauantai;14;8;22
95;25.06.2016;2016;06;18;Lauantai;6;6;12
95;25.06.2016;2016;06;19;Lauantai;9;7;16
95;25.06.2016;2016;06;20;Lauantai;13;17;30
95;25.06.2016;2016;06;21;Lauantai;2;1;3
95;25.06.2016;2016;06;22;Lauantai;1;6;7
95;25.06.2016;2016;06;23;Lauantai;0;0;0
95;26.06.2016;2016;06;00;Sunnuntai;2;0;2
95;26.06.2016;2016;06;01;Sunnuntai;0;0;0
95;26.06.2016;2016;06;02;Sunnuntai;1;0;1
95;26.06.2016;2016;06;03;Sunnuntai;0;1;1
95;26.06.2016;2016;06;04;Sunnuntai;0;0;0
95;26.06.2016;2016;06;05;Sunnuntai;1;0;1
95;26.06.2016;2016;06;06;Sunnuntai;3;1;4
95;26.06.2016;2016;06;07;Sunnuntai;5;1;6
95;26.06.2016;2016;06;08;Sunnuntai;8;8;16
95;26.06.2016;2016;06;09;Sunnuntai;15;13;28
95;26.06.2016;2016;06;10;Sunnuntai;18;12;30
95;26.06.2016;2016;06;11;Sunnuntai;18;11;29
95;26.06.2016;2016;06;12;Sunnuntai;26;26;52
95;26.06.2016;2016;06;13;Sunnuntai;28;19;47
95;26.06.2016;2016;06;14;Sunnuntai;33;31;64
95;26.06.2016;2016;06;15;Sunnuntai;23;22;45
95;26.06.2016;2016;06;16;Sunnuntai;23;35;58
95;26.06.2016;2016;06;17;Sunnuntai;27;20;47
95;26.06.2016;2016;06;18;Sunnuntai;31;17;48
95;26.06.2016;2016;06;19;Sunnuntai;27;28;55
95;26.06.2016;2016;06;20;Sunnuntai;4;16;20
95;26.06.2016;2016;06;21;Sunnuntai;9;8;17
95;26.06.2016;2016;06;22;Sunnuntai;3;8;11
95;26.06.2016;2016;06;23;Sunnuntai;1;2;3
95;27.06.2016;2016;06;00;Maanantai;2;2;4
95;27.06.2016;2016;06;01;Maanantai;0;0;0
95;27.06.2016;2016;06;02;Maanantai;0;0;0
95;27.06.2016;2016;06;03;Maanantai;0;1;1
95;27.06.2016;2016;06;04;Maanantai;2;0;2
95;27.06.2016;2016;06;05;Maanantai;9;4;13
95;27.06.2016;2016;06;06;Maanantai;26;17;43
95;27.06.2016;2016;06;07;Maanantai;26;13;39
95;27.06.2016;2016;06;08;Maanantai;17;19;36
95;27.06.2016;2016;06;09;Maanantai;5;9;14
95;27.06.2016;2016;06;10;Maanantai;23;16;39
95;27.06.2016;2016;06;11;Maanantai;17;16;33
95;27.06.2016;2016;06;12;Maanantai;21;18;39
95;27.06.2016;2016;06;13;Maanantai;18;21;39
95;27.06.2016;2016;06;14;Maanantai;22;14;36
95;27.06.2016;2016;06;15;Maanantai;30;38;68
95;27.06.2016;2016;06;16;Maanantai;22;48;70
95;27.06.2016;2016;06;17;Maanantai;16;29;45
95;27.06.2016;2016;06;18;Maanantai;14;21;35
95;27.06.2016;2016;06;19;Maanantai;17;9;26
95;27.06.2016;2016;06;20;Maanantai;14;5;19
95;27.06.2016;2016;06;21;Maanantai;7;9;16
95;27.06.2016;2016;06;22;Maanantai;4;3;7
95;27.06.2016;2016;06;23;Maanantai;1;1;2
95;28.06.2016;2016;06;00;Tiistai;1;0;1
95;28.06.2016;2016;06;01;Tiistai;1;0;1
95;28.06.2016;2016;06;02;Tiistai;0;0;0
95;28.06.2016;2016;06;03;Tiistai;0;0;0
95;28.06.2016;2016;06;04;Tiistai;0;0;0
95;28.06.2016;2016;06;05;Tiistai;6;3;9
95;28.06.2016;2016;06;06;Tiistai;5;13;18
95;28.06.2016;2016;06;07;Tiistai;8;8;16
95;28.06.2016;2016;06;08;Tiistai;4;2;6
95;28.06.2016;2016;06;09;Tiistai;1;3;4
95;28.06.2016;2016;06;10;Tiistai;4;5;9
95;28.06.2016;2016;06;11;Tiistai;6;2;8
95;28.06.2016;2016;06;12;Tiistai;8;5;13
95;28.06.2016;2016;06;13;Tiistai;4;8;12
95;28.06.2016;2016;06;14;Tiistai;12;10;22
95;28.06.2016;2016;06;15;Tiistai;21;20;41
95;28.06.2016;2016;06;16;Tiistai;21;25;46
95;28.06.2016;2016;06;17;Tiistai;17;25;42
95;28.06.2016;2016;06;18;Tiistai;13;27;40
95;28.06.2016;2016;06;19;Tiistai;17;20;37
95;28.06.2016;2016;06;20;Tiistai;23;11;34
95;28.06.2016;2016;06;21;Tiistai;17;14;31
95;28.06.2016;2016;06;22;Tiistai;4;7;11
95;28.06.2016;2016;06;23;Tiistai;1;0;1
95;29.06.2016;2016;06;00;Keskiviikko;0;1;1
95;29.06.2016;2016;06;01;Keskiviikko;1;0;1
95;29.06.2016;2016;06;02;Keskiviikko;0;0;0
95;29.06.2016;2016;06;03;Keskiviikko;0;1;1
95;29.06.2016;2016;06;04;Keskiviikko;2;0;2
95;29.06.2016;2016;06;05;Keskiviikko;10;5;15
95;29.06.2016;2016;06;06;Keskiviikko;28;16;44
95;29.06.2016;2016;06;07;Keskiviikko;26;15;41
95;29.06.2016;2016;06;08;Keskiviikko;12;14;26
95;29.06.2016;2016;06;09;Keskiviikko;9;15;24
95;29.06.2016;2016;06;10;Keskiviikko;17;17;34
95;29.06.2016;2016;06;11;Keskiviikko;21;10;31
95;29.06.2016;2016;06;12;Keskiviikko;19;12;31
95;29.06.2016;2016;06;13;Keskiviikko;23;19;42
95;29.06.2016;2016;06;14;Keskiviikko;16;20;36
95;29.06.2016;2016;06;15;Keskiviikko;38;34;72
95;29.06.2016;2016;06;16;Keskiviikko;9;26;35
95;29.06.2016;2016;06;17;Keskiviikko;13;17;30
95;29.06.2016;2016;06;18;Keskiviikko;8;8;16
95;29.06.2016;2016;06;19;Keskiviikko;26;18;44
95;29.06.2016;2016;06;20;Keskiviikko;18;18;36
95;29.06.2016;2016;06;21;Keskiviikko;14;15;29
95;29.06.2016;2016;06;22;Keskiviikko;10;4;14
95;29.06.2016;2016;06;23;Keskiviikko;0;3;3
95;30.06.2016;2016;06;00;Torstai;1;1;2
95;30.06.2016;2016;06;01;Torstai;0;1;1
95;30.06.2016;2016;06;02;Torstai;0;0;0
95;30.06.2016;2016;06;03;Torstai;0;0;0
95;30.06.2016;2016;06;04;Torstai;1;0;1
95;30.06.2016;2016;06;05;Torstai;6;5;11
95;30.06.2016;2016;06;06;Torstai;21;10;31
95;30.06.2016;2016;06;07;Torstai;18;11;29
95;30.06.2016;2016;06;08;Torstai;15;15;30
95;30.06.2016;2016;06;09;Torstai;15;14;29
95;30.06.2016;2016;06;10;Torstai;13;22;35
95;30.06.2016;2016;06;11;Torstai;35;14;49
95;30.06.2016;2016;06;12;Torstai;21;14;35
95;30.06.2016;2016;06;13;Torstai;15;20;35
95;30.06.2016;2016;06;14;Torstai;21;30;51
95;30.06.2016;2016;06;15;Torstai;16;27;43
95;30.06.2016;2016;06;16;Torstai;8;19;27
95;30.06.2016;2016;06;17;Torstai;5;15;20
95;30.06.2016;2016;06;18;Torstai;11;12;23
95;30.06.2016;2016;06;19;Torstai;13;10;23
95;30.06.2016;2016;06;20;Torstai;18;19;37
95;30.06.2016;2016;06;21;Torstai;8;9;17
95;30.06.2016;2016;06;22;Torstai;6;2;8
95;30.06.2016;2016;06;23;Torstai;0;1;1
95;01.07.2016;2016;07;00;Perjantai;1;3;4
95;01.07.2016;2016;07;01;Perjantai;0;0;0
95;01.07.2016;2016;07;02;Perjantai;0;0;0
95;01.07.2016;2016;07;03;Perjantai;0;0;0
95;01.07.2016;2016;07;04;Perjantai;2;0;2
95;01.07.2016;2016;07;05;Perjantai;7;4;11
95;01.07.2016;2016;07;06;Perjantai;25;8;33
95;01.07.2016;2016;07;07;Perjantai;12;9;21
95;01.07.2016;2016;07;08;Perjantai;10;9;19
95;01.07.2016;2016;07;09;Perjantai;11;7;18
95;01.07.2016;2016;07;10;Perjantai;8;5;13
95;01.07.2016;2016;07;11;Perjantai;9;5;14
95;01.07.2016;2016;07;12;Perjantai;6;13;19
95;01.07.2016;2016;07;13;Perjantai;6;3;9
95;01.07.2016;2016;07;14;Perjantai;8;16;24
95;01.07.2016;2016;07;15;Perjantai;10;19;29
95;01.07.2016;2016;07;16;Perjantai;7;12;19
95;01.07.2016;2016;07;17;Perjantai;11;10;21
95;01.07.2016;2016;07;18;Perjantai;8;10;18
95;01.07.2016;2016;07;19;Perjantai;12;10;22
95;01.07.2016;2016;07;20;Perjantai;11;7;18
95;01.07.2016;2016;07;21;Perjantai;6;4;10
95;01.07.2016;2016;07;22;Perjantai;3;5;8
95;01.07.2016;2016;07;23;Perjantai;1;3;4
95;02.07.2016;2016;07;00;Lauantai;0;1;1
95;02.07.2016;2016;07;01;Lauantai;0;3;3
95;02.07.2016;2016;07;02;Lauantai;1;1;2
95;02.07.2016;2016;07;03;Lauantai;0;1;1
95;02.07.2016;2016;07;04;Lauantai;3;1;4
95;02.07.2016;2016;07;05;Lauantai;1;1;2
95;02.07.2016;2016;07;06;Lauantai;5;1;6
95;02.07.2016;2016;07;07;Lauantai;4;2;6
95;02.07.2016;2016;07;08;Lauantai;10;7;17
95;02.07.2016;2016;07;09;Lauantai;19;13;32
95;02.07.2016;2016;07;10;Lauantai;20;23;43
95;02.07.2016;2016;07;11;Lauantai;19;12;31
95;02.07.2016;2016;07;12;Lauantai;25;19;44
95;02.07.2016;2016;07;13;Lauantai;30;15;45
95;02.07.2016;2016;07;14;Lauantai;24;16;40
95;02.07.2016;2016;07;15;Lauantai;23;17;40
95;02.07.2016;2016;07;16;Lauantai;12;17;29
95;02.07.2016;2016;07;17;Lauantai;11;9;20
95;02.07.2016;2016;07;18;Lauantai;13;12;25
95;02.07.2016;2016;07;19;Lauantai;9;16;25
95;02.07.2016;2016;07;20;Lauantai;8;3;11
95;02.07.2016;2016;07;21;Lauantai;9;16;25
95;02.07.2016;2016;07;22;Lauantai;9;9;18
95;02.07.2016;2016;07;23;Lauantai;3;0;3
95;03.07.2016;2016;07;00;Sunnuntai;0;8;8
95;03.07.2016;2016;07;01;Sunnuntai;4;3;7
95;03.07.2016;2016;07;02;Sunnuntai;4;2;6
95;03.07.2016;2016;07;03;Sunnuntai;1;5;6
95;03.07.2016;2016;07;04;Sunnuntai;1;1;2
95;03.07.2016;2016;07;05;Sunnuntai;1;1;2
95;03.07.2016;2016;07;06;Sunnuntai;2;4;6
95;03.07.2016;2016;07;07;Sunnuntai;11;5;16
95;03.07.2016;2016;07;08;Sunnuntai;6;2;8
95;03.07.2016;2016;07;09;Sunnuntai;1;4;5
95;03.07.2016;2016;07;10;Sunnuntai;1;0;1
95;03.07.2016;2016;07;11;Sunnuntai;4;3;7
95;03.07.2016;2016;07;12;Sunnuntai;6;4;10
95;03.07.2016;2016;07;13;Sunnuntai;2;5;7
95;03.07.2016;2016;07;14;Sunnuntai;2;3;5
95;03.07.2016;2016;07;15;Sunnuntai;4;10;14
95;03.07.2016;2016;07;16;Sunnuntai;14;11;25
95;03.07.2016;2016;07;17;Sunnuntai;7;15;22
95;03.07.2016;2016;07;18;Sunnuntai;16;18;34
95;03.07.2016;2016;07;19;Sunnuntai;23;23;46
95;03.07.2016;2016;07;20;Sunnuntai;23;15;38
95;03.07.2016;2016;07;21;Sunnuntai;5;9;14
95;03.07.2016;2016;07;22;Sunnuntai;2;5;7
95;03.07.2016;2016;07;23;Sunnuntai;2;1;3
95;04.07.2016;2016;07;00;Maanantai;0;1;1
95;04.07.2016;2016;07;01;Maanantai;1;3;4
95;04.07.2016;2016;07;02;Maanantai;0;0;0
95;04.07.2016;2016;07;03;Maanantai;0;0;0
95;04.07.2016;2016;07;04;Maanantai;1;0;1
95;04.07.2016;2016;07;05;Maanantai;4;1;5
95;04.07.2016;2016;07;06;Maanantai;10;10;20
95;04.07.2016;2016;07;07;Maanantai;8;9;17
95;04.07.2016;2016;07;08;Maanantai;10;11;21
95;04.07.2016;2016;07;09;Maanantai;6;5;11
95;04.07.2016;2016;07;10;Maanantai;7;8;15
95;04.07.2016;2016;07;11;Maanantai;4;7;11
95;04.07.2016;2016;07;12;Maanantai;5;3;8
95;04.07.2016;2016;07;13;Maanantai;1;4;5
95;04.07.2016;2016;07;14;Maanantai;4;10;14
95;04.07.2016;2016;07;15;Maanantai;13;17;30
95;04.07.2016;2016;07;16;Maanantai;12;11;23
95;04.07.2016;2016;07;17;Maanantai;7;8;15
95;04.07.2016;2016;07;18;Maanantai;12;15;27
95;04.07.2016;2016;07;19;Maanantai;6;13;19
95;04.07.2016;2016;07;20;Maanantai;3;2;5
95;04.07.2016;2016;07;21;Maanantai;2;6;8
95;04.07.2016;2016;07;22;Maanantai;1;1;2
95;04.07.2016;2016;07;23;Maanantai;0;0;0
95;05.07.2016;2016;07;00;Tiistai;0;0;0
95;05.07.2016;2016;07;01;Tiistai;1;0;1
95;05.07.2016;2016;07;02;Tiistai;0;0;0
95;05.07.2016;2016;07;03;Tiistai;0;0;0
95;05.07.2016;2016;07;04;Tiistai;0;1;1
95;05.07.2016;2016;07;05;Tiistai;5;1;6
95;05.07.2016;2016;07;06;Tiistai;7;7;14
95;05.07.2016;2016;07;07;Tiistai;9;9;18
95;05.07.2016;2016;07;08;Tiistai;4;3;7
95;05.07.2016;2016;07;09;Tiistai;3;0;3
95;05.07.2016;2016;07;10;Tiistai;1;5;6
95;05.07.2016;2016;07;11;Tiistai;10;8;18
95;05.07.2016;2016;07;12;Tiistai;11;8;19
95;05.07.2016;2016;07;13;Tiistai;17;18;35
95;05.07.2016;2016;07;14;Tiistai;13;13;26
95;05.07.2016;2016;07;15;Tiistai;10;11;21
95;05.07.2016;2016;07;16;Tiistai;11;10;21
95;05.07.2016;2016;07;17;Tiistai;0;2;2
95;05.07.2016;2016;07;18;Tiistai;3;7;10
95;05.07.2016;2016;07;19;Tiistai;4;10;14
95;05.07.2016;2016;07;20;Tiistai;7;3;10
95;05.07.2016;2016;07;21;Tiistai;2;6;8
95;05.07.2016;2016;07;22;Tiistai;1;2;3
95;05.07.2016;2016;07;23;Tiistai;2;0;2
95;06.07.2016;2016;07;00;Keskiviikko;0;1;1
95;06.07.2016;2016;07;01;Keskiviikko;0;0;0
95;06.07.2016;2016;07;02;Keskiviikko;2;0;2
95;06.07.2016;2016;07;03;Keskiviikko;1;0;1
95;06.07.2016;2016;07;04;Keskiviikko;0;0;0
95;06.07.2016;2016;07;05;Keskiviikko;7;2;9
95;06.07.2016;2016;07;06;Keskiviikko;5;5;10
95;06.07.2016;2016;07;07;Keskiviikko;4;5;9
95;06.07.2016;2016;07;08;Keskiviikko;3;2;5
95;06.07.2016;2016;07;09;Keskiviikko;1;2;3
95;06.07.2016;2016;07;10;Keskiviikko;12;3;15
95;06.07.2016;2016;07;11;Keskiviikko;18;7;25
95;06.07.2016;2016;07;12;Keskiviikko;16;14;30
95;06.07.2016;2016;07;13;Keskiviikko;16;13;29
95;06.07.2016;2016;07;14;Keskiviikko;18;22;40
95;06.07.2016;2016;07;15;Keskiviikko;12;27;39
95;06.07.2016;2016;07;16;Keskiviikko;9;21;30
95;06.07.2016;2016;07;17;Keskiviikko;14;10;24
95;06.07.2016;2016;07;18;Keskiviikko;6;4;10
95;06.07.2016;2016;07;19;Keskiviikko;4;4;8
95;06.07.2016;2016;07;20;Keskiviikko;6;9;15
95;06.07.2016;2016;07;21;Keskiviikko;12;5;17
95;06.07.2016;2016;07;22;Keskiviikko;2;7;9
95;06.07.2016;2016;07;23;Keskiviikko;1;0;1
95;07.07.2016;2016;07;00;Torstai;0;0;0
95;07.07.2016;2016;07;01;Torstai;0;1;1
95;07.07.2016;2016;07;02;Torstai;1;0;1
95;07.07.2016;2016;07;03;Torstai;0;0;0
95;07.07.2016;2016;07;04;Torstai;1;0;1
95;07.07.2016;2016;07;05;Torstai;7;0;7
95;07.07.2016;2016;07;06;Torstai;13;6;19
95;07.07.2016;2016;07;07;Torstai;17;10;27
95;07.07.2016;2016;07;08;Torstai;6;10;16
95;07.07.2016;2016;07;09;Torstai;7;8;15
95;07.07.2016;2016;07;10;Torstai;4;7;11
95;07.07.2016;2016;07;11;Torstai;3;3;6
95;07.07.2016;2016;07;12;Torstai;0;1;1
95;07.07.2016;2016;07;13;Torstai;1;4;5
95;07.07.2016;2016;07;14;Torstai;2;13;15
95;07.07.2016;2016;07;15;Torstai;12;13;25
95;07.07.2016;2016;07;16;Torstai;14;17;31
95;07.07.2016;2016;07;17;Torstai;6;9;15
95;07.07.2016;2016;07;18;Torstai;14;7;21
95;07.07.2016;2016;07;19;Torstai;7;13;20
95;07.07.2016;2016;07;20;Torstai;5;4;9
95;07.07.2016;2016;07;21;Torstai;9;11;20
95;07.07.2016;2016;07;22;Torstai;4;2;6
95;07.07.2016;2016;07;23;Torstai;1;0;1
95;08.07.2016;2016;07;00;Perjantai;0;1;1
95;08.07.2016;2016;07;01;Perjantai;0;2;2
95;08.07.2016;2016;07;02;Perjantai;0;0;0
95;08.07.2016;2016;07;03;Perjantai;1;1;2
95;08.07.2016;2016;07;04;Perjantai;1;1;2
95;08.07.2016;2016;07;05;Perjantai;7;1;8
95;08.07.2016;2016;07;06;Perjantai;6;12;18
95;08.07.2016;2016;07;07;Perjantai;21;9;30
95;08.07.2016;2016;07;08;Perjantai;8;9;17
95;08.07.2016;2016;07;09;Perjantai;14;9;23
95;08.07.2016;2016;07;10;Perjantai;4;7;11
95;08.07.2016;2016;07;11;Perjantai;13;20;33
95;08.07.2016;2016;07;12;Perjantai;29;19;48
95;08.07.2016;2016;07;13;Perjantai;18;12;30
95;08.07.2016;2016;07;14;Perjantai;18;23;41
95;08.07.2016;2016;07;15;Perjantai;18;26;44
95;08.07.2016;2016;07;16;Perjantai;15;25;40
95;08.07.2016;2016;07;17;Perjantai;23;21;44
95;08.07.2016;2016;07;18;Perjantai;18;23;41
95;08.07.2016;2016;07;19;Perjantai;11;13;24
95;08.07.2016;2016;07;20;Perjantai;8;12;20
95;08.07.2016;2016;07;21;Perjantai;7;11;18
95;08.07.2016;2016;07;22;Perjantai;1;3;4
95;08.07.2016;2016;07;23;Perjantai;1;4;5
95;09.07.2016;2016;07;00;Lauantai;0;4;4
95;09.07.2016;2016;07;01;Lauantai;1;3;4
95;09.07.2016;2016;07;02;Lauantai;2;3;5
95;09.07.2016;2016;07;03;Lauantai;2;0;2
95;09.07.2016;2016;07;04;Lauantai;1;1;2
95;09.07.2016;2016;07;05;Lauantai;0;2;2
95;09.07.2016;2016;07;06;Lauantai;2;0;2
95;09.07.2016;2016;07;07;Lauantai;5;3;8
95;09.07.2016;2016;07;08;Lauantai;8;1;9
95;09.07.2016;2016;07;09;Lauantai;10;6;16
95;09.07.2016;2016;07;10;Lauantai;11;16;27
95;09.07.2016;2016;07;11;Lauantai;10;4;14
95;09.07.2016;2016;07;12;Lauantai;13;16;29
95;09.07.2016;2016;07;13;Lauantai;16;8;24
95;09.07.2016;2016;07;14;Lauantai;10;12;22
95;09.07.2016;2016;07;15;Lauantai;5;17;22
95;09.07.2016;2016;07;16;Lauantai;13;15;28
95;09.07.2016;2016;07;17;Lauantai;5;19;24
95;09.07.2016;2016;07;18;Lauantai;15;13;28
95;09.07.2016;2016;07;19;Lauantai;11;15;26
95;09.07.2016;2016;07;20;Lauantai;12;4;16
95;09.07.2016;2016;07;21;Lauantai;4;9;13
95;09.07.2016;2016;07;22;Lauantai;4;1;5
95;09.07.2016;2016;07;23;Lauantai;0;1;1
95;10.07.2016;2016;07;00;Sunnuntai;2;2;4
95;10.07.2016;2016;07;01;Sunnuntai;0;0;0
95;10.07.2016;2016;07;02;Sunnuntai;0;5;5
95;10.07.2016;2016;07;03;Sunnuntai;1;1;2
95;10.07.2016;2016;07;04;Sunnuntai;0;0;0
95;10.07.2016;2016;07;05;Sunnuntai;0;1;1
95;10.07.2016;2016;07;06;Sunnuntai;2;3;5
95;10.07.2016;2016;07;07;Sunnuntai;5;2;7
95;10.07.2016;2016;07;08;Sunnuntai;10;9;19
95;10.07.2016;2016;07;09;Sunnuntai;16;12;28
95;10.07.2016;2016;07;10;Sunnuntai;15;14;29
95;10.07.2016;2016;07;11;Sunnuntai;25;14;39
95;10.07.2016;2016;07;12;Sunnuntai;30;28;58
95;10.07.2016;2016;07;13;Sunnuntai;16;22;38
95;10.07.2016;2016;07;14;Sunnuntai;36;23;59
95;10.07.2016;2016;07;15;Sunnuntai;20;20;40
95;10.07.2016;2016;07;16;Sunnuntai;24;15;39
95;10.07.2016;2016;07;17;Sunnuntai;15;19;34
95;10.07.2016;2016;07;18;Sunnuntai;14;14;28
95;10.07.2016;2016;07;19;Sunnuntai;28;17;45
95;10.07.2016;2016;07;20;Sunnuntai;11;27;38
95;10.07.2016;2016;07;21;Sunnuntai;8;9;17
95;10.07.2016;2016;07;22;Sunnuntai;9;0;9
95;10.07.2016;2016;07;23;Sunnuntai;0;6;6
95;11.07.2016;2016;07;00;Maanantai;1;5;6
95;11.07.2016;2016;07;01;Maanantai;2;1;3
95;11.07.2016;2016;07;02;Maanantai;1;0;1
95;11.07.2016;2016;07;03;Maanantai;0;0;0
95;11.07.2016;2016;07;04;Maanantai;2;0;2
95;11.07.2016;2016;07;05;Maanantai;9;2;11
95;11.07.2016;2016;07;06;Maanantai;20;13;33
95;11.07.2016;2016;07;07;Maanantai;19;15;34
95;11.07.2016;2016;07;08;Maanantai;9;12;21
95;11.07.2016;2016;07;09;Maanantai;18;14;32
95;11.07.2016;2016;07;10;Maanantai;26;21;47
95;11.07.2016;2016;07;11;Maanantai;29;6;35
95;11.07.2016;2016;07;12;Maanantai;23;16;39
95;11.07.2016;2016;07;13;Maanantai;16;36;52
95;11.07.2016;2016;07;14;Maanantai;33;18;51
95;11.07.2016;2016;07;15;Maanantai;47;36;83
95;11.07.2016;2016;07;16;Maanantai;31;36;67
95;11.07.2016;2016;07;17;Maanantai;25;28;53
95;11.07.2016;2016;07;18;Maanantai;41;25;66
95;11.07.2016;2016;07;19;Maanantai;25;28;53
95;11.07.2016;2016;07;20;Maanantai;17;24;41
95;11.07.2016;2016;07;21;Maanantai;13;22;35
95;11.07.2016;2016;07;22;Maanantai;13;10;23
95;11.07.2016;2016;07;23;Maanantai;2;8;10
95;12.07.2016;2016;07;00;Tiistai;0;2;2
95;12.07.2016;2016;07;01;Tiistai;0;0;0
95;12.07.2016;2016;07;02;Tiistai;0;0;0
95;12.07.2016;2016;07;03;Tiistai;0;0;0
95;12.07.2016;2016;07;04;Tiistai;4;0;4
95;12.07.2016;2016;07;05;Tiistai;8;3;11
95;12.07.2016;2016;07;06;Tiistai;13;16;29
95;12.07.2016;2016;07;07;Tiistai;18;18;36
95;12.07.2016;2016;07;08;Tiistai;19;18;37
95;12.07.2016;2016;07;09;Tiistai;30;16;46
95;12.07.2016;2016;07;10;Tiistai;23;18;41
95;12.07.2016;2016;07;11;Tiistai;33;28;61
95;12.07.2016;2016;07;12;Tiistai;20;22;42
95;12.07.2016;2016;07;13;Tiistai;31;18;49
95;12.07.2016;2016;07;14;Tiistai;34;30;64
95;12.07.2016;2016;07;15;Tiistai;25;30;55
95;12.07.2016;2016;07;16;Tiistai;20;41;61
95;12.07.2016;2016;07;17;Tiistai;20;43;63
95;12.07.2016;2016;07;18;Tiistai;19;21;40
95;12.07.2016;2016;07;19;Tiistai;13;19;32
95;12.07.2016;2016;07;20;Tiistai;28;22;50
95;12.07.2016;2016;07;21;Tiistai;21;17;38
95;12.07.2016;2016;07;22;Tiistai;8;13;21
95;12.07.2016;2016;07;23;Tiistai;3;4;7
95;13.07.2016;2016;07;00;Keskiviikko;0;3;3
95;13.07.2016;2016;07;01;Keskiviikko;0;0;0
95;13.07.2016;2016;07;02;Keskiviikko;0;1;1
95;13.07.2016;2016;07;03;Keskiviikko;0;1;1
95;13.07.2016;2016;07;04;Keskiviikko;1;0;1
95;13.07.2016;2016;07;05;Keskiviikko;7;2;9
95;13.07.2016;2016;07;06;Keskiviikko;17;14;31
95;13.07.2016;2016;07;07;Keskiviikko;16;12;28
95;13.07.2016;2016;07;08;Keskiviikko;9;10;19
95;13.07.2016;2016;07;09;Keskiviikko;10;8;18
95;13.07.2016;2016;07;10;Keskiviikko;25;15;40
95;13.07.2016;2016;07;11;Keskiviikko;19;22;41
95;13.07.2016;2016;07;12;Keskiviikko;29;13;42
95;13.07.2016;2016;07;13;Keskiviikko;24;30;54
95;13.07.2016;2016;07;14;Keskiviikko;23;34;57
95;13.07.2016;2016;07;15;Keskiviikko;34;36;70
95;13.07.2016;2016;07;16;Keskiviikko;44;38;82
95;13.07.2016;2016;07;17;Keskiviikko;28;38;66
95;13.07.2016;2016;07;18;Keskiviikko;29;28;57
95;13.07.2016;2016;07;19;Keskiviikko;25;24;49
95;13.07.2016;2016;07;20;Keskiviikko;29;27;56
95;13.07.2016;2016;07;21;Keskiviikko;15;11;26
95;13.07.2016;2016;07;22;Keskiviikko;4;16;20
95;13.07.2016;2016;07;23;Keskiviikko;7;10;17
95;14.07.2016;2016;07;00;Torstai;0;0;0
95;14.07.2016;2016;07;01;Torstai;0;1;1
95;14.07.2016;2016;07;02;Torstai;0;3;3
95;14.07.2016;2016;07;03;Torstai;1;1;2
95;14.07.2016;2016;07;04;Torstai;1;0;1
95;14.07.2016;2016;07;05;Torstai;10;3;13
95;14.07.2016;2016;07;06;Torstai;19;15;34
95;14.07.2016;2016;07;07;Torstai;19;10;29
95;14.07.2016;2016;07;08;Torstai;15;13;28
95;14.07.2016;2016;07;09;Torstai;12;19;31
95;14.07.2016;2016;07;10;Torstai;31;23;54
95;14.07.2016;2016;07;11;Torstai;23;21;44
95;14.07.2016;2016;07;12;Torstai;26;14;40
95;14.07.2016;2016;07;13;Torstai;26;24;50
95;14.07.2016;2016;07;14;Torstai;19;26;45
95;14.07.2016;2016;07;15;Torstai;31;32;63
95;14.07.2016;2016;07;16;Torstai;26;41;67
95;14.07.2016;2016;07;17;Torstai;24;22;46
95;14.07.2016;2016;07;18;Torstai;9;24;33
95;14.07.2016;2016;07;19;Torstai;33;34;67
95;14.07.2016;2016;07;20;Torstai;28;10;38
95;14.07.2016;2016;07;21;Torstai;9;11;20
95;14.07.2016;2016;07;22;Torstai;2;22;24
95;14.07.2016;2016;07;23;Torstai;0;4;4
95;15.07.2016;2016;07;00;Perjantai;0;5;5
95;15.07.2016;2016;07;01;Perjantai;0;4;4
95;15.07.2016;2016;07;02;Perjantai;0;0;0
95;15.07.2016;2016;07;03;Perjantai;0;1;1
95;15.07.2016;2016;07;04;Perjantai;0;0;0
95;15.07.2016;2016;07;05;Perjantai;6;2;8
95;15.07.2016;2016;07;06;Perjantai;9;12;21
95;15.07.2016;2016;07;07;Perjantai;16;9;25
95;15.07.2016;2016;07;08;Perjantai;6;4;10
95;15.07.2016;2016;07;09;Perjantai;10;5;15
95;15.07.2016;2016;07;10;Perjantai;11;4;15
95;15.07.2016;2016;07;11;Perjantai;17;8;25
95;15.07.2016;2016;07;12;Perjantai;13;12;25
95;15.07.2016;2016;07;13;Perjantai;16;23;39
95;15.07.2016;2016;07;14;Perjantai;7;21;28
95;15.07.2016;2016;07;15;Perjantai;15;12;27
95;15.07.2016;2016;07;16;Perjantai;16;15;31
95;15.07.2016;2016;07;17;Perjantai;13;16;29
95;15.07.2016;2016;07;18;Perjantai;8;19;27
95;15.07.2016;2016;07;19;Perjantai;13;11;24
95;15.07.2016;2016;07;20;Perjantai;7;6;13
95;15.07.2016;2016;07;21;Perjantai;9;11;20
95;15.07.2016;2016;07;22;Perjantai;2;3;5
95;15.07.2016;2016;07;23;Perjantai;1;2;3
95;16.07.2016;2016;07;00;Lauantai;0;10;10
95;16.07.2016;2016;07;01;Lauantai;0;1;1
95;16.07.2016;2016;07;02;Lauantai;0;3;3
95;16.07.2016;2016;07;03;Lauantai;0;0;0
95;16.07.2016;2016;07;04;Lauantai;0;2;2
95;16.07.2016;2016;07;05;Lauantai;0;0;0
95;16.07.2016;2016;07;06;Lauantai;2;0;2
95;16.07.2016;2016;07;07;Lauantai;1;0;1
95;16.07.2016;2016;07;08;Lauantai;2;1;3
95;16.07.2016;2016;07;09;Lauantai;3;1;4
95;16.07.2016;2016;07;10;Lauantai;7;3;10
95;16.07.2016;2016;07;11;Lauantai;2;6;8
95;16.07.2016;2016;07;12;Lauantai;2;7;9
95;16.07.2016;2016;07;13;Lauantai;5;2;7
95;16.07.2016;2016;07;14;Lauantai;7;2;9
95;16.07.2016;2016;07;15;Lauantai;1;3;4
95;16.07.2016;2016;07;16;Lauantai;2;7;9
95;16.07.2016;2016;07;17;Lauantai;13;11;24
95;16.07.2016;2016;07;18;Lauantai;11;8;19
95;16.07.2016;2016;07;19;Lauantai;11;13;24
95;16.07.2016;2016;07;20;Lauantai;13;10;23
95;16.07.2016;2016;07;21;Lauantai;17;6;23
95;16.07.2016;2016;07;22;Lauantai;2;2;4
95;16.07.2016;2016;07;23;Lauantai;4;1;5
95;17.07.2016;2016;07;00;Sunnuntai;1;0;1
95;17.07.2016;2016;07;01;Sunnuntai;3;1;4
95;17.07.2016;2016;07;02;Sunnuntai;0;4;4
95;17.07.2016;2016;07;03;Sunnuntai;0;7;7
95;17.07.2016;2016;07;04;Sunnuntai;0;3;3
95;17.07.2016;2016;07;05;Sunnuntai;1;0;1
95;17.07.2016;2016;07;06;Sunnuntai;1;0;1
95;17.07.2016;2016;07;07;Sunnuntai;4;6;10
95;17.07.2016;2016;07;08;Sunnuntai;4;8;12
95;17.07.2016;2016;07;09;Sunnuntai;6;6;12
95;17.07.2016;2016;07;10;Sunnuntai;9;6;15
95;17.07.2016;2016;07;11;Sunnuntai;12;14;26
95;17.07.2016;2016;07;12;Sunnuntai;10;12;22
95;17.07.2016;2016;07;13;Sunnuntai;10;11;21
95;17.07.2016;2016;07;14;Sunnuntai;10;8;18
95;17.07.2016;2016;07;15;Sunnuntai;9;6;15
95;17.07.2016;2016;07;16;Sunnuntai;2;1;3
95;17.07.2016;2016;07;17;Sunnuntai;5;10;15
95;17.07.2016;2016;07;18;Sunnuntai;12;18;30
95;17.07.2016;2016;07;19;Sunnuntai;12;18;30
95;17.07.2016;2016;07;20;Sunnuntai;12;16;28
95;17.07.2016;2016;07;21;Sunnuntai;9;16;25
95;17.07.2016;2016;07;22;Sunnuntai;5;4;9
95;17.07.2016;2016;07;23;Sunnuntai;2;0;2
95;18.07.2016;2016;07;00;Maanantai;0;5;5
95;18.07.2016;2016;07;01;Maanantai;0;0;0
95;18.07.2016;2016;07;02;Maanantai;0;0;0
95;18.07.2016;2016;07;03;Maanantai;0;0;0
95;18.07.2016;2016;07;04;Maanantai;1;0;1
95;18.07.2016;2016;07;05;Maanantai;5;1;6
95;18.07.2016;2016;07;06;Maanantai;10;17;27
95;18.07.2016;2016;07;07;Maanantai;15;10;25
95;18.07.2016;2016;07;08;Maanantai;17;12;29
95;18.07.2016;2016;07;09;Maanantai;12;8;20
95;18.07.2016;2016;07;10;Maanantai;10;21;31
95;18.07.2016;2016;07;11;Maanantai;20;15;35
95;18.07.2016;2016;07;12;Maanantai;26;16;42
95;18.07.2016;2016;07;13;Maanantai;17;19;36
95;18.07.2016;2016;07;14;Maanantai;26;25;51
95;18.07.2016;2016;07;15;Maanantai;35;26;61
95;18.07.2016;2016;07;16;Maanantai;27;33;60
95;18.07.2016;2016;07;17;Maanantai;32;29;61
95;18.07.2016;2016;07;18;Maanantai;28;38;66
95;18.07.2016;2016;07;19;Maanantai;25;19;44
95;18.07.2016;2016;07;20;Maanantai;33;29;62
95;18.07.2016;2016;07;21;Maanantai;10;23;33
95;18.07.2016;2016;07;22;Maanantai;7;8;15
95;18.07.2016;2016;07;23;Maanantai;3;4;7
95;19.07.2016;2016;07;00;Tiistai;0;0;0
95;19.07.2016;2016;07;01;Tiistai;0;0;0
95;19.07.2016;2016;07;02;Tiistai;0;0;0
95;19.07.2016;2016;07;03;Tiistai;0;0;0
95;19.07.2016;2016;07;04;Tiistai;1;0;1
95;19.07.2016;2016;07;05;Tiistai;5;1;6
95;19.07.2016;2016;07;06;Tiistai;15;18;33
95;19.07.2016;2016;07;07;Tiistai;22;8;30
95;19.07.2016;2016;07;08;Tiistai;14;10;24
95;19.07.2016;2016;07;09;Tiistai;14;12;26
95;19.07.2016;2016;07;10;Tiistai;7;14;21
95;19.07.2016;2016;07;11;Tiistai;15;16;31
95;19.07.2016;2016;07;12;Tiistai;21;18;39
95;19.07.2016;2016;07;13;Tiistai;28;18;46
95;19.07.2016;2016;07;14;Tiistai;10;24;34
95;19.07.2016;2016;07;15;Tiistai;44;25;69
95;19.07.2016;2016;07;16;Tiistai;23;29;52
95;19.07.2016;2016;07;17;Tiistai;16;26;42
95;19.07.2016;2016;07;18;Tiistai;21;18;39
95;19.07.2016;2016;07;19;Tiistai;27;34;61
95;19.07.2016;2016;07;20;Tiistai;25;22;47
95;19.07.2016;2016;07;21;Tiistai;13;9;22
95;19.07.2016;2016;07;22;Tiistai;6;5;11
95;19.07.2016;2016;07;23;Tiistai;1;3;4
95;20.07.2016;2016;07;00;Keskiviikko;0;1;1
95;20.07.2016;2016;07;01;Keskiviikko;0;0;0
95;20.07.2016;2016;07;02;Keskiviikko;0;0;0
95;20.07.2016;2016;07;03;Keskiviikko;2;0;2
95;20.07.2016;2016;07;04;Keskiviikko;3;2;5
95;20.07.2016;2016;07;05;Keskiviikko;5;1;6
95;20.07.2016;2016;07;06;Keskiviikko;16;14;30
95;20.07.2016;2016;07;07;Keskiviikko;23;13;36
95;20.07.2016;2016;07;08;Keskiviikko;10;14;24
95;20.07.2016;2016;07;09;Keskiviikko;11;15;26
95;20.07.2016;2016;07;10;Keskiviikko;31;27;58
95;20.07.2016;2016;07;11;Keskiviikko;28;24;52
95;20.07.2016;2016;07;12;Keskiviikko;37;19;56
95;20.07.2016;2016;07;13;Keskiviikko;21;35;56
95;20.07.2016;2016;07;14;Keskiviikko;20;25;45
95;20.07.2016;2016;07;15;Keskiviikko;30;37;67
95;20.07.2016;2016;07;16;Keskiviikko;31;46;77
95;20.07.2016;2016;07;17;Keskiviikko;15;37;52
95;20.07.2016;2016;07;18;Keskiviikko;20;24;44
95;20.07.2016;2016;07;19;Keskiviikko;18;25;43
95;20.07.2016;2016;07;20;Keskiviikko;16;18;34
95;20.07.2016;2016;07;21;Keskiviikko;9;17;26
95;20.07.2016;2016;07;22;Keskiviikko;10;16;26
95;20.07.2016;2016;07;23;Keskiviikko;3;8;11
95;21.07.2016;2016;07;00;Torstai;1;7;8
95;21.07.2016;2016;07;01;Torstai;2;2;4
95;21.07.2016;2016;07;02;Torstai;0;0;0
95;21.07.2016;2016;07;03;Torstai;0;0;0
95;21.07.2016;2016;07;04;Torstai;2;0;2
95;21.07.2016;2016;07;05;Torstai;7;3;10
95;21.07.2016;2016;07;06;Torstai;16;15;31
95;21.07.2016;2016;07;07;Torstai;18;7;25
95;21.07.2016;2016;07;08;Torstai;17;12;29
95;21.07.2016;2016;07;09;Torstai;14;17;31
95;21.07.2016;2016;07;10;Torstai;13;26;39
95;21.07.2016;2016;07;11;Torstai;24;17;41
95;21.07.2016;2016;07;12;Torstai;21;13;34
95;21.07.2016;2016;07;13;Torstai;35;23;58
95;21.07.2016;2016;07;14;Torstai;25;29;54
95;21.07.2016;2016;07;15;Torstai;41;23;64
95;21.07.2016;2016;07;16;Torstai;33;39;72
95;21.07.2016;2016;07;17;Torstai;31;37;68
95;21.07.2016;2016;07;18;Torstai;21;27;48
95;21.07.2016;2016;07;19;Torstai;25;30;55
95;21.07.2016;2016;07;20;Torstai;19;27;46
95;21.07.2016;2016;07;21;Torstai;17;18;35
95;21.07.2016;2016;07;22;Torstai;4;17;21
95;21.07.2016;2016;07;23;Torstai;1;8;9
95;22.07.2016;2016;07;00;Perjantai;0;3;3
95;22.07.2016;2016;07;01;Perjantai;2;3;5
95;22.07.2016;2016;07;02;Perjantai;0;2;2
95;22.07.2016;2016;07;03;Perjantai;0;1;1
95;22.07.2016;2016;07;04;Perjantai;3;0;3
95;22.07.2016;2016;07;05;Perjantai;5;1;6
95;22.07.2016;2016;07;06;Perjantai;15;11;26
95;22.07.2016;2016;07;07;Perjantai;15;12;27
95;22.07.2016;2016;07;08;Perjantai;18;13;31
95;22.07.2016;2016;07;09;Perjantai;10;11;21
95;22.07.2016;2016;07;10;Perjantai;19;12;31
95;22.07.2016;2016;07;11;Perjantai;13;12;25
95;22.07.2016;2016;07;12;Perjantai;27;13;40
95;22.07.2016;2016;07;13;Perjantai;30;24;54
95;22.07.2016;2016;07;14;Perjantai;26;33;59
95;22.07.2016;2016;07;15;Perjantai;36;24;60
95;22.07.2016;2016;07;16;Perjantai;15;25;40
95;22.07.2016;2016;07;17;Perjantai;28;21;49
95;22.07.2016;2016;07;18;Perjantai;22;21;43
95;22.07.2016;2016;07;19;Perjantai;8;26;34
95;22.07.2016;2016;07;20;Perjantai;11;19;30
95;22.07.2016;2016;07;21;Perjantai;12;15;27
95;22.07.2016;2016;07;22;Perjantai;8;9;17
95;22.07.2016;2016;07;23;Perjantai;5;8;13
95;23.07.2016;2016;07;00;Lauantai;3;5;8
95;23.07.2016;2016;07;01;Lauantai;0;0;0
95;23.07.2016;2016;07;02;Lauantai;0;0;0
95;23.07.2016;2016;07;03;Lauantai;2;6;8
95;23.07.2016;2016;07;04;Lauantai;0;3;3
95;23.07.2016;2016;07;05;Lauantai;2;3;5
95;23.07.2016;2016;07;06;Lauantai;2;6;8
95;23.07.2016;2016;07;07;Lauantai;5;1;6
95;23.07.2016;2016;07;08;Lauantai;5;4;9
95;23.07.2016;2016;07;09;Lauantai;14;14;28
95;23.07.2016;2016;07;10;Lauantai;25;24;49
95;23.07.2016;2016;07;11;Lauantai;22;18;40
95;23.07.2016;2016;07;12;Lauantai;39;20;59
95;23.07.2016;2016;07;13;Lauantai;29;22;51
95;23.07.2016;2016;07;14;Lauantai;19;20;39
95;23.07.2016;2016;07;15;Lauantai;29;17;46
95;23.07.2016;2016;07;16;Lauantai;16;18;34
95;23.07.2016;2016;07;17;Lauantai;20;17;37
95;23.07.2016;2016;07;18;Lauantai;27;22;49
95;23.07.2016;2016;07;19;Lauantai;16;23;39
95;23.07.2016;2016;07;20;Lauantai;21;21;42
95;23.07.2016;2016;07;21;Lauantai;13;23;36
95;23.07.2016;2016;07;22;Lauantai;6;21;27
95;23.07.2016;2016;07;23;Lauantai;5;10;15
95;24.07.2016;2016;07;00;Sunnuntai;1;6;7
95;24.07.2016;2016;07;01;Sunnuntai;0;0;0
95;24.07.2016;2016;07;02;Sunnuntai;0;2;2
95;24.07.2016;2016;07;03;Sunnuntai;1;1;2
95;24.07.2016;2016;07;04;Sunnuntai;3;0;3
95;24.07.2016;2016;07;05;Sunnuntai;0;0;0
95;24.07.2016;2016;07;06;Sunnuntai;4;2;6
95;24.07.2016;2016;07;07;Sunnuntai;4;4;8
95;24.07.2016;2016;07;08;Sunnuntai;7;5;12
95;24.07.2016;2016;07;09;Sunnuntai;19;19;38
95;24.07.2016;2016;07;10;Sunnuntai;30;35;65
95;24.07.2016;2016;07;11;Sunnuntai;49;18;67
95;24.07.2016;2016;07;12;Sunnuntai;43;33;76
95;24.07.2016;2016;07;13;Sunnuntai;28;42;70
95;24.07.2016;2016;07;14;Sunnuntai;37;24;61
95;24.07.2016;2016;07;15;Sunnuntai;33;21;54
95;24.07.2016;2016;07;16;Sunnuntai;14;25;39
95;24.07.2016;2016;07;17;Sunnuntai;14;27;41
95;24.07.2016;2016;07;18;Sunnuntai;17;34;51
95;24.07.2016;2016;07;19;Sunnuntai;28;27;55
95;24.07.2016;2016;07;20;Sunnuntai;18;23;41
95;24.07.2016;2016;07;21;Sunnuntai;8;10;18
95;24.07.2016;2016;07;22;Sunnuntai;7;14;21
95;24.07.2016;2016;07;23;Sunnuntai;1;2;3
95;25.07.2016;2016;07;00;Maanantai;1;0;1
95;25.07.2016;2016;07;01;Maanantai;2;0;2
95;25.07.2016;2016;07;02;Maanantai;1;2;3
95;25.07.2016;2016;07;03;Maanantai;2;1;3
95;25.07.2016;2016;07;04;Maanantai;1;1;2
95;25.07.2016;2016;07;05;Maanantai;8;1;9
95;25.07.2016;2016;07;06;Maanantai;29;15;44
95;25.07.2016;2016;07;07;Maanantai;20;12;32
95;25.07.2016;2016;07;08;Maanantai;19;17;36
95;25.07.2016;2016;07;09;Maanantai;18;10;28
95;25.07.2016;2016;07;10;Maanantai;30;17;47
95;25.07.2016;2016;07;11;Maanantai;20;20;40
95;25.07.2016;2016;07;12;Maanantai;26;13;39
95;25.07.2016;2016;07;13;Maanantai;17;28;45
95;25.07.2016;2016;07;14;Maanantai;39;37;76
95;25.07.2016;2016;07;15;Maanantai;43;38;81
95;25.07.2016;2016;07;16;Maanantai;39;57;96
95;25.07.2016;2016;07;17;Maanantai;43;31;74
95;25.07.2016;2016;07;18;Maanantai;27;21;48
95;25.07.2016;2016;07;19;Maanantai;19;52;71
95;25.07.2016;2016;07;20;Maanantai;27;37;64
95;25.07.2016;2016;07;21;Maanantai;18;26;44
95;25.07.2016;2016;07;22;Maanantai;6;11;17
95;25.07.2016;2016;07;23;Maanantai;7;5;12
95;26.07.2016;2016;07;00;Tiistai;0;3;3
95;26.07.2016;2016;07;01;Tiistai;1;1;2
95;26.07.2016;2016;07;02;Tiistai;0;0;0
95;26.07.2016;2016;07;03;Tiistai;0;0;0
95;26.07.2016;2016;07;04;Tiistai;2;1;3
95;26.07.2016;2016;07;05;Tiistai;5;0;5
95;26.07.2016;2016;07;06;Tiistai;24;17;41
95;26.07.2016;2016;07;07;Tiistai;31;19;50
95;26.07.2016;2016;07;08;Tiistai;24;16;40
95;26.07.2016;2016;07;09;Tiistai;17;12;29
95;26.07.2016;2016;07;10;Tiistai;28;19;47
95;26.07.2016;2016;07;11;Tiistai;25;34;59
95;26.07.2016;2016;07;12;Tiistai;38;32;70
95;26.07.2016;2016;07;13;Tiistai;31;26;57
95;26.07.2016;2016;07;14;Tiistai;24;37;61
95;26.07.2016;2016;07;15;Tiistai;40;30;70
95;26.07.2016;2016;07;16;Tiistai;47;58;105
95;26.07.2016;2016;07;17;Tiistai;39;36;75
95;26.07.2016;2016;07;18;Tiistai;36;32;68
95;26.07.2016;2016;07;19;Tiistai;32;28;60
95;26.07.2016;2016;07;20;Tiistai;23;44;67
95;26.07.2016;2016;07;21;Tiistai;9;13;22
95;26.07.2016;2016;07;22;Tiistai;12;10;22
95;26.07.2016;2016;07;23;Tiistai;3;4;7
95;27.07.2016;2016;07;00;Keskiviikko;0;4;4
95;27.07.2016;2016;07;01;Keskiviikko;1;0;1
95;27.07.2016;2016;07;02;Keskiviikko;0;1;1
95;27.07.2016;2016;07;03;Keskiviikko;0;0;0
95;27.07.2016;2016;07;04;Keskiviikko;2;0;2
95;27.07.2016;2016;07;05;Keskiviikko;7;1;8
95;27.07.2016;2016;07;06;Keskiviikko;21;10;31
95;27.07.2016;2016;07;07;Keskiviikko;19;8;27
95;27.07.2016;2016;07;08;Keskiviikko;6;12;18
95;27.07.2016;2016;07;09;Keskiviikko;3;2;5
95;27.07.2016;2016;07;10;Keskiviikko;2;2;4
95;27.07.2016;2016;07;11;Keskiviikko;10;10;20
95;27.07.2016;2016;07;12;Keskiviikko;18;5;23
95;27.07.2016;2016;07;13;Keskiviikko;17;11;28
95;27.07.2016;2016;07;14;Keskiviikko;19;12;31
95;27.07.2016;2016;07;15;Keskiviikko;30;23;53
95;27.07.2016;2016;07;16;Keskiviikko;33;37;70
95;27.07.2016;2016;07;17;Keskiviikko;21;38;59
95;27.07.2016;2016;07;18;Keskiviikko;23;40;63
95;27.07.2016;2016;07;19;Keskiviikko;31;15;46
95;27.07.2016;2016;07;20;Keskiviikko;10;18;28
95;27.07.2016;2016;07;21;Keskiviikko;7;17;24
95;27.07.2016;2016;07;22;Keskiviikko;8;10;18
95;27.07.2016;2016;07;23;Keskiviikko;3;1;4
95;28.07.2016;2016;07;00;Torstai;1;1;2
95;28.07.2016;2016;07;01;Torstai;0;2;2
95;28.07.2016;2016;07;02;Torstai;1;0;1
95;28.07.2016;2016;07;03;Torstai;2;1;3
95;28.07.2016;2016;07;04;Torstai;2;0;2
95;28.07.2016;2016;07;05;Torstai;6;1;7
95;28.07.2016;2016;07;06;Torstai;25;13;38
95;28.07.2016;2016;07;07;Torstai;22;15;37
95;28.07.2016;2016;07;08;Torstai;10;19;29
95;28.07.2016;2016;07;09;Torstai;21;12;33
95;28.07.2016;2016;07;10;Torstai;9;22;31
95;28.07.2016;2016;07;11;Torstai;15;16;31
95;28.07.2016;2016;07;12;Torstai;28;15;43
95;28.07.2016;2016;07;13;Torstai;11;26;37
95;28.07.2016;2016;07;14;Torstai;37;28;65
95;28.07.2016;2016;07;15;Torstai;51;30;81
95;28.07.2016;2016;07;16;Torstai;33;43;76
95;28.07.2016;2016;07;17;Torstai;20;36;56
95;28.07.2016;2016;07;18;Torstai;24;23;47
95;28.07.2016;2016;07;19;Torstai;16;21;37
95;28.07.2016;2016;07;20;Torstai;15;10;25
95;28.07.2016;2016;07;21;Torstai;5;10;15
95;28.07.2016;2016;07;22;Torstai;6;7;13
95;28.07.2016;2016;07;23;Torstai;0;3;3
95;29.07.2016;2016;07;00;Perjantai;1;2;3
95;29.07.2016;2016;07;01;Perjantai;0;0;0
95;29.07.2016;2016;07;02;Perjantai;0;3;3
95;29.07.2016;2016;07;03;Perjantai;0;0;0
95;29.07.2016;2016;07;04;Perjantai;2;0;2
95;29.07.2016;2016;07;05;Perjantai;7;2;9
95;29.07.2016;2016;07;06;Perjantai;22;6;28
95;29.07.2016;2016;07;07;Perjantai;13;4;17
95;29.07.2016;2016;07;08;Perjantai;9;8;17
95;29.07.2016;2016;07;09;Perjantai;8;7;15
95;29.07.2016;2016;07;10;Perjantai;27;15;42
95;29.07.2016;2016;07;11;Perjantai;11;13;24
95;29.07.2016;2016;07;12;Perjantai;21;16;37
95;29.07.2016;2016;07;13;Perjantai;22;23;45
95;29.07.2016;2016;07;14;Perjantai;34;23;57
95;29.07.2016;2016;07;15;Perjantai;27;19;46
95;29.07.2016;2016;07;16;Perjantai;13;33;46
95;29.07.2016;2016;07;17;Perjantai;10;18;28
95;29.07.2016;2016;07;18;Perjantai;26;18;44
95;29.07.2016;2016;07;19;Perjantai;17;20;37
95;29.07.2016;2016;07;20;Perjantai;21;10;31
95;29.07.2016;2016;07;21;Perjantai;7;8;15
95;29.07.2016;2016;07;22;Perjantai;4;6;10
95;29.07.2016;2016;07;23;Perjantai;2;4;6
95;30.07.2016;2016;07;00;Lauantai;1;3;4
95;30.07.2016;2016;07;01;Lauantai;1;9;10
95;30.07.2016;2016;07;02;Lauantai;0;9;9
95;30.07.2016;2016;07;03;Lauantai;1;4;5
95;30.07.2016;2016;07;04;Lauantai;1;3;4
95;30.07.2016;2016;07;05;Lauantai;0;4;4
95;30.07.2016;2016;07;06;Lauantai;5;1;6
95;30.07.2016;2016;07;07;Lauantai;5;5;10
95;30.07.2016;2016;07;08;Lauantai;8;4;12
95;30.07.2016;2016;07;09;Lauantai;15;9;24
95;30.07.2016;2016;07;10;Lauantai;15;17;32
95;30.07.2016;2016;07;11;Lauantai;20;16;36
95;30.07.2016;2016;07;12;Lauantai;21;32;53
95;30.07.2016;2016;07;13;Lauantai;25;17;42
95;30.07.2016;2016;07;14;Lauantai;18;14;32
95;30.07.2016;2016;07;15;Lauantai;0;12;12
95;30.07.2016;2016;07;16;Lauantai;6;13;19
95;30.07.2016;2016;07;17;Lauantai;20;5;25
95;30.07.2016;2016;07;18;Lauantai;23;26;49
95;30.07.2016;2016;07;19;Lauantai;19;27;46
95;30.07.2016;2016;07;20;Lauantai;13;14;27
95;30.07.2016;2016;07;21;Lauantai;10;18;28
95;30.07.2016;2016;07;22;Lauantai;7;7;14
95;30.07.2016;2016;07;23;Lauantai;2;3;5
95;31.07.2016;2016;07;00;Sunnuntai;0;6;6
95;31.07.2016;2016;07;01;Sunnuntai;0;6;6
95;31.07.2016;2016;07;02;Sunnuntai;0;6;6
95;31.07.2016;2016;07;03;Sunnuntai;0;7;7
95;31.07.2016;2016;07;04;Sunnuntai;0;0;0
95;31.07.2016;2016;07;05;Sunnuntai;0;0;0
95;31.07.2016;2016;07;06;Sunnuntai;2;4;6
95;31.07.2016;2016;07;07;Sunnuntai;3;1;4
95;31.07.2016;2016;07;08;Sunnuntai;9;5;14
95;31.07.2016;2016;07;09;Sunnuntai;15;4;19
95;31.07.2016;2016;07;10;Sunnuntai;11;12;23
95;31.07.2016;2016;07;11;Sunnuntai;11;9;20
95;31.07.2016;2016;07;12;Sunnuntai;3;5;8
95;31.07.2016;2016;07;13;Sunnuntai;8;6;14
95;31.07.2016;2016;07;14;Sunnuntai;12;11;23
95;31.07.2016;2016;07;15;Sunnuntai;9;15;24
95;31.07.2016;2016;07;16;Sunnuntai;10;17;27
95;31.07.2016;2016;07;17;Sunnuntai;12;9;21
95;31.07.2016;2016;07;18;Sunnuntai;3;2;5
95;31.07.2016;2016;07;19;Sunnuntai;5;3;8
95;31.07.2016;2016;07;20;Sunnuntai;10;8;18
95;31.07.2016;2016;07;21;Sunnuntai;5;4;9
95;31.07.2016;2016;07;22;Sunnuntai;2;6;8
95;31.07.2016;2016;07;23;Sunnuntai;2;2;4
95;01.08.2016;2016;08;00;Maanantai;0;1;1
95;01.08.2016;2016;08;01;Maanantai;0;0;0
95;01.08.2016;2016;08;02;Maanantai;0;0;0
95;01.08.2016;2016;08;03;Maanantai;0;0;0
95;01.08.2016;2016;08;04;Maanantai;1;0;1
95;01.08.2016;2016;08;05;Maanantai;5;3;8
95;01.08.2016;2016;08;06;Maanantai;33;16;49
95;01.08.2016;2016;08;07;Maanantai;30;18;48
95;01.08.2016;2016;08;08;Maanantai;16;16;32
95;01.08.2016;2016;08;09;Maanantai;13;10;23
95;01.08.2016;2016;08;10;Maanantai;16;15;31
95;01.08.2016;2016;08;11;Maanantai;12;15;27
95;01.08.2016;2016;08;12;Maanantai;28;19;47
95;01.08.2016;2016;08;13;Maanantai;12;22;34
95;01.08.2016;2016;08;14;Maanantai;27;18;45
95;01.08.2016;2016;08;15;Maanantai;30;35;65
95;01.08.2016;2016;08;16;Maanantai;31;48;79
95;01.08.2016;2016;08;17;Maanantai;32;44;76
95;01.08.2016;2016;08;18;Maanantai;19;33;52
95;01.08.2016;2016;08;19;Maanantai;30;26;56
95;01.08.2016;2016;08;20;Maanantai;26;24;50
95;01.08.2016;2016;08;21;Maanantai;19;20;39
95;01.08.2016;2016;08;22;Maanantai;3;11;14
95;01.08.2016;2016;08;23;Maanantai;1;1;2
95;02.08.2016;2016;08;00;Tiistai;1;2;3
95;02.08.2016;2016;08;01;Tiistai;2;2;4
95;02.08.2016;2016;08;02;Tiistai;0;0;0
95;02.08.2016;2016;08;03;Tiistai;0;0;0
95;02.08.2016;2016;08;04;Tiistai;2;0;2
95;02.08.2016;2016;08;05;Tiistai;6;3;9
95;02.08.2016;2016;08;06;Tiistai;29;12;41
95;02.08.2016;2016;08;07;Tiistai;35;13;48
95;02.08.2016;2016;08;08;Tiistai;4;12;16
95;02.08.2016;2016;08;09;Tiistai;4;2;6
95;02.08.2016;2016;08;10;Tiistai;8;8;16
95;02.08.2016;2016;08;11;Tiistai;17;6;23
95;02.08.2016;2016;08;12;Tiistai;12;7;19
95;02.08.2016;2016;08;13;Tiistai;13;11;24
95;02.08.2016;2016;08;14;Tiistai;7;11;18
95;02.08.2016;2016;08;15;Tiistai;8;18;26
95;02.08.2016;2016;08;16;Tiistai;12;24;36
95;02.08.2016;2016;08;17;Tiistai;11;16;27
95;02.08.2016;2016;08;18;Tiistai;20;23;43
95;02.08.2016;2016;08;19;Tiistai;28;13;41
95;02.08.2016;2016;08;20;Tiistai;15;17;32
95;02.08.2016;2016;08;21;Tiistai;10;11;21
95;02.08.2016;2016;08;22;Tiistai;5;9;14
95;02.08.2016;2016;08;23;Tiistai;1;0;1
95;03.08.2016;2016;08;00;Keskiviikko;1;2;3
95;03.08.2016;2016;08;01;Keskiviikko;1;0;1
95;03.08.2016;2016;08;02;Keskiviikko;0;0;0
95;03.08.2016;2016;08;03;Keskiviikko;0;0;0
95;03.08.2016;2016;08;04;Keskiviikko;1;0;1
95;03.08.2016;2016;08;05;Keskiviikko;5;2;7
95;03.08.2016;2016;08;06;Keskiviikko;22;8;30
95;03.08.2016;2016;08;07;Keskiviikko;20;13;33
95;03.08.2016;2016;08;08;Keskiviikko;12;11;23
95;03.08.2016;2016;08;09;Keskiviikko;6;16;22
95;03.08.2016;2016;08;10;Keskiviikko;16;10;26
95;03.08.2016;2016;08;11;Keskiviikko;16;8;24
95;03.08.2016;2016;08;12;Keskiviikko;16;9;25
95;03.08.2016;2016;08;13;Keskiviikko;7;18;25
95;03.08.2016;2016;08;14;Keskiviikko;9;6;15
95;03.08.2016;2016;08;15;Keskiviikko;17;11;28
95;03.08.2016;2016;08;16;Keskiviikko;17;20;37
95;03.08.2016;2016;08;17;Keskiviikko;8;20;28
95;03.08.2016;2016;08;18;Keskiviikko;19;17;36
95;03.08.2016;2016;08;19;Keskiviikko;20;28;48
95;03.08.2016;2016;08;20;Keskiviikko;14;24;38
95;03.08.2016;2016;08;21;Keskiviikko;10;10;20
95;03.08.2016;2016;08;22;Keskiviikko;3;11;14
95;03.08.2016;2016;08;23;Keskiviikko;1;2;3
95;04.08.2016;2016;08;00;Torstai;2;0;2
95;04.08.2016;2016;08;01;Torstai;0;0;0
95;04.08.2016;2016;08;02;Torstai;0;0;0
95;04.08.2016;2016;08;03;Torstai;0;0;0
95;04.08.2016;2016;08;04;Torstai;1;0;1
95;04.08.2016;2016;08;05;Torstai;4;4;8
95;04.08.2016;2016;08;06;Torstai;25;9;34
95;04.08.2016;2016;08;07;Torstai;20;8;28
95;04.08.2016;2016;08;08;Torstai;16;14;30
95;04.08.2016;2016;08;09;Torstai;13;11;24
95;04.08.2016;2016;08;10;Torstai;20;17;37
95;04.08.2016;2016;08;11;Torstai;17;14;31
95;04.08.2016;2016;08;12;Torstai;15;22;37
95;04.08.2016;2016;08;13;Torstai;29;14;43
95;04.08.2016;2016;08;14;Torstai;21;15;36
95;04.08.2016;2016;08;15;Torstai;30;29;59
95;04.08.2016;2016;08;16;Torstai;21;43;64
95;04.08.2016;2016;08;17;Torstai;16;22;38
95;04.08.2016;2016;08;18;Torstai;11;14;25
95;04.08.2016;2016;08;19;Torstai;12;11;23
95;04.08.2016;2016;08;20;Torstai;2;8;10
95;04.08.2016;2016;08;21;Torstai;2;7;9
95;04.08.2016;2016;08;22;Torstai;2;5;7
95;04.08.2016;2016;08;23;Torstai;2;4;6
95;05.08.2016;2016;08;00;Perjantai;0;1;1
95;05.08.2016;2016;08;01;Perjantai;0;0;0
95;05.08.2016;2016;08;02;Perjantai;0;0;0
95;05.08.2016;2016;08;03;Perjantai;0;0;0
95;05.08.2016;2016;08;04;Perjantai;0;0;0
95;05.08.2016;2016;08;05;Perjantai;2;4;6
95;05.08.2016;2016;08;06;Perjantai;18;9;27
95;05.08.2016;2016;08;07;Perjantai;16;10;26
95;05.08.2016;2016;08;08;Perjantai;4;2;6
95;05.08.2016;2016;08;09;Perjantai;4;10;14
95;05.08.2016;2016;08;10;Perjantai;10;8;18
95;05.08.2016;2016;08;11;Perjantai;4;2;6
95;05.08.2016;2016;08;12;Perjantai;11;11;22
95;05.08.2016;2016;08;13;Perjantai;10;6;16
95;05.08.2016;2016;08;14;Perjantai;13;27;40
95;05.08.2016;2016;08;15;Perjantai;22;30;52
95;05.08.2016;2016;08;16;Perjantai;15;28;43
95;05.08.2016;2016;08;17;Perjantai;14;15;29
95;05.08.2016;2016;08;18;Perjantai;13;19;32
95;05.08.2016;2016;08;19;Perjantai;19;19;38
95;05.08.2016;2016;08;20;Perjantai;10;14;24
95;05.08.2016;2016;08;21;Perjantai;10;9;19
95;05.08.2016;2016;08;22;Perjantai;7;3;10
95;05.08.2016;2016;08;23;Perjantai;5;12;17
95;06.08.2016;2016;08;00;Lauantai;2;3;5
95;06.08.2016;2016;08;01;Lauantai;1;4;5
95;06.08.2016;2016;08;02;Lauantai;0;0;0
95;06.08.2016;2016;08;03;Lauantai;0;1;1
95;06.08.2016;2016;08;04;Lauantai;0;1;1
95;06.08.2016;2016;08;05;Lauantai;2;2;4
95;06.08.2016;2016;08;06;Lauantai;2;3;5
95;06.08.2016;2016;08;07;Lauantai;4;6;10
95;06.08.2016;2016;08;08;Lauantai;11;8;19
95;06.08.2016;2016;08;09;Lauantai;20;7;27
95;06.08.2016;2016;08;10;Lauantai;21;24;45
95;06.08.2016;2016;08;11;Lauantai;17;21;38
95;06.08.2016;2016;08;12;Lauantai;18;15;33
95;06.08.2016;2016;08;13;Lauantai;17;25;42
95;06.08.2016;2016;08;14;Lauantai;15;13;28
95;06.08.2016;2016;08;15;Lauantai;28;25;53
95;06.08.2016;2016;08;16;Lauantai;10;8;18
95;06.08.2016;2016;08;17;Lauantai;16;14;30
95;06.08.2016;2016;08;18;Lauantai;20;16;36
95;06.08.2016;2016;08;19;Lauantai;10;18;28
95;06.08.2016;2016;08;20;Lauantai;16;8;24
95;06.08.2016;2016;08;21;Lauantai;6;5;11
95;06.08.2016;2016;08;22;Lauantai;3;2;5
95;06.08.2016;2016;08;23;Lauantai;0;3;3
95;07.08.2016;2016;08;00;Sunnuntai;0;3;3
95;07.08.2016;2016;08;01;Sunnuntai;4;1;5
95;07.08.2016;2016;08;02;Sunnuntai;0;1;1
95;07.08.2016;2016;08;03;Sunnuntai;0;2;2
95;07.08.2016;2016;08;04;Sunnuntai;0;0;0
95;07.08.2016;2016;08;05;Sunnuntai;0;1;1
95;07.08.2016;2016;08;06;Sunnuntai;1;2;3
95;07.08.2016;2016;08;07;Sunnuntai;4;5;9
95;07.08.2016;2016;08;08;Sunnuntai;6;5;11
95;07.08.2016;2016;08;09;Sunnuntai;13;7;20
95;07.08.2016;2016;08;10;Sunnuntai;15;23;38
95;07.08.2016;2016;08;11;Sunnuntai;33;17;50
95;07.08.2016;2016;08;12;Sunnuntai;17;23;40
95;07.08.2016;2016;08;13;Sunnuntai;22;15;37
95;07.08.2016;2016;08;14;Sunnuntai;21;21;42
95;07.08.2016;2016;08;15;Sunnuntai;17;13;30
95;07.08.2016;2016;08;16;Sunnuntai;10;19;29
95;07.08.2016;2016;08;17;Sunnuntai;24;23;47
95;07.08.2016;2016;08;18;Sunnuntai;24;26;50
95;07.08.2016;2016;08;19;Sunnuntai;21;25;46
95;07.08.2016;2016;08;20;Sunnuntai;25;22;47
95;07.08.2016;2016;08;21;Sunnuntai;15;7;22
95;07.08.2016;2016;08;22;Sunnuntai;6;4;10
95;07.08.2016;2016;08;23;Sunnuntai;2;4;6
95;08.08.2016;2016;08;00;Maanantai;3;3;6
95;08.08.2016;2016;08;01;Maanantai;0;0;0
95;08.08.2016;2016;08;02;Maanantai;1;0;1
95;08.08.2016;2016;08;03;Maanantai;0;0;0
95;08.08.2016;2016;08;04;Maanantai;1;0;1
95;08.08.2016;2016;08;05;Maanantai;9;0;9
95;08.08.2016;2016;08;06;Maanantai;30;19;49
95;08.08.2016;2016;08;07;Maanantai;37;18;55
95;08.08.2016;2016;08;08;Maanantai;21;21;42
95;08.08.2016;2016;08;09;Maanantai;12;11;23
95;08.08.2016;2016;08;10;Maanantai;10;8;18
95;08.08.2016;2016;08;11;Maanantai;29;16;45
95;08.08.2016;2016;08;12;Maanantai;18;15;33
95;08.08.2016;2016;08;13;Maanantai;14;11;25
95;08.08.2016;2016;08;14;Maanantai;18;14;32
95;08.08.2016;2016;08;15;Maanantai;39;24;63
95;08.08.2016;2016;08;16;Maanantai;21;55;76
95;08.08.2016;2016;08;17;Maanantai;26;22;48
95;08.08.2016;2016;08;18;Maanantai;16;25;41
95;08.08.2016;2016;08;19;Maanantai;24;29;53
95;08.08.2016;2016;08;20;Maanantai;21;17;38
95;08.08.2016;2016;08;21;Maanantai;9;11;20
95;08.08.2016;2016;08;22;Maanantai;2;7;9
95;08.08.2016;2016;08;23;Maanantai;2;1;3
95;09.08.2016;2016;08;00;Tiistai;1;1;2
95;09.08.2016;2016;08;01;Tiistai;0;2;2
95;09.08.2016;2016;08;02;Tiistai;0;3;3
95;09.08.2016;2016;08;03;Tiistai;1;0;1
95;09.08.2016;2016;08;04;Tiistai;2;0;2
95;09.08.2016;2016;08;05;Tiistai;8;6;14
95;09.08.2016;2016;08;06;Tiistai;23;13;36
95;09.08.2016;2016;08;07;Tiistai;28;20;48
95;09.08.2016;2016;08;08;Tiistai;7;11;18
95;09.08.2016;2016;08;09;Tiistai;9;8;17
95;09.08.2016;2016;08;10;Tiistai;15;5;20
95;09.08.2016;2016;08;11;Tiistai;11;10;21
95;09.08.2016;2016;08;12;Tiistai;9;6;15
95;09.08.2016;2016;08;13;Tiistai;5;6;11
95;09.08.2016;2016;08;14;Tiistai;6;11;17
95;09.08.2016;2016;08;15;Tiistai;23;24;47
95;09.08.2016;2016;08;16;Tiistai;22;26;48
95;09.08.2016;2016;08;17;Tiistai;11;24;35
95;09.08.2016;2016;08;18;Tiistai;10;11;21
95;09.08.2016;2016;08;19;Tiistai;11;17;28
95;09.08.2016;2016;08;20;Tiistai;12;13;25
95;09.08.2016;2016;08;21;Tiistai;6;6;12
95;09.08.2016;2016;08;22;Tiistai;3;2;5
95;09.08.2016;2016;08;23;Tiistai;2;1;3
95;10.08.2016;2016;08;00;Keskiviikko;1;0;1
95;10.08.2016;2016;08;01;Keskiviikko;0;2;2
95;10.08.2016;2016;08;02;Keskiviikko;0;0;0
95;10.08.2016;2016;08;03;Keskiviikko;0;0;0
95;10.08.2016;2016;08;04;Keskiviikko;4;0;4
95;10.08.2016;2016;08;05;Keskiviikko;4;1;5
95;10.08.2016;2016;08;06;Keskiviikko;14;8;22
95;10.08.2016;2016;08;07;Keskiviikko;12;14;26
95;10.08.2016;2016;08;08;Keskiviikko;6;16;22
95;10.08.2016;2016;08;09;Keskiviikko;5;5;10
95;10.08.2016;2016;08;10;Keskiviikko;10;9;19
95;10.08.2016;2016;08;11;Keskiviikko;18;5;23
95;10.08.2016;2016;08;12;Keskiviikko;17;10;27
95;10.08.2016;2016;08;13;Keskiviikko;24;15;39
95;10.08.2016;2016;08;14;Keskiviikko;16;27;43
95;10.08.2016;2016;08;15;Keskiviikko;21;21;42
95;10.08.2016;2016;08;16;Keskiviikko;11;17;28
95;10.08.2016;2016;08;17;Keskiviikko;8;13;21
95;10.08.2016;2016;08;18;Keskiviikko;17;10;27
95;10.08.2016;2016;08;19;Keskiviikko;3;15;18
95;10.08.2016;2016;08;20;Keskiviikko;5;8;13
95;10.08.2016;2016;08;21;Keskiviikko;9;9;18
95;10.08.2016;2016;08;22;Keskiviikko;3;4;7
95;10.08.2016;2016;08;23;Keskiviikko;0;2;2
95;11.08.2016;2016;08;00;Torstai;0;0;0
95;11.08.2016;2016;08;01;Torstai;0;0;0
95;11.08.2016;2016;08;02;Torstai;0;0;0
95;11.08.2016;2016;08;03;Torstai;0;1;1
95;11.08.2016;2016;08;04;Torstai;2;0;2
95;11.08.2016;2016;08;05;Torstai;4;1;5
95;11.08.2016;2016;08;06;Torstai;29;7;36
95;11.08.2016;2016;08;07;Torstai;22;15;37
95;11.08.2016;2016;08;08;Torstai;20;26;46
95;11.08.2016;2016;08;09;Torstai;14;9;23
95;11.08.2016;2016;08;10;Torstai;11;10;21
95;11.08.2016;2016;08;11;Torstai;14;13;27
95;11.08.2016;2016;08;12;Torstai;14;12;26
95;11.08.2016;2016;08;13;Torstai;21;14;35
95;11.08.2016;2016;08;14;Torstai;13;9;22
95;11.08.2016;2016;08;15;Torstai;29;31;60
95;11.08.2016;2016;08;16;Torstai;20;30;50
95;11.08.2016;2016;08;17;Torstai;16;17;33
95;11.08.2016;2016;08;18;Torstai;12;12;24
95;11.08.2016;2016;08;19;Torstai;10;15;25
95;11.08.2016;2016;08;20;Torstai;7;4;11
95;11.08.2016;2016;08;21;Torstai;5;4;9
95;11.08.2016;2016;08;22;Torstai;4;1;5
95;11.08.2016;2016;08;23;Torstai;0;1;1
95;12.08.2016;2016;08;00;Perjantai;0;2;2
95;12.08.2016;2016;08;01;Perjantai;0;0;0
95;12.08.2016;2016;08;02;Perjantai;0;0;0
95;12.08.2016;2016;08;03;Perjantai;0;0;0
95;12.08.2016;2016;08;04;Perjantai;0;0;0
95;12.08.2016;2016;08;05;Perjantai;4;3;7
95;12.08.2016;2016;08;06;Perjantai;18;10;28
95;12.08.2016;2016;08;07;Perjantai;14;10;24
95;12.08.2016;2016;08;08;Perjantai;11;10;21
95;12.08.2016;2016;08;09;Perjantai;5;7;12
95;12.08.2016;2016;08;10;Perjantai;2;1;3
95;12.08.2016;2016;08;11;Perjantai;1;3;4
95;12.08.2016;2016;08;12;Perjantai;6;4;10
95;12.08.2016;2016;08;13;Perjantai;14;8;22
95;12.08.2016;2016;08;14;Perjantai;8;13;21
95;12.08.2016;2016;08;15;Perjantai;17;23;40
95;12.08.2016;2016;08;16;Perjantai;13;22;35
95;12.08.2016;2016;08;17;Perjantai;17;21;38
95;12.08.2016;2016;08;18;Perjantai;9;9;18
95;12.08.2016;2016;08;19;Perjantai;9;10;19
95;12.08.2016;2016;08;20;Perjantai;11;12;23
95;12.08.2016;2016;08;21;Perjantai;3;7;10
95;12.08.2016;2016;08;22;Perjantai;10;9;19
95;12.08.2016;2016;08;23;Perjantai;1;3;4
95;13.08.2016;2016;08;00;Lauantai;0;5;5
95;13.08.2016;2016;08;01;Lauantai;0;0;0
95;13.08.2016;2016;08;02;Lauantai;0;0;0
95;13.08.2016;2016;08;03;Lauantai;0;0;0
95;13.08.2016;2016;08;04;Lauantai;0;0;0
95;13.08.2016;2016;08;05;Lauantai;2;1;3
95;13.08.2016;2016;08;06;Lauantai;3;2;5
95;13.08.2016;2016;08;07;Lauantai;6;0;6
95;13.08.2016;2016;08;08;Lauantai;4;0;4
95;13.08.2016;2016;08;09;Lauantai;3;3;6
95;13.08.2016;2016;08;10;Lauantai;2;2;4
95;13.08.2016;2016;08;11;Lauantai;6;6;12
95;13.08.2016;2016;08;12;Lauantai;2;4;6
95;13.08.2016;2016;08;13;Lauantai;4;6;10
95;13.08.2016;2016;08;14;Lauantai;1;2;3
95;13.08.2016;2016;08;15;Lauantai;0;1;1
95;13.08.2016;2016;08;16;Lauantai;3;2;5
95;13.08.2016;2016;08;17;Lauantai;2;2;4
95;13.08.2016;2016;08;18;Lauantai;3;3;6
95;13.08.2016;2016;08;19;Lauantai;1;3;4
95;13.08.2016;2016;08;20;Lauantai;11;5;16
95;13.08.2016;2016;08;21;Lauantai;2;7;9
95;13.08.2016;2016;08;22;Lauantai;1;2;3
95;13.08.2016;2016;08;23;Lauantai;2;1;3
95;14.08.2016;2016;08;00;Sunnuntai;0;0;0
95;14.08.2016;2016;08;01;Sunnuntai;0;0;0
95;14.08.2016;2016;08;02;Sunnuntai;0;0;0
95;14.08.2016;2016;08;03;Sunnuntai;0;0;0
95;14.08.2016;2016;08;04;Sunnuntai;0;1;1
95;14.08.2016;2016;08;05;Sunnuntai;0;1;1
95;14.08.2016;2016;08;06;Sunnuntai;0;1;1
95;14.08.2016;2016;08;07;Sunnuntai;2;0;2
95;14.08.2016;2016;08;08;Sunnuntai;5;7;12
95;14.08.2016;2016;08;09;Sunnuntai;7;6;13
95;14.08.2016;2016;08;10;Sunnuntai;14;14;28
95;14.08.2016;2016;08;11;Sunnuntai;13;27;40
95;14.08.2016;2016;08;12;Sunnuntai;15;16;31
95;14.08.2016;2016;08;13;Sunnuntai;27;13;40
95;14.08.2016;2016;08;14;Sunnuntai;23;29;52
95;14.08.2016;2016;08;15;Sunnuntai;28;23;51
95;14.08.2016;2016;08;16;Sunnuntai;12;22;34
95;14.08.2016;2016;08;17;Sunnuntai;21;24;45
95;14.08.2016;2016;08;18;Sunnuntai;20;19;39
95;14.08.2016;2016;08;19;Sunnuntai;38;36;74
95;14.08.2016;2016;08;20;Sunnuntai;20;20;40
95;14.08.2016;2016;08;21;Sunnuntai;7;6;13
95;14.08.2016;2016;08;22;Sunnuntai;2;3;5
95;14.08.2016;2016;08;23;Sunnuntai;0;2;2
95;15.08.2016;2016;08;00;Maanantai;0;0;0
95;15.08.2016;2016;08;01;Maanantai;0;0;0
95;15.08.2016;2016;08;02;Maanantai;0;0;0
95;15.08.2016;2016;08;03;Maanantai;0;0;0
95;15.08.2016;2016;08;04;Maanantai;0;0;0
95;15.08.2016;2016;08;05;Maanantai;3;5;8
95;15.08.2016;2016;08;06;Maanantai;28;12;40
95;15.08.2016;2016;08;07;Maanantai;24;21;45
95;15.08.2016;2016;08;08;Maanantai;12;16;28
95;15.08.2016;2016;08;09;Maanantai;8;20;28
95;15.08.2016;2016;08;10;Maanantai;7;16;23
95;15.08.2016;2016;08;11;Maanantai;10;10;20
95;15.08.2016;2016;08;12;Maanantai;18;8;26
95;15.08.2016;2016;08;13;Maanantai;5;9;14
95;15.08.2016;2016;08;14;Maanantai;26;18;44
95;15.08.2016;2016;08;15;Maanantai;25;30;55
95;15.08.2016;2016;08;16;Maanantai;36;26;62
95;15.08.2016;2016;08;17;Maanantai;18;22;40
95;15.08.2016;2016;08;18;Maanantai;24;29;53
95;15.08.2016;2016;08;19;Maanantai;17;21;38
95;15.08.2016;2016;08;20;Maanantai;9;9;18
95;15.08.2016;2016;08;21;Maanantai;11;10;21
95;15.08.2016;2016;08;22;Maanantai;2;5;7
95;15.08.2016;2016;08;23;Maanantai;1;0;1
95;16.08.2016;2016;08;00;Tiistai;0;0;0
95;16.08.2016;2016;08;01;Tiistai;0;0;0
95;16.08.2016;2016;08;02;Tiistai;0;0;0
95;16.08.2016;2016;08;03;Tiistai;0;0;0
95;16.08.2016;2016;08;04;Tiistai;0;1;1
95;16.08.2016;2016;08;05;Tiistai;2;2;4
95;16.08.2016;2016;08;06;Tiistai;21;11;32
95;16.08.2016;2016;08;07;Tiistai;24;21;45
95;16.08.2016;2016;08;08;Tiistai;12;13;25
95;16.08.2016;2016;08;09;Tiistai;5;10;15
95;16.08.2016;2016;08;10;Tiistai;5;6;11
95;16.08.2016;2016;08;11;Tiistai;5;8;13
95;16.08.2016;2016;08;12;Tiistai;6;5;11
95;16.08.2016;2016;08;13;Tiistai;7;4;11
95;16.08.2016;2016;08;14;Tiistai;15;12;27
95;16.08.2016;2016;08;15;Tiistai;13;14;27
95;16.08.2016;2016;08;16;Tiistai;22;20;42
95;16.08.2016;2016;08;17;Tiistai;7;15;22
95;16.08.2016;2016;08;18;Tiistai;4;8;12
95;16.08.2016;2016;08;19;Tiistai;6;7;13
95;16.08.2016;2016;08;20;Tiistai;4;4;8
95;16.08.2016;2016;08;21;Tiistai;6;5;11
95;16.08.2016;2016;08;22;Tiistai;1;0;1
95;16.08.2016;2016;08;23;Tiistai;1;0;1
95;17.08.2016;2016;08;00;Keskiviikko;0;0;0
95;17.08.2016;2016;08;01;Keskiviikko;0;0;0
95;17.08.2016;2016;08;02;Keskiviikko;0;0;0
95;17.08.2016;2016;08;03;Keskiviikko;0;0;0
95;17.08.2016;2016;08;04;Keskiviikko;0;0;0
95;17.08.2016;2016;08;05;Keskiviikko;5;2;7
95;17.08.2016;2016;08;06;Keskiviikko;19;15;34
95;17.08.2016;2016;08;07;Keskiviikko;22;25;47
95;17.08.2016;2016;08;08;Keskiviikko;12;11;23
95;17.08.2016;2016;08;09;Keskiviikko;10;9;19
95;17.08.2016;2016;08;10;Keskiviikko;2;4;6
95;17.08.2016;2016;08;11;Keskiviikko;5;8;13
95;17.08.2016;2016;08;12;Keskiviikko;11;6;17
95;17.08.2016;2016;08;13;Keskiviikko;20;10;30
95;17.08.2016;2016;08;14;Keskiviikko;22;12;34
95;17.08.2016;2016;08;15;Keskiviikko;21;22;43
95;17.08.2016;2016;08;16;Keskiviikko;23;33;56
95;17.08.2016;2016;08;17;Keskiviikko;22;26;48
95;17.08.2016;2016;08;18;Keskiviikko;13;32;45
95;17.08.2016;2016;08;19;Keskiviikko;17;24;41
95;17.08.2016;2016;08;20;Keskiviikko;19;25;44
95;17.08.2016;2016;08;21;Keskiviikko;6;5;11
95;17.08.2016;2016;08;22;Keskiviikko;4;3;7
95;17.08.2016;2016;08;23;Keskiviikko;2;1;3
95;18.08.2016;2016;08;00;Torstai;0;0;0
95;18.08.2016;2016;08;01;Torstai;0;0;0
95;18.08.2016;2016;08;02;Torstai;0;0;0
95;18.08.2016;2016;08;03;Torstai;0;0;0
95;18.08.2016;2016;08;04;Torstai;0;0;0
95;18.08.2016;2016;08;05;Torstai;4;1;5
95;18.08.2016;2016;08;06;Torstai;33;14;47
95;18.08.2016;2016;08;07;Torstai;29;24;53
95;18.08.2016;2016;08;08;Torstai;14;16;30
95;18.08.2016;2016;08;09;Torstai;14;20;34
95;18.08.2016;2016;08;10;Torstai;11;13;24
95;18.08.2016;2016;08;11;Torstai;25;26;51
95;18.08.2016;2016;08;12;Torstai;22;18;40
95;18.08.2016;2016;08;13;Torstai;13;11;24
95;18.08.2016;2016;08;14;Torstai;12;14;26
95;18.08.2016;2016;08;15;Torstai;28;24;52
95;18.08.2016;2016;08;16;Torstai;45;42;87
95;18.08.2016;2016;08;17;Torstai;24;18;42
95;18.08.2016;2016;08;18;Torstai;9;30;39
95;18.08.2016;2016;08;19;Torstai;21;14;35
95;18.08.2016;2016;08;20;Torstai;17;15;32
95;18.08.2016;2016;08;21;Torstai;1;9;10
95;18.08.2016;2016;08;22;Torstai;3;5;8
95;18.08.2016;2016;08;23;Torstai;1;2;3
95;19.08.2016;2016;08;00;Perjantai;0;0;0
95;19.08.2016;2016;08;01;Perjantai;0;0;0
95;19.08.2016;2016;08;02;Perjantai;0;0;0
95;19.08.2016;2016;08;03;Perjantai;0;0;0
95;19.08.2016;2016;08;04;Perjantai;1;0;1
95;19.08.2016;2016;08;05;Perjantai;2;2;4
95;19.08.2016;2016;08;06;Perjantai;10;5;15
95;19.08.2016;2016;08;07;Perjantai;7;15;22
95;19.08.2016;2016;08;08;Perjantai;2;7;9
95;19.08.2016;2016;08;09;Perjantai;5;7;12
95;19.08.2016;2016;08;10;Perjantai;2;2;4
95;19.08.2016;2016;08;11;Perjantai;9;4;13
95;19.08.2016;2016;08;12;Perjantai;7;12;19
95;19.08.2016;2016;08;13;Perjantai;8;7;15
95;19.08.2016;2016;08;14;Perjantai;18;12;30
95;19.08.2016;2016;08;15;Perjantai;10;11;21
95;19.08.2016;2016;08;16;Perjantai;20;11;31
95;19.08.2016;2016;08;17;Perjantai;9;21;30
95;19.08.2016;2016;08;18;Perjantai;13;6;19
95;19.08.2016;2016;08;19;Perjantai;17;17;34
95;19.08.2016;2016;08;20;Perjantai;11;11;22
95;19.08.2016;2016;08;21;Perjantai;6;6;12
95;19.08.2016;2016;08;22;Perjantai;1;5;6
95;19.08.2016;2016;08;23;Perjantai;6;2;8
95;20.08.2016;2016;08;00;Lauantai;3;3;6
95;20.08.2016;2016;08;01;Lauantai;1;2;3
95;20.08.2016;2016;08;02;Lauantai;0;1;1
95;20.08.2016;2016;08;03;Lauantai;0;1;1
95;20.08.2016;2016;08;04;Lauantai;2;1;3
95;20.08.2016;2016;08;05;Lauantai;1;0;1
95;20.08.2016;2016;08;06;Lauantai;3;2;5
95;20.08.2016;2016;08;07;Lauantai;3;1;4
95;20.08.2016;2016;08;08;Lauantai;6;8;14
95;20.08.2016;2016;08;09;Lauantai;14;13;27
95;20.08.2016;2016;08;10;Lauantai;12;15;27
95;20.08.2016;2016;08;11;Lauantai;12;12;24
95;20.08.2016;2016;08;12;Lauantai;15;17;32
95;20.08.2016;2016;08;13;Lauantai;21;9;30
95;20.08.2016;2016;08;14;Lauantai;13;21;34
95;20.08.2016;2016;08;15;Lauantai;13;12;25
95;20.08.2016;2016;08;16;Lauantai;8;20;28
95;20.08.2016;2016;08;17;Lauantai;9;20;29
95;20.08.2016;2016;08;18;Lauantai;1;4;5
95;20.08.2016;2016;08;19;Lauantai;10;6;16
95;20.08.2016;2016;08;20;Lauantai;3;4;7
95;20.08.2016;2016;08;21;Lauantai;6;10;16
95;20.08.2016;2016;08;22;Lauantai;2;1;3
95;20.08.2016;2016;08;23;Lauantai;2;3;5
95;21.08.2016;2016;08;00;Sunnuntai;0;0;0
95;21.08.2016;2016;08;01;Sunnuntai;0;1;1
95;21.08.2016;2016;08;02;Sunnuntai;1;0;1
95;21.08.2016;2016;08;03;Sunnuntai;0;2;2
95;21.08.2016;2016;08;04;Sunnuntai;2;0;2
95;21.08.2016;2016;08;05;Sunnuntai;0;0;0
95;21.08.2016;2016;08;06;Sunnuntai;3;1;4
95;21.08.2016;2016;08;07;Sunnuntai;2;1;3
95;21.08.2016;2016;08;08;Sunnuntai;0;5;5
95;21.08.2016;2016;08;09;Sunnuntai;5;5;10
95;21.08.2016;2016;08;10;Sunnuntai;12;13;25
95;21.08.2016;2016;08;11;Sunnuntai;19;11;30
95;21.08.2016;2016;08;12;Sunnuntai;8;12;20
95;21.08.2016;2016;08;13;Sunnuntai;14;15;29
95;21.08.2016;2016;08;14;Sunnuntai;23;13;36
95;21.08.2016;2016;08;15;Sunnuntai;16;13;29
95;21.08.2016;2016;08;16;Sunnuntai;17;17;34
95;21.08.2016;2016;08;17;Sunnuntai;14;17;31
95;21.08.2016;2016;08;18;Sunnuntai;17;27;44
95;21.08.2016;2016;08;19;Sunnuntai;24;12;36
95;21.08.2016;2016;08;20;Sunnuntai;21;15;36
95;21.08.2016;2016;08;21;Sunnuntai;7;2;9
95;21.08.2016;2016;08;22;Sunnuntai;0;5;5
95;21.08.2016;2016;08;23;Sunnuntai;0;0;0
95;22.08.2016;2016;08;00;Maanantai;0;0;0
95;22.08.2016;2016;08;01;Maanantai;0;0;0
95;22.08.2016;2016;08;02;Maanantai;0;0;0
95;22.08.2016;2016;08;03;Maanantai;0;0;0
95;22.08.2016;2016;08;04;Maanantai;0;0;0
95;22.08.2016;2016;08;05;Maanantai;6;3;9
95;22.08.2016;2016;08;06;Maanantai;5;9;14
95;22.08.2016;2016;08;07;Maanantai;12;10;22
95;22.08.2016;2016;08;08;Maanantai;4;4;8
95;22.08.2016;2016;08;09;Maanantai;3;6;9
95;22.08.2016;2016;08;10;Maanantai;4;5;9
95;22.08.2016;2016;08;11;Maanantai;3;4;7
95;22.08.2016;2016;08;12;Maanantai;8;8;16
95;22.08.2016;2016;08;13;Maanantai;17;7;24
95;22.08.2016;2016;08;14;Maanantai;7;5;12
95;22.08.2016;2016;08;15;Maanantai;16;8;24
95;22.08.2016;2016;08;16;Maanantai;13;9;22
95;22.08.2016;2016;08;17;Maanantai;4;11;15
95;22.08.2016;2016;08;18;Maanantai;4;6;10
95;22.08.2016;2016;08;19;Maanantai;5;5;10
95;22.08.2016;2016;08;20;Maanantai;9;1;10
95;22.08.2016;2016;08;21;Maanantai;1;3;4
95;22.08.2016;2016;08;22;Maanantai;0;1;1
95;22.08.2016;2016;08;23;Maanantai;2;0;2
95;23.08.2016;2016;08;00;Tiistai;0;0;0
95;23.08.2016;2016;08;01;Tiistai;0;0;0
95;23.08.2016;2016;08;02;Tiistai;0;0;0
95;23.08.2016;2016;08;03;Tiistai;0;0;0
95;23.08.2016;2016;08;04;Tiistai;1;1;2
95;23.08.2016;2016;08;05;Tiistai;6;4;10
95;23.08.2016;2016;08;06;Tiistai;21;11;32
95;23.08.2016;2016;08;07;Tiistai;15;28;43
95;23.08.2016;2016;08;08;Tiistai;14;18;32
95;23.08.2016;2016;08;09;Tiistai;3;4;7
95;23.08.2016;2016;08;10;Tiistai;11;70;81
95;23.08.2016;2016;08;11;Tiistai;10;9;19
95;23.08.2016;2016;08;12;Tiistai;13;9;22
95;23.08.2016;2016;08;13;Tiistai;74;11;85
95;23.08.2016;2016;08;14;Tiistai;24;16;40
95;23.08.2016;2016;08;15;Tiistai;29;26;55
95;23.08.2016;2016;08;16;Tiistai;30;30;60
95;23.08.2016;2016;08;17;Tiistai;21;20;41
95;23.08.2016;2016;08;18;Tiistai;18;30;48
95;23.08.2016;2016;08;19;Tiistai;11;11;22
95;23.08.2016;2016;08;20;Tiistai;13;13;26
95;23.08.2016;2016;08;21;Tiistai;4;13;17
95;23.08.2016;2016;08;22;Tiistai;4;6;10
95;23.08.2016;2016;08;23;Tiistai;1;0;1
95;24.08.2016;2016;08;00;Keskiviikko;0;1;1
95;24.08.2016;2016;08;01;Keskiviikko;0;0;0
95;24.08.2016;2016;08;02;Keskiviikko;0;0;0
95;24.08.2016;2016;08;03;Keskiviikko;0;0;0
95;24.08.2016;2016;08;04;Keskiviikko;0;0;0
95;24.08.2016;2016;08;05;Keskiviikko;8;3;11
95;24.08.2016;2016;08;06;Keskiviikko;23;14;37
95;24.08.2016;2016;08;07;Keskiviikko;27;26;53
95;24.08.2016;2016;08;08;Keskiviikko;17;16;33
95;24.08.2016;2016;08;09;Keskiviikko;15;13;28
95;24.08.2016;2016;08;10;Keskiviikko;14;15;29
95;24.08.2016;2016;08;11;Keskiviikko;13;7;20
95;24.08.2016;2016;08;12;Keskiviikko;19;16;35
95;24.08.2016;2016;08;13;Keskiviikko;20;11;31
95;24.08.2016;2016;08;14;Keskiviikko;27;18;45
95;24.08.2016;2016;08;15;Keskiviikko;34;27;61
95;24.08.2016;2016;08;16;Keskiviikko;33;39;72
95;24.08.2016;2016;08;17;Keskiviikko;14;24;38
95;24.08.2016;2016;08;18;Keskiviikko;28;19;47
95;24.08.2016;2016;08;19;Keskiviikko;16;23;39
95;24.08.2016;2016;08;20;Keskiviikko;14;17;31
95;24.08.2016;2016;08;21;Keskiviikko;1;5;6
95;24.08.2016;2016;08;22;Keskiviikko;2;3;5
95;24.08.2016;2016;08;23;Keskiviikko;1;1;2
95;25.08.2016;2016;08;00;Torstai;0;1;1
95;25.08.2016;2016;08;01;Torstai;0;0;0
95;25.08.2016;2016;08;02;Torstai;0;0;0
95;25.08.2016;2016;08;03;Torstai;0;0;0
95;25.08.2016;2016;08;04;Torstai;0;1;1
95;25.08.2016;2016;08;05;Torstai;8;3;11
95;25.08.2016;2016;08;06;Torstai;13;13;26
95;25.08.2016;2016;08;07;Torstai;15;17;32
95;25.08.2016;2016;08;08;Torstai;8;11;19
95;25.08.2016;2016;08;09;Torstai;4;10;14
95;25.08.2016;2016;08;10;Torstai;3;3;6
95;25.08.2016;2016;08;11;Torstai;2;4;6
95;25.08.2016;2016;08;12;Torstai;5;6;11
95;25.08.2016;2016;08;13;Torstai;10;6;16
95;25.08.2016;2016;08;14;Torstai;11;5;16
95;25.08.2016;2016;08;15;Torstai;16;12;28
95;25.08.2016;2016;08;16;Torstai;30;20;50
95;25.08.2016;2016;08;17;Torstai;14;10;24
95;25.08.2016;2016;08;18;Torstai;12;8;20
95;25.08.2016;2016;08;19;Torstai;12;13;25
95;25.08.2016;2016;08;20;Torstai;6;10;16
95;25.08.2016;2016;08;21;Torstai;8;6;14
95;25.08.2016;2016;08;22;Torstai;0;2;2
95;25.08.2016;2016;08;23;Torstai;1;0;1
95;26.08.2016;2016;08;00;Perjantai;0;1;1
95;26.08.2016;2016;08;01;Perjantai;0;1;1
95;26.08.2016;2016;08;02;Perjantai;0;0;0
95;26.08.2016;2016;08;03;Perjantai;0;0;0
95;26.08.2016;2016;08;04;Perjantai;0;0;0
95;26.08.2016;2016;08;05;Perjantai;6;3;9
95;26.08.2016;2016;08;06;Perjantai;18;9;27
95;26.08.2016;2016;08;07;Perjantai;21;22;43
95;26.08.2016;2016;08;08;Perjantai;10;19;29
95;26.08.2016;2016;08;09;Perjantai;13;10;23
95;26.08.2016;2016;08;10;Perjantai;15;9;24
95;26.08.2016;2016;08;11;Perjantai;10;9;19
95;26.08.2016;2016;08;12;Perjantai;19;10;29
95;26.08.2016;2016;08;13;Perjantai;23;9;32
95;26.08.2016;2016;08;14;Perjantai;22;23;45
95;26.08.2016;2016;08;15;Perjantai;18;17;35
95;26.08.2016;2016;08;16;Perjantai;23;26;49
95;26.08.2016;2016;08;17;Perjantai;12;29;41
95;26.08.2016;2016;08;18;Perjantai;22;34;56
95;26.08.2016;2016;08;19;Perjantai;10;16;26
95;26.08.2016;2016;08;20;Perjantai;11;13;24
95;26.08.2016;2016;08;21;Perjantai;4;13;17
95;26.08.2016;2016;08;22;Perjantai;2;8;10
95;26.08.2016;2016;08;23;Perjantai;4;1;5
95;27.08.2016;2016;08;00;Lauantai;1;2;3
95;27.08.2016;2016;08;01;Lauantai;0;0;0
95;27.08.2016;2016;08;02;Lauantai;2;1;3
95;27.08.2016;2016;08;03;Lauantai;0;0;0
95;27.08.2016;2016;08;04;Lauantai;0;0;0
95;27.08.2016;2016;08;05;Lauantai;0;1;1
95;27.08.2016;2016;08;06;Lauantai;1;0;1
95;27.08.2016;2016;08;07;Lauantai;2;0;2
95;27.08.2016;2016;08;08;Lauantai;1;3;4
95;27.08.2016;2016;08;09;Lauantai;3;4;7
95;27.08.2016;2016;08;10;Lauantai;4;2;6
95;27.08.2016;2016;08;11;Lauantai;3;7;10
95;27.08.2016;2016;08;12;Lauantai;8;2;10
95;27.08.2016;2016;08;13;Lauantai;2;3;5
95;27.08.2016;2016;08;14;Lauantai;2;3;5
95;27.08.2016;2016;08;15;Lauantai;1;1;2
95;27.08.2016;2016;08;16;Lauantai;2;2;4
95;27.08.2016;2016;08;17;Lauantai;2;4;6
95;27.08.2016;2016;08;18;Lauantai;7;0;7
95;27.08.2016;2016;08;19;Lauantai;3;1;4
95;27.08.2016;2016;08;20;Lauantai;1;6;7
95;27.08.2016;2016;08;21;Lauantai;0;3;3
95;27.08.2016;2016;08;22;Lauantai;1;0;1
95;27.08.2016;2016;08;23;Lauantai;0;0;0
95;28.08.2016;2016;08;00;Sunnuntai;0;0;0
95;28.08.2016;2016;08;01;Sunnuntai;0;0;0
95;28.08.2016;2016;08;02;Sunnuntai;0;1;1
95;28.08.2016;2016;08;03;Sunnuntai;0;0;0
95;28.08.2016;2016;08;04;Sunnuntai;0;0;0
95;28.08.2016;2016;08;05;Sunnuntai;1;0;1
95;28.08.2016;2016;08;06;Sunnuntai;0;1;1
95;28.08.2016;2016;08;07;Sunnuntai;5;2;7
95;28.08.2016;2016;08;08;Sunnuntai;4;0;4
95;28.08.2016;2016;08;09;Sunnuntai;7;9;16
95;28.08.2016;2016;08;10;Sunnuntai;12;13;25
95;28.08.2016;2016;08;11;Sunnuntai;14;12;26
95;28.08.2016;2016;08;12;Sunnuntai;26;18;44
95;28.08.2016;2016;08;13;Sunnuntai;25;19;44
95;28.08.2016;2016;08;14;Sunnuntai;21;12;33
95;28.08.2016;2016;08;15;Sunnuntai;12;17;29
95;28.08.2016;2016;08;16;Sunnuntai;9;11;20
95;28.08.2016;2016;08;17;Sunnuntai;13;18;31
95;28.08.2016;2016;08;18;Sunnuntai;17;20;37
95;28.08.2016;2016;08;19;Sunnuntai;13;20;33
95;28.08.2016;2016;08;20;Sunnuntai;7;5;12
95;28.08.2016;2016;08;21;Sunnuntai;3;6;9
95;28.08.2016;2016;08;22;Sunnuntai;4;2;6
95;28.08.2016;2016;08;23;Sunnuntai;0;7;7
95;29.08.2016;2016;08;00;Maanantai;0;0;0
95;29.08.2016;2016;08;01;Maanantai;1;0;1
95;29.08.2016;2016;08;02;Maanantai;0;0;0
95;29.08.2016;2016;08;03;Maanantai;0;0;0
95;29.08.2016;2016;08;04;Maanantai;0;0;0
95;29.08.2016;2016;08;05;Maanantai;8;3;11
95;29.08.2016;2016;08;06;Maanantai;22;12;34
95;29.08.2016;2016;08;07;Maanantai;24;26;50
95;29.08.2016;2016;08;08;Maanantai;9;16;25
95;29.08.2016;2016;08;09;Maanantai;14;14;28
95;29.08.2016;2016;08;10;Maanantai;14;12;26
95;29.08.2016;2016;08;11;Maanantai;8;19;27
95;29.08.2016;2016;08;12;Maanantai;9;11;20
95;29.08.2016;2016;08;13;Maanantai;16;11;27
95;29.08.2016;2016;08;14;Maanantai;18;18;36
95;29.08.2016;2016;08;15;Maanantai;33;24;57
95;29.08.2016;2016;08;16;Maanantai;31;37;68
95;29.08.2016;2016;08;17;Maanantai;16;21;37
95;29.08.2016;2016;08;18;Maanantai;14;26;40
95;29.08.2016;2016;08;19;Maanantai;26;21;47
95;29.08.2016;2016;08;20;Maanantai;9;10;19
95;29.08.2016;2016;08;21;Maanantai;4;8;12
95;29.08.2016;2016;08;22;Maanantai;3;4;7
95;29.08.2016;2016;08;23;Maanantai;1;0;1
95;30.08.2016;2016;08;00;Tiistai;1;0;1
95;30.08.2016;2016;08;01;Tiistai;0;0;0
95;30.08.2016;2016;08;02;Tiistai;0;0;0
95;30.08.2016;2016;08;03;Tiistai;0;0;0
95;30.08.2016;2016;08;04;Tiistai;3;0;3
95;30.08.2016;2016;08;05;Tiistai;8;3;11
95;30.08.2016;2016;08;06;Tiistai;22;14;36
95;30.08.2016;2016;08;07;Tiistai;26;25;51
95;30.08.2016;2016;08;08;Tiistai;8;15;23
95;30.08.2016;2016;08;09;Tiistai;6;10;16
95;30.08.2016;2016;08;10;Tiistai;8;9;17
95;30.08.2016;2016;08;11;Tiistai;11;9;20
95;30.08.2016;2016;08;12;Tiistai;10;13;23
95;30.08.2016;2016;08;13;Tiistai;9;11;20
95;30.08.2016;2016;08;14;Tiistai;20;18;38
95;30.08.2016;2016;08;15;Tiistai;22;27;49
95;30.08.2016;2016;08;16;Tiistai;26;24;50
95;30.08.2016;2016;08;17;Tiistai;10;35;45
95;30.08.2016;2016;08;18;Tiistai;14;12;26
95;30.08.2016;2016;08;19;Tiistai;14;7;21
95;30.08.2016;2016;08;20;Tiistai;5;6;11
95;30.08.2016;2016;08;21;Tiistai;3;6;9
95;30.08.2016;2016;08;22;Tiistai;1;2;3
95;30.08.2016;2016;08;23;Tiistai;3;0;3
95;31.08.2016;2016;08;00;Keskiviikko;0;0;0
95;31.08.2016;2016;08;01;Keskiviikko;0;0;0
95;31.08.2016;2016;08;02;Keskiviikko;0;0;0
95;31.08.2016;2016;08;03;Keskiviikko;0;0;0
95;31.08.2016;2016;08;04;Keskiviikko;3;1;4
95;31.08.2016;2016;08;05;Keskiviikko;6;4;10
95;31.08.2016;2016;08;06;Keskiviikko;20;13;33
95;31.08.2016;2016;08;07;Keskiviikko;25;22;47
95;31.08.2016;2016;08;08;Keskiviikko;18;23;41
95;31.08.2016;2016;08;09;Keskiviikko;8;12;20
95;31.08.2016;2016;08;10;Keskiviikko;12;10;22
95;31.08.2016;2016;08;11;Keskiviikko;11;9;20
95;31.08.2016;2016;08;12;Keskiviikko;10;8;18
95;31.08.2016;2016;08;13;Keskiviikko;22;14;36
95;31.08.2016;2016;08;14;Keskiviikko;14;17;31
95;31.08.2016;2016;08;15;Keskiviikko;23;27;50
95;31.08.2016;2016;08;16;Keskiviikko;35;42;77
95;31.08.2016;2016;08;17;Keskiviikko;21;21;42
95;31.08.2016;2016;08;18;Keskiviikko;14;21;35
95;31.08.2016;2016;08;19;Keskiviikko;11;22;33
95;31.08.2016;2016;08;20;Keskiviikko;7;8;15
95;31.08.2016;2016;08;21;Keskiviikko;0;3;3
95;31.08.2016;2016;08;22;Keskiviikko;2;3;5
95;31.08.2016;2016;08;23;Keskiviikko;3;0;3
95;01.09.2016;2016;09;00;Torstai;0;0;0
95;01.09.2016;2016;09;01;Torstai;0;0;0
95;01.09.2016;2016;09;02;Torstai;0;0;0
95;01.09.2016;2016;09;03;Torstai;0;0;0
95;01.09.2016;2016;09;04;Torstai;1;0;1
95;01.09.2016;2016;09;05;Torstai;4;2;6
95;01.09.2016;2016;09;06;Torstai;21;11;32
95;01.09.2016;2016;09;07;Torstai;15;12;27
95;01.09.2016;2016;09;08;Torstai;5;5;10
95;01.09.2016;2016;09;09;Torstai;8;11;19
95;01.09.2016;2016;09;10;Torstai;0;2;2
95;01.09.2016;2016;09;11;Torstai;3;5;8
95;01.09.2016;2016;09;12;Torstai;4;5;9
95;01.09.2016;2016;09;13;Torstai;3;9;12
95;01.09.2016;2016;09;14;Torstai;8;12;20
95;01.09.2016;2016;09;15;Torstai;19;24;43
95;01.09.2016;2016;09;16;Torstai;29;22;51
95;01.09.2016;2016;09;17;Torstai;19;13;32
95;01.09.2016;2016;09;18;Torstai;12;19;31
95;01.09.2016;2016;09;19;Torstai;15;15;30
95;01.09.2016;2016;09;20;Torstai;6;13;19
95;01.09.2016;2016;09;21;Torstai;4;4;8
95;01.09.2016;2016;09;22;Torstai;3;2;5
95;01.09.2016;2016;09;23;Torstai;2;1;3
95;02.09.2016;2016;09;00;Perjantai;0;0;0
95;02.09.2016;2016;09;01;Perjantai;0;0;0
95;02.09.2016;2016;09;02;Perjantai;0;0;0
95;02.09.2016;2016;09;03;Perjantai;0;0;0
95;02.09.2016;2016;09;04;Perjantai;1;1;2
95;02.09.2016;2016;09;05;Perjantai;4;6;10
95;02.09.2016;2016;09;06;Perjantai;21;7;28
95;02.09.2016;2016;09;07;Perjantai;17;18;35
95;02.09.2016;2016;09;08;Perjantai;11;13;24
95;02.09.2016;2016;09;09;Perjantai;4;8;12
95;02.09.2016;2016;09;10;Perjantai;9;3;12
95;02.09.2016;2016;09;11;Perjantai;2;0;2
95;02.09.2016;2016;09;12;Perjantai;3;4;7
95;02.09.2016;2016;09;13;Perjantai;15;13;28
95;02.09.2016;2016;09;14;Perjantai;18;10;28
95;02.09.2016;2016;09;15;Perjantai;14;17;31
95;02.09.2016;2016;09;16;Perjantai;14;26;40
95;02.09.2016;2016;09;17;Perjantai;11;32;43
95;02.09.2016;2016;09;18;Perjantai;17;8;25
95;02.09.2016;2016;09;19;Perjantai;7;19;26
95;02.09.2016;2016;09;20;Perjantai;15;10;25
95;02.09.2016;2016;09;21;Perjantai;3;5;8
95;02.09.2016;2016;09;22;Perjantai;1;5;6
95;02.09.2016;2016;09;23;Perjantai;0;1;1
95;03.09.2016;2016;09;00;Lauantai;7;1;8
95;03.09.2016;2016;09;01;Lauantai;1;1;2
95;03.09.2016;2016;09;02;Lauantai;1;1;2
95;03.09.2016;2016;09;03;Lauantai;0;1;1
95;03.09.2016;2016;09;04;Lauantai;1;0;1
95;03.09.2016;2016;09;05;Lauantai;0;3;3
95;03.09.2016;2016;09;06;Lauantai;1;0;1
95;03.09.2016;2016;09;07;Lauantai;5;2;7
95;03.09.2016;2016;09;08;Lauantai;5;5;10
95;03.09.2016;2016;09;09;Lauantai;4;7;11
95;03.09.2016;2016;09;10;Lauantai;9;8;17
95;03.09.2016;2016;09;11;Lauantai;17;8;25
95;03.09.2016;2016;09;12;Lauantai;20;11;31
95;03.09.2016;2016;09;13;Lauantai;16;16;32
95;03.09.2016;2016;09;14;Lauantai;22;24;46
95;03.09.2016;2016;09;15;Lauantai;15;17;32
95;03.09.2016;2016;09;16;Lauantai;22;23;45
95;03.09.2016;2016;09;17;Lauantai;24;23;47
95;03.09.2016;2016;09;18;Lauantai;15;9;24
95;03.09.2016;2016;09;19;Lauantai;8;22;30
95;03.09.2016;2016;09;20;Lauantai;5;18;23
95;03.09.2016;2016;09;21;Lauantai;4;5;9
95;03.09.2016;2016;09;22;Lauantai;4;2;6
95;03.09.2016;2016;09;23;Lauantai;1;0;1
95;04.09.2016;2016;09;00;Sunnuntai;5;1;6
95;04.09.2016;2016;09;01;Sunnuntai;0;2;2
95;04.09.2016;2016;09;02;Sunnuntai;1;0;1
95;04.09.2016;2016;09;03;Sunnuntai;0;1;1
95;04.09.2016;2016;09;04;Sunnuntai;0;0;0
95;04.09.2016;2016;09;05;Sunnuntai;0;1;1
95;04.09.2016;2016;09;06;Sunnuntai;0;1;1
95;04.09.2016;2016;09;07;Sunnuntai;3;2;5
95;04.09.2016;2016;09;08;Sunnuntai;6;4;10
95;04.09.2016;2016;09;09;Sunnuntai;7;9;16
95;04.09.2016;2016;09;10;Sunnuntai;9;8;17
95;04.09.2016;2016;09;11;Sunnuntai;18;16;34
95;04.09.2016;2016;09;12;Sunnuntai;20;31;51
95;04.09.2016;2016;09;13;Sunnuntai;15;19;34
95;04.09.2016;2016;09;14;Sunnuntai;19;28;47
95;04.09.2016;2016;09;15;Sunnuntai;25;17;42
95;04.09.2016;2016;09;16;Sunnuntai;21;8;29
95;04.09.2016;2016;09;17;Sunnuntai;11;18;29
95;04.09.2016;2016;09;18;Sunnuntai;13;22;35
95;04.09.2016;2016;09;19;Sunnuntai;14;16;30
95;04.09.2016;2016;09;20;Sunnuntai;12;4;16
95;04.09.2016;2016;09;21;Sunnuntai;2;3;5
95;04.09.2016;2016;09;22;Sunnuntai;0;1;1
95;04.09.2016;2016;09;23;Sunnuntai;0;0;0
95;05.09.2016;2016;09;00;Maanantai;0;0;0
95;05.09.2016;2016;09;01;Maanantai;0;0;0
95;05.09.2016;2016;09;02;Maanantai;0;0;0
95;05.09.2016;2016;09;03;Maanantai;0;0;0
95;05.09.2016;2016;09;04;Maanantai;2;0;2
95;05.09.2016;2016;09;05;Maanantai;5;2;7
95;05.09.2016;2016;09;06;Maanantai;12;15;27
95;05.09.2016;2016;09;07;Maanantai;27;26;53
95;05.09.2016;2016;09;08;Maanantai;6;10;16
95;05.09.2016;2016;09;09;Maanantai;14;16;30
95;05.09.2016;2016;09;10;Maanantai;4;10;14
95;05.09.2016;2016;09;11;Maanantai;6;9;15
95;05.09.2016;2016;09;12;Maanantai;9;9;18
95;05.09.2016;2016;09;13;Maanantai;8;14;22
95;05.09.2016;2016;09;14;Maanantai;16;18;34
95;05.09.2016;2016;09;15;Maanantai;34;26;60
95;05.09.2016;2016;09;16;Maanantai;30;30;60
95;05.09.2016;2016;09;17;Maanantai;16;25;41
95;05.09.2016;2016;09;18;Maanantai;21;18;39
95;05.09.2016;2016;09;19;Maanantai;9;12;21
95;05.09.2016;2016;09;20;Maanantai;5;8;13
95;05.09.2016;2016;09;21;Maanantai;8;5;13
95;05.09.2016;2016;09;22;Maanantai;2;4;6
95;05.09.2016;2016;09;23;Maanantai;0;0;0
95;06.09.2016;2016;09;00;Tiistai;0;0;0
95;06.09.2016;2016;09;01;Tiistai;0;0;0
95;06.09.2016;2016;09;02;Tiistai;0;0;0
95;06.09.2016;2016;09;03;Tiistai;0;0;0
95;06.09.2016;2016;09;04;Tiistai;2;1;3
95;06.09.2016;2016;09;05;Tiistai;8;4;12
95;06.09.2016;2016;09;06;Tiistai;22;11;33
95;06.09.2016;2016;09;07;Tiistai;25;25;50
95;06.09.2016;2016;09;08;Tiistai;9;16;25
95;06.09.2016;2016;09;09;Tiistai;12;10;22
95;06.09.2016;2016;09;10;Tiistai;11;8;19
95;06.09.2016;2016;09;11;Tiistai;6;9;15
95;06.09.2016;2016;09;12;Tiistai;8;8;16
95;06.09.2016;2016;09;13;Tiistai;15;10;25
95;06.09.2016;2016;09;14;Tiistai;19;20;39
95;06.09.2016;2016;09;15;Tiistai;24;19;43
95;06.09.2016;2016;09;16;Tiistai;17;33;50
95;06.09.2016;2016;09;17;Tiistai;10;26;36
95;06.09.2016;2016;09;18;Tiistai;8;14;22
95;06.09.2016;2016;09;19;Tiistai;7;10;17
95;06.09.2016;2016;09;20;Tiistai;3;5;8
95;06.09.2016;2016;09;21;Tiistai;4;2;6
95;06.09.2016;2016;09;22;Tiistai;2;3;5
95;06.09.2016;2016;09;23;Tiistai;0;0;0
95;07.09.2016;2016;09;00;Keskiviikko;0;0;0
95;07.09.2016;2016;09;01;Keskiviikko;0;0;0
95;07.09.2016;2016;09;02;Keskiviikko;0;0;0
95;07.09.2016;2016;09;03;Keskiviikko;0;0;0
95;07.09.2016;2016;09;04;Keskiviikko;1;0;1
95;07.09.2016;2016;09;05;Keskiviikko;5;3;8
95;07.09.2016;2016;09;06;Keskiviikko;17;9;26
95;07.09.2016;2016;09;07;Keskiviikko;22;21;43
95;07.09.2016;2016;09;08;Keskiviikko;10;15;25
95;07.09.2016;2016;09;09;Keskiviikko;4;8;12
95;07.09.2016;2016;09;10;Keskiviikko;12;7;19
95;07.09.2016;2016;09;11;Keskiviikko;11;3;14
95;07.09.2016;2016;09;12;Keskiviikko;10;6;16
95;07.09.2016;2016;09;13;Keskiviikko;12;9;21
95;07.09.2016;2016;09;14;Keskiviikko;13;13;26
95;07.09.2016;2016;09;15;Keskiviikko;12;18;30
95;07.09.2016;2016;09;16;Keskiviikko;20;23;43
95;07.09.2016;2016;09;17;Keskiviikko;11;20;31
95;07.09.2016;2016;09;18;Keskiviikko;12;15;27
95;07.09.2016;2016;09;19;Keskiviikko;13;9;22
95;07.09.2016;2016;09;20;Keskiviikko;5;12;17
95;07.09.2016;2016;09;21;Keskiviikko;4;4;8
95;07.09.2016;2016;09;22;Keskiviikko;6;2;8
95;07.09.2016;2016;09;23;Keskiviikko;0;0;0
95;08.09.2016;2016;09;00;Torstai;1;0;1
95;08.09.2016;2016;09;01;Torstai;0;0;0
95;08.09.2016;2016;09;02;Torstai;0;0;0
95;08.09.2016;2016;09;03;Torstai;0;0;0
95;08.09.2016;2016;09;04;Torstai;1;1;2
95;08.09.2016;2016;09;05;Torstai;8;3;11
95;08.09.2016;2016;09;06;Torstai;18;11;29
95;08.09.2016;2016;09;07;Torstai;32;12;44
95;08.09.2016;2016;09;08;Torstai;5;14;19
95;08.09.2016;2016;09;09;Torstai;10;16;26
95;08.09.2016;2016;09;10;Torstai;10;6;16
95;08.09.2016;2016;09;11;Torstai;11;12;23
95;08.09.2016;2016;09;12;Torstai;10;7;17
95;08.09.2016;2016;09;13;Torstai;8;9;17
95;08.09.2016;2016;09;14;Torstai;13;15;28
95;08.09.2016;2016;09;15;Torstai;25;27;52
95;08.09.2016;2016;09;16;Torstai;24;35;59
95;08.09.2016;2016;09;17;Torstai;16;24;40
95;08.09.2016;2016;09;18;Torstai;2;10;12
95;08.09.2016;2016;09;19;Torstai;3;16;19
95;08.09.2016;2016;09;20;Torstai;5;14;19
95;08.09.2016;2016;09;21;Torstai;1;5;6
95;08.09.2016;2016;09;22;Torstai;3;3;6
95;08.09.2016;2016;09;23;Torstai;1;0;1
95;09.09.2016;2016;09;00;Perjantai;0;0;0
95;09.09.2016;2016;09;01;Perjantai;0;0;0
95;09.09.2016;2016;09;02;Perjantai;0;0;0
95;09.09.2016;2016;09;03;Perjantai;0;0;0
95;09.09.2016;2016;09;04;Perjantai;2;0;2
95;09.09.2016;2016;09;05;Perjantai;4;6;10
95;09.09.2016;2016;09;06;Perjantai;22;7;29
95;09.09.2016;2016;09;07;Perjantai;23;21;44
95;09.09.2016;2016;09;08;Perjantai;13;15;28
95;09.09.2016;2016;09;09;Perjantai;4;7;11
95;09.09.2016;2016;09;10;Perjantai;10;3;13
95;09.09.2016;2016;09;11;Perjantai;9;7;16
95;09.09.2016;2016;09;12;Perjantai;19;5;24
95;09.09.2016;2016;09;13;Perjantai;21;14;35
95;09.09.2016;2016;09;14;Perjantai;20;18;38
95;09.09.2016;2016;09;15;Perjantai;19;19;38
95;09.09.2016;2016;09;16;Perjantai;18;32;50
95;09.09.2016;2016;09;17;Perjantai;13;17;30
95;09.09.2016;2016;09;18;Perjantai;12;15;27
95;09.09.2016;2016;09;19;Perjantai;7;9;16
95;09.09.2016;2016;09;20;Perjantai;4;11;15
95;09.09.2016;2016;09;21;Perjantai;2;2;4
95;09.09.2016;2016;09;22;Perjantai;0;5;5
95;09.09.2016;2016;09;23;Perjantai;1;0;1
95;10.09.2016;2016;09;00;Lauantai;0;0;0
95;10.09.2016;2016;09;01;Lauantai;0;0;0
95;10.09.2016;2016;09;02;Lauantai;0;1;1
95;10.09.2016;2016;09;03;Lauantai;0;1;1
95;10.09.2016;2016;09;04;Lauantai;2;0;2
95;10.09.2016;2016;09;05;Lauantai;1;0;1
95;10.09.2016;2016;09;06;Lauantai;5;0;5
95;10.09.2016;2016;09;07;Lauantai;2;8;10
95;10.09.2016;2016;09;08;Lauantai;1;5;6
95;10.09.2016;2016;09;09;Lauantai;4;5;9
95;10.09.2016;2016;09;10;Lauantai;6;11;17
95;10.09.2016;2016;09;11;Lauantai;7;4;11
95;10.09.2016;2016;09;12;Lauantai;8;7;15
95;10.09.2016;2016;09;13;Lauantai;24;5;29
95;10.09.2016;2016;09;14;Lauantai;19;9;28
95;10.09.2016;2016;09;15;Lauantai;7;9;16
95;10.09.2016;2016;09;16;Lauantai;11;13;24
95;10.09.2016;2016;09;17;Lauantai;6;15;21
95;10.09.2016;2016;09;18;Lauantai;8;9;17
95;10.09.2016;2016;09;19;Lauantai;7;5;12
95;10.09.2016;2016;09;20;Lauantai;3;9;12
95;10.09.2016;2016;09;21;Lauantai;4;3;7
95;10.09.2016;2016;09;22;Lauantai;0;1;1
95;10.09.2016;2016;09;23;Lauantai;0;0;0
95;11.09.2016;2016;09;00;Sunnuntai;2;0;2
95;11.09.2016;2016;09;01;Sunnuntai;0;0;0
95;11.09.2016;2016;09;02;Sunnuntai;0;0;0
95;11.09.2016;2016;09;03;Sunnuntai;0;1;1
95;11.09.2016;2016;09;04;Sunnuntai;1;0;1
95;11.09.2016;2016;09;05;Sunnuntai;1;0;1
95;11.09.2016;2016;09;06;Sunnuntai;2;0;2
95;11.09.2016;2016;09;07;Sunnuntai;3;2;5
95;11.09.2016;2016;09;08;Sunnuntai;4;5;9
95;11.09.2016;2016;09;09;Sunnuntai;7;7;14
95;11.09.2016;2016;09;10;Sunnuntai;5;12;17
95;11.09.2016;2016;09;11;Sunnuntai;10;8;18
95;11.09.2016;2016;09;12;Sunnuntai;22;12;34
95;11.09.2016;2016;09;13;Sunnuntai;12;8;20
95;11.09.2016;2016;09;14;Sunnuntai;14;16;30
95;11.09.2016;2016;09;15;Sunnuntai;14;9;23
95;11.09.2016;2016;09;16;Sunnuntai;11;16;27
95;11.09.2016;2016;09;17;Sunnuntai;17;11;28
95;11.09.2016;2016;09;18;Sunnuntai;5;10;15
95;11.09.2016;2016;09;19;Sunnuntai;8;6;14
95;11.09.2016;2016;09;20;Sunnuntai;6;6;12
95;11.09.2016;2016;09;21;Sunnuntai;2;5;7
95;11.09.2016;2016;09;22;Sunnuntai;1;2;3
95;11.09.2016;2016;09;23;Sunnuntai;0;0;0
95;12.09.2016;2016;09;00;Maanantai;0;1;1
95;12.09.2016;2016;09;01;Maanantai;0;0;0
95;12.09.2016;2016;09;02;Maanantai;0;0;0
95;12.09.2016;2016;09;03;Maanantai;0;1;1
95;12.09.2016;2016;09;04;Maanantai;0;0;0
95;12.09.2016;2016;09;05;Maanantai;6;2;8
95;12.09.2016;2016;09;06;Maanantai;11;11;22
95;12.09.2016;2016;09;07;Maanantai;15;17;32
95;12.09.2016;2016;09;08;Maanantai;6;13;19
95;12.09.2016;2016;09;09;Maanantai;11;12;23
95;12.09.2016;2016;09;10;Maanantai;8;6;14
95;12.09.2016;2016;09;11;Maanantai;11;9;20
95;12.09.2016;2016;09;12;Maanantai;11;1;12
95;12.09.2016;2016;09;13;Maanantai;5;5;10
95;12.09.2016;2016;09;14;Maanantai;9;8;17
95;12.09.2016;2016;09;15;Maanantai;9;20;29
95;12.09.2016;2016;09;16;Maanantai;34;21;55
95;12.09.2016;2016;09;17;Maanantai;8;17;25
95;12.09.2016;2016;09;18;Maanantai;9;11;20
95;12.09.2016;2016;09;19;Maanantai;14;14;28
95;12.09.2016;2016;09;20;Maanantai;12;4;16
95;12.09.2016;2016;09;21;Maanantai;11;7;18
95;12.09.2016;2016;09;22;Maanantai;2;3;5
95;12.09.2016;2016;09;23;Maanantai;0;0;0
95;13.09.2016;2016;09;00;Tiistai;0;0;0
95;13.09.2016;2016;09;01;Tiistai;0;0;0
95;13.09.2016;2016;09;02;Tiistai;0;0;0
95;13.09.2016;2016;09;03;Tiistai;0;0;0
95;13.09.2016;2016;09;04;Tiistai;0;0;0
95;13.09.2016;2016;09;05;Tiistai;9;5;14
95;13.09.2016;2016;09;06;Tiistai;24;14;38
95;13.09.2016;2016;09;07;Tiistai;36;19;55
95;13.09.2016;2016;09;08;Tiistai;11;15;26
95;13.09.2016;2016;09;09;Tiistai;6;11;17
95;13.09.2016;2016;09;10;Tiistai;12;6;18
95;13.09.2016;2016;09;11;Tiistai;11;7;18
95;13.09.2016;2016;09;12;Tiistai;15;13;28
95;13.09.2016;2016;09;13;Tiistai;17;13;30
95;13.09.2016;2016;09;14;Tiistai;22;18;40
95;13.09.2016;2016;09;15;Tiistai;19;41;60
95;13.09.2016;2016;09;16;Tiistai;37;48;85
95;13.09.2016;2016;09;17;Tiistai;17;21;38
95;13.09.2016;2016;09;18;Tiistai;16;21;37
95;13.09.2016;2016;09;19;Tiistai;12;12;24
95;13.09.2016;2016;09;20;Tiistai;10;10;20
95;13.09.2016;2016;09;21;Tiistai;3;5;8
95;13.09.2016;2016;09;22;Tiistai;4;2;6
95;13.09.2016;2016;09;23;Tiistai;1;2;3
95;14.09.2016;2016;09;00;Keskiviikko;0;0;0
95;14.09.2016;2016;09;01;Keskiviikko;0;0;0
95;14.09.2016;2016;09;02;Keskiviikko;0;0;0
95;14.09.2016;2016;09;03;Keskiviikko;0;1;1
95;14.09.2016;2016;09;04;Keskiviikko;0;0;0
95;14.09.2016;2016;09;05;Keskiviikko;6;3;9
95;14.09.2016;2016;09;06;Keskiviikko;20;13;33
95;14.09.2016;2016;09;07;Keskiviikko;24;25;49
95;14.09.2016;2016;09;08;Keskiviikko;11;19;30
95;14.09.2016;2016;09;09;Keskiviikko;11;8;19
95;14.09.2016;2016;09;10;Keskiviikko;13;7;20
95;14.09.2016;2016;09;11;Keskiviikko;15;14;29
95;14.09.2016;2016;09;12;Keskiviikko;11;10;21
95;14.09.2016;2016;09;13;Keskiviikko;33;14;47
95;14.09.2016;2016;09;14;Keskiviikko;15;20;35
95;14.09.2016;2016;09;15;Keskiviikko;26;37;63
95;14.09.2016;2016;09;16;Keskiviikko;34;37;71
95;14.09.2016;2016;09;17;Keskiviikko;14;24;38
95;14.09.2016;2016;09;18;Keskiviikko;18;18;36
95;14.09.2016;2016;09;19;Keskiviikko;15;21;36
95;14.09.2016;2016;09;20;Keskiviikko;4;8;12
95;14.09.2016;2016;09;21;Keskiviikko;3;5;8
95;14.09.2016;2016;09;22;Keskiviikko;5;1;6
95;14.09.2016;2016;09;23;Keskiviikko;0;0;0
95;15.09.2016;2016;09;00;Torstai;0;0;0
95;15.09.2016;2016;09;01;Torstai;0;0;0
95;15.09.2016;2016;09;02;Torstai;0;0;0
95;15.09.2016;2016;09;03;Torstai;0;0;0
95;15.09.2016;2016;09;04;Torstai;2;1;3
95;15.09.2016;2016;09;05;Torstai;9;2;11
95;15.09.2016;2016;09;06;Torstai;13;13;26
95;15.09.2016;2016;09;07;Torstai;24;21;45
95;15.09.2016;2016;09;08;Torstai;8;12;20
95;15.09.2016;2016;09;09;Torstai;6;14;20
95;15.09.2016;2016;09;10;Torstai;9;5;14
95;15.09.2016;2016;09;11;Torstai;8;5;13
95;15.09.2016;2016;09;12;Torstai;15;6;21
95;15.09.2016;2016;09;13;Torstai;10;16;26
95;15.09.2016;2016;09;14;Torstai;12;20;32
95;15.09.2016;2016;09;15;Torstai;19;23;42
95;15.09.2016;2016;09;16;Torstai;28;24;52
95;15.09.2016;2016;09;17;Torstai;14;17;31
95;15.09.2016;2016;09;18;Torstai;12;13;25
95;15.09.2016;2016;09;19;Torstai;12;17;29
95;15.09.2016;2016;09;20;Torstai;6;2;8
95;15.09.2016;2016;09;21;Torstai;3;5;8
95;15.09.2016;2016;09;22;Torstai;1;4;5
95;15.09.2016;2016;09;23;Torstai;1;1;2
95;16.09.2016;2016;09;00;Perjantai;0;0;0
95;16.09.2016;2016;09;01;Perjantai;0;1;1
95;16.09.2016;2016;09;02;Perjantai;0;0;0
95;16.09.2016;2016;09;03;Perjantai;0;0;0
95;16.09.2016;2016;09;04;Perjantai;1;0;1
95;16.09.2016;2016;09;05;Perjantai;4;7;11
95;16.09.2016;2016;09;06;Perjantai;17;7;24
95;16.09.2016;2016;09;07;Perjantai;15;19;34
95;16.09.2016;2016;09;08;Perjantai;9;14;23
95;16.09.2016;2016;09;09;Perjantai;8;5;13
95;16.09.2016;2016;09;10;Perjantai;11;10;21
95;16.09.2016;2016;09;11;Perjantai;10;6;16
95;16.09.2016;2016;09;12;Perjantai;11;7;18
95;16.09.2016;2016;09;13;Perjantai;25;10;35
95;16.09.2016;2016;09;14;Perjantai;22;24;46
95;16.09.2016;2016;09;15;Perjantai;18;21;39
95;16.09.2016;2016;09;16;Perjantai;13;19;32
95;16.09.2016;2016;09;17;Perjantai;15;22;37
95;16.09.2016;2016;09;18;Perjantai;14;17;31
95;16.09.2016;2016;09;19;Perjantai;6;8;14
95;16.09.2016;2016;09;20;Perjantai;5;10;15
95;16.09.2016;2016;09;21;Perjantai;3;3;6
95;16.09.2016;2016;09;22;Perjantai;0;1;1
95;16.09.2016;2016;09;23;Perjantai;0;0;0
95;17.09.2016;2016;09;00;Lauantai;0;1;1
95;17.09.2016;2016;09;01;Lauantai;0;0;0
95;17.09.2016;2016;09;02;Lauantai;0;0;0
95;17.09.2016;2016;09;03;Lauantai;0;2;2
95;17.09.2016;2016;09;04;Lauantai;1;0;1
95;17.09.2016;2016;09;05;Lauantai;2;0;2
95;17.09.2016;2016;09;06;Lauantai;2;1;3
95;17.09.2016;2016;09;07;Lauantai;5;5;10
95;17.09.2016;2016;09;08;Lauantai;2;2;4
95;17.09.2016;2016;09;09;Lauantai;3;3;6
95;17.09.2016;2016;09;10;Lauantai;9;9;18
95;17.09.2016;2016;09;11;Lauantai;13;13;26
95;17.09.2016;2016;09;12;Lauantai;13;9;22
95;17.09.2016;2016;09;13;Lauantai;11;13;24
95;17.09.2016;2016;09;14;Lauantai;15;24;39
95;17.09.2016;2016;09;15;Lauantai;12;6;18
95;17.09.2016;2016;09;16;Lauantai;16;12;28
95;17.09.2016;2016;09;17;Lauantai;9;10;19
95;17.09.2016;2016;09;18;Lauantai;13;11;24
95;17.09.2016;2016;09;19;Lauantai;7;10;17
95;17.09.2016;2016;09;20;Lauantai;6;3;9
95;17.09.2016;2016;09;21;Lauantai;1;0;1
95;17.09.2016;2016;09;22;Lauantai;0;1;1
95;17.09.2016;2016;09;23;Lauantai;0;1;1
95;18.09.2016;2016;09;00;Sunnuntai;0;0;0
95;18.09.2016;2016;09;01;Sunnuntai;0;0;0
95;18.09.2016;2016;09;02;Sunnuntai;0;0;0
95;18.09.2016;2016;09;03;Sunnuntai;0;2;2
95;18.09.2016;2016;09;04;Sunnuntai;0;0;0
95;18.09.2016;2016;09;05;Sunnuntai;1;0;1
95;18.09.2016;2016;09;06;Sunnuntai;0;1;1
95;18.09.2016;2016;09;07;Sunnuntai;2;1;3
95;18.09.2016;2016;09;08;Sunnuntai;1;4;5
95;18.09.2016;2016;09;09;Sunnuntai;4;8;12
95;18.09.2016;2016;09;10;Sunnuntai;10;5;15
95;18.09.2016;2016;09;11;Sunnuntai;17;15;32
95;18.09.2016;2016;09;12;Sunnuntai;19;12;31
95;18.09.2016;2016;09;13;Sunnuntai;27;16;43
95;18.09.2016;2016;09;14;Sunnuntai;7;12;19
95;18.09.2016;2016;09;15;Sunnuntai;8;15;23
95;18.09.2016;2016;09;16;Sunnuntai;19;16;35
95;18.09.2016;2016;09;17;Sunnuntai;10;12;22
95;18.09.2016;2016;09;18;Sunnuntai;10;13;23
95;18.09.2016;2016;09;19;Sunnuntai;13;10;23
95;18.09.2016;2016;09;20;Sunnuntai;11;2;13
95;18.09.2016;2016;09;21;Sunnuntai;4;4;8
95;18.09.2016;2016;09;22;Sunnuntai;2;1;3
95;18.09.2016;2016;09;23;Sunnuntai;1;0;1
95;19.09.2016;2016;09;00;Maanantai;1;0;1
95;19.09.2016;2016;09;01;Maanantai;0;0;0
95;19.09.2016;2016;09;02;Maanantai;0;0;0
95;19.09.2016;2016;09;03;Maanantai;0;0;0
95;19.09.2016;2016;09;04;Maanantai;1;1;2
95;19.09.2016;2016;09;05;Maanantai;4;3;7
95;19.09.2016;2016;09;06;Maanantai;15;16;31
95;19.09.2016;2016;09;07;Maanantai;18;15;33
95;19.09.2016;2016;09;08;Maanantai;12;15;27
95;19.09.2016;2016;09;09;Maanantai;10;14;24
95;19.09.2016;2016;09;10;Maanantai;11;10;21
95;19.09.2016;2016;09;11;Maanantai;9;12;21
95;19.09.2016;2016;09;12;Maanantai;18;12;30
95;19.09.2016;2016;09;13;Maanantai;11;13;24
95;19.09.2016;2016;09;14;Maanantai;20;18;38
95;19.09.2016;2016;09;15;Maanantai;21;33;54
95;19.09.2016;2016;09;16;Maanantai;33;37;70
95;19.09.2016;2016;09;17;Maanantai;20;23;43
95;19.09.2016;2016;09;18;Maanantai;20;20;40
95;19.09.2016;2016;09;19;Maanantai;4;13;17
95;19.09.2016;2016;09;20;Maanantai;5;8;13
95;19.09.2016;2016;09;21;Maanantai;3;4;7
95;19.09.2016;2016;09;22;Maanantai;1;1;2
95;19.09.2016;2016;09;23;Maanantai;0;0;0
95;20.09.2016;2016;09;00;Tiistai;0;0;0
95;20.09.2016;2016;09;01;Tiistai;0;0;0
95;20.09.2016;2016;09;02;Tiistai;1;0;1
95;20.09.2016;2016;09;03;Tiistai;0;0;0
95;20.09.2016;2016;09;04;Tiistai;2;1;3
95;20.09.2016;2016;09;05;Tiistai;6;5;11
95;20.09.2016;2016;09;06;Tiistai;20;15;35
95;20.09.2016;2016;09;07;Tiistai;24;28;52
95;20.09.2016;2016;09;08;Tiistai;11;13;24
95;20.09.2016;2016;09;09;Tiistai;8;8;16
95;20.09.2016;2016;09;10;Tiistai;10;13;23
95;20.09.2016;2016;09;11;Tiistai;12;5;17
95;20.09.2016;2016;09;12;Tiistai;11;8;19
95;20.09.2016;2016;09;13;Tiistai;9;10;19
95;20.09.2016;2016;09;14;Tiistai;24;9;33
95;20.09.2016;2016;09;15;Tiistai;19;26;45
95;20.09.2016;2016;09;16;Tiistai;21;34;55
95;20.09.2016;2016;09;17;Tiistai;18;15;33
95;20.09.2016;2016;09;18;Tiistai;3;7;10
95;20.09.2016;2016;09;19;Tiistai;11;11;22
95;20.09.2016;2016;09;20;Tiistai;9;10;19
95;20.09.2016;2016;09;21;Tiistai;10;4;14
95;20.09.2016;2016;09;22;Tiistai;1;6;7
95;20.09.2016;2016;09;23;Tiistai;1;0;1
95;21.09.2016;2016;09;00;Keskiviikko;0;0;0
95;21.09.2016;2016;09;01;Keskiviikko;0;1;1
95;21.09.2016;2016;09;02;Keskiviikko;0;0;0
95;21.09.2016;2016;09;03;Keskiviikko;0;0;0
95;21.09.2016;2016;09;04;Keskiviikko;0;0;0
95;21.09.2016;2016;09;05;Keskiviikko;5;4;9
95;21.09.2016;2016;09;06;Keskiviikko;20;11;31
95;21.09.2016;2016;09;07;Keskiviikko;27;24;51
95;21.09.2016;2016;09;08;Keskiviikko;13;17;30
95;21.09.2016;2016;09;09;Keskiviikko;5;11;16
95;21.09.2016;2016;09;10;Keskiviikko;11;5;16
95;21.09.2016;2016;09;11;Keskiviikko;19;6;25
95;21.09.2016;2016;09;12;Keskiviikko;15;8;23
95;21.09.2016;2016;09;13;Keskiviikko;18;14;32
95;21.09.2016;2016;09;14;Keskiviikko;25;19;44
95;21.09.2016;2016;09;15;Keskiviikko;25;20;45
95;21.09.2016;2016;09;16;Keskiviikko;25;39;64
95;21.09.2016;2016;09;17;Keskiviikko;14;20;34
95;21.09.2016;2016;09;18;Keskiviikko;22;18;40
95;21.09.2016;2016;09;19;Keskiviikko;11;16;27
95;21.09.2016;2016;09;20;Keskiviikko;9;8;17
95;21.09.2016;2016;09;21;Keskiviikko;2;1;3
95;21.09.2016;2016;09;22;Keskiviikko;3;0;3
95;21.09.2016;2016;09;23;Keskiviikko;1;0;1
95;22.09.2016;2016;09;00;Torstai;0;0;0
95;22.09.2016;2016;09;01;Torstai;0;0;0
95;22.09.2016;2016;09;02;Torstai;0;0;0
95;22.09.2016;2016;09;03;Torstai;0;1;1
95;22.09.2016;2016;09;04;Torstai;1;2;3
95;22.09.2016;2016;09;05;Torstai;6;6;12
95;22.09.2016;2016;09;06;Torstai;17;16;33
95;22.09.2016;2016;09;07;Torstai;25;19;44
95;22.09.2016;2016;09;08;Torstai;9;12;21
95;22.09.2016;2016;09;09;Torstai;7;14;21
95;22.09.2016;2016;09;10;Torstai;13;10;23
95;22.09.2016;2016;09;11;Torstai;8;6;14
95;22.09.2016;2016;09;12;Torstai;11;11;22
95;22.09.2016;2016;09;13;Torstai;13;12;25
95;22.09.2016;2016;09;14;Torstai;14;9;23
95;22.09.2016;2016;09;15;Torstai;19;20;39
95;22.09.2016;2016;09;16;Torstai;27;37;64
95;22.09.2016;2016;09;17;Torstai;13;19;32
95;22.09.2016;2016;09;18;Torstai;11;11;22
95;22.09.2016;2016;09;19;Torstai;4;10;14
95;22.09.2016;2016;09;20;Torstai;8;4;12
95;22.09.2016;2016;09;21;Torstai;0;4;4
95;22.09.2016;2016;09;22;Torstai;2;4;6
95;22.09.2016;2016;09;23;Torstai;0;0;0
95;23.09.2016;2016;09;00;Perjantai;0;0;0
95;23.09.2016;2016;09;01;Perjantai;0;0;0
95;23.09.2016;2016;09;02;Perjantai;0;0;0
95;23.09.2016;2016;09;03;Perjantai;0;0;0
95;23.09.2016;2016;09;04;Perjantai;1;0;1
95;23.09.2016;2016;09;05;Perjantai;4;6;10
95;23.09.2016;2016;09;06;Perjantai;13;10;23
95;23.09.2016;2016;09;07;Perjantai;16;19;35
95;23.09.2016;2016;09;08;Perjantai;9;17;26
95;23.09.2016;2016;09;09;Perjantai;6;6;12
95;23.09.2016;2016;09;10;Perjantai;6;10;16
95;23.09.2016;2016;09;11;Perjantai;5;5;10
95;23.09.2016;2016;09;12;Perjantai;14;6;20
95;23.09.2016;2016;09;13;Perjantai;16;12;28
95;23.09.2016;2016;09;14;Perjantai;17;17;34
95;23.09.2016;2016;09;15;Perjantai;22;13;35
95;23.09.2016;2016;09;16;Perjantai;18;14;32
95;23.09.2016;2016;09;17;Perjantai;11;12;23
95;23.09.2016;2016;09;18;Perjantai;3;7;10
95;23.09.2016;2016;09;19;Perjantai;8;3;11
95;23.09.2016;2016;09;20;Perjantai;2;8;10
95;23.09.2016;2016;09;21;Perjantai;2;1;3
95;23.09.2016;2016;09;22;Perjantai;0;2;2
95;23.09.2016;2016;09;23;Perjantai;0;0;0
95;24.09.2016;2016;09;00;Lauantai;0;0;0
95;24.09.2016;2016;09;01;Lauantai;0;4;4
95;24.09.2016;2016;09;02;Lauantai;2;0;2
95;24.09.2016;2016;09;03;Lauantai;1;2;3
95;24.09.2016;2016;09;04;Lauantai;1;0;1
95;24.09.2016;2016;09;05;Lauantai;2;0;2
95;24.09.2016;2016;09;06;Lauantai;0;0;0
95;24.09.2016;2016;09;07;Lauantai;2;0;2
95;24.09.2016;2016;09;08;Lauantai;2;5;7
95;24.09.2016;2016;09;09;Lauantai;5;7;12
95;24.09.2016;2016;09;10;Lauantai;7;3;10
95;24.09.2016;2016;09;11;Lauantai;5;10;15
95;24.09.2016;2016;09;12;Lauantai;8;7;15
95;24.09.2016;2016;09;13;Lauantai;6;6;12
95;24.09.2016;2016;09;14;Lauantai;10;9;19
95;24.09.2016;2016;09;15;Lauantai;11;16;27
95;24.09.2016;2016;09;16;Lauantai;5;13;18
95;24.09.2016;2016;09;17;Lauantai;2;3;5
95;24.09.2016;2016;09;18;Lauantai;3;9;12
95;24.09.2016;2016;09;19;Lauantai;4;4;8
95;24.09.2016;2016;09;20;Lauantai;7;7;14
95;24.09.2016;2016;09;21;Lauantai;2;1;3
95;24.09.2016;2016;09;22;Lauantai;0;4;4
95;24.09.2016;2016;09;23;Lauantai;0;1;1
95;25.09.2016;2016;09;00;Sunnuntai;1;0;1
95;25.09.2016;2016;09;01;Sunnuntai;0;0;0
95;25.09.2016;2016;09;02;Sunnuntai;0;0;0
95;25.09.2016;2016;09;03;Sunnuntai;0;2;2
95;25.09.2016;2016;09;04;Sunnuntai;0;1;1
95;25.09.2016;2016;09;05;Sunnuntai;1;0;1
95;25.09.2016;2016;09;06;Sunnuntai;0;0;0
95;25.09.2016;2016;09;07;Sunnuntai;1;1;2
95;25.09.2016;2016;09;08;Sunnuntai;4;3;7
95;25.09.2016;2016;09;09;Sunnuntai;3;4;7
95;25.09.2016;2016;09;10;Sunnuntai;8;8;16
95;25.09.2016;2016;09;11;Sunnuntai;10;5;15
95;25.09.2016;2016;09;12;Sunnuntai;12;17;29
95;25.09.2016;2016;09;13;Sunnuntai;23;13;36
95;25.09.2016;2016;09;14;Sunnuntai;10;10;20
95;25.09.2016;2016;09;15;Sunnuntai;9;12;21
95;25.09.2016;2016;09;16;Sunnuntai;12;4;16
95;25.09.2016;2016;09;17;Sunnuntai;10;10;20
95;25.09.2016;2016;09;18;Sunnuntai;14;18;32
95;25.09.2016;2016;09;19;Sunnuntai;14;12;26
95;25.09.2016;2016;09;20;Sunnuntai;7;1;8
95;25.09.2016;2016;09;21;Sunnuntai;4;5;9
95;25.09.2016;2016;09;22;Sunnuntai;0;1;1
95;25.09.2016;2016;09;23;Sunnuntai;1;0;1
95;26.09.2016;2016;09;00;Maanantai;0;0;0
95;26.09.2016;2016;09;01;Maanantai;1;0;1
95;26.09.2016;2016;09;02;Maanantai;0;1;1
95;26.09.2016;2016;09;03;Maanantai;1;1;2
95;26.09.2016;2016;09;04;Maanantai;0;0;0
95;26.09.2016;2016;09;05;Maanantai;6;3;9
95;26.09.2016;2016;09;06;Maanantai;18;15;33
95;26.09.2016;2016;09;07;Maanantai;24;27;51
95;26.09.2016;2016;09;08;Maanantai;8;14;22
95;26.09.2016;2016;09;09;Maanantai;11;2;13
95;26.09.2016;2016;09;10;Maanantai;10;13;23
95;26.09.2016;2016;09;11;Maanantai;14;7;21
95;26.09.2016;2016;09;12;Maanantai;13;10;23
95;26.09.2016;2016;09;13;Maanantai;11;3;14
95;26.09.2016;2016;09;14;Maanantai;17;14;31
95;26.09.2016;2016;09;15;Maanantai;22;31;53
95;26.09.2016;2016;09;16;Maanantai;27;28;55
95;26.09.2016;2016;09;17;Maanantai;14;18;32
95;26.09.2016;2016;09;18;Maanantai;14;11;25
95;26.09.2016;2016;09;19;Maanantai;6;17;23
95;26.09.2016;2016;09;20;Maanantai;3;3;6
95;26.09.2016;2016;09;21;Maanantai;0;3;3
95;26.09.2016;2016;09;22;Maanantai;1;2;3
95;26.09.2016;2016;09;23;Maanantai;0;0;0
95;27.09.2016;2016;09;00;Tiistai;0;0;0
95;27.09.2016;2016;09;01;Tiistai;0;0;0
95;27.09.2016;2016;09;02;Tiistai;0;0;0
95;27.09.2016;2016;09;03;Tiistai;0;0;0
95;27.09.2016;2016;09;04;Tiistai;0;0;0
95;27.09.2016;2016;09;05;Tiistai;6;2;8
95;27.09.2016;2016;09;06;Tiistai;19;12;31
95;27.09.2016;2016;09;07;Tiistai;25;25;50
95;27.09.2016;2016;09;08;Tiistai;6;12;18
95;27.09.2016;2016;09;09;Tiistai;11;5;16
95;27.09.2016;2016;09;10;Tiistai;14;4;18
95;27.09.2016;2016;09;11;Tiistai;16;12;28
95;27.09.2016;2016;09;12;Tiistai;9;5;14
95;27.09.2016;2016;09;13;Tiistai;19;19;38
95;27.09.2016;2016;09;14;Tiistai;16;13;29
95;27.09.2016;2016;09;15;Tiistai;17;34;51
95;27.09.2016;2016;09;16;Tiistai;20;24;44
95;27.09.2016;2016;09;17;Tiistai;15;15;30
95;27.09.2016;2016;09;18;Tiistai;21;16;37
95;27.09.2016;2016;09;19;Tiistai;7;5;12
95;27.09.2016;2016;09;20;Tiistai;4;8;12
95;27.09.2016;2016;09;21;Tiistai;3;1;4
95;27.09.2016;2016;09;22;Tiistai;3;1;4
95;27.09.2016;2016;09;23;Tiistai;0;0;0
95;28.09.2016;2016;09;00;Keskiviikko;0;0;0
95;28.09.2016;2016;09;01;Keskiviikko;0;0;0
95;28.09.2016;2016;09;02;Keskiviikko;1;1;2
95;28.09.2016;2016;09;03;Keskiviikko;1;0;1
95;28.09.2016;2016;09;04;Keskiviikko;1;0;1
95;28.09.2016;2016;09;05;Keskiviikko;7;3;10
95;28.09.2016;2016;09;06;Keskiviikko;15;12;27
95;28.09.2016;2016;09;07;Keskiviikko;21;20;41
95;28.09.2016;2016;09;08;Keskiviikko;5;8;13
95;28.09.2016;2016;09;09;Keskiviikko;10;7;17
95;28.09.2016;2016;09;10;Keskiviikko;15;7;22
95;28.09.2016;2016;09;11;Keskiviikko;9;4;13
95;28.09.2016;2016;09;12;Keskiviikko;8;5;13
95;28.09.2016;2016;09;13;Keskiviikko;11;6;17
95;28.09.2016;2016;09;14;Keskiviikko;7;13;20
95;28.09.2016;2016;09;15;Keskiviikko;10;19;29
95;28.09.2016;2016;09;16;Keskiviikko;19;12;31
95;28.09.2016;2016;09;17;Keskiviikko;4;10;14
95;28.09.2016;2016;09;18;Keskiviikko;0;6;6
95;28.09.2016;2016;09;19;Keskiviikko;2;3;5
95;28.09.2016;2016;09;20;Keskiviikko;0;0;0
95;28.09.2016;2016;09;21;Keskiviikko;1;0;1
95;28.09.2016;2016;09;22;Keskiviikko;1;0;1
95;28.09.2016;2016;09;23;Keskiviikko;0;0;0
95;29.09.2016;2016;09;00;Torstai;0;0;0
95;29.09.2016;2016;09;01;Torstai;0;0;0
95;29.09.2016;2016;09;02;Torstai;0;0;0
95;29.09.2016;2016;09;03;Torstai;0;0;0
95;29.09.2016;2016;09;04;Torstai;1;0;1
95;29.09.2016;2016;09;05;Torstai;4;3;7
95;29.09.2016;2016;09;06;Torstai;19;12;31
95;29.09.2016;2016;09;07;Torstai;18;23;41
95;29.09.2016;2016;09;08;Torstai;10;9;19
95;29.09.2016;2016;09;09;Torstai;6;9;15
95;29.09.2016;2016;09;10;Torstai;13;4;17
95;29.09.2016;2016;09;11;Torstai;12;8;20
95;29.09.2016;2016;09;12;Torstai;10;10;20
95;29.09.2016;2016;09;13;Torstai;16;9;25
95;29.09.2016;2016;09;14;Torstai;15;18;33
95;29.09.2016;2016;09;15;Torstai;18;16;34
95;29.09.2016;2016;09;16;Torstai;15;22;37
95;29.09.2016;2016;09;17;Torstai;9;17;26
95;29.09.2016;2016;09;18;Torstai;4;3;7
95;29.09.2016;2016;09;19;Torstai;1;5;6
95;29.09.2016;2016;09;20;Torstai;5;1;6
95;29.09.2016;2016;09;21;Torstai;1;3;4
95;29.09.2016;2016;09;22;Torstai;1;1;2
95;29.09.2016;2016;09;23;Torstai;1;0;1
95;30.09.2016;2016;09;00;Perjantai;1;0;1
95;30.09.2016;2016;09;01;Perjantai;0;1;1
95;30.09.2016;2016;09;02;Perjantai;0;0;0
95;30.09.2016;2016;09;03;Perjantai;0;0;0
95;30.09.2016;2016;09;04;Perjantai;0;0;0
95;30.09.2016;2016;09;05;Perjantai;3;5;8
95;30.09.2016;2016;09;06;Perjantai;12;9;21
95;30.09.2016;2016;09;07;Perjantai;16;13;29
95;30.09.2016;2016;09;08;Perjantai;8;6;14
95;30.09.2016;2016;09;09;Perjantai;7;4;11
95;30.09.2016;2016;09;10;Perjantai;7;5;12
95;30.09.2016;2016;09;11;Perjantai;6;3;9
95;30.09.2016;2016;09;12;Perjantai;10;7;17
95;30.09.2016;2016;09;13;Perjantai;10;6;16
95;30.09.2016;2016;09;14;Perjantai;10;11;21
95;30.09.2016;2016;09;15;Perjantai;10;10;20
95;30.09.2016;2016;09;16;Perjantai;14;16;30
95;30.09.2016;2016;09;17;Perjantai;5;7;12
95;30.09.2016;2016;09;18;Perjantai;2;6;8
95;30.09.2016;2016;09;19;Perjantai;1;6;7
95;30.09.2016;2016;09;20;Perjantai;4;2;6
95;30.09.2016;2016;09;21;Perjantai;5;4;9
95;30.09.2016;2016;09;22;Perjantai;2;3;5
95;30.09.2016;2016;09;23;Perjantai;0;0;0
95;01.10.2016;2016;10;00;Lauantai;0;0;0
95;01.10.2016;2016;10;01;Lauantai;0;0;0
95;01.10.2016;2016;10;02;Lauantai;2;0;2
95;01.10.2016;2016;10;03;Lauantai;0;0;0
95;01.10.2016;2016;10;04;Lauantai;1;0;1
95;01.10.2016;2016;10;05;Lauantai;1;0;1
95;01.10.2016;2016;10;06;Lauantai;3;0;3
95;01.10.2016;2016;10;07;Lauantai;3;1;4
95;01.10.2016;2016;10;08;Lauantai;5;3;8
95;01.10.2016;2016;10;09;Lauantai;7;3;10
95;01.10.2016;2016;10;10;Lauantai;4;11;15
95;01.10.2016;2016;10;11;Lauantai;6;11;17
95;01.10.2016;2016;10;12;Lauantai;8;5;13
95;01.10.2016;2016;10;13;Lauantai;4;4;8
95;01.10.2016;2016;10;14;Lauantai;12;10;22
95;01.10.2016;2016;10;15;Lauantai;9;9;18
95;01.10.2016;2016;10;16;Lauantai;6;11;17
95;01.10.2016;2016;10;17;Lauantai;9;10;19
95;01.10.2016;2016;10;18;Lauantai;4;5;9
95;01.10.2016;2016;10;19;Lauantai;2;6;8
95;01.10.2016;2016;10;20;Lauantai;4;5;9
95;01.10.2016;2016;10;21;Lauantai;0;3;3
95;01.10.2016;2016;10;22;Lauantai;1;2;3
95;01.10.2016;2016;10;23;Lauantai;1;1;2
95;02.10.2016;2016;10;00;Sunnuntai;0;1;1
95;02.10.2016;2016;10;01;Sunnuntai;0;2;2
95;02.10.2016;2016;10;02;Sunnuntai;2;0;2
95;02.10.2016;2016;10;03;Sunnuntai;1;1;2
95;02.10.2016;2016;10;04;Sunnuntai;2;0;2
95;02.10.2016;2016;10;05;Sunnuntai;0;0;0
95;02.10.2016;2016;10;06;Sunnuntai;5;1;6
95;02.10.2016;2016;10;07;Sunnuntai;4;1;5
95;02.10.2016;2016;10;08;Sunnuntai;5;3;8
95;02.10.2016;2016;10;09;Sunnuntai;3;3;6
95;02.10.2016;2016;10;10;Sunnuntai;8;9;17
95;02.10.2016;2016;10;11;Sunnuntai;18;11;29
95;02.10.2016;2016;10;12;Sunnuntai;20;17;37
95;02.10.2016;2016;10;13;Sunnuntai;13;4;17
95;02.10.2016;2016;10;14;Sunnuntai;15;13;28
95;02.10.2016;2016;10;15;Sunnuntai;7;7;14
95;02.10.2016;2016;10;16;Sunnuntai;5;9;14
95;02.10.2016;2016;10;17;Sunnuntai;11;4;15
95;02.10.2016;2016;10;18;Sunnuntai;10;4;14
95;02.10.2016;2016;10;19;Sunnuntai;11;15;26
95;02.10.2016;2016;10;20;Sunnuntai;1;4;5
95;02.10.2016;2016;10;21;Sunnuntai;1;3;4
95;02.10.2016;2016;10;22;Sunnuntai;0;1;1
95;02.10.2016;2016;10;23;Sunnuntai;0;3;3
95;03.10.2016;2016;10;00;Maanantai;1;0;1
95;03.10.2016;2016;10;01;Maanantai;0;0;0
95;03.10.2016;2016;10;02;Maanantai;0;0;0
95;03.10.2016;2016;10;03;Maanantai;1;1;2
95;03.10.2016;2016;10;04;Maanantai;3;1;4
95;03.10.2016;2016;10;05;Maanantai;5;2;7
95;03.10.2016;2016;10;06;Maanantai;14;12;26
95;03.10.2016;2016;10;07;Maanantai;20;20;40
95;03.10.2016;2016;10;08;Maanantai;10;16;26
95;03.10.2016;2016;10;09;Maanantai;15;2;17
95;03.10.2016;2016;10;10;Maanantai;6;8;14
95;03.10.2016;2016;10;11;Maanantai;8;7;15
95;03.10.2016;2016;10;12;Maanantai;7;4;11
95;03.10.2016;2016;10;13;Maanantai;9;7;16
95;03.10.2016;2016;10;14;Maanantai;9;20;29
95;03.10.2016;2016;10;15;Maanantai;24;15;39
95;03.10.2016;2016;10;16;Maanantai;19;30;49
95;03.10.2016;2016;10;17;Maanantai;13;20;33
95;03.10.2016;2016;10;18;Maanantai;12;12;24
95;03.10.2016;2016;10;19;Maanantai;7;6;13
95;03.10.2016;2016;10;20;Maanantai;2;6;8
95;03.10.2016;2016;10;21;Maanantai;1;4;5
95;03.10.2016;2016;10;22;Maanantai;0;3;3
95;03.10.2016;2016;10;23;Maanantai;0;0;0
95;04.10.2016;2016;10;00;Tiistai;0;0;0
95;04.10.2016;2016;10;01;Tiistai;0;1;1
95;04.10.2016;2016;10;02;Tiistai;0;0;0
95;04.10.2016;2016;10;03;Tiistai;0;0;0
95;04.10.2016;2016;10;04;Tiistai;2;0;2
95;04.10.2016;2016;10;05;Tiistai;7;3;10
95;04.10.2016;2016;10;06;Tiistai;20;14;34
95;04.10.2016;2016;10;07;Tiistai;12;26;38
95;04.10.2016;2016;10;08;Tiistai;11;12;23
95;04.10.2016;2016;10;09;Tiistai;6;7;13
95;04.10.2016;2016;10;10;Tiistai;5;8;13
95;04.10.2016;2016;10;11;Tiistai;6;4;10
95;04.10.2016;2016;10;12;Tiistai;9;12;21
95;04.10.2016;2016;10;13;Tiistai;10;12;22
95;04.10.2016;2016;10;14;Tiistai;20;8;28
95;04.10.2016;2016;10;15;Tiistai;26;27;53
95;04.10.2016;2016;10;16;Tiistai;23;19;42
95;04.10.2016;2016;10;17;Tiistai;8;20;28
95;04.10.2016;2016;10;18;Tiistai;15;12;27
95;04.10.2016;2016;10;19;Tiistai;3;11;14
95;04.10.2016;2016;10;20;Tiistai;4;5;9
95;04.10.2016;2016;10;21;Tiistai;2;2;4
95;04.10.2016;2016;10;22;Tiistai;1;4;5
95;04.10.2016;2016;10;23;Tiistai;0;2;2
95;05.10.2016;2016;10;00;Keskiviikko;0;0;0
95;05.10.2016;2016;10;01;Keskiviikko;0;0;0
95;05.10.2016;2016;10;02;Keskiviikko;0;0;0
95;05.10.2016;2016;10;03;Keskiviikko;0;0;0
95;05.10.2016;2016;10;04;Keskiviikko;1;1;2
95;05.10.2016;2016;10;05;Keskiviikko;6;4;10
95;05.10.2016;2016;10;06;Keskiviikko;11;10;21
95;05.10.2016;2016;10;07;Keskiviikko;15;20;35
95;05.10.2016;2016;10;08;Keskiviikko;5;11;16
95;05.10.2016;2016;10;09;Keskiviikko;1;3;4
95;05.10.2016;2016;10;10;Keskiviikko;8;7;15
95;05.10.2016;2016;10;11;Keskiviikko;9;6;15
95;05.10.2016;2016;10;12;Keskiviikko;14;6;20
95;05.10.2016;2016;10;13;Keskiviikko;14;7;21
95;05.10.2016;2016;10;14;Keskiviikko;15;7;22
95;05.10.2016;2016;10;15;Keskiviikko;15;20;35
95;05.10.2016;2016;10;16;Keskiviikko;20;18;38
95;05.10.2016;2016;10;17;Keskiviikko;8;12;20
95;05.10.2016;2016;10;18;Keskiviikko;3;12;15
95;05.10.2016;2016;10;19;Keskiviikko;3;9;12
95;05.10.2016;2016;10;20;Keskiviikko;1;4;5
95;05.10.2016;2016;10;21;Keskiviikko;3;3;6
95;05.10.2016;2016;10;22;Keskiviikko;0;3;3
95;05.10.2016;2016;10;23;Keskiviikko;0;0;0
95;06.10.2016;2016;10;00;Torstai;0;0;0
95;06.10.2016;2016;10;01;Torstai;0;0;0
95;06.10.2016;2016;10;02;Torstai;0;0;0
95;06.10.2016;2016;10;03;Torstai;1;0;1
95;06.10.2016;2016;10;04;Torstai;1;0;1
95;06.10.2016;2016;10;05;Torstai;5;3;8
95;06.10.2016;2016;10;06;Torstai;12;9;21
95;06.10.2016;2016;10;07;Torstai;16;15;31
95;06.10.2016;2016;10;08;Torstai;13;13;26
95;06.10.2016;2016;10;09;Torstai;6;10;16
95;06.10.2016;2016;10;10;Torstai;8;8;16
95;06.10.2016;2016;10;11;Torstai;8;5;13
95;06.10.2016;2016;10;12;Torstai;9;11;20
95;06.10.2016;2016;10;13;Torstai;7;10;17
95;06.10.2016;2016;10;14;Torstai;8;11;19
95;06.10.2016;2016;10;15;Torstai;21;13;34
95;06.10.2016;2016;10;16;Torstai;25;26;51
95;06.10.2016;2016;10;17;Torstai;10;14;24
95;06.10.2016;2016;10;18;Torstai;8;8;16
95;06.10.2016;2016;10;19;Torstai;8;7;15
95;06.10.2016;2016;10;20;Torstai;4;2;6
95;06.10.2016;2016;10;21;Torstai;5;3;8
95;06.10.2016;2016;10;22;Torstai;2;1;3
95;06.10.2016;2016;10;23;Torstai;0;1;1
95;07.10.2016;2016;10;00;Perjantai;1;1;2
95;07.10.2016;2016;10;01;Perjantai;0;0;0
95;07.10.2016;2016;10;02;Perjantai;0;0;0
95;07.10.2016;2016;10;03;Perjantai;0;1;1
95;07.10.2016;2016;10;04;Perjantai;1;0;1
95;07.10.2016;2016;10;05;Perjantai;7;6;13
95;07.10.2016;2016;10;06;Perjantai;5;5;10
95;07.10.2016;2016;10;07;Perjantai;14;16;30
95;07.10.2016;2016;10;08;Perjantai;9;14;23
95;07.10.2016;2016;10;09;Perjantai;8;4;12
95;07.10.2016;2016;10;10;Perjantai;6;8;14
95;07.10.2016;2016;10;11;Perjantai;7;5;12
95;07.10.2016;2016;10;12;Perjantai;8;6;14
95;07.10.2016;2016;10;13;Perjantai;12;8;20
95;07.10.2016;2016;10;14;Perjantai;9;16;25
95;07.10.2016;2016;10;15;Perjantai;15;8;23
95;07.10.2016;2016;10;16;Perjantai;18;14;32
95;07.10.2016;2016;10;17;Perjantai;10;14;24
95;07.10.2016;2016;10;18;Perjantai;9;10;19
95;07.10.2016;2016;10;19;Perjantai;9;2;11
95;07.10.2016;2016;10;20;Perjantai;0;7;7
95;07.10.2016;2016;10;21;Perjantai;2;2;4
95;07.10.2016;2016;10;22;Perjantai;0;2;2
95;07.10.2016;2016;10;23;Perjantai;0;3;3
95;08.10.2016;2016;10;00;Lauantai;0;1;1
95;08.10.2016;2016;10;01;Lauantai;3;0;3
95;08.10.2016;2016;10;02;Lauantai;0;0;0
95;08.10.2016;2016;10;03;Lauantai;1;0;1
95;08.10.2016;2016;10;04;Lauantai;1;1;2
95;08.10.2016;2016;10;05;Lauantai;0;0;0
95;08.10.2016;2016;10;06;Lauantai;1;0;1
95;08.10.2016;2016;10;07;Lauantai;2;2;4
95;08.10.2016;2016;10;08;Lauantai;4;3;7
95;08.10.2016;2016;10;09;Lauantai;3;2;5
95;08.10.2016;2016;10;10;Lauantai;7;6;13
95;08.10.2016;2016;10;11;Lauantai;5;14;19
95;08.10.2016;2016;10;12;Lauantai;4;4;8
95;08.10.2016;2016;10;13;Lauantai;7;10;17
95;08.10.2016;2016;10;14;Lauantai;9;3;12
95;08.10.2016;2016;10;15;Lauantai;11;14;25
95;08.10.2016;2016;10;16;Lauantai;5;6;11
95;08.10.2016;2016;10;17;Lauantai;6;11;17
95;08.10.2016;2016;10;18;Lauantai;2;2;4
95;08.10.2016;2016;10;19;Lauantai;4;2;6
95;08.10.2016;2016;10;20;Lauantai;7;5;12
95;08.10.2016;2016;10;21;Lauantai;1;1;2
95;08.10.2016;2016;10;22;Lauantai;0;2;2
95;08.10.2016;2016;10;23;Lauantai;0;0;0
95;09.10.2016;2016;10;00;Sunnuntai;1;0;1
95;09.10.2016;2016;10;01;Sunnuntai;0;0;0
95;09.10.2016;2016;10;02;Sunnuntai;0;0;0
95;09.10.2016;2016;10;03;Sunnuntai;0;1;1
95;09.10.2016;2016;10;04;Sunnuntai;1;0;1
95;09.10.2016;2016;10;05;Sunnuntai;0;0;0
95;09.10.2016;2016;10;06;Sunnuntai;4;0;4
95;09.10.2016;2016;10;07;Sunnuntai;3;2;5
95;09.10.2016;2016;10;08;Sunnuntai;3;2;5
95;09.10.2016;2016;10;09;Sunnuntai;3;6;9
95;09.10.2016;2016;10;10;Sunnuntai;9;6;15
95;09.10.2016;2016;10;11;Sunnuntai;7;12;19
95;09.10.2016;2016;10;12;Sunnuntai;9;14;23
95;09.10.2016;2016;10;13;Sunnuntai;20;8;28
95;09.10.2016;2016;10;14;Sunnuntai;8;18;26
95;09.10.2016;2016;10;15;Sunnuntai;13;9;22
95;09.10.2016;2016;10;16;Sunnuntai;7;7;14
95;09.10.2016;2016;10;17;Sunnuntai;11;6;17
95;09.10.2016;2016;10;18;Sunnuntai;4;6;10
95;09.10.2016;2016;10;19;Sunnuntai;9;4;13
95;09.10.2016;2016;10;20;Sunnuntai;4;4;8
95;09.10.2016;2016;10;21;Sunnuntai;1;2;3
95;09.10.2016;2016;10;22;Sunnuntai;2;2;4
95;09.10.2016;2016;10;23;Sunnuntai;1;0;1
95;10.10.2016;2016;10;00;Maanantai;0;0;0
95;10.10.2016;2016;10;01;Maanantai;0;0;0
95;10.10.2016;2016;10;02;Maanantai;0;0;0
95;10.10.2016;2016;10;03;Maanantai;1;2;3
95;10.10.2016;2016;10;04;Maanantai;3;1;4
95;10.10.2016;2016;10;05;Maanantai;7;4;11
95;10.10.2016;2016;10;06;Maanantai;13;9;22
95;10.10.2016;2016;10;07;Maanantai;16;18;34
95;10.10.2016;2016;10;08;Maanantai;7;11;18
95;10.10.2016;2016;10;09;Maanantai;8;5;13
95;10.10.2016;2016;10;10;Maanantai;4;5;9
95;10.10.2016;2016;10;11;Maanantai;8;5;13
95;10.10.2016;2016;10;12;Maanantai;12;10;22
95;10.10.2016;2016;10;13;Maanantai;11;13;24
95;10.10.2016;2016;10;14;Maanantai;12;5;17
95;10.10.2016;2016;10;15;Maanantai;21;18;39
95;10.10.2016;2016;10;16;Maanantai;20;25;45
95;10.10.2016;2016;10;17;Maanantai;12;11;23
95;10.10.2016;2016;10;18;Maanantai;7;17;24
95;10.10.2016;2016;10;19;Maanantai;4;7;11
95;10.10.2016;2016;10;20;Maanantai;5;1;6
95;10.10.2016;2016;10;21;Maanantai;0;5;5
95;10.10.2016;2016;10;22;Maanantai;5;3;8
95;10.10.2016;2016;10;23;Maanantai;0;0;0
95;11.10.2016;2016;10;00;Tiistai;1;0;1
95;11.10.2016;2016;10;01;Tiistai;0;0;0
95;11.10.2016;2016;10;02;Tiistai;0;0;0
95;11.10.2016;2016;10;03;Tiistai;1;0;1
95;11.10.2016;2016;10;04;Tiistai;2;1;3
95;11.10.2016;2016;10;05;Tiistai;4;3;7
95;11.10.2016;2016;10;06;Tiistai;19;9;28
95;11.10.2016;2016;10;07;Tiistai;17;19;36
95;11.10.2016;2016;10;08;Tiistai;9;13;22
95;11.10.2016;2016;10;09;Tiistai;8;10;18
95;11.10.2016;2016;10;10;Tiistai;7;5;12
95;11.10.2016;2016;10;11;Tiistai;13;8;21
95;11.10.2016;2016;10;12;Tiistai;10;6;16
95;11.10.2016;2016;10;13;Tiistai;13;8;21
95;11.10.2016;2016;10;14;Tiistai;14;10;24
95;11.10.2016;2016;10;15;Tiistai;18;18;36
95;11.10.2016;2016;10;16;Tiistai;15;25;40
95;11.10.2016;2016;10;17;Tiistai;6;15;21
95;11.10.2016;2016;10;18;Tiistai;11;7;18
95;11.10.2016;2016;10;19;Tiistai;3;8;11
95;11.10.2016;2016;10;20;Tiistai;6;6;12
95;11.10.2016;2016;10;21;Tiistai;1;4;5
95;11.10.2016;2016;10;22;Tiistai;1;1;2
95;11.10.2016;2016;10;23;Tiistai;1;0;1
95;12.10.2016;2016;10;00;Keskiviikko;0;0;0
95;12.10.2016;2016;10;01;Keskiviikko;0;0;0
95;12.10.2016;2016;10;02;Keskiviikko;0;0;0
95;12.10.2016;2016;10;03;Keskiviikko;0;0;0
95;12.10.2016;2016;10;04;Keskiviikko;2;0;2
95;12.10.2016;2016;10;05;Keskiviikko;4;2;6
95;12.10.2016;2016;10;06;Keskiviikko;14;12;26
95;12.10.2016;2016;10;07;Keskiviikko;21;17;38
95;12.10.2016;2016;10;08;Keskiviikko;8;9;17
95;12.10.2016;2016;10;09;Keskiviikko;9;2;11
95;12.10.2016;2016;10;10;Keskiviikko;4;6;10
95;12.10.2016;2016;10;11;Keskiviikko;5;10;15
95;12.10.2016;2016;10;12;Keskiviikko;3;4;7
95;12.10.2016;2016;10;13;Keskiviikko;15;6;21
95;12.10.2016;2016;10;14;Keskiviikko;18;13;31
95;12.10.2016;2016;10;15;Keskiviikko;17;17;34
95;12.10.2016;2016;10;16;Keskiviikko;15;23;38
95;12.10.2016;2016;10;17;Keskiviikko;9;20;29
95;12.10.2016;2016;10;18;Keskiviikko;7;6;13
95;12.10.2016;2016;10;19;Keskiviikko;6;7;13
95;12.10.2016;2016;10;20;Keskiviikko;1;3;4
95;12.10.2016;2016;10;21;Keskiviikko;3;2;5
95;12.10.2016;2016;10;22;Keskiviikko;1;3;4
95;12.10.2016;2016;10;23;Keskiviikko;0;0;0
95;13.10.2016;2016;10;00;Torstai;0;0;0
95;13.10.2016;2016;10;01;Torstai;0;0;0
95;13.10.2016;2016;10;02;Torstai;0;0;0
95;13.10.2016;2016;10;03;Torstai;0;0;0
95;13.10.2016;2016;10;04;Torstai;3;0;3
95;13.10.2016;2016;10;05;Torstai;6;7;13
95;13.10.2016;2016;10;06;Torstai;14;13;27
95;13.10.2016;2016;10;07;Torstai;21;15;36
95;13.10.2016;2016;10;08;Torstai;14;12;26
95;13.10.2016;2016;10;09;Torstai;5;3;8
95;13.10.2016;2016;10;10;Torstai;2;5;7
95;13.10.2016;2016;10;11;Torstai;7;9;16
95;13.10.2016;2016;10;12;Torstai;11;6;17
95;13.10.2016;2016;10;13;Torstai;20;11;31
95;13.10.2016;2016;10;14;Torstai;9;19;28
95;13.10.2016;2016;10;15;Torstai;19;21;40
95;13.10.2016;2016;10;16;Torstai;20;20;40
95;13.10.2016;2016;10;17;Torstai;9;10;19
95;13.10.2016;2016;10;18;Torstai;7;11;18
95;13.10.2016;2016;10;19;Torstai;3;3;6
95;13.10.2016;2016;10;20;Torstai;2;1;3
95;13.10.2016;2016;10;21;Torstai;1;6;7
95;13.10.2016;2016;10;22;Torstai;3;3;6
95;13.10.2016;2016;10;23;Torstai;1;0;1
95;14.10.2016;2016;10;00;Perjantai;1;0;1
95;14.10.2016;2016;10;01;Perjantai;0;0;0
95;14.10.2016;2016;10;02;Perjantai;0;0;0
95;14.10.2016;2016;10;03;Perjantai;0;1;1
95;14.10.2016;2016;10;04;Perjantai;2;0;2
95;14.10.2016;2016;10;05;Perjantai;3;3;6
95;14.10.2016;2016;10;06;Perjantai;12;5;17
95;14.10.2016;2016;10;07;Perjantai;18;15;33
95;14.10.2016;2016;10;08;Perjantai;13;8;21
95;14.10.2016;2016;10;09;Perjantai;9;6;15
95;14.10.2016;2016;10;10;Perjantai;1;4;5
95;14.10.2016;2016;10;11;Perjantai;11;6;17
95;14.10.2016;2016;10;12;Perjantai;10;7;17
95;14.10.2016;2016;10;13;Perjantai;7;11;18
95;14.10.2016;2016;10;14;Perjantai;12;7;19
95;14.10.2016;2016;10;15;Perjantai;13;15;28
95;14.10.2016;2016;10;16;Perjantai;10;19;29
95;14.10.2016;2016;10;17;Perjantai;7;10;17
95;14.10.2016;2016;10;18;Perjantai;5;5;10
95;14.10.2016;2016;10;19;Perjantai;3;5;8
95;14.10.2016;2016;10;20;Perjantai;1;0;1
95;14.10.2016;2016;10;21;Perjantai;0;3;3
95;14.10.2016;2016;10;22;Perjantai;0;2;2
95;14.10.2016;2016;10;23;Perjantai;1;2;3
95;15.10.2016;2016;10;00;Lauantai;0;1;1
95;15.10.2016;2016;10;01;Lauantai;0;0;0
95;15.10.2016;2016;10;02;Lauantai;0;0;0
95;15.10.2016;2016;10;03;Lauantai;1;1;2
95;15.10.2016;2016;10;04;Lauantai;0;1;1
95;15.10.2016;2016;10;05;Lauantai;2;0;2
95;15.10.2016;2016;10;06;Lauantai;0;0;0
95;15.10.2016;2016;10;07;Lauantai;3;1;4
95;15.10.2016;2016;10;08;Lauantai;3;1;4
95;15.10.2016;2016;10;09;Lauantai;2;6;8
95;15.10.2016;2016;10;10;Lauantai;7;1;8
95;15.10.2016;2016;10;11;Lauantai;4;5;9
95;15.10.2016;2016;10;12;Lauantai;11;2;13
95;15.10.2016;2016;10;13;Lauantai;6;11;17
95;15.10.2016;2016;10;14;Lauantai;1;8;9
95;15.10.2016;2016;10;15;Lauantai;11;8;19
95;15.10.2016;2016;10;16;Lauantai;3;4;7
95;15.10.2016;2016;10;17;Lauantai;6;8;14
95;15.10.2016;2016;10;18;Lauantai;3;5;8
95;15.10.2016;2016;10;19;Lauantai;2;0;2
95;15.10.2016;2016;10;20;Lauantai;3;5;8
95;15.10.2016;2016;10;21;Lauantai;2;2;4
95;15.10.2016;2016;10;22;Lauantai;1;1;2
95;15.10.2016;2016;10;23;Lauantai;0;1;1
95;16.10.2016;2016;10;00;Sunnuntai;0;0;0
95;16.10.2016;2016;10;01;Sunnuntai;0;0;0
95;16.10.2016;2016;10;02;Sunnuntai;0;0;0
95;16.10.2016;2016;10;03;Sunnuntai;0;1;1
95;16.10.2016;2016;10;04;Sunnuntai;0;0;0
95;16.10.2016;2016;10;05;Sunnuntai;1;0;1
95;16.10.2016;2016;10;06;Sunnuntai;2;0;2
95;16.10.2016;2016;10;07;Sunnuntai;0;1;1
95;16.10.2016;2016;10;08;Sunnuntai;3;4;7
95;16.10.2016;2016;10;09;Sunnuntai;2;0;2
95;16.10.2016;2016;10;10;Sunnuntai;2;5;7
95;16.10.2016;2016;10;11;Sunnuntai;7;3;10
95;16.10.2016;2016;10;12;Sunnuntai;5;8;13
95;16.10.2016;2016;10;13;Sunnuntai;4;0;4
95;16.10.2016;2016;10;14;Sunnuntai;4;8;12
95;16.10.2016;2016;10;15;Sunnuntai;4;5;9
95;16.10.2016;2016;10;16;Sunnuntai;5;4;9
95;16.10.2016;2016;10;17;Sunnuntai;3;2;5
95;16.10.2016;2016;10;18;Sunnuntai;3;10;13
95;16.10.2016;2016;10;19;Sunnuntai;6;4;10
95;16.10.2016;2016;10;20;Sunnuntai;5;2;7
95;16.10.2016;2016;10;21;Sunnuntai;1;2;3
95;16.10.2016;2016;10;22;Sunnuntai;0;2;2
95;16.10.2016;2016;10;23;Sunnuntai;0;1;1
95;17.10.2016;2016;10;00;Maanantai;0;1;1
95;17.10.2016;2016;10;01;Maanantai;0;0;0
95;17.10.2016;2016;10;02;Maanantai;0;0;0
95;17.10.2016;2016;10;03;Maanantai;0;1;1
95;17.10.2016;2016;10;04;Maanantai;1;0;1
95;17.10.2016;2016;10;05;Maanantai;6;3;9
95;17.10.2016;2016;10;06;Maanantai;13;13;26
95;17.10.2016;2016;10;07;Maanantai;14;11;25
95;17.10.2016;2016;10;08;Maanantai;8;16;24
95;17.10.2016;2016;10;09;Maanantai;8;10;18
95;17.10.2016;2016;10;10;Maanantai;6;4;10
95;17.10.2016;2016;10;11;Maanantai;6;6;12
95;17.10.2016;2016;10;12;Maanantai;9;8;17
95;17.10.2016;2016;10;13;Maanantai;11;4;15
95;17.10.2016;2016;10;14;Maanantai;9;13;22
95;17.10.2016;2016;10;15;Maanantai;15;17;32
95;17.10.2016;2016;10;16;Maanantai;24;19;43
95;17.10.2016;2016;10;17;Maanantai;12;10;22
95;17.10.2016;2016;10;18;Maanantai;2;8;10
95;17.10.2016;2016;10;19;Maanantai;1;5;6
95;17.10.2016;2016;10;20;Maanantai;3;7;10
95;17.10.2016;2016;10;21;Maanantai;2;4;6
95;17.10.2016;2016;10;22;Maanantai;3;0;3
95;17.10.2016;2016;10;23;Maanantai;0;0;0
95;18.10.2016;2016;10;00;Tiistai;1;1;2
95;18.10.2016;2016;10;01;Tiistai;0;0;0
95;18.10.2016;2016;10;02;Tiistai;0;0;0
95;18.10.2016;2016;10;03;Tiistai;0;0;0
95;18.10.2016;2016;10;04;Tiistai;1;0;1
95;18.10.2016;2016;10;05;Tiistai;6;5;11
95;18.10.2016;2016;10;06;Tiistai;13;13;26
95;18.10.2016;2016;10;07;Tiistai;16;18;34
95;18.10.2016;2016;10;08;Tiistai;9;11;20
95;18.10.2016;2016;10;09;Tiistai;9;7;16
95;18.10.2016;2016;10;10;Tiistai;6;2;8
95;18.10.2016;2016;10;11;Tiistai;9;7;16
95;18.10.2016;2016;10;12;Tiistai;8;9;17
95;18.10.2016;2016;10;13;Tiistai;6;12;18
95;18.10.2016;2016;10;14;Tiistai;20;7;27
95;18.10.2016;2016;10;15;Tiistai;21;20;41
95;18.10.2016;2016;10;16;Tiistai;22;15;37
95;18.10.2016;2016;10;17;Tiistai;8;19;27
95;18.10.2016;2016;10;18;Tiistai;8;17;25
95;18.10.2016;2016;10;19;Tiistai;8;5;13
95;18.10.2016;2016;10;20;Tiistai;4;8;12
95;18.10.2016;2016;10;21;Tiistai;1;1;2
95;18.10.2016;2016;10;22;Tiistai;3;0;3
95;18.10.2016;2016;10;23;Tiistai;0;0;0
95;19.10.2016;2016;10;00;Keskiviikko;1;0;1
95;19.10.2016;2016;10;01;Keskiviikko;0;0;0
95;19.10.2016;2016;10;02;Keskiviikko;0;0;0
95;19.10.2016;2016;10;03;Keskiviikko;2;0;2
95;19.10.2016;2016;10;04;Keskiviikko;2;0;2
95;19.10.2016;2016;10;05;Keskiviikko;7;3;10
95;19.10.2016;2016;10;06;Keskiviikko;15;12;27
95;19.10.2016;2016;10;07;Keskiviikko;15;14;29
95;19.10.2016;2016;10;08;Keskiviikko;12;11;23
95;19.10.2016;2016;10;09;Keskiviikko;8;8;16
95;19.10.2016;2016;10;10;Keskiviikko;7;7;14
95;19.10.2016;2016;10;11;Keskiviikko;10;7;17
95;19.10.2016;2016;10;12;Keskiviikko;6;4;10
95;19.10.2016;2016;10;13;Keskiviikko;14;8;22
95;19.10.2016;2016;10;14;Keskiviikko;9;5;14
95;19.10.2016;2016;10;15;Keskiviikko;19;16;35
95;19.10.2016;2016;10;16;Keskiviikko;19;21;40
95;19.10.2016;2016;10;17;Keskiviikko;9;10;19
95;19.10.2016;2016;10;18;Keskiviikko;5;8;13
95;19.10.2016;2016;10;19;Keskiviikko;7;8;15
95;19.10.2016;2016;10;20;Keskiviikko;4;7;11
95;19.10.2016;2016;10;21;Keskiviikko;1;0;1
95;19.10.2016;2016;10;22;Keskiviikko;2;2;4
95;19.10.2016;2016;10;23;Keskiviikko;0;0;0
95;20.10.2016;2016;10;00;Torstai;2;2;4
95;20.10.2016;2016;10;01;Torstai;0;0;0
95;20.10.2016;2016;10;02;Torstai;0;0;0
95;20.10.2016;2016;10;03;Torstai;0;0;0
95;20.10.2016;2016;10;04;Torstai;3;1;4
95;20.10.2016;2016;10;05;Torstai;5;3;8
95;20.10.2016;2016;10;06;Torstai;13;9;22
95;20.10.2016;2016;10;07;Torstai;16;12;28
95;20.10.2016;2016;10;08;Torstai;10;14;24
95;20.10.2016;2016;10;09;Torstai;4;5;9
95;20.10.2016;2016;10;10;Torstai;11;7;18
95;20.10.2016;2016;10;11;Torstai;6;2;8
95;20.10.2016;2016;10;12;Torstai;5;7;12
95;20.10.2016;2016;10;13;Torstai;4;10;14
95;20.10.2016;2016;10;14;Torstai;15;8;23
95;20.10.2016;2016;10;15;Torstai;17;19;36
95;20.10.2016;2016;10;16;Torstai;20;23;43
95;20.10.2016;2016;10;17;Torstai;11;7;18
95;20.10.2016;2016;10;18;Torstai;7;7;14
95;20.10.2016;2016;10;19;Torstai;5;4;9
95;20.10.2016;2016;10;20;Torstai;3;6;9
95;20.10.2016;2016;10;21;Torstai;2;3;5
95;20.10.2016;2016;10;22;Torstai;1;5;6
95;20.10.2016;2016;10;23;Torstai;0;0;0
95;21.10.2016;2016;10;00;Perjantai;0;0;0
95;21.10.2016;2016;10;01;Perjantai;0;1;1
95;21.10.2016;2016;10;02;Perjantai;0;0;0
95;21.10.2016;2016;10;03;Perjantai;0;2;2
95;21.10.2016;2016;10;04;Perjantai;1;0;1
95;21.10.2016;2016;10;05;Perjantai;6;5;11
95;21.10.2016;2016;10;06;Perjantai;10;5;15
95;21.10.2016;2016;10;07;Perjantai;15;12;27
95;21.10.2016;2016;10;08;Perjantai;3;7;10
95;21.10.2016;2016;10;09;Perjantai;6;4;10
95;21.10.2016;2016;10;10;Perjantai;9;5;14
95;21.10.2016;2016;10;11;Perjantai;7;8;15
95;21.10.2016;2016;10;12;Perjantai;14;12;26
95;21.10.2016;2016;10;13;Perjantai;16;6;22
95;21.10.2016;2016;10;14;Perjantai;12;10;22
95;21.10.2016;2016;10;15;Perjantai;15;7;22
95;21.10.2016;2016;10;16;Perjantai;10;17;27
95;21.10.2016;2016;10;17;Perjantai;8;12;20
95;21.10.2016;2016;10;18;Perjantai;6;6;12
95;21.10.2016;2016;10;19;Perjantai;3;6;9
95;21.10.2016;2016;10;20;Perjantai;3;6;9
95;21.10.2016;2016;10;21;Perjantai;4;8;12
95;21.10.2016;2016;10;22;Perjantai;0;2;2
95;21.10.2016;2016;10;23;Perjantai;0;0;0
95;22.10.2016;2016;10;00;Lauantai;0;0;0
95;22.10.2016;2016;10;01;Lauantai;0;0;0
95;22.10.2016;2016;10;02;Lauantai;0;0;0
95;22.10.2016;2016;10;03;Lauantai;0;1;1
95;22.10.2016;2016;10;04;Lauantai;0;0;0
95;22.10.2016;2016;10;05;Lauantai;0;2;2
95;22.10.2016;2016;10;06;Lauantai;0;0;0
95;22.10.2016;2016;10;07;Lauantai;1;3;4
95;22.10.2016;2016;10;08;Lauantai;4;5;9
95;22.10.2016;2016;10;09;Lauantai;8;8;16
95;22.10.2016;2016;10;10;Lauantai;3;8;11
95;22.10.2016;2016;10;11;Lauantai;8;8;16
95;22.10.2016;2016;10;12;Lauantai;8;12;20
95;22.10.2016;2016;10;13;Lauantai;8;6;14
95;22.10.2016;2016;10;14;Lauantai;8;5;13
95;22.10.2016;2016;10;15;Lauantai;5;9;14
95;22.10.2016;2016;10;16;Lauantai;6;6;12
95;22.10.2016;2016;10;17;Lauantai;3;5;8
95;22.10.2016;2016;10;18;Lauantai;4;2;6
95;22.10.2016;2016;10;19;Lauantai;5;0;5
95;22.10.2016;2016;10;20;Lauantai;1;0;1
95;22.10.2016;2016;10;21;Lauantai;2;1;3
95;22.10.2016;2016;10;22;Lauantai;0;1;1
95;22.10.2016;2016;10;23;Lauantai;0;1;1
95;23.10.2016;2016;10;00;Sunnuntai;0;1;1
95;23.10.2016;2016;10;01;Sunnuntai;0;1;1
95;23.10.2016;2016;10;02;Sunnuntai;0;0;0
95;23.10.2016;2016;10;03;Sunnuntai;1;0;1
95;23.10.2016;2016;10;04;Sunnuntai;1;1;2
95;23.10.2016;2016;10;05;Sunnuntai;0;1;1
95;23.10.2016;2016;10;06;Sunnuntai;1;0;1
95;23.10.2016;2016;10;07;Sunnuntai;2;1;3
95;23.10.2016;2016;10;08;Sunnuntai;3;1;4
95;23.10.2016;2016;10;09;Sunnuntai;3;1;4
95;23.10.2016;2016;10;10;Sunnuntai;6;2;8
95;23.10.2016;2016;10;11;Sunnuntai;5;5;10
95;23.10.2016;2016;10;12;Sunnuntai;6;6;12
95;23.10.2016;2016;10;13;Sunnuntai;3;9;12
95;23.10.2016;2016;10;14;Sunnuntai;10;9;19
95;23.10.2016;2016;10;15;Sunnuntai;8;6;14
95;23.10.2016;2016;10;16;Sunnuntai;3;3;6
95;23.10.2016;2016;10;17;Sunnuntai;4;2;6
95;23.10.2016;2016;10;18;Sunnuntai;9;5;14
95;23.10.2016;2016;10;19;Sunnuntai;4;5;9
95;23.10.2016;2016;10;20;Sunnuntai;3;2;5
95;23.10.2016;2016;10;21;Sunnuntai;3;2;5
95;23.10.2016;2016;10;22;Sunnuntai;0;4;4
95;23.10.2016;2016;10;23;Sunnuntai;0;1;1
95;24.10.2016;2016;10;00;Maanantai;0;0;0
95;24.10.2016;2016;10;01;Maanantai;0;1;1
95;24.10.2016;2016;10;02;Maanantai;0;0;0
95;24.10.2016;2016;10;03;Maanantai;1;0;1
95;24.10.2016;2016;10;04;Maanantai;2;0;2
95;24.10.2016;2016;10;05;Maanantai;7;4;11
95;24.10.2016;2016;10;06;Maanantai;13;9;22
95;24.10.2016;2016;10;07;Maanantai;9;8;17
95;24.10.2016;2016;10;08;Maanantai;6;7;13
95;24.10.2016;2016;10;09;Maanantai;8;6;14
95;24.10.2016;2016;10;10;Maanantai;5;4;9
95;24.10.2016;2016;10;11;Maanantai;8;6;14
95;24.10.2016;2016;10;12;Maanantai;6;4;10
95;24.10.2016;2016;10;13;Maanantai;7;6;13
95;24.10.2016;2016;10;14;Maanantai;9;7;16
95;24.10.2016;2016;10;15;Maanantai;14;13;27
95;24.10.2016;2016;10;16;Maanantai;11;23;34
95;24.10.2016;2016;10;17;Maanantai;8;11;19
95;24.10.2016;2016;10;18;Maanantai;8;16;24
95;24.10.2016;2016;10;19;Maanantai;2;4;6
95;24.10.2016;2016;10;20;Maanantai;2;1;3
95;24.10.2016;2016;10;21;Maanantai;1;1;2
95;24.10.2016;2016;10;22;Maanantai;2;2;4
95;24.10.2016;2016;10;23;Maanantai;0;0;0
95;25.10.2016;2016;10;00;Tiistai;0;0;0
95;25.10.2016;2016;10;01;Tiistai;0;0;0
95;25.10.2016;2016;10;02;Tiistai;0;0;0
95;25.10.2016;2016;10;03;Tiistai;0;0;0
95;25.10.2016;2016;10;04;Tiistai;1;0;1
95;25.10.2016;2016;10;05;Tiistai;7;5;12
95;25.10.2016;2016;10;06;Tiistai;9;10;19
95;25.10.2016;2016;10;07;Tiistai;13;9;22
95;25.10.2016;2016;10;08;Tiistai;4;5;9
95;25.10.2016;2016;10;09;Tiistai;2;7;9
95;25.10.2016;2016;10;10;Tiistai;10;4;14
95;25.10.2016;2016;10;11;Tiistai;5;3;8
95;25.10.2016;2016;10;12;Tiistai;9;9;18
95;25.10.2016;2016;10;13;Tiistai;3;2;5
95;25.10.2016;2016;10;14;Tiistai;7;6;13
95;25.10.2016;2016;10;15;Tiistai;16;9;25
95;25.10.2016;2016;10;16;Tiistai;16;16;32
95;25.10.2016;2016;10;17;Tiistai;9;11;20
95;25.10.2016;2016;10;18;Tiistai;6;3;9
95;25.10.2016;2016;10;19;Tiistai;9;5;14
95;25.10.2016;2016;10;20;Tiistai;2;5;7
95;25.10.2016;2016;10;21;Tiistai;4;2;6
95;25.10.2016;2016;10;22;Tiistai;2;3;5
95;25.10.2016;2016;10;23;Tiistai;2;0;2
95;26.10.2016;2016;10;00;Keskiviikko;0;0;0
95;26.10.2016;2016;10;01;Keskiviikko;0;0;0
95;26.10.2016;2016;10;02;Keskiviikko;0;1;1
95;26.10.2016;2016;10;03;Keskiviikko;2;1;3
95;26.10.2016;2016;10;04;Keskiviikko;1;0;1
95;26.10.2016;2016;10;05;Keskiviikko;5;6;11
95;26.10.2016;2016;10;06;Keskiviikko;10;7;17
95;26.10.2016;2016;10;07;Keskiviikko;5;8;13
95;26.10.2016;2016;10;08;Keskiviikko;6;4;10
95;26.10.2016;2016;10;09;Keskiviikko;1;2;3
95;26.10.2016;2016;10;10;Keskiviikko;3;1;4
95;26.10.2016;2016;10;11;Keskiviikko;2;2;4
95;26.10.2016;2016;10;12;Keskiviikko;7;2;9
95;26.10.2016;2016;10;13;Keskiviikko;6;4;10
95;26.10.2016;2016;10;14;Keskiviikko;4;4;8
95;26.10.2016;2016;10;15;Keskiviikko;9;13;22
95;26.10.2016;2016;10;16;Keskiviikko;12;4;16
95;26.10.2016;2016;10;17;Keskiviikko;10;11;21
95;26.10.2016;2016;10;18;Keskiviikko;1;5;6
95;26.10.2016;2016;10;19;Keskiviikko;3;5;8
95;26.10.2016;2016;10;20;Keskiviikko;3;2;5
95;26.10.2016;2016;10;21;Keskiviikko;0;5;5
95;26.10.2016;2016;10;22;Keskiviikko;0;1;1
95;26.10.2016;2016;10;23;Keskiviikko;0;0;0
95;27.10.2016;2016;10;00;Torstai;1;1;2
95;27.10.2016;2016;10;01;Torstai;0;0;0
95;27.10.2016;2016;10;02;Torstai;0;0;0
95;27.10.2016;2016;10;03;Torstai;0;1;1
95;27.10.2016;2016;10;04;Torstai;1;0;1
95;27.10.2016;2016;10;05;Torstai;5;6;11
95;27.10.2016;2016;10;06;Torstai;7;8;15
95;27.10.2016;2016;10;07;Torstai;5;7;12
95;27.10.2016;2016;10;08;Torstai;3;3;6
95;27.10.2016;2016;10;09;Torstai;2;0;2
95;27.10.2016;2016;10;10;Torstai;5;1;6
95;27.10.2016;2016;10;11;Torstai;5;3;8
95;27.10.2016;2016;10;12;Torstai;2;2;4
95;27.10.2016;2016;10;13;Torstai;6;5;11
95;27.10.2016;2016;10;14;Torstai;3;5;8
95;27.10.2016;2016;10;15;Torstai;13;8;21
95;27.10.2016;2016;10;16;Torstai;12;5;17
95;27.10.2016;2016;10;17;Torstai;6;2;8
95;27.10.2016;2016;10;18;Torstai;3;8;11
95;27.10.2016;2016;10;19;Torstai;1;0;1
95;27.10.2016;2016;10;20;Torstai;4;2;6
95;27.10.2016;2016;10;21;Torstai;0;1;1
95;27.10.2016;2016;10;22;Torstai;1;2;3
95;27.10.2016;2016;10;23;Torstai;0;0;0
95;28.10.2016;2016;10;00;Perjantai;0;0;0
95;28.10.2016;2016;10;01;Perjantai;0;0;0
95;28.10.2016;2016;10;02;Perjantai;0;0;0
95;28.10.2016;2016;10;03;Perjantai;0;0;0
95;28.10.2016;2016;10;04;Perjantai;0;0;0
95;28.10.2016;2016;10;05;Perjantai;5;5;10
95;28.10.2016;2016;10;06;Perjantai;8;6;14
95;28.10.2016;2016;10;07;Perjantai;2;6;8
95;28.10.2016;2016;10;08;Perjantai;2;0;2
95;28.10.2016;2016;10;09;Perjantai;1;4;5
95;28.10.2016;2016;10;10;Perjantai;2;1;3
95;28.10.2016;2016;10;11;Perjantai;4;2;6
95;28.10.2016;2016;10;12;Perjantai;9;3;12
95;28.10.2016;2016;10;13;Perjantai;4;4;8
95;28.10.2016;2016;10;14;Perjantai;8;7;15
95;28.10.2016;2016;10;15;Perjantai;9;9;18
95;28.10.2016;2016;10;16;Perjantai;6;5;11
95;28.10.2016;2016;10;17;Perjantai;5;9;14
95;28.10.2016;2016;10;18;Perjantai;3;4;7
95;28.10.2016;2016;10;19;Perjantai;1;4;5
95;28.10.2016;2016;10;20;Perjantai;6;2;8
95;28.10.2016;2016;10;21;Perjantai;1;7;8
95;28.10.2016;2016;10;22;Perjantai;0;1;1
95;28.10.2016;2016;10;23;Perjantai;0;1;1
95;29.10.2016;2016;10;00;Lauantai;1;0;1
95;29.10.2016;2016;10;01;Lauantai;0;0;0
95;29.10.2016;2016;10;02;Lauantai;0;0;0
95;29.10.2016;2016;10;03;Lauantai;0;0;0
95;29.10.2016;2016;10;04;Lauantai;2;0;2
95;29.10.2016;2016;10;05;Lauantai;0;0;0
95;29.10.2016;2016;10;06;Lauantai;1;0;1
95;29.10.2016;2016;10;07;Lauantai;2;3;5
95;29.10.2016;2016;10;08;Lauantai;4;3;7
95;29.10.2016;2016;10;09;Lauantai;3;1;4
95;29.10.2016;2016;10;10;Lauantai;5;3;8
95;29.10.2016;2016;10;11;Lauantai;5;6;11
95;29.10.2016;2016;10;12;Lauantai;6;8;14
95;29.10.2016;2016;10;13;Lauantai;5;8;13
95;29.10.2016;2016;10;14;Lauantai;6;6;12
95;29.10.2016;2016;10;15;Lauantai;10;11;21
95;29.10.2016;2016;10;16;Lauantai;7;4;11
95;29.10.2016;2016;10;17;Lauantai;3;2;5
95;29.10.2016;2016;10;18;Lauantai;2;0;2
95;29.10.2016;2016;10;19;Lauantai;3;1;4
95;29.10.2016;2016;10;20;Lauantai;4;2;6
95;29.10.2016;2016;10;21;Lauantai;3;2;5
95;29.10.2016;2016;10;22;Lauantai;0;2;2
95;29.10.2016;2016;10;23;Lauantai;0;1;1
95;30.10.2016;2016;10;00;Sunnuntai;0;2;2
95;30.10.2016;2016;10;01;Sunnuntai;0;0;0
95;30.10.2016;2016;10;02;Sunnuntai;0;0;0
95;30.10.2016;2016;10;03;Sunnuntai;0;0;0
95;30.10.2016;2016;10;04;Sunnuntai;1;0;1
95;30.10.2016;2016;10;05;Sunnuntai;1;1;2
95;30.10.2016;2016;10;06;Sunnuntai;0;0;0
95;30.10.2016;2016;10;07;Sunnuntai;1;1;2
95;30.10.2016;2016;10;08;Sunnuntai;2;3;5
95;30.10.2016;2016;10;09;Sunnuntai;5;2;7
95;30.10.2016;2016;10;10;Sunnuntai;11;2;13
95;30.10.2016;2016;10;11;Sunnuntai;10;6;16
95;30.10.2016;2016;10;12;Sunnuntai;3;6;9
95;30.10.2016;2016;10;13;Sunnuntai;4;10;14
95;30.10.2016;2016;10;14;Sunnuntai;3;6;9
95;30.10.2016;2016;10;15;Sunnuntai;8;5;13
95;30.10.2016;2016;10;16;Sunnuntai;7;4;11
95;30.10.2016;2016;10;17;Sunnuntai;1;0;1
95;30.10.2016;2016;10;18;Sunnuntai;2;1;3
95;30.10.2016;2016;10;19;Sunnuntai;10;0;10
95;30.10.2016;2016;10;20;Sunnuntai;2;2;4
95;30.10.2016;2016;10;21;Sunnuntai;1;2;3
95;30.10.2016;2016;10;22;Sunnuntai;0;1;1
95;30.10.2016;2016;10;23;Sunnuntai;0;1;1
95;31.10.2016;2016;10;00;Maanantai;1;0;1
95;31.10.2016;2016;10;01;Maanantai;0;0;0
95;31.10.2016;2016;10;02;Maanantai;0;0;0
95;31.10.2016;2016;10;03;Maanantai;1;2;3
95;31.10.2016;2016;10;04;Maanantai;0;0;0
95;31.10.2016;2016;10;05;Maanantai;1;0;1
95;31.10.2016;2016;10;06;Maanantai;18;14;32
95;31.10.2016;2016;10;07;Maanantai;15;12;27
95;31.10.2016;2016;10;08;Maanantai;5;11;16
95;31.10.2016;2016;10;09;Maanantai;8;7;15
95;31.10.2016;2016;10;10;Maanantai;7;5;12
95;31.10.2016;2016;10;11;Maanantai;3;7;10
95;31.10.2016;2016;10;12;Maanantai;9;3;12
95;31.10.2016;2016;10;13;Maanantai;3;6;9
95;31.10.2016;2016;10;14;Maanantai;11;14;25
95;31.10.2016;2016;10;15;Maanantai;22;15;37
95;31.10.2016;2016;10;16;Maanantai;21;15;36
95;31.10.2016;2016;10;17;Maanantai;4;12;16
95;31.10.2016;2016;10;18;Maanantai;6;7;13
95;31.10.2016;2016;10;19;Maanantai;1;8;9
95;31.10.2016;2016;10;20;Maanantai;4;3;7
95;31.10.2016;2016;10;21;Maanantai;2;6;8
95;31.10.2016;2016;10;22;Maanantai;3;1;4
95;31.10.2016;2016;10;23;Maanantai;1;0;1
95;01.11.2016;2016;11;00;Tiistai;0;0;0
95;01.11.2016;2016;11;01;Tiistai;0;1;1
95;01.11.2016;2016;11;02;Tiistai;0;0;0
95;01.11.2016;2016;11;03;Tiistai;0;0;0
95;01.11.2016;2016;11;04;Tiistai;1;0;1
95;01.11.2016;2016;11;05;Tiistai;5;6;11
95;01.11.2016;2016;11;06;Tiistai;18;10;28
95;01.11.2016;2016;11;07;Tiistai;14;14;28
95;01.11.2016;2016;11;08;Tiistai;6;11;17
95;01.11.2016;2016;11;09;Tiistai;7;5;12
95;01.11.2016;2016;11;10;Tiistai;3;1;4
95;01.11.2016;2016;11;11;Tiistai;7;2;9
95;01.11.2016;2016;11;12;Tiistai;4;3;7
95;01.11.2016;2016;11;13;Tiistai;7;7;14
95;01.11.2016;2016;11;14;Tiistai;13;5;18
95;01.11.2016;2016;11;15;Tiistai;15;13;28
95;01.11.2016;2016;11;16;Tiistai;9;13;22
95;01.11.2016;2016;11;17;Tiistai;3;9;12
95;01.11.2016;2016;11;18;Tiistai;1;1;2
95;01.11.2016;2016;11;19;Tiistai;4;3;7
95;01.11.2016;2016;11;20;Tiistai;0;3;3
95;01.11.2016;2016;11;21;Tiistai;0;1;1
95;01.11.2016;2016;11;22;Tiistai;1;1;2
95;01.11.2016;2016;11;23;Tiistai;0;0;0
95;02.11.2016;2016;11;00;Keskiviikko;0;0;0
95;02.11.2016;2016;11;01;Keskiviikko;0;0;0
95;02.11.2016;2016;11;02;Keskiviikko;0;0;0
95;02.11.2016;2016;11;03;Keskiviikko;0;0;0
95;02.11.2016;2016;11;04;Keskiviikko;2;1;3
95;02.11.2016;2016;11;05;Keskiviikko;6;5;11
95;02.11.2016;2016;11;06;Keskiviikko;13;7;20
95;02.11.2016;2016;11;07;Keskiviikko;11;10;21
95;02.11.2016;2016;11;08;Keskiviikko;6;7;13
95;02.11.2016;2016;11;09;Keskiviikko;3;5;8
95;02.11.2016;2016;11;10;Keskiviikko;3;1;4
95;02.11.2016;2016;11;11;Keskiviikko;5;3;8
95;02.11.2016;2016;11;12;Keskiviikko;5;2;7
95;02.11.2016;2016;11;13;Keskiviikko;12;3;15
95;02.11.2016;2016;11;14;Keskiviikko;8;10;18
95;02.11.2016;2016;11;15;Keskiviikko;11;18;29
95;02.11.2016;2016;11;16;Keskiviikko;15;5;20
95;02.11.2016;2016;11;17;Keskiviikko;2;10;12
95;02.11.2016;2016;11;18;Keskiviikko;7;6;13
95;02.11.2016;2016;11;19;Keskiviikko;1;3;4
95;02.11.2016;2016;11;20;Keskiviikko;0;0;0
95;02.11.2016;2016;11;21;Keskiviikko;1;2;3
95;02.11.2016;2016;11;22;Keskiviikko;0;0;0
95;02.11.2016;2016;11;23;Keskiviikko;0;0;0
95;03.11.2016;2016;11;00;Torstai;0;0;0
95;03.11.2016;2016;11;01;Torstai;0;0;0
95;03.11.2016;2016;11;02;Torstai;0;0;0
95;03.11.2016;2016;11;03;Torstai;0;0;0
95;03.11.2016;2016;11;04;Torstai;2;0;2
95;03.11.2016;2016;11;05;Torstai;6;3;9
95;03.11.2016;2016;11;06;Torstai;8;11;19
95;03.11.2016;2016;11;07;Torstai;12;11;23
95;03.11.2016;2016;11;08;Torstai;8;5;13
95;03.11.2016;2016;11;09;Torstai;2;9;11
95;03.11.2016;2016;11;10;Torstai;0;2;2
95;03.11.2016;2016;11;11;Torstai;1;2;3
95;03.11.2016;2016;11;12;Torstai;6;4;10
95;03.11.2016;2016;11;13;Torstai;5;3;8
95;03.11.2016;2016;11;14;Torstai;7;11;18
95;03.11.2016;2016;11;15;Torstai;19;11;30
95;03.11.2016;2016;11;16;Torstai;14;11;25
95;03.11.2016;2016;11;17;Torstai;8;8;16
95;03.11.2016;2016;11;18;Torstai;2;5;7
95;03.11.2016;2016;11;19;Torstai;0;1;1
95;03.11.2016;2016;11;20;Torstai;2;2;4
95;03.11.2016;2016;11;21;Torstai;1;1;2
95;03.11.2016;2016;11;22;Torstai;1;2;3
95;03.11.2016;2016;11;23;Torstai;0;0;0
95;04.11.2016;2016;11;00;Perjantai;0;0;0
95;04.11.2016;2016;11;01;Perjantai;0;0;0
95;04.11.2016;2016;11;02;Perjantai;0;0;0
95;04.11.2016;2016;11;03;Perjantai;0;1;1
95;04.11.2016;2016;11;04;Perjantai;1;0;1
95;04.11.2016;2016;11;05;Perjantai;5;3;8
95;04.11.2016;2016;11;06;Perjantai;8;6;14
95;04.11.2016;2016;11;07;Perjantai;6;7;13
95;04.11.2016;2016;11;08;Perjantai;5;10;15
95;04.11.2016;2016;11;09;Perjantai;4;4;8
95;04.11.2016;2016;11;10;Perjantai;3;1;4
95;04.11.2016;2016;11;11;Perjantai;3;3;6
95;04.11.2016;2016;11;12;Perjantai;3;4;7
95;04.11.2016;2016;11;13;Perjantai;9;2;11
95;04.11.2016;2016;11;14;Perjantai;8;8;16
95;04.11.2016;2016;11;15;Perjantai;6;7;13
95;04.11.2016;2016;11;16;Perjantai;6;9;15
95;04.11.2016;2016;11;17;Perjantai;4;9;13
95;04.11.2016;2016;11;18;Perjantai;2;3;5
95;04.11.2016;2016;11;19;Perjantai;2;3;5
95;04.11.2016;2016;11;20;Perjantai;0;0;0
95;04.11.2016;2016;11;21;Perjantai;1;2;3
95;04.11.2016;2016;11;22;Perjantai;0;0;0
95;04.11.2016;2016;11;23;Perjantai;0;1;1
95;05.11.2016;2016;11;00;Lauantai;2;1;3
95;05.11.2016;2016;11;01;Lauantai;0;0;0
95;05.11.2016;2016;11;02;Lauantai;0;0;0
95;05.11.2016;2016;11;03;Lauantai;0;0;0
95;05.11.2016;2016;11;04;Lauantai;1;0;1
95;05.11.2016;2016;11;05;Lauantai;0;0;0
95;05.11.2016;2016;11;06;Lauantai;0;0;0
95;05.11.2016;2016;11;07;Lauantai;1;0;1
95;05.11.2016;2016;11;08;Lauantai;0;0;0
95;05.11.2016;2016;11;09;Lauantai;2;0;2
95;05.11.2016;2016;11;10;Lauantai;0;1;1
95;05.11.2016;2016;11;11;Lauantai;3;4;7
95;05.11.2016;2016;11;12;Lauantai;5;5;10
95;05.11.2016;2016;11;13;Lauantai;5;3;8
95;05.11.2016;2016;11;14;Lauantai;5;1;6
95;05.11.2016;2016;11;15;Lauantai;1;1;2
95;05.11.2016;2016;11;16;Lauantai;2;4;6
95;05.11.2016;2016;11;17;Lauantai;6;3;9
95;05.11.2016;2016;11;18;Lauantai;3;5;8
95;05.11.2016;2016;11;19;Lauantai;3;2;5
95;05.11.2016;2016;11;20;Lauantai;0;1;1
95;05.11.2016;2016;11;21;Lauantai;2;3;5
95;05.11.2016;2016;11;22;Lauantai;1;1;2
95;05.11.2016;2016;11;23;Lauantai;0;0;0
95;06.11.2016;2016;11;00;Sunnuntai;1;1;2
95;06.11.2016;2016;11;01;Sunnuntai;0;0;0
95;06.11.2016;2016;11;02;Sunnuntai;0;0;0
95;06.11.2016;2016;11;03;Sunnuntai;0;0;0
95;06.11.2016;2016;11;04;Sunnuntai;1;0;1
95;06.11.2016;2016;11;05;Sunnuntai;0;1;1
95;06.11.2016;2016;11;06;Sunnuntai;1;0;1
95;06.11.2016;2016;11;07;Sunnuntai;0;0;0
95;06.11.2016;2016;11;08;Sunnuntai;1;1;2
95;06.11.2016;2016;11;09;Sunnuntai;1;0;1
95;06.11.2016;2016;11;10;Sunnuntai;0;0;0
95;06.11.2016;2016;11;11;Sunnuntai;1;3;4
95;06.11.2016;2016;11;12;Sunnuntai;2;4;6
95;06.11.2016;2016;11;13;Sunnuntai;4;3;7
95;06.11.2016;2016;11;14;Sunnuntai;4;4;8
95;06.11.2016;2016;11;15;Sunnuntai;2;2;4
95;06.11.2016;2016;11;16;Sunnuntai;1;2;3
95;06.11.2016;2016;11;17;Sunnuntai;2;1;3
95;06.11.2016;2016;11;18;Sunnuntai;1;2;3
95;06.11.2016;2016;11;19;Sunnuntai;1;1;2
95;06.11.2016;2016;11;20;Sunnuntai;2;1;3
95;06.11.2016;2016;11;21;Sunnuntai;1;3;4
95;06.11.2016;2016;11;22;Sunnuntai;0;1;1
95;06.11.2016;2016;11;23;Sunnuntai;1;0;1
95;07.11.2016;2016;11;00;Maanantai;0;0;0
95;07.11.2016;2016;11;01;Maanantai;0;0;0
95;07.11.2016;2016;11;02;Maanantai;0;0;0
95;07.11.2016;2016;11;03;Maanantai;0;0;0
95;07.11.2016;2016;11;04;Maanantai;1;1;2
95;07.11.2016;2016;11;05;Maanantai;4;1;5
95;07.11.2016;2016;11;06;Maanantai;10;10;20
95;07.11.2016;2016;11;07;Maanantai;8;8;16
95;07.11.2016;2016;11;08;Maanantai;4;8;12
95;07.11.2016;2016;11;09;Maanantai;6;2;8
95;07.11.2016;2016;11;10;Maanantai;3;0;3
95;07.11.2016;2016;11;11;Maanantai;2;1;3
95;07.11.2016;2016;11;12;Maanantai;4;2;6
95;07.11.2016;2016;11;13;Maanantai;0;3;3
95;07.11.2016;2016;11;14;Maanantai;11;9;20
95;07.11.2016;2016;11;15;Maanantai;9;9;18
95;07.11.2016;2016;11;16;Maanantai;17;6;23
95;07.11.2016;2016;11;17;Maanantai;4;14;18
95;07.11.2016;2016;11;18;Maanantai;3;3;6
95;07.11.2016;2016;11;19;Maanantai;1;4;5
95;07.11.2016;2016;11;20;Maanantai;2;0;2
95;07.11.2016;2016;11;21;Maanantai;0;0;0
95;07.11.2016;2016;11;22;Maanantai;2;0;2
95;07.11.2016;2016;11;23;Maanantai;1;0;1
95;08.11.2016;2016;11;00;Tiistai;0;0;0
95;08.11.2016;2016;11;01;Tiistai;0;0;0
95;08.11.2016;2016;11;02;Tiistai;0;0;0
95;08.11.2016;2016;11;03;Tiistai;0;0;0
95;08.11.2016;2016;11;04;Tiistai;2;1;3
95;08.11.2016;2016;11;05;Tiistai;5;3;8
95;08.11.2016;2016;11;06;Tiistai;6;5;11
95;08.11.2016;2016;11;07;Tiistai;10;13;23
95;08.11.2016;2016;11;08;Tiistai;4;7;11
95;08.11.2016;2016;11;09;Tiistai;7;3;10
95;08.11.2016;2016;11;10;Tiistai;5;2;7
95;08.11.2016;2016;11;11;Tiistai;6;3;9
95;08.11.2016;2016;11;12;Tiistai;2;4;6
95;08.11.2016;2016;11;13;Tiistai;4;7;11
95;08.11.2016;2016;11;14;Tiistai;10;5;15
95;08.11.2016;2016;11;15;Tiistai;10;12;22
95;08.11.2016;2016;11;16;Tiistai;14;4;18
95;08.11.2016;2016;11;17;Tiistai;1;4;5
95;08.11.2016;2016;11;18;Tiistai;7;1;8
95;08.11.2016;2016;11;19;Tiistai;2;4;6
95;08.11.2016;2016;11;20;Tiistai;0;1;1
95;08.11.2016;2016;11;21;Tiistai;2;1;3
95;08.11.2016;2016;11;22;Tiistai;3;2;5
95;08.11.2016;2016;11;23;Tiistai;0;0;0
95;09.11.2016;2016;11;00;Keskiviikko;0;0;0
95;09.11.2016;2016;11;01;Keskiviikko;0;0;0
95;09.11.2016;2016;11;02;Keskiviikko;0;0;0
95;09.11.2016;2016;11;03;Keskiviikko;0;0;0
95;09.11.2016;2016;11;04;Keskiviikko;2;0;2
95;09.11.2016;2016;11;05;Keskiviikko;5;4;9
95;09.11.2016;2016;11;06;Keskiviikko;6;8;14
95;09.11.2016;2016;11;07;Keskiviikko;12;7;19
95;09.11.2016;2016;11;08;Keskiviikko;6;5;11
95;09.11.2016;2016;11;09;Keskiviikko;1;5;6
95;09.11.2016;2016;11;10;Keskiviikko;4;4;8
95;09.11.2016;2016;11;11;Keskiviikko;8;2;10
95;09.11.2016;2016;11;12;Keskiviikko;3;1;4
95;09.11.2016;2016;11;13;Keskiviikko;6;4;10
95;09.11.2016;2016;11;14;Keskiviikko;5;5;10
95;09.11.2016;2016;11;15;Keskiviikko;13;8;21
95;09.11.2016;2016;11;16;Keskiviikko;8;7;15
95;09.11.2016;2016;11;17;Keskiviikko;2;7;9
95;09.11.2016;2016;11;18;Keskiviikko;1;5;6
95;09.11.2016;2016;11;19;Keskiviikko;2;3;5
95;09.11.2016;2016;11;20;Keskiviikko;0;1;1
95;09.11.2016;2016;11;21;Keskiviikko;2;1;3
95;09.11.2016;2016;11;22;Keskiviikko;1;5;6
95;09.11.2016;2016;11;23;Keskiviikko;0;1;1
95;10.11.2016;2016;11;00;Torstai;0;0;0
95;10.11.2016;2016;11;01;Torstai;0;1;1
95;10.11.2016;2016;11;02;Torstai;0;0;0
95;10.11.2016;2016;11;03;Torstai;0;0;0
95;10.11.2016;2016;11;04;Torstai;1;0;1
95;10.11.2016;2016;11;05;Torstai;4;5;9
95;10.11.2016;2016;11;06;Torstai;5;5;10
95;10.11.2016;2016;11;07;Torstai;10;7;17
95;10.11.2016;2016;11;08;Torstai;5;8;13
95;10.11.2016;2016;11;09;Torstai;3;3;6
95;10.11.2016;2016;11;10;Torstai;5;1;6
95;10.11.2016;2016;11;11;Torstai;3;1;4
95;10.11.2016;2016;11;12;Torstai;4;2;6
95;10.11.2016;2016;11;13;Torstai;2;6;8
95;10.11.2016;2016;11;14;Torstai;7;5;12
95;10.11.2016;2016;11;15;Torstai;10;10;20
95;10.11.2016;2016;11;16;Torstai;12;10;22
95;10.11.2016;2016;11;17;Torstai;4;5;9
95;10.11.2016;2016;11;18;Torstai;1;7;8
95;10.11.2016;2016;11;19;Torstai;2;1;3
95;10.11.2016;2016;11;20;Torstai;1;1;2
95;10.11.2016;2016;11;21;Torstai;0;1;1
95;10.11.2016;2016;11;22;Torstai;1;1;2
95;10.11.2016;2016;11;23;Torstai;0;0;0
95;11.11.2016;2016;11;00;Perjantai;0;0;0
95;11.11.2016;2016;11;01;Perjantai;0;0;0
95;11.11.2016;2016;11;02;Perjantai;0;0;0
95;11.11.2016;2016;11;03;Perjantai;0;0;0
95;11.11.2016;2016;11;04;Perjantai;1;0;1
95;11.11.2016;2016;11;05;Perjantai;4;7;11
95;11.11.2016;2016;11;06;Perjantai;5;3;8
95;11.11.2016;2016;11;07;Perjantai;7;3;10
95;11.11.2016;2016;11;08;Perjantai;6;5;11
95;11.11.2016;2016;11;09;Perjantai;3;2;5
95;11.11.2016;2016;11;10;Perjantai;1;1;2
95;11.11.2016;2016;11;11;Perjantai;1;0;1
95;11.11.2016;2016;11;12;Perjantai;4;1;5
95;11.11.2016;2016;11;13;Perjantai;6;3;9
95;11.11.2016;2016;11;14;Perjantai;7;8;15
95;11.11.2016;2016;11;15;Perjantai;5;6;11
95;11.11.2016;2016;11;16;Perjantai;4;6;10
95;11.11.2016;2016;11;17;Perjantai;1;9;10
95;11.11.2016;2016;11;18;Perjantai;2;2;4
95;11.11.2016;2016;11;19;Perjantai;2;2;4
95;11.11.2016;2016;11;20;Perjantai;1;2;3
95;11.11.2016;2016;11;21;Perjantai;1;0;1
95;11.11.2016;2016;11;22;Perjantai;0;1;1
95;11.11.2016;2016;11;23;Perjantai;0;0;0
95;12.11.2016;2016;11;00;Lauantai;0;3;3
95;12.11.2016;2016;11;01;Lauantai;0;0;0
95;12.11.2016;2016;11;02;Lauantai;0;0;0
95;12.11.2016;2016;11;03;Lauantai;0;0;0
95;12.11.2016;2016;11;04;Lauantai;2;0;2
95;12.11.2016;2016;11;05;Lauantai;3;0;3
95;12.11.2016;2016;11;06;Lauantai;1;0;1
95;12.11.2016;2016;11;07;Lauantai;2;1;3
95;12.11.2016;2016;11;08;Lauantai;2;1;3
95;12.11.2016;2016;11;09;Lauantai;1;1;2
95;12.11.2016;2016;11;10;Lauantai;3;2;5
95;12.11.2016;2016;11;11;Lauantai;4;2;6
95;12.11.2016;2016;11;12;Lauantai;1;4;5
95;12.11.2016;2016;11;13;Lauantai;7;3;10
95;12.11.2016;2016;11;14;Lauantai;5;3;8
95;12.11.2016;2016;11;15;Lauantai;2;6;8
95;12.11.2016;2016;11;16;Lauantai;0;3;3
95;12.11.2016;2016;11;17;Lauantai;1;1;2
95;12.11.2016;2016;11;18;Lauantai;0;2;2
95;12.11.2016;2016;11;19;Lauantai;1;1;2
95;12.11.2016;2016;11;20;Lauantai;1;1;2
95;12.11.2016;2016;11;21;Lauantai;0;0;0
95;12.11.2016;2016;11;22;Lauantai;1;2;3
95;12.11.2016;2016;11;23;Lauantai;0;0;0
95;13.11.2016;2016;11;00;Sunnuntai;2;0;2
95;13.11.2016;2016;11;01;Sunnuntai;0;0;0
95;13.11.2016;2016;11;02;Sunnuntai;0;0;0
95;13.11.2016;2016;11;03;Sunnuntai;0;0;0
95;13.11.2016;2016;11;04;Sunnuntai;1;0;1
95;13.11.2016;2016;11;05;Sunnuntai;2;0;2
95;13.11.2016;2016;11;06;Sunnuntai;1;1;2
95;13.11.2016;2016;11;07;Sunnuntai;0;0;0
95;13.11.2016;2016;11;08;Sunnuntai;0;1;1
95;13.11.2016;2016;11;09;Sunnuntai;0;3;3
95;13.11.2016;2016;11;10;Sunnuntai;5;0;5
95;13.11.2016;2016;11;11;Sunnuntai;2;3;5
95;13.11.2016;2016;11;12;Sunnuntai;4;4;8
95;13.11.2016;2016;11;13;Sunnuntai;1;8;9
95;13.11.2016;2016;11;14;Sunnuntai;2;1;3
95;13.11.2016;2016;11;15;Sunnuntai;2;4;6
95;13.11.2016;2016;11;16;Sunnuntai;4;3;7
95;13.11.2016;2016;11;17;Sunnuntai;3;3;6
95;13.11.2016;2016;11;18;Sunnuntai;3;1;4
95;13.11.2016;2016;11;19;Sunnuntai;4;1;5
95;13.11.2016;2016;11;20;Sunnuntai;0;0;0
95;13.11.2016;2016;11;21;Sunnuntai;1;2;3
95;13.11.2016;2016;11;22;Sunnuntai;0;0;0
95;13.11.2016;2016;11;23;Sunnuntai;0;0;0
95;14.11.2016;2016;11;00;Maanantai;1;0;1
95;14.11.2016;2016;11;01;Maanantai;0;0;0
95;14.11.2016;2016;11;02;Maanantai;0;0;0
95;14.11.2016;2016;11;03;Maanantai;1;1;2
95;14.11.2016;2016;11;04;Maanantai;1;0;1
95;14.11.2016;2016;11;05;Maanantai;3;4;7
95;14.11.2016;2016;11;06;Maanantai;4;6;10
95;14.11.2016;2016;11;07;Maanantai;8;9;17
95;14.11.2016;2016;11;08;Maanantai;6;7;13
95;14.11.2016;2016;11;09;Maanantai;3;7;10
95;14.11.2016;2016;11;10;Maanantai;5;5;10
95;14.11.2016;2016;11;11;Maanantai;4;2;6
95;14.11.2016;2016;11;12;Maanantai;8;3;11
95;14.11.2016;2016;11;13;Maanantai;6;6;12
95;14.11.2016;2016;11;14;Maanantai;4;3;7
95;14.11.2016;2016;11;15;Maanantai;9;7;16
95;14.11.2016;2016;11;16;Maanantai;13;11;24
95;14.11.2016;2016;11;17;Maanantai;1;6;7
95;14.11.2016;2016;11;18;Maanantai;2;0;2
95;14.11.2016;2016;11;19;Maanantai;2;0;2
95;14.11.2016;2016;11;20;Maanantai;1;0;1
95;14.11.2016;2016;11;21;Maanantai;1;5;6
95;14.11.2016;2016;11;22;Maanantai;0;1;1
95;14.11.2016;2016;11;23;Maanantai;0;0;0
95;15.11.2016;2016;11;00;Tiistai;0;0;0
95;15.11.2016;2016;11;01;Tiistai;0;0;0
95;15.11.2016;2016;11;02;Tiistai;0;0;0
95;15.11.2016;2016;11;03;Tiistai;0;0;0
95;15.11.2016;2016;11;04;Tiistai;1;0;1
95;15.11.2016;2016;11;05;Tiistai;4;3;7
95;15.11.2016;2016;11;06;Tiistai;6;9;15
95;15.11.2016;2016;11;07;Tiistai;6;10;16
95;15.11.2016;2016;11;08;Tiistai;6;5;11
95;15.11.2016;2016;11;09;Tiistai;6;5;11
95;15.11.2016;2016;11;10;Tiistai;1;2;3
95;15.11.2016;2016;11;11;Tiistai;10;2;12
95;15.11.2016;2016;11;12;Tiistai;3;6;9
95;15.11.2016;2016;11;13;Tiistai;4;3;7
95;15.11.2016;2016;11;14;Tiistai;6;4;10
95;15.11.2016;2016;11;15;Tiistai;13;9;22
95;15.11.2016;2016;11;16;Tiistai;12;6;18
95;15.11.2016;2016;11;17;Tiistai;4;11;15
95;15.11.2016;2016;11;18;Tiistai;3;4;7
95;15.11.2016;2016;11;19;Tiistai;0;3;3
95;15.11.2016;2016;11;20;Tiistai;2;5;7
95;15.11.2016;2016;11;21;Tiistai;1;1;2
95;15.11.2016;2016;11;22;Tiistai;1;1;2
95;15.11.2016;2016;11;23;Tiistai;0;0;0
95;16.11.2016;2016;11;00;Keskiviikko;0;0;0
95;16.11.2016;2016;11;01;Keskiviikko;0;0;0
95;16.11.2016;2016;11;02;Keskiviikko;0;0;0
95;16.11.2016;2016;11;03;Keskiviikko;0;0;0
95;16.11.2016;2016;11;04;Keskiviikko;0;0;0
95;16.11.2016;2016;11;05;Keskiviikko;3;5;8
95;16.11.2016;2016;11;06;Keskiviikko;12;3;15
95;16.11.2016;2016;11;07;Keskiviikko;15;6;21
95;16.11.2016;2016;11;08;Keskiviikko;7;9;16
95;16.11.2016;2016;11;09;Keskiviikko;2;0;2
95;16.11.2016;2016;11;10;Keskiviikko;2;1;3
95;16.11.2016;2016;11;11;Keskiviikko;1;3;4
95;16.11.2016;2016;11;12;Keskiviikko;2;3;5
95;16.11.2016;2016;11;13;Keskiviikko;5;3;8
95;16.11.2016;2016;11;14;Keskiviikko;9;6;15
95;16.11.2016;2016;11;15;Keskiviikko;9;14;23
95;16.11.2016;2016;11;16;Keskiviikko;5;11;16
95;16.11.2016;2016;11;17;Keskiviikko;4;5;9
95;16.11.2016;2016;11;18;Keskiviikko;4;3;7
95;16.11.2016;2016;11;19;Keskiviikko;2;2;4
95;16.11.2016;2016;11;20;Keskiviikko;1;1;2
95;16.11.2016;2016;11;21;Keskiviikko;1;5;6
95;16.11.2016;2016;11;22;Keskiviikko;0;0;0
95;16.11.2016;2016;11;23;Keskiviikko;0;0;0
95;17.11.2016;2016;11;00;Torstai;0;0;0
95;17.11.2016;2016;11;01;Torstai;0;0;0
95;17.11.2016;2016;11;02;Torstai;0;0;0
95;17.11.2016;2016;11;03;Torstai;1;0;1
95;17.11.2016;2016;11;04;Torstai;0;0;0
95;17.11.2016;2016;11;05;Torstai;9;4;13
95;17.11.2016;2016;11;06;Torstai;4;10;14
95;17.11.2016;2016;11;07;Torstai;10;7;17
95;17.11.2016;2016;11;08;Torstai;9;8;17
95;17.11.2016;2016;11;09;Torstai;3;3;6
95;17.11.2016;2016;11;10;Torstai;3;5;8
95;17.11.2016;2016;11;11;Torstai;4;2;6
95;17.11.2016;2016;11;12;Torstai;4;1;5
95;17.11.2016;2016;11;13;Torstai;6;4;10
95;17.11.2016;2016;11;14;Torstai;5;9;14
95;17.11.2016;2016;11;15;Torstai;14;9;23
95;17.11.2016;2016;11;16;Torstai;17;10;27
95;17.11.2016;2016;11;17;Torstai;4;10;14
95;17.11.2016;2016;11;18;Torstai;1;8;9
95;17.11.2016;2016;11;19;Torstai;3;0;3
95;17.11.2016;2016;11;20;Torstai;0;1;1
95;17.11.2016;2016;11;21;Torstai;0;2;2
95;17.11.2016;2016;11;22;Torstai;0;0;0
95;17.11.2016;2016;11;23;Torstai;3;0;3
95;18.11.2016;2016;11;00;Perjantai;0;0;0
95;18.11.2016;2016;11;01;Perjantai;0;0;0
95;18.11.2016;2016;11;02;Perjantai;0;0;0
95;18.11.2016;2016;11;03;Perjantai;1;1;2
95;18.11.2016;2016;11;04;Perjantai;1;0;1
95;18.11.2016;2016;11;05;Perjantai;4;4;8
95;18.11.2016;2016;11;06;Perjantai;5;6;11
95;18.11.2016;2016;11;07;Perjantai;10;8;18
95;18.11.2016;2016;11;08;Perjantai;5;2;7
95;18.11.2016;2016;11;09;Perjantai;3;3;6
95;18.11.2016;2016;11;10;Perjantai;3;1;4
95;18.11.2016;2016;11;11;Perjantai;0;1;1
95;18.11.2016;2016;11;12;Perjantai;1;5;6
95;18.11.2016;2016;11;13;Perjantai;10;5;15
95;18.11.2016;2016;11;14;Perjantai;11;9;20
95;18.11.2016;2016;11;15;Perjantai;8;6;14
95;18.11.2016;2016;11;16;Perjantai;2;2;4
95;18.11.2016;2016;11;17;Perjantai;1;2;3
95;18.11.2016;2016;11;18;Perjantai;2;8;10
95;18.11.2016;2016;11;19;Perjantai;2;4;6
95;18.11.2016;2016;11;20;Perjantai;0;0;0
95;18.11.2016;2016;11;21;Perjantai;3;2;5
95;18.11.2016;2016;11;22;Perjantai;0;1;1
95;18.11.2016;2016;11;23;Perjantai;0;0;0
95;19.11.2016;2016;11;00;Lauantai;0;0;0
95;19.11.2016;2016;11;01;Lauantai;2;0;2
95;19.11.2016;2016;11;02;Lauantai;0;0;0
95;19.11.2016;2016;11;03;Lauantai;0;0;0
95;19.11.2016;2016;11;04;Lauantai;2;0;2
95;19.11.2016;2016;11;05;Lauantai;2;0;2
95;19.11.2016;2016;11;06;Lauantai;0;0;0
95;19.11.2016;2016;11;07;Lauantai;0;2;2
95;19.11.2016;2016;11;08;Lauantai;1;0;1
95;19.11.2016;2016;11;09;Lauantai;1;0;1
95;19.11.2016;2016;11;10;Lauantai;0;0;0
95;19.11.2016;2016;11;11;Lauantai;2;7;9
95;19.11.2016;2016;11;12;Lauantai;1;2;3
95;19.11.2016;2016;11;13;Lauantai;4;1;5
95;19.11.2016;2016;11;14;Lauantai;2;1;3
95;19.11.2016;2016;11;15;Lauantai;2;2;4
95;19.11.2016;2016;11;16;Lauantai;2;2;4
95;19.11.2016;2016;11;17;Lauantai;3;4;7
95;19.11.2016;2016;11;18;Lauantai;3;1;4
95;19.11.2016;2016;11;19;Lauantai;0;2;2
95;19.11.2016;2016;11;20;Lauantai;0;0;0
95;19.11.2016;2016;11;21;Lauantai;0;0;0
95;19.11.2016;2016;11;22;Lauantai;0;1;1
95;19.11.2016;2016;11;23;Lauantai;0;0;0
95;20.11.2016;2016;11;00;Sunnuntai;0;0;0
95;20.11.2016;2016;11;01;Sunnuntai;0;0;0
95;20.11.2016;2016;11;02;Sunnuntai;0;0;0
95;20.11.2016;2016;11;03;Sunnuntai;0;0;0
95;20.11.2016;2016;11;04;Sunnuntai;0;0;0
95;20.11.2016;2016;11;05;Sunnuntai;3;0;3
95;20.11.2016;2016;11;06;Sunnuntai;0;0;0
95;20.11.2016;2016;11;07;Sunnuntai;3;0;3
95;20.11.2016;2016;11;08;Sunnuntai;2;1;3
95;20.11.2016;2016;11;09;Sunnuntai;2;0;2
95;20.11.2016;2016;11;10;Sunnuntai;5;0;5
95;20.11.2016;2016;11;11;Sunnuntai;3;1;4
95;20.11.2016;2016;11;12;Sunnuntai;4;5;9
95;20.11.2016;2016;11;13;Sunnuntai;4;4;8
95;20.11.2016;2016;11;14;Sunnuntai;5;1;6
95;20.11.2016;2016;11;15;Sunnuntai;3;3;6
95;20.11.2016;2016;11;16;Sunnuntai;1;6;7
95;20.11.2016;2016;11;17;Sunnuntai;2;6;8
95;20.11.2016;2016;11;18;Sunnuntai;1;0;1
95;20.11.2016;2016;11;19;Sunnuntai;4;3;7
95;20.11.2016;2016;11;20;Sunnuntai;1;1;2
95;20.11.2016;2016;11;21;Sunnuntai;3;2;5
95;20.11.2016;2016;11;22;Sunnuntai;0;1;1
95;20.11.2016;2016;11;23;Sunnuntai;0;0;0
95;21.11.2016;2016;11;00;Maanantai;0;0;0
95;21.11.2016;2016;11;01;Maanantai;0;0;0
95;21.11.2016;2016;11;02;Maanantai;0;0;0
95;21.11.2016;2016;11;03;Maanantai;0;1;1
95;21.11.2016;2016;11;04;Maanantai;1;0;1
95;21.11.2016;2016;11;05;Maanantai;6;1;7
95;21.11.2016;2016;11;06;Maanantai;8;5;13
95;21.11.2016;2016;11;07;Maanantai;15;9;24
95;21.11.2016;2016;11;08;Maanantai;4;5;9
95;21.11.2016;2016;11;09;Maanantai;2;5;7
95;21.11.2016;2016;11;10;Maanantai;5;0;5
95;21.11.2016;2016;11;11;Maanantai;8;4;12
95;21.11.2016;2016;11;12;Maanantai;5;4;9
95;21.11.2016;2016;11;13;Maanantai;10;9;19
95;21.11.2016;2016;11;14;Maanantai;2;11;13
95;21.11.2016;2016;11;15;Maanantai;12;10;22
95;21.11.2016;2016;11;16;Maanantai;8;8;16
95;21.11.2016;2016;11;17;Maanantai;1;8;9
95;21.11.2016;2016;11;18;Maanantai;1;3;4
95;21.11.2016;2016;11;19;Maanantai;2;1;3
95;21.11.2016;2016;11;20;Maanantai;2;3;5
95;21.11.2016;2016;11;21;Maanantai;0;2;2
95;21.11.2016;2016;11;22;Maanantai;2;2;4
95;21.11.2016;2016;11;23;Maanantai;0;1;1
95;22.11.2016;2016;11;00;Tiistai;0;0;0
95;22.11.2016;2016;11;01;Tiistai;0;0;0
95;22.11.2016;2016;11;02;Tiistai;0;1;1
95;22.11.2016;2016;11;03;Tiistai;0;0;0
95;22.11.2016;2016;11;04;Tiistai;1;0;1
95;22.11.2016;2016;11;05;Tiistai;3;4;7
95;22.11.2016;2016;11;06;Tiistai;11;7;18
95;22.11.2016;2016;11;07;Tiistai;9;13;22
95;22.11.2016;2016;11;08;Tiistai;8;4;12
95;22.11.2016;2016;11;09;Tiistai;5;1;6
95;22.11.2016;2016;11;10;Tiistai;7;6;13
95;22.11.2016;2016;11;11;Tiistai;5;3;8
95;22.11.2016;2016;11;12;Tiistai;9;5;14
95;22.11.2016;2016;11;13;Tiistai;9;6;15
95;22.11.2016;2016;11;14;Tiistai;8;15;23
95;22.11.2016;2016;11;15;Tiistai;11;10;21
95;22.11.2016;2016;11;16;Tiistai;11;11;22
95;22.11.2016;2016;11;17;Tiistai;6;9;15
95;22.11.2016;2016;11;18;Tiistai;2;4;6
95;22.11.2016;2016;11;19;Tiistai;1;1;2
95;22.11.2016;2016;11;20;Tiistai;1;4;5
95;22.11.2016;2016;11;21;Tiistai;1;1;2
95;22.11.2016;2016;11;22;Tiistai;1;1;2
95;22.11.2016;2016;11;23;Tiistai;0;0;0
95;23.11.2016;2016;11;00;Keskiviikko;0;0;0
95;23.11.2016;2016;11;01;Keskiviikko;1;0;1
95;23.11.2016;2016;11;02;Keskiviikko;0;1;1
95;23.11.2016;2016;11;03;Keskiviikko;0;0;0
95;23.11.2016;2016;11;04;Keskiviikko;1;1;2
95;23.11.2016;2016;11;05;Keskiviikko;3;1;4
95;23.11.2016;2016;11;06;Keskiviikko;9;8;17
95;23.11.2016;2016;11;07;Keskiviikko;11;9;20
95;23.11.2016;2016;11;08;Keskiviikko;7;8;15
95;23.11.2016;2016;11;09;Keskiviikko;4;2;6
95;23.11.2016;2016;11;10;Keskiviikko;1;3;4
95;23.11.2016;2016;11;11;Keskiviikko;0;2;2
95;23.11.2016;2016;11;12;Keskiviikko;3;3;6
95;23.11.2016;2016;11;13;Keskiviikko;1;4;5
95;23.11.2016;2016;11;14;Keskiviikko;3;4;7
95;23.11.2016;2016;11;15;Keskiviikko;7;9;16
95;23.11.2016;2016;11;16;Keskiviikko;11;12;23
95;23.11.2016;2016;11;17;Keskiviikko;7;6;13
95;23.11.2016;2016;11;18;Keskiviikko;1;3;4
95;23.11.2016;2016;11;19;Keskiviikko;3;2;5
95;23.11.2016;2016;11;20;Keskiviikko;2;2;4
95;23.11.2016;2016;11;21;Keskiviikko;0;1;1
95;23.11.2016;2016;11;22;Keskiviikko;1;0;1
95;23.11.2016;2016;11;23;Keskiviikko;0;0;0
95;24.11.2016;2016;11;00;Torstai;0;0;0
95;24.11.2016;2016;11;01;Torstai;0;0;0
95;24.11.2016;2016;11;02;Torstai;0;0;0
95;24.11.2016;2016;11;03;Torstai;0;0;0
95;24.11.2016;2016;11;04;Torstai;0;0;0
95;24.11.2016;2016;11;05;Torstai;5;2;7
95;24.11.2016;2016;11;06;Torstai;8;7;15
95;24.11.2016;2016;11;07;Torstai;14;9;23
95;24.11.2016;2016;11;08;Torstai;6;6;12
95;24.11.2016;2016;11;09;Torstai;6;0;6
95;24.11.2016;2016;11;10;Torstai;4;2;6
95;24.11.2016;2016;11;11;Torstai;4;2;6
95;24.11.2016;2016;11;12;Torstai;6;2;8
95;24.11.2016;2016;11;13;Torstai;3;4;7
95;24.11.2016;2016;11;14;Torstai;4;5;9
95;24.11.2016;2016;11;15;Torstai;10;13;23
95;24.11.2016;2016;11;16;Torstai;9;10;19
95;24.11.2016;2016;11;17;Torstai;3;12;15
95;24.11.2016;2016;11;18;Torstai;2;4;6
95;24.11.2016;2016;11;19;Torstai;2;2;4
95;24.11.2016;2016;11;20;Torstai;0;3;3
95;24.11.2016;2016;11;21;Torstai;0;4;4
95;24.11.2016;2016;11;22;Torstai;1;1;2
95;24.11.2016;2016;11;23;Torstai;0;0;0
95;25.11.2016;2016;11;00;Perjantai;0;0;0
95;25.11.2016;2016;11;01;Perjantai;0;0;0
95;25.11.2016;2016;11;02;Perjantai;0;0;0
95;25.11.2016;2016;11;03;Perjantai;0;1;1
95;25.11.2016;2016;11;04;Perjantai;0;0;0
95;25.11.2016;2016;11;05;Perjantai;5;2;7
95;25.11.2016;2016;11;06;Perjantai;7;5;12
95;25.11.2016;2016;11;07;Perjantai;8;7;15
95;25.11.2016;2016;11;08;Perjantai;5;5;10
95;25.11.2016;2016;11;09;Perjantai;5;1;6
95;25.11.2016;2016;11;10;Perjantai;6;0;6
95;25.11.2016;2016;11;11;Perjantai;2;0;2
95;25.11.2016;2016;11;12;Perjantai;1;4;5
95;25.11.2016;2016;11;13;Perjantai;2;5;7
95;25.11.2016;2016;11;14;Perjantai;8;7;15
95;25.11.2016;2016;11;15;Perjantai;10;10;20
95;25.11.2016;2016;11;16;Perjantai;4;5;9
95;25.11.2016;2016;11;17;Perjantai;4;6;10
95;25.11.2016;2016;11;18;Perjantai;1;2;3
95;25.11.2016;2016;11;19;Perjantai;2;2;4
95;25.11.2016;2016;11;20;Perjantai;1;3;4
95;25.11.2016;2016;11;21;Perjantai;0;0;0
95;25.11.2016;2016;11;22;Perjantai;0;0;0
95;25.11.2016;2016;11;23;Perjantai;0;0;0
95;26.11.2016;2016;11;00;Lauantai;0;0;0
95;26.11.2016;2016;11;01;Lauantai;0;0;0
95;26.11.2016;2016;11;02;Lauantai;0;0;0
95;26.11.2016;2016;11;03;Lauantai;0;0;0
95;26.11.2016;2016;11;04;Lauantai;1;0;1
95;26.11.2016;2016;11;05;Lauantai;3;0;3
95;26.11.2016;2016;11;06;Lauantai;1;0;1
95;26.11.2016;2016;11;07;Lauantai;0;0;0
95;26.11.2016;2016;11;08;Lauantai;1;0;1
95;26.11.2016;2016;11;09;Lauantai;2;1;3
95;26.11.2016;2016;11;10;Lauantai;1;3;4
95;26.11.2016;2016;11;11;Lauantai;2;5;7
95;26.11.2016;2016;11;12;Lauantai;0;3;3
95;26.11.2016;2016;11;13;Lauantai;3;2;5
95;26.11.2016;2016;11;14;Lauantai;3;1;4
95;26.11.2016;2016;11;15;Lauantai;2;2;4
95;26.11.2016;2016;11;16;Lauantai;2;4;6
95;26.11.2016;2016;11;17;Lauantai;1;2;3
95;26.11.2016;2016;11;18;Lauantai;2;2;4
95;26.11.2016;2016;11;19;Lauantai;0;0;0
95;26.11.2016;2016;11;20;Lauantai;0;1;1
95;26.11.2016;2016;11;21;Lauantai;1;1;2
95;26.11.2016;2016;11;22;Lauantai;0;2;2
95;26.11.2016;2016;11;23;Lauantai;0;1;1
95;27.11.2016;2016;11;00;Sunnuntai;0;0;0
95;27.11.2016;2016;11;01;Sunnuntai;0;1;1
95;27.11.2016;2016;11;02;Sunnuntai;0;0;0
95;27.11.2016;2016;11;03;Sunnuntai;0;0;0
95;27.11.2016;2016;11;04;Sunnuntai;0;0;0
95;27.11.2016;2016;11;05;Sunnuntai;0;0;0
95;27.11.2016;2016;11;06;Sunnuntai;1;0;1
95;27.11.2016;2016;11;07;Sunnuntai;0;0;0
95;27.11.2016;2016;11;08;Sunnuntai;0;0;0
95;27.11.2016;2016;11;09;Sunnuntai;1;2;3
95;27.11.2016;2016;11;10;Sunnuntai;3;0;3
95;27.11.2016;2016;11;11;Sunnuntai;2;1;3
95;27.11.2016;2016;11;12;Sunnuntai;3;3;6
95;27.11.2016;2016;11;13;Sunnuntai;0;0;0
95;27.11.2016;2016;11;14;Sunnuntai;1;0;1
95;27.11.2016;2016;11;15;Sunnuntai;1;4;5
95;27.11.2016;2016;11;16;Sunnuntai;1;0;1
95;27.11.2016;2016;11;17;Sunnuntai;2;2;4
95;27.11.2016;2016;11;18;Sunnuntai;2;1;3
95;27.11.2016;2016;11;19;Sunnuntai;2;0;2
95;27.11.2016;2016;11;20;Sunnuntai;2;0;2
95;27.11.2016;2016;11;21;Sunnuntai;2;1;3
95;27.11.2016;2016;11;22;Sunnuntai;0;0;0
95;27.11.2016;2016;11;23;Sunnuntai;0;0;0
95;28.11.2016;2016;11;00;Maanantai;0;0;0
95;28.11.2016;2016;11;01;Maanantai;0;0;0
95;28.11.2016;2016;11;02;Maanantai;0;0;0
95;28.11.2016;2016;11;03;Maanantai;0;0;0
95;28.11.2016;2016;11;04;Maanantai;2;1;3
95;28.11.2016;2016;11;05;Maanantai;4;3;7
95;28.11.2016;2016;11;06;Maanantai;4;8;12
95;28.11.2016;2016;11;07;Maanantai;10;10;20
95;28.11.2016;2016;11;08;Maanantai;6;3;9
95;28.11.2016;2016;11;09;Maanantai;6;0;6
95;28.11.2016;2016;11;10;Maanantai;7;1;8
95;28.11.2016;2016;11;11;Maanantai;4;1;5
95;28.11.2016;2016;11;12;Maanantai;5;3;8
95;28.11.2016;2016;11;13;Maanantai;4;5;9
95;28.11.2016;2016;11;14;Maanantai;1;10;11
95;28.11.2016;2016;11;15;Maanantai;10;11;21
95;28.11.2016;2016;11;16;Maanantai;7;8;15
95;28.11.2016;2016;11;17;Maanantai;2;8;10
95;28.11.2016;2016;11;18;Maanantai;6;1;7
95;28.11.2016;2016;11;19;Maanantai;1;7;8
95;28.11.2016;2016;11;20;Maanantai;2;2;4
95;28.11.2016;2016;11;21;Maanantai;1;1;2
95;28.11.2016;2016;11;22;Maanantai;1;2;3
95;28.11.2016;2016;11;23;Maanantai;0;0;0
95;29.11.2016;2016;11;00;Tiistai;0;0;0
95;29.11.2016;2016;11;01;Tiistai;0;0;0
95;29.11.2016;2016;11;02;Tiistai;0;0;0
95;29.11.2016;2016;11;03;Tiistai;0;1;1
95;29.11.2016;2016;11;04;Tiistai;2;1;3
95;29.11.2016;2016;11;05;Tiistai;4;6;10
95;29.11.2016;2016;11;06;Tiistai;3;6;9
95;29.11.2016;2016;11;07;Tiistai;5;12;17
95;29.11.2016;2016;11;08;Tiistai;10;4;14
95;29.11.2016;2016;11;09;Tiistai;3;2;5
95;29.11.2016;2016;11;10;Tiistai;5;1;6
95;29.11.2016;2016;11;11;Tiistai;4;2;6
95;29.11.2016;2016;11;12;Tiistai;2;3;5
95;29.11.2016;2016;11;13;Tiistai;7;3;10
95;29.11.2016;2016;11;14;Tiistai;4;11;15
95;29.11.2016;2016;11;15;Tiistai;8;5;13
95;29.11.2016;2016;11;16;Tiistai;9;5;14
95;29.11.2016;2016;11;17;Tiistai;2;12;14
95;29.11.2016;2016;11;18;Tiistai;5;3;8
95;29.11.2016;2016;11;19;Tiistai;3;2;5
95;29.11.2016;2016;11;20;Tiistai;0;3;3
95;29.11.2016;2016;11;21;Tiistai;1;0;1
95;29.11.2016;2016;11;22;Tiistai;1;2;3
95;29.11.2016;2016;11;23;Tiistai;0;0;0
95;30.11.2016;2016;11;00;Keskiviikko;0;0;0
95;30.11.2016;2016;11;01;Keskiviikko;0;0;0
95;30.11.2016;2016;11;02;Keskiviikko;0;0;0
95;30.11.2016;2016;11;03;Keskiviikko;0;0;0
95;30.11.2016;2016;11;04;Keskiviikko;1;1;2
95;30.11.2016;2016;11;05;Keskiviikko;6;5;11
95;30.11.2016;2016;11;06;Keskiviikko;6;6;12
95;30.11.2016;2016;11;07;Keskiviikko;9;8;17
95;30.11.2016;2016;11;08;Keskiviikko;3;3;6
95;30.11.2016;2016;11;09;Keskiviikko;6;1;7
95;30.11.2016;2016;11;10;Keskiviikko;5;1;6
95;30.11.2016;2016;11;11;Keskiviikko;3;0;3
95;30.11.2016;2016;11;12;Keskiviikko;6;5;11
95;30.11.2016;2016;11;13;Keskiviikko;6;0;6
95;30.11.2016;2016;11;14;Keskiviikko;4;8;12
95;30.11.2016;2016;11;15;Keskiviikko;8;10;18
95;30.11.2016;2016;11;16;Keskiviikko;9;6;15
95;30.11.2016;2016;11;17;Keskiviikko;6;7;13
95;30.11.2016;2016;11;18;Keskiviikko;1;6;7
95;30.11.2016;2016;11;19;Keskiviikko;2;3;5
95;30.11.2016;2016;11;20;Keskiviikko;0;1;1
95;30.11.2016;2016;11;21;Keskiviikko;1;0;1
95;30.11.2016;2016;11;22;Keskiviikko;0;1;1
95;30.11.2016;2016;11;23;Keskiviikko;0;0;0
95;01.12.2016;2016;12;00;Torstai;0;0;0
95;01.12.2016;2016;12;01;Torstai;0;0;0
95;01.12.2016;2016;12;02;Torstai;0;0;0
95;01.12.2016;2016;12;03;Torstai;0;0;0
95;01.12.2016;2016;12;04;Torstai;3;1;4
95;01.12.2016;2016;12;05;Torstai;3;5;8
95;01.12.2016;2016;12;06;Torstai;9;6;15
95;01.12.2016;2016;12;07;Torstai;7;11;18
95;01.12.2016;2016;12;08;Torstai;5;6;11
95;01.12.2016;2016;12;09;Torstai;4;6;10
95;01.12.2016;2016;12;10;Torstai;7;5;12
95;01.12.2016;2016;12;11;Torstai;3;4;7
95;01.12.2016;2016;12;12;Torstai;2;5;7
95;01.12.2016;2016;12;13;Torstai;9;5;14
95;01.12.2016;2016;12;14;Torstai;3;8;11
95;01.12.2016;2016;12;15;Torstai;10;10;20
95;01.12.2016;2016;12;16;Torstai;15;5;20
95;01.12.2016;2016;12;17;Torstai;5;8;13
95;01.12.2016;2016;12;18;Torstai;5;6;11
95;01.12.2016;2016;12;19;Torstai;3;3;6
95;01.12.2016;2016;12;20;Torstai;0;1;1
95;01.12.2016;2016;12;21;Torstai;2;0;2
95;01.12.2016;2016;12;22;Torstai;0;3;3
95;01.12.2016;2016;12;23;Torstai;0;0;0
95;02.12.2016;2016;12;00;Perjantai;0;0;0
95;02.12.2016;2016;12;01;Perjantai;0;0;0
95;02.12.2016;2016;12;02;Perjantai;0;0;0
95;02.12.2016;2016;12;03;Perjantai;0;0;0
95;02.12.2016;2016;12;04;Perjantai;1;1;2
95;02.12.2016;2016;12;05;Perjantai;2;7;9
95;02.12.2016;2016;12;06;Perjantai;9;6;15
95;02.12.2016;2016;12;07;Perjantai;6;8;14
95;02.12.2016;2016;12;08;Perjantai;2;3;5
95;02.12.2016;2016;12;09;Perjantai;5;3;8
95;02.12.2016;2016;12;10;Perjantai;3;1;4
95;02.12.2016;2016;12;11;Perjantai;3;1;4
95;02.12.2016;2016;12;12;Perjantai;7;3;10
95;02.12.2016;2016;12;13;Perjantai;8;2;10
95;02.12.2016;2016;12;14;Perjantai;10;10;20
95;02.12.2016;2016;12;15;Perjantai;8;2;10
95;02.12.2016;2016;12;16;Perjantai;8;9;17
95;02.12.2016;2016;12;17;Perjantai;5;6;11
95;02.12.2016;2016;12;18;Perjantai;2;2;4
95;02.12.2016;2016;12;19;Perjantai;1;3;4
95;02.12.2016;2016;12;20;Perjantai;0;0;0
95;02.12.2016;2016;12;21;Perjantai;0;1;1
95;02.12.2016;2016;12;22;Perjantai;0;1;1
95;02.12.2016;2016;12;23;Perjantai;0;1;1
95;03.12.2016;2016;12;00;Lauantai;0;0;0
95;03.12.2016;2016;12;01;Lauantai;0;0;0
95;03.12.2016;2016;12;02;Lauantai;0;0;0
95;03.12.2016;2016;12;03;Lauantai;0;0;0
95;03.12.2016;2016;12;04;Lauantai;1;0;1
95;03.12.2016;2016;12;05;Lauantai;2;0;2
95;03.12.2016;2016;12;06;Lauantai;2;0;2
95;03.12.2016;2016;12;07;Lauantai;2;0;2
95;03.12.2016;2016;12;08;Lauantai;1;1;2
95;03.12.2016;2016;12;09;Lauantai;1;1;2
95;03.12.2016;2016;12;10;Lauantai;1;1;2
95;03.12.2016;2016;12;11;Lauantai;2;3;5
95;03.12.2016;2016;12;12;Lauantai;0;2;2
95;03.12.2016;2016;12;13;Lauantai;2;2;4
95;03.12.2016;2016;12;14;Lauantai;1;1;2
95;03.12.2016;2016;12;15;Lauantai;0;2;2
95;03.12.2016;2016;12;16;Lauantai;0;3;3
95;03.12.2016;2016;12;17;Lauantai;2;1;3
95;03.12.2016;2016;12;18;Lauantai;0;2;2
95;03.12.2016;2016;12;19;Lauantai;0;1;1
95;03.12.2016;2016;12;20;Lauantai;1;1;2
95;03.12.2016;2016;12;21;Lauantai;0;0;0
95;03.12.2016;2016;12;22;Lauantai;1;1;2
95;03.12.2016;2016;12;23;Lauantai;0;0;0
95;04.12.2016;2016;12;00;Sunnuntai;0;0;0
95;04.12.2016;2016;12;01;Sunnuntai;0;0;0
95;04.12.2016;2016;12;02;Sunnuntai;0;0;0
95;04.12.2016;2016;12;03;Sunnuntai;0;0;0
95;04.12.2016;2016;12;04;Sunnuntai;0;0;0
95;04.12.2016;2016;12;05;Sunnuntai;0;0;0
95;04.12.2016;2016;12;06;Sunnuntai;2;0;2
95;04.12.2016;2016;12;07;Sunnuntai;0;0;0
95;04.12.2016;2016;12;08;Sunnuntai;0;0;0
95;04.12.2016;2016;12;09;Sunnuntai;0;0;0
95;04.12.2016;2016;12;10;Sunnuntai;1;0;1
95;04.12.2016;2016;12;11;Sunnuntai;3;0;3
95;04.12.2016;2016;12;12;Sunnuntai;1;0;1
95;04.12.2016;2016;12;13;Sunnuntai;1;1;2
95;04.12.2016;2016;12;14;Sunnuntai;0;2;2
95;04.12.2016;2016;12;15;Sunnuntai;0;1;1
95;04.12.2016;2016;12;16;Sunnuntai;1;2;3
95;04.12.2016;2016;12;17;Sunnuntai;0;0;0
95;04.12.2016;2016;12;18;Sunnuntai;0;0;0
95;04.12.2016;2016;12;19;Sunnuntai;0;0;0
95;04.12.2016;2016;12;20;Sunnuntai;0;0;0
95;04.12.2016;2016;12;21;Sunnuntai;0;1;1
95;04.12.2016;2016;12;22;Sunnuntai;0;0;0
95;04.12.2016;2016;12;23;Sunnuntai;0;0;0
95;05.12.2016;2016;12;00;Maanantai;0;0;0
95;05.12.2016;2016;12;01;Maanantai;0;0;0
95;05.12.2016;2016;12;02;Maanantai;0;0;0
95;05.12.2016;2016;12;03;Maanantai;0;0;0
95;05.12.2016;2016;12;04;Maanantai;1;0;1
95;05.12.2016;2016;12;05;Maanantai;1;2;3
95;05.12.2016;2016;12;06;Maanantai;1;2;3
95;05.12.2016;2016;12;07;Maanantai;4;4;8
95;05.12.2016;2016;12;08;Maanantai;4;2;6
95;05.12.2016;2016;12;09;Maanantai;2;4;6
95;05.12.2016;2016;12;10;Maanantai;1;0;1
95;05.12.2016;2016;12;11;Maanantai;4;0;4
95;05.12.2016;2016;12;12;Maanantai;3;0;3
95;05.12.2016;2016;12;13;Maanantai;5;0;5
95;05.12.2016;2016;12;14;Maanantai;2;5;7
95;05.12.2016;2016;12;15;Maanantai;5;3;8
95;05.12.2016;2016;12;16;Maanantai;1;6;7
95;05.12.2016;2016;12;17;Maanantai;3;5;8
95;05.12.2016;2016;12;18;Maanantai;1;1;2
95;05.12.2016;2016;12;19;Maanantai;0;1;1
95;05.12.2016;2016;12;20;Maanantai;1;0;1
95;05.12.2016;2016;12;21;Maanantai;0;1;1
95;05.12.2016;2016;12;22;Maanantai;0;0;0
95;05.12.2016;2016;12;23;Maanantai;0;1;1
95;06.12.2016;2016;12;00;Tiistai;0;1;1
95;06.12.2016;2016;12;01;Tiistai;0;1;1
95;06.12.2016;2016;12;02;Tiistai;0;0;0
95;06.12.2016;2016;12;03;Tiistai;0;0;0
95;06.12.2016;2016;12;04;Tiistai;0;0;0
95;06.12.2016;2016;12;05;Tiistai;1;2;3
95;06.12.2016;2016;12;06;Tiistai;0;0;0
95;06.12.2016;2016;12;07;Tiistai;0;0;0
95;06.12.2016;2016;12;08;Tiistai;0;0;0
95;06.12.2016;2016;12;09;Tiistai;1;0;1
95;06.12.2016;2016;12;10;Tiistai;0;0;0
95;06.12.2016;2016;12;11;Tiistai;1;1;2
95;06.12.2016;2016;12;12;Tiistai;0;1;1
95;06.12.2016;2016;12;13;Tiistai;1;2;3
95;06.12.2016;2016;12;14;Tiistai;3;1;4
95;06.12.2016;2016;12;15;Tiistai;0;1;1
95;06.12.2016;2016;12;16;Tiistai;0;1;1
95;06.12.2016;2016;12;17;Tiistai;0;1;1
95;06.12.2016;2016;12;18;Tiistai;1;1;2
95;06.12.2016;2016;12;19;Tiistai;0;0;0
95;06.12.2016;2016;12;20;Tiistai;0;1;1
95;06.12.2016;2016;12;21;Tiistai;1;1;2
95;06.12.2016;2016;12;22;Tiistai;0;0;0
95;06.12.2016;2016;12;23;Tiistai;0;0;0
95;07.12.2016;2016;12;00;Keskiviikko;0;0;0
95;07.12.2016;2016;12;01;Keskiviikko;0;0;0
95;07.12.2016;2016;12;02;Keskiviikko;0;0;0
95;07.12.2016;2016;12;03;Keskiviikko;1;0;1
95;07.12.2016;2016;12;04;Keskiviikko;1;0;1
95;07.12.2016;2016;12;05;Keskiviikko;4;2;6
95;07.12.2016;2016;12;06;Keskiviikko;6;11;17
95;07.12.2016;2016;12;07;Keskiviikko;11;12;23
95;07.12.2016;2016;12;08;Keskiviikko;6;6;12
95;07.12.2016;2016;12;09;Keskiviikko;5;4;9
95;07.12.2016;2016;12;10;Keskiviikko;3;0;3
95;07.12.2016;2016;12;11;Keskiviikko;3;2;5
95;07.12.2016;2016;12;12;Keskiviikko;5;2;7
95;07.12.2016;2016;12;13;Keskiviikko;7;4;11
95;07.12.2016;2016;12;14;Keskiviikko;6;11;17
95;07.12.2016;2016;12;15;Keskiviikko;9;8;17
95;07.12.2016;2016;12;16;Keskiviikko;11;10;21
95;07.12.2016;2016;12;17;Keskiviikko;5;9;14
95;07.12.2016;2016;12;18;Keskiviikko;5;6;11
95;07.12.2016;2016;12;19;Keskiviikko;4;6;10
95;07.12.2016;2016;12;20;Keskiviikko;3;2;5
95;07.12.2016;2016;12;21;Keskiviikko;1;2;3
95;07.12.2016;2016;12;22;Keskiviikko;1;1;2
95;07.12.2016;2016;12;23;Keskiviikko;0;2;2
95;08.12.2016;2016;12;00;Torstai;0;0;0
95;08.12.2016;2016;12;01;Torstai;0;0;0
95;08.12.2016;2016;12;02;Torstai;0;0;0
95;08.12.2016;2016;12;03;Torstai;0;0;0
95;08.12.2016;2016;12;04;Torstai;2;1;3
95;08.12.2016;2016;12;05;Torstai;4;3;7
95;08.12.2016;2016;12;06;Torstai;6;6;12
95;08.12.2016;2016;12;07;Torstai;9;7;16
95;08.12.2016;2016;12;08;Torstai;5;3;8
95;08.12.2016;2016;12;09;Torstai;3;3;6
95;08.12.2016;2016;12;10;Torstai;8;1;9
95;08.12.2016;2016;12;11;Torstai;3;2;5
95;08.12.2016;2016;12;12;Torstai;2;2;4
95;08.12.2016;2016;12;13;Torstai;6;5;11
95;08.12.2016;2016;12;14;Torstai;6;4;10
95;08.12.2016;2016;12;15;Torstai;7;10;17
95;08.12.2016;2016;12;16;Torstai;7;6;13
95;08.12.2016;2016;12;17;Torstai;5;8;13
95;08.12.2016;2016;12;18;Torstai;5;4;9
95;08.12.2016;2016;12;19;Torstai;4;3;7
95;08.12.2016;2016;12;20;Torstai;0;4;4
95;08.12.2016;2016;12;21;Torstai;2;4;6
95;08.12.2016;2016;12;22;Torstai;3;1;4
95;08.12.2016;2016;12;23;Torstai;0;2;2
95;09.12.2016;2016;12;00;Perjantai;0;0;0
95;09.12.2016;2016;12;01;Perjantai;0;0;0
95;09.12.2016;2016;12;02;Perjantai;0;0;0
95;09.12.2016;2016;12;03;Perjantai;0;0;0
95;09.12.2016;2016;12;04;Perjantai;1;0;1
95;09.12.2016;2016;12;05;Perjantai;5;3;8
95;09.12.2016;2016;12;06;Perjantai;7;5;12
95;09.12.2016;2016;12;07;Perjantai;6;10;16
95;09.12.2016;2016;12;08;Perjantai;3;1;4
95;09.12.2016;2016;12;09;Perjantai;3;3;6
95;09.12.2016;2016;12;10;Perjantai;6;0;6
95;09.12.2016;2016;12;11;Perjantai;4;2;6
95;09.12.2016;2016;12;12;Perjantai;5;4;9
95;09.12.2016;2016;12;13;Perjantai;4;7;11
95;09.12.2016;2016;12;14;Perjantai;5;4;9
95;09.12.2016;2016;12;15;Perjantai;14;5;19
95;09.12.2016;2016;12;16;Perjantai;7;11;18
95;09.12.2016;2016;12;17;Perjantai;3;10;13
95;09.12.2016;2016;12;18;Perjantai;2;2;4
95;09.12.2016;2016;12;19;Perjantai;3;1;4
95;09.12.2016;2016;12;20;Perjantai;0;2;2
95;09.12.2016;2016;12;21;Perjantai;1;1;2
95;09.12.2016;2016;12;22;Perjantai;0;2;2
95;09.12.2016;2016;12;23;Perjantai;0;0;0
95;10.12.2016;2016;12;00;Lauantai;0;0;0
95;10.12.2016;2016;12;01;Lauantai;0;0;0
95;10.12.2016;2016;12;02;Lauantai;0;0;0
95;10.12.2016;2016;12;03;Lauantai;0;0;0
95;10.12.2016;2016;12;04;Lauantai;0;0;0
95;10.12.2016;2016;12;05;Lauantai;1;1;2
95;10.12.2016;2016;12;06;Lauantai;1;0;1
95;10.12.2016;2016;12;07;Lauantai;1;1;2
95;10.12.2016;2016;12;08;Lauantai;1;1;2
95;10.12.2016;2016;12;09;Lauantai;2;0;2
95;10.12.2016;2016;12;10;Lauantai;0;0;0
95;10.12.2016;2016;12;11;Lauantai;1;3;4
95;10.12.2016;2016;12;12;Lauantai;3;0;3
95;10.12.2016;2016;12;13;Lauantai;3;2;5
95;10.12.2016;2016;12;14;Lauantai;3;2;5
95;10.12.2016;2016;12;15;Lauantai;1;2;3
95;10.12.2016;2016;12;16;Lauantai;0;4;4
95;10.12.2016;2016;12;17;Lauantai;1;1;2
95;10.12.2016;2016;12;18;Lauantai;0;0;0
95;10.12.2016;2016;12;19;Lauantai;1;3;4
95;10.12.2016;2016;12;20;Lauantai;1;0;1
95;10.12.2016;2016;12;21;Lauantai;1;2;3
95;10.12.2016;2016;12;22;Lauantai;1;1;2
95;10.12.2016;2016;12;23;Lauantai;0;1;1
95;11.12.2016;2016;12;00;Sunnuntai;0;0;0
95;11.12.2016;2016;12;01;Sunnuntai;0;0;0
95;11.12.2016;2016;12;02;Sunnuntai;1;0;1
95;11.12.2016;2016;12;03;Sunnuntai;0;0;0
95;11.12.2016;2016;12;04;Sunnuntai;0;0;0
95;11.12.2016;2016;12;05;Sunnuntai;1;1;2
95;11.12.2016;2016;12;06;Sunnuntai;2;0;2
95;11.12.2016;2016;12;07;Sunnuntai;1;0;1
95;11.12.2016;2016;12;08;Sunnuntai;1;1;2
95;11.12.2016;2016;12;09;Sunnuntai;2;0;2
95;11.12.2016;2016;12;10;Sunnuntai;0;1;1
95;11.12.2016;2016;12;11;Sunnuntai;1;0;1
95;11.12.2016;2016;12;12;Sunnuntai;3;3;6
95;11.12.2016;2016;12;13;Sunnuntai;4;1;5
95;11.12.2016;2016;12;14;Sunnuntai;2;7;9
95;11.12.2016;2016;12;15;Sunnuntai;1;5;6
95;11.12.2016;2016;12;16;Sunnuntai;1;0;1
95;11.12.2016;2016;12;17;Sunnuntai;2;2;4
95;11.12.2016;2016;12;18;Sunnuntai;1;1;2
95;11.12.2016;2016;12;19;Sunnuntai;1;1;2
95;11.12.2016;2016;12;20;Sunnuntai;0;1;1
95;11.12.2016;2016;12;21;Sunnuntai;0;0;0
95;11.12.2016;2016;12;22;Sunnuntai;0;2;2
95;11.12.2016;2016;12;23;Sunnuntai;0;0;0
95;12.12.2016;2016;12;00;Maanantai;0;0;0
95;12.12.2016;2016;12;01;Maanantai;0;0;0
95;12.12.2016;2016;12;02;Maanantai;0;0;0
95;12.12.2016;2016;12;03;Maanantai;0;0;0
95;12.12.2016;2016;12;04;Maanantai;1;0;1
95;12.12.2016;2016;12;05;Maanantai;3;4;7
95;12.12.2016;2016;12;06;Maanantai;7;6;13
95;12.12.2016;2016;12;07;Maanantai;9;4;13
95;12.12.2016;2016;12;08;Maanantai;7;4;11
95;12.12.2016;2016;12;09;Maanantai;3;3;6
95;12.12.2016;2016;12;10;Maanantai;1;4;5
95;12.12.2016;2016;12;11;Maanantai;4;1;5
95;12.12.2016;2016;12;12;Maanantai;4;0;4
95;12.12.2016;2016;12;13;Maanantai;1;2;3
95;12.12.2016;2016;12;14;Maanantai;5;3;8
95;12.12.2016;2016;12;15;Maanantai;8;11;19
95;12.12.2016;2016;12;16;Maanantai;14;6;20
95;12.12.2016;2016;12;17;Maanantai;1;10;11
95;12.12.2016;2016;12;18;Maanantai;2;4;6
95;12.12.2016;2016;12;19;Maanantai;0;2;2
95;12.12.2016;2016;12;20;Maanantai;1;1;2
95;12.12.2016;2016;12;21;Maanantai;0;0;0
95;12.12.2016;2016;12;22;Maanantai;0;1;1
95;12.12.2016;2016;12;23;Maanantai;0;0;0
95;13.12.2016;2016;12;00;Tiistai;0;0;0
95;13.12.2016;2016;12;01;Tiistai;0;0;0
95;13.12.2016;2016;12;02;Tiistai;0;0;0
95;13.12.2016;2016;12;03;Tiistai;0;0;0
95;13.12.2016;2016;12;04;Tiistai;0;0;0
95;13.12.2016;2016;12;05;Tiistai;4;4;8
95;13.12.2016;2016;12;06;Tiistai;6;9;15
95;13.12.2016;2016;12;07;Tiistai;3;10;13
95;13.12.2016;2016;12;08;Tiistai;2;4;6
95;13.12.2016;2016;12;09;Tiistai;6;1;7
95;13.12.2016;2016;12;10;Tiistai;2;3;5
95;13.12.2016;2016;12;11;Tiistai;1;2;3
95;13.12.2016;2016;12;12;Tiistai;3;0;3
95;13.12.2016;2016;12;13;Tiistai;7;2;9
95;13.12.2016;2016;12;14;Tiistai;7;9;16
95;13.12.2016;2016;12;15;Tiistai;7;8;15
95;13.12.2016;2016;12;16;Tiistai;12;9;21
95;13.12.2016;2016;12;17;Tiistai;6;4;10
95;13.12.2016;2016;12;18;Tiistai;2;1;3
95;13.12.2016;2016;12;19;Tiistai;0;6;6
95;13.12.2016;2016;12;20;Tiistai;0;4;4
95;13.12.2016;2016;12;21;Tiistai;1;1;2
95;13.12.2016;2016;12;22;Tiistai;0;0;0
95;13.12.2016;2016;12;23;Tiistai;0;0;0
95;14.12.2016;2016;12;00;Keskiviikko;0;0;0
95;14.12.2016;2016;12;01;Keskiviikko;0;0;0
95;14.12.2016;2016;12;02;Keskiviikko;0;0;0
95;14.12.2016;2016;12;03;Keskiviikko;1;0;1
95;14.12.2016;2016;12;04;Keskiviikko;1;1;2
95;14.12.2016;2016;12;05;Keskiviikko;7;3;10
95;14.12.2016;2016;12;06;Keskiviikko;9;5;14
95;14.12.2016;2016;12;07;Keskiviikko;12;16;28
95;14.12.2016;2016;12;08;Keskiviikko;2;5;7
95;14.12.2016;2016;12;09;Keskiviikko;2;3;5
95;14.12.2016;2016;12;10;Keskiviikko;3;1;4
95;14.12.2016;2016;12;11;Keskiviikko;2;2;4
95;14.12.2016;2016;12;12;Keskiviikko;5;5;10
95;14.12.2016;2016;12;13;Keskiviikko;4;1;5
95;14.12.2016;2016;12;14;Keskiviikko;9;8;17
95;14.12.2016;2016;12;15;Keskiviikko;8;9;17
95;14.12.2016;2016;12;16;Keskiviikko;11;7;18
95;14.12.2016;2016;12;17;Keskiviikko;5;5;10
95;14.12.2016;2016;12;18;Keskiviikko;6;3;9
95;14.12.2016;2016;12;19;Keskiviikko;4;4;8
95;14.12.2016;2016;12;20;Keskiviikko;1;2;3
95;14.12.2016;2016;12;21;Keskiviikko;1;1;2
95;14.12.2016;2016;12;22;Keskiviikko;0;1;1
95;14.12.2016;2016;12;23;Keskiviikko;0;0;0
95;15.12.2016;2016;12;00;Torstai;0;0;0
95;15.12.2016;2016;12;01;Torstai;0;0;0
95;15.12.2016;2016;12;02;Torstai;0;0;0
95;15.12.2016;2016;12;03;Torstai;0;0;0
95;15.12.2016;2016;12;04;Torstai;1;2;3
95;15.12.2016;2016;12;05;Torstai;6;4;10
95;15.12.2016;2016;12;06;Torstai;7;8;15
95;15.12.2016;2016;12;07;Torstai;8;6;14
95;15.12.2016;2016;12;08;Torstai;2;4;6
95;15.12.2016;2016;12;09;Torstai;4;6;10
95;15.12.2016;2016;12;10;Torstai;7;3;10
95;15.12.2016;2016;12;11;Torstai;3;3;6
95;15.12.2016;2016;12;12;Torstai;3;5;8
95;15.12.2016;2016;12;13;Torstai;4;4;8
95;15.12.2016;2016;12;14;Torstai;4;5;9
95;15.12.2016;2016;12;15;Torstai;10;12;22
95;15.12.2016;2016;12;16;Torstai;11;7;18
95;15.12.2016;2016;12;17;Torstai;2;5;7
95;15.12.2016;2016;12;18;Torstai;3;1;4
95;15.12.2016;2016;12;19;Torstai;5;5;10
95;15.12.2016;2016;12;20;Torstai;1;3;4
95;15.12.2016;2016;12;21;Torstai;1;1;2
95;15.12.2016;2016;12;22;Torstai;0;0;0
95;15.12.2016;2016;12;23;Torstai;0;0;0
95;16.12.2016;2016;12;00;Perjantai;0;1;1
95;16.12.2016;2016;12;01;Perjantai;0;0;0
95;16.12.2016;2016;12;02;Perjantai;0;0;0
95;16.12.2016;2016;12;03;Perjantai;0;0;0
95;16.12.2016;2016;12;04;Perjantai;0;0;0
95;16.12.2016;2016;12;05;Perjantai;4;5;9
95;16.12.2016;2016;12;06;Perjantai;7;7;14
95;16.12.2016;2016;12;07;Perjantai;6;7;13
95;16.12.2016;2016;12;08;Perjantai;5;3;8
95;16.12.2016;2016;12;09;Perjantai;3;2;5
95;16.12.2016;2016;12;10;Perjantai;3;4;7
95;16.12.2016;2016;12;11;Perjantai;4;3;7
95;16.12.2016;2016;12;12;Perjantai;3;3;6
95;16.12.2016;2016;12;13;Perjantai;5;9;14
95;16.12.2016;2016;12;14;Perjantai;9;12;21
95;16.12.2016;2016;12;15;Perjantai;7;4;11
95;16.12.2016;2016;12;16;Perjantai;5;6;11
95;16.12.2016;2016;12;17;Perjantai;3;1;4
95;16.12.2016;2016;12;18;Perjantai;1;5;6
95;16.12.2016;2016;12;19;Perjantai;1;2;3
95;16.12.2016;2016;12;20;Perjantai;2;2;4
95;16.12.2016;2016;12;21;Perjantai;0;4;4
95;16.12.2016;2016;12;22;Perjantai;2;1;3
95;16.12.2016;2016;12;23;Perjantai;1;0;1
95;17.12.2016;2016;12;00;Lauantai;0;0;0
95;17.12.2016;2016;12;01;Lauantai;0;0;0
95;17.12.2016;2016;12;02;Lauantai;0;1;1
95;17.12.2016;2016;12;03;Lauantai;0;0;0
95;17.12.2016;2016;12;04;Lauantai;0;1;1
95;17.12.2016;2016;12;05;Lauantai;0;0;0
95;17.12.2016;2016;12;06;Lauantai;0;0;0
95;17.12.2016;2016;12;07;Lauantai;0;0;0
95;17.12.2016;2016;12;08;Lauantai;1;0;1
95;17.12.2016;2016;12;09;Lauantai;3;2;5
95;17.12.2016;2016;12;10;Lauantai;1;1;2
95;17.12.2016;2016;12;11;Lauantai;1;8;9
95;17.12.2016;2016;12;12;Lauantai;2;2;4
95;17.12.2016;2016;12;13;Lauantai;2;2;4
95;17.12.2016;2016;12;14;Lauantai;1;1;2
95;17.12.2016;2016;12;15;Lauantai;0;0;0
95;17.12.2016;2016;12;16;Lauantai;1;3;4
95;17.12.2016;2016;12;17;Lauantai;1;1;2
95;17.12.2016;2016;12;18;Lauantai;3;5;8
95;17.12.2016;2016;12;19;Lauantai;2;3;5
95;17.12.2016;2016;12;20;Lauantai;1;3;4
95;17.12.2016;2016;12;21;Lauantai;2;2;4
95;17.12.2016;2016;12;22;Lauantai;0;0;0
95;17.12.2016;2016;12;23;Lauantai;0;1;1
95;18.12.2016;2016;12;00;Sunnuntai;0;0;0
95;18.12.2016;2016;12;01;Sunnuntai;0;0;0
95;18.12.2016;2016;12;02;Sunnuntai;1;0;1
95;18.12.2016;2016;12;03;Sunnuntai;0;0;0
95;18.12.2016;2016;12;04;Sunnuntai;2;0;2
95;18.12.2016;2016;12;05;Sunnuntai;0;1;1
95;18.12.2016;2016;12;06;Sunnuntai;0;0;0
95;18.12.2016;2016;12;07;Sunnuntai;2;0;2
95;18.12.2016;2016;12;08;Sunnuntai;0;0;0
95;18.12.2016;2016;12;09;Sunnuntai;0;2;2
95;18.12.2016;2016;12;10;Sunnuntai;5;1;6
95;18.12.2016;2016;12;11;Sunnuntai;1;1;2
95;18.12.2016;2016;12;12;Sunnuntai;3;0;3
95;18.12.2016;2016;12;13;Sunnuntai;2;5;7
95;18.12.2016;2016;12;14;Sunnuntai;2;3;5
95;18.12.2016;2016;12;15;Sunnuntai;1;2;3
95;18.12.2016;2016;12;16;Sunnuntai;1;1;2
95;18.12.2016;2016;12;17;Sunnuntai;1;2;3
95;18.12.2016;2016;12;18;Sunnuntai;3;4;7
95;18.12.2016;2016;12;19;Sunnuntai;1;0;1
95;18.12.2016;2016;12;20;Sunnuntai;1;1;2
95;18.12.2016;2016;12;21;Sunnuntai;1;0;1
95;18.12.2016;2016;12;22;Sunnuntai;0;2;2
95;18.12.2016;2016;12;23;Sunnuntai;0;0;0
95;19.12.2016;2016;12;00;Maanantai;0;0;0
95;19.12.2016;2016;12;01;Maanantai;0;0;0
95;19.12.2016;2016;12;02;Maanantai;0;1;1
95;19.12.2016;2016;12;03;Maanantai;0;0;0
95;19.12.2016;2016;12;04;Maanantai;2;0;2
95;19.12.2016;2016;12;05;Maanantai;3;1;4
95;19.12.2016;2016;12;06;Maanantai;5;11;16
95;19.12.2016;2016;12;07;Maanantai;10;6;16
95;19.12.2016;2016;12;08;Maanantai;3;8;11
95;19.12.2016;2016;12;09;Maanantai;3;5;8
95;19.12.2016;2016;12;10;Maanantai;1;1;2
95;19.12.2016;2016;12;11;Maanantai;2;2;4
95;19.12.2016;2016;12;12;Maanantai;3;2;5
95;19.12.2016;2016;12;13;Maanantai;7;4;11
95;19.12.2016;2016;12;14;Maanantai;3;5;8
95;19.12.2016;2016;12;15;Maanantai;14;12;26
95;19.12.2016;2016;12;16;Maanantai;13;5;18
95;19.12.2016;2016;12;17;Maanantai;0;7;7
95;19.12.2016;2016;12;18;Maanantai;5;4;9
95;19.12.2016;2016;12;19;Maanantai;0;3;3
95;19.12.2016;2016;12;20;Maanantai;2;0;2
95;19.12.2016;2016;12;21;Maanantai;3;0;3
95;19.12.2016;2016;12;22;Maanantai;2;1;3
95;19.12.2016;2016;12;23;Maanantai;1;0;1
95;20.12.2016;2016;12;00;Tiistai;0;0;0
95;20.12.2016;2016;12;01;Tiistai;0;0;0
95;20.12.2016;2016;12;02;Tiistai;0;0;0
95;20.12.2016;2016;12;03;Tiistai;0;1;1
95;20.12.2016;2016;12;04;Tiistai;0;0;0
95;20.12.2016;2016;12;05;Tiistai;1;3;4
95;20.12.2016;2016;12;06;Tiistai;6;5;11
95;20.12.2016;2016;12;07;Tiistai;4;13;17
95;20.12.2016;2016;12;08;Tiistai;3;5;8
95;20.12.2016;2016;12;09;Tiistai;6;4;10
95;20.12.2016;2016;12;10;Tiistai;1;2;3
95;20.12.2016;2016;12;11;Tiistai;1;2;3
95;20.12.2016;2016;12;12;Tiistai;2;1;3
95;20.12.2016;2016;12;13;Tiistai;4;3;7
95;20.12.2016;2016;12;14;Tiistai;9;2;11
95;20.12.2016;2016;12;15;Tiistai;9;3;12
95;20.12.2016;2016;12;16;Tiistai;8;3;11
95;20.12.2016;2016;12;17;Tiistai;3;5;8
95;20.12.2016;2016;12;18;Tiistai;3;2;5
95;20.12.2016;2016;12;19;Tiistai;1;1;2
95;20.12.2016;2016;12;20;Tiistai;0;1;1
95;20.12.2016;2016;12;21;Tiistai;0;1;1
95;20.12.2016;2016;12;22;Tiistai;1;2;3
95;20.12.2016;2016;12;23;Tiistai;0;0;0
95;21.12.2016;2016;12;00;Keskiviikko;0;0;0
95;21.12.2016;2016;12;01;Keskiviikko;0;0;0
95;21.12.2016;2016;12;02;Keskiviikko;0;0;0
95;21.12.2016;2016;12;03;Keskiviikko;1;0;1
95;21.12.2016;2016;12;04;Keskiviikko;0;1;1
95;21.12.2016;2016;12;05;Keskiviikko;2;1;3
95;21.12.2016;2016;12;06;Keskiviikko;7;7;14
95;21.12.2016;2016;12;07;Keskiviikko;11;4;15
95;21.12.2016;2016;12;08;Keskiviikko;4;4;8
95;21.12.2016;2016;12;09;Keskiviikko;3;3;6
95;21.12.2016;2016;12;10;Keskiviikko;5;0;5
95;21.12.2016;2016;12;11;Keskiviikko;6;0;6
95;21.12.2016;2016;12;12;Keskiviikko;9;5;14
95;21.12.2016;2016;12;13;Keskiviikko;8;5;13
95;21.12.2016;2016;12;14;Keskiviikko;8;5;13
95;21.12.2016;2016;12;15;Keskiviikko;5;5;10
95;21.12.2016;2016;12;16;Keskiviikko;6;6;12
95;21.12.2016;2016;12;17;Keskiviikko;5;6;11
95;21.12.2016;2016;12;18;Keskiviikko;4;5;9
95;21.12.2016;2016;12;19;Keskiviikko;1;4;5
95;21.12.2016;2016;12;20;Keskiviikko;0;2;2
95;21.12.2016;2016;12;21;Keskiviikko;0;1;1
95;21.12.2016;2016;12;22;Keskiviikko;1;2;3
95;21.12.2016;2016;12;23;Keskiviikko;0;1;1
95;22.12.2016;2016;12;00;Torstai;0;0;0
95;22.12.2016;2016;12;01;Torstai;0;0;0
95;22.12.2016;2016;12;02;Torstai;0;0;0
95;22.12.2016;2016;12;03;Torstai;0;1;1
95;22.12.2016;2016;12;04;Torstai;1;0;1
95;22.12.2016;2016;12;05;Torstai;1;1;2
95;22.12.2016;2016;12;06;Torstai;4;2;6
95;22.12.2016;2016;12;07;Torstai;10;2;12
95;22.12.2016;2016;12;08;Torstai;4;1;5
95;22.12.2016;2016;12;09;Torstai;2;1;3
95;22.12.2016;2016;12;10;Torstai;4;0;4
95;22.12.2016;2016;12;11;Torstai;1;2;3
95;22.12.2016;2016;12;12;Torstai;1;3;4
95;22.12.2016;2016;12;13;Torstai;0;2;2
95;22.12.2016;2016;12;14;Torstai;2;3;5
95;22.12.2016;2016;12;15;Torstai;4;4;8
95;22.12.2016;2016;12;16;Torstai;5;2;7
95;22.12.2016;2016;12;17;Torstai;5;4;9
95;22.12.2016;2016;12;18;Torstai;3;2;5
95;22.12.2016;2016;12;19;Torstai;1;2;3
95;22.12.2016;2016;12;20;Torstai;2;3;5
95;22.12.2016;2016;12;21;Torstai;0;0;0
95;22.12.2016;2016;12;22;Torstai;1;0;1
95;22.12.2016;2016;12;23;Torstai;0;0;0
95;23.12.2016;2016;12;00;Perjantai;1;2;3
95;23.12.2016;2016;12;01;Perjantai;0;0;0
95;23.12.2016;2016;12;02;Perjantai;0;0;0
95;23.12.2016;2016;12;03;Perjantai;0;0;0
95;23.12.2016;2016;12;04;Perjantai;2;1;3
95;23.12.2016;2016;12;05;Perjantai;2;2;4
95;23.12.2016;2016;12;06;Perjantai;1;4;5
95;23.12.2016;2016;12;07;Perjantai;1;0;1
95;23.12.2016;2016;12;08;Perjantai;5;1;6
95;23.12.2016;2016;12;09;Perjantai;3;0;3
95;23.12.2016;2016;12;10;Perjantai;3;2;5
95;23.12.2016;2016;12;11;Perjantai;1;2;3
95;23.12.2016;2016;12;12;Perjantai;2;5;7
95;23.12.2016;2016;12;13;Perjantai;6;0;6
95;23.12.2016;2016;12;14;Perjantai;0;5;5
95;23.12.2016;2016;12;15;Perjantai;2;4;6
95;23.12.2016;2016;12;16;Perjantai;4;1;5
95;23.12.2016;2016;12;17;Perjantai;2;3;5
95;23.12.2016;2016;12;18;Perjantai;1;3;4
95;23.12.2016;2016;12;19;Perjantai;2;1;3
95;23.12.2016;2016;12;20;Perjantai;0;0;0
95;23.12.2016;2016;12;21;Perjantai;0;1;1
95;23.12.2016;2016;12;22;Perjantai;1;0;1
95;23.12.2016;2016;12;23;Perjantai;0;0;0
95;24.12.2016;2016;12;00;Lauantai;0;0;0
95;24.12.2016;2016;12;01;Lauantai;0;0;0
95;24.12.2016;2016;12;02;Lauantai;0;0;0
95;24.12.2016;2016;12;03;Lauantai;0;0;0
95;24.12.2016;2016;12;04;Lauantai;0;0;0
95;24.12.2016;2016;12;05;Lauantai;0;0;0
95;24.12.2016;2016;12;06;Lauantai;2;0;2
95;24.12.2016;2016;12;07;Lauantai;0;0;0
95;24.12.2016;2016;12;08;Lauantai;2;0;2
95;24.12.2016;2016;12;09;Lauantai;0;2;2
95;24.12.2016;2016;12;10;Lauantai;0;2;2
95;24.12.2016;2016;12;11;Lauantai;4;1;5
95;24.12.2016;2016;12;12;Lauantai;2;2;4
95;24.12.2016;2016;12;13;Lauantai;2;0;2
95;24.12.2016;2016;12;14;Lauantai;0;0;0
95;24.12.2016;2016;12;15;Lauantai;0;1;1
95;24.12.2016;2016;12;16;Lauantai;0;2;2
95;24.12.2016;2016;12;17;Lauantai;0;0;0
95;24.12.2016;2016;12;18;Lauantai;0;0;0
95;24.12.2016;2016;12;19;Lauantai;0;0;0
95;24.12.2016;2016;12;20;Lauantai;2;0;2
95;24.12.2016;2016;12;21;Lauantai;0;1;1
95;24.12.2016;2016;12;22;Lauantai;2;2;4
95;24.12.2016;2016;12;23;Lauantai;0;0;0
95;25.12.2016;2016;12;00;Sunnuntai;0;0;0
95;25.12.2016;2016;12;01;Sunnuntai;0;0;0
95;25.12.2016;2016;12;02;Sunnuntai;0;0;0
95;25.12.2016;2016;12;03;Sunnuntai;0;0;0
95;25.12.2016;2016;12;04;Sunnuntai;0;1;1
95;25.12.2016;2016;12;05;Sunnuntai;1;0;1
95;25.12.2016;2016;12;06;Sunnuntai;0;0;0
95;25.12.2016;2016;12;07;Sunnuntai;0;0;0
95;25.12.2016;2016;12;08;Sunnuntai;0;0;0
95;25.12.2016;2016;12;09;Sunnuntai;0;2;2
95;25.12.2016;2016;12;10;Sunnuntai;1;0;1
95;25.12.2016;2016;12;11;Sunnuntai;1;0;1
95;25.12.2016;2016;12;12;Sunnuntai;1;3;4
95;25.12.2016;2016;12;13;Sunnuntai;1;3;4
95;25.12.2016;2016;12;14;Sunnuntai;2;0;2
95;25.12.2016;2016;12;15;Sunnuntai;0;0;0
95;25.12.2016;2016;12;16;Sunnuntai;0;3;3
95;25.12.2016;2016;12;17;Sunnuntai;0;5;5
95;25.12.2016;2016;12;18;Sunnuntai;0;0;0
95;25.12.2016;2016;12;19;Sunnuntai;3;1;4
95;25.12.2016;2016;12;20;Sunnuntai;1;1;2
95;25.12.2016;2016;12;21;Sunnuntai;0;0;0
95;25.12.2016;2016;12;22;Sunnuntai;2;2;4
95;25.12.2016;2016;12;23;Sunnuntai;1;1;2
95;26.12.2016;2016;12;00;Maanantai;0;0;0
95;26.12.2016;2016;12;01;Maanantai;0;0;0
95;26.12.2016;2016;12;02;Maanantai;0;0;0
95;26.12.2016;2016;12;03;Maanantai;0;1;1
95;26.12.2016;2016;12;04;Maanantai;0;0;0
95;26.12.2016;2016;12;05;Maanantai;0;0;0
95;26.12.2016;2016;12;06;Maanantai;1;0;1
95;26.12.2016;2016;12;07;Maanantai;1;0;1
95;26.12.2016;2016;12;08;Maanantai;1;1;2
95;26.12.2016;2016;12;09;Maanantai;2;1;3
95;26.12.2016;2016;12;10;Maanantai;0;1;1
95;26.12.2016;2016;12;11;Maanantai;0;0;0
95;26.12.2016;2016;12;12;Maanantai;3;4;7
95;26.12.2016;2016;12;13;Maanantai;2;1;3
95;26.12.2016;2016;12;14;Maanantai;1;0;1
95;26.12.2016;2016;12;15;Maanantai;0;2;2
95;26.12.2016;2016;12;16;Maanantai;2;0;2
95;26.12.2016;2016;12;17;Maanantai;2;3;5
95;26.12.2016;2016;12;18;Maanantai;2;1;3
95;26.12.2016;2016;12;19;Maanantai;2;0;2
95;26.12.2016;2016;12;20;Maanantai;0;0;0
95;26.12.2016;2016;12;21;Maanantai;0;0;0
95;26.12.2016;2016;12;22;Maanantai;0;0;0
95;26.12.2016;2016;12;23;Maanantai;0;0;0
95;27.12.2016;2016;12;00;Tiistai;0;0;0
95;27.12.2016;2016;12;01;Tiistai;0;0;0
95;27.12.2016;2016;12;02;Tiistai;0;0;0
95;27.12.2016;2016;12;03;Tiistai;0;0;0
95;27.12.2016;2016;12;04;Tiistai;0;1;1
95;27.12.2016;2016;12;05;Tiistai;1;2;3
95;27.12.2016;2016;12;06;Tiistai;2;2;4
95;27.12.2016;2016;12;07;Tiistai;2;1;3
95;27.12.2016;2016;12;08;Tiistai;3;4;7
95;27.12.2016;2016;12;09;Tiistai;1;1;2
95;27.12.2016;2016;12;10;Tiistai;2;0;2
95;27.12.2016;2016;12;11;Tiistai;2;1;3
95;27.12.2016;2016;12;12;Tiistai;2;0;2
95;27.12.2016;2016;12;13;Tiistai;1;3;4
95;27.12.2016;2016;12;14;Tiistai;1;4;5
95;27.12.2016;2016;12;15;Tiistai;4;5;9
95;27.12.2016;2016;12;16;Tiistai;3;3;6
95;27.12.2016;2016;12;17;Tiistai;1;3;4
95;27.12.2016;2016;12;18;Tiistai;2;5;7
95;27.12.2016;2016;12;19;Tiistai;0;2;2
95;27.12.2016;2016;12;20;Tiistai;0;1;1
95;27.12.2016;2016;12;21;Tiistai;1;0;1
95;27.12.2016;2016;12;22;Tiistai;0;2;2
95;27.12.2016;2016;12;23;Tiistai;0;0;0
95;28.12.2016;2016;12;00;Keskiviikko;0;0;0
95;28.12.2016;2016;12;01;Keskiviikko;0;0;0
95;28.12.2016;2016;12;02;Keskiviikko;0;0;0
95;28.12.2016;2016;12;03;Keskiviikko;0;0;0
95;28.12.2016;2016;12;04;Keskiviikko;1;1;2
95;28.12.2016;2016;12;05;Keskiviikko;4;1;5
95;28.12.2016;2016;12;06;Keskiviikko;2;2;4
95;28.12.2016;2016;12;07;Keskiviikko;4;3;7
95;28.12.2016;2016;12;08;Keskiviikko;2;2;4
95;28.12.2016;2016;12;09;Keskiviikko;2;0;2
95;28.12.2016;2016;12;10;Keskiviikko;1;0;1
95;28.12.2016;2016;12;11;Keskiviikko;0;1;1
95;28.12.2016;2016;12;12;Keskiviikko;1;0;1
95;28.12.2016;2016;12;13;Keskiviikko;1;3;4
95;28.12.2016;2016;12;14;Keskiviikko;0;5;5
95;28.12.2016;2016;12;15;Keskiviikko;3;3;6
95;28.12.2016;2016;12;16;Keskiviikko;2;2;4
95;28.12.2016;2016;12;17;Keskiviikko;3;3;6
95;28.12.2016;2016;12;18;Keskiviikko;0;1;1
95;28.12.2016;2016;12;19;Keskiviikko;0;2;2
95;28.12.2016;2016;12;20;Keskiviikko;0;2;2
95;28.12.2016;2016;12;21;Keskiviikko;0;0;0
95;28.12.2016;2016;12;22;Keskiviikko;1;1;2
95;28.12.2016;2016;12;23;Keskiviikko;0;0;0
95;29.12.2016;2016;12;00;Torstai;1;0;1
95;29.12.2016;2016;12;01;Torstai;0;0;0
95;29.12.2016;2016;12;02;Torstai;1;0;1
95;29.12.2016;2016;12;03;Torstai;0;0;0
95;29.12.2016;2016;12;04;Torstai;2;0;2
95;29.12.2016;2016;12;05;Torstai;3;1;4
95;29.12.2016;2016;12;06;Torstai;2;1;3
95;29.12.2016;2016;12;07;Torstai;3;2;5
95;29.12.2016;2016;12;08;Torstai;4;1;5
95;29.12.2016;2016;12;09;Torstai;2;0;2
95;29.12.2016;2016;12;10;Torstai;3;3;6
95;29.12.2016;2016;12;11;Torstai;1;0;1
95;29.12.2016;2016;12;12;Torstai;5;2;7
95;29.12.2016;2016;12;13;Torstai;2;2;4
95;29.12.2016;2016;12;14;Torstai;2;5;7
95;29.12.2016;2016;12;15;Torstai;2;9;11
95;29.12.2016;2016;12;16;Torstai;6;4;10
95;29.12.2016;2016;12;17;Torstai;6;0;6
95;29.12.2016;2016;12;18;Torstai;2;3;5
95;29.12.2016;2016;12;19;Torstai;0;1;1
95;29.12.2016;2016;12;20;Torstai;1;1;2
95;29.12.2016;2016;12;21;Torstai;0;3;3
95;29.12.2016;2016;12;22;Torstai;1;2;3
95;29.12.2016;2016;12;23;Torstai;0;2;2
95;30.12.2016;2016;12;00;Perjantai;0;0;0
95;30.12.2016;2016;12;01;Perjantai;0;0;0
95;30.12.2016;2016;12;02;Perjantai;0;0;0
95;30.12.2016;2016;12;03;Perjantai;0;1;1
95;30.12.2016;2016;12;04;Perjantai;3;1;4
95;30.12.2016;2016;12;05;Perjantai;2;0;2
95;30.12.2016;2016;12;06;Perjantai;5;1;6
95;30.12.2016;2016;12;07;Perjantai;2;1;3
95;30.12.2016;2016;12;08;Perjantai;3;2;5
95;30.12.2016;2016;12;09;Perjantai;2;1;3
95;30.12.2016;2016;12;10;Perjantai;1;4;5
95;30.12.2016;2016;12;11;Perjantai;1;0;1
95;30.12.2016;2016;12;12;Perjantai;3;3;6
95;30.12.2016;2016;12;13;Perjantai;0;2;2
95;30.12.2016;2016;12;14;Perjantai;1;1;2
95;30.12.2016;2016;12;15;Perjantai;2;2;4
95;30.12.2016;2016;12;16;Perjantai;0;1;1
95;30.12.2016;2016;12;17;Perjantai;2;1;3
95;30.12.2016;2016;12;18;Perjantai;2;4;6
95;30.12.2016;2016;12;19;Perjantai;1;4;5
95;30.12.2016;2016;12;20;Perjantai;0;0;0
95;30.12.2016;2016;12;21;Perjantai;0;0;0
95;30.12.2016;2016;12;22;Perjantai;0;2;2
95;30.12.2016;2016;12;23;Perjantai;0;0;0
95;31.12.2016;2016;12;00;Lauantai;0;0;0
95;31.12.2016;2016;12;01;Lauantai;0;0;0
95;31.12.2016;2016;12;02;Lauantai;0;0;0
95;31.12.2016;2016;12;03;Lauantai;0;1;1
95;31.12.2016;2016;12;04;Lauantai;1;0;1
95;31.12.2016;2016;12;05;Lauantai;0;0;0
95;31.12.2016;2016;12;06;Lauantai;2;0;2
95;31.12.2016;2016;12;07;Lauantai;0;0;0
95;31.12.2016;2016;12;08;Lauantai;0;0;0
95;31.12.2016;2016;12;09;Lauantai;1;0;1
95;31.12.2016;2016;12;10;Lauantai;1;1;2
95;31.12.2016;2016;12;11;Lauantai;1;0;1
95;31.12.2016;2016;12;12;Lauantai;3;3;6
95;31.12.2016;2016;12;13;Lauantai;2;2;4
95;31.12.2016;2016;12;14;Lauantai;2;1;3
95;31.12.2016;2016;12;15;Lauantai;0;2;2
95;31.12.2016;2016;12;16;Lauantai;0;2;2
95;31.12.2016;2016;12;17;Lauantai;3;2;5
95;31.12.2016;2016;12;18;Lauantai;1;0;1
95;31.12.2016;2016;12;19;Lauantai;0;0;0
95;31.12.2016;2016;12;20;Lauantai;2;1;3
95;31.12.2016;2016;12;21;Lauantai;0;0;0
95;31.12.2016;2016;12;22;Lauantai;0;0;0
95;31.12.2016;2016;12;23;Lauantai;0;0;0
95;01.01.2017;2017;01;00;Sunnuntai;0;0;0
95;01.01.2017;2017;01;01;Sunnuntai;0;0;0
95;01.01.2017;2017;01;02;Sunnuntai;0;0;0
95;01.01.2017;2017;01;03;Sunnuntai;0;1;1
95;01.01.2017;2017;01;04;Sunnuntai;0;0;0
95;01.01.2017;2017;01;05;Sunnuntai;0;0;0
95;01.01.2017;2017;01;06;Sunnuntai;1;0;1
95;01.01.2017;2017;01;07;Sunnuntai;0;0;0
95;01.01.2017;2017;01;08;Sunnuntai;0;0;0
95;01.01.2017;2017;01;09;Sunnuntai;0;1;1
95;01.01.2017;2017;01;10;Sunnuntai;0;0;0
95;01.01.2017;2017;01;11;Sunnuntai;0;1;1
95;01.01.2017;2017;01;12;Sunnuntai;1;0;1
95;01.01.2017;2017;01;13;Sunnuntai;1;0;1
95;01.01.2017;2017;01;14;Sunnuntai;3;1;4
95;01.01.2017;2017;01;15;Sunnuntai;1;0;1
95;01.01.2017;2017;01;16;Sunnuntai;1;5;6
95;01.01.2017;2017;01;17;Sunnuntai;0;0;0
95;01.01.2017;2017;01;18;Sunnuntai;2;0;2
95;01.01.2017;2017;01;19;Sunnuntai;1;2;3
95;01.01.2017;2017;01;20;Sunnuntai;0;1;1
95;01.01.2017;2017;01;21;Sunnuntai;0;1;1
95;01.01.2017;2017;01;22;Sunnuntai;0;1;1
95;01.01.2017;2017;01;23;Sunnuntai;0;0;0
95;02.01.2017;2017;01;00;Maanantai;0;0;0
95;02.01.2017;2017;01;01;Maanantai;0;0;0
95;02.01.2017;2017;01;02;Maanantai;0;0;0
95;02.01.2017;2017;01;03;Maanantai;0;0;0
95;02.01.2017;2017;01;04;Maanantai;1;0;1
95;02.01.2017;2017;01;05;Maanantai;0;2;2
95;02.01.2017;2017;01;06;Maanantai;3;1;4
95;02.01.2017;2017;01;07;Maanantai;5;9;14
95;02.01.2017;2017;01;08;Maanantai;5;4;9
95;02.01.2017;2017;01;09;Maanantai;3;3;6
95;02.01.2017;2017;01;10;Maanantai;3;0;3
95;02.01.2017;2017;01;11;Maanantai;0;1;1
95;02.01.2017;2017;01;12;Maanantai;1;0;1
95;02.01.2017;2017;01;13;Maanantai;1;2;3
95;02.01.2017;2017;01;14;Maanantai;3;2;5
95;02.01.2017;2017;01;15;Maanantai;6;4;10
95;02.01.2017;2017;01;16;Maanantai;9;5;14
95;02.01.2017;2017;01;17;Maanantai;2;6;8
95;02.01.2017;2017;01;18;Maanantai;1;4;5
95;02.01.2017;2017;01;19;Maanantai;0;2;2
95;02.01.2017;2017;01;20;Maanantai;0;1;1
95;02.01.2017;2017;01;21;Maanantai;1;1;2
95;02.01.2017;2017;01;22;Maanantai;1;0;1
95;02.01.2017;2017;01;23;Maanantai;0;0;0
95;03.01.2017;2017;01;00;Tiistai;0;0;0
95;03.01.2017;2017;01;01;Tiistai;0;0;0
95;03.01.2017;2017;01;02;Tiistai;0;0;0
95;03.01.2017;2017;01;03;Tiistai;0;0;0
95;03.01.2017;2017;01;04;Tiistai;1;1;2
95;03.01.2017;2017;01;05;Tiistai;1;1;2
95;03.01.2017;2017;01;06;Tiistai;1;2;3
95;03.01.2017;2017;01;07;Tiistai;5;8;13
95;03.01.2017;2017;01;08;Tiistai;5;3;8
95;03.01.2017;2017;01;09;Tiistai;2;1;3
95;03.01.2017;2017;01;10;Tiistai;2;2;4
95;03.01.2017;2017;01;11;Tiistai;0;0;0
95;03.01.2017;2017;01;12;Tiistai;2;0;2
95;03.01.2017;2017;01;13;Tiistai;1;3;4
95;03.01.2017;2017;01;14;Tiistai;0;0;0
95;03.01.2017;2017;01;15;Tiistai;2;2;4
95;03.01.2017;2017;01;16;Tiistai;6;6;12
95;03.01.2017;2017;01;17;Tiistai;1;4;5
95;03.01.2017;2017;01;18;Tiistai;3;3;6
95;03.01.2017;2017;01;19;Tiistai;0;1;1
95;03.01.2017;2017;01;20;Tiistai;1;1;2
95;03.01.2017;2017;01;21;Tiistai;1;1;2
95;03.01.2017;2017;01;22;Tiistai;0;0;0
95;03.01.2017;2017;01;23;Tiistai;0;0;0
95;04.01.2017;2017;01;00;Keskiviikko;0;0;0
95;04.01.2017;2017;01;01;Keskiviikko;0;0;0
95;04.01.2017;2017;01;02;Keskiviikko;0;0;0
95;04.01.2017;2017;01;03;Keskiviikko;0;1;1
95;04.01.2017;2017;01;04;Keskiviikko;0;0;0
95;04.01.2017;2017;01;05;Keskiviikko;3;2;5
95;04.01.2017;2017;01;06;Keskiviikko;2;1;3
95;04.01.2017;2017;01;07;Keskiviikko;3;2;5
95;04.01.2017;2017;01;08;Keskiviikko;2;1;3
95;04.01.2017;2017;01;09;Keskiviikko;1;0;1
95;04.01.2017;2017;01;10;Keskiviikko;0;0;0
95;04.01.2017;2017;01;11;Keskiviikko;0;0;0
95;04.01.2017;2017;01;12;Keskiviikko;1;0;1
95;04.01.2017;2017;01;13;Keskiviikko;3;0;3
95;04.01.2017;2017;01;14;Keskiviikko;1;1;2
95;04.01.2017;2017;01;15;Keskiviikko;1;1;2
95;04.01.2017;2017;01;16;Keskiviikko;1;1;2
95;04.01.2017;2017;01;17;Keskiviikko;0;2;2
95;04.01.2017;2017;01;18;Keskiviikko;0;1;1
95;04.01.2017;2017;01;19;Keskiviikko;0;1;1
95;04.01.2017;2017;01;20;Keskiviikko;0;0;0
95;04.01.2017;2017;01;21;Keskiviikko;0;0;0
95;04.01.2017;2017;01;22;Keskiviikko;0;1;1
95;04.01.2017;2017;01;23;Keskiviikko;0;0;0
95;05.01.2017;2017;01;00;Torstai;0;0;0
95;05.01.2017;2017;01;01;Torstai;0;0;0
95;05.01.2017;2017;01;02;Torstai;0;0;0
95;05.01.2017;2017;01;03;Torstai;0;0;0
95;05.01.2017;2017;01;04;Torstai;0;0;0
95;05.01.2017;2017;01;05;Torstai;1;1;2
95;05.01.2017;2017;01;06;Torstai;0;0;0
95;05.01.2017;2017;01;07;Torstai;1;3;4
95;05.01.2017;2017;01;08;Torstai;2;0;2
95;05.01.2017;2017;01;09;Torstai;1;0;1
95;05.01.2017;2017;01;10;Torstai;0;0;0
95;05.01.2017;2017;01;11;Torstai;1;0;1
95;05.01.2017;2017;01;12;Torstai;0;0;0
95;05.01.2017;2017;01;13;Torstai;1;1;2
95;05.01.2017;2017;01;14;Torstai;1;1;2
95;05.01.2017;2017;01;15;Torstai;1;0;1
95;05.01.2017;2017;01;16;Torstai;0;2;2
95;05.01.2017;2017;01;17;Torstai;0;2;2
95;05.01.2017;2017;01;18;Torstai;0;0;0
95;05.01.2017;2017;01;19;Torstai;1;0;1
95;05.01.2017;2017;01;20;Torstai;0;1;1
95;05.01.2017;2017;01;21;Torstai;2;1;3
95;05.01.2017;2017;01;22;Torstai;0;0;0
95;05.01.2017;2017;01;23;Torstai;0;0;0
95;06.01.2017;2017;01;00;Perjantai;1;0;1
95;06.01.2017;2017;01;01;Perjantai;0;0;0
95;06.01.2017;2017;01;02;Perjantai;0;0;0
95;06.01.2017;2017;01;03;Perjantai;0;0;0
95;06.01.2017;2017;01;04;Perjantai;0;0;0
95;06.01.2017;2017;01;05;Perjantai;0;0;0
95;06.01.2017;2017;01;06;Perjantai;0;0;0
95;06.01.2017;2017;01;07;Perjantai;0;0;0
95;06.01.2017;2017;01;08;Perjantai;0;0;0
95;06.01.2017;2017;01;09;Perjantai;0;0;0
95;06.01.2017;2017;01;10;Perjantai;0;1;1
95;06.01.2017;2017;01;11;Perjantai;0;0;0
95;06.01.2017;2017;01;12;Perjantai;0;0;0
95;06.01.2017;2017;01;13;Perjantai;0;0;0
95;06.01.2017;2017;01;14;Perjantai;0;0;0
95;06.01.2017;2017;01;15;Perjantai;0;0;0
95;06.01.2017;2017;01;16;Perjantai;0;1;1
95;06.01.2017;2017;01;17;Perjantai;1;1;2
95;06.01.2017;2017;01;18;Perjantai;0;1;1
95;06.01.2017;2017;01;19;Perjantai;0;0;0
95;06.01.2017;2017;01;20;Perjantai;0;0;0
95;06.01.2017;2017;01;21;Perjantai;0;0;0
95;06.01.2017;2017;01;22;Perjantai;0;0;0
95;06.01.2017;2017;01;23;Perjantai;0;0;0
95;07.01.2017;2017;01;00;Lauantai;0;0;0
95;07.01.2017;2017;01;01;Lauantai;0;0;0
95;07.01.2017;2017;01;02;Lauantai;0;0;0
95;07.01.2017;2017;01;03;Lauantai;0;0;0
95;07.01.2017;2017;01;04;Lauantai;0;0;0
95;07.01.2017;2017;01;05;Lauantai;0;1;1
95;07.01.2017;2017;01;06;Lauantai;0;0;0
95;07.01.2017;2017;01;07;Lauantai;2;0;2
95;07.01.2017;2017;01;08;Lauantai;0;0;0
95;07.01.2017;2017;01;09;Lauantai;0;0;0
95;07.01.2017;2017;01;10;Lauantai;0;1;1
95;07.01.2017;2017;01;11;Lauantai;1;0;1
95;07.01.2017;2017;01;12;Lauantai;1;2;3
95;07.01.2017;2017;01;13;Lauantai;4;2;6
95;07.01.2017;2017;01;14;Lauantai;0;1;1
95;07.01.2017;2017;01;15;Lauantai;2;2;4
95;07.01.2017;2017;01;16;Lauantai;1;1;2
95;07.01.2017;2017;01;17;Lauantai;2;3;5
95;07.01.2017;2017;01;18;Lauantai;2;0;2
95;07.01.2017;2017;01;19;Lauantai;1;1;2
95;07.01.2017;2017;01;20;Lauantai;1;0;1
95;07.01.2017;2017;01;21;Lauantai;0;1;1
95;07.01.2017;2017;01;22;Lauantai;0;0;0
95;07.01.2017;2017;01;23;Lauantai;0;0;0
95;08.01.2017;2017;01;00;Sunnuntai;0;0;0
95;08.01.2017;2017;01;01;Sunnuntai;0;0;0
95;08.01.2017;2017;01;02;Sunnuntai;0;1;1
95;08.01.2017;2017;01;03;Sunnuntai;0;0;0
95;08.01.2017;2017;01;04;Sunnuntai;2;0;2
95;08.01.2017;2017;01;05;Sunnuntai;1;0;1
95;08.01.2017;2017;01;06;Sunnuntai;1;0;1
95;08.01.2017;2017;01;07;Sunnuntai;0;1;1
95;08.01.2017;2017;01;08;Sunnuntai;1;1;2
95;08.01.2017;2017;01;09;Sunnuntai;1;2;3
95;08.01.2017;2017;01;10;Sunnuntai;2;2;4
95;08.01.2017;2017;01;11;Sunnuntai;2;1;3
95;08.01.2017;2017;01;12;Sunnuntai;2;1;3
95;08.01.2017;2017;01;13;Sunnuntai;1;4;5
95;08.01.2017;2017;01;14;Sunnuntai;1;3;4
95;08.01.2017;2017;01;15;Sunnuntai;0;5;5
95;08.01.2017;2017;01;16;Sunnuntai;0;1;1
95;08.01.2017;2017;01;17;Sunnuntai;3;0;3
95;08.01.2017;2017;01;18;Sunnuntai;1;0;1
95;08.01.2017;2017;01;19;Sunnuntai;1;0;1
95;08.01.2017;2017;01;20;Sunnuntai;0;1;1
95;08.01.2017;2017;01;21;Sunnuntai;0;2;2
95;08.01.2017;2017;01;22;Sunnuntai;0;0;0
95;08.01.2017;2017;01;23;Sunnuntai;0;0;0
95;09.01.2017;2017;01;00;Maanantai;0;0;0
95;09.01.2017;2017;01;01;Maanantai;0;0;0
95;09.01.2017;2017;01;02;Maanantai;0;0;0
95;09.01.2017;2017;01;03;Maanantai;0;0;0
95;09.01.2017;2017;01;04;Maanantai;2;0;2
95;09.01.2017;2017;01;05;Maanantai;3;2;5
95;09.01.2017;2017;01;06;Maanantai;7;4;11
95;09.01.2017;2017;01;07;Maanantai;8;10;18
95;09.01.2017;2017;01;08;Maanantai;3;5;8
95;09.01.2017;2017;01;09;Maanantai;8;3;11
95;09.01.2017;2017;01;10;Maanantai;3;2;5
95;09.01.2017;2017;01;11;Maanantai;1;2;3
95;09.01.2017;2017;01;12;Maanantai;5;2;7
95;09.01.2017;2017;01;13;Maanantai;3;4;7
95;09.01.2017;2017;01;14;Maanantai;4;6;10
95;09.01.2017;2017;01;15;Maanantai;7;12;19
95;09.01.2017;2017;01;16;Maanantai;12;7;19
95;09.01.2017;2017;01;17;Maanantai;7;3;10
95;09.01.2017;2017;01;18;Maanantai;4;7;11
95;09.01.2017;2017;01;19;Maanantai;1;7;8
95;09.01.2017;2017;01;20;Maanantai;3;6;9
95;09.01.2017;2017;01;21;Maanantai;2;2;4
95;09.01.2017;2017;01;22;Maanantai;1;2;3
95;09.01.2017;2017;01;23;Maanantai;0;0;0
95;10.01.2017;2017;01;00;Tiistai;0;0;0
95;10.01.2017;2017;01;01;Tiistai;0;0;0
95;10.01.2017;2017;01;02;Tiistai;0;0;0
95;10.01.2017;2017;01;03;Tiistai;1;1;2
95;10.01.2017;2017;01;04;Tiistai;1;0;1
95;10.01.2017;2017;01;05;Tiistai;6;3;9
95;10.01.2017;2017;01;06;Tiistai;10;2;12
95;10.01.2017;2017;01;07;Tiistai;6;11;17
95;10.01.2017;2017;01;08;Tiistai;6;3;9
95;10.01.2017;2017;01;09;Tiistai;3;2;5
95;10.01.2017;2017;01;10;Tiistai;2;1;3
95;10.01.2017;2017;01;11;Tiistai;5;2;7
95;10.01.2017;2017;01;12;Tiistai;4;1;5
95;10.01.2017;2017;01;13;Tiistai;6;2;8
95;10.01.2017;2017;01;14;Tiistai;3;1;4
95;10.01.2017;2017;01;15;Tiistai;9;11;20
95;10.01.2017;2017;01;16;Tiistai;17;9;26
95;10.01.2017;2017;01;17;Tiistai;2;7;9
95;10.01.2017;2017;01;18;Tiistai;2;4;6
95;10.01.2017;2017;01;19;Tiistai;1;3;4
95;10.01.2017;2017;01;20;Tiistai;1;6;7
95;10.01.2017;2017;01;21;Tiistai;1;1;2
95;10.01.2017;2017;01;22;Tiistai;0;2;2
95;10.01.2017;2017;01;23;Tiistai;0;0;0
95;11.01.2017;2017;01;00;Keskiviikko;0;0;0
95;11.01.2017;2017;01;01;Keskiviikko;0;1;1
95;11.01.2017;2017;01;02;Keskiviikko;0;0;0
95;11.01.2017;2017;01;03;Keskiviikko;0;0;0
95;11.01.2017;2017;01;04;Keskiviikko;0;0;0
95;11.01.2017;2017;01;05;Keskiviikko;2;3;5
95;11.01.2017;2017;01;06;Keskiviikko;7;4;11
95;11.01.2017;2017;01;07;Keskiviikko;9;10;19
95;11.01.2017;2017;01;08;Keskiviikko;6;7;13
95;11.01.2017;2017;01;09;Keskiviikko;1;1;2
95;11.01.2017;2017;01;10;Keskiviikko;1;4;5
95;11.01.2017;2017;01;11;Keskiviikko;1;4;5
95;11.01.2017;2017;01;12;Keskiviikko;5;4;9
95;11.01.2017;2017;01;13;Keskiviikko;3;3;6
95;11.01.2017;2017;01;14;Keskiviikko;4;4;8
95;11.01.2017;2017;01;15;Keskiviikko;13;4;17
95;11.01.2017;2017;01;16;Keskiviikko;8;10;18
95;11.01.2017;2017;01;17;Keskiviikko;2;5;7
95;11.01.2017;2017;01;18;Keskiviikko;1;1;2
95;11.01.2017;2017;01;19;Keskiviikko;4;3;7
95;11.01.2017;2017;01;20;Keskiviikko;0;1;1
95;11.01.2017;2017;01;21;Keskiviikko;1;1;2
95;11.01.2017;2017;01;22;Keskiviikko;0;3;3
95;11.01.2017;2017;01;23;Keskiviikko;0;0;0
95;12.01.2017;2017;01;00;Torstai;0;1;1
95;12.01.2017;2017;01;01;Torstai;0;0;0
95;12.01.2017;2017;01;02;Torstai;0;0;0
95;12.01.2017;2017;01;03;Torstai;0;0;0
95;12.01.2017;2017;01;04;Torstai;1;0;1
95;12.01.2017;2017;01;05;Torstai;1;2;3
95;12.01.2017;2017;01;06;Torstai;7;3;10
95;12.01.2017;2017;01;07;Torstai;9;5;14
95;12.01.2017;2017;01;08;Torstai;2;4;6
95;12.01.2017;2017;01;09;Torstai;3;3;6
95;12.01.2017;2017;01;10;Torstai;1;1;2
95;12.01.2017;2017;01;11;Torstai;1;2;3
95;12.01.2017;2017;01;12;Torstai;1;0;1
95;12.01.2017;2017;01;13;Torstai;8;2;10
95;12.01.2017;2017;01;14;Torstai;3;6;9
95;12.01.2017;2017;01;15;Torstai;6;6;12
95;12.01.2017;2017;01;16;Torstai;8;7;15
95;12.01.2017;2017;01;17;Torstai;4;3;7
95;12.01.2017;2017;01;18;Torstai;0;5;5
95;12.01.2017;2017;01;19;Torstai;3;1;4
95;12.01.2017;2017;01;20;Torstai;1;3;4
95;12.01.2017;2017;01;21;Torstai;0;0;0
95;12.01.2017;2017;01;22;Torstai;0;2;2
95;12.01.2017;2017;01;23;Torstai;0;0;0
95;13.01.2017;2017;01;00;Perjantai;0;0;0
95;13.01.2017;2017;01;01;Perjantai;0;0;0
95;13.01.2017;2017;01;02;Perjantai;0;0;0
95;13.01.2017;2017;01;03;Perjantai;0;0;0
95;13.01.2017;2017;01;04;Perjantai;1;0;1
95;13.01.2017;2017;01;05;Perjantai;1;2;3
95;13.01.2017;2017;01;06;Perjantai;6;4;10
95;13.01.2017;2017;01;07;Perjantai;6;8;14
95;13.01.2017;2017;01;08;Perjantai;2;5;7
95;13.01.2017;2017;01;09;Perjantai;4;1;5
95;13.01.2017;2017;01;10;Perjantai;5;2;7
95;13.01.2017;2017;01;11;Perjantai;0;2;2
95;13.01.2017;2017;01;12;Perjantai;2;3;5
95;13.01.2017;2017;01;13;Perjantai;7;4;11
95;13.01.2017;2017;01;14;Perjantai;7;4;11
95;13.01.2017;2017;01;15;Perjantai;8;4;12
95;13.01.2017;2017;01;16;Perjantai;2;4;6
95;13.01.2017;2017;01;17;Perjantai;6;5;11
95;13.01.2017;2017;01;18;Perjantai;1;3;4
95;13.01.2017;2017;01;19;Perjantai;1;3;4
95;13.01.2017;2017;01;20;Perjantai;1;2;3
95;13.01.2017;2017;01;21;Perjantai;0;0;0
95;13.01.2017;2017;01;22;Perjantai;0;1;1
95;13.01.2017;2017;01;23;Perjantai;0;0;0
95;14.01.2017;2017;01;00;Lauantai;0;0;0
95;14.01.2017;2017;01;01;Lauantai;0;0;0
95;14.01.2017;2017;01;02;Lauantai;0;0;0
95;14.01.2017;2017;01;03;Lauantai;0;0;0
95;14.01.2017;2017;01;04;Lauantai;0;0;0
95;14.01.2017;2017;01;05;Lauantai;0;0;0
95;14.01.2017;2017;01;06;Lauantai;0;0;0
95;14.01.2017;2017;01;07;Lauantai;0;0;0
95;14.01.2017;2017;01;08;Lauantai;1;0;1
95;14.01.2017;2017;01;09;Lauantai;1;7;8
95;14.01.2017;2017;01;10;Lauantai;0;1;1
95;14.01.2017;2017;01;11;Lauantai;2;0;2
95;14.01.2017;2017;01;12;Lauantai;1;1;2
95;14.01.2017;2017;01;13;Lauantai;3;0;3
95;14.01.2017;2017;01;14;Lauantai;1;1;2
95;14.01.2017;2017;01;15;Lauantai;1;0;1
95;14.01.2017;2017;01;16;Lauantai;1;2;3
95;14.01.2017;2017;01;17;Lauantai;1;1;2
95;14.01.2017;2017;01;18;Lauantai;4;4;8
95;14.01.2017;2017;01;19;Lauantai;6;1;7
95;14.01.2017;2017;01;20;Lauantai;0;2;2
95;14.01.2017;2017;01;21;Lauantai;0;2;2
95;14.01.2017;2017;01;22;Lauantai;0;1;1
95;14.01.2017;2017;01;23;Lauantai;0;0;0
95;15.01.2017;2017;01;00;Sunnuntai;0;0;0
95;15.01.2017;2017;01;01;Sunnuntai;0;0;0
95;15.01.2017;2017;01;02;Sunnuntai;0;0;0
95;15.01.2017;2017;01;03;Sunnuntai;1;1;2
95;15.01.2017;2017;01;04;Sunnuntai;0;0;0
95;15.01.2017;2017;01;05;Sunnuntai;0;0;0
95;15.01.2017;2017;01;06;Sunnuntai;0;0;0
95;15.01.2017;2017;01;07;Sunnuntai;1;0;1
95;15.01.2017;2017;01;08;Sunnuntai;0;2;2
95;15.01.2017;2017;01;09;Sunnuntai;0;2;2
95;15.01.2017;2017;01;10;Sunnuntai;2;1;3
95;15.01.2017;2017;01;11;Sunnuntai;4;1;5
95;15.01.2017;2017;01;12;Sunnuntai;4;3;7
95;15.01.2017;2017;01;13;Sunnuntai;2;1;3
95;15.01.2017;2017;01;14;Sunnuntai;1;4;5
95;15.01.2017;2017;01;15;Sunnuntai;4;2;6
95;15.01.2017;2017;01;16;Sunnuntai;1;2;3
95;15.01.2017;2017;01;17;Sunnuntai;1;2;3
95;15.01.2017;2017;01;18;Sunnuntai;1;1;2
95;15.01.2017;2017;01;19;Sunnuntai;1;1;2
95;15.01.2017;2017;01;20;Sunnuntai;0;0;0
95;15.01.2017;2017;01;21;Sunnuntai;0;2;2
95;15.01.2017;2017;01;22;Sunnuntai;0;1;1
95;15.01.2017;2017;01;23;Sunnuntai;0;0;0
95;16.01.2017;2017;01;00;Maanantai;0;0;0
95;16.01.2017;2017;01;01;Maanantai;0;0;0
95;16.01.2017;2017;01;02;Maanantai;0;0;0
95;16.01.2017;2017;01;03;Maanantai;0;0;0
95;16.01.2017;2017;01;04;Maanantai;0;0;0
95;16.01.2017;2017;01;05;Maanantai;9;2;11
95;16.01.2017;2017;01;06;Maanantai;7;1;8
95;16.01.2017;2017;01;07;Maanantai;8;7;15
95;16.01.2017;2017;01;08;Maanantai;3;5;8
95;16.01.2017;2017;01;09;Maanantai;5;5;10
95;16.01.2017;2017;01;10;Maanantai;0;2;2
95;16.01.2017;2017;01;11;Maanantai;4;2;6
95;16.01.2017;2017;01;12;Maanantai;0;1;1
95;16.01.2017;2017;01;13;Maanantai;2;2;4
95;16.01.2017;2017;01;14;Maanantai;5;9;14
95;16.01.2017;2017;01;15;Maanantai;6;4;10
95;16.01.2017;2017;01;16;Maanantai;15;6;21
95;16.01.2017;2017;01;17;Maanantai;3;4;7
95;16.01.2017;2017;01;18;Maanantai;2;4;6
95;16.01.2017;2017;01;19;Maanantai;2;3;5
95;16.01.2017;2017;01;20;Maanantai;2;3;5
95;16.01.2017;2017;01;21;Maanantai;2;0;2
95;16.01.2017;2017;01;22;Maanantai;1;1;2
95;16.01.2017;2017;01;23;Maanantai;0;0;0
95;17.01.2017;2017;01;00;Tiistai;0;0;0
95;17.01.2017;2017;01;01;Tiistai;0;0;0
95;17.01.2017;2017;01;02;Tiistai;0;0;0
95;17.01.2017;2017;01;03;Tiistai;0;0;0
95;17.01.2017;2017;01;04;Tiistai;0;0;0
95;17.01.2017;2017;01;05;Tiistai;8;1;9
95;17.01.2017;2017;01;06;Tiistai;10;4;14
95;17.01.2017;2017;01;07;Tiistai;8;11;19
95;17.01.2017;2017;01;08;Tiistai;3;11;14
95;17.01.2017;2017;01;09;Tiistai;4;1;5
95;17.01.2017;2017;01;10;Tiistai;1;2;3
95;17.01.2017;2017;01;11;Tiistai;3;2;5
95;17.01.2017;2017;01;12;Tiistai;5;0;5
95;17.01.2017;2017;01;13;Tiistai;2;7;9
95;17.01.2017;2017;01;14;Tiistai;10;4;14
95;17.01.2017;2017;01;15;Tiistai;9;10;19
95;17.01.2017;2017;01;16;Tiistai;12;6;18
95;17.01.2017;2017;01;17;Tiistai;3;6;9
95;17.01.2017;2017;01;18;Tiistai;3;5;8
95;17.01.2017;2017;01;19;Tiistai;2;2;4
95;17.01.2017;2017;01;20;Tiistai;0;2;2
95;17.01.2017;2017;01;21;Tiistai;0;1;1
95;17.01.2017;2017;01;22;Tiistai;1;3;4
95;17.01.2017;2017;01;23;Tiistai;0;0;0
95;18.01.2017;2017;01;00;Keskiviikko;0;0;0
95;18.01.2017;2017;01;01;Keskiviikko;0;0;0
95;18.01.2017;2017;01;02;Keskiviikko;0;0;0
95;18.01.2017;2017;01;03;Keskiviikko;0;0;0
95;18.01.2017;2017;01;04;Keskiviikko;2;1;3
95;18.01.2017;2017;01;05;Keskiviikko;5;2;7
95;18.01.2017;2017;01;06;Keskiviikko;7;9;16
95;18.01.2017;2017;01;07;Keskiviikko;11;10;21
95;18.01.2017;2017;01;08;Keskiviikko;7;7;14
95;18.01.2017;2017;01;09;Keskiviikko;2;2;4
95;18.01.2017;2017;01;10;Keskiviikko;6;2;8
95;18.01.2017;2017;01;11;Keskiviikko;2;3;5
95;18.01.2017;2017;01;12;Keskiviikko;10;2;12
95;18.01.2017;2017;01;13;Keskiviikko;10;8;18
95;18.01.2017;2017;01;14;Keskiviikko;3;6;9
95;18.01.2017;2017;01;15;Keskiviikko;11;11;22
95;18.01.2017;2017;01;16;Keskiviikko;8;6;14
95;18.01.2017;2017;01;17;Keskiviikko;4;9;13
95;18.01.2017;2017;01;18;Keskiviikko;5;4;9
95;18.01.2017;2017;01;19;Keskiviikko;0;2;2
95;18.01.2017;2017;01;20;Keskiviikko;1;6;7
95;18.01.2017;2017;01;21;Keskiviikko;0;0;0
95;18.01.2017;2017;01;22;Keskiviikko;1;2;3
95;18.01.2017;2017;01;23;Keskiviikko;0;0;0
95;19.01.2017;2017;01;00;Torstai;0;0;0
95;19.01.2017;2017;01;01;Torstai;0;0;0
95;19.01.2017;2017;01;02;Torstai;0;0;0
95;19.01.2017;2017;01;03;Torstai;0;0;0
95;19.01.2017;2017;01;04;Torstai;3;0;3
95;19.01.2017;2017;01;05;Torstai;1;3;4
95;19.01.2017;2017;01;06;Torstai;7;3;10
95;19.01.2017;2017;01;07;Torstai;7;6;13
95;19.01.2017;2017;01;08;Torstai;5;6;11
95;19.01.2017;2017;01;09;Torstai;2;5;7
95;19.01.2017;2017;01;10;Torstai;2;1;3
95;19.01.2017;2017;01;11;Torstai;5;2;7
95;19.01.2017;2017;01;12;Torstai;2;1;3
95;19.01.2017;2017;01;13;Torstai;6;1;7
95;19.01.2017;2017;01;14;Torstai;4;6;10
95;19.01.2017;2017;01;15;Torstai;2;6;8
95;19.01.2017;2017;01;16;Torstai;11;3;14
95;19.01.2017;2017;01;17;Torstai;3;2;5
95;19.01.2017;2017;01;18;Torstai;0;1;1
95;19.01.2017;2017;01;19;Torstai;1;4;5
95;19.01.2017;2017;01;20;Torstai;1;0;1
95;19.01.2017;2017;01;21;Torstai;0;3;3
95;19.01.2017;2017;01;22;Torstai;0;1;1
95;19.01.2017;2017;01;23;Torstai;0;0;0
95;20.01.2017;2017;01;00;Perjantai;0;0;0
95;20.01.2017;2017;01;01;Perjantai;0;0;0
95;20.01.2017;2017;01;02;Perjantai;0;0;0
95;20.01.2017;2017;01;03;Perjantai;0;0;0
95;20.01.2017;2017;01;04;Perjantai;0;1;1
95;20.01.2017;2017;01;05;Perjantai;3;2;5
95;20.01.2017;2017;01;06;Perjantai;4;3;7
95;20.01.2017;2017;01;07;Perjantai;4;3;7
95;20.01.2017;2017;01;08;Perjantai;3;7;10
95;20.01.2017;2017;01;09;Perjantai;2;2;4
95;20.01.2017;2017;01;10;Perjantai;2;1;3
95;20.01.2017;2017;01;11;Perjantai;4;4;8
95;20.01.2017;2017;01;12;Perjantai;2;0;2
95;20.01.2017;2017;01;13;Perjantai;2;2;4
95;20.01.2017;2017;01;14;Perjantai;1;2;3
95;20.01.2017;2017;01;15;Perjantai;5;8;13
95;20.01.2017;2017;01;16;Perjantai;4;4;8
95;20.01.2017;2017;01;17;Perjantai;0;2;2
95;20.01.2017;2017;01;18;Perjantai;1;2;3
95;20.01.2017;2017;01;19;Perjantai;6;2;8
95;20.01.2017;2017;01;20;Perjantai;1;2;3
95;20.01.2017;2017;01;21;Perjantai;0;1;1
95;20.01.2017;2017;01;22;Perjantai;0;2;2
95;20.01.2017;2017;01;23;Perjantai;0;0;0
95;21.01.2017;2017;01;00;Lauantai;0;0;0
95;21.01.2017;2017;01;01;Lauantai;1;0;1
95;21.01.2017;2017;01;02;Lauantai;0;0;0
95;21.01.2017;2017;01;03;Lauantai;0;0;0
95;21.01.2017;2017;01;04;Lauantai;0;1;1
95;21.01.2017;2017;01;05;Lauantai;0;0;0
95;21.01.2017;2017;01;06;Lauantai;2;0;2
95;21.01.2017;2017;01;07;Lauantai;1;0;1
95;21.01.2017;2017;01;08;Lauantai;1;0;1
95;21.01.2017;2017;01;09;Lauantai;1;1;2
95;21.01.2017;2017;01;10;Lauantai;2;0;2
95;21.01.2017;2017;01;11;Lauantai;1;1;2
95;21.01.2017;2017;01;12;Lauantai;3;1;4
95;21.01.2017;2017;01;13;Lauantai;4;2;6
95;21.01.2017;2017;01;14;Lauantai;0;4;4
95;21.01.2017;2017;01;15;Lauantai;0;0;0
95;21.01.2017;2017;01;16;Lauantai;1;5;6
95;21.01.2017;2017;01;17;Lauantai;2;0;2
95;21.01.2017;2017;01;18;Lauantai;1;1;2
95;21.01.2017;2017;01;19;Lauantai;0;0;0
95;21.01.2017;2017;01;20;Lauantai;2;0;2
95;21.01.2017;2017;01;21;Lauantai;2;2;4
95;21.01.2017;2017;01;22;Lauantai;0;2;2
95;21.01.2017;2017;01;23;Lauantai;0;0;0
95;22.01.2017;2017;01;00;Sunnuntai;0;0;0
95;22.01.2017;2017;01;01;Sunnuntai;0;0;0
95;22.01.2017;2017;01;02;Sunnuntai;0;0;0
95;22.01.2017;2017;01;03;Sunnuntai;0;1;1
95;22.01.2017;2017;01;04;Sunnuntai;1;0;1
95;22.01.2017;2017;01;05;Sunnuntai;0;1;1
95;22.01.2017;2017;01;06;Sunnuntai;2;0;2
95;22.01.2017;2017;01;07;Sunnuntai;0;0;0
95;22.01.2017;2017;01;08;Sunnuntai;1;1;2
95;22.01.2017;2017;01;09;Sunnuntai;1;2;3
95;22.01.2017;2017;01;10;Sunnuntai;1;0;1
95;22.01.2017;2017;01;11;Sunnuntai;0;1;1
95;22.01.2017;2017;01;12;Sunnuntai;5;3;8
95;22.01.2017;2017;01;13;Sunnuntai;3;7;10
95;22.01.2017;2017;01;14;Sunnuntai;2;5;7
95;22.01.2017;2017;01;15;Sunnuntai;0;2;2
95;22.01.2017;2017;01;16;Sunnuntai;1;2;3
95;22.01.2017;2017;01;17;Sunnuntai;7;0;7
95;22.01.2017;2017;01;18;Sunnuntai;3;2;5
95;22.01.2017;2017;01;19;Sunnuntai;1;0;1
95;22.01.2017;2017;01;20;Sunnuntai;0;0;0
95;22.01.2017;2017;01;21;Sunnuntai;1;0;1
95;22.01.2017;2017;01;22;Sunnuntai;0;1;1
95;22.01.2017;2017;01;23;Sunnuntai;1;0;1
95;23.01.2017;2017;01;00;Maanantai;0;0;0
95;23.01.2017;2017;01;01;Maanantai;0;0;0
95;23.01.2017;2017;01;02;Maanantai;0;0;0
95;23.01.2017;2017;01;03;Maanantai;0;1;1
95;23.01.2017;2017;01;04;Maanantai;0;0;0
95;23.01.2017;2017;01;05;Maanantai;4;3;7
95;23.01.2017;2017;01;06;Maanantai;7;8;15
95;23.01.2017;2017;01;07;Maanantai;7;8;15
95;23.01.2017;2017;01;08;Maanantai;2;4;6
95;23.01.2017;2017;01;09;Maanantai;6;2;8
95;23.01.2017;2017;01;10;Maanantai;3;2;5
95;23.01.2017;2017;01;11;Maanantai;1;3;4
95;23.01.2017;2017;01;12;Maanantai;5;0;5
95;23.01.2017;2017;01;13;Maanantai;9;1;10
95;23.01.2017;2017;01;14;Maanantai;4;4;8
95;23.01.2017;2017;01;15;Maanantai;8;7;15
95;23.01.2017;2017;01;16;Maanantai;14;14;28
95;23.01.2017;2017;01;17;Maanantai;4;5;9
95;23.01.2017;2017;01;18;Maanantai;1;4;5
95;23.01.2017;2017;01;19;Maanantai;1;2;3
95;23.01.2017;2017;01;20;Maanantai;1;3;4
95;23.01.2017;2017;01;21;Maanantai;0;0;0
95;23.01.2017;2017;01;22;Maanantai;0;1;1
95;23.01.2017;2017;01;23;Maanantai;0;1;1
95;24.01.2017;2017;01;00;Tiistai;0;0;0
95;24.01.2017;2017;01;01;Tiistai;0;0;0
95;24.01.2017;2017;01;02;Tiistai;0;0;0
95;24.01.2017;2017;01;03;Tiistai;0;0;0
95;24.01.2017;2017;01;04;Tiistai;0;0;0
95;24.01.2017;2017;01;05;Tiistai;3;2;5
95;24.01.2017;2017;01;06;Tiistai;1;4;5
95;24.01.2017;2017;01;07;Tiistai;11;7;18
95;24.01.2017;2017;01;08;Tiistai;6;8;14
95;24.01.2017;2017;01;09;Tiistai;3;2;5
95;24.01.2017;2017;01;10;Tiistai;4;0;4
95;24.01.2017;2017;01;11;Tiistai;2;1;3
95;24.01.2017;2017;01;12;Tiistai;3;1;4
95;24.01.2017;2017;01;13;Tiistai;4;1;5
95;24.01.2017;2017;01;14;Tiistai;4;1;5
95;24.01.2017;2017;01;15;Tiistai;6;3;9
95;24.01.2017;2017;01;16;Tiistai;10;8;18
95;24.01.2017;2017;01;17;Tiistai;1;2;3
95;24.01.2017;2017;01;18;Tiistai;2;2;4
95;24.01.2017;2017;01;19;Tiistai;0;1;1
95;24.01.2017;2017;01;20;Tiistai;2;2;4
95;24.01.2017;2017;01;21;Tiistai;0;1;1
95;24.01.2017;2017;01;22;Tiistai;1;1;2
95;24.01.2017;2017;01;23;Tiistai;0;0;0
95;25.01.2017;2017;01;00;Keskiviikko;0;0;0
95;25.01.2017;2017;01;01;Keskiviikko;0;0;0
95;25.01.2017;2017;01;02;Keskiviikko;0;0;0
95;25.01.2017;2017;01;03;Keskiviikko;0;0;0
95;25.01.2017;2017;01;04;Keskiviikko;0;0;0
95;25.01.2017;2017;01;05;Keskiviikko;1;1;2
95;25.01.2017;2017;01;06;Keskiviikko;6;4;10
95;25.01.2017;2017;01;07;Keskiviikko;8;7;15
95;25.01.2017;2017;01;08;Keskiviikko;5;1;6
95;25.01.2017;2017;01;09;Keskiviikko;1;2;3
95;25.01.2017;2017;01;10;Keskiviikko;2;1;3
95;25.01.2017;2017;01;11;Keskiviikko;4;3;7
95;25.01.2017;2017;01;12;Keskiviikko;4;2;6
95;25.01.2017;2017;01;13;Keskiviikko;5;7;12
95;25.01.2017;2017;01;14;Keskiviikko;6;5;11
95;25.01.2017;2017;01;15;Keskiviikko;2;8;10
95;25.01.2017;2017;01;16;Keskiviikko;6;5;11
95;25.01.2017;2017;01;17;Keskiviikko;1;1;2
95;25.01.2017;2017;01;18;Keskiviikko;0;1;1
95;25.01.2017;2017;01;19;Keskiviikko;3;4;7
95;25.01.2017;2017;01;20;Keskiviikko;2;2;4
95;25.01.2017;2017;01;21;Keskiviikko;2;2;4
95;25.01.2017;2017;01;22;Keskiviikko;0;0;0
95;25.01.2017;2017;01;23;Keskiviikko;0;0;0
95;26.01.2017;2017;01;00;Torstai;0;0;0
95;26.01.2017;2017;01;01;Torstai;0;0;0
95;26.01.2017;2017;01;02;Torstai;0;0;0
95;26.01.2017;2017;01;03;Torstai;2;1;3
95;26.01.2017;2017;01;04;Torstai;0;1;1
95;26.01.2017;2017;01;05;Torstai;4;1;5
95;26.01.2017;2017;01;06;Torstai;3;6;9
95;26.01.2017;2017;01;07;Torstai;8;6;14
95;26.01.2017;2017;01;08;Torstai;4;5;9
95;26.01.2017;2017;01;09;Torstai;5;3;8
95;26.01.2017;2017;01;10;Torstai;5;2;7
95;26.01.2017;2017;01;11;Torstai;0;5;5
95;26.01.2017;2017;01;12;Torstai;2;3;5
95;26.01.2017;2017;01;13;Torstai;4;4;8
95;26.01.2017;2017;01;14;Torstai;5;8;13
95;26.01.2017;2017;01;15;Torstai;10;6;16
95;26.01.2017;2017;01;16;Torstai;6;6;12
95;26.01.2017;2017;01;17;Torstai;4;4;8
95;26.01.2017;2017;01;18;Torstai;1;4;5
95;26.01.2017;2017;01;19;Torstai;2;2;4
95;26.01.2017;2017;01;20;Torstai;1;4;5
95;26.01.2017;2017;01;21;Torstai;0;0;0
95;26.01.2017;2017;01;22;Torstai;0;0;0
95;26.01.2017;2017;01;23;Torstai;0;0;0
95;27.01.2017;2017;01;00;Perjantai;0;0;0
95;27.01.2017;2017;01;01;Perjantai;0;0;0
95;27.01.2017;2017;01;02;Perjantai;0;0;0
95;27.01.2017;2017;01;03;Perjantai;0;0;0
95;27.01.2017;2017;01;04;Perjantai;0;0;0
95;27.01.2017;2017;01;05;Perjantai;6;2;8
95;27.01.2017;2017;01;06;Perjantai;11;7;18
95;27.01.2017;2017;01;07;Perjantai;8;11;19
95;27.01.2017;2017;01;08;Perjantai;4;3;7
95;27.01.2017;2017;01;09;Perjantai;4;2;6
95;27.01.2017;2017;01;10;Perjantai;2;0;2
95;27.01.2017;2017;01;11;Perjantai;1;3;4
95;27.01.2017;2017;01;12;Perjantai;2;3;5
95;27.01.2017;2017;01;13;Perjantai;4;2;6
95;27.01.2017;2017;01;14;Perjantai;15;8;23
95;27.01.2017;2017;01;15;Perjantai;4;6;10
95;27.01.2017;2017;01;16;Perjantai;7;6;13
95;27.01.2017;2017;01;17;Perjantai;3;5;8
95;27.01.2017;2017;01;18;Perjantai;0;3;3
95;27.01.2017;2017;01;19;Perjantai;0;2;2
95;27.01.2017;2017;01;20;Perjantai;0;2;2
95;27.01.2017;2017;01;21;Perjantai;0;1;1
95;27.01.2017;2017;01;22;Perjantai;1;2;3
95;27.01.2017;2017;01;23;Perjantai;1;0;1
95;28.01.2017;2017;01;00;Lauantai;0;0;0
95;28.01.2017;2017;01;01;Lauantai;0;0;0
95;28.01.2017;2017;01;02;Lauantai;0;1;1
95;28.01.2017;2017;01;03;Lauantai;0;0;0
95;28.01.2017;2017;01;04;Lauantai;2;0;2
95;28.01.2017;2017;01;05;Lauantai;0;0;0
95;28.01.2017;2017;01;06;Lauantai;1;0;1
95;28.01.2017;2017;01;07;Lauantai;0;0;0
95;28.01.2017;2017;01;08;Lauantai;1;2;3
95;28.01.2017;2017;01;09;Lauantai;0;1;1
95;28.01.2017;2017;01;10;Lauantai;2;2;4
95;28.01.2017;2017;01;11;Lauantai;4;1;5
95;28.01.2017;2017;01;12;Lauantai;4;10;14
95;28.01.2017;2017;01;13;Lauantai;5;10;15
95;28.01.2017;2017;01;14;Lauantai;6;4;10
95;28.01.2017;2017;01;15;Lauantai;2;3;5
95;28.01.2017;2017;01;16;Lauantai;0;3;3
95;28.01.2017;2017;01;17;Lauantai;4;2;6
95;28.01.2017;2017;01;18;Lauantai;4;1;5
95;28.01.2017;2017;01;19;Lauantai;4;1;5
95;28.01.2017;2017;01;20;Lauantai;1;0;1
95;28.01.2017;2017;01;21;Lauantai;0;0;0
95;28.01.2017;2017;01;22;Lauantai;0;3;3
95;28.01.2017;2017;01;23;Lauantai;0;0;0
95;29.01.2017;2017;01;00;Sunnuntai;0;1;1
95;29.01.2017;2017;01;01;Sunnuntai;0;0;0
95;29.01.2017;2017;01;02;Sunnuntai;0;0;0
95;29.01.2017;2017;01;03;Sunnuntai;0;0;0
95;29.01.2017;2017;01;04;Sunnuntai;2;0;2
95;29.01.2017;2017;01;05;Sunnuntai;0;0;0
95;29.01.2017;2017;01;06;Sunnuntai;0;0;0
95;29.01.2017;2017;01;07;Sunnuntai;1;1;2
95;29.01.2017;2017;01;08;Sunnuntai;0;2;2
95;29.01.2017;2017;01;09;Sunnuntai;1;1;2
95;29.01.2017;2017;01;10;Sunnuntai;3;3;6
95;29.01.2017;2017;01;11;Sunnuntai;2;0;2
95;29.01.2017;2017;01;12;Sunnuntai;2;3;5
95;29.01.2017;2017;01;13;Sunnuntai;3;2;5
95;29.01.2017;2017;01;14;Sunnuntai;1;1;2
95;29.01.2017;2017;01;15;Sunnuntai;2;2;4
95;29.01.2017;2017;01;16;Sunnuntai;0;3;3
95;29.01.2017;2017;01;17;Sunnuntai;2;1;3
95;29.01.2017;2017;01;18;Sunnuntai;1;1;2
95;29.01.2017;2017;01;19;Sunnuntai;5;1;6
95;29.01.2017;2017;01;20;Sunnuntai;4;0;4
95;29.01.2017;2017;01;21;Sunnuntai;0;2;2
95;29.01.2017;2017;01;22;Sunnuntai;1;1;2
95;29.01.2017;2017;01;23;Sunnuntai;0;0;0
95;30.01.2017;2017;01;00;Maanantai;0;1;1
95;30.01.2017;2017;01;01;Maanantai;0;0;0
95;30.01.2017;2017;01;02;Maanantai;0;0;0
95;30.01.2017;2017;01;03;Maanantai;0;0;0
95;30.01.2017;2017;01;04;Maanantai;0;1;1
95;30.01.2017;2017;01;05;Maanantai;6;1;7
95;30.01.2017;2017;01;06;Maanantai;5;4;9
95;30.01.2017;2017;01;07;Maanantai;9;9;18
95;30.01.2017;2017;01;08;Maanantai;1;4;5
95;30.01.2017;2017;01;09;Maanantai;3;2;5
95;30.01.2017;2017;01;10;Maanantai;3;1;4
95;30.01.2017;2017;01;11;Maanantai;8;2;10
95;30.01.2017;2017;01;12;Maanantai;2;2;4
95;30.01.2017;2017;01;13;Maanantai;7;3;10
95;30.01.2017;2017;01;14;Maanantai;5;4;9
95;30.01.2017;2017;01;15;Maanantai;15;12;27
95;30.01.2017;2017;01;16;Maanantai;11;9;20
95;30.01.2017;2017;01;17;Maanantai;5;6;11
95;30.01.2017;2017;01;18;Maanantai;2;4;6
95;30.01.2017;2017;01;19;Maanantai;2;8;10
95;30.01.2017;2017;01;20;Maanantai;5;2;7
95;30.01.2017;2017;01;21;Maanantai;1;2;3
95;30.01.2017;2017;01;22;Maanantai;1;1;2
95;30.01.2017;2017;01;23;Maanantai;0;0;0
95;31.01.2017;2017;01;00;Tiistai;0;0;0
95;31.01.2017;2017;01;01;Tiistai;0;0;0
95;31.01.2017;2017;01;02;Tiistai;0;0;0
95;31.01.2017;2017;01;03;Tiistai;0;1;1
95;31.01.2017;2017;01;04;Tiistai;0;0;0
95;31.01.2017;2017;01;05;Tiistai;4;1;5
95;31.01.2017;2017;01;06;Tiistai;11;6;17
95;31.01.2017;2017;01;07;Tiistai;17;9;26
95;31.01.2017;2017;01;08;Tiistai;4;7;11
95;31.01.2017;2017;01;09;Tiistai;1;2;3
95;31.01.2017;2017;01;10;Tiistai;2;3;5
95;31.01.2017;2017;01;11;Tiistai;5;3;8
95;31.01.2017;2017;01;12;Tiistai;4;1;5
95;31.01.2017;2017;01;13;Tiistai;13;5;18
95;31.01.2017;2017;01;14;Tiistai;1;4;5
95;31.01.2017;2017;01;15;Tiistai;10;10;20
95;31.01.2017;2017;01;16;Tiistai;12;13;25
95;31.01.2017;2017;01;17;Tiistai;2;6;8
95;31.01.2017;2017;01;18;Tiistai;4;4;8
95;31.01.2017;2017;01;19;Tiistai;2;2;4
95;31.01.2017;2017;01;20;Tiistai;0;3;3
95;31.01.2017;2017;01;21;Tiistai;3;1;4
95;31.01.2017;2017;01;22;Tiistai;1;3;4
95;31.01.2017;2017;01;23;Tiistai;0;0;0
95;01.02.2017;2017;02;00;Keskiviikko;0;0;0
95;01.02.2017;2017;02;01;Keskiviikko;0;1;1
95;01.02.2017;2017;02;02;Keskiviikko;0;0;0
95;01.02.2017;2017;02;03;Keskiviikko;0;0;0
95;01.02.2017;2017;02;04;Keskiviikko;3;1;4
95;01.02.2017;2017;02;05;Keskiviikko;2;1;3
95;01.02.2017;2017;02;06;Keskiviikko;4;3;7
95;01.02.2017;2017;02;07;Keskiviikko;9;9;18
95;01.02.2017;2017;02;08;Keskiviikko;4;10;14
95;01.02.2017;2017;02;09;Keskiviikko;1;2;3
95;01.02.2017;2017;02;10;Keskiviikko;6;2;8
95;01.02.2017;2017;02;11;Keskiviikko;2;0;2
95;01.02.2017;2017;02;12;Keskiviikko;4;1;5
95;01.02.2017;2017;02;13;Keskiviikko;6;5;11
95;01.02.2017;2017;02;14;Keskiviikko;3;5;8
95;01.02.2017;2017;02;15;Keskiviikko;7;9;16
95;01.02.2017;2017;02;16;Keskiviikko;8;9;17
95;01.02.2017;2017;02;17;Keskiviikko;2;4;6
95;01.02.2017;2017;02;18;Keskiviikko;3;4;7
95;01.02.2017;2017;02;19;Keskiviikko;2;5;7
95;01.02.2017;2017;02;20;Keskiviikko;2;0;2
95;01.02.2017;2017;02;21;Keskiviikko;1;0;1
95;01.02.2017;2017;02;22;Keskiviikko;1;2;3
95;01.02.2017;2017;02;23;Keskiviikko;0;0;0
95;02.02.2017;2017;02;00;Torstai;0;0;0
95;02.02.2017;2017;02;01;Torstai;0;0;0
95;02.02.2017;2017;02;02;Torstai;0;0;0
95;02.02.2017;2017;02;03;Torstai;0;0;0
95;02.02.2017;2017;02;04;Torstai;1;0;1
95;02.02.2017;2017;02;05;Torstai;3;1;4
95;02.02.2017;2017;02;06;Torstai;11;6;17
95;02.02.2017;2017;02;07;Torstai;7;8;15
95;02.02.2017;2017;02;08;Torstai;3;4;7
95;02.02.2017;2017;02;09;Torstai;1;2;3
95;02.02.2017;2017;02;10;Torstai;3;0;3
95;02.02.2017;2017;02;11;Torstai;2;0;2
95;02.02.2017;2017;02;12;Torstai;4;0;4
95;02.02.2017;2017;02;13;Torstai;2;4;6
95;02.02.2017;2017;02;14;Torstai;4;6;10
95;02.02.2017;2017;02;15;Torstai;2;7;9
95;02.02.2017;2017;02;16;Torstai;9;4;13
95;02.02.2017;2017;02;17;Torstai;1;4;5
95;02.02.2017;2017;02;18;Torstai;2;2;4
95;02.02.2017;2017;02;19;Torstai;1;2;3
95;02.02.2017;2017;02;20;Torstai;1;1;2
95;02.02.2017;2017;02;21;Torstai;0;0;0
95;02.02.2017;2017;02;22;Torstai;2;1;3
95;02.02.2017;2017;02;23;Torstai;0;0;0
95;03.02.2017;2017;02;00;Perjantai;0;0;0
95;03.02.2017;2017;02;01;Perjantai;0;0;0
95;03.02.2017;2017;02;02;Perjantai;0;0;0
95;03.02.2017;2017;02;03;Perjantai;0;0;0
95;03.02.2017;2017;02;04;Perjantai;0;0;0
95;03.02.2017;2017;02;05;Perjantai;3;1;4
95;03.02.2017;2017;02;06;Perjantai;7;2;9
95;03.02.2017;2017;02;07;Perjantai;6;8;14
95;03.02.2017;2017;02;08;Perjantai;3;5;8
95;03.02.2017;2017;02;09;Perjantai;2;2;4
95;03.02.2017;2017;02;10;Perjantai;3;0;3
95;03.02.2017;2017;02;11;Perjantai;3;3;6
95;03.02.2017;2017;02;12;Perjantai;2;0;2
95;03.02.2017;2017;02;13;Perjantai;2;6;8
95;03.02.2017;2017;02;14;Perjantai;6;1;7
95;03.02.2017;2017;02;15;Perjantai;4;8;12
95;03.02.2017;2017;02;16;Perjantai;5;6;11
95;03.02.2017;2017;02;17;Perjantai;2;1;3
95;03.02.2017;2017;02;18;Perjantai;2;5;7
95;03.02.2017;2017;02;19;Perjantai;1;1;2
95;03.02.2017;2017;02;20;Perjantai;0;1;1
95;03.02.2017;2017;02;21;Perjantai;2;0;2
95;03.02.2017;2017;02;22;Perjantai;0;2;2
95;03.02.2017;2017;02;23;Perjantai;0;0;0
95;04.02.2017;2017;02;00;Lauantai;0;1;1
95;04.02.2017;2017;02;01;Lauantai;2;0;2
95;04.02.2017;2017;02;02;Lauantai;0;0;0
95;04.02.2017;2017;02;03;Lauantai;0;1;1
95;04.02.2017;2017;02;04;Lauantai;0;0;0
95;04.02.2017;2017;02;05;Lauantai;2;1;3
95;04.02.2017;2017;02;06;Lauantai;2;0;2
95;04.02.2017;2017;02;07;Lauantai;3;0;3
95;04.02.2017;2017;02;08;Lauantai;0;0;0
95;04.02.2017;2017;02;09;Lauantai;4;1;5
95;04.02.2017;2017;02;10;Lauantai;0;1;1
95;04.02.2017;2017;02;11;Lauantai;1;6;7
95;04.02.2017;2017;02;12;Lauantai;7;3;10
95;04.02.2017;2017;02;13;Lauantai;6;4;10
95;04.02.2017;2017;02;14;Lauantai;1;4;5
95;04.02.2017;2017;02;15;Lauantai;2;2;4
95;04.02.2017;2017;02;16;Lauantai;2;4;6
95;04.02.2017;2017;02;17;Lauantai;6;2;8
95;04.02.2017;2017;02;18;Lauantai;0;4;4
95;04.02.2017;2017;02;19;Lauantai;1;0;1
95;04.02.2017;2017;02;20;Lauantai;0;1;1
95;04.02.2017;2017;02;21;Lauantai;2;1;3
95;04.02.2017;2017;02;22;Lauantai;0;1;1
95;04.02.2017;2017;02;23;Lauantai;0;0;0
95;05.02.2017;2017;02;00;Sunnuntai;1;0;1
95;05.02.2017;2017;02;01;Sunnuntai;0;0;0
95;05.02.2017;2017;02;02;Sunnuntai;1;0;1
95;05.02.2017;2017;02;03;Sunnuntai;0;0;0
95;05.02.2017;2017;02;04;Sunnuntai;1;1;2
95;05.02.2017;2017;02;05;Sunnuntai;2;0;2
95;05.02.2017;2017;02;06;Sunnuntai;0;0;0
95;05.02.2017;2017;02;07;Sunnuntai;0;0;0
95;05.02.2017;2017;02;08;Sunnuntai;1;2;3
95;05.02.2017;2017;02;09;Sunnuntai;1;3;4
95;05.02.2017;2017;02;10;Sunnuntai;3;1;4
95;05.02.2017;2017;02;11;Sunnuntai;5;2;7
95;05.02.2017;2017;02;12;Sunnuntai;4;3;7
95;05.02.2017;2017;02;13;Sunnuntai;0;4;4
95;05.02.2017;2017;02;14;Sunnuntai;1;3;4
95;05.02.2017;2017;02;15;Sunnuntai;7;3;10
95;05.02.2017;2017;02;16;Sunnuntai;0;1;1
95;05.02.2017;2017;02;17;Sunnuntai;0;1;1
95;05.02.2017;2017;02;18;Sunnuntai;2;0;2
95;05.02.2017;2017;02;19;Sunnuntai;1;1;2
95;05.02.2017;2017;02;20;Sunnuntai;1;0;1
95;05.02.2017;2017;02;21;Sunnuntai;1;2;3
95;05.02.2017;2017;02;22;Sunnuntai;0;1;1
95;05.02.2017;2017;02;23;Sunnuntai;0;0;0
95;06.02.2017;2017;02;00;Maanantai;0;0;0
95;06.02.2017;2017;02;01;Maanantai;0;0;0
95;06.02.2017;2017;02;02;Maanantai;0;0;0
95;06.02.2017;2017;02;03;Maanantai;0;0;0
95;06.02.2017;2017;02;04;Maanantai;0;1;1
95;06.02.2017;2017;02;05;Maanantai;7;2;9
95;06.02.2017;2017;02;06;Maanantai;6;1;7
95;06.02.2017;2017;02;07;Maanantai;11;10;21
95;06.02.2017;2017;02;08;Maanantai;3;5;8
95;06.02.2017;2017;02;09;Maanantai;3;2;5
95;06.02.2017;2017;02;10;Maanantai;2;2;4
95;06.02.2017;2017;02;11;Maanantai;0;0;0
95;06.02.2017;2017;02;12;Maanantai;8;3;11
95;06.02.2017;2017;02;13;Maanantai;5;2;7
95;06.02.2017;2017;02;14;Maanantai;7;7;14
95;06.02.2017;2017;02;15;Maanantai;6;5;11
95;06.02.2017;2017;02;16;Maanantai;9;5;14
95;06.02.2017;2017;02;17;Maanantai;2;7;9
95;06.02.2017;2017;02;18;Maanantai;0;0;0
95;06.02.2017;2017;02;19;Maanantai;3;2;5
95;06.02.2017;2017;02;20;Maanantai;3;0;3
95;06.02.2017;2017;02;21;Maanantai;0;2;2
95;06.02.2017;2017;02;22;Maanantai;0;2;2
95;06.02.2017;2017;02;23;Maanantai;1;0;1
95;07.02.2017;2017;02;00;Tiistai;0;0;0
95;07.02.2017;2017;02;01;Tiistai;0;0;0
95;07.02.2017;2017;02;02;Tiistai;0;0;0
95;07.02.2017;2017;02;03;Tiistai;0;0;0
95;07.02.2017;2017;02;04;Tiistai;2;0;2
95;07.02.2017;2017;02;05;Tiistai;3;1;4
95;07.02.2017;2017;02;06;Tiistai;2;2;4
95;07.02.2017;2017;02;07;Tiistai;5;6;11
95;07.02.2017;2017;02;08;Tiistai;6;7;13
95;07.02.2017;2017;02;09;Tiistai;2;3;5
95;07.02.2017;2017;02;10;Tiistai;4;2;6
95;07.02.2017;2017;02;11;Tiistai;2;0;2
95;07.02.2017;2017;02;12;Tiistai;2;4;6
95;07.02.2017;2017;02;13;Tiistai;5;2;7
95;07.02.2017;2017;02;14;Tiistai;8;5;13
95;07.02.2017;2017;02;15;Tiistai;5;4;9
95;07.02.2017;2017;02;16;Tiistai;11;5;16
95;07.02.2017;2017;02;17;Tiistai;7;2;9
95;07.02.2017;2017;02;18;Tiistai;2;7;9
95;07.02.2017;2017;02;19;Tiistai;6;3;9
95;07.02.2017;2017;02;20;Tiistai;1;6;7
95;07.02.2017;2017;02;21;Tiistai;0;2;2
95;07.02.2017;2017;02;22;Tiistai;0;1;1
95;07.02.2017;2017;02;23;Tiistai;1;0;1
95;08.02.2017;2017;02;00;Keskiviikko;0;0;0
95;08.02.2017;2017;02;01;Keskiviikko;0;0;0
95;08.02.2017;2017;02;02;Keskiviikko;0;0;0
95;08.02.2017;2017;02;03;Keskiviikko;0;0;0
95;08.02.2017;2017;02;04;Keskiviikko;2;0;2
95;08.02.2017;2017;02;05;Keskiviikko;4;1;5
95;08.02.2017;2017;02;06;Keskiviikko;3;3;6
95;08.02.2017;2017;02;07;Keskiviikko;6;5;11
95;08.02.2017;2017;02;08;Keskiviikko;2;3;5
95;08.02.2017;2017;02;09;Keskiviikko;1;3;4
95;08.02.2017;2017;02;10;Keskiviikko;2;1;3
95;08.02.2017;2017;02;11;Keskiviikko;4;0;4
95;08.02.2017;2017;02;12;Keskiviikko;2;1;3
95;08.02.2017;2017;02;13;Keskiviikko;6;5;11
95;08.02.2017;2017;02;14;Keskiviikko;3;6;9
95;08.02.2017;2017;02;15;Keskiviikko;3;5;8
95;08.02.2017;2017;02;16;Keskiviikko;6;3;9
95;08.02.2017;2017;02;17;Keskiviikko;1;4;5
95;08.02.2017;2017;02;18;Keskiviikko;1;3;4
95;08.02.2017;2017;02;19;Keskiviikko;4;1;5
95;08.02.2017;2017;02;20;Keskiviikko;1;1;2
95;08.02.2017;2017;02;21;Keskiviikko;2;0;2
95;08.02.2017;2017;02;22;Keskiviikko;0;1;1
95;08.02.2017;2017;02;23;Keskiviikko;1;1;2
95;09.02.2017;2017;02;00;Torstai;0;0;0
95;09.02.2017;2017;02;01;Torstai;0;0;0
95;09.02.2017;2017;02;02;Torstai;0;0;0
95;09.02.2017;2017;02;03;Torstai;0;0;0
95;09.02.2017;2017;02;04;Torstai;0;0;0
95;09.02.2017;2017;02;05;Torstai;1;2;3
95;09.02.2017;2017;02;06;Torstai;2;4;6
95;09.02.2017;2017;02;07;Torstai;3;1;4
95;09.02.2017;2017;02;08;Torstai;3;2;5
95;09.02.2017;2017;02;09;Torstai;0;1;1
95;09.02.2017;2017;02;10;Torstai;1;2;3
95;09.02.2017;2017;02;11;Torstai;4;0;4
95;09.02.2017;2017;02;12;Torstai;2;0;2
95;09.02.2017;2017;02;13;Torstai;0;1;1
95;09.02.2017;2017;02;14;Torstai;2;7;9
95;09.02.2017;2017;02;15;Torstai;4;2;6
95;09.02.2017;2017;02;16;Torstai;4;1;5
95;09.02.2017;2017;02;17;Torstai;1;2;3
95;09.02.2017;2017;02;18;Torstai;0;2;2
95;09.02.2017;2017;02;19;Torstai;3;4;7
95;09.02.2017;2017;02;20;Torstai;2;1;3
95;09.02.2017;2017;02;21;Torstai;0;2;2
95;09.02.2017;2017;02;22;Torstai;0;2;2
95;09.02.2017;2017;02;23;Torstai;0;0;0
95;10.02.2017;2017;02;00;Perjantai;0;0;0
95;10.02.2017;2017;02;01;Perjantai;0;0;0
95;10.02.2017;2017;02;02;Perjantai;0;0;0
95;10.02.2017;2017;02;03;Perjantai;2;0;2
95;10.02.2017;2017;02;04;Perjantai;1;0;1
95;10.02.2017;2017;02;05;Perjantai;4;2;6
95;10.02.2017;2017;02;06;Perjantai;1;3;4
95;10.02.2017;2017;02;07;Perjantai;7;7;14
95;10.02.2017;2017;02;08;Perjantai;0;1;1
95;10.02.2017;2017;02;09;Perjantai;2;4;6
95;10.02.2017;2017;02;10;Perjantai;1;0;1
95;10.02.2017;2017;02;11;Perjantai;1;0;1
95;10.02.2017;2017;02;12;Perjantai;5;1;6
95;10.02.2017;2017;02;13;Perjantai;2;2;4
95;10.02.2017;2017;02;14;Perjantai;8;7;15
95;10.02.2017;2017;02;15;Perjantai;10;6;16
95;10.02.2017;2017;02;16;Perjantai;3;4;7
95;10.02.2017;2017;02;17;Perjantai;2;6;8
95;10.02.2017;2017;02;18;Perjantai;1;3;4
95;10.02.2017;2017;02;19;Perjantai;1;0;1
95;10.02.2017;2017;02;20;Perjantai;0;1;1
95;10.02.2017;2017;02;21;Perjantai;0;1;1
95;10.02.2017;2017;02;22;Perjantai;0;1;1
95;10.02.2017;2017;02;23;Perjantai;0;0;0
95;11.02.2017;2017;02;00;Lauantai;0;0;0
95;11.02.2017;2017;02;01;Lauantai;0;0;0
95;11.02.2017;2017;02;02;Lauantai;0;0;0
95;11.02.2017;2017;02;03;Lauantai;1;0;1
95;11.02.2017;2017;02;04;Lauantai;1;1;2
95;11.02.2017;2017;02;05;Lauantai;0;0;0
95;11.02.2017;2017;02;06;Lauantai;0;0;0
95;11.02.2017;2017;02;07;Lauantai;0;0;0
95;11.02.2017;2017;02;08;Lauantai;0;0;0
95;11.02.2017;2017;02;09;Lauantai;1;1;2
95;11.02.2017;2017;02;10;Lauantai;2;1;3
95;11.02.2017;2017;02;11;Lauantai;2;3;5
95;11.02.2017;2017;02;12;Lauantai;3;2;5
95;11.02.2017;2017;02;13;Lauantai;1;4;5
95;11.02.2017;2017;02;14;Lauantai;3;2;5
95;11.02.2017;2017;02;15;Lauantai;1;1;2
95;11.02.2017;2017;02;16;Lauantai;6;2;8
95;11.02.2017;2017;02;17;Lauantai;0;6;6
95;11.02.2017;2017;02;18;Lauantai;2;2;4
95;11.02.2017;2017;02;19;Lauantai;2;0;2
95;11.02.2017;2017;02;20;Lauantai;1;0;1
95;11.02.2017;2017;02;21;Lauantai;0;2;2
95;11.02.2017;2017;02;22;Lauantai;2;0;2
95;11.02.2017;2017;02;23;Lauantai;0;0;0
95;12.02.2017;2017;02;00;Sunnuntai;0;0;0
95;12.02.2017;2017;02;01;Sunnuntai;0;1;1
95;12.02.2017;2017;02;02;Sunnuntai;0;0;0
95;12.02.2017;2017;02;03;Sunnuntai;0;0;0
95;12.02.2017;2017;02;04;Sunnuntai;0;0;0
95;12.02.2017;2017;02;05;Sunnuntai;0;0;0
95;12.02.2017;2017;02;06;Sunnuntai;1;0;1
95;12.02.2017;2017;02;07;Sunnuntai;2;0;2
95;12.02.2017;2017;02;08;Sunnuntai;0;0;0
95;12.02.2017;2017;02;09;Sunnuntai;1;1;2
95;12.02.2017;2017;02;10;Sunnuntai;1;2;3
95;12.02.2017;2017;02;11;Sunnuntai;5;4;9
95;12.02.2017;2017;02;12;Sunnuntai;5;2;7
95;12.02.2017;2017;02;13;Sunnuntai;4;6;10
95;12.02.2017;2017;02;14;Sunnuntai;1;5;6
95;12.02.2017;2017;02;15;Sunnuntai;6;2;8
95;12.02.2017;2017;02;16;Sunnuntai;1;1;2
95;12.02.2017;2017;02;17;Sunnuntai;3;4;7
95;12.02.2017;2017;02;18;Sunnuntai;4;1;5
95;12.02.2017;2017;02;19;Sunnuntai;1;1;2
95;12.02.2017;2017;02;20;Sunnuntai;0;0;0
95;12.02.2017;2017;02;21;Sunnuntai;1;0;1
95;12.02.2017;2017;02;22;Sunnuntai;0;0;0
95;12.02.2017;2017;02;23;Sunnuntai;0;0;0
95;13.02.2017;2017;02;00;Maanantai;0;0;0
95;13.02.2017;2017;02;01;Maanantai;0;0;0
95;13.02.2017;2017;02;02;Maanantai;0;0;0
95;13.02.2017;2017;02;03;Maanantai;0;0;0
95;13.02.2017;2017;02;04;Maanantai;0;0;0
95;13.02.2017;2017;02;05;Maanantai;5;2;7
95;13.02.2017;2017;02;06;Maanantai;5;3;8
95;13.02.2017;2017;02;07;Maanantai;9;6;15
95;13.02.2017;2017;02;08;Maanantai;5;9;14
95;13.02.2017;2017;02;09;Maanantai;1;3;4
95;13.02.2017;2017;02;10;Maanantai;3;1;4
95;13.02.2017;2017;02;11;Maanantai;4;3;7
95;13.02.2017;2017;02;12;Maanantai;5;3;8
95;13.02.2017;2017;02;13;Maanantai;5;4;9
95;13.02.2017;2017;02;14;Maanantai;5;9;14
95;13.02.2017;2017;02;15;Maanantai;11;9;20
95;13.02.2017;2017;02;16;Maanantai;7;7;14
95;13.02.2017;2017;02;17;Maanantai;4;4;8
95;13.02.2017;2017;02;18;Maanantai;1;2;3
95;13.02.2017;2017;02;19;Maanantai;2;3;5
95;13.02.2017;2017;02;20;Maanantai;3;3;6
95;13.02.2017;2017;02;21;Maanantai;0;1;1
95;13.02.2017;2017;02;22;Maanantai;1;2;3
95;13.02.2017;2017;02;23;Maanantai;0;1;1
95;14.02.2017;2017;02;00;Tiistai;0;0;0
95;14.02.2017;2017;02;01;Tiistai;0;0;0
95;14.02.2017;2017;02;02;Tiistai;0;0;0
95;14.02.2017;2017;02;03;Tiistai;0;0;0
95;14.02.2017;2017;02;04;Tiistai;1;0;1
95;14.02.2017;2017;02;05;Tiistai;5;2;7
95;14.02.2017;2017;02;06;Tiistai;4;4;8
95;14.02.2017;2017;02;07;Tiistai;12;12;24
95;14.02.2017;2017;02;08;Tiistai;6;4;10
95;14.02.2017;2017;02;09;Tiistai;2;5;7
95;14.02.2017;2017;02;10;Tiistai;6;0;6
95;14.02.2017;2017;02;11;Tiistai;4;1;5
95;14.02.2017;2017;02;12;Tiistai;2;1;3
95;14.02.2017;2017;02;13;Tiistai;2;9;11
95;14.02.2017;2017;02;14;Tiistai;4;5;9
95;14.02.2017;2017;02;15;Tiistai;13;10;23
95;14.02.2017;2017;02;16;Tiistai;4;4;8
95;14.02.2017;2017;02;17;Tiistai;2;4;6
95;14.02.2017;2017;02;18;Tiistai;4;5;9
95;14.02.2017;2017;02;19;Tiistai;0;1;1
95;14.02.2017;2017;02;20;Tiistai;0;6;6
95;14.02.2017;2017;02;21;Tiistai;0;1;1
95;14.02.2017;2017;02;22;Tiistai;1;1;2
95;14.02.2017;2017;02;23;Tiistai;0;0;0
95;15.02.2017;2017;02;00;Keskiviikko;0;0;0
95;15.02.2017;2017;02;01;Keskiviikko;0;0;0
95;15.02.2017;2017;02;02;Keskiviikko;0;0;0
95;15.02.2017;2017;02;03;Keskiviikko;0;0;0
95;15.02.2017;2017;02;04;Keskiviikko;0;0;0
95;15.02.2017;2017;02;05;Keskiviikko;7;2;9
95;15.02.2017;2017;02;06;Keskiviikko;4;2;6
95;15.02.2017;2017;02;07;Keskiviikko;7;9;16
95;15.02.2017;2017;02;08;Keskiviikko;1;2;3
95;15.02.2017;2017;02;09;Keskiviikko;0;2;2
95;15.02.2017;2017;02;10;Keskiviikko;3;3;6
95;15.02.2017;2017;02;11;Keskiviikko;2;3;5
95;15.02.2017;2017;02;12;Keskiviikko;0;3;3
95;15.02.2017;2017;02;13;Keskiviikko;4;4;8
95;15.02.2017;2017;02;14;Keskiviikko;14;3;17
95;15.02.2017;2017;02;15;Keskiviikko;8;7;15
95;15.02.2017;2017;02;16;Keskiviikko;6;2;8
95;15.02.2017;2017;02;17;Keskiviikko;7;4;11
95;15.02.2017;2017;02;18;Keskiviikko;2;8;10
95;15.02.2017;2017;02;19;Keskiviikko;0;2;2
95;15.02.2017;2017;02;20;Keskiviikko;0;1;1
95;15.02.2017;2017;02;21;Keskiviikko;0;1;1
95;15.02.2017;2017;02;22;Keskiviikko;2;0;2
95;15.02.2017;2017;02;23;Keskiviikko;0;0;0
95;16.02.2017;2017;02;00;Torstai;0;0;0
95;16.02.2017;2017;02;01;Torstai;0;0;0
95;16.02.2017;2017;02;02;Torstai;0;0;0
95;16.02.2017;2017;02;03;Torstai;0;0;0
95;16.02.2017;2017;02;04;Torstai;0;0;0
95;16.02.2017;2017;02;05;Torstai;2;4;6
95;16.02.2017;2017;02;06;Torstai;8;2;10
95;16.02.2017;2017;02;07;Torstai;8;7;15
95;16.02.2017;2017;02;08;Torstai;3;3;6
95;16.02.2017;2017;02;09;Torstai;4;5;9
95;16.02.2017;2017;02;10;Torstai;6;4;10
95;16.02.2017;2017;02;11;Torstai;0;0;0
95;16.02.2017;2017;02;12;Torstai;0;3;3
95;16.02.2017;2017;02;13;Torstai;3;3;6
95;16.02.2017;2017;02;14;Torstai;6;5;11
95;16.02.2017;2017;02;15;Torstai;6;5;11
95;16.02.2017;2017;02;16;Torstai;11;7;18
95;16.02.2017;2017;02;17;Torstai;1;1;2
95;16.02.2017;2017;02;18;Torstai;4;2;6
95;16.02.2017;2017;02;19;Torstai;1;5;6
95;16.02.2017;2017;02;20;Torstai;1;3;4
95;16.02.2017;2017;02;21;Torstai;0;0;0
95;16.02.2017;2017;02;22;Torstai;1;0;1
95;16.02.2017;2017;02;23;Torstai;1;0;1
95;17.02.2017;2017;02;00;Perjantai;0;0;0
95;17.02.2017;2017;02;01;Perjantai;0;0;0
95;17.02.2017;2017;02;02;Perjantai;0;0;0
95;17.02.2017;2017;02;03;Perjantai;0;0;0
95;17.02.2017;2017;02;04;Perjantai;2;0;2
95;17.02.2017;2017;02;05;Perjantai;1;4;5
95;17.02.2017;2017;02;06;Perjantai;8;4;12
95;17.02.2017;2017;02;07;Perjantai;5;9;14
95;17.02.2017;2017;02;08;Perjantai;1;6;7
95;17.02.2017;2017;02;09;Perjantai;1;0;1
95;17.02.2017;2017;02;10;Perjantai;2;2;4
95;17.02.2017;2017;02;11;Perjantai;1;2;3
95;17.02.2017;2017;02;12;Perjantai;4;1;5
95;17.02.2017;2017;02;13;Perjantai;2;5;7
95;17.02.2017;2017;02;14;Perjantai;7;5;12
95;17.02.2017;2017;02;15;Perjantai;8;8;16
95;17.02.2017;2017;02;16;Perjantai;6;5;11
95;17.02.2017;2017;02;17;Perjantai;4;4;8
95;17.02.2017;2017;02;18;Perjantai;0;4;4
95;17.02.2017;2017;02;19;Perjantai;2;2;4
95;17.02.2017;2017;02;20;Perjantai;0;1;1
95;17.02.2017;2017;02;21;Perjantai;0;1;1
95;17.02.2017;2017;02;22;Perjantai;0;2;2
95;17.02.2017;2017;02;23;Perjantai;0;0;0
95;18.02.2017;2017;02;00;Lauantai;0;0;0
95;18.02.2017;2017;02;01;Lauantai;1;0;1
95;18.02.2017;2017;02;02;Lauantai;0;0;0
95;18.02.2017;2017;02;03;Lauantai;0;0;0
95;18.02.2017;2017;02;04;Lauantai;3;1;4
95;18.02.2017;2017;02;05;Lauantai;1;1;2
95;18.02.2017;2017;02;06;Lauantai;0;0;0
95;18.02.2017;2017;02;07;Lauantai;0;0;0
95;18.02.2017;2017;02;08;Lauantai;2;0;2
95;18.02.2017;2017;02;09;Lauantai;3;1;4
95;18.02.2017;2017;02;10;Lauantai;1;0;1
95;18.02.2017;2017;02;11;Lauantai;0;3;3
95;18.02.2017;2017;02;12;Lauantai;2;7;9
95;18.02.2017;2017;02;13;Lauantai;4;1;5
95;18.02.2017;2017;02;14;Lauantai;0;2;2
95;18.02.2017;2017;02;15;Lauantai;2;6;8
95;18.02.2017;2017;02;16;Lauantai;4;4;8
95;18.02.2017;2017;02;17;Lauantai;4;2;6
95;18.02.2017;2017;02;18;Lauantai;1;0;1
95;18.02.2017;2017;02;19;Lauantai;2;0;2
95;18.02.2017;2017;02;20;Lauantai;0;3;3
95;18.02.2017;2017;02;21;Lauantai;0;1;1
95;18.02.2017;2017;02;22;Lauantai;1;1;2
95;18.02.2017;2017;02;23;Lauantai;1;0;1
95;19.02.2017;2017;02;00;Sunnuntai;0;2;2
95;19.02.2017;2017;02;01;Sunnuntai;0;0;0
95;19.02.2017;2017;02;02;Sunnuntai;0;0;0
95;19.02.2017;2017;02;03;Sunnuntai;0;0;0
95;19.02.2017;2017;02;04;Sunnuntai;0;0;0
95;19.02.2017;2017;02;05;Sunnuntai;1;0;1
95;19.02.2017;2017;02;06;Sunnuntai;1;0;1
95;19.02.2017;2017;02;07;Sunnuntai;0;0;0
95;19.02.2017;2017;02;08;Sunnuntai;0;2;2
95;19.02.2017;2017;02;09;Sunnuntai;0;0;0
95;19.02.2017;2017;02;10;Sunnuntai;1;2;3
95;19.02.2017;2017;02;11;Sunnuntai;7;6;13
95;19.02.2017;2017;02;12;Sunnuntai;5;2;7
95;19.02.2017;2017;02;13;Sunnuntai;1;3;4
95;19.02.2017;2017;02;14;Sunnuntai;0;2;2
95;19.02.2017;2017;02;15;Sunnuntai;4;2;6
95;19.02.2017;2017;02;16;Sunnuntai;2;1;3
95;19.02.2017;2017;02;17;Sunnuntai;0;1;1
95;19.02.2017;2017;02;18;Sunnuntai;1;1;2
95;19.02.2017;2017;02;19;Sunnuntai;7;4;11
95;19.02.2017;2017;02;20;Sunnuntai;0;0;0
95;19.02.2017;2017;02;21;Sunnuntai;3;1;4
95;19.02.2017;2017;02;22;Sunnuntai;0;3;3
95;19.02.2017;2017;02;23;Sunnuntai;0;0;0
95;20.02.2017;2017;02;00;Maanantai;0;0;0
95;20.02.2017;2017;02;01;Maanantai;0;0;0
95;20.02.2017;2017;02;02;Maanantai;0;0;0
95;20.02.2017;2017;02;03;Maanantai;0;0;0
95;20.02.2017;2017;02;04;Maanantai;2;0;2
95;20.02.2017;2017;02;05;Maanantai;1;2;3
95;20.02.2017;2017;02;06;Maanantai;7;5;12
95;20.02.2017;2017;02;07;Maanantai;8;6;14
95;20.02.2017;2017;02;08;Maanantai;2;2;4
95;20.02.2017;2017;02;09;Maanantai;1;2;3
95;20.02.2017;2017;02;10;Maanantai;3;2;5
95;20.02.2017;2017;02;11;Maanantai;5;4;9
95;20.02.2017;2017;02;12;Maanantai;5;2;7
95;20.02.2017;2017;02;13;Maanantai;1;5;6
95;20.02.2017;2017;02;14;Maanantai;7;6;13
95;20.02.2017;2017;02;15;Maanantai;4;8;12
95;20.02.2017;2017;02;16;Maanantai;10;6;16
95;20.02.2017;2017;02;17;Maanantai;1;7;8
95;20.02.2017;2017;02;18;Maanantai;1;2;3
95;20.02.2017;2017;02;19;Maanantai;1;6;7
95;20.02.2017;2017;02;20;Maanantai;3;1;4
95;20.02.2017;2017;02;21;Maanantai;1;1;2
95;20.02.2017;2017;02;22;Maanantai;0;3;3
95;20.02.2017;2017;02;23;Maanantai;0;1;1
95;21.02.2017;2017;02;00;Tiistai;0;0;0
95;21.02.2017;2017;02;01;Tiistai;0;0;0
95;21.02.2017;2017;02;02;Tiistai;0;0;0
95;21.02.2017;2017;02;03;Tiistai;0;0;0
95;21.02.2017;2017;02;04;Tiistai;1;0;1
95;21.02.2017;2017;02;05;Tiistai;3;2;5
95;21.02.2017;2017;02;06;Tiistai;5;1;6
95;21.02.2017;2017;02;07;Tiistai;10;8;18
95;21.02.2017;2017;02;08;Tiistai;2;7;9
95;21.02.2017;2017;02;09;Tiistai;2;0;2
95;21.02.2017;2017;02;10;Tiistai;3;1;4
95;21.02.2017;2017;02;11;Tiistai;1;2;3
95;21.02.2017;2017;02;12;Tiistai;3;3;6
95;21.02.2017;2017;02;13;Tiistai;0;2;2
95;21.02.2017;2017;02;14;Tiistai;8;5;13
95;21.02.2017;2017;02;15;Tiistai;11;6;17
95;21.02.2017;2017;02;16;Tiistai;7;2;9
95;21.02.2017;2017;02;17;Tiistai;1;2;3
95;21.02.2017;2017;02;18;Tiistai;0;2;2
95;21.02.2017;2017;02;19;Tiistai;0;3;3
95;21.02.2017;2017;02;20;Tiistai;1;3;4
95;21.02.2017;2017;02;21;Tiistai;1;0;1
95;21.02.2017;2017;02;22;Tiistai;0;0;0
95;21.02.2017;2017;02;23;Tiistai;0;0;0
95;22.02.2017;2017;02;00;Keskiviikko;0;0;0
95;22.02.2017;2017;02;01;Keskiviikko;1;0;1
95;22.02.2017;2017;02;02;Keskiviikko;0;0;0
95;22.02.2017;2017;02;03;Keskiviikko;0;0;0
95;22.02.2017;2017;02;04;Keskiviikko;0;0;0
95;22.02.2017;2017;02;05;Keskiviikko;3;2;5
95;22.02.2017;2017;02;06;Keskiviikko;3;2;5
95;22.02.2017;2017;02;07;Keskiviikko;6;8;14
95;22.02.2017;2017;02;08;Keskiviikko;2;2;4
95;22.02.2017;2017;02;09;Keskiviikko;3;3;6
95;22.02.2017;2017;02;10;Keskiviikko;4;2;6
95;22.02.2017;2017;02;11;Keskiviikko;2;0;2
95;22.02.2017;2017;02;12;Keskiviikko;5;3;8
95;22.02.2017;2017;02;13;Keskiviikko;5;5;10
95;22.02.2017;2017;02;14;Keskiviikko;7;3;10
95;22.02.2017;2017;02;15;Keskiviikko;4;7;11
95;22.02.2017;2017;02;16;Keskiviikko;8;3;11
95;22.02.2017;2017;02;17;Keskiviikko;3;4;7
95;22.02.2017;2017;02;18;Keskiviikko;3;4;7
95;22.02.2017;2017;02;19;Keskiviikko;0;1;1
95;22.02.2017;2017;02;20;Keskiviikko;0;3;3
95;22.02.2017;2017;02;21;Keskiviikko;0;1;1
95;22.02.2017;2017;02;22;Keskiviikko;0;0;0
95;22.02.2017;2017;02;23;Keskiviikko;0;1;1
95;23.02.2017;2017;02;00;Torstai;1;1;2
95;23.02.2017;2017;02;01;Torstai;0;0;0
95;23.02.2017;2017;02;02;Torstai;0;0;0
95;23.02.2017;2017;02;03;Torstai;0;0;0
95;23.02.2017;2017;02;04;Torstai;0;0;0
95;23.02.2017;2017;02;05;Torstai;1;3;4
95;23.02.2017;2017;02;06;Torstai;4;2;6
95;23.02.2017;2017;02;07;Torstai;5;4;9
95;23.02.2017;2017;02;08;Torstai;4;3;7
95;23.02.2017;2017;02;09;Torstai;4;2;6
95;23.02.2017;2017;02;10;Torstai;0;1;1
95;23.02.2017;2017;02;11;Torstai;4;1;5
95;23.02.2017;2017;02;12;Torstai;1;0;1
95;23.02.2017;2017;02;13;Torstai;1;2;3
95;23.02.2017;2017;02;14;Torstai;4;3;7
95;23.02.2017;2017;02;15;Torstai;4;3;7
95;23.02.2017;2017;02;16;Torstai;8;3;11
95;23.02.2017;2017;02;17;Torstai;0;5;5
95;23.02.2017;2017;02;18;Torstai;1;2;3
95;23.02.2017;2017;02;19;Torstai;2;1;3
95;23.02.2017;2017;02;20;Torstai;0;1;1
95;23.02.2017;2017;02;21;Torstai;0;1;1
95;23.02.2017;2017;02;22;Torstai;0;1;1
95;23.02.2017;2017;02;23;Torstai;1;0;1
95;24.02.2017;2017;02;00;Perjantai;0;0;0
95;24.02.2017;2017;02;01;Perjantai;0;0;0
95;24.02.2017;2017;02;02;Perjantai;0;0;0
95;24.02.2017;2017;02;03;Perjantai;0;0;0
95;24.02.2017;2017;02;04;Perjantai;0;0;0
95;24.02.2017;2017;02;05;Perjantai;5;2;7
95;24.02.2017;2017;02;06;Perjantai;3;3;6
95;24.02.2017;2017;02;07;Perjantai;7;4;11
95;24.02.2017;2017;02;08;Perjantai;1;3;4
95;24.02.2017;2017;02;09;Perjantai;4;3;7
95;24.02.2017;2017;02;10;Perjantai;4;0;4
95;24.02.2017;2017;02;11;Perjantai;2;4;6
95;24.02.2017;2017;02;12;Perjantai;1;2;3
95;24.02.2017;2017;02;13;Perjantai;2;0;2
95;24.02.2017;2017;02;14;Perjantai;2;4;6
95;24.02.2017;2017;02;15;Perjantai;7;4;11
95;24.02.2017;2017;02;16;Perjantai;1;4;5
95;24.02.2017;2017;02;17;Perjantai;1;2;3
95;24.02.2017;2017;02;18;Perjantai;1;3;4
95;24.02.2017;2017;02;19;Perjantai;1;0;1
95;24.02.2017;2017;02;20;Perjantai;0;0;0
95;24.02.2017;2017;02;21;Perjantai;2;3;5
95;24.02.2017;2017;02;22;Perjantai;1;2;3
95;24.02.2017;2017;02;23;Perjantai;1;1;2
95;25.02.2017;2017;02;00;Lauantai;0;0;0
95;25.02.2017;2017;02;01;Lauantai;0;0;0
95;25.02.2017;2017;02;02;Lauantai;0;0;0
95;25.02.2017;2017;02;03;Lauantai;0;0;0
95;25.02.2017;2017;02;04;Lauantai;0;0;0
95;25.02.2017;2017;02;05;Lauantai;0;1;1
95;25.02.2017;2017;02;06;Lauantai;0;0;0
95;25.02.2017;2017;02;07;Lauantai;0;1;1
95;25.02.2017;2017;02;08;Lauantai;3;0;3
95;25.02.2017;2017;02;09;Lauantai;0;0;0
95;25.02.2017;2017;02;10;Lauantai;2;4;6
95;25.02.2017;2017;02;11;Lauantai;0;1;1
95;25.02.2017;2017;02;12;Lauantai;1;0;1
95;25.02.2017;2017;02;13;Lauantai;4;1;5
95;25.02.2017;2017;02;14;Lauantai;1;4;5
95;25.02.2017;2017;02;15;Lauantai;3;2;5
95;25.02.2017;2017;02;16;Lauantai;3;4;7
95;25.02.2017;2017;02;17;Lauantai;0;2;2
95;25.02.2017;2017;02;18;Lauantai;0;0;0
95;25.02.2017;2017;02;19;Lauantai;0;0;0
95;25.02.2017;2017;02;20;Lauantai;0;1;1
95;25.02.2017;2017;02;21;Lauantai;1;0;1
95;25.02.2017;2017;02;22;Lauantai;0;1;1
95;25.02.2017;2017;02;23;Lauantai;0;1;1
95;26.02.2017;2017;02;00;Sunnuntai;0;0;0
95;26.02.2017;2017;02;01;Sunnuntai;0;1;1
95;26.02.2017;2017;02;02;Sunnuntai;0;0;0
95;26.02.2017;2017;02;03;Sunnuntai;1;0;1
95;26.02.2017;2017;02;04;Sunnuntai;0;0;0
95;26.02.2017;2017;02;05;Sunnuntai;0;1;1
95;26.02.2017;2017;02;06;Sunnuntai;0;0;0
95;26.02.2017;2017;02;07;Sunnuntai;0;0;0
95;26.02.2017;2017;02;08;Sunnuntai;0;1;1
95;26.02.2017;2017;02;09;Sunnuntai;0;0;0
95;26.02.2017;2017;02;10;Sunnuntai;2;0;2
95;26.02.2017;2017;02;11;Sunnuntai;2;3;5
95;26.02.2017;2017;02;12;Sunnuntai;3;1;4
95;26.02.2017;2017;02;13;Sunnuntai;3;3;6
95;26.02.2017;2017;02;14;Sunnuntai;5;2;7
95;26.02.2017;2017;02;15;Sunnuntai;4;0;4
95;26.02.2017;2017;02;16;Sunnuntai;1;4;5
95;26.02.2017;2017;02;17;Sunnuntai;1;0;1
95;26.02.2017;2017;02;18;Sunnuntai;0;0;0
95;26.02.2017;2017;02;19;Sunnuntai;2;4;6
95;26.02.2017;2017;02;20;Sunnuntai;3;0;3
95;26.02.2017;2017;02;21;Sunnuntai;0;0;0
95;26.02.2017;2017;02;22;Sunnuntai;0;0;0
95;26.02.2017;2017;02;23;Sunnuntai;0;0;0
95;27.02.2017;2017;02;00;Maanantai;0;0;0
95;27.02.2017;2017;02;01;Maanantai;0;0;0
95;27.02.2017;2017;02;02;Maanantai;0;0;0
95;27.02.2017;2017;02;03;Maanantai;0;0;0
95;27.02.2017;2017;02;04;Maanantai;2;0;2
95;27.02.2017;2017;02;05;Maanantai;1;2;3
95;27.02.2017;2017;02;06;Maanantai;2;3;5
95;27.02.2017;2017;02;07;Maanantai;5;10;15
95;27.02.2017;2017;02;08;Maanantai;3;3;6
95;27.02.2017;2017;02;09;Maanantai;0;5;5
95;27.02.2017;2017;02;10;Maanantai;2;3;5
95;27.02.2017;2017;02;11;Maanantai;6;1;7
95;27.02.2017;2017;02;12;Maanantai;9;0;9
95;27.02.2017;2017;02;13;Maanantai;2;2;4
95;27.02.2017;2017;02;14;Maanantai;10;9;19
95;27.02.2017;2017;02;15;Maanantai;12;3;15
95;27.02.2017;2017;02;16;Maanantai;12;8;20
95;27.02.2017;2017;02;17;Maanantai;2;8;10
95;27.02.2017;2017;02;18;Maanantai;6;2;8
95;27.02.2017;2017;02;19;Maanantai;2;1;3
95;27.02.2017;2017;02;20;Maanantai;2;2;4
95;27.02.2017;2017;02;21;Maanantai;0;1;1
95;27.02.2017;2017;02;22;Maanantai;2;2;4
95;27.02.2017;2017;02;23;Maanantai;0;0;0
95;28.02.2017;2017;02;00;Tiistai;0;0;0
95;28.02.2017;2017;02;01;Tiistai;0;0;0
95;28.02.2017;2017;02;02;Tiistai;0;0;0
95;28.02.2017;2017;02;03;Tiistai;0;0;0
95;28.02.2017;2017;02;04;Tiistai;3;2;5
95;28.02.2017;2017;02;05;Tiistai;6;3;9
95;28.02.2017;2017;02;06;Tiistai;6;7;13
95;28.02.2017;2017;02;07;Tiistai;10;5;15
95;28.02.2017;2017;02;08;Tiistai;8;7;15
95;28.02.2017;2017;02;09;Tiistai;3;0;3
95;28.02.2017;2017;02;10;Tiistai;5;2;7
95;28.02.2017;2017;02;11;Tiistai;8;0;8
95;28.02.2017;2017;02;12;Tiistai;9;4;13
95;28.02.2017;2017;02;13;Tiistai;4;3;7
95;28.02.2017;2017;02;14;Tiistai;3;4;7
95;28.02.2017;2017;02;15;Tiistai;5;11;16
95;28.02.2017;2017;02;16;Tiistai;9;9;18
95;28.02.2017;2017;02;17;Tiistai;7;6;13
95;28.02.2017;2017;02;18;Tiistai;6;3;9
95;28.02.2017;2017;02;19;Tiistai;7;6;13
95;28.02.2017;2017;02;20;Tiistai;0;4;4
95;28.02.2017;2017;02;21;Tiistai;0;1;1
95;28.02.2017;2017;02;22;Tiistai;2;1;3
95;28.02.2017;2017;02;23;Tiistai;0;0;0
95;01.03.2017;2017;03;00;Keskiviikko;0;0;0
95;01.03.2017;2017;03;01;Keskiviikko;0;1;1
95;01.03.2017;2017;03;02;Keskiviikko;0;0;0
95;01.03.2017;2017;03;03;Keskiviikko;0;0;0
95;01.03.2017;2017;03;04;Keskiviikko;0;0;0
95;01.03.2017;2017;03;05;Keskiviikko;5;3;8
95;01.03.2017;2017;03;06;Keskiviikko;8;1;9
95;01.03.2017;2017;03;07;Keskiviikko;10;11;21
95;01.03.2017;2017;03;08;Keskiviikko;1;3;4
95;01.03.2017;2017;03;09;Keskiviikko;4;1;5
95;01.03.2017;2017;03;10;Keskiviikko;2;2;4
95;01.03.2017;2017;03;11;Keskiviikko;5;0;5
95;01.03.2017;2017;03;12;Keskiviikko;2;2;4
95;01.03.2017;2017;03;13;Keskiviikko;6;1;7
95;01.03.2017;2017;03;14;Keskiviikko;5;0;5
95;01.03.2017;2017;03;15;Keskiviikko;7;1;8
95;01.03.2017;2017;03;16;Keskiviikko;9;1;10
95;01.03.2017;2017;03;17;Keskiviikko;2;2;4
95;01.03.2017;2017;03;18;Keskiviikko;1;3;4
95;01.03.2017;2017;03;19;Keskiviikko;0;0;0
95;01.03.2017;2017;03;20;Keskiviikko;3;2;5
95;01.03.2017;2017;03;21;Keskiviikko;0;0;0
95;01.03.2017;2017;03;22;Keskiviikko;1;0;1
95;01.03.2017;2017;03;23;Keskiviikko;0;0;0
95;02.03.2017;2017;03;00;Torstai;0;0;0
95;02.03.2017;2017;03;01;Torstai;0;0;0
95;02.03.2017;2017;03;02;Torstai;0;0;0
95;02.03.2017;2017;03;03;Torstai;0;0;0
95;02.03.2017;2017;03;04;Torstai;1;1;2
95;02.03.2017;2017;03;05;Torstai;3;2;5
95;02.03.2017;2017;03;06;Torstai;3;0;3
95;02.03.2017;2017;03;07;Torstai;9;4;13
95;02.03.2017;2017;03;08;Torstai;7;3;10
95;02.03.2017;2017;03;09;Torstai;2;0;2
95;02.03.2017;2017;03;10;Torstai;4;1;5
95;02.03.2017;2017;03;11;Torstai;1;2;3
95;02.03.2017;2017;03;12;Torstai;0;3;3
95;02.03.2017;2017;03;13;Torstai;2;3;5
95;02.03.2017;2017;03;14;Torstai;11;8;19
95;02.03.2017;2017;03;15;Torstai;9;2;11
95;02.03.2017;2017;03;16;Torstai;5;4;9
95;02.03.2017;2017;03;17;Torstai;1;7;8
95;02.03.2017;2017;03;18;Torstai;2;3;5
95;02.03.2017;2017;03;19;Torstai;2;1;3
95;02.03.2017;2017;03;20;Torstai;1;1;2
95;02.03.2017;2017;03;21;Torstai;0;3;3
95;02.03.2017;2017;03;22;Torstai;2;0;2
95;02.03.2017;2017;03;23;Torstai;1;0;1
95;03.03.2017;2017;03;00;Perjantai;0;0;0
95;03.03.2017;2017;03;01;Perjantai;0;0;0
95;03.03.2017;2017;03;02;Perjantai;0;0;0
95;03.03.2017;2017;03;03;Perjantai;0;0;0
95;03.03.2017;2017;03;04;Perjantai;1;0;1
95;03.03.2017;2017;03;05;Perjantai;2;5;7
95;03.03.2017;2017;03;06;Perjantai;3;3;6
95;03.03.2017;2017;03;07;Perjantai;6;8;14
95;03.03.2017;2017;03;08;Perjantai;3;1;4
95;03.03.2017;2017;03;09;Perjantai;4;3;7
95;03.03.2017;2017;03;10;Perjantai;3;1;4
95;03.03.2017;2017;03;11;Perjantai;5;1;6
95;03.03.2017;2017;03;12;Perjantai;1;3;4
95;03.03.2017;2017;03;13;Perjantai;8;4;12
95;03.03.2017;2017;03;14;Perjantai;3;2;5
95;03.03.2017;2017;03;15;Perjantai;10;8;18
95;03.03.2017;2017;03;16;Perjantai;4;2;6
95;03.03.2017;2017;03;17;Perjantai;3;5;8
95;03.03.2017;2017;03;18;Perjantai;0;1;1
95;03.03.2017;2017;03;19;Perjantai;2;2;4
95;03.03.2017;2017;03;20;Perjantai;0;3;3
95;03.03.2017;2017;03;21;Perjantai;2;0;2
95;03.03.2017;2017;03;22;Perjantai;0;0;0
95;03.03.2017;2017;03;23;Perjantai;0;0;0
95;04.03.2017;2017;03;00;Lauantai;0;0;0
95;04.03.2017;2017;03;01;Lauantai;0;0;0
95;04.03.2017;2017;03;02;Lauantai;0;0;0
95;04.03.2017;2017;03;03;Lauantai;0;0;0
95;04.03.2017;2017;03;04;Lauantai;1;1;2
95;04.03.2017;2017;03;05;Lauantai;2;1;3
95;04.03.2017;2017;03;06;Lauantai;3;0;3
95;04.03.2017;2017;03;07;Lauantai;0;1;1
95;04.03.2017;2017;03;08;Lauantai;1;0;1
95;04.03.2017;2017;03;09;Lauantai;0;1;1
95;04.03.2017;2017;03;10;Lauantai;1;0;1
95;04.03.2017;2017;03;11;Lauantai;2;1;3
95;04.03.2017;2017;03;12;Lauantai;9;3;12
95;04.03.2017;2017;03;13;Lauantai;4;4;8
95;04.03.2017;2017;03;14;Lauantai;4;0;4
95;04.03.2017;2017;03;15;Lauantai;3;5;8
95;04.03.2017;2017;03;16;Lauantai;1;2;3
95;04.03.2017;2017;03;17;Lauantai;0;0;0
95;04.03.2017;2017;03;18;Lauantai;1;2;3
95;04.03.2017;2017;03;19;Lauantai;0;1;1
95;04.03.2017;2017;03;20;Lauantai;0;0;0
95;04.03.2017;2017;03;21;Lauantai;1;1;2
95;04.03.2017;2017;03;22;Lauantai;0;1;1
95;04.03.2017;2017;03;23;Lauantai;1;0;1
95;05.03.2017;2017;03;00;Sunnuntai;0;0;0
95;05.03.2017;2017;03;01;Sunnuntai;0;0;0
95;05.03.2017;2017;03;02;Sunnuntai;0;1;1
95;05.03.2017;2017;03;03;Sunnuntai;0;0;0
95;05.03.2017;2017;03;04;Sunnuntai;0;0;0
95;05.03.2017;2017;03;05;Sunnuntai;0;0;0
95;05.03.2017;2017;03;06;Sunnuntai;2;0;2
95;05.03.2017;2017;03;07;Sunnuntai;0;0;0
95;05.03.2017;2017;03;08;Sunnuntai;0;0;0
95;05.03.2017;2017;03;09;Sunnuntai;0;1;1
95;05.03.2017;2017;03;10;Sunnuntai;0;2;2
95;05.03.2017;2017;03;11;Sunnuntai;3;2;5
95;05.03.2017;2017;03;12;Sunnuntai;3;3;6
95;05.03.2017;2017;03;13;Sunnuntai;2;3;5
95;05.03.2017;2017;03;14;Sunnuntai;2;2;4
95;05.03.2017;2017;03;15;Sunnuntai;0;3;3
95;05.03.2017;2017;03;16;Sunnuntai;0;0;0
95;05.03.2017;2017;03;17;Sunnuntai;0;2;2
95;05.03.2017;2017;03;18;Sunnuntai;3;4;7
95;05.03.2017;2017;03;19;Sunnuntai;0;0;0
95;05.03.2017;2017;03;20;Sunnuntai;0;1;1
95;05.03.2017;2017;03;21;Sunnuntai;2;1;3
95;05.03.2017;2017;03;22;Sunnuntai;0;1;1
95;05.03.2017;2017;03;23;Sunnuntai;0;0;0
95;06.03.2017;2017;03;00;Maanantai;0;0;0
95;06.03.2017;2017;03;01;Maanantai;0;0;0
95;06.03.2017;2017;03;02;Maanantai;0;0;0
95;06.03.2017;2017;03;03;Maanantai;0;0;0
95;06.03.2017;2017;03;04;Maanantai;0;0;0
95;06.03.2017;2017;03;05;Maanantai;1;2;3
95;06.03.2017;2017;03;06;Maanantai;6;2;8
95;06.03.2017;2017;03;07;Maanantai;0;1;1
95;06.03.2017;2017;03;08;Maanantai;1;2;3
95;06.03.2017;2017;03;09;Maanantai;4;2;6
95;06.03.2017;2017;03;10;Maanantai;7;0;7
95;06.03.2017;2017;03;11;Maanantai;1;1;2
95;06.03.2017;2017;03;12;Maanantai;1;1;2
95;06.03.2017;2017;03;13;Maanantai;2;4;6
95;06.03.2017;2017;03;14;Maanantai;5;7;12
95;06.03.2017;2017;03;15;Maanantai;1;4;5
95;06.03.2017;2017;03;16;Maanantai;4;4;8
95;06.03.2017;2017;03;17;Maanantai;4;3;7
95;06.03.2017;2017;03;18;Maanantai;2;1;3
95;06.03.2017;2017;03;19;Maanantai;2;2;4
95;06.03.2017;2017;03;20;Maanantai;0;2;2
95;06.03.2017;2017;03;21;Maanantai;0;2;2
95;06.03.2017;2017;03;22;Maanantai;1;2;3
95;06.03.2017;2017;03;23;Maanantai;0;0;0
95;07.03.2017;2017;03;00;Tiistai;0;0;0
95;07.03.2017;2017;03;01;Tiistai;0;0;0
95;07.03.2017;2017;03;02;Tiistai;0;0;0
95;07.03.2017;2017;03;03;Tiistai;0;0;0
95;07.03.2017;2017;03;04;Tiistai;0;0;0
95;07.03.2017;2017;03;05;Tiistai;1;4;5
95;07.03.2017;2017;03;06;Tiistai;2;0;2
95;07.03.2017;2017;03;07;Tiistai;6;3;9
95;07.03.2017;2017;03;08;Tiistai;1;4;5
95;07.03.2017;2017;03;09;Tiistai;6;0;6
95;07.03.2017;2017;03;10;Tiistai;2;0;2
95;07.03.2017;2017;03;11;Tiistai;3;3;6
95;07.03.2017;2017;03;12;Tiistai;1;1;2
95;07.03.2017;2017;03;13;Tiistai;3;2;5
95;07.03.2017;2017;03;14;Tiistai;3;4;7
95;07.03.2017;2017;03;15;Tiistai;6;4;10
95;07.03.2017;2017;03;16;Tiistai;4;5;9
95;07.03.2017;2017;03;17;Tiistai;4;5;9
95;07.03.2017;2017;03;18;Tiistai;1;1;2
95;07.03.2017;2017;03;19;Tiistai;2;1;3
95;07.03.2017;2017;03;20;Tiistai;2;1;3
95;07.03.2017;2017;03;21;Tiistai;0;1;1
95;07.03.2017;2017;03;22;Tiistai;0;0;0
95;07.03.2017;2017;03;23;Tiistai;0;0;0
95;08.03.2017;2017;03;00;Keskiviikko;0;1;1
95;08.03.2017;2017;03;01;Keskiviikko;0;0;0
95;08.03.2017;2017;03;02;Keskiviikko;0;0;0
95;08.03.2017;2017;03;03;Keskiviikko;0;0;0
95;08.03.2017;2017;03;04;Keskiviikko;0;0;0
95;08.03.2017;2017;03;05;Keskiviikko;3;3;6
95;08.03.2017;2017;03;06;Keskiviikko;5;3;8
95;08.03.2017;2017;03;07;Keskiviikko;3;2;5
95;08.03.2017;2017;03;08;Keskiviikko;6;1;7
95;08.03.2017;2017;03;09;Keskiviikko;2;0;2
95;08.03.2017;2017;03;10;Keskiviikko;2;0;2
95;08.03.2017;2017;03;11;Keskiviikko;0;1;1
95;08.03.2017;2017;03;12;Keskiviikko;5;3;8
95;08.03.2017;2017;03;13;Keskiviikko;1;2;3
95;08.03.2017;2017;03;14;Keskiviikko;5;6;11
95;08.03.2017;2017;03;15;Keskiviikko;3;5;8
95;08.03.2017;2017;03;16;Keskiviikko;4;3;7
95;08.03.2017;2017;03;17;Keskiviikko;1;9;10
95;08.03.2017;2017;03;18;Keskiviikko;3;2;5
95;08.03.2017;2017;03;19;Keskiviikko;0;0;0
95;08.03.2017;2017;03;20;Keskiviikko;0;2;2
95;08.03.2017;2017;03;21;Keskiviikko;2;0;2
95;08.03.2017;2017;03;22;Keskiviikko;0;1;1
95;08.03.2017;2017;03;23;Keskiviikko;0;0;0
95;09.03.2017;2017;03;00;Torstai;0;0;0
95;09.03.2017;2017;03;01;Torstai;0;1;1
95;09.03.2017;2017;03;02;Torstai;0;0;0
95;09.03.2017;2017;03;03;Torstai;0;0;0
95;09.03.2017;2017;03;04;Torstai;1;0;1
95;09.03.2017;2017;03;05;Torstai;3;2;5
95;09.03.2017;2017;03;06;Torstai;3;1;4
95;09.03.2017;2017;03;07;Torstai;6;1;7
95;09.03.2017;2017;03;08;Torstai;2;2;4
95;09.03.2017;2017;03;09;Torstai;3;2;5
95;09.03.2017;2017;03;10;Torstai;4;4;8
95;09.03.2017;2017;03;11;Torstai;1;1;2
95;09.03.2017;2017;03;12;Torstai;6;2;8
95;09.03.2017;2017;03;13;Torstai;1;0;1
95;09.03.2017;2017;03;14;Torstai;0;1;1
95;09.03.2017;2017;03;15;Torstai;4;5;9
95;09.03.2017;2017;03;16;Torstai;3;3;6
95;09.03.2017;2017;03;17;Torstai;4;2;6
95;09.03.2017;2017;03;18;Torstai;0;6;6
95;09.03.2017;2017;03;19;Torstai;1;2;3
95;09.03.2017;2017;03;20;Torstai;0;0;0
95;09.03.2017;2017;03;21;Torstai;0;1;1
95;09.03.2017;2017;03;22;Torstai;0;2;2
95;09.03.2017;2017;03;23;Torstai;0;0;0
95;10.03.2017;2017;03;00;Perjantai;0;0;0
95;10.03.2017;2017;03;01;Perjantai;0;0;0
95;10.03.2017;2017;03;02;Perjantai;0;0;0
95;10.03.2017;2017;03;03;Perjantai;0;0;0
95;10.03.2017;2017;03;04;Perjantai;1;1;2
95;10.03.2017;2017;03;05;Perjantai;1;2;3
95;10.03.2017;2017;03;06;Perjantai;3;1;4
95;10.03.2017;2017;03;07;Perjantai;7;2;9
95;10.03.2017;2017;03;08;Perjantai;3;2;5
95;10.03.2017;2017;03;09;Perjantai;4;0;4
95;10.03.2017;2017;03;10;Perjantai;2;0;2
95;10.03.2017;2017;03;11;Perjantai;0;0;0
95;10.03.2017;2017;03;12;Perjantai;1;0;1
95;10.03.2017;2017;03;13;Perjantai;3;6;9
95;10.03.2017;2017;03;14;Perjantai;2;4;6
95;10.03.2017;2017;03;15;Perjantai;5;2;7
95;10.03.2017;2017;03;16;Perjantai;7;3;10
95;10.03.2017;2017;03;17;Perjantai;5;1;6
95;10.03.2017;2017;03;18;Perjantai;2;5;7
95;10.03.2017;2017;03;19;Perjantai;0;1;1
95;10.03.2017;2017;03;20;Perjantai;2;0;2
95;10.03.2017;2017;03;21;Perjantai;1;0;1
95;10.03.2017;2017;03;22;Perjantai;1;2;3
95;10.03.2017;2017;03;23;Perjantai;0;0;0
95;11.03.2017;2017;03;00;Lauantai;0;0;0
95;11.03.2017;2017;03;01;Lauantai;0;0;0
95;11.03.2017;2017;03;02;Lauantai;0;0;0
95;11.03.2017;2017;03;03;Lauantai;0;0;0
95;11.03.2017;2017;03;04;Lauantai;0;0;0
95;11.03.2017;2017;03;05;Lauantai;0;0;0
95;11.03.2017;2017;03;06;Lauantai;5;0;5
95;11.03.2017;2017;03;07;Lauantai;0;1;1
95;11.03.2017;2017;03;08;Lauantai;0;0;0
95;11.03.2017;2017;03;09;Lauantai;1;1;2
95;11.03.2017;2017;03;10;Lauantai;1;3;4
95;11.03.2017;2017;03;11;Lauantai;3;2;5
95;11.03.2017;2017;03;12;Lauantai;4;5;9
95;11.03.2017;2017;03;13;Lauantai;4;4;8
95;11.03.2017;2017;03;14;Lauantai;6;2;8
95;11.03.2017;2017;03;15;Lauantai;3;3;6
95;11.03.2017;2017;03;16;Lauantai;1;1;2
95;11.03.2017;2017;03;17;Lauantai;2;4;6
95;11.03.2017;2017;03;18;Lauantai;3;3;6
95;11.03.2017;2017;03;19;Lauantai;2;0;2
95;11.03.2017;2017;03;20;Lauantai;0;0;0
95;11.03.2017;2017;03;21;Lauantai;0;2;2
95;11.03.2017;2017;03;22;Lauantai;0;1;1
95;11.03.2017;2017;03;23;Lauantai;1;0;1
95;12.03.2017;2017;03;00;Sunnuntai;1;1;2
95;12.03.2017;2017;03;01;Sunnuntai;0;0;0
95;12.03.2017;2017;03;02;Sunnuntai;0;1;1
95;12.03.2017;2017;03;03;Sunnuntai;0;0;0
95;12.03.2017;2017;03;04;Sunnuntai;0;0;0
95;12.03.2017;2017;03;05;Sunnuntai;0;0;0
95;12.03.2017;2017;03;06;Sunnuntai;1;0;1
95;12.03.2017;2017;03;07;Sunnuntai;0;0;0
95;12.03.2017;2017;03;08;Sunnuntai;1;2;3
95;12.03.2017;2017;03;09;Sunnuntai;1;1;2
95;12.03.2017;2017;03;10;Sunnuntai;2;1;3
95;12.03.2017;2017;03;11;Sunnuntai;5;3;8
95;12.03.2017;2017;03;12;Sunnuntai;3;4;7
95;12.03.2017;2017;03;13;Sunnuntai;2;2;4
95;12.03.2017;2017;03;14;Sunnuntai;4;0;4
95;12.03.2017;2017;03;15;Sunnuntai;3;1;4
95;12.03.2017;2017;03;16;Sunnuntai;0;4;4
95;12.03.2017;2017;03;17;Sunnuntai;0;0;0
95;12.03.2017;2017;03;18;Sunnuntai;1;1;2
95;12.03.2017;2017;03;19;Sunnuntai;2;0;2
95;12.03.2017;2017;03;20;Sunnuntai;2;0;2
95;12.03.2017;2017;03;21;Sunnuntai;0;2;2
95;12.03.2017;2017;03;22;Sunnuntai;0;1;1
95;12.03.2017;2017;03;23;Sunnuntai;1;0;1
95;13.03.2017;2017;03;00;Maanantai;0;0;0
95;13.03.2017;2017;03;01;Maanantai;0;0;0
95;13.03.2017;2017;03;02;Maanantai;1;0;1
95;13.03.2017;2017;03;03;Maanantai;0;0;0
95;13.03.2017;2017;03;04;Maanantai;1;0;1
95;13.03.2017;2017;03;05;Maanantai;4;3;7
95;13.03.2017;2017;03;06;Maanantai;6;2;8
95;13.03.2017;2017;03;07;Maanantai;6;7;13
95;13.03.2017;2017;03;08;Maanantai;5;6;11
95;13.03.2017;2017;03;09;Maanantai;8;7;15
95;13.03.2017;2017;03;10;Maanantai;0;0;0
95;13.03.2017;2017;03;11;Maanantai;4;4;8
95;13.03.2017;2017;03;12;Maanantai;4;3;7
95;13.03.2017;2017;03;13;Maanantai;2;3;5
95;13.03.2017;2017;03;14;Maanantai;10;10;20
95;13.03.2017;2017;03;15;Maanantai;14;9;23
95;13.03.2017;2017;03;16;Maanantai;14;9;23
95;13.03.2017;2017;03;17;Maanantai;1;4;5
95;13.03.2017;2017;03;18;Maanantai;1;3;4
95;13.03.2017;2017;03;19;Maanantai;2;4;6
95;13.03.2017;2017;03;20;Maanantai;1;2;3
95;13.03.2017;2017;03;21;Maanantai;1;0;1
95;13.03.2017;2017;03;22;Maanantai;0;0;0
95;13.03.2017;2017;03;23;Maanantai;0;0;0
95;14.03.2017;2017;03;00;Tiistai;1;0;1
95;14.03.2017;2017;03;01;Tiistai;0;0;0
95;14.03.2017;2017;03;02;Tiistai;0;0;0
95;14.03.2017;2017;03;03;Tiistai;0;0;0
95;14.03.2017;2017;03;04;Tiistai;1;0;1
95;14.03.2017;2017;03;05;Tiistai;2;3;5
95;14.03.2017;2017;03;06;Tiistai;7;3;10
95;14.03.2017;2017;03;07;Tiistai;11;6;17
95;14.03.2017;2017;03;08;Tiistai;6;5;11
95;14.03.2017;2017;03;09;Tiistai;5;1;6
95;14.03.2017;2017;03;10;Tiistai;3;4;7
95;14.03.2017;2017;03;11;Tiistai;2;3;5
95;14.03.2017;2017;03;12;Tiistai;1;0;1
95;14.03.2017;2017;03;13;Tiistai;3;4;7
95;14.03.2017;2017;03;14;Tiistai;7;9;16
95;14.03.2017;2017;03;15;Tiistai;8;7;15
95;14.03.2017;2017;03;16;Tiistai;5;6;11
95;14.03.2017;2017;03;17;Tiistai;4;3;7
95;14.03.2017;2017;03;18;Tiistai;5;4;9
95;14.03.2017;2017;03;19;Tiistai;2;3;5
95;14.03.2017;2017;03;20;Tiistai;0;3;3
95;14.03.2017;2017;03;21;Tiistai;1;1;2
95;14.03.2017;2017;03;22;Tiistai;2;2;4
95;14.03.2017;2017;03;23;Tiistai;0;0;0
95;15.03.2017;2017;03;00;Keskiviikko;0;0;0
95;15.03.2017;2017;03;01;Keskiviikko;0;0;0
95;15.03.2017;2017;03;02;Keskiviikko;0;0;0
95;15.03.2017;2017;03;03;Keskiviikko;0;0;0
95;15.03.2017;2017;03;04;Keskiviikko;1;0;1
95;15.03.2017;2017;03;05;Keskiviikko;2;1;3
95;15.03.2017;2017;03;06;Keskiviikko;5;1;6
95;15.03.2017;2017;03;07;Keskiviikko;4;2;6
95;15.03.2017;2017;03;08;Keskiviikko;2;3;5
95;15.03.2017;2017;03;09;Keskiviikko;1;2;3
95;15.03.2017;2017;03;10;Keskiviikko;0;2;2
95;15.03.2017;2017;03;11;Keskiviikko;3;2;5
95;15.03.2017;2017;03;12;Keskiviikko;0;0;0
95;15.03.2017;2017;03;13;Keskiviikko;2;4;6
95;15.03.2017;2017;03;14;Keskiviikko;2;4;6
95;15.03.2017;2017;03;15;Keskiviikko;6;4;10
95;15.03.2017;2017;03;16;Keskiviikko;6;2;8
95;15.03.2017;2017;03;17;Keskiviikko;3;4;7
95;15.03.2017;2017;03;18;Keskiviikko;1;1;2
95;15.03.2017;2017;03;19;Keskiviikko;0;2;2
95;15.03.2017;2017;03;20;Keskiviikko;0;2;2
95;15.03.2017;2017;03;21;Keskiviikko;1;1;2
95;15.03.2017;2017;03;22;Keskiviikko;0;0;0
95;15.03.2017;2017;03;23;Keskiviikko;0;0;0
95;16.03.2017;2017;03;00;Torstai;1;0;1
95;16.03.2017;2017;03;01;Torstai;0;0;0
95;16.03.2017;2017;03;02;Torstai;0;0;0
95;16.03.2017;2017;03;03;Torstai;0;1;1
95;16.03.2017;2017;03;04;Torstai;0;0;0
95;16.03.2017;2017;03;05;Torstai;1;1;2
95;16.03.2017;2017;03;06;Torstai;2;4;6
95;16.03.2017;2017;03;07;Torstai;8;3;11
95;16.03.2017;2017;03;08;Torstai;2;1;3
95;16.03.2017;2017;03;09;Torstai;5;4;9
95;16.03.2017;2017;03;10;Torstai;3;4;7
95;16.03.2017;2017;03;11;Torstai;2;2;4
95;16.03.2017;2017;03;12;Torstai;4;1;5
95;16.03.2017;2017;03;13;Torstai;3;3;6
95;16.03.2017;2017;03;14;Torstai;2;4;6
95;16.03.2017;2017;03;15;Torstai;4;5;9
95;16.03.2017;2017;03;16;Torstai;12;3;15
95;16.03.2017;2017;03;17;Torstai;5;4;9
95;16.03.2017;2017;03;18;Torstai;3;6;9
95;16.03.2017;2017;03;19;Torstai;1;2;3
95;16.03.2017;2017;03;20;Torstai;1;1;2
95;16.03.2017;2017;03;21;Torstai;1;2;3
95;16.03.2017;2017;03;22;Torstai;1;0;1
95;16.03.2017;2017;03;23;Torstai;0;0;0
95;17.03.2017;2017;03;00;Perjantai;0;0;0
95;17.03.2017;2017;03;01;Perjantai;0;0;0
95;17.03.2017;2017;03;02;Perjantai;0;0;0
95;17.03.2017;2017;03;03;Perjantai;0;0;0
95;17.03.2017;2017;03;04;Perjantai;0;0;0
95;17.03.2017;2017;03;05;Perjantai;2;1;3
95;17.03.2017;2017;03;06;Perjantai;0;2;2
95;17.03.2017;2017;03;07;Perjantai;4;3;7
95;17.03.2017;2017;03;08;Perjantai;1;3;4
95;17.03.2017;2017;03;09;Perjantai;0;0;0
95;17.03.2017;2017;03;10;Perjantai;1;1;2
95;17.03.2017;2017;03;11;Perjantai;0;0;0
95;17.03.2017;2017;03;12;Perjantai;0;1;1
95;17.03.2017;2017;03;13;Perjantai;2;1;3
95;17.03.2017;2017;03;14;Perjantai;3;2;5
95;17.03.2017;2017;03;15;Perjantai;3;1;4
95;17.03.2017;2017;03;16;Perjantai;0;1;1
95;17.03.2017;2017;03;17;Perjantai;0;2;2
95;17.03.2017;2017;03;18;Perjantai;2;3;5
95;17.03.2017;2017;03;19;Perjantai;1;2;3
95;17.03.2017;2017;03;20;Perjantai;0;1;1
95;17.03.2017;2017;03;21;Perjantai;0;0;0
95;17.03.2017;2017;03;22;Perjantai;1;0;1
95;17.03.2017;2017;03;23;Perjantai;0;0;0
95;18.03.2017;2017;03;00;Lauantai;0;0;0
95;18.03.2017;2017;03;01;Lauantai;0;0;0
95;18.03.2017;2017;03;02;Lauantai;0;0;0
95;18.03.2017;2017;03;03;Lauantai;0;0;0
95;18.03.2017;2017;03;04;Lauantai;0;0;0
95;18.03.2017;2017;03;05;Lauantai;0;0;0
95;18.03.2017;2017;03;06;Lauantai;0;0;0
95;18.03.2017;2017;03;07;Lauantai;1;2;3
95;18.03.2017;2017;03;08;Lauantai;1;0;1
95;18.03.2017;2017;03;09;Lauantai;2;1;3
95;18.03.2017;2017;03;10;Lauantai;0;0;0
95;18.03.2017;2017;03;11;Lauantai;0;2;2
95;18.03.2017;2017;03;12;Lauantai;5;3;8
95;18.03.2017;2017;03;13;Lauantai;2;1;3
95;18.03.2017;2017;03;14;Lauantai;2;3;5
95;18.03.2017;2017;03;15;Lauantai;2;1;3
95;18.03.2017;2017;03;16;Lauantai;1;2;3
95;18.03.2017;2017;03;17;Lauantai;1;4;5
95;18.03.2017;2017;03;18;Lauantai;3;2;5
95;18.03.2017;2017;03;19;Lauantai;0;0;0
95;18.03.2017;2017;03;20;Lauantai;0;0;0
95;18.03.2017;2017;03;21;Lauantai;0;0;0
95;18.03.2017;2017;03;22;Lauantai;1;1;2
95;18.03.2017;2017;03;23;Lauantai;0;0;0
95;19.03.2017;2017;03;00;Sunnuntai;0;0;0
95;19.03.2017;2017;03;01;Sunnuntai;0;0;0
95;19.03.2017;2017;03;02;Sunnuntai;0;1;1
95;19.03.2017;2017;03;03;Sunnuntai;0;0;0
95;19.03.2017;2017;03;04;Sunnuntai;1;0;1
95;19.03.2017;2017;03;05;Sunnuntai;0;0;0
95;19.03.2017;2017;03;06;Sunnuntai;0;0;0
95;19.03.2017;2017;03;07;Sunnuntai;1;1;2
95;19.03.2017;2017;03;08;Sunnuntai;0;7;7
95;19.03.2017;2017;03;09;Sunnuntai;1;0;1
95;19.03.2017;2017;03;10;Sunnuntai;3;1;4
95;19.03.2017;2017;03;11;Sunnuntai;0;1;1
95;19.03.2017;2017;03;12;Sunnuntai;3;3;6
95;19.03.2017;2017;03;13;Sunnuntai;2;10;12
95;19.03.2017;2017;03;14;Sunnuntai;1;4;5
95;19.03.2017;2017;03;15;Sunnuntai;8;0;8
95;19.03.2017;2017;03;16;Sunnuntai;2;2;4
95;19.03.2017;2017;03;17;Sunnuntai;1;2;3
95;19.03.2017;2017;03;18;Sunnuntai;4;3;7
95;19.03.2017;2017;03;19;Sunnuntai;0;0;0
95;19.03.2017;2017;03;20;Sunnuntai;0;2;2
95;19.03.2017;2017;03;21;Sunnuntai;1;0;1
95;19.03.2017;2017;03;22;Sunnuntai;2;2;4
95;19.03.2017;2017;03;23;Sunnuntai;1;0;1
95;20.03.2017;2017;03;00;Maanantai;0;0;0
95;20.03.2017;2017;03;01;Maanantai;0;1;1
95;20.03.2017;2017;03;02;Maanantai;0;0;0
95;20.03.2017;2017;03;03;Maanantai;0;0;0
95;20.03.2017;2017;03;04;Maanantai;1;0;1
95;20.03.2017;2017;03;05;Maanantai;1;2;3
95;20.03.2017;2017;03;06;Maanantai;6;3;9
95;20.03.2017;2017;03;07;Maanantai;10;3;13
95;20.03.2017;2017;03;08;Maanantai;6;5;11
95;20.03.2017;2017;03;09;Maanantai;3;4;7
95;20.03.2017;2017;03;10;Maanantai;1;4;5
95;20.03.2017;2017;03;11;Maanantai;2;1;3
95;20.03.2017;2017;03;12;Maanantai;3;0;3
95;20.03.2017;2017;03;13;Maanantai;7;1;8
95;20.03.2017;2017;03;14;Maanantai;5;6;11
95;20.03.2017;2017;03;15;Maanantai;8;5;13
95;20.03.2017;2017;03;16;Maanantai;8;6;14
95;20.03.2017;2017;03;17;Maanantai;2;5;7
95;20.03.2017;2017;03;18;Maanantai;1;5;6
95;20.03.2017;2017;03;19;Maanantai;2;4;6
95;20.03.2017;2017;03;20;Maanantai;4;2;6
95;20.03.2017;2017;03;21;Maanantai;0;2;2
95;20.03.2017;2017;03;22;Maanantai;0;3;3
95;20.03.2017;2017;03;23;Maanantai;0;0;0
95;21.03.2017;2017;03;00;Tiistai;0;0;0
95;21.03.2017;2017;03;01;Tiistai;0;0;0
95;21.03.2017;2017;03;02;Tiistai;0;0;0
95;21.03.2017;2017;03;03;Tiistai;0;0;0
95;21.03.2017;2017;03;04;Tiistai;1;0;1
95;21.03.2017;2017;03;05;Tiistai;2;2;4
95;21.03.2017;2017;03;06;Tiistai;4;2;6
95;21.03.2017;2017;03;07;Tiistai;7;7;14
95;21.03.2017;2017;03;08;Tiistai;8;5;13
95;21.03.2017;2017;03;09;Tiistai;1;1;2
95;21.03.2017;2017;03;10;Tiistai;6;4;10
95;21.03.2017;2017;03;11;Tiistai;2;4;6
95;21.03.2017;2017;03;12;Tiistai;2;4;6
95;21.03.2017;2017;03;13;Tiistai;5;0;5
95;21.03.2017;2017;03;14;Tiistai;12;5;17
95;21.03.2017;2017;03;15;Tiistai;6;4;10
95;21.03.2017;2017;03;16;Tiistai;4;5;9
95;21.03.2017;2017;03;17;Tiistai;1;8;9
95;21.03.2017;2017;03;18;Tiistai;1;3;4
95;21.03.2017;2017;03;19;Tiistai;2;3;5
95;21.03.2017;2017;03;20;Tiistai;0;2;2
95;21.03.2017;2017;03;21;Tiistai;0;1;1
95;21.03.2017;2017;03;22;Tiistai;0;2;2
95;21.03.2017;2017;03;23;Tiistai;0;0;0
95;22.03.2017;2017;03;00;Keskiviikko;1;0;1
95;22.03.2017;2017;03;01;Keskiviikko;0;0;0
95;22.03.2017;2017;03;02;Keskiviikko;0;0;0
95;22.03.2017;2017;03;03;Keskiviikko;0;0;0
95;22.03.2017;2017;03;04;Keskiviikko;0;0;0
95;22.03.2017;2017;03;05;Keskiviikko;2;3;5
95;22.03.2017;2017;03;06;Keskiviikko;1;1;2
95;22.03.2017;2017;03;07;Keskiviikko;7;7;14
95;22.03.2017;2017;03;08;Keskiviikko;6;2;8
95;22.03.2017;2017;03;09;Keskiviikko;2;1;3
95;22.03.2017;2017;03;10;Keskiviikko;3;1;4
95;22.03.2017;2017;03;11;Keskiviikko;6;2;8
95;22.03.2017;2017;03;12;Keskiviikko;0;3;3
95;22.03.2017;2017;03;13;Keskiviikko;6;4;10
95;22.03.2017;2017;03;14;Keskiviikko;4;5;9
95;22.03.2017;2017;03;15;Keskiviikko;11;5;16
95;22.03.2017;2017;03;16;Keskiviikko;6;6;12
95;22.03.2017;2017;03;17;Keskiviikko;2;4;6
95;22.03.2017;2017;03;18;Keskiviikko;2;1;3
95;22.03.2017;2017;03;19;Keskiviikko;3;3;6
95;22.03.2017;2017;03;20;Keskiviikko;0;1;1
95;22.03.2017;2017;03;21;Keskiviikko;0;1;1
95;22.03.2017;2017;03;22;Keskiviikko;0;1;1
95;22.03.2017;2017;03;23;Keskiviikko;0;0;0
95;23.03.2017;2017;03;00;Torstai;0;0;0
95;23.03.2017;2017;03;01;Torstai;0;0;0
95;23.03.2017;2017;03;02;Torstai;0;0;0
95;23.03.2017;2017;03;03;Torstai;0;0;0
95;23.03.2017;2017;03;04;Torstai;1;1;2
95;23.03.2017;2017;03;05;Torstai;3;1;4
95;23.03.2017;2017;03;06;Torstai;5;2;7
95;23.03.2017;2017;03;07;Torstai;11;3;14
95;23.03.2017;2017;03;08;Torstai;3;3;6
95;23.03.2017;2017;03;09;Torstai;2;2;4
95;23.03.2017;2017;03;10;Torstai;2;1;3
95;23.03.2017;2017;03;11;Torstai;3;3;6
95;23.03.2017;2017;03;12;Torstai;1;3;4
95;23.03.2017;2017;03;13;Torstai;5;3;8
95;23.03.2017;2017;03;14;Torstai;2;4;6
95;23.03.2017;2017;03;15;Torstai;6;5;11
95;23.03.2017;2017;03;16;Torstai;7;4;11
95;23.03.2017;2017;03;17;Torstai;3;11;14
95;23.03.2017;2017;03;18;Torstai;1;2;3
95;23.03.2017;2017;03;19;Torstai;2;1;3
95;23.03.2017;2017;03;20;Torstai;0;1;1
95;23.03.2017;2017;03;21;Torstai;0;0;0
95;23.03.2017;2017;03;22;Torstai;0;0;0
95;23.03.2017;2017;03;23;Torstai;0;1;1
95;24.03.2017;2017;03;00;Perjantai;0;0;0
95;24.03.2017;2017;03;01;Perjantai;0;0;0
95;24.03.2017;2017;03;02;Perjantai;0;0;0
95;24.03.2017;2017;03;03;Perjantai;0;0;0
95;24.03.2017;2017;03;04;Perjantai;0;0;0
95;24.03.2017;2017;03;05;Perjantai;1;2;3
95;24.03.2017;2017;03;06;Perjantai;4;3;7
95;24.03.2017;2017;03;07;Perjantai;3;5;8
95;24.03.2017;2017;03;08;Perjantai;5;3;8
95;24.03.2017;2017;03;09;Perjantai;2;4;6
95;24.03.2017;2017;03;10;Perjantai;2;2;4
95;24.03.2017;2017;03;11;Perjantai;1;0;1
95;24.03.2017;2017;03;12;Perjantai;3;2;5
95;24.03.2017;2017;03;13;Perjantai;11;3;14
95;24.03.2017;2017;03;14;Perjantai;5;7;12
95;24.03.2017;2017;03;15;Perjantai;12;6;18
95;24.03.2017;2017;03;16;Perjantai;2;2;4
95;24.03.2017;2017;03;17;Perjantai;2;3;5
95;24.03.2017;2017;03;18;Perjantai;2;4;6
95;24.03.2017;2017;03;19;Perjantai;2;0;2
95;24.03.2017;2017;03;20;Perjantai;0;1;1
95;24.03.2017;2017;03;21;Perjantai;2;2;4
95;24.03.2017;2017;03;22;Perjantai;0;2;2
95;24.03.2017;2017;03;23;Perjantai;1;0;1
95;25.03.2017;2017;03;00;Lauantai;0;0;0
95;25.03.2017;2017;03;01;Lauantai;0;0;0
95;25.03.2017;2017;03;02;Lauantai;0;0;0
95;25.03.2017;2017;03;03;Lauantai;0;0;0
95;25.03.2017;2017;03;04;Lauantai;0;1;1
95;25.03.2017;2017;03;05;Lauantai;0;1;1
95;25.03.2017;2017;03;06;Lauantai;0;0;0
95;25.03.2017;2017;03;07;Lauantai;1;1;2
95;25.03.2017;2017;03;08;Lauantai;1;1;2
95;25.03.2017;2017;03;09;Lauantai;4;1;5
95;25.03.2017;2017;03;10;Lauantai;1;0;1
95;25.03.2017;2017;03;11;Lauantai;6;3;9
95;25.03.2017;2017;03;12;Lauantai;10;6;16
95;25.03.2017;2017;03;13;Lauantai;6;3;9
95;25.03.2017;2017;03;14;Lauantai;7;6;13
95;25.03.2017;2017;03;15;Lauantai;2;9;11
95;25.03.2017;2017;03;16;Lauantai;9;5;14
95;25.03.2017;2017;03;17;Lauantai;7;9;16
95;25.03.2017;2017;03;18;Lauantai;2;4;6
95;25.03.2017;2017;03;19;Lauantai;4;0;4
95;25.03.2017;2017;03;20;Lauantai;0;0;0
95;25.03.2017;2017;03;21;Lauantai;2;5;7
95;25.03.2017;2017;03;22;Lauantai;0;2;2
95;25.03.2017;2017;03;23;Lauantai;0;1;1
95;26.03.2017;2017;03;00;Sunnuntai;0;0;0
95;26.03.2017;2017;03;01;Sunnuntai;0;0;0
95;26.03.2017;2017;03;02;Sunnuntai;0;0;0
95;26.03.2017;2017;03;03;Sunnuntai;0;0;0
95;26.03.2017;2017;03;04;Sunnuntai;0;0;0
95;26.03.2017;2017;03;05;Sunnuntai;1;1;2
95;26.03.2017;2017;03;06;Sunnuntai;1;0;1
95;26.03.2017;2017;03;07;Sunnuntai;0;1;1
95;26.03.2017;2017;03;08;Sunnuntai;1;1;2
95;26.03.2017;2017;03;09;Sunnuntai;2;0;2
95;26.03.2017;2017;03;10;Sunnuntai;6;1;7
95;26.03.2017;2017;03;11;Sunnuntai;2;4;6
95;26.03.2017;2017;03;12;Sunnuntai;8;6;14
95;26.03.2017;2017;03;13;Sunnuntai;0;4;4
95;26.03.2017;2017;03;14;Sunnuntai;4;4;8
95;26.03.2017;2017;03;15;Sunnuntai;2;2;4
95;26.03.2017;2017;03;16;Sunnuntai;2;4;6
95;26.03.2017;2017;03;17;Sunnuntai;3;1;4
95;26.03.2017;2017;03;18;Sunnuntai;2;1;3
95;26.03.2017;2017;03;19;Sunnuntai;1;0;1
95;26.03.2017;2017;03;20;Sunnuntai;1;2;3
95;26.03.2017;2017;03;21;Sunnuntai;3;2;5
95;26.03.2017;2017;03;22;Sunnuntai;0;0;0
95;26.03.2017;2017;03;23;Sunnuntai;0;0;0
95;27.03.2017;2017;03;00;Maanantai;0;0;0
95;27.03.2017;2017;03;01;Maanantai;0;0;0
95;27.03.2017;2017;03;02;Maanantai;0;0;0
95;27.03.2017;2017;03;03;Maanantai;0;0;0
95;27.03.2017;2017;03;04;Maanantai;0;0;0
95;27.03.2017;2017;03;05;Maanantai;3;3;6
95;27.03.2017;2017;03;06;Maanantai;6;2;8
95;27.03.2017;2017;03;07;Maanantai;5;7;12
95;27.03.2017;2017;03;08;Maanantai;4;5;9
95;27.03.2017;2017;03;09;Maanantai;6;6;12
95;27.03.2017;2017;03;10;Maanantai;2;5;7
95;27.03.2017;2017;03;11;Maanantai;2;1;3
95;27.03.2017;2017;03;12;Maanantai;2;4;6
95;27.03.2017;2017;03;13;Maanantai;5;3;8
95;27.03.2017;2017;03;14;Maanantai;10;4;14
95;27.03.2017;2017;03;15;Maanantai;10;7;17
95;27.03.2017;2017;03;16;Maanantai;10;6;16
95;27.03.2017;2017;03;17;Maanantai;0;3;3
95;27.03.2017;2017;03;18;Maanantai;1;5;6
95;27.03.2017;2017;03;19;Maanantai;0;3;3
95;27.03.2017;2017;03;20;Maanantai;3;1;4
95;27.03.2017;2017;03;21;Maanantai;0;0;0
95;27.03.2017;2017;03;22;Maanantai;1;0;1
95;27.03.2017;2017;03;23;Maanantai;0;0;0
95;28.03.2017;2017;03;00;Tiistai;0;0;0
95;28.03.2017;2017;03;01;Tiistai;0;0;0
95;28.03.2017;2017;03;02;Tiistai;0;0;0
95;28.03.2017;2017;03;03;Tiistai;0;0;0
95;28.03.2017;2017;03;04;Tiistai;0;0;0
95;28.03.2017;2017;03;05;Tiistai;2;1;3
95;28.03.2017;2017;03;06;Tiistai;2;1;3
95;28.03.2017;2017;03;07;Tiistai;8;9;17
95;28.03.2017;2017;03;08;Tiistai;3;3;6
95;28.03.2017;2017;03;09;Tiistai;6;3;9
95;28.03.2017;2017;03;10;Tiistai;3;3;6
95;28.03.2017;2017;03;11;Tiistai;3;2;5
95;28.03.2017;2017;03;12;Tiistai;1;5;6
95;28.03.2017;2017;03;13;Tiistai;2;2;4
95;28.03.2017;2017;03;14;Tiistai;7;6;13
95;28.03.2017;2017;03;15;Tiistai;5;2;7
95;28.03.2017;2017;03;16;Tiistai;6;4;10
95;28.03.2017;2017;03;17;Tiistai;5;6;11
95;28.03.2017;2017;03;18;Tiistai;1;6;7
95;28.03.2017;2017;03;19;Tiistai;0;1;1
95;28.03.2017;2017;03;20;Tiistai;0;5;5
95;28.03.2017;2017;03;21;Tiistai;0;0;0
95;28.03.2017;2017;03;22;Tiistai;2;1;3
95;28.03.2017;2017;03;23;Tiistai;0;0;0
95;29.03.2017;2017;03;00;Keskiviikko;0;0;0
95;29.03.2017;2017;03;01;Keskiviikko;0;0;0
95;29.03.2017;2017;03;02;Keskiviikko;0;0;0
95;29.03.2017;2017;03;03;Keskiviikko;0;0;0
95;29.03.2017;2017;03;04;Keskiviikko;2;0;2
95;29.03.2017;2017;03;05;Keskiviikko;1;1;2
95;29.03.2017;2017;03;06;Keskiviikko;4;4;8
95;29.03.2017;2017;03;07;Keskiviikko;10;7;17
95;29.03.2017;2017;03;08;Keskiviikko;1;4;5
95;29.03.2017;2017;03;09;Keskiviikko;3;4;7
95;29.03.2017;2017;03;10;Keskiviikko;0;0;0
95;29.03.2017;2017;03;11;Keskiviikko;3;2;5
95;29.03.2017;2017;03;12;Keskiviikko;4;2;6
95;29.03.2017;2017;03;13;Keskiviikko;7;5;12
95;29.03.2017;2017;03;14;Keskiviikko;8;5;13
95;29.03.2017;2017;03;15;Keskiviikko;7;7;14
95;29.03.2017;2017;03;16;Keskiviikko;12;4;16
95;29.03.2017;2017;03;17;Keskiviikko;2;12;14
95;29.03.2017;2017;03;18;Keskiviikko;3;4;7
95;29.03.2017;2017;03;19;Keskiviikko;2;3;5
95;29.03.2017;2017;03;20;Keskiviikko;1;1;2
95;29.03.2017;2017;03;21;Keskiviikko;0;2;2
95;29.03.2017;2017;03;22;Keskiviikko;4;0;4
95;29.03.2017;2017;03;23;Keskiviikko;0;0;0
95;30.03.2017;2017;03;00;Torstai;0;0;0
95;30.03.2017;2017;03;01;Torstai;0;0;0
95;30.03.2017;2017;03;02;Torstai;0;0;0
95;30.03.2017;2017;03;03;Torstai;0;0;0
95;30.03.2017;2017;03;04;Torstai;2;0;2
95;30.03.2017;2017;03;05;Torstai;2;1;3
95;30.03.2017;2017;03;06;Torstai;3;3;6
95;30.03.2017;2017;03;07;Torstai;7;2;9
95;30.03.2017;2017;03;08;Torstai;3;3;6
95;30.03.2017;2017;03;09;Torstai;4;5;9
95;30.03.2017;2017;03;10;Torstai;2;4;6
95;30.03.2017;2017;03;11;Torstai;5;1;6
95;30.03.2017;2017;03;12;Torstai;2;2;4
95;30.03.2017;2017;03;13;Torstai;4;3;7
95;30.03.2017;2017;03;14;Torstai;2;11;13
95;30.03.2017;2017;03;15;Torstai;9;10;19
95;30.03.2017;2017;03;16;Torstai;10;3;13
95;30.03.2017;2017;03;17;Torstai;3;11;14
95;30.03.2017;2017;03;18;Torstai;4;4;8
95;30.03.2017;2017;03;19;Torstai;2;1;3
95;30.03.2017;2017;03;20;Torstai;2;0;2
95;30.03.2017;2017;03;21;Torstai;1;1;2
95;30.03.2017;2017;03;22;Torstai;3;2;5
95;30.03.2017;2017;03;23;Torstai;1;1;2
95;31.03.2017;2017;03;00;Perjantai;0;0;0
95;31.03.2017;2017;03;01;Perjantai;0;0;0
95;31.03.2017;2017;03;02;Perjantai;0;0;0
95;31.03.2017;2017;03;03;Perjantai;0;0;0
95;31.03.2017;2017;03;04;Perjantai;2;0;2
95;31.03.2017;2017;03;05;Perjantai;1;4;5
95;31.03.2017;2017;03;06;Perjantai;4;4;8
95;31.03.2017;2017;03;07;Perjantai;10;9;19
95;31.03.2017;2017;03;08;Perjantai;1;3;4
95;31.03.2017;2017;03;09;Perjantai;1;1;2
95;31.03.2017;2017;03;10;Perjantai;7;5;12
95;31.03.2017;2017;03;11;Perjantai;7;2;9
95;31.03.2017;2017;03;12;Perjantai;1;3;4
95;31.03.2017;2017;03;13;Perjantai;1;5;6
95;31.03.2017;2017;03;14;Perjantai;9;4;13
95;31.03.2017;2017;03;15;Perjantai;10;7;17
95;31.03.2017;2017;03;16;Perjantai;7;6;13
95;31.03.2017;2017;03;17;Perjantai;2;5;7
95;31.03.2017;2017;03;18;Perjantai;1;9;10
95;31.03.2017;2017;03;19;Perjantai;4;2;6
95;31.03.2017;2017;03;20;Perjantai;0;3;3
95;31.03.2017;2017;03;21;Perjantai;3;4;7
95;31.03.2017;2017;03;22;Perjantai;1;1;2
95;31.03.2017;2017;03;23;Perjantai;0;0;0
95;01.04.2017;2017;04;00;Lauantai;1;0;1
95;01.04.2017;2017;04;01;Lauantai;1;0;1
95;01.04.2017;2017;04;02;Lauantai;0;0;0
95;01.04.2017;2017;04;03;Lauantai;0;0;0
95;01.04.2017;2017;04;04;Lauantai;0;1;1
95;01.04.2017;2017;04;05;Lauantai;0;1;1
95;01.04.2017;2017;04;06;Lauantai;0;0;0
95;01.04.2017;2017;04;07;Lauantai;2;1;3
95;01.04.2017;2017;04;08;Lauantai;1;3;4
95;01.04.2017;2017;04;09;Lauantai;3;3;6
95;01.04.2017;2017;04;10;Lauantai;4;1;5
95;01.04.2017;2017;04;11;Lauantai;6;2;8
95;01.04.2017;2017;04;12;Lauantai;2;1;3
95;01.04.2017;2017;04;13;Lauantai;2;6;8
95;01.04.2017;2017;04;14;Lauantai;2;3;5
95;01.04.2017;2017;04;15;Lauantai;4;2;6
95;01.04.2017;2017;04;16;Lauantai;1;2;3
95;01.04.2017;2017;04;17;Lauantai;1;0;1
95;01.04.2017;2017;04;18;Lauantai;1;0;1
95;01.04.2017;2017;04;19;Lauantai;3;1;4
95;01.04.2017;2017;04;20;Lauantai;1;2;3
95;01.04.2017;2017;04;21;Lauantai;1;0;1
95;01.04.2017;2017;04;22;Lauantai;0;1;1
95;01.04.2017;2017;04;23;Lauantai;1;0;1
95;02.04.2017;2017;04;00;Sunnuntai;0;0;0
95;02.04.2017;2017;04;01;Sunnuntai;0;0;0
95;02.04.2017;2017;04;02;Sunnuntai;0;1;1
95;02.04.2017;2017;04;03;Sunnuntai;0;0;0
95;02.04.2017;2017;04;04;Sunnuntai;0;0;0
95;02.04.2017;2017;04;05;Sunnuntai;0;0;0
95;02.04.2017;2017;04;06;Sunnuntai;0;0;0
95;02.04.2017;2017;04;07;Sunnuntai;1;1;2
95;02.04.2017;2017;04;08;Sunnuntai;0;3;3
95;02.04.2017;2017;04;09;Sunnuntai;3;2;5
95;02.04.2017;2017;04;10;Sunnuntai;1;3;4
95;02.04.2017;2017;04;11;Sunnuntai;1;3;4
95;02.04.2017;2017;04;12;Sunnuntai;2;2;4
95;02.04.2017;2017;04;13;Sunnuntai;2;4;6
95;02.04.2017;2017;04;14;Sunnuntai;0;6;6
95;02.04.2017;2017;04;15;Sunnuntai;5;3;8
95;02.04.2017;2017;04;16;Sunnuntai;7;3;10
95;02.04.2017;2017;04;17;Sunnuntai;7;1;8
95;02.04.2017;2017;04;18;Sunnuntai;2;0;2
95;02.04.2017;2017;04;19;Sunnuntai;3;1;4
95;02.04.2017;2017;04;20;Sunnuntai;2;0;2
95;02.04.2017;2017;04;21;Sunnuntai;2;3;5
95;02.04.2017;2017;04;22;Sunnuntai;0;1;1
95;02.04.2017;2017;04;23;Sunnuntai;0;0;0
95;03.04.2017;2017;04;00;Maanantai;0;0;0
95;03.04.2017;2017;04;01;Maanantai;0;0;0
95;03.04.2017;2017;04;02;Maanantai;0;0;0
95;03.04.2017;2017;04;03;Maanantai;0;0;0
95;03.04.2017;2017;04;04;Maanantai;2;0;2
95;03.04.2017;2017;04;05;Maanantai;2;3;5
95;03.04.2017;2017;04;06;Maanantai;7;9;16
95;03.04.2017;2017;04;07;Maanantai;4;13;17
95;03.04.2017;2017;04;08;Maanantai;4;7;11
95;03.04.2017;2017;04;09;Maanantai;2;1;3
95;03.04.2017;2017;04;10;Maanantai;3;4;7
95;03.04.2017;2017;04;11;Maanantai;7;3;10
95;03.04.2017;2017;04;12;Maanantai;4;3;7
95;03.04.2017;2017;04;13;Maanantai;4;4;8
95;03.04.2017;2017;04;14;Maanantai;4;9;13
95;03.04.2017;2017;04;15;Maanantai;18;7;25
95;03.04.2017;2017;04;16;Maanantai;11;7;18
95;03.04.2017;2017;04;17;Maanantai;3;4;7
95;03.04.2017;2017;04;18;Maanantai;2;3;5
95;03.04.2017;2017;04;19;Maanantai;1;7;8
95;03.04.2017;2017;04;20;Maanantai;1;2;3
95;03.04.2017;2017;04;21;Maanantai;0;1;1
95;03.04.2017;2017;04;22;Maanantai;0;0;0
95;03.04.2017;2017;04;23;Maanantai;0;0;0
95;04.04.2017;2017;04;00;Tiistai;0;0;0
95;04.04.2017;2017;04;01;Tiistai;0;0;0
95;04.04.2017;2017;04;02;Tiistai;0;0;0
95;04.04.2017;2017;04;03;Tiistai;0;0;0
95;04.04.2017;2017;04;04;Tiistai;3;1;4
95;04.04.2017;2017;04;05;Tiistai;3;2;5
95;04.04.2017;2017;04;06;Tiistai;11;5;16
95;04.04.2017;2017;04;07;Tiistai;10;11;21
95;04.04.2017;2017;04;08;Tiistai;4;7;11
95;04.04.2017;2017;04;09;Tiistai;3;3;6
95;04.04.2017;2017;04;10;Tiistai;8;7;15
95;04.04.2017;2017;04;11;Tiistai;8;2;10
95;04.04.2017;2017;04;12;Tiistai;4;5;9
95;04.04.2017;2017;04;13;Tiistai;7;3;10
95;04.04.2017;2017;04;14;Tiistai;8;4;12
95;04.04.2017;2017;04;15;Tiistai;8;12;20
95;04.04.2017;2017;04;16;Tiistai;10;16;26
95;04.04.2017;2017;04;17;Tiistai;3;12;15
95;04.04.2017;2017;04;18;Tiistai;3;9;12
95;04.04.2017;2017;04;19;Tiistai;1;3;4
95;04.04.2017;2017;04;20;Tiistai;4;7;11
95;04.04.2017;2017;04;21;Tiistai;0;5;5
95;04.04.2017;2017;04;22;Tiistai;1;0;1
95;04.04.2017;2017;04;23;Tiistai;0;0;0
95;05.04.2017;2017;04;00;Keskiviikko;0;0;0
95;05.04.2017;2017;04;01;Keskiviikko;0;0;0
95;05.04.2017;2017;04;02;Keskiviikko;0;0;0
95;05.04.2017;2017;04;03;Keskiviikko;0;0;0
95;05.04.2017;2017;04;04;Keskiviikko;2;1;3
95;05.04.2017;2017;04;05;Keskiviikko;4;2;6
95;05.04.2017;2017;04;06;Keskiviikko;9;2;11
95;05.04.2017;2017;04;07;Keskiviikko;9;14;23
95;05.04.2017;2017;04;08;Keskiviikko;3;3;6
95;05.04.2017;2017;04;09;Keskiviikko;4;2;6
95;05.04.2017;2017;04;10;Keskiviikko;8;3;11
95;05.04.2017;2017;04;11;Keskiviikko;4;3;7
95;05.04.2017;2017;04;12;Keskiviikko;7;9;16
95;05.04.2017;2017;04;13;Keskiviikko;5;3;8
95;05.04.2017;2017;04;14;Keskiviikko;10;10;20
95;05.04.2017;2017;04;15;Keskiviikko;6;14;20
95;05.04.2017;2017;04;16;Keskiviikko;14;13;27
95;05.04.2017;2017;04;17;Keskiviikko;7;6;13
95;05.04.2017;2017;04;18;Keskiviikko;14;13;27
95;05.04.2017;2017;04;19;Keskiviikko;5;7;12
95;05.04.2017;2017;04;20;Keskiviikko;1;4;5
95;05.04.2017;2017;04;21;Keskiviikko;3;2;5
95;05.04.2017;2017;04;22;Keskiviikko;2;0;2
95;05.04.2017;2017;04;23;Keskiviikko;1;1;2
95;06.04.2017;2017;04;00;Torstai;0;0;0
95;06.04.2017;2017;04;01;Torstai;0;0;0
95;06.04.2017;2017;04;02;Torstai;0;0;0
95;06.04.2017;2017;04;03;Torstai;0;0;0
95;06.04.2017;2017;04;04;Torstai;0;0;0
95;06.04.2017;2017;04;05;Torstai;5;2;7
95;06.04.2017;2017;04;06;Torstai;9;5;14
95;06.04.2017;2017;04;07;Torstai;7;16;23
95;06.04.2017;2017;04;08;Torstai;5;6;11
95;06.04.2017;2017;04;09;Torstai;5;3;8
95;06.04.2017;2017;04;10;Torstai;6;4;10
95;06.04.2017;2017;04;11;Torstai;6;4;10
95;06.04.2017;2017;04;12;Torstai;4;7;11
95;06.04.2017;2017;04;13;Torstai;6;12;18
95;06.04.2017;2017;04;14;Torstai;8;5;13
95;06.04.2017;2017;04;15;Torstai;7;10;17
95;06.04.2017;2017;04;16;Torstai;10;12;22
95;06.04.2017;2017;04;17;Torstai;3;6;9
95;06.04.2017;2017;04;18;Torstai;8;8;16
95;06.04.2017;2017;04;19;Torstai;5;8;13
95;06.04.2017;2017;04;20;Torstai;3;5;8
95;06.04.2017;2017;04;21;Torstai;0;3;3
95;06.04.2017;2017;04;22;Torstai;1;0;1
95;06.04.2017;2017;04;23;Torstai;0;0;0
95;07.04.2017;2017;04;00;Perjantai;0;1;1
95;07.04.2017;2017;04;01;Perjantai;0;0;0
95;07.04.2017;2017;04;02;Perjantai;0;0;0
95;07.04.2017;2017;04;03;Perjantai;0;0;0
95;07.04.2017;2017;04;04;Perjantai;0;0;0
95;07.04.2017;2017;04;05;Perjantai;1;3;4
95;07.04.2017;2017;04;06;Perjantai;9;5;14
95;07.04.2017;2017;04;07;Perjantai;7;7;14
95;07.04.2017;2017;04;08;Perjantai;6;4;10
95;07.04.2017;2017;04;09;Perjantai;6;3;9
95;07.04.2017;2017;04;10;Perjantai;5;5;10
95;07.04.2017;2017;04;11;Perjantai;6;1;7
95;07.04.2017;2017;04;12;Perjantai;1;1;2
95;07.04.2017;2017;04;13;Perjantai;7;9;16
95;07.04.2017;2017;04;14;Perjantai;7;6;13
95;07.04.2017;2017;04;15;Perjantai;11;6;17
95;07.04.2017;2017;04;16;Perjantai;4;8;12
95;07.04.2017;2017;04;17;Perjantai;2;8;10
95;07.04.2017;2017;04;18;Perjantai;0;3;3
95;07.04.2017;2017;04;19;Perjantai;1;2;3
95;07.04.2017;2017;04;20;Perjantai;2;3;5
95;07.04.2017;2017;04;21;Perjantai;1;2;3
95;07.04.2017;2017;04;22;Perjantai;1;1;2
95;07.04.2017;2017;04;23;Perjantai;0;0;0
95;08.04.2017;2017;04;00;Lauantai;0;0;0
95;08.04.2017;2017;04;01;Lauantai;0;0;0
95;08.04.2017;2017;04;02;Lauantai;0;0;0
95;08.04.2017;2017;04;03;Lauantai;0;0;0
95;08.04.2017;2017;04;04;Lauantai;2;1;3
95;08.04.2017;2017;04;05;Lauantai;1;1;2
95;08.04.2017;2017;04;06;Lauantai;3;0;3
95;08.04.2017;2017;04;07;Lauantai;0;2;2
95;08.04.2017;2017;04;08;Lauantai;0;0;0
95;08.04.2017;2017;04;09;Lauantai;1;0;1
95;08.04.2017;2017;04;10;Lauantai;0;2;2
95;08.04.2017;2017;04;11;Lauantai;5;5;10
95;08.04.2017;2017;04;12;Lauantai;5;5;10
95;08.04.2017;2017;04;13;Lauantai;12;5;17
95;08.04.2017;2017;04;14;Lauantai;6;11;17
95;08.04.2017;2017;04;15;Lauantai;1;9;10
95;08.04.2017;2017;04;16;Lauantai;5;2;7
95;08.04.2017;2017;04;17;Lauantai;1;6;7
95;08.04.2017;2017;04;18;Lauantai;4;2;6
95;08.04.2017;2017;04;19;Lauantai;5;3;8
95;08.04.2017;2017;04;20;Lauantai;0;1;1
95;08.04.2017;2017;04;21;Lauantai;1;4;5
95;08.04.2017;2017;04;22;Lauantai;0;1;1
95;08.04.2017;2017;04;23;Lauantai;0;0;0
95;09.04.2017;2017;04;00;Sunnuntai;0;0;0
95;09.04.2017;2017;04;01;Sunnuntai;0;0;0
95;09.04.2017;2017;04;02;Sunnuntai;0;0;0
95;09.04.2017;2017;04;03;Sunnuntai;0;0;0
95;09.04.2017;2017;04;04;Sunnuntai;1;1;2
95;09.04.2017;2017;04;05;Sunnuntai;1;0;1
95;09.04.2017;2017;04;06;Sunnuntai;3;1;4
95;09.04.2017;2017;04;07;Sunnuntai;0;0;0
95;09.04.2017;2017;04;08;Sunnuntai;2;1;3
95;09.04.2017;2017;04;09;Sunnuntai;1;1;2
95;09.04.2017;2017;04;10;Sunnuntai;4;4;8
95;09.04.2017;2017;04;11;Sunnuntai;2;2;4
95;09.04.2017;2017;04;12;Sunnuntai;2;5;7
95;09.04.2017;2017;04;13;Sunnuntai;1;3;4
95;09.04.2017;2017;04;14;Sunnuntai;2;3;5
95;09.04.2017;2017;04;15;Sunnuntai;0;7;7
95;09.04.2017;2017;04;16;Sunnuntai;4;3;7
95;09.04.2017;2017;04;17;Sunnuntai;5;5;10
95;09.04.2017;2017;04;18;Sunnuntai;4;3;7
95;09.04.2017;2017;04;19;Sunnuntai;5;2;7
95;09.04.2017;2017;04;20;Sunnuntai;3;0;3
95;09.04.2017;2017;04;21;Sunnuntai;1;2;3
95;09.04.2017;2017;04;22;Sunnuntai;0;1;1
95;09.04.2017;2017;04;23;Sunnuntai;0;0;0
95;10.04.2017;2017;04;00;Maanantai;0;0;0
95;10.04.2017;2017;04;01;Maanantai;0;0;0
95;10.04.2017;2017;04;02;Maanantai;0;0;0
95;10.04.2017;2017;04;03;Maanantai;0;0;0
95;10.04.2017;2017;04;04;Maanantai;0;0;0
95;10.04.2017;2017;04;05;Maanantai;1;1;2
95;10.04.2017;2017;04;06;Maanantai;5;6;11
95;10.04.2017;2017;04;07;Maanantai;3;8;11
95;10.04.2017;2017;04;08;Maanantai;4;11;15
95;10.04.2017;2017;04;09;Maanantai;10;5;15
95;10.04.2017;2017;04;10;Maanantai;5;4;9
95;10.04.2017;2017;04;11;Maanantai;8;4;12
95;10.04.2017;2017;04;12;Maanantai;3;4;7
95;10.04.2017;2017;04;13;Maanantai;3;4;7
95;10.04.2017;2017;04;14;Maanantai;3;3;6
95;10.04.2017;2017;04;15;Maanantai;8;6;14
95;10.04.2017;2017;04;16;Maanantai;14;6;20
95;10.04.2017;2017;04;17;Maanantai;1;7;8
95;10.04.2017;2017;04;18;Maanantai;2;2;4
95;10.04.2017;2017;04;19;Maanantai;3;0;3
95;10.04.2017;2017;04;20;Maanantai;0;1;1
95;10.04.2017;2017;04;21;Maanantai;2;1;3
95;10.04.2017;2017;04;22;Maanantai;2;1;3
95;10.04.2017;2017;04;23;Maanantai;0;0;0
95;11.04.2017;2017;04;00;Tiistai;0;0;0
95;11.04.2017;2017;04;01;Tiistai;0;0;0
95;11.04.2017;2017;04;02;Tiistai;0;0;0
95;11.04.2017;2017;04;03;Tiistai;0;0;0
95;11.04.2017;2017;04;04;Tiistai;0;0;0
95;11.04.2017;2017;04;05;Tiistai;1;1;2
95;11.04.2017;2017;04;06;Tiistai;8;4;12
95;11.04.2017;2017;04;07;Tiistai;5;11;16
95;11.04.2017;2017;04;08;Tiistai;4;3;7
95;11.04.2017;2017;04;09;Tiistai;3;3;6
95;11.04.2017;2017;04;10;Tiistai;2;3;5
95;11.04.2017;2017;04;11;Tiistai;1;1;2
95;11.04.2017;2017;04;12;Tiistai;2;1;3
95;11.04.2017;2017;04;13;Tiistai;1;1;2
95;11.04.2017;2017;04;14;Tiistai;5;4;9
95;11.04.2017;2017;04;15;Tiistai;9;3;12
95;11.04.2017;2017;04;16;Tiistai;8;4;12
95;11.04.2017;2017;04;17;Tiistai;0;6;6
95;11.04.2017;2017;04;18;Tiistai;1;4;5
95;11.04.2017;2017;04;19;Tiistai;5;2;7
95;11.04.2017;2017;04;20;Tiistai;0;2;2
95;11.04.2017;2017;04;21;Tiistai;0;3;3
95;11.04.2017;2017;04;22;Tiistai;1;1;2
95;11.04.2017;2017;04;23;Tiistai;0;0;0
95;12.04.2017;2017;04;00;Keskiviikko;0;0;0
95;12.04.2017;2017;04;01;Keskiviikko;0;0;0
95;12.04.2017;2017;04;02;Keskiviikko;0;0;0
95;12.04.2017;2017;04;03;Keskiviikko;0;0;0
95;12.04.2017;2017;04;04;Keskiviikko;0;0;0
95;12.04.2017;2017;04;05;Keskiviikko;1;2;3
95;12.04.2017;2017;04;06;Keskiviikko;9;3;12
95;12.04.2017;2017;04;07;Keskiviikko;13;10;23
95;12.04.2017;2017;04;08;Keskiviikko;3;4;7
95;12.04.2017;2017;04;09;Keskiviikko;3;7;10
95;12.04.2017;2017;04;10;Keskiviikko;2;1;3
95;12.04.2017;2017;04;11;Keskiviikko;8;1;9
95;12.04.2017;2017;04;12;Keskiviikko;5;3;8
95;12.04.2017;2017;04;13;Keskiviikko;10;8;18
95;12.04.2017;2017;04;14;Keskiviikko;7;4;11
95;12.04.2017;2017;04;15;Keskiviikko;7;10;17
95;12.04.2017;2017;04;16;Keskiviikko;13;9;22
95;12.04.2017;2017;04;17;Keskiviikko;7;12;19
95;12.04.2017;2017;04;18;Keskiviikko;4;8;12
95;12.04.2017;2017;04;19;Keskiviikko;5;13;18
95;12.04.2017;2017;04;20;Keskiviikko;8;6;14
95;12.04.2017;2017;04;21;Keskiviikko;0;5;5
95;12.04.2017;2017;04;22;Keskiviikko;1;0;1
95;12.04.2017;2017;04;23;Keskiviikko;0;0;0
95;13.04.2017;2017;04;00;Torstai;0;0;0
95;13.04.2017;2017;04;01;Torstai;0;0;0
95;13.04.2017;2017;04;02;Torstai;0;0;0
95;13.04.2017;2017;04;03;Torstai;0;0;0
95;13.04.2017;2017;04;04;Torstai;2;0;2
95;13.04.2017;2017;04;05;Torstai;2;3;5
95;13.04.2017;2017;04;06;Torstai;5;3;8
95;13.04.2017;2017;04;07;Torstai;8;11;19
95;13.04.2017;2017;04;08;Torstai;4;3;7
95;13.04.2017;2017;04;09;Torstai;0;8;8
95;13.04.2017;2017;04;10;Torstai;3;2;5
95;13.04.2017;2017;04;11;Torstai;3;1;4
95;13.04.2017;2017;04;12;Torstai;4;5;9
95;13.04.2017;2017;04;13;Torstai;2;7;9
95;13.04.2017;2017;04;14;Torstai;5;4;9
95;13.04.2017;2017;04;15;Torstai;14;5;19
95;13.04.2017;2017;04;16;Torstai;9;3;12
95;13.04.2017;2017;04;17;Torstai;4;2;6
95;13.04.2017;2017;04;18;Torstai;1;2;3
95;13.04.2017;2017;04;19;Torstai;3;2;5
95;13.04.2017;2017;04;20;Torstai;2;0;2
95;13.04.2017;2017;04;21;Torstai;0;0;0
95;13.04.2017;2017;04;22;Torstai;0;0;0
95;13.04.2017;2017;04;23;Torstai;1;0;1
95;14.04.2017;2017;04;00;Perjantai;0;0;0
95;14.04.2017;2017;04;01;Perjantai;0;0;0
95;14.04.2017;2017;04;02;Perjantai;0;0;0
95;14.04.2017;2017;04;03;Perjantai;0;0;0
95;14.04.2017;2017;04;04;Perjantai;0;0;0
95;14.04.2017;2017;04;05;Perjantai;0;0;0
95;14.04.2017;2017;04;06;Perjantai;1;0;1
95;14.04.2017;2017;04;07;Perjantai;0;0;0
95;14.04.2017;2017;04;08;Perjantai;1;2;3
95;14.04.2017;2017;04;09;Perjantai;0;2;2
95;14.04.2017;2017;04;10;Perjantai;7;3;10
95;14.04.2017;2017;04;11;Perjantai;2;3;5
95;14.04.2017;2017;04;12;Perjantai;2;5;7
95;14.04.2017;2017;04;13;Perjantai;8;9;17
95;14.04.2017;2017;04;14;Perjantai;0;3;3
95;14.04.2017;2017;04;15;Perjantai;3;5;8
95;14.04.2017;2017;04;16;Perjantai;3;4;7
95;14.04.2017;2017;04;17;Perjantai;1;3;4
95;14.04.2017;2017;04;18;Perjantai;3;6;9
95;14.04.2017;2017;04;19;Perjantai;0;5;5
95;14.04.2017;2017;04;20;Perjantai;1;0;1
95;14.04.2017;2017;04;21;Perjantai;1;1;2
95;14.04.2017;2017;04;22;Perjantai;3;1;4
95;14.04.2017;2017;04;23;Perjantai;0;0;0
95;15.04.2017;2017;04;00;Lauantai;0;0;0
95;15.04.2017;2017;04;01;Lauantai;0;5;5
95;15.04.2017;2017;04;02;Lauantai;0;0;0
95;15.04.2017;2017;04;03;Lauantai;0;0;0
95;15.04.2017;2017;04;04;Lauantai;0;0;0
95;15.04.2017;2017;04;05;Lauantai;2;0;2
95;15.04.2017;2017;04;06;Lauantai;2;0;2
95;15.04.2017;2017;04;07;Lauantai;0;2;2
95;15.04.2017;2017;04;08;Lauantai;0;1;1
95;15.04.2017;2017;04;09;Lauantai;1;2;3
95;15.04.2017;2017;04;10;Lauantai;1;3;4
95;15.04.2017;2017;04;11;Lauantai;1;4;5
95;15.04.2017;2017;04;12;Lauantai;5;0;5
95;15.04.2017;2017;04;13;Lauantai;0;6;6
95;15.04.2017;2017;04;14;Lauantai;2;5;7
95;15.04.2017;2017;04;15;Lauantai;2;6;8
95;15.04.2017;2017;04;16;Lauantai;3;4;7
95;15.04.2017;2017;04;17;Lauantai;5;2;7
95;15.04.2017;2017;04;18;Lauantai;4;4;8
95;15.04.2017;2017;04;19;Lauantai;3;6;9
95;15.04.2017;2017;04;20;Lauantai;2;1;3
95;15.04.2017;2017;04;21;Lauantai;0;8;8
95;15.04.2017;2017;04;22;Lauantai;0;0;0
95;15.04.2017;2017;04;23;Lauantai;0;0;0
95;16.04.2017;2017;04;00;Sunnuntai;2;0;2
95;16.04.2017;2017;04;01;Sunnuntai;0;0;0
95;16.04.2017;2017;04;02;Sunnuntai;0;0;0
95;16.04.2017;2017;04;03;Sunnuntai;1;0;1
95;16.04.2017;2017;04;04;Sunnuntai;0;0;0
95;16.04.2017;2017;04;05;Sunnuntai;1;0;1
95;16.04.2017;2017;04;06;Sunnuntai;0;0;0
95;16.04.2017;2017;04;07;Sunnuntai;0;1;1
95;16.04.2017;2017;04;08;Sunnuntai;0;1;1
95;16.04.2017;2017;04;09;Sunnuntai;2;0;2
95;16.04.2017;2017;04;10;Sunnuntai;3;2;5
95;16.04.2017;2017;04;11;Sunnuntai;3;3;6
95;16.04.2017;2017;04;12;Sunnuntai;4;7;11
95;16.04.2017;2017;04;13;Sunnuntai;9;6;15
95;16.04.2017;2017;04;14;Sunnuntai;4;11;15
95;16.04.2017;2017;04;15;Sunnuntai;3;5;8
95;16.04.2017;2017;04;16;Sunnuntai;7;1;8
95;16.04.2017;2017;04;17;Sunnuntai;13;3;16
95;16.04.2017;2017;04;18;Sunnuntai;3;8;11
95;16.04.2017;2017;04;19;Sunnuntai;2;1;3
95;16.04.2017;2017;04;20;Sunnuntai;0;0;0
95;16.04.2017;2017;04;21;Sunnuntai;2;1;3
95;16.04.2017;2017;04;22;Sunnuntai;0;0;0
95;16.04.2017;2017;04;23;Sunnuntai;0;0;0
95;17.04.2017;2017;04;00;Maanantai;0;0;0
95;17.04.2017;2017;04;01;Maanantai;0;0;0
95;17.04.2017;2017;04;02;Maanantai;0;0;0
95;17.04.2017;2017;04;03;Maanantai;0;0;0
95;17.04.2017;2017;04;04;Maanantai;0;0;0
95;17.04.2017;2017;04;05;Maanantai;1;0;1
95;17.04.2017;2017;04;06;Maanantai;2;2;4
95;17.04.2017;2017;04;07;Maanantai;2;4;6
95;17.04.2017;2017;04;08;Maanantai;0;0;0
95;17.04.2017;2017;04;09;Maanantai;2;3;5
95;17.04.2017;2017;04;10;Maanantai;2;1;3
95;17.04.2017;2017;04;11;Maanantai;2;6;8
95;17.04.2017;2017;04;12;Maanantai;13;12;25
95;17.04.2017;2017;04;13;Maanantai;10;8;18
95;17.04.2017;2017;04;14;Maanantai;3;5;8
95;17.04.2017;2017;04;15;Maanantai;8;8;16
95;17.04.2017;2017;04;16;Maanantai;4;7;11
95;17.04.2017;2017;04;17;Maanantai;5;6;11
95;17.04.2017;2017;04;18;Maanantai;2;1;3
95;17.04.2017;2017;04;19;Maanantai;3;2;5
95;17.04.2017;2017;04;20;Maanantai;1;0;1
95;17.04.2017;2017;04;21;Maanantai;0;1;1
95;17.04.2017;2017;04;22;Maanantai;0;0;0
95;17.04.2017;2017;04;23;Maanantai;1;1;2
95;18.04.2017;2017;04;00;Tiistai;0;0;0
95;18.04.2017;2017;04;01;Tiistai;0;0;0
95;18.04.2017;2017;04;02;Tiistai;0;0;0
95;18.04.2017;2017;04;03;Tiistai;0;0;0
95;18.04.2017;2017;04;04;Tiistai;2;0;2
95;18.04.2017;2017;04;05;Tiistai;1;5;6
95;18.04.2017;2017;04;06;Tiistai;3;5;8
95;18.04.2017;2017;04;07;Tiistai;9;16;25
95;18.04.2017;2017;04;08;Tiistai;6;9;15
95;18.04.2017;2017;04;09;Tiistai;4;5;9
95;18.04.2017;2017;04;10;Tiistai;7;4;11
95;18.04.2017;2017;04;11;Tiistai;5;7;12
95;18.04.2017;2017;04;12;Tiistai;17;5;22
95;18.04.2017;2017;04;13;Tiistai;8;5;13
95;18.04.2017;2017;04;14;Tiistai;11;14;25
95;18.04.2017;2017;04;15;Tiistai;7;10;17
95;18.04.2017;2017;04;16;Tiistai;20;9;29
95;18.04.2017;2017;04;17;Tiistai;9;14;23
95;18.04.2017;2017;04;18;Tiistai;4;13;17
95;18.04.2017;2017;04;19;Tiistai;5;9;14
95;18.04.2017;2017;04;20;Tiistai;2;2;4
95;18.04.2017;2017;04;21;Tiistai;0;2;2
95;18.04.2017;2017;04;22;Tiistai;0;2;2
95;18.04.2017;2017;04;23;Tiistai;0;0;0
95;19.04.2017;2017;04;00;Keskiviikko;0;0;0
95;19.04.2017;2017;04;01;Keskiviikko;0;0;0
95;19.04.2017;2017;04;02;Keskiviikko;0;0;0
95;19.04.2017;2017;04;03;Keskiviikko;0;0;0
95;19.04.2017;2017;04;04;Keskiviikko;2;0;2
95;19.04.2017;2017;04;05;Keskiviikko;2;3;5
95;19.04.2017;2017;04;06;Keskiviikko;7;6;13
95;19.04.2017;2017;04;07;Keskiviikko;9;15;24
95;19.04.2017;2017;04;08;Keskiviikko;7;7;14
95;19.04.2017;2017;04;09;Keskiviikko;2;5;7
95;19.04.2017;2017;04;10;Keskiviikko;5;6;11
95;19.04.2017;2017;04;11;Keskiviikko;7;4;11
95;19.04.2017;2017;04;12;Keskiviikko;6;8;14
95;19.04.2017;2017;04;13;Keskiviikko;9;9;18
95;19.04.2017;2017;04;14;Keskiviikko;11;11;22
95;19.04.2017;2017;04;15;Keskiviikko;17;10;27
95;19.04.2017;2017;04;16;Keskiviikko;14;17;31
95;19.04.2017;2017;04;17;Keskiviikko;6;6;12
95;19.04.2017;2017;04;18;Keskiviikko;6;11;17
95;19.04.2017;2017;04;19;Keskiviikko;2;6;8
95;19.04.2017;2017;04;20;Keskiviikko;4;2;6
95;19.04.2017;2017;04;21;Keskiviikko;0;2;2
95;19.04.2017;2017;04;22;Keskiviikko;1;1;2
95;19.04.2017;2017;04;23;Keskiviikko;0;1;1
95;20.04.2017;2017;04;00;Torstai;0;0;0
95;20.04.2017;2017;04;01;Torstai;0;0;0
95;20.04.2017;2017;04;02;Torstai;0;0;0
95;20.04.2017;2017;04;03;Torstai;0;0;0
95;20.04.2017;2017;04;04;Torstai;0;0;0
95;20.04.2017;2017;04;05;Torstai;1;3;4
95;20.04.2017;2017;04;06;Torstai;6;4;10
95;20.04.2017;2017;04;07;Torstai;10;14;24
95;20.04.2017;2017;04;08;Torstai;6;3;9
95;20.04.2017;2017;04;09;Torstai;2;5;7
95;20.04.2017;2017;04;10;Torstai;3;3;6
95;20.04.2017;2017;04;11;Torstai;11;3;14
95;20.04.2017;2017;04;12;Torstai;8;6;14
95;20.04.2017;2017;04;13;Torstai;6;7;13
95;20.04.2017;2017;04;14;Torstai;4;5;9
95;20.04.2017;2017;04;15;Torstai;6;5;11
95;20.04.2017;2017;04;16;Torstai;14;6;20
95;20.04.2017;2017;04;17;Torstai;3;4;7
95;20.04.2017;2017;04;18;Torstai;0;2;2
95;20.04.2017;2017;04;19;Torstai;2;0;2
95;20.04.2017;2017;04;20;Torstai;1;0;1
95;20.04.2017;2017;04;21;Torstai;2;1;3
95;20.04.2017;2017;04;22;Torstai;1;1;2
95;20.04.2017;2017;04;23;Torstai;0;1;1
95;21.04.2017;2017;04;00;Perjantai;1;0;1
95;21.04.2017;2017;04;01;Perjantai;0;0;0
95;21.04.2017;2017;04;02;Perjantai;0;0;0
95;21.04.2017;2017;04;03;Perjantai;0;0;0
95;21.04.2017;2017;04;04;Perjantai;0;0;0
95;21.04.2017;2017;04;05;Perjantai;3;3;6
95;21.04.2017;2017;04;06;Perjantai;6;6;12
95;21.04.2017;2017;04;07;Perjantai;8;11;19
95;21.04.2017;2017;04;08;Perjantai;3;10;13
95;21.04.2017;2017;04;09;Perjantai;6;3;9
95;21.04.2017;2017;04;10;Perjantai;3;4;7
95;21.04.2017;2017;04;11;Perjantai;9;3;12
95;21.04.2017;2017;04;12;Perjantai;8;3;11
95;21.04.2017;2017;04;13;Perjantai;12;10;22
95;21.04.2017;2017;04;14;Perjantai;12;5;17
95;21.04.2017;2017;04;15;Perjantai;11;19;30
95;21.04.2017;2017;04;16;Perjantai;12;14;26
95;21.04.2017;2017;04;17;Perjantai;6;9;15
95;21.04.2017;2017;04;18;Perjantai;3;2;5
95;21.04.2017;2017;04;19;Perjantai;3;5;8
95;21.04.2017;2017;04;20;Perjantai;1;1;2
95;21.04.2017;2017;04;21;Perjantai;1;3;4
95;21.04.2017;2017;04;22;Perjantai;1;2;3
95;21.04.2017;2017;04;23;Perjantai;0;0;0
95;22.04.2017;2017;04;00;Lauantai;0;0;0
95;22.04.2017;2017;04;01;Lauantai;0;1;1
95;22.04.2017;2017;04;02;Lauantai;0;0;0
95;22.04.2017;2017;04;03;Lauantai;0;1;1
95;22.04.2017;2017;04;04;Lauantai;1;0;1
95;22.04.2017;2017;04;05;Lauantai;0;0;0
95;22.04.2017;2017;04;06;Lauantai;0;1;1
95;22.04.2017;2017;04;07;Lauantai;0;2;2
95;22.04.2017;2017;04;08;Lauantai;2;2;4
95;22.04.2017;2017;04;09;Lauantai;10;2;12
95;22.04.2017;2017;04;10;Lauantai;2;3;5
95;22.04.2017;2017;04;11;Lauantai;14;16;30
95;22.04.2017;2017;04;12;Lauantai;13;14;27
95;22.04.2017;2017;04;13;Lauantai;22;14;36
95;22.04.2017;2017;04;14;Lauantai;17;14;31
95;22.04.2017;2017;04;15;Lauantai;8;8;16
95;22.04.2017;2017;04;16;Lauantai;6;6;12
95;22.04.2017;2017;04;17;Lauantai;7;5;12
95;22.04.2017;2017;04;18;Lauantai;5;7;12
95;22.04.2017;2017;04;19;Lauantai;5;4;9
95;22.04.2017;2017;04;20;Lauantai;3;7;10
95;22.04.2017;2017;04;21;Lauantai;1;1;2
95;22.04.2017;2017;04;22;Lauantai;0;1;1
95;22.04.2017;2017;04;23;Lauantai;0;0;0
95;23.04.2017;2017;04;00;Sunnuntai;0;0;0
95;23.04.2017;2017;04;01;Sunnuntai;0;1;1
95;23.04.2017;2017;04;02;Sunnuntai;0;1;1
95;23.04.2017;2017;04;03;Sunnuntai;0;0;0
95;23.04.2017;2017;04;04;Sunnuntai;1;0;1
95;23.04.2017;2017;04;05;Sunnuntai;0;0;0
95;23.04.2017;2017;04;06;Sunnuntai;0;0;0
95;23.04.2017;2017;04;07;Sunnuntai;1;2;3
95;23.04.2017;2017;04;08;Sunnuntai;3;2;5
95;23.04.2017;2017;04;09;Sunnuntai;3;5;8
95;23.04.2017;2017;04;10;Sunnuntai;9;8;17
95;23.04.2017;2017;04;11;Sunnuntai;9;10;19
95;23.04.2017;2017;04;12;Sunnuntai;9;9;18
95;23.04.2017;2017;04;13;Sunnuntai;9;23;32
95;23.04.2017;2017;04;14;Sunnuntai;11;13;24
95;23.04.2017;2017;04;15;Sunnuntai;13;13;26
95;23.04.2017;2017;04;16;Sunnuntai;6;3;9
95;23.04.2017;2017;04;17;Sunnuntai;7;3;10
95;23.04.2017;2017;04;18;Sunnuntai;9;8;17
95;23.04.2017;2017;04;19;Sunnuntai;8;3;11
95;23.04.2017;2017;04;20;Sunnuntai;2;5;7
95;23.04.2017;2017;04;21;Sunnuntai;2;1;3
95;23.04.2017;2017;04;22;Sunnuntai;0;0;0
95;23.04.2017;2017;04;23;Sunnuntai;0;1;1
95;24.04.2017;2017;04;00;Maanantai;0;0;0
95;24.04.2017;2017;04;01;Maanantai;0;1;1
95;24.04.2017;2017;04;02;Maanantai;0;0;0
95;24.04.2017;2017;04;03;Maanantai;0;0;0
95;24.04.2017;2017;04;04;Maanantai;1;0;1
95;24.04.2017;2017;04;05;Maanantai;4;2;6
95;24.04.2017;2017;04;06;Maanantai;11;8;19
95;24.04.2017;2017;04;07;Maanantai;10;12;22
95;24.04.2017;2017;04;08;Maanantai;3;7;10
95;24.04.2017;2017;04;09;Maanantai;13;9;22
95;24.04.2017;2017;04;10;Maanantai;4;7;11
95;24.04.2017;2017;04;11;Maanantai;15;5;20
95;24.04.2017;2017;04;12;Maanantai;8;8;16
95;24.04.2017;2017;04;13;Maanantai;6;7;13
95;24.04.2017;2017;04;14;Maanantai;11;9;20
95;24.04.2017;2017;04;15;Maanantai;20;14;34
95;24.04.2017;2017;04;16;Maanantai;20;17;37
95;24.04.2017;2017;04;17;Maanantai;6;20;26
95;24.04.2017;2017;04;18;Maanantai;2;10;12
95;24.04.2017;2017;04;19;Maanantai;3;5;8
95;24.04.2017;2017;04;20;Maanantai;3;6;9
95;24.04.2017;2017;04;21;Maanantai;4;2;6
95;24.04.2017;2017;04;22;Maanantai;2;0;2
95;24.04.2017;2017;04;23;Maanantai;0;0;0
95;25.04.2017;2017;04;00;Tiistai;0;0;0
95;25.04.2017;2017;04;01;Tiistai;0;2;2
95;25.04.2017;2017;04;02;Tiistai;0;0;0
95;25.04.2017;2017;04;03;Tiistai;0;0;0
95;25.04.2017;2017;04;04;Tiistai;1;1;2
95;25.04.2017;2017;04;05;Tiistai;3;4;7
95;25.04.2017;2017;04;06;Tiistai;11;5;16
95;25.04.2017;2017;04;07;Tiistai;18;25;43
95;25.04.2017;2017;04;08;Tiistai;7;9;16
95;25.04.2017;2017;04;09;Tiistai;11;10;21
95;25.04.2017;2017;04;10;Tiistai;10;7;17
95;25.04.2017;2017;04;11;Tiistai;11;12;23
95;25.04.2017;2017;04;12;Tiistai;13;13;26
95;25.04.2017;2017;04;13;Tiistai;11;13;24
95;25.04.2017;2017;04;14;Tiistai;19;10;29
95;25.04.2017;2017;04;15;Tiistai;20;13;33
95;25.04.2017;2017;04;16;Tiistai;17;15;32
95;25.04.2017;2017;04;17;Tiistai;5;14;19
95;25.04.2017;2017;04;18;Tiistai;11;21;32
95;25.04.2017;2017;04;19;Tiistai;10;9;19
95;25.04.2017;2017;04;20;Tiistai;1;6;7
95;25.04.2017;2017;04;21;Tiistai;1;5;6
95;25.04.2017;2017;04;22;Tiistai;3;2;5
95;25.04.2017;2017;04;23;Tiistai;2;0;2
95;26.04.2017;2017;04;00;Keskiviikko;0;1;1
95;26.04.2017;2017;04;01;Keskiviikko;0;0;0
95;26.04.2017;2017;04;02;Keskiviikko;0;0;0
95;26.04.2017;2017;04;03;Keskiviikko;0;1;1
95;26.04.2017;2017;04;04;Keskiviikko;0;0;0
95;26.04.2017;2017;04;05;Keskiviikko;2;2;4
95;26.04.2017;2017;04;06;Keskiviikko;5;4;9
95;26.04.2017;2017;04;07;Keskiviikko;7;16;23
95;26.04.2017;2017;04;08;Keskiviikko;2;3;5
95;26.04.2017;2017;04;09;Keskiviikko;2;4;6
95;26.04.2017;2017;04;10;Keskiviikko;0;2;2
95;26.04.2017;2017;04;11;Keskiviikko;2;0;2
95;26.04.2017;2017;04;12;Keskiviikko;2;1;3
95;26.04.2017;2017;04;13;Keskiviikko;3;4;7
95;26.04.2017;2017;04;14;Keskiviikko;8;4;12
95;26.04.2017;2017;04;15;Keskiviikko;3;6;9
95;26.04.2017;2017;04;16;Keskiviikko;7;7;14
95;26.04.2017;2017;04;17;Keskiviikko;3;4;7
95;26.04.2017;2017;04;18;Keskiviikko;3;2;5
95;26.04.2017;2017;04;19;Keskiviikko;2;1;3
95;26.04.2017;2017;04;20;Keskiviikko;0;0;0
95;26.04.2017;2017;04;21;Keskiviikko;0;0;0
95;26.04.2017;2017;04;22;Keskiviikko;2;2;4
95;26.04.2017;2017;04;23;Keskiviikko;0;0;0
95;27.04.2017;2017;04;00;Torstai;0;0;0
95;27.04.2017;2017;04;01;Torstai;0;0;0
95;27.04.2017;2017;04;02;Torstai;0;0;0
95;27.04.2017;2017;04;03;Torstai;0;0;0
95;27.04.2017;2017;04;04;Torstai;1;0;1
95;27.04.2017;2017;04;05;Torstai;2;3;5
95;27.04.2017;2017;04;06;Torstai;7;3;10
95;27.04.2017;2017;04;07;Torstai;7;4;11
95;27.04.2017;2017;04;08;Torstai;3;2;5
95;27.04.2017;2017;04;09;Torstai;5;9;14
95;27.04.2017;2017;04;10;Torstai;5;4;9
95;27.04.2017;2017;04;11;Torstai;4;2;6
95;27.04.2017;2017;04;12;Torstai;3;4;7
95;27.04.2017;2017;04;13;Torstai;4;7;11
95;27.04.2017;2017;04;14;Torstai;10;4;14
95;27.04.2017;2017;04;15;Torstai;11;11;22
95;27.04.2017;2017;04;16;Torstai;9;9;18
95;27.04.2017;2017;04;17;Torstai;9;3;12
95;27.04.2017;2017;04;18;Torstai;3;4;7
95;27.04.2017;2017;04;19;Torstai;2;11;13
95;27.04.2017;2017;04;20;Torstai;7;2;9
95;27.04.2017;2017;04;21;Torstai;4;2;6
95;27.04.2017;2017;04;22;Torstai;2;1;3
95;27.04.2017;2017;04;23;Torstai;0;1;1
95;28.04.2017;2017;04;00;Perjantai;0;0;0
95;28.04.2017;2017;04;01;Perjantai;0;0;0
95;28.04.2017;2017;04;02;Perjantai;0;0;0
95;28.04.2017;2017;04;03;Perjantai;0;0;0
95;28.04.2017;2017;04;04;Perjantai;2;0;2
95;28.04.2017;2017;04;05;Perjantai;3;3;6
95;28.04.2017;2017;04;06;Perjantai;4;1;5
95;28.04.2017;2017;04;07;Perjantai;7;18;25
95;28.04.2017;2017;04;08;Perjantai;8;8;16
95;28.04.2017;2017;04;09;Perjantai;10;5;15
95;28.04.2017;2017;04;10;Perjantai;5;1;6
95;28.04.2017;2017;04;11;Perjantai;3;9;12
95;28.04.2017;2017;04;12;Perjantai;9;11;20
95;28.04.2017;2017;04;13;Perjantai;16;9;25
95;28.04.2017;2017;04;14;Perjantai;12;9;21
95;28.04.2017;2017;04;15;Perjantai;9;14;23
95;28.04.2017;2017;04;16;Perjantai;7;8;15
95;28.04.2017;2017;04;17;Perjantai;3;10;13
95;28.04.2017;2017;04;18;Perjantai;10;8;18
95;28.04.2017;2017;04;19;Perjantai;7;8;15
95;28.04.2017;2017;04;20;Perjantai;2;4;6
95;28.04.2017;2017;04;21;Perjantai;7;4;11
95;28.04.2017;2017;04;22;Perjantai;3;4;7
95;28.04.2017;2017;04;23;Perjantai;0;0;0
95;29.04.2017;2017;04;00;Lauantai;0;0;0
95;29.04.2017;2017;04;01;Lauantai;0;0;0
95;29.04.2017;2017;04;02;Lauantai;0;3;3
95;29.04.2017;2017;04;03;Lauantai;0;2;2
95;29.04.2017;2017;04;04;Lauantai;2;1;3
95;29.04.2017;2017;04;05;Lauantai;2;0;2
95;29.04.2017;2017;04;06;Lauantai;1;1;2
95;29.04.2017;2017;04;07;Lauantai;2;3;5
95;29.04.2017;2017;04;08;Lauantai;5;3;8
95;29.04.2017;2017;04;09;Lauantai;8;5;13
95;29.04.2017;2017;04;10;Lauantai;6;12;18
95;29.04.2017;2017;04;11;Lauantai;14;8;22
95;29.04.2017;2017;04;12;Lauantai;19;6;25
95;29.04.2017;2017;04;13;Lauantai;7;14;21
95;29.04.2017;2017;04;14;Lauantai;10;17;27
95;29.04.2017;2017;04;15;Lauantai;17;11;28
95;29.04.2017;2017;04;16;Lauantai;6;14;20
95;29.04.2017;2017;04;17;Lauantai;10;11;21
95;29.04.2017;2017;04;18;Lauantai;11;6;17
95;29.04.2017;2017;04;19;Lauantai;2;4;6
95;29.04.2017;2017;04;20;Lauantai;7;1;8
95;29.04.2017;2017;04;21;Lauantai;4;2;6
95;29.04.2017;2017;04;22;Lauantai;0;4;4
95;29.04.2017;2017;04;23;Lauantai;0;0;0
95;30.04.2017;2017;04;00;Sunnuntai;2;0;2
95;30.04.2017;2017;04;01;Sunnuntai;0;0;0
95;30.04.2017;2017;04;02;Sunnuntai;0;2;2
95;30.04.2017;2017;04;03;Sunnuntai;0;0;0
95;30.04.2017;2017;04;04;Sunnuntai;0;0;0
95;30.04.2017;2017;04;05;Sunnuntai;0;0;0
95;30.04.2017;2017;04;06;Sunnuntai;2;0;2
95;30.04.2017;2017;04;07;Sunnuntai;0;0;0
95;30.04.2017;2017;04;08;Sunnuntai;2;2;4
95;30.04.2017;2017;04;09;Sunnuntai;0;0;0
95;30.04.2017;2017;04;10;Sunnuntai;2;2;4
95;30.04.2017;2017;04;11;Sunnuntai;1;7;8
95;30.04.2017;2017;04;12;Sunnuntai;7;5;12
95;30.04.2017;2017;04;13;Sunnuntai;3;3;6
95;30.04.2017;2017;04;14;Sunnuntai;4;5;9
95;30.04.2017;2017;04;15;Sunnuntai;1;2;3
95;30.04.2017;2017;04;16;Sunnuntai;1;6;7
95;30.04.2017;2017;04;17;Sunnuntai;3;6;9
95;30.04.2017;2017;04;18;Sunnuntai;6;1;7
95;30.04.2017;2017;04;19;Sunnuntai;7;1;8
95;30.04.2017;2017;04;20;Sunnuntai;2;1;3
95;30.04.2017;2017;04;21;Sunnuntai;0;1;1
95;30.04.2017;2017;04;22;Sunnuntai;0;1;1
95;30.04.2017;2017;04;23;Sunnuntai;0;0;0
95;01.05.2017;2017;05;00;Maanantai;0;0;0
95;01.05.2017;2017;05;01;Maanantai;0;0;0
95;01.05.2017;2017;05;02;Maanantai;0;2;2
95;01.05.2017;2017;05;03;Maanantai;0;2;2
95;01.05.2017;2017;05;04;Maanantai;0;0;0
95;01.05.2017;2017;05;05;Maanantai;0;0;0
95;01.05.2017;2017;05;06;Maanantai;2;0;2
95;01.05.2017;2017;05;07;Maanantai;2;1;3
95;01.05.2017;2017;05;08;Maanantai;3;4;7
95;01.05.2017;2017;05;09;Maanantai;4;3;7
95;01.05.2017;2017;05;10;Maanantai;9;10;19
95;01.05.2017;2017;05;11;Maanantai;15;7;22
95;01.05.2017;2017;05;12;Maanantai;32;8;40
95;01.05.2017;2017;05;13;Maanantai;16;34;50
95;01.05.2017;2017;05;14;Maanantai;4;29;33
95;01.05.2017;2017;05;15;Maanantai;14;6;20
95;01.05.2017;2017;05;16;Maanantai;9;15;24
95;01.05.2017;2017;05;17;Maanantai;9;13;22
95;01.05.2017;2017;05;18;Maanantai;5;4;9
95;01.05.2017;2017;05;19;Maanantai;8;9;17
95;01.05.2017;2017;05;20;Maanantai;8;5;13
95;01.05.2017;2017;05;21;Maanantai;5;4;9
95;01.05.2017;2017;05;22;Maanantai;1;4;5
95;01.05.2017;2017;05;23;Maanantai;1;2;3
95;02.05.2017;2017;05;00;Tiistai;0;0;0
95;02.05.2017;2017;05;01;Tiistai;0;0;0
95;02.05.2017;2017;05;02;Tiistai;0;0;0
95;02.05.2017;2017;05;03;Tiistai;0;1;1
95;02.05.2017;2017;05;04;Tiistai;4;1;5
95;02.05.2017;2017;05;05;Tiistai;6;5;11
95;02.05.2017;2017;05;06;Tiistai;16;4;20
95;02.05.2017;2017;05;07;Tiistai;22;27;49
95;02.05.2017;2017;05;08;Tiistai;12;12;24
95;02.05.2017;2017;05;09;Tiistai;13;6;19
95;02.05.2017;2017;05;10;Tiistai;4;6;10
95;02.05.2017;2017;05;11;Tiistai;6;7;13
95;02.05.2017;2017;05;12;Tiistai;12;8;20
95;02.05.2017;2017;05;13;Tiistai;8;9;17
95;02.05.2017;2017;05;14;Tiistai;17;11;28
95;02.05.2017;2017;05;15;Tiistai;23;25;48
95;02.05.2017;2017;05;16;Tiistai;20;24;44
95;02.05.2017;2017;05;17;Tiistai;9;27;36
95;02.05.2017;2017;05;18;Tiistai;12;16;28
95;02.05.2017;2017;05;19;Tiistai;10;10;20
95;02.05.2017;2017;05;20;Tiistai;5;8;13
95;02.05.2017;2017;05;21;Tiistai;5;5;10
95;02.05.2017;2017;05;22;Tiistai;1;1;2
95;02.05.2017;2017;05;23;Tiistai;1;2;3
95;03.05.2017;2017;05;00;Keskiviikko;0;0;0
95;03.05.2017;2017;05;01;Keskiviikko;0;0;0
95;03.05.2017;2017;05;02;Keskiviikko;1;0;1
95;03.05.2017;2017;05;03;Keskiviikko;0;0;0
95;03.05.2017;2017;05;04;Keskiviikko;3;0;3
95;03.05.2017;2017;05;05;Keskiviikko;7;8;15
95;03.05.2017;2017;05;06;Keskiviikko;17;12;29
95;03.05.2017;2017;05;07;Keskiviikko;13;21;34
95;03.05.2017;2017;05;08;Keskiviikko;15;9;24
95;03.05.2017;2017;05;09;Keskiviikko;8;10;18
95;03.05.2017;2017;05;10;Keskiviikko;2;6;8
95;03.05.2017;2017;05;11;Keskiviikko;6;10;16
95;03.05.2017;2017;05;12;Keskiviikko;10;6;16
95;03.05.2017;2017;05;13;Keskiviikko;13;4;17
95;03.05.2017;2017;05;14;Keskiviikko;17;12;29
95;03.05.2017;2017;05;15;Keskiviikko;16;20;36
95;03.05.2017;2017;05;16;Keskiviikko;29;25;54
95;03.05.2017;2017;05;17;Keskiviikko;12;23;35
95;03.05.2017;2017;05;18;Keskiviikko;9;9;18
95;03.05.2017;2017;05;19;Keskiviikko;6;14;20
95;03.05.2017;2017;05;20;Keskiviikko;7;8;15
95;03.05.2017;2017;05;21;Keskiviikko;7;8;15
95;03.05.2017;2017;05;22;Keskiviikko;3;4;7
95;03.05.2017;2017;05;23;Keskiviikko;0;2;2
95;04.05.2017;2017;05;00;Torstai;0;0;0
95;04.05.2017;2017;05;01;Torstai;0;0;0
95;04.05.2017;2017;05;02;Torstai;0;0;0
95;04.05.2017;2017;05;03;Torstai;0;0;0
95;04.05.2017;2017;05;04;Torstai;2;1;3
95;04.05.2017;2017;05;05;Torstai;10;4;14
95;04.05.2017;2017;05;06;Torstai;17;12;29
95;04.05.2017;2017;05;07;Torstai;16;17;33
95;04.05.2017;2017;05;08;Torstai;15;7;22
95;04.05.2017;2017;05;09;Torstai;7;17;24
95;04.05.2017;2017;05;10;Torstai;11;8;19
95;04.05.2017;2017;05;11;Torstai;12;6;18
95;04.05.2017;2017;05;12;Torstai;6;5;11
95;04.05.2017;2017;05;13;Torstai;15;6;21
95;04.05.2017;2017;05;14;Torstai;12;16;28
95;04.05.2017;2017;05;15;Torstai;22;23;45
95;04.05.2017;2017;05;16;Torstai;18;35;53
95;04.05.2017;2017;05;17;Torstai;9;24;33
95;04.05.2017;2017;05;18;Torstai;14;11;25
95;04.05.2017;2017;05;19;Torstai;16;15;31
95;04.05.2017;2017;05;20;Torstai;4;11;15
95;04.05.2017;2017;05;21;Torstai;1;8;9
95;04.05.2017;2017;05;22;Torstai;1;3;4
95;04.05.2017;2017;05;23;Torstai;1;0;1
95;05.05.2017;2017;05;00;Perjantai;0;1;1
95;05.05.2017;2017;05;01;Perjantai;0;0;0
95;05.05.2017;2017;05;02;Perjantai;0;0;0
95;05.05.2017;2017;05;03;Perjantai;0;0;0
95;05.05.2017;2017;05;04;Perjantai;1;0;1
95;05.05.2017;2017;05;05;Perjantai;8;4;12
95;05.05.2017;2017;05;06;Perjantai;13;11;24
95;05.05.2017;2017;05;07;Perjantai;19;14;33
95;05.05.2017;2017;05;08;Perjantai;19;7;26
95;05.05.2017;2017;05;09;Perjantai;4;9;13
95;05.05.2017;2017;05;10;Perjantai;11;13;24
95;05.05.2017;2017;05;11;Perjantai;9;10;19
95;05.05.2017;2017;05;12;Perjantai;12;7;19
95;05.05.2017;2017;05;13;Perjantai;12;11;23
95;05.05.2017;2017;05;14;Perjantai;28;24;52
95;05.05.2017;2017;05;15;Perjantai;18;20;38
95;05.05.2017;2017;05;16;Perjantai;13;24;37
95;05.05.2017;2017;05;17;Perjantai;11;15;26
95;05.05.2017;2017;05;18;Perjantai;14;25;39
95;05.05.2017;2017;05;19;Perjantai;18;22;40
95;05.05.2017;2017;05;20;Perjantai;11;8;19
95;05.05.2017;2017;05;21;Perjantai;3;5;8
95;05.05.2017;2017;05;22;Perjantai;2;4;6
95;05.05.2017;2017;05;23;Perjantai;0;5;5
95;06.05.2017;2017;05;00;Lauantai;2;1;3
95;06.05.2017;2017;05;01;Lauantai;0;2;2
95;06.05.2017;2017;05;02;Lauantai;0;2;2
95;06.05.2017;2017;05;03;Lauantai;0;0;0
95;06.05.2017;2017;05;04;Lauantai;2;0;2
95;06.05.2017;2017;05;05;Lauantai;1;0;1
95;06.05.2017;2017;05;06;Lauantai;2;1;3
95;06.05.2017;2017;05;07;Lauantai;5;4;9
95;06.05.2017;2017;05;08;Lauantai;2;4;6
95;06.05.2017;2017;05;09;Lauantai;3;3;6
95;06.05.2017;2017;05;10;Lauantai;5;32;37
95;06.05.2017;2017;05;11;Lauantai;7;10;17
95;06.05.2017;2017;05;12;Lauantai;7;6;13
95;06.05.2017;2017;05;13;Lauantai;10;15;25
95;06.05.2017;2017;05;14;Lauantai;6;9;15
95;06.05.2017;2017;05;15;Lauantai;10;5;15
95;06.05.2017;2017;05;16;Lauantai;10;8;18
95;06.05.2017;2017;05;17;Lauantai;9;16;25
95;06.05.2017;2017;05;18;Lauantai;15;13;28
95;06.05.2017;2017;05;19;Lauantai;3;10;13
95;06.05.2017;2017;05;20;Lauantai;5;3;8
95;06.05.2017;2017;05;21;Lauantai;2;2;4
95;06.05.2017;2017;05;22;Lauantai;0;0;0
95;06.05.2017;2017;05;23;Lauantai;5;0;5
95;07.05.2017;2017;05;00;Sunnuntai;0;0;0
95;07.05.2017;2017;05;01;Sunnuntai;0;0;0
95;07.05.2017;2017;05;02;Sunnuntai;1;1;2
95;07.05.2017;2017;05;03;Sunnuntai;0;0;0
95;07.05.2017;2017;05;04;Sunnuntai;0;1;1
95;07.05.2017;2017;05;05;Sunnuntai;1;0;1
95;07.05.2017;2017;05;06;Sunnuntai;4;0;4
95;07.05.2017;2017;05;07;Sunnuntai;6;2;8
95;07.05.2017;2017;05;08;Sunnuntai;3;5;8
95;07.05.2017;2017;05;09;Sunnuntai;17;12;29
95;07.05.2017;2017;05;10;Sunnuntai;28;49;77
95;07.05.2017;2017;05;11;Sunnuntai;16;20;36
95;07.05.2017;2017;05;12;Sunnuntai;46;9;55
95;07.05.2017;2017;05;13;Sunnuntai;12;23;35
95;07.05.2017;2017;05;14;Sunnuntai;11;15;26
95;07.05.2017;2017;05;15;Sunnuntai;20;16;36
95;07.05.2017;2017;05;16;Sunnuntai;15;10;25
95;07.05.2017;2017;05;17;Sunnuntai;9;13;22
95;07.05.2017;2017;05;18;Sunnuntai;6;6;12
95;07.05.2017;2017;05;19;Sunnuntai;7;5;12
95;07.05.2017;2017;05;20;Sunnuntai;5;5;10
95;07.05.2017;2017;05;21;Sunnuntai;4;4;8
95;07.05.2017;2017;05;22;Sunnuntai;2;1;3
95;07.05.2017;2017;05;23;Sunnuntai;0;0;0
95;08.05.2017;2017;05;00;Maanantai;0;0;0
95;08.05.2017;2017;05;01;Maanantai;0;0;0
95;08.05.2017;2017;05;02;Maanantai;0;0;0
95;08.05.2017;2017;05;03;Maanantai;0;0;0
95;08.05.2017;2017;05;04;Maanantai;3;0;3
95;08.05.2017;2017;05;05;Maanantai;8;2;10
95;08.05.2017;2017;05;06;Maanantai;19;9;28
95;08.05.2017;2017;05;07;Maanantai;10;13;23
95;08.05.2017;2017;05;08;Maanantai;16;14;30
95;08.05.2017;2017;05;09;Maanantai;11;8;19
95;08.05.2017;2017;05;10;Maanantai;6;2;8
95;08.05.2017;2017;05;11;Maanantai;7;6;13
95;08.05.2017;2017;05;12;Maanantai;2;7;9
95;08.05.2017;2017;05;13;Maanantai;6;7;13
95;08.05.2017;2017;05;14;Maanantai;7;13;20
95;08.05.2017;2017;05;15;Maanantai;11;14;25
95;08.05.2017;2017;05;16;Maanantai;16;17;33
95;08.05.2017;2017;05;17;Maanantai;4;17;21
95;08.05.2017;2017;05;18;Maanantai;11;9;20
95;08.05.2017;2017;05;19;Maanantai;9;6;15
95;08.05.2017;2017;05;20;Maanantai;5;6;11
95;08.05.2017;2017;05;21;Maanantai;2;2;4
95;08.05.2017;2017;05;22;Maanantai;4;2;6
95;08.05.2017;2017;05;23;Maanantai;0;2;2
95;09.05.2017;2017;05;00;Tiistai;0;0;0
95;09.05.2017;2017;05;01;Tiistai;0;0;0
95;09.05.2017;2017;05;02;Tiistai;0;0;0
95;09.05.2017;2017;05;03;Tiistai;0;0;0
95;09.05.2017;2017;05;04;Tiistai;2;0;2
95;09.05.2017;2017;05;05;Tiistai;5;2;7
95;09.05.2017;2017;05;06;Tiistai;14;9;23
95;09.05.2017;2017;05;07;Tiistai;20;14;34
95;09.05.2017;2017;05;08;Tiistai;7;9;16
95;09.05.2017;2017;05;09;Tiistai;10;8;18
95;09.05.2017;2017;05;10;Tiistai;5;2;7
95;09.05.2017;2017;05;11;Tiistai;6;5;11
95;09.05.2017;2017;05;12;Tiistai;6;0;6
95;09.05.2017;2017;05;13;Tiistai;6;8;14
95;09.05.2017;2017;05;14;Tiistai;9;9;18
95;09.05.2017;2017;05;15;Tiistai;16;17;33
95;09.05.2017;2017;05;16;Tiistai;19;18;37
95;09.05.2017;2017;05;17;Tiistai;5;13;18
95;09.05.2017;2017;05;18;Tiistai;10;12;22
95;09.05.2017;2017;05;19;Tiistai;10;10;20
95;09.05.2017;2017;05;20;Tiistai;5;4;9
95;09.05.2017;2017;05;21;Tiistai;5;3;8
95;09.05.2017;2017;05;22;Tiistai;3;1;4
95;09.05.2017;2017;05;23;Tiistai;0;0;0
95;10.05.2017;2017;05;00;Keskiviikko;0;0;0
95;10.05.2017;2017;05;01;Keskiviikko;0;0;0
95;10.05.2017;2017;05;02;Keskiviikko;0;1;1
95;10.05.2017;2017;05;03;Keskiviikko;0;0;0
95;10.05.2017;2017;05;04;Keskiviikko;0;0;0
95;10.05.2017;2017;05;05;Keskiviikko;9;3;12
95;10.05.2017;2017;05;06;Keskiviikko;16;10;26
95;10.05.2017;2017;05;07;Keskiviikko;21;13;34
95;10.05.2017;2017;05;08;Keskiviikko;14;12;26
95;10.05.2017;2017;05;09;Keskiviikko;12;7;19
95;10.05.2017;2017;05;10;Keskiviikko;2;8;10
95;10.05.2017;2017;05;11;Keskiviikko;6;2;8
95;10.05.2017;2017;05;12;Keskiviikko;7;3;10
95;10.05.2017;2017;05;13;Keskiviikko;9;4;13
95;10.05.2017;2017;05;14;Keskiviikko;2;7;9
95;10.05.2017;2017;05;15;Keskiviikko;10;19;29
95;10.05.2017;2017;05;16;Keskiviikko;18;26;44
95;10.05.2017;2017;05;17;Keskiviikko;4;13;17
95;10.05.2017;2017;05;18;Keskiviikko;7;7;14
95;10.05.2017;2017;05;19;Keskiviikko;7;8;15
95;10.05.2017;2017;05;20;Keskiviikko;4;5;9
95;10.05.2017;2017;05;21;Keskiviikko;0;5;5
95;10.05.2017;2017;05;22;Keskiviikko;2;1;3
95;10.05.2017;2017;05;23;Keskiviikko;1;0;1
95;11.05.2017;2017;05;00;Torstai;1;0;1
95;11.05.2017;2017;05;01;Torstai;1;0;1
95;11.05.2017;2017;05;02;Torstai;0;0;0
95;11.05.2017;2017;05;03;Torstai;0;0;0
95;11.05.2017;2017;05;04;Torstai;2;0;2
95;11.05.2017;2017;05;05;Torstai;6;5;11
95;11.05.2017;2017;05;06;Torstai;6;9;15
95;11.05.2017;2017;05;07;Torstai;19;14;33
95;11.05.2017;2017;05;08;Torstai;10;6;16
95;11.05.2017;2017;05;09;Torstai;8;6;14
95;11.05.2017;2017;05;10;Torstai;4;2;6
95;11.05.2017;2017;05;11;Torstai;6;5;11
95;11.05.2017;2017;05;12;Torstai;4;8;12
95;11.05.2017;2017;05;13;Torstai;4;6;10
95;11.05.2017;2017;05;14;Torstai;5;9;14
95;11.05.2017;2017;05;15;Torstai;15;9;24
95;11.05.2017;2017;05;16;Torstai;16;21;37
95;11.05.2017;2017;05;17;Torstai;13;8;21
95;11.05.2017;2017;05;18;Torstai;10;11;21
95;11.05.2017;2017;05;19;Torstai;6;15;21
95;11.05.2017;2017;05;20;Torstai;5;7;12
95;11.05.2017;2017;05;21;Torstai;4;6;10
95;11.05.2017;2017;05;22;Torstai;4;0;4
95;11.05.2017;2017;05;23;Torstai;1;0;1
95;12.05.2017;2017;05;00;Perjantai;1;1;2
95;12.05.2017;2017;05;01;Perjantai;0;0;0
95;12.05.2017;2017;05;02;Perjantai;0;0;0
95;12.05.2017;2017;05;03;Perjantai;0;1;1
95;12.05.2017;2017;05;04;Perjantai;2;0;2
95;12.05.2017;2017;05;05;Perjantai;3;1;4
95;12.05.2017;2017;05;06;Perjantai;14;9;23
95;12.05.2017;2017;05;07;Perjantai;10;9;19
95;12.05.2017;2017;05;08;Perjantai;14;9;23
95;12.05.2017;2017;05;09;Perjantai;9;8;17
95;12.05.2017;2017;05;10;Perjantai;5;9;14
95;12.05.2017;2017;05;11;Perjantai;4;3;7
95;12.05.2017;2017;05;12;Perjantai;4;3;7
95;12.05.2017;2017;05;13;Perjantai;12;16;28
95;12.05.2017;2017;05;14;Perjantai;9;5;14
95;12.05.2017;2017;05;15;Perjantai;8;21;29
95;12.05.2017;2017;05;16;Perjantai;9;14;23
95;12.05.2017;2017;05;17;Perjantai;3;13;16
95;12.05.2017;2017;05;18;Perjantai;8;9;17
95;12.05.2017;2017;05;19;Perjantai;8;8;16
95;12.05.2017;2017;05;20;Perjantai;6;9;15
95;12.05.2017;2017;05;21;Perjantai;8;5;13
95;12.05.2017;2017;05;22;Perjantai;1;1;2
95;12.05.2017;2017;05;23;Perjantai;1;0;1
95;13.05.2017;2017;05;00;Lauantai;0;0;0
95;13.05.2017;2017;05;01;Lauantai;0;0;0
95;13.05.2017;2017;05;02;Lauantai;0;1;1
95;13.05.2017;2017;05;03;Lauantai;0;0;0
95;13.05.2017;2017;05;04;Lauantai;1;1;2
95;13.05.2017;2017;05;05;Lauantai;1;5;6
95;13.05.2017;2017;05;06;Lauantai;1;0;1
95;13.05.2017;2017;05;07;Lauantai;1;2;3
95;13.05.2017;2017;05;08;Lauantai;4;2;6
95;13.05.2017;2017;05;09;Lauantai;5;13;18
95;13.05.2017;2017;05;10;Lauantai;8;9;17
95;13.05.2017;2017;05;11;Lauantai;9;11;20
95;13.05.2017;2017;05;12;Lauantai;13;15;28
95;13.05.2017;2017;05;13;Lauantai;17;6;23
95;13.05.2017;2017;05;14;Lauantai;25;7;32
95;13.05.2017;2017;05;15;Lauantai;5;6;11
95;13.05.2017;2017;05;16;Lauantai;11;5;16
95;13.05.2017;2017;05;17;Lauantai;7;16;23
95;13.05.2017;2017;05;18;Lauantai;13;11;24
95;13.05.2017;2017;05;19;Lauantai;14;4;18
95;13.05.2017;2017;05;20;Lauantai;4;9;13
95;13.05.2017;2017;05;21;Lauantai;5;6;11
95;13.05.2017;2017;05;22;Lauantai;0;4;4
95;13.05.2017;2017;05;23;Lauantai;2;1;3
95;14.05.2017;2017;05;00;Sunnuntai;0;2;2
95;14.05.2017;2017;05;01;Sunnuntai;0;0;0
95;14.05.2017;2017;05;02;Sunnuntai;0;0;0
95;14.05.2017;2017;05;03;Sunnuntai;0;0;0
95;14.05.2017;2017;05;04;Sunnuntai;0;0;0
95;14.05.2017;2017;05;05;Sunnuntai;0;0;0
95;14.05.2017;2017;05;06;Sunnuntai;3;1;4
95;14.05.2017;2017;05;07;Sunnuntai;2;5;7
95;14.05.2017;2017;05;08;Sunnuntai;2;1;3
95;14.05.2017;2017;05;09;Sunnuntai;2;0;2
95;14.05.2017;2017;05;10;Sunnuntai;0;21;21
95;14.05.2017;2017;05;11;Sunnuntai;3;6;9
95;14.05.2017;2017;05;12;Sunnuntai;13;2;15
95;14.05.2017;2017;05;13;Sunnuntai;0;4;4
95;14.05.2017;2017;05;14;Sunnuntai;3;0;3
95;14.05.2017;2017;05;15;Sunnuntai;0;0;0
95;14.05.2017;2017;05;16;Sunnuntai;2;2;4
95;14.05.2017;2017;05;17;Sunnuntai;2;1;3
95;14.05.2017;2017;05;18;Sunnuntai;1;3;4
95;14.05.2017;2017;05;19;Sunnuntai;4;0;4
95;14.05.2017;2017;05;20;Sunnuntai;4;1;5
95;14.05.2017;2017;05;21;Sunnuntai;2;1;3
95;14.05.2017;2017;05;22;Sunnuntai;0;0;0
95;14.05.2017;2017;05;23;Sunnuntai;0;0;0
95;15.05.2017;2017;05;00;Maanantai;0;0;0
95;15.05.2017;2017;05;01;Maanantai;0;1;1
95;15.05.2017;2017;05;02;Maanantai;0;0;0
95;15.05.2017;2017;05;03;Maanantai;0;0;0
95;15.05.2017;2017;05;04;Maanantai;0;0;0
95;15.05.2017;2017;05;05;Maanantai;8;7;15
95;15.05.2017;2017;05;06;Maanantai;15;9;24
95;15.05.2017;2017;05;07;Maanantai;15;15;30
95;15.05.2017;2017;05;08;Maanantai;11;9;20
95;15.05.2017;2017;05;09;Maanantai;7;16;23
95;15.05.2017;2017;05;10;Maanantai;8;3;11
95;15.05.2017;2017;05;11;Maanantai;8;1;9
95;15.05.2017;2017;05;12;Maanantai;11;5;16
95;15.05.2017;2017;05;13;Maanantai;12;9;21
95;15.05.2017;2017;05;14;Maanantai;11;15;26
95;15.05.2017;2017;05;15;Maanantai;30;22;52
95;15.05.2017;2017;05;16;Maanantai;18;27;45
95;15.05.2017;2017;05;17;Maanantai;21;29;50
95;15.05.2017;2017;05;18;Maanantai;13;18;31
95;15.05.2017;2017;05;19;Maanantai;16;20;36
95;15.05.2017;2017;05;20;Maanantai;13;15;28
95;15.05.2017;2017;05;21;Maanantai;1;9;10
95;15.05.2017;2017;05;22;Maanantai;3;1;4
95;15.05.2017;2017;05;23;Maanantai;0;1;1
95;16.05.2017;2017;05;00;Tiistai;0;0;0
95;16.05.2017;2017;05;01;Tiistai;0;0;0
95;16.05.2017;2017;05;02;Tiistai;0;0;0
95;16.05.2017;2017;05;03;Tiistai;0;0;0
95;16.05.2017;2017;05;04;Tiistai;1;0;1
95;16.05.2017;2017;05;05;Tiistai;8;4;12
95;16.05.2017;2017;05;06;Tiistai;22;14;36
95;16.05.2017;2017;05;07;Tiistai;27;26;53
95;16.05.2017;2017;05;08;Tiistai;12;8;20
95;16.05.2017;2017;05;09;Tiistai;11;10;21
95;16.05.2017;2017;05;10;Tiistai;15;5;20
95;16.05.2017;2017;05;11;Tiistai;13;11;24
95;16.05.2017;2017;05;12;Tiistai;19;17;36
95;16.05.2017;2017;05;13;Tiistai;9;13;22
95;16.05.2017;2017;05;14;Tiistai;19;14;33
95;16.05.2017;2017;05;15;Tiistai;30;29;59
95;16.05.2017;2017;05;16;Tiistai;19;29;48
95;16.05.2017;2017;05;17;Tiistai;23;28;51
95;16.05.2017;2017;05;18;Tiistai;21;26;47
95;16.05.2017;2017;05;19;Tiistai;16;16;32
95;16.05.2017;2017;05;20;Tiistai;10;14;24
95;16.05.2017;2017;05;21;Tiistai;3;5;8
95;16.05.2017;2017;05;22;Tiistai;3;3;6
95;16.05.2017;2017;05;23;Tiistai;0;0;0
95;17.05.2017;2017;05;00;Keskiviikko;0;0;0
95;17.05.2017;2017;05;01;Keskiviikko;0;0;0
95;17.05.2017;2017;05;02;Keskiviikko;0;0;0
95;17.05.2017;2017;05;03;Keskiviikko;0;0;0
95;17.05.2017;2017;05;04;Keskiviikko;1;0;1
95;17.05.2017;2017;05;05;Keskiviikko;8;7;15
95;17.05.2017;2017;05;06;Keskiviikko;10;8;18
95;17.05.2017;2017;05;07;Keskiviikko;14;14;28
95;17.05.2017;2017;05;08;Keskiviikko;7;3;10
95;17.05.2017;2017;05;09;Keskiviikko;5;2;7
95;17.05.2017;2017;05;10;Keskiviikko;1;2;3
95;17.05.2017;2017;05;11;Keskiviikko;2;1;3
95;17.05.2017;2017;05;12;Keskiviikko;3;0;3
95;17.05.2017;2017;05;13;Keskiviikko;6;5;11
95;17.05.2017;2017;05;14;Keskiviikko;12;4;16
95;17.05.2017;2017;05;15;Keskiviikko;7;17;24
95;17.05.2017;2017;05;16;Keskiviikko;7;11;18
95;17.05.2017;2017;05;17;Keskiviikko;9;8;17
95;17.05.2017;2017;05;18;Keskiviikko;7;11;18
95;17.05.2017;2017;05;19;Keskiviikko;7;3;10
95;17.05.2017;2017;05;20;Keskiviikko;2;2;4
95;17.05.2017;2017;05;21;Keskiviikko;5;2;7
95;17.05.2017;2017;05;22;Keskiviikko;0;0;0
95;17.05.2017;2017;05;23;Keskiviikko;0;1;1
95;18.05.2017;2017;05;00;Torstai;0;0;0
95;18.05.2017;2017;05;01;Torstai;0;0;0
95;18.05.2017;2017;05;02;Torstai;0;0;0
95;18.05.2017;2017;05;03;Torstai;0;0;0
95;18.05.2017;2017;05;04;Torstai;3;0;3
95;18.05.2017;2017;05;05;Torstai;9;3;12
95;18.05.2017;2017;05;06;Torstai;12;13;25
95;18.05.2017;2017;05;07;Torstai;20;10;30
95;18.05.2017;2017;05;08;Torstai;14;13;27
95;18.05.2017;2017;05;09;Torstai;10;9;19
95;18.05.2017;2017;05;10;Torstai;3;6;9
95;18.05.2017;2017;05;11;Torstai;11;3;14
95;18.05.2017;2017;05;12;Torstai;9;5;14
95;18.05.2017;2017;05;13;Torstai;6;4;10
95;18.05.2017;2017;05;14;Torstai;21;10;31
95;18.05.2017;2017;05;15;Torstai;20;34;54
95;18.05.2017;2017;05;16;Torstai;22;36;58
95;18.05.2017;2017;05;17;Torstai;13;17;30
95;18.05.2017;2017;05;18;Torstai;12;13;25
95;18.05.2017;2017;05;19;Torstai;16;11;27
95;18.05.2017;2017;05;20;Torstai;9;9;18
95;18.05.2017;2017;05;21;Torstai;2;7;9
95;18.05.2017;2017;05;22;Torstai;0;2;2
95;18.05.2017;2017;05;23;Torstai;1;0;1
95;19.05.2017;2017;05;00;Perjantai;0;0;0
95;19.05.2017;2017;05;01;Perjantai;0;1;1
95;19.05.2017;2017;05;02;Perjantai;0;0;0
95;19.05.2017;2017;05;03;Perjantai;1;0;1
95;19.05.2017;2017;05;04;Perjantai;1;0;1
95;19.05.2017;2017;05;05;Perjantai;5;3;8
95;19.05.2017;2017;05;06;Perjantai;3;4;7
95;19.05.2017;2017;05;07;Perjantai;3;5;8
95;19.05.2017;2017;05;08;Perjantai;6;5;11
95;19.05.2017;2017;05;09;Perjantai;6;1;7
95;19.05.2017;2017;05;10;Perjantai;1;2;3
95;19.05.2017;2017;05;11;Perjantai;2;3;5
95;19.05.2017;2017;05;12;Perjantai;2;4;6
95;19.05.2017;2017;05;13;Perjantai;10;3;13
95;19.05.2017;2017;05;14;Perjantai;10;12;22
95;19.05.2017;2017;05;15;Perjantai;6;16;22
95;19.05.2017;2017;05;16;Perjantai;5;8;13
95;19.05.2017;2017;05;17;Perjantai;6;6;12
95;19.05.2017;2017;05;18;Perjantai;5;7;12
95;19.05.2017;2017;05;19;Perjantai;12;7;19
95;19.05.2017;2017;05;20;Perjantai;2;7;9
95;19.05.2017;2017;05;21;Perjantai;6;2;8
95;19.05.2017;2017;05;22;Perjantai;1;5;6
95;19.05.2017;2017;05;23;Perjantai;2;4;6
95;20.05.2017;2017;05;00;Lauantai;0;0;0
95;20.05.2017;2017;05;01;Lauantai;0;0;0
95;20.05.2017;2017;05;02;Lauantai;0;1;1
95;20.05.2017;2017;05;03;Lauantai;1;1;2
95;20.05.2017;2017;05;04;Lauantai;0;0;0
95;20.05.2017;2017;05;05;Lauantai;2;1;3
95;20.05.2017;2017;05;06;Lauantai;1;3;4
95;20.05.2017;2017;05;07;Lauantai;7;0;7
95;20.05.2017;2017;05;08;Lauantai;6;6;12
95;20.05.2017;2017;05;09;Lauantai;10;15;25
95;20.05.2017;2017;05;10;Lauantai;25;12;37
95;20.05.2017;2017;05;11;Lauantai;12;17;29
95;20.05.2017;2017;05;12;Lauantai;16;19;35
95;20.05.2017;2017;05;13;Lauantai;25;16;41
95;20.05.2017;2017;05;14;Lauantai;23;17;40
95;20.05.2017;2017;05;15;Lauantai;12;20;32
95;20.05.2017;2017;05;16;Lauantai;15;13;28
95;20.05.2017;2017;05;17;Lauantai;22;7;29
95;20.05.2017;2017;05;18;Lauantai;18;18;36
95;20.05.2017;2017;05;19;Lauantai;6;11;17
95;20.05.2017;2017;05;20;Lauantai;4;3;7
95;20.05.2017;2017;05;21;Lauantai;0;4;4
95;20.05.2017;2017;05;22;Lauantai;5;4;9
95;20.05.2017;2017;05;23;Lauantai;2;0;2
95;21.05.2017;2017;05;00;Sunnuntai;0;1;1
95;21.05.2017;2017;05;01;Sunnuntai;0;0;0
95;21.05.2017;2017;05;02;Sunnuntai;0;1;1
95;21.05.2017;2017;05;03;Sunnuntai;0;2;2
95;21.05.2017;2017;05;04;Sunnuntai;0;0;0
95;21.05.2017;2017;05;05;Sunnuntai;2;0;2
95;21.05.2017;2017;05;06;Sunnuntai;3;1;4
95;21.05.2017;2017;05;07;Sunnuntai;4;5;9
95;21.05.2017;2017;05;08;Sunnuntai;10;6;16
95;21.05.2017;2017;05;09;Sunnuntai;5;4;9
95;21.05.2017;2017;05;10;Sunnuntai;13;22;35
95;21.05.2017;2017;05;11;Sunnuntai;16;19;35
95;21.05.2017;2017;05;12;Sunnuntai;35;25;60
95;21.05.2017;2017;05;13;Sunnuntai;19;17;36
95;21.05.2017;2017;05;14;Sunnuntai;29;25;54
95;21.05.2017;2017;05;15;Sunnuntai;26;19;45
95;21.05.2017;2017;05;16;Sunnuntai;20;27;47
95;21.05.2017;2017;05;17;Sunnuntai;18;17;35
95;21.05.2017;2017;05;18;Sunnuntai;12;6;18
95;21.05.2017;2017;05;19;Sunnuntai;11;16;27
95;21.05.2017;2017;05;20;Sunnuntai;13;13;26
95;21.05.2017;2017;05;21;Sunnuntai;4;6;10
95;21.05.2017;2017;05;22;Sunnuntai;1;1;2
95;21.05.2017;2017;05;23;Sunnuntai;0;2;2
95;22.05.2017;2017;05;00;Maanantai;0;0;0
95;22.05.2017;2017;05;01;Maanantai;1;0;1
95;22.05.2017;2017;05;02;Maanantai;0;0;0
95;22.05.2017;2017;05;03;Maanantai;0;0;0
95;22.05.2017;2017;05;04;Maanantai;2;0;2
95;22.05.2017;2017;05;05;Maanantai;9;3;12
95;22.05.2017;2017;05;06;Maanantai;22;12;34
95;22.05.2017;2017;05;07;Maanantai;26;21;47
95;22.05.2017;2017;05;08;Maanantai;10;14;24
95;22.05.2017;2017;05;09;Maanantai;13;21;34
95;22.05.2017;2017;05;10;Maanantai;10;8;18
95;22.05.2017;2017;05;11;Maanantai;9;13;22
95;22.05.2017;2017;05;12;Maanantai;20;12;32
95;22.05.2017;2017;05;13;Maanantai;28;19;47
95;22.05.2017;2017;05;14;Maanantai;19;15;34
95;22.05.2017;2017;05;15;Maanantai;21;31;52
95;22.05.2017;2017;05;16;Maanantai;29;34;63
95;22.05.2017;2017;05;17;Maanantai;23;30;53
95;22.05.2017;2017;05;18;Maanantai;20;30;50
95;22.05.2017;2017;05;19;Maanantai;17;20;37
95;22.05.2017;2017;05;20;Maanantai;17;22;39
95;22.05.2017;2017;05;21;Maanantai;8;11;19
95;22.05.2017;2017;05;22;Maanantai;5;8;13
95;22.05.2017;2017;05;23;Maanantai;1;1;2
95;23.05.2017;2017;05;00;Tiistai;1;0;1
95;23.05.2017;2017;05;01;Tiistai;0;1;1
95;23.05.2017;2017;05;02;Tiistai;0;0;0
95;23.05.2017;2017;05;03;Tiistai;0;1;1
95;23.05.2017;2017;05;04;Tiistai;3;0;3
95;23.05.2017;2017;05;05;Tiistai;9;6;15
95;23.05.2017;2017;05;06;Tiistai;29;12;41
95;23.05.2017;2017;05;07;Tiistai;24;31;55
95;23.05.2017;2017;05;08;Tiistai;16;12;28
95;23.05.2017;2017;05;09;Tiistai;10;6;16
95;23.05.2017;2017;05;10;Tiistai;12;9;21
95;23.05.2017;2017;05;11;Tiistai;11;5;16
95;23.05.2017;2017;05;12;Tiistai;18;7;25
95;23.05.2017;2017;05;13;Tiistai;7;14;21
95;23.05.2017;2017;05;14;Tiistai;18;15;33
95;23.05.2017;2017;05;15;Tiistai;26;32;58
95;23.05.2017;2017;05;16;Tiistai;36;48;84
95;23.05.2017;2017;05;17;Tiistai;13;35;48
95;23.05.2017;2017;05;18;Tiistai;23;20;43
95;23.05.2017;2017;05;19;Tiistai;18;21;39
95;23.05.2017;2017;05;20;Tiistai;16;8;24
95;23.05.2017;2017;05;21;Tiistai;5;8;13
95;23.05.2017;2017;05;22;Tiistai;7;3;10
95;23.05.2017;2017;05;23;Tiistai;4;1;5
95;24.05.2017;2017;05;00;Keskiviikko;0;0;0
95;24.05.2017;2017;05;01;Keskiviikko;0;1;1
95;24.05.2017;2017;05;02;Keskiviikko;0;0;0
95;24.05.2017;2017;05;03;Keskiviikko;2;0;2
95;24.05.2017;2017;05;04;Keskiviikko;2;0;2
95;24.05.2017;2017;05;05;Keskiviikko;6;2;8
95;24.05.2017;2017;05;06;Keskiviikko;23;13;36
95;24.05.2017;2017;05;07;Keskiviikko;16;21;37
95;24.05.2017;2017;05;08;Keskiviikko;13;11;24
95;24.05.2017;2017;05;09;Keskiviikko;16;6;22
95;24.05.2017;2017;05;10;Keskiviikko;12;8;20
95;24.05.2017;2017;05;11;Keskiviikko;11;14;25
95;24.05.2017;2017;05;12;Keskiviikko;11;11;22
95;24.05.2017;2017;05;13;Keskiviikko;11;14;25
95;24.05.2017;2017;05;14;Keskiviikko;21;28;49
95;24.05.2017;2017;05;15;Keskiviikko;23;27;50
95;24.05.2017;2017;05;16;Keskiviikko;37;30;67
95;24.05.2017;2017;05;17;Keskiviikko;16;21;37
95;24.05.2017;2017;05;18;Keskiviikko;21;30;51
95;24.05.2017;2017;05;19;Keskiviikko;15;19;34
95;24.05.2017;2017;05;20;Keskiviikko;10;21;31
95;24.05.2017;2017;05;21;Keskiviikko;6;7;13
95;24.05.2017;2017;05;22;Keskiviikko;8;6;14
95;24.05.2017;2017;05;23;Keskiviikko;1;3;4
95;25.05.2017;2017;05;00;Torstai;0;0;0
95;25.05.2017;2017;05;01;Torstai;0;0;0
95;25.05.2017;2017;05;02;Torstai;0;0;0
95;25.05.2017;2017;05;03;Torstai;0;2;2
95;25.05.2017;2017;05;04;Torstai;0;0;0
95;25.05.2017;2017;05;05;Torstai;1;1;2
95;25.05.2017;2017;05;06;Torstai;5;2;7
95;25.05.2017;2017;05;07;Torstai;5;6;11
95;25.05.2017;2017;05;08;Torstai;3;6;9
95;25.05.2017;2017;05;09;Torstai;9;12;21
95;25.05.2017;2017;05;10;Torstai;15;18;33
95;25.05.2017;2017;05;11;Torstai;12;18;30
95;25.05.2017;2017;05;12;Torstai;19;7;26
95;25.05.2017;2017;05;13;Torstai;16;14;30
95;25.05.2017;2017;05;14;Torstai;9;12;21
95;25.05.2017;2017;05;15;Torstai;11;18;29
95;25.05.2017;2017;05;16;Torstai;24;9;33
95;25.05.2017;2017;05;17;Torstai;14;15;29
95;25.05.2017;2017;05;18;Torstai;15;25;40
95;25.05.2017;2017;05;19;Torstai;22;18;40
95;25.05.2017;2017;05;20;Torstai;4;18;22
95;25.05.2017;2017;05;21;Torstai;9;8;17
95;25.05.2017;2017;05;22;Torstai;4;2;6
95;25.05.2017;2017;05;23;Torstai;0;2;2
95;26.05.2017;2017;05;00;Perjantai;0;0;0
95;26.05.2017;2017;05;01;Perjantai;0;0;0
95;26.05.2017;2017;05;02;Perjantai;0;1;1
95;26.05.2017;2017;05;03;Perjantai;1;0;1
95;26.05.2017;2017;05;04;Perjantai;2;0;2
95;26.05.2017;2017;05;05;Perjantai;5;4;9
95;26.05.2017;2017;05;06;Perjantai;7;6;13
95;26.05.2017;2017;05;07;Perjantai;17;23;40
95;26.05.2017;2017;05;08;Perjantai;15;7;22
95;26.05.2017;2017;05;09;Perjantai;14;6;20
95;26.05.2017;2017;05;10;Perjantai;8;4;12
95;26.05.2017;2017;05;11;Perjantai;3;7;10
95;26.05.2017;2017;05;12;Perjantai;16;7;23
95;26.05.2017;2017;05;13;Perjantai;8;7;15
95;26.05.2017;2017;05;14;Perjantai;7;15;22
95;26.05.2017;2017;05;15;Perjantai;19;19;38
95;26.05.2017;2017;05;16;Perjantai;19;22;41
95;26.05.2017;2017;05;17;Perjantai;7;12;19
95;26.05.2017;2017;05;18;Perjantai;9;18;27
95;26.05.2017;2017;05;19;Perjantai;9;12;21
95;26.05.2017;2017;05;20;Perjantai;9;12;21
95;26.05.2017;2017;05;21;Perjantai;5;9;14
95;26.05.2017;2017;05;22;Perjantai;6;2;8
95;26.05.2017;2017;05;23;Perjantai;0;0;0
95;27.05.2017;2017;05;00;Lauantai;0;2;2
95;27.05.2017;2017;05;01;Lauantai;0;1;1
95;27.05.2017;2017;05;02;Lauantai;0;0;0
95;27.05.2017;2017;05;03;Lauantai;0;1;1
95;27.05.2017;2017;05;04;Lauantai;1;0;1
95;27.05.2017;2017;05;05;Lauantai;1;1;2
95;27.05.2017;2017;05;06;Lauantai;3;0;3
95;27.05.2017;2017;05;07;Lauantai;5;2;7
95;27.05.2017;2017;05;08;Lauantai;1;2;3
95;27.05.2017;2017;05;09;Lauantai;6;2;8
95;27.05.2017;2017;05;10;Lauantai;10;12;22
95;27.05.2017;2017;05;11;Lauantai;10;11;21
95;27.05.2017;2017;05;12;Lauantai;16;11;27
95;27.05.2017;2017;05;13;Lauantai;8;9;17
95;27.05.2017;2017;05;14;Lauantai;6;5;11
95;27.05.2017;2017;05;15;Lauantai;13;10;23
95;27.05.2017;2017;05;16;Lauantai;5;12;17
95;27.05.2017;2017;05;17;Lauantai;7;13;20
95;27.05.2017;2017;05;18;Lauantai;6;6;12
95;27.05.2017;2017;05;19;Lauantai;9;7;16
95;27.05.2017;2017;05;20;Lauantai;4;2;6
95;27.05.2017;2017;05;21;Lauantai;1;2;3
95;27.05.2017;2017;05;22;Lauantai;3;3;6
95;27.05.2017;2017;05;23;Lauantai;1;3;4
95;28.05.2017;2017;05;00;Sunnuntai;0;0;0
95;28.05.2017;2017;05;01;Sunnuntai;0;1;1
95;28.05.2017;2017;05;02;Sunnuntai;0;0;0
95;28.05.2017;2017;05;03;Sunnuntai;0;0;0
95;28.05.2017;2017;05;04;Sunnuntai;1;1;2
95;28.05.2017;2017;05;05;Sunnuntai;0;0;0
95;28.05.2017;2017;05;06;Sunnuntai;1;0;1
95;28.05.2017;2017;05;07;Sunnuntai;0;0;0
95;28.05.2017;2017;05;08;Sunnuntai;6;3;9
95;28.05.2017;2017;05;09;Sunnuntai;8;2;10
95;28.05.2017;2017;05;10;Sunnuntai;2;5;7
95;28.05.2017;2017;05;11;Sunnuntai;4;1;5
95;28.05.2017;2017;05;12;Sunnuntai;0;0;0
95;28.05.2017;2017;05;13;Sunnuntai;5;0;5
95;28.05.2017;2017;05;14;Sunnuntai;4;2;6
95;28.05.2017;2017;05;15;Sunnuntai;7;4;11
95;28.05.2017;2017;05;16;Sunnuntai;2;5;7
95;28.05.2017;2017;05;17;Sunnuntai;5;4;9
95;28.05.2017;2017;05;18;Sunnuntai;4;4;8
95;28.05.2017;2017;05;19;Sunnuntai;9;5;14
95;28.05.2017;2017;05;20;Sunnuntai;4;4;8
95;28.05.2017;2017;05;21;Sunnuntai;2;1;3
95;28.05.2017;2017;05;22;Sunnuntai;2;1;3
95;28.05.2017;2017;05;23;Sunnuntai;0;0;0
95;29.05.2017;2017;05;00;Maanantai;0;0;0
95;29.05.2017;2017;05;01;Maanantai;0;1;1
95;29.05.2017;2017;05;02;Maanantai;0;0;0
95;29.05.2017;2017;05;03;Maanantai;0;0;0
95;29.05.2017;2017;05;04;Maanantai;1;0;1
95;29.05.2017;2017;05;05;Maanantai;4;4;8
95;29.05.2017;2017;05;06;Maanantai;24;17;41
95;29.05.2017;2017;05;07;Maanantai;19;22;41
95;29.05.2017;2017;05;08;Maanantai;10;9;19
95;29.05.2017;2017;05;09;Maanantai;7;11;18
95;29.05.2017;2017;05;10;Maanantai;9;5;14
95;29.05.2017;2017;05;11;Maanantai;15;8;23
95;29.05.2017;2017;05;12;Maanantai;14;9;23
95;29.05.2017;2017;05;13;Maanantai;15;14;29
95;29.05.2017;2017;05;14;Maanantai;13;11;24
95;29.05.2017;2017;05;15;Maanantai;25;23;48
95;29.05.2017;2017;05;16;Maanantai;19;23;42
95;29.05.2017;2017;05;17;Maanantai;17;35;52
95;29.05.2017;2017;05;18;Maanantai;14;24;38
95;29.05.2017;2017;05;19;Maanantai;17;19;36
95;29.05.2017;2017;05;20;Maanantai;8;10;18
95;29.05.2017;2017;05;21;Maanantai;4;7;11
95;29.05.2017;2017;05;22;Maanantai;5;4;9
95;29.05.2017;2017;05;23;Maanantai;0;1;1
95;30.05.2017;2017;05;00;Tiistai;0;1;1
95;30.05.2017;2017;05;01;Tiistai;2;0;2
95;30.05.2017;2017;05;02;Tiistai;0;0;0
95;30.05.2017;2017;05;03;Tiistai;0;0;0
95;30.05.2017;2017;05;04;Tiistai;3;0;3
95;30.05.2017;2017;05;05;Tiistai;6;7;13
95;30.05.2017;2017;05;06;Tiistai;27;11;38
95;30.05.2017;2017;05;07;Tiistai;26;26;52
95;30.05.2017;2017;05;08;Tiistai;13;11;24
95;30.05.2017;2017;05;09;Tiistai;9;11;20
95;30.05.2017;2017;05;10;Tiistai;13;9;22
95;30.05.2017;2017;05;11;Tiistai;11;9;20
95;30.05.2017;2017;05;12;Tiistai;13;8;21
95;30.05.2017;2017;05;13;Tiistai;5;12;17
95;30.05.2017;2017;05;14;Tiistai;12;19;31
95;30.05.2017;2017;05;15;Tiistai;19;27;46
95;30.05.2017;2017;05;16;Tiistai;31;38;69
95;30.05.2017;2017;05;17;Tiistai;17;20;37
95;30.05.2017;2017;05;18;Tiistai;21;10;31
95;30.05.2017;2017;05;19;Tiistai;14;27;41
95;30.05.2017;2017;05;20;Tiistai;10;10;20
95;30.05.2017;2017;05;21;Tiistai;5;16;21
95;30.05.2017;2017;05;22;Tiistai;3;3;6
95;30.05.2017;2017;05;23;Tiistai;2;2;4
95;31.05.2017;2017;05;00;Keskiviikko;0;1;1
95;31.05.2017;2017;05;01;Keskiviikko;1;0;1
95;31.05.2017;2017;05;02;Keskiviikko;0;0;0
95;31.05.2017;2017;05;03;Keskiviikko;0;0;0
95;31.05.2017;2017;05;04;Keskiviikko;0;0;0
95;31.05.2017;2017;05;05;Keskiviikko;8;5;13
95;31.05.2017;2017;05;06;Keskiviikko;14;12;26
95;31.05.2017;2017;05;07;Keskiviikko;25;20;45
95;31.05.2017;2017;05;08;Keskiviikko;10;5;15
95;31.05.2017;2017;05;09;Keskiviikko;4;4;8
95;31.05.2017;2017;05;10;Keskiviikko;4;3;7
95;31.05.2017;2017;05;11;Keskiviikko;4;3;7
95;31.05.2017;2017;05;12;Keskiviikko;5;4;9
95;31.05.2017;2017;05;13;Keskiviikko;4;7;11
95;31.05.2017;2017;05;14;Keskiviikko;16;7;23
95;31.05.2017;2017;05;15;Keskiviikko;17;12;29
95;31.05.2017;2017;05;16;Keskiviikko;24;34;58
95;31.05.2017;2017;05;17;Keskiviikko;9;16;25
95;31.05.2017;2017;05;18;Keskiviikko;10;9;19
95;31.05.2017;2017;05;19;Keskiviikko;6;8;14
95;31.05.2017;2017;05;20;Keskiviikko;8;12;20
95;31.05.2017;2017;05;21;Keskiviikko;3;4;7
95;31.05.2017;2017;05;22;Keskiviikko;4;4;8
95;31.05.2017;2017;05;23;Keskiviikko;0;0;0
95;01.06.2017;2017;06;00;Torstai;0;0;0
95;01.06.2017;2017;06;01;Torstai;0;0;0
95;01.06.2017;2017;06;02;Torstai;0;3;3
95;01.06.2017;2017;06;03;Torstai;0;0;0
95;01.06.2017;2017;06;04;Torstai;5;0;5
95;01.06.2017;2017;06;05;Torstai;6;5;11
95;01.06.2017;2017;06;06;Torstai;16;11;27
95;01.06.2017;2017;06;07;Torstai;32;24;56
95;01.06.2017;2017;06;08;Torstai;11;10;21
95;01.06.2017;2017;06;09;Torstai;8;6;14
95;01.06.2017;2017;06;10;Torstai;6;4;10
95;01.06.2017;2017;06;11;Torstai;5;9;14
95;01.06.2017;2017;06;12;Torstai;1;4;5
95;01.06.2017;2017;06;13;Torstai;6;9;15
95;01.06.2017;2017;06;14;Torstai;6;6;12
95;01.06.2017;2017;06;15;Torstai;15;17;32
95;01.06.2017;2017;06;16;Torstai;17;26;43
95;01.06.2017;2017;06;17;Torstai;3;15;18
95;01.06.2017;2017;06;18;Torstai;6;6;12
95;01.06.2017;2017;06;19;Torstai;3;9;12
95;01.06.2017;2017;06;20;Torstai;5;4;9
95;01.06.2017;2017;06;21;Torstai;5;8;13
95;01.06.2017;2017;06;22;Torstai;0;0;0
95;01.06.2017;2017;06;23;Torstai;1;0;1
95;02.06.2017;2017;06;00;Perjantai;0;0;0
95;02.06.2017;2017;06;01;Perjantai;0;0;0
95;02.06.2017;2017;06;02;Perjantai;0;0;0
95;02.06.2017;2017;06;03;Perjantai;0;0;0
95;02.06.2017;2017;06;04;Perjantai;0;0;0
95;02.06.2017;2017;06;05;Perjantai;4;4;8
95;02.06.2017;2017;06;06;Perjantai;2;5;7
95;02.06.2017;2017;06;07;Perjantai;3;3;6
95;02.06.2017;2017;06;08;Perjantai;3;7;10
95;02.06.2017;2017;06;09;Perjantai;6;7;13
95;02.06.2017;2017;06;10;Perjantai;2;1;3
95;02.06.2017;2017;06;11;Perjantai;6;2;8
95;02.06.2017;2017;06;12;Perjantai;3;6;9
95;02.06.2017;2017;06;13;Perjantai;6;3;9
95;02.06.2017;2017;06;14;Perjantai;9;10;19
95;02.06.2017;2017;06;15;Perjantai;6;9;15
95;02.06.2017;2017;06;16;Perjantai;8;5;13
95;02.06.2017;2017;06;17;Perjantai;3;9;12
95;02.06.2017;2017;06;18;Perjantai;4;7;11
95;02.06.2017;2017;06;19;Perjantai;5;4;9
95;02.06.2017;2017;06;20;Perjantai;3;6;9
95;02.06.2017;2017;06;21;Perjantai;3;2;5
95;02.06.2017;2017;06;22;Perjantai;2;0;2
95;02.06.2017;2017;06;23;Perjantai;0;0;0
95;03.06.2017;2017;06;00;Lauantai;0;1;1
95;03.06.2017;2017;06;01;Lauantai;0;1;1
95;03.06.2017;2017;06;02;Lauantai;0;0;0
95;03.06.2017;2017;06;03;Lauantai;0;0;0
95;03.06.2017;2017;06;04;Lauantai;0;0;0
95;03.06.2017;2017;06;05;Lauantai;0;0;0
95;03.06.2017;2017;06;06;Lauantai;2;1;3
95;03.06.2017;2017;06;07;Lauantai;1;3;4
95;03.06.2017;2017;06;08;Lauantai;2;5;7
95;03.06.2017;2017;06;09;Lauantai;4;4;8
95;03.06.2017;2017;06;10;Lauantai;5;9;14
95;03.06.2017;2017;06;11;Lauantai;8;4;12
95;03.06.2017;2017;06;12;Lauantai;20;4;24
95;03.06.2017;2017;06;13;Lauantai;5;9;14
95;03.06.2017;2017;06;14;Lauantai;3;4;7
95;03.06.2017;2017;06;15;Lauantai;23;6;29
95;03.06.2017;2017;06;16;Lauantai;2;2;4
95;03.06.2017;2017;06;17;Lauantai;5;5;10
95;03.06.2017;2017;06;18;Lauantai;7;15;22
95;03.06.2017;2017;06;19;Lauantai;4;8;12
95;03.06.2017;2017;06;20;Lauantai;5;1;6
95;03.06.2017;2017;06;21;Lauantai;0;6;6
95;03.06.2017;2017;06;22;Lauantai;3;4;7
95;03.06.2017;2017;06;23;Lauantai;0;2;2
95;04.06.2017;2017;06;00;Sunnuntai;0;0;0
95;04.06.2017;2017;06;01;Sunnuntai;2;1;3
95;04.06.2017;2017;06;02;Sunnuntai;0;1;1
95;04.06.2017;2017;06;03;Sunnuntai;0;1;1
95;04.06.2017;2017;06;04;Sunnuntai;0;0;0
95;04.06.2017;2017;06;05;Sunnuntai;0;0;0
95;04.06.2017;2017;06;06;Sunnuntai;1;0;1
95;04.06.2017;2017;06;07;Sunnuntai;2;3;5
95;04.06.2017;2017;06;08;Sunnuntai;5;1;6
95;04.06.2017;2017;06;09;Sunnuntai;6;6;12
95;04.06.2017;2017;06;10;Sunnuntai;13;9;22
95;04.06.2017;2017;06;11;Sunnuntai;13;19;32
95;04.06.2017;2017;06;12;Sunnuntai;13;19;32
95;04.06.2017;2017;06;13;Sunnuntai;14;15;29
95;04.06.2017;2017;06;14;Sunnuntai;25;17;42
95;04.06.2017;2017;06;15;Sunnuntai;20;18;38
95;04.06.2017;2017;06;16;Sunnuntai;12;10;22
95;04.06.2017;2017;06;17;Sunnuntai;3;11;14
95;04.06.2017;2017;06;18;Sunnuntai;13;25;38
95;04.06.2017;2017;06;19;Sunnuntai;23;14;37
95;04.06.2017;2017;06;20;Sunnuntai;9;10;19
95;04.06.2017;2017;06;21;Sunnuntai;9;4;13
95;04.06.2017;2017;06;22;Sunnuntai;1;3;4
95;04.06.2017;2017;06;23;Sunnuntai;1;0;1
95;05.06.2017;2017;06;00;Maanantai;0;0;0
95;05.06.2017;2017;06;01;Maanantai;0;0;0
95;05.06.2017;2017;06;02;Maanantai;0;1;1
95;05.06.2017;2017;06;03;Maanantai;0;0;0
95;05.06.2017;2017;06;04;Maanantai;1;0;1
95;05.06.2017;2017;06;05;Maanantai;8;3;11
95;05.06.2017;2017;06;06;Maanantai;26;15;41
95;05.06.2017;2017;06;07;Maanantai;26;21;47
95;05.06.2017;2017;06;08;Maanantai;10;11;21
95;05.06.2017;2017;06;09;Maanantai;6;9;15
95;05.06.2017;2017;06;10;Maanantai;10;8;18
95;05.06.2017;2017;06;11;Maanantai;15;9;24
95;05.06.2017;2017;06;12;Maanantai;9;5;14
95;05.06.2017;2017;06;13;Maanantai;13;14;27
95;05.06.2017;2017;06;14;Maanantai;17;18;35
95;05.06.2017;2017;06;15;Maanantai;20;26;46
95;05.06.2017;2017;06;16;Maanantai;33;51;84
95;05.06.2017;2017;06;17;Maanantai;19;33;52
95;05.06.2017;2017;06;18;Maanantai;12;17;29
95;05.06.2017;2017;06;19;Maanantai;17;12;29
95;05.06.2017;2017;06;20;Maanantai;9;16;25
95;05.06.2017;2017;06;21;Maanantai;6;7;13
95;05.06.2017;2017;06;22;Maanantai;4;4;8
95;05.06.2017;2017;06;23;Maanantai;0;1;1
95;06.06.2017;2017;06;00;Tiistai;0;1;1
95;06.06.2017;2017;06;01;Tiistai;0;0;0
95;06.06.2017;2017;06;02;Tiistai;0;0;0
95;06.06.2017;2017;06;03;Tiistai;0;1;1
95;06.06.2017;2017;06;04;Tiistai;0;0;0
95;06.06.2017;2017;06;05;Tiistai;5;2;7
95;06.06.2017;2017;06;06;Tiistai;18;8;26
95;06.06.2017;2017;06;07;Tiistai;16;16;32
95;06.06.2017;2017;06;08;Tiistai;5;5;10
95;06.06.2017;2017;06;09;Tiistai;9;2;11
95;06.06.2017;2017;06;10;Tiistai;4;6;10
95;06.06.2017;2017;06;11;Tiistai;7;6;13
95;06.06.2017;2017;06;12;Tiistai;10;11;21
95;06.06.2017;2017;06;13;Tiistai;9;12;21
95;06.06.2017;2017;06;14;Tiistai;6;15;21
95;06.06.2017;2017;06;15;Tiistai;22;22;44
95;06.06.2017;2017;06;16;Tiistai;27;35;62
95;06.06.2017;2017;06;17;Tiistai;22;26;48
95;06.06.2017;2017;06;18;Tiistai;21;20;41
95;06.06.2017;2017;06;19;Tiistai;17;23;40
95;06.06.2017;2017;06;20;Tiistai;20;19;39
95;06.06.2017;2017;06;21;Tiistai;10;8;18
95;06.06.2017;2017;06;22;Tiistai;6;3;9
95;06.06.2017;2017;06;23;Tiistai;1;2;3
95;07.06.2017;2017;06;00;Keskiviikko;2;2;4
95;07.06.2017;2017;06;01;Keskiviikko;0;0;0
95;07.06.2017;2017;06;02;Keskiviikko;0;0;0
95;07.06.2017;2017;06;03;Keskiviikko;0;0;0
95;07.06.2017;2017;06;04;Keskiviikko;4;0;4
95;07.06.2017;2017;06;05;Keskiviikko;10;3;13
95;07.06.2017;2017;06;06;Keskiviikko;36;15;51
95;07.06.2017;2017;06;07;Keskiviikko;32;24;56
95;07.06.2017;2017;06;08;Keskiviikko;19;15;34
95;07.06.2017;2017;06;09;Keskiviikko;15;9;24
95;07.06.2017;2017;06;10;Keskiviikko;13;15;28
95;07.06.2017;2017;06;11;Keskiviikko;26;29;55
95;07.06.2017;2017;06;12;Keskiviikko;20;16;36
95;07.06.2017;2017;06;13;Keskiviikko;22;19;41
95;07.06.2017;2017;06;14;Keskiviikko;25;24;49
95;07.06.2017;2017;06;15;Keskiviikko;30;32;62
95;07.06.2017;2017;06;16;Keskiviikko;37;47;84
95;07.06.2017;2017;06;17;Keskiviikko;17;45;62
95;07.06.2017;2017;06;18;Keskiviikko;19;46;65
95;07.06.2017;2017;06;19;Keskiviikko;26;33;59
95;07.06.2017;2017;06;20;Keskiviikko;23;31;54
95;07.06.2017;2017;06;21;Keskiviikko;10;9;19
95;07.06.2017;2017;06;22;Keskiviikko;3;11;14
95;07.06.2017;2017;06;23;Keskiviikko;1;2;3
95;08.06.2017;2017;06;00;Torstai;1;0;1
95;08.06.2017;2017;06;01;Torstai;1;1;2
95;08.06.2017;2017;06;02;Torstai;0;0;0
95;08.06.2017;2017;06;03;Torstai;0;1;1
95;08.06.2017;2017;06;04;Torstai;1;2;3
95;08.06.2017;2017;06;05;Torstai;8;3;11
95;08.06.2017;2017;06;06;Torstai;36;9;45
95;08.06.2017;2017;06;07;Torstai;35;25;60
95;08.06.2017;2017;06;08;Torstai;16;9;25
95;08.06.2017;2017;06;09;Torstai;19;16;35
95;08.06.2017;2017;06;10;Torstai;22;14;36
95;08.06.2017;2017;06;11;Torstai;30;11;41
95;08.06.2017;2017;06;12;Torstai;16;26;42
95;08.06.2017;2017;06;13;Torstai;13;16;29
95;08.06.2017;2017;06;14;Torstai;20;30;50
95;08.06.2017;2017;06;15;Torstai;19;34;53
95;08.06.2017;2017;06;16;Torstai;36;44;80
95;08.06.2017;2017;06;17;Torstai;26;43;69
95;08.06.2017;2017;06;18;Torstai;18;16;34
95;08.06.2017;2017;06;19;Torstai;17;25;42
95;08.06.2017;2017;06;20;Torstai;21;17;38
95;08.06.2017;2017;06;21;Torstai;6;19;25
95;08.06.2017;2017;06;22;Torstai;6;8;14
95;08.06.2017;2017;06;23;Torstai;1;3;4
95;09.06.2017;2017;06;00;Perjantai;0;0;0
95;09.06.2017;2017;06;01;Perjantai;0;2;2
95;09.06.2017;2017;06;02;Perjantai;0;1;1
95;09.06.2017;2017;06;03;Perjantai;0;0;0
95;09.06.2017;2017;06;04;Perjantai;1;1;2
95;09.06.2017;2017;06;05;Perjantai;7;3;10
95;09.06.2017;2017;06;06;Perjantai;26;12;38
95;09.06.2017;2017;06;07;Perjantai;32;16;48
95;09.06.2017;2017;06;08;Perjantai;8;17;25
95;09.06.2017;2017;06;09;Perjantai;13;12;25
95;09.06.2017;2017;06;10;Perjantai;15;11;26
95;09.06.2017;2017;06;11;Perjantai;14;16;30
95;09.06.2017;2017;06;12;Perjantai;9;24;33
95;09.06.2017;2017;06;13;Perjantai;19;17;36
95;09.06.2017;2017;06;14;Perjantai;29;28;57
95;09.06.2017;2017;06;15;Perjantai;31;33;64
95;09.06.2017;2017;06;16;Perjantai;28;22;50
95;09.06.2017;2017;06;17;Perjantai;20;23;43
95;09.06.2017;2017;06;18;Perjantai;23;27;50
95;09.06.2017;2017;06;19;Perjantai;8;22;30
95;09.06.2017;2017;06;20;Perjantai;9;3;12
95;09.06.2017;2017;06;21;Perjantai;4;11;15
95;09.06.2017;2017;06;22;Perjantai;1;4;5
95;09.06.2017;2017;06;23;Perjantai;5;7;12
95;10.06.2017;2017;06;00;Lauantai;0;2;2
95;10.06.2017;2017;06;01;Lauantai;0;2;2
95;10.06.2017;2017;06;02;Lauantai;0;2;2
95;10.06.2017;2017;06;03;Lauantai;0;2;2
95;10.06.2017;2017;06;04;Lauantai;0;1;1
95;10.06.2017;2017;06;05;Lauantai;1;0;1
95;10.06.2017;2017;06;06;Lauantai;2;3;5
95;10.06.2017;2017;06;07;Lauantai;4;3;7
95;10.06.2017;2017;06;08;Lauantai;8;8;16
95;10.06.2017;2017;06;09;Lauantai;13;13;26
95;10.06.2017;2017;06;10;Lauantai;22;10;32
95;10.06.2017;2017;06;11;Lauantai;7;23;30
95;10.06.2017;2017;06;12;Lauantai;29;15;44
95;10.06.2017;2017;06;13;Lauantai;22;15;37
95;10.06.2017;2017;06;14;Lauantai;19;17;36
95;10.06.2017;2017;06;15;Lauantai;18;17;35
95;10.06.2017;2017;06;16;Lauantai;16;21;37
95;10.06.2017;2017;06;17;Lauantai;14;23;37
95;10.06.2017;2017;06;18;Lauantai;8;18;26
95;10.06.2017;2017;06;19;Lauantai;15;8;23
95;10.06.2017;2017;06;20;Lauantai;7;14;21
95;10.06.2017;2017;06;21;Lauantai;6;6;12
95;10.06.2017;2017;06;22;Lauantai;3;5;8
95;10.06.2017;2017;06;23;Lauantai;0;1;1
95;11.06.2017;2017;06;00;Sunnuntai;1;0;1
95;11.06.2017;2017;06;01;Sunnuntai;1;0;1
95;11.06.2017;2017;06;02;Sunnuntai;0;2;2
95;11.06.2017;2017;06;03;Sunnuntai;0;3;3
95;11.06.2017;2017;06;04;Sunnuntai;1;1;2
95;11.06.2017;2017;06;05;Sunnuntai;0;2;2
95;11.06.2017;2017;06;06;Sunnuntai;4;2;6
95;11.06.2017;2017;06;07;Sunnuntai;2;6;8
95;11.06.2017;2017;06;08;Sunnuntai;8;5;13
95;11.06.2017;2017;06;09;Sunnuntai;9;14;23
95;11.06.2017;2017;06;10;Sunnuntai;24;22;46
95;11.06.2017;2017;06;11;Sunnuntai;36;24;60
95;11.06.2017;2017;06;12;Sunnuntai;27;23;50
95;11.06.2017;2017;06;13;Sunnuntai;33;34;67
95;11.06.2017;2017;06;14;Sunnuntai;18;22;40
95;11.06.2017;2017;06;15;Sunnuntai;26;20;46
95;11.06.2017;2017;06;16;Sunnuntai;21;21;42
95;11.06.2017;2017;06;17;Sunnuntai;20;19;39
95;11.06.2017;2017;06;18;Sunnuntai;14;12;26
95;11.06.2017;2017;06;19;Sunnuntai;18;17;35
95;11.06.2017;2017;06;20;Sunnuntai;9;13;22
95;11.06.2017;2017;06;21;Sunnuntai;9;6;15
95;11.06.2017;2017;06;22;Sunnuntai;1;7;8
95;11.06.2017;2017;06;23;Sunnuntai;1;3;4
95;12.06.2017;2017;06;00;Maanantai;0;0;0
95;12.06.2017;2017;06;01;Maanantai;0;0;0
95;12.06.2017;2017;06;02;Maanantai;1;0;1
95;12.06.2017;2017;06;03;Maanantai;1;1;2
95;12.06.2017;2017;06;04;Maanantai;2;1;3
95;12.06.2017;2017;06;05;Maanantai;7;6;13
95;12.06.2017;2017;06;06;Maanantai;15;10;25
95;12.06.2017;2017;06;07;Maanantai;12;20;32
95;12.06.2017;2017;06;08;Maanantai;2;5;7
95;12.06.2017;2017;06;09;Maanantai;2;0;2
95;12.06.2017;2017;06;10;Maanantai;4;1;5
95;12.06.2017;2017;06;11;Maanantai;3;1;4
95;12.06.2017;2017;06;12;Maanantai;8;6;14
95;12.06.2017;2017;06;13;Maanantai;6;11;17
95;12.06.2017;2017;06;14;Maanantai;7;6;13
95;12.06.2017;2017;06;15;Maanantai;23;19;42
95;12.06.2017;2017;06;16;Maanantai;26;33;59
95;12.06.2017;2017;06;17;Maanantai;15;14;29
95;12.06.2017;2017;06;18;Maanantai;19;13;32
95;12.06.2017;2017;06;19;Maanantai;10;11;21
95;12.06.2017;2017;06;20;Maanantai;9;10;19
95;12.06.2017;2017;06;21;Maanantai;6;7;13
95;12.06.2017;2017;06;22;Maanantai;2;2;4
95;12.06.2017;2017;06;23;Maanantai;1;2;3
95;13.06.2017;2017;06;00;Tiistai;1;1;2
95;13.06.2017;2017;06;01;Tiistai;0;0;0
95;13.06.2017;2017;06;02;Tiistai;0;0;0
95;13.06.2017;2017;06;03;Tiistai;0;0;0
95;13.06.2017;2017;06;04;Tiistai;0;0;0
95;13.06.2017;2017;06;05;Tiistai;11;6;17
95;13.06.2017;2017;06;06;Tiistai;24;14;38
95;13.06.2017;2017;06;07;Tiistai;31;25;56
95;13.06.2017;2017;06;08;Tiistai;12;14;26
95;13.06.2017;2017;06;09;Tiistai;14;10;24
95;13.06.2017;2017;06;10;Tiistai;12;11;23
95;13.06.2017;2017;06;11;Tiistai;14;10;24
95;13.06.2017;2017;06;12;Tiistai;11;11;22
95;13.06.2017;2017;06;13;Tiistai;14;10;24
95;13.06.2017;2017;06;14;Tiistai;16;18;34
95;13.06.2017;2017;06;15;Tiistai;27;23;50
95;13.06.2017;2017;06;16;Tiistai;36;47;83
95;13.06.2017;2017;06;17;Tiistai;14;30;44
95;13.06.2017;2017;06;18;Tiistai;17;20;37
95;13.06.2017;2017;06;19;Tiistai;22;25;47
95;13.06.2017;2017;06;20;Tiistai;12;28;40
95;13.06.2017;2017;06;21;Tiistai;14;12;26
95;13.06.2017;2017;06;22;Tiistai;3;6;9
95;13.06.2017;2017;06;23;Tiistai;2;1;3
95;14.06.2017;2017;06;00;Keskiviikko;1;0;1
95;14.06.2017;2017;06;01;Keskiviikko;2;3;5
95;14.06.2017;2017;06;02;Keskiviikko;0;0;0
95;14.06.2017;2017;06;03;Keskiviikko;2;2;4
95;14.06.2017;2017;06;04;Keskiviikko;2;0;2
95;14.06.2017;2017;06;05;Keskiviikko;6;7;13
95;14.06.2017;2017;06;06;Keskiviikko;25;14;39
95;14.06.2017;2017;06;07;Keskiviikko;33;24;57
95;14.06.2017;2017;06;08;Keskiviikko;14;19;33
95;14.06.2017;2017;06;09;Keskiviikko;8;13;21
95;14.06.2017;2017;06;10;Keskiviikko;21;13;34
95;14.06.2017;2017;06;11;Keskiviikko;18;17;35
95;14.06.2017;2017;06;12;Keskiviikko;26;12;38
95;14.06.2017;2017;06;13;Keskiviikko;16;13;29
95;14.06.2017;2017;06;14;Keskiviikko;15;21;36
95;14.06.2017;2017;06;15;Keskiviikko;23;31;54
95;14.06.2017;2017;06;16;Keskiviikko;28;49;77
95;14.06.2017;2017;06;17;Keskiviikko;19;29;48
95;14.06.2017;2017;06;18;Keskiviikko;19;23;42
95;14.06.2017;2017;06;19;Keskiviikko;13;21;34
95;14.06.2017;2017;06;20;Keskiviikko;14;19;33
95;14.06.2017;2017;06;21;Keskiviikko;2;13;15
95;14.06.2017;2017;06;22;Keskiviikko;5;5;10
95;14.06.2017;2017;06;23;Keskiviikko;0;1;1
95;15.06.2017;2017;06;00;Torstai;4;1;5
95;15.06.2017;2017;06;01;Torstai;1;0;1
95;15.06.2017;2017;06;02;Torstai;1;0;1
95;15.06.2017;2017;06;03;Torstai;0;0;0
95;15.06.2017;2017;06;04;Torstai;0;0;0
95;15.06.2017;2017;06;05;Torstai;12;6;18
95;15.06.2017;2017;06;06;Torstai;21;15;36
95;15.06.2017;2017;06;07;Torstai;33;19;52
95;15.06.2017;2017;06;08;Torstai;21;10;31
95;15.06.2017;2017;06;09;Torstai;17;14;31
95;15.06.2017;2017;06;10;Torstai;13;9;22
95;15.06.2017;2017;06;11;Torstai;19;19;38
95;15.06.2017;2017;06;12;Torstai;26;11;37
95;15.06.2017;2017;06;13;Torstai;20;25;45
95;15.06.2017;2017;06;14;Torstai;37;26;63
95;15.06.2017;2017;06;15;Torstai;40;35;75
95;15.06.2017;2017;06;16;Torstai;33;50;83
95;15.06.2017;2017;06;17;Torstai;24;43;67
95;15.06.2017;2017;06;18;Torstai;27;30;57
95;15.06.2017;2017;06;19;Torstai;29;44;73
95;15.06.2017;2017;06;20;Torstai;19;28;47
95;15.06.2017;2017;06;21;Torstai;10;21;31
95;15.06.2017;2017;06;22;Torstai;5;9;14
95;15.06.2017;2017;06;23;Torstai;2;5;7
95;16.06.2017;2017;06;00;Perjantai;0;1;1
95;16.06.2017;2017;06;01;Perjantai;1;0;1
95;16.06.2017;2017;06;02;Perjantai;0;0;0
95;16.06.2017;2017;06;03;Perjantai;0;0;0
95;16.06.2017;2017;06;04;Perjantai;1;0;1
95;16.06.2017;2017;06;05;Perjantai;6;6;12
95;16.06.2017;2017;06;06;Perjantai;27;15;42
95;16.06.2017;2017;06;07;Perjantai;22;22;44
95;16.06.2017;2017;06;08;Perjantai;13;6;19
95;16.06.2017;2017;06;09;Perjantai;12;9;21
95;16.06.2017;2017;06;10;Perjantai;16;14;30
95;16.06.2017;2017;06;11;Perjantai;26;18;44
95;16.06.2017;2017;06;12;Perjantai;27;11;38
95;16.06.2017;2017;06;13;Perjantai;18;20;38
95;16.06.2017;2017;06;14;Perjantai;30;39;69
95;16.06.2017;2017;06;15;Perjantai;35;35;70
95;16.06.2017;2017;06;16;Perjantai;36;36;72
95;16.06.2017;2017;06;17;Perjantai;14;24;38
95;16.06.2017;2017;06;18;Perjantai;17;25;42
95;16.06.2017;2017;06;19;Perjantai;18;16;34
95;16.06.2017;2017;06;20;Perjantai;13;13;26
95;16.06.2017;2017;06;21;Perjantai;10;18;28
95;16.06.2017;2017;06;22;Perjantai;4;3;7
95;16.06.2017;2017;06;23;Perjantai;4;7;11
95;17.06.2017;2017;06;00;Lauantai;0;1;1
95;17.06.2017;2017;06;01;Lauantai;0;4;4
95;17.06.2017;2017;06;02;Lauantai;2;2;4
95;17.06.2017;2017;06;03;Lauantai;1;3;4
95;17.06.2017;2017;06;04;Lauantai;4;0;4
95;17.06.2017;2017;06;05;Lauantai;1;2;3
95;17.06.2017;2017;06;06;Lauantai;4;1;5
95;17.06.2017;2017;06;07;Lauantai;4;2;6
95;17.06.2017;2017;06;08;Lauantai;11;7;18
95;17.06.2017;2017;06;09;Lauantai;14;11;25
95;17.06.2017;2017;06;10;Lauantai;24;19;43
95;17.06.2017;2017;06;11;Lauantai;13;22;35
95;17.06.2017;2017;06;12;Lauantai;47;38;85
95;17.06.2017;2017;06;13;Lauantai;28;24;52
95;17.06.2017;2017;06;14;Lauantai;17;27;44
95;17.06.2017;2017;06;15;Lauantai;23;33;56
95;17.06.2017;2017;06;16;Lauantai;22;15;37
95;17.06.2017;2017;06;17;Lauantai;10;32;42
95;17.06.2017;2017;06;18;Lauantai;18;23;41
95;17.06.2017;2017;06;19;Lauantai;13;18;31
95;17.06.2017;2017;06;20;Lauantai;10;15;25
95;17.06.2017;2017;06;21;Lauantai;3;9;12
95;17.06.2017;2017;06;22;Lauantai;2;0;2
95;17.06.2017;2017;06;23;Lauantai;7;1;8
95;18.06.2017;2017;06;00;Sunnuntai;0;3;3
95;18.06.2017;2017;06;01;Sunnuntai;3;5;8
95;18.06.2017;2017;06;02;Sunnuntai;0;1;1
95;18.06.2017;2017;06;03;Sunnuntai;2;0;2
95;18.06.2017;2017;06;04;Sunnuntai;3;1;4
95;18.06.2017;2017;06;05;Sunnuntai;2;1;3
95;18.06.2017;2017;06;06;Sunnuntai;1;0;1
95;18.06.2017;2017;06;07;Sunnuntai;1;0;1
95;18.06.2017;2017;06;08;Sunnuntai;1;1;2
95;18.06.2017;2017;06;09;Sunnuntai;3;1;4
95;18.06.2017;2017;06;10;Sunnuntai;8;9;17
95;18.06.2017;2017;06;11;Sunnuntai;4;4;8
95;18.06.2017;2017;06;12;Sunnuntai;15;7;22
95;18.06.2017;2017;06;13;Sunnuntai;8;12;20
95;18.06.2017;2017;06;14;Sunnuntai;14;16;30
95;18.06.2017;2017;06;15;Sunnuntai;21;8;29
95;18.06.2017;2017;06;16;Sunnuntai;5;10;15
95;18.06.2017;2017;06;17;Sunnuntai;16;13;29
95;18.06.2017;2017;06;18;Sunnuntai;6;4;10
95;18.06.2017;2017;06;19;Sunnuntai;9;17;26
95;18.06.2017;2017;06;20;Sunnuntai;7;11;18
95;18.06.2017;2017;06;21;Sunnuntai;1;4;5
95;18.06.2017;2017;06;22;Sunnuntai;2;6;8
95;18.06.2017;2017;06;23;Sunnuntai;4;2;6
95;19.06.2017;2017;06;00;Maanantai;0;2;2
95;19.06.2017;2017;06;01;Maanantai;0;1;1
95;19.06.2017;2017;06;02;Maanantai;0;0;0
95;19.06.2017;2017;06;03;Maanantai;0;0;0
95;19.06.2017;2017;06;04;Maanantai;7;0;7
95;19.06.2017;2017;06;05;Maanantai;8;3;11
95;19.06.2017;2017;06;06;Maanantai;25;16;41
95;19.06.2017;2017;06;07;Maanantai;25;18;43
95;19.06.2017;2017;06;08;Maanantai;8;8;16
95;19.06.2017;2017;06;09;Maanantai;14;9;23
95;19.06.2017;2017;06;10;Maanantai;12;2;14
95;19.06.2017;2017;06;11;Maanantai;9;14;23
95;19.06.2017;2017;06;12;Maanantai;6;6;12
95;19.06.2017;2017;06;13;Maanantai;17;17;34
95;19.06.2017;2017;06;14;Maanantai;18;41;59
95;19.06.2017;2017;06;15;Maanantai;27;23;50
95;19.06.2017;2017;06;16;Maanantai;30;44;74
95;19.06.2017;2017;06;17;Maanantai;41;29;70
95;19.06.2017;2017;06;18;Maanantai;16;15;31
95;19.06.2017;2017;06;19;Maanantai;16;20;36
95;19.06.2017;2017;06;20;Maanantai;14;15;29
95;19.06.2017;2017;06;21;Maanantai;11;7;18
95;19.06.2017;2017;06;22;Maanantai;3;3;6
95;19.06.2017;2017;06;23;Maanantai;1;2;3
95;20.06.2017;2017;06;00;Tiistai;0;4;4
95;20.06.2017;2017;06;01;Tiistai;1;0;1
95;20.06.2017;2017;06;02;Tiistai;0;0;0
95;20.06.2017;2017;06;03;Tiistai;0;0;0
95;20.06.2017;2017;06;04;Tiistai;2;0;2
95;20.06.2017;2017;06;05;Tiistai;6;4;10
95;20.06.2017;2017;06;06;Tiistai;24;11;35
95;20.06.2017;2017;06;07;Tiistai;24;17;41
95;20.06.2017;2017;06;08;Tiistai;9;16;25
95;20.06.2017;2017;06;09;Tiistai;11;13;24
95;20.06.2017;2017;06;10;Tiistai;13;11;24
95;20.06.2017;2017;06;11;Tiistai;20;10;30
95;20.06.2017;2017;06;12;Tiistai;11;10;21
95;20.06.2017;2017;06;13;Tiistai;10;12;22
95;20.06.2017;2017;06;14;Tiistai;16;21;37
95;20.06.2017;2017;06;15;Tiistai;21;34;55
95;20.06.2017;2017;06;16;Tiistai;37;28;65
95;20.06.2017;2017;06;17;Tiistai;19;27;46
95;20.06.2017;2017;06;18;Tiistai;24;24;48
95;20.06.2017;2017;06;19;Tiistai;12;27;39
95;20.06.2017;2017;06;20;Tiistai;13;23;36
95;20.06.2017;2017;06;21;Tiistai;8;11;19
95;20.06.2017;2017;06;22;Tiistai;3;7;10
95;20.06.2017;2017;06;23;Tiistai;2;2;4
95;21.06.2017;2017;06;00;Keskiviikko;0;3;3
95;21.06.2017;2017;06;01;Keskiviikko;0;2;2
95;21.06.2017;2017;06;02;Keskiviikko;0;0;0
95;21.06.2017;2017;06;03;Keskiviikko;0;0;0
95;21.06.2017;2017;06;04;Keskiviikko;2;0;2
95;21.06.2017;2017;06;05;Keskiviikko;7;3;10
95;21.06.2017;2017;06;06;Keskiviikko;12;14;26
95;21.06.2017;2017;06;07;Keskiviikko;23;14;37
95;21.06.2017;2017;06;08;Keskiviikko;8;10;18
95;21.06.2017;2017;06;09;Keskiviikko;10;10;20
95;21.06.2017;2017;06;10;Keskiviikko;9;14;23
95;21.06.2017;2017;06;11;Keskiviikko;22;19;41
95;21.06.2017;2017;06;12;Keskiviikko;5;10;15
95;21.06.2017;2017;06;13;Keskiviikko;15;9;24
95;21.06.2017;2017;06;14;Keskiviikko;6;10;16
95;21.06.2017;2017;06;15;Keskiviikko;12;18;30
95;21.06.2017;2017;06;16;Keskiviikko;20;22;42
95;21.06.2017;2017;06;17;Keskiviikko;10;18;28
95;21.06.2017;2017;06;18;Keskiviikko;10;16;26
95;21.06.2017;2017;06;19;Keskiviikko;8;12;20
95;21.06.2017;2017;06;20;Keskiviikko;7;7;14
95;21.06.2017;2017;06;21;Keskiviikko;7;8;15
95;21.06.2017;2017;06;22;Keskiviikko;9;4;13
95;21.06.2017;2017;06;23;Keskiviikko;2;1;3
95;22.06.2017;2017;06;00;Torstai;1;0;1
95;22.06.2017;2017;06;01;Torstai;0;0;0
95;22.06.2017;2017;06;02;Torstai;0;1;1
95;22.06.2017;2017;06;03;Torstai;0;0;0
95;22.06.2017;2017;06;04;Torstai;2;0;2
95;22.06.2017;2017;06;05;Torstai;9;3;12
95;22.06.2017;2017;06;06;Torstai;17;7;24
95;22.06.2017;2017;06;07;Torstai;16;11;27
95;22.06.2017;2017;06;08;Torstai;7;8;15
95;22.06.2017;2017;06;09;Torstai;0;5;5
95;22.06.2017;2017;06;10;Torstai;3;4;7
95;22.06.2017;2017;06;11;Torstai;9;10;19
95;22.06.2017;2017;06;12;Torstai;11;9;20
95;22.06.2017;2017;06;13;Torstai;7;13;20
95;22.06.2017;2017;06;14;Torstai;6;16;22
95;22.06.2017;2017;06;15;Torstai;12;12;24
95;22.06.2017;2017;06;16;Torstai;10;19;29
95;22.06.2017;2017;06;17;Torstai;5;10;15
95;22.06.2017;2017;06;18;Torstai;18;12;30
95;22.06.2017;2017;06;19;Torstai;11;10;21
95;22.06.2017;2017;06;20;Torstai;4;12;16
95;22.06.2017;2017;06;21;Torstai;0;7;7
95;22.06.2017;2017;06;22;Torstai;3;2;5
95;22.06.2017;2017;06;23;Torstai;0;1;1
95;23.06.2017;2017;06;00;Perjantai;0;2;2
95;23.06.2017;2017;06;01;Perjantai;0;2;2
95;23.06.2017;2017;06;02;Perjantai;2;1;3
95;23.06.2017;2017;06;03;Perjantai;0;0;0
95;23.06.2017;2017;06;04;Perjantai;0;0;0
95;23.06.2017;2017;06;05;Perjantai;0;0;0
95;23.06.2017;2017;06;06;Perjantai;3;0;3
95;23.06.2017;2017;06;07;Perjantai;2;1;3
95;23.06.2017;2017;06;08;Perjantai;2;10;12
95;23.06.2017;2017;06;09;Perjantai;2;7;9
95;23.06.2017;2017;06;10;Perjantai;6;6;12
95;23.06.2017;2017;06;11;Perjantai;5;13;18
95;23.06.2017;2017;06;12;Perjantai;11;9;20
95;23.06.2017;2017;06;13;Perjantai;8;11;19
95;23.06.2017;2017;06;14;Perjantai;11;11;22
95;23.06.2017;2017;06;15;Perjantai;5;13;18
95;23.06.2017;2017;06;16;Perjantai;9;14;23
95;23.06.2017;2017;06;17;Perjantai;11;4;15
95;23.06.2017;2017;06;18;Perjantai;13;6;19
95;23.06.2017;2017;06;19;Perjantai;6;9;15
95;23.06.2017;2017;06;20;Perjantai;0;3;3
95;23.06.2017;2017;06;21;Perjantai;1;4;5
95;23.06.2017;2017;06;22;Perjantai;6;5;11
95;23.06.2017;2017;06;23;Perjantai;0;1;1
95;24.06.2017;2017;06;00;Lauantai;2;0;2
95;24.06.2017;2017;06;01;Lauantai;0;2;2
95;24.06.2017;2017;06;02;Lauantai;4;4;8
95;24.06.2017;2017;06;03;Lauantai;2;2;4
95;24.06.2017;2017;06;04;Lauantai;0;0;0
95;24.06.2017;2017;06;05;Lauantai;0;0;0
95;24.06.2017;2017;06;06;Lauantai;0;1;1
95;24.06.2017;2017;06;07;Lauantai;2;2;4
95;24.06.2017;2017;06;08;Lauantai;0;3;3
95;24.06.2017;2017;06;09;Lauantai;6;11;17
95;24.06.2017;2017;06;10;Lauantai;6;7;13
95;24.06.2017;2017;06;11;Lauantai;16;15;31
95;24.06.2017;2017;06;12;Lauantai;12;20;32
95;24.06.2017;2017;06;13;Lauantai;21;15;36
95;24.06.2017;2017;06;14;Lauantai;28;22;50
95;24.06.2017;2017;06;15;Lauantai;22;20;42
95;24.06.2017;2017;06;16;Lauantai;26;18;44
95;24.06.2017;2017;06;17;Lauantai;12;20;32
95;24.06.2017;2017;06;18;Lauantai;9;14;23
95;24.06.2017;2017;06;19;Lauantai;16;6;22
95;24.06.2017;2017;06;20;Lauantai;9;4;13
95;24.06.2017;2017;06;21;Lauantai;6;5;11
95;24.06.2017;2017;06;22;Lauantai;3;2;5
95;24.06.2017;2017;06;23;Lauantai;5;1;6
95;25.06.2017;2017;06;00;Sunnuntai;3;5;8
95;25.06.2017;2017;06;01;Sunnuntai;0;1;1
95;25.06.2017;2017;06;02;Sunnuntai;0;1;1
95;25.06.2017;2017;06;03;Sunnuntai;0;2;2
95;25.06.2017;2017;06;04;Sunnuntai;0;1;1
95;25.06.2017;2017;06;05;Sunnuntai;1;0;1
95;25.06.2017;2017;06;06;Sunnuntai;0;1;1
95;25.06.2017;2017;06;07;Sunnuntai;5;2;7
95;25.06.2017;2017;06;08;Sunnuntai;4;2;6
95;25.06.2017;2017;06;09;Sunnuntai;14;6;20
95;25.06.2017;2017;06;10;Sunnuntai;3;18;21
95;25.06.2017;2017;06;11;Sunnuntai;9;2;11
95;25.06.2017;2017;06;12;Sunnuntai;18;3;21
95;25.06.2017;2017;06;13;Sunnuntai;4;5;9
95;25.06.2017;2017;06;14;Sunnuntai;4;11;15
95;25.06.2017;2017;06;15;Sunnuntai;4;3;7
95;25.06.2017;2017;06;16;Sunnuntai;7;2;9
95;25.06.2017;2017;06;17;Sunnuntai;4;1;5
95;25.06.2017;2017;06;18;Sunnuntai;9;10;19
95;25.06.2017;2017;06;19;Sunnuntai;8;7;15
95;25.06.2017;2017;06;20;Sunnuntai;9;6;15
95;25.06.2017;2017;06;21;Sunnuntai;1;0;1
95;25.06.2017;2017;06;22;Sunnuntai;1;2;3
95;25.06.2017;2017;06;23;Sunnuntai;4;0;4
95;26.06.2017;2017;06;00;Maanantai;0;2;2
95;26.06.2017;2017;06;01;Maanantai;0;0;0
95;26.06.2017;2017;06;02;Maanantai;0;0;0
95;26.06.2017;2017;06;03;Maanantai;0;0;0
95;26.06.2017;2017;06;04;Maanantai;1;0;1
95;26.06.2017;2017;06;05;Maanantai;6;3;9
95;26.06.2017;2017;06;06;Maanantai;8;5;13
95;26.06.2017;2017;06;07;Maanantai;5;13;18
95;26.06.2017;2017;06;08;Maanantai;6;6;12
95;26.06.2017;2017;06;09;Maanantai;4;1;5
95;26.06.2017;2017;06;10;Maanantai;2;6;8
95;26.06.2017;2017;06;11;Maanantai;3;2;5
95;26.06.2017;2017;06;12;Maanantai;6;4;10
95;26.06.2017;2017;06;13;Maanantai;8;5;13
95;26.06.2017;2017;06;14;Maanantai;5;5;10
95;26.06.2017;2017;06;15;Maanantai;10;13;23
95;26.06.2017;2017;06;16;Maanantai;26;13;39
95;26.06.2017;2017;06;17;Maanantai;11;27;38
95;26.06.2017;2017;06;18;Maanantai;10;26;36
95;26.06.2017;2017;06;19;Maanantai;20;19;39
95;26.06.2017;2017;06;20;Maanantai;17;11;28
95;26.06.2017;2017;06;21;Maanantai;9;8;17
95;26.06.2017;2017;06;22;Maanantai;2;5;7
95;26.06.2017;2017;06;23;Maanantai;2;2;4
95;27.06.2017;2017;06;00;Tiistai;0;0;0
95;27.06.2017;2017;06;01;Tiistai;0;1;1
95;27.06.2017;2017;06;02;Tiistai;0;0;0
95;27.06.2017;2017;06;03;Tiistai;2;0;2
95;27.06.2017;2017;06;04;Tiistai;4;0;4
95;27.06.2017;2017;06;05;Tiistai;9;6;15
95;27.06.2017;2017;06;06;Tiistai;22;13;35
95;27.06.2017;2017;06;07;Tiistai;20;19;39
95;27.06.2017;2017;06;08;Tiistai;10;10;20
95;27.06.2017;2017;06;09;Tiistai;14;8;22
95;27.06.2017;2017;06;10;Tiistai;12;16;28
95;27.06.2017;2017;06;11;Tiistai;10;8;18
95;27.06.2017;2017;06;12;Tiistai;9;18;27
95;27.06.2017;2017;06;13;Tiistai;15;19;34
95;27.06.2017;2017;06;14;Tiistai;16;15;31
95;27.06.2017;2017;06;15;Tiistai;19;29;48
95;27.06.2017;2017;06;16;Tiistai;20;29;49
95;27.06.2017;2017;06;17;Tiistai;19;23;42
95;27.06.2017;2017;06;18;Tiistai;11;16;27
95;27.06.2017;2017;06;19;Tiistai;10;9;19
95;27.06.2017;2017;06;20;Tiistai;16;10;26
95;27.06.2017;2017;06;21;Tiistai;3;6;9
95;27.06.2017;2017;06;22;Tiistai;5;8;13
95;27.06.2017;2017;06;23;Tiistai;2;0;2
95;28.06.2017;2017;06;00;Keskiviikko;0;1;1
95;28.06.2017;2017;06;01;Keskiviikko;0;2;2
95;28.06.2017;2017;06;02;Keskiviikko;0;0;0
95;28.06.2017;2017;06;03;Keskiviikko;0;0;0
95;28.06.2017;2017;06;04;Keskiviikko;2;0;2
95;28.06.2017;2017;06;05;Keskiviikko;6;6;12
95;28.06.2017;2017;06;06;Keskiviikko;22;10;32
95;28.06.2017;2017;06;07;Keskiviikko;16;15;31
95;28.06.2017;2017;06;08;Keskiviikko;7;8;15
95;28.06.2017;2017;06;09;Keskiviikko;6;2;8
95;28.06.2017;2017;06;10;Keskiviikko;2;3;5
95;28.06.2017;2017;06;11;Keskiviikko;7;6;13
95;28.06.2017;2017;06;12;Keskiviikko;7;4;11
95;28.06.2017;2017;06;13;Keskiviikko;8;7;15
95;28.06.2017;2017;06;14;Keskiviikko;10;10;20
95;28.06.2017;2017;06;15;Keskiviikko;14;12;26
95;28.06.2017;2017;06;16;Keskiviikko;19;19;38
95;28.06.2017;2017;06;17;Keskiviikko;6;20;26
95;28.06.2017;2017;06;18;Keskiviikko;3;15;18
95;28.06.2017;2017;06;19;Keskiviikko;14;10;24
95;28.06.2017;2017;06;20;Keskiviikko;10;12;22
95;28.06.2017;2017;06;21;Keskiviikko;3;11;14
95;28.06.2017;2017;06;22;Keskiviikko;3;3;6
95;28.06.2017;2017;06;23;Keskiviikko;2;2;4
95;29.06.2017;2017;06;00;Torstai;2;1;3
95;29.06.2017;2017;06;01;Torstai;0;0;0
95;29.06.2017;2017;06;02;Torstai;0;0;0
95;29.06.2017;2017;06;03;Torstai;0;0;0
95;29.06.2017;2017;06;04;Torstai;3;0;3
95;29.06.2017;2017;06;05;Torstai;11;5;16
95;29.06.2017;2017;06;06;Torstai;25;10;35
95;29.06.2017;2017;06;07;Torstai;24;15;39
95;29.06.2017;2017;06;08;Torstai;16;14;30
95;29.06.2017;2017;06;09;Torstai;9;11;20
95;29.06.2017;2017;06;10;Torstai;16;5;21
95;29.06.2017;2017;06;11;Torstai;21;22;43
95;29.06.2017;2017;06;12;Torstai;18;21;39
95;29.06.2017;2017;06;13;Torstai;11;19;30
95;29.06.2017;2017;06;14;Torstai;12;32;44
95;29.06.2017;2017;06;15;Torstai;27;35;62
95;29.06.2017;2017;06;16;Torstai;30;48;78
95;29.06.2017;2017;06;17;Torstai;24;20;44
95;29.06.2017;2017;06;18;Torstai;14;23;37
95;29.06.2017;2017;06;19;Torstai;17;26;43
95;29.06.2017;2017;06;20;Torstai;20;15;35
95;29.06.2017;2017;06;21;Torstai;11;9;20
95;29.06.2017;2017;06;22;Torstai;2;7;9
95;29.06.2017;2017;06;23;Torstai;1;6;7
95;30.06.2017;2017;06;00;Perjantai;0;0;0
95;30.06.2017;2017;06;01;Perjantai;0;0;0
95;30.06.2017;2017;06;02;Perjantai;0;1;1
95;30.06.2017;2017;06;03;Perjantai;0;0;0
95;30.06.2017;2017;06;04;Perjantai;2;0;2
95;30.06.2017;2017;06;05;Perjantai;5;6;11
95;30.06.2017;2017;06;06;Perjantai;21;13;34
95;30.06.2017;2017;06;07;Perjantai;18;18;36
95;30.06.2017;2017;06;08;Perjantai;12;13;25
95;30.06.2017;2017;06;09;Perjantai;17;12;29
95;30.06.2017;2017;06;10;Perjantai;27;17;44
95;30.06.2017;2017;06;11;Perjantai;27;21;48
95;30.06.2017;2017;06;12;Perjantai;19;16;35
95;30.06.2017;2017;06;13;Perjantai;20;21;41
95;30.06.2017;2017;06;14;Perjantai;33;25;58
95;30.06.2017;2017;06;15;Perjantai;22;42;64
95;30.06.2017;2017;06;16;Perjantai;32;24;56
95;30.06.2017;2017;06;17;Perjantai;21;27;48
95;30.06.2017;2017;06;18;Perjantai;24;24;48
95;30.06.2017;2017;06;19;Perjantai;21;25;46
95;30.06.2017;2017;06;20;Perjantai;7;9;16
95;30.06.2017;2017;06;21;Perjantai;5;9;14
95;30.06.2017;2017;06;22;Perjantai;4;9;13
95;30.06.2017;2017;06;23;Perjantai;5;4;9
95;01.07.2017;2017;07;00;Lauantai;1;4;5
95;01.07.2017;2017;07;01;Lauantai;0;0;0
95;01.07.2017;2017;07;02;Lauantai;0;0;0
95;01.07.2017;2017;07;03;Lauantai;0;1;1
95;01.07.2017;2017;07;04;Lauantai;1;2;3
95;01.07.2017;2017;07;05;Lauantai;0;2;2
95;01.07.2017;2017;07;06;Lauantai;3;1;4
95;01.07.2017;2017;07;07;Lauantai;7;2;9
95;01.07.2017;2017;07;08;Lauantai;13;6;19
95;01.07.2017;2017;07;09;Lauantai;17;8;25
95;01.07.2017;2017;07;10;Lauantai;12;18;30
95;01.07.2017;2017;07;11;Lauantai;29;17;46
95;01.07.2017;2017;07;12;Lauantai;38;18;56
95;01.07.2017;2017;07;13;Lauantai;32;33;65
95;01.07.2017;2017;07;14;Lauantai;29;13;42
95;01.07.2017;2017;07;15;Lauantai;25;27;52
95;01.07.2017;2017;07;16;Lauantai;24;20;44
95;01.07.2017;2017;07;17;Lauantai;19;30;49
95;01.07.2017;2017;07;18;Lauantai;17;21;38
95;01.07.2017;2017;07;19;Lauantai;16;8;24
95;01.07.2017;2017;07;20;Lauantai;13;12;25
95;01.07.2017;2017;07;21;Lauantai;9;12;21
95;01.07.2017;2017;07;22;Lauantai;6;13;19
95;01.07.2017;2017;07;23;Lauantai;0;0;0
95;02.07.2017;2017;07;00;Sunnuntai;2;5;7
95;02.07.2017;2017;07;01;Sunnuntai;2;5;7
95;02.07.2017;2017;07;02;Sunnuntai;3;3;6
95;02.07.2017;2017;07;03;Sunnuntai;0;4;4
95;02.07.2017;2017;07;04;Sunnuntai;1;1;2
95;02.07.2017;2017;07;05;Sunnuntai;1;0;1
95;02.07.2017;2017;07;06;Sunnuntai;3;4;7
95;02.07.2017;2017;07;07;Sunnuntai;5;2;7
95;02.07.2017;2017;07;08;Sunnuntai;6;2;8
95;02.07.2017;2017;07;09;Sunnuntai;19;8;27
95;02.07.2017;2017;07;10;Sunnuntai;24;15;39
95;02.07.2017;2017;07;11;Sunnuntai;26;22;48
95;02.07.2017;2017;07;12;Sunnuntai;27;34;61
95;02.07.2017;2017;07;13;Sunnuntai;40;29;69
95;02.07.2017;2017;07;14;Sunnuntai;35;19;54
95;02.07.2017;2017;07;15;Sunnuntai;32;32;64
95;02.07.2017;2017;07;16;Sunnuntai;27;22;49
95;02.07.2017;2017;07;17;Sunnuntai;29;18;47
95;02.07.2017;2017;07;18;Sunnuntai;20;22;42
95;02.07.2017;2017;07;19;Sunnuntai;36;16;52
95;02.07.2017;2017;07;20;Sunnuntai;13;7;20
95;02.07.2017;2017;07;21;Sunnuntai;4;14;18
95;02.07.2017;2017;07;22;Sunnuntai;2;6;8
95;02.07.2017;2017;07;23;Sunnuntai;0;5;5
95;03.07.2017;2017;07;00;Maanantai;2;2;4
95;03.07.2017;2017;07;01;Maanantai;1;0;1
95;03.07.2017;2017;07;02;Maanantai;0;0;0
95;03.07.2017;2017;07;03;Maanantai;0;0;0
95;03.07.2017;2017;07;04;Maanantai;3;0;3
95;03.07.2017;2017;07;05;Maanantai;7;1;8
95;03.07.2017;2017;07;06;Maanantai;21;10;31
95;03.07.2017;2017;07;07;Maanantai;29;15;44
95;03.07.2017;2017;07;08;Maanantai;18;11;29
95;03.07.2017;2017;07;09;Maanantai;19;16;35
95;03.07.2017;2017;07;10;Maanantai;16;11;27
95;03.07.2017;2017;07;11;Maanantai;16;21;37
95;03.07.2017;2017;07;12;Maanantai;30;34;64
95;03.07.2017;2017;07;13;Maanantai;19;18;37
95;03.07.2017;2017;07;14;Maanantai;19;27;46
95;03.07.2017;2017;07;15;Maanantai;24;33;57
95;03.07.2017;2017;07;16;Maanantai;33;39;72
95;03.07.2017;2017;07;17;Maanantai;18;20;38
95;03.07.2017;2017;07;18;Maanantai;19;21;40
95;03.07.2017;2017;07;19;Maanantai;19;17;36
95;03.07.2017;2017;07;20;Maanantai;9;20;29
95;03.07.2017;2017;07;21;Maanantai;10;11;21
95;03.07.2017;2017;07;22;Maanantai;9;6;15
95;03.07.2017;2017;07;23;Maanantai;3;6;9
95;04.07.2017;2017;07;00;Tiistai;0;2;2
95;04.07.2017;2017;07;01;Tiistai;0;0;0
95;04.07.2017;2017;07;02;Tiistai;1;0;1
95;04.07.2017;2017;07;03;Tiistai;0;0;0
95;04.07.2017;2017;07;04;Tiistai;4;0;4
95;04.07.2017;2017;07;05;Tiistai;9;3;12
95;04.07.2017;2017;07;06;Tiistai;14;12;26
95;04.07.2017;2017;07;07;Tiistai;12;14;26
95;04.07.2017;2017;07;08;Tiistai;13;6;19
95;04.07.2017;2017;07;09;Tiistai;15;11;26
95;04.07.2017;2017;07;10;Tiistai;18;10;28
95;04.07.2017;2017;07;11;Tiistai;9;13;22
95;04.07.2017;2017;07;12;Tiistai;5;8;13
95;04.07.2017;2017;07;13;Tiistai;8;7;15
95;04.07.2017;2017;07;14;Tiistai;12;13;25
95;04.07.2017;2017;07;15;Tiistai;24;23;47
95;04.07.2017;2017;07;16;Tiistai;14;27;41
95;04.07.2017;2017;07;17;Tiistai;4;18;22
95;04.07.2017;2017;07;18;Tiistai;18;16;34
95;04.07.2017;2017;07;19;Tiistai;18;14;32
95;04.07.2017;2017;07;20;Tiistai;17;11;28
95;04.07.2017;2017;07;21;Tiistai;15;16;31
95;04.07.2017;2017;07;22;Tiistai;2;4;6
95;04.07.2017;2017;07;23;Tiistai;1;1;2
95;05.07.2017;2017;07;00;Keskiviikko;1;2;3
95;05.07.2017;2017;07;01;Keskiviikko;3;0;3
95;05.07.2017;2017;07;02;Keskiviikko;0;0;0
95;05.07.2017;2017;07;03;Keskiviikko;0;1;1
95;05.07.2017;2017;07;04;Keskiviikko;1;0;1
95;05.07.2017;2017;07;05;Keskiviikko;6;4;10
95;05.07.2017;2017;07;06;Keskiviikko;7;4;11
95;05.07.2017;2017;07;07;Keskiviikko;15;7;22
95;05.07.2017;2017;07;08;Keskiviikko;6;8;14
95;05.07.2017;2017;07;09;Keskiviikko;13;13;26
95;05.07.2017;2017;07;10;Keskiviikko;6;4;10
95;05.07.2017;2017;07;11;Keskiviikko;12;16;28
95;05.07.2017;2017;07;12;Keskiviikko;6;9;15
95;05.07.2017;2017;07;13;Keskiviikko;12;6;18
95;05.07.2017;2017;07;14;Keskiviikko;7;15;22
95;05.07.2017;2017;07;15;Keskiviikko;8;21;29
95;05.07.2017;2017;07;16;Keskiviikko;18;15;33
95;05.07.2017;2017;07;17;Keskiviikko;5;12;17
95;05.07.2017;2017;07;18;Keskiviikko;14;8;22
95;05.07.2017;2017;07;19;Keskiviikko;5;7;12
95;05.07.2017;2017;07;20;Keskiviikko;0;8;8
95;05.07.2017;2017;07;21;Keskiviikko;3;6;9
95;05.07.2017;2017;07;22;Keskiviikko;3;1;4
95;05.07.2017;2017;07;23;Keskiviikko;3;0;3
95;06.07.2017;2017;07;00;Torstai;0;1;1
95;06.07.2017;2017;07;01;Torstai;0;2;2
95;06.07.2017;2017;07;02;Torstai;0;0;0
95;06.07.2017;2017;07;03;Torstai;1;2;3
95;06.07.2017;2017;07;04;Torstai;3;0;3
95;06.07.2017;2017;07;05;Torstai;4;2;6
95;06.07.2017;2017;07;06;Torstai;8;4;12
95;06.07.2017;2017;07;07;Torstai;11;4;15
95;06.07.2017;2017;07;08;Torstai;6;5;11
95;06.07.2017;2017;07;09;Torstai;3;1;4
95;06.07.2017;2017;07;10;Torstai;0;1;1
95;06.07.2017;2017;07;11;Torstai;4;2;6
95;06.07.2017;2017;07;12;Torstai;4;3;7
95;06.07.2017;2017;07;13;Torstai;6;4;10
95;06.07.2017;2017;07;14;Torstai;7;14;21
95;06.07.2017;2017;07;15;Torstai;8;14;22
95;06.07.2017;2017;07;16;Torstai;11;18;29
95;06.07.2017;2017;07;17;Torstai;3;15;18
95;06.07.2017;2017;07;18;Torstai;11;13;24
95;06.07.2017;2017;07;19;Torstai;10;5;15
95;06.07.2017;2017;07;20;Torstai;11;9;20
95;06.07.2017;2017;07;21;Torstai;3;7;10
95;06.07.2017;2017;07;22;Torstai;5;6;11
95;06.07.2017;2017;07;23;Torstai;0;0;0
95;07.07.2017;2017;07;00;Perjantai;2;1;3
95;07.07.2017;2017;07;01;Perjantai;0;0;0
95;07.07.2017;2017;07;02;Perjantai;0;3;3
95;07.07.2017;2017;07;03;Perjantai;0;0;0
95;07.07.2017;2017;07;04;Perjantai;3;0;3
95;07.07.2017;2017;07;05;Perjantai;6;1;7
95;07.07.2017;2017;07;06;Perjantai;15;5;20
95;07.07.2017;2017;07;07;Perjantai;17;15;32
95;07.07.2017;2017;07;08;Perjantai;12;3;15
95;07.07.2017;2017;07;09;Perjantai;10;11;21
95;07.07.2017;2017;07;10;Perjantai;11;17;28
95;07.07.2017;2017;07;11;Perjantai;16;13;29
95;07.07.2017;2017;07;12;Perjantai;25;21;46
95;07.07.2017;2017;07;13;Perjantai;21;23;44
95;07.07.2017;2017;07;14;Perjantai;19;28;47
95;07.07.2017;2017;07;15;Perjantai;17;31;48
95;07.07.2017;2017;07;16;Perjantai;16;31;47
95;07.07.2017;2017;07;17;Perjantai;14;18;32
95;07.07.2017;2017;07;18;Perjantai;25;20;45
95;07.07.2017;2017;07;19;Perjantai;26;15;41
95;07.07.2017;2017;07;20;Perjantai;14;10;24
95;07.07.2017;2017;07;21;Perjantai;5;15;20
95;07.07.2017;2017;07;22;Perjantai;1;3;4
95;07.07.2017;2017;07;23;Perjantai;1;4;5
95;08.07.2017;2017;07;00;Lauantai;1;3;4
95;08.07.2017;2017;07;01;Lauantai;0;1;1
95;08.07.2017;2017;07;02;Lauantai;1;2;3
95;08.07.2017;2017;07;03;Lauantai;0;0;0
95;08.07.2017;2017;07;04;Lauantai;1;1;2
95;08.07.2017;2017;07;05;Lauantai;2;0;2
95;08.07.2017;2017;07;06;Lauantai;4;1;5
95;08.07.2017;2017;07;07;Lauantai;4;2;6
95;08.07.2017;2017;07;08;Lauantai;7;6;13
95;08.07.2017;2017;07;09;Lauantai;7;7;14
95;08.07.2017;2017;07;10;Lauantai;28;11;39
95;08.07.2017;2017;07;11;Lauantai;27;19;46
95;08.07.2017;2017;07;12;Lauantai;36;21;57
95;08.07.2017;2017;07;13;Lauantai;36;21;57
95;08.07.2017;2017;07;14;Lauantai;39;33;72
95;08.07.2017;2017;07;15;Lauantai;30;18;48
95;08.07.2017;2017;07;16;Lauantai;26;29;55
95;08.07.2017;2017;07;17;Lauantai;13;27;40
95;08.07.2017;2017;07;18;Lauantai;25;24;49
95;08.07.2017;2017;07;19;Lauantai;38;18;56
95;08.07.2017;2017;07;20;Lauantai;7;15;22
95;08.07.2017;2017;07;21;Lauantai;12;9;21
95;08.07.2017;2017;07;22;Lauantai;5;8;13
95;08.07.2017;2017;07;23;Lauantai;2;5;7
95;09.07.2017;2017;07;00;Sunnuntai;1;7;8
95;09.07.2017;2017;07;01;Sunnuntai;0;0;0
95;09.07.2017;2017;07;02;Sunnuntai;1;4;5
95;09.07.2017;2017;07;03;Sunnuntai;0;3;3
95;09.07.2017;2017;07;04;Sunnuntai;1;1;2
95;09.07.2017;2017;07;05;Sunnuntai;1;1;2
95;09.07.2017;2017;07;06;Sunnuntai;3;0;3
95;09.07.2017;2017;07;07;Sunnuntai;6;5;11
95;09.07.2017;2017;07;08;Sunnuntai;11;8;19
95;09.07.2017;2017;07;09;Sunnuntai;9;16;25
95;09.07.2017;2017;07;10;Sunnuntai;15;26;41
95;09.07.2017;2017;07;11;Sunnuntai;29;16;45
95;09.07.2017;2017;07;12;Sunnuntai;41;18;59
95;09.07.2017;2017;07;13;Sunnuntai;25;36;61
95;09.07.2017;2017;07;14;Sunnuntai;23;19;42
95;09.07.2017;2017;07;15;Sunnuntai;21;19;40
95;09.07.2017;2017;07;16;Sunnuntai;32;20;52
95;09.07.2017;2017;07;17;Sunnuntai;20;29;49
95;09.07.2017;2017;07;18;Sunnuntai;24;30;54
95;09.07.2017;2017;07;19;Sunnuntai;23;24;47
95;09.07.2017;2017;07;20;Sunnuntai;19;20;39
95;09.07.2017;2017;07;21;Sunnuntai;15;17;32
95;09.07.2017;2017;07;22;Sunnuntai;5;4;9
95;09.07.2017;2017;07;23;Sunnuntai;4;0;4
95;10.07.2017;2017;07;00;Maanantai;1;1;2
95;10.07.2017;2017;07;01;Maanantai;2;3;5
95;10.07.2017;2017;07;02;Maanantai;0;0;0
95;10.07.2017;2017;07;03;Maanantai;0;0;0
95;10.07.2017;2017;07;04;Maanantai;4;0;4
95;10.07.2017;2017;07;05;Maanantai;8;4;12
95;10.07.2017;2017;07;06;Maanantai;19;8;27
95;10.07.2017;2017;07;07;Maanantai;14;10;24
95;10.07.2017;2017;07;08;Maanantai;19;14;33
95;10.07.2017;2017;07;09;Maanantai;14;9;23
95;10.07.2017;2017;07;10;Maanantai;16;17;33
95;10.07.2017;2017;07;11;Maanantai;35;33;68
95;10.07.2017;2017;07;12;Maanantai;39;33;72
95;10.07.2017;2017;07;13;Maanantai;40;15;55
95;10.07.2017;2017;07;14;Maanantai;27;32;59
95;10.07.2017;2017;07;15;Maanantai;25;46;71
95;10.07.2017;2017;07;16;Maanantai;27;29;56
95;10.07.2017;2017;07;17;Maanantai;11;30;41
95;10.07.2017;2017;07;18;Maanantai;16;22;38
95;10.07.2017;2017;07;19;Maanantai;11;30;41
95;10.07.2017;2017;07;20;Maanantai;28;19;47
95;10.07.2017;2017;07;21;Maanantai;7;6;13
95;10.07.2017;2017;07;22;Maanantai;6;7;13
95;10.07.2017;2017;07;23;Maanantai;4;2;6
95;11.07.2017;2017;07;00;Tiistai;2;3;5
95;11.07.2017;2017;07;01;Tiistai;1;3;4
95;11.07.2017;2017;07;02;Tiistai;0;0;0
95;11.07.2017;2017;07;03;Tiistai;0;0;0
95;11.07.2017;2017;07;04;Tiistai;4;0;4
95;11.07.2017;2017;07;05;Tiistai;9;3;12
95;11.07.2017;2017;07;06;Tiistai;22;11;33
95;11.07.2017;2017;07;07;Tiistai;17;20;37
95;11.07.2017;2017;07;08;Tiistai;14;13;27
95;11.07.2017;2017;07;09;Tiistai;13;9;22
95;11.07.2017;2017;07;10;Tiistai;26;24;50
95;11.07.2017;2017;07;11;Tiistai;31;20;51
95;11.07.2017;2017;07;12;Tiistai;30;20;50
95;11.07.2017;2017;07;13;Tiistai;30;32;62
95;11.07.2017;2017;07;14;Tiistai;20;28;48
95;11.07.2017;2017;07;15;Tiistai;26;30;56
95;11.07.2017;2017;07;16;Tiistai;30;35;65
95;11.07.2017;2017;07;17;Tiistai;27;27;54
95;11.07.2017;2017;07;18;Tiistai;12;23;35
95;11.07.2017;2017;07;19;Tiistai;23;20;43
95;11.07.2017;2017;07;20;Tiistai;15;12;27
95;11.07.2017;2017;07;21;Tiistai;5;8;13
95;11.07.2017;2017;07;22;Tiistai;0;4;4
95;11.07.2017;2017;07;23;Tiistai;2;1;3
95;12.07.2017;2017;07;00;Keskiviikko;0;3;3
95;12.07.2017;2017;07;01;Keskiviikko;0;1;1
95;12.07.2017;2017;07;02;Keskiviikko;0;0;0
95;12.07.2017;2017;07;03;Keskiviikko;0;0;0
95;12.07.2017;2017;07;04;Keskiviikko;1;0;1
95;12.07.2017;2017;07;05;Keskiviikko;5;3;8
95;12.07.2017;2017;07;06;Keskiviikko;3;6;9
95;12.07.2017;2017;07;07;Keskiviikko;5;5;10
95;12.07.2017;2017;07;08;Keskiviikko;2;6;8
95;12.07.2017;2017;07;09;Keskiviikko;2;2;4
95;12.07.2017;2017;07;10;Keskiviikko;1;2;3
95;12.07.2017;2017;07;11;Keskiviikko;3;6;9
95;12.07.2017;2017;07;12;Keskiviikko;8;6;14
95;12.07.2017;2017;07;13;Keskiviikko;12;9;21
95;12.07.2017;2017;07;14;Keskiviikko;7;5;12
95;12.07.2017;2017;07;15;Keskiviikko;9;8;17
95;12.07.2017;2017;07;16;Keskiviikko;9;3;12
95;12.07.2017;2017;07;17;Keskiviikko;6;6;12
95;12.07.2017;2017;07;18;Keskiviikko;1;4;5
95;12.07.2017;2017;07;19;Keskiviikko;3;0;3
95;12.07.2017;2017;07;20;Keskiviikko;6;2;8
95;12.07.2017;2017;07;21;Keskiviikko;2;4;6
95;12.07.2017;2017;07;22;Keskiviikko;0;3;3
95;12.07.2017;2017;07;23;Keskiviikko;0;1;1
95;13.07.2017;2017;07;00;Torstai;0;1;1
95;13.07.2017;2017;07;01;Torstai;0;0;0
95;13.07.2017;2017;07;02;Torstai;0;0;0
95;13.07.2017;2017;07;03;Torstai;1;1;2
95;13.07.2017;2017;07;04;Torstai;0;0;0
95;13.07.2017;2017;07;05;Torstai;3;3;6
95;13.07.2017;2017;07;06;Torstai;8;7;15
95;13.07.2017;2017;07;07;Torstai;11;5;16
95;13.07.2017;2017;07;08;Torstai;12;8;20
95;13.07.2017;2017;07;09;Torstai;8;8;16
95;13.07.2017;2017;07;10;Torstai;9;11;20
95;13.07.2017;2017;07;11;Torstai;21;8;29
95;13.07.2017;2017;07;12;Torstai;20;23;43
95;13.07.2017;2017;07;13;Torstai;30;15;45
95;13.07.2017;2017;07;14;Torstai;22;28;50
95;13.07.2017;2017;07;15;Torstai;20;31;51
95;13.07.2017;2017;07;16;Torstai;18;13;31
95;13.07.2017;2017;07;17;Torstai;11;17;28
95;13.07.2017;2017;07;18;Torstai;5;14;19
95;13.07.2017;2017;07;19;Torstai;8;9;17
95;13.07.2017;2017;07;20;Torstai;7;9;16
95;13.07.2017;2017;07;21;Torstai;8;7;15
95;13.07.2017;2017;07;22;Torstai;2;3;5
95;13.07.2017;2017;07;23;Torstai;4;4;8
95;14.07.2017;2017;07;00;Perjantai;1;3;4
95;14.07.2017;2017;07;01;Perjantai;1;0;1
95;14.07.2017;2017;07;02;Perjantai;1;0;1
95;14.07.2017;2017;07;03;Perjantai;0;1;1
95;14.07.2017;2017;07;04;Perjantai;1;0;1
95;14.07.2017;2017;07;05;Perjantai;6;2;8
95;14.07.2017;2017;07;06;Perjantai;2;3;5
95;14.07.2017;2017;07;07;Perjantai;9;4;13
95;14.07.2017;2017;07;08;Perjantai;3;6;9
95;14.07.2017;2017;07;09;Perjantai;1;0;1
95;14.07.2017;2017;07;10;Perjantai;0;2;2
95;14.07.2017;2017;07;11;Perjantai;0;0;0
95;14.07.2017;2017;07;12;Perjantai;1;1;2
95;14.07.2017;2017;07;13;Perjantai;6;6;12
95;14.07.2017;2017;07;14;Perjantai;14;8;22
95;14.07.2017;2017;07;15;Perjantai;15;12;27
95;14.07.2017;2017;07;16;Perjantai;15;7;22
95;14.07.2017;2017;07;17;Perjantai;7;18;25
95;14.07.2017;2017;07;18;Perjantai;21;14;35
95;14.07.2017;2017;07;19;Perjantai;12;13;25
95;14.07.2017;2017;07;20;Perjantai;6;4;10
95;14.07.2017;2017;07;21;Perjantai;10;7;17
95;14.07.2017;2017;07;22;Perjantai;2;6;8
95;14.07.2017;2017;07;23;Perjantai;1;2;3
95;15.07.2017;2017;07;00;Lauantai;0;5;5
95;15.07.2017;2017;07;01;Lauantai;0;1;1
95;15.07.2017;2017;07;02;Lauantai;0;0;0
95;15.07.2017;2017;07;03;Lauantai;0;1;1
95;15.07.2017;2017;07;04;Lauantai;0;0;0
95;15.07.2017;2017;07;05;Lauantai;1;4;5
95;15.07.2017;2017;07;06;Lauantai;2;1;3
95;15.07.2017;2017;07;07;Lauantai;5;2;7
95;15.07.2017;2017;07;08;Lauantai;8;6;14
95;15.07.2017;2017;07;09;Lauantai;7;5;12
95;15.07.2017;2017;07;10;Lauantai;19;13;32
95;15.07.2017;2017;07;11;Lauantai;15;14;29
95;15.07.2017;2017;07;12;Lauantai;29;17;46
95;15.07.2017;2017;07;13;Lauantai;28;25;53
95;15.07.2017;2017;07;14;Lauantai;22;21;43
95;15.07.2017;2017;07;15;Lauantai;16;23;39
95;15.07.2017;2017;07;16;Lauantai;24;14;38
95;15.07.2017;2017;07;17;Lauantai;18;19;37
95;15.07.2017;2017;07;18;Lauantai;13;16;29
95;15.07.2017;2017;07;19;Lauantai;8;10;18
95;15.07.2017;2017;07;20;Lauantai;11;18;29
95;15.07.2017;2017;07;21;Lauantai;11;9;20
95;15.07.2017;2017;07;22;Lauantai;2;9;11
95;15.07.2017;2017;07;23;Lauantai;0;1;1
95;16.07.2017;2017;07;00;Sunnuntai;4;2;6
95;16.07.2017;2017;07;01;Sunnuntai;0;5;5
95;16.07.2017;2017;07;02;Sunnuntai;1;1;2
95;16.07.2017;2017;07;03;Sunnuntai;0;6;6
95;16.07.2017;2017;07;04;Sunnuntai;0;2;2
95;16.07.2017;2017;07;05;Sunnuntai;0;0;0
95;16.07.2017;2017;07;06;Sunnuntai;7;3;10
95;16.07.2017;2017;07;07;Sunnuntai;4;4;8
95;16.07.2017;2017;07;08;Sunnuntai;5;6;11
95;16.07.2017;2017;07;09;Sunnuntai;14;22;36
95;16.07.2017;2017;07;10;Sunnuntai;14;28;42
95;16.07.2017;2017;07;11;Sunnuntai;35;20;55
95;16.07.2017;2017;07;12;Sunnuntai;60;40;100
95;16.07.2017;2017;07;13;Sunnuntai;46;21;67
95;16.07.2017;2017;07;14;Sunnuntai;29;38;67
95;16.07.2017;2017;07;15;Sunnuntai;27;37;64
95;16.07.2017;2017;07;16;Sunnuntai;25;36;61
95;16.07.2017;2017;07;17;Sunnuntai;27;31;58
95;16.07.2017;2017;07;18;Sunnuntai;30;19;49
95;16.07.2017;2017;07;19;Sunnuntai;43;28;71
95;16.07.2017;2017;07;20;Sunnuntai;22;17;39
95;16.07.2017;2017;07;21;Sunnuntai;10;12;22
95;16.07.2017;2017;07;22;Sunnuntai;6;11;17
95;16.07.2017;2017;07;23;Sunnuntai;0;2;2
95;17.07.2017;2017;07;00;Maanantai;3;1;4
95;17.07.2017;2017;07;01;Maanantai;1;0;1
95;17.07.2017;2017;07;02;Maanantai;0;0;0
95;17.07.2017;2017;07;03;Maanantai;0;1;1
95;17.07.2017;2017;07;04;Maanantai;2;0;2
95;17.07.2017;2017;07;05;Maanantai;6;2;8
95;17.07.2017;2017;07;06;Maanantai;17;9;26
95;17.07.2017;2017;07;07;Maanantai;19;9;28
95;17.07.2017;2017;07;08;Maanantai;17;11;28
95;17.07.2017;2017;07;09;Maanantai;17;6;23
95;17.07.2017;2017;07;10;Maanantai;12;14;26
95;17.07.2017;2017;07;11;Maanantai;20;22;42
95;17.07.2017;2017;07;12;Maanantai;33;15;48
95;17.07.2017;2017;07;13;Maanantai;20;18;38
95;17.07.2017;2017;07;14;Maanantai;15;35;50
95;17.07.2017;2017;07;15;Maanantai;16;28;44
95;17.07.2017;2017;07;16;Maanantai;35;38;73
95;17.07.2017;2017;07;17;Maanantai;18;24;42
95;17.07.2017;2017;07;18;Maanantai;28;26;54
95;17.07.2017;2017;07;19;Maanantai;12;37;49
95;17.07.2017;2017;07;20;Maanantai;14;20;34
95;17.07.2017;2017;07;21;Maanantai;8;7;15
95;17.07.2017;2017;07;22;Maanantai;6;4;10
95;17.07.2017;2017;07;23;Maanantai;0;4;4
95;18.07.2017;2017;07;00;Tiistai;0;0;0
95;18.07.2017;2017;07;01;Tiistai;0;1;1
95;18.07.2017;2017;07;02;Tiistai;0;0;0
95;18.07.2017;2017;07;03;Tiistai;0;1;1
95;18.07.2017;2017;07;04;Tiistai;1;0;1
95;18.07.2017;2017;07;05;Tiistai;3;1;4
95;18.07.2017;2017;07;06;Tiistai;6;3;9
95;18.07.2017;2017;07;07;Tiistai;6;3;9
95;18.07.2017;2017;07;08;Tiistai;2;3;5
95;18.07.2017;2017;07;09;Tiistai;2;0;2
95;18.07.2017;2017;07;10;Tiistai;3;2;5
95;18.07.2017;2017;07;11;Tiistai;1;3;4
95;18.07.2017;2017;07;12;Tiistai;2;1;3
95;18.07.2017;2017;07;13;Tiistai;7;6;13
95;18.07.2017;2017;07;14;Tiistai;6;2;8
95;18.07.2017;2017;07;15;Tiistai;8;15;23
95;18.07.2017;2017;07;16;Tiistai;14;6;20
95;18.07.2017;2017;07;17;Tiistai;7;12;19
95;18.07.2017;2017;07;18;Tiistai;6;9;15
95;18.07.2017;2017;07;19;Tiistai;6;9;15
95;18.07.2017;2017;07;20;Tiistai;8;5;13
95;18.07.2017;2017;07;21;Tiistai;2;6;8
95;18.07.2017;2017;07;22;Tiistai;3;1;4
95;18.07.2017;2017;07;23;Tiistai;1;0;1
95;19.07.2017;2017;07;00;Keskiviikko;0;0;0
95;19.07.2017;2017;07;01;Keskiviikko;0;0;0
95;19.07.2017;2017;07;02;Keskiviikko;0;0;0
95;19.07.2017;2017;07;03;Keskiviikko;0;1;1
95;19.07.2017;2017;07;04;Keskiviikko;2;0;2
95;19.07.2017;2017;07;05;Keskiviikko;2;2;4
95;19.07.2017;2017;07;06;Keskiviikko;14;6;20
95;19.07.2017;2017;07;07;Keskiviikko;8;5;13
95;19.07.2017;2017;07;08;Keskiviikko;10;6;16
95;19.07.2017;2017;07;09;Keskiviikko;10;7;17
95;19.07.2017;2017;07;10;Keskiviikko;14;7;21
95;19.07.2017;2017;07;11;Keskiviikko;11;15;26
95;19.07.2017;2017;07;12;Keskiviikko;23;9;32
95;19.07.2017;2017;07;13;Keskiviikko;15;12;27
95;19.07.2017;2017;07;14;Keskiviikko;18;10;28
95;19.07.2017;2017;07;15;Keskiviikko;13;26;39
95;19.07.2017;2017;07;16;Keskiviikko;17;32;49
95;19.07.2017;2017;07;17;Keskiviikko;13;20;33
95;19.07.2017;2017;07;18;Keskiviikko;14;22;36
95;19.07.2017;2017;07;19;Keskiviikko;16;18;34
95;19.07.2017;2017;07;20;Keskiviikko;9;12;21
95;19.07.2017;2017;07;21;Keskiviikko;12;9;21
95;19.07.2017;2017;07;22;Keskiviikko;5;6;11
95;19.07.2017;2017;07;23;Keskiviikko;2;2;4
95;20.07.2017;2017;07;00;Torstai;0;0;0
95;20.07.2017;2017;07;01;Torstai;0;0;0
95;20.07.2017;2017;07;02;Torstai;0;0;0
95;20.07.2017;2017;07;03;Torstai;0;1;1
95;20.07.2017;2017;07;04;Torstai;1;0;1
95;20.07.2017;2017;07;05;Torstai;3;1;4
95;20.07.2017;2017;07;06;Torstai;19;5;24
95;20.07.2017;2017;07;07;Torstai;16;7;23
95;20.07.2017;2017;07;08;Torstai;11;7;18
95;20.07.2017;2017;07;09;Torstai;7;11;18
95;20.07.2017;2017;07;10;Torstai;14;16;30
95;20.07.2017;2017;07;11;Torstai;11;13;24
95;20.07.2017;2017;07;12;Torstai;17;19;36
95;20.07.2017;2017;07;13;Torstai;16;20;36
95;20.07.2017;2017;07;14;Torstai;20;23;43
95;20.07.2017;2017;07;15;Torstai;24;31;55
95;20.07.2017;2017;07;16;Torstai;25;23;48
95;20.07.2017;2017;07;17;Torstai;13;30;43
95;20.07.2017;2017;07;18;Torstai;14;20;34
95;20.07.2017;2017;07;19;Torstai;16;24;40
95;20.07.2017;2017;07;20;Torstai;19;11;30
95;20.07.2017;2017;07;21;Torstai;10;9;19
95;20.07.2017;2017;07;22;Torstai;8;6;14
95;20.07.2017;2017;07;23;Torstai;5;3;8
95;21.07.2017;2017;07;00;Perjantai;2;2;4
95;21.07.2017;2017;07;01;Perjantai;1;0;1
95;21.07.2017;2017;07;02;Perjantai;2;1;3
95;21.07.2017;2017;07;03;Perjantai;0;0;0
95;21.07.2017;2017;07;04;Perjantai;0;0;0
95;21.07.2017;2017;07;05;Perjantai;3;4;7
95;21.07.2017;2017;07;06;Perjantai;9;4;13
95;21.07.2017;2017;07;07;Perjantai;10;5;15
95;21.07.2017;2017;07;08;Perjantai;8;7;15
95;21.07.2017;2017;07;09;Perjantai;12;8;20
95;21.07.2017;2017;07;10;Perjantai;11;7;18
95;21.07.2017;2017;07;11;Perjantai;22;17;39
95;21.07.2017;2017;07;12;Perjantai;17;21;38
95;21.07.2017;2017;07;13;Perjantai;13;13;26
95;21.07.2017;2017;07;14;Perjantai;13;21;34
95;21.07.2017;2017;07;15;Perjantai;19;21;40
95;21.07.2017;2017;07;16;Perjantai;13;23;36
95;21.07.2017;2017;07;17;Perjantai;7;13;20
95;21.07.2017;2017;07;18;Perjantai;12;19;31
95;21.07.2017;2017;07;19;Perjantai;13;9;22
95;21.07.2017;2017;07;20;Perjantai;15;8;23
95;21.07.2017;2017;07;21;Perjantai;2;6;8
95;21.07.2017;2017;07;22;Perjantai;3;3;6
95;21.07.2017;2017;07;23;Perjantai;2;1;3
95;22.07.2017;2017;07;00;Lauantai;0;2;2
95;22.07.2017;2017;07;01;Lauantai;0;1;1
95;22.07.2017;2017;07;02;Lauantai;0;0;0
95;22.07.2017;2017;07;03;Lauantai;1;1;2
95;22.07.2017;2017;07;04;Lauantai;2;0;2
95;22.07.2017;2017;07;05;Lauantai;0;1;1
95;22.07.2017;2017;07;06;Lauantai;4;0;4
95;22.07.2017;2017;07;07;Lauantai;4;0;4
95;22.07.2017;2017;07;08;Lauantai;5;3;8
95;22.07.2017;2017;07;09;Lauantai;14;9;23
95;22.07.2017;2017;07;10;Lauantai;21;11;32
95;22.07.2017;2017;07;11;Lauantai;12;13;25
95;22.07.2017;2017;07;12;Lauantai;15;13;28
95;22.07.2017;2017;07;13;Lauantai;11;20;31
95;22.07.2017;2017;07;14;Lauantai;20;16;36
95;22.07.2017;2017;07;15;Lauantai;9;16;25
95;22.07.2017;2017;07;16;Lauantai;14;18;32
95;22.07.2017;2017;07;17;Lauantai;15;12;27
95;22.07.2017;2017;07;18;Lauantai;16;10;26
95;22.07.2017;2017;07;19;Lauantai;20;7;27
95;22.07.2017;2017;07;20;Lauantai;6;11;17
95;22.07.2017;2017;07;21;Lauantai;5;2;7
95;22.07.2017;2017;07;22;Lauantai;7;2;9
95;22.07.2017;2017;07;23;Lauantai;1;3;4
95;23.07.2017;2017;07;00;Sunnuntai;0;3;3
95;23.07.2017;2017;07;01;Sunnuntai;0;0;0
95;23.07.2017;2017;07;02;Sunnuntai;0;0;0
95;23.07.2017;2017;07;03;Sunnuntai;0;2;2
95;23.07.2017;2017;07;04;Sunnuntai;0;2;2
95;23.07.2017;2017;07;05;Sunnuntai;0;1;1
95;23.07.2017;2017;07;06;Sunnuntai;4;1;5
95;23.07.2017;2017;07;07;Sunnuntai;5;2;7
95;23.07.2017;2017;07;08;Sunnuntai;3;7;10
95;23.07.2017;2017;07;09;Sunnuntai;17;14;31
95;23.07.2017;2017;07;10;Sunnuntai;23;25;48
95;23.07.2017;2017;07;11;Sunnuntai;21;36;57
95;23.07.2017;2017;07;12;Sunnuntai;29;14;43
95;23.07.2017;2017;07;13;Sunnuntai;18;20;38
95;23.07.2017;2017;07;14;Sunnuntai;15;22;37
95;23.07.2017;2017;07;15;Sunnuntai;4;9;13
95;23.07.2017;2017;07;16;Sunnuntai;12;5;17
95;23.07.2017;2017;07;17;Sunnuntai;5;5;10
95;23.07.2017;2017;07;18;Sunnuntai;0;4;4
95;23.07.2017;2017;07;19;Sunnuntai;3;6;9
95;23.07.2017;2017;07;20;Sunnuntai;6;5;11
95;23.07.2017;2017;07;21;Sunnuntai;4;5;9
95;23.07.2017;2017;07;22;Sunnuntai;0;2;2
95;23.07.2017;2017;07;23;Sunnuntai;3;0;3
95;24.07.2017;2017;07;00;Maanantai;0;0;0
95;24.07.2017;2017;07;01;Maanantai;2;1;3
95;24.07.2017;2017;07;02;Maanantai;1;1;2
95;24.07.2017;2017;07;03;Maanantai;0;0;0
95;24.07.2017;2017;07;04;Maanantai;0;0;0
95;24.07.2017;2017;07;05;Maanantai;5;5;10
95;24.07.2017;2017;07;06;Maanantai;12;12;24
95;24.07.2017;2017;07;07;Maanantai;14;12;26
95;24.07.2017;2017;07;08;Maanantai;5;5;10
95;24.07.2017;2017;07;09;Maanantai;8;10;18
95;24.07.2017;2017;07;10;Maanantai;11;11;22
95;24.07.2017;2017;07;11;Maanantai;23;10;33
95;24.07.2017;2017;07;12;Maanantai;29;12;41
95;24.07.2017;2017;07;13;Maanantai;16;25;41
95;24.07.2017;2017;07;14;Maanantai;18;28;46
95;24.07.2017;2017;07;15;Maanantai;23;25;48
95;24.07.2017;2017;07;16;Maanantai;37;24;61
95;24.07.2017;2017;07;17;Maanantai;22;21;43
95;24.07.2017;2017;07;18;Maanantai;18;27;45
95;24.07.2017;2017;07;19;Maanantai;15;23;38
95;24.07.2017;2017;07;20;Maanantai;11;9;20
95;24.07.2017;2017;07;21;Maanantai;13;14;27
95;24.07.2017;2017;07;22;Maanantai;14;11;25
95;24.07.2017;2017;07;23;Maanantai;1;1;2
95;25.07.2017;2017;07;00;Tiistai;0;2;2
95;25.07.2017;2017;07;01;Tiistai;0;0;0
95;25.07.2017;2017;07;02;Tiistai;0;0;0
95;25.07.2017;2017;07;03;Tiistai;0;0;0
95;25.07.2017;2017;07;04;Tiistai;0;0;0
95;25.07.2017;2017;07;05;Tiistai;4;6;10
95;25.07.2017;2017;07;06;Tiistai;26;13;39
95;25.07.2017;2017;07;07;Tiistai;18;13;31
95;25.07.2017;2017;07;08;Tiistai;8;12;20
95;25.07.2017;2017;07;09;Tiistai;16;6;22
95;25.07.2017;2017;07;10;Tiistai;20;21;41
95;25.07.2017;2017;07;11;Tiistai;13;20;33
95;25.07.2017;2017;07;12;Tiistai;35;39;74
95;25.07.2017;2017;07;13;Tiistai;25;24;49
95;25.07.2017;2017;07;14;Tiistai;31;33;64
95;25.07.2017;2017;07;15;Tiistai;30;34;64
95;25.07.2017;2017;07;16;Tiistai;36;30;66
95;25.07.2017;2017;07;17;Tiistai;24;26;50
95;25.07.2017;2017;07;18;Tiistai;18;31;49
95;25.07.2017;2017;07;19;Tiistai;29;31;60
95;25.07.2017;2017;07;20;Tiistai;17;21;38
95;25.07.2017;2017;07;21;Tiistai;24;21;45
95;25.07.2017;2017;07;22;Tiistai;5;5;10
95;25.07.2017;2017;07;23;Tiistai;3;3;6
95;26.07.2017;2017;07;00;Keskiviikko;1;1;2
95;26.07.2017;2017;07;01;Keskiviikko;0;1;1
95;26.07.2017;2017;07;02;Keskiviikko;3;0;3
95;26.07.2017;2017;07;03;Keskiviikko;0;1;1
95;26.07.2017;2017;07;04;Keskiviikko;0;3;3
95;26.07.2017;2017;07;05;Keskiviikko;6;5;11
95;26.07.2017;2017;07;06;Keskiviikko;20;8;28
95;26.07.2017;2017;07;07;Keskiviikko;26;15;41
95;26.07.2017;2017;07;08;Keskiviikko;12;7;19
95;26.07.2017;2017;07;09;Keskiviikko;22;13;35
95;26.07.2017;2017;07;10;Keskiviikko;24;30;54
95;26.07.2017;2017;07;11;Keskiviikko;23;19;42
95;26.07.2017;2017;07;12;Keskiviikko;30;31;61
95;26.07.2017;2017;07;13;Keskiviikko;35;21;56
95;26.07.2017;2017;07;14;Keskiviikko;43;17;60
95;26.07.2017;2017;07;15;Keskiviikko;33;37;70
95;26.07.2017;2017;07;16;Keskiviikko;30;41;71
95;26.07.2017;2017;07;17;Keskiviikko;31;36;67
95;26.07.2017;2017;07;18;Keskiviikko;43;43;86
95;26.07.2017;2017;07;19;Keskiviikko;25;32;57
95;26.07.2017;2017;07;20;Keskiviikko;15;17;32
95;26.07.2017;2017;07;21;Keskiviikko;14;19;33
95;26.07.2017;2017;07;22;Keskiviikko;5;10;15
95;26.07.2017;2017;07;23;Keskiviikko;5;2;7
95;27.07.2017;2017;07;00;Torstai;2;0;2
95;27.07.2017;2017;07;01;Torstai;1;2;3
95;27.07.2017;2017;07;02;Torstai;0;3;3
95;27.07.2017;2017;07;03;Torstai;0;1;1
95;27.07.2017;2017;07;04;Torstai;2;0;2
95;27.07.2017;2017;07;05;Torstai;5;2;7
95;27.07.2017;2017;07;06;Torstai;17;9;26
95;27.07.2017;2017;07;07;Torstai;29;13;42
95;27.07.2017;2017;07;08;Torstai;13;9;22
95;27.07.2017;2017;07;09;Torstai;6;15;21
95;27.07.2017;2017;07;10;Torstai;12;23;35
95;27.07.2017;2017;07;11;Torstai;28;24;52
95;27.07.2017;2017;07;12;Torstai;30;21;51
95;27.07.2017;2017;07;13;Torstai;28;25;53
95;27.07.2017;2017;07;14;Torstai;28;25;53
95;27.07.2017;2017;07;15;Torstai;28;38;66
95;27.07.2017;2017;07;16;Torstai;52;39;91
95;27.07.2017;2017;07;17;Torstai;23;27;50
95;27.07.2017;2017;07;18;Torstai;27;31;58
95;27.07.2017;2017;07;19;Torstai;19;17;36
95;27.07.2017;2017;07;20;Torstai;10;17;27
95;27.07.2017;2017;07;21;Torstai;9;12;21
95;27.07.2017;2017;07;22;Torstai;8;10;18
95;27.07.2017;2017;07;23;Torstai;2;5;7
95;28.07.2017;2017;07;00;Perjantai;0;3;3
95;28.07.2017;2017;07;01;Perjantai;3;0;3
95;28.07.2017;2017;07;02;Perjantai;1;0;1
95;28.07.2017;2017;07;03;Perjantai;0;0;0
95;28.07.2017;2017;07;04;Perjantai;1;3;4
95;28.07.2017;2017;07;05;Perjantai;5;3;8
95;28.07.2017;2017;07;06;Perjantai;14;6;20
95;28.07.2017;2017;07;07;Perjantai;15;9;24
95;28.07.2017;2017;07;08;Perjantai;11;8;19
95;28.07.2017;2017;07;09;Perjantai;13;11;24
95;28.07.2017;2017;07;10;Perjantai;15;7;22
95;28.07.2017;2017;07;11;Perjantai;16;21;37
95;28.07.2017;2017;07;12;Perjantai;20;23;43
95;28.07.2017;2017;07;13;Perjantai;38;22;60
95;28.07.2017;2017;07;14;Perjantai;26;23;49
95;28.07.2017;2017;07;15;Perjantai;36;22;58
95;28.07.2017;2017;07;16;Perjantai;30;17;47
95;28.07.2017;2017;07;17;Perjantai;18;23;41
95;28.07.2017;2017;07;18;Perjantai;18;19;37
95;28.07.2017;2017;07;19;Perjantai;18;10;28
95;28.07.2017;2017;07;20;Perjantai;17;24;41
95;28.07.2017;2017;07;21;Perjantai;8;10;18
95;28.07.2017;2017;07;22;Perjantai;2;6;8
95;28.07.2017;2017;07;23;Perjantai;3;2;5
95;29.07.2017;2017;07;00;Lauantai;0;14;14
95;29.07.2017;2017;07;01;Lauantai;0;14;14
95;29.07.2017;2017;07;02;Lauantai;1;7;8
95;29.07.2017;2017;07;03;Lauantai;0;8;8
95;29.07.2017;2017;07;04;Lauantai;0;7;7
95;29.07.2017;2017;07;05;Lauantai;1;2;3
95;29.07.2017;2017;07;06;Lauantai;2;1;3
95;29.07.2017;2017;07;07;Lauantai;4;3;7
95;29.07.2017;2017;07;08;Lauantai;7;3;10
95;29.07.2017;2017;07;09;Lauantai;8;8;16
95;29.07.2017;2017;07;10;Lauantai;5;7;12
95;29.07.2017;2017;07;11;Lauantai;4;5;9
95;29.07.2017;2017;07;12;Lauantai;7;5;12
95;29.07.2017;2017;07;13;Lauantai;12;8;20
95;29.07.2017;2017;07;14;Lauantai;15;5;20
95;29.07.2017;2017;07;15;Lauantai;11;15;26
95;29.07.2017;2017;07;16;Lauantai;12;8;20
95;29.07.2017;2017;07;17;Lauantai;12;12;24
95;29.07.2017;2017;07;18;Lauantai;9;9;18
95;29.07.2017;2017;07;19;Lauantai;23;7;30
95;29.07.2017;2017;07;20;Lauantai;9;5;14
95;29.07.2017;2017;07;21;Lauantai;3;7;10
95;29.07.2017;2017;07;22;Lauantai;6;4;10
95;29.07.2017;2017;07;23;Lauantai;3;4;7
95;30.07.2017;2017;07;00;Sunnuntai;0;4;4
95;30.07.2017;2017;07;01;Sunnuntai;0;14;14
95;30.07.2017;2017;07;02;Sunnuntai;2;2;4
95;30.07.2017;2017;07;03;Sunnuntai;0;3;3
95;30.07.2017;2017;07;04;Sunnuntai;0;6;6
95;30.07.2017;2017;07;05;Sunnuntai;2;0;2
95;30.07.2017;2017;07;06;Sunnuntai;2;5;7
95;30.07.2017;2017;07;07;Sunnuntai;3;8;11
95;30.07.2017;2017;07;08;Sunnuntai;8;2;10
95;30.07.2017;2017;07;09;Sunnuntai;13;7;20
95;30.07.2017;2017;07;10;Sunnuntai;12;21;33
95;30.07.2017;2017;07;11;Sunnuntai;28;24;52
95;30.07.2017;2017;07;12;Sunnuntai;58;24;82
95;30.07.2017;2017;07;13;Sunnuntai;43;29;72
95;30.07.2017;2017;07;14;Sunnuntai;27;39;66
95;30.07.2017;2017;07;15;Sunnuntai;24;40;64
95;30.07.2017;2017;07;16;Sunnuntai;23;32;55
95;30.07.2017;2017;07;17;Sunnuntai;20;34;54
95;30.07.2017;2017;07;18;Sunnuntai;15;22;37
95;30.07.2017;2017;07;19;Sunnuntai;33;30;63
95;30.07.2017;2017;07;20;Sunnuntai;18;9;27
95;30.07.2017;2017;07;21;Sunnuntai;3;8;11
95;30.07.2017;2017;07;22;Sunnuntai;3;10;13
95;30.07.2017;2017;07;23;Sunnuntai;1;0;1
95;31.07.2017;2017;07;00;Maanantai;0;0;0
95;31.07.2017;2017;07;01;Maanantai;1;0;1
95;31.07.2017;2017;07;02;Maanantai;0;0;0
95;31.07.2017;2017;07;03;Maanantai;0;0;0
95;31.07.2017;2017;07;04;Maanantai;0;0;0
95;31.07.2017;2017;07;05;Maanantai;5;5;10
95;31.07.2017;2017;07;06;Maanantai;21;9;30
95;31.07.2017;2017;07;07;Maanantai;20;19;39
95;31.07.2017;2017;07;08;Maanantai;15;11;26
95;31.07.2017;2017;07;09;Maanantai;14;8;22
95;31.07.2017;2017;07;10;Maanantai;16;11;27
95;31.07.2017;2017;07;11;Maanantai;14;9;23
95;31.07.2017;2017;07;12;Maanantai;25;16;41
95;31.07.2017;2017;07;13;Maanantai;21;16;37
95;31.07.2017;2017;07;14;Maanantai;36;20;56
95;31.07.2017;2017;07;15;Maanantai;25;37;62
95;31.07.2017;2017;07;16;Maanantai;41;39;80
95;31.07.2017;2017;07;17;Maanantai;35;33;68
95;31.07.2017;2017;07;18;Maanantai;26;43;69
95;31.07.2017;2017;07;19;Maanantai;7;22;29
95;31.07.2017;2017;07;20;Maanantai;9;19;28
95;31.07.2017;2017;07;21;Maanantai;7;10;17
95;31.07.2017;2017;07;22;Maanantai;3;10;13
95;31.07.2017;2017;07;23;Maanantai;0;5;5
95;01.08.2017;2017;08;00;Tiistai;0;0;0
95;01.08.2017;2017;08;01;Tiistai;1;0;1
95;01.08.2017;2017;08;02;Tiistai;0;0;0
95;01.08.2017;2017;08;03;Tiistai;1;2;3
95;01.08.2017;2017;08;04;Tiistai;0;0;0
95;01.08.2017;2017;08;05;Tiistai;3;5;8
95;01.08.2017;2017;08;06;Tiistai;15;8;23
95;01.08.2017;2017;08;07;Tiistai;28;16;44
95;01.08.2017;2017;08;08;Tiistai;14;14;28
95;01.08.2017;2017;08;09;Tiistai;16;12;28
95;01.08.2017;2017;08;10;Tiistai;19;12;31
95;01.08.2017;2017;08;11;Tiistai;17;11;28
95;01.08.2017;2017;08;12;Tiistai;22;13;35
95;01.08.2017;2017;08;13;Tiistai;28;24;52
95;01.08.2017;2017;08;14;Tiistai;19;24;43
95;01.08.2017;2017;08;15;Tiistai;27;30;57
95;01.08.2017;2017;08;16;Tiistai;38;40;78
95;01.08.2017;2017;08;17;Tiistai;14;32;46
95;01.08.2017;2017;08;18;Tiistai;24;16;40
95;01.08.2017;2017;08;19;Tiistai;18;24;42
95;01.08.2017;2017;08;20;Tiistai;14;13;27
95;01.08.2017;2017;08;21;Tiistai;8;19;27
95;01.08.2017;2017;08;22;Tiistai;6;3;9
95;01.08.2017;2017;08;23;Tiistai;1;1;2
95;02.08.2017;2017;08;00;Keskiviikko;3;0;3
95;02.08.2017;2017;08;01;Keskiviikko;0;0;0
95;02.08.2017;2017;08;02;Keskiviikko;1;1;2
95;02.08.2017;2017;08;03;Keskiviikko;0;0;0
95;02.08.2017;2017;08;04;Keskiviikko;0;0;0
95;02.08.2017;2017;08;05;Keskiviikko;3;6;9
95;02.08.2017;2017;08;06;Keskiviikko;22;11;33
95;02.08.2017;2017;08;07;Keskiviikko;25;20;45
95;02.08.2017;2017;08;08;Keskiviikko;17;9;26
95;02.08.2017;2017;08;09;Keskiviikko;16;8;24
95;02.08.2017;2017;08;10;Keskiviikko;23;14;37
95;02.08.2017;2017;08;11;Keskiviikko;26;28;54
95;02.08.2017;2017;08;12;Keskiviikko;23;20;43
95;02.08.2017;2017;08;13;Keskiviikko;21;17;38
95;02.08.2017;2017;08;14;Keskiviikko;15;15;30
95;02.08.2017;2017;08;15;Keskiviikko;29;28;57
95;02.08.2017;2017;08;16;Keskiviikko;37;36;73
95;02.08.2017;2017;08;17;Keskiviikko;20;35;55
95;02.08.2017;2017;08;18;Keskiviikko;20;25;45
95;02.08.2017;2017;08;19;Keskiviikko;21;29;50
95;02.08.2017;2017;08;20;Keskiviikko;11;18;29
95;02.08.2017;2017;08;21;Keskiviikko;12;22;34
95;02.08.2017;2017;08;22;Keskiviikko;2;4;6
95;02.08.2017;2017;08;23;Keskiviikko;3;1;4
95;03.08.2017;2017;08;00;Torstai;1;1;2
95;03.08.2017;2017;08;01;Torstai;0;0;0
95;03.08.2017;2017;08;02;Torstai;0;1;1
95;03.08.2017;2017;08;03;Torstai;0;0;0
95;03.08.2017;2017;08;04;Torstai;1;0;1
95;03.08.2017;2017;08;05;Torstai;5;6;11
95;03.08.2017;2017;08;06;Torstai;25;3;28
95;03.08.2017;2017;08;07;Torstai;22;12;34
95;03.08.2017;2017;08;08;Torstai;14;14;28
95;03.08.2017;2017;08;09;Torstai;18;6;24
95;03.08.2017;2017;08;10;Torstai;10;14;24
95;03.08.2017;2017;08;11;Torstai;16;13;29
95;03.08.2017;2017;08;12;Torstai;11;25;36
95;03.08.2017;2017;08;13;Torstai;16;18;34
95;03.08.2017;2017;08;14;Torstai;15;16;31
95;03.08.2017;2017;08;15;Torstai;31;31;62
95;03.08.2017;2017;08;16;Torstai;25;40;65
95;03.08.2017;2017;08;17;Torstai;23;30;53
95;03.08.2017;2017;08;18;Torstai;15;31;46
95;03.08.2017;2017;08;19;Torstai;21;19;40
95;03.08.2017;2017;08;20;Torstai;10;23;33
95;03.08.2017;2017;08;21;Torstai;9;14;23
95;03.08.2017;2017;08;22;Torstai;2;1;3
95;03.08.2017;2017;08;23;Torstai;2;1;3
95;04.08.2017;2017;08;00;Perjantai;0;0;0
95;04.08.2017;2017;08;01;Perjantai;0;0;0
95;04.08.2017;2017;08;02;Perjantai;0;0;0
95;04.08.2017;2017;08;03;Perjantai;0;1;1
95;04.08.2017;2017;08;04;Perjantai;1;0;1
95;04.08.2017;2017;08;05;Perjantai;2;4;6
95;04.08.2017;2017;08;06;Perjantai;16;7;23
95;04.08.2017;2017;08;07;Perjantai;22;10;32
95;04.08.2017;2017;08;08;Perjantai;17;13;30
95;04.08.2017;2017;08;09;Perjantai;15;10;25
95;04.08.2017;2017;08;10;Perjantai;19;9;28
95;04.08.2017;2017;08;11;Perjantai;14;16;30
95;04.08.2017;2017;08;12;Perjantai;23;13;36
95;04.08.2017;2017;08;13;Perjantai;20;19;39
95;04.08.2017;2017;08;14;Perjantai;21;15;36
95;04.08.2017;2017;08;15;Perjantai;21;37;58
95;04.08.2017;2017;08;16;Perjantai;29;40;69
95;04.08.2017;2017;08;17;Perjantai;12;27;39
95;04.08.2017;2017;08;18;Perjantai;10;16;26
95;04.08.2017;2017;08;19;Perjantai;15;16;31
95;04.08.2017;2017;08;20;Perjantai;24;20;44
95;04.08.2017;2017;08;21;Perjantai;9;12;21
95;04.08.2017;2017;08;22;Perjantai;3;9;12
95;04.08.2017;2017;08;23;Perjantai;1;3;4
95;05.08.2017;2017;08;00;Lauantai;1;3;4
95;05.08.2017;2017;08;01;Lauantai;0;0;0
95;05.08.2017;2017;08;02;Lauantai;1;2;3
95;05.08.2017;2017;08;03;Lauantai;1;0;1
95;05.08.2017;2017;08;04;Lauantai;0;0;0
95;05.08.2017;2017;08;05;Lauantai;1;2;3
95;05.08.2017;2017;08;06;Lauantai;3;0;3
95;05.08.2017;2017;08;07;Lauantai;4;5;9
95;05.08.2017;2017;08;08;Lauantai;6;6;12
95;05.08.2017;2017;08;09;Lauantai;7;5;12
95;05.08.2017;2017;08;10;Lauantai;5;6;11
95;05.08.2017;2017;08;11;Lauantai;5;11;16
95;05.08.2017;2017;08;12;Lauantai;17;17;34
95;05.08.2017;2017;08;13;Lauantai;13;27;40
95;05.08.2017;2017;08;14;Lauantai;19;14;33
95;05.08.2017;2017;08;15;Lauantai;9;16;25
95;05.08.2017;2017;08;16;Lauantai;8;13;21
95;05.08.2017;2017;08;17;Lauantai;6;7;13
95;05.08.2017;2017;08;18;Lauantai;2;2;4
95;05.08.2017;2017;08;19;Lauantai;2;3;5
95;05.08.2017;2017;08;20;Lauantai;2;2;4
95;05.08.2017;2017;08;21;Lauantai;0;8;8
95;05.08.2017;2017;08;22;Lauantai;0;4;4
95;05.08.2017;2017;08;23;Lauantai;0;2;2
95;06.08.2017;2017;08;00;Sunnuntai;0;0;0
95;06.08.2017;2017;08;01;Sunnuntai;0;2;2
95;06.08.2017;2017;08;02;Sunnuntai;1;1;2
95;06.08.2017;2017;08;03;Sunnuntai;1;0;1
95;06.08.2017;2017;08;04;Sunnuntai;0;1;1
95;06.08.2017;2017;08;05;Sunnuntai;0;0;0
95;06.08.2017;2017;08;06;Sunnuntai;3;1;4
95;06.08.2017;2017;08;07;Sunnuntai;4;1;5
95;06.08.2017;2017;08;08;Sunnuntai;6;6;12
95;06.08.2017;2017;08;09;Sunnuntai;10;5;15
95;06.08.2017;2017;08;10;Sunnuntai;4;13;17
95;06.08.2017;2017;08;11;Sunnuntai;15;17;32
95;06.08.2017;2017;08;12;Sunnuntai;10;7;17
95;06.08.2017;2017;08;13;Sunnuntai;12;9;21
95;06.08.2017;2017;08;14;Sunnuntai;10;8;18
95;06.08.2017;2017;08;15;Sunnuntai;6;9;15
95;06.08.2017;2017;08;16;Sunnuntai;8;3;11
95;06.08.2017;2017;08;17;Sunnuntai;4;11;15
95;06.08.2017;2017;08;18;Sunnuntai;10;9;19
95;06.08.2017;2017;08;19;Sunnuntai;9;10;19
95;06.08.2017;2017;08;20;Sunnuntai;10;6;16
95;06.08.2017;2017;08;21;Sunnuntai;2;5;7
95;06.08.2017;2017;08;22;Sunnuntai;3;3;6
95;06.08.2017;2017;08;23;Sunnuntai;1;1;2
95;07.08.2017;2017;08;00;Maanantai;1;0;1
95;07.08.2017;2017;08;01;Maanantai;0;0;0
95;07.08.2017;2017;08;02;Maanantai;0;0;0
95;07.08.2017;2017;08;03;Maanantai;0;1;1
95;07.08.2017;2017;08;04;Maanantai;1;1;2
95;07.08.2017;2017;08;05;Maanantai;3;4;7
95;07.08.2017;2017;08;06;Maanantai;22;8;30
95;07.08.2017;2017;08;07;Maanantai;17;20;37
95;07.08.2017;2017;08;08;Maanantai;12;10;22
95;07.08.2017;2017;08;09;Maanantai;12;8;20
95;07.08.2017;2017;08;10;Maanantai;13;14;27
95;07.08.2017;2017;08;11;Maanantai;14;20;34
95;07.08.2017;2017;08;12;Maanantai;11;8;19
95;07.08.2017;2017;08;13;Maanantai;20;12;32
95;07.08.2017;2017;08;14;Maanantai;13;9;22
95;07.08.2017;2017;08;15;Maanantai;19;27;46
95;07.08.2017;2017;08;16;Maanantai;30;49;79
95;07.08.2017;2017;08;17;Maanantai;17;23;40
95;07.08.2017;2017;08;18;Maanantai;14;25;39
95;07.08.2017;2017;08;19;Maanantai;27;19;46
95;07.08.2017;2017;08;20;Maanantai;32;12;44
95;07.08.2017;2017;08;21;Maanantai;4;10;14
95;07.08.2017;2017;08;22;Maanantai;3;2;5
95;07.08.2017;2017;08;23;Maanantai;0;2;2
95;08.08.2017;2017;08;00;Tiistai;0;0;0
95;08.08.2017;2017;08;01;Tiistai;0;0;0
95;08.08.2017;2017;08;02;Tiistai;0;0;0
95;08.08.2017;2017;08;03;Tiistai;0;0;0
95;08.08.2017;2017;08;04;Tiistai;1;0;1
95;08.08.2017;2017;08;05;Tiistai;5;8;13
95;08.08.2017;2017;08;06;Tiistai;34;7;41
95;08.08.2017;2017;08;07;Tiistai;30;23;53
95;08.08.2017;2017;08;08;Tiistai;14;15;29
95;08.08.2017;2017;08;09;Tiistai;14;11;25
95;08.08.2017;2017;08;10;Tiistai;10;18;28
95;08.08.2017;2017;08;11;Tiistai;11;11;22
95;08.08.2017;2017;08;12;Tiistai;26;23;49
95;08.08.2017;2017;08;13;Tiistai;18;19;37
95;08.08.2017;2017;08;14;Tiistai;24;15;39
95;08.08.2017;2017;08;15;Tiistai;34;15;49
95;08.08.2017;2017;08;16;Tiistai;35;51;86
95;08.08.2017;2017;08;17;Tiistai;14;32;46
95;08.08.2017;2017;08;18;Tiistai;16;16;32
95;08.08.2017;2017;08;19;Tiistai;10;9;19
95;08.08.2017;2017;08;20;Tiistai;6;12;18
95;08.08.2017;2017;08;21;Tiistai;0;8;8
95;08.08.2017;2017;08;22;Tiistai;2;5;7
95;08.08.2017;2017;08;23;Tiistai;2;0;2
95;09.08.2017;2017;08;00;Keskiviikko;0;1;1
95;09.08.2017;2017;08;01;Keskiviikko;0;0;0
95;09.08.2017;2017;08;02;Keskiviikko;0;1;1
95;09.08.2017;2017;08;03;Keskiviikko;0;0;0
95;09.08.2017;2017;08;04;Keskiviikko;0;0;0
95;09.08.2017;2017;08;05;Keskiviikko;9;6;15
95;09.08.2017;2017;08;06;Keskiviikko;20;7;27
95;09.08.2017;2017;08;07;Keskiviikko;36;23;59
95;09.08.2017;2017;08;08;Keskiviikko;13;27;40
95;09.08.2017;2017;08;09;Keskiviikko;9;6;15
95;09.08.2017;2017;08;10;Keskiviikko;12;8;20
95;09.08.2017;2017;08;11;Keskiviikko;11;15;26
95;09.08.2017;2017;08;12;Keskiviikko;14;10;24
95;09.08.2017;2017;08;13;Keskiviikko;22;15;37
95;09.08.2017;2017;08;14;Keskiviikko;22;24;46
95;09.08.2017;2017;08;15;Keskiviikko;40;31;71
95;09.08.2017;2017;08;16;Keskiviikko;41;43;84
95;09.08.2017;2017;08;17;Keskiviikko;20;35;55
95;09.08.2017;2017;08;18;Keskiviikko;24;36;60
95;09.08.2017;2017;08;19;Keskiviikko;8;25;33
95;09.08.2017;2017;08;20;Keskiviikko;13;19;32
95;09.08.2017;2017;08;21;Keskiviikko;6;16;22
95;09.08.2017;2017;08;22;Keskiviikko;2;6;8
95;09.08.2017;2017;08;23;Keskiviikko;5;3;8
95;10.08.2017;2017;08;00;Torstai;0;0;0
95;10.08.2017;2017;08;01;Torstai;0;1;1
95;10.08.2017;2017;08;02;Torstai;0;0;0
95;10.08.2017;2017;08;03;Torstai;0;0;0
95;10.08.2017;2017;08;04;Torstai;2;1;3
95;10.08.2017;2017;08;05;Torstai;4;6;10
95;10.08.2017;2017;08;06;Torstai;12;5;17
95;10.08.2017;2017;08;07;Torstai;13;12;25
95;10.08.2017;2017;08;08;Torstai;12;28;40
95;10.08.2017;2017;08;09;Torstai;19;5;24
95;10.08.2017;2017;08;10;Torstai;9;10;19
95;10.08.2017;2017;08;11;Torstai;4;8;12
95;10.08.2017;2017;08;12;Torstai;3;3;6
95;10.08.2017;2017;08;13;Torstai;9;5;14
95;10.08.2017;2017;08;14;Torstai;7;10;17
95;10.08.2017;2017;08;15;Torstai;15;10;25
95;10.08.2017;2017;08;16;Torstai;16;5;21
95;10.08.2017;2017;08;17;Torstai;9;14;23
95;10.08.2017;2017;08;18;Torstai;6;8;14
95;10.08.2017;2017;08;19;Torstai;8;10;18
95;10.08.2017;2017;08;20;Torstai;9;4;13
95;10.08.2017;2017;08;21;Torstai;3;4;7
95;10.08.2017;2017;08;22;Torstai;1;0;1
95;10.08.2017;2017;08;23;Torstai;0;0;0
95;11.08.2017;2017;08;00;Perjantai;2;0;2
95;11.08.2017;2017;08;01;Perjantai;0;0;0
95;11.08.2017;2017;08;02;Perjantai;0;0;0
95;11.08.2017;2017;08;03;Perjantai;0;0;0
95;11.08.2017;2017;08;04;Perjantai;3;0;3
95;11.08.2017;2017;08;05;Perjantai;3;6;9
95;11.08.2017;2017;08;06;Perjantai;22;8;30
95;11.08.2017;2017;08;07;Perjantai;28;28;56
95;11.08.2017;2017;08;08;Perjantai;6;23;29
95;11.08.2017;2017;08;09;Perjantai;13;9;22
95;11.08.2017;2017;08;10;Perjantai;9;9;18
95;11.08.2017;2017;08;11;Perjantai;16;17;33
95;11.08.2017;2017;08;12;Perjantai;9;11;20
95;11.08.2017;2017;08;13;Perjantai;42;11;53
95;11.08.2017;2017;08;14;Perjantai;23;19;42
95;11.08.2017;2017;08;15;Perjantai;21;27;48
95;11.08.2017;2017;08;16;Perjantai;19;31;50
95;11.08.2017;2017;08;17;Perjantai;16;17;33
95;11.08.2017;2017;08;18;Perjantai;12;11;23
95;11.08.2017;2017;08;19;Perjantai;15;16;31
95;11.08.2017;2017;08;20;Perjantai;18;7;25
95;11.08.2017;2017;08;21;Perjantai;12;8;20
95;11.08.2017;2017;08;22;Perjantai;2;3;5
95;11.08.2017;2017;08;23;Perjantai;4;0;4
95;12.08.2017;2017;08;00;Lauantai;0;3;3
95;12.08.2017;2017;08;01;Lauantai;0;4;4
95;12.08.2017;2017;08;02;Lauantai;0;0;0
95;12.08.2017;2017;08;03;Lauantai;0;0;0
95;12.08.2017;2017;08;04;Lauantai;0;0;0
95;12.08.2017;2017;08;05;Lauantai;2;1;3
95;12.08.2017;2017;08;06;Lauantai;1;0;1
95;12.08.2017;2017;08;07;Lauantai;5;7;12
95;12.08.2017;2017;08;08;Lauantai;8;12;20
95;12.08.2017;2017;08;09;Lauantai;19;12;31
95;12.08.2017;2017;08;10;Lauantai;19;15;34
95;12.08.2017;2017;08;11;Lauantai;31;21;52
95;12.08.2017;2017;08;12;Lauantai;26;16;42
95;12.08.2017;2017;08;13;Lauantai;30;22;52
95;12.08.2017;2017;08;14;Lauantai;30;20;50
95;12.08.2017;2017;08;15;Lauantai;32;18;50
95;12.08.2017;2017;08;16;Lauantai;14;18;32
95;12.08.2017;2017;08;17;Lauantai;15;28;43
95;12.08.2017;2017;08;18;Lauantai;9;11;20
95;12.08.2017;2017;08;19;Lauantai;13;16;29
95;12.08.2017;2017;08;20;Lauantai;9;12;21
95;12.08.2017;2017;08;21;Lauantai;1;6;7
95;12.08.2017;2017;08;22;Lauantai;2;4;6
95;12.08.2017;2017;08;23;Lauantai;1;0;1
95;13.08.2017;2017;08;00;Sunnuntai;1;4;5
95;13.08.2017;2017;08;01;Sunnuntai;0;2;2
95;13.08.2017;2017;08;02;Sunnuntai;0;0;0
95;13.08.2017;2017;08;03;Sunnuntai;0;1;1
95;13.08.2017;2017;08;04;Sunnuntai;0;0;0
95;13.08.2017;2017;08;05;Sunnuntai;0;0;0
95;13.08.2017;2017;08;06;Sunnuntai;2;0;2
95;13.08.2017;2017;08;07;Sunnuntai;1;0;1
95;13.08.2017;2017;08;08;Sunnuntai;4;1;5
95;13.08.2017;2017;08;09;Sunnuntai;5;3;8
95;13.08.2017;2017;08;10;Sunnuntai;8;5;13
95;13.08.2017;2017;08;11;Sunnuntai;3;6;9
95;13.08.2017;2017;08;12;Sunnuntai;3;2;5
95;13.08.2017;2017;08;13;Sunnuntai;3;3;6
95;13.08.2017;2017;08;14;Sunnuntai;2;3;5
95;13.08.2017;2017;08;15;Sunnuntai;4;5;9
95;13.08.2017;2017;08;16;Sunnuntai;6;2;8
95;13.08.2017;2017;08;17;Sunnuntai;5;7;12
95;13.08.2017;2017;08;18;Sunnuntai;4;5;9
95;13.08.2017;2017;08;19;Sunnuntai;8;9;17
95;13.08.2017;2017;08;20;Sunnuntai;6;9;15
95;13.08.2017;2017;08;21;Sunnuntai;8;3;11
95;13.08.2017;2017;08;22;Sunnuntai;0;1;1
95;13.08.2017;2017;08;23;Sunnuntai;1;1;2
95;14.08.2017;2017;08;00;Maanantai;1;0;1
95;14.08.2017;2017;08;01;Maanantai;0;0;0
95;14.08.2017;2017;08;02;Maanantai;0;0;0
95;14.08.2017;2017;08;03;Maanantai;0;0;0
95;14.08.2017;2017;08;04;Maanantai;2;0;2
95;14.08.2017;2017;08;05;Maanantai;9;3;12
95;14.08.2017;2017;08;06;Maanantai;23;12;35
95;14.08.2017;2017;08;07;Maanantai;19;29;48
95;14.08.2017;2017;08;08;Maanantai;12;23;35
95;14.08.2017;2017;08;09;Maanantai;14;23;37
95;14.08.2017;2017;08;10;Maanantai;7;9;16
95;14.08.2017;2017;08;11;Maanantai;11;6;17
95;14.08.2017;2017;08;12;Maanantai;9;7;16
95;14.08.2017;2017;08;13;Maanantai;10;8;18
95;14.08.2017;2017;08;14;Maanantai;21;10;31
95;14.08.2017;2017;08;15;Maanantai;27;12;39
95;14.08.2017;2017;08;16;Maanantai;39;33;72
95;14.08.2017;2017;08;17;Maanantai;19;21;40
95;14.08.2017;2017;08;18;Maanantai;2;14;16
95;14.08.2017;2017;08;19;Maanantai;14;12;26
95;14.08.2017;2017;08;20;Maanantai;3;15;18
95;14.08.2017;2017;08;21;Maanantai;5;11;16
95;14.08.2017;2017;08;22;Maanantai;7;6;13
95;14.08.2017;2017;08;23;Maanantai;1;2;3
95;15.08.2017;2017;08;00;Tiistai;0;0;0
95;15.08.2017;2017;08;01;Tiistai;0;0;0
95;15.08.2017;2017;08;02;Tiistai;2;0;2
95;15.08.2017;2017;08;03;Tiistai;0;1;1
95;15.08.2017;2017;08;04;Tiistai;1;0;1
95;15.08.2017;2017;08;05;Tiistai;12;4;16
95;15.08.2017;2017;08;06;Tiistai;24;12;36
95;15.08.2017;2017;08;07;Tiistai;37;42;79
95;15.08.2017;2017;08;08;Tiistai;15;19;34
95;15.08.2017;2017;08;09;Tiistai;8;15;23
95;15.08.2017;2017;08;10;Tiistai;8;11;19
95;15.08.2017;2017;08;11;Tiistai;16;6;22
95;15.08.2017;2017;08;12;Tiistai;17;7;24
95;15.08.2017;2017;08;13;Tiistai;13;10;23
95;15.08.2017;2017;08;14;Tiistai;19;16;35
95;15.08.2017;2017;08;15;Tiistai;32;24;56
95;15.08.2017;2017;08;16;Tiistai;41;44;85
95;15.08.2017;2017;08;17;Tiistai;17;22;39
95;15.08.2017;2017;08;18;Tiistai;21;19;40
95;15.08.2017;2017;08;19;Tiistai;19;17;36
95;15.08.2017;2017;08;20;Tiistai;9;19;28
95;15.08.2017;2017;08;21;Tiistai;4;9;13
95;15.08.2017;2017;08;22;Tiistai;4;3;7
95;15.08.2017;2017;08;23;Tiistai;2;3;5
95;16.08.2017;2017;08;00;Keskiviikko;0;0;0
95;16.08.2017;2017;08;01;Keskiviikko;0;0;0
95;16.08.2017;2017;08;02;Keskiviikko;1;0;1
95;16.08.2017;2017;08;03;Keskiviikko;0;1;1
95;16.08.2017;2017;08;04;Keskiviikko;1;1;2
95;16.08.2017;2017;08;05;Keskiviikko;6;6;12
95;16.08.2017;2017;08;06;Keskiviikko;25;12;37
95;16.08.2017;2017;08;07;Keskiviikko;33;48;81
95;16.08.2017;2017;08;08;Keskiviikko;22;24;46
95;16.08.2017;2017;08;09;Keskiviikko;12;11;23
95;16.08.2017;2017;08;10;Keskiviikko;24;12;36
95;16.08.2017;2017;08;11;Keskiviikko;17;23;40
95;16.08.2017;2017;08;12;Keskiviikko;21;15;36
95;16.08.2017;2017;08;13;Keskiviikko;25;20;45
95;16.08.2017;2017;08;14;Keskiviikko;29;19;48
95;16.08.2017;2017;08;15;Keskiviikko;36;33;69
95;16.08.2017;2017;08;16;Keskiviikko;42;45;87
95;16.08.2017;2017;08;17;Keskiviikko;16;26;42
95;16.08.2017;2017;08;18;Keskiviikko;9;26;35
95;16.08.2017;2017;08;19;Keskiviikko;18;15;33
95;16.08.2017;2017;08;20;Keskiviikko;19;15;34
95;16.08.2017;2017;08;21;Keskiviikko;4;8;12
95;16.08.2017;2017;08;22;Keskiviikko;9;2;11
95;16.08.2017;2017;08;23;Keskiviikko;1;1;2
95;17.08.2017;2017;08;00;Torstai;0;0;0
95;17.08.2017;2017;08;01;Torstai;0;0;0
95;17.08.2017;2017;08;02;Torstai;0;0;0
95;17.08.2017;2017;08;03;Torstai;0;1;1
95;17.08.2017;2017;08;04;Torstai;2;1;3
95;17.08.2017;2017;08;05;Torstai;5;4;9
95;17.08.2017;2017;08;06;Torstai;25;8;33
95;17.08.2017;2017;08;07;Torstai;29;36;65
95;17.08.2017;2017;08;08;Torstai;15;25;40
95;17.08.2017;2017;08;09;Torstai;11;13;24
95;17.08.2017;2017;08;10;Torstai;12;7;19
95;17.08.2017;2017;08;11;Torstai;14;15;29
95;17.08.2017;2017;08;12;Torstai;20;11;31
95;17.08.2017;2017;08;13;Torstai;16;20;36
95;17.08.2017;2017;08;14;Torstai;18;19;37
95;17.08.2017;2017;08;15;Torstai;30;29;59
95;17.08.2017;2017;08;16;Torstai;60;28;88
95;17.08.2017;2017;08;17;Torstai;18;20;38
95;17.08.2017;2017;08;18;Torstai;13;21;34
95;17.08.2017;2017;08;19;Torstai;12;17;29
95;17.08.2017;2017;08;20;Torstai;9;20;29
95;17.08.2017;2017;08;21;Torstai;12;14;26
95;17.08.2017;2017;08;22;Torstai;2;6;8
95;17.08.2017;2017;08;23;Torstai;0;0;0
95;18.08.2017;2017;08;00;Perjantai;0;3;3
95;18.08.2017;2017;08;01;Perjantai;0;0;0
95;18.08.2017;2017;08;02;Perjantai;0;0;0
95;18.08.2017;2017;08;03;Perjantai;0;0;0
95;18.08.2017;2017;08;04;Perjantai;1;1;2
95;18.08.2017;2017;08;05;Perjantai;2;3;5
95;18.08.2017;2017;08;06;Perjantai;22;5;27
95;18.08.2017;2017;08;07;Perjantai;25;30;55
95;18.08.2017;2017;08;08;Perjantai;9;18;27
95;18.08.2017;2017;08;09;Perjantai;12;13;25
95;18.08.2017;2017;08;10;Perjantai;12;8;20
95;18.08.2017;2017;08;11;Perjantai;23;11;34
95;18.08.2017;2017;08;12;Perjantai;29;13;42
95;18.08.2017;2017;08;13;Perjantai;25;14;39
95;18.08.2017;2017;08;14;Perjantai;23;17;40
95;18.08.2017;2017;08;15;Perjantai;12;38;50
95;18.08.2017;2017;08;16;Perjantai;21;18;39
95;18.08.2017;2017;08;17;Perjantai;11;18;29
95;18.08.2017;2017;08;18;Perjantai;13;17;30
95;18.08.2017;2017;08;19;Perjantai;8;6;14
95;18.08.2017;2017;08;20;Perjantai;11;7;18
95;18.08.2017;2017;08;21;Perjantai;1;3;4
95;18.08.2017;2017;08;22;Perjantai;1;4;5
95;18.08.2017;2017;08;23;Perjantai;0;0;0
95;19.08.2017;2017;08;00;Lauantai;0;0;0
95;19.08.2017;2017;08;01;Lauantai;4;0;4
95;19.08.2017;2017;08;02;Lauantai;0;0;0
95;19.08.2017;2017;08;03;Lauantai;1;1;2
95;19.08.2017;2017;08;04;Lauantai;0;0;0
95;19.08.2017;2017;08;05;Lauantai;1;1;2
95;19.08.2017;2017;08;06;Lauantai;1;0;1
95;19.08.2017;2017;08;07;Lauantai;4;2;6
95;19.08.2017;2017;08;08;Lauantai;4;3;7
95;19.08.2017;2017;08;09;Lauantai;6;9;15
95;19.08.2017;2017;08;10;Lauantai;16;4;20
95;19.08.2017;2017;08;11;Lauantai;8;9;17
95;19.08.2017;2017;08;12;Lauantai;21;20;41
95;19.08.2017;2017;08;13;Lauantai;26;24;50
95;19.08.2017;2017;08;14;Lauantai;18;18;36
95;19.08.2017;2017;08;15;Lauantai;15;12;27
95;19.08.2017;2017;08;16;Lauantai;17;19;36
95;19.08.2017;2017;08;17;Lauantai;8;13;21
95;19.08.2017;2017;08;18;Lauantai;8;25;33
95;19.08.2017;2017;08;19;Lauantai;1;6;7
95;19.08.2017;2017;08;20;Lauantai;3;2;5
95;19.08.2017;2017;08;21;Lauantai;1;4;5
95;19.08.2017;2017;08;22;Lauantai;2;0;2
95;19.08.2017;2017;08;23;Lauantai;0;2;2
95;20.08.2017;2017;08;00;Sunnuntai;0;1;1
95;20.08.2017;2017;08;01;Sunnuntai;2;1;3
95;20.08.2017;2017;08;02;Sunnuntai;0;1;1
95;20.08.2017;2017;08;03;Sunnuntai;0;0;0
95;20.08.2017;2017;08;04;Sunnuntai;1;0;1
95;20.08.2017;2017;08;05;Sunnuntai;1;0;1
95;20.08.2017;2017;08;06;Sunnuntai;1;3;4
95;20.08.2017;2017;08;07;Sunnuntai;8;2;10
95;20.08.2017;2017;08;08;Sunnuntai;3;11;14
95;20.08.2017;2017;08;09;Sunnuntai;18;8;26
95;20.08.2017;2017;08;10;Sunnuntai;12;18;30
95;20.08.2017;2017;08;11;Sunnuntai;11;29;40
95;20.08.2017;2017;08;12;Sunnuntai;34;10;44
95;20.08.2017;2017;08;13;Sunnuntai;16;5;21
95;20.08.2017;2017;08;14;Sunnuntai;9;12;21
95;20.08.2017;2017;08;15;Sunnuntai;10;10;20
95;20.08.2017;2017;08;16;Sunnuntai;10;7;17
95;20.08.2017;2017;08;17;Sunnuntai;4;14;18
95;20.08.2017;2017;08;18;Sunnuntai;13;12;25
95;20.08.2017;2017;08;19;Sunnuntai;16;4;20
95;20.08.2017;2017;08;20;Sunnuntai;6;7;13
95;20.08.2017;2017;08;21;Sunnuntai;3;6;9
95;20.08.2017;2017;08;22;Sunnuntai;4;2;6
95;20.08.2017;2017;08;23;Sunnuntai;2;0;2
95;21.08.2017;2017;08;00;Maanantai;0;0;0
95;21.08.2017;2017;08;01;Maanantai;0;0;0
95;21.08.2017;2017;08;02;Maanantai;1;0;1
95;21.08.2017;2017;08;03;Maanantai;1;0;1
95;21.08.2017;2017;08;04;Maanantai;1;1;2
95;21.08.2017;2017;08;05;Maanantai;7;5;12
95;21.08.2017;2017;08;06;Maanantai;24;11;35
95;21.08.2017;2017;08;07;Maanantai;23;31;54
95;21.08.2017;2017;08;08;Maanantai;9;22;31
95;21.08.2017;2017;08;09;Maanantai;11;15;26
95;21.08.2017;2017;08;10;Maanantai;6;7;13
95;21.08.2017;2017;08;11;Maanantai;11;6;17
95;21.08.2017;2017;08;12;Maanantai;5;13;18
95;21.08.2017;2017;08;13;Maanantai;8;9;17
95;21.08.2017;2017;08;14;Maanantai;25;13;38
95;21.08.2017;2017;08;15;Maanantai;36;22;58
95;21.08.2017;2017;08;16;Maanantai;41;35;76
95;21.08.2017;2017;08;17;Maanantai;20;16;36
95;21.08.2017;2017;08;18;Maanantai;11;29;40
95;21.08.2017;2017;08;19;Maanantai;7;7;14
95;21.08.2017;2017;08;20;Maanantai;8;5;13
95;21.08.2017;2017;08;21;Maanantai;2;6;8
95;21.08.2017;2017;08;22;Maanantai;3;2;5
95;21.08.2017;2017;08;23;Maanantai;5;0;5
95;22.08.2017;2017;08;00;Tiistai;0;0;0
95;22.08.2017;2017;08;01;Tiistai;0;1;1
95;22.08.2017;2017;08;02;Tiistai;1;0;1
95;22.08.2017;2017;08;03;Tiistai;1;0;1
95;22.08.2017;2017;08;04;Tiistai;1;0;1
95;22.08.2017;2017;08;05;Tiistai;8;5;13
95;22.08.2017;2017;08;06;Tiistai;19;11;30
95;22.08.2017;2017;08;07;Tiistai;23;36;59
95;22.08.2017;2017;08;08;Tiistai;14;22;36
95;22.08.2017;2017;08;09;Tiistai;11;10;21
95;22.08.2017;2017;08;10;Tiistai;7;7;14
95;22.08.2017;2017;08;11;Tiistai;10;4;14
95;22.08.2017;2017;08;12;Tiistai;5;3;8
95;22.08.2017;2017;08;13;Tiistai;12;7;19
95;22.08.2017;2017;08;14;Tiistai;14;7;21
95;22.08.2017;2017;08;15;Tiistai;22;19;41
95;22.08.2017;2017;08;16;Tiistai;31;34;65
95;22.08.2017;2017;08;17;Tiistai;13;19;32
95;22.08.2017;2017;08;18;Tiistai;12;18;30
95;22.08.2017;2017;08;19;Tiistai;13;13;26
95;22.08.2017;2017;08;20;Tiistai;9;11;20
95;22.08.2017;2017;08;21;Tiistai;1;2;3
95;22.08.2017;2017;08;22;Tiistai;1;1;2
95;22.08.2017;2017;08;23;Tiistai;1;1;2
95;23.08.2017;2017;08;00;Keskiviikko;0;0;0
95;23.08.2017;2017;08;01;Keskiviikko;0;0;0
95;23.08.2017;2017;08;02;Keskiviikko;0;0;0
95;23.08.2017;2017;08;03;Keskiviikko;0;2;2
95;23.08.2017;2017;08;04;Keskiviikko;2;0;2
95;23.08.2017;2017;08;05;Keskiviikko;6;7;13
95;23.08.2017;2017;08;06;Keskiviikko;20;12;32
95;23.08.2017;2017;08;07;Keskiviikko;37;29;66
95;23.08.2017;2017;08;08;Keskiviikko;13;24;37
95;23.08.2017;2017;08;09;Keskiviikko;6;13;19
95;23.08.2017;2017;08;10;Keskiviikko;6;7;13
95;23.08.2017;2017;08;11;Keskiviikko;11;10;21
95;23.08.2017;2017;08;12;Keskiviikko;14;9;23
95;23.08.2017;2017;08;13;Keskiviikko;12;8;20
95;23.08.2017;2017;08;14;Keskiviikko;29;13;42
95;23.08.2017;2017;08;15;Keskiviikko;20;25;45
95;23.08.2017;2017;08;16;Keskiviikko;30;32;62
95;23.08.2017;2017;08;17;Keskiviikko;18;19;37
95;23.08.2017;2017;08;18;Keskiviikko;14;20;34
95;23.08.2017;2017;08;19;Keskiviikko;15;15;30
95;23.08.2017;2017;08;20;Keskiviikko;6;7;13
95;23.08.2017;2017;08;21;Keskiviikko;4;11;15
95;23.08.2017;2017;08;22;Keskiviikko;0;1;1
95;23.08.2017;2017;08;23;Keskiviikko;0;0;0
95;24.08.2017;2017;08;00;Torstai;0;0;0
95;24.08.2017;2017;08;01;Torstai;0;2;2
95;24.08.2017;2017;08;02;Torstai;0;0;0
95;24.08.2017;2017;08;03;Torstai;0;0;0
95;24.08.2017;2017;08;04;Torstai;1;0;1
95;24.08.2017;2017;08;05;Torstai;2;3;5
95;24.08.2017;2017;08;06;Torstai;20;9;29
95;24.08.2017;2017;08;07;Torstai;32;30;62
95;24.08.2017;2017;08;08;Torstai;14;18;32
95;24.08.2017;2017;08;09;Torstai;11;14;25
95;24.08.2017;2017;08;10;Torstai;10;4;14
95;24.08.2017;2017;08;11;Torstai;6;10;16
95;24.08.2017;2017;08;12;Torstai;19;11;30
95;24.08.2017;2017;08;13;Torstai;8;9;17
95;24.08.2017;2017;08;14;Torstai;16;18;34
95;24.08.2017;2017;08;15;Torstai;17;23;40
95;24.08.2017;2017;08;16;Torstai;40;33;73
95;24.08.2017;2017;08;17;Torstai;11;13;24
95;24.08.2017;2017;08;18;Torstai;6;18;24
95;24.08.2017;2017;08;19;Torstai;15;11;26
95;24.08.2017;2017;08;20;Torstai;6;13;19
95;24.08.2017;2017;08;21;Torstai;5;6;11
95;24.08.2017;2017;08;22;Torstai;0;1;1
95;24.08.2017;2017;08;23;Torstai;0;1;1
95;25.08.2017;2017;08;00;Perjantai;0;0;0
95;25.08.2017;2017;08;01;Perjantai;0;1;1
95;25.08.2017;2017;08;02;Perjantai;0;0;0
95;25.08.2017;2017;08;03;Perjantai;0;0;0
95;25.08.2017;2017;08;04;Perjantai;1;0;1
95;25.08.2017;2017;08;05;Perjantai;6;5;11
95;25.08.2017;2017;08;06;Perjantai;14;4;18
95;25.08.2017;2017;08;07;Perjantai;15;19;34
95;25.08.2017;2017;08;08;Perjantai;9;9;18
95;25.08.2017;2017;08;09;Perjantai;4;5;9
95;25.08.2017;2017;08;10;Perjantai;3;2;5
95;25.08.2017;2017;08;11;Perjantai;3;5;8
95;25.08.2017;2017;08;12;Perjantai;1;6;7
95;25.08.2017;2017;08;13;Perjantai;10;3;13
95;25.08.2017;2017;08;14;Perjantai;10;11;21
95;25.08.2017;2017;08;15;Perjantai;14;9;23
95;25.08.2017;2017;08;16;Perjantai;10;9;19
95;25.08.2017;2017;08;17;Perjantai;2;7;9
95;25.08.2017;2017;08;18;Perjantai;1;5;6
95;25.08.2017;2017;08;19;Perjantai;1;4;5
95;25.08.2017;2017;08;20;Perjantai;1;1;2
95;25.08.2017;2017;08;21;Perjantai;2;1;3
95;25.08.2017;2017;08;22;Perjantai;0;1;1
95;25.08.2017;2017;08;23;Perjantai;1;1;2
95;26.08.2017;2017;08;00;Lauantai;0;0;0
95;26.08.2017;2017;08;01;Lauantai;4;0;4
95;26.08.2017;2017;08;02;Lauantai;0;0;0
95;26.08.2017;2017;08;03;Lauantai;0;1;1
95;26.08.2017;2017;08;04;Lauantai;1;0;1
95;26.08.2017;2017;08;05;Lauantai;0;1;1
95;26.08.2017;2017;08;06;Lauantai;0;1;1
95;26.08.2017;2017;08;07;Lauantai;1;1;2
95;26.08.2017;2017;08;08;Lauantai;2;1;3
95;26.08.2017;2017;08;09;Lauantai;0;3;3
95;26.08.2017;2017;08;10;Lauantai;4;1;5
95;26.08.2017;2017;08;11;Lauantai;1;5;6
95;26.08.2017;2017;08;12;Lauantai;8;6;14
95;26.08.2017;2017;08;13;Lauantai;14;10;24
95;26.08.2017;2017;08;14;Lauantai;12;15;27
95;26.08.2017;2017;08;15;Lauantai;8;7;15
95;26.08.2017;2017;08;16;Lauantai;8;12;20
95;26.08.2017;2017;08;17;Lauantai;6;13;19
95;26.08.2017;2017;08;18;Lauantai;11;2;13
95;26.08.2017;2017;08;19;Lauantai;8;11;19
95;26.08.2017;2017;08;20;Lauantai;9;2;11
95;26.08.2017;2017;08;21;Lauantai;4;10;14
95;26.08.2017;2017;08;22;Lauantai;0;0;0
95;26.08.2017;2017;08;23;Lauantai;0;0;0
95;27.08.2017;2017;08;00;Sunnuntai;0;1;1
95;27.08.2017;2017;08;01;Sunnuntai;0;4;4
95;27.08.2017;2017;08;02;Sunnuntai;0;1;1
95;27.08.2017;2017;08;03;Sunnuntai;0;0;0
95;27.08.2017;2017;08;04;Sunnuntai;0;0;0
95;27.08.2017;2017;08;05;Sunnuntai;0;0;0
95;27.08.2017;2017;08;06;Sunnuntai;1;0;1
95;27.08.2017;2017;08;07;Sunnuntai;1;4;5
95;27.08.2017;2017;08;08;Sunnuntai;5;2;7
95;27.08.2017;2017;08;09;Sunnuntai;13;7;20
95;27.08.2017;2017;08;10;Sunnuntai;4;3;7
95;27.08.2017;2017;08;11;Sunnuntai;12;8;20
95;27.08.2017;2017;08;12;Sunnuntai;7;9;16
95;27.08.2017;2017;08;13;Sunnuntai;14;13;27
95;27.08.2017;2017;08;14;Sunnuntai;9;11;20
95;27.08.2017;2017;08;15;Sunnuntai;12;12;24
95;27.08.2017;2017;08;16;Sunnuntai;9;8;17
95;27.08.2017;2017;08;17;Sunnuntai;10;13;23
95;27.08.2017;2017;08;18;Sunnuntai;11;11;22
95;27.08.2017;2017;08;19;Sunnuntai;7;11;18
95;27.08.2017;2017;08;20;Sunnuntai;6;3;9
95;27.08.2017;2017;08;21;Sunnuntai;4;3;7
95;27.08.2017;2017;08;22;Sunnuntai;0;1;1
95;27.08.2017;2017;08;23;Sunnuntai;0;0;0
95;28.08.2017;2017;08;00;Maanantai;1;1;2
95;28.08.2017;2017;08;01;Maanantai;0;0;0
95;28.08.2017;2017;08;02;Maanantai;0;1;1
95;28.08.2017;2017;08;03;Maanantai;1;0;1
95;28.08.2017;2017;08;04;Maanantai;0;0;0
95;28.08.2017;2017;08;05;Maanantai;7;1;8
95;28.08.2017;2017;08;06;Maanantai;17;12;29
95;28.08.2017;2017;08;07;Maanantai;16;26;42
95;28.08.2017;2017;08;08;Maanantai;14;18;32
95;28.08.2017;2017;08;09;Maanantai;19;11;30
95;28.08.2017;2017;08;10;Maanantai;12;3;15
95;28.08.2017;2017;08;11;Maanantai;13;11;24
95;28.08.2017;2017;08;12;Maanantai;9;10;19
95;28.08.2017;2017;08;13;Maanantai;13;4;17
95;28.08.2017;2017;08;14;Maanantai;25;17;42
95;28.08.2017;2017;08;15;Maanantai;24;30;54
95;28.08.2017;2017;08;16;Maanantai;29;29;58
95;28.08.2017;2017;08;17;Maanantai;22;27;49
95;28.08.2017;2017;08;18;Maanantai;12;19;31
95;28.08.2017;2017;08;19;Maanantai;9;16;25
95;28.08.2017;2017;08;20;Maanantai;5;8;13
95;28.08.2017;2017;08;21;Maanantai;1;8;9
95;28.08.2017;2017;08;22;Maanantai;1;3;4
95;28.08.2017;2017;08;23;Maanantai;0;0;0
95;29.08.2017;2017;08;00;Tiistai;0;0;0
95;29.08.2017;2017;08;01;Tiistai;0;1;1
95;29.08.2017;2017;08;02;Tiistai;0;0;0
95;29.08.2017;2017;08;03;Tiistai;0;0;0
95;29.08.2017;2017;08;04;Tiistai;0;0;0
95;29.08.2017;2017;08;05;Tiistai;6;4;10
95;29.08.2017;2017;08;06;Tiistai;24;10;34
95;29.08.2017;2017;08;07;Tiistai;29;36;65
95;29.08.2017;2017;08;08;Tiistai;15;20;35
95;29.08.2017;2017;08;09;Tiistai;12;7;19
95;29.08.2017;2017;08;10;Tiistai;8;7;15
95;29.08.2017;2017;08;11;Tiistai;17;8;25
95;29.08.2017;2017;08;12;Tiistai;10;11;21
95;29.08.2017;2017;08;13;Tiistai;8;6;14
95;29.08.2017;2017;08;14;Tiistai;18;9;27
95;29.08.2017;2017;08;15;Tiistai;18;17;35
95;29.08.2017;2017;08;16;Tiistai;13;20;33
95;29.08.2017;2017;08;17;Tiistai;4;8;12
95;29.08.2017;2017;08;18;Tiistai;4;7;11
95;29.08.2017;2017;08;19;Tiistai;0;5;5
95;29.08.2017;2017;08;20;Tiistai;2;3;5
95;29.08.2017;2017;08;21;Tiistai;1;7;8
95;29.08.2017;2017;08;22;Tiistai;1;2;3
95;29.08.2017;2017;08;23;Tiistai;0;0;0
95;30.08.2017;2017;08;00;Keskiviikko;3;0;3
95;30.08.2017;2017;08;01;Keskiviikko;0;0;0
95;30.08.2017;2017;08;02;Keskiviikko;1;0;1
95;30.08.2017;2017;08;03;Keskiviikko;0;0;0
95;30.08.2017;2017;08;04;Keskiviikko;0;0;0
95;30.08.2017;2017;08;05;Keskiviikko;4;2;6
95;30.08.2017;2017;08;06;Keskiviikko;2;5;7
95;30.08.2017;2017;08;07;Keskiviikko;10;14;24
95;30.08.2017;2017;08;08;Keskiviikko;9;12;21
95;30.08.2017;2017;08;09;Keskiviikko;5;4;9
95;30.08.2017;2017;08;10;Keskiviikko;2;4;6
95;30.08.2017;2017;08;11;Keskiviikko;1;1;2
95;30.08.2017;2017;08;12;Keskiviikko;2;1;3
95;30.08.2017;2017;08;13;Keskiviikko;10;4;14
95;30.08.2017;2017;08;14;Keskiviikko;15;11;26
95;30.08.2017;2017;08;15;Keskiviikko;14;14;28
95;30.08.2017;2017;08;16;Keskiviikko;16;11;27
95;30.08.2017;2017;08;17;Keskiviikko;12;19;31
95;30.08.2017;2017;08;18;Keskiviikko;19;17;36
95;30.08.2017;2017;08;19;Keskiviikko;9;15;24
95;30.08.2017;2017;08;20;Keskiviikko;8;11;19
95;30.08.2017;2017;08;21;Keskiviikko;6;5;11
95;30.08.2017;2017;08;22;Keskiviikko;1;1;2
95;30.08.2017;2017;08;23;Keskiviikko;0;0;0
95;31.08.2017;2017;08;00;Torstai;1;0;1
95;31.08.2017;2017;08;01;Torstai;0;0;0
95;31.08.2017;2017;08;02;Torstai;0;0;0
95;31.08.2017;2017;08;03;Torstai;0;1;1
95;31.08.2017;2017;08;04;Torstai;1;0;1
95;31.08.2017;2017;08;05;Torstai;7;5;12
95;31.08.2017;2017;08;06;Torstai;24;6;30
95;31.08.2017;2017;08;07;Torstai;36;33;69
95;31.08.2017;2017;08;08;Torstai;17;11;28
95;31.08.2017;2017;08;09;Torstai;14;21;35
95;31.08.2017;2017;08;10;Torstai;9;13;22
95;31.08.2017;2017;08;11;Torstai;10;21;31
95;31.08.2017;2017;08;12;Torstai;13;9;22
95;31.08.2017;2017;08;13;Torstai;15;20;35
95;31.08.2017;2017;08;14;Torstai;15;12;27
95;31.08.2017;2017;08;15;Torstai;37;36;73
95;31.08.2017;2017;08;16;Torstai;43;37;80
95;31.08.2017;2017;08;17;Torstai;11;25;36
95;31.08.2017;2017;08;18;Torstai;15;27;42
95;31.08.2017;2017;08;19;Torstai;7;17;24
95;31.08.2017;2017;08;20;Torstai;11;9;20
95;31.08.2017;2017;08;21;Torstai;2;8;10
95;31.08.2017;2017;08;22;Torstai;3;0;3
95;31.08.2017;2017;08;23;Torstai;1;0;1
95;01.09.2017;2017;09;00;Perjantai;1;0;1
95;01.09.2017;2017;09;01;Perjantai;0;0;0
95;01.09.2017;2017;09;02;Perjantai;1;0;1
95;01.09.2017;2017;09;03;Perjantai;0;0;0
95;01.09.2017;2017;09;04;Perjantai;0;0;0
95;01.09.2017;2017;09;05;Perjantai;4;3;7
95;01.09.2017;2017;09;06;Perjantai;4;2;6
95;01.09.2017;2017;09;07;Perjantai;9;12;21
95;01.09.2017;2017;09;08;Perjantai;5;4;9
95;01.09.2017;2017;09;09;Perjantai;4;2;6
95;01.09.2017;2017;09;10;Perjantai;2;2;4
95;01.09.2017;2017;09;11;Perjantai;3;3;6
95;01.09.2017;2017;09;12;Perjantai;2;3;5
95;01.09.2017;2017;09;13;Perjantai;4;2;6
95;01.09.2017;2017;09;14;Perjantai;5;5;10
95;01.09.2017;2017;09;15;Perjantai;7;11;18
95;01.09.2017;2017;09;16;Perjantai;6;7;13
95;01.09.2017;2017;09;17;Perjantai;5;8;13
95;01.09.2017;2017;09;18;Perjantai;2;8;10
95;01.09.2017;2017;09;19;Perjantai;2;5;7
95;01.09.2017;2017;09;20;Perjantai;2;4;6
95;01.09.2017;2017;09;21;Perjantai;1;1;2
95;01.09.2017;2017;09;22;Perjantai;1;0;1
95;01.09.2017;2017;09;23;Perjantai;0;0;0
95;02.09.2017;2017;09;00;Lauantai;0;1;1
95;02.09.2017;2017;09;01;Lauantai;0;3;3
95;02.09.2017;2017;09;02;Lauantai;1;2;3
95;02.09.2017;2017;09;03;Lauantai;0;0;0
95;02.09.2017;2017;09;04;Lauantai;0;0;0
95;02.09.2017;2017;09;05;Lauantai;2;0;2
95;02.09.2017;2017;09;06;Lauantai;1;0;1
95;02.09.2017;2017;09;07;Lauantai;2;2;4
95;02.09.2017;2017;09;08;Lauantai;7;2;9
95;02.09.2017;2017;09;09;Lauantai;11;9;20
95;02.09.2017;2017;09;10;Lauantai;4;16;20
95;02.09.2017;2017;09;11;Lauantai;16;6;22
95;02.09.2017;2017;09;12;Lauantai;9;15;24
95;02.09.2017;2017;09;13;Lauantai;17;14;31
95;02.09.2017;2017;09;14;Lauantai;12;14;26
95;02.09.2017;2017;09;15;Lauantai;24;17;41
95;02.09.2017;2017;09;16;Lauantai;16;17;33
95;02.09.2017;2017;09;17;Lauantai;11;14;25
95;02.09.2017;2017;09;18;Lauantai;9;12;21
95;02.09.2017;2017;09;19;Lauantai;6;8;14
95;02.09.2017;2017;09;20;Lauantai;3;7;10
95;02.09.2017;2017;09;21;Lauantai;1;4;5
95;02.09.2017;2017;09;22;Lauantai;2;2;4
95;02.09.2017;2017;09;23;Lauantai;0;1;1
95;03.09.2017;2017;09;00;Sunnuntai;0;2;2
95;03.09.2017;2017;09;01;Sunnuntai;0;2;2
95;03.09.2017;2017;09;02;Sunnuntai;1;1;2
95;03.09.2017;2017;09;03;Sunnuntai;0;1;1
95;03.09.2017;2017;09;04;Sunnuntai;0;0;0
95;03.09.2017;2017;09;05;Sunnuntai;0;1;1
95;03.09.2017;2017;09;06;Sunnuntai;1;2;3
95;03.09.2017;2017;09;07;Sunnuntai;2;6;8
95;03.09.2017;2017;09;08;Sunnuntai;1;4;5
95;03.09.2017;2017;09;09;Sunnuntai;11;3;14
95;03.09.2017;2017;09;10;Sunnuntai;8;33;41
95;03.09.2017;2017;09;11;Sunnuntai;13;13;26
95;03.09.2017;2017;09;12;Sunnuntai;12;9;21
95;03.09.2017;2017;09;13;Sunnuntai;37;16;53
95;03.09.2017;2017;09;14;Sunnuntai;16;15;31
95;03.09.2017;2017;09;15;Sunnuntai;18;12;30
95;03.09.2017;2017;09;16;Sunnuntai;24;23;47
95;03.09.2017;2017;09;17;Sunnuntai;21;22;43
95;03.09.2017;2017;09;18;Sunnuntai;19;13;32
95;03.09.2017;2017;09;19;Sunnuntai;17;13;30
95;03.09.2017;2017;09;20;Sunnuntai;7;10;17
95;03.09.2017;2017;09;21;Sunnuntai;1;6;7
95;03.09.2017;2017;09;22;Sunnuntai;1;2;3
95;03.09.2017;2017;09;23;Sunnuntai;1;0;1
95;04.09.2017;2017;09;00;Maanantai;1;1;2
95;04.09.2017;2017;09;01;Maanantai;0;0;0
95;04.09.2017;2017;09;02;Maanantai;0;0;0
95;04.09.2017;2017;09;03;Maanantai;0;0;0
95;04.09.2017;2017;09;04;Maanantai;0;0;0
95;04.09.2017;2017;09;05;Maanantai;9;3;12
95;04.09.2017;2017;09;06;Maanantai;20;14;34
95;04.09.2017;2017;09;07;Maanantai;23;23;46
95;04.09.2017;2017;09;08;Maanantai;16;15;31
95;04.09.2017;2017;09;09;Maanantai;11;21;32
95;04.09.2017;2017;09;10;Maanantai;20;12;32
95;04.09.2017;2017;09;11;Maanantai;18;11;29
95;04.09.2017;2017;09;12;Maanantai;13;6;19
95;04.09.2017;2017;09;13;Maanantai;15;17;32
95;04.09.2017;2017;09;14;Maanantai;22;18;40
95;04.09.2017;2017;09;15;Maanantai;28;25;53
95;04.09.2017;2017;09;16;Maanantai;43;33;76
95;04.09.2017;2017;09;17;Maanantai;18;16;34
95;04.09.2017;2017;09;18;Maanantai;20;17;37
95;04.09.2017;2017;09;19;Maanantai;14;14;28
95;04.09.2017;2017;09;20;Maanantai;12;11;23
95;04.09.2017;2017;09;21;Maanantai;2;5;7
95;04.09.2017;2017;09;22;Maanantai;2;4;6
95;04.09.2017;2017;09;23;Maanantai;0;2;2
95;05.09.2017;2017;09;00;Tiistai;0;1;1
95;05.09.2017;2017;09;01;Tiistai;0;1;1
95;05.09.2017;2017;09;02;Tiistai;3;0;3
95;05.09.2017;2017;09;03;Tiistai;1;0;1
95;05.09.2017;2017;09;04;Tiistai;4;0;4
95;05.09.2017;2017;09;05;Tiistai;6;5;11
95;05.09.2017;2017;09;06;Tiistai;24;8;32
95;05.09.2017;2017;09;07;Tiistai;27;29;56
95;05.09.2017;2017;09;08;Tiistai;17;28;45
95;05.09.2017;2017;09;09;Tiistai;10;6;16
95;05.09.2017;2017;09;10;Tiistai;10;13;23
95;05.09.2017;2017;09;11;Tiistai;14;7;21
95;05.09.2017;2017;09;12;Tiistai;19;9;28
95;05.09.2017;2017;09;13;Tiistai;18;18;36
95;05.09.2017;2017;09;14;Tiistai;25;18;43
95;05.09.2017;2017;09;15;Tiistai;23;32;55
95;05.09.2017;2017;09;16;Tiistai;45;32;77
95;05.09.2017;2017;09;17;Tiistai;21;32;53
95;05.09.2017;2017;09;18;Tiistai;11;18;29
95;05.09.2017;2017;09;19;Tiistai;9;7;16
95;05.09.2017;2017;09;20;Tiistai;2;9;11
95;05.09.2017;2017;09;21;Tiistai;4;7;11
95;05.09.2017;2017;09;22;Tiistai;1;3;4
95;05.09.2017;2017;09;23;Tiistai;0;0;0
95;06.09.2017;2017;09;00;Keskiviikko;0;0;0
95;06.09.2017;2017;09;01;Keskiviikko;0;0;0
95;06.09.2017;2017;09;02;Keskiviikko;0;0;0
95;06.09.2017;2017;09;03;Keskiviikko;0;1;1
95;06.09.2017;2017;09;04;Keskiviikko;3;1;4
95;06.09.2017;2017;09;05;Keskiviikko;3;2;5
95;06.09.2017;2017;09;06;Keskiviikko;20;9;29
95;06.09.2017;2017;09;07;Keskiviikko;27;27;54
95;06.09.2017;2017;09;08;Keskiviikko;12;26;38
95;06.09.2017;2017;09;09;Keskiviikko;7;12;19
95;06.09.2017;2017;09;10;Keskiviikko;11;8;19
95;06.09.2017;2017;09;11;Keskiviikko;11;14;25
95;06.09.2017;2017;09;12;Keskiviikko;12;17;29
95;06.09.2017;2017;09;13;Keskiviikko;23;19;42
95;06.09.2017;2017;09;14;Keskiviikko;20;18;38
95;06.09.2017;2017;09;15;Keskiviikko;23;31;54
95;06.09.2017;2017;09;16;Keskiviikko;38;37;75
95;06.09.2017;2017;09;17;Keskiviikko;16;24;40
95;06.09.2017;2017;09;18;Keskiviikko;12;20;32
95;06.09.2017;2017;09;19;Keskiviikko;17;14;31
95;06.09.2017;2017;09;20;Keskiviikko;6;10;16
95;06.09.2017;2017;09;21;Keskiviikko;4;5;9
95;06.09.2017;2017;09;22;Keskiviikko;2;2;4
95;06.09.2017;2017;09;23;Keskiviikko;0;1;1
95;07.09.2017;2017;09;00;Torstai;0;0;0
95;07.09.2017;2017;09;01;Torstai;0;0;0
95;07.09.2017;2017;09;02;Torstai;0;1;1
95;07.09.2017;2017;09;03;Torstai;0;1;1
95;07.09.2017;2017;09;04;Torstai;1;0;1
95;07.09.2017;2017;09;05;Torstai;5;4;9
95;07.09.2017;2017;09;06;Torstai;20;9;29
95;07.09.2017;2017;09;07;Torstai;26;30;56
95;07.09.2017;2017;09;08;Torstai;14;17;31
95;07.09.2017;2017;09;09;Torstai;13;21;34
95;07.09.2017;2017;09;10;Torstai;4;4;8
95;07.09.2017;2017;09;11;Torstai;10;7;17
95;07.09.2017;2017;09;12;Torstai;7;11;18
95;07.09.2017;2017;09;13;Torstai;9;6;15
95;07.09.2017;2017;09;14;Torstai;13;10;23
95;07.09.2017;2017;09;15;Torstai;22;19;41
95;07.09.2017;2017;09;16;Torstai;40;26;66
95;07.09.2017;2017;09;17;Torstai;19;21;40
95;07.09.2017;2017;09;18;Torstai;4;18;22
95;07.09.2017;2017;09;19;Torstai;8;7;15
95;07.09.2017;2017;09;20;Torstai;3;6;9
95;07.09.2017;2017;09;21;Torstai;2;5;7
95;07.09.2017;2017;09;22;Torstai;1;3;4
95;07.09.2017;2017;09;23;Torstai;0;1;1
95;08.09.2017;2017;09;00;Perjantai;0;0;0
95;08.09.2017;2017;09;01;Perjantai;1;0;1
95;08.09.2017;2017;09;02;Perjantai;0;0;0
95;08.09.2017;2017;09;03;Perjantai;0;0;0
95;08.09.2017;2017;09;04;Perjantai;0;0;0
95;08.09.2017;2017;09;05;Perjantai;6;3;9
95;08.09.2017;2017;09;06;Perjantai;5;7;12
95;08.09.2017;2017;09;07;Perjantai;14;13;27
95;08.09.2017;2017;09;08;Perjantai;7;9;16
95;08.09.2017;2017;09;09;Perjantai;1;7;8
95;08.09.2017;2017;09;10;Perjantai;8;1;9
95;08.09.2017;2017;09;11;Perjantai;5;4;9
95;08.09.2017;2017;09;12;Perjantai;8;2;10
95;08.09.2017;2017;09;13;Perjantai;14;2;16
95;08.09.2017;2017;09;14;Perjantai;17;7;24
95;08.09.2017;2017;09;15;Perjantai;12;9;21
95;08.09.2017;2017;09;16;Perjantai;6;15;21
95;08.09.2017;2017;09;17;Perjantai;4;6;10
95;08.09.2017;2017;09;18;Perjantai;6;5;11
95;08.09.2017;2017;09;19;Perjantai;4;6;10
95;08.09.2017;2017;09;20;Perjantai;2;4;6
95;08.09.2017;2017;09;21;Perjantai;4;1;5
95;08.09.2017;2017;09;22;Perjantai;0;1;1
95;08.09.2017;2017;09;23;Perjantai;1;0;1
95;09.09.2017;2017;09;00;Lauantai;2;4;6
95;09.09.2017;2017;09;01;Lauantai;0;0;0
95;09.09.2017;2017;09;02;Lauantai;1;1;2
95;09.09.2017;2017;09;03;Lauantai;0;1;1
95;09.09.2017;2017;09;04;Lauantai;1;0;1
95;09.09.2017;2017;09;05;Lauantai;0;0;0
95;09.09.2017;2017;09;06;Lauantai;2;1;3
95;09.09.2017;2017;09;07;Lauantai;3;0;3
95;09.09.2017;2017;09;08;Lauantai;6;8;14
95;09.09.2017;2017;09;09;Lauantai;1;2;3
95;09.09.2017;2017;09;10;Lauantai;7;8;15
95;09.09.2017;2017;09;11;Lauantai;3;10;13
95;09.09.2017;2017;09;12;Lauantai;6;10;16
95;09.09.2017;2017;09;13;Lauantai;16;3;19
95;09.09.2017;2017;09;14;Lauantai;9;3;12
95;09.09.2017;2017;09;15;Lauantai;7;5;12
95;09.09.2017;2017;09;16;Lauantai;10;8;18
95;09.09.2017;2017;09;17;Lauantai;3;9;12
95;09.09.2017;2017;09;18;Lauantai;6;6;12
95;09.09.2017;2017;09;19;Lauantai;6;5;11
95;09.09.2017;2017;09;20;Lauantai;3;7;10
95;09.09.2017;2017;09;21;Lauantai;1;2;3
95;09.09.2017;2017;09;22;Lauantai;1;1;2
95;09.09.2017;2017;09;23;Lauantai;0;0;0
95;10.09.2017;2017;09;00;Sunnuntai;1;0;1
95;10.09.2017;2017;09;01;Sunnuntai;0;0;0
95;10.09.2017;2017;09;02;Sunnuntai;2;0;2
95;10.09.2017;2017;09;03;Sunnuntai;0;1;1
95;10.09.2017;2017;09;04;Sunnuntai;0;1;1
95;10.09.2017;2017;09;05;Sunnuntai;0;0;0
95;10.09.2017;2017;09;06;Sunnuntai;2;0;2
95;10.09.2017;2017;09;07;Sunnuntai;3;0;3
95;10.09.2017;2017;09;08;Sunnuntai;1;2;3
95;10.09.2017;2017;09;09;Sunnuntai;1;0;1
95;10.09.2017;2017;09;10;Sunnuntai;1;0;1
95;10.09.2017;2017;09;11;Sunnuntai;0;3;3
95;10.09.2017;2017;09;12;Sunnuntai;0;0;0
95;10.09.2017;2017;09;13;Sunnuntai;1;1;2
95;10.09.2017;2017;09;14;Sunnuntai;2;2;4
95;10.09.2017;2017;09;15;Sunnuntai;0;1;1
95;10.09.2017;2017;09;16;Sunnuntai;2;1;3
95;10.09.2017;2017;09;17;Sunnuntai;3;1;4
95;10.09.2017;2017;09;18;Sunnuntai;1;2;3
95;10.09.2017;2017;09;19;Sunnuntai;0;0;0
95;10.09.2017;2017;09;20;Sunnuntai;1;1;2
95;10.09.2017;2017;09;21;Sunnuntai;0;1;1
95;10.09.2017;2017;09;22;Sunnuntai;0;0;0
95;10.09.2017;2017;09;23;Sunnuntai;0;0;0
95;11.09.2017;2017;09;00;Maanantai;0;0;0
95;11.09.2017;2017;09;01;Maanantai;0;0;0
95;11.09.2017;2017;09;02;Maanantai;0;0;0
95;11.09.2017;2017;09;03;Maanantai;0;0;0
95;11.09.2017;2017;09;04;Maanantai;1;0;1
95;11.09.2017;2017;09;05;Maanantai;4;3;7
95;11.09.2017;2017;09;06;Maanantai;21;10;31
95;11.09.2017;2017;09;07;Maanantai;20;25;45
95;11.09.2017;2017;09;08;Maanantai;10;18;28
95;11.09.2017;2017;09;09;Maanantai;11;16;27
95;11.09.2017;2017;09;10;Maanantai;17;10;27
95;11.09.2017;2017;09;11;Maanantai;10;8;18
95;11.09.2017;2017;09;12;Maanantai;14;5;19
95;11.09.2017;2017;09;13;Maanantai;5;11;16
95;11.09.2017;2017;09;14;Maanantai;14;13;27
95;11.09.2017;2017;09;15;Maanantai;23;26;49
95;11.09.2017;2017;09;16;Maanantai;37;25;62
95;11.09.2017;2017;09;17;Maanantai;9;18;27
95;11.09.2017;2017;09;18;Maanantai;15;18;33
95;11.09.2017;2017;09;19;Maanantai;6;15;21
95;11.09.2017;2017;09;20;Maanantai;6;11;17
95;11.09.2017;2017;09;21;Maanantai;4;4;8
95;11.09.2017;2017;09;22;Maanantai;2;0;2
95;11.09.2017;2017;09;23;Maanantai;1;0;1
95;12.09.2017;2017;09;00;Tiistai;0;0;0
95;12.09.2017;2017;09;01;Tiistai;0;0;0
95;12.09.2017;2017;09;02;Tiistai;0;0;0
95;12.09.2017;2017;09;03;Tiistai;0;0;0
95;12.09.2017;2017;09;04;Tiistai;1;0;1
95;12.09.2017;2017;09;05;Tiistai;5;4;9
95;12.09.2017;2017;09;06;Tiistai;25;7;32
95;12.09.2017;2017;09;07;Tiistai;17;28;45
95;12.09.2017;2017;09;08;Tiistai;16;22;38
95;12.09.2017;2017;09;09;Tiistai;4;8;12
95;12.09.2017;2017;09;10;Tiistai;10;12;22
95;12.09.2017;2017;09;11;Tiistai;7;8;15
95;12.09.2017;2017;09;12;Tiistai;9;4;13
95;12.09.2017;2017;09;13;Tiistai;8;8;16
95;12.09.2017;2017;09;14;Tiistai;16;10;26
95;12.09.2017;2017;09;15;Tiistai;13;13;26
95;12.09.2017;2017;09;16;Tiistai;18;14;32
95;12.09.2017;2017;09;17;Tiistai;3;9;12
95;12.09.2017;2017;09;18;Tiistai;2;3;5
95;12.09.2017;2017;09;19;Tiistai;1;5;6
95;12.09.2017;2017;09;20;Tiistai;2;6;8
95;12.09.2017;2017;09;21;Tiistai;1;2;3
95;12.09.2017;2017;09;22;Tiistai;2;0;2
95;12.09.2017;2017;09;23;Tiistai;0;0;0
95;13.09.2017;2017;09;00;Keskiviikko;0;0;0
95;13.09.2017;2017;09;01;Keskiviikko;0;1;1
95;13.09.2017;2017;09;02;Keskiviikko;0;0;0
95;13.09.2017;2017;09;03;Keskiviikko;0;0;0
95;13.09.2017;2017;09;04;Keskiviikko;2;1;3
95;13.09.2017;2017;09;05;Keskiviikko;5;3;8
95;13.09.2017;2017;09;06;Keskiviikko;13;6;19
95;13.09.2017;2017;09;07;Keskiviikko;16;22;38
95;13.09.2017;2017;09;08;Keskiviikko;10;18;28
95;13.09.2017;2017;09;09;Keskiviikko;6;10;16
95;13.09.2017;2017;09;10;Keskiviikko;5;5;10
95;13.09.2017;2017;09;11;Keskiviikko;9;6;15
95;13.09.2017;2017;09;12;Keskiviikko;6;6;12
95;13.09.2017;2017;09;13;Keskiviikko;6;10;16
95;13.09.2017;2017;09;14;Keskiviikko;15;17;32
95;13.09.2017;2017;09;15;Keskiviikko;14;22;36
95;13.09.2017;2017;09;16;Keskiviikko;28;16;44
95;13.09.2017;2017;09;17;Keskiviikko;10;14;24
95;13.09.2017;2017;09;18;Keskiviikko;14;18;32
95;13.09.2017;2017;09;19;Keskiviikko;9;6;15
95;13.09.2017;2017;09;20;Keskiviikko;5;14;19
95;13.09.2017;2017;09;21;Keskiviikko;1;2;3
95;13.09.2017;2017;09;22;Keskiviikko;2;1;3
95;13.09.2017;2017;09;23;Keskiviikko;1;0;1
95;14.09.2017;2017;09;00;Torstai;0;0;0
95;14.09.2017;2017;09;01;Torstai;1;0;1
95;14.09.2017;2017;09;02;Torstai;0;0;0
95;14.09.2017;2017;09;03;Torstai;0;0;0
95;14.09.2017;2017;09;04;Torstai;2;0;2
95;14.09.2017;2017;09;05;Torstai;5;4;9
95;14.09.2017;2017;09;06;Torstai;22;8;30
95;14.09.2017;2017;09;07;Torstai;19;30;49
95;14.09.2017;2017;09;08;Torstai;8;19;27
95;14.09.2017;2017;09;09;Torstai;13;16;29
95;14.09.2017;2017;09;10;Torstai;4;7;11
95;14.09.2017;2017;09;11;Torstai;7;4;11
95;14.09.2017;2017;09;12;Torstai;11;6;17
95;14.09.2017;2017;09;13;Torstai;8;5;13
95;14.09.2017;2017;09;14;Torstai;13;13;26
95;14.09.2017;2017;09;15;Torstai;22;22;44
95;14.09.2017;2017;09;16;Torstai;31;23;54
95;14.09.2017;2017;09;17;Torstai;20;16;36
95;14.09.2017;2017;09;18;Torstai;6;13;19
95;14.09.2017;2017;09;19;Torstai;6;8;14
95;14.09.2017;2017;09;20;Torstai;5;4;9
95;14.09.2017;2017;09;21;Torstai;0;3;3
95;14.09.2017;2017;09;22;Torstai;1;3;4
95;14.09.2017;2017;09;23;Torstai;1;1;2
95;15.09.2017;2017;09;00;Perjantai;0;0;0
95;15.09.2017;2017;09;01;Perjantai;0;0;0
95;15.09.2017;2017;09;02;Perjantai;0;0;0
95;15.09.2017;2017;09;03;Perjantai;0;0;0
95;15.09.2017;2017;09;04;Perjantai;2;0;2
95;15.09.2017;2017;09;05;Perjantai;5;4;9
95;15.09.2017;2017;09;06;Perjantai;12;7;19
95;15.09.2017;2017;09;07;Perjantai;20;24;44
95;15.09.2017;2017;09;08;Perjantai;8;16;24
95;15.09.2017;2017;09;09;Perjantai;4;5;9
95;15.09.2017;2017;09;10;Perjantai;9;3;12
95;15.09.2017;2017;09;11;Perjantai;3;1;4
95;15.09.2017;2017;09;12;Perjantai;8;2;10
95;15.09.2017;2017;09;13;Perjantai;19;9;28
95;15.09.2017;2017;09;14;Perjantai;8;15;23
95;15.09.2017;2017;09;15;Perjantai;13;9;22
95;15.09.2017;2017;09;16;Perjantai;13;14;27
95;15.09.2017;2017;09;17;Perjantai;2;8;10
95;15.09.2017;2017;09;18;Perjantai;4;6;10
95;15.09.2017;2017;09;19;Perjantai;3;5;8
95;15.09.2017;2017;09;20;Perjantai;1;4;5
95;15.09.2017;2017;09;21;Perjantai;0;1;1
95;15.09.2017;2017;09;22;Perjantai;0;1;1
95;15.09.2017;2017;09;23;Perjantai;0;0;0
95;16.09.2017;2017;09;00;Lauantai;3;1;4
95;16.09.2017;2017;09;01;Lauantai;0;0;0
95;16.09.2017;2017;09;02;Lauantai;0;0;0
95;16.09.2017;2017;09;03;Lauantai;1;1;2
95;16.09.2017;2017;09;04;Lauantai;2;0;2
95;16.09.2017;2017;09;05;Lauantai;2;0;2
95;16.09.2017;2017;09;06;Lauantai;4;0;4
95;16.09.2017;2017;09;07;Lauantai;2;2;4
95;16.09.2017;2017;09;08;Lauantai;2;3;5
95;16.09.2017;2017;09;09;Lauantai;10;8;18
95;16.09.2017;2017;09;10;Lauantai;1;6;7
95;16.09.2017;2017;09;11;Lauantai;14;3;17
95;16.09.2017;2017;09;12;Lauantai;7;9;16
95;16.09.2017;2017;09;13;Lauantai;12;12;24
95;16.09.2017;2017;09;14;Lauantai;10;5;15
95;16.09.2017;2017;09;15;Lauantai;8;11;19
95;16.09.2017;2017;09;16;Lauantai;8;10;18
95;16.09.2017;2017;09;17;Lauantai;4;1;5
95;16.09.2017;2017;09;18;Lauantai;4;8;12
95;16.09.2017;2017;09;19;Lauantai;5;3;8
95;16.09.2017;2017;09;20;Lauantai;3;4;7
95;16.09.2017;2017;09;21;Lauantai;1;2;3
95;16.09.2017;2017;09;22;Lauantai;0;1;1
95;16.09.2017;2017;09;23;Lauantai;1;0;1
95;17.09.2017;2017;09;00;Sunnuntai;2;0;2
95;17.09.2017;2017;09;01;Sunnuntai;0;1;1
95;17.09.2017;2017;09;02;Sunnuntai;0;0;0
95;17.09.2017;2017;09;03;Sunnuntai;0;0;0
95;17.09.2017;2017;09;04;Sunnuntai;0;1;1
95;17.09.2017;2017;09;05;Sunnuntai;1;0;1
95;17.09.2017;2017;09;06;Sunnuntai;1;0;1
95;17.09.2017;2017;09;07;Sunnuntai;2;3;5
95;17.09.2017;2017;09;08;Sunnuntai;3;1;4
95;17.09.2017;2017;09;09;Sunnuntai;1;2;3
95;17.09.2017;2017;09;10;Sunnuntai;11;6;17
95;17.09.2017;2017;09;11;Sunnuntai;8;3;11
95;17.09.2017;2017;09;12;Sunnuntai;8;8;16
95;17.09.2017;2017;09;13;Sunnuntai;14;16;30
95;17.09.2017;2017;09;14;Sunnuntai;9;15;24
95;17.09.2017;2017;09;15;Sunnuntai;11;4;15
95;17.09.2017;2017;09;16;Sunnuntai;11;13;24
95;17.09.2017;2017;09;17;Sunnuntai;3;9;12
95;17.09.2017;2017;09;18;Sunnuntai;9;6;15
95;17.09.2017;2017;09;19;Sunnuntai;6;10;16
95;17.09.2017;2017;09;20;Sunnuntai;3;5;8
95;17.09.2017;2017;09;21;Sunnuntai;1;6;7
95;17.09.2017;2017;09;22;Sunnuntai;0;1;1
95;17.09.2017;2017;09;23;Sunnuntai;0;0;0
95;18.09.2017;2017;09;00;Maanantai;0;0;0
95;18.09.2017;2017;09;01;Maanantai;0;1;1
95;18.09.2017;2017;09;02;Maanantai;0;2;2
95;18.09.2017;2017;09;03;Maanantai;0;0;0
95;18.09.2017;2017;09;04;Maanantai;0;0;0
95;18.09.2017;2017;09;05;Maanantai;7;4;11
95;18.09.2017;2017;09;06;Maanantai;18;10;28
95;18.09.2017;2017;09;07;Maanantai;15;18;33
95;18.09.2017;2017;09;08;Maanantai;8;10;18
95;18.09.2017;2017;09;09;Maanantai;7;11;18
95;18.09.2017;2017;09;10;Maanantai;7;6;13
95;18.09.2017;2017;09;11;Maanantai;2;3;5
95;18.09.2017;2017;09;12;Maanantai;6;3;9
95;18.09.2017;2017;09;13;Maanantai;10;3;13
95;18.09.2017;2017;09;14;Maanantai;16;12;28
95;18.09.2017;2017;09;15;Maanantai;22;24;46
95;18.09.2017;2017;09;16;Maanantai;27;27;54
95;18.09.2017;2017;09;17;Maanantai;13;17;30
95;18.09.2017;2017;09;18;Maanantai;12;9;21
95;18.09.2017;2017;09;19;Maanantai;5;4;9
95;18.09.2017;2017;09;20;Maanantai;0;12;12
95;18.09.2017;2017;09;21;Maanantai;6;5;11
95;18.09.2017;2017;09;22;Maanantai;3;4;7
95;18.09.2017;2017;09;23;Maanantai;1;0;1
95;19.09.2017;2017;09;00;Tiistai;0;1;1
95;19.09.2017;2017;09;01;Tiistai;0;0;0
95;19.09.2017;2017;09;02;Tiistai;0;0;0
95;19.09.2017;2017;09;03;Tiistai;0;0;0
95;19.09.2017;2017;09;04;Tiistai;1;0;1
95;19.09.2017;2017;09;05;Tiistai;3;4;7
95;19.09.2017;2017;09;06;Tiistai;16;7;23
95;19.09.2017;2017;09;07;Tiistai;13;25;38
95;19.09.2017;2017;09;08;Tiistai;8;15;23
95;19.09.2017;2017;09;09;Tiistai;7;7;14
95;19.09.2017;2017;09;10;Tiistai;3;3;6
95;19.09.2017;2017;09;11;Tiistai;4;3;7
95;19.09.2017;2017;09;12;Tiistai;3;1;4
95;19.09.2017;2017;09;13;Tiistai;7;9;16
95;19.09.2017;2017;09;14;Tiistai;16;6;22
95;19.09.2017;2017;09;15;Tiistai;15;16;31
95;19.09.2017;2017;09;16;Tiistai;22;16;38
95;19.09.2017;2017;09;17;Tiistai;5;11;16
95;19.09.2017;2017;09;18;Tiistai;4;3;7
95;19.09.2017;2017;09;19;Tiistai;2;3;5
95;19.09.2017;2017;09;20;Tiistai;2;7;9
95;19.09.2017;2017;09;21;Tiistai;0;3;3
95;19.09.2017;2017;09;22;Tiistai;3;2;5
95;19.09.2017;2017;09;23;Tiistai;1;0;1
95;20.09.2017;2017;09;00;Keskiviikko;0;0;0
95;20.09.2017;2017;09;01;Keskiviikko;0;0;0
95;20.09.2017;2017;09;02;Keskiviikko;0;0;0
95;20.09.2017;2017;09;03;Keskiviikko;0;0;0
95;20.09.2017;2017;09;04;Keskiviikko;2;0;2
95;20.09.2017;2017;09;05;Keskiviikko;5;4;9
95;20.09.2017;2017;09;06;Keskiviikko;19;10;29
95;20.09.2017;2017;09;07;Keskiviikko;18;26;44
95;20.09.2017;2017;09;08;Keskiviikko;11;13;24
95;20.09.2017;2017;09;09;Keskiviikko;6;8;14
95;20.09.2017;2017;09;10;Keskiviikko;5;5;10
95;20.09.2017;2017;09;11;Keskiviikko;6;4;10
95;20.09.2017;2017;09;12;Keskiviikko;11;7;18
95;20.09.2017;2017;09;13;Keskiviikko;9;8;17
95;20.09.2017;2017;09;14;Keskiviikko;15;11;26
95;20.09.2017;2017;09;15;Keskiviikko;18;22;40
95;20.09.2017;2017;09;16;Keskiviikko;24;15;39
95;20.09.2017;2017;09;17;Keskiviikko;14;15;29
95;20.09.2017;2017;09;18;Keskiviikko;5;10;15
95;20.09.2017;2017;09;19;Keskiviikko;8;4;12
95;20.09.2017;2017;09;20;Keskiviikko;4;10;14
95;20.09.2017;2017;09;21;Keskiviikko;0;1;1
95;20.09.2017;2017;09;22;Keskiviikko;1;1;2
95;20.09.2017;2017;09;23;Keskiviikko;0;0;0
95;21.09.2017;2017;09;00;Torstai;0;1;1
95;21.09.2017;2017;09;01;Torstai;0;0;0
95;21.09.2017;2017;09;02;Torstai;0;0;0
95;21.09.2017;2017;09;03;Torstai;0;0;0
95;21.09.2017;2017;09;04;Torstai;2;0;2
95;21.09.2017;2017;09;05;Torstai;6;5;11
95;21.09.2017;2017;09;06;Torstai;19;8;27
95;21.09.2017;2017;09;07;Torstai;20;19;39
95;21.09.2017;2017;09;08;Torstai;12;13;25
95;21.09.2017;2017;09;09;Torstai;5;15;20
95;21.09.2017;2017;09;10;Torstai;6;1;7
95;21.09.2017;2017;09;11;Torstai;6;8;14
95;21.09.2017;2017;09;12;Torstai;8;9;17
95;21.09.2017;2017;09;13;Torstai;2;9;11
95;21.09.2017;2017;09;14;Torstai;13;5;18
95;21.09.2017;2017;09;15;Torstai;15;17;32
95;21.09.2017;2017;09;16;Torstai;27;26;53
95;21.09.2017;2017;09;17;Torstai;7;5;12
95;21.09.2017;2017;09;18;Torstai;2;8;10
95;21.09.2017;2017;09;19;Torstai;3;6;9
95;21.09.2017;2017;09;20;Torstai;4;4;8
95;21.09.2017;2017;09;21;Torstai;2;6;8
95;21.09.2017;2017;09;22;Torstai;2;0;2
95;21.09.2017;2017;09;23;Torstai;0;0;0
95;22.09.2017;2017;09;00;Perjantai;0;2;2
95;22.09.2017;2017;09;01;Perjantai;0;0;0
95;22.09.2017;2017;09;02;Perjantai;0;0;0
95;22.09.2017;2017;09;03;Perjantai;0;0;0
95;22.09.2017;2017;09;04;Perjantai;0;0;0
95;22.09.2017;2017;09;05;Perjantai;5;4;9
95;22.09.2017;2017;09;06;Perjantai;14;2;16
95;22.09.2017;2017;09;07;Perjantai;12;17;29
95;22.09.2017;2017;09;08;Perjantai;12;19;31
95;22.09.2017;2017;09;09;Perjantai;4;3;7
95;22.09.2017;2017;09;10;Perjantai;6;3;9
95;22.09.2017;2017;09;11;Perjantai;7;3;10
95;22.09.2017;2017;09;12;Perjantai;7;8;15
95;22.09.2017;2017;09;13;Perjantai;23;8;31
95;22.09.2017;2017;09;14;Perjantai;12;13;25
95;22.09.2017;2017;09;15;Perjantai;20;22;42
95;22.09.2017;2017;09;16;Perjantai;23;21;44
95;22.09.2017;2017;09;17;Perjantai;5;15;20
95;22.09.2017;2017;09;18;Perjantai;7;15;22
95;22.09.2017;2017;09;19;Perjantai;7;7;14
95;22.09.2017;2017;09;20;Perjantai;3;1;4
95;22.09.2017;2017;09;21;Perjantai;3;5;8
95;22.09.2017;2017;09;22;Perjantai;1;2;3
95;22.09.2017;2017;09;23;Perjantai;0;0;0
95;23.09.2017;2017;09;00;Lauantai;0;2;2
95;23.09.2017;2017;09;01;Lauantai;0;0;0
95;23.09.2017;2017;09;02;Lauantai;0;1;1
95;23.09.2017;2017;09;03;Lauantai;0;0;0
95;23.09.2017;2017;09;04;Lauantai;0;0;0
95;23.09.2017;2017;09;05;Lauantai;1;1;2
95;23.09.2017;2017;09;06;Lauantai;0;0;0
95;23.09.2017;2017;09;07;Lauantai;4;3;7
95;23.09.2017;2017;09;08;Lauantai;5;3;8
95;23.09.2017;2017;09;09;Lauantai;2;6;8
95;23.09.2017;2017;09;10;Lauantai;7;10;17
95;23.09.2017;2017;09;11;Lauantai;10;3;13
95;23.09.2017;2017;09;12;Lauantai;7;14;21
95;23.09.2017;2017;09;13;Lauantai;3;12;15
95;23.09.2017;2017;09;14;Lauantai;7;9;16
95;23.09.2017;2017;09;15;Lauantai;10;5;15
95;23.09.2017;2017;09;16;Lauantai;6;10;16
95;23.09.2017;2017;09;17;Lauantai;9;10;19
95;23.09.2017;2017;09;18;Lauantai;10;10;20
95;23.09.2017;2017;09;19;Lauantai;5;0;5
95;23.09.2017;2017;09;20;Lauantai;0;8;8
95;23.09.2017;2017;09;21;Lauantai;2;1;3
95;23.09.2017;2017;09;22;Lauantai;1;2;3
95;23.09.2017;2017;09;23;Lauantai;0;1;1
95;24.09.2017;2017;09;00;Sunnuntai;2;1;3
95;24.09.2017;2017;09;01;Sunnuntai;1;2;3
95;24.09.2017;2017;09;02;Sunnuntai;0;0;0
95;24.09.2017;2017;09;03;Sunnuntai;1;1;2
95;24.09.2017;2017;09;04;Sunnuntai;0;0;0
95;24.09.2017;2017;09;05;Sunnuntai;2;0;2
95;24.09.2017;2017;09;06;Sunnuntai;1;2;3
95;24.09.2017;2017;09;07;Sunnuntai;3;2;5
95;24.09.2017;2017;09;08;Sunnuntai;7;5;12
95;24.09.2017;2017;09;09;Sunnuntai;5;6;11
95;24.09.2017;2017;09;10;Sunnuntai;18;11;29
95;24.09.2017;2017;09;11;Sunnuntai;12;11;23
95;24.09.2017;2017;09;12;Sunnuntai;14;9;23
95;24.09.2017;2017;09;13;Sunnuntai;12;15;27
95;24.09.2017;2017;09;14;Sunnuntai;13;11;24
95;24.09.2017;2017;09;15;Sunnuntai;17;11;28
95;24.09.2017;2017;09;16;Sunnuntai;8;11;19
95;24.09.2017;2017;09;17;Sunnuntai;12;6;18
95;24.09.2017;2017;09;18;Sunnuntai;14;5;19
95;24.09.2017;2017;09;19;Sunnuntai;6;6;12
95;24.09.2017;2017;09;20;Sunnuntai;9;6;15
95;24.09.2017;2017;09;21;Sunnuntai;2;4;6
95;24.09.2017;2017;09;22;Sunnuntai;1;1;2
95;24.09.2017;2017;09;23;Sunnuntai;0;0;0
95;25.09.2017;2017;09;00;Maanantai;0;0;0
95;25.09.2017;2017;09;01;Maanantai;0;0;0
95;25.09.2017;2017;09;02;Maanantai;0;1;1
95;25.09.2017;2017;09;03;Maanantai;0;0;0
95;25.09.2017;2017;09;04;Maanantai;2;0;2
95;25.09.2017;2017;09;05;Maanantai;3;2;5
95;25.09.2017;2017;09;06;Maanantai;16;8;24
95;25.09.2017;2017;09;07;Maanantai;17;24;41
95;25.09.2017;2017;09;08;Maanantai;12;16;28
95;25.09.2017;2017;09;09;Maanantai;10;8;18
95;25.09.2017;2017;09;10;Maanantai;12;6;18
95;25.09.2017;2017;09;11;Maanantai;8;5;13
95;25.09.2017;2017;09;12;Maanantai;7;5;12
95;25.09.2017;2017;09;13;Maanantai;19;14;33
95;25.09.2017;2017;09;14;Maanantai;12;12;24
95;25.09.2017;2017;09;15;Maanantai;30;27;57
95;25.09.2017;2017;09;16;Maanantai;27;41;68
95;25.09.2017;2017;09;17;Maanantai;22;27;49
95;25.09.2017;2017;09;18;Maanantai;8;21;29
95;25.09.2017;2017;09;19;Maanantai;9;11;20
95;25.09.2017;2017;09;20;Maanantai;8;8;16
95;25.09.2017;2017;09;21;Maanantai;3;1;4
95;25.09.2017;2017;09;22;Maanantai;3;6;9
95;25.09.2017;2017;09;23;Maanantai;1;0;1
95;26.09.2017;2017;09;00;Tiistai;0;0;0
95;26.09.2017;2017;09;01;Tiistai;0;0;0
95;26.09.2017;2017;09;02;Tiistai;0;0;0
95;26.09.2017;2017;09;03;Tiistai;0;1;1
95;26.09.2017;2017;09;04;Tiistai;3;0;3
95;26.09.2017;2017;09;05;Tiistai;6;4;10
95;26.09.2017;2017;09;06;Tiistai;17;9;26
95;26.09.2017;2017;09;07;Tiistai;20;36;56
95;26.09.2017;2017;09;08;Tiistai;14;10;24
95;26.09.2017;2017;09;09;Tiistai;10;7;17
95;26.09.2017;2017;09;10;Tiistai;16;9;25
95;26.09.2017;2017;09;11;Tiistai;11;2;13
95;26.09.2017;2017;09;12;Tiistai;10;11;21
95;26.09.2017;2017;09;13;Tiistai;13;7;20
95;26.09.2017;2017;09;14;Tiistai;10;14;24
95;26.09.2017;2017;09;15;Tiistai;18;20;38
95;26.09.2017;2017;09;16;Tiistai;22;29;51
95;26.09.2017;2017;09;17;Tiistai;11;16;27
95;26.09.2017;2017;09;18;Tiistai;3;8;11
95;26.09.2017;2017;09;19;Tiistai;4;6;10
95;26.09.2017;2017;09;20;Tiistai;7;6;13
95;26.09.2017;2017;09;21;Tiistai;1;8;9
95;26.09.2017;2017;09;22;Tiistai;4;2;6
95;26.09.2017;2017;09;23;Tiistai;0;0;0
95;27.09.2017;2017;09;00;Keskiviikko;0;0;0
95;27.09.2017;2017;09;01;Keskiviikko;0;1;1
95;27.09.2017;2017;09;02;Keskiviikko;0;0;0
95;27.09.2017;2017;09;03;Keskiviikko;0;0;0
95;27.09.2017;2017;09;04;Keskiviikko;0;0;0
95;27.09.2017;2017;09;05;Keskiviikko;4;2;6
95;27.09.2017;2017;09;06;Keskiviikko;13;6;19
95;27.09.2017;2017;09;07;Keskiviikko;23;32;55
95;27.09.2017;2017;09;08;Keskiviikko;9;12;21
95;27.09.2017;2017;09;09;Keskiviikko;7;6;13
95;27.09.2017;2017;09;10;Keskiviikko;12;4;16
95;27.09.2017;2017;09;11;Keskiviikko;4;7;11
95;27.09.2017;2017;09;12;Keskiviikko;7;3;10
95;27.09.2017;2017;09;13;Keskiviikko;11;8;19
95;27.09.2017;2017;09;14;Keskiviikko;8;8;16
95;27.09.2017;2017;09;15;Keskiviikko;11;15;26
95;27.09.2017;2017;09;16;Keskiviikko;23;18;41
95;27.09.2017;2017;09;17;Keskiviikko;10;14;24
95;27.09.2017;2017;09;18;Keskiviikko;3;12;15
95;27.09.2017;2017;09;19;Keskiviikko;7;11;18
95;27.09.2017;2017;09;20;Keskiviikko;2;3;5
95;27.09.2017;2017;09;21;Keskiviikko;0;2;2
95;27.09.2017;2017;09;22;Keskiviikko;3;2;5
95;27.09.2017;2017;09;23;Keskiviikko;2;1;3
95;28.09.2017;2017;09;00;Torstai;0;0;0
95;28.09.2017;2017;09;01;Torstai;0;0;0
95;28.09.2017;2017;09;02;Torstai;0;0;0
95;28.09.2017;2017;09;03;Torstai;0;0;0
95;28.09.2017;2017;09;04;Torstai;0;0;0
95;28.09.2017;2017;09;05;Torstai;5;3;8
95;28.09.2017;2017;09;06;Torstai;11;5;16
95;28.09.2017;2017;09;07;Torstai;15;29;44
95;28.09.2017;2017;09;08;Torstai;13;14;27
95;28.09.2017;2017;09;09;Torstai;11;3;14
95;28.09.2017;2017;09;10;Torstai;14;5;19
95;28.09.2017;2017;09;11;Torstai;9;8;17
95;28.09.2017;2017;09;12;Torstai;6;2;8
95;28.09.2017;2017;09;13;Torstai;7;11;18
95;28.09.2017;2017;09;14;Torstai;6;10;16
95;28.09.2017;2017;09;15;Torstai;20;17;37
95;28.09.2017;2017;09;16;Torstai;24;14;38
95;28.09.2017;2017;09;17;Torstai;7;11;18
95;28.09.2017;2017;09;18;Torstai;6;10;16
95;28.09.2017;2017;09;19;Torstai;9;7;16
95;28.09.2017;2017;09;20;Torstai;2;8;10
95;28.09.2017;2017;09;21;Torstai;1;2;3
95;28.09.2017;2017;09;22;Torstai;4;2;6
95;28.09.2017;2017;09;23;Torstai;0;0;0
95;29.09.2017;2017;09;00;Perjantai;0;0;0
95;29.09.2017;2017;09;01;Perjantai;0;1;1
95;29.09.2017;2017;09;02;Perjantai;0;0;0
95;29.09.2017;2017;09;03;Perjantai;0;0;0
95;29.09.2017;2017;09;04;Perjantai;2;1;3
95;29.09.2017;2017;09;05;Perjantai;6;2;8
95;29.09.2017;2017;09;06;Perjantai;11;8;19
95;29.09.2017;2017;09;07;Perjantai;11;24;35
95;29.09.2017;2017;09;08;Perjantai;15;10;25
95;29.09.2017;2017;09;09;Perjantai;10;6;16
95;29.09.2017;2017;09;10;Perjantai;8;4;12
95;29.09.2017;2017;09;11;Perjantai;6;5;11
95;29.09.2017;2017;09;12;Perjantai;9;10;19
95;29.09.2017;2017;09;13;Perjantai;11;12;23
95;29.09.2017;2017;09;14;Perjantai;14;13;27
95;29.09.2017;2017;09;15;Perjantai;14;13;27
95;29.09.2017;2017;09;16;Perjantai;8;15;23
95;29.09.2017;2017;09;17;Perjantai;5;10;15
95;29.09.2017;2017;09;18;Perjantai;9;7;16
95;29.09.2017;2017;09;19;Perjantai;5;4;9
95;29.09.2017;2017;09;20;Perjantai;2;0;2
95;29.09.2017;2017;09;21;Perjantai;3;3;6
95;29.09.2017;2017;09;22;Perjantai;1;1;2
95;29.09.2017;2017;09;23;Perjantai;1;1;2
95;30.09.2017;2017;09;00;Lauantai;2;0;2
95;30.09.2017;2017;09;01;Lauantai;1;3;4
95;30.09.2017;2017;09;02;Lauantai;0;0;0
95;30.09.2017;2017;09;03;Lauantai;0;0;0
95;30.09.2017;2017;09;04;Lauantai;1;0;1
95;30.09.2017;2017;09;05;Lauantai;0;0;0
95;30.09.2017;2017;09;06;Lauantai;1;0;1
95;30.09.2017;2017;09;07;Lauantai;3;1;4
95;30.09.2017;2017;09;08;Lauantai;2;1;3
95;30.09.2017;2017;09;09;Lauantai;3;3;6
95;30.09.2017;2017;09;10;Lauantai;5;9;14
95;30.09.2017;2017;09;11;Lauantai;4;3;7
95;30.09.2017;2017;09;12;Lauantai;13;8;21
95;30.09.2017;2017;09;13;Lauantai;16;6;22
95;30.09.2017;2017;09;14;Lauantai;16;7;23
95;30.09.2017;2017;09;15;Lauantai;8;9;17
95;30.09.2017;2017;09;16;Lauantai;6;12;18
95;30.09.2017;2017;09;17;Lauantai;7;7;14
95;30.09.2017;2017;09;18;Lauantai;6;8;14
95;30.09.2017;2017;09;19;Lauantai;4;5;9
95;30.09.2017;2017;09;20;Lauantai;1;5;6
95;30.09.2017;2017;09;21;Lauantai;3;4;7
95;30.09.2017;2017;09;22;Lauantai;0;2;2
95;30.09.2017;2017;09;23;Lauantai;1;1;2
95;01.10.2017;2017;10;00;Sunnuntai;0;0;0
95;01.10.2017;2017;10;01;Sunnuntai;2;0;2
95;01.10.2017;2017;10;02;Sunnuntai;0;1;1
95;01.10.2017;2017;10;03;Sunnuntai;0;0;0
95;01.10.2017;2017;10;04;Sunnuntai;0;0;0
95;01.10.2017;2017;10;05;Sunnuntai;0;0;0
95;01.10.2017;2017;10;06;Sunnuntai;0;0;0
95;01.10.2017;2017;10;07;Sunnuntai;2;1;3
95;01.10.2017;2017;10;08;Sunnuntai;4;0;4
95;01.10.2017;2017;10;09;Sunnuntai;6;3;9
95;01.10.2017;2017;10;10;Sunnuntai;3;2;5
95;01.10.2017;2017;10;11;Sunnuntai;17;9;26
95;01.10.2017;2017;10;12;Sunnuntai;8;8;16
95;01.10.2017;2017;10;13;Sunnuntai;4;10;14
95;01.10.2017;2017;10;14;Sunnuntai;8;11;19
95;01.10.2017;2017;10;15;Sunnuntai;3;5;8
95;01.10.2017;2017;10;16;Sunnuntai;5;13;18
95;01.10.2017;2017;10;17;Sunnuntai;8;5;13
95;01.10.2017;2017;10;18;Sunnuntai;7;4;11
95;01.10.2017;2017;10;19;Sunnuntai;12;2;14
95;01.10.2017;2017;10;20;Sunnuntai;1;5;6
95;01.10.2017;2017;10;21;Sunnuntai;2;3;5
95;01.10.2017;2017;10;22;Sunnuntai;0;0;0
95;01.10.2017;2017;10;23;Sunnuntai;0;0;0
95;02.10.2017;2017;10;00;Maanantai;0;0;0
95;02.10.2017;2017;10;01;Maanantai;0;0;0
95;02.10.2017;2017;10;02;Maanantai;0;0;0
95;02.10.2017;2017;10;03;Maanantai;0;0;0
95;02.10.2017;2017;10;04;Maanantai;0;0;0
95;02.10.2017;2017;10;05;Maanantai;3;3;6
95;02.10.2017;2017;10;06;Maanantai;14;10;24
95;02.10.2017;2017;10;07;Maanantai;15;25;40
95;02.10.2017;2017;10;08;Maanantai;12;13;25
95;02.10.2017;2017;10;09;Maanantai;9;2;11
95;02.10.2017;2017;10;10;Maanantai;8;9;17
95;02.10.2017;2017;10;11;Maanantai;8;8;16
95;02.10.2017;2017;10;12;Maanantai;6;3;9
95;02.10.2017;2017;10;13;Maanantai;11;6;17
95;02.10.2017;2017;10;14;Maanantai;12;12;24
95;02.10.2017;2017;10;15;Maanantai;11;15;26
95;02.10.2017;2017;10;16;Maanantai;21;18;39
95;02.10.2017;2017;10;17;Maanantai;11;8;19
95;02.10.2017;2017;10;18;Maanantai;9;11;20
95;02.10.2017;2017;10;19;Maanantai;9;8;17
95;02.10.2017;2017;10;20;Maanantai;1;4;5
95;02.10.2017;2017;10;21;Maanantai;4;5;9
95;02.10.2017;2017;10;22;Maanantai;1;0;1
95;02.10.2017;2017;10;23;Maanantai;3;1;4
95;03.10.2017;2017;10;00;Tiistai;0;0;0
95;03.10.2017;2017;10;01;Tiistai;0;0;0
95;03.10.2017;2017;10;02;Tiistai;0;0;0
95;03.10.2017;2017;10;03;Tiistai;0;0;0
95;03.10.2017;2017;10;04;Tiistai;2;1;3
95;03.10.2017;2017;10;05;Tiistai;6;4;10
95;03.10.2017;2017;10;06;Tiistai;15;13;28
95;03.10.2017;2017;10;07;Tiistai;12;30;42
95;03.10.2017;2017;10;08;Tiistai;7;12;19
95;03.10.2017;2017;10;09;Tiistai;8;5;13
95;03.10.2017;2017;10;10;Tiistai;1;6;7
95;03.10.2017;2017;10;11;Tiistai;4;6;10
95;03.10.2017;2017;10;12;Tiistai;4;2;6
95;03.10.2017;2017;10;13;Tiistai;3;3;6
95;03.10.2017;2017;10;14;Tiistai;25;8;33
95;03.10.2017;2017;10;15;Tiistai;11;13;24
95;03.10.2017;2017;10;16;Tiistai;17;17;34
95;03.10.2017;2017;10;17;Tiistai;3;5;8
95;03.10.2017;2017;10;18;Tiistai;5;8;13
95;03.10.2017;2017;10;19;Tiistai;3;3;6
95;03.10.2017;2017;10;20;Tiistai;3;2;5
95;03.10.2017;2017;10;21;Tiistai;0;2;2
95;03.10.2017;2017;10;22;Tiistai;2;0;2
95;03.10.2017;2017;10;23;Tiistai;0;0;0
95;04.10.2017;2017;10;00;Keskiviikko;0;0;0
95;04.10.2017;2017;10;01;Keskiviikko;0;0;0
95;04.10.2017;2017;10;02;Keskiviikko;0;0;0
95;04.10.2017;2017;10;03;Keskiviikko;0;1;1
95;04.10.2017;2017;10;04;Keskiviikko;0;0;0
95;04.10.2017;2017;10;05;Keskiviikko;3;3;6
95;04.10.2017;2017;10;06;Keskiviikko;11;11;22
95;04.10.2017;2017;10;07;Keskiviikko;11;20;31
95;04.10.2017;2017;10;08;Keskiviikko;6;13;19
95;04.10.2017;2017;10;09;Keskiviikko;2;4;6
95;04.10.2017;2017;10;10;Keskiviikko;2;0;2
95;04.10.2017;2017;10;11;Keskiviikko;3;2;5
95;04.10.2017;2017;10;12;Keskiviikko;3;3;6
95;04.10.2017;2017;10;13;Keskiviikko;10;2;12
95;04.10.2017;2017;10;14;Keskiviikko;18;9;27
95;04.10.2017;2017;10;15;Keskiviikko;17;12;29
95;04.10.2017;2017;10;16;Keskiviikko;15;12;27
95;04.10.2017;2017;10;17;Keskiviikko;5;8;13
95;04.10.2017;2017;10;18;Keskiviikko;4;8;12
95;04.10.2017;2017;10;19;Keskiviikko;5;5;10
95;04.10.2017;2017;10;20;Keskiviikko;2;6;8
95;04.10.2017;2017;10;21;Keskiviikko;0;2;2
95;04.10.2017;2017;10;22;Keskiviikko;1;1;2
95;04.10.2017;2017;10;23;Keskiviikko;0;1;1
95;05.10.2017;2017;10;00;Torstai;0;0;0
95;05.10.2017;2017;10;01;Torstai;1;0;1
95;05.10.2017;2017;10;02;Torstai;0;1;1
95;05.10.2017;2017;10;03;Torstai;0;0;0
95;05.10.2017;2017;10;04;Torstai;1;0;1
95;05.10.2017;2017;10;05;Torstai;5;3;8
95;05.10.2017;2017;10;06;Torstai;10;8;18
95;05.10.2017;2017;10;07;Torstai;13;17;30
95;05.10.2017;2017;10;08;Torstai;7;10;17
95;05.10.2017;2017;10;09;Torstai;9;9;18
95;05.10.2017;2017;10;10;Torstai;2;6;8
95;05.10.2017;2017;10;11;Torstai;6;8;14
95;05.10.2017;2017;10;12;Torstai;7;7;14
95;05.10.2017;2017;10;13;Torstai;8;4;12
95;05.10.2017;2017;10;14;Torstai;4;11;15
95;05.10.2017;2017;10;15;Torstai;17;15;32
95;05.10.2017;2017;10;16;Torstai;26;14;40
95;05.10.2017;2017;10;17;Torstai;8;8;16
95;05.10.2017;2017;10;18;Torstai;7;7;14
95;05.10.2017;2017;10;19;Torstai;5;9;14
95;05.10.2017;2017;10;20;Torstai;4;3;7
95;05.10.2017;2017;10;21;Torstai;2;2;4
95;05.10.2017;2017;10;22;Torstai;2;3;5
95;05.10.2017;2017;10;23;Torstai;1;0;1
95;06.10.2017;2017;10;00;Perjantai;0;0;0
95;06.10.2017;2017;10;01;Perjantai;1;1;2
95;06.10.2017;2017;10;02;Perjantai;0;0;0
95;06.10.2017;2017;10;03;Perjantai;0;0;0
95;06.10.2017;2017;10;04;Perjantai;3;0;3
95;06.10.2017;2017;10;05;Perjantai;5;3;8
95;06.10.2017;2017;10;06;Perjantai;10;7;17
95;06.10.2017;2017;10;07;Perjantai;13;23;36
95;06.10.2017;2017;10;08;Perjantai;14;16;30
95;06.10.2017;2017;10;09;Perjantai;3;2;5
95;06.10.2017;2017;10;10;Perjantai;7;2;9
95;06.10.2017;2017;10;11;Perjantai;6;6;12
95;06.10.2017;2017;10;12;Perjantai;7;8;15
95;06.10.2017;2017;10;13;Perjantai;16;4;20
95;06.10.2017;2017;10;14;Perjantai;28;20;48
95;06.10.2017;2017;10;15;Perjantai;14;17;31
95;06.10.2017;2017;10;16;Perjantai;12;20;32
95;06.10.2017;2017;10;17;Perjantai;4;6;10
95;06.10.2017;2017;10;18;Perjantai;2;4;6
95;06.10.2017;2017;10;19;Perjantai;4;6;10
95;06.10.2017;2017;10;20;Perjantai;1;1;2
95;06.10.2017;2017;10;21;Perjantai;0;3;3
95;06.10.2017;2017;10;22;Perjantai;2;3;5
95;06.10.2017;2017;10;23;Perjantai;1;0;1
95;07.10.2017;2017;10;00;Lauantai;0;0;0
95;07.10.2017;2017;10;01;Lauantai;0;0;0
95;07.10.2017;2017;10;02;Lauantai;0;0;0
95;07.10.2017;2017;10;03;Lauantai;0;1;1
95;07.10.2017;2017;10;04;Lauantai;0;1;1
95;07.10.2017;2017;10;05;Lauantai;0;0;0
95;07.10.2017;2017;10;06;Lauantai;4;0;4
95;07.10.2017;2017;10;07;Lauantai;0;2;2
95;07.10.2017;2017;10;08;Lauantai;4;3;7
95;07.10.2017;2017;10;09;Lauantai;3;3;6
95;07.10.2017;2017;10;10;Lauantai;6;11;17
95;07.10.2017;2017;10;11;Lauantai;12;9;21
95;07.10.2017;2017;10;12;Lauantai;8;8;16
95;07.10.2017;2017;10;13;Lauantai;5;4;9
95;07.10.2017;2017;10;14;Lauantai;11;12;23
95;07.10.2017;2017;10;15;Lauantai;9;7;16
95;07.10.2017;2017;10;16;Lauantai;9;7;16
95;07.10.2017;2017;10;17;Lauantai;13;10;23
95;07.10.2017;2017;10;18;Lauantai;3;10;13
95;07.10.2017;2017;10;19;Lauantai;3;16;19
95;07.10.2017;2017;10;20;Lauantai;3;2;5
95;07.10.2017;2017;10;21;Lauantai;1;5;6
95;07.10.2017;2017;10;22;Lauantai;0;1;1
95;07.10.2017;2017;10;23;Lauantai;0;0;0
95;08.10.2017;2017;10;00;Sunnuntai;1;0;1
95;08.10.2017;2017;10;01;Sunnuntai;1;2;3
95;08.10.2017;2017;10;02;Sunnuntai;0;0;0
95;08.10.2017;2017;10;03;Sunnuntai;0;1;1
95;08.10.2017;2017;10;04;Sunnuntai;0;0;0
95;08.10.2017;2017;10;05;Sunnuntai;0;0;0
95;08.10.2017;2017;10;06;Sunnuntai;1;0;1
95;08.10.2017;2017;10;07;Sunnuntai;1;3;4
95;08.10.2017;2017;10;08;Sunnuntai;2;4;6
95;08.10.2017;2017;10;09;Sunnuntai;0;4;4
95;08.10.2017;2017;10;10;Sunnuntai;6;6;12
95;08.10.2017;2017;10;11;Sunnuntai;9;15;24
95;08.10.2017;2017;10;12;Sunnuntai;20;7;27
95;08.10.2017;2017;10;13;Sunnuntai;11;11;22
95;08.10.2017;2017;10;14;Sunnuntai;13;8;21
95;08.10.2017;2017;10;15;Sunnuntai;3;7;10
95;08.10.2017;2017;10;16;Sunnuntai;13;12;25
95;08.10.2017;2017;10;17;Sunnuntai;7;9;16
95;08.10.2017;2017;10;18;Sunnuntai;14;5;19
95;08.10.2017;2017;10;19;Sunnuntai;6;2;8
95;08.10.2017;2017;10;20;Sunnuntai;6;2;8
95;08.10.2017;2017;10;21;Sunnuntai;0;8;8
95;08.10.2017;2017;10;22;Sunnuntai;0;0;0
95;08.10.2017;2017;10;23;Sunnuntai;0;0;0
95;09.10.2017;2017;10;00;Maanantai;1;0;1
95;09.10.2017;2017;10;01;Maanantai;0;0;0
95;09.10.2017;2017;10;02;Maanantai;0;0;0
95;09.10.2017;2017;10;03;Maanantai;0;1;1
95;09.10.2017;2017;10;04;Maanantai;1;0;1
95;09.10.2017;2017;10;05;Maanantai;5;2;7
95;09.10.2017;2017;10;06;Maanantai;10;10;20
95;09.10.2017;2017;10;07;Maanantai;16;22;38
95;09.10.2017;2017;10;08;Maanantai;15;11;26
95;09.10.2017;2017;10;09;Maanantai;9;19;28
95;09.10.2017;2017;10;10;Maanantai;3;9;12
95;09.10.2017;2017;10;11;Maanantai;9;6;15
95;09.10.2017;2017;10;12;Maanantai;8;4;12
95;09.10.2017;2017;10;13;Maanantai;10;9;19
95;09.10.2017;2017;10;14;Maanantai;11;9;20
95;09.10.2017;2017;10;15;Maanantai;22;23;45
95;09.10.2017;2017;10;16;Maanantai;33;20;53
95;09.10.2017;2017;10;17;Maanantai;10;13;23
95;09.10.2017;2017;10;18;Maanantai;9;14;23
95;09.10.2017;2017;10;19;Maanantai;10;7;17
95;09.10.2017;2017;10;20;Maanantai;2;4;6
95;09.10.2017;2017;10;21;Maanantai;3;3;6
95;09.10.2017;2017;10;22;Maanantai;3;2;5
95;09.10.2017;2017;10;23;Maanantai;1;0;1
95;10.10.2017;2017;10;00;Tiistai;0;0;0
95;10.10.2017;2017;10;01;Tiistai;0;0;0
95;10.10.2017;2017;10;02;Tiistai;0;0;0
95;10.10.2017;2017;10;03;Tiistai;0;0;0
95;10.10.2017;2017;10;04;Tiistai;0;0;0
95;10.10.2017;2017;10;05;Tiistai;3;3;6
95;10.10.2017;2017;10;06;Tiistai;9;9;18
95;10.10.2017;2017;10;07;Tiistai;9;16;25
95;10.10.2017;2017;10;08;Tiistai;8;11;19
95;10.10.2017;2017;10;09;Tiistai;7;2;9
95;10.10.2017;2017;10;10;Tiistai;5;1;6
95;10.10.2017;2017;10;11;Tiistai;1;2;3
95;10.10.2017;2017;10;12;Tiistai;3;1;4
95;10.10.2017;2017;10;13;Tiistai;5;4;9
95;10.10.2017;2017;10;14;Tiistai;8;4;12
95;10.10.2017;2017;10;15;Tiistai;11;12;23
95;10.10.2017;2017;10;16;Tiistai;16;14;30
95;10.10.2017;2017;10;17;Tiistai;4;8;12
95;10.10.2017;2017;10;18;Tiistai;3;8;11
95;10.10.2017;2017;10;19;Tiistai;1;1;2
95;10.10.2017;2017;10;20;Tiistai;0;0;0
95;10.10.2017;2017;10;21;Tiistai;1;0;1
95;10.10.2017;2017;10;22;Tiistai;3;1;4
95;10.10.2017;2017;10;23;Tiistai;0;0;0
95;11.10.2017;2017;10;00;Keskiviikko;0;0;0
95;11.10.2017;2017;10;01;Keskiviikko;0;0;0
95;11.10.2017;2017;10;02;Keskiviikko;0;0;0
95;11.10.2017;2017;10;03;Keskiviikko;0;1;1
95;11.10.2017;2017;10;04;Keskiviikko;1;0;1
95;11.10.2017;2017;10;05;Keskiviikko;4;3;7
95;11.10.2017;2017;10;06;Keskiviikko;10;7;17
95;11.10.2017;2017;10;07;Keskiviikko;15;20;35
95;11.10.2017;2017;10;08;Keskiviikko;9;18;27
95;11.10.2017;2017;10;09;Keskiviikko;10;2;12
95;11.10.2017;2017;10;10;Keskiviikko;5;6;11
95;11.10.2017;2017;10;11;Keskiviikko;9;9;18
95;11.10.2017;2017;10;12;Keskiviikko;6;8;14
95;11.10.2017;2017;10;13;Keskiviikko;9;12;21
95;11.10.2017;2017;10;14;Keskiviikko;19;11;30
95;11.10.2017;2017;10;15;Keskiviikko;16;19;35
95;11.10.2017;2017;10;16;Keskiviikko;25;18;43
95;11.10.2017;2017;10;17;Keskiviikko;12;9;21
95;11.10.2017;2017;10;18;Keskiviikko;9;12;21
95;11.10.2017;2017;10;19;Keskiviikko;5;7;12
95;11.10.2017;2017;10;20;Keskiviikko;5;2;7
95;11.10.2017;2017;10;21;Keskiviikko;2;5;7
95;11.10.2017;2017;10;22;Keskiviikko;1;3;4
95;11.10.2017;2017;10;23;Keskiviikko;0;2;2
95;12.10.2017;2017;10;00;Torstai;0;0;0
95;12.10.2017;2017;10;01;Torstai;0;0;0
95;12.10.2017;2017;10;02;Torstai;0;0;0
95;12.10.2017;2017;10;03;Torstai;0;0;0
95;12.10.2017;2017;10;04;Torstai;2;0;2
95;12.10.2017;2017;10;05;Torstai;6;2;8
95;12.10.2017;2017;10;06;Torstai;12;5;17
95;12.10.2017;2017;10;07;Torstai;18;19;37
95;12.10.2017;2017;10;08;Torstai;11;12;23
95;12.10.2017;2017;10;09;Torstai;8;11;19
95;12.10.2017;2017;10;10;Torstai;6;7;13
95;12.10.2017;2017;10;11;Torstai;5;8;13
95;12.10.2017;2017;10;12;Torstai;4;5;9
95;12.10.2017;2017;10;13;Torstai;9;9;18
95;12.10.2017;2017;10;14;Torstai;8;8;16
95;12.10.2017;2017;10;15;Torstai;18;21;39
95;12.10.2017;2017;10;16;Torstai;26;13;39
95;12.10.2017;2017;10;17;Torstai;7;11;18
95;12.10.2017;2017;10;18;Torstai;3;8;11
95;12.10.2017;2017;10;19;Torstai;4;5;9
95;12.10.2017;2017;10;20;Torstai;4;5;9
95;12.10.2017;2017;10;21;Torstai;5;3;8
95;12.10.2017;2017;10;22;Torstai;1;1;2
95;12.10.2017;2017;10;23;Torstai;0;1;1
95;13.10.2017;2017;10;00;Perjantai;1;0;1
95;13.10.2017;2017;10;01;Perjantai;0;0;0
95;13.10.2017;2017;10;02;Perjantai;0;1;1
95;13.10.2017;2017;10;03;Perjantai;0;0;0
95;13.10.2017;2017;10;04;Perjantai;0;0;0
95;13.10.2017;2017;10;05;Perjantai;6;3;9
95;13.10.2017;2017;10;06;Perjantai;13;12;25
95;13.10.2017;2017;10;07;Perjantai;9;17;26
95;13.10.2017;2017;10;08;Perjantai;14;13;27
95;13.10.2017;2017;10;09;Perjantai;5;11;16
95;13.10.2017;2017;10;10;Perjantai;7;12;19
95;13.10.2017;2017;10;11;Perjantai;5;3;8
95;13.10.2017;2017;10;12;Perjantai;9;8;17
95;13.10.2017;2017;10;13;Perjantai;16;5;21
95;13.10.2017;2017;10;14;Perjantai;20;11;31
95;13.10.2017;2017;10;15;Perjantai;11;12;23
95;13.10.2017;2017;10;16;Perjantai;16;13;29
95;13.10.2017;2017;10;17;Perjantai;3;11;14
95;13.10.2017;2017;10;18;Perjantai;4;10;14
95;13.10.2017;2017;10;19;Perjantai;5;3;8
95;13.10.2017;2017;10;20;Perjantai;1;2;3
95;13.10.2017;2017;10;21;Perjantai;1;2;3
95;13.10.2017;2017;10;22;Perjantai;1;4;5
95;13.10.2017;2017;10;23;Perjantai;0;0;0
95;14.10.2017;2017;10;00;Lauantai;0;0;0
95;14.10.2017;2017;10;01;Lauantai;0;0;0
95;14.10.2017;2017;10;02;Lauantai;0;1;1
95;14.10.2017;2017;10;03;Lauantai;0;1;1
95;14.10.2017;2017;10;04;Lauantai;1;2;3
95;14.10.2017;2017;10;05;Lauantai;3;0;3
95;14.10.2017;2017;10;06;Lauantai;5;1;6
95;14.10.2017;2017;10;07;Lauantai;2;1;3
95;14.10.2017;2017;10;08;Lauantai;3;3;6
95;14.10.2017;2017;10;09;Lauantai;5;9;14
95;14.10.2017;2017;10;10;Lauantai;7;7;14
95;14.10.2017;2017;10;11;Lauantai;6;4;10
95;14.10.2017;2017;10;12;Lauantai;6;9;15
95;14.10.2017;2017;10;13;Lauantai;8;10;18
95;14.10.2017;2017;10;14;Lauantai;2;9;11
95;14.10.2017;2017;10;15;Lauantai;9;8;17
95;14.10.2017;2017;10;16;Lauantai;3;2;5
95;14.10.2017;2017;10;17;Lauantai;3;3;6
95;14.10.2017;2017;10;18;Lauantai;1;2;3
95;14.10.2017;2017;10;19;Lauantai;0;0;0
95;14.10.2017;2017;10;20;Lauantai;0;0;0
95;14.10.2017;2017;10;21;Lauantai;2;0;2
95;14.10.2017;2017;10;22;Lauantai;0;1;1
95;14.10.2017;2017;10;23;Lauantai;1;0;1
95;15.10.2017;2017;10;00;Sunnuntai;0;0;0
95;15.10.2017;2017;10;01;Sunnuntai;0;1;1
95;15.10.2017;2017;10;02;Sunnuntai;0;1;1
95;15.10.2017;2017;10;03;Sunnuntai;1;0;1
95;15.10.2017;2017;10;04;Sunnuntai;1;0;1
95;15.10.2017;2017;10;05;Sunnuntai;0;0;0
95;15.10.2017;2017;10;06;Sunnuntai;3;0;3
95;15.10.2017;2017;10;07;Sunnuntai;0;2;2
95;15.10.2017;2017;10;08;Sunnuntai;3;1;4
95;15.10.2017;2017;10;09;Sunnuntai;4;1;5
95;15.10.2017;2017;10;10;Sunnuntai;5;4;9
95;15.10.2017;2017;10;11;Sunnuntai;9;9;18
95;15.10.2017;2017;10;12;Sunnuntai;5;10;15
95;15.10.2017;2017;10;13;Sunnuntai;7;14;21
95;15.10.2017;2017;10;14;Sunnuntai;8;13;21
95;15.10.2017;2017;10;15;Sunnuntai;6;8;14
95;15.10.2017;2017;10;16;Sunnuntai;15;11;26
95;15.10.2017;2017;10;17;Sunnuntai;8;6;14
95;15.10.2017;2017;10;18;Sunnuntai;3;7;10
95;15.10.2017;2017;10;19;Sunnuntai;6;1;7
95;15.10.2017;2017;10;20;Sunnuntai;1;3;4
95;15.10.2017;2017;10;21;Sunnuntai;1;2;3
95;15.10.2017;2017;10;22;Sunnuntai;0;1;1
95;15.10.2017;2017;10;23;Sunnuntai;0;0;0
95;16.10.2017;2017;10;00;Maanantai;0;0;0
95;16.10.2017;2017;10;01;Maanantai;0;0;0
95;16.10.2017;2017;10;02;Maanantai;0;0;0
95;16.10.2017;2017;10;03;Maanantai;0;0;0
95;16.10.2017;2017;10;04;Maanantai;1;0;1
95;16.10.2017;2017;10;05;Maanantai;5;3;8
95;16.10.2017;2017;10;06;Maanantai;6;8;14
95;16.10.2017;2017;10;07;Maanantai;4;10;14
95;16.10.2017;2017;10;08;Maanantai;10;6;16
95;16.10.2017;2017;10;09;Maanantai;4;10;14
95;16.10.2017;2017;10;10;Maanantai;0;2;2
95;16.10.2017;2017;10;11;Maanantai;1;2;3
95;16.10.2017;2017;10;12;Maanantai;1;4;5
95;16.10.2017;2017;10;13;Maanantai;4;3;7
95;16.10.2017;2017;10;14;Maanantai;6;3;9
95;16.10.2017;2017;10;15;Maanantai;10;17;27
95;16.10.2017;2017;10;16;Maanantai;18;13;31
95;16.10.2017;2017;10;17;Maanantai;8;10;18
95;16.10.2017;2017;10;18;Maanantai;5;3;8
95;16.10.2017;2017;10;19;Maanantai;1;4;5
95;16.10.2017;2017;10;20;Maanantai;1;1;2
95;16.10.2017;2017;10;21;Maanantai;1;1;2
95;16.10.2017;2017;10;22;Maanantai;0;1;1
95;16.10.2017;2017;10;23;Maanantai;0;0;0
95;17.10.2017;2017;10;00;Tiistai;0;0;0
95;17.10.2017;2017;10;01;Tiistai;0;0;0
95;17.10.2017;2017;10;02;Tiistai;0;0;0
95;17.10.2017;2017;10;03;Tiistai;0;1;1
95;17.10.2017;2017;10;04;Tiistai;0;0;0
95;17.10.2017;2017;10;05;Tiistai;3;3;6
95;17.10.2017;2017;10;06;Tiistai;11;14;25
95;17.10.2017;2017;10;07;Tiistai;11;28;39
95;17.10.2017;2017;10;08;Tiistai;15;11;26
95;17.10.2017;2017;10;09;Tiistai;4;4;8
95;17.10.2017;2017;10;10;Tiistai;5;8;13
95;17.10.2017;2017;10;11;Tiistai;2;4;6
95;17.10.2017;2017;10;12;Tiistai;10;7;17
95;17.10.2017;2017;10;13;Tiistai;8;10;18
95;17.10.2017;2017;10;14;Tiistai;20;9;29
95;17.10.2017;2017;10;15;Tiistai;24;18;42
95;17.10.2017;2017;10;16;Tiistai;23;17;40
95;17.10.2017;2017;10;17;Tiistai;9;20;29
95;17.10.2017;2017;10;18;Tiistai;3;6;9
95;17.10.2017;2017;10;19;Tiistai;5;10;15
95;17.10.2017;2017;10;20;Tiistai;4;4;8
95;17.10.2017;2017;10;21;Tiistai;1;2;3
95;17.10.2017;2017;10;22;Tiistai;1;2;3
95;17.10.2017;2017;10;23;Tiistai;0;0;0
95;18.10.2017;2017;10;00;Keskiviikko;0;0;0
95;18.10.2017;2017;10;01;Keskiviikko;0;0;0
95;18.10.2017;2017;10;02;Keskiviikko;0;0;0
95;18.10.2017;2017;10;03;Keskiviikko;0;0;0
95;18.10.2017;2017;10;04;Keskiviikko;0;0;0
95;18.10.2017;2017;10;05;Keskiviikko;4;5;9
95;18.10.2017;2017;10;06;Keskiviikko;14;13;27
95;18.10.2017;2017;10;07;Keskiviikko;13;17;30
95;18.10.2017;2017;10;08;Keskiviikko;13;16;29
95;18.10.2017;2017;10;09;Keskiviikko;5;5;10
95;18.10.2017;2017;10;10;Keskiviikko;4;5;9
95;18.10.2017;2017;10;11;Keskiviikko;7;11;18
95;18.10.2017;2017;10;12;Keskiviikko;7;5;12
95;18.10.2017;2017;10;13;Keskiviikko;8;2;10
95;18.10.2017;2017;10;14;Keskiviikko;17;6;23
95;18.10.2017;2017;10;15;Keskiviikko;11;14;25
95;18.10.2017;2017;10;16;Keskiviikko;16;17;33
95;18.10.2017;2017;10;17;Keskiviikko;10;7;17
95;18.10.2017;2017;10;18;Keskiviikko;4;6;10
95;18.10.2017;2017;10;19;Keskiviikko;6;5;11
95;18.10.2017;2017;10;20;Keskiviikko;3;4;7
95;18.10.2017;2017;10;21;Keskiviikko;1;1;2
95;18.10.2017;2017;10;22;Keskiviikko;0;1;1
95;18.10.2017;2017;10;23;Keskiviikko;0;0;0
95;19.10.2017;2017;10;00;Torstai;0;0;0
95;19.10.2017;2017;10;01;Torstai;0;0;0
95;19.10.2017;2017;10;02;Torstai;0;0;0
95;19.10.2017;2017;10;03;Torstai;0;0;0
95;19.10.2017;2017;10;04;Torstai;1;0;1
95;19.10.2017;2017;10;05;Torstai;4;3;7
95;19.10.2017;2017;10;06;Torstai;8;10;18
95;19.10.2017;2017;10;07;Torstai;14;18;32
95;19.10.2017;2017;10;08;Torstai;16;9;25
95;19.10.2017;2017;10;09;Torstai;2;8;10
95;19.10.2017;2017;10;10;Torstai;2;3;5
95;19.10.2017;2017;10;11;Torstai;5;6;11
95;19.10.2017;2017;10;12;Torstai;9;3;12
95;19.10.2017;2017;10;13;Torstai;3;11;14
95;19.10.2017;2017;10;14;Torstai;10;9;19
95;19.10.2017;2017;10;15;Torstai;17;14;31
95;19.10.2017;2017;10;16;Torstai;23;10;33
95;19.10.2017;2017;10;17;Torstai;12;13;25
95;19.10.2017;2017;10;18;Torstai;5;7;12
95;19.10.2017;2017;10;19;Torstai;5;5;10
95;19.10.2017;2017;10;20;Torstai;2;3;5
95;19.10.2017;2017;10;21;Torstai;1;1;2
95;19.10.2017;2017;10;22;Torstai;2;3;5
95;19.10.2017;2017;10;23;Torstai;0;0;0
95;20.10.2017;2017;10;00;Perjantai;0;0;0
95;20.10.2017;2017;10;01;Perjantai;2;0;2
95;20.10.2017;2017;10;02;Perjantai;0;0;0
95;20.10.2017;2017;10;03;Perjantai;0;0;0
95;20.10.2017;2017;10;04;Perjantai;0;0;0
95;20.10.2017;2017;10;05;Perjantai;2;3;5
95;20.10.2017;2017;10;06;Perjantai;4;6;10
95;20.10.2017;2017;10;07;Perjantai;5;17;22
95;20.10.2017;2017;10;08;Perjantai;11;14;25
95;20.10.2017;2017;10;09;Perjantai;2;3;5
95;20.10.2017;2017;10;10;Perjantai;5;3;8
95;20.10.2017;2017;10;11;Perjantai;1;4;5
95;20.10.2017;2017;10;12;Perjantai;4;3;7
95;20.10.2017;2017;10;13;Perjantai;12;2;14
95;20.10.2017;2017;10;14;Perjantai;6;6;12
95;20.10.2017;2017;10;15;Perjantai;18;2;20
95;20.10.2017;2017;10;16;Perjantai;8;11;19
95;20.10.2017;2017;10;17;Perjantai;1;7;8
95;20.10.2017;2017;10;18;Perjantai;0;4;4
95;20.10.2017;2017;10;19;Perjantai;3;3;6
95;20.10.2017;2017;10;20;Perjantai;1;1;2
95;20.10.2017;2017;10;21;Perjantai;1;3;4
95;20.10.2017;2017;10;22;Perjantai;1;1;2
95;20.10.2017;2017;10;23;Perjantai;0;0;0
95;21.10.2017;2017;10;00;Lauantai;0;0;0
95;21.10.2017;2017;10;01;Lauantai;0;0;0
95;21.10.2017;2017;10;02;Lauantai;2;0;2
95;21.10.2017;2017;10;03;Lauantai;0;0;0
95;21.10.2017;2017;10;04;Lauantai;1;0;1
95;21.10.2017;2017;10;05;Lauantai;0;1;1
95;21.10.2017;2017;10;06;Lauantai;1;0;1
95;21.10.2017;2017;10;07;Lauantai;1;3;4
95;21.10.2017;2017;10;08;Lauantai;0;1;1
95;21.10.2017;2017;10;09;Lauantai;1;3;4
95;21.10.2017;2017;10;10;Lauantai;1;2;3
95;21.10.2017;2017;10;11;Lauantai;0;3;3
95;21.10.2017;2017;10;12;Lauantai;3;4;7
95;21.10.2017;2017;10;13;Lauantai;1;3;4
95;21.10.2017;2017;10;14;Lauantai;4;2;6
95;21.10.2017;2017;10;15;Lauantai;3;6;9
95;21.10.2017;2017;10;16;Lauantai;4;3;7
95;21.10.2017;2017;10;17;Lauantai;1;4;5
95;21.10.2017;2017;10;18;Lauantai;1;1;2
95;21.10.2017;2017;10;19;Lauantai;1;3;4
95;21.10.2017;2017;10;20;Lauantai;1;3;4
95;21.10.2017;2017;10;21;Lauantai;0;3;3
95;21.10.2017;2017;10;22;Lauantai;1;0;1
95;21.10.2017;2017;10;23;Lauantai;1;0;1
95;22.10.2017;2017;10;00;Sunnuntai;1;0;1
95;22.10.2017;2017;10;01;Sunnuntai;0;0;0
95;22.10.2017;2017;10;02;Sunnuntai;0;0;0
95;22.10.2017;2017;10;03;Sunnuntai;0;0;0
95;22.10.2017;2017;10;04;Sunnuntai;0;0;0
95;22.10.2017;2017;10;05;Sunnuntai;0;0;0
95;22.10.2017;2017;10;06;Sunnuntai;1;0;1
95;22.10.2017;2017;10;07;Sunnuntai;1;1;2
95;22.10.2017;2017;10;08;Sunnuntai;4;2;6
95;22.10.2017;2017;10;09;Sunnuntai;2;3;5
95;22.10.2017;2017;10;10;Sunnuntai;2;2;4
95;22.10.2017;2017;10;11;Sunnuntai;4;2;6
95;22.10.2017;2017;10;12;Sunnuntai;8;6;14
95;22.10.2017;2017;10;13;Sunnuntai;10;6;16
95;22.10.2017;2017;10;14;Sunnuntai;3;5;8
95;22.10.2017;2017;10;15;Sunnuntai;4;4;8
95;22.10.2017;2017;10;16;Sunnuntai;4;4;8
95;22.10.2017;2017;10;17;Sunnuntai;2;4;6
95;22.10.2017;2017;10;18;Sunnuntai;1;2;3
95;22.10.2017;2017;10;19;Sunnuntai;0;3;3
95;22.10.2017;2017;10;20;Sunnuntai;1;1;2
95;22.10.2017;2017;10;21;Sunnuntai;0;0;0
95;22.10.2017;2017;10;22;Sunnuntai;0;0;0
95;22.10.2017;2017;10;23;Sunnuntai;0;0;0
95;23.10.2017;2017;10;00;Maanantai;0;0;0
95;23.10.2017;2017;10;01;Maanantai;0;0;0
95;23.10.2017;2017;10;02;Maanantai;0;0;0
95;23.10.2017;2017;10;03;Maanantai;0;0;0
95;23.10.2017;2017;10;04;Maanantai;0;0;0
95;23.10.2017;2017;10;05;Maanantai;4;2;6
95;23.10.2017;2017;10;06;Maanantai;3;6;9
95;23.10.2017;2017;10;07;Maanantai;6;6;12
95;23.10.2017;2017;10;08;Maanantai;5;8;13
95;23.10.2017;2017;10;09;Maanantai;3;1;4
95;23.10.2017;2017;10;10;Maanantai;3;1;4
95;23.10.2017;2017;10;11;Maanantai;6;3;9
95;23.10.2017;2017;10;12;Maanantai;8;3;11
95;23.10.2017;2017;10;13;Maanantai;2;8;10
95;23.10.2017;2017;10;14;Maanantai;3;10;13
95;23.10.2017;2017;10;15;Maanantai;11;7;18
95;23.10.2017;2017;10;16;Maanantai;11;5;16
95;23.10.2017;2017;10;17;Maanantai;7;6;13
95;23.10.2017;2017;10;18;Maanantai;2;8;10
95;23.10.2017;2017;10;19;Maanantai;1;2;3
95;23.10.2017;2017;10;20;Maanantai;1;3;4
95;23.10.2017;2017;10;21;Maanantai;1;1;2
95;23.10.2017;2017;10;22;Maanantai;2;0;2
95;23.10.2017;2017;10;23;Maanantai;1;0;1
95;24.10.2017;2017;10;00;Tiistai;0;0;0
95;24.10.2017;2017;10;01;Tiistai;0;1;1
95;24.10.2017;2017;10;02;Tiistai;1;1;2
95;24.10.2017;2017;10;03;Tiistai;0;0;0
95;24.10.2017;2017;10;04;Tiistai;0;0;0
95;24.10.2017;2017;10;05;Tiistai;8;3;11
95;24.10.2017;2017;10;06;Tiistai;4;4;8
95;24.10.2017;2017;10;07;Tiistai;6;8;14
95;24.10.2017;2017;10;08;Tiistai;6;6;12
95;24.10.2017;2017;10;09;Tiistai;2;4;6
95;24.10.2017;2017;10;10;Tiistai;2;0;2
95;24.10.2017;2017;10;11;Tiistai;3;6;9
95;24.10.2017;2017;10;12;Tiistai;3;4;7
95;24.10.2017;2017;10;13;Tiistai;3;3;6
95;24.10.2017;2017;10;14;Tiistai;1;8;9
95;24.10.2017;2017;10;15;Tiistai;12;12;24
95;24.10.2017;2017;10;16;Tiistai;10;4;14
95;24.10.2017;2017;10;17;Tiistai;3;8;11
95;24.10.2017;2017;10;18;Tiistai;2;7;9
95;24.10.2017;2017;10;19;Tiistai;2;5;7
95;24.10.2017;2017;10;20;Tiistai;3;0;3
95;24.10.2017;2017;10;21;Tiistai;1;3;4
95;24.10.2017;2017;10;22;Tiistai;2;0;2
95;24.10.2017;2017;10;23;Tiistai;0;0;0
95;25.10.2017;2017;10;00;Keskiviikko;0;0;0
95;25.10.2017;2017;10;01;Keskiviikko;0;2;2
95;25.10.2017;2017;10;02;Keskiviikko;0;0;0
95;25.10.2017;2017;10;03;Keskiviikko;0;0;0
95;25.10.2017;2017;10;04;Keskiviikko;1;0;1
95;25.10.2017;2017;10;05;Keskiviikko;3;2;5
95;25.10.2017;2017;10;06;Keskiviikko;5;5;10
95;25.10.2017;2017;10;07;Keskiviikko;4;4;8
95;25.10.2017;2017;10;08;Keskiviikko;8;7;15
95;25.10.2017;2017;10;09;Keskiviikko;5;3;8
95;25.10.2017;2017;10;10;Keskiviikko;6;4;10
95;25.10.2017;2017;10;11;Keskiviikko;4;1;5
95;25.10.2017;2017;10;12;Keskiviikko;5;4;9
95;25.10.2017;2017;10;13;Keskiviikko;3;4;7
95;25.10.2017;2017;10;14;Keskiviikko;1;5;6
95;25.10.2017;2017;10;15;Keskiviikko;7;9;16
95;25.10.2017;2017;10;16;Keskiviikko;8;5;13
95;25.10.2017;2017;10;17;Keskiviikko;4;7;11
95;25.10.2017;2017;10;18;Keskiviikko;2;6;8
95;25.10.2017;2017;10;19;Keskiviikko;4;3;7
95;25.10.2017;2017;10;20;Keskiviikko;2;4;6
95;25.10.2017;2017;10;21;Keskiviikko;2;2;4
95;25.10.2017;2017;10;22;Keskiviikko;1;2;3
95;25.10.2017;2017;10;23;Keskiviikko;0;0;0
95;26.10.2017;2017;10;00;Torstai;0;0;0
95;26.10.2017;2017;10;01;Torstai;0;0;0
95;26.10.2017;2017;10;02;Torstai;0;0;0
95;26.10.2017;2017;10;03;Torstai;0;0;0
95;26.10.2017;2017;10;04;Torstai;2;0;2
95;26.10.2017;2017;10;05;Torstai;6;2;8
95;26.10.2017;2017;10;06;Torstai;5;5;10
95;26.10.2017;2017;10;07;Torstai;4;7;11
95;26.10.2017;2017;10;08;Torstai;6;4;10
95;26.10.2017;2017;10;09;Torstai;5;3;8
95;26.10.2017;2017;10;10;Torstai;2;2;4
95;26.10.2017;2017;10;11;Torstai;2;4;6
95;26.10.2017;2017;10;12;Torstai;5;1;6
95;26.10.2017;2017;10;13;Torstai;2;1;3
95;26.10.2017;2017;10;14;Torstai;8;9;17
95;26.10.2017;2017;10;15;Torstai;9;8;17
95;26.10.2017;2017;10;16;Torstai;14;10;24
95;26.10.2017;2017;10;17;Torstai;5;8;13
95;26.10.2017;2017;10;18;Torstai;3;5;8
95;26.10.2017;2017;10;19;Torstai;1;1;2
95;26.10.2017;2017;10;20;Torstai;1;1;2
95;26.10.2017;2017;10;21;Torstai;0;1;1
95;26.10.2017;2017;10;22;Torstai;2;2;4
95;26.10.2017;2017;10;23;Torstai;0;0;0
95;27.10.2017;2017;10;00;Perjantai;0;1;1
95;27.10.2017;2017;10;01;Perjantai;0;0;0
95;27.10.2017;2017;10;02;Perjantai;0;0;0
95;27.10.2017;2017;10;03;Perjantai;0;0;0
95;27.10.2017;2017;10;04;Perjantai;0;1;1
95;27.10.2017;2017;10;05;Perjantai;4;1;5
95;27.10.2017;2017;10;06;Perjantai;4;2;6
95;27.10.2017;2017;10;07;Perjantai;2;9;11
95;27.10.2017;2017;10;08;Perjantai;5;3;8
95;27.10.2017;2017;10;09;Perjantai;8;2;10
95;27.10.2017;2017;10;10;Perjantai;4;1;5
95;27.10.2017;2017;10;11;Perjantai;10;7;17
95;27.10.2017;2017;10;12;Perjantai;5;4;9
95;27.10.2017;2017;10;13;Perjantai;7;3;10
95;27.10.2017;2017;10;14;Perjantai;3;9;12
95;27.10.2017;2017;10;15;Perjantai;5;9;14
95;27.10.2017;2017;10;16;Perjantai;5;8;13
95;27.10.2017;2017;10;17;Perjantai;6;5;11
95;27.10.2017;2017;10;18;Perjantai;6;4;10
95;27.10.2017;2017;10;19;Perjantai;1;5;6
95;27.10.2017;2017;10;20;Perjantai;0;2;2
95;27.10.2017;2017;10;21;Perjantai;1;1;2
95;27.10.2017;2017;10;22;Perjantai;0;1;1
95;27.10.2017;2017;10;23;Perjantai;0;1;1
95;28.10.2017;2017;10;00;Lauantai;0;0;0
95;28.10.2017;2017;10;01;Lauantai;0;1;1
95;28.10.2017;2017;10;02;Lauantai;0;0;0
95;28.10.2017;2017;10;03;Lauantai;0;0;0
95;28.10.2017;2017;10;04;Lauantai;0;0;0
95;28.10.2017;2017;10;05;Lauantai;0;1;1
95;28.10.2017;2017;10;06;Lauantai;1;0;1
95;28.10.2017;2017;10;07;Lauantai;0;1;1
95;28.10.2017;2017;10;08;Lauantai;2;0;2
95;28.10.2017;2017;10;09;Lauantai;1;0;1
95;28.10.2017;2017;10;10;Lauantai;1;2;3
95;28.10.2017;2017;10;11;Lauantai;1;1;2
95;28.10.2017;2017;10;12;Lauantai;2;1;3
95;28.10.2017;2017;10;13;Lauantai;1;3;4
95;28.10.2017;2017;10;14;Lauantai;0;1;1
95;28.10.2017;2017;10;15;Lauantai;4;1;5
95;28.10.2017;2017;10;16;Lauantai;3;0;3
95;28.10.2017;2017;10;17;Lauantai;1;1;2
95;28.10.2017;2017;10;18;Lauantai;0;0;0
95;28.10.2017;2017;10;19;Lauantai;1;0;1
95;28.10.2017;2017;10;20;Lauantai;0;0;0
95;28.10.2017;2017;10;21;Lauantai;0;1;1
95;28.10.2017;2017;10;22;Lauantai;0;2;2
95;28.10.2017;2017;10;23;Lauantai;0;2;2
95;29.10.2017;2017;10;00;Sunnuntai;0;0;0
95;29.10.2017;2017;10;01;Sunnuntai;1;0;1
95;29.10.2017;2017;10;02;Sunnuntai;1;0;1
95;29.10.2017;2017;10;03;Sunnuntai;0;0;0
95;29.10.2017;2017;10;04;Sunnuntai;0;0;0
95;29.10.2017;2017;10;05;Sunnuntai;0;1;1
95;29.10.2017;2017;10;06;Sunnuntai;1;0;1
95;29.10.2017;2017;10;07;Sunnuntai;0;0;0
95;29.10.2017;2017;10;08;Sunnuntai;0;1;1
95;29.10.2017;2017;10;09;Sunnuntai;0;0;0
95;29.10.2017;2017;10;10;Sunnuntai;2;0;2
95;29.10.2017;2017;10;11;Sunnuntai;0;0;0
95;29.10.2017;2017;10;12;Sunnuntai;1;0;1
95;29.10.2017;2017;10;13;Sunnuntai;0;0;0
95;29.10.2017;2017;10;14;Sunnuntai;0;0;0
95;29.10.2017;2017;10;15;Sunnuntai;3;2;5
95;29.10.2017;2017;10;16;Sunnuntai;0;0;0
95;29.10.2017;2017;10;17;Sunnuntai;2;0;2
95;29.10.2017;2017;10;18;Sunnuntai;1;0;1
95;29.10.2017;2017;10;19;Sunnuntai;0;1;1
95;29.10.2017;2017;10;20;Sunnuntai;0;0;0
95;29.10.2017;2017;10;21;Sunnuntai;0;0;0
95;29.10.2017;2017;10;22;Sunnuntai;0;2;2
95;29.10.2017;2017;10;23;Sunnuntai;0;0;0
95;30.10.2017;2017;10;00;Maanantai;0;0;0
95;30.10.2017;2017;10;01;Maanantai;0;0;0
95;30.10.2017;2017;10;02;Maanantai;0;0;0
95;30.10.2017;2017;10;03;Maanantai;0;0;0
95;30.10.2017;2017;10;04;Maanantai;0;0;0
95;30.10.2017;2017;10;05;Maanantai;0;1;1
95;30.10.2017;2017;10;06;Maanantai;9;7;16
95;30.10.2017;2017;10;07;Maanantai;5;6;11
95;30.10.2017;2017;10;08;Maanantai;8;4;12
95;30.10.2017;2017;10;09;Maanantai;4;5;9
95;30.10.2017;2017;10;10;Maanantai;4;2;6
95;30.10.2017;2017;10;11;Maanantai;3;3;6
95;30.10.2017;2017;10;12;Maanantai;1;3;4
95;30.10.2017;2017;10;13;Maanantai;2;2;4
95;30.10.2017;2017;10;14;Maanantai;6;3;9
95;30.10.2017;2017;10;15;Maanantai;5;7;12
95;30.10.2017;2017;10;16;Maanantai;15;8;23
95;30.10.2017;2017;10;17;Maanantai;2;8;10
95;30.10.2017;2017;10;18;Maanantai;6;7;13
95;30.10.2017;2017;10;19;Maanantai;3;3;6
95;30.10.2017;2017;10;20;Maanantai;2;3;5
95;30.10.2017;2017;10;21;Maanantai;2;0;2
95;30.10.2017;2017;10;22;Maanantai;0;0;0
95;30.10.2017;2017;10;23;Maanantai;0;2;2
95;31.10.2017;2017;10;00;Tiistai;0;0;0
95;31.10.2017;2017;10;01;Tiistai;0;0;0
95;31.10.2017;2017;10;02;Tiistai;0;0;0
95;31.10.2017;2017;10;03;Tiistai;0;0;0
95;31.10.2017;2017;10;04;Tiistai;0;1;1
95;31.10.2017;2017;10;05;Tiistai;4;6;10
95;31.10.2017;2017;10;06;Tiistai;10;7;17
95;31.10.2017;2017;10;07;Tiistai;10;14;24
95;31.10.2017;2017;10;08;Tiistai;8;13;21
95;31.10.2017;2017;10;09;Tiistai;3;5;8
95;31.10.2017;2017;10;10;Tiistai;1;2;3
95;31.10.2017;2017;10;11;Tiistai;4;0;4
95;31.10.2017;2017;10;12;Tiistai;3;2;5
95;31.10.2017;2017;10;13;Tiistai;2;1;3
95;31.10.2017;2017;10;14;Tiistai;17;4;21
95;31.10.2017;2017;10;15;Tiistai;14;12;26
95;31.10.2017;2017;10;16;Tiistai;9;13;22
95;31.10.2017;2017;10;17;Tiistai;6;6;12
95;31.10.2017;2017;10;18;Tiistai;4;5;9
95;31.10.2017;2017;10;19;Tiistai;0;2;2
95;31.10.2017;2017;10;20;Tiistai;3;1;4
95;31.10.2017;2017;10;21;Tiistai;1;2;3
95;31.10.2017;2017;10;22;Tiistai;0;0;0
95;31.10.2017;2017;10;23;Tiistai;0;0;0
95;01.11.2017;2017;11;00;Keskiviikko;0;0;0
95;01.11.2017;2017;11;01;Keskiviikko;0;0;0
95;01.11.2017;2017;11;02;Keskiviikko;0;0;0
95;01.11.2017;2017;11;03;Keskiviikko;0;0;0
95;01.11.2017;2017;11;04;Keskiviikko;0;0;0
95;01.11.2017;2017;11;05;Keskiviikko;2;4;6
95;01.11.2017;2017;11;06;Keskiviikko;2;4;6
95;01.11.2017;2017;11;07;Keskiviikko;4;10;14
95;01.11.2017;2017;11;08;Keskiviikko;5;8;13
95;01.11.2017;2017;11;09;Keskiviikko;2;4;6
95;01.11.2017;2017;11;10;Keskiviikko;0;2;2
95;01.11.2017;2017;11;11;Keskiviikko;1;1;2
95;01.11.2017;2017;11;12;Keskiviikko;3;1;4
95;01.11.2017;2017;11;13;Keskiviikko;4;2;6
95;01.11.2017;2017;11;14;Keskiviikko;8;4;12
95;01.11.2017;2017;11;15;Keskiviikko;7;6;13
95;01.11.2017;2017;11;16;Keskiviikko;13;5;18
95;01.11.2017;2017;11;17;Keskiviikko;4;3;7
95;01.11.2017;2017;11;18;Keskiviikko;1;2;3
95;01.11.2017;2017;11;19;Keskiviikko;4;4;8
95;01.11.2017;2017;11;20;Keskiviikko;1;0;1
95;01.11.2017;2017;11;21;Keskiviikko;3;0;3
95;01.11.2017;2017;11;22;Keskiviikko;0;0;0
95;01.11.2017;2017;11;23;Keskiviikko;0;0;0
95;02.11.2017;2017;11;00;Torstai;0;0;0
95;02.11.2017;2017;11;01;Torstai;0;0;0
95;02.11.2017;2017;11;02;Torstai;0;0;0
95;02.11.2017;2017;11;03;Torstai;0;0;0
95;02.11.2017;2017;11;04;Torstai;2;0;2
95;02.11.2017;2017;11;05;Torstai;5;2;7
95;02.11.2017;2017;11;06;Torstai;4;4;8
95;02.11.2017;2017;11;07;Torstai;3;6;9
95;02.11.2017;2017;11;08;Torstai;5;3;8
95;02.11.2017;2017;11;09;Torstai;4;3;7
95;02.11.2017;2017;11;10;Torstai;2;2;4
95;02.11.2017;2017;11;11;Torstai;2;3;5
95;02.11.2017;2017;11;12;Torstai;4;1;5
95;02.11.2017;2017;11;13;Torstai;2;1;3
95;02.11.2017;2017;11;14;Torstai;7;8;15
95;02.11.2017;2017;11;15;Torstai;8;7;15
95;02.11.2017;2017;11;16;Torstai;12;9;21
95;02.11.2017;2017;11;17;Torstai;4;7;11
95;02.11.2017;2017;11;18;Torstai;3;4;7
95;02.11.2017;2017;11;19;Torstai;1;1;2
95;02.11.2017;2017;11;20;Torstai;1;1;2
95;02.11.2017;2017;11;21;Torstai;0;1;1
95;02.11.2017;2017;11;22;Torstai;2;2;4
95;02.11.2017;2017;11;23;Torstai;0;0;0
95;03.11.2017;2017;11;00;Perjantai;0;0;0
95;03.11.2017;2017;11;01;Perjantai;0;0;0
95;03.11.2017;2017;11;02;Perjantai;0;0;0
95;03.11.2017;2017;11;03;Perjantai;0;0;0
95;03.11.2017;2017;11;04;Perjantai;0;0;0
95;03.11.2017;2017;11;05;Perjantai;6;4;10
95;03.11.2017;2017;11;06;Perjantai;6;7;13
95;03.11.2017;2017;11;07;Perjantai;6;9;15
95;03.11.2017;2017;11;08;Perjantai;5;6;11
95;03.11.2017;2017;11;09;Perjantai;4;4;8
95;03.11.2017;2017;11;10;Perjantai;2;2;4
95;03.11.2017;2017;11;11;Perjantai;1;5;6
95;03.11.2017;2017;11;12;Perjantai;1;3;4
95;03.11.2017;2017;11;13;Perjantai;8;7;15
95;03.11.2017;2017;11;14;Perjantai;8;6;14
95;03.11.2017;2017;11;15;Perjantai;10;8;18
95;03.11.2017;2017;11;16;Perjantai;8;9;17
95;03.11.2017;2017;11;17;Perjantai;3;6;9
95;03.11.2017;2017;11;18;Perjantai;3;3;6
95;03.11.2017;2017;11;19;Perjantai;4;5;9
95;03.11.2017;2017;11;20;Perjantai;0;1;1
95;03.11.2017;2017;11;21;Perjantai;0;2;2
95;03.11.2017;2017;11;22;Perjantai;0;0;0
95;03.11.2017;2017;11;23;Perjantai;0;0;0
95;04.11.2017;2017;11;00;Lauantai;0;0;0
95;04.11.2017;2017;11;01;Lauantai;0;0;0
95;04.11.2017;2017;11;02;Lauantai;0;0;0
95;04.11.2017;2017;11;03;Lauantai;0;0;0
95;04.11.2017;2017;11;04;Lauantai;1;0;1
95;04.11.2017;2017;11;05;Lauantai;0;0;0
95;04.11.2017;2017;11;06;Lauantai;1;1;2
95;04.11.2017;2017;11;07;Lauantai;3;0;3
95;04.11.2017;2017;11;08;Lauantai;1;2;3
95;04.11.2017;2017;11;09;Lauantai;2;3;5
95;04.11.2017;2017;11;10;Lauantai;4;4;8
95;04.11.2017;2017;11;11;Lauantai;4;4;8
95;04.11.2017;2017;11;12;Lauantai;7;5;12
95;04.11.2017;2017;11;13;Lauantai;1;3;4
95;04.11.2017;2017;11;14;Lauantai;9;8;17
95;04.11.2017;2017;11;15;Lauantai;2;1;3
95;04.11.2017;2017;11;16;Lauantai;1;2;3
95;04.11.2017;2017;11;17;Lauantai;1;3;4
95;04.11.2017;2017;11;18;Lauantai;0;4;4
95;04.11.2017;2017;11;19;Lauantai;2;1;3
95;04.11.2017;2017;11;20;Lauantai;0;0;0
95;04.11.2017;2017;11;21;Lauantai;0;0;0
95;04.11.2017;2017;11;22;Lauantai;0;2;2
95;04.11.2017;2017;11;23;Lauantai;0;0;0
95;05.11.2017;2017;11;00;Sunnuntai;0;2;2
95;05.11.2017;2017;11;01;Sunnuntai;0;0;0
95;05.11.2017;2017;11;02;Sunnuntai;0;0;0
95;05.11.2017;2017;11;03;Sunnuntai;0;0;0
95;05.11.2017;2017;11;04;Sunnuntai;1;1;2
95;05.11.2017;2017;11;05;Sunnuntai;0;0;0
95;05.11.2017;2017;11;06;Sunnuntai;2;0;2
95;05.11.2017;2017;11;07;Sunnuntai;1;1;2
95;05.11.2017;2017;11;08;Sunnuntai;2;2;4
95;05.11.2017;2017;11;09;Sunnuntai;1;2;3
95;05.11.2017;2017;11;10;Sunnuntai;4;5;9
95;05.11.2017;2017;11;11;Sunnuntai;2;3;5
95;05.11.2017;2017;11;12;Sunnuntai;2;4;6
95;05.11.2017;2017;11;13;Sunnuntai;3;5;8
95;05.11.2017;2017;11;14;Sunnuntai;3;12;15
95;05.11.2017;2017;11;15;Sunnuntai;5;2;7
95;05.11.2017;2017;11;16;Sunnuntai;3;1;4
95;05.11.2017;2017;11;17;Sunnuntai;2;1;3
95;05.11.2017;2017;11;18;Sunnuntai;0;1;1
95;05.11.2017;2017;11;19;Sunnuntai;0;3;3
95;05.11.2017;2017;11;20;Sunnuntai;2;0;2
95;05.11.2017;2017;11;21;Sunnuntai;0;1;1
95;05.11.2017;2017;11;22;Sunnuntai;0;0;0
95;05.11.2017;2017;11;23;Sunnuntai;0;0;0
95;06.11.2017;2017;11;00;Maanantai;0;0;0
95;06.11.2017;2017;11;01;Maanantai;0;0;0
95;06.11.2017;2017;11;02;Maanantai;0;0;0
95;06.11.2017;2017;11;03;Maanantai;0;0;0
95;06.11.2017;2017;11;04;Maanantai;0;0;0
95;06.11.2017;2017;11;05;Maanantai;6;0;6
95;06.11.2017;2017;11;06;Maanantai;4;5;9
95;06.11.2017;2017;11;07;Maanantai;7;8;15
95;06.11.2017;2017;11;08;Maanantai;3;6;9
95;06.11.2017;2017;11;09;Maanantai;5;10;15
95;06.11.2017;2017;11;10;Maanantai;2;2;4
95;06.11.2017;2017;11;11;Maanantai;8;2;10
95;06.11.2017;2017;11;12;Maanantai;1;1;2
95;06.11.2017;2017;11;13;Maanantai;6;6;12
95;06.11.2017;2017;11;14;Maanantai;4;8;12
95;06.11.2017;2017;11;15;Maanantai;8;6;14
95;06.11.2017;2017;11;16;Maanantai;17;8;25
95;06.11.2017;2017;11;17;Maanantai;7;9;16
95;06.11.2017;2017;11;18;Maanantai;5;4;9
95;06.11.2017;2017;11;19;Maanantai;1;6;7
95;06.11.2017;2017;11;20;Maanantai;1;4;5
95;06.11.2017;2017;11;21;Maanantai;3;2;5
95;06.11.2017;2017;11;22;Maanantai;1;1;2
95;06.11.2017;2017;11;23;Maanantai;0;1;1
95;07.11.2017;2017;11;00;Tiistai;0;0;0
95;07.11.2017;2017;11;01;Tiistai;0;0;0
95;07.11.2017;2017;11;02;Tiistai;0;0;0
95;07.11.2017;2017;11;03;Tiistai;0;0;0
95;07.11.2017;2017;11;04;Tiistai;0;0;0
95;07.11.2017;2017;11;05;Tiistai;8;2;10
95;07.11.2017;2017;11;06;Tiistai;13;10;23
95;07.11.2017;2017;11;07;Tiistai;12;16;28
95;07.11.2017;2017;11;08;Tiistai;5;9;14
95;07.11.2017;2017;11;09;Tiistai;7;4;11
95;07.11.2017;2017;11;10;Tiistai;6;1;7
95;07.11.2017;2017;11;11;Tiistai;4;3;7
95;07.11.2017;2017;11;12;Tiistai;3;5;8
95;07.11.2017;2017;11;13;Tiistai;3;8;11
95;07.11.2017;2017;11;14;Tiistai;12;9;21
95;07.11.2017;2017;11;15;Tiistai;12;15;27
95;07.11.2017;2017;11;16;Tiistai;13;16;29
95;07.11.2017;2017;11;17;Tiistai;8;5;13
95;07.11.2017;2017;11;18;Tiistai;8;5;13
95;07.11.2017;2017;11;19;Tiistai;0;5;5
95;07.11.2017;2017;11;20;Tiistai;2;2;4
95;07.11.2017;2017;11;21;Tiistai;4;3;7
95;07.11.2017;2017;11;22;Tiistai;1;3;4
95;07.11.2017;2017;11;23;Tiistai;0;1;1
95;08.11.2017;2017;11;00;Keskiviikko;0;0;0
95;08.11.2017;2017;11;01;Keskiviikko;0;0;0
95;08.11.2017;2017;11;02;Keskiviikko;0;0;0
95;08.11.2017;2017;11;03;Keskiviikko;0;0;0
95;08.11.2017;2017;11;04;Keskiviikko;3;0;3
95;08.11.2017;2017;11;05;Keskiviikko;4;2;6
95;08.11.2017;2017;11;06;Keskiviikko;5;7;12
95;08.11.2017;2017;11;07;Keskiviikko;8;20;28
95;08.11.2017;2017;11;08;Keskiviikko;6;8;14
95;08.11.2017;2017;11;09;Keskiviikko;3;7;10
95;08.11.2017;2017;11;10;Keskiviikko;3;2;5
95;08.11.2017;2017;11;11;Keskiviikko;4;5;9
95;08.11.2017;2017;11;12;Keskiviikko;4;2;6
95;08.11.2017;2017;11;13;Keskiviikko;9;5;14
95;08.11.2017;2017;11;14;Keskiviikko;9;8;17
95;08.11.2017;2017;11;15;Keskiviikko;8;6;14
95;08.11.2017;2017;11;16;Keskiviikko;12;8;20
95;08.11.2017;2017;11;17;Keskiviikko;4;5;9
95;08.11.2017;2017;11;18;Keskiviikko;7;6;13
95;08.11.2017;2017;11;19;Keskiviikko;1;5;6
95;08.11.2017;2017;11;20;Keskiviikko;2;3;5
95;08.11.2017;2017;11;21;Keskiviikko;0;1;1
95;08.11.2017;2017;11;22;Keskiviikko;0;2;2
95;08.11.2017;2017;11;23;Keskiviikko;0;0;0
95;09.11.2017;2017;11;00;Torstai;1;0;1
95;09.11.2017;2017;11;01;Torstai;0;0;0
95;09.11.2017;2017;11;02;Torstai;0;0;0
95;09.11.2017;2017;11;03;Torstai;0;0;0
95;09.11.2017;2017;11;04;Torstai;1;0;1
95;09.11.2017;2017;11;05;Torstai;5;1;6
95;09.11.2017;2017;11;06;Torstai;6;4;10
95;09.11.2017;2017;11;07;Torstai;8;11;19
95;09.11.2017;2017;11;08;Torstai;7;8;15
95;09.11.2017;2017;11;09;Torstai;5;9;14
95;09.11.2017;2017;11;10;Torstai;4;4;8
95;09.11.2017;2017;11;11;Torstai;2;7;9
95;09.11.2017;2017;11;12;Torstai;5;3;8
95;09.11.2017;2017;11;13;Torstai;6;6;12
95;09.11.2017;2017;11;14;Torstai;11;5;16
95;09.11.2017;2017;11;15;Torstai;13;11;24
95;09.11.2017;2017;11;16;Torstai;18;8;26
95;09.11.2017;2017;11;17;Torstai;7;7;14
95;09.11.2017;2017;11;18;Torstai;7;8;15
95;09.11.2017;2017;11;19;Torstai;2;4;6
95;09.11.2017;2017;11;20;Torstai;3;3;6
95;09.11.2017;2017;11;21;Torstai;0;3;3
95;09.11.2017;2017;11;22;Torstai;0;2;2
95;09.11.2017;2017;11;23;Torstai;2;1;3
95;10.11.2017;2017;11;00;Perjantai;1;0;1
95;10.11.2017;2017;11;01;Perjantai;0;0;0
95;10.11.2017;2017;11;02;Perjantai;0;0;0
95;10.11.2017;2017;11;03;Perjantai;0;0;0
95;10.11.2017;2017;11;04;Perjantai;0;0;0
95;10.11.2017;2017;11;05;Perjantai;1;2;3
95;10.11.2017;2017;11;06;Perjantai;4;4;8
95;10.11.2017;2017;11;07;Perjantai;3;10;13
95;10.11.2017;2017;11;08;Perjantai;3;10;13
95;10.11.2017;2017;11;09;Perjantai;4;4;8
95;10.11.2017;2017;11;10;Perjantai;2;4;6
95;10.11.2017;2017;11;11;Perjantai;7;3;10
95;10.11.2017;2017;11;12;Perjantai;4;7;11
95;10.11.2017;2017;11;13;Perjantai;9;7;16
95;10.11.2017;2017;11;14;Perjantai;10;5;15
95;10.11.2017;2017;11;15;Perjantai;9;7;16
95;10.11.2017;2017;11;16;Perjantai;6;6;12
95;10.11.2017;2017;11;17;Perjantai;5;2;7
95;10.11.2017;2017;11;18;Perjantai;3;4;7
95;10.11.2017;2017;11;19;Perjantai;3;3;6
95;10.11.2017;2017;11;20;Perjantai;0;3;3
95;10.11.2017;2017;11;21;Perjantai;0;2;2
95;10.11.2017;2017;11;22;Perjantai;0;4;4
95;10.11.2017;2017;11;23;Perjantai;0;0;0
95;11.11.2017;2017;11;00;Lauantai;0;3;3
95;11.11.2017;2017;11;01;Lauantai;0;0;0
95;11.11.2017;2017;11;02;Lauantai;0;0;0
95;11.11.2017;2017;11;03;Lauantai;0;0;0
95;11.11.2017;2017;11;04;Lauantai;0;0;0
95;11.11.2017;2017;11;05;Lauantai;1;1;2
95;11.11.2017;2017;11;06;Lauantai;2;0;2
95;11.11.2017;2017;11;07;Lauantai;1;1;2
95;11.11.2017;2017;11;08;Lauantai;1;0;1
95;11.11.2017;2017;11;09;Lauantai;5;5;10
95;11.11.2017;2017;11;10;Lauantai;4;10;14
95;11.11.2017;2017;11;11;Lauantai;7;2;9
95;11.11.2017;2017;11;12;Lauantai;7;2;9
95;11.11.2017;2017;11;13;Lauantai;4;3;7
95;11.11.2017;2017;11;14;Lauantai;2;3;5
95;11.11.2017;2017;11;15;Lauantai;3;10;13
95;11.11.2017;2017;11;16;Lauantai;2;3;5
95;11.11.2017;2017;11;17;Lauantai;3;2;5
95;11.11.2017;2017;11;18;Lauantai;2;0;2
95;11.11.2017;2017;11;19;Lauantai;0;2;2
95;11.11.2017;2017;11;20;Lauantai;0;2;2
95;11.11.2017;2017;11;21;Lauantai;0;2;2
95;11.11.2017;2017;11;22;Lauantai;1;3;4
95;11.11.2017;2017;11;23;Lauantai;1;1;2
95;12.11.2017;2017;11;00;Sunnuntai;0;1;1
95;12.11.2017;2017;11;01;Sunnuntai;0;0;0
95;12.11.2017;2017;11;02;Sunnuntai;0;0;0
95;12.11.2017;2017;11;03;Sunnuntai;1;0;1
95;12.11.2017;2017;11;04;Sunnuntai;0;0;0
95;12.11.2017;2017;11;05;Sunnuntai;1;1;2
95;12.11.2017;2017;11;06;Sunnuntai;1;0;1
95;12.11.2017;2017;11;07;Sunnuntai;0;1;1
95;12.11.2017;2017;11;08;Sunnuntai;1;1;2
95;12.11.2017;2017;11;09;Sunnuntai;2;2;4
95;12.11.2017;2017;11;10;Sunnuntai;6;3;9
95;12.11.2017;2017;11;11;Sunnuntai;4;4;8
95;12.11.2017;2017;11;12;Sunnuntai;1;5;6
95;12.11.2017;2017;11;13;Sunnuntai;3;4;7
95;12.11.2017;2017;11;14;Sunnuntai;7;4;11
95;12.11.2017;2017;11;15;Sunnuntai;1;1;2
95;12.11.2017;2017;11;16;Sunnuntai;0;1;1
95;12.11.2017;2017;11;17;Sunnuntai;1;0;1
95;12.11.2017;2017;11;18;Sunnuntai;4;2;6
95;12.11.2017;2017;11;19;Sunnuntai;0;1;1
95;12.11.2017;2017;11;20;Sunnuntai;2;4;6
95;12.11.2017;2017;11;21;Sunnuntai;0;1;1
95;12.11.2017;2017;11;22;Sunnuntai;0;0;0
95;12.11.2017;2017;11;23;Sunnuntai;0;0;0
95;13.11.2017;2017;11;00;Maanantai;0;0;0
95;13.11.2017;2017;11;01;Maanantai;0;0;0
95;13.11.2017;2017;11;02;Maanantai;0;0;0
95;13.11.2017;2017;11;03;Maanantai;0;0;0
95;13.11.2017;2017;11;04;Maanantai;0;0;0
95;13.11.2017;2017;11;05;Maanantai;5;3;8
95;13.11.2017;2017;11;06;Maanantai;7;5;12
95;13.11.2017;2017;11;07;Maanantai;6;9;15
95;13.11.2017;2017;11;08;Maanantai;6;5;11
95;13.11.2017;2017;11;09;Maanantai;4;12;16
95;13.11.2017;2017;11;10;Maanantai;7;3;10
95;13.11.2017;2017;11;11;Maanantai;5;6;11
95;13.11.2017;2017;11;12;Maanantai;4;5;9
95;13.11.2017;2017;11;13;Maanantai;5;5;10
95;13.11.2017;2017;11;14;Maanantai;8;8;16
95;13.11.2017;2017;11;15;Maanantai;9;10;19
95;13.11.2017;2017;11;16;Maanantai;18;9;27
95;13.11.2017;2017;11;17;Maanantai;5;8;13
95;13.11.2017;2017;11;18;Maanantai;4;4;8
95;13.11.2017;2017;11;19;Maanantai;4;4;8
95;13.11.2017;2017;11;20;Maanantai;2;5;7
95;13.11.2017;2017;11;21;Maanantai;5;2;7
95;13.11.2017;2017;11;22;Maanantai;0;1;1
95;13.11.2017;2017;11;23;Maanantai;1;0;1
95;14.11.2017;2017;11;00;Tiistai;0;0;0
95;14.11.2017;2017;11;01;Tiistai;0;0;0
95;14.11.2017;2017;11;02;Tiistai;0;0;0
95;14.11.2017;2017;11;03;Tiistai;0;0;0
95;14.11.2017;2017;11;04;Tiistai;3;0;3
95;14.11.2017;2017;11;05;Tiistai;5;3;8
95;14.11.2017;2017;11;06;Tiistai;7;6;13
95;14.11.2017;2017;11;07;Tiistai;9;15;24
95;14.11.2017;2017;11;08;Tiistai;7;6;13
95;14.11.2017;2017;11;09;Tiistai;5;4;9
95;14.11.2017;2017;11;10;Tiistai;4;3;7
95;14.11.2017;2017;11;11;Tiistai;0;0;0
95;14.11.2017;2017;11;12;Tiistai;3;7;10
95;14.11.2017;2017;11;13;Tiistai;2;3;5
95;14.11.2017;2017;11;14;Tiistai;14;5;19
95;14.11.2017;2017;11;15;Tiistai;7;9;16
95;14.11.2017;2017;11;16;Tiistai;10;7;17
95;14.11.2017;2017;11;17;Tiistai;2;11;13
95;14.11.2017;2017;11;18;Tiistai;6;6;12
95;14.11.2017;2017;11;19;Tiistai;2;4;6
95;14.11.2017;2017;11;20;Tiistai;4;2;6
95;14.11.2017;2017;11;21;Tiistai;1;0;1
95;14.11.2017;2017;11;22;Tiistai;1;1;2
95;14.11.2017;2017;11;23;Tiistai;0;0;0
95;15.11.2017;2017;11;00;Keskiviikko;0;0;0
95;15.11.2017;2017;11;01;Keskiviikko;0;0;0
95;15.11.2017;2017;11;02;Keskiviikko;0;0;0
95;15.11.2017;2017;11;03;Keskiviikko;0;0;0
95;15.11.2017;2017;11;04;Keskiviikko;3;0;3
95;15.11.2017;2017;11;05;Keskiviikko;4;2;6
95;15.11.2017;2017;11;06;Keskiviikko;5;8;13
95;15.11.2017;2017;11;07;Keskiviikko;9;21;30
95;15.11.2017;2017;11;08;Keskiviikko;7;9;16
95;15.11.2017;2017;11;09;Keskiviikko;3;8;11
95;15.11.2017;2017;11;10;Keskiviikko;3;2;5
95;15.11.2017;2017;11;11;Keskiviikko;4;5;9
95;15.11.2017;2017;11;12;Keskiviikko;4;2;6
95;15.11.2017;2017;11;13;Keskiviikko;9;5;14
95;15.11.2017;2017;11;14;Keskiviikko;9;9;18
95;15.11.2017;2017;11;15;Keskiviikko;9;7;16
95;15.11.2017;2017;11;16;Keskiviikko;12;9;21
95;15.11.2017;2017;11;17;Keskiviikko;4;5;9
95;15.11.2017;2017;11;18;Keskiviikko;8;7;15
95;15.11.2017;2017;11;19;Keskiviikko;1;5;6
95;15.11.2017;2017;11;20;Keskiviikko;2;3;5
95;15.11.2017;2017;11;21;Keskiviikko;0;1;1
95;15.11.2017;2017;11;22;Keskiviikko;0;2;2
95;15.11.2017;2017;11;23;Keskiviikko;0;0;0
95;16.11.2017;2017;11;00;Torstai;1;0;1
95;16.11.2017;2017;11;01;Torstai;0;0;0
95;16.11.2017;2017;11;02;Torstai;0;0;0
95;16.11.2017;2017;11;03;Torstai;0;0;0
95;16.11.2017;2017;11;04;Torstai;1;0;1
95;16.11.2017;2017;11;05;Torstai;5;1;6
95;16.11.2017;2017;11;06;Torstai;5;4;9
95;16.11.2017;2017;11;07;Torstai;6;9;15
95;16.11.2017;2017;11;08;Torstai;5;6;11
95;16.11.2017;2017;11;09;Torstai;5;7;12
95;16.11.2017;2017;11;10;Torstai;4;4;8
95;16.11.2017;2017;11;11;Torstai;2;5;7
95;16.11.2017;2017;11;12;Torstai;5;3;8
95;16.11.2017;2017;11;13;Torstai;5;5;10
95;16.11.2017;2017;11;14;Torstai;9;5;14
95;16.11.2017;2017;11;15;Torstai;11;9;20
95;16.11.2017;2017;11;16;Torstai;14;6;20
95;16.11.2017;2017;11;17;Torstai;5;5;10
95;16.11.2017;2017;11;18;Torstai;5;6;11
95;16.11.2017;2017;11;19;Torstai;2;4;6
95;16.11.2017;2017;11;20;Torstai;3;3;6
95;16.11.2017;2017;11;21;Torstai;0;3;3
95;16.11.2017;2017;11;22;Torstai;0;2;2
95;16.11.2017;2017;11;23;Torstai;2;1;3
95;17.11.2017;2017;11;00;Perjantai;1;0;1
95;17.11.2017;2017;11;01;Perjantai;0;0;0
95;17.11.2017;2017;11;02;Perjantai;0;0;0
95;17.11.2017;2017;11;03;Perjantai;0;0;0
95;17.11.2017;2017;11;04;Perjantai;0;1;1
95;17.11.2017;2017;11;05;Perjantai;4;3;7
95;17.11.2017;2017;11;06;Perjantai;2;2;4
95;17.11.2017;2017;11;07;Perjantai;5;12;17
95;17.11.2017;2017;11;08;Perjantai;6;8;14
95;17.11.2017;2017;11;09;Perjantai;2;1;3
95;17.11.2017;2017;11;10;Perjantai;1;1;2
95;17.11.2017;2017;11;11;Perjantai;1;1;2
95;17.11.2017;2017;11;12;Perjantai;1;1;2
95;17.11.2017;2017;11;13;Perjantai;11;4;15
95;17.11.2017;2017;11;14;Perjantai;8;3;11
95;17.11.2017;2017;11;15;Perjantai;8;6;14
95;17.11.2017;2017;11;16;Perjantai;7;5;12
95;17.11.2017;2017;11;17;Perjantai;4;1;5
95;17.11.2017;2017;11;18;Perjantai;3;2;5
95;17.11.2017;2017;11;19;Perjantai;2;3;5
95;17.11.2017;2017;11;20;Perjantai;1;3;4
95;17.11.2017;2017;11;21;Perjantai;1;1;2
95;17.11.2017;2017;11;22;Perjantai;0;1;1
95;17.11.2017;2017;11;23;Perjantai;0;0;0
95;18.11.2017;2017;11;00;Lauantai;0;0;0
95;18.11.2017;2017;11;01;Lauantai;0;0;0
95;18.11.2017;2017;11;02;Lauantai;0;1;1
95;18.11.2017;2017;11;03;Lauantai;0;0;0
95;18.11.2017;2017;11;04;Lauantai;1;0;1
95;18.11.2017;2017;11;05;Lauantai;0;0;0
95;18.11.2017;2017;11;06;Lauantai;0;0;0
95;18.11.2017;2017;11;07;Lauantai;1;0;1
95;18.11.2017;2017;11;08;Lauantai;2;0;2
95;18.11.2017;2017;11;09;Lauantai;0;0;0
95;18.11.2017;2017;11;10;Lauantai;5;0;5
95;18.11.2017;2017;11;11;Lauantai;6;6;12
95;18.11.2017;2017;11;12;Lauantai;0;5;5
95;18.11.2017;2017;11;13;Lauantai;0;6;6
95;18.11.2017;2017;11;14;Lauantai;5;6;11
95;18.11.2017;2017;11;15;Lauantai;1;1;2
95;18.11.2017;2017;11;16;Lauantai;2;7;9
95;18.11.2017;2017;11;17;Lauantai;2;3;5
95;18.11.2017;2017;11;18;Lauantai;1;3;4
95;18.11.2017;2017;11;19;Lauantai;3;1;4
95;18.11.2017;2017;11;20;Lauantai;0;1;1
95;18.11.2017;2017;11;21;Lauantai;0;0;0
95;18.11.2017;2017;11;22;Lauantai;0;2;2
95;18.11.2017;2017;11;23;Lauantai;0;0;0
95;19.11.2017;2017;11;00;Sunnuntai;0;1;1
95;19.11.2017;2017;11;01;Sunnuntai;0;0;0
95;19.11.2017;2017;11;02;Sunnuntai;0;0;0
95;19.11.2017;2017;11;03;Sunnuntai;2;0;2
95;19.11.2017;2017;11;04;Sunnuntai;1;0;1
95;19.11.2017;2017;11;05;Sunnuntai;0;0;0
95;19.11.2017;2017;11;06;Sunnuntai;0;0;0
95;19.11.2017;2017;11;07;Sunnuntai;1;0;1
95;19.11.2017;2017;11;08;Sunnuntai;0;1;1
95;19.11.2017;2017;11;09;Sunnuntai;2;1;3
95;19.11.2017;2017;11;10;Sunnuntai;7;2;9
95;19.11.2017;2017;11;11;Sunnuntai;1;0;1
95;19.11.2017;2017;11;12;Sunnuntai;3;5;8
95;19.11.2017;2017;11;13;Sunnuntai;0;2;2
95;19.11.2017;2017;11;14;Sunnuntai;2;3;5
95;19.11.2017;2017;11;15;Sunnuntai;2;2;4
95;19.11.2017;2017;11;16;Sunnuntai;0;2;2
95;19.11.2017;2017;11;17;Sunnuntai;0;0;0
95;19.11.2017;2017;11;18;Sunnuntai;4;1;5
95;19.11.2017;2017;11;19;Sunnuntai;1;1;2
95;19.11.2017;2017;11;20;Sunnuntai;0;2;2
95;19.11.2017;2017;11;21;Sunnuntai;2;0;2
95;19.11.2017;2017;11;22;Sunnuntai;0;0;0
95;19.11.2017;2017;11;23;Sunnuntai;0;0;0
95;20.11.2017;2017;11;00;Maanantai;0;0;0
95;20.11.2017;2017;11;01;Maanantai;1;0;1
95;20.11.2017;2017;11;02;Maanantai;0;0;0
95;20.11.2017;2017;11;03;Maanantai;0;0;0
95;20.11.2017;2017;11;04;Maanantai;0;0;0
95;20.11.2017;2017;11;05;Maanantai;4;1;5
95;20.11.2017;2017;11;06;Maanantai;7;8;15
95;20.11.2017;2017;11;07;Maanantai;3;12;15
95;20.11.2017;2017;11;08;Maanantai;5;7;12
95;20.11.2017;2017;11;09;Maanantai;8;10;18
95;20.11.2017;2017;11;10;Maanantai;5;4;9
95;20.11.2017;2017;11;11;Maanantai;3;8;11
95;20.11.2017;2017;11;12;Maanantai;2;4;6
95;20.11.2017;2017;11;13;Maanantai;3;4;7
95;20.11.2017;2017;11;14;Maanantai;6;6;12
95;20.11.2017;2017;11;15;Maanantai;9;8;17
95;20.11.2017;2017;11;16;Maanantai;17;7;24
95;20.11.2017;2017;11;17;Maanantai;10;6;16
95;20.11.2017;2017;11;18;Maanantai;2;5;7
95;20.11.2017;2017;11;19;Maanantai;3;3;6
95;20.11.2017;2017;11;20;Maanantai;1;3;4
95;20.11.2017;2017;11;21;Maanantai;2;1;3
95;20.11.2017;2017;11;22;Maanantai;1;0;1
95;20.11.2017;2017;11;23;Maanantai;1;0;1
95;21.11.2017;2017;11;00;Tiistai;0;0;0
95;21.11.2017;2017;11;01;Tiistai;0;0;0
95;21.11.2017;2017;11;02;Tiistai;0;1;1
95;21.11.2017;2017;11;03;Tiistai;0;0;0
95;21.11.2017;2017;11;04;Tiistai;0;0;0
95;21.11.2017;2017;11;05;Tiistai;3;1;4
95;21.11.2017;2017;11;06;Tiistai;11;6;17
95;21.11.2017;2017;11;07;Tiistai;6;21;27
95;21.11.2017;2017;11;08;Tiistai;7;4;11
95;21.11.2017;2017;11;09;Tiistai;3;4;7
95;21.11.2017;2017;11;10;Tiistai;6;3;9
95;21.11.2017;2017;11;11;Tiistai;0;4;4
95;21.11.2017;2017;11;12;Tiistai;2;3;5
95;21.11.2017;2017;11;13;Tiistai;2;3;5
95;21.11.2017;2017;11;14;Tiistai;11;4;15
95;21.11.2017;2017;11;15;Tiistai;7;9;16
95;21.11.2017;2017;11;16;Tiistai;16;12;28
95;21.11.2017;2017;11;17;Tiistai;2;8;10
95;21.11.2017;2017;11;18;Tiistai;3;4;7
95;21.11.2017;2017;11;19;Tiistai;2;3;5
95;21.11.2017;2017;11;20;Tiistai;3;2;5
95;21.11.2017;2017;11;21;Tiistai;1;1;2
95;21.11.2017;2017;11;22;Tiistai;0;0;0
95;21.11.2017;2017;11;23;Tiistai;0;0;0
95;22.11.2017;2017;11;00;Keskiviikko;1;1;2
95;22.11.2017;2017;11;01;Keskiviikko;0;0;0
95;22.11.2017;2017;11;02;Keskiviikko;0;0;0
95;22.11.2017;2017;11;03;Keskiviikko;0;0;0
95;22.11.2017;2017;11;04;Keskiviikko;1;0;1
95;22.11.2017;2017;11;05;Keskiviikko;5;3;8
95;22.11.2017;2017;11;06;Keskiviikko;5;4;9
95;22.11.2017;2017;11;07;Keskiviikko;9;16;25
95;22.11.2017;2017;11;08;Keskiviikko;4;7;11
95;22.11.2017;2017;11;09;Keskiviikko;4;2;6
95;22.11.2017;2017;11;10;Keskiviikko;5;0;5
95;22.11.2017;2017;11;11;Keskiviikko;1;2;3
95;22.11.2017;2017;11;12;Keskiviikko;4;1;5
95;22.11.2017;2017;11;13;Keskiviikko;1;3;4
95;22.11.2017;2017;11;14;Keskiviikko;2;8;10
95;22.11.2017;2017;11;15;Keskiviikko;6;8;14
95;22.11.2017;2017;11;16;Keskiviikko;12;9;21
95;22.11.2017;2017;11;17;Keskiviikko;7;7;14
95;22.11.2017;2017;11;18;Keskiviikko;1;4;5
95;22.11.2017;2017;11;19;Keskiviikko;0;0;0
95;22.11.2017;2017;11;20;Keskiviikko;0;0;0
95;22.11.2017;2017;11;21;Keskiviikko;1;0;1
95;22.11.2017;2017;11;22;Keskiviikko;1;0;1
95;22.11.2017;2017;11;23;Keskiviikko;0;0;0
95;23.11.2017;2017;11;00;Torstai;0;0;0
95;23.11.2017;2017;11;01;Torstai;1;0;1
95;23.11.2017;2017;11;02;Torstai;0;0;0
95;23.11.2017;2017;11;03;Torstai;0;0;0
95;23.11.2017;2017;11;04;Torstai;1;0;1
95;23.11.2017;2017;11;05;Torstai;2;2;4
95;23.11.2017;2017;11;06;Torstai;4;1;5
95;23.11.2017;2017;11;07;Torstai;11;14;25
95;23.11.2017;2017;11;08;Torstai;2;5;7
95;23.11.2017;2017;11;09;Torstai;2;1;3
95;23.11.2017;2017;11;10;Torstai;3;1;4
95;23.11.2017;2017;11;11;Torstai;4;1;5
95;23.11.2017;2017;11;12;Torstai;0;1;1
95;23.11.2017;2017;11;13;Torstai;3;2;5
95;23.11.2017;2017;11;14;Torstai;0;6;6
95;23.11.2017;2017;11;15;Torstai;3;5;8
95;23.11.2017;2017;11;16;Torstai;8;3;11
95;23.11.2017;2017;11;17;Torstai;5;3;8
95;23.11.2017;2017;11;18;Torstai;2;4;6
95;23.11.2017;2017;11;19;Torstai;1;1;2
95;23.11.2017;2017;11;20;Torstai;2;0;2
95;23.11.2017;2017;11;21;Torstai;0;1;1
95;23.11.2017;2017;11;22;Torstai;1;0;1
95;23.11.2017;2017;11;23;Torstai;0;0;0
95;24.11.2017;2017;11;00;Perjantai;0;0;0
95;24.11.2017;2017;11;01;Perjantai;0;0;0
95;24.11.2017;2017;11;02;Perjantai;0;0;0
95;24.11.2017;2017;11;03;Perjantai;0;0;0
95;24.11.2017;2017;11;04;Perjantai;0;0;0
95;24.11.2017;2017;11;05;Perjantai;2;2;4
95;24.11.2017;2017;11;06;Perjantai;4;5;9
95;24.11.2017;2017;11;07;Perjantai;2;2;4
95;24.11.2017;2017;11;08;Perjantai;3;2;5
95;24.11.2017;2017;11;09;Perjantai;2;0;2
95;24.11.2017;2017;11;10;Perjantai;6;1;7
95;24.11.2017;2017;11;11;Perjantai;2;4;6
95;24.11.2017;2017;11;12;Perjantai;2;0;2
95;24.11.2017;2017;11;13;Perjantai;3;1;4
95;24.11.2017;2017;11;14;Perjantai;3;6;9
95;24.11.2017;2017;11;15;Perjantai;3;5;8
95;24.11.2017;2017;11;16;Perjantai;1;5;6
95;24.11.2017;2017;11;17;Perjantai;7;5;12
95;24.11.2017;2017;11;18;Perjantai;1;0;1
95;24.11.2017;2017;11;19;Perjantai;0;0;0
95;24.11.2017;2017;11;20;Perjantai;0;1;1
95;24.11.2017;2017;11;21;Perjantai;0;2;2
95;24.11.2017;2017;11;22;Perjantai;0;1;1
95;24.11.2017;2017;11;23;Perjantai;1;0;1
95;25.11.2017;2017;11;00;Lauantai;0;0;0
95;25.11.2017;2017;11;01;Lauantai;0;0;0
95;25.11.2017;2017;11;02;Lauantai;0;0;0
95;25.11.2017;2017;11;03;Lauantai;0;0;0
95;25.11.2017;2017;11;04;Lauantai;1;2;3
95;25.11.2017;2017;11;05;Lauantai;0;0;0
95;25.11.2017;2017;11;06;Lauantai;2;0;2
95;25.11.2017;2017;11;07;Lauantai;1;0;1
95;25.11.2017;2017;11;08;Lauantai;1;0;1
95;25.11.2017;2017;11;09;Lauantai;2;1;3
95;25.11.2017;2017;11;10;Lauantai;0;1;1
95;25.11.2017;2017;11;11;Lauantai;2;2;4
95;25.11.2017;2017;11;12;Lauantai;1;4;5
95;25.11.2017;2017;11;13;Lauantai;3;3;6
95;25.11.2017;2017;11;14;Lauantai;3;5;8
95;25.11.2017;2017;11;15;Lauantai;3;3;6
95;25.11.2017;2017;11;16;Lauantai;2;1;3
95;25.11.2017;2017;11;17;Lauantai;0;3;3
95;25.11.2017;2017;11;18;Lauantai;4;1;5
95;25.11.2017;2017;11;19;Lauantai;3;2;5
95;25.11.2017;2017;11;20;Lauantai;0;0;0
95;25.11.2017;2017;11;21;Lauantai;1;1;2
95;25.11.2017;2017;11;22;Lauantai;0;1;1
95;25.11.2017;2017;11;23;Lauantai;0;0;0
95;26.11.2017;2017;11;00;Sunnuntai;0;0;0
95;26.11.2017;2017;11;01;Sunnuntai;0;0;0
95;26.11.2017;2017;11;02;Sunnuntai;1;0;1
95;26.11.2017;2017;11;03;Sunnuntai;0;2;2
95;26.11.2017;2017;11;04;Sunnuntai;0;0;0
95;26.11.2017;2017;11;05;Sunnuntai;0;0;0
95;26.11.2017;2017;11;06;Sunnuntai;3;0;3
95;26.11.2017;2017;11;07;Sunnuntai;0;0;0
95;26.11.2017;2017;11;08;Sunnuntai;0;0;0
95;26.11.2017;2017;11;09;Sunnuntai;1;2;3
95;26.11.2017;2017;11;10;Sunnuntai;2;1;3
95;26.11.2017;2017;11;11;Sunnuntai;4;0;4
95;26.11.2017;2017;11;12;Sunnuntai;1;8;9
95;26.11.2017;2017;11;13;Sunnuntai;2;3;5
95;26.11.2017;2017;11;14;Sunnuntai;1;5;6
95;26.11.2017;2017;11;15;Sunnuntai;3;3;6
95;26.11.2017;2017;11;16;Sunnuntai;1;6;7
95;26.11.2017;2017;11;17;Sunnuntai;2;0;2
95;26.11.2017;2017;11;18;Sunnuntai;1;2;3
95;26.11.2017;2017;11;19;Sunnuntai;0;2;2
95;26.11.2017;2017;11;20;Sunnuntai;0;0;0
95;26.11.2017;2017;11;21;Sunnuntai;0;0;0
95;26.11.2017;2017;11;22;Sunnuntai;0;1;1
95;26.11.2017;2017;11;23;Sunnuntai;0;0;0
95;27.11.2017;2017;11;00;Maanantai;0;0;0
95;27.11.2017;2017;11;01;Maanantai;0;0;0
95;27.11.2017;2017;11;02;Maanantai;0;0;0
95;27.11.2017;2017;11;03;Maanantai;0;0;0
95;27.11.2017;2017;11;04;Maanantai;0;0;0
95;27.11.2017;2017;11;05;Maanantai;4;3;7
95;27.11.2017;2017;11;06;Maanantai;7;5;12
95;27.11.2017;2017;11;07;Maanantai;12;13;25
95;27.11.2017;2017;11;08;Maanantai;8;5;13
95;27.11.2017;2017;11;09;Maanantai;8;3;11
95;27.11.2017;2017;11;10;Maanantai;3;3;6
95;27.11.2017;2017;11;11;Maanantai;6;2;8
95;27.11.2017;2017;11;12;Maanantai;7;1;8
95;27.11.2017;2017;11;13;Maanantai;1;2;3
95;27.11.2017;2017;11;14;Maanantai;6;9;15
95;27.11.2017;2017;11;15;Maanantai;11;7;18
95;27.11.2017;2017;11;16;Maanantai;8;10;18
95;27.11.2017;2017;11;17;Maanantai;5;3;8
95;27.11.2017;2017;11;18;Maanantai;1;3;4
95;27.11.2017;2017;11;19;Maanantai;2;2;4
95;27.11.2017;2017;11;20;Maanantai;0;1;1
95;27.11.2017;2017;11;21;Maanantai;1;2;3
95;27.11.2017;2017;11;22;Maanantai;2;0;2
95;27.11.2017;2017;11;23;Maanantai;1;2;3
95;28.11.2017;2017;11;00;Tiistai;0;0;0
95;28.11.2017;2017;11;01;Tiistai;1;0;1
95;28.11.2017;2017;11;02;Tiistai;0;0;0
95;28.11.2017;2017;11;03;Tiistai;0;0;0
95;28.11.2017;2017;11;04;Tiistai;2;0;2
95;28.11.2017;2017;11;05;Tiistai;2;4;6
95;28.11.2017;2017;11;06;Tiistai;6;3;9
95;28.11.2017;2017;11;07;Tiistai;15;10;25
95;28.11.2017;2017;11;08;Tiistai;6;7;13
95;28.11.2017;2017;11;09;Tiistai;4;1;5
95;28.11.2017;2017;11;10;Tiistai;6;2;8
95;28.11.2017;2017;11;11;Tiistai;3;3;6
95;28.11.2017;2017;11;12;Tiistai;2;3;5
95;28.11.2017;2017;11;13;Tiistai;2;3;5
95;28.11.2017;2017;11;14;Tiistai;6;1;7
95;28.11.2017;2017;11;15;Tiistai;4;6;10
95;28.11.2017;2017;11;16;Tiistai;7;10;17
95;28.11.2017;2017;11;17;Tiistai;5;5;10
95;28.11.2017;2017;11;18;Tiistai;2;2;4
95;28.11.2017;2017;11;19;Tiistai;3;2;5
95;28.11.2017;2017;11;20;Tiistai;0;5;5
95;28.11.2017;2017;11;21;Tiistai;1;1;2
95;28.11.2017;2017;11;22;Tiistai;1;1;2
95;28.11.2017;2017;11;23;Tiistai;0;0;0
95;29.11.2017;2017;11;00;Keskiviikko;0;0;0
95;29.11.2017;2017;11;01;Keskiviikko;0;1;1
95;29.11.2017;2017;11;02;Keskiviikko;0;0;0
95;29.11.2017;2017;11;03;Keskiviikko;0;0;0
95;29.11.2017;2017;11;04;Keskiviikko;2;0;2
95;29.11.2017;2017;11;05;Keskiviikko;1;2;3
95;29.11.2017;2017;11;06;Keskiviikko;8;4;12
95;29.11.2017;2017;11;07;Keskiviikko;12;13;25
95;29.11.2017;2017;11;08;Keskiviikko;3;3;6
95;29.11.2017;2017;11;09;Keskiviikko;2;1;3
95;29.11.2017;2017;11;10;Keskiviikko;4;1;5
95;29.11.2017;2017;11;11;Keskiviikko;0;1;1
95;29.11.2017;2017;11;12;Keskiviikko;1;3;4
95;29.11.2017;2017;11;13;Keskiviikko;2;3;5
95;29.11.2017;2017;11;14;Keskiviikko;0;4;4
95;29.11.2017;2017;11;15;Keskiviikko;10;7;17
95;29.11.2017;2017;11;16;Keskiviikko;11;11;22
95;29.11.2017;2017;11;17;Keskiviikko;4;4;8
95;29.11.2017;2017;11;18;Keskiviikko;4;4;8
95;29.11.2017;2017;11;19;Keskiviikko;1;2;3
95;29.11.2017;2017;11;20;Keskiviikko;1;2;3
95;29.11.2017;2017;11;21;Keskiviikko;1;0;1
95;29.11.2017;2017;11;22;Keskiviikko;1;0;1
95;29.11.2017;2017;11;23;Keskiviikko;0;1;1
95;30.11.2017;2017;11;00;Torstai;0;1;1
95;30.11.2017;2017;11;01;Torstai;1;0;1
95;30.11.2017;2017;11;02;Torstai;0;0;0
95;30.11.2017;2017;11;03;Torstai;0;0;0
95;30.11.2017;2017;11;04;Torstai;2;0;2
95;30.11.2017;2017;11;05;Torstai;4;3;7
95;30.11.2017;2017;11;06;Torstai;10;5;15
95;30.11.2017;2017;11;07;Torstai;7;10;17
95;30.11.2017;2017;11;08;Torstai;2;8;10
95;30.11.2017;2017;11;09;Torstai;6;9;15
95;30.11.2017;2017;11;10;Torstai;4;2;6
95;30.11.2017;2017;11;11;Torstai;2;4;6
95;30.11.2017;2017;11;12;Torstai;1;3;4
95;30.11.2017;2017;11;13;Torstai;2;5;7
95;30.11.2017;2017;11;14;Torstai;8;5;13
95;30.11.2017;2017;11;15;Torstai;6;7;13
95;30.11.2017;2017;11;16;Torstai;19;9;28
95;30.11.2017;2017;11;17;Torstai;6;5;11
95;30.11.2017;2017;11;18;Torstai;0;3;3
95;30.11.2017;2017;11;19;Torstai;3;3;6
95;30.11.2017;2017;11;20;Torstai;0;0;0
95;30.11.2017;2017;11;21;Torstai;1;2;3
95;30.11.2017;2017;11;22;Torstai;0;0;0
95;30.11.2017;2017;11;23;Torstai;1;0;1
95;01.12.2017;2017;12;00;Perjantai;0;0;0
95;01.12.2017;2017;12;01;Perjantai;0;0;0
95;01.12.2017;2017;12;02;Perjantai;0;0;0
95;01.12.2017;2017;12;03;Perjantai;0;1;1
95;01.12.2017;2017;12;04;Perjantai;0;1;1
95;01.12.2017;2017;12;05;Perjantai;5;3;8
95;01.12.2017;2017;12;06;Perjantai;7;5;12
95;01.12.2017;2017;12;07;Perjantai;4;10;14
95;01.12.2017;2017;12;08;Perjantai;7;11;18
95;01.12.2017;2017;12;09;Perjantai;5;2;7
95;01.12.2017;2017;12;10;Perjantai;4;4;8
95;01.12.2017;2017;12;11;Perjantai;4;4;8
95;01.12.2017;2017;12;12;Perjantai;6;0;6
95;01.12.2017;2017;12;13;Perjantai;8;7;15
95;01.12.2017;2017;12;14;Perjantai;10;9;19
95;01.12.2017;2017;12;15;Perjantai;13;9;22
95;01.12.2017;2017;12;16;Perjantai;7;5;12
95;01.12.2017;2017;12;17;Perjantai;4;5;9
95;01.12.2017;2017;12;18;Perjantai;0;4;4
95;01.12.2017;2017;12;19;Perjantai;0;1;1
95;01.12.2017;2017;12;20;Perjantai;0;1;1
95;01.12.2017;2017;12;21;Perjantai;1;1;2
95;01.12.2017;2017;12;22;Perjantai;2;0;2
95;01.12.2017;2017;12;23;Perjantai;0;0;0
95;02.12.2017;2017;12;00;Lauantai;1;1;2
95;02.12.2017;2017;12;01;Lauantai;0;0;0
95;02.12.2017;2017;12;02;Lauantai;0;0;0
95;02.12.2017;2017;12;03;Lauantai;0;0;0
95;02.12.2017;2017;12;04;Lauantai;2;0;2
95;02.12.2017;2017;12;05;Lauantai;1;0;1
95;02.12.2017;2017;12;06;Lauantai;0;0;0
95;02.12.2017;2017;12;07;Lauantai;0;0;0
95;02.12.2017;2017;12;08;Lauantai;0;0;0
95;02.12.2017;2017;12;09;Lauantai;2;2;4
95;02.12.2017;2017;12;10;Lauantai;4;0;4
95;02.12.2017;2017;12;11;Lauantai;3;3;6
95;02.12.2017;2017;12;12;Lauantai;1;6;7
95;02.12.2017;2017;12;13;Lauantai;1;4;5
95;02.12.2017;2017;12;14;Lauantai;3;4;7
95;02.12.2017;2017;12;15;Lauantai;3;2;5
95;02.12.2017;2017;12;16;Lauantai;2;1;3
95;02.12.2017;2017;12;17;Lauantai;2;1;3
95;02.12.2017;2017;12;18;Lauantai;0;2;2
95;02.12.2017;2017;12;19;Lauantai;0;0;0
95;02.12.2017;2017;12;20;Lauantai;1;2;3
95;02.12.2017;2017;12;21;Lauantai;1;3;4
95;02.12.2017;2017;12;22;Lauantai;0;0;0
95;02.12.2017;2017;12;23;Lauantai;0;0;0
95;03.12.2017;2017;12;00;Sunnuntai;1;0;1
95;03.12.2017;2017;12;01;Sunnuntai;1;0;1
95;03.12.2017;2017;12;02;Sunnuntai;2;0;2
95;03.12.2017;2017;12;03;Sunnuntai;0;0;0
95;03.12.2017;2017;12;04;Sunnuntai;0;0;0
95;03.12.2017;2017;12;05;Sunnuntai;0;0;0
95;03.12.2017;2017;12;06;Sunnuntai;1;0;1
95;03.12.2017;2017;12;07;Sunnuntai;0;0;0
95;03.12.2017;2017;12;08;Sunnuntai;0;1;1
95;03.12.2017;2017;12;09;Sunnuntai;1;1;2
95;03.12.2017;2017;12;10;Sunnuntai;3;2;5
95;03.12.2017;2017;12;11;Sunnuntai;2;0;2
95;03.12.2017;2017;12;12;Sunnuntai;2;6;8
95;03.12.2017;2017;12;13;Sunnuntai;2;3;5
95;03.12.2017;2017;12;14;Sunnuntai;6;2;8
95;03.12.2017;2017;12;15;Sunnuntai;2;1;3
95;03.12.2017;2017;12;16;Sunnuntai;1;2;3
95;03.12.2017;2017;12;17;Sunnuntai;6;2;8
95;03.12.2017;2017;12;18;Sunnuntai;2;3;5
95;03.12.2017;2017;12;19;Sunnuntai;1;0;1
95;03.12.2017;2017;12;20;Sunnuntai;0;1;1
95;03.12.2017;2017;12;21;Sunnuntai;1;1;2
95;03.12.2017;2017;12;22;Sunnuntai;0;1;1
95;03.12.2017;2017;12;23;Sunnuntai;0;0;0
95;04.12.2017;2017;12;00;Maanantai;0;0;0
95;04.12.2017;2017;12;01;Maanantai;0;0;0
95;04.12.2017;2017;12;02;Maanantai;0;0;0
95;04.12.2017;2017;12;03;Maanantai;0;0;0
95;04.12.2017;2017;12;04;Maanantai;0;0;0
95;04.12.2017;2017;12;05;Maanantai;2;3;5
95;04.12.2017;2017;12;06;Maanantai;7;3;10
95;04.12.2017;2017;12;07;Maanantai;7;7;14
95;04.12.2017;2017;12;08;Maanantai;4;10;14
95;04.12.2017;2017;12;09;Maanantai;5;11;16
95;04.12.2017;2017;12;10;Maanantai;3;1;4
95;04.12.2017;2017;12;11;Maanantai;1;2;3
95;04.12.2017;2017;12;12;Maanantai;1;1;2
95;04.12.2017;2017;12;13;Maanantai;4;4;8
95;04.12.2017;2017;12;14;Maanantai;4;5;9
95;04.12.2017;2017;12;15;Maanantai;8;6;14
95;04.12.2017;2017;12;16;Maanantai;15;7;22
95;04.12.2017;2017;12;17;Maanantai;7;5;12
95;04.12.2017;2017;12;18;Maanantai;1;5;6
95;04.12.2017;2017;12;19;Maanantai;0;1;1
95;04.12.2017;2017;12;20;Maanantai;0;1;1
95;04.12.2017;2017;12;21;Maanantai;1;0;1
95;04.12.2017;2017;12;22;Maanantai;1;1;2
95;04.12.2017;2017;12;23;Maanantai;0;0;0
95;05.12.2017;2017;12;00;Tiistai;0;0;0
95;05.12.2017;2017;12;01;Tiistai;0;0;0
95;05.12.2017;2017;12;02;Tiistai;0;0;0
95;05.12.2017;2017;12;03;Tiistai;0;1;1
95;05.12.2017;2017;12;04;Tiistai;1;0;1
95;05.12.2017;2017;12;05;Tiistai;1;3;4
95;05.12.2017;2017;12;06;Tiistai;5;2;7
95;05.12.2017;2017;12;07;Tiistai;5;7;12
95;05.12.2017;2017;12;08;Tiistai;7;13;20
95;05.12.2017;2017;12;09;Tiistai;3;2;5
95;05.12.2017;2017;12;10;Tiistai;2;4;6
95;05.12.2017;2017;12;11;Tiistai;2;2;4
95;05.12.2017;2017;12;12;Tiistai;1;1;2
95;05.12.2017;2017;12;13;Tiistai;1;2;3
95;05.12.2017;2017;12;14;Tiistai;10;6;16
95;05.12.2017;2017;12;15;Tiistai;5;3;8
95;05.12.2017;2017;12;16;Tiistai;5;3;8
95;05.12.2017;2017;12;17;Tiistai;2;1;3
95;05.12.2017;2017;12;18;Tiistai;3;4;7
95;05.12.2017;2017;12;19;Tiistai;5;2;7
95;05.12.2017;2017;12;20;Tiistai;3;0;3
95;05.12.2017;2017;12;21;Tiistai;1;1;2
95;05.12.2017;2017;12;22;Tiistai;2;2;4
95;05.12.2017;2017;12;23;Tiistai;0;0;0
95;06.12.2017;2017;12;00;Keskiviikko;0;2;2
95;06.12.2017;2017;12;01;Keskiviikko;0;0;0
95;06.12.2017;2017;12;02;Keskiviikko;1;0;1
95;06.12.2017;2017;12;03;Keskiviikko;0;0;0
95;06.12.2017;2017;12;04;Keskiviikko;2;1;3
95;06.12.2017;2017;12;05;Keskiviikko;0;1;1
95;06.12.2017;2017;12;06;Keskiviikko;2;0;2
95;06.12.2017;2017;12;07;Keskiviikko;0;0;0
95;06.12.2017;2017;12;08;Keskiviikko;3;1;4
95;06.12.2017;2017;12;09;Keskiviikko;1;2;3
95;06.12.2017;2017;12;10;Keskiviikko;2;1;3
95;06.12.2017;2017;12;11;Keskiviikko;4;2;6
95;06.12.2017;2017;12;12;Keskiviikko;3;0;3
95;06.12.2017;2017;12;13;Keskiviikko;0;0;0
95;06.12.2017;2017;12;14;Keskiviikko;1;2;3
95;06.12.2017;2017;12;15;Keskiviikko;1;3;4
95;06.12.2017;2017;12;16;Keskiviikko;1;3;4
95;06.12.2017;2017;12;17;Keskiviikko;2;2;4
95;06.12.2017;2017;12;18;Keskiviikko;1;0;1
95;06.12.2017;2017;12;19;Keskiviikko;2;0;2
95;06.12.2017;2017;12;20;Keskiviikko;2;0;2
95;06.12.2017;2017;12;21;Keskiviikko;0;1;1
95;06.12.2017;2017;12;22;Keskiviikko;0;1;1
95;06.12.2017;2017;12;23;Keskiviikko;1;0;1
95;07.12.2017;2017;12;00;Torstai;0;2;2
95;07.12.2017;2017;12;01;Torstai;0;0;0
95;07.12.2017;2017;12;02;Torstai;0;0;0
95;07.12.2017;2017;12;03;Torstai;0;0;0
95;07.12.2017;2017;12;04;Torstai;0;0;0
95;07.12.2017;2017;12;05;Torstai;4;2;6
95;07.12.2017;2017;12;06;Torstai;6;4;10
95;07.12.2017;2017;12;07;Torstai;5;8;13
95;07.12.2017;2017;12;08;Torstai;4;6;10
95;07.12.2017;2017;12;09;Torstai;3;7;10
95;07.12.2017;2017;12;10;Torstai;3;1;4
95;07.12.2017;2017;12;11;Torstai;0;0;0
95;07.12.2017;2017;12;12;Torstai;2;1;3
95;07.12.2017;2017;12;13;Torstai;3;4;7
95;07.12.2017;2017;12;14;Torstai;2;5;7
95;07.12.2017;2017;12;15;Torstai;9;8;17
95;07.12.2017;2017;12;16;Torstai;14;6;20
95;07.12.2017;2017;12;17;Torstai;7;4;11
95;07.12.2017;2017;12;18;Torstai;2;10;12
95;07.12.2017;2017;12;19;Torstai;1;1;2
95;07.12.2017;2017;12;20;Torstai;0;2;2
95;07.12.2017;2017;12;21;Torstai;0;1;1
95;07.12.2017;2017;12;22;Torstai;0;1;1
95;07.12.2017;2017;12;23;Torstai;0;2;2
95;08.12.2017;2017;12;00;Perjantai;0;0;0
95;08.12.2017;2017;12;01;Perjantai;0;0;0
95;08.12.2017;2017;12;02;Perjantai;0;0;0
95;08.12.2017;2017;12;03;Perjantai;0;0;0
95;08.12.2017;2017;12;04;Perjantai;0;0;0
95;08.12.2017;2017;12;05;Perjantai;3;1;4
95;08.12.2017;2017;12;06;Perjantai;3;3;6
95;08.12.2017;2017;12;07;Perjantai;5;4;9
95;08.12.2017;2017;12;08;Perjantai;4;4;8
95;08.12.2017;2017;12;09;Perjantai;2;3;5
95;08.12.2017;2017;12;10;Perjantai;1;0;1
95;08.12.2017;2017;12;11;Perjantai;1;0;1
95;08.12.2017;2017;12;12;Perjantai;0;1;1
95;08.12.2017;2017;12;13;Perjantai;4;1;5
95;08.12.2017;2017;12;14;Perjantai;5;4;9
95;08.12.2017;2017;12;15;Perjantai;3;2;5
95;08.12.2017;2017;12;16;Perjantai;4;2;6
95;08.12.2017;2017;12;17;Perjantai;0;3;3
95;08.12.2017;2017;12;18;Perjantai;1;1;2
95;08.12.2017;2017;12;19;Perjantai;0;2;2
95;08.12.2017;2017;12;20;Perjantai;0;1;1
95;08.12.2017;2017;12;21;Perjantai;0;0;0
95;08.12.2017;2017;12;22;Perjantai;0;0;0
95;08.12.2017;2017;12;23;Perjantai;0;0;0
95;09.12.2017;2017;12;00;Lauantai;0;0;0
95;09.12.2017;2017;12;01;Lauantai;0;0;0
95;09.12.2017;2017;12;02;Lauantai;0;0;0
95;09.12.2017;2017;12;03;Lauantai;0;0;0
95;09.12.2017;2017;12;04;Lauantai;1;1;2
95;09.12.2017;2017;12;05;Lauantai;1;1;2
95;09.12.2017;2017;12;06;Lauantai;4;0;4
95;09.12.2017;2017;12;07;Lauantai;0;0;0
95;09.12.2017;2017;12;08;Lauantai;1;1;2
95;09.12.2017;2017;12;09;Lauantai;3;1;4
95;09.12.2017;2017;12;10;Lauantai;4;6;10
95;09.12.2017;2017;12;11;Lauantai;2;1;3
95;09.12.2017;2017;12;12;Lauantai;3;8;11
95;09.12.2017;2017;12;13;Lauantai;0;4;4
95;09.12.2017;2017;12;14;Lauantai;4;0;4
95;09.12.2017;2017;12;15;Lauantai;1;5;6
95;09.12.2017;2017;12;16;Lauantai;3;3;6
95;09.12.2017;2017;12;17;Lauantai;0;1;1
95;09.12.2017;2017;12;18;Lauantai;3;1;4
95;09.12.2017;2017;12;19;Lauantai;0;0;0
95;09.12.2017;2017;12;20;Lauantai;0;3;3
95;09.12.2017;2017;12;21;Lauantai;2;1;3
95;09.12.2017;2017;12;22;Lauantai;1;0;1
95;09.12.2017;2017;12;23;Lauantai;0;0;0
95;10.12.2017;2017;12;00;Sunnuntai;0;2;2
95;10.12.2017;2017;12;01;Sunnuntai;3;0;3
95;10.12.2017;2017;12;02;Sunnuntai;0;0;0
95;10.12.2017;2017;12;03;Sunnuntai;0;1;1
95;10.12.2017;2017;12;04;Sunnuntai;0;0;0
95;10.12.2017;2017;12;05;Sunnuntai;0;0;0
95;10.12.2017;2017;12;06;Sunnuntai;2;0;2
95;10.12.2017;2017;12;07;Sunnuntai;0;0;0
95;10.12.2017;2017;12;08;Sunnuntai;0;2;2
95;10.12.2017;2017;12;09;Sunnuntai;0;1;1
95;10.12.2017;2017;12;10;Sunnuntai;5;0;5
95;10.12.2017;2017;12;11;Sunnuntai;3;1;4
95;10.12.2017;2017;12;12;Sunnuntai;1;3;4
95;10.12.2017;2017;12;13;Sunnuntai;7;2;9
95;10.12.2017;2017;12;14;Sunnuntai;0;4;4
95;10.12.2017;2017;12;15;Sunnuntai;0;2;2
95;10.12.2017;2017;12;16;Sunnuntai;0;1;1
95;10.12.2017;2017;12;17;Sunnuntai;2;2;4
95;10.12.2017;2017;12;18;Sunnuntai;0;1;1
95;10.12.2017;2017;12;19;Sunnuntai;2;1;3
95;10.12.2017;2017;12;20;Sunnuntai;1;0;1
95;10.12.2017;2017;12;21;Sunnuntai;3;4;7
95;10.12.2017;2017;12;22;Sunnuntai;0;1;1
95;10.12.2017;2017;12;23;Sunnuntai;0;0;0
95;11.12.2017;2017;12;00;Maanantai;0;0;0
95;11.12.2017;2017;12;01;Maanantai;0;0;0
95;11.12.2017;2017;12;02;Maanantai;0;0;0
95;11.12.2017;2017;12;03;Maanantai;0;1;1
95;11.12.2017;2017;12;04;Maanantai;2;0;2
95;11.12.2017;2017;12;05;Maanantai;3;3;6
95;11.12.2017;2017;12;06;Maanantai;12;5;17
95;11.12.2017;2017;12;07;Maanantai;8;8;16
95;11.12.2017;2017;12;08;Maanantai;3;11;14
95;11.12.2017;2017;12;09;Maanantai;6;6;12
95;11.12.2017;2017;12;10;Maanantai;0;3;3
95;11.12.2017;2017;12;11;Maanantai;3;1;4
95;11.12.2017;2017;12;12;Maanantai;5;2;7
95;11.12.2017;2017;12;13;Maanantai;4;4;8
95;11.12.2017;2017;12;14;Maanantai;8;7;15
95;11.12.2017;2017;12;15;Maanantai;10;10;20
95;11.12.2017;2017;12;16;Maanantai;18;8;26
95;11.12.2017;2017;12;17;Maanantai;9;7;16
95;11.12.2017;2017;12;18;Maanantai;2;5;7
95;11.12.2017;2017;12;19;Maanantai;3;1;4
95;11.12.2017;2017;12;20;Maanantai;1;0;1
95;11.12.2017;2017;12;21;Maanantai;1;3;4
95;11.12.2017;2017;12;22;Maanantai;0;1;1
95;11.12.2017;2017;12;23;Maanantai;0;1;1
95;12.12.2017;2017;12;00;Tiistai;0;1;1
95;12.12.2017;2017;12;01;Tiistai;0;0;0
95;12.12.2017;2017;12;02;Tiistai;0;0;0
95;12.12.2017;2017;12;03;Tiistai;0;0;0
95;12.12.2017;2017;12;04;Tiistai;2;0;2
95;12.12.2017;2017;12;05;Tiistai;6;6;12
95;12.12.2017;2017;12;06;Tiistai;2;5;7
95;12.12.2017;2017;12;07;Tiistai;15;10;25
95;12.12.2017;2017;12;08;Tiistai;2;14;16
95;12.12.2017;2017;12;09;Tiistai;3;1;4
95;12.12.2017;2017;12;10;Tiistai;6;1;7
95;12.12.2017;2017;12;11;Tiistai;1;1;2
95;12.12.2017;2017;12;12;Tiistai;3;5;8
95;12.12.2017;2017;12;13;Tiistai;2;3;5
95;12.12.2017;2017;12;14;Tiistai;5;7;12
95;12.12.2017;2017;12;15;Tiistai;7;2;9
95;12.12.2017;2017;12;16;Tiistai;10;6;16
95;12.12.2017;2017;12;17;Tiistai;5;5;10
95;12.12.2017;2017;12;18;Tiistai;1;0;1
95;12.12.2017;2017;12;19;Tiistai;2;1;3
95;12.12.2017;2017;12;20;Tiistai;2;0;2
95;12.12.2017;2017;12;21;Tiistai;0;0;0
95;12.12.2017;2017;12;22;Tiistai;0;0;0
95;12.12.2017;2017;12;23;Tiistai;0;0;0
95;13.12.2017;2017;12;00;Keskiviikko;0;0;0
95;13.12.2017;2017;12;01;Keskiviikko;0;0;0
95;13.12.2017;2017;12;02;Keskiviikko;0;0;0
95;13.12.2017;2017;12;03;Keskiviikko;0;0;0
95;13.12.2017;2017;12;04;Keskiviikko;0;0;0
95;13.12.2017;2017;12;05;Keskiviikko;5;1;6
95;13.12.2017;2017;12;06;Keskiviikko;6;5;11
95;13.12.2017;2017;12;07;Keskiviikko;4;3;7
95;13.12.2017;2017;12;08;Keskiviikko;3;7;10
95;13.12.2017;2017;12;09;Keskiviikko;4;4;8
95;13.12.2017;2017;12;10;Keskiviikko;0;3;3
95;13.12.2017;2017;12;11;Keskiviikko;0;1;1
95;13.12.2017;2017;12;12;Keskiviikko;0;0;0
95;13.12.2017;2017;12;13;Keskiviikko;5;1;6
95;13.12.2017;2017;12;14;Keskiviikko;6;2;8
95;13.12.2017;2017;12;15;Keskiviikko;3;7;10
95;13.12.2017;2017;12;16;Keskiviikko;9;6;15
95;13.12.2017;2017;12;17;Keskiviikko;4;1;5
95;13.12.2017;2017;12;18;Keskiviikko;1;3;4
95;13.12.2017;2017;12;19;Keskiviikko;1;0;1
95;13.12.2017;2017;12;20;Keskiviikko;0;1;1
95;13.12.2017;2017;12;21;Keskiviikko;0;2;2
95;13.12.2017;2017;12;22;Keskiviikko;0;0;0
95;13.12.2017;2017;12;23;Keskiviikko;0;1;1
95;14.12.2017;2017;12;00;Torstai;0;0;0
95;14.12.2017;2017;12;01;Torstai;0;0;0
95;14.12.2017;2017;12;02;Torstai;0;0;0
95;14.12.2017;2017;12;03;Torstai;0;0;0
95;14.12.2017;2017;12;04;Torstai;0;0;0
95;14.12.2017;2017;12;05;Torstai;2;3;5
95;14.12.2017;2017;12;06;Torstai;8;6;14
95;14.12.2017;2017;12;07;Torstai;9;7;16
95;14.12.2017;2017;12;08;Torstai;5;4;9
95;14.12.2017;2017;12;09;Torstai;2;12;14
95;14.12.2017;2017;12;10;Torstai;0;2;2
95;14.12.2017;2017;12;11;Torstai;1;1;2
95;14.12.2017;2017;12;12;Torstai;1;1;2
95;14.12.2017;2017;12;13;Torstai;1;4;5
95;14.12.2017;2017;12;14;Torstai;8;3;11
95;14.12.2017;2017;12;15;Torstai;4;4;8
95;14.12.2017;2017;12;16;Torstai;18;7;25
95;14.12.2017;2017;12;17;Torstai;6;4;10
95;14.12.2017;2017;12;18;Torstai;2;2;4
95;14.12.2017;2017;12;19;Torstai;2;5;7
95;14.12.2017;2017;12;20;Torstai;0;1;1
95;14.12.2017;2017;12;21;Torstai;1;0;1
95;14.12.2017;2017;12;22;Torstai;0;1;1
95;14.12.2017;2017;12;23;Torstai;0;0;0
95;15.12.2017;2017;12;00;Perjantai;0;0;0
95;15.12.2017;2017;12;01;Perjantai;0;0;0
95;15.12.2017;2017;12;02;Perjantai;0;0;0
95;15.12.2017;2017;12;03;Perjantai;0;0;0
95;15.12.2017;2017;12;04;Perjantai;0;0;0
95;15.12.2017;2017;12;05;Perjantai;3;3;6
95;15.12.2017;2017;12;06;Perjantai;8;4;12
95;15.12.2017;2017;12;07;Perjantai;2;8;10
95;15.12.2017;2017;12;08;Perjantai;2;9;11
95;15.12.2017;2017;12;09;Perjantai;3;6;9
95;15.12.2017;2017;12;10;Perjantai;3;1;4
95;15.12.2017;2017;12;11;Perjantai;6;2;8
95;15.12.2017;2017;12;12;Perjantai;2;1;3
95;15.12.2017;2017;12;13;Perjantai;7;4;11
95;15.12.2017;2017;12;14;Perjantai;11;5;16
95;15.12.2017;2017;12;15;Perjantai;14;5;19
95;15.12.2017;2017;12;16;Perjantai;1;3;4
95;15.12.2017;2017;12;17;Perjantai;0;0;0
95;15.12.2017;2017;12;18;Perjantai;1;3;4
95;15.12.2017;2017;12;19;Perjantai;3;3;6
95;15.12.2017;2017;12;20;Perjantai;1;0;1
95;15.12.2017;2017;12;21;Perjantai;1;0;1
95;15.12.2017;2017;12;22;Perjantai;0;1;1
95;15.12.2017;2017;12;23;Perjantai;1;0;1
95;16.12.2017;2017;12;00;Lauantai;0;0;0
95;16.12.2017;2017;12;01;Lauantai;0;0;0
95;16.12.2017;2017;12;02;Lauantai;0;0;0
95;16.12.2017;2017;12;03;Lauantai;0;0;0
95;16.12.2017;2017;12;04;Lauantai;0;1;1
95;16.12.2017;2017;12;05;Lauantai;2;0;2
95;16.12.2017;2017;12;06;Lauantai;0;0;0
95;16.12.2017;2017;12;07;Lauantai;1;1;2
95;16.12.2017;2017;12;08;Lauantai;0;0;0
95;16.12.2017;2017;12;09;Lauantai;3;0;3
95;16.12.2017;2017;12;10;Lauantai;1;1;2
95;16.12.2017;2017;12;11;Lauantai;3;4;7
95;16.12.2017;2017;12;12;Lauantai;3;3;6
95;16.12.2017;2017;12;13;Lauantai;1;1;2
95;16.12.2017;2017;12;14;Lauantai;3;2;5
95;16.12.2017;2017;12;15;Lauantai;0;2;2
95;16.12.2017;2017;12;16;Lauantai;0;1;1
95;16.12.2017;2017;12;17;Lauantai;1;1;2
95;16.12.2017;2017;12;18;Lauantai;0;1;1
95;16.12.2017;2017;12;19;Lauantai;1;0;1
95;16.12.2017;2017;12;20;Lauantai;0;0;0
95;16.12.2017;2017;12;21;Lauantai;1;0;1
95;16.12.2017;2017;12;22;Lauantai;0;1;1
95;16.12.2017;2017;12;23;Lauantai;0;1;1
95;17.12.2017;2017;12;00;Sunnuntai;0;0;0
95;17.12.2017;2017;12;01;Sunnuntai;0;1;1
95;17.12.2017;2017;12;02;Sunnuntai;0;1;1
95;17.12.2017;2017;12;03;Sunnuntai;0;0;0
95;17.12.2017;2017;12;04;Sunnuntai;0;0;0
95;17.12.2017;2017;12;05;Sunnuntai;1;0;1
95;17.12.2017;2017;12;06;Sunnuntai;0;0;0
95;17.12.2017;2017;12;07;Sunnuntai;0;0;0
95;17.12.2017;2017;12;08;Sunnuntai;1;2;3
95;17.12.2017;2017;12;09;Sunnuntai;9;2;11
95;17.12.2017;2017;12;10;Sunnuntai;2;1;3
95;17.12.2017;2017;12;11;Sunnuntai;3;2;5
95;17.12.2017;2017;12;12;Sunnuntai;6;1;7
95;17.12.2017;2017;12;13;Sunnuntai;1;1;2
95;17.12.2017;2017;12;14;Sunnuntai;4;5;9
95;17.12.2017;2017;12;15;Sunnuntai;1;1;2
95;17.12.2017;2017;12;16;Sunnuntai;0;1;1
95;17.12.2017;2017;12;17;Sunnuntai;3;3;6
95;17.12.2017;2017;12;18;Sunnuntai;2;1;3
95;17.12.2017;2017;12;19;Sunnuntai;0;1;1
95;17.12.2017;2017;12;20;Sunnuntai;1;1;2
95;17.12.2017;2017;12;21;Sunnuntai;2;2;4
95;17.12.2017;2017;12;22;Sunnuntai;0;1;1
95;17.12.2017;2017;12;23;Sunnuntai;2;1;3
95;18.12.2017;2017;12;00;Maanantai;0;0;0
95;18.12.2017;2017;12;01;Maanantai;0;0;0
95;18.12.2017;2017;12;02;Maanantai;0;0;0
95;18.12.2017;2017;12;03;Maanantai;0;0;0
95;18.12.2017;2017;12;04;Maanantai;2;0;2
95;18.12.2017;2017;12;05;Maanantai;3;4;7
95;18.12.2017;2017;12;06;Maanantai;9;8;17
95;18.12.2017;2017;12;07;Maanantai;9;7;16
95;18.12.2017;2017;12;08;Maanantai;9;8;17
95;18.12.2017;2017;12;09;Maanantai;3;11;14
95;18.12.2017;2017;12;10;Maanantai;4;4;8
95;18.12.2017;2017;12;11;Maanantai;4;4;8
95;18.12.2017;2017;12;12;Maanantai;1;2;3
95;18.12.2017;2017;12;13;Maanantai;7;2;9
95;18.12.2017;2017;12;14;Maanantai;7;6;13
95;18.12.2017;2017;12;15;Maanantai;11;10;21
95;18.12.2017;2017;12;16;Maanantai;19;12;31
95;18.12.2017;2017;12;17;Maanantai;6;6;12
95;18.12.2017;2017;12;18;Maanantai;3;3;6
95;18.12.2017;2017;12;19;Maanantai;3;4;7
95;18.12.2017;2017;12;20;Maanantai;0;3;3
95;18.12.2017;2017;12;21;Maanantai;2;0;2
95;18.12.2017;2017;12;22;Maanantai;1;0;1
95;18.12.2017;2017;12;23;Maanantai;0;0;0
95;19.12.2017;2017;12;00;Tiistai;0;0;0
95;19.12.2017;2017;12;01;Tiistai;0;2;2
95;19.12.2017;2017;12;02;Tiistai;0;0;0
95;19.12.2017;2017;12;03;Tiistai;0;0;0
95;19.12.2017;2017;12;04;Tiistai;2;0;2
95;19.12.2017;2017;12;05;Tiistai;6;4;10
95;19.12.2017;2017;12;06;Tiistai;5;6;11
95;19.12.2017;2017;12;07;Tiistai;13;9;22
95;19.12.2017;2017;12;08;Tiistai;5;12;17
95;19.12.2017;2017;12;09;Tiistai;1;4;5
95;19.12.2017;2017;12;10;Tiistai;7;4;11
95;19.12.2017;2017;12;11;Tiistai;1;3;4
95;19.12.2017;2017;12;12;Tiistai;2;2;4
95;19.12.2017;2017;12;13;Tiistai;4;8;12
95;19.12.2017;2017;12;14;Tiistai;13;6;19
95;19.12.2017;2017;12;15;Tiistai;9;9;18
95;19.12.2017;2017;12;16;Tiistai;11;6;17
95;19.12.2017;2017;12;17;Tiistai;11;8;19
95;19.12.2017;2017;12;18;Tiistai;4;6;10
95;19.12.2017;2017;12;19;Tiistai;2;3;5
95;19.12.2017;2017;12;20;Tiistai;0;3;3
95;19.12.2017;2017;12;21;Tiistai;2;1;3
95;19.12.2017;2017;12;22;Tiistai;1;0;1
95;19.12.2017;2017;12;23;Tiistai;0;0;0
95;20.12.2017;2017;12;00;Keskiviikko;0;0;0
95;20.12.2017;2017;12;01;Keskiviikko;0;1;1
95;20.12.2017;2017;12;02;Keskiviikko;0;0;0
95;20.12.2017;2017;12;03;Keskiviikko;0;0;0
95;20.12.2017;2017;12;04;Keskiviikko;0;0;0
95;20.12.2017;2017;12;05;Keskiviikko;5;4;9
95;20.12.2017;2017;12;06;Keskiviikko;4;5;9
95;20.12.2017;2017;12;07;Keskiviikko;6;6;12
95;20.12.2017;2017;12;08;Keskiviikko;6;8;14
95;20.12.2017;2017;12;09;Keskiviikko;0;3;3
95;20.12.2017;2017;12;10;Keskiviikko;1;3;4
95;20.12.2017;2017;12;11;Keskiviikko;2;0;2
95;20.12.2017;2017;12;12;Keskiviikko;1;1;2
95;20.12.2017;2017;12;13;Keskiviikko;2;1;3
95;20.12.2017;2017;12;14;Keskiviikko;7;1;8
95;20.12.2017;2017;12;15;Keskiviikko;2;5;7
95;20.12.2017;2017;12;16;Keskiviikko;10;3;13
95;20.12.2017;2017;12;17;Keskiviikko;0;4;4
95;20.12.2017;2017;12;18;Keskiviikko;2;4;6
95;20.12.2017;2017;12;19;Keskiviikko;2;0;2
95;20.12.2017;2017;12;20;Keskiviikko;1;0;1
95;20.12.2017;2017;12;21;Keskiviikko;1;1;2
95;20.12.2017;2017;12;22;Keskiviikko;0;0;0
95;20.12.2017;2017;12;23;Keskiviikko;1;1;2
95;21.12.2017;2017;12;00;Torstai;0;0;0
95;21.12.2017;2017;12;01;Torstai;0;0;0
95;21.12.2017;2017;12;02;Torstai;0;0;0
95;21.12.2017;2017;12;03;Torstai;0;0;0
95;21.12.2017;2017;12;04;Torstai;0;0;0
95;21.12.2017;2017;12;05;Torstai;3;1;4
95;21.12.2017;2017;12;06;Torstai;7;4;11
95;21.12.2017;2017;12;07;Torstai;5;1;6
95;21.12.2017;2017;12;08;Torstai;9;3;12
95;21.12.2017;2017;12;09;Torstai;4;9;13
95;21.12.2017;2017;12;10;Torstai;3;2;5
95;21.12.2017;2017;12;11;Torstai;4;3;7
95;21.12.2017;2017;12;12;Torstai;3;2;5
95;21.12.2017;2017;12;13;Torstai;0;3;3
95;21.12.2017;2017;12;14;Torstai;1;5;6
95;21.12.2017;2017;12;15;Torstai;9;7;16
95;21.12.2017;2017;12;16;Torstai;11;1;12
95;21.12.2017;2017;12;17;Torstai;2;5;7
95;21.12.2017;2017;12;18;Torstai;4;3;7
95;21.12.2017;2017;12;19;Torstai;0;2;2
95;21.12.2017;2017;12;20;Torstai;0;0;0
95;21.12.2017;2017;12;21;Torstai;5;5;10
95;21.12.2017;2017;12;22;Torstai;0;3;3
95;21.12.2017;2017;12;23;Torstai;0;0;0
95;22.12.2017;2017;12;00;Perjantai;3;6;9
95;22.12.2017;2017;12;01;Perjantai;0;0;0
95;22.12.2017;2017;12;02;Perjantai;0;0;0
95;22.12.2017;2017;12;03;Perjantai;0;0;0
95;22.12.2017;2017;12;04;Perjantai;0;0;0
95;22.12.2017;2017;12;05;Perjantai;4;3;7
95;22.12.2017;2017;12;06;Perjantai;7;3;10
95;22.12.2017;2017;12;07;Perjantai;4;4;8
95;22.12.2017;2017;12;08;Perjantai;6;2;8
95;22.12.2017;2017;12;09;Perjantai;1;1;2
95;22.12.2017;2017;12;10;Perjantai;1;1;2
95;22.12.2017;2017;12;11;Perjantai;5;1;6
95;22.12.2017;2017;12;12;Perjantai;2;3;5
95;22.12.2017;2017;12;13;Perjantai;3;4;7
95;22.12.2017;2017;12;14;Perjantai;6;6;12
95;22.12.2017;2017;12;15;Perjantai;4;12;16
95;22.12.2017;2017;12;16;Perjantai;2;3;5
95;22.12.2017;2017;12;17;Perjantai;1;4;5
95;22.12.2017;2017;12;18;Perjantai;4;2;6
95;22.12.2017;2017;12;19;Perjantai;0;2;2
95;22.12.2017;2017;12;20;Perjantai;0;0;0
95;22.12.2017;2017;12;21;Perjantai;0;1;1
95;22.12.2017;2017;12;22;Perjantai;1;0;1
95;22.12.2017;2017;12;23;Perjantai;0;0;0
95;23.12.2017;2017;12;00;Lauantai;0;0;0
95;23.12.2017;2017;12;01;Lauantai;0;0;0
95;23.12.2017;2017;12;02;Lauantai;0;0;0
95;23.12.2017;2017;12;03;Lauantai;0;0;0
95;23.12.2017;2017;12;04;Lauantai;0;0;0
95;23.12.2017;2017;12;05;Lauantai;0;0;0
95;23.12.2017;2017;12;06;Lauantai;1;0;1
95;23.12.2017;2017;12;07;Lauantai;1;0;1
95;23.12.2017;2017;12;08;Lauantai;0;0;0
95;23.12.2017;2017;12;09;Lauantai;0;0;0
95;23.12.2017;2017;12;10;Lauantai;2;0;2
95;23.12.2017;2017;12;11;Lauantai;0;0;0
95;23.12.2017;2017;12;12;Lauantai;0;2;2
95;23.12.2017;2017;12;13;Lauantai;0;1;1
95;23.12.2017;2017;12;14;Lauantai;0;1;1
95;23.12.2017;2017;12;15;Lauantai;1;4;5
95;23.12.2017;2017;12;16;Lauantai;2;0;2
95;23.12.2017;2017;12;17;Lauantai;0;1;1
95;23.12.2017;2017;12;18;Lauantai;0;0;0
95;23.12.2017;2017;12;19;Lauantai;1;0;1
95;23.12.2017;2017;12;20;Lauantai;0;1;1
95;23.12.2017;2017;12;21;Lauantai;0;0;0
95;23.12.2017;2017;12;22;Lauantai;0;0;0
95;23.12.2017;2017;12;23;Lauantai;0;0;0
95;24.12.2017;2017;12;00;Sunnuntai;0;0;0
95;24.12.2017;2017;12;01;Sunnuntai;0;0;0
95;24.12.2017;2017;12;02;Sunnuntai;0;0;0
95;24.12.2017;2017;12;03;Sunnuntai;0;0;0
95;24.12.2017;2017;12;04;Sunnuntai;0;0;0
95;24.12.2017;2017;12;05;Sunnuntai;0;0;0
95;24.12.2017;2017;12;06;Sunnuntai;2;0;2
95;24.12.2017;2017;12;07;Sunnuntai;0;1;1
95;24.12.2017;2017;12;08;Sunnuntai;0;0;0
95;24.12.2017;2017;12;09;Sunnuntai;0;0;0
95;24.12.2017;2017;12;10;Sunnuntai;0;0;0
95;24.12.2017;2017;12;11;Sunnuntai;3;2;5
95;24.12.2017;2017;12;12;Sunnuntai;1;2;3
95;24.12.2017;2017;12;13;Sunnuntai;1;2;3
95;24.12.2017;2017;12;14;Sunnuntai;1;1;2
95;24.12.2017;2017;12;15;Sunnuntai;1;1;2
95;24.12.2017;2017;12;16;Sunnuntai;0;0;0
95;24.12.2017;2017;12;17;Sunnuntai;0;0;0
95;24.12.2017;2017;12;18;Sunnuntai;0;1;1
95;24.12.2017;2017;12;19;Sunnuntai;0;1;1
95;24.12.2017;2017;12;20;Sunnuntai;0;1;1
95;24.12.2017;2017;12;21;Sunnuntai;1;0;1
95;24.12.2017;2017;12;22;Sunnuntai;0;2;2
95;24.12.2017;2017;12;23;Sunnuntai;0;0;0
95;25.12.2017;2017;12;00;Maanantai;0;0;0
95;25.12.2017;2017;12;01;Maanantai;0;0;0
95;25.12.2017;2017;12;02;Maanantai;0;0;0
95;25.12.2017;2017;12;03;Maanantai;2;0;2
95;25.12.2017;2017;12;04;Maanantai;0;0;0
95;25.12.2017;2017;12;05;Maanantai;0;0;0
95;25.12.2017;2017;12;06;Maanantai;1;0;1
95;25.12.2017;2017;12;07;Maanantai;1;0;1
95;25.12.2017;2017;12;08;Maanantai;0;0;0
95;25.12.2017;2017;12;09;Maanantai;0;0;0
95;25.12.2017;2017;12;10;Maanantai;4;1;5
95;25.12.2017;2017;12;11;Maanantai;1;1;2
95;25.12.2017;2017;12;12;Maanantai;2;2;4
95;25.12.2017;2017;12;13;Maanantai;6;5;11
95;25.12.2017;2017;12;14;Maanantai;1;1;2
95;25.12.2017;2017;12;15;Maanantai;2;2;4
95;25.12.2017;2017;12;16;Maanantai;0;1;1
95;25.12.2017;2017;12;17;Maanantai;0;1;1
95;25.12.2017;2017;12;18;Maanantai;0;0;0
95;25.12.2017;2017;12;19;Maanantai;0;0;0
95;25.12.2017;2017;12;20;Maanantai;1;1;2
95;25.12.2017;2017;12;21;Maanantai;1;0;1
95;25.12.2017;2017;12;22;Maanantai;0;1;1
95;25.12.2017;2017;12;23;Maanantai;0;0;0
95;26.12.2017;2017;12;00;Tiistai;1;1;2
95;26.12.2017;2017;12;01;Tiistai;0;0;0
95;26.12.2017;2017;12;02;Tiistai;0;0;0
95;26.12.2017;2017;12;03;Tiistai;0;0;0
95;26.12.2017;2017;12;04;Tiistai;1;0;1
95;26.12.2017;2017;12;05;Tiistai;1;0;1
95;26.12.2017;2017;12;06;Tiistai;0;0;0
95;26.12.2017;2017;12;07;Tiistai;0;0;0
95;26.12.2017;2017;12;08;Tiistai;0;0;0
95;26.12.2017;2017;12;09;Tiistai;2;2;4
95;26.12.2017;2017;12;10;Tiistai;0;2;2
95;26.12.2017;2017;12;11;Tiistai;2;1;3
95;26.12.2017;2017;12;12;Tiistai;1;4;5
95;26.12.2017;2017;12;13;Tiistai;1;3;4
95;26.12.2017;2017;12;14;Tiistai;1;2;3
95;26.12.2017;2017;12;15;Tiistai;2;1;3
95;26.12.2017;2017;12;16;Tiistai;2;0;2
95;26.12.2017;2017;12;17;Tiistai;2;4;6
95;26.12.2017;2017;12;18;Tiistai;1;0;1
95;26.12.2017;2017;12;19;Tiistai;1;0;1
95;26.12.2017;2017;12;20;Tiistai;0;0;0
95;26.12.2017;2017;12;21;Tiistai;1;0;1
95;26.12.2017;2017;12;22;Tiistai;0;1;1
95;26.12.2017;2017;12;23;Tiistai;0;0;0
95;27.12.2017;2017;12;00;Keskiviikko;0;0;0
95;27.12.2017;2017;12;01;Keskiviikko;0;0;0
95;27.12.2017;2017;12;02;Keskiviikko;0;0;0
95;27.12.2017;2017;12;03;Keskiviikko;0;0;0
95;27.12.2017;2017;12;04;Keskiviikko;0;0;0
95;27.12.2017;2017;12;05;Keskiviikko;2;1;3
95;27.12.2017;2017;12;06;Keskiviikko;2;2;4
95;27.12.2017;2017;12;07;Keskiviikko;2;2;4
95;27.12.2017;2017;12;08;Keskiviikko;2;0;2
95;27.12.2017;2017;12;09;Keskiviikko;0;0;0
95;27.12.2017;2017;12;10;Keskiviikko;1;0;1
95;27.12.2017;2017;12;11;Keskiviikko;0;0;0
95;27.12.2017;2017;12;12;Keskiviikko;3;1;4
95;27.12.2017;2017;12;13;Keskiviikko;1;0;1
95;27.12.2017;2017;12;14;Keskiviikko;0;1;1
95;27.12.2017;2017;12;15;Keskiviikko;2;3;5
95;27.12.2017;2017;12;16;Keskiviikko;4;2;6
95;27.12.2017;2017;12;17;Keskiviikko;0;3;3
95;27.12.2017;2017;12;18;Keskiviikko;0;0;0
95;27.12.2017;2017;12;19;Keskiviikko;1;2;3
95;27.12.2017;2017;12;20;Keskiviikko;1;1;2
95;27.12.2017;2017;12;21;Keskiviikko;0;1;1
95;27.12.2017;2017;12;22;Keskiviikko;0;1;1
95;27.12.2017;2017;12;23;Keskiviikko;0;0;0
95;28.12.2017;2017;12;00;Torstai;0;0;0
95;28.12.2017;2017;12;01;Torstai;0;0;0
95;28.12.2017;2017;12;02;Torstai;0;0;0
95;28.12.2017;2017;12;03;Torstai;0;0;0
95;28.12.2017;2017;12;04;Torstai;1;0;1
95;28.12.2017;2017;12;05;Torstai;1;0;1
95;28.12.2017;2017;12;06;Torstai;5;3;8
95;28.12.2017;2017;12;07;Torstai;2;2;4
95;28.12.2017;2017;12;08;Torstai;4;1;5
95;28.12.2017;2017;12;09;Torstai;3;0;3
95;28.12.2017;2017;12;10;Torstai;0;2;2
95;28.12.2017;2017;12;11;Torstai;5;3;8
95;28.12.2017;2017;12;12;Torstai;2;1;3
95;28.12.2017;2017;12;13;Torstai;2;5;7
95;28.12.2017;2017;12;14;Torstai;0;6;6
95;28.12.2017;2017;12;15;Torstai;2;4;6
95;28.12.2017;2017;12;16;Torstai;2;1;3
95;28.12.2017;2017;12;17;Torstai;2;1;3
95;28.12.2017;2017;12;18;Torstai;1;5;6
95;28.12.2017;2017;12;19;Torstai;2;2;4
95;28.12.2017;2017;12;20;Torstai;0;0;0
95;28.12.2017;2017;12;21;Torstai;0;2;2
95;28.12.2017;2017;12;22;Torstai;0;0;0
95;28.12.2017;2017;12;23;Torstai;2;0;2
95;29.12.2017;2017;12;00;Perjantai;0;0;0
95;29.12.2017;2017;12;01;Perjantai;0;0;0
95;29.12.2017;2017;12;02;Perjantai;0;0;0
95;29.12.2017;2017;12;03;Perjantai;0;0;0
95;29.12.2017;2017;12;04;Perjantai;1;0;1
95;29.12.2017;2017;12;05;Perjantai;4;0;4
95;29.12.2017;2017;12;06;Perjantai;2;3;5
95;29.12.2017;2017;12;07;Perjantai;2;2;4
95;29.12.2017;2017;12;08;Perjantai;3;0;3
95;29.12.2017;2017;12;09;Perjantai;1;1;2
95;29.12.2017;2017;12;10;Perjantai;0;2;2
95;29.12.2017;2017;12;11;Perjantai;1;0;1
95;29.12.2017;2017;12;12;Perjantai;5;0;5
95;29.12.2017;2017;12;13;Perjantai;0;4;4
95;29.12.2017;2017;12;14;Perjantai;1;4;5
95;29.12.2017;2017;12;15;Perjantai;3;1;4
95;29.12.2017;2017;12;16;Perjantai;1;4;5
95;29.12.2017;2017;12;17;Perjantai;0;3;3
95;29.12.2017;2017;12;18;Perjantai;1;4;5
95;29.12.2017;2017;12;19;Perjantai;1;3;4
95;29.12.2017;2017;12;20;Perjantai;1;1;2
95;29.12.2017;2017;12;21;Perjantai;1;0;1
95;29.12.2017;2017;12;22;Perjantai;0;0;0
95;29.12.2017;2017;12;23;Perjantai;4;0;4
95;30.12.2017;2017;12;00;Lauantai;0;0;0
95;30.12.2017;2017;12;01;Lauantai;2;1;3
95;30.12.2017;2017;12;02;Lauantai;0;0;0
95;30.12.2017;2017;12;03;Lauantai;0;0;0
95;30.12.2017;2017;12;04;Lauantai;1;0;1
95;30.12.2017;2017;12;05;Lauantai;1;1;2
95;30.12.2017;2017;12;06;Lauantai;0;0;0
95;30.12.2017;2017;12;07;Lauantai;0;0;0
95;30.12.2017;2017;12;08;Lauantai;1;0;1
95;30.12.2017;2017;12;09;Lauantai;1;0;1
95;30.12.2017;2017;12;10;Lauantai;0;0;0
95;30.12.2017;2017;12;11;Lauantai;0;0;0
95;30.12.2017;2017;12;12;Lauantai;1;2;3
95;30.12.2017;2017;12;13;Lauantai;1;2;3
95;30.12.2017;2017;12;14;Lauantai;5;3;8
95;30.12.2017;2017;12;15;Lauantai;2;4;6
95;30.12.2017;2017;12;16;Lauantai;1;1;2
95;30.12.2017;2017;12;17;Lauantai;3;1;4
95;30.12.2017;2017;12;18;Lauantai;0;3;3
95;30.12.2017;2017;12;19;Lauantai;1;4;5
95;30.12.2017;2017;12;20;Lauantai;0;1;1
95;30.12.2017;2017;12;21;Lauantai;1;0;1
95;30.12.2017;2017;12;22;Lauantai;0;0;0
95;30.12.2017;2017;12;23;Lauantai;0;0;0
95;31.12.2017;2017;12;00;Sunnuntai;0;0;0
95;31.12.2017;2017;12;01;Sunnuntai;0;0;0
95;31.12.2017;2017;12;02;Sunnuntai;0;0;0
95;31.12.2017;2017;12;03;Sunnuntai;0;0;0
95;31.12.2017;2017;12;04;Sunnuntai;0;0;0
95;31.12.2017;2017;12;05;Sunnuntai;0;0;0
95;31.12.2017;2017;12;06;Sunnuntai;0;0;0
95;31.12.2017;2017;12;07;Sunnuntai;0;0;0
95;31.12.2017;2017;12;08;Sunnuntai;0;0;0
95;31.12.2017;2017;12;09;Sunnuntai;1;1;2
95;31.12.2017;2017;12;10;Sunnuntai;2;1;3
95;31.12.2017;2017;12;11;Sunnuntai;2;0;2
95;31.12.2017;2017;12;12;Sunnuntai;1;4;5
95;31.12.2017;2017;12;13;Sunnuntai;0;4;4
95;31.12.2017;2017;12;14;Sunnuntai;2;0;2
95;31.12.2017;2017;12;15;Sunnuntai;0;1;1
95;31.12.2017;2017;12;16;Sunnuntai;4;0;4
95;31.12.2017;2017;12;17;Sunnuntai;0;1;1
95;31.12.2017;2017;12;18;Sunnuntai;0;1;1
95;31.12.2017;2017;12;19;Sunnuntai;0;2;2
95;31.12.2017;2017;12;20;Sunnuntai;0;0;0
95;31.12.2017;2017;12;21;Sunnuntai;0;0;0
95;31.12.2017;2017;12;22;Sunnuntai;1;0;1
95;31.12.2017;2017;12;23;Sunnuntai;0;0;0
95;01.01.2018;2018;01;00;Maanantai;0;1;1
95;01.01.2018;2018;01;01;Maanantai;0;0;0
95;01.01.2018;2018;01;02;Maanantai;0;1;1
95;01.01.2018;2018;01;03;Maanantai;0;0;0
95;01.01.2018;2018;01;04;Maanantai;1;0;1
95;01.01.2018;2018;01;05;Maanantai;1;0;1
95;01.01.2018;2018;01;06;Maanantai;0;0;0
95;01.01.2018;2018;01;07;Maanantai;1;1;2
95;01.01.2018;2018;01;08;Maanantai;0;0;0
95;01.01.2018;2018;01;09;Maanantai;0;1;1
95;01.01.2018;2018;01;10;Maanantai;1;1;2
95;01.01.2018;2018;01;11;Maanantai;0;1;1
95;01.01.2018;2018;01;12;Maanantai;1;2;3
95;01.01.2018;2018;01;13;Maanantai;3;2;5
95;01.01.2018;2018;01;14;Maanantai;2;1;3
95;01.01.2018;2018;01;15;Maanantai;2;3;5
95;01.01.2018;2018;01;16;Maanantai;1;2;3
95;01.01.2018;2018;01;17;Maanantai;0;1;1
95;01.01.2018;2018;01;18;Maanantai;1;1;2
95;01.01.2018;2018;01;19;Maanantai;1;0;1
95;01.01.2018;2018;01;20;Maanantai;0;2;2
95;01.01.2018;2018;01;21;Maanantai;1;0;1
95;01.01.2018;2018;01;22;Maanantai;0;0;0
95;01.01.2018;2018;01;23;Maanantai;0;0;0
95;02.01.2018;2018;01;00;Tiistai;0;0;0
95;02.01.2018;2018;01;01;Tiistai;0;0;0
95;02.01.2018;2018;01;02;Tiistai;0;0;0
95;02.01.2018;2018;01;03;Tiistai;0;0;0
95;02.01.2018;2018;01;04;Tiistai;1;0;1
95;02.01.2018;2018;01;05;Tiistai;4;1;5
95;02.01.2018;2018;01;06;Tiistai;7;6;13
95;02.01.2018;2018;01;07;Tiistai;7;7;14
95;02.01.2018;2018;01;08;Tiistai;3;6;9
95;02.01.2018;2018;01;09;Tiistai;3;1;4
95;02.01.2018;2018;01;10;Tiistai;2;2;4
95;02.01.2018;2018;01;11;Tiistai;4;1;5
95;02.01.2018;2018;01;12;Tiistai;2;4;6
95;02.01.2018;2018;01;13;Tiistai;5;1;6
95;02.01.2018;2018;01;14;Tiistai;2;5;7
95;02.01.2018;2018;01;15;Tiistai;6;5;11
95;02.01.2018;2018;01;16;Tiistai;8;8;16
95;02.01.2018;2018;01;17;Tiistai;5;6;11
95;02.01.2018;2018;01;18;Tiistai;4;6;10
95;02.01.2018;2018;01;19;Tiistai;3;1;4
95;02.01.2018;2018;01;20;Tiistai;1;2;3
95;02.01.2018;2018;01;21;Tiistai;0;2;2
95;02.01.2018;2018;01;22;Tiistai;0;1;1
95;02.01.2018;2018;01;23;Tiistai;0;0;0
95;03.01.2018;2018;01;00;Keskiviikko;0;0;0
95;03.01.2018;2018;01;01;Keskiviikko;0;0;0
95;03.01.2018;2018;01;02;Keskiviikko;0;0;0
95;03.01.2018;2018;01;03;Keskiviikko;0;0;0
95;03.01.2018;2018;01;04;Keskiviikko;1;0;1
95;03.01.2018;2018;01;05;Keskiviikko;3;2;5
95;03.01.2018;2018;01;06;Keskiviikko;3;6;9
95;03.01.2018;2018;01;07;Keskiviikko;14;7;21
95;03.01.2018;2018;01;08;Keskiviikko;3;4;7
95;03.01.2018;2018;01;09;Keskiviikko;1;1;2
95;03.01.2018;2018;01;10;Keskiviikko;1;3;4
95;03.01.2018;2018;01;11;Keskiviikko;0;1;1
95;03.01.2018;2018;01;12;Keskiviikko;1;1;2
95;03.01.2018;2018;01;13;Keskiviikko;3;1;4
95;03.01.2018;2018;01;14;Keskiviikko;6;4;10
95;03.01.2018;2018;01;15;Keskiviikko;4;8;12
95;03.01.2018;2018;01;16;Keskiviikko;8;6;14
95;03.01.2018;2018;01;17;Keskiviikko;10;8;18
95;03.01.2018;2018;01;18;Keskiviikko;3;5;8
95;03.01.2018;2018;01;19;Keskiviikko;3;3;6
95;03.01.2018;2018;01;20;Keskiviikko;0;0;0
95;03.01.2018;2018;01;21;Keskiviikko;0;2;2
95;03.01.2018;2018;01;22;Keskiviikko;1;4;5
95;03.01.2018;2018;01;23;Keskiviikko;1;0;1
95;04.01.2018;2018;01;00;Torstai;0;0;0
95;04.01.2018;2018;01;01;Torstai;0;0;0
95;04.01.2018;2018;01;02;Torstai;0;0;0
95;04.01.2018;2018;01;03;Torstai;0;0;0
95;04.01.2018;2018;01;04;Torstai;1;0;1
95;04.01.2018;2018;01;05;Torstai;1;0;1
95;04.01.2018;2018;01;06;Torstai;8;0;8
95;04.01.2018;2018;01;07;Torstai;4;0;4
95;04.01.2018;2018;01;08;Torstai;5;0;5
95;04.01.2018;2018;01;09;Torstai;3;0;3
95;04.01.2018;2018;01;10;Torstai;2;0;2
95;04.01.2018;2018;01;11;Torstai;8;0;8
95;04.01.2018;2018;01;12;Torstai;3;0;3
95;04.01.2018;2018;01;13;Torstai;7;0;7
95;04.01.2018;2018;01;14;Torstai;6;0;6
95;04.01.2018;2018;01;15;Torstai;6;0;6
95;04.01.2018;2018;01;16;Torstai;3;0;3
95;04.01.2018;2018;01;17;Torstai;3;0;3
95;04.01.2018;2018;01;18;Torstai;6;0;6
95;04.01.2018;2018;01;19;Torstai;4;0;4
95;04.01.2018;2018;01;20;Torstai;0;0;0
95;04.01.2018;2018;01;21;Torstai;2;0;2
95;04.01.2018;2018;01;22;Torstai;0;0;0
95;04.01.2018;2018;01;23;Torstai;2;0;2
95;05.01.2018;2018;01;00;Perjantai;0;0;0
95;05.01.2018;2018;01;01;Perjantai;0;0;0
95;05.01.2018;2018;01;02;Perjantai;0;0;0
95;05.01.2018;2018;01;03;Perjantai;0;0;0
95;05.01.2018;2018;01;04;Perjantai;2;0;2
95;05.01.2018;2018;01;05;Perjantai;3;2;5
95;05.01.2018;2018;01;06;Perjantai;6;4;10
95;05.01.2018;2018;01;07;Perjantai;2;4;6
95;05.01.2018;2018;01;08;Perjantai;1;4;5
95;05.01.2018;2018;01;09;Perjantai;3;0;3
95;05.01.2018;2018;01;10;Perjantai;1;1;2
95;05.01.2018;2018;01;11;Perjantai;1;0;1
95;05.01.2018;2018;01;12;Perjantai;0;0;0
95;05.01.2018;2018;01;13;Perjantai;2;1;3
95;05.01.2018;2018;01;14;Perjantai;1;1;2
95;05.01.2018;2018;01;15;Perjantai;9;3;12
95;05.01.2018;2018;01;16;Perjantai;4;1;5
95;05.01.2018;2018;01;17;Perjantai;1;2;3
95;05.01.2018;2018;01;18;Perjantai;0;1;1
95;05.01.2018;2018;01;19;Perjantai;1;0;1
95;05.01.2018;2018;01;20;Perjantai;1;2;3
95;05.01.2018;2018;01;21;Perjantai;1;1;2
95;05.01.2018;2018;01;22;Perjantai;0;1;1
95;05.01.2018;2018;01;23;Perjantai;0;0;0
95;06.01.2018;2018;01;00;Lauantai;0;0;0
95;06.01.2018;2018;01;01;Lauantai;0;0;0
95;06.01.2018;2018;01;02;Lauantai;0;1;1
95;06.01.2018;2018;01;03;Lauantai;0;0;0
95;06.01.2018;2018;01;04;Lauantai;0;0;0
95;06.01.2018;2018;01;05;Lauantai;0;0;0
95;06.01.2018;2018;01;06;Lauantai;1;0;1
95;06.01.2018;2018;01;07;Lauantai;0;0;0
95;06.01.2018;2018;01;08;Lauantai;0;0;0
95;06.01.2018;2018;01;09;Lauantai;0;0;0
95;06.01.2018;2018;01;10;Lauantai;2;0;2
95;06.01.2018;2018;01;11;Lauantai;1;1;2
95;06.01.2018;2018;01;12;Lauantai;2;1;3
95;06.01.2018;2018;01;13;Lauantai;1;0;1
95;06.01.2018;2018;01;14;Lauantai;1;2;3
95;06.01.2018;2018;01;15;Lauantai;1;1;2
95;06.01.2018;2018;01;16;Lauantai;0;3;3
95;06.01.2018;2018;01;17;Lauantai;2;2;4
95;06.01.2018;2018;01;18;Lauantai;0;1;1
95;06.01.2018;2018;01;19;Lauantai;0;0;0
95;06.01.2018;2018;01;20;Lauantai;0;0;0
95;06.01.2018;2018;01;21;Lauantai;0;1;1
95;06.01.2018;2018;01;22;Lauantai;0;1;1
95;06.01.2018;2018;01;23;Lauantai;0;0;0
95;07.01.2018;2018;01;00;Sunnuntai;0;0;0
95;07.01.2018;2018;01;01;Sunnuntai;0;0;0
95;07.01.2018;2018;01;02;Sunnuntai;0;0;0
95;07.01.2018;2018;01;03;Sunnuntai;0;0;0
95;07.01.2018;2018;01;04;Sunnuntai;0;0;0
95;07.01.2018;2018;01;05;Sunnuntai;0;0;0
95;07.01.2018;2018;01;06;Sunnuntai;0;0;0
95;07.01.2018;2018;01;07;Sunnuntai;1;0;1
95;07.01.2018;2018;01;08;Sunnuntai;0;0;0
95;07.01.2018;2018;01;09;Sunnuntai;0;1;1
95;07.01.2018;2018;01;10;Sunnuntai;6;0;6
95;07.01.2018;2018;01;11;Sunnuntai;1;1;2
95;07.01.2018;2018;01;12;Sunnuntai;2;1;3
95;07.01.2018;2018;01;13;Sunnuntai;1;1;2
95;07.01.2018;2018;01;14;Sunnuntai;1;3;4
95;07.01.2018;2018;01;15;Sunnuntai;1;0;1
95;07.01.2018;2018;01;16;Sunnuntai;0;1;1
95;07.01.2018;2018;01;17;Sunnuntai;2;2;4
95;07.01.2018;2018;01;18;Sunnuntai;2;1;3
95;07.01.2018;2018;01;19;Sunnuntai;1;2;3
95;07.01.2018;2018;01;20;Sunnuntai;1;1;2
95;07.01.2018;2018;01;21;Sunnuntai;0;4;4
95;07.01.2018;2018;01;22;Sunnuntai;0;2;2
95;07.01.2018;2018;01;23;Sunnuntai;0;0;0
95;08.01.2018;2018;01;00;Maanantai;0;0;0
95;08.01.2018;2018;01;01;Maanantai;0;0;0
95;08.01.2018;2018;01;02;Maanantai;0;0;0
95;08.01.2018;2018;01;03;Maanantai;0;0;0
95;08.01.2018;2018;01;04;Maanantai;0;0;0
95;08.01.2018;2018;01;05;Maanantai;1;3;4
95;08.01.2018;2018;01;06;Maanantai;8;3;11
95;08.01.2018;2018;01;07;Maanantai;6;3;9
95;08.01.2018;2018;01;08;Maanantai;3;7;10
95;08.01.2018;2018;01;09;Maanantai;4;11;15
95;08.01.2018;2018;01;10;Maanantai;0;2;2
95;08.01.2018;2018;01;11;Maanantai;2;0;2
95;08.01.2018;2018;01;12;Maanantai;0;1;1
95;08.01.2018;2018;01;13;Maanantai;4;2;6
95;08.01.2018;2018;01;14;Maanantai;4;2;6
95;08.01.2018;2018;01;15;Maanantai;5;4;9
95;08.01.2018;2018;01;16;Maanantai;12;7;19
95;08.01.2018;2018;01;17;Maanantai;2;5;7
95;08.01.2018;2018;01;18;Maanantai;1;1;2
95;08.01.2018;2018;01;19;Maanantai;3;0;3
95;08.01.2018;2018;01;20;Maanantai;0;2;2
95;08.01.2018;2018;01;21;Maanantai;1;0;1
95;08.01.2018;2018;01;22;Maanantai;0;1;1
95;08.01.2018;2018;01;23;Maanantai;0;0;0
95;09.01.2018;2018;01;00;Tiistai;0;0;0
95;09.01.2018;2018;01;01;Tiistai;0;0;0
95;09.01.2018;2018;01;02;Tiistai;0;0;0
95;09.01.2018;2018;01;03;Tiistai;0;0;0
95;09.01.2018;2018;01;04;Tiistai;1;0;1
95;09.01.2018;2018;01;05;Tiistai;6;3;9
95;09.01.2018;2018;01;06;Tiistai;9;4;13
95;09.01.2018;2018;01;07;Tiistai;13;13;26
95;09.01.2018;2018;01;08;Tiistai;5;12;17
95;09.01.2018;2018;01;09;Tiistai;2;2;4
95;09.01.2018;2018;01;10;Tiistai;0;2;2
95;09.01.2018;2018;01;11;Tiistai;2;1;3
95;09.01.2018;2018;01;12;Tiistai;0;3;3
95;09.01.2018;2018;01;13;Tiistai;2;3;5
95;09.01.2018;2018;01;14;Tiistai;9;8;17
95;09.01.2018;2018;01;15;Tiistai;10;6;16
95;09.01.2018;2018;01;16;Tiistai;14;12;26
95;09.01.2018;2018;01;17;Tiistai;2;5;7
95;09.01.2018;2018;01;18;Tiistai;5;3;8
95;09.01.2018;2018;01;19;Tiistai;2;2;4
95;09.01.2018;2018;01;20;Tiistai;2;0;2
95;09.01.2018;2018;01;21;Tiistai;1;6;7
95;09.01.2018;2018;01;22;Tiistai;0;0;0
95;09.01.2018;2018;01;23;Tiistai;0;0;0
95;10.01.2018;2018;01;00;Keskiviikko;0;0;0
95;10.01.2018;2018;01;01;Keskiviikko;0;1;1
95;10.01.2018;2018;01;02;Keskiviikko;0;0;0
95;10.01.2018;2018;01;03;Keskiviikko;1;0;1
95;10.01.2018;2018;01;04;Keskiviikko;0;0;0
95;10.01.2018;2018;01;05;Keskiviikko;5;3;8
95;10.01.2018;2018;01;06;Keskiviikko;7;5;12
95;10.01.2018;2018;01;07;Keskiviikko;8;9;17
95;10.01.2018;2018;01;08;Keskiviikko;3;11;14
95;10.01.2018;2018;01;09;Keskiviikko;3;4;7
95;10.01.2018;2018;01;10;Keskiviikko;3;4;7
95;10.01.2018;2018;01;11;Keskiviikko;2;1;3
95;10.01.2018;2018;01;12;Keskiviikko;1;4;5
95;10.01.2018;2018;01;13;Keskiviikko;7;3;10
95;10.01.2018;2018;01;14;Keskiviikko;14;8;22
95;10.01.2018;2018;01;15;Keskiviikko;13;11;24
95;10.01.2018;2018;01;16;Keskiviikko;10;4;14
95;10.01.2018;2018;01;17;Keskiviikko;3;8;11
95;10.01.2018;2018;01;18;Keskiviikko;6;1;7
95;10.01.2018;2018;01;19;Keskiviikko;1;4;5
95;10.01.2018;2018;01;20;Keskiviikko;1;2;3
95;10.01.2018;2018;01;21;Keskiviikko;2;0;2
95;10.01.2018;2018;01;22;Keskiviikko;1;0;1
95;10.01.2018;2018;01;23;Keskiviikko;2;0;2
95;11.01.2018;2018;01;00;Torstai;0;0;0
95;11.01.2018;2018;01;01;Torstai;0;0;0
95;11.01.2018;2018;01;02;Torstai;0;0;0
95;11.01.2018;2018;01;03;Torstai;0;0;0
95;11.01.2018;2018;01;04;Torstai;0;0;0
95;11.01.2018;2018;01;05;Torstai;2;4;6
95;11.01.2018;2018;01;06;Torstai;7;8;15
95;11.01.2018;2018;01;07;Torstai;16;8;24
95;11.01.2018;2018;01;08;Torstai;4;11;15
95;11.01.2018;2018;01;09;Torstai;0;5;5
95;11.01.2018;2018;01;10;Torstai;0;3;3
95;11.01.2018;2018;01;11;Torstai;2;0;2
95;11.01.2018;2018;01;12;Torstai;2;3;5
95;11.01.2018;2018;01;13;Torstai;2;1;3
95;11.01.2018;2018;01;14;Torstai;6;3;9
95;11.01.2018;2018;01;15;Torstai;9;4;13
95;11.01.2018;2018;01;16;Torstai;21;14;35
95;11.01.2018;2018;01;17;Torstai;5;4;9
95;11.01.2018;2018;01;18;Torstai;1;3;4
95;11.01.2018;2018;01;19;Torstai;0;0;0
95;11.01.2018;2018;01;20;Torstai;1;1;2
95;11.01.2018;2018;01;21;Torstai;0;1;1
95;11.01.2018;2018;01;22;Torstai;0;0;0
95;11.01.2018;2018;01;23;Torstai;0;0;0
95;12.01.2018;2018;01;00;Perjantai;0;1;1
95;12.01.2018;2018;01;01;Perjantai;0;0;0
95;12.01.2018;2018;01;02;Perjantai;0;0;0
95;12.01.2018;2018;01;03;Perjantai;0;0;0
95;12.01.2018;2018;01;04;Perjantai;2;0;2
95;12.01.2018;2018;01;05;Perjantai;5;3;8
95;12.01.2018;2018;01;06;Perjantai;4;7;11
95;12.01.2018;2018;01;07;Perjantai;7;11;18
95;12.01.2018;2018;01;08;Perjantai;1;8;9
95;12.01.2018;2018;01;09;Perjantai;3;4;7
95;12.01.2018;2018;01;10;Perjantai;3;1;4
95;12.01.2018;2018;01;11;Perjantai;3;4;7
95;12.01.2018;2018;01;12;Perjantai;0;3;3
95;12.01.2018;2018;01;13;Perjantai;9;2;11
95;12.01.2018;2018;01;14;Perjantai;11;6;17
95;12.01.2018;2018;01;15;Perjantai;13;8;21
95;12.01.2018;2018;01;16;Perjantai;7;2;9
95;12.01.2018;2018;01;17;Perjantai;4;5;9
95;12.01.2018;2018;01;18;Perjantai;4;1;5
95;12.01.2018;2018;01;19;Perjantai;2;1;3
95;12.01.2018;2018;01;20;Perjantai;1;3;4
95;12.01.2018;2018;01;21;Perjantai;1;1;2
95;12.01.2018;2018;01;22;Perjantai;0;1;1
95;12.01.2018;2018;01;23;Perjantai;0;0;0
95;13.01.2018;2018;01;00;Lauantai;0;0;0
95;13.01.2018;2018;01;01;Lauantai;0;0;0
95;13.01.2018;2018;01;02;Lauantai;0;0;0
95;13.01.2018;2018;01;03;Lauantai;0;0;0
95;13.01.2018;2018;01;04;Lauantai;1;0;1
95;13.01.2018;2018;01;05;Lauantai;2;1;3
95;13.01.2018;2018;01;06;Lauantai;0;0;0
95;13.01.2018;2018;01;07;Lauantai;3;1;4
95;13.01.2018;2018;01;08;Lauantai;1;0;1
95;13.01.2018;2018;01;09;Lauantai;3;3;6
95;13.01.2018;2018;01;10;Lauantai;1;0;1
95;13.01.2018;2018;01;11;Lauantai;2;1;3
95;13.01.2018;2018;01;12;Lauantai;5;2;7
95;13.01.2018;2018;01;13;Lauantai;1;4;5
95;13.01.2018;2018;01;14;Lauantai;2;2;4
95;13.01.2018;2018;01;15;Lauantai;5;2;7
95;13.01.2018;2018;01;16;Lauantai;2;3;5
95;13.01.2018;2018;01;17;Lauantai;1;2;3
95;13.01.2018;2018;01;18;Lauantai;0;3;3
95;13.01.2018;2018;01;19;Lauantai;2;2;4
95;13.01.2018;2018;01;20;Lauantai;0;0;0
95;13.01.2018;2018;01;21;Lauantai;0;0;0
95;13.01.2018;2018;01;22;Lauantai;0;0;0
95;13.01.2018;2018;01;23;Lauantai;1;0;1
95;14.01.2018;2018;01;00;Sunnuntai;0;0;0
95;14.01.2018;2018;01;01;Sunnuntai;0;1;1
95;14.01.2018;2018;01;02;Sunnuntai;1;0;1
95;14.01.2018;2018;01;03;Sunnuntai;0;0;0
95;14.01.2018;2018;01;04;Sunnuntai;1;0;1
95;14.01.2018;2018;01;05;Sunnuntai;1;0;1
95;14.01.2018;2018;01;06;Sunnuntai;1;0;1
95;14.01.2018;2018;01;07;Sunnuntai;1;0;1
95;14.01.2018;2018;01;08;Sunnuntai;5;1;6
95;14.01.2018;2018;01;09;Sunnuntai;0;2;2
95;14.01.2018;2018;01;10;Sunnuntai;2;3;5
95;14.01.2018;2018;01;11;Sunnuntai;4;6;10
95;14.01.2018;2018;01;12;Sunnuntai;2;2;4
95;14.01.2018;2018;01;13;Sunnuntai;4;3;7
95;14.01.2018;2018;01;14;Sunnuntai;7;5;12
95;14.01.2018;2018;01;15;Sunnuntai;1;4;5
95;14.01.2018;2018;01;16;Sunnuntai;0;0;0
95;14.01.2018;2018;01;17;Sunnuntai;0;3;3
95;14.01.2018;2018;01;18;Sunnuntai;3;1;4
95;14.01.2018;2018;01;19;Sunnuntai;0;2;2
95;14.01.2018;2018;01;20;Sunnuntai;0;1;1
95;14.01.2018;2018;01;21;Sunnuntai;1;0;1
95;14.01.2018;2018;01;22;Sunnuntai;1;2;3
95;14.01.2018;2018;01;23;Sunnuntai;0;0;0
95;15.01.2018;2018;01;00;Maanantai;0;0;0
95;15.01.2018;2018;01;01;Maanantai;0;0;0
95;15.01.2018;2018;01;02;Maanantai;0;0;0
95;15.01.2018;2018;01;03;Maanantai;0;0;0
95;15.01.2018;2018;01;04;Maanantai;1;1;2
95;15.01.2018;2018;01;05;Maanantai;4;1;5
95;15.01.2018;2018;01;06;Maanantai;3;6;9
95;15.01.2018;2018;01;07;Maanantai;11;8;19
95;15.01.2018;2018;01;08;Maanantai;2;6;8
95;15.01.2018;2018;01;09;Maanantai;8;11;19
95;15.01.2018;2018;01;10;Maanantai;4;2;6
95;15.01.2018;2018;01;11;Maanantai;2;0;2
95;15.01.2018;2018;01;12;Maanantai;0;2;2
95;15.01.2018;2018;01;13;Maanantai;4;1;5
95;15.01.2018;2018;01;14;Maanantai;5;3;8
95;15.01.2018;2018;01;15;Maanantai;13;7;20
95;15.01.2018;2018;01;16;Maanantai;14;5;19
95;15.01.2018;2018;01;17;Maanantai;4;9;13
95;15.01.2018;2018;01;18;Maanantai;1;3;4
95;15.01.2018;2018;01;19;Maanantai;0;0;0
95;15.01.2018;2018;01;20;Maanantai;0;2;2
95;15.01.2018;2018;01;21;Maanantai;3;0;3
95;15.01.2018;2018;01;22;Maanantai;1;1;2
95;15.01.2018;2018;01;23;Maanantai;0;0;0
95;16.01.2018;2018;01;00;Tiistai;0;0;0
95;16.01.2018;2018;01;01;Tiistai;0;0;0
95;16.01.2018;2018;01;02;Tiistai;0;0;0
95;16.01.2018;2018;01;03;Tiistai;0;0;0
95;16.01.2018;2018;01;04;Tiistai;0;0;0
95;16.01.2018;2018;01;05;Tiistai;3;3;6
95;16.01.2018;2018;01;06;Tiistai;4;8;12
95;16.01.2018;2018;01;07;Tiistai;8;11;19
95;16.01.2018;2018;01;08;Tiistai;3;9;12
95;16.01.2018;2018;01;09;Tiistai;4;2;6
95;16.01.2018;2018;01;10;Tiistai;3;2;5
95;16.01.2018;2018;01;11;Tiistai;6;1;7
95;16.01.2018;2018;01;12;Tiistai;5;4;9
95;16.01.2018;2018;01;13;Tiistai;5;3;8
95;16.01.2018;2018;01;14;Tiistai;10;3;13
95;16.01.2018;2018;01;15;Tiistai;14;5;19
95;16.01.2018;2018;01;16;Tiistai;14;6;20
95;16.01.2018;2018;01;17;Tiistai;3;5;8
95;16.01.2018;2018;01;18;Tiistai;2;4;6
95;16.01.2018;2018;01;19;Tiistai;0;3;3
95;16.01.2018;2018;01;20;Tiistai;0;1;1
95;16.01.2018;2018;01;21;Tiistai;0;2;2
95;16.01.2018;2018;01;22;Tiistai;1;1;2
95;16.01.2018;2018;01;23;Tiistai;0;1;1
95;17.01.2018;2018;01;00;Keskiviikko;0;0;0
95;17.01.2018;2018;01;01;Keskiviikko;0;0;0
95;17.01.2018;2018;01;02;Keskiviikko;0;0;0
95;17.01.2018;2018;01;03;Keskiviikko;0;0;0
95;17.01.2018;2018;01;04;Keskiviikko;0;0;0
95;17.01.2018;2018;01;05;Keskiviikko;1;3;4
95;17.01.2018;2018;01;06;Keskiviikko;5;4;9
95;17.01.2018;2018;01;07;Keskiviikko;7;11;18
95;17.01.2018;2018;01;08;Keskiviikko;3;6;9
95;17.01.2018;2018;01;09;Keskiviikko;1;4;5
95;17.01.2018;2018;01;10;Keskiviikko;1;1;2
95;17.01.2018;2018;01;11;Keskiviikko;0;0;0
95;17.01.2018;2018;01;12;Keskiviikko;2;1;3
95;17.01.2018;2018;01;13;Keskiviikko;10;3;13
95;17.01.2018;2018;01;14;Keskiviikko;10;4;14
95;17.01.2018;2018;01;15;Keskiviikko;9;4;13
95;17.01.2018;2018;01;16;Keskiviikko;13;2;15
95;17.01.2018;2018;01;17;Keskiviikko;3;5;8
95;17.01.2018;2018;01;18;Keskiviikko;4;2;6
95;17.01.2018;2018;01;19;Keskiviikko;1;3;4
95;17.01.2018;2018;01;20;Keskiviikko;1;0;1
95;17.01.2018;2018;01;21;Keskiviikko;0;0;0
95;17.01.2018;2018;01;22;Keskiviikko;1;2;3
95;17.01.2018;2018;01;23;Keskiviikko;0;1;1
95;18.01.2018;2018;01;00;Torstai;0;0;0
95;18.01.2018;2018;01;01;Torstai;0;0;0
95;18.01.2018;2018;01;02;Torstai;0;0;0
95;18.01.2018;2018;01;03;Torstai;0;0;0
95;18.01.2018;2018;01;04;Torstai;0;0;0
95;18.01.2018;2018;01;05;Torstai;3;2;5
95;18.01.2018;2018;01;06;Torstai;7;4;11
95;18.01.2018;2018;01;07;Torstai;10;11;21
95;18.01.2018;2018;01;08;Torstai;2;4;6
95;18.01.2018;2018;01;09;Torstai;3;8;11
95;18.01.2018;2018;01;10;Torstai;1;5;6
95;18.01.2018;2018;01;11;Torstai;5;2;7
95;18.01.2018;2018;01;12;Torstai;1;4;5
95;18.01.2018;2018;01;13;Torstai;2;3;5
95;18.01.2018;2018;01;14;Torstai;5;4;9
95;18.01.2018;2018;01;15;Torstai;10;5;15
95;18.01.2018;2018;01;16;Torstai;14;6;20
95;18.01.2018;2018;01;17;Torstai;3;6;9
95;18.01.2018;2018;01;18;Torstai;3;1;4
95;18.01.2018;2018;01;19;Torstai;3;2;5
95;18.01.2018;2018;01;20;Torstai;2;6;8
95;18.01.2018;2018;01;21;Torstai;0;1;1
95;18.01.2018;2018;01;22;Torstai;2;0;2
95;18.01.2018;2018;01;23;Torstai;0;0;0
95;19.01.2018;2018;01;00;Perjantai;0;0;0
95;19.01.2018;2018;01;01;Perjantai;0;0;0
95;19.01.2018;2018;01;02;Perjantai;0;0;0
95;19.01.2018;2018;01;03;Perjantai;0;0;0
95;19.01.2018;2018;01;04;Perjantai;0;0;0
95;19.01.2018;2018;01;05;Perjantai;5;3;8
95;19.01.2018;2018;01;06;Perjantai;3;2;5
95;19.01.2018;2018;01;07;Perjantai;7;8;15
95;19.01.2018;2018;01;08;Perjantai;7;7;14
95;19.01.2018;2018;01;09;Perjantai;1;4;5
95;19.01.2018;2018;01;10;Perjantai;0;0;0
95;19.01.2018;2018;01;11;Perjantai;6;1;7
95;19.01.2018;2018;01;12;Perjantai;0;1;1
95;19.01.2018;2018;01;13;Perjantai;5;3;8
95;19.01.2018;2018;01;14;Perjantai;5;5;10
95;19.01.2018;2018;01;15;Perjantai;10;5;15
95;19.01.2018;2018;01;16;Perjantai;6;5;11
95;19.01.2018;2018;01;17;Perjantai;2;4;6
95;19.01.2018;2018;01;18;Perjantai;1;1;2
95;19.01.2018;2018;01;19;Perjantai;1;2;3
95;19.01.2018;2018;01;20;Perjantai;1;0;1
95;19.01.2018;2018;01;21;Perjantai;0;0;0
95;19.01.2018;2018;01;22;Perjantai;0;0;0
95;19.01.2018;2018;01;23;Perjantai;0;0;0
95;20.01.2018;2018;01;00;Lauantai;0;0;0
95;20.01.2018;2018;01;01;Lauantai;0;0;0
95;20.01.2018;2018;01;02;Lauantai;0;0;0
95;20.01.2018;2018;01;03;Lauantai;0;1;1
95;20.01.2018;2018;01;04;Lauantai;0;0;0
95;20.01.2018;2018;01;05;Lauantai;0;0;0
95;20.01.2018;2018;01;06;Lauantai;1;0;1
95;20.01.2018;2018;01;07;Lauantai;1;2;3
95;20.01.2018;2018;01;08;Lauantai;0;1;1
95;20.01.2018;2018;01;09;Lauantai;1;0;1
95;20.01.2018;2018;01;10;Lauantai;1;0;1
95;20.01.2018;2018;01;11;Lauantai;2;0;2
95;20.01.2018;2018;01;12;Lauantai;1;3;4
95;20.01.2018;2018;01;13;Lauantai;0;1;1
95;20.01.2018;2018;01;14;Lauantai;0;1;1
95;20.01.2018;2018;01;15;Lauantai;4;0;4
95;20.01.2018;2018;01;16;Lauantai;1;0;1
95;20.01.2018;2018;01;17;Lauantai;0;1;1
95;20.01.2018;2018;01;18;Lauantai;0;3;3
95;20.01.2018;2018;01;19;Lauantai;0;1;1
95;20.01.2018;2018;01;20;Lauantai;0;0;0
95;20.01.2018;2018;01;21;Lauantai;1;1;2
95;20.01.2018;2018;01;22;Lauantai;0;0;0
95;20.01.2018;2018;01;23;Lauantai;0;0;0
95;21.01.2018;2018;01;00;Sunnuntai;0;0;0
95;21.01.2018;2018;01;01;Sunnuntai;0;0;0
95;21.01.2018;2018;01;02;Sunnuntai;0;0;0
95;21.01.2018;2018;01;03;Sunnuntai;0;0;0
95;21.01.2018;2018;01;04;Sunnuntai;0;0;0
95;21.01.2018;2018;01;05;Sunnuntai;0;0;0
95;21.01.2018;2018;01;06;Sunnuntai;0;0;0
95;21.01.2018;2018;01;07;Sunnuntai;0;0;0
95;21.01.2018;2018;01;08;Sunnuntai;0;0;0
95;21.01.2018;2018;01;09;Sunnuntai;0;0;0
95;21.01.2018;2018;01;10;Sunnuntai;1;0;1
95;21.01.2018;2018;01;11;Sunnuntai;1;0;1
95;21.01.2018;2018;01;12;Sunnuntai;1;2;3
95;21.01.2018;2018;01;13;Sunnuntai;0;2;2
95;21.01.2018;2018;01;14;Sunnuntai;3;0;3
95;21.01.2018;2018;01;15;Sunnuntai;0;2;2
95;21.01.2018;2018;01;16;Sunnuntai;1;1;2
95;21.01.2018;2018;01;17;Sunnuntai;0;0;0
95;21.01.2018;2018;01;18;Sunnuntai;1;1;2
95;21.01.2018;2018;01;19;Sunnuntai;1;0;1
95;21.01.2018;2018;01;20;Sunnuntai;1;2;3
95;21.01.2018;2018;01;21;Sunnuntai;0;0;0
95;21.01.2018;2018;01;22;Sunnuntai;1;0;1
95;21.01.2018;2018;01;23;Sunnuntai;0;0;0
95;22.01.2018;2018;01;00;Maanantai;0;0;0
95;22.01.2018;2018;01;01;Maanantai;0;0;0
95;22.01.2018;2018;01;02;Maanantai;0;0;0
95;22.01.2018;2018;01;03;Maanantai;0;0;0
95;22.01.2018;2018;01;04;Maanantai;0;0;0
95;22.01.2018;2018;01;05;Maanantai;2;2;4
95;22.01.2018;2018;01;06;Maanantai;2;2;4
95;22.01.2018;2018;01;07;Maanantai;6;4;10
95;22.01.2018;2018;01;08;Maanantai;1;3;4
95;22.01.2018;2018;01;09;Maanantai;2;4;6
95;22.01.2018;2018;01;10;Maanantai;1;3;4
95;22.01.2018;2018;01;11;Maanantai;0;0;0
95;22.01.2018;2018;01;12;Maanantai;0;1;1
95;22.01.2018;2018;01;13;Maanantai;4;0;4
95;22.01.2018;2018;01;14;Maanantai;3;3;6
95;22.01.2018;2018;01;15;Maanantai;7;3;10
95;22.01.2018;2018;01;16;Maanantai;11;3;14
95;22.01.2018;2018;01;17;Maanantai;2;2;4
95;22.01.2018;2018;01;18;Maanantai;0;0;0
95;22.01.2018;2018;01;19;Maanantai;0;1;1
95;22.01.2018;2018;01;20;Maanantai;1;2;3
95;22.01.2018;2018;01;21;Maanantai;1;0;1
95;22.01.2018;2018;01;22;Maanantai;1;0;1
95;22.01.2018;2018;01;23;Maanantai;0;0;0
95;23.01.2018;2018;01;00;Tiistai;0;0;0
95;23.01.2018;2018;01;01;Tiistai;0;0;0
95;23.01.2018;2018;01;02;Tiistai;0;0;0
95;23.01.2018;2018;01;03;Tiistai;0;0;0
95;23.01.2018;2018;01;04;Tiistai;0;0;0
95;23.01.2018;2018;01;05;Tiistai;1;3;4
95;23.01.2018;2018;01;06;Tiistai;2;2;4
95;23.01.2018;2018;01;07;Tiistai;5;2;7
95;23.01.2018;2018;01;08;Tiistai;4;5;9
95;23.01.2018;2018;01;09;Tiistai;1;1;2
95;23.01.2018;2018;01;10;Tiistai;2;0;2
95;23.01.2018;2018;01;11;Tiistai;0;0;0
95;23.01.2018;2018;01;12;Tiistai;2;2;4
95;23.01.2018;2018;01;13;Tiistai;3;1;4
95;23.01.2018;2018;01;14;Tiistai;9;0;9
95;23.01.2018;2018;01;15;Tiistai;4;0;4
95;23.01.2018;2018;01;16;Tiistai;5;5;10
95;23.01.2018;2018;01;17;Tiistai;3;1;4
95;23.01.2018;2018;01;18;Tiistai;1;0;1
95;23.01.2018;2018;01;19;Tiistai;1;0;1
95;23.01.2018;2018;01;20;Tiistai;0;0;0
95;23.01.2018;2018;01;21;Tiistai;0;0;0
95;23.01.2018;2018;01;22;Tiistai;0;0;0
95;23.01.2018;2018;01;23;Tiistai;0;0;0
95;24.01.2018;2018;01;00;Keskiviikko;0;0;0
95;24.01.2018;2018;01;01;Keskiviikko;0;0;0
95;24.01.2018;2018;01;02;Keskiviikko;0;0;0
95;24.01.2018;2018;01;03;Keskiviikko;0;0;0
95;24.01.2018;2018;01;04;Keskiviikko;1;0;1
95;24.01.2018;2018;01;05;Keskiviikko;2;3;5
95;24.01.2018;2018;01;06;Keskiviikko;5;2;7
95;24.01.2018;2018;01;07;Keskiviikko;6;6;12
95;24.01.2018;2018;01;08;Keskiviikko;8;8;16
95;24.01.2018;2018;01;09;Keskiviikko;2;0;2
95;24.01.2018;2018;01;10;Keskiviikko;2;3;5
95;24.01.2018;2018;01;11;Keskiviikko;1;1;2
95;24.01.2018;2018;01;12;Keskiviikko;0;1;1
95;24.01.2018;2018;01;13;Keskiviikko;4;2;6
95;24.01.2018;2018;01;14;Keskiviikko;7;5;12
95;24.01.2018;2018;01;15;Keskiviikko;5;3;8
95;24.01.2018;2018;01;16;Keskiviikko;11;1;12
95;24.01.2018;2018;01;17;Keskiviikko;1;1;2
95;24.01.2018;2018;01;18;Keskiviikko;0;3;3
95;24.01.2018;2018;01;19;Keskiviikko;1;1;2
95;24.01.2018;2018;01;20;Keskiviikko;0;0;0
95;24.01.2018;2018;01;21;Keskiviikko;0;1;1
95;24.01.2018;2018;01;22;Keskiviikko;0;1;1
95;24.01.2018;2018;01;23;Keskiviikko;0;0;0
95;25.01.2018;2018;01;00;Torstai;0;0;0
95;25.01.2018;2018;01;01;Torstai;0;0;0
95;25.01.2018;2018;01;02;Torstai;0;0;0
95;25.01.2018;2018;01;03;Torstai;0;0;0
95;25.01.2018;2018;01;04;Torstai;0;0;0
95;25.01.2018;2018;01;05;Torstai;2;3;5
95;25.01.2018;2018;01;06;Torstai;2;3;5
95;25.01.2018;2018;01;07;Torstai;8;3;11
95;25.01.2018;2018;01;08;Torstai;3;4;7
95;25.01.2018;2018;01;09;Torstai;0;7;7
95;25.01.2018;2018;01;10;Torstai;3;4;7
95;25.01.2018;2018;01;11;Torstai;0;2;2
95;25.01.2018;2018;01;12;Torstai;0;1;1
95;25.01.2018;2018;01;13;Torstai;2;1;3
95;25.01.2018;2018;01;14;Torstai;8;2;10
95;25.01.2018;2018;01;15;Torstai;12;3;15
95;25.01.2018;2018;01;16;Torstai;7;8;15
95;25.01.2018;2018;01;17;Torstai;6;4;10
95;25.01.2018;2018;01;18;Torstai;0;2;2
95;25.01.2018;2018;01;19;Torstai;0;0;0
95;25.01.2018;2018;01;20;Torstai;1;4;5
95;25.01.2018;2018;01;21;Torstai;1;1;2
95;25.01.2018;2018;01;22;Torstai;0;1;1
95;25.01.2018;2018;01;23;Torstai;0;0;0
95;26.01.2018;2018;01;00;Perjantai;0;0;0
95;26.01.2018;2018;01;01;Perjantai;0;0;0
95;26.01.2018;2018;01;02;Perjantai;0;0;0
95;26.01.2018;2018;01;03;Perjantai;0;0;0
95;26.01.2018;2018;01;04;Perjantai;0;0;0
95;26.01.2018;2018;01;05;Perjantai;3;2;5
95;26.01.2018;2018;01;06;Perjantai;1;3;4
95;26.01.2018;2018;01;07;Perjantai;3;6;9
95;26.01.2018;2018;01;08;Perjantai;6;6;12
95;26.01.2018;2018;01;09;Perjantai;0;4;4
95;26.01.2018;2018;01;10;Perjantai;0;1;1
95;26.01.2018;2018;01;11;Perjantai;2;3;5
95;26.01.2018;2018;01;12;Perjantai;7;3;10
95;26.01.2018;2018;01;13;Perjantai;6;2;8
95;26.01.2018;2018;01;14;Perjantai;9;4;13
95;26.01.2018;2018;01;15;Perjantai;12;4;16
95;26.01.2018;2018;01;16;Perjantai;4;2;6
95;26.01.2018;2018;01;17;Perjantai;4;0;4
95;26.01.2018;2018;01;18;Perjantai;3;1;4
95;26.01.2018;2018;01;19;Perjantai;0;2;2
95;26.01.2018;2018;01;20;Perjantai;0;0;0
95;26.01.2018;2018;01;21;Perjantai;0;2;2
95;26.01.2018;2018;01;22;Perjantai;0;1;1
95;26.01.2018;2018;01;23;Perjantai;0;0;0
95;27.01.2018;2018;01;00;Lauantai;0;0;0
95;27.01.2018;2018;01;01;Lauantai;0;0;0
95;27.01.2018;2018;01;02;Lauantai;0;1;1
95;27.01.2018;2018;01;03;Lauantai;0;0;0
95;27.01.2018;2018;01;04;Lauantai;1;0;1
95;27.01.2018;2018;01;05;Lauantai;0;0;0
95;27.01.2018;2018;01;06;Lauantai;2;0;2
95;27.01.2018;2018;01;07;Lauantai;0;0;0
95;27.01.2018;2018;01;08;Lauantai;1;2;3
95;27.01.2018;2018;01;09;Lauantai;2;0;2
95;27.01.2018;2018;01;10;Lauantai;3;3;6
95;27.01.2018;2018;01;11;Lauantai;0;3;3
95;27.01.2018;2018;01;12;Lauantai;5;2;7
95;27.01.2018;2018;01;13;Lauantai;7;3;10
95;27.01.2018;2018;01;14;Lauantai;3;4;7
95;27.01.2018;2018;01;15;Lauantai;4;2;6
95;27.01.2018;2018;01;16;Lauantai;1;4;5
95;27.01.2018;2018;01;17;Lauantai;3;3;6
95;27.01.2018;2018;01;18;Lauantai;0;3;3
95;27.01.2018;2018;01;19;Lauantai;0;2;2
95;27.01.2018;2018;01;20;Lauantai;0;1;1
95;27.01.2018;2018;01;21;Lauantai;0;1;1
95;27.01.2018;2018;01;22;Lauantai;2;0;2
95;27.01.2018;2018;01;23;Lauantai;0;0;0
95;28.01.2018;2018;01;00;Sunnuntai;0;0;0
95;28.01.2018;2018;01;01;Sunnuntai;0;0;0
95;28.01.2018;2018;01;02;Sunnuntai;0;0;0
95;28.01.2018;2018;01;03;Sunnuntai;2;0;2
95;28.01.2018;2018;01;04;Sunnuntai;1;1;2
95;28.01.2018;2018;01;05;Sunnuntai;0;0;0
95;28.01.2018;2018;01;06;Sunnuntai;0;0;0
95;28.01.2018;2018;01;07;Sunnuntai;1;2;3
95;28.01.2018;2018;01;08;Sunnuntai;0;1;1
95;28.01.2018;2018;01;09;Sunnuntai;3;1;4
95;28.01.2018;2018;01;10;Sunnuntai;5;5;10
95;28.01.2018;2018;01;11;Sunnuntai;2;2;4
95;28.01.2018;2018;01;12;Sunnuntai;2;0;2
95;28.01.2018;2018;01;13;Sunnuntai;4;4;8
95;28.01.2018;2018;01;14;Sunnuntai;2;3;5
95;28.01.2018;2018;01;15;Sunnuntai;0;0;0
95;28.01.2018;2018;01;16;Sunnuntai;0;1;1
95;28.01.2018;2018;01;17;Sunnuntai;2;3;5
95;28.01.2018;2018;01;18;Sunnuntai;3;0;3
95;28.01.2018;2018;01;19;Sunnuntai;1;2;3
95;28.01.2018;2018;01;20;Sunnuntai;0;2;2
95;28.01.2018;2018;01;21;Sunnuntai;1;1;2
95;28.01.2018;2018;01;22;Sunnuntai;0;0;0
95;28.01.2018;2018;01;23;Sunnuntai;0;0;0
95;29.01.2018;2018;01;00;Maanantai;0;0;0
95;29.01.2018;2018;01;01;Maanantai;0;0;0
95;29.01.2018;2018;01;02;Maanantai;0;0;0
95;29.01.2018;2018;01;03;Maanantai;0;0;0
95;29.01.2018;2018;01;04;Maanantai;1;0;1
95;29.01.2018;2018;01;05;Maanantai;4;3;7
95;29.01.2018;2018;01;06;Maanantai;5;5;10
95;29.01.2018;2018;01;07;Maanantai;5;7;12
95;29.01.2018;2018;01;08;Maanantai;6;5;11
95;29.01.2018;2018;01;09;Maanantai;3;7;10
95;29.01.2018;2018;01;10;Maanantai;5;5;10
95;29.01.2018;2018;01;11;Maanantai;0;0;0
95;29.01.2018;2018;01;12;Maanantai;5;4;9
95;29.01.2018;2018;01;13;Maanantai;5;4;9
95;29.01.2018;2018;01;14;Maanantai;7;4;11
95;29.01.2018;2018;01;15;Maanantai;8;6;14
95;29.01.2018;2018;01;16;Maanantai;15;9;24
95;29.01.2018;2018;01;17;Maanantai;3;4;7
95;29.01.2018;2018;01;18;Maanantai;1;0;1
95;29.01.2018;2018;01;19;Maanantai;0;1;1
95;29.01.2018;2018;01;20;Maanantai;2;3;5
95;29.01.2018;2018;01;21;Maanantai;2;1;3
95;29.01.2018;2018;01;22;Maanantai;1;0;1
95;29.01.2018;2018;01;23;Maanantai;0;0;0
95;30.01.2018;2018;01;00;Tiistai;0;0;0
95;30.01.2018;2018;01;01;Tiistai;0;0;0
95;30.01.2018;2018;01;02;Tiistai;0;0;0
95;30.01.2018;2018;01;03;Tiistai;0;0;0
95;30.01.2018;2018;01;04;Tiistai;0;0;0
95;30.01.2018;2018;01;05;Tiistai;5;1;6
95;30.01.2018;2018;01;06;Tiistai;7;3;10
95;30.01.2018;2018;01;07;Tiistai;7;11;18
95;30.01.2018;2018;01;08;Tiistai;6;5;11
95;30.01.2018;2018;01;09;Tiistai;4;0;4
95;30.01.2018;2018;01;10;Tiistai;6;0;6
95;30.01.2018;2018;01;11;Tiistai;2;1;3
95;30.01.2018;2018;01;12;Tiistai;5;3;8
95;30.01.2018;2018;01;13;Tiistai;1;3;4
95;30.01.2018;2018;01;14;Tiistai;4;4;8
95;30.01.2018;2018;01;15;Tiistai;8;6;14
95;30.01.2018;2018;01;16;Tiistai;10;3;13
95;30.01.2018;2018;01;17;Tiistai;7;7;14
95;30.01.2018;2018;01;18;Tiistai;0;5;5
95;30.01.2018;2018;01;19;Tiistai;0;1;1
95;30.01.2018;2018;01;20;Tiistai;3;3;6
95;30.01.2018;2018;01;21;Tiistai;2;0;2
95;30.01.2018;2018;01;22;Tiistai;2;0;2
95;30.01.2018;2018;01;23;Tiistai;0;0;0
95;31.01.2018;2018;01;00;Keskiviikko;0;0;0
95;31.01.2018;2018;01;01;Keskiviikko;0;0;0
95;31.01.2018;2018;01;02;Keskiviikko;0;0;0
95;31.01.2018;2018;01;03;Keskiviikko;0;0;0
95;31.01.2018;2018;01;04;Keskiviikko;0;0;0
95;31.01.2018;2018;01;05;Keskiviikko;4;1;5
95;31.01.2018;2018;01;06;Keskiviikko;8;3;11
95;31.01.2018;2018;01;07;Keskiviikko;15;7;22
95;31.01.2018;2018;01;08;Keskiviikko;2;4;6
95;31.01.2018;2018;01;09;Keskiviikko;7;2;9
95;31.01.2018;2018;01;10;Keskiviikko;7;0;7
95;31.01.2018;2018;01;11;Keskiviikko;4;1;5
95;31.01.2018;2018;01;12;Keskiviikko;2;4;6
95;31.01.2018;2018;01;13;Keskiviikko;1;3;4
95;31.01.2018;2018;01;14;Keskiviikko;6;7;13
95;31.01.2018;2018;01;15;Keskiviikko;8;6;14
95;31.01.2018;2018;01;16;Keskiviikko;11;6;17
95;31.01.2018;2018;01;17;Keskiviikko;4;6;10
95;31.01.2018;2018;01;18;Keskiviikko;2;3;5
95;31.01.2018;2018;01;19;Keskiviikko;2;1;3
95;31.01.2018;2018;01;20;Keskiviikko;2;2;4
95;31.01.2018;2018;01;21;Keskiviikko;0;2;2
95;31.01.2018;2018;01;22;Keskiviikko;2;0;2
95;31.01.2018;2018;01;23;Keskiviikko;0;0;0
95;01.02.2018;2018;02;00;Torstai;0;0;0
95;01.02.2018;2018;02;01;Torstai;0;0;0
95;01.02.2018;2018;02;02;Torstai;0;0;0
95;01.02.2018;2018;02;03;Torstai;0;0;0
95;01.02.2018;2018;02;04;Torstai;0;0;0
95;01.02.2018;2018;02;05;Torstai;4;2;6
95;01.02.2018;2018;02;06;Torstai;2;2;4
95;01.02.2018;2018;02;07;Torstai;9;7;16
95;01.02.2018;2018;02;08;Torstai;2;2;4
95;01.02.2018;2018;02;09;Torstai;3;0;3
95;01.02.2018;2018;02;10;Torstai;3;0;3
95;01.02.2018;2018;02;11;Torstai;7;1;8
95;01.02.2018;2018;02;12;Torstai;5;1;6
95;01.02.2018;2018;02;13;Torstai;0;3;3
95;01.02.2018;2018;02;14;Torstai;2;2;4
95;01.02.2018;2018;02;15;Torstai;7;4;11
95;01.02.2018;2018;02;16;Torstai;6;4;10
95;01.02.2018;2018;02;17;Torstai;0;5;5
95;01.02.2018;2018;02;18;Torstai;0;3;3
95;01.02.2018;2018;02;19;Torstai;1;0;1
95;01.02.2018;2018;02;20;Torstai;1;2;3
95;01.02.2018;2018;02;21;Torstai;1;2;3
95;01.02.2018;2018;02;22;Torstai;2;0;2
95;01.02.2018;2018;02;23;Torstai;0;0;0
95;02.02.2018;2018;02;00;Perjantai;0;0;0
95;02.02.2018;2018;02;01;Perjantai;0;0;0
95;02.02.2018;2018;02;02;Perjantai;0;0;0
95;02.02.2018;2018;02;03;Perjantai;0;0;0
95;02.02.2018;2018;02;04;Perjantai;0;1;1
95;02.02.2018;2018;02;05;Perjantai;3;1;4
95;02.02.2018;2018;02;06;Perjantai;4;0;4
95;02.02.2018;2018;02;07;Perjantai;7;8;15
95;02.02.2018;2018;02;08;Perjantai;4;4;8
95;02.02.2018;2018;02;09;Perjantai;3;2;5
95;02.02.2018;2018;02;10;Perjantai;6;1;7
95;02.02.2018;2018;02;11;Perjantai;7;0;7
95;02.02.2018;2018;02;12;Perjantai;1;2;3
95;02.02.2018;2018;02;13;Perjantai;2;3;5
95;02.02.2018;2018;02;14;Perjantai;2;2;4
95;02.02.2018;2018;02;15;Perjantai;7;3;10
95;02.02.2018;2018;02;16;Perjantai;2;5;7
95;02.02.2018;2018;02;17;Perjantai;6;4;10
95;02.02.2018;2018;02;18;Perjantai;2;1;3
95;02.02.2018;2018;02;19;Perjantai;0;0;0
95;02.02.2018;2018;02;20;Perjantai;1;3;4
95;02.02.2018;2018;02;21;Perjantai;0;0;0
95;02.02.2018;2018;02;22;Perjantai;0;0;0
95;02.02.2018;2018;02;23;Perjantai;0;0;0
95;03.02.2018;2018;02;00;Lauantai;0;0;0
95;03.02.2018;2018;02;01;Lauantai;0;1;1
95;03.02.2018;2018;02;02;Lauantai;0;0;0
95;03.02.2018;2018;02;03;Lauantai;0;0;0
95;03.02.2018;2018;02;04;Lauantai;1;0;1
95;03.02.2018;2018;02;05;Lauantai;0;0;0
95;03.02.2018;2018;02;06;Lauantai;0;0;0
95;03.02.2018;2018;02;07;Lauantai;2;0;2
95;03.02.2018;2018;02;08;Lauantai;0;1;1
95;03.02.2018;2018;02;09;Lauantai;0;0;0
95;03.02.2018;2018;02;10;Lauantai;0;0;0
95;03.02.2018;2018;02;11;Lauantai;0;0;0
95;03.02.2018;2018;02;12;Lauantai;0;1;1
95;03.02.2018;2018;02;13;Lauantai;0;0;0
95;03.02.2018;2018;02;14;Lauantai;0;1;1
95;03.02.2018;2018;02;15;Lauantai;0;2;2
95;03.02.2018;2018;02;16;Lauantai;1;1;2
95;03.02.2018;2018;02;17;Lauantai;2;1;3
95;03.02.2018;2018;02;18;Lauantai;0;0;0
95;03.02.2018;2018;02;19;Lauantai;0;0;0
95;03.02.2018;2018;02;20;Lauantai;0;1;1
95;03.02.2018;2018;02;21;Lauantai;0;0;0
95;03.02.2018;2018;02;22;Lauantai;0;0;0
95;03.02.2018;2018;02;23;Lauantai;0;1;1
95;04.02.2018;2018;02;00;Sunnuntai;0;0;0
95;04.02.2018;2018;02;01;Sunnuntai;1;0;1
95;04.02.2018;2018;02;02;Sunnuntai;0;0;0
95;04.02.2018;2018;02;03;Sunnuntai;0;0;0
95;04.02.2018;2018;02;04;Sunnuntai;1;0;1
95;04.02.2018;2018;02;05;Sunnuntai;0;0;0
95;04.02.2018;2018;02;06;Sunnuntai;0;0;0
95;04.02.2018;2018;02;07;Sunnuntai;0;0;0
95;04.02.2018;2018;02;08;Sunnuntai;0;0;0
95;04.02.2018;2018;02;09;Sunnuntai;0;0;0
95;04.02.2018;2018;02;10;Sunnuntai;0;0;0
95;04.02.2018;2018;02;11;Sunnuntai;1;0;1
95;04.02.2018;2018;02;12;Sunnuntai;0;0;0
95;04.02.2018;2018;02;13;Sunnuntai;0;0;0
95;04.02.2018;2018;02;14;Sunnuntai;0;1;1
95;04.02.2018;2018;02;15;Sunnuntai;0;0;0
95;04.02.2018;2018;02;16;Sunnuntai;0;1;1
95;04.02.2018;2018;02;17;Sunnuntai;1;0;1
95;04.02.2018;2018;02;18;Sunnuntai;1;0;1
95;04.02.2018;2018;02;19;Sunnuntai;0;0;0
95;04.02.2018;2018;02;20;Sunnuntai;0;0;0
95;04.02.2018;2018;02;21;Sunnuntai;0;1;1
95;04.02.2018;2018;02;22;Sunnuntai;1;1;2
95;04.02.2018;2018;02;23;Sunnuntai;0;0;0
95;05.02.2018;2018;02;00;Maanantai;0;0;0
95;05.02.2018;2018;02;01;Maanantai;0;0;0
95;05.02.2018;2018;02;02;Maanantai;0;0;0
95;05.02.2018;2018;02;03;Maanantai;0;0;0
95;05.02.2018;2018;02;04;Maanantai;0;0;0
95;05.02.2018;2018;02;05;Maanantai;3;2;5
95;05.02.2018;2018;02;06;Maanantai;4;0;4
95;05.02.2018;2018;02;07;Maanantai;3;3;6
95;05.02.2018;2018;02;08;Maanantai;1;0;1
95;05.02.2018;2018;02;09;Maanantai;2;2;4
95;05.02.2018;2018;02;10;Maanantai;3;1;4
95;05.02.2018;2018;02;11;Maanantai;1;2;3
95;05.02.2018;2018;02;12;Maanantai;4;1;5
95;05.02.2018;2018;02;13;Maanantai;3;0;3
95;05.02.2018;2018;02;14;Maanantai;3;2;5
95;05.02.2018;2018;02;15;Maanantai;5;2;7
95;05.02.2018;2018;02;16;Maanantai;4;4;8
95;05.02.2018;2018;02;17;Maanantai;3;2;5
95;05.02.2018;2018;02;18;Maanantai;0;0;0
95;05.02.2018;2018;02;19;Maanantai;0;0;0
95;05.02.2018;2018;02;20;Maanantai;1;0;1
95;05.02.2018;2018;02;21;Maanantai;3;1;4
95;05.02.2018;2018;02;22;Maanantai;0;0;0
95;05.02.2018;2018;02;23;Maanantai;0;0;0
95;06.02.2018;2018;02;00;Tiistai;0;1;1
95;06.02.2018;2018;02;01;Tiistai;0;0;0
95;06.02.2018;2018;02;02;Tiistai;0;0;0
95;06.02.2018;2018;02;03;Tiistai;0;0;0
95;06.02.2018;2018;02;04;Tiistai;0;0;0
95;06.02.2018;2018;02;05;Tiistai;2;2;4
95;06.02.2018;2018;02;06;Tiistai;2;2;4
95;06.02.2018;2018;02;07;Tiistai;4;4;8
95;06.02.2018;2018;02;08;Tiistai;3;4;7
95;06.02.2018;2018;02;09;Tiistai;0;1;1
95;06.02.2018;2018;02;10;Tiistai;4;1;5
95;06.02.2018;2018;02;11;Tiistai;0;0;0
95;06.02.2018;2018;02;12;Tiistai;5;2;7
95;06.02.2018;2018;02;13;Tiistai;2;1;3
95;06.02.2018;2018;02;14;Tiistai;5;2;7
95;06.02.2018;2018;02;15;Tiistai;5;1;6
95;06.02.2018;2018;02;16;Tiistai;5;1;6
95;06.02.2018;2018;02;17;Tiistai;0;1;1
95;06.02.2018;2018;02;18;Tiistai;0;4;4
95;06.02.2018;2018;02;19;Tiistai;1;0;1
95;06.02.2018;2018;02;20;Tiistai;0;0;0
95;06.02.2018;2018;02;21;Tiistai;1;0;1
95;06.02.2018;2018;02;22;Tiistai;0;1;1
95;06.02.2018;2018;02;23;Tiistai;0;0;0
95;07.02.2018;2018;02;00;Keskiviikko;0;0;0
95;07.02.2018;2018;02;01;Keskiviikko;0;0;0
95;07.02.2018;2018;02;02;Keskiviikko;0;0;0
95;07.02.2018;2018;02;03;Keskiviikko;0;0;0
95;07.02.2018;2018;02;04;Keskiviikko;0;0;0
95;07.02.2018;2018;02;05;Keskiviikko;4;5;9
95;07.02.2018;2018;02;06;Keskiviikko;1;3;4
95;07.02.2018;2018;02;07;Keskiviikko;6;6;12
95;07.02.2018;2018;02;08;Keskiviikko;3;4;7
95;07.02.2018;2018;02;09;Keskiviikko;0;2;2
95;07.02.2018;2018;02;10;Keskiviikko;0;1;1
95;07.02.2018;2018;02;11;Keskiviikko;2;0;2
95;07.02.2018;2018;02;12;Keskiviikko;0;0;0
95;07.02.2018;2018;02;13;Keskiviikko;2;2;4
95;07.02.2018;2018;02;14;Keskiviikko;5;4;9
95;07.02.2018;2018;02;15;Keskiviikko;7;4;11
95;07.02.2018;2018;02;16;Keskiviikko;12;5;17
95;07.02.2018;2018;02;17;Keskiviikko;5;3;8
95;07.02.2018;2018;02;18;Keskiviikko;1;1;2
95;07.02.2018;2018;02;19;Keskiviikko;1;1;2
95;07.02.2018;2018;02;20;Keskiviikko;0;1;1
95;07.02.2018;2018;02;21;Keskiviikko;0;0;0
95;07.02.2018;2018;02;22;Keskiviikko;1;1;2
95;07.02.2018;2018;02;23;Keskiviikko;0;0;0
95;08.02.2018;2018;02;00;Torstai;0;0;0
95;08.02.2018;2018;02;01;Torstai;0;0;0
95;08.02.2018;2018;02;02;Torstai;0;1;1
95;08.02.2018;2018;02;03;Torstai;0;0;0
95;08.02.2018;2018;02;04;Torstai;0;0;0
95;08.02.2018;2018;02;05;Torstai;1;2;3
95;08.02.2018;2018;02;06;Torstai;3;2;5
95;08.02.2018;2018;02;07;Torstai;5;6;11
95;08.02.2018;2018;02;08;Torstai;1;1;2
95;08.02.2018;2018;02;09;Torstai;3;6;9
95;08.02.2018;2018;02;10;Torstai;0;2;2
95;08.02.2018;2018;02;11;Torstai;0;1;1
95;08.02.2018;2018;02;12;Torstai;0;0;0
95;08.02.2018;2018;02;13;Torstai;1;0;1
95;08.02.2018;2018;02;14;Torstai;2;2;4
95;08.02.2018;2018;02;15;Torstai;8;2;10
95;08.02.2018;2018;02;16;Torstai;12;2;14
95;08.02.2018;2018;02;17;Torstai;4;4;8
95;08.02.2018;2018;02;18;Torstai;1;0;1
95;08.02.2018;2018;02;19;Torstai;0;2;2
95;08.02.2018;2018;02;20;Torstai;1;2;3
95;08.02.2018;2018;02;21;Torstai;0;0;0
95;08.02.2018;2018;02;22;Torstai;0;1;1
95;08.02.2018;2018;02;23;Torstai;0;0;0
95;09.02.2018;2018;02;00;Perjantai;0;0;0
95;09.02.2018;2018;02;01;Perjantai;0;0;0
95;09.02.2018;2018;02;02;Perjantai;0;1;1
95;09.02.2018;2018;02;03;Perjantai;0;0;0
95;09.02.2018;2018;02;04;Perjantai;2;0;2
95;09.02.2018;2018;02;05;Perjantai;3;3;6
95;09.02.2018;2018;02;06;Perjantai;3;1;4
95;09.02.2018;2018;02;07;Perjantai;8;2;10
95;09.02.2018;2018;02;08;Perjantai;7;2;9
95;09.02.2018;2018;02;09;Perjantai;5;3;8
95;09.02.2018;2018;02;10;Perjantai;2;1;3
95;09.02.2018;2018;02;11;Perjantai;3;1;4
95;09.02.2018;2018;02;12;Perjantai;0;1;1
95;09.02.2018;2018;02;13;Perjantai;10;2;12
95;09.02.2018;2018;02;14;Perjantai;9;1;10
95;09.02.2018;2018;02;15;Perjantai;7;1;8
95;09.02.2018;2018;02;16;Perjantai;6;1;7
95;09.02.2018;2018;02;17;Perjantai;4;3;7
95;09.02.2018;2018;02;18;Perjantai;4;2;6
95;09.02.2018;2018;02;19;Perjantai;1;1;2
95;09.02.2018;2018;02;20;Perjantai;2;0;2
95;09.02.2018;2018;02;21;Perjantai;1;0;1
95;09.02.2018;2018;02;22;Perjantai;0;1;1
95;09.02.2018;2018;02;23;Perjantai;0;0;0
95;10.02.2018;2018;02;00;Lauantai;0;0;0
95;10.02.2018;2018;02;01;Lauantai;0;0;0
95;10.02.2018;2018;02;02;Lauantai;0;0;0
95;10.02.2018;2018;02;03;Lauantai;0;0;0
95;10.02.2018;2018;02;04;Lauantai;0;0;0
95;10.02.2018;2018;02;05;Lauantai;1;0;1
95;10.02.2018;2018;02;06;Lauantai;0;0;0
95;10.02.2018;2018;02;07;Lauantai;2;0;2
95;10.02.2018;2018;02;08;Lauantai;0;0;0
95;10.02.2018;2018;02;09;Lauantai;1;1;2
95;10.02.2018;2018;02;10;Lauantai;1;0;1
95;10.02.2018;2018;02;11;Lauantai;2;2;4
95;10.02.2018;2018;02;12;Lauantai;3;1;4
95;10.02.2018;2018;02;13;Lauantai;1;1;2
95;10.02.2018;2018;02;14;Lauantai;0;0;0
95;10.02.2018;2018;02;15;Lauantai;0;1;1
95;10.02.2018;2018;02;16;Lauantai;2;2;4
95;10.02.2018;2018;02;17;Lauantai;0;0;0
95;10.02.2018;2018;02;18;Lauantai;0;1;1
95;10.02.2018;2018;02;19;Lauantai;0;0;0
95;10.02.2018;2018;02;20;Lauantai;0;0;0
95;10.02.2018;2018;02;21;Lauantai;0;1;1
95;10.02.2018;2018;02;22;Lauantai;2;0;2
95;10.02.2018;2018;02;23;Lauantai;1;0;1
95;11.02.2018;2018;02;00;Sunnuntai;0;0;0
95;11.02.2018;2018;02;01;Sunnuntai;0;0;0
95;11.02.2018;2018;02;02;Sunnuntai;0;0;0
95;11.02.2018;2018;02;03;Sunnuntai;0;0;0
95;11.02.2018;2018;02;04;Sunnuntai;0;0;0
95;11.02.2018;2018;02;05;Sunnuntai;0;0;0
95;11.02.2018;2018;02;06;Sunnuntai;1;0;1
95;11.02.2018;2018;02;07;Sunnuntai;2;0;2
95;11.02.2018;2018;02;08;Sunnuntai;1;0;1
95;11.02.2018;2018;02;09;Sunnuntai;0;0;0
95;11.02.2018;2018;02;10;Sunnuntai;2;0;2
95;11.02.2018;2018;02;11;Sunnuntai;3;1;4
95;11.02.2018;2018;02;12;Sunnuntai;6;0;6
95;11.02.2018;2018;02;13;Sunnuntai;0;1;1
95;11.02.2018;2018;02;14;Sunnuntai;0;3;3
95;11.02.2018;2018;02;15;Sunnuntai;0;0;0
95;11.02.2018;2018;02;16;Sunnuntai;1;0;1
95;11.02.2018;2018;02;17;Sunnuntai;2;1;3
95;11.02.2018;2018;02;18;Sunnuntai;1;1;2
95;11.02.2018;2018;02;19;Sunnuntai;0;0;0
95;11.02.2018;2018;02;20;Sunnuntai;1;0;1
95;11.02.2018;2018;02;21;Sunnuntai;1;0;1
95;11.02.2018;2018;02;22;Sunnuntai;0;0;0
95;11.02.2018;2018;02;23;Sunnuntai;0;0;0
95;12.02.2018;2018;02;00;Maanantai;0;0;0
95;12.02.2018;2018;02;01;Maanantai;0;0;0
95;12.02.2018;2018;02;02;Maanantai;0;0;0
95;12.02.2018;2018;02;03;Maanantai;0;0;0
95;12.02.2018;2018;02;04;Maanantai;0;0;0
95;12.02.2018;2018;02;05;Maanantai;7;1;8
95;12.02.2018;2018;02;06;Maanantai;12;3;15
95;12.02.2018;2018;02;07;Maanantai;6;2;8
95;12.02.2018;2018;02;08;Maanantai;4;1;5
95;12.02.2018;2018;02;09;Maanantai;10;4;14
95;12.02.2018;2018;02;10;Maanantai;2;0;2
95;12.02.2018;2018;02;11;Maanantai;7;2;9
95;12.02.2018;2018;02;12;Maanantai;2;2;4
95;12.02.2018;2018;02;13;Maanantai;2;1;3
95;12.02.2018;2018;02;14;Maanantai;3;5;8
95;12.02.2018;2018;02;15;Maanantai;8;7;15
95;12.02.2018;2018;02;16;Maanantai;12;8;20
95;12.02.2018;2018;02;17;Maanantai;2;5;7
95;12.02.2018;2018;02;18;Maanantai;1;4;5
95;12.02.2018;2018;02;19;Maanantai;4;1;5
95;12.02.2018;2018;02;20;Maanantai;1;1;2
95;12.02.2018;2018;02;21;Maanantai;1;0;1
95;12.02.2018;2018;02;22;Maanantai;1;0;1
95;12.02.2018;2018;02;23;Maanantai;1;1;2
95;13.02.2018;2018;02;00;Tiistai;0;0;0
95;13.02.2018;2018;02;01;Tiistai;0;0;0
95;13.02.2018;2018;02;02;Tiistai;0;0;0
95;13.02.2018;2018;02;03;Tiistai;0;0;0
95;13.02.2018;2018;02;04;Tiistai;1;1;2
95;13.02.2018;2018;02;05;Tiistai;4;3;7
95;13.02.2018;2018;02;06;Tiistai;9;6;15
95;13.02.2018;2018;02;07;Tiistai;5;11;16
95;13.02.2018;2018;02;08;Tiistai;3;8;11
95;13.02.2018;2018;02;09;Tiistai;5;2;7
95;13.02.2018;2018;02;10;Tiistai;2;1;3
95;13.02.2018;2018;02;11;Tiistai;3;0;3
95;13.02.2018;2018;02;12;Tiistai;3;2;5
95;13.02.2018;2018;02;13;Tiistai;2;4;6
95;13.02.2018;2018;02;14;Tiistai;11;2;13
95;13.02.2018;2018;02;15;Tiistai;11;7;18
95;13.02.2018;2018;02;16;Tiistai;9;11;20
95;13.02.2018;2018;02;17;Tiistai;0;7;7
95;13.02.2018;2018;02;18;Tiistai;4;3;7
95;13.02.2018;2018;02;19;Tiistai;1;5;6
95;13.02.2018;2018;02;20;Tiistai;0;3;3
95;13.02.2018;2018;02;21;Tiistai;1;1;2
95;13.02.2018;2018;02;22;Tiistai;3;3;6
95;13.02.2018;2018;02;23;Tiistai;0;0;0
95;14.02.2018;2018;02;00;Keskiviikko;0;0;0
95;14.02.2018;2018;02;01;Keskiviikko;0;0;0
95;14.02.2018;2018;02;02;Keskiviikko;0;0;0
95;14.02.2018;2018;02;03;Keskiviikko;0;0;0
95;14.02.2018;2018;02;04;Keskiviikko;0;0;0
95;14.02.2018;2018;02;05;Keskiviikko;9;0;9
95;14.02.2018;2018;02;06;Keskiviikko;4;0;4
95;14.02.2018;2018;02;07;Keskiviikko;12;0;12
95;14.02.2018;2018;02;08;Keskiviikko;7;0;7
95;14.02.2018;2018;02;09;Keskiviikko;2;0;2
95;14.02.2018;2018;02;10;Keskiviikko;1;0;1
95;14.02.2018;2018;02;11;Keskiviikko;2;0;2
95;14.02.2018;2018;02;12;Keskiviikko;0;0;0
95;14.02.2018;2018;02;13;Keskiviikko;4;0;4
95;14.02.2018;2018;02;14;Keskiviikko;9;0;9
95;14.02.2018;2018;02;15;Keskiviikko;11;0;11
95;14.02.2018;2018;02;16;Keskiviikko;17;0;17
95;14.02.2018;2018;02;17;Keskiviikko;8;0;8
95;14.02.2018;2018;02;18;Keskiviikko;2;0;2
95;14.02.2018;2018;02;19;Keskiviikko;2;0;2
95;14.02.2018;2018;02;20;Keskiviikko;1;0;1
95;14.02.2018;2018;02;21;Keskiviikko;0;0;0
95;14.02.2018;2018;02;22;Keskiviikko;2;0;2
95;14.02.2018;2018;02;23;Keskiviikko;0;0;0
95;15.02.2018;2018;02;00;Torstai;0;0;0
95;15.02.2018;2018;02;01;Torstai;0;0;0
95;15.02.2018;2018;02;02;Torstai;1;0;1
95;15.02.2018;2018;02;03;Torstai;0;0;0
95;15.02.2018;2018;02;04;Torstai;0;0;0
95;15.02.2018;2018;02;05;Torstai;3;0;3
95;15.02.2018;2018;02;06;Torstai;5;0;5
95;15.02.2018;2018;02;07;Torstai;11;0;11
95;15.02.2018;2018;02;08;Torstai;2;0;2
95;15.02.2018;2018;02;09;Torstai;9;0;9
95;15.02.2018;2018;02;10;Torstai;2;0;2
95;15.02.2018;2018;02;11;Torstai;1;0;1
95;15.02.2018;2018;02;12;Torstai;0;0;0
95;15.02.2018;2018;02;13;Torstai;1;0;1
95;15.02.2018;2018;02;14;Torstai;4;0;4
95;15.02.2018;2018;02;15;Torstai;10;0;10
95;15.02.2018;2018;02;16;Torstai;14;0;14
95;15.02.2018;2018;02;17;Torstai;8;0;8
95;15.02.2018;2018;02;18;Torstai;1;0;1
95;15.02.2018;2018;02;19;Torstai;2;0;2
95;15.02.2018;2018;02;20;Torstai;3;0;3
95;15.02.2018;2018;02;21;Torstai;0;0;0
95;15.02.2018;2018;02;22;Torstai;1;0;1
95;15.02.2018;2018;02;23;Torstai;0;0;0
95;16.02.2018;2018;02;00;Perjantai;0;0;0
95;16.02.2018;2018;02;01;Perjantai;0;0;0
95;16.02.2018;2018;02;02;Perjantai;0;0;0
95;16.02.2018;2018;02;03;Perjantai;0;0;0
95;16.02.2018;2018;02;04;Perjantai;0;1;1
95;16.02.2018;2018;02;05;Perjantai;6;2;8
95;16.02.2018;2018;02;06;Perjantai;3;5;8
95;16.02.2018;2018;02;07;Perjantai;10;10;20
95;16.02.2018;2018;02;08;Perjantai;4;7;11
95;16.02.2018;2018;02;09;Perjantai;3;2;5
95;16.02.2018;2018;02;10;Perjantai;2;1;3
95;16.02.2018;2018;02;11;Perjantai;0;1;1
95;16.02.2018;2018;02;12;Perjantai;6;2;8
95;16.02.2018;2018;02;13;Perjantai;5;1;6
95;16.02.2018;2018;02;14;Perjantai;12;1;13
95;16.02.2018;2018;02;15;Perjantai;18;3;21
95;16.02.2018;2018;02;16;Perjantai;12;4;16
95;16.02.2018;2018;02;17;Perjantai;3;1;4
95;16.02.2018;2018;02;18;Perjantai;1;2;3
95;16.02.2018;2018;02;19;Perjantai;2;1;3
95;16.02.2018;2018;02;20;Perjantai;0;1;1
95;16.02.2018;2018;02;21;Perjantai;0;0;0
95;16.02.2018;2018;02;22;Perjantai;1;0;1
95;16.02.2018;2018;02;23;Perjantai;2;0;2
95;17.02.2018;2018;02;00;Lauantai;0;0;0
95;17.02.2018;2018;02;01;Lauantai;0;0;0
95;17.02.2018;2018;02;02;Lauantai;0;0;0
95;17.02.2018;2018;02;03;Lauantai;0;0;0
95;17.02.2018;2018;02;04;Lauantai;1;0;1
95;17.02.2018;2018;02;05;Lauantai;2;0;2
95;17.02.2018;2018;02;06;Lauantai;1;0;1
95;17.02.2018;2018;02;07;Lauantai;1;0;1
95;17.02.2018;2018;02;08;Lauantai;1;0;1
95;17.02.2018;2018;02;09;Lauantai;0;0;0
95;17.02.2018;2018;02;10;Lauantai;1;0;1
95;17.02.2018;2018;02;11;Lauantai;1;0;1
95;17.02.2018;2018;02;12;Lauantai;2;0;2
95;17.02.2018;2018;02;13;Lauantai;2;6;8
95;17.02.2018;2018;02;14;Lauantai;5;3;8
95;17.02.2018;2018;02;15;Lauantai;1;3;4
95;17.02.2018;2018;02;16;Lauantai;3;2;5
95;17.02.2018;2018;02;17;Lauantai;1;1;2
95;17.02.2018;2018;02;18;Lauantai;2;3;5
95;17.02.2018;2018;02;19;Lauantai;1;0;1
95;17.02.2018;2018;02;20;Lauantai;0;1;1
95;17.02.2018;2018;02;21;Lauantai;0;1;1
95;17.02.2018;2018;02;22;Lauantai;0;0;0
95;17.02.2018;2018;02;23;Lauantai;0;0;0
95;18.02.2018;2018;02;00;Sunnuntai;0;0;0
95;18.02.2018;2018;02;01;Sunnuntai;0;0;0
95;18.02.2018;2018;02;02;Sunnuntai;0;1;1
95;18.02.2018;2018;02;03;Sunnuntai;0;1;1
95;18.02.2018;2018;02;04;Sunnuntai;0;0;0
95;18.02.2018;2018;02;05;Sunnuntai;1;0;1
95;18.02.2018;2018;02;06;Sunnuntai;0;0;0
95;18.02.2018;2018;02;07;Sunnuntai;2;0;2
95;18.02.2018;2018;02;08;Sunnuntai;0;0;0
95;18.02.2018;2018;02;09;Sunnuntai;0;0;0
95;18.02.2018;2018;02;10;Sunnuntai;0;0;0
95;18.02.2018;2018;02;11;Sunnuntai;1;1;2
95;18.02.2018;2018;02;12;Sunnuntai;1;1;2
95;18.02.2018;2018;02;13;Sunnuntai;1;1;2
95;18.02.2018;2018;02;14;Sunnuntai;3;2;5
95;18.02.2018;2018;02;15;Sunnuntai;0;0;0
95;18.02.2018;2018;02;16;Sunnuntai;1;0;1
95;18.02.2018;2018;02;17;Sunnuntai;0;1;1
95;18.02.2018;2018;02;18;Sunnuntai;0;0;0
95;18.02.2018;2018;02;19;Sunnuntai;0;0;0
95;18.02.2018;2018;02;20;Sunnuntai;1;1;2
95;18.02.2018;2018;02;21;Sunnuntai;0;0;0
95;18.02.2018;2018;02;22;Sunnuntai;0;1;1
95;18.02.2018;2018;02;23;Sunnuntai;1;2;3
95;19.02.2018;2018;02;00;Maanantai;0;0;0
95;19.02.2018;2018;02;01;Maanantai;0;0;0
95;19.02.2018;2018;02;02;Maanantai;0;0;0
95;19.02.2018;2018;02;03;Maanantai;0;0;0
95;19.02.2018;2018;02;04;Maanantai;0;0;0
95;19.02.2018;2018;02;05;Maanantai;6;0;6
95;19.02.2018;2018;02;06;Maanantai;5;1;6
95;19.02.2018;2018;02;07;Maanantai;5;3;8
95;19.02.2018;2018;02;08;Maanantai;0;2;2
95;19.02.2018;2018;02;09;Maanantai;3;6;9
95;19.02.2018;2018;02;10;Maanantai;1;1;2
95;19.02.2018;2018;02;11;Maanantai;1;1;2
95;19.02.2018;2018;02;12;Maanantai;0;0;0
95;19.02.2018;2018;02;13;Maanantai;4;2;6
95;19.02.2018;2018;02;14;Maanantai;3;3;6
95;19.02.2018;2018;02;15;Maanantai;6;3;9
95;19.02.2018;2018;02;16;Maanantai;8;2;10
95;19.02.2018;2018;02;17;Maanantai;3;2;5
95;19.02.2018;2018;02;18;Maanantai;0;0;0
95;19.02.2018;2018;02;19;Maanantai;0;0;0
95;19.02.2018;2018;02;20;Maanantai;1;0;1
95;19.02.2018;2018;02;21;Maanantai;0;1;1
95;19.02.2018;2018;02;22;Maanantai;0;0;0
95;19.02.2018;2018;02;23;Maanantai;0;0;0
95;20.02.2018;2018;02;00;Tiistai;0;0;0
95;20.02.2018;2018;02;01;Tiistai;0;0;0
95;20.02.2018;2018;02;02;Tiistai;0;0;0
95;20.02.2018;2018;02;03;Tiistai;0;0;0
95;20.02.2018;2018;02;04;Tiistai;0;1;1
95;20.02.2018;2018;02;05;Tiistai;3;2;5
95;20.02.2018;2018;02;06;Tiistai;0;1;1
95;20.02.2018;2018;02;07;Tiistai;5;0;5
95;20.02.2018;2018;02;08;Tiistai;2;3;5
95;20.02.2018;2018;02;09;Tiistai;0;2;2
95;20.02.2018;2018;02;10;Tiistai;2;2;4
95;20.02.2018;2018;02;11;Tiistai;0;0;0
95;20.02.2018;2018;02;12;Tiistai;0;0;0
95;20.02.2018;2018;02;13;Tiistai;3;1;4
95;20.02.2018;2018;02;14;Tiistai;5;3;8
95;20.02.2018;2018;02;15;Tiistai;7;3;10
95;20.02.2018;2018;02;16;Tiistai;4;2;6
95;20.02.2018;2018;02;17;Tiistai;3;2;5
95;20.02.2018;2018;02;18;Tiistai;2;1;3
95;20.02.2018;2018;02;19;Tiistai;2;0;2
95;20.02.2018;2018;02;20;Tiistai;0;0;0
95;20.02.2018;2018;02;21;Tiistai;0;0;0
95;20.02.2018;2018;02;22;Tiistai;0;0;0
95;20.02.2018;2018;02;23;Tiistai;0;0;0
95;21.02.2018;2018;02;00;Keskiviikko;0;0;0
95;21.02.2018;2018;02;01;Keskiviikko;0;0;0
95;21.02.2018;2018;02;02;Keskiviikko;0;0;0
95;21.02.2018;2018;02;03;Keskiviikko;0;0;0
95;21.02.2018;2018;02;04;Keskiviikko;0;1;1
95;21.02.2018;2018;02;05;Keskiviikko;3;2;5
95;21.02.2018;2018;02;06;Keskiviikko;2;2;4
95;21.02.2018;2018;02;07;Keskiviikko;7;0;7
95;21.02.2018;2018;02;08;Keskiviikko;4;6;10
95;21.02.2018;2018;02;09;Keskiviikko;4;4;8
95;21.02.2018;2018;02;10;Keskiviikko;8;2;10
95;21.02.2018;2018;02;11;Keskiviikko;0;0;0
95;21.02.2018;2018;02;12;Keskiviikko;2;1;3
95;21.02.2018;2018;02;13;Keskiviikko;8;2;10
95;21.02.2018;2018;02;14;Keskiviikko;6;4;10
95;21.02.2018;2018;02;15;Keskiviikko;9;5;14
95;21.02.2018;2018;02;16;Keskiviikko;9;2;11
95;21.02.2018;2018;02;17;Keskiviikko;3;4;7
95;21.02.2018;2018;02;18;Keskiviikko;3;0;3
95;21.02.2018;2018;02;19;Keskiviikko;0;0;0
95;21.02.2018;2018;02;20;Keskiviikko;1;0;1
95;21.02.2018;2018;02;21;Keskiviikko;0;0;0
95;21.02.2018;2018;02;22;Keskiviikko;0;1;1
95;21.02.2018;2018;02;23;Keskiviikko;0;0;0
95;22.02.2018;2018;02;00;Torstai;0;1;1
95;22.02.2018;2018;02;01;Torstai;0;0;0
95;22.02.2018;2018;02;02;Torstai;0;0;0
95;22.02.2018;2018;02;03;Torstai;0;0;0
95;22.02.2018;2018;02;04;Torstai;0;0;0
95;22.02.2018;2018;02;05;Torstai;6;0;6
95;22.02.2018;2018;02;06;Torstai;7;1;8
95;22.02.2018;2018;02;07;Torstai;3;1;4
95;22.02.2018;2018;02;08;Torstai;6;2;8
95;22.02.2018;2018;02;09;Torstai;9;2;11
95;22.02.2018;2018;02;10;Torstai;2;2;4
95;22.02.2018;2018;02;11;Torstai;2;2;4
95;22.02.2018;2018;02;12;Torstai;1;0;1
95;22.02.2018;2018;02;13;Torstai;1;0;1
95;22.02.2018;2018;02;14;Torstai;4;1;5
95;22.02.2018;2018;02;15;Torstai;10;3;13
95;22.02.2018;2018;02;16;Torstai;11;6;17
95;22.02.2018;2018;02;17;Torstai;2;2;4
95;22.02.2018;2018;02;18;Torstai;3;0;3
95;22.02.2018;2018;02;19;Torstai;4;0;4
95;22.02.2018;2018;02;20;Torstai;0;0;0
95;22.02.2018;2018;02;21;Torstai;0;0;0
95;22.02.2018;2018;02;22;Torstai;0;0;0
95;22.02.2018;2018;02;23;Torstai;1;0;1
95;23.02.2018;2018;02;00;Perjantai;0;0;0
95;23.02.2018;2018;02;01;Perjantai;0;0;0
95;23.02.2018;2018;02;02;Perjantai;0;0;0
95;23.02.2018;2018;02;03;Perjantai;0;0;0
95;23.02.2018;2018;02;04;Perjantai;2;0;2
95;23.02.2018;2018;02;05;Perjantai;3;2;5
95;23.02.2018;2018;02;06;Perjantai;7;0;7
95;23.02.2018;2018;02;07;Perjantai;9;1;10
95;23.02.2018;2018;02;08;Perjantai;4;5;9
95;23.02.2018;2018;02;09;Perjantai;1;3;4
95;23.02.2018;2018;02;10;Perjantai;3;1;4
95;23.02.2018;2018;02;11;Perjantai;2;1;3
95;23.02.2018;2018;02;12;Perjantai;0;5;5
95;23.02.2018;2018;02;13;Perjantai;8;0;8
95;23.02.2018;2018;02;14;Perjantai;10;2;12
95;23.02.2018;2018;02;15;Perjantai;17;1;18
95;23.02.2018;2018;02;16;Perjantai;3;4;7
95;23.02.2018;2018;02;17;Perjantai;3;1;4
95;23.02.2018;2018;02;18;Perjantai;2;0;2
95;23.02.2018;2018;02;19;Perjantai;2;1;3
95;23.02.2018;2018;02;20;Perjantai;0;0;0
95;23.02.2018;2018;02;21;Perjantai;0;0;0
95;23.02.2018;2018;02;22;Perjantai;0;0;0
95;23.02.2018;2018;02;23;Perjantai;0;0;0
95;24.02.2018;2018;02;00;Lauantai;0;0;0
95;24.02.2018;2018;02;01;Lauantai;0;0;0
95;24.02.2018;2018;02;02;Lauantai;0;0;0
95;24.02.2018;2018;02;03;Lauantai;0;0;0
95;24.02.2018;2018;02;04;Lauantai;0;0;0
95;24.02.2018;2018;02;05;Lauantai;0;0;0
95;24.02.2018;2018;02;06;Lauantai;0;0;0
95;24.02.2018;2018;02;07;Lauantai;1;0;1
95;24.02.2018;2018;02;08;Lauantai;0;0;0
95;24.02.2018;2018;02;09;Lauantai;0;0;0
95;24.02.2018;2018;02;10;Lauantai;0;0;0
95;24.02.2018;2018;02;11;Lauantai;0;0;0
95;24.02.2018;2018;02;12;Lauantai;2;1;3
95;24.02.2018;2018;02;13;Lauantai;2;1;3
95;24.02.2018;2018;02;14;Lauantai;0;0;0
95;24.02.2018;2018;02;15;Lauantai;0;0;0
95;24.02.2018;2018;02;16;Lauantai;4;0;4
95;24.02.2018;2018;02;17;Lauantai;2;3;5
95;24.02.2018;2018;02;18;Lauantai;2;0;2
95;24.02.2018;2018;02;19;Lauantai;0;0;0
95;24.02.2018;2018;02;20;Lauantai;0;0;0
95;24.02.2018;2018;02;21;Lauantai;1;0;1
95;24.02.2018;2018;02;22;Lauantai;0;0;0
95;24.02.2018;2018;02;23;Lauantai;0;0;0
95;25.02.2018;2018;02;00;Sunnuntai;0;0;0
95;25.02.2018;2018;02;01;Sunnuntai;0;0;0
95;25.02.2018;2018;02;02;Sunnuntai;0;0;0
95;25.02.2018;2018;02;03;Sunnuntai;0;0;0
95;25.02.2018;2018;02;04;Sunnuntai;0;0;0
95;25.02.2018;2018;02;05;Sunnuntai;1;0;1
95;25.02.2018;2018;02;06;Sunnuntai;0;0;0
95;25.02.2018;2018;02;07;Sunnuntai;0;0;0
95;25.02.2018;2018;02;08;Sunnuntai;0;0;0
95;25.02.2018;2018;02;09;Sunnuntai;0;0;0
95;25.02.2018;2018;02;10;Sunnuntai;1;4;5
95;25.02.2018;2018;02;11;Sunnuntai;2;4;6
95;25.02.2018;2018;02;12;Sunnuntai;1;0;1
95;25.02.2018;2018;02;13;Sunnuntai;1;0;1
95;25.02.2018;2018;02;14;Sunnuntai;2;0;2
95;25.02.2018;2018;02;15;Sunnuntai;4;1;5
95;25.02.2018;2018;02;16;Sunnuntai;0;0;0
95;25.02.2018;2018;02;17;Sunnuntai;0;0;0
95;25.02.2018;2018;02;18;Sunnuntai;2;0;2
95;25.02.2018;2018;02;19;Sunnuntai;4;0;4
95;25.02.2018;2018;02;20;Sunnuntai;2;1;3
95;25.02.2018;2018;02;21;Sunnuntai;0;0;0
95;25.02.2018;2018;02;22;Sunnuntai;0;2;2
95;25.02.2018;2018;02;23;Sunnuntai;0;0;0
95;26.02.2018;2018;02;00;Maanantai;0;0;0
95;26.02.2018;2018;02;01;Maanantai;0;0;0
95;26.02.2018;2018;02;02;Maanantai;1;0;1
95;26.02.2018;2018;02;03;Maanantai;0;0;0
95;26.02.2018;2018;02;04;Maanantai;0;0;0
95;26.02.2018;2018;02;05;Maanantai;4;0;4
95;26.02.2018;2018;02;06;Maanantai;4;0;4
95;26.02.2018;2018;02;07;Maanantai;9;3;12
95;26.02.2018;2018;02;08;Maanantai;4;2;6
95;26.02.2018;2018;02;09;Maanantai;1;3;4
95;26.02.2018;2018;02;10;Maanantai;5;3;8
95;26.02.2018;2018;02;11;Maanantai;6;2;8
95;26.02.2018;2018;02;12;Maanantai;2;1;3
95;26.02.2018;2018;02;13;Maanantai;1;2;3
95;26.02.2018;2018;02;14;Maanantai;5;1;6
95;26.02.2018;2018;02;15;Maanantai;9;1;10
95;26.02.2018;2018;02;16;Maanantai;19;5;24
95;26.02.2018;2018;02;17;Maanantai;2;3;5
95;26.02.2018;2018;02;18;Maanantai;2;3;5
95;26.02.2018;2018;02;19;Maanantai;0;0;0
95;26.02.2018;2018;02;20;Maanantai;0;1;1
95;26.02.2018;2018;02;21;Maanantai;1;1;2
95;26.02.2018;2018;02;22;Maanantai;2;1;3
95;26.02.2018;2018;02;23;Maanantai;0;0;0
95;27.02.2018;2018;02;00;Tiistai;0;0;0
95;27.02.2018;2018;02;01;Tiistai;0;0;0
95;27.02.2018;2018;02;02;Tiistai;0;0;0
95;27.02.2018;2018;02;03;Tiistai;0;0;0
95;27.02.2018;2018;02;04;Tiistai;0;0;0
95;27.02.2018;2018;02;05;Tiistai;3;2;5
95;27.02.2018;2018;02;06;Tiistai;3;0;3
95;27.02.2018;2018;02;07;Tiistai;8;3;11
95;27.02.2018;2018;02;08;Tiistai;5;3;8
95;27.02.2018;2018;02;09;Tiistai;2;0;2
95;27.02.2018;2018;02;10;Tiistai;2;1;3
95;27.02.2018;2018;02;11;Tiistai;2;1;3
95;27.02.2018;2018;02;12;Tiistai;0;0;0
95;27.02.2018;2018;02;13;Tiistai;2;2;4
95;27.02.2018;2018;02;14;Tiistai;6;2;8
95;27.02.2018;2018;02;15;Tiistai;14;4;18
95;27.02.2018;2018;02;16;Tiistai;5;2;7
95;27.02.2018;2018;02;17;Tiistai;3;2;5
95;27.02.2018;2018;02;18;Tiistai;1;0;1
95;27.02.2018;2018;02;19;Tiistai;0;0;0
95;27.02.2018;2018;02;20;Tiistai;0;0;0
95;27.02.2018;2018;02;21;Tiistai;0;0;0
95;27.02.2018;2018;02;22;Tiistai;2;2;4
95;27.02.2018;2018;02;23;Tiistai;0;0;0
95;28.02.2018;2018;02;00;Keskiviikko;0;0;0
95;28.02.2018;2018;02;01;Keskiviikko;0;0;0
95;28.02.2018;2018;02;02;Keskiviikko;0;0;0
95;28.02.2018;2018;02;03;Keskiviikko;0;0;0
95;28.02.2018;2018;02;04;Keskiviikko;0;0;0
95;28.02.2018;2018;02;05;Keskiviikko;4;2;6
95;28.02.2018;2018;02;06;Keskiviikko;1;0;1
95;28.02.2018;2018;02;07;Keskiviikko;9;1;10
95;28.02.2018;2018;02;08;Keskiviikko;6;0;6
95;28.02.2018;2018;02;09;Keskiviikko;0;0;0
95;28.02.2018;2018;02;10;Keskiviikko;1;0;1
95;28.02.2018;2018;02;11;Keskiviikko;0;0;0
95;28.02.2018;2018;02;12;Keskiviikko;2;0;2
95;28.02.2018;2018;02;13;Keskiviikko;7;1;8
95;28.02.2018;2018;02;14;Keskiviikko;9;1;10
95;28.02.2018;2018;02;15;Keskiviikko;6;1;7
95;28.02.2018;2018;02;16;Keskiviikko;13;2;15
95;28.02.2018;2018;02;17;Keskiviikko;4;0;4
95;28.02.2018;2018;02;18;Keskiviikko;1;1;2
95;28.02.2018;2018;02;19;Keskiviikko;0;1;1
95;28.02.2018;2018;02;20;Keskiviikko;0;1;1
95;28.02.2018;2018;02;21;Keskiviikko;0;0;0
95;28.02.2018;2018;02;22;Keskiviikko;2;0;2
95;28.02.2018;2018;02;23;Keskiviikko;0;0;0
95;01.03.2018;2018;03;00;Torstai;0;0;0
95;01.03.2018;2018;03;01;Torstai;0;0;0
95;01.03.2018;2018;03;02;Torstai;0;0;0
95;01.03.2018;2018;03;03;Torstai;0;0;0
95;01.03.2018;2018;03;04;Torstai;0;0;0
95;01.03.2018;2018;03;05;Torstai;6;0;6
95;01.03.2018;2018;03;06;Torstai;4;1;5
95;01.03.2018;2018;03;07;Torstai;7;0;7
95;01.03.2018;2018;03;08;Torstai;8;0;8
95;01.03.2018;2018;03;09;Torstai;4;0;4
95;01.03.2018;2018;03;10;Torstai;2;1;3
95;01.03.2018;2018;03;11;Torstai;3;2;5
95;01.03.2018;2018;03;12;Torstai;2;1;3
95;01.03.2018;2018;03;13;Torstai;3;2;5
95;01.03.2018;2018;03;14;Torstai;9;0;9
95;01.03.2018;2018;03;15;Torstai;9;1;10
95;01.03.2018;2018;03;16;Torstai;12;1;13
95;01.03.2018;2018;03;17;Torstai;5;1;6
95;01.03.2018;2018;03;18;Torstai;2;2;4
95;01.03.2018;2018;03;19;Torstai;0;0;0
95;01.03.2018;2018;03;20;Torstai;1;0;1
95;01.03.2018;2018;03;21;Torstai;3;1;4
95;01.03.2018;2018;03;22;Torstai;2;0;2
95;01.03.2018;2018;03;23;Torstai;1;0;1
95;02.03.2018;2018;03;00;Perjantai;0;0;0
95;02.03.2018;2018;03;01;Perjantai;0;0;0
95;02.03.2018;2018;03;02;Perjantai;0;0;0
95;02.03.2018;2018;03;03;Perjantai;0;0;0
95;02.03.2018;2018;03;04;Perjantai;0;0;0
95;02.03.2018;2018;03;05;Perjantai;4;1;5
95;02.03.2018;2018;03;06;Perjantai;2;0;2
95;02.03.2018;2018;03;07;Perjantai;10;2;12
95;02.03.2018;2018;03;08;Perjantai;1;2;3
95;02.03.2018;2018;03;09;Perjantai;5;2;7
95;02.03.2018;2018;03;10;Perjantai;7;1;8
95;02.03.2018;2018;03;11;Perjantai;5;0;5
95;02.03.2018;2018;03;12;Perjantai;0;0;0
95;02.03.2018;2018;03;13;Perjantai;5;2;7
95;02.03.2018;2018;03;14;Perjantai;7;3;10
95;02.03.2018;2018;03;15;Perjantai;7;1;8
95;02.03.2018;2018;03;16;Perjantai;1;4;5
95;02.03.2018;2018;03;17;Perjantai;3;5;8
95;02.03.2018;2018;03;18;Perjantai;2;1;3
95;02.03.2018;2018;03;19;Perjantai;0;0;0
95;02.03.2018;2018;03;20;Perjantai;1;0;1
95;02.03.2018;2018;03;21;Perjantai;1;1;2
95;02.03.2018;2018;03;22;Perjantai;0;0;0
95;02.03.2018;2018;03;23;Perjantai;0;0;0
95;03.03.2018;2018;03;00;Lauantai;0;0;0
95;03.03.2018;2018;03;01;Lauantai;0;0;0
95;03.03.2018;2018;03;02;Lauantai;0;0;0
95;03.03.2018;2018;03;03;Lauantai;0;0;0
95;03.03.2018;2018;03;04;Lauantai;0;0;0
95;03.03.2018;2018;03;05;Lauantai;0;0;0
95;03.03.2018;2018;03;06;Lauantai;1;0;1
95;03.03.2018;2018;03;07;Lauantai;0;0;0
95;03.03.2018;2018;03;08;Lauantai;0;0;0
95;03.03.2018;2018;03;09;Lauantai;0;0;0
95;03.03.2018;2018;03;10;Lauantai;0;1;1
95;03.03.2018;2018;03;11;Lauantai;3;0;3
95;03.03.2018;2018;03;12;Lauantai;1;1;2
95;03.03.2018;2018;03;13;Lauantai;4;0;4
95;03.03.2018;2018;03;14;Lauantai;2;3;5
95;03.03.2018;2018;03;15;Lauantai;1;1;2
95;03.03.2018;2018;03;16;Lauantai;1;3;4
95;03.03.2018;2018;03;17;Lauantai;0;3;3
95;03.03.2018;2018;03;18;Lauantai;0;1;1
95;03.03.2018;2018;03;19;Lauantai;3;1;4
95;03.03.2018;2018;03;20;Lauantai;0;0;0
95;03.03.2018;2018;03;21;Lauantai;1;1;2
95;03.03.2018;2018;03;22;Lauantai;0;0;0
95;03.03.2018;2018;03;23;Lauantai;0;0;0
95;04.03.2018;2018;03;00;Sunnuntai;0;0;0
95;04.03.2018;2018;03;01;Sunnuntai;0;1;1
95;04.03.2018;2018;03;02;Sunnuntai;1;0;1
95;04.03.2018;2018;03;03;Sunnuntai;0;0;0
95;04.03.2018;2018;03;04;Sunnuntai;0;0;0
95;04.03.2018;2018;03;05;Sunnuntai;0;0;0
95;04.03.2018;2018;03;06;Sunnuntai;2;0;2
95;04.03.2018;2018;03;07;Sunnuntai;0;0;0
95;04.03.2018;2018;03;08;Sunnuntai;0;0;0
95;04.03.2018;2018;03;09;Sunnuntai;0;0;0
95;04.03.2018;2018;03;10;Sunnuntai;1;2;3
95;04.03.2018;2018;03;11;Sunnuntai;2;4;6
95;04.03.2018;2018;03;12;Sunnuntai;3;1;4
95;04.03.2018;2018;03;13;Sunnuntai;1;0;1
95;04.03.2018;2018;03;14;Sunnuntai;4;3;7
95;04.03.2018;2018;03;15;Sunnuntai;2;2;4
95;04.03.2018;2018;03;16;Sunnuntai;3;3;6
95;04.03.2018;2018;03;17;Sunnuntai;1;1;2
95;04.03.2018;2018;03;18;Sunnuntai;3;0;3
95;04.03.2018;2018;03;19;Sunnuntai;0;0;0
95;04.03.2018;2018;03;20;Sunnuntai;0;1;1
95;04.03.2018;2018;03;21;Sunnuntai;1;1;2
95;04.03.2018;2018;03;22;Sunnuntai;0;0;0
95;04.03.2018;2018;03;23;Sunnuntai;0;1;1
95;05.03.2018;2018;03;00;Maanantai;0;0;0
95;05.03.2018;2018;03;01;Maanantai;0;0;0
95;05.03.2018;2018;03;02;Maanantai;0;0;0
95;05.03.2018;2018;03;03;Maanantai;0;1;1
95;05.03.2018;2018;03;04;Maanantai;1;0;1
95;05.03.2018;2018;03;05;Maanantai;2;2;4
95;05.03.2018;2018;03;06;Maanantai;3;0;3
95;05.03.2018;2018;03;07;Maanantai;5;2;7
95;05.03.2018;2018;03;08;Maanantai;1;1;2
95;05.03.2018;2018;03;09;Maanantai;1;0;1
95;05.03.2018;2018;03;10;Maanantai;0;0;0
95;05.03.2018;2018;03;11;Maanantai;2;1;3
95;05.03.2018;2018;03;12;Maanantai;0;3;3
95;05.03.2018;2018;03;13;Maanantai;1;2;3
95;05.03.2018;2018;03;14;Maanantai;2;4;6
95;05.03.2018;2018;03;15;Maanantai;4;4;8
95;05.03.2018;2018;03;16;Maanantai;1;3;4
95;05.03.2018;2018;03;17;Maanantai;3;4;7
95;05.03.2018;2018;03;18;Maanantai;0;3;3
95;05.03.2018;2018;03;19;Maanantai;1;0;1
95;05.03.2018;2018;03;20;Maanantai;0;0;0
95;05.03.2018;2018;03;21;Maanantai;0;0;0
95;05.03.2018;2018;03;22;Maanantai;0;0;0
95;05.03.2018;2018;03;23;Maanantai;0;0;0
95;06.03.2018;2018;03;00;Tiistai;0;0;0
95;06.03.2018;2018;03;01;Tiistai;0;0;0
95;06.03.2018;2018;03;02;Tiistai;0;0;0
95;06.03.2018;2018;03;03;Tiistai;0;0;0
95;06.03.2018;2018;03;04;Tiistai;0;0;0
95;06.03.2018;2018;03;05;Tiistai;2;2;4
95;06.03.2018;2018;03;06;Tiistai;6;0;6
95;06.03.2018;2018;03;07;Tiistai;1;3;4
95;06.03.2018;2018;03;08;Tiistai;1;1;2
95;06.03.2018;2018;03;09;Tiistai;1;1;2
95;06.03.2018;2018;03;10;Tiistai;0;1;1
95;06.03.2018;2018;03;11;Tiistai;1;0;1
95;06.03.2018;2018;03;12;Tiistai;3;0;3
95;06.03.2018;2018;03;13;Tiistai;5;2;7
95;06.03.2018;2018;03;14;Tiistai;2;2;4
95;06.03.2018;2018;03;15;Tiistai;3;3;6
95;06.03.2018;2018;03;16;Tiistai;2;2;4
95;06.03.2018;2018;03;17;Tiistai;1;3;4
95;06.03.2018;2018;03;18;Tiistai;2;0;2
95;06.03.2018;2018;03;19;Tiistai;0;0;0
95;06.03.2018;2018;03;20;Tiistai;0;0;0
95;06.03.2018;2018;03;21;Tiistai;1;0;1
95;06.03.2018;2018;03;22;Tiistai;0;0;0
95;06.03.2018;2018;03;23;Tiistai;0;0;0
95;07.03.2018;2018;03;00;Keskiviikko;0;0;0
95;07.03.2018;2018;03;01;Keskiviikko;0;0;0
95;07.03.2018;2018;03;02;Keskiviikko;0;1;1
95;07.03.2018;2018;03;03;Keskiviikko;0;0;0
95;07.03.2018;2018;03;04;Keskiviikko;1;0;1
95;07.03.2018;2018;03;05;Keskiviikko;4;2;6
95;07.03.2018;2018;03;06;Keskiviikko;7;1;8
95;07.03.2018;2018;03;07;Keskiviikko;2;2;4
95;07.03.2018;2018;03;08;Keskiviikko;0;2;2
95;07.03.2018;2018;03;09;Keskiviikko;0;0;0
95;07.03.2018;2018;03;10;Keskiviikko;0;1;1
95;07.03.2018;2018;03;11;Keskiviikko;2;0;2
95;07.03.2018;2018;03;12;Keskiviikko;4;3;7
95;07.03.2018;2018;03;13;Keskiviikko;1;1;2
95;07.03.2018;2018;03;14;Keskiviikko;1;1;2
95;07.03.2018;2018;03;15;Keskiviikko;5;6;11
95;07.03.2018;2018;03;16;Keskiviikko;3;1;4
95;07.03.2018;2018;03;17;Keskiviikko;5;4;9
95;07.03.2018;2018;03;18;Keskiviikko;0;2;2
95;07.03.2018;2018;03;19;Keskiviikko;1;0;1
95;07.03.2018;2018;03;20;Keskiviikko;0;0;0
95;07.03.2018;2018;03;21;Keskiviikko;3;0;3
95;07.03.2018;2018;03;22;Keskiviikko;0;1;1
95;07.03.2018;2018;03;23;Keskiviikko;0;0;0
95;08.03.2018;2018;03;00;Torstai;0;0;0
95;08.03.2018;2018;03;01;Torstai;0;0;0
95;08.03.2018;2018;03;02;Torstai;0;0;0
95;08.03.2018;2018;03;03;Torstai;0;0;0
95;08.03.2018;2018;03;04;Torstai;0;0;0
95;08.03.2018;2018;03;05;Torstai;3;3;6
95;08.03.2018;2018;03;06;Torstai;4;0;4
95;08.03.2018;2018;03;07;Torstai;5;2;7
95;08.03.2018;2018;03;08;Torstai;2;0;2
95;08.03.2018;2018;03;09;Torstai;0;1;1
95;08.03.2018;2018;03;10;Torstai;3;2;5
95;08.03.2018;2018;03;11;Torstai;2;0;2
95;08.03.2018;2018;03;12;Torstai;2;2;4
95;08.03.2018;2018;03;13;Torstai;1;4;5
95;08.03.2018;2018;03;14;Torstai;4;0;4
95;08.03.2018;2018;03;15;Torstai;6;4;10
95;08.03.2018;2018;03;16;Torstai;4;4;8
95;08.03.2018;2018;03;17;Torstai;2;2;4
95;08.03.2018;2018;03;18;Torstai;5;2;7
95;08.03.2018;2018;03;19;Torstai;1;0;1
95;08.03.2018;2018;03;20;Torstai;0;0;0
95;08.03.2018;2018;03;21;Torstai;1;0;1
95;08.03.2018;2018;03;22;Torstai;0;0;0
95;08.03.2018;2018;03;23;Torstai;0;0;0
95;09.03.2018;2018;03;00;Perjantai;0;0;0
95;09.03.2018;2018;03;01;Perjantai;0;0;0
95;09.03.2018;2018;03;02;Perjantai;0;0;0
95;09.03.2018;2018;03;03;Perjantai;0;0;0
95;09.03.2018;2018;03;04;Perjantai;0;0;0
95;09.03.2018;2018;03;05;Perjantai;5;2;7
95;09.03.2018;2018;03;06;Perjantai;2;1;3
95;09.03.2018;2018;03;07;Perjantai;5;2;7
95;09.03.2018;2018;03;08;Perjantai;4;0;4
95;09.03.2018;2018;03;09;Perjantai;1;1;2
95;09.03.2018;2018;03;10;Perjantai;1;1;2
95;09.03.2018;2018;03;11;Perjantai;2;0;2
95;09.03.2018;2018;03;12;Perjantai;2;2;4
95;09.03.2018;2018;03;13;Perjantai;4;1;5
95;09.03.2018;2018;03;14;Perjantai;5;2;7
95;09.03.2018;2018;03;15;Perjantai;8;2;10
95;09.03.2018;2018;03;16;Perjantai;3;5;8
95;09.03.2018;2018;03;17;Perjantai;3;1;4
95;09.03.2018;2018;03;18;Perjantai;0;1;1
95;09.03.2018;2018;03;19;Perjantai;2;0;2
95;09.03.2018;2018;03;20;Perjantai;0;2;2
95;09.03.2018;2018;03;21;Perjantai;1;0;1
95;09.03.2018;2018;03;22;Perjantai;0;0;0
95;09.03.2018;2018;03;23;Perjantai;0;0;0
95;10.03.2018;2018;03;00;Lauantai;0;0;0
95;10.03.2018;2018;03;01;Lauantai;0;0;0
95;10.03.2018;2018;03;02;Lauantai;0;1;1
95;10.03.2018;2018;03;03;Lauantai;0;0;0
95;10.03.2018;2018;03;04;Lauantai;1;0;1
95;10.03.2018;2018;03;05;Lauantai;1;1;2
95;10.03.2018;2018;03;06;Lauantai;0;0;0
95;10.03.2018;2018;03;07;Lauantai;1;0;1
95;10.03.2018;2018;03;08;Lauantai;0;0;0
95;10.03.2018;2018;03;09;Lauantai;1;0;1
95;10.03.2018;2018;03;10;Lauantai;0;3;3
95;10.03.2018;2018;03;11;Lauantai;0;3;3
95;10.03.2018;2018;03;12;Lauantai;2;1;3
95;10.03.2018;2018;03;13;Lauantai;2;1;3
95;10.03.2018;2018;03;14;Lauantai;1;2;3
95;10.03.2018;2018;03;15;Lauantai;2;2;4
95;10.03.2018;2018;03;16;Lauantai;3;2;5
95;10.03.2018;2018;03;17;Lauantai;1;1;2
95;10.03.2018;2018;03;18;Lauantai;0;0;0
95;10.03.2018;2018;03;19;Lauantai;2;1;3
95;10.03.2018;2018;03;20;Lauantai;0;1;1
95;10.03.2018;2018;03;21;Lauantai;0;1;1
95;10.03.2018;2018;03;22;Lauantai;1;0;1
95;10.03.2018;2018;03;23;Lauantai;0;0;0
95;11.03.2018;2018;03;00;Sunnuntai;0;0;0
95;11.03.2018;2018;03;01;Sunnuntai;0;0;0
95;11.03.2018;2018;03;02;Sunnuntai;0;0;0
95;11.03.2018;2018;03;03;Sunnuntai;0;0;0
95;11.03.2018;2018;03;04;Sunnuntai;0;0;0
95;11.03.2018;2018;03;05;Sunnuntai;0;0;0
95;11.03.2018;2018;03;06;Sunnuntai;0;0;0
95;11.03.2018;2018;03;07;Sunnuntai;0;1;1
95;11.03.2018;2018;03;08;Sunnuntai;2;0;2
95;11.03.2018;2018;03;09;Sunnuntai;0;1;1
95;11.03.2018;2018;03;10;Sunnuntai;1;0;1
95;11.03.2018;2018;03;11;Sunnuntai;1;0;1
95;11.03.2018;2018;03;12;Sunnuntai;1;0;1
95;11.03.2018;2018;03;13;Sunnuntai;0;0;0
95;11.03.2018;2018;03;14;Sunnuntai;1;0;1
95;11.03.2018;2018;03;15;Sunnuntai;0;0;0
95;11.03.2018;2018;03;16;Sunnuntai;0;0;0
95;11.03.2018;2018;03;17;Sunnuntai;0;1;1
95;11.03.2018;2018;03;18;Sunnuntai;2;0;2
95;11.03.2018;2018;03;19;Sunnuntai;1;0;1
95;11.03.2018;2018;03;20;Sunnuntai;0;0;0
95;11.03.2018;2018;03;21;Sunnuntai;0;0;0
95;11.03.2018;2018;03;22;Sunnuntai;0;0;0
95;11.03.2018;2018;03;23;Sunnuntai;1;0;1
95;12.03.2018;2018;03;00;Maanantai;1;0;1
95;12.03.2018;2018;03;01;Maanantai;0;0;0
95;12.03.2018;2018;03;02;Maanantai;0;0;0
95;12.03.2018;2018;03;03;Maanantai;0;0;0
95;12.03.2018;2018;03;04;Maanantai;0;0;0
95;12.03.2018;2018;03;05;Maanantai;5;0;5
95;12.03.2018;2018;03;06;Maanantai;3;0;3
95;12.03.2018;2018;03;07;Maanantai;4;0;4
95;12.03.2018;2018;03;08;Maanantai;2;0;2
95;12.03.2018;2018;03;09;Maanantai;2;0;2
95;12.03.2018;2018;03;10;Maanantai;1;0;1
95;12.03.2018;2018;03;11;Maanantai;2;0;2
95;12.03.2018;2018;03;12;Maanantai;1;0;1
95;12.03.2018;2018;03;13;Maanantai;4;4;8
95;12.03.2018;2018;03;14;Maanantai;5;1;6
95;12.03.2018;2018;03;15;Maanantai;11;3;14
95;12.03.2018;2018;03;16;Maanantai;11;1;12
95;12.03.2018;2018;03;17;Maanantai;8;1;9
95;12.03.2018;2018;03;18;Maanantai;3;2;5
95;12.03.2018;2018;03;19;Maanantai;0;0;0
95;12.03.2018;2018;03;20;Maanantai;1;1;2
95;12.03.2018;2018;03;21;Maanantai;3;1;4
95;12.03.2018;2018;03;22;Maanantai;2;0;2
95;12.03.2018;2018;03;23;Maanantai;0;0;0
95;13.03.2018;2018;03;00;Tiistai;0;1;1
95;13.03.2018;2018;03;01;Tiistai;0;0;0
95;13.03.2018;2018;03;02;Tiistai;1;0;1
95;13.03.2018;2018;03;03;Tiistai;0;0;0
95;13.03.2018;2018;03;04;Tiistai;1;0;1
95;13.03.2018;2018;03;05;Tiistai;5;2;7
95;13.03.2018;2018;03;06;Tiistai;6;1;7
95;13.03.2018;2018;03;07;Tiistai;11;4;15
95;13.03.2018;2018;03;08;Tiistai;3;5;8
95;13.03.2018;2018;03;09;Tiistai;5;0;5
95;13.03.2018;2018;03;10;Tiistai;1;0;1
95;13.03.2018;2018;03;11;Tiistai;2;2;4
95;13.03.2018;2018;03;12;Tiistai;0;1;1
95;13.03.2018;2018;03;13;Tiistai;3;1;4
95;13.03.2018;2018;03;14;Tiistai;6;3;9
95;13.03.2018;2018;03;15;Tiistai;15;1;16
95;13.03.2018;2018;03;16;Tiistai;6;1;7
95;13.03.2018;2018;03;17;Tiistai;6;2;8
95;13.03.2018;2018;03;18;Tiistai;5;0;5
95;13.03.2018;2018;03;19;Tiistai;0;1;1
95;13.03.2018;2018;03;20;Tiistai;1;1;2
95;13.03.2018;2018;03;21;Tiistai;1;1;2
95;13.03.2018;2018;03;22;Tiistai;1;0;1
95;13.03.2018;2018;03;23;Tiistai;0;0;0
95;14.03.2018;2018;03;00;Keskiviikko;1;0;1
95;14.03.2018;2018;03;01;Keskiviikko;0;0;0
95;14.03.2018;2018;03;02;Keskiviikko;0;0;0
95;14.03.2018;2018;03;03;Keskiviikko;0;0;0
95;14.03.2018;2018;03;04;Keskiviikko;0;0;0
95;14.03.2018;2018;03;05;Keskiviikko;5;1;6
95;14.03.2018;2018;03;06;Keskiviikko;5;2;7
95;14.03.2018;2018;03;07;Keskiviikko;8;2;10
95;14.03.2018;2018;03;08;Keskiviikko;3;0;3
95;14.03.2018;2018;03;09;Keskiviikko;6;1;7
95;14.03.2018;2018;03;10;Keskiviikko;0;0;0
95;14.03.2018;2018;03;11;Keskiviikko;1;0;1
95;14.03.2018;2018;03;12;Keskiviikko;1;1;2
95;14.03.2018;2018;03;13;Keskiviikko;3;3;6
95;14.03.2018;2018;03;14;Keskiviikko;5;1;6
95;14.03.2018;2018;03;15;Keskiviikko;8;0;8
95;14.03.2018;2018;03;16;Keskiviikko;11;0;11
95;14.03.2018;2018;03;17;Keskiviikko;7;1;8
95;14.03.2018;2018;03;18;Keskiviikko;3;1;4
95;14.03.2018;2018;03;19;Keskiviikko;2;0;2
95;14.03.2018;2018;03;20;Keskiviikko;1;1;2
95;14.03.2018;2018;03;21;Keskiviikko;0;0;0
95;14.03.2018;2018;03;22;Keskiviikko;2;0;2
95;14.03.2018;2018;03;23;Keskiviikko;0;0;0
95;15.03.2018;2018;03;00;Torstai;0;0;0
95;15.03.2018;2018;03;01;Torstai;0;0;0
95;15.03.2018;2018;03;02;Torstai;0;0;0
95;15.03.2018;2018;03;03;Torstai;0;0;0
95;15.03.2018;2018;03;04;Torstai;2;0;2
95;15.03.2018;2018;03;05;Torstai;2;0;2
95;15.03.2018;2018;03;06;Torstai;2;2;4
95;15.03.2018;2018;03;07;Torstai;6;1;7
95;15.03.2018;2018;03;08;Torstai;2;1;3
95;15.03.2018;2018;03;09;Torstai;7;1;8
95;15.03.2018;2018;03;10;Torstai;1;0;1
95;15.03.2018;2018;03;11;Torstai;1;1;2
95;15.03.2018;2018;03;12;Torstai;1;1;2
95;15.03.2018;2018;03;13;Torstai;1;0;1
95;15.03.2018;2018;03;14;Torstai;3;0;3
95;15.03.2018;2018;03;15;Torstai;6;2;8
95;15.03.2018;2018;03;16;Torstai;15;1;16
95;15.03.2018;2018;03;17;Torstai;1;1;2
95;15.03.2018;2018;03;18;Torstai;2;0;2
95;15.03.2018;2018;03;19;Torstai;1;0;1
95;15.03.2018;2018;03;20;Torstai;1;0;1
95;15.03.2018;2018;03;21;Torstai;0;1;1
95;15.03.2018;2018;03;22;Torstai;1;0;1
95;15.03.2018;2018;03;23;Torstai;0;0;0
95;16.03.2018;2018;03;00;Perjantai;1;0;1
95;16.03.2018;2018;03;01;Perjantai;0;0;0
95;16.03.2018;2018;03;02;Perjantai;0;0;0
95;16.03.2018;2018;03;03;Perjantai;0;0;0
95;16.03.2018;2018;03;04;Perjantai;3;0;3
95;16.03.2018;2018;03;05;Perjantai;3;0;3
95;16.03.2018;2018;03;06;Perjantai;1;1;2
95;16.03.2018;2018;03;07;Perjantai;6;2;8
95;16.03.2018;2018;03;08;Perjantai;2;1;3
95;16.03.2018;2018;03;09;Perjantai;1;0;1
95;16.03.2018;2018;03;10;Perjantai;2;0;2
95;16.03.2018;2018;03;11;Perjantai;0;0;0
95;16.03.2018;2018;03;12;Perjantai;0;0;0
95;16.03.2018;2018;03;13;Perjantai;7;1;8
95;16.03.2018;2018;03;14;Perjantai;7;0;7
95;16.03.2018;2018;03;15;Perjantai;11;2;13
95;16.03.2018;2018;03;16;Perjantai;3;0;3
95;16.03.2018;2018;03;17;Perjantai;4;0;4
95;16.03.2018;2018;03;18;Perjantai;0;0;0
95;16.03.2018;2018;03;19;Perjantai;1;1;2
95;16.03.2018;2018;03;20;Perjantai;1;0;1
95;16.03.2018;2018;03;21;Perjantai;0;0;0
95;16.03.2018;2018;03;22;Perjantai;1;0;1
95;16.03.2018;2018;03;23;Perjantai;0;0;0
95;17.03.2018;2018;03;00;Lauantai;0;0;0
95;17.03.2018;2018;03;01;Lauantai;0;0;0
95;17.03.2018;2018;03;02;Lauantai;0;0;0
95;17.03.2018;2018;03;03;Lauantai;0;0;0
95;17.03.2018;2018;03;04;Lauantai;1;0;1
95;17.03.2018;2018;03;05;Lauantai;0;0;0
95;17.03.2018;2018;03;06;Lauantai;0;0;0
95;17.03.2018;2018;03;07;Lauantai;0;0;0
95;17.03.2018;2018;03;08;Lauantai;0;0;0
95;17.03.2018;2018;03;09;Lauantai;3;0;3
95;17.03.2018;2018;03;10;Lauantai;0;0;0
95;17.03.2018;2018;03;11;Lauantai;3;2;5
95;17.03.2018;2018;03;12;Lauantai;2;1;3
95;17.03.2018;2018;03;13;Lauantai;1;1;2
95;17.03.2018;2018;03;14;Lauantai;4;1;5
95;17.03.2018;2018;03;15;Lauantai;0;1;1
95;17.03.2018;2018;03;16;Lauantai;1;0;1
95;17.03.2018;2018;03;17;Lauantai;0;0;0
95;17.03.2018;2018;03;18;Lauantai;2;0;2
95;17.03.2018;2018;03;19;Lauantai;1;0;1
95;17.03.2018;2018;03;20;Lauantai;1;0;1
95;17.03.2018;2018;03;21;Lauantai;1;0;1
95;17.03.2018;2018;03;22;Lauantai;1;0;1
95;17.03.2018;2018;03;23;Lauantai;0;0;0
95;18.03.2018;2018;03;00;Sunnuntai;0;0;0
95;18.03.2018;2018;03;01;Sunnuntai;0;0;0
95;18.03.2018;2018;03;02;Sunnuntai;0;0;0
95;18.03.2018;2018;03;03;Sunnuntai;0;0;0
95;18.03.2018;2018;03;04;Sunnuntai;0;0;0
95;18.03.2018;2018;03;05;Sunnuntai;0;0;0
95;18.03.2018;2018;03;06;Sunnuntai;0;0;0
95;18.03.2018;2018;03;07;Sunnuntai;1;0;1
95;18.03.2018;2018;03;08;Sunnuntai;0;0;0
95;18.03.2018;2018;03;09;Sunnuntai;1;0;1
95;18.03.2018;2018;03;10;Sunnuntai;2;0;2
95;18.03.2018;2018;03;11;Sunnuntai;1;0;1
95;18.03.2018;2018;03;12;Sunnuntai;5;3;8
95;18.03.2018;2018;03;13;Sunnuntai;0;1;1
95;18.03.2018;2018;03;14;Sunnuntai;2;1;3
95;18.03.2018;2018;03;15;Sunnuntai;0;1;1
95;18.03.2018;2018;03;16;Sunnuntai;6;0;6
95;18.03.2018;2018;03;17;Sunnuntai;3;0;3
95;18.03.2018;2018;03;18;Sunnuntai;3;0;3
95;18.03.2018;2018;03;19;Sunnuntai;2;0;2
95;18.03.2018;2018;03;20;Sunnuntai;1;0;1
95;18.03.2018;2018;03;21;Sunnuntai;1;1;2
95;18.03.2018;2018;03;22;Sunnuntai;2;0;2
95;18.03.2018;2018;03;23;Sunnuntai;0;0;0
95;19.03.2018;2018;03;00;Maanantai;0;0;0
95;19.03.2018;2018;03;01;Maanantai;0;0;0
95;19.03.2018;2018;03;02;Maanantai;0;0;0
95;19.03.2018;2018;03;03;Maanantai;0;0;0
95;19.03.2018;2018;03;04;Maanantai;1;0;1
95;19.03.2018;2018;03;05;Maanantai;3;0;3
95;19.03.2018;2018;03;06;Maanantai;3;0;3
95;19.03.2018;2018;03;07;Maanantai;8;3;11
95;19.03.2018;2018;03;08;Maanantai;6;1;7
95;19.03.2018;2018;03;09;Maanantai;5;2;7
95;19.03.2018;2018;03;10;Maanantai;4;1;5
95;19.03.2018;2018;03;11;Maanantai;4;0;4
95;19.03.2018;2018;03;12;Maanantai;2;0;2
95;19.03.2018;2018;03;13;Maanantai;6;1;7
95;19.03.2018;2018;03;14;Maanantai;11;8;19
95;19.03.2018;2018;03;15;Maanantai;9;3;12
95;19.03.2018;2018;03;16;Maanantai;16;2;18
95;19.03.2018;2018;03;17;Maanantai;7;6;13
95;19.03.2018;2018;03;18;Maanantai;5;2;7
95;19.03.2018;2018;03;19;Maanantai;0;1;1
95;19.03.2018;2018;03;20;Maanantai;1;1;2
95;19.03.2018;2018;03;21;Maanantai;3;2;5
95;19.03.2018;2018;03;22;Maanantai;0;0;0
95;19.03.2018;2018;03;23;Maanantai;0;0;0
95;20.03.2018;2018;03;00;Tiistai;0;1;1
95;20.03.2018;2018;03;01;Tiistai;0;0;0
95;20.03.2018;2018;03;02;Tiistai;0;0;0
95;20.03.2018;2018;03;03;Tiistai;0;0;0
95;20.03.2018;2018;03;04;Tiistai;1;0;1
95;20.03.2018;2018;03;05;Tiistai;3;2;5
95;20.03.2018;2018;03;06;Tiistai;6;3;9
95;20.03.2018;2018;03;07;Tiistai;8;6;14
95;20.03.2018;2018;03;08;Tiistai;2;9;11
95;20.03.2018;2018;03;09;Tiistai;4;3;7
95;20.03.2018;2018;03;10;Tiistai;0;1;1
95;20.03.2018;2018;03;11;Tiistai;2;1;3
95;20.03.2018;2018;03;12;Tiistai;2;1;3
95;20.03.2018;2018;03;13;Tiistai;6;0;6
95;20.03.2018;2018;03;14;Tiistai;12;7;19
95;20.03.2018;2018;03;15;Tiistai;13;0;13
95;20.03.2018;2018;03;16;Tiistai;7;7;14
95;20.03.2018;2018;03;17;Tiistai;6;2;8
95;20.03.2018;2018;03;18;Tiistai;7;2;9
95;20.03.2018;2018;03;19;Tiistai;2;0;2
95;20.03.2018;2018;03;20;Tiistai;0;0;0
95;20.03.2018;2018;03;21;Tiistai;0;0;0
95;20.03.2018;2018;03;22;Tiistai;0;0;0
95;20.03.2018;2018;03;23;Tiistai;1;0;1
95;21.03.2018;2018;03;00;Keskiviikko;0;0;0
95;21.03.2018;2018;03;01;Keskiviikko;0;0;0
95;21.03.2018;2018;03;02;Keskiviikko;0;0;0
95;21.03.2018;2018;03;03;Keskiviikko;0;0;0
95;21.03.2018;2018;03;04;Keskiviikko;0;0;0
95;21.03.2018;2018;03;05;Keskiviikko;4;1;5
95;21.03.2018;2018;03;06;Keskiviikko;7;3;10
95;21.03.2018;2018;03;07;Keskiviikko;5;2;7
95;21.03.2018;2018;03;08;Keskiviikko;3;2;5
95;21.03.2018;2018;03;09;Keskiviikko;3;1;4
95;21.03.2018;2018;03;10;Keskiviikko;1;1;2
95;21.03.2018;2018;03;11;Keskiviikko;1;1;2
95;21.03.2018;2018;03;12;Keskiviikko;1;0;1
95;21.03.2018;2018;03;13;Keskiviikko;8;1;9
95;21.03.2018;2018;03;14;Keskiviikko;2;3;5
95;21.03.2018;2018;03;15;Keskiviikko;12;4;16
95;21.03.2018;2018;03;16;Keskiviikko;10;4;14
95;21.03.2018;2018;03;17;Keskiviikko;9;0;9
95;21.03.2018;2018;03;18;Keskiviikko;0;1;1
95;21.03.2018;2018;03;19;Keskiviikko;0;0;0
95;21.03.2018;2018;03;20;Keskiviikko;1;0;1
95;21.03.2018;2018;03;21;Keskiviikko;1;1;2
95;21.03.2018;2018;03;22;Keskiviikko;0;0;0
95;21.03.2018;2018;03;23;Keskiviikko;0;0;0
95;22.03.2018;2018;03;00;Torstai;0;0;0
95;22.03.2018;2018;03;01;Torstai;0;0;0
95;22.03.2018;2018;03;02;Torstai;0;0;0
95;22.03.2018;2018;03;03;Torstai;0;0;0
95;22.03.2018;2018;03;04;Torstai;0;0;0
95;22.03.2018;2018;03;05;Torstai;5;4;9
95;22.03.2018;2018;03;06;Torstai;8;4;12
95;22.03.2018;2018;03;07;Torstai;13;9;22
95;22.03.2018;2018;03;08;Torstai;4;3;7
95;22.03.2018;2018;03;09;Torstai;6;5;11
95;22.03.2018;2018;03;10;Torstai;3;2;5
95;22.03.2018;2018;03;11;Torstai;1;3;4
95;22.03.2018;2018;03;12;Torstai;2;3;5
95;22.03.2018;2018;03;13;Torstai;5;2;7
95;22.03.2018;2018;03;14;Torstai;7;4;11
95;22.03.2018;2018;03;15;Torstai;12;9;21
95;22.03.2018;2018;03;16;Torstai;12;4;16
95;22.03.2018;2018;03;17;Torstai;3;7;10
95;22.03.2018;2018;03;18;Torstai;1;0;1
95;22.03.2018;2018;03;19;Torstai;3;2;5
95;22.03.2018;2018;03;20;Torstai;0;0;0
95;22.03.2018;2018;03;21;Torstai;3;0;3
95;22.03.2018;2018;03;22;Torstai;0;1;1
95;22.03.2018;2018;03;23;Torstai;0;0;0
95;23.03.2018;2018;03;00;Perjantai;0;1;1
95;23.03.2018;2018;03;01;Perjantai;0;0;0
95;23.03.2018;2018;03;02;Perjantai;0;0;0
95;23.03.2018;2018;03;03;Perjantai;0;0;0
95;23.03.2018;2018;03;04;Perjantai;0;0;0
95;23.03.2018;2018;03;05;Perjantai;3;3;6
95;23.03.2018;2018;03;06;Perjantai;3;0;3
95;23.03.2018;2018;03;07;Perjantai;11;3;14
95;23.03.2018;2018;03;08;Perjantai;4;3;7
95;23.03.2018;2018;03;09;Perjantai;0;4;4
95;23.03.2018;2018;03;10;Perjantai;1;3;4
95;23.03.2018;2018;03;11;Perjantai;4;2;6
95;23.03.2018;2018;03;12;Perjantai;1;1;2
95;23.03.2018;2018;03;13;Perjantai;8;1;9
95;23.03.2018;2018;03;14;Perjantai;10;8;18
95;23.03.2018;2018;03;15;Perjantai;3;5;8
95;23.03.2018;2018;03;16;Perjantai;6;5;11
95;23.03.2018;2018;03;17;Perjantai;2;3;5
95;23.03.2018;2018;03;18;Perjantai;3;2;5
95;23.03.2018;2018;03;19;Perjantai;3;0;3
95;23.03.2018;2018;03;20;Perjantai;0;1;1
95;23.03.2018;2018;03;21;Perjantai;2;1;3
95;23.03.2018;2018;03;22;Perjantai;0;0;0
95;23.03.2018;2018;03;23;Perjantai;0;0;0
95;24.03.2018;2018;03;00;Lauantai;0;0;0
95;24.03.2018;2018;03;01;Lauantai;0;0;0
95;24.03.2018;2018;03;02;Lauantai;0;0;0
95;24.03.2018;2018;03;03;Lauantai;0;0;0
95;24.03.2018;2018;03;04;Lauantai;1;0;1
95;24.03.2018;2018;03;05;Lauantai;4;1;5
95;24.03.2018;2018;03;06;Lauantai;0;0;0
95;24.03.2018;2018;03;07;Lauantai;0;0;0
95;24.03.2018;2018;03;08;Lauantai;2;1;3
95;24.03.2018;2018;03;09;Lauantai;0;0;0
95;24.03.2018;2018;03;10;Lauantai;0;1;1
95;24.03.2018;2018;03;11;Lauantai;0;4;4
95;24.03.2018;2018;03;12;Lauantai;1;1;2
95;24.03.2018;2018;03;13;Lauantai;1;2;3
95;24.03.2018;2018;03;14;Lauantai;2;1;3
95;24.03.2018;2018;03;15;Lauantai;3;0;3
95;24.03.2018;2018;03;16;Lauantai;0;0;0
95;24.03.2018;2018;03;17;Lauantai;0;0;0
95;24.03.2018;2018;03;18;Lauantai;1;1;2
95;24.03.2018;2018;03;19;Lauantai;0;1;1
95;24.03.2018;2018;03;20;Lauantai;0;0;0
95;24.03.2018;2018;03;21;Lauantai;0;0;0
95;24.03.2018;2018;03;22;Lauantai;1;0;1
95;24.03.2018;2018;03;23;Lauantai;1;0;1
95;25.03.2018;2018;03;00;Sunnuntai;0;0;0
95;25.03.2018;2018;03;01;Sunnuntai;0;0;0
95;25.03.2018;2018;03;02;Sunnuntai;0;0;0
95;25.03.2018;2018;03;03;Sunnuntai;0;0;0
95;25.03.2018;2018;03;04;Sunnuntai;0;0;0
95;25.03.2018;2018;03;05;Sunnuntai;1;0;1
95;25.03.2018;2018;03;06;Sunnuntai;1;0;1
95;25.03.2018;2018;03;07;Sunnuntai;0;0;0
95;25.03.2018;2018;03;08;Sunnuntai;0;0;0
95;25.03.2018;2018;03;09;Sunnuntai;0;1;1
95;25.03.2018;2018;03;10;Sunnuntai;0;0;0
95;25.03.2018;2018;03;11;Sunnuntai;2;0;2
95;25.03.2018;2018;03;12;Sunnuntai;0;3;3
95;25.03.2018;2018;03;13;Sunnuntai;7;0;7
95;25.03.2018;2018;03;14;Sunnuntai;1;2;3
95;25.03.2018;2018;03;15;Sunnuntai;3;2;5
95;25.03.2018;2018;03;16;Sunnuntai;3;3;6
95;25.03.2018;2018;03;17;Sunnuntai;0;1;1
95;25.03.2018;2018;03;18;Sunnuntai;3;3;6
95;25.03.2018;2018;03;19;Sunnuntai;1;0;1
95;25.03.2018;2018;03;20;Sunnuntai;1;0;1
95;25.03.2018;2018;03;21;Sunnuntai;1;1;2
95;25.03.2018;2018;03;22;Sunnuntai;1;1;2
95;25.03.2018;2018;03;23;Sunnuntai;0;0;0
95;26.03.2018;2018;03;00;Maanantai;1;0;1
95;26.03.2018;2018;03;01;Maanantai;0;0;0
95;26.03.2018;2018;03;02;Maanantai;1;0;1
95;26.03.2018;2018;03;03;Maanantai;0;0;0
95;26.03.2018;2018;03;04;Maanantai;0;0;0
95;26.03.2018;2018;03;05;Maanantai;3;1;4
95;26.03.2018;2018;03;06;Maanantai;2;2;4
95;26.03.2018;2018;03;07;Maanantai;5;4;9
95;26.03.2018;2018;03;08;Maanantai;4;1;5
95;26.03.2018;2018;03;09;Maanantai;4;3;7
95;26.03.2018;2018;03;10;Maanantai;2;1;3
95;26.03.2018;2018;03;11;Maanantai;3;2;5
95;26.03.2018;2018;03;12;Maanantai;1;0;1
95;26.03.2018;2018;03;13;Maanantai;6;1;7
95;26.03.2018;2018;03;14;Maanantai;2;1;3
95;26.03.2018;2018;03;15;Maanantai;8;4;12
95;26.03.2018;2018;03;16;Maanantai;11;4;15
95;26.03.2018;2018;03;17;Maanantai;6;5;11
95;26.03.2018;2018;03;18;Maanantai;3;1;4
95;26.03.2018;2018;03;19;Maanantai;2;2;4
95;26.03.2018;2018;03;20;Maanantai;0;3;3
95;26.03.2018;2018;03;21;Maanantai;2;1;3
95;26.03.2018;2018;03;22;Maanantai;1;1;2
95;26.03.2018;2018;03;23;Maanantai;0;0;0
95;27.03.2018;2018;03;00;Tiistai;0;0;0
95;27.03.2018;2018;03;01;Tiistai;0;0;0
95;27.03.2018;2018;03;02;Tiistai;0;0;0
95;27.03.2018;2018;03;03;Tiistai;0;0;0
95;27.03.2018;2018;03;04;Tiistai;0;0;0
95;27.03.2018;2018;03;05;Tiistai;4;1;5
95;27.03.2018;2018;03;06;Tiistai;1;2;3
95;27.03.2018;2018;03;07;Tiistai;11;4;15
95;27.03.2018;2018;03;08;Tiistai;5;0;5
95;27.03.2018;2018;03;09;Tiistai;2;1;3
95;27.03.2018;2018;03;10;Tiistai;0;2;2
95;27.03.2018;2018;03;11;Tiistai;0;2;2
95;27.03.2018;2018;03;12;Tiistai;3;1;4
95;27.03.2018;2018;03;13;Tiistai;5;1;6
95;27.03.2018;2018;03;14;Tiistai;7;1;8
95;27.03.2018;2018;03;15;Tiistai;4;2;6
95;27.03.2018;2018;03;16;Tiistai;11;2;13
95;27.03.2018;2018;03;17;Tiistai;1;0;1
95;27.03.2018;2018;03;18;Tiistai;1;2;3
95;27.03.2018;2018;03;19;Tiistai;2;1;3
95;27.03.2018;2018;03;20;Tiistai;0;0;0
95;27.03.2018;2018;03;21;Tiistai;1;0;1
95;27.03.2018;2018;03;22;Tiistai;1;1;2
95;27.03.2018;2018;03;23;Tiistai;0;0;0
95;28.03.2018;2018;03;00;Keskiviikko;0;0;0
95;28.03.2018;2018;03;01;Keskiviikko;0;0;0
95;28.03.2018;2018;03;02;Keskiviikko;0;0;0
95;28.03.2018;2018;03;03;Keskiviikko;0;0;0
95;28.03.2018;2018;03;04;Keskiviikko;0;0;0
95;28.03.2018;2018;03;05;Keskiviikko;3;0;3
95;28.03.2018;2018;03;06;Keskiviikko;5;2;7
95;28.03.2018;2018;03;07;Keskiviikko;8;7;15
95;28.03.2018;2018;03;08;Keskiviikko;3;5;8
95;28.03.2018;2018;03;09;Keskiviikko;3;2;5
95;28.03.2018;2018;03;10;Keskiviikko;1;3;4
95;28.03.2018;2018;03;11;Keskiviikko;1;1;2
95;28.03.2018;2018;03;12;Keskiviikko;2;1;3
95;28.03.2018;2018;03;13;Keskiviikko;6;4;10
95;28.03.2018;2018;03;14;Keskiviikko;8;10;18
95;28.03.2018;2018;03;15;Keskiviikko;8;6;14
95;28.03.2018;2018;03;16;Keskiviikko;10;6;16
95;28.03.2018;2018;03;17;Keskiviikko;4;9;13
95;28.03.2018;2018;03;18;Keskiviikko;3;3;6
95;28.03.2018;2018;03;19;Keskiviikko;2;4;6
95;28.03.2018;2018;03;20;Keskiviikko;1;0;1
95;28.03.2018;2018;03;21;Keskiviikko;1;1;2
95;28.03.2018;2018;03;22;Keskiviikko;1;0;1
95;28.03.2018;2018;03;23;Keskiviikko;0;0;0
95;29.03.2018;2018;03;00;Torstai;0;0;0
95;29.03.2018;2018;03;01;Torstai;0;0;0
95;29.03.2018;2018;03;02;Torstai;0;0;0
95;29.03.2018;2018;03;03;Torstai;0;0;0
95;29.03.2018;2018;03;04;Torstai;2;0;2
95;29.03.2018;2018;03;05;Torstai;1;1;2
95;29.03.2018;2018;03;06;Torstai;2;2;4
95;29.03.2018;2018;03;07;Torstai;9;7;16
95;29.03.2018;2018;03;08;Torstai;5;5;10
95;29.03.2018;2018;03;09;Torstai;1;0;1
95;29.03.2018;2018;03;10;Torstai;4;3;7
95;29.03.2018;2018;03;11;Torstai;3;2;5
95;29.03.2018;2018;03;12;Torstai;2;1;3
95;29.03.2018;2018;03;13;Torstai;5;1;6
95;29.03.2018;2018;03;14;Torstai;5;12;17
95;29.03.2018;2018;03;15;Torstai;5;9;14
95;29.03.2018;2018;03;16;Torstai;4;6;10
95;29.03.2018;2018;03;17;Torstai;3;5;8
95;29.03.2018;2018;03;18;Torstai;1;2;3
95;29.03.2018;2018;03;19;Torstai;0;2;2
95;29.03.2018;2018;03;20;Torstai;1;1;2
95;29.03.2018;2018;03;21;Torstai;2;0;2
95;29.03.2018;2018;03;22;Torstai;0;0;0
95;29.03.2018;2018;03;23;Torstai;0;0;0
95;30.03.2018;2018;03;00;Perjantai;0;0;0
95;30.03.2018;2018;03;01;Perjantai;0;0;0
95;30.03.2018;2018;03;02;Perjantai;0;0;0
95;30.03.2018;2018;03;03;Perjantai;0;1;1
95;30.03.2018;2018;03;04;Perjantai;2;0;2
95;30.03.2018;2018;03;05;Perjantai;2;0;2
95;30.03.2018;2018;03;06;Perjantai;0;0;0
95;30.03.2018;2018;03;07;Perjantai;2;0;2
95;30.03.2018;2018;03;08;Perjantai;0;0;0
95;30.03.2018;2018;03;09;Perjantai;0;0;0
95;30.03.2018;2018;03;10;Perjantai;0;2;2
95;30.03.2018;2018;03;11;Perjantai;4;1;5
95;30.03.2018;2018;03;12;Perjantai;2;2;4
95;30.03.2018;2018;03;13;Perjantai;1;5;6
95;30.03.2018;2018;03;14;Perjantai;1;4;5
95;30.03.2018;2018;03;15;Perjantai;2;3;5
95;30.03.2018;2018;03;16;Perjantai;1;0;1
95;30.03.2018;2018;03;17;Perjantai;2;1;3
95;30.03.2018;2018;03;18;Perjantai;5;3;8
95;30.03.2018;2018;03;19;Perjantai;0;1;1
95;30.03.2018;2018;03;20;Perjantai;1;1;2
95;30.03.2018;2018;03;21;Perjantai;0;1;1
95;30.03.2018;2018;03;22;Perjantai;0;1;1
95;30.03.2018;2018;03;23;Perjantai;0;0;0
95;31.03.2018;2018;03;00;Lauantai;0;0;0
95;31.03.2018;2018;03;01;Lauantai;0;2;2
95;31.03.2018;2018;03;02;Lauantai;0;0;0
95;31.03.2018;2018;03;03;Lauantai;0;2;2
95;31.03.2018;2018;03;04;Lauantai;0;0;0
95;31.03.2018;2018;03;05;Lauantai;3;0;3
95;31.03.2018;2018;03;06;Lauantai;2;0;2
95;31.03.2018;2018;03;07;Lauantai;1;1;2
95;31.03.2018;2018;03;08;Lauantai;0;0;0
95;31.03.2018;2018;03;09;Lauantai;0;0;0
95;31.03.2018;2018;03;10;Lauantai;5;3;8
95;31.03.2018;2018;03;11;Lauantai;4;1;5
95;31.03.2018;2018;03;12;Lauantai;1;4;5
95;31.03.2018;2018;03;13;Lauantai;3;3;6
95;31.03.2018;2018;03;14;Lauantai;1;4;5
95;31.03.2018;2018;03;15;Lauantai;0;7;7
95;31.03.2018;2018;03;16;Lauantai;0;2;2
95;31.03.2018;2018;03;17;Lauantai;0;2;2
95;31.03.2018;2018;03;18;Lauantai;2;1;3
95;31.03.2018;2018;03;19;Lauantai;2;3;5
95;31.03.2018;2018;03;20;Lauantai;0;0;0
95;31.03.2018;2018;03;21;Lauantai;1;2;3
95;31.03.2018;2018;03;22;Lauantai;2;1;3
95;31.03.2018;2018;03;23;Lauantai;0;0;0
95;01.04.2018;2018;04;00;Sunnuntai;1;0;1
95;01.04.2018;2018;04;01;Sunnuntai;0;0;0
95;01.04.2018;2018;04;02;Sunnuntai;0;0;0
95;01.04.2018;2018;04;03;Sunnuntai;0;0;0
95;01.04.2018;2018;04;04;Sunnuntai;0;1;1
95;01.04.2018;2018;04;05;Sunnuntai;0;0;0
95;01.04.2018;2018;04;06;Sunnuntai;0;0;0
95;01.04.2018;2018;04;07;Sunnuntai;1;0;1
95;01.04.2018;2018;04;08;Sunnuntai;0;1;1
95;01.04.2018;2018;04;09;Sunnuntai;0;1;1
95;01.04.2018;2018;04;10;Sunnuntai;5;3;8
95;01.04.2018;2018;04;11;Sunnuntai;2;1;3
95;01.04.2018;2018;04;12;Sunnuntai;1;5;6
95;01.04.2018;2018;04;13;Sunnuntai;5;3;8
95;01.04.2018;2018;04;14;Sunnuntai;3;3;6
95;01.04.2018;2018;04;15;Sunnuntai;7;2;9
95;01.04.2018;2018;04;16;Sunnuntai;2;1;3
95;01.04.2018;2018;04;17;Sunnuntai;1;1;2
95;01.04.2018;2018;04;18;Sunnuntai;3;2;5
95;01.04.2018;2018;04;19;Sunnuntai;3;0;3
95;01.04.2018;2018;04;20;Sunnuntai;0;0;0
95;01.04.2018;2018;04;21;Sunnuntai;1;1;2
95;01.04.2018;2018;04;22;Sunnuntai;3;0;3
95;01.04.2018;2018;04;23;Sunnuntai;0;0;0
95;02.04.2018;2018;04;00;Maanantai;0;0;0
95;02.04.2018;2018;04;01;Maanantai;0;0;0
95;02.04.2018;2018;04;02;Maanantai;0;1;1
95;02.04.2018;2018;04;03;Maanantai;0;0;0
95;02.04.2018;2018;04;04;Maanantai;0;0;0
95;02.04.2018;2018;04;05;Maanantai;0;0;0
95;02.04.2018;2018;04;06;Maanantai;0;0;0
95;02.04.2018;2018;04;07;Maanantai;1;0;1
95;02.04.2018;2018;04;08;Maanantai;0;0;0
95;02.04.2018;2018;04;09;Maanantai;0;2;2
95;02.04.2018;2018;04;10;Maanantai;1;1;2
95;02.04.2018;2018;04;11;Maanantai;2;2;4
95;02.04.2018;2018;04;12;Maanantai;1;0;1
95;02.04.2018;2018;04;13;Maanantai;3;0;3
95;02.04.2018;2018;04;14;Maanantai;4;1;5
95;02.04.2018;2018;04;15;Maanantai;0;2;2
95;02.04.2018;2018;04;16;Maanantai;0;3;3
95;02.04.2018;2018;04;17;Maanantai;0;1;1
95;02.04.2018;2018;04;18;Maanantai;3;1;4
95;02.04.2018;2018;04;19;Maanantai;0;2;2
95;02.04.2018;2018;04;20;Maanantai;3;0;3
95;02.04.2018;2018;04;21;Maanantai;2;0;2
95;02.04.2018;2018;04;22;Maanantai;0;0;0
95;02.04.2018;2018;04;23;Maanantai;0;0;0
95;03.04.2018;2018;04;00;Tiistai;0;0;0
95;03.04.2018;2018;04;01;Tiistai;0;0;0
95;03.04.2018;2018;04;02;Tiistai;0;0;0
95;03.04.2018;2018;04;03;Tiistai;0;0;0
95;03.04.2018;2018;04;04;Tiistai;0;0;0
95;03.04.2018;2018;04;05;Tiistai;1;3;4
95;03.04.2018;2018;04;06;Tiistai;4;1;5
95;03.04.2018;2018;04;07;Tiistai;6;5;11
95;03.04.2018;2018;04;08;Tiistai;2;3;5
95;03.04.2018;2018;04;09;Tiistai;2;0;2
95;03.04.2018;2018;04;10;Tiistai;5;0;5
95;03.04.2018;2018;04;11;Tiistai;3;0;3
95;03.04.2018;2018;04;12;Tiistai;3;0;3
95;03.04.2018;2018;04;13;Tiistai;0;2;2
95;03.04.2018;2018;04;14;Tiistai;5;3;8
95;03.04.2018;2018;04;15;Tiistai;7;3;10
95;03.04.2018;2018;04;16;Tiistai;4;4;8
95;03.04.2018;2018;04;17;Tiistai;3;5;8
95;03.04.2018;2018;04;18;Tiistai;1;4;5
95;03.04.2018;2018;04;19;Tiistai;0;1;1
95;03.04.2018;2018;04;20;Tiistai;0;1;1
95;03.04.2018;2018;04;21;Tiistai;1;0;1
95;03.04.2018;2018;04;22;Tiistai;0;0;0
95;03.04.2018;2018;04;23;Tiistai;0;0;0
95;04.04.2018;2018;04;00;Keskiviikko;0;0;0
95;04.04.2018;2018;04;01;Keskiviikko;0;0;0
95;04.04.2018;2018;04;02;Keskiviikko;0;0;0
95;04.04.2018;2018;04;03;Keskiviikko;0;0;0
95;04.04.2018;2018;04;04;Keskiviikko;0;0;0
95;04.04.2018;2018;04;05;Keskiviikko;3;4;7
95;04.04.2018;2018;04;06;Keskiviikko;4;4;8
95;04.04.2018;2018;04;07;Keskiviikko;5;8;13
95;04.04.2018;2018;04;08;Keskiviikko;2;7;9
95;04.04.2018;2018;04;09;Keskiviikko;4;0;4
95;04.04.2018;2018;04;10;Keskiviikko;5;3;8
95;04.04.2018;2018;04;11;Keskiviikko;6;5;11
95;04.04.2018;2018;04;12;Keskiviikko;1;2;3
95;04.04.2018;2018;04;13;Keskiviikko;6;2;8
95;04.04.2018;2018;04;14;Keskiviikko;7;3;10
95;04.04.2018;2018;04;15;Keskiviikko;9;6;15
95;04.04.2018;2018;04;16;Keskiviikko;10;3;13
95;04.04.2018;2018;04;17;Keskiviikko;6;8;14
95;04.04.2018;2018;04;18;Keskiviikko;0;2;2
95;04.04.2018;2018;04;19;Keskiviikko;2;0;2
95;04.04.2018;2018;04;20;Keskiviikko;2;0;2
95;04.04.2018;2018;04;21;Keskiviikko;1;0;1
95;04.04.2018;2018;04;22;Keskiviikko;0;0;0
95;04.04.2018;2018;04;23;Keskiviikko;0;0;0
95;05.04.2018;2018;04;00;Torstai;0;0;0
95;05.04.2018;2018;04;01;Torstai;0;0;0
95;05.04.2018;2018;04;02;Torstai;0;0;0
95;05.04.2018;2018;04;03;Torstai;0;0;0
95;05.04.2018;2018;04;04;Torstai;0;0;0
95;05.04.2018;2018;04;05;Torstai;2;0;2
95;05.04.2018;2018;04;06;Torstai;5;0;5
95;05.04.2018;2018;04;07;Torstai;8;1;9
95;05.04.2018;2018;04;08;Torstai;4;2;6
95;05.04.2018;2018;04;09;Torstai;1;0;1
95;05.04.2018;2018;04;10;Torstai;3;1;4
95;05.04.2018;2018;04;11;Torstai;2;0;2
95;05.04.2018;2018;04;12;Torstai;2;1;3
95;05.04.2018;2018;04;13;Torstai;2;0;2
95;05.04.2018;2018;04;14;Torstai;4;2;6
95;05.04.2018;2018;04;15;Torstai;7;4;11
95;05.04.2018;2018;04;16;Torstai;4;3;7
95;05.04.2018;2018;04;17;Torstai;2;4;6
95;05.04.2018;2018;04;18;Torstai;1;2;3
95;05.04.2018;2018;04;19;Torstai;2;1;3
95;05.04.2018;2018;04;20;Torstai;0;1;1
95;05.04.2018;2018;04;21;Torstai;2;0;2
95;05.04.2018;2018;04;22;Torstai;0;2;2
95;05.04.2018;2018;04;23;Torstai;0;0;0
95;06.04.2018;2018;04;00;Perjantai;0;0;0
95;06.04.2018;2018;04;01;Perjantai;0;0;0
95;06.04.2018;2018;04;02;Perjantai;0;0;0
95;06.04.2018;2018;04;03;Perjantai;0;0;0
95;06.04.2018;2018;04;04;Perjantai;0;0;0
95;06.04.2018;2018;04;05;Perjantai;1;4;5
95;06.04.2018;2018;04;06;Perjantai;1;1;2
95;06.04.2018;2018;04;07;Perjantai;4;9;13
95;06.04.2018;2018;04;08;Perjantai;3;3;6
95;06.04.2018;2018;04;09;Perjantai;2;0;2
95;06.04.2018;2018;04;10;Perjantai;7;5;12
95;06.04.2018;2018;04;11;Perjantai;5;2;7
95;06.04.2018;2018;04;12;Perjantai;0;1;1
95;06.04.2018;2018;04;13;Perjantai;0;1;1
95;06.04.2018;2018;04;14;Perjantai;4;2;6
95;06.04.2018;2018;04;15;Perjantai;11;1;12
95;06.04.2018;2018;04;16;Perjantai;2;5;7
95;06.04.2018;2018;04;17;Perjantai;2;2;4
95;06.04.2018;2018;04;18;Perjantai;0;1;1
95;06.04.2018;2018;04;19;Perjantai;0;2;2
95;06.04.2018;2018;04;20;Perjantai;0;0;0
95;06.04.2018;2018;04;21;Perjantai;2;0;2
95;06.04.2018;2018;04;22;Perjantai;0;0;0
95;06.04.2018;2018;04;23;Perjantai;0;0;0
95;07.04.2018;2018;04;00;Lauantai;0;0;0
95;07.04.2018;2018;04;01;Lauantai;0;0;0
95;07.04.2018;2018;04;02;Lauantai;0;0;0
95;07.04.2018;2018;04;03;Lauantai;0;0;0
95;07.04.2018;2018;04;04;Lauantai;0;0;0
95;07.04.2018;2018;04;05;Lauantai;0;0;0
95;07.04.2018;2018;04;06;Lauantai;0;0;0
95;07.04.2018;2018;04;07;Lauantai;0;1;1
95;07.04.2018;2018;04;08;Lauantai;2;0;2
95;07.04.2018;2018;04;09;Lauantai;0;2;2
95;07.04.2018;2018;04;10;Lauantai;3;4;7
95;07.04.2018;2018;04;11;Lauantai;6;4;10
95;07.04.2018;2018;04;12;Lauantai;2;1;3
95;07.04.2018;2018;04;13;Lauantai;8;5;13
95;07.04.2018;2018;04;14;Lauantai;1;4;5
95;07.04.2018;2018;04;15;Lauantai;1;3;4
95;07.04.2018;2018;04;16;Lauantai;3;4;7
95;07.04.2018;2018;04;17;Lauantai;1;0;1
95;07.04.2018;2018;04;18;Lauantai;2;1;3
95;07.04.2018;2018;04;19;Lauantai;3;1;4
95;07.04.2018;2018;04;20;Lauantai;1;2;3
95;07.04.2018;2018;04;21;Lauantai;1;0;1
95;07.04.2018;2018;04;22;Lauantai;0;0;0
95;07.04.2018;2018;04;23;Lauantai;0;0;0
95;08.04.2018;2018;04;00;Sunnuntai;0;0;0
95;08.04.2018;2018;04;01;Sunnuntai;0;0;0
95;08.04.2018;2018;04;02;Sunnuntai;0;0;0
95;08.04.2018;2018;04;03;Sunnuntai;0;0;0
95;08.04.2018;2018;04;04;Sunnuntai;0;0;0
95;08.04.2018;2018;04;05;Sunnuntai;0;0;0
95;08.04.2018;2018;04;06;Sunnuntai;0;0;0
95;08.04.2018;2018;04;07;Sunnuntai;0;1;1
95;08.04.2018;2018;04;08;Sunnuntai;0;0;0
95;08.04.2018;2018;04;09;Sunnuntai;0;1;1
95;08.04.2018;2018;04;10;Sunnuntai;0;0;0
95;08.04.2018;2018;04;11;Sunnuntai;2;6;8
95;08.04.2018;2018;04;12;Sunnuntai;6;2;8
95;08.04.2018;2018;04;13;Sunnuntai;1;6;7
95;08.04.2018;2018;04;14;Sunnuntai;2;4;6
95;08.04.2018;2018;04;15;Sunnuntai;3;3;6
95;08.04.2018;2018;04;16;Sunnuntai;3;5;8
95;08.04.2018;2018;04;17;Sunnuntai;5;4;9
95;08.04.2018;2018;04;18;Sunnuntai;3;1;4
95;08.04.2018;2018;04;19;Sunnuntai;3;3;6
95;08.04.2018;2018;04;20;Sunnuntai;0;2;2
95;08.04.2018;2018;04;21;Sunnuntai;2;0;2
95;08.04.2018;2018;04;22;Sunnuntai;0;1;1
95;08.04.2018;2018;04;23;Sunnuntai;0;1;1
95;09.04.2018;2018;04;00;Maanantai;0;0;0
95;09.04.2018;2018;04;01;Maanantai;0;0;0
95;09.04.2018;2018;04;02;Maanantai;0;0;0
95;09.04.2018;2018;04;03;Maanantai;0;0;0
95;09.04.2018;2018;04;04;Maanantai;2;0;2
95;09.04.2018;2018;04;05;Maanantai;1;4;5
95;09.04.2018;2018;04;06;Maanantai;6;5;11
95;09.04.2018;2018;04;07;Maanantai;6;10;16
95;09.04.2018;2018;04;08;Maanantai;5;6;11
95;09.04.2018;2018;04;09;Maanantai;4;3;7
95;09.04.2018;2018;04;10;Maanantai;4;0;4
95;09.04.2018;2018;04;11;Maanantai;5;0;5
95;09.04.2018;2018;04;12;Maanantai;2;2;4
95;09.04.2018;2018;04;13;Maanantai;5;5;10
95;09.04.2018;2018;04;14;Maanantai;8;7;15
95;09.04.2018;2018;04;15;Maanantai;10;7;17
95;09.04.2018;2018;04;16;Maanantai;13;9;22
95;09.04.2018;2018;04;17;Maanantai;5;6;11
95;09.04.2018;2018;04;18;Maanantai;2;5;7
95;09.04.2018;2018;04;19;Maanantai;4;2;6
95;09.04.2018;2018;04;20;Maanantai;1;4;5
95;09.04.2018;2018;04;21;Maanantai;1;1;2
95;09.04.2018;2018;04;22;Maanantai;2;1;3
95;09.04.2018;2018;04;23;Maanantai;0;0;0
95;10.04.2018;2018;04;00;Tiistai;0;1;1
95;10.04.2018;2018;04;01;Tiistai;0;0;0
95;10.04.2018;2018;04;02;Tiistai;0;0;0
95;10.04.2018;2018;04;03;Tiistai;0;0;0
95;10.04.2018;2018;04;04;Tiistai;0;0;0
95;10.04.2018;2018;04;05;Tiistai;6;5;11
95;10.04.2018;2018;04;06;Tiistai;4;2;6
95;10.04.2018;2018;04;07;Tiistai;6;13;19
95;10.04.2018;2018;04;08;Tiistai;5;6;11
95;10.04.2018;2018;04;09;Tiistai;1;3;4
95;10.04.2018;2018;04;10;Tiistai;2;2;4
95;10.04.2018;2018;04;11;Tiistai;7;3;10
95;10.04.2018;2018;04;12;Tiistai;3;4;7
95;10.04.2018;2018;04;13;Tiistai;4;2;6
95;10.04.2018;2018;04;14;Tiistai;9;3;12
95;10.04.2018;2018;04;15;Tiistai;14;6;20
95;10.04.2018;2018;04;16;Tiistai;8;8;16
95;10.04.2018;2018;04;17;Tiistai;2;4;6
95;10.04.2018;2018;04;18;Tiistai;5;4;9
95;10.04.2018;2018;04;19;Tiistai;3;2;5
95;10.04.2018;2018;04;20;Tiistai;0;0;0
95;10.04.2018;2018;04;21;Tiistai;0;2;2
95;10.04.2018;2018;04;22;Tiistai;2;0;2
95;10.04.2018;2018;04;23;Tiistai;0;1;1
95;11.04.2018;2018;04;00;Keskiviikko;0;0;0
95;11.04.2018;2018;04;01;Keskiviikko;0;0;0
95;11.04.2018;2018;04;02;Keskiviikko;0;0;0
95;11.04.2018;2018;04;03;Keskiviikko;0;0;0
95;11.04.2018;2018;04;04;Keskiviikko;0;0;0
95;11.04.2018;2018;04;05;Keskiviikko;4;1;5
95;11.04.2018;2018;04;06;Keskiviikko;8;4;12
95;11.04.2018;2018;04;07;Keskiviikko;8;14;22
95;11.04.2018;2018;04;08;Keskiviikko;2;7;9
95;11.04.2018;2018;04;09;Keskiviikko;2;4;6
95;11.04.2018;2018;04;10;Keskiviikko;3;2;5
95;11.04.2018;2018;04;11;Keskiviikko;2;0;2
95;11.04.2018;2018;04;12;Keskiviikko;1;3;4
95;11.04.2018;2018;04;13;Keskiviikko;13;7;20
95;11.04.2018;2018;04;14;Keskiviikko;12;8;20
95;11.04.2018;2018;04;15;Keskiviikko;11;11;22
95;11.04.2018;2018;04;16;Keskiviikko;8;9;17
95;11.04.2018;2018;04;17;Keskiviikko;4;9;13
95;11.04.2018;2018;04;18;Keskiviikko;4;4;8
95;11.04.2018;2018;04;19;Keskiviikko;1;2;3
95;11.04.2018;2018;04;20;Keskiviikko;1;4;5
95;11.04.2018;2018;04;21;Keskiviikko;2;1;3
95;11.04.2018;2018;04;22;Keskiviikko;1;1;2
95;11.04.2018;2018;04;23;Keskiviikko;1;0;1
95;12.04.2018;2018;04;00;Torstai;0;0;0
95;12.04.2018;2018;04;01;Torstai;0;0;0
95;12.04.2018;2018;04;02;Torstai;0;0;0
95;12.04.2018;2018;04;03;Torstai;0;0;0
95;12.04.2018;2018;04;04;Torstai;2;0;2
95;12.04.2018;2018;04;05;Torstai;5;1;6
95;12.04.2018;2018;04;06;Torstai;5;4;9
95;12.04.2018;2018;04;07;Torstai;13;10;23
95;12.04.2018;2018;04;08;Torstai;6;7;13
95;12.04.2018;2018;04;09;Torstai;2;13;15
95;12.04.2018;2018;04;10;Torstai;4;1;5
95;12.04.2018;2018;04;11;Torstai;6;3;9
95;12.04.2018;2018;04;12;Torstai;6;4;10
95;12.04.2018;2018;04;13;Torstai;2;6;8
95;12.04.2018;2018;04;14;Torstai;9;4;13
95;12.04.2018;2018;04;15;Torstai;12;18;30
95;12.04.2018;2018;04;16;Torstai;31;11;42
95;12.04.2018;2018;04;17;Torstai;4;10;14
95;12.04.2018;2018;04;18;Torstai;4;7;11
95;12.04.2018;2018;04;19;Torstai;7;5;12
95;12.04.2018;2018;04;20;Torstai;7;5;12
95;12.04.2018;2018;04;21;Torstai;0;1;1
95;12.04.2018;2018;04;22;Torstai;3;2;5
95;12.04.2018;2018;04;23;Torstai;1;0;1
95;13.04.2018;2018;04;00;Perjantai;0;0;0
95;13.04.2018;2018;04;01;Perjantai;0;0;0
95;13.04.2018;2018;04;02;Perjantai;0;0;0
95;13.04.2018;2018;04;03;Perjantai;0;0;0
95;13.04.2018;2018;04;04;Perjantai;0;1;1
95;13.04.2018;2018;04;05;Perjantai;4;2;6
95;13.04.2018;2018;04;06;Perjantai;6;2;8
95;13.04.2018;2018;04;07;Perjantai;14;6;20
95;13.04.2018;2018;04;08;Perjantai;3;11;14
95;13.04.2018;2018;04;09;Perjantai;3;4;7
95;13.04.2018;2018;04;10;Perjantai;0;4;4
95;13.04.2018;2018;04;11;Perjantai;6;5;11
95;13.04.2018;2018;04;12;Perjantai;3;4;7
95;13.04.2018;2018;04;13;Perjantai;18;6;24
95;13.04.2018;2018;04;14;Perjantai;11;10;21
95;13.04.2018;2018;04;15;Perjantai;11;12;23
95;13.04.2018;2018;04;16;Perjantai;11;12;23
95;13.04.2018;2018;04;17;Perjantai;3;10;13
95;13.04.2018;2018;04;18;Perjantai;11;10;21
95;13.04.2018;2018;04;19;Perjantai;4;7;11
95;13.04.2018;2018;04;20;Perjantai;1;3;4
95;13.04.2018;2018;04;21;Perjantai;1;3;4
95;13.04.2018;2018;04;22;Perjantai;0;0;0
95;13.04.2018;2018;04;23;Perjantai;0;0;0
95;14.04.2018;2018;04;00;Lauantai;0;0;0
95;14.04.2018;2018;04;01;Lauantai;0;0;0
95;14.04.2018;2018;04;02;Lauantai;0;0;0
95;14.04.2018;2018;04;03;Lauantai;0;0;0
95;14.04.2018;2018;04;04;Lauantai;0;0;0
95;14.04.2018;2018;04;05;Lauantai;1;1;2
95;14.04.2018;2018;04;06;Lauantai;0;0;0
95;14.04.2018;2018;04;07;Lauantai;2;2;4
95;14.04.2018;2018;04;08;Lauantai;1;1;2
95;14.04.2018;2018;04;09;Lauantai;1;1;2
95;14.04.2018;2018;04;10;Lauantai;9;2;11
95;14.04.2018;2018;04;11;Lauantai;7;2;9
95;14.04.2018;2018;04;12;Lauantai;8;15;23
95;14.04.2018;2018;04;13;Lauantai;8;9;17
95;14.04.2018;2018;04;14;Lauantai;17;7;24
95;14.04.2018;2018;04;15;Lauantai;9;8;17
95;14.04.2018;2018;04;16;Lauantai;7;6;13
95;14.04.2018;2018;04;17;Lauantai;6;10;16
95;14.04.2018;2018;04;18;Lauantai;6;4;10
95;14.04.2018;2018;04;19;Lauantai;2;3;5
95;14.04.2018;2018;04;20;Lauantai;6;4;10
95;14.04.2018;2018;04;21;Lauantai;3;2;5
95;14.04.2018;2018;04;22;Lauantai;0;2;2
95;14.04.2018;2018;04;23;Lauantai;0;1;1
95;15.04.2018;2018;04;00;Sunnuntai;0;0;0
95;15.04.2018;2018;04;01;Sunnuntai;0;1;1
95;15.04.2018;2018;04;02;Sunnuntai;0;0;0
95;15.04.2018;2018;04;03;Sunnuntai;0;0;0
95;15.04.2018;2018;04;04;Sunnuntai;0;0;0
95;15.04.2018;2018;04;05;Sunnuntai;0;1;1
95;15.04.2018;2018;04;06;Sunnuntai;0;0;0
95;15.04.2018;2018;04;07;Sunnuntai;1;3;4
95;15.04.2018;2018;04;08;Sunnuntai;3;3;6
95;15.04.2018;2018;04;09;Sunnuntai;3;4;7
95;15.04.2018;2018;04;10;Sunnuntai;8;8;16
95;15.04.2018;2018;04;11;Sunnuntai;3;9;12
95;15.04.2018;2018;04;12;Sunnuntai;21;12;33
95;15.04.2018;2018;04;13;Sunnuntai;12;19;31
95;15.04.2018;2018;04;14;Sunnuntai;31;15;46
95;15.04.2018;2018;04;15;Sunnuntai;25;8;33
95;15.04.2018;2018;04;16;Sunnuntai;11;13;24
95;15.04.2018;2018;04;17;Sunnuntai;13;14;27
95;15.04.2018;2018;04;18;Sunnuntai;10;11;21
95;15.04.2018;2018;04;19;Sunnuntai;3;5;8
95;15.04.2018;2018;04;20;Sunnuntai;8;6;14
95;15.04.2018;2018;04;21;Sunnuntai;4;5;9
95;15.04.2018;2018;04;22;Sunnuntai;2;1;3
95;15.04.2018;2018;04;23;Sunnuntai;1;0;1
95;16.04.2018;2018;04;00;Maanantai;0;0;0
95;16.04.2018;2018;04;01;Maanantai;0;0;0
95;16.04.2018;2018;04;02;Maanantai;0;0;0
95;16.04.2018;2018;04;03;Maanantai;0;0;0
95;16.04.2018;2018;04;04;Maanantai;0;1;1
95;16.04.2018;2018;04;05;Maanantai;8;6;14
95;16.04.2018;2018;04;06;Maanantai;11;7;18
95;16.04.2018;2018;04;07;Maanantai;11;16;27
95;16.04.2018;2018;04;08;Maanantai;10;14;24
95;16.04.2018;2018;04;09;Maanantai;9;14;23
95;16.04.2018;2018;04;10;Maanantai;9;1;10
95;16.04.2018;2018;04;11;Maanantai;11;10;21
95;16.04.2018;2018;04;12;Maanantai;8;6;14
95;16.04.2018;2018;04;13;Maanantai;8;6;14
95;16.04.2018;2018;04;14;Maanantai;25;11;36
95;16.04.2018;2018;04;15;Maanantai;12;25;37
95;16.04.2018;2018;04;16;Maanantai;24;20;44
95;16.04.2018;2018;04;17;Maanantai;20;21;41
95;16.04.2018;2018;04;18;Maanantai;11;10;21
95;16.04.2018;2018;04;19;Maanantai;6;15;21
95;16.04.2018;2018;04;20;Maanantai;10;6;16
95;16.04.2018;2018;04;21;Maanantai;5;5;10
95;16.04.2018;2018;04;22;Maanantai;1;3;4
95;16.04.2018;2018;04;23;Maanantai;1;1;2
95;17.04.2018;2018;04;00;Tiistai;1;0;1
95;17.04.2018;2018;04;01;Tiistai;0;0;0
95;17.04.2018;2018;04;02;Tiistai;0;0;0
95;17.04.2018;2018;04;03;Tiistai;0;0;0
95;17.04.2018;2018;04;04;Tiistai;0;0;0
95;17.04.2018;2018;04;05;Tiistai;4;7;11
95;17.04.2018;2018;04;06;Tiistai;12;7;19
95;17.04.2018;2018;04;07;Tiistai;21;24;45
95;17.04.2018;2018;04;08;Tiistai;8;15;23
95;17.04.2018;2018;04;09;Tiistai;7;7;14
95;17.04.2018;2018;04;10;Tiistai;8;5;13
95;17.04.2018;2018;04;11;Tiistai;8;7;15
95;17.04.2018;2018;04;12;Tiistai;8;2;10
95;17.04.2018;2018;04;13;Tiistai;12;5;17
95;17.04.2018;2018;04;14;Tiistai;18;6;24
95;17.04.2018;2018;04;15;Tiistai;20;16;36
95;17.04.2018;2018;04;16;Tiistai;17;24;41
95;17.04.2018;2018;04;17;Tiistai;20;18;38
95;17.04.2018;2018;04;18;Tiistai;6;13;19
95;17.04.2018;2018;04;19;Tiistai;10;11;21
95;17.04.2018;2018;04;20;Tiistai;9;5;14
95;17.04.2018;2018;04;21;Tiistai;3;3;6
95;17.04.2018;2018;04;22;Tiistai;1;2;3
95;17.04.2018;2018;04;23;Tiistai;0;0;0
95;18.04.2018;2018;04;00;Keskiviikko;0;0;0
95;18.04.2018;2018;04;01;Keskiviikko;0;0;0
95;18.04.2018;2018;04;02;Keskiviikko;0;0;0
95;18.04.2018;2018;04;03;Keskiviikko;0;0;0
95;18.04.2018;2018;04;04;Keskiviikko;1;0;1
95;18.04.2018;2018;04;05;Keskiviikko;3;10;13
95;18.04.2018;2018;04;06;Keskiviikko;14;7;21
95;18.04.2018;2018;04;07;Keskiviikko;11;25;36
95;18.04.2018;2018;04;08;Keskiviikko;8;11;19
95;18.04.2018;2018;04;09;Keskiviikko;8;7;15
95;18.04.2018;2018;04;10;Keskiviikko;13;8;21
95;18.04.2018;2018;04;11;Keskiviikko;8;11;19
95;18.04.2018;2018;04;12;Keskiviikko;14;17;31
95;18.04.2018;2018;04;13;Keskiviikko;14;14;28
95;18.04.2018;2018;04;14;Keskiviikko;17;15;32
95;18.04.2018;2018;04;15;Keskiviikko;24;18;42
95;18.04.2018;2018;04;16;Keskiviikko;27;22;49
95;18.04.2018;2018;04;17;Keskiviikko;18;16;34
95;18.04.2018;2018;04;18;Keskiviikko;20;13;33
95;18.04.2018;2018;04;19;Keskiviikko;14;16;30
95;18.04.2018;2018;04;20;Keskiviikko;7;9;16
95;18.04.2018;2018;04;21;Keskiviikko;5;4;9
95;18.04.2018;2018;04;22;Keskiviikko;1;5;6
95;18.04.2018;2018;04;23;Keskiviikko;0;1;1
95;19.04.2018;2018;04;00;Torstai;0;0;0
95;19.04.2018;2018;04;01;Torstai;0;0;0
95;19.04.2018;2018;04;02;Torstai;0;0;0
95;19.04.2018;2018;04;03;Torstai;0;0;0
95;19.04.2018;2018;04;04;Torstai;1;0;1
95;19.04.2018;2018;04;05;Torstai;6;9;15
95;19.04.2018;2018;04;06;Torstai;7;8;15
95;19.04.2018;2018;04;07;Torstai;15;16;31
95;19.04.2018;2018;04;08;Torstai;7;9;16
95;19.04.2018;2018;04;09;Torstai;14;12;26
95;19.04.2018;2018;04;10;Torstai;2;14;16
95;19.04.2018;2018;04;11;Torstai;6;4;10
95;19.04.2018;2018;04;12;Torstai;9;10;19
95;19.04.2018;2018;04;13;Torstai;9;6;15
95;19.04.2018;2018;04;14;Torstai;24;14;38
95;19.04.2018;2018;04;15;Torstai;17;16;33
95;19.04.2018;2018;04;16;Torstai;22;18;40
95;19.04.2018;2018;04;17;Torstai;4;13;17
95;19.04.2018;2018;04;18;Torstai;7;9;16
95;19.04.2018;2018;04;19;Torstai;16;12;28
95;19.04.2018;2018;04;20;Torstai;4;6;10
95;19.04.2018;2018;04;21;Torstai;1;2;3
95;19.04.2018;2018;04;22;Torstai;0;1;1
95;19.04.2018;2018;04;23;Torstai;0;0;0
95;20.04.2018;2018;04;00;Perjantai;0;0;0
95;20.04.2018;2018;04;01;Perjantai;0;0;0
95;20.04.2018;2018;04;02;Perjantai;0;0;0
95;20.04.2018;2018;04;03;Perjantai;0;0;0
95;20.04.2018;2018;04;04;Perjantai;0;2;2
95;20.04.2018;2018;04;05;Perjantai;2;5;7
95;20.04.2018;2018;04;06;Perjantai;4;4;8
95;20.04.2018;2018;04;07;Perjantai;7;11;18
95;20.04.2018;2018;04;08;Perjantai;4;6;10
95;20.04.2018;2018;04;09;Perjantai;2;3;5
95;20.04.2018;2018;04;10;Perjantai;2;2;4
95;20.04.2018;2018;04;11;Perjantai;2;1;3
95;20.04.2018;2018;04;12;Perjantai;8;1;9
95;20.04.2018;2018;04;13;Perjantai;11;5;16
95;20.04.2018;2018;04;14;Perjantai;12;4;16
95;20.04.2018;2018;04;15;Perjantai;10;5;15
95;20.04.2018;2018;04;16;Perjantai;10;11;21
95;20.04.2018;2018;04;17;Perjantai;3;5;8
95;20.04.2018;2018;04;18;Perjantai;2;6;8
95;20.04.2018;2018;04;19;Perjantai;3;1;4
95;20.04.2018;2018;04;20;Perjantai;0;4;4
95;20.04.2018;2018;04;21;Perjantai;0;1;1
95;20.04.2018;2018;04;22;Perjantai;0;1;1
95;20.04.2018;2018;04;23;Perjantai;0;0;0
95;21.04.2018;2018;04;00;Lauantai;0;1;1
95;21.04.2018;2018;04;01;Lauantai;0;0;0
95;21.04.2018;2018;04;02;Lauantai;0;0;0
95;21.04.2018;2018;04;03;Lauantai;0;2;2
95;21.04.2018;2018;04;04;Lauantai;1;0;1
95;21.04.2018;2018;04;05;Lauantai;2;1;3
95;21.04.2018;2018;04;06;Lauantai;0;1;1
95;21.04.2018;2018;04;07;Lauantai;0;3;3
95;21.04.2018;2018;04;08;Lauantai;2;3;5
95;21.04.2018;2018;04;09;Lauantai;4;6;10
95;21.04.2018;2018;04;10;Lauantai;15;11;26
95;21.04.2018;2018;04;11;Lauantai;4;8;12
95;21.04.2018;2018;04;12;Lauantai;5;8;13
95;21.04.2018;2018;04;13;Lauantai;7;12;19
95;21.04.2018;2018;04;14;Lauantai;18;10;28
95;21.04.2018;2018;04;15;Lauantai;10;14;24
95;21.04.2018;2018;04;16;Lauantai;11;19;30
95;21.04.2018;2018;04;17;Lauantai;13;6;19
95;21.04.2018;2018;04;18;Lauantai;15;3;18
95;21.04.2018;2018;04;19;Lauantai;4;2;6
95;21.04.2018;2018;04;20;Lauantai;3;1;4
95;21.04.2018;2018;04;21;Lauantai;0;1;1
95;21.04.2018;2018;04;22;Lauantai;0;0;0
95;21.04.2018;2018;04;23;Lauantai;0;0;0
95;22.04.2018;2018;04;00;Sunnuntai;0;1;1
95;22.04.2018;2018;04;01;Sunnuntai;0;0;0
95;22.04.2018;2018;04;02;Sunnuntai;0;0;0
95;22.04.2018;2018;04;03;Sunnuntai;0;1;1
95;22.04.2018;2018;04;04;Sunnuntai;0;1;1
95;22.04.2018;2018;04;05;Sunnuntai;1;1;2
95;22.04.2018;2018;04;06;Sunnuntai;0;0;0
95;22.04.2018;2018;04;07;Sunnuntai;3;4;7
95;22.04.2018;2018;04;08;Sunnuntai;3;1;4
95;22.04.2018;2018;04;09;Sunnuntai;4;9;13
95;22.04.2018;2018;04;10;Sunnuntai;10;12;22
95;22.04.2018;2018;04;11;Sunnuntai;15;12;27
95;22.04.2018;2018;04;12;Sunnuntai;17;22;39
95;22.04.2018;2018;04;13;Sunnuntai;27;30;57
95;22.04.2018;2018;04;14;Sunnuntai;13;13;26
95;22.04.2018;2018;04;15;Sunnuntai;11;16;27
95;22.04.2018;2018;04;16;Sunnuntai;10;11;21
95;22.04.2018;2018;04;17;Sunnuntai;10;16;26
95;22.04.2018;2018;04;18;Sunnuntai;18;10;28
95;22.04.2018;2018;04;19;Sunnuntai;8;13;21
95;22.04.2018;2018;04;20;Sunnuntai;6;5;11
95;22.04.2018;2018;04;21;Sunnuntai;1;3;4
95;22.04.2018;2018;04;22;Sunnuntai;0;0;0
95;22.04.2018;2018;04;23;Sunnuntai;0;0;0
95;23.04.2018;2018;04;00;Maanantai;0;0;0
95;23.04.2018;2018;04;01;Maanantai;0;0;0
95;23.04.2018;2018;04;02;Maanantai;0;0;0
95;23.04.2018;2018;04;03;Maanantai;0;1;1
95;23.04.2018;2018;04;04;Maanantai;0;0;0
95;23.04.2018;2018;04;05;Maanantai;9;5;14
95;23.04.2018;2018;04;06;Maanantai;10;3;13
95;23.04.2018;2018;04;07;Maanantai;16;19;35
95;23.04.2018;2018;04;08;Maanantai;9;14;23
95;23.04.2018;2018;04;09;Maanantai;8;16;24
95;23.04.2018;2018;04;10;Maanantai;7;7;14
95;23.04.2018;2018;04;11;Maanantai;8;12;20
95;23.04.2018;2018;04;12;Maanantai;7;4;11
95;23.04.2018;2018;04;13;Maanantai;14;13;27
95;23.04.2018;2018;04;14;Maanantai;19;11;30
95;23.04.2018;2018;04;15;Maanantai;13;21;34
95;23.04.2018;2018;04;16;Maanantai;17;26;43
95;23.04.2018;2018;04;17;Maanantai;12;13;25
95;23.04.2018;2018;04;18;Maanantai;18;6;24
95;23.04.2018;2018;04;19;Maanantai;10;12;22
95;23.04.2018;2018;04;20;Maanantai;8;7;15
95;23.04.2018;2018;04;21;Maanantai;4;2;6
95;23.04.2018;2018;04;22;Maanantai;4;1;5
95;23.04.2018;2018;04;23;Maanantai;0;0;0
95;24.04.2018;2018;04;00;Tiistai;0;2;2
95;24.04.2018;2018;04;01;Tiistai;1;0;1
95;24.04.2018;2018;04;02;Tiistai;0;0;0
95;24.04.2018;2018;04;03;Tiistai;0;0;0
95;24.04.2018;2018;04;04;Tiistai;0;0;0
95;24.04.2018;2018;04;05;Tiistai;6;6;12
95;24.04.2018;2018;04;06;Tiistai;10;6;16
95;24.04.2018;2018;04;07;Tiistai;10;26;36
95;24.04.2018;2018;04;08;Tiistai;7;7;14
95;24.04.2018;2018;04;09;Tiistai;6;3;9
95;24.04.2018;2018;04;10;Tiistai;2;2;4
95;24.04.2018;2018;04;11;Tiistai;4;5;9
95;24.04.2018;2018;04;12;Tiistai;7;5;12
95;24.04.2018;2018;04;13;Tiistai;7;3;10
95;24.04.2018;2018;04;14;Tiistai;13;5;18
95;24.04.2018;2018;04;15;Tiistai;13;14;27
95;24.04.2018;2018;04;16;Tiistai;14;12;26
95;24.04.2018;2018;04;17;Tiistai;4;8;12
95;24.04.2018;2018;04;18;Tiistai;6;10;16
95;24.04.2018;2018;04;19;Tiistai;4;1;5
95;24.04.2018;2018;04;20;Tiistai;3;7;10
95;24.04.2018;2018;04;21;Tiistai;6;6;12
95;24.04.2018;2018;04;22;Tiistai;3;1;4
95;24.04.2018;2018;04;23;Tiistai;0;0;0
95;25.04.2018;2018;04;00;Keskiviikko;2;1;3
95;25.04.2018;2018;04;01;Keskiviikko;0;0;0
95;25.04.2018;2018;04;02;Keskiviikko;0;0;0
95;25.04.2018;2018;04;03;Keskiviikko;0;0;0
95;25.04.2018;2018;04;04;Keskiviikko;2;0;2
95;25.04.2018;2018;04;05;Keskiviikko;4;5;9
95;25.04.2018;2018;04;06;Keskiviikko;8;7;15
95;25.04.2018;2018;04;07;Keskiviikko;14;24;38
95;25.04.2018;2018;04;08;Keskiviikko;4;7;11
95;25.04.2018;2018;04;09;Keskiviikko;6;8;14
95;25.04.2018;2018;04;10;Keskiviikko;3;4;7
95;25.04.2018;2018;04;11;Keskiviikko;10;10;20
95;25.04.2018;2018;04;12;Keskiviikko;13;8;21
95;25.04.2018;2018;04;13;Keskiviikko;3;10;13
95;25.04.2018;2018;04;14;Keskiviikko;11;9;20
95;25.04.2018;2018;04;15;Keskiviikko;20;11;31
95;25.04.2018;2018;04;16;Keskiviikko;25;19;44
95;25.04.2018;2018;04;17;Keskiviikko;16;11;27
95;25.04.2018;2018;04;18;Keskiviikko;7;9;16
95;25.04.2018;2018;04;19;Keskiviikko;3;7;10
95;25.04.2018;2018;04;20;Keskiviikko;5;5;10
95;25.04.2018;2018;04;21;Keskiviikko;3;1;4
95;25.04.2018;2018;04;22;Keskiviikko;4;3;7
95;25.04.2018;2018;04;23;Keskiviikko;0;1;1
95;26.04.2018;2018;04;00;Torstai;0;1;1
95;26.04.2018;2018;04;01;Torstai;1;0;1
95;26.04.2018;2018;04;02;Torstai;0;0;0
95;26.04.2018;2018;04;03;Torstai;0;0;0
95;26.04.2018;2018;04;04;Torstai;0;0;0
95;26.04.2018;2018;04;05;Torstai;5;3;8
95;26.04.2018;2018;04;06;Torstai;12;6;18
95;26.04.2018;2018;04;07;Torstai;12;16;28
95;26.04.2018;2018;04;08;Torstai;6;11;17
95;26.04.2018;2018;04;09;Torstai;4;11;15
95;26.04.2018;2018;04;10;Torstai;6;3;9
95;26.04.2018;2018;04;11;Torstai;8;7;15
95;26.04.2018;2018;04;12;Torstai;8;11;19
95;26.04.2018;2018;04;13;Torstai;4;12;16
95;26.04.2018;2018;04;14;Torstai;12;13;25
95;26.04.2018;2018;04;15;Torstai;17;18;35
95;26.04.2018;2018;04;16;Torstai;30;16;46
95;26.04.2018;2018;04;17;Torstai;7;12;19
95;26.04.2018;2018;04;18;Torstai;12;15;27
95;26.04.2018;2018;04;19;Torstai;14;7;21
95;26.04.2018;2018;04;20;Torstai;2;4;6
95;26.04.2018;2018;04;21;Torstai;4;2;6
95;26.04.2018;2018;04;22;Torstai;3;2;5
95;26.04.2018;2018;04;23;Torstai;1;0;1
95;27.04.2018;2018;04;00;Perjantai;0;0;0
95;27.04.2018;2018;04;01;Perjantai;0;0;0
95;27.04.2018;2018;04;02;Perjantai;0;1;1
95;27.04.2018;2018;04;03;Perjantai;0;0;0
95;27.04.2018;2018;04;04;Perjantai;0;1;1
95;27.04.2018;2018;04;05;Perjantai;8;2;10
95;27.04.2018;2018;04;06;Perjantai;8;3;11
95;27.04.2018;2018;04;07;Perjantai;13;17;30
95;27.04.2018;2018;04;08;Perjantai;8;12;20
95;27.04.2018;2018;04;09;Perjantai;6;8;14
95;27.04.2018;2018;04;10;Perjantai;8;7;15
95;27.04.2018;2018;04;11;Perjantai;17;7;24
95;27.04.2018;2018;04;12;Perjantai;13;9;22
95;27.04.2018;2018;04;13;Perjantai;7;7;14
95;27.04.2018;2018;04;14;Perjantai;10;17;27
95;27.04.2018;2018;04;15;Perjantai;27;17;44
95;27.04.2018;2018;04;16;Perjantai;17;18;35
95;27.04.2018;2018;04;17;Perjantai;14;26;40
95;27.04.2018;2018;04;18;Perjantai;5;12;17
95;27.04.2018;2018;04;19;Perjantai;9;13;22
95;27.04.2018;2018;04;20;Perjantai;8;11;19
95;27.04.2018;2018;04;21;Perjantai;4;2;6
95;27.04.2018;2018;04;22;Perjantai;2;2;4
95;27.04.2018;2018;04;23;Perjantai;0;0;0
95;28.04.2018;2018;04;00;Lauantai;0;0;0
95;28.04.2018;2018;04;01;Lauantai;0;1;1
95;28.04.2018;2018;04;02;Lauantai;0;0;0
95;28.04.2018;2018;04;03;Lauantai;0;0;0
95;28.04.2018;2018;04;04;Lauantai;1;0;1
95;28.04.2018;2018;04;05;Lauantai;0;2;2
95;28.04.2018;2018;04;06;Lauantai;5;0;5
95;28.04.2018;2018;04;07;Lauantai;2;3;5
95;28.04.2018;2018;04;08;Lauantai;4;5;9
95;28.04.2018;2018;04;09;Lauantai;5;6;11
95;28.04.2018;2018;04;10;Lauantai;10;8;18
95;28.04.2018;2018;04;11;Lauantai;15;28;43
95;28.04.2018;2018;04;12;Lauantai;14;17;31
95;28.04.2018;2018;04;13;Lauantai;13;27;40
95;28.04.2018;2018;04;14;Lauantai;22;13;35
95;28.04.2018;2018;04;15;Lauantai;17;19;36
95;28.04.2018;2018;04;16;Lauantai;16;15;31
95;28.04.2018;2018;04;17;Lauantai;8;14;22
95;28.04.2018;2018;04;18;Lauantai;18;20;38
95;28.04.2018;2018;04;19;Lauantai;13;15;28
95;28.04.2018;2018;04;20;Lauantai;5;3;8
95;28.04.2018;2018;04;21;Lauantai;4;6;10
95;28.04.2018;2018;04;22;Lauantai;1;4;5
95;28.04.2018;2018;04;23;Lauantai;3;2;5
95;29.04.2018;2018;04;00;Sunnuntai;0;0;0
95;29.04.2018;2018;04;01;Sunnuntai;0;0;0
95;29.04.2018;2018;04;02;Sunnuntai;0;0;0
95;29.04.2018;2018;04;03;Sunnuntai;0;0;0
95;29.04.2018;2018;04;04;Sunnuntai;1;0;1
95;29.04.2018;2018;04;05;Sunnuntai;0;3;3
95;29.04.2018;2018;04;06;Sunnuntai;3;1;4
95;29.04.2018;2018;04;07;Sunnuntai;0;3;3
95;29.04.2018;2018;04;08;Sunnuntai;4;6;10
95;29.04.2018;2018;04;09;Sunnuntai;9;5;14
95;29.04.2018;2018;04;10;Sunnuntai;10;17;27
95;29.04.2018;2018;04;11;Sunnuntai;13;11;24
95;29.04.2018;2018;04;12;Sunnuntai;9;20;29
95;29.04.2018;2018;04;13;Sunnuntai;17;12;29
95;29.04.2018;2018;04;14;Sunnuntai;17;20;37
95;29.04.2018;2018;04;15;Sunnuntai;25;10;35
95;29.04.2018;2018;04;16;Sunnuntai;12;14;26
95;29.04.2018;2018;04;17;Sunnuntai;16;16;32
95;29.04.2018;2018;04;18;Sunnuntai;17;18;35
95;29.04.2018;2018;04;19;Sunnuntai;5;11;16
95;29.04.2018;2018;04;20;Sunnuntai;7;12;19
95;29.04.2018;2018;04;21;Sunnuntai;8;3;11
95;29.04.2018;2018;04;22;Sunnuntai;0;1;1
95;29.04.2018;2018;04;23;Sunnuntai;0;3;3
95;30.04.2018;2018;04;00;Maanantai;2;1;3
95;30.04.2018;2018;04;01;Maanantai;0;0;0
95;30.04.2018;2018;04;02;Maanantai;1;0;1
95;30.04.2018;2018;04;03;Maanantai;0;0;0
95;30.04.2018;2018;04;04;Maanantai;0;1;1
95;30.04.2018;2018;04;05;Maanantai;6;3;9
95;30.04.2018;2018;04;06;Maanantai;8;5;13
95;30.04.2018;2018;04;07;Maanantai;9;12;21
95;30.04.2018;2018;04;08;Maanantai;6;6;12
95;30.04.2018;2018;04;09;Maanantai;12;5;17
95;30.04.2018;2018;04;10;Maanantai;15;11;26
95;30.04.2018;2018;04;11;Maanantai;12;7;19
95;30.04.2018;2018;04;12;Maanantai;8;18;26
95;30.04.2018;2018;04;13;Maanantai;10;15;25
95;30.04.2018;2018;04;14;Maanantai;9;11;20
95;30.04.2018;2018;04;15;Maanantai;16;23;39
95;30.04.2018;2018;04;16;Maanantai;19;17;36
95;30.04.2018;2018;04;17;Maanantai;15;13;28
95;30.04.2018;2018;04;18;Maanantai;11;2;13
95;30.04.2018;2018;04;19;Maanantai;4;3;7
95;30.04.2018;2018;04;20;Maanantai;5;6;11
95;30.04.2018;2018;04;21;Maanantai;4;4;8
95;30.04.2018;2018;04;22;Maanantai;2;1;3
95;30.04.2018;2018;04;23;Maanantai;0;1;1
95;01.05.2018;2018;05;00;Tiistai;0;0;0
95;01.05.2018;2018;05;01;Tiistai;0;0;0
95;01.05.2018;2018;05;02;Tiistai;0;0;0
95;01.05.2018;2018;05;03;Tiistai;2;0;2
95;01.05.2018;2018;05;04;Tiistai;0;0;0
95;01.05.2018;2018;05;05;Tiistai;1;1;2
95;01.05.2018;2018;05;06;Tiistai;0;2;2
95;01.05.2018;2018;05;07;Tiistai;3;5;8
95;01.05.2018;2018;05;08;Tiistai;3;6;9
95;01.05.2018;2018;05;09;Tiistai;5;6;11
95;01.05.2018;2018;05;10;Tiistai;15;3;18
95;01.05.2018;2018;05;11;Tiistai;23;7;30
95;01.05.2018;2018;05;12;Tiistai;42;11;53
95;01.05.2018;2018;05;13;Tiistai;18;27;45
95;01.05.2018;2018;05;14;Tiistai;12;20;32
95;01.05.2018;2018;05;15;Tiistai;11;12;23
95;01.05.2018;2018;05;16;Tiistai;17;16;33
95;01.05.2018;2018;05;17;Tiistai;6;16;22
95;01.05.2018;2018;05;18;Tiistai;25;16;41
95;01.05.2018;2018;05;19;Tiistai;7;9;16
95;01.05.2018;2018;05;20;Tiistai;4;10;14
95;01.05.2018;2018;05;21;Tiistai;3;5;8
95;01.05.2018;2018;05;22;Tiistai;1;1;2
95;01.05.2018;2018;05;23;Tiistai;2;0;2
95;02.05.2018;2018;05;00;Keskiviikko;0;1;1
95;02.05.2018;2018;05;01;Keskiviikko;0;0;0
95;02.05.2018;2018;05;02;Keskiviikko;0;1;1
95;02.05.2018;2018;05;03;Keskiviikko;0;0;0
95;02.05.2018;2018;05;04;Keskiviikko;0;0;0
95;02.05.2018;2018;05;05;Keskiviikko;4;4;8
95;02.05.2018;2018;05;06;Keskiviikko;14;6;20
95;02.05.2018;2018;05;07;Keskiviikko;9;18;27
95;02.05.2018;2018;05;08;Keskiviikko;9;6;15
95;02.05.2018;2018;05;09;Keskiviikko;3;8;11
95;02.05.2018;2018;05;10;Keskiviikko;1;4;5
95;02.05.2018;2018;05;11;Keskiviikko;5;6;11
95;02.05.2018;2018;05;12;Keskiviikko;4;2;6
95;02.05.2018;2018;05;13;Keskiviikko;10;2;12
95;02.05.2018;2018;05;14;Keskiviikko;6;8;14
95;02.05.2018;2018;05;15;Keskiviikko;10;11;21
95;02.05.2018;2018;05;16;Keskiviikko;10;17;27
95;02.05.2018;2018;05;17;Keskiviikko;5;8;13
95;02.05.2018;2018;05;18;Keskiviikko;2;5;7
95;02.05.2018;2018;05;19;Keskiviikko;2;3;5
95;02.05.2018;2018;05;20;Keskiviikko;3;2;5
95;02.05.2018;2018;05;21;Keskiviikko;2;7;9
95;02.05.2018;2018;05;22;Keskiviikko;0;0;0
95;02.05.2018;2018;05;23;Keskiviikko;1;0;1
95;03.05.2018;2018;05;00;Torstai;0;0;0
95;03.05.2018;2018;05;01;Torstai;0;0;0
95;03.05.2018;2018;05;02;Torstai;0;0;0
95;03.05.2018;2018;05;03;Torstai;0;0;0
95;03.05.2018;2018;05;04;Torstai;0;1;1
95;03.05.2018;2018;05;05;Torstai;9;4;13
95;03.05.2018;2018;05;06;Torstai;16;8;24
95;03.05.2018;2018;05;07;Torstai;17;30;47
95;03.05.2018;2018;05;08;Torstai;13;13;26
95;03.05.2018;2018;05;09;Torstai;7;8;15
95;03.05.2018;2018;05;10;Torstai;3;9;12
95;03.05.2018;2018;05;11;Torstai;3;4;7
95;03.05.2018;2018;05;12;Torstai;15;5;20
95;03.05.2018;2018;05;13;Torstai;5;3;8
95;03.05.2018;2018;05;14;Torstai;15;14;29
95;03.05.2018;2018;05;15;Torstai;20;20;40
95;03.05.2018;2018;05;16;Torstai;24;17;41
95;03.05.2018;2018;05;17;Torstai;9;20;29
95;03.05.2018;2018;05;18;Torstai;7;7;14
95;03.05.2018;2018;05;19;Torstai;14;11;25
95;03.05.2018;2018;05;20;Torstai;10;6;16
95;03.05.2018;2018;05;21;Torstai;2;2;4
95;03.05.2018;2018;05;22;Torstai;2;0;2
95;03.05.2018;2018;05;23;Torstai;0;1;1
95;04.05.2018;2018;05;00;Perjantai;1;0;1
95;04.05.2018;2018;05;01;Perjantai;0;0;0
95;04.05.2018;2018;05;02;Perjantai;0;1;1
95;04.05.2018;2018;05;03;Perjantai;0;0;0
95;04.05.2018;2018;05;04;Perjantai;2;0;2
95;04.05.2018;2018;05;05;Perjantai;5;6;11
95;04.05.2018;2018;05;06;Perjantai;5;3;8
95;04.05.2018;2018;05;07;Perjantai;6;7;13
95;04.05.2018;2018;05;08;Perjantai;5;9;14
95;04.05.2018;2018;05;09;Perjantai;4;4;8
95;04.05.2018;2018;05;10;Perjantai;3;1;4
95;04.05.2018;2018;05;11;Perjantai;4;3;7
95;04.05.2018;2018;05;12;Perjantai;0;3;3
95;04.05.2018;2018;05;13;Perjantai;3;0;3
95;04.05.2018;2018;05;14;Perjantai;9;5;14
95;04.05.2018;2018;05;15;Perjantai;12;4;16
95;04.05.2018;2018;05;16;Perjantai;7;9;16
95;04.05.2018;2018;05;17;Perjantai;2;5;7
95;04.05.2018;2018;05;18;Perjantai;3;2;5
95;04.05.2018;2018;05;19;Perjantai;2;3;5
95;04.05.2018;2018;05;20;Perjantai;3;4;7
95;04.05.2018;2018;05;21;Perjantai;1;2;3
95;04.05.2018;2018;05;22;Perjantai;0;1;1
95;04.05.2018;2018;05;23;Perjantai;0;0;0
95;05.05.2018;2018;05;00;Lauantai;0;0;0
95;05.05.2018;2018;05;01;Lauantai;0;0;0
95;05.05.2018;2018;05;02;Lauantai;0;1;1
95;05.05.2018;2018;05;03;Lauantai;0;0;0
95;05.05.2018;2018;05;04;Lauantai;1;0;1
95;05.05.2018;2018;05;05;Lauantai;1;1;2
95;05.05.2018;2018;05;06;Lauantai;0;2;2
95;05.05.2018;2018;05;07;Lauantai;0;2;2
95;05.05.2018;2018;05;08;Lauantai;4;1;5
95;05.05.2018;2018;05;09;Lauantai;7;11;18
95;05.05.2018;2018;05;10;Lauantai;5;8;13
95;05.05.2018;2018;05;11;Lauantai;11;8;19
95;05.05.2018;2018;05;12;Lauantai;21;13;34
95;05.05.2018;2018;05;13;Lauantai;11;20;31
95;05.05.2018;2018;05;14;Lauantai;12;14;26
95;05.05.2018;2018;05;15;Lauantai;15;9;24
95;05.05.2018;2018;05;16;Lauantai;22;24;46
95;05.05.2018;2018;05;17;Lauantai;18;14;32
95;05.05.2018;2018;05;18;Lauantai;21;13;34
95;05.05.2018;2018;05;19;Lauantai;7;17;24
95;05.05.2018;2018;05;20;Lauantai;13;12;25
95;05.05.2018;2018;05;21;Lauantai;3;4;7
95;05.05.2018;2018;05;22;Lauantai;3;6;9
95;05.05.2018;2018;05;23;Lauantai;0;1;1
95;06.05.2018;2018;05;00;Sunnuntai;2;0;2
95;06.05.2018;2018;05;01;Sunnuntai;1;0;1
95;06.05.2018;2018;05;02;Sunnuntai;2;0;2
95;06.05.2018;2018;05;03;Sunnuntai;0;1;1
95;06.05.2018;2018;05;04;Sunnuntai;0;3;3
95;06.05.2018;2018;05;05;Sunnuntai;0;2;2
95;06.05.2018;2018;05;06;Sunnuntai;1;2;3
95;06.05.2018;2018;05;07;Sunnuntai;4;5;9
95;06.05.2018;2018;05;08;Sunnuntai;6;7;13
95;06.05.2018;2018;05;09;Sunnuntai;18;13;31
95;06.05.2018;2018;05;10;Sunnuntai;35;18;53
95;06.05.2018;2018;05;11;Sunnuntai;34;17;51
95;06.05.2018;2018;05;12;Sunnuntai;14;19;33
95;06.05.2018;2018;05;13;Sunnuntai;15;22;37
95;06.05.2018;2018;05;14;Sunnuntai;12;9;21
95;06.05.2018;2018;05;15;Sunnuntai;18;14;32
95;06.05.2018;2018;05;16;Sunnuntai;19;24;43
95;06.05.2018;2018;05;17;Sunnuntai;22;15;37
95;06.05.2018;2018;05;18;Sunnuntai;8;16;24
95;06.05.2018;2018;05;19;Sunnuntai;13;14;27
95;06.05.2018;2018;05;20;Sunnuntai;6;8;14
95;06.05.2018;2018;05;21;Sunnuntai;6;5;11
95;06.05.2018;2018;05;22;Sunnuntai;2;0;2
95;06.05.2018;2018;05;23;Sunnuntai;0;0;0
95;07.05.2018;2018;05;00;Maanantai;0;1;1
95;07.05.2018;2018;05;01;Maanantai;0;0;0
95;07.05.2018;2018;05;02;Maanantai;0;0;0
95;07.05.2018;2018;05;03;Maanantai;0;0;0
95;07.05.2018;2018;05;04;Maanantai;0;0;0
95;07.05.2018;2018;05;05;Maanantai;10;5;15
95;07.05.2018;2018;05;06;Maanantai;22;12;34
95;07.05.2018;2018;05;07;Maanantai;15;20;35
95;07.05.2018;2018;05;08;Maanantai;13;19;32
95;07.05.2018;2018;05;09;Maanantai;6;14;20
95;07.05.2018;2018;05;10;Maanantai;12;10;22
95;07.05.2018;2018;05;11;Maanantai;7;8;15
95;07.05.2018;2018;05;12;Maanantai;5;4;9
95;07.05.2018;2018;05;13;Maanantai;6;8;14
95;07.05.2018;2018;05;14;Maanantai;9;9;18
95;07.05.2018;2018;05;15;Maanantai;11;16;27
95;07.05.2018;2018;05;16;Maanantai;24;20;44
95;07.05.2018;2018;05;17;Maanantai;10;10;20
95;07.05.2018;2018;05;18;Maanantai;12;9;21
95;07.05.2018;2018;05;19;Maanantai;8;5;13
95;07.05.2018;2018;05;20;Maanantai;8;4;12
95;07.05.2018;2018;05;21;Maanantai;4;5;9
95;07.05.2018;2018;05;22;Maanantai;0;1;1
95;07.05.2018;2018;05;23;Maanantai;1;0;1
95;08.05.2018;2018;05;00;Tiistai;0;0;0
95;08.05.2018;2018;05;01;Tiistai;0;0;0
95;08.05.2018;2018;05;02;Tiistai;0;0;0
95;08.05.2018;2018;05;03;Tiistai;0;0;0
95;08.05.2018;2018;05;04;Tiistai;1;1;2
95;08.05.2018;2018;05;05;Tiistai;12;9;21
95;08.05.2018;2018;05;06;Tiistai;32;13;45
95;08.05.2018;2018;05;07;Tiistai;26;31;57
95;08.05.2018;2018;05;08;Tiistai;16;24;40
95;08.05.2018;2018;05;09;Tiistai;10;7;17
95;08.05.2018;2018;05;10;Tiistai;10;10;20
95;08.05.2018;2018;05;11;Tiistai;9;10;19
95;08.05.2018;2018;05;12;Tiistai;14;9;23
95;08.05.2018;2018;05;13;Tiistai;13;15;28
95;08.05.2018;2018;05;14;Tiistai;24;21;45
95;08.05.2018;2018;05;15;Tiistai;24;28;52
95;08.05.2018;2018;05;16;Tiistai;28;40;68
95;08.05.2018;2018;05;17;Tiistai;19;35;54
95;08.05.2018;2018;05;18;Tiistai;22;21;43
95;08.05.2018;2018;05;19;Tiistai;20;22;42
95;08.05.2018;2018;05;20;Tiistai;10;16;26
95;08.05.2018;2018;05;21;Tiistai;7;5;12
95;08.05.2018;2018;05;22;Tiistai;2;2;4
95;08.05.2018;2018;05;23;Tiistai;1;0;1
95;09.05.2018;2018;05;00;Keskiviikko;0;0;0
95;09.05.2018;2018;05;01;Keskiviikko;0;0;0
95;09.05.2018;2018;05;02;Keskiviikko;0;0;0
95;09.05.2018;2018;05;03;Keskiviikko;0;1;1
95;09.05.2018;2018;05;04;Keskiviikko;1;0;1
95;09.05.2018;2018;05;05;Keskiviikko;8;9;17
95;09.05.2018;2018;05;06;Keskiviikko;24;17;41
95;09.05.2018;2018;05;07;Keskiviikko;18;30;48
95;09.05.2018;2018;05;08;Keskiviikko;21;20;41
95;09.05.2018;2018;05;09;Keskiviikko;8;11;19
95;09.05.2018;2018;05;10;Keskiviikko;10;4;14
95;09.05.2018;2018;05;11;Keskiviikko;14;14;28
95;09.05.2018;2018;05;12;Keskiviikko;13;8;21
95;09.05.2018;2018;05;13;Keskiviikko;21;14;35
95;09.05.2018;2018;05;14;Keskiviikko;23;17;40
95;09.05.2018;2018;05;15;Keskiviikko;25;34;59
95;09.05.2018;2018;05;16;Keskiviikko;35;47;82
95;09.05.2018;2018;05;17;Keskiviikko;23;20;43
95;09.05.2018;2018;05;18;Keskiviikko;17;23;40
95;09.05.2018;2018;05;19;Keskiviikko;20;17;37
95;09.05.2018;2018;05;20;Keskiviikko;15;9;24
95;09.05.2018;2018;05;21;Keskiviikko;7;7;14
95;09.05.2018;2018;05;22;Keskiviikko;3;7;10
95;09.05.2018;2018;05;23;Keskiviikko;1;3;4
95;10.05.2018;2018;05;00;Torstai;2;1;3
95;10.05.2018;2018;05;01;Torstai;0;2;2
95;10.05.2018;2018;05;02;Torstai;1;0;1
95;10.05.2018;2018;05;03;Torstai;0;0;0
95;10.05.2018;2018;05;04;Torstai;0;0;0
95;10.05.2018;2018;05;05;Torstai;5;3;8
95;10.05.2018;2018;05;06;Torstai;3;7;10
95;10.05.2018;2018;05;07;Torstai;4;7;11
95;10.05.2018;2018;05;08;Torstai;14;5;19
95;10.05.2018;2018;05;09;Torstai;8;11;19
95;10.05.2018;2018;05;10;Torstai;26;28;54
95;10.05.2018;2018;05;11;Torstai;25;30;55
95;10.05.2018;2018;05;12;Torstai;34;42;76
95;10.05.2018;2018;05;13;Torstai;36;31;67
95;10.05.2018;2018;05;14;Torstai;34;24;58
95;10.05.2018;2018;05;15;Torstai;63;46;109
95;10.05.2018;2018;05;16;Torstai;29;26;55
95;10.05.2018;2018;05;17;Torstai;23;31;54
95;10.05.2018;2018;05;18;Torstai;26;30;56
95;10.05.2018;2018;05;19;Torstai;27;13;40
95;10.05.2018;2018;05;20;Torstai;6;18;24
95;10.05.2018;2018;05;21;Torstai;10;11;21
95;10.05.2018;2018;05;22;Torstai;4;2;6
95;10.05.2018;2018;05;23;Torstai;2;1;3
95;11.05.2018;2018;05;00;Perjantai;1;0;1
95;11.05.2018;2018;05;01;Perjantai;0;0;0
95;11.05.2018;2018;05;02;Perjantai;0;0;0
95;11.05.2018;2018;05;03;Perjantai;0;0;0
95;11.05.2018;2018;05;04;Perjantai;2;1;3
95;11.05.2018;2018;05;05;Perjantai;9;4;13
95;11.05.2018;2018;05;06;Perjantai;22;10;32
95;11.05.2018;2018;05;07;Perjantai;19;27;46
95;11.05.2018;2018;05;08;Perjantai;16;20;36
95;11.05.2018;2018;05;09;Perjantai;11;11;22
95;11.05.2018;2018;05;10;Perjantai;9;10;19
95;11.05.2018;2018;05;11;Perjantai;14;12;26
95;11.05.2018;2018;05;12;Perjantai;19;7;26
95;11.05.2018;2018;05;13;Perjantai;14;21;35
95;11.05.2018;2018;05;14;Perjantai;32;27;59
95;11.05.2018;2018;05;15;Perjantai;33;40;73
95;11.05.2018;2018;05;16;Perjantai;25;28;53
95;11.05.2018;2018;05;17;Perjantai;23;24;47
95;11.05.2018;2018;05;18;Perjantai;19;23;42
95;11.05.2018;2018;05;19;Perjantai;18;16;34
95;11.05.2018;2018;05;20;Perjantai;11;5;16
95;11.05.2018;2018;05;21;Perjantai;9;7;16
95;11.05.2018;2018;05;22;Perjantai;4;3;7
95;11.05.2018;2018;05;23;Perjantai;2;2;4
95;12.05.2018;2018;05;00;Lauantai;1;1;2
95;12.05.2018;2018;05;01;Lauantai;1;0;1
95;12.05.2018;2018;05;02;Lauantai;2;2;4
95;12.05.2018;2018;05;03;Lauantai;1;0;1
95;12.05.2018;2018;05;04;Lauantai;2;2;4
95;12.05.2018;2018;05;05;Lauantai;1;4;5
95;12.05.2018;2018;05;06;Lauantai;5;3;8
95;12.05.2018;2018;05;07;Lauantai;3;2;5
95;12.05.2018;2018;05;08;Lauantai;10;8;18
95;12.05.2018;2018;05;09;Lauantai;17;11;28
95;12.05.2018;2018;05;10;Lauantai;16;29;45
95;12.05.2018;2018;05;11;Lauantai;21;21;42
95;12.05.2018;2018;05;12;Lauantai;36;31;67
95;12.05.2018;2018;05;13;Lauantai;43;39;82
95;12.05.2018;2018;05;14;Lauantai;34;25;59
95;12.05.2018;2018;05;15;Lauantai;41;34;75
95;12.05.2018;2018;05;16;Lauantai;26;36;62
95;12.05.2018;2018;05;17;Lauantai;19;19;38
95;12.05.2018;2018;05;18;Lauantai;22;27;49
95;12.05.2018;2018;05;19;Lauantai;16;17;33
95;12.05.2018;2018;05;20;Lauantai;6;13;19
95;12.05.2018;2018;05;21;Lauantai;5;6;11
95;12.05.2018;2018;05;22;Lauantai;6;4;10
95;12.05.2018;2018;05;23;Lauantai;2;3;5
95;13.05.2018;2018;05;00;Sunnuntai;0;0;0
95;13.05.2018;2018;05;01;Sunnuntai;2;1;3
95;13.05.2018;2018;05;02;Sunnuntai;1;4;5
95;13.05.2018;2018;05;03;Sunnuntai;0;1;1
95;13.05.2018;2018;05;04;Sunnuntai;0;1;1
95;13.05.2018;2018;05;05;Sunnuntai;1;1;2
95;13.05.2018;2018;05;06;Sunnuntai;4;1;5
95;13.05.2018;2018;05;07;Sunnuntai;2;3;5
95;13.05.2018;2018;05;08;Sunnuntai;5;2;7
95;13.05.2018;2018;05;09;Sunnuntai;14;5;19
95;13.05.2018;2018;05;10;Sunnuntai;20;22;42
95;13.05.2018;2018;05;11;Sunnuntai;34;28;62
95;13.05.2018;2018;05;12;Sunnuntai;38;24;62
95;13.05.2018;2018;05;13;Sunnuntai;20;22;42
95;13.05.2018;2018;05;14;Sunnuntai;18;37;55
95;13.05.2018;2018;05;15;Sunnuntai;26;29;55
95;13.05.2018;2018;05;16;Sunnuntai;23;26;49
95;13.05.2018;2018;05;17;Sunnuntai;36;38;74
95;13.05.2018;2018;05;18;Sunnuntai;30;25;55
95;13.05.2018;2018;05;19;Sunnuntai;23;22;45
95;13.05.2018;2018;05;20;Sunnuntai;19;22;41
95;13.05.2018;2018;05;21;Sunnuntai;8;4;12
95;13.05.2018;2018;05;22;Sunnuntai;3;0;3
95;13.05.2018;2018;05;23;Sunnuntai;0;2;2
95;14.05.2018;2018;05;00;Maanantai;0;0;0
95;14.05.2018;2018;05;01;Maanantai;1;0;1
95;14.05.2018;2018;05;02;Maanantai;0;0;0
95;14.05.2018;2018;05;03;Maanantai;0;0;0
95;14.05.2018;2018;05;04;Maanantai;4;2;6
95;14.05.2018;2018;05;05;Maanantai;10;8;18
95;14.05.2018;2018;05;06;Maanantai;33;24;57
95;14.05.2018;2018;05;07;Maanantai;35;35;70
95;14.05.2018;2018;05;08;Maanantai;16;25;41
95;14.05.2018;2018;05;09;Maanantai;13;17;30
95;14.05.2018;2018;05;10;Maanantai;17;14;31
95;14.05.2018;2018;05;11;Maanantai;21;18;39
95;14.05.2018;2018;05;12;Maanantai;30;23;53
95;14.05.2018;2018;05;13;Maanantai;16;24;40
95;14.05.2018;2018;05;14;Maanantai;36;24;60
95;14.05.2018;2018;05;15;Maanantai;32;41;73
95;14.05.2018;2018;05;16;Maanantai;47;50;97
95;14.05.2018;2018;05;17;Maanantai;27;35;62
95;14.05.2018;2018;05;18;Maanantai;15;25;40
95;14.05.2018;2018;05;19;Maanantai;17;20;37
95;14.05.2018;2018;05;20;Maanantai;16;21;37
95;14.05.2018;2018;05;21;Maanantai;6;11;17
95;14.05.2018;2018;05;22;Maanantai;2;3;5
95;14.05.2018;2018;05;23;Maanantai;1;1;2
95;15.05.2018;2018;05;00;Tiistai;0;0;0
95;15.05.2018;2018;05;01;Tiistai;1;0;1
95;15.05.2018;2018;05;02;Tiistai;0;0;0
95;15.05.2018;2018;05;03;Tiistai;0;0;0
95;15.05.2018;2018;05;04;Tiistai;1;2;3
95;15.05.2018;2018;05;05;Tiistai;15;11;26
95;15.05.2018;2018;05;06;Tiistai;38;22;60
95;15.05.2018;2018;05;07;Tiistai;32;41;73
95;15.05.2018;2018;05;08;Tiistai;18;22;40
95;15.05.2018;2018;05;09;Tiistai;16;12;28
95;15.05.2018;2018;05;10;Tiistai;14;7;21
95;15.05.2018;2018;05;11;Tiistai;14;12;26
95;15.05.2018;2018;05;12;Tiistai;21;13;34
95;15.05.2018;2018;05;13;Tiistai;23;24;47
95;15.05.2018;2018;05;14;Tiistai;28;19;47
95;15.05.2018;2018;05;15;Tiistai;29;29;58
95;15.05.2018;2018;05;16;Tiistai;57;59;116
95;15.05.2018;2018;05;17;Tiistai;32;45;77
95;15.05.2018;2018;05;18;Tiistai;33;40;73
95;15.05.2018;2018;05;19;Tiistai;20;22;42
95;15.05.2018;2018;05;20;Tiistai;14;16;30
95;15.05.2018;2018;05;21;Tiistai;9;8;17
95;15.05.2018;2018;05;22;Tiistai;2;1;3
95;15.05.2018;2018;05;23;Tiistai;4;0;4
95;16.05.2018;2018;05;00;Keskiviikko;0;0;0
95;16.05.2018;2018;05;01;Keskiviikko;1;0;1
95;16.05.2018;2018;05;02;Keskiviikko;0;0;0
95;16.05.2018;2018;05;03;Keskiviikko;0;0;0
95;16.05.2018;2018;05;04;Keskiviikko;2;2;4
95;16.05.2018;2018;05;05;Keskiviikko;13;12;25
95;16.05.2018;2018;05;06;Keskiviikko;33;17;50
95;16.05.2018;2018;05;07;Keskiviikko;41;34;75
95;16.05.2018;2018;05;08;Keskiviikko;14;24;38
95;16.05.2018;2018;05;09;Keskiviikko;23;21;44
95;16.05.2018;2018;05;10;Keskiviikko;17;18;35
95;16.05.2018;2018;05;11;Keskiviikko;19;27;46
95;16.05.2018;2018;05;12;Keskiviikko;20;16;36
95;16.05.2018;2018;05;13;Keskiviikko;23;17;40
95;16.05.2018;2018;05;14;Keskiviikko;33;16;49
95;16.05.2018;2018;05;15;Keskiviikko;46;54;100
95;16.05.2018;2018;05;16;Keskiviikko;35;47;82
95;16.05.2018;2018;05;17;Keskiviikko;25;30;55
95;16.05.2018;2018;05;18;Keskiviikko;34;42;76
95;16.05.2018;2018;05;19;Keskiviikko;29;27;56
95;16.05.2018;2018;05;20;Keskiviikko;20;23;43
95;16.05.2018;2018;05;21;Keskiviikko;6;14;20
95;16.05.2018;2018;05;22;Keskiviikko;4;7;11
95;16.05.2018;2018;05;23;Keskiviikko;2;0;2
95;17.05.2018;2018;05;00;Torstai;1;1;2
95;17.05.2018;2018;05;01;Torstai;0;0;0
95;17.05.2018;2018;05;02;Torstai;0;1;1
95;17.05.2018;2018;05;03;Torstai;0;1;1
95;17.05.2018;2018;05;04;Torstai;2;0;2
95;17.05.2018;2018;05;05;Torstai;10;13;23
95;17.05.2018;2018;05;06;Torstai;34;14;48
95;17.05.2018;2018;05;07;Torstai;29;25;54
95;17.05.2018;2018;05;08;Torstai;13;15;28
95;17.05.2018;2018;05;09;Torstai;17;15;32
95;17.05.2018;2018;05;10;Torstai;18;10;28
95;17.05.2018;2018;05;11;Torstai;13;19;32
95;17.05.2018;2018;05;12;Torstai;12;9;21
95;17.05.2018;2018;05;13;Torstai;4;17;21
95;17.05.2018;2018;05;14;Torstai;15;17;32
95;17.05.2018;2018;05;15;Torstai;24;22;46
95;17.05.2018;2018;05;16;Torstai;32;49;81
95;17.05.2018;2018;05;17;Torstai;24;30;54
95;17.05.2018;2018;05;18;Torstai;13;23;36
95;17.05.2018;2018;05;19;Torstai;12;15;27
95;17.05.2018;2018;05;20;Torstai;25;10;35
95;17.05.2018;2018;05;21;Torstai;4;7;11
95;17.05.2018;2018;05;22;Torstai;3;2;5
95;17.05.2018;2018;05;23;Torstai;0;0;0
95;18.05.2018;2018;05;00;Perjantai;3;0;3
95;18.05.2018;2018;05;01;Perjantai;0;0;0
95;18.05.2018;2018;05;02;Perjantai;1;0;1
95;18.05.2018;2018;05;03;Perjantai;0;0;0
95;18.05.2018;2018;05;04;Perjantai;0;0;0
95;18.05.2018;2018;05;05;Perjantai;9;8;17
95;18.05.2018;2018;05;06;Perjantai;13;10;23
95;18.05.2018;2018;05;07;Perjantai;24;28;52
95;18.05.2018;2018;05;08;Perjantai;9;16;25
95;18.05.2018;2018;05;09;Perjantai;6;13;19
95;18.05.2018;2018;05;10;Perjantai;7;9;16
95;18.05.2018;2018;05;11;Perjantai;6;4;10
95;18.05.2018;2018;05;12;Perjantai;8;8;16
95;18.05.2018;2018;05;13;Perjantai;14;12;26
95;18.05.2018;2018;05;14;Perjantai;17;17;34
95;18.05.2018;2018;05;15;Perjantai;16;16;32
95;18.05.2018;2018;05;16;Perjantai;27;26;53
95;18.05.2018;2018;05;17;Perjantai;11;22;33
95;18.05.2018;2018;05;18;Perjantai;7;9;16
95;18.05.2018;2018;05;19;Perjantai;10;8;18
95;18.05.2018;2018;05;20;Perjantai;7;8;15
95;18.05.2018;2018;05;21;Perjantai;6;9;15
95;18.05.2018;2018;05;22;Perjantai;0;5;5
95;18.05.2018;2018;05;23;Perjantai;2;0;2
95;19.05.2018;2018;05;00;Lauantai;2;0;2
95;19.05.2018;2018;05;01;Lauantai;0;0;0
95;19.05.2018;2018;05;02;Lauantai;1;0;1
95;19.05.2018;2018;05;03;Lauantai;0;1;1
95;19.05.2018;2018;05;04;Lauantai;1;1;2
95;19.05.2018;2018;05;05;Lauantai;0;2;2
95;19.05.2018;2018;05;06;Lauantai;4;1;5
95;19.05.2018;2018;05;07;Lauantai;6;3;9
95;19.05.2018;2018;05;08;Lauantai;7;2;9
95;19.05.2018;2018;05;09;Lauantai;15;11;26
95;19.05.2018;2018;05;10;Lauantai;1;6;7
95;19.05.2018;2018;05;11;Lauantai;15;12;27
95;19.05.2018;2018;05;12;Lauantai;27;17;44
95;19.05.2018;2018;05;13;Lauantai;20;13;33
95;19.05.2018;2018;05;14;Lauantai;23;29;52
95;19.05.2018;2018;05;15;Lauantai;16;16;32
95;19.05.2018;2018;05;16;Lauantai;17;20;37
95;19.05.2018;2018;05;17;Lauantai;7;20;27
95;19.05.2018;2018;05;18;Lauantai;7;12;19
95;19.05.2018;2018;05;19;Lauantai;13;10;23
95;19.05.2018;2018;05;20;Lauantai;11;18;29
95;19.05.2018;2018;05;21;Lauantai;1;4;5
95;19.05.2018;2018;05;22;Lauantai;2;0;2
95;19.05.2018;2018;05;23;Lauantai;2;5;7
95;20.05.2018;2018;05;00;Sunnuntai;1;1;2
95;20.05.2018;2018;05;01;Sunnuntai;2;1;3
95;20.05.2018;2018;05;02;Sunnuntai;0;1;1
95;20.05.2018;2018;05;03;Sunnuntai;0;3;3
95;20.05.2018;2018;05;04;Sunnuntai;1;1;2
95;20.05.2018;2018;05;05;Sunnuntai;1;1;2
95;20.05.2018;2018;05;06;Sunnuntai;2;0;2
95;20.05.2018;2018;05;07;Sunnuntai;2;5;7
95;20.05.2018;2018;05;08;Sunnuntai;11;6;17
95;20.05.2018;2018;05;09;Sunnuntai;18;4;22
95;20.05.2018;2018;05;10;Sunnuntai;18;14;32
95;20.05.2018;2018;05;11;Sunnuntai;16;23;39
95;20.05.2018;2018;05;12;Sunnuntai;16;23;39
95;20.05.2018;2018;05;13;Sunnuntai;30;19;49
95;20.05.2018;2018;05;14;Sunnuntai;17;30;47
95;20.05.2018;2018;05;15;Sunnuntai;18;14;32
95;20.05.2018;2018;05;16;Sunnuntai;19;13;32
95;20.05.2018;2018;05;17;Sunnuntai;13;17;30
95;20.05.2018;2018;05;18;Sunnuntai;18;15;33
95;20.05.2018;2018;05;19;Sunnuntai;23;17;40
95;20.05.2018;2018;05;20;Sunnuntai;4;8;12
95;20.05.2018;2018;05;21;Sunnuntai;2;7;9
95;20.05.2018;2018;05;22;Sunnuntai;1;1;2
95;20.05.2018;2018;05;23;Sunnuntai;0;3;3
95;21.05.2018;2018;05;00;Maanantai;0;2;2
95;21.05.2018;2018;05;01;Maanantai;0;0;0
95;21.05.2018;2018;05;02;Maanantai;0;0;0
95;21.05.2018;2018;05;03;Maanantai;1;0;1
95;21.05.2018;2018;05;04;Maanantai;1;1;2
95;21.05.2018;2018;05;05;Maanantai;10;9;19
95;21.05.2018;2018;05;06;Maanantai;32;19;51
95;21.05.2018;2018;05;07;Maanantai;31;32;63
95;21.05.2018;2018;05;08;Maanantai;10;21;31
95;21.05.2018;2018;05;09;Maanantai;12;23;35
95;21.05.2018;2018;05;10;Maanantai;14;14;28
95;21.05.2018;2018;05;11;Maanantai;25;14;39
95;21.05.2018;2018;05;12;Maanantai;12;20;32
95;21.05.2018;2018;05;13;Maanantai;21;20;41
95;21.05.2018;2018;05;14;Maanantai;33;27;60
95;21.05.2018;2018;05;15;Maanantai;39;36;75
95;21.05.2018;2018;05;16;Maanantai;46;57;103
95;21.05.2018;2018;05;17;Maanantai;17;35;52
95;21.05.2018;2018;05;18;Maanantai;26;37;63
95;21.05.2018;2018;05;19;Maanantai;28;28;56
95;21.05.2018;2018;05;20;Maanantai;23;21;44
95;21.05.2018;2018;05;21;Maanantai;6;12;18
95;21.05.2018;2018;05;22;Maanantai;2;0;2
95;21.05.2018;2018;05;23;Maanantai;4;0;4
95;22.05.2018;2018;05;00;Tiistai;1;2;3
95;22.05.2018;2018;05;01;Tiistai;0;0;0
95;22.05.2018;2018;05;02;Tiistai;0;0;0
95;22.05.2018;2018;05;03;Tiistai;0;0;0
95;22.05.2018;2018;05;04;Tiistai;1;0;1
95;22.05.2018;2018;05;05;Tiistai;13;8;21
95;22.05.2018;2018;05;06;Tiistai;45;16;61
95;22.05.2018;2018;05;07;Tiistai;40;51;91
95;22.05.2018;2018;05;08;Tiistai;25;21;46
95;22.05.2018;2018;05;09;Tiistai;13;10;23
95;22.05.2018;2018;05;10;Tiistai;19;17;36
95;22.05.2018;2018;05;11;Tiistai;14;15;29
95;22.05.2018;2018;05;12;Tiistai;12;24;36
95;22.05.2018;2018;05;13;Tiistai;15;27;42
95;22.05.2018;2018;05;14;Tiistai;37;26;63
95;22.05.2018;2018;05;15;Tiistai;42;44;86
95;22.05.2018;2018;05;16;Tiistai;41;67;108
95;22.05.2018;2018;05;17;Tiistai;34;39;73
95;22.05.2018;2018;05;18;Tiistai;32;25;57
95;22.05.2018;2018;05;19;Tiistai;26;24;50
95;22.05.2018;2018;05;20;Tiistai;17;18;35
95;22.05.2018;2018;05;21;Tiistai;10;15;25
95;22.05.2018;2018;05;22;Tiistai;2;4;6
95;22.05.2018;2018;05;23;Tiistai;1;3;4
95;23.05.2018;2018;05;00;Keskiviikko;1;0;1
95;23.05.2018;2018;05;01;Keskiviikko;1;3;4
95;23.05.2018;2018;05;02;Keskiviikko;0;0;0
95;23.05.2018;2018;05;03;Keskiviikko;0;0;0
95;23.05.2018;2018;05;04;Keskiviikko;1;0;1
95;23.05.2018;2018;05;05;Keskiviikko;11;7;18
95;23.05.2018;2018;05;06;Keskiviikko;27;11;38
95;23.05.2018;2018;05;07;Keskiviikko;38;40;78
95;23.05.2018;2018;05;08;Keskiviikko;9;14;23
95;23.05.2018;2018;05;09;Keskiviikko;5;13;18
95;23.05.2018;2018;05;10;Keskiviikko;7;8;15
95;23.05.2018;2018;05;11;Keskiviikko;8;12;20
95;23.05.2018;2018;05;12;Keskiviikko;7;11;18
95;23.05.2018;2018;05;13;Keskiviikko;15;10;25
95;23.05.2018;2018;05;14;Keskiviikko;13;21;34
95;23.05.2018;2018;05;15;Keskiviikko;23;23;46
95;23.05.2018;2018;05;16;Keskiviikko;28;28;56
95;23.05.2018;2018;05;17;Keskiviikko;20;22;42
95;23.05.2018;2018;05;18;Keskiviikko;11;11;22
95;23.05.2018;2018;05;19;Keskiviikko;12;21;33
95;23.05.2018;2018;05;20;Keskiviikko;18;8;26
95;23.05.2018;2018;05;21;Keskiviikko;5;8;13
95;23.05.2018;2018;05;22;Keskiviikko;3;3;6
95;23.05.2018;2018;05;23;Keskiviikko;1;0;1
95;24.05.2018;2018;05;00;Torstai;2;1;3
95;24.05.2018;2018;05;01;Torstai;0;0;0
95;24.05.2018;2018;05;02;Torstai;0;0;0
95;24.05.2018;2018;05;03;Torstai;1;0;1
95;24.05.2018;2018;05;04;Torstai;3;2;5
95;24.05.2018;2018;05;05;Torstai;12;6;18
95;24.05.2018;2018;05;06;Torstai;29;15;44
95;24.05.2018;2018;05;07;Torstai;26;32;58
95;24.05.2018;2018;05;08;Torstai;19;26;45
95;24.05.2018;2018;05;09;Torstai;10;20;30
95;24.05.2018;2018;05;10;Torstai;12;9;21
95;24.05.2018;2018;05;11;Torstai;15;10;25
95;24.05.2018;2018;05;12;Torstai;16;6;22
95;24.05.2018;2018;05;13;Torstai;11;14;25
95;24.05.2018;2018;05;14;Torstai;20;21;41
95;24.05.2018;2018;05;15;Torstai;31;26;57
95;24.05.2018;2018;05;16;Torstai;34;32;66
95;24.05.2018;2018;05;17;Torstai;17;32;49
95;24.05.2018;2018;05;18;Torstai;15;14;29
95;24.05.2018;2018;05;19;Torstai;16;14;30
95;24.05.2018;2018;05;20;Torstai;14;8;22
95;24.05.2018;2018;05;21;Torstai;2;14;16
95;24.05.2018;2018;05;22;Torstai;5;3;8
95;24.05.2018;2018;05;23;Torstai;1;0;1
95;25.05.2018;2018;05;00;Perjantai;0;1;1
95;25.05.2018;2018;05;01;Perjantai;0;1;1
95;25.05.2018;2018;05;02;Perjantai;0;1;1
95;25.05.2018;2018;05;03;Perjantai;0;0;0
95;25.05.2018;2018;05;04;Perjantai;2;0;2
95;25.05.2018;2018;05;05;Perjantai;11;3;14
95;25.05.2018;2018;05;06;Perjantai;25;19;44
95;25.05.2018;2018;05;07;Perjantai;31;34;65
95;25.05.2018;2018;05;08;Perjantai;19;16;35
95;25.05.2018;2018;05;09;Perjantai;16;14;30
95;25.05.2018;2018;05;10;Perjantai;10;13;23
95;25.05.2018;2018;05;11;Perjantai;19;11;30
95;25.05.2018;2018;05;12;Perjantai;24;15;39
95;25.05.2018;2018;05;13;Perjantai;13;19;32
95;25.05.2018;2018;05;14;Perjantai;25;26;51
95;25.05.2018;2018;05;15;Perjantai;33;36;69
95;25.05.2018;2018;05;16;Perjantai;31;40;71
95;25.05.2018;2018;05;17;Perjantai;23;25;48
95;25.05.2018;2018;05;18;Perjantai;26;19;45
95;25.05.2018;2018;05;19;Perjantai;22;21;43
95;25.05.2018;2018;05;20;Perjantai;5;17;22
95;25.05.2018;2018;05;21;Perjantai;1;9;10
95;25.05.2018;2018;05;22;Perjantai;3;3;6
95;25.05.2018;2018;05;23;Perjantai;1;0;1
95;26.05.2018;2018;05;00;Lauantai;0;3;3
95;26.05.2018;2018;05;01;Lauantai;1;2;3
95;26.05.2018;2018;05;02;Lauantai;0;0;0
95;26.05.2018;2018;05;03;Lauantai;0;0;0
95;26.05.2018;2018;05;04;Lauantai;0;0;0
95;26.05.2018;2018;05;05;Lauantai;2;1;3
95;26.05.2018;2018;05;06;Lauantai;6;1;7
95;26.05.2018;2018;05;07;Lauantai;8;15;23
95;26.05.2018;2018;05;08;Lauantai;5;7;12
95;26.05.2018;2018;05;09;Lauantai;14;4;18
95;26.05.2018;2018;05;10;Lauantai;19;8;27
95;26.05.2018;2018;05;11;Lauantai;18;14;32
95;26.05.2018;2018;05;12;Lauantai;21;10;31
95;26.05.2018;2018;05;13;Lauantai;16;13;29
95;26.05.2018;2018;05;14;Lauantai;21;16;37
95;26.05.2018;2018;05;15;Lauantai;19;22;41
95;26.05.2018;2018;05;16;Lauantai;13;27;40
95;26.05.2018;2018;05;17;Lauantai;8;15;23
95;26.05.2018;2018;05;18;Lauantai;17;5;22
95;26.05.2018;2018;05;19;Lauantai;6;10;16
95;26.05.2018;2018;05;20;Lauantai;7;7;14
95;26.05.2018;2018;05;21;Lauantai;2;4;6
95;26.05.2018;2018;05;22;Lauantai;0;7;7
95;26.05.2018;2018;05;23;Lauantai;1;1;2
95;27.05.2018;2018;05;00;Sunnuntai;1;3;4
95;27.05.2018;2018;05;01;Sunnuntai;0;2;2
95;27.05.2018;2018;05;02;Sunnuntai;0;0;0
95;27.05.2018;2018;05;03;Sunnuntai;0;0;0
95;27.05.2018;2018;05;04;Sunnuntai;0;3;3
95;27.05.2018;2018;05;05;Sunnuntai;0;0;0
95;27.05.2018;2018;05;06;Sunnuntai;3;2;5
95;27.05.2018;2018;05;07;Sunnuntai;1;4;5
95;27.05.2018;2018;05;08;Sunnuntai;6;5;11
95;27.05.2018;2018;05;09;Sunnuntai;9;10;19
95;27.05.2018;2018;05;10;Sunnuntai;17;14;31
95;27.05.2018;2018;05;11;Sunnuntai;24;21;45
95;27.05.2018;2018;05;12;Sunnuntai;17;17;34
95;27.05.2018;2018;05;13;Sunnuntai;13;14;27
95;27.05.2018;2018;05;14;Sunnuntai;17;17;34
95;27.05.2018;2018;05;15;Sunnuntai;13;22;35
95;27.05.2018;2018;05;16;Sunnuntai;11;8;19
95;27.05.2018;2018;05;17;Sunnuntai;8;14;22
95;27.05.2018;2018;05;18;Sunnuntai;18;15;33
95;27.05.2018;2018;05;19;Sunnuntai;6;18;24
95;27.05.2018;2018;05;20;Sunnuntai;10;11;21
95;27.05.2018;2018;05;21;Sunnuntai;4;8;12
95;27.05.2018;2018;05;22;Sunnuntai;4;6;10
95;27.05.2018;2018;05;23;Sunnuntai;0;0;0
95;28.05.2018;2018;05;00;Maanantai;2;1;3
95;28.05.2018;2018;05;01;Maanantai;0;0;0
95;28.05.2018;2018;05;02;Maanantai;0;0;0
95;28.05.2018;2018;05;03;Maanantai;0;0;0
95;28.05.2018;2018;05;04;Maanantai;1;0;1
95;28.05.2018;2018;05;05;Maanantai;11;9;20
95;28.05.2018;2018;05;06;Maanantai;22;17;39
95;28.05.2018;2018;05;07;Maanantai;35;39;74
95;28.05.2018;2018;05;08;Maanantai;23;27;50
95;28.05.2018;2018;05;09;Maanantai;11;13;24
95;28.05.2018;2018;05;10;Maanantai;11;14;25
95;28.05.2018;2018;05;11;Maanantai;13;8;21
95;28.05.2018;2018;05;12;Maanantai;11;13;24
95;28.05.2018;2018;05;13;Maanantai;14;14;28
95;28.05.2018;2018;05;14;Maanantai;15;22;37
95;28.05.2018;2018;05;15;Maanantai;31;29;60
95;28.05.2018;2018;05;16;Maanantai;47;46;93
95;28.05.2018;2018;05;17;Maanantai;22;34;56
95;28.05.2018;2018;05;18;Maanantai;19;21;40
95;28.05.2018;2018;05;19;Maanantai;12;17;29
95;28.05.2018;2018;05;20;Maanantai;13;12;25
95;28.05.2018;2018;05;21;Maanantai;6;7;13
95;28.05.2018;2018;05;22;Maanantai;1;2;3
95;28.05.2018;2018;05;23;Maanantai;0;0;0
95;29.05.2018;2018;05;00;Tiistai;0;1;1
95;29.05.2018;2018;05;01;Tiistai;0;0;0
95;29.05.2018;2018;05;02;Tiistai;1;0;1
95;29.05.2018;2018;05;03;Tiistai;0;0;0
95;29.05.2018;2018;05;04;Tiistai;1;0;1
95;29.05.2018;2018;05;05;Tiistai;11;7;18
95;29.05.2018;2018;05;06;Tiistai;25;18;43
95;29.05.2018;2018;05;07;Tiistai;36;27;63
95;29.05.2018;2018;05;08;Tiistai;24;28;52
95;29.05.2018;2018;05;09;Tiistai;18;12;30
95;29.05.2018;2018;05;10;Tiistai;26;13;39
95;29.05.2018;2018;05;11;Tiistai;15;16;31
95;29.05.2018;2018;05;12;Tiistai;18;19;37
95;29.05.2018;2018;05;13;Tiistai;24;18;42
95;29.05.2018;2018;05;14;Tiistai;17;19;36
95;29.05.2018;2018;05;15;Tiistai;32;32;64
95;29.05.2018;2018;05;16;Tiistai;39;56;95
95;29.05.2018;2018;05;17;Tiistai;15;49;64
95;29.05.2018;2018;05;18;Tiistai;13;12;25
95;29.05.2018;2018;05;19;Tiistai;38;17;55
95;29.05.2018;2018;05;20;Tiistai;13;9;22
95;29.05.2018;2018;05;21;Tiistai;9;12;21
95;29.05.2018;2018;05;22;Tiistai;4;4;8
95;29.05.2018;2018;05;23;Tiistai;0;0;0
95;30.05.2018;2018;05;00;Keskiviikko;0;0;0
95;30.05.2018;2018;05;01;Keskiviikko;1;1;2
95;30.05.2018;2018;05;02;Keskiviikko;0;0;0
95;30.05.2018;2018;05;03;Keskiviikko;0;0;0
95;30.05.2018;2018;05;04;Keskiviikko;1;2;3
95;30.05.2018;2018;05;05;Keskiviikko;7;5;12
95;30.05.2018;2018;05;06;Keskiviikko;23;20;43
95;30.05.2018;2018;05;07;Keskiviikko;33;31;64
95;30.05.2018;2018;05;08;Keskiviikko;15;28;43
95;30.05.2018;2018;05;09;Keskiviikko;19;9;28
95;30.05.2018;2018;05;10;Keskiviikko;15;10;25
95;30.05.2018;2018;05;11;Keskiviikko;8;7;15
95;30.05.2018;2018;05;12;Keskiviikko;15;13;28
95;30.05.2018;2018;05;13;Keskiviikko;8;7;15
95;30.05.2018;2018;05;14;Keskiviikko;16;22;38
95;30.05.2018;2018;05;15;Keskiviikko;32;19;51
95;30.05.2018;2018;05;16;Keskiviikko;31;32;63
95;30.05.2018;2018;05;17;Keskiviikko;10;23;33
95;30.05.2018;2018;05;18;Keskiviikko;19;18;37
95;30.05.2018;2018;05;19;Keskiviikko;14;18;32
95;30.05.2018;2018;05;20;Keskiviikko;6;13;19
95;30.05.2018;2018;05;21;Keskiviikko;4;7;11
95;30.05.2018;2018;05;22;Keskiviikko;5;6;11
95;30.05.2018;2018;05;23;Keskiviikko;2;0;2
95;31.05.2018;2018;05;00;Torstai;0;1;1
95;31.05.2018;2018;05;01;Torstai;0;0;0
95;31.05.2018;2018;05;02;Torstai;3;0;3
95;31.05.2018;2018;05;03;Torstai;0;0;0
95;31.05.2018;2018;05;04;Torstai;1;2;3
95;31.05.2018;2018;05;05;Torstai;8;5;13
95;31.05.2018;2018;05;06;Torstai;26;12;38
95;31.05.2018;2018;05;07;Torstai;31;27;58
95;31.05.2018;2018;05;08;Torstai;12;22;34
95;31.05.2018;2018;05;09;Torstai;18;5;23
95;31.05.2018;2018;05;10;Torstai;20;8;28
95;31.05.2018;2018;05;11;Torstai;12;19;31
95;31.05.2018;2018;05;12;Torstai;14;18;32
95;31.05.2018;2018;05;13;Torstai;15;13;28
95;31.05.2018;2018;05;14;Torstai;20;16;36
95;31.05.2018;2018;05;15;Torstai;36;33;69
95;31.05.2018;2018;05;16;Torstai;25;34;59
95;31.05.2018;2018;05;17;Torstai;22;29;51
95;31.05.2018;2018;05;18;Torstai;15;22;37
95;31.05.2018;2018;05;19;Torstai;12;18;30
95;31.05.2018;2018;05;20;Torstai;8;11;19
95;31.05.2018;2018;05;21;Torstai;8;11;19
95;31.05.2018;2018;05;22;Torstai;3;2;5
95;31.05.2018;2018;05;23;Torstai;0;2;2
95;01.06.2018;2018;06;00;Perjantai;1;0;1
95;01.06.2018;2018;06;01;Perjantai;1;0;1
95;01.06.2018;2018;06;02;Perjantai;1;0;1
95;01.06.2018;2018;06;03;Perjantai;0;0;0
95;01.06.2018;2018;06;04;Perjantai;2;0;2
95;01.06.2018;2018;06;05;Perjantai;14;0;14
95;01.06.2018;2018;06;06;Perjantai;44;0;44
95;01.06.2018;2018;06;07;Perjantai;65;0;65
95;01.06.2018;2018;06;08;Perjantai;35;0;35
95;01.06.2018;2018;06;09;Perjantai;30;0;30
95;01.06.2018;2018;06;10;Perjantai;23;0;23
95;01.06.2018;2018;06;11;Perjantai;30;0;30
95;01.06.2018;2018;06;12;Perjantai;39;0;39
95;01.06.2018;2018;06;13;Perjantai;32;0;32
95;01.06.2018;2018;06;14;Perjantai;51;0;51
95;01.06.2018;2018;06;15;Perjantai;69;0;69
95;01.06.2018;2018;06;16;Perjantai;71;0;71
95;01.06.2018;2018;06;17;Perjantai;48;0;48
95;01.06.2018;2018;06;18;Perjantai;45;0;45
95;01.06.2018;2018;06;19;Perjantai;43;0;43
95;01.06.2018;2018;06;20;Perjantai;22;0;22
95;01.06.2018;2018;06;21;Perjantai;10;0;10
95;01.06.2018;2018;06;22;Perjantai;6;0;6
95;01.06.2018;2018;06;23;Perjantai;1;0;1
95;02.06.2018;2018;06;00;Lauantai;1;3;4
95;02.06.2018;2018;06;01;Lauantai;0;1;1
95;02.06.2018;2018;06;02;Lauantai;0;2;2
95;02.06.2018;2018;06;03;Lauantai;0;0;0
95;02.06.2018;2018;06;04;Lauantai;2;0;2
95;02.06.2018;2018;06;05;Lauantai;0;5;5
95;02.06.2018;2018;06;06;Lauantai;1;1;2
95;02.06.2018;2018;06;07;Lauantai;4;10;14
95;02.06.2018;2018;06;08;Lauantai;11;9;20
95;02.06.2018;2018;06;09;Lauantai;15;14;29
95;02.06.2018;2018;06;10;Lauantai;28;25;53
95;02.06.2018;2018;06;11;Lauantai;20;22;42
95;02.06.2018;2018;06;12;Lauantai;20;19;39
95;02.06.2018;2018;06;13;Lauantai;28;26;54
95;02.06.2018;2018;06;14;Lauantai;20;27;47
95;02.06.2018;2018;06;15;Lauantai;26;19;45
95;02.06.2018;2018;06;16;Lauantai;22;18;40
95;02.06.2018;2018;06;17;Lauantai;9;21;30
95;02.06.2018;2018;06;18;Lauantai;18;17;35
95;02.06.2018;2018;06;19;Lauantai;19;13;32
95;02.06.2018;2018;06;20;Lauantai;1;5;6
95;02.06.2018;2018;06;21;Lauantai;4;4;8
95;02.06.2018;2018;06;22;Lauantai;1;6;7
95;02.06.2018;2018;06;23;Lauantai;4;0;4
95;03.06.2018;2018;06;00;Sunnuntai;2;1;3
95;03.06.2018;2018;06;01;Sunnuntai;1;3;4
95;03.06.2018;2018;06;02;Sunnuntai;1;1;2
95;03.06.2018;2018;06;03;Sunnuntai;1;5;6
95;03.06.2018;2018;06;04;Sunnuntai;0;0;0
95;03.06.2018;2018;06;05;Sunnuntai;1;2;3
95;03.06.2018;2018;06;06;Sunnuntai;3;1;4
95;03.06.2018;2018;06;07;Sunnuntai;6;4;10
95;03.06.2018;2018;06;08;Sunnuntai;5;1;6
95;03.06.2018;2018;06;09;Sunnuntai;8;9;17
95;03.06.2018;2018;06;10;Sunnuntai;16;12;28
95;03.06.2018;2018;06;11;Sunnuntai;22;21;43
95;03.06.2018;2018;06;12;Sunnuntai;16;21;37
95;03.06.2018;2018;06;13;Sunnuntai;29;13;42
95;03.06.2018;2018;06;14;Sunnuntai;11;10;21
95;03.06.2018;2018;06;15;Sunnuntai;18;14;32
95;03.06.2018;2018;06;16;Sunnuntai;13;19;32
95;03.06.2018;2018;06;17;Sunnuntai;21;16;37
95;03.06.2018;2018;06;18;Sunnuntai;17;16;33
95;03.06.2018;2018;06;19;Sunnuntai;12;12;24
95;03.06.2018;2018;06;20;Sunnuntai;6;11;17
95;03.06.2018;2018;06;21;Sunnuntai;4;4;8
95;03.06.2018;2018;06;22;Sunnuntai;5;11;16
95;03.06.2018;2018;06;23;Sunnuntai;1;0;1
95;04.06.2018;2018;06;00;Maanantai;0;0;0
95;04.06.2018;2018;06;01;Maanantai;0;0;0
95;04.06.2018;2018;06;02;Maanantai;1;4;5
95;04.06.2018;2018;06;03;Maanantai;1;0;1
95;04.06.2018;2018;06;04;Maanantai;1;0;1
95;04.06.2018;2018;06;05;Maanantai;10;6;16
95;04.06.2018;2018;06;06;Maanantai;11;11;22
95;04.06.2018;2018;06;07;Maanantai;7;10;17
95;04.06.2018;2018;06;08;Maanantai;9;4;13
95;04.06.2018;2018;06;09;Maanantai;5;5;10
95;04.06.2018;2018;06;10;Maanantai;2;5;7
95;04.06.2018;2018;06;11;Maanantai;3;2;5
95;04.06.2018;2018;06;12;Maanantai;8;4;12
95;04.06.2018;2018;06;13;Maanantai;2;11;13
95;04.06.2018;2018;06;14;Maanantai;7;10;17
95;04.06.2018;2018;06;15;Maanantai;16;21;37
95;04.06.2018;2018;06;16;Maanantai;9;16;25
95;04.06.2018;2018;06;17;Maanantai;8;10;18
95;04.06.2018;2018;06;18;Maanantai;2;5;7
95;04.06.2018;2018;06;19;Maanantai;2;5;7
95;04.06.2018;2018;06;20;Maanantai;1;2;3
95;04.06.2018;2018;06;21;Maanantai;4;1;5
95;04.06.2018;2018;06;22;Maanantai;3;2;5
95;04.06.2018;2018;06;23;Maanantai;1;1;2
95;05.06.2018;2018;06;00;Tiistai;1;0;1
95;05.06.2018;2018;06;01;Tiistai;0;0;0
95;05.06.2018;2018;06;02;Tiistai;0;0;0
95;05.06.2018;2018;06;03;Tiistai;0;0;0
95;05.06.2018;2018;06;04;Tiistai;0;0;0
95;05.06.2018;2018;06;05;Tiistai;9;5;14
95;05.06.2018;2018;06;06;Tiistai;12;10;22
95;05.06.2018;2018;06;07;Tiistai;11;16;27
95;05.06.2018;2018;06;08;Tiistai;6;4;10
95;05.06.2018;2018;06;09;Tiistai;7;7;14
95;05.06.2018;2018;06;10;Tiistai;7;5;12
95;05.06.2018;2018;06;11;Tiistai;7;10;17
95;05.06.2018;2018;06;12;Tiistai;10;5;15
95;05.06.2018;2018;06;13;Tiistai;7;10;17
95;05.06.2018;2018;06;14;Tiistai;10;11;21
95;05.06.2018;2018;06;15;Tiistai;19;19;38
95;05.06.2018;2018;06;16;Tiistai;18;29;47
95;05.06.2018;2018;06;17;Tiistai;10;19;29
95;05.06.2018;2018;06;18;Tiistai;5;15;20
95;05.06.2018;2018;06;19;Tiistai;8;4;12
95;05.06.2018;2018;06;20;Tiistai;5;9;14
95;05.06.2018;2018;06;21;Tiistai;3;2;5
95;05.06.2018;2018;06;22;Tiistai;3;2;5
95;05.06.2018;2018;06;23;Tiistai;1;0;1
95;06.06.2018;2018;06;00;Keskiviikko;0;0;0
95;06.06.2018;2018;06;01;Keskiviikko;1;0;1
95;06.06.2018;2018;06;02;Keskiviikko;0;0;0
95;06.06.2018;2018;06;03;Keskiviikko;0;0;0
95;06.06.2018;2018;06;04;Keskiviikko;0;0;0
95;06.06.2018;2018;06;05;Keskiviikko;12;3;15
95;06.06.2018;2018;06;06;Keskiviikko;18;16;34
95;06.06.2018;2018;06;07;Keskiviikko;20;21;41
95;06.06.2018;2018;06;08;Keskiviikko;10;6;16
95;06.06.2018;2018;06;09;Keskiviikko;8;7;15
95;06.06.2018;2018;06;10;Keskiviikko;8;7;15
95;06.06.2018;2018;06;11;Keskiviikko;11;5;16
95;06.06.2018;2018;06;12;Keskiviikko;5;10;15
95;06.06.2018;2018;06;13;Keskiviikko;0;7;7
95;06.06.2018;2018;06;14;Keskiviikko;9;15;24
95;06.06.2018;2018;06;15;Keskiviikko;22;21;43
95;06.06.2018;2018;06;16;Keskiviikko;25;23;48
95;06.06.2018;2018;06;17;Keskiviikko;11;15;26
95;06.06.2018;2018;06;18;Keskiviikko;16;14;30
95;06.06.2018;2018;06;19;Keskiviikko;8;14;22
95;06.06.2018;2018;06;20;Keskiviikko;7;8;15
95;06.06.2018;2018;06;21;Keskiviikko;3;2;5
95;06.06.2018;2018;06;22;Keskiviikko;2;2;4
95;06.06.2018;2018;06;23;Keskiviikko;1;1;2
95;07.06.2018;2018;06;00;Torstai;0;0;0
95;07.06.2018;2018;06;01;Torstai;0;0;0
95;07.06.2018;2018;06;02;Torstai;0;0;0
95;07.06.2018;2018;06;03;Torstai;0;0;0
95;07.06.2018;2018;06;04;Torstai;1;1;2
95;07.06.2018;2018;06;05;Torstai;11;3;14
95;07.06.2018;2018;06;06;Torstai;4;9;13
95;07.06.2018;2018;06;07;Torstai;6;10;16
95;07.06.2018;2018;06;08;Torstai;6;3;9
95;07.06.2018;2018;06;09;Torstai;2;3;5
95;07.06.2018;2018;06;10;Torstai;0;0;0
95;07.06.2018;2018;06;11;Torstai;3;5;8
95;07.06.2018;2018;06;12;Torstai;2;1;3
95;07.06.2018;2018;06;13;Torstai;3;5;8
95;07.06.2018;2018;06;14;Torstai;6;7;13
95;07.06.2018;2018;06;15;Torstai;9;17;26
95;07.06.2018;2018;06;16;Torstai;19;13;32
95;07.06.2018;2018;06;17;Torstai;11;12;23
95;07.06.2018;2018;06;18;Torstai;11;10;21
95;07.06.2018;2018;06;19;Torstai;9;8;17
95;07.06.2018;2018;06;20;Torstai;9;12;21
95;07.06.2018;2018;06;21;Torstai;4;1;5
95;07.06.2018;2018;06;22;Torstai;4;3;7
95;07.06.2018;2018;06;23;Torstai;0;0;0
95;08.06.2018;2018;06;00;Perjantai;1;0;1
95;08.06.2018;2018;06;01;Perjantai;0;0;0
95;08.06.2018;2018;06;02;Perjantai;0;0;0
95;08.06.2018;2018;06;03;Perjantai;0;0;0
95;08.06.2018;2018;06;04;Perjantai;1;0;1
95;08.06.2018;2018;06;05;Perjantai;10;3;13
95;08.06.2018;2018;06;06;Perjantai;13;11;24
95;08.06.2018;2018;06;07;Perjantai;18;14;32
95;08.06.2018;2018;06;08;Perjantai;10;10;20
95;08.06.2018;2018;06;09;Perjantai;1;0;1
95;08.06.2018;2018;06;10;Perjantai;12;9;21
95;08.06.2018;2018;06;11;Perjantai;6;6;12
95;08.06.2018;2018;06;12;Perjantai;14;14;28
95;08.06.2018;2018;06;13;Perjantai;12;12;24
95;08.06.2018;2018;06;14;Perjantai;11;10;21
95;08.06.2018;2018;06;15;Perjantai;24;24;48
95;08.06.2018;2018;06;16;Perjantai;31;16;47
95;08.06.2018;2018;06;17;Perjantai;18;18;36
95;08.06.2018;2018;06;18;Perjantai;8;12;20
95;08.06.2018;2018;06;19;Perjantai;7;15;22
95;08.06.2018;2018;06;20;Perjantai;13;5;18
95;08.06.2018;2018;06;21;Perjantai;4;11;15
95;08.06.2018;2018;06;22;Perjantai;4;3;7
95;08.06.2018;2018;06;23;Perjantai;1;2;3
95;09.06.2018;2018;06;00;Lauantai;0;1;1
95;09.06.2018;2018;06;01;Lauantai;0;2;2
95;09.06.2018;2018;06;02;Lauantai;1;0;1
95;09.06.2018;2018;06;03;Lauantai;0;0;0
95;09.06.2018;2018;06;04;Lauantai;0;2;2
95;09.06.2018;2018;06;05;Lauantai;0;2;2
95;09.06.2018;2018;06;06;Lauantai;3;3;6
95;09.06.2018;2018;06;07;Lauantai;3;3;6
95;09.06.2018;2018;06;08;Lauantai;12;5;17
95;09.06.2018;2018;06;09;Lauantai;8;6;14
95;09.06.2018;2018;06;10;Lauantai;16;17;33
95;09.06.2018;2018;06;11;Lauantai;14;14;28
95;09.06.2018;2018;06;12;Lauantai;18;20;38
95;09.06.2018;2018;06;13;Lauantai;14;15;29
95;09.06.2018;2018;06;14;Lauantai;13;15;28
95;09.06.2018;2018;06;15;Lauantai;14;11;25
95;09.06.2018;2018;06;16;Lauantai;13;15;28
95;09.06.2018;2018;06;17;Lauantai;10;13;23
95;09.06.2018;2018;06;18;Lauantai;8;12;20
95;09.06.2018;2018;06;19;Lauantai;10;13;23
95;09.06.2018;2018;06;20;Lauantai;4;9;13
95;09.06.2018;2018;06;21;Lauantai;6;8;14
95;09.06.2018;2018;06;22;Lauantai;7;6;13
95;09.06.2018;2018;06;23;Lauantai;3;2;5
95;10.06.2018;2018;06;00;Sunnuntai;1;0;1
95;10.06.2018;2018;06;01;Sunnuntai;0;0;0
95;10.06.2018;2018;06;02;Sunnuntai;0;2;2
95;10.06.2018;2018;06;03;Sunnuntai;1;2;3
95;10.06.2018;2018;06;04;Sunnuntai;0;1;1
95;10.06.2018;2018;06;05;Sunnuntai;1;1;2
95;10.06.2018;2018;06;06;Sunnuntai;1;2;3
95;10.06.2018;2018;06;07;Sunnuntai;2;1;3
95;10.06.2018;2018;06;08;Sunnuntai;4;5;9
95;10.06.2018;2018;06;09;Sunnuntai;8;4;12
95;10.06.2018;2018;06;10;Sunnuntai;10;29;39
95;10.06.2018;2018;06;11;Sunnuntai;22;13;35
95;10.06.2018;2018;06;12;Sunnuntai;31;15;46
95;10.06.2018;2018;06;13;Sunnuntai;15;22;37
95;10.06.2018;2018;06;14;Sunnuntai;23;8;31
95;10.06.2018;2018;06;15;Sunnuntai;20;21;41
95;10.06.2018;2018;06;16;Sunnuntai;23;14;37
95;10.06.2018;2018;06;17;Sunnuntai;17;13;30
95;10.06.2018;2018;06;18;Sunnuntai;17;16;33
95;10.06.2018;2018;06;19;Sunnuntai;29;13;42
95;10.06.2018;2018;06;20;Sunnuntai;13;14;27
95;10.06.2018;2018;06;21;Sunnuntai;7;10;17
95;10.06.2018;2018;06;22;Sunnuntai;3;3;6
95;10.06.2018;2018;06;23;Sunnuntai;1;1;2
95;11.06.2018;2018;06;00;Maanantai;3;2;5
95;11.06.2018;2018;06;01;Maanantai;0;0;0
95;11.06.2018;2018;06;02;Maanantai;1;0;1
95;11.06.2018;2018;06;03;Maanantai;2;1;3
95;11.06.2018;2018;06;04;Maanantai;1;1;2
95;11.06.2018;2018;06;05;Maanantai;7;6;13
95;11.06.2018;2018;06;06;Maanantai;25;14;39
95;11.06.2018;2018;06;07;Maanantai;32;26;58
95;11.06.2018;2018;06;08;Maanantai;13;16;29
95;11.06.2018;2018;06;09;Maanantai;14;16;30
95;11.06.2018;2018;06;10;Maanantai;14;17;31
95;11.06.2018;2018;06;11;Maanantai;19;13;32
95;11.06.2018;2018;06;12;Maanantai;16;12;28
95;11.06.2018;2018;06;13;Maanantai;12;12;24
95;11.06.2018;2018;06;14;Maanantai;16;25;41
95;11.06.2018;2018;06;15;Maanantai;28;25;53
95;11.06.2018;2018;06;16;Maanantai;28;53;81
95;11.06.2018;2018;06;17;Maanantai;12;25;37
95;11.06.2018;2018;06;18;Maanantai;29;29;58
95;11.06.2018;2018;06;19;Maanantai;22;27;49
95;11.06.2018;2018;06;20;Maanantai;20;20;40
95;11.06.2018;2018;06;21;Maanantai;7;12;19
95;11.06.2018;2018;06;22;Maanantai;3;3;6
95;11.06.2018;2018;06;23;Maanantai;1;0;1
95;12.06.2018;2018;06;00;Tiistai;0;0;0
95;12.06.2018;2018;06;01;Tiistai;0;0;0
95;12.06.2018;2018;06;02;Tiistai;1;1;2
95;12.06.2018;2018;06;03;Tiistai;1;0;1
95;12.06.2018;2018;06;04;Tiistai;2;1;3
95;12.06.2018;2018;06;05;Tiistai;7;6;13
95;12.06.2018;2018;06;06;Tiistai;31;17;48
95;12.06.2018;2018;06;07;Tiistai;18;31;49
95;12.06.2018;2018;06;08;Tiistai;17;11;28
95;12.06.2018;2018;06;09;Tiistai;15;8;23
95;12.06.2018;2018;06;10;Tiistai;6;7;13
95;12.06.2018;2018;06;11;Tiistai;10;8;18
95;12.06.2018;2018;06;12;Tiistai;11;17;28
95;12.06.2018;2018;06;13;Tiistai;8;11;19
95;12.06.2018;2018;06;14;Tiistai;19;9;28
95;12.06.2018;2018;06;15;Tiistai;30;28;58
95;12.06.2018;2018;06;16;Tiistai;36;39;75
95;12.06.2018;2018;06;17;Tiistai;8;21;29
95;12.06.2018;2018;06;18;Tiistai;14;16;30
95;12.06.2018;2018;06;19;Tiistai;12;14;26
95;12.06.2018;2018;06;20;Tiistai;8;8;16
95;12.06.2018;2018;06;21;Tiistai;10;4;14
95;12.06.2018;2018;06;22;Tiistai;7;3;10
95;12.06.2018;2018;06;23;Tiistai;0;1;1
95;13.06.2018;2018;06;00;Keskiviikko;0;2;2
95;13.06.2018;2018;06;01;Keskiviikko;0;0;0
95;13.06.2018;2018;06;02;Keskiviikko;0;0;0
95;13.06.2018;2018;06;03;Keskiviikko;0;0;0
95;13.06.2018;2018;06;04;Keskiviikko;1;1;2
95;13.06.2018;2018;06;05;Keskiviikko;8;2;10
95;13.06.2018;2018;06;06;Keskiviikko;17;13;30
95;13.06.2018;2018;06;07;Keskiviikko;26;25;51
95;13.06.2018;2018;06;08;Keskiviikko;16;13;29
95;13.06.2018;2018;06;09;Keskiviikko;6;16;22
95;13.06.2018;2018;06;10;Keskiviikko;15;19;34
95;13.06.2018;2018;06;11;Keskiviikko;11;8;19
95;13.06.2018;2018;06;12;Keskiviikko;19;16;35
95;13.06.2018;2018;06;13;Keskiviikko;14;18;32
95;13.06.2018;2018;06;14;Keskiviikko;12;12;24
95;13.06.2018;2018;06;15;Keskiviikko;32;30;62
95;13.06.2018;2018;06;16;Keskiviikko;32;38;70
95;13.06.2018;2018;06;17;Keskiviikko;20;24;44
95;13.06.2018;2018;06;18;Keskiviikko;20;23;43
95;13.06.2018;2018;06;19;Keskiviikko;13;16;29
95;13.06.2018;2018;06;20;Keskiviikko;12;11;23
95;13.06.2018;2018;06;21;Keskiviikko;1;7;8
95;13.06.2018;2018;06;22;Keskiviikko;8;9;17
95;13.06.2018;2018;06;23;Keskiviikko;1;0;1
95;14.06.2018;2018;06;00;Torstai;2;0;2
95;14.06.2018;2018;06;01;Torstai;0;0;0
95;14.06.2018;2018;06;02;Torstai;0;0;0
95;14.06.2018;2018;06;03;Torstai;1;1;2
95;14.06.2018;2018;06;04;Torstai;2;0;2
95;14.06.2018;2018;06;05;Torstai;7;5;12
95;14.06.2018;2018;06;06;Torstai;22;15;37
95;14.06.2018;2018;06;07;Torstai;25;27;52
95;14.06.2018;2018;06;08;Torstai;16;16;32
95;14.06.2018;2018;06;09;Torstai;13;10;23
95;14.06.2018;2018;06;10;Torstai;14;14;28
95;14.06.2018;2018;06;11;Torstai;23;19;42
95;14.06.2018;2018;06;12;Torstai;28;16;44
95;14.06.2018;2018;06;13;Torstai;14;16;30
95;14.06.2018;2018;06;14;Torstai;16;26;42
95;14.06.2018;2018;06;15;Torstai;28;26;54
95;14.06.2018;2018;06;16;Torstai;44;39;83
95;14.06.2018;2018;06;17;Torstai;15;37;52
95;14.06.2018;2018;06;18;Torstai;19;13;32
95;14.06.2018;2018;06;19;Torstai;14;25;39
95;14.06.2018;2018;06;20;Torstai;5;12;17
95;14.06.2018;2018;06;21;Torstai;6;13;19
95;14.06.2018;2018;06;22;Torstai;8;8;16
95;14.06.2018;2018;06;23;Torstai;4;2;6
95;15.06.2018;2018;06;00;Perjantai;2;0;2
95;15.06.2018;2018;06;01;Perjantai;0;0;0
95;15.06.2018;2018;06;02;Perjantai;6;2;8
95;15.06.2018;2018;06;03;Perjantai;1;0;1
95;15.06.2018;2018;06;04;Perjantai;1;0;1
95;15.06.2018;2018;06;05;Perjantai;12;6;18
95;15.06.2018;2018;06;06;Perjantai;15;15;30
95;15.06.2018;2018;06;07;Perjantai;18;11;29
95;15.06.2018;2018;06;08;Perjantai;7;14;21
95;15.06.2018;2018;06;09;Perjantai;11;6;17
95;15.06.2018;2018;06;10;Perjantai;8;14;22
95;15.06.2018;2018;06;11;Perjantai;17;9;26
95;15.06.2018;2018;06;12;Perjantai;14;11;25
95;15.06.2018;2018;06;13;Perjantai;16;6;22
95;15.06.2018;2018;06;14;Perjantai;24;22;46
95;15.06.2018;2018;06;15;Perjantai;25;25;50
95;15.06.2018;2018;06;16;Perjantai;23;25;48
95;15.06.2018;2018;06;17;Perjantai;16;13;29
95;15.06.2018;2018;06;18;Perjantai;16;16;32
95;15.06.2018;2018;06;19;Perjantai;16;7;23
95;15.06.2018;2018;06;20;Perjantai;9;5;14
95;15.06.2018;2018;06;21;Perjantai;7;8;15
95;15.06.2018;2018;06;22;Perjantai;1;3;4
95;15.06.2018;2018;06;23;Perjantai;2;2;4
95;16.06.2018;2018;06;00;Lauantai;0;3;3
95;16.06.2018;2018;06;01;Lauantai;0;3;3
95;16.06.2018;2018;06;02;Lauantai;2;1;3
95;16.06.2018;2018;06;03;Lauantai;1;0;1
95;16.06.2018;2018;06;04;Lauantai;1;1;2
95;16.06.2018;2018;06;05;Lauantai;3;4;7
95;16.06.2018;2018;06;06;Lauantai;2;0;2
95;16.06.2018;2018;06;07;Lauantai;3;2;5
95;16.06.2018;2018;06;08;Lauantai;14;8;22
95;16.06.2018;2018;06;09;Lauantai;8;12;20
95;16.06.2018;2018;06;10;Lauantai;20;19;39
95;16.06.2018;2018;06;11;Lauantai;32;22;54
95;16.06.2018;2018;06;12;Lauantai;23;23;46
95;16.06.2018;2018;06;13;Lauantai;20;19;39
95;16.06.2018;2018;06;14;Lauantai;23;18;41
95;16.06.2018;2018;06;15;Lauantai;21;19;40
95;16.06.2018;2018;06;16;Lauantai;15;16;31
95;16.06.2018;2018;06;17;Lauantai;17;25;42
95;16.06.2018;2018;06;18;Lauantai;24;19;43
95;16.06.2018;2018;06;19;Lauantai;9;13;22
95;16.06.2018;2018;06;20;Lauantai;7;9;16
95;16.06.2018;2018;06;21;Lauantai;11;8;19
95;16.06.2018;2018;06;22;Lauantai;2;4;6
95;16.06.2018;2018;06;23;Lauantai;2;3;5
95;17.06.2018;2018;06;00;Sunnuntai;2;1;3
95;17.06.2018;2018;06;01;Sunnuntai;0;7;7
95;17.06.2018;2018;06;02;Sunnuntai;1;4;5
95;17.06.2018;2018;06;03;Sunnuntai;0;2;2
95;17.06.2018;2018;06;04;Sunnuntai;1;3;4
95;17.06.2018;2018;06;05;Sunnuntai;2;0;2
95;17.06.2018;2018;06;06;Sunnuntai;2;3;5
95;17.06.2018;2018;06;07;Sunnuntai;3;2;5
95;17.06.2018;2018;06;08;Sunnuntai;7;5;12
95;17.06.2018;2018;06;09;Sunnuntai;14;14;28
95;17.06.2018;2018;06;10;Sunnuntai;18;24;42
95;17.06.2018;2018;06;11;Sunnuntai;37;17;54
95;17.06.2018;2018;06;12;Sunnuntai;35;28;63
95;17.06.2018;2018;06;13;Sunnuntai;26;29;55
95;17.06.2018;2018;06;14;Sunnuntai;33;42;75
95;17.06.2018;2018;06;15;Sunnuntai;27;22;49
95;17.06.2018;2018;06;16;Sunnuntai;21;24;45
95;17.06.2018;2018;06;17;Sunnuntai;21;29;50
95;17.06.2018;2018;06;18;Sunnuntai;25;21;46
95;17.06.2018;2018;06;19;Sunnuntai;20;26;46
95;17.06.2018;2018;06;20;Sunnuntai;12;17;29
95;17.06.2018;2018;06;21;Sunnuntai;9;12;21
95;17.06.2018;2018;06;22;Sunnuntai;8;7;15
95;17.06.2018;2018;06;23;Sunnuntai;0;3;3
95;18.06.2018;2018;06;00;Maanantai;1;1;2
95;18.06.2018;2018;06;01;Maanantai;0;0;0
95;18.06.2018;2018;06;02;Maanantai;0;0;0
95;18.06.2018;2018;06;03;Maanantai;1;0;1
95;18.06.2018;2018;06;04;Maanantai;2;0;2
95;18.06.2018;2018;06;05;Maanantai;7;4;11
95;18.06.2018;2018;06;06;Maanantai;11;9;20
95;18.06.2018;2018;06;07;Maanantai;28;16;44
95;18.06.2018;2018;06;08;Maanantai;6;10;16
95;18.06.2018;2018;06;09;Maanantai;4;2;6
95;18.06.2018;2018;06;10;Maanantai;7;8;15
95;18.06.2018;2018;06;11;Maanantai;4;6;10
95;18.06.2018;2018;06;12;Maanantai;6;2;8
95;18.06.2018;2018;06;13;Maanantai;13;7;20
95;18.06.2018;2018;06;14;Maanantai;17;14;31
95;18.06.2018;2018;06;15;Maanantai;15;19;34
95;18.06.2018;2018;06;16;Maanantai;19;19;38
95;18.06.2018;2018;06;17;Maanantai;9;13;22
95;18.06.2018;2018;06;18;Maanantai;11;17;28
95;18.06.2018;2018;06;19;Maanantai;8;10;18
95;18.06.2018;2018;06;20;Maanantai;14;10;24
95;18.06.2018;2018;06;21;Maanantai;3;4;7
95;18.06.2018;2018;06;22;Maanantai;1;5;6
95;18.06.2018;2018;06;23;Maanantai;4;1;5
95;19.06.2018;2018;06;00;Tiistai;0;2;2
95;19.06.2018;2018;06;01;Tiistai;0;1;1
95;19.06.2018;2018;06;02;Tiistai;0;0;0
95;19.06.2018;2018;06;03;Tiistai;1;0;1
95;19.06.2018;2018;06;04;Tiistai;4;0;4
95;19.06.2018;2018;06;05;Tiistai;5;4;9
95;19.06.2018;2018;06;06;Tiistai;13;10;23
95;19.06.2018;2018;06;07;Tiistai;23;18;41
95;19.06.2018;2018;06;08;Tiistai;15;20;35
95;19.06.2018;2018;06;09;Tiistai;9;12;21
95;19.06.2018;2018;06;10;Tiistai;10;3;13
95;19.06.2018;2018;06;11;Tiistai;6;9;15
95;19.06.2018;2018;06;12;Tiistai;3;5;8
95;19.06.2018;2018;06;13;Tiistai;5;1;6
95;19.06.2018;2018;06;14;Tiistai;11;11;22
95;19.06.2018;2018;06;15;Tiistai;11;6;17
95;19.06.2018;2018;06;16;Tiistai;13;17;30
95;19.06.2018;2018;06;17;Tiistai;6;8;14
95;19.06.2018;2018;06;18;Tiistai;6;5;11
95;19.06.2018;2018;06;19;Tiistai;7;5;12
95;19.06.2018;2018;06;20;Tiistai;5;6;11
95;19.06.2018;2018;06;21;Tiistai;1;0;1
95;19.06.2018;2018;06;22;Tiistai;0;1;1
95;19.06.2018;2018;06;23;Tiistai;2;0;2
95;20.06.2018;2018;06;00;Keskiviikko;0;0;0
95;20.06.2018;2018;06;01;Keskiviikko;0;0;0
95;20.06.2018;2018;06;02;Keskiviikko;0;0;0
95;20.06.2018;2018;06;03;Keskiviikko;0;0;0
95;20.06.2018;2018;06;04;Keskiviikko;1;0;1
95;20.06.2018;2018;06;05;Keskiviikko;8;2;10
95;20.06.2018;2018;06;06;Keskiviikko;7;10;17
95;20.06.2018;2018;06;07;Keskiviikko;28;18;46
95;20.06.2018;2018;06;08;Keskiviikko;6;11;17
95;20.06.2018;2018;06;09;Keskiviikko;12;8;20
95;20.06.2018;2018;06;10;Keskiviikko;10;4;14
95;20.06.2018;2018;06;11;Keskiviikko;8;9;17
95;20.06.2018;2018;06;12;Keskiviikko;6;10;16
95;20.06.2018;2018;06;13;Keskiviikko;14;9;23
95;20.06.2018;2018;06;14;Keskiviikko;9;18;27
95;20.06.2018;2018;06;15;Keskiviikko;18;18;36
95;20.06.2018;2018;06;16;Keskiviikko;28;33;61
95;20.06.2018;2018;06;17;Keskiviikko;11;22;33
95;20.06.2018;2018;06;18;Keskiviikko;7;15;22
95;20.06.2018;2018;06;19;Keskiviikko;11;8;19
95;20.06.2018;2018;06;20;Keskiviikko;12;6;18
95;20.06.2018;2018;06;21;Keskiviikko;8;8;16
95;20.06.2018;2018;06;22;Keskiviikko;6;5;11
95;20.06.2018;2018;06;23;Keskiviikko;3;1;4
95;21.06.2018;2018;06;00;Torstai;2;1;3
95;21.06.2018;2018;06;01;Torstai;0;0;0
95;21.06.2018;2018;06;02;Torstai;0;0;0
95;21.06.2018;2018;06;03;Torstai;1;0;1
95;21.06.2018;2018;06;04;Torstai;2;2;4
95;21.06.2018;2018;06;05;Torstai;2;5;7
95;21.06.2018;2018;06;06;Torstai;8;12;20
95;21.06.2018;2018;06;07;Torstai;11;15;26
95;21.06.2018;2018;06;08;Torstai;15;15;30
95;21.06.2018;2018;06;09;Torstai;15;11;26
95;21.06.2018;2018;06;10;Torstai;3;9;12
95;21.06.2018;2018;06;11;Torstai;15;20;35
95;21.06.2018;2018;06;12;Torstai;16;12;28
95;21.06.2018;2018;06;13;Torstai;19;22;41
95;21.06.2018;2018;06;14;Torstai;27;20;47
95;21.06.2018;2018;06;15;Torstai;28;22;50
95;21.06.2018;2018;06;16;Torstai;21;21;42
95;21.06.2018;2018;06;17;Torstai;17;17;34
95;21.06.2018;2018;06;18;Torstai;8;13;21
95;21.06.2018;2018;06;19;Torstai;13;16;29
95;21.06.2018;2018;06;20;Torstai;11;16;27
95;21.06.2018;2018;06;21;Torstai;7;7;14
95;21.06.2018;2018;06;22;Torstai;4;0;4
95;21.06.2018;2018;06;23;Torstai;4;1;5
95;22.06.2018;2018;06;00;Perjantai;2;2;4
95;22.06.2018;2018;06;01;Perjantai;2;0;2
95;22.06.2018;2018;06;02;Perjantai;0;0;0
95;22.06.2018;2018;06;03;Perjantai;2;1;3
95;22.06.2018;2018;06;04;Perjantai;1;1;2
95;22.06.2018;2018;06;05;Perjantai;1;0;1
95;22.06.2018;2018;06;06;Perjantai;0;0;0
95;22.06.2018;2018;06;07;Perjantai;2;0;2
95;22.06.2018;2018;06;08;Perjantai;0;0;0
95;22.06.2018;2018;06;09;Perjantai;0;0;0
95;22.06.2018;2018;06;10;Perjantai;0;2;2
95;22.06.2018;2018;06;11;Perjantai;1;1;2
95;22.06.2018;2018;06;12;Perjantai;1;2;3
95;22.06.2018;2018;06;13;Perjantai;0;1;1
95;22.06.2018;2018;06;14;Perjantai;3;1;4
95;22.06.2018;2018;06;15;Perjantai;0;2;2
95;22.06.2018;2018;06;16;Perjantai;4;1;5
95;22.06.2018;2018;06;17;Perjantai;1;6;7
95;22.06.2018;2018;06;18;Perjantai;0;1;1
95;22.06.2018;2018;06;19;Perjantai;1;7;8
95;22.06.2018;2018;06;20;Perjantai;0;2;2
95;22.06.2018;2018;06;21;Perjantai;1;1;2
95;22.06.2018;2018;06;22;Perjantai;9;0;9
95;22.06.2018;2018;06;23;Perjantai;0;0;0
95;23.06.2018;2018;06;00;Lauantai;2;0;2
95;23.06.2018;2018;06;01;Lauantai;0;0;0
95;23.06.2018;2018;06;02;Lauantai;0;0;0
95;23.06.2018;2018;06;03;Lauantai;1;0;1
95;23.06.2018;2018;06;04;Lauantai;0;0;0
95;23.06.2018;2018;06;05;Lauantai;0;0;0
95;23.06.2018;2018;06;06;Lauantai;0;2;2
95;23.06.2018;2018;06;07;Lauantai;5;1;6
95;23.06.2018;2018;06;08;Lauantai;0;3;3
95;23.06.2018;2018;06;09;Lauantai;1;4;5
95;23.06.2018;2018;06;10;Lauantai;6;2;8
95;23.06.2018;2018;06;11;Lauantai;3;1;4
95;23.06.2018;2018;06;12;Lauantai;2;4;6
95;23.06.2018;2018;06;13;Lauantai;3;4;7
95;23.06.2018;2018;06;14;Lauantai;2;2;4
95;23.06.2018;2018;06;15;Lauantai;1;9;10
95;23.06.2018;2018;06;16;Lauantai;4;6;10
95;23.06.2018;2018;06;17;Lauantai;8;6;14
95;23.06.2018;2018;06;18;Lauantai;4;10;14
95;23.06.2018;2018;06;19;Lauantai;17;6;23
95;23.06.2018;2018;06;20;Lauantai;2;4;6
95;23.06.2018;2018;06;21;Lauantai;2;3;5
95;23.06.2018;2018;06;22;Lauantai;0;1;1
95;23.06.2018;2018;06;23;Lauantai;4;2;6
95;24.06.2018;2018;06;00;Sunnuntai;0;1;1
95;24.06.2018;2018;06;01;Sunnuntai;1;3;4
95;24.06.2018;2018;06;02;Sunnuntai;1;0;1
95;24.06.2018;2018;06;03;Sunnuntai;0;1;1
95;24.06.2018;2018;06;04;Sunnuntai;0;0;0
95;24.06.2018;2018;06;05;Sunnuntai;0;1;1
95;24.06.2018;2018;06;06;Sunnuntai;1;1;2
95;24.06.2018;2018;06;07;Sunnuntai;3;3;6
95;24.06.2018;2018;06;08;Sunnuntai;4;1;5
95;24.06.2018;2018;06;09;Sunnuntai;26;14;40
95;24.06.2018;2018;06;10;Sunnuntai;24;24;48
95;24.06.2018;2018;06;11;Sunnuntai;28;14;42
95;24.06.2018;2018;06;12;Sunnuntai;27;21;48
95;24.06.2018;2018;06;13;Sunnuntai;49;29;78
95;24.06.2018;2018;06;14;Sunnuntai;26;18;44
95;24.06.2018;2018;06;15;Sunnuntai;19;23;42
95;24.06.2018;2018;06;16;Sunnuntai;26;26;52
95;24.06.2018;2018;06;17;Sunnuntai;17;13;30
95;24.06.2018;2018;06;18;Sunnuntai;23;21;44
95;24.06.2018;2018;06;19;Sunnuntai;20;20;40
95;24.06.2018;2018;06;20;Sunnuntai;12;5;17
95;24.06.2018;2018;06;21;Sunnuntai;3;9;12
95;24.06.2018;2018;06;22;Sunnuntai;3;6;9
95;24.06.2018;2018;06;23;Sunnuntai;1;1;2
95;25.06.2018;2018;06;00;Maanantai;0;0;0
95;25.06.2018;2018;06;01;Maanantai;0;0;0
95;25.06.2018;2018;06;02;Maanantai;0;0;0
95;25.06.2018;2018;06;03;Maanantai;0;0;0
95;25.06.2018;2018;06;04;Maanantai;1;2;3
95;25.06.2018;2018;06;05;Maanantai;10;3;13
95;25.06.2018;2018;06;06;Maanantai;28;13;41
95;25.06.2018;2018;06;07;Maanantai;25;20;45
95;25.06.2018;2018;06;08;Maanantai;15;17;32
95;25.06.2018;2018;06;09;Maanantai;17;9;26
95;25.06.2018;2018;06;10;Maanantai;20;13;33
95;25.06.2018;2018;06;11;Maanantai;29;19;48
95;25.06.2018;2018;06;12;Maanantai;19;20;39
95;25.06.2018;2018;06;13;Maanantai;30;19;49
95;25.06.2018;2018;06;14;Maanantai;41;28;69
95;25.06.2018;2018;06;15;Maanantai;40;38;78
95;25.06.2018;2018;06;16;Maanantai;40;39;79
95;25.06.2018;2018;06;17;Maanantai;22;27;49
95;25.06.2018;2018;06;18;Maanantai;21;20;41
95;25.06.2018;2018;06;19;Maanantai;15;37;52
95;25.06.2018;2018;06;20;Maanantai;22;20;42
95;25.06.2018;2018;06;21;Maanantai;12;22;34
95;25.06.2018;2018;06;22;Maanantai;3;5;8
95;25.06.2018;2018;06;23;Maanantai;2;0;2
95;26.06.2018;2018;06;00;Tiistai;6;0;6
95;26.06.2018;2018;06;01;Tiistai;1;5;6
95;26.06.2018;2018;06;02;Tiistai;0;0;0
95;26.06.2018;2018;06;03;Tiistai;1;1;2
95;26.06.2018;2018;06;04;Tiistai;0;0;0
95;26.06.2018;2018;06;05;Tiistai;7;7;14
95;26.06.2018;2018;06;06;Tiistai;33;20;53
95;26.06.2018;2018;06;07;Tiistai;31;20;51
95;26.06.2018;2018;06;08;Tiistai;12;12;24
95;26.06.2018;2018;06;09;Tiistai;16;9;25
95;26.06.2018;2018;06;10;Tiistai;18;11;29
95;26.06.2018;2018;06;11;Tiistai;19;10;29
95;26.06.2018;2018;06;12;Tiistai;20;23;43
95;26.06.2018;2018;06;13;Tiistai;29;12;41
95;26.06.2018;2018;06;14;Tiistai;25;22;47
95;26.06.2018;2018;06;15;Tiistai;31;39;70
95;26.06.2018;2018;06;16;Tiistai;27;43;70
95;26.06.2018;2018;06;17;Tiistai;16;24;40
95;26.06.2018;2018;06;18;Tiistai;12;21;33
95;26.06.2018;2018;06;19;Tiistai;20;25;45
95;26.06.2018;2018;06;20;Tiistai;15;6;21
95;26.06.2018;2018;06;21;Tiistai;9;12;21
95;26.06.2018;2018;06;22;Tiistai;4;6;10
95;26.06.2018;2018;06;23;Tiistai;1;3;4
95;27.06.2018;2018;06;00;Keskiviikko;1;0;1
95;27.06.2018;2018;06;01;Keskiviikko;1;0;1
95;27.06.2018;2018;06;02;Keskiviikko;0;0;0
95;27.06.2018;2018;06;03;Keskiviikko;1;0;1
95;27.06.2018;2018;06;04;Keskiviikko;3;0;3
95;27.06.2018;2018;06;05;Keskiviikko;12;3;15
95;27.06.2018;2018;06;06;Keskiviikko;28;16;44
95;27.06.2018;2018;06;07;Keskiviikko;24;27;51
95;27.06.2018;2018;06;08;Keskiviikko;20;12;32
95;27.06.2018;2018;06;09;Keskiviikko;22;9;31
95;27.06.2018;2018;06;10;Keskiviikko;8;15;23
95;27.06.2018;2018;06;11;Keskiviikko;3;19;22
95;27.06.2018;2018;06;12;Keskiviikko;15;15;30
95;27.06.2018;2018;06;13;Keskiviikko;19;19;38
95;27.06.2018;2018;06;14;Keskiviikko;20;15;35
95;27.06.2018;2018;06;15;Keskiviikko;26;33;59
95;27.06.2018;2018;06;16;Keskiviikko;30;33;63
95;27.06.2018;2018;06;17;Keskiviikko;21;36;57
95;27.06.2018;2018;06;18;Keskiviikko;16;16;32
95;27.06.2018;2018;06;19;Keskiviikko;11;22;33
95;27.06.2018;2018;06;20;Keskiviikko;17;7;24
95;27.06.2018;2018;06;21;Keskiviikko;6;10;16
95;27.06.2018;2018;06;22;Keskiviikko;3;2;5
95;27.06.2018;2018;06;23;Keskiviikko;2;2;4
95;28.06.2018;2018;06;00;Torstai;2;0;2
95;28.06.2018;2018;06;01;Torstai;1;0;1
95;28.06.2018;2018;06;02;Torstai;0;0;0
95;28.06.2018;2018;06;03;Torstai;1;0;1
95;28.06.2018;2018;06;04;Torstai;0;0;0
95;28.06.2018;2018;06;05;Torstai;5;2;7
95;28.06.2018;2018;06;06;Torstai;9;10;19
95;28.06.2018;2018;06;07;Torstai;12;16;28
95;28.06.2018;2018;06;08;Torstai;7;6;13
95;28.06.2018;2018;06;09;Torstai;5;2;7
95;28.06.2018;2018;06;10;Torstai;3;0;3
95;28.06.2018;2018;06;11;Torstai;4;2;6
95;28.06.2018;2018;06;12;Torstai;0;5;5
95;28.06.2018;2018;06;13;Torstai;5;2;7
95;28.06.2018;2018;06;14;Torstai;5;5;10
95;28.06.2018;2018;06;15;Torstai;8;5;13
95;28.06.2018;2018;06;16;Torstai;11;9;20
95;28.06.2018;2018;06;17;Torstai;4;7;11
95;28.06.2018;2018;06;18;Torstai;2;3;5
95;28.06.2018;2018;06;19;Torstai;2;2;4
95;28.06.2018;2018;06;20;Torstai;2;3;5
95;28.06.2018;2018;06;21;Torstai;2;1;3
95;28.06.2018;2018;06;22;Torstai;0;1;1
95;28.06.2018;2018;06;23;Torstai;0;1;1
95;29.06.2018;2018;06;00;Perjantai;0;0;0
95;29.06.2018;2018;06;01;Perjantai;0;1;1
95;29.06.2018;2018;06;02;Perjantai;0;0;0
95;29.06.2018;2018;06;03;Perjantai;1;0;1
95;29.06.2018;2018;06;04;Perjantai;0;0;0
95;29.06.2018;2018;06;05;Perjantai;8;3;11
95;29.06.2018;2018;06;06;Perjantai;13;10;23
95;29.06.2018;2018;06;07;Perjantai;14;17;31
95;29.06.2018;2018;06;08;Perjantai;11;8;19
95;29.06.2018;2018;06;09;Perjantai;7;5;12
95;29.06.2018;2018;06;10;Perjantai;10;7;17
95;29.06.2018;2018;06;11;Perjantai;5;8;13
95;29.06.2018;2018;06;12;Perjantai;7;7;14
95;29.06.2018;2018;06;13;Perjantai;5;11;16
95;29.06.2018;2018;06;14;Perjantai;7;14;21
95;29.06.2018;2018;06;15;Perjantai;16;16;32
95;29.06.2018;2018;06;16;Perjantai;13;17;30
95;29.06.2018;2018;06;17;Perjantai;11;8;19
95;29.06.2018;2018;06;18;Perjantai;8;13;21
95;29.06.2018;2018;06;19;Perjantai;6;15;21
95;29.06.2018;2018;06;20;Perjantai;13;8;21
95;29.06.2018;2018;06;21;Perjantai;4;3;7
95;29.06.2018;2018;06;22;Perjantai;1;5;6
95;29.06.2018;2018;06;23;Perjantai;1;0;1
95;30.06.2018;2018;06;00;Lauantai;1;1;2
95;30.06.2018;2018;06;01;Lauantai;0;0;0
95;30.06.2018;2018;06;02;Lauantai;1;0;1
95;30.06.2018;2018;06;03;Lauantai;1;0;1
95;30.06.2018;2018;06;04;Lauantai;2;0;2
95;30.06.2018;2018;06;05;Lauantai;1;1;2
95;30.06.2018;2018;06;06;Lauantai;1;0;1
95;30.06.2018;2018;06;07;Lauantai;5;3;8
95;30.06.2018;2018;06;08;Lauantai;4;4;8
95;30.06.2018;2018;06;09;Lauantai;5;8;13
95;30.06.2018;2018;06;10;Lauantai;16;7;23
95;30.06.2018;2018;06;11;Lauantai;9;17;26
95;30.06.2018;2018;06;12;Lauantai;10;19;29
95;30.06.2018;2018;06;13;Lauantai;14;13;27
95;30.06.2018;2018;06;14;Lauantai;15;13;28
95;30.06.2018;2018;06;15;Lauantai;19;17;36
95;30.06.2018;2018;06;16;Lauantai;17;11;28
95;30.06.2018;2018;06;17;Lauantai;14;20;34
95;30.06.2018;2018;06;18;Lauantai;7;7;14
95;30.06.2018;2018;06;19;Lauantai;6;16;22
95;30.06.2018;2018;06;20;Lauantai;9;11;20
95;30.06.2018;2018;06;21;Lauantai;5;1;6
95;30.06.2018;2018;06;22;Lauantai;1;5;6
95;30.06.2018;2018;06;23;Lauantai;3;0;3
95;01.07.2018;2018;07;00;Sunnuntai;2;0;2
95;01.07.2018;2018;07;01;Sunnuntai;0;0;0
95;01.07.2018;2018;07;02;Sunnuntai;1;0;1
95;01.07.2018;2018;07;03;Sunnuntai;2;1;3
95;01.07.2018;2018;07;04;Sunnuntai;1;1;2
95;01.07.2018;2018;07;05;Sunnuntai;0;0;0
95;01.07.2018;2018;07;06;Sunnuntai;2;1;3
95;01.07.2018;2018;07;07;Sunnuntai;4;4;8
95;01.07.2018;2018;07;08;Sunnuntai;10;8;18
95;01.07.2018;2018;07;09;Sunnuntai;20;12;32
95;01.07.2018;2018;07;10;Sunnuntai;9;16;25
95;01.07.2018;2018;07;11;Sunnuntai;14;23;37
95;01.07.2018;2018;07;12;Sunnuntai;22;25;47
95;01.07.2018;2018;07;13;Sunnuntai;33;30;63
95;01.07.2018;2018;07;14;Sunnuntai;34;23;57
95;01.07.2018;2018;07;15;Sunnuntai;20;35;55
95;01.07.2018;2018;07;16;Sunnuntai;29;30;59
95;01.07.2018;2018;07;17;Sunnuntai;17;24;41
95;01.07.2018;2018;07;18;Sunnuntai;32;26;58
95;01.07.2018;2018;07;19;Sunnuntai;19;20;39
95;01.07.2018;2018;07;20;Sunnuntai;10;12;22
95;01.07.2018;2018;07;21;Sunnuntai;7;3;10
95;01.07.2018;2018;07;22;Sunnuntai;3;3;6
95;01.07.2018;2018;07;23;Sunnuntai;0;1;1
95;02.07.2018;2018;07;00;Maanantai;1;2;3
95;02.07.2018;2018;07;01;Maanantai;2;2;4
95;02.07.2018;2018;07;02;Maanantai;0;0;0
95;02.07.2018;2018;07;03;Maanantai;0;0;0
95;02.07.2018;2018;07;04;Maanantai;1;1;2
95;02.07.2018;2018;07;05;Maanantai;11;3;14
95;02.07.2018;2018;07;06;Maanantai;20;15;35
95;02.07.2018;2018;07;07;Maanantai;25;16;41
95;02.07.2018;2018;07;08;Maanantai;17;12;29
95;02.07.2018;2018;07;09;Maanantai;23;12;35
95;02.07.2018;2018;07;10;Maanantai;11;19;30
95;02.07.2018;2018;07;11;Maanantai;21;12;33
95;02.07.2018;2018;07;12;Maanantai;25;19;44
95;02.07.2018;2018;07;13;Maanantai;28;25;53
95;02.07.2018;2018;07;14;Maanantai;25;44;69
95;02.07.2018;2018;07;15;Maanantai;34;29;63
95;02.07.2018;2018;07;16;Maanantai;34;39;73
95;02.07.2018;2018;07;17;Maanantai;26;29;55
95;02.07.2018;2018;07;18;Maanantai;33;43;76
95;02.07.2018;2018;07;19;Maanantai;31;20;51
95;02.07.2018;2018;07;20;Maanantai;17;26;43
95;02.07.2018;2018;07;21;Maanantai;11;8;19
95;02.07.2018;2018;07;22;Maanantai;3;4;7
95;02.07.2018;2018;07;23;Maanantai;5;3;8
95;03.07.2018;2018;07;00;Tiistai;1;1;2
95;03.07.2018;2018;07;01;Tiistai;0;0;0
95;03.07.2018;2018;07;02;Tiistai;0;0;0
95;03.07.2018;2018;07;03;Tiistai;1;0;1
95;03.07.2018;2018;07;04;Tiistai;0;0;0
95;03.07.2018;2018;07;05;Tiistai;16;4;20
95;03.07.2018;2018;07;06;Tiistai;16;15;31
95;03.07.2018;2018;07;07;Tiistai;19;21;40
95;03.07.2018;2018;07;08;Tiistai;19;10;29
95;03.07.2018;2018;07;09;Tiistai;17;11;28
95;03.07.2018;2018;07;10;Tiistai;10;10;20
95;03.07.2018;2018;07;11;Tiistai;25;10;35
95;03.07.2018;2018;07;12;Tiistai;16;14;30
95;03.07.2018;2018;07;13;Tiistai;29;28;57
95;03.07.2018;2018;07;14;Tiistai;33;29;62
95;03.07.2018;2018;07;15;Tiistai;28;35;63
95;03.07.2018;2018;07;16;Tiistai;25;38;63
95;03.07.2018;2018;07;17;Tiistai;24;22;46
95;03.07.2018;2018;07;18;Tiistai;24;22;46
95;03.07.2018;2018;07;19;Tiistai;24;23;47
95;03.07.2018;2018;07;20;Tiistai;11;13;24
95;03.07.2018;2018;07;21;Tiistai;8;4;12
95;03.07.2018;2018;07;22;Tiistai;3;8;11
95;03.07.2018;2018;07;23;Tiistai;3;1;4
95;04.07.2018;2018;07;00;Keskiviikko;0;1;1
95;04.07.2018;2018;07;01;Keskiviikko;0;1;1
95;04.07.2018;2018;07;02;Keskiviikko;0;0;0
95;04.07.2018;2018;07;03;Keskiviikko;0;0;0
95;04.07.2018;2018;07;04;Keskiviikko;0;0;0
95;04.07.2018;2018;07;05;Keskiviikko;4;3;7
95;04.07.2018;2018;07;06;Keskiviikko;3;7;10
95;04.07.2018;2018;07;07;Keskiviikko;6;6;12
95;04.07.2018;2018;07;08;Keskiviikko;6;3;9
95;04.07.2018;2018;07;09;Keskiviikko;4;4;8
95;04.07.2018;2018;07;10;Keskiviikko;0;2;2
95;04.07.2018;2018;07;11;Keskiviikko;1;0;1
95;04.07.2018;2018;07;12;Keskiviikko;0;1;1
95;04.07.2018;2018;07;13;Keskiviikko;1;2;3
95;04.07.2018;2018;07;14;Keskiviikko;3;4;7
95;04.07.2018;2018;07;15;Keskiviikko;14;4;18
95;04.07.2018;2018;07;16;Keskiviikko;8;22;30
95;04.07.2018;2018;07;17;Keskiviikko;16;26;42
95;04.07.2018;2018;07;18;Keskiviikko;26;17;43
95;04.07.2018;2018;07;19;Keskiviikko;22;23;45
95;04.07.2018;2018;07;20;Keskiviikko;15;6;21
95;04.07.2018;2018;07;21;Keskiviikko;7;5;12
95;04.07.2018;2018;07;22;Keskiviikko;5;7;12
95;04.07.2018;2018;07;23;Keskiviikko;3;3;6
95;05.07.2018;2018;07;00;Torstai;1;0;1
95;05.07.2018;2018;07;01;Torstai;0;2;2
95;05.07.2018;2018;07;02;Torstai;0;0;0
95;05.07.2018;2018;07;03;Torstai;1;0;1
95;05.07.2018;2018;07;04;Torstai;2;1;3
95;05.07.2018;2018;07;05;Torstai;14;5;19
95;05.07.2018;2018;07;06;Torstai;17;9;26
95;05.07.2018;2018;07;07;Torstai;25;16;41
95;05.07.2018;2018;07;08;Torstai;20;16;36
95;05.07.2018;2018;07;09;Torstai;21;12;33
95;05.07.2018;2018;07;10;Torstai;15;18;33
95;05.07.2018;2018;07;11;Torstai;24;19;43
95;05.07.2018;2018;07;12;Torstai;27;27;54
95;05.07.2018;2018;07;13;Torstai;20;22;42
95;05.07.2018;2018;07;14;Torstai;13;24;37
95;05.07.2018;2018;07;15;Torstai;18;31;49
95;05.07.2018;2018;07;16;Torstai;16;31;47
95;05.07.2018;2018;07;17;Torstai;22;10;32
95;05.07.2018;2018;07;18;Torstai;9;14;23
95;05.07.2018;2018;07;19;Torstai;10;8;18
95;05.07.2018;2018;07;20;Torstai;11;6;17
95;05.07.2018;2018;07;21;Torstai;2;3;5
95;05.07.2018;2018;07;22;Torstai;6;2;8
95;05.07.2018;2018;07;23;Torstai;1;4;5
95;06.07.2018;2018;07;00;Perjantai;0;0;0
95;06.07.2018;2018;07;01;Perjantai;0;1;1
95;06.07.2018;2018;07;02;Perjantai;1;1;2
95;06.07.2018;2018;07;03;Perjantai;1;0;1
95;06.07.2018;2018;07;04;Perjantai;2;0;2
95;06.07.2018;2018;07;05;Perjantai;11;5;16
95;06.07.2018;2018;07;06;Perjantai;13;5;18
95;06.07.2018;2018;07;07;Perjantai;21;17;38
95;06.07.2018;2018;07;08;Perjantai;12;8;20
95;06.07.2018;2018;07;09;Perjantai;11;8;19
95;06.07.2018;2018;07;10;Perjantai;10;8;18
95;06.07.2018;2018;07;11;Perjantai;19;7;26
95;06.07.2018;2018;07;12;Perjantai;28;8;36
95;06.07.2018;2018;07;13;Perjantai;21;25;46
95;06.07.2018;2018;07;14;Perjantai;26;26;52
95;06.07.2018;2018;07;15;Perjantai;22;37;59
95;06.07.2018;2018;07;16;Perjantai;23;32;55
95;06.07.2018;2018;07;17;Perjantai;18;30;48
95;06.07.2018;2018;07;18;Perjantai;18;29;47
95;06.07.2018;2018;07;19;Perjantai;17;20;37
95;06.07.2018;2018;07;20;Perjantai;17;22;39
95;06.07.2018;2018;07;21;Perjantai;10;9;19
95;06.07.2018;2018;07;22;Perjantai;6;8;14
95;06.07.2018;2018;07;23;Perjantai;2;4;6
95;07.07.2018;2018;07;00;Lauantai;0;4;4
95;07.07.2018;2018;07;01;Lauantai;1;2;3
95;07.07.2018;2018;07;02;Lauantai;1;6;7
95;07.07.2018;2018;07;03;Lauantai;5;0;5
95;07.07.2018;2018;07;04;Lauantai;1;0;1
95;07.07.2018;2018;07;05;Lauantai;1;0;1
95;07.07.2018;2018;07;06;Lauantai;3;6;9
95;07.07.2018;2018;07;07;Lauantai;6;5;11
95;07.07.2018;2018;07;08;Lauantai;11;7;18
95;07.07.2018;2018;07;09;Lauantai;21;11;32
95;07.07.2018;2018;07;10;Lauantai;21;15;36
95;07.07.2018;2018;07;11;Lauantai;18;25;43
95;07.07.2018;2018;07;12;Lauantai;19;17;36
95;07.07.2018;2018;07;13;Lauantai;21;25;46
95;07.07.2018;2018;07;14;Lauantai;32;19;51
95;07.07.2018;2018;07;15;Lauantai;29;18;47
95;07.07.2018;2018;07;16;Lauantai;18;15;33
95;07.07.2018;2018;07;17;Lauantai;25;26;51
95;07.07.2018;2018;07;18;Lauantai;9;22;31
95;07.07.2018;2018;07;19;Lauantai;11;17;28
95;07.07.2018;2018;07;20;Lauantai;12;7;19
95;07.07.2018;2018;07;21;Lauantai;6;5;11
95;07.07.2018;2018;07;22;Lauantai;5;0;5
95;07.07.2018;2018;07;23;Lauantai;0;1;1
95;08.07.2018;2018;07;00;Sunnuntai;0;5;5
95;08.07.2018;2018;07;01;Sunnuntai;2;2;4
95;08.07.2018;2018;07;02;Sunnuntai;2;1;3
95;08.07.2018;2018;07;03;Sunnuntai;0;2;2
95;08.07.2018;2018;07;04;Sunnuntai;1;1;2
95;08.07.2018;2018;07;05;Sunnuntai;1;1;2
95;08.07.2018;2018;07;06;Sunnuntai;1;2;3
95;08.07.2018;2018;07;07;Sunnuntai;4;1;5
95;08.07.2018;2018;07;08;Sunnuntai;8;4;12
95;08.07.2018;2018;07;09;Sunnuntai;13;9;22
95;08.07.2018;2018;07;10;Sunnuntai;18;16;34
95;08.07.2018;2018;07;11;Sunnuntai;18;19;37
95;08.07.2018;2018;07;12;Sunnuntai;39;23;62
95;08.07.2018;2018;07;13;Sunnuntai;31;21;52
95;08.07.2018;2018;07;14;Sunnuntai;32;22;54
95;08.07.2018;2018;07;15;Sunnuntai;21;30;51
95;08.07.2018;2018;07;16;Sunnuntai;27;18;45
95;08.07.2018;2018;07;17;Sunnuntai;22;40;62
95;08.07.2018;2018;07;18;Sunnuntai;16;21;37
95;08.07.2018;2018;07;19;Sunnuntai;24;13;37
95;08.07.2018;2018;07;20;Sunnuntai;18;14;32
95;08.07.2018;2018;07;21;Sunnuntai;10;7;17
95;08.07.2018;2018;07;22;Sunnuntai;6;5;11
95;08.07.2018;2018;07;23;Sunnuntai;2;2;4
95;09.07.2018;2018;07;00;Maanantai;1;1;2
95;09.07.2018;2018;07;01;Maanantai;0;2;2
95;09.07.2018;2018;07;02;Maanantai;1;1;2
95;09.07.2018;2018;07;03;Maanantai;1;0;1
95;09.07.2018;2018;07;04;Maanantai;0;1;1
95;09.07.2018;2018;07;05;Maanantai;14;6;20
95;09.07.2018;2018;07;06;Maanantai;26;15;41
95;09.07.2018;2018;07;07;Maanantai;33;17;50
95;09.07.2018;2018;07;08;Maanantai;17;14;31
95;09.07.2018;2018;07;09;Maanantai;15;13;28
95;09.07.2018;2018;07;10;Maanantai;26;16;42
95;09.07.2018;2018;07;11;Maanantai;27;26;53
95;09.07.2018;2018;07;12;Maanantai;29;31;60
95;09.07.2018;2018;07;13;Maanantai;30;27;57
95;09.07.2018;2018;07;14;Maanantai;38;27;65
95;09.07.2018;2018;07;15;Maanantai;39;35;74
95;09.07.2018;2018;07;16;Maanantai;33;48;81
95;09.07.2018;2018;07;17;Maanantai;24;21;45
95;09.07.2018;2018;07;18;Maanantai;38;40;78
95;09.07.2018;2018;07;19;Maanantai;39;31;70
95;09.07.2018;2018;07;20;Maanantai;30;21;51
95;09.07.2018;2018;07;21;Maanantai;9;21;30
95;09.07.2018;2018;07;22;Maanantai;11;15;26
95;09.07.2018;2018;07;23;Maanantai;2;4;6
95;10.07.2018;2018;07;00;Tiistai;1;0;1
95;10.07.2018;2018;07;01;Tiistai;2;0;2
95;10.07.2018;2018;07;02;Tiistai;1;1;2
95;10.07.2018;2018;07;03;Tiistai;1;1;2
95;10.07.2018;2018;07;04;Tiistai;0;0;0
95;10.07.2018;2018;07;05;Tiistai;12;5;17
95;10.07.2018;2018;07;06;Tiistai;25;14;39
95;10.07.2018;2018;07;07;Tiistai;22;18;40
95;10.07.2018;2018;07;08;Tiistai;30;16;46
95;10.07.2018;2018;07;09;Tiistai;15;12;27
95;10.07.2018;2018;07;10;Tiistai;30;22;52
95;10.07.2018;2018;07;11;Tiistai;23;22;45
95;10.07.2018;2018;07;12;Tiistai;24;21;45
95;10.07.2018;2018;07;13;Tiistai;34;18;52
95;10.07.2018;2018;07;14;Tiistai;23;32;55
95;10.07.2018;2018;07;15;Tiistai;34;40;74
95;10.07.2018;2018;07;16;Tiistai;34;54;88
95;10.07.2018;2018;07;17;Tiistai;33;46;79
95;10.07.2018;2018;07;18;Tiistai;33;31;64
95;10.07.2018;2018;07;19;Tiistai;35;27;62
95;10.07.2018;2018;07;20;Tiistai;19;17;36
95;10.07.2018;2018;07;21;Tiistai;8;19;27
95;10.07.2018;2018;07;22;Tiistai;7;2;9
95;10.07.2018;2018;07;23;Tiistai;5;6;11
95;11.07.2018;2018;07;00;Keskiviikko;0;6;6
95;11.07.2018;2018;07;01;Keskiviikko;3;0;3
95;11.07.2018;2018;07;02;Keskiviikko;0;1;1
95;11.07.2018;2018;07;03;Keskiviikko;1;3;4
95;11.07.2018;2018;07;04;Keskiviikko;2;0;2
95;11.07.2018;2018;07;05;Keskiviikko;13;5;18
95;11.07.2018;2018;07;06;Keskiviikko;30;13;43
95;11.07.2018;2018;07;07;Keskiviikko;20;15;35
95;11.07.2018;2018;07;08;Keskiviikko;18;13;31
95;11.07.2018;2018;07;09;Keskiviikko;22;13;35
95;11.07.2018;2018;07;10;Keskiviikko;22;18;40
95;11.07.2018;2018;07;11;Keskiviikko;42;18;60
95;11.07.2018;2018;07;12;Keskiviikko;28;38;66
95;11.07.2018;2018;07;13;Keskiviikko;23;21;44
95;11.07.2018;2018;07;14;Keskiviikko;41;37;78
95;11.07.2018;2018;07;15;Keskiviikko;35;43;78
95;11.07.2018;2018;07;16;Keskiviikko;33;46;79
95;11.07.2018;2018;07;17;Keskiviikko;18;34;52
95;11.07.2018;2018;07;18;Keskiviikko;28;33;61
95;11.07.2018;2018;07;19;Keskiviikko;32;17;49
95;11.07.2018;2018;07;20;Keskiviikko;32;18;50
95;11.07.2018;2018;07;21;Keskiviikko;9;18;27
95;11.07.2018;2018;07;22;Keskiviikko;3;8;11
95;11.07.2018;2018;07;23;Keskiviikko;6;3;9
95;12.07.2018;2018;07;00;Torstai;3;2;5
95;12.07.2018;2018;07;01;Torstai;0;0;0
95;12.07.2018;2018;07;02;Torstai;2;0;2
95;12.07.2018;2018;07;03;Torstai;2;1;3
95;12.07.2018;2018;07;04;Torstai;0;0;0
95;12.07.2018;2018;07;05;Torstai;14;5;19
95;12.07.2018;2018;07;06;Torstai;29;17;46
95;12.07.2018;2018;07;07;Torstai;27;14;41
95;12.07.2018;2018;07;08;Torstai;23;18;41
95;12.07.2018;2018;07;09;Torstai;30;12;42
95;12.07.2018;2018;07;10;Torstai;21;21;42
95;12.07.2018;2018;07;11;Torstai;23;18;41
95;12.07.2018;2018;07;12;Torstai;33;29;62
95;12.07.2018;2018;07;13;Torstai;14;27;41
95;12.07.2018;2018;07;14;Torstai;25;27;52
95;12.07.2018;2018;07;15;Torstai;53;36;89
95;12.07.2018;2018;07;16;Torstai;32;51;83
95;12.07.2018;2018;07;17;Torstai;30;26;56
95;12.07.2018;2018;07;18;Torstai;18;21;39
95;12.07.2018;2018;07;19;Torstai;18;20;38
95;12.07.2018;2018;07;20;Torstai;15;14;29
95;12.07.2018;2018;07;21;Torstai;12;8;20
95;12.07.2018;2018;07;22;Torstai;11;9;20
95;12.07.2018;2018;07;23;Torstai;2;9;11
95;13.07.2018;2018;07;00;Perjantai;0;4;4
95;13.07.2018;2018;07;01;Perjantai;1;2;3
95;13.07.2018;2018;07;02;Perjantai;0;0;0
95;13.07.2018;2018;07;03;Perjantai;3;0;3
95;13.07.2018;2018;07;04;Perjantai;1;2;3
95;13.07.2018;2018;07;05;Perjantai;11;4;15
95;13.07.2018;2018;07;06;Perjantai;15;12;27
95;13.07.2018;2018;07;07;Perjantai;17;15;32
95;13.07.2018;2018;07;08;Perjantai;10;10;20
95;13.07.2018;2018;07;09;Perjantai;23;8;31
95;13.07.2018;2018;07;10;Perjantai;23;17;40
95;13.07.2018;2018;07;11;Perjantai;24;24;48
95;13.07.2018;2018;07;12;Perjantai;23;24;47
95;13.07.2018;2018;07;13;Perjantai;29;17;46
95;13.07.2018;2018;07;14;Perjantai;23;48;71
95;13.07.2018;2018;07;15;Perjantai;29;31;60
95;13.07.2018;2018;07;16;Perjantai;25;18;43
95;13.07.2018;2018;07;17;Perjantai;19;24;43
95;13.07.2018;2018;07;18;Perjantai;13;26;39
95;13.07.2018;2018;07;19;Perjantai;25;22;47
95;13.07.2018;2018;07;20;Perjantai;15;12;27
95;13.07.2018;2018;07;21;Perjantai;8;7;15
95;13.07.2018;2018;07;22;Perjantai;5;7;12
95;13.07.2018;2018;07;23;Perjantai;3;9;12
95;14.07.2018;2018;07;00;Lauantai;3;4;7
95;14.07.2018;2018;07;01;Lauantai;5;0;5
95;14.07.2018;2018;07;02;Lauantai;0;1;1
95;14.07.2018;2018;07;03;Lauantai;1;0;1
95;14.07.2018;2018;07;04;Lauantai;1;2;3
95;14.07.2018;2018;07;05;Lauantai;1;5;6
95;14.07.2018;2018;07;06;Lauantai;3;6;9
95;14.07.2018;2018;07;07;Lauantai;0;3;3
95;14.07.2018;2018;07;08;Lauantai;9;5;14
95;14.07.2018;2018;07;09;Lauantai;7;2;9
95;14.07.2018;2018;07;10;Lauantai;18;16;34
95;14.07.2018;2018;07;11;Lauantai;14;12;26
95;14.07.2018;2018;07;12;Lauantai;15;18;33
95;14.07.2018;2018;07;13;Lauantai;29;24;53
95;14.07.2018;2018;07;14;Lauantai;19;18;37
95;14.07.2018;2018;07;15;Lauantai;16;20;36
95;14.07.2018;2018;07;16;Lauantai;16;20;36
95;14.07.2018;2018;07;17;Lauantai;20;13;33
95;14.07.2018;2018;07;18;Lauantai;19;26;45
95;14.07.2018;2018;07;19;Lauantai;11;21;32
95;14.07.2018;2018;07;20;Lauantai;10;16;26
95;14.07.2018;2018;07;21;Lauantai;15;7;22
95;14.07.2018;2018;07;22;Lauantai;0;15;15
95;14.07.2018;2018;07;23;Lauantai;5;6;11
95;15.07.2018;2018;07;00;Sunnuntai;2;9;11
95;15.07.2018;2018;07;01;Sunnuntai;2;2;4
95;15.07.2018;2018;07;02;Sunnuntai;2;5;7
95;15.07.2018;2018;07;03;Sunnuntai;0;3;3
95;15.07.2018;2018;07;04;Sunnuntai;0;0;0
95;15.07.2018;2018;07;05;Sunnuntai;0;1;1
95;15.07.2018;2018;07;06;Sunnuntai;1;2;3
95;15.07.2018;2018;07;07;Sunnuntai;5;1;6
95;15.07.2018;2018;07;08;Sunnuntai;10;11;21
95;15.07.2018;2018;07;09;Sunnuntai;31;15;46
95;15.07.2018;2018;07;10;Sunnuntai;26;18;44
95;15.07.2018;2018;07;11;Sunnuntai;41;29;70
95;15.07.2018;2018;07;12;Sunnuntai;39;29;68
95;15.07.2018;2018;07;13;Sunnuntai;33;24;57
95;15.07.2018;2018;07;14;Sunnuntai;28;35;63
95;15.07.2018;2018;07;15;Sunnuntai;27;23;50
95;15.07.2018;2018;07;16;Sunnuntai;19;28;47
95;15.07.2018;2018;07;17;Sunnuntai;18;24;42
95;15.07.2018;2018;07;18;Sunnuntai;14;24;38
95;15.07.2018;2018;07;19;Sunnuntai;21;9;30
95;15.07.2018;2018;07;20;Sunnuntai;17;12;29
95;15.07.2018;2018;07;21;Sunnuntai;10;13;23
95;15.07.2018;2018;07;22;Sunnuntai;7;2;9
95;15.07.2018;2018;07;23;Sunnuntai;2;4;6
95;16.07.2018;2018;07;00;Maanantai;0;3;3
95;16.07.2018;2018;07;01;Maanantai;0;0;0
95;16.07.2018;2018;07;02;Maanantai;0;0;0
95;16.07.2018;2018;07;03;Maanantai;0;0;0
95;16.07.2018;2018;07;04;Maanantai;1;0;1
95;16.07.2018;2018;07;05;Maanantai;10;6;16
95;16.07.2018;2018;07;06;Maanantai;24;14;38
95;16.07.2018;2018;07;07;Maanantai;24;21;45
95;16.07.2018;2018;07;08;Maanantai;13;14;27
95;16.07.2018;2018;07;09;Maanantai;19;15;34
95;16.07.2018;2018;07;10;Maanantai;15;17;32
95;16.07.2018;2018;07;11;Maanantai;29;22;51
95;16.07.2018;2018;07;12;Maanantai;23;21;44
95;16.07.2018;2018;07;13;Maanantai;33;15;48
95;16.07.2018;2018;07;14;Maanantai;23;30;53
95;16.07.2018;2018;07;15;Maanantai;39;35;74
95;16.07.2018;2018;07;16;Maanantai;29;56;85
95;16.07.2018;2018;07;17;Maanantai;30;38;68
95;16.07.2018;2018;07;18;Maanantai;26;25;51
95;16.07.2018;2018;07;19;Maanantai;14;18;32
95;16.07.2018;2018;07;20;Maanantai;18;29;47
95;16.07.2018;2018;07;21;Maanantai;13;23;36
95;16.07.2018;2018;07;22;Maanantai;6;9;15
95;16.07.2018;2018;07;23;Maanantai;3;7;10
95;17.07.2018;2018;07;00;Tiistai;0;1;1
95;17.07.2018;2018;07;01;Tiistai;0;2;2
95;17.07.2018;2018;07;02;Tiistai;0;1;1
95;17.07.2018;2018;07;03;Tiistai;1;1;2
95;17.07.2018;2018;07;04;Tiistai;3;0;3
95;17.07.2018;2018;07;05;Tiistai;11;3;14
95;17.07.2018;2018;07;06;Tiistai;26;14;40
95;17.07.2018;2018;07;07;Tiistai;23;27;50
95;17.07.2018;2018;07;08;Tiistai;19;10;29
95;17.07.2018;2018;07;09;Tiistai;24;15;39
95;17.07.2018;2018;07;10;Tiistai;24;16;40
95;17.07.2018;2018;07;11;Tiistai;24;18;42
95;17.07.2018;2018;07;12;Tiistai;20;23;43
95;17.07.2018;2018;07;13;Tiistai;16;22;38
95;17.07.2018;2018;07;14;Tiistai;21;39;60
95;17.07.2018;2018;07;15;Tiistai;33;31;64
95;17.07.2018;2018;07;16;Tiistai;35;43;78
95;17.07.2018;2018;07;17;Tiistai;22;34;56
95;17.07.2018;2018;07;18;Tiistai;17;21;38
95;17.07.2018;2018;07;19;Tiistai;15;16;31
95;17.07.2018;2018;07;20;Tiistai;19;23;42
95;17.07.2018;2018;07;21;Tiistai;18;12;30
95;17.07.2018;2018;07;22;Tiistai;7;9;16
95;17.07.2018;2018;07;23;Tiistai;2;7;9
95;18.07.2018;2018;07;00;Keskiviikko;0;4;4
95;18.07.2018;2018;07;01;Keskiviikko;1;1;2
95;18.07.2018;2018;07;02;Keskiviikko;0;1;1
95;18.07.2018;2018;07;03;Keskiviikko;3;0;3
95;18.07.2018;2018;07;04;Keskiviikko;3;1;4
95;18.07.2018;2018;07;05;Keskiviikko;15;4;19
95;18.07.2018;2018;07;06;Keskiviikko;21;16;37
95;18.07.2018;2018;07;07;Keskiviikko;23;19;42
95;18.07.2018;2018;07;08;Keskiviikko;25;14;39
95;18.07.2018;2018;07;09;Keskiviikko;18;18;36
95;18.07.2018;2018;07;10;Keskiviikko;25;15;40
95;18.07.2018;2018;07;11;Keskiviikko;19;16;35
95;18.07.2018;2018;07;12;Keskiviikko;20;21;41
95;18.07.2018;2018;07;13;Keskiviikko;15;11;26
95;18.07.2018;2018;07;14;Keskiviikko;29;33;62
95;18.07.2018;2018;07;15;Keskiviikko;27;33;60
95;18.07.2018;2018;07;16;Keskiviikko;23;41;64
95;18.07.2018;2018;07;17;Keskiviikko;17;16;33
95;18.07.2018;2018;07;18;Keskiviikko;11;20;31
95;18.07.2018;2018;07;19;Keskiviikko;23;15;38
95;18.07.2018;2018;07;20;Keskiviikko;16;27;43
95;18.07.2018;2018;07;21;Keskiviikko;24;18;42
95;18.07.2018;2018;07;22;Keskiviikko;11;11;22
95;18.07.2018;2018;07;23;Keskiviikko;2;10;12
95;19.07.2018;2018;07;00;Torstai;4;1;5
95;19.07.2018;2018;07;01;Torstai;4;2;6
95;19.07.2018;2018;07;02;Torstai;0;2;2
95;19.07.2018;2018;07;03;Torstai;3;0;3
95;19.07.2018;2018;07;04;Torstai;0;2;2
95;19.07.2018;2018;07;05;Torstai;14;4;18
95;19.07.2018;2018;07;06;Torstai;19;10;29
95;19.07.2018;2018;07;07;Torstai;26;16;42
95;19.07.2018;2018;07;08;Torstai;17;14;31
95;19.07.2018;2018;07;09;Torstai;16;15;31
95;19.07.2018;2018;07;10;Torstai;14;17;31
95;19.07.2018;2018;07;11;Torstai;24;18;42
95;19.07.2018;2018;07;12;Torstai;24;26;50
95;19.07.2018;2018;07;13;Torstai;30;16;46
95;19.07.2018;2018;07;14;Torstai;20;32;52
95;19.07.2018;2018;07;15;Torstai;33;27;60
95;19.07.2018;2018;07;16;Torstai;20;39;59
95;19.07.2018;2018;07;17;Torstai;15;27;42
95;19.07.2018;2018;07;18;Torstai;16;22;38
95;19.07.2018;2018;07;19;Torstai;21;26;47
95;19.07.2018;2018;07;20;Torstai;22;16;38
95;19.07.2018;2018;07;21;Torstai;13;21;34
95;19.07.2018;2018;07;22;Torstai;12;8;20
95;19.07.2018;2018;07;23;Torstai;7;7;14
95;20.07.2018;2018;07;00;Perjantai;1;5;6
95;20.07.2018;2018;07;01;Perjantai;2;0;2
95;20.07.2018;2018;07;02;Perjantai;0;2;2
95;20.07.2018;2018;07;03;Perjantai;1;1;2
95;20.07.2018;2018;07;04;Perjantai;0;0;0
95;20.07.2018;2018;07;05;Perjantai;15;7;22
95;20.07.2018;2018;07;06;Perjantai;16;11;27
95;20.07.2018;2018;07;07;Perjantai;21;17;38
95;20.07.2018;2018;07;08;Perjantai;12;13;25
95;20.07.2018;2018;07;09;Perjantai;24;13;37
95;20.07.2018;2018;07;10;Perjantai;18;14;32
95;20.07.2018;2018;07;11;Perjantai;15;8;23
95;20.07.2018;2018;07;12;Perjantai;23;19;42
95;20.07.2018;2018;07;13;Perjantai;24;13;37
95;20.07.2018;2018;07;14;Perjantai;19;35;54
95;20.07.2018;2018;07;15;Perjantai;31;32;63
95;20.07.2018;2018;07;16;Perjantai;16;28;44
95;20.07.2018;2018;07;17;Perjantai;22;22;44
95;20.07.2018;2018;07;18;Perjantai;15;21;36
95;20.07.2018;2018;07;19;Perjantai;15;10;25
95;20.07.2018;2018;07;20;Perjantai;8;10;18
95;20.07.2018;2018;07;21;Perjantai;7;14;21
95;20.07.2018;2018;07;22;Perjantai;4;14;18
95;20.07.2018;2018;07;23;Perjantai;3;7;10
95;21.07.2018;2018;07;00;Lauantai;1;10;11
95;21.07.2018;2018;07;01;Lauantai;0;5;5
95;21.07.2018;2018;07;02;Lauantai;0;0;0
95;21.07.2018;2018;07;03;Lauantai;0;4;4
95;21.07.2018;2018;07;04;Lauantai;0;2;2
95;21.07.2018;2018;07;05;Lauantai;3;1;4
95;21.07.2018;2018;07;06;Lauantai;0;2;2
95;21.07.2018;2018;07;07;Lauantai;5;4;9
95;21.07.2018;2018;07;08;Lauantai;13;8;21
95;21.07.2018;2018;07;09;Lauantai;9;13;22
95;21.07.2018;2018;07;10;Lauantai;9;8;17
95;21.07.2018;2018;07;11;Lauantai;5;10;15
95;21.07.2018;2018;07;12;Lauantai;10;7;17
95;21.07.2018;2018;07;13;Lauantai;10;14;24
95;21.07.2018;2018;07;14;Lauantai;9;10;19
95;21.07.2018;2018;07;15;Lauantai;11;9;20
95;21.07.2018;2018;07;16;Lauantai;5;13;18
95;21.07.2018;2018;07;17;Lauantai;15;12;27
95;21.07.2018;2018;07;18;Lauantai;20;9;29
95;21.07.2018;2018;07;19;Lauantai;10;9;19
95;21.07.2018;2018;07;20;Lauantai;10;13;23
95;21.07.2018;2018;07;21;Lauantai;9;8;17
95;21.07.2018;2018;07;22;Lauantai;5;1;6
95;21.07.2018;2018;07;23;Lauantai;0;1;1
95;22.07.2018;2018;07;00;Sunnuntai;3;0;3
95;22.07.2018;2018;07;01;Sunnuntai;2;2;4
95;22.07.2018;2018;07;02;Sunnuntai;0;2;2
95;22.07.2018;2018;07;03;Sunnuntai;0;3;3
95;22.07.2018;2018;07;04;Sunnuntai;0;1;1
95;22.07.2018;2018;07;05;Sunnuntai;0;0;0
95;22.07.2018;2018;07;06;Sunnuntai;3;3;6
95;22.07.2018;2018;07;07;Sunnuntai;4;2;6
95;22.07.2018;2018;07;08;Sunnuntai;7;8;15
95;22.07.2018;2018;07;09;Sunnuntai;7;4;11
95;22.07.2018;2018;07;10;Sunnuntai;10;6;16
95;22.07.2018;2018;07;11;Sunnuntai;14;11;25
95;22.07.2018;2018;07;12;Sunnuntai;33;17;50
95;22.07.2018;2018;07;13;Sunnuntai;21;18;39
95;22.07.2018;2018;07;14;Sunnuntai;16;26;42
95;22.07.2018;2018;07;15;Sunnuntai;21;32;53
95;22.07.2018;2018;07;16;Sunnuntai;12;12;24
95;22.07.2018;2018;07;17;Sunnuntai;11;9;20
95;22.07.2018;2018;07;18;Sunnuntai;13;11;24
95;22.07.2018;2018;07;19;Sunnuntai;8;8;16
95;22.07.2018;2018;07;20;Sunnuntai;14;10;24
95;22.07.2018;2018;07;21;Sunnuntai;5;8;13
95;22.07.2018;2018;07;22;Sunnuntai;2;2;4
95;22.07.2018;2018;07;23;Sunnuntai;0;3;3
95;23.07.2018;2018;07;00;Maanantai;0;0;0
95;23.07.2018;2018;07;01;Maanantai;0;0;0
95;23.07.2018;2018;07;02;Maanantai;0;0;0
95;23.07.2018;2018;07;03;Maanantai;0;0;0
95;23.07.2018;2018;07;04;Maanantai;2;2;4
95;23.07.2018;2018;07;05;Maanantai;7;1;8
95;23.07.2018;2018;07;06;Maanantai;13;15;28
95;23.07.2018;2018;07;07;Maanantai;21;15;36
95;23.07.2018;2018;07;08;Maanantai;18;15;33
95;23.07.2018;2018;07;09;Maanantai;12;18;30
95;23.07.2018;2018;07;10;Maanantai;17;9;26
95;23.07.2018;2018;07;11;Maanantai;15;17;32
95;23.07.2018;2018;07;12;Maanantai;27;24;51
95;23.07.2018;2018;07;13;Maanantai;23;16;39
95;23.07.2018;2018;07;14;Maanantai;16;26;42
95;23.07.2018;2018;07;15;Maanantai;33;33;66
95;23.07.2018;2018;07;16;Maanantai;46;42;88
95;23.07.2018;2018;07;17;Maanantai;41;22;63
95;23.07.2018;2018;07;18;Maanantai;25;40;65
95;23.07.2018;2018;07;19;Maanantai;20;34;54
95;23.07.2018;2018;07;20;Maanantai;34;26;60
95;23.07.2018;2018;07;21;Maanantai;18;22;40
95;23.07.2018;2018;07;22;Maanantai;10;9;19
95;23.07.2018;2018;07;23;Maanantai;3;6;9
95;24.07.2018;2018;07;00;Tiistai;3;0;3
95;24.07.2018;2018;07;01;Tiistai;0;4;4
95;24.07.2018;2018;07;02;Tiistai;3;0;3
95;24.07.2018;2018;07;03;Tiistai;0;0;0
95;24.07.2018;2018;07;04;Tiistai;1;1;2
95;24.07.2018;2018;07;05;Tiistai;8;1;9
95;24.07.2018;2018;07;06;Tiistai;28;15;43
95;24.07.2018;2018;07;07;Tiistai;22;19;41
95;24.07.2018;2018;07;08;Tiistai;18;17;35
95;24.07.2018;2018;07;09;Tiistai;14;13;27
95;24.07.2018;2018;07;10;Tiistai;22;13;35
95;24.07.2018;2018;07;11;Tiistai;25;19;44
95;24.07.2018;2018;07;12;Tiistai;22;12;34
95;24.07.2018;2018;07;13;Tiistai;32;28;60
95;24.07.2018;2018;07;14;Tiistai;23;27;50
95;24.07.2018;2018;07;15;Tiistai;32;37;69
95;24.07.2018;2018;07;16;Tiistai;28;38;66
95;24.07.2018;2018;07;17;Tiistai;28;27;55
95;24.07.2018;2018;07;18;Tiistai;30;32;62
95;24.07.2018;2018;07;19;Tiistai;29;34;63
95;24.07.2018;2018;07;20;Tiistai;23;26;49
95;24.07.2018;2018;07;21;Tiistai;19;14;33
95;24.07.2018;2018;07;22;Tiistai;15;10;25
95;24.07.2018;2018;07;23;Tiistai;2;4;6
95;25.07.2018;2018;07;00;Keskiviikko;0;0;0
95;25.07.2018;2018;07;01;Keskiviikko;2;1;3
95;25.07.2018;2018;07;02;Keskiviikko;0;1;1
95;25.07.2018;2018;07;03;Keskiviikko;1;1;2
95;25.07.2018;2018;07;04;Keskiviikko;0;0;0
95;25.07.2018;2018;07;05;Keskiviikko;9;2;11
95;25.07.2018;2018;07;06;Keskiviikko;20;11;31
95;25.07.2018;2018;07;07;Keskiviikko;28;15;43
95;25.07.2018;2018;07;08;Keskiviikko;26;7;33
95;25.07.2018;2018;07;09;Keskiviikko;12;23;35
95;25.07.2018;2018;07;10;Keskiviikko;28;20;48
95;25.07.2018;2018;07;11;Keskiviikko;20;15;35
95;25.07.2018;2018;07;12;Keskiviikko;23;18;41
95;25.07.2018;2018;07;13;Keskiviikko;15;21;36
95;25.07.2018;2018;07;14;Keskiviikko;21;17;38
95;25.07.2018;2018;07;15;Keskiviikko;23;44;67
95;25.07.2018;2018;07;16;Keskiviikko;37;32;69
95;25.07.2018;2018;07;17;Keskiviikko;24;23;47
95;25.07.2018;2018;07;18;Keskiviikko;28;33;61
95;25.07.2018;2018;07;19;Keskiviikko;18;25;43
95;25.07.2018;2018;07;20;Keskiviikko;25;16;41
95;25.07.2018;2018;07;21;Keskiviikko;13;10;23
95;25.07.2018;2018;07;22;Keskiviikko;5;8;13
95;25.07.2018;2018;07;23;Keskiviikko;2;6;8
95;26.07.2018;2018;07;00;Torstai;1;5;6
95;26.07.2018;2018;07;01;Torstai;1;1;2
95;26.07.2018;2018;07;02;Torstai;0;0;0
95;26.07.2018;2018;07;03;Torstai;1;1;2
95;26.07.2018;2018;07;04;Torstai;1;1;2
95;26.07.2018;2018;07;05;Torstai;7;2;9
95;26.07.2018;2018;07;06;Torstai;13;14;27
95;26.07.2018;2018;07;07;Torstai;25;13;38
95;26.07.2018;2018;07;08;Torstai;23;22;45
95;26.07.2018;2018;07;09;Torstai;12;18;30
95;26.07.2018;2018;07;10;Torstai;12;14;26
95;26.07.2018;2018;07;11;Torstai;14;22;36
95;26.07.2018;2018;07;12;Torstai;20;17;37
95;26.07.2018;2018;07;13;Torstai;23;16;39
95;26.07.2018;2018;07;14;Torstai;19;14;33
95;26.07.2018;2018;07;15;Torstai;24;29;53
95;26.07.2018;2018;07;16;Torstai;32;35;67
95;26.07.2018;2018;07;17;Torstai;9;39;48
95;26.07.2018;2018;07;18;Torstai;26;26;52
95;26.07.2018;2018;07;19;Torstai;23;28;51
95;26.07.2018;2018;07;20;Torstai;23;26;49
95;26.07.2018;2018;07;21;Torstai;15;7;22
95;26.07.2018;2018;07;22;Torstai;5;8;13
95;26.07.2018;2018;07;23;Torstai;6;3;9
95;27.07.2018;2018;07;00;Perjantai;0;3;3
95;27.07.2018;2018;07;01;Perjantai;3;1;4
95;27.07.2018;2018;07;02;Perjantai;0;0;0
95;27.07.2018;2018;07;03;Perjantai;1;0;1
95;27.07.2018;2018;07;04;Perjantai;0;1;1
95;27.07.2018;2018;07;05;Perjantai;3;1;4
95;27.07.2018;2018;07;06;Perjantai;9;13;22
95;27.07.2018;2018;07;07;Perjantai;22;17;39
95;27.07.2018;2018;07;08;Perjantai;8;10;18
95;27.07.2018;2018;07;09;Perjantai;12;7;19
95;27.07.2018;2018;07;10;Perjantai;16;17;33
95;27.07.2018;2018;07;11;Perjantai;44;22;66
95;27.07.2018;2018;07;12;Perjantai;31;25;56
95;27.07.2018;2018;07;13;Perjantai;28;16;44
95;27.07.2018;2018;07;14;Perjantai;37;23;60
95;27.07.2018;2018;07;15;Perjantai;28;34;62
95;27.07.2018;2018;07;16;Perjantai;31;28;59
95;27.07.2018;2018;07;17;Perjantai;26;16;42
95;27.07.2018;2018;07;18;Perjantai;21;14;35
95;27.07.2018;2018;07;19;Perjantai;21;16;37
95;27.07.2018;2018;07;20;Perjantai;18;15;33
95;27.07.2018;2018;07;21;Perjantai;9;7;16
95;27.07.2018;2018;07;22;Perjantai;7;6;13
95;27.07.2018;2018;07;23;Perjantai;1;14;15
95;28.07.2018;2018;07;00;Lauantai;2;8;10
95;28.07.2018;2018;07;01;Lauantai;0;10;10
95;28.07.2018;2018;07;02;Lauantai;1;4;5
95;28.07.2018;2018;07;03;Lauantai;1;9;10
95;28.07.2018;2018;07;04;Lauantai;3;7;10
95;28.07.2018;2018;07;05;Lauantai;3;5;8
95;28.07.2018;2018;07;06;Lauantai;1;2;3
95;28.07.2018;2018;07;07;Lauantai;3;4;7
95;28.07.2018;2018;07;08;Lauantai;3;7;10
95;28.07.2018;2018;07;09;Lauantai;13;12;25
95;28.07.2018;2018;07;10;Lauantai;14;9;23
95;28.07.2018;2018;07;11;Lauantai;15;17;32
95;28.07.2018;2018;07;12;Lauantai;26;19;45
95;28.07.2018;2018;07;13;Lauantai;31;19;50
95;28.07.2018;2018;07;14;Lauantai;14;17;31
95;28.07.2018;2018;07;15;Lauantai;22;17;39
95;28.07.2018;2018;07;16;Lauantai;33;16;49
95;28.07.2018;2018;07;17;Lauantai;18;18;36
95;28.07.2018;2018;07;18;Lauantai;31;25;56
95;28.07.2018;2018;07;19;Lauantai;24;21;45
95;28.07.2018;2018;07;20;Lauantai;15;16;31
95;28.07.2018;2018;07;21;Lauantai;12;8;20
95;28.07.2018;2018;07;22;Lauantai;5;7;12
95;28.07.2018;2018;07;23;Lauantai;2;6;8
95;29.07.2018;2018;07;00;Sunnuntai;2;8;10
95;29.07.2018;2018;07;01;Sunnuntai;2;15;17
95;29.07.2018;2018;07;02;Sunnuntai;5;9;14
95;29.07.2018;2018;07;03;Sunnuntai;0;8;8
95;29.07.2018;2018;07;04;Sunnuntai;0;6;6
95;29.07.2018;2018;07;05;Sunnuntai;1;4;5
95;29.07.2018;2018;07;06;Sunnuntai;6;6;12
95;29.07.2018;2018;07;07;Sunnuntai;3;3;6
95;29.07.2018;2018;07;08;Sunnuntai;6;7;13
95;29.07.2018;2018;07;09;Sunnuntai;11;3;14
95;29.07.2018;2018;07;10;Sunnuntai;16;23;39
95;29.07.2018;2018;07;11;Sunnuntai;24;20;44
95;29.07.2018;2018;07;12;Sunnuntai;25;14;39
95;29.07.2018;2018;07;13;Sunnuntai;20;17;37
95;29.07.2018;2018;07;14;Sunnuntai;21;21;42
95;29.07.2018;2018;07;15;Sunnuntai;32;30;62
95;29.07.2018;2018;07;16;Sunnuntai;14;19;33
95;29.07.2018;2018;07;17;Sunnuntai;20;28;48
95;29.07.2018;2018;07;18;Sunnuntai;23;16;39
95;29.07.2018;2018;07;19;Sunnuntai;22;24;46
95;29.07.2018;2018;07;20;Sunnuntai;19;14;33
95;29.07.2018;2018;07;21;Sunnuntai;12;16;28
95;29.07.2018;2018;07;22;Sunnuntai;12;10;22
95;29.07.2018;2018;07;23;Sunnuntai;2;2;4
95;30.07.2018;2018;07;00;Maanantai;1;4;5
95;30.07.2018;2018;07;01;Maanantai;0;3;3
95;30.07.2018;2018;07;02;Maanantai;1;2;3
95;30.07.2018;2018;07;03;Maanantai;0;0;0
95;30.07.2018;2018;07;04;Maanantai;0;0;0
95;30.07.2018;2018;07;05;Maanantai;9;6;15
95;30.07.2018;2018;07;06;Maanantai;31;16;47
95;30.07.2018;2018;07;07;Maanantai;19;16;35
95;30.07.2018;2018;07;08;Maanantai;17;14;31
95;30.07.2018;2018;07;09;Maanantai;15;15;30
95;30.07.2018;2018;07;10;Maanantai;29;17;46
95;30.07.2018;2018;07;11;Maanantai;24;14;38
95;30.07.2018;2018;07;12;Maanantai;16;17;33
95;30.07.2018;2018;07;13;Maanantai;13;26;39
95;30.07.2018;2018;07;14;Maanantai;21;25;46
95;30.07.2018;2018;07;15;Maanantai;38;31;69
95;30.07.2018;2018;07;16;Maanantai;33;44;77
95;30.07.2018;2018;07;17;Maanantai;27;28;55
95;30.07.2018;2018;07;18;Maanantai;15;24;39
95;30.07.2018;2018;07;19;Maanantai;26;25;51
95;30.07.2018;2018;07;20;Maanantai;28;22;50
95;30.07.2018;2018;07;21;Maanantai;18;15;33
95;30.07.2018;2018;07;22;Maanantai;13;10;23
95;30.07.2018;2018;07;23;Maanantai;4;3;7
95;31.07.2018;2018;07;00;Tiistai;4;4;8
95;31.07.2018;2018;07;01;Tiistai;2;0;2
95;31.07.2018;2018;07;02;Tiistai;1;0;1
95;31.07.2018;2018;07;03;Tiistai;0;0;0
95;31.07.2018;2018;07;04;Tiistai;0;2;2
95;31.07.2018;2018;07;05;Tiistai;11;4;15
95;31.07.2018;2018;07;06;Tiistai;31;15;46
95;31.07.2018;2018;07;07;Tiistai;19;24;43
95;31.07.2018;2018;07;08;Tiistai;22;14;36
95;31.07.2018;2018;07;09;Tiistai;20;30;50
95;31.07.2018;2018;07;10;Tiistai;20;15;35
95;31.07.2018;2018;07;11;Tiistai;34;23;57
95;31.07.2018;2018;07;12;Tiistai;18;16;34
95;31.07.2018;2018;07;13;Tiistai;23;21;44
95;31.07.2018;2018;07;14;Tiistai;36;24;60
95;31.07.2018;2018;07;15;Tiistai;21;39;60
95;31.07.2018;2018;07;16;Tiistai;27;42;69
95;31.07.2018;2018;07;17;Tiistai;15;16;31
95;31.07.2018;2018;07;18;Tiistai;19;27;46
95;31.07.2018;2018;07;19;Tiistai;17;30;47
95;31.07.2018;2018;07;20;Tiistai;24;18;42
95;31.07.2018;2018;07;21;Tiistai;14;12;26
95;31.07.2018;2018;07;22;Tiistai;5;2;7
95;31.07.2018;2018;07;23;Tiistai;2;3;5
95;01.08.2018;2018;08;00;Keskiviikko;2;2;4
95;01.08.2018;2018;08;01;Keskiviikko;0;2;2
95;01.08.2018;2018;08;02;Keskiviikko;0;2;2
95;01.08.2018;2018;08;03;Keskiviikko;0;0;0
95;01.08.2018;2018;08;04;Keskiviikko;0;3;3
95;01.08.2018;2018;08;05;Keskiviikko;7;3;10
95;01.08.2018;2018;08;06;Keskiviikko;20;10;30
95;01.08.2018;2018;08;07;Keskiviikko;17;17;34
95;01.08.2018;2018;08;08;Keskiviikko;13;12;25
95;01.08.2018;2018;08;09;Keskiviikko;14;11;25
95;01.08.2018;2018;08;10;Keskiviikko;12;13;25
95;01.08.2018;2018;08;11;Keskiviikko;15;15;30
95;01.08.2018;2018;08;12;Keskiviikko;15;21;36
95;01.08.2018;2018;08;13;Keskiviikko;13;20;33
95;01.08.2018;2018;08;14;Keskiviikko;24;12;36
95;01.08.2018;2018;08;15;Keskiviikko;26;27;53
95;01.08.2018;2018;08;16;Keskiviikko;26;27;53
95;01.08.2018;2018;08;17;Keskiviikko;13;18;31
95;01.08.2018;2018;08;18;Keskiviikko;13;25;38
95;01.08.2018;2018;08;19;Keskiviikko;20;17;37
95;01.08.2018;2018;08;20;Keskiviikko;26;18;44
95;01.08.2018;2018;08;21;Keskiviikko;11;17;28
95;01.08.2018;2018;08;22;Keskiviikko;3;4;7
95;01.08.2018;2018;08;23;Keskiviikko;7;6;13
95;02.08.2018;2018;08;00;Torstai;1;2;3
95;02.08.2018;2018;08;01;Torstai;1;2;3
95;02.08.2018;2018;08;02;Torstai;2;0;2
95;02.08.2018;2018;08;03;Torstai;0;1;1
95;02.08.2018;2018;08;04;Torstai;1;1;2
95;02.08.2018;2018;08;05;Torstai;7;7;14
95;02.08.2018;2018;08;06;Torstai;24;12;36
95;02.08.2018;2018;08;07;Torstai;22;21;43
95;02.08.2018;2018;08;08;Torstai;21;8;29
95;02.08.2018;2018;08;09;Torstai;11;12;23
95;02.08.2018;2018;08;10;Torstai;23;17;40
95;02.08.2018;2018;08;11;Torstai;26;26;52
95;02.08.2018;2018;08;12;Torstai;17;16;33
95;02.08.2018;2018;08;13;Torstai;12;12;24
95;02.08.2018;2018;08;14;Torstai;16;22;38
95;02.08.2018;2018;08;15;Torstai;23;30;53
95;02.08.2018;2018;08;16;Torstai;28;40;68
95;02.08.2018;2018;08;17;Torstai;19;46;65
95;02.08.2018;2018;08;18;Torstai;24;25;49
95;02.08.2018;2018;08;19;Torstai;22;29;51
95;02.08.2018;2018;08;20;Torstai;30;24;54
95;02.08.2018;2018;08;21;Torstai;33;13;46
95;02.08.2018;2018;08;22;Torstai;6;5;11
95;02.08.2018;2018;08;23;Torstai;5;1;6
95;03.08.2018;2018;08;00;Perjantai;2;1;3
95;03.08.2018;2018;08;01;Perjantai;3;0;3
95;03.08.2018;2018;08;02;Perjantai;0;1;1
95;03.08.2018;2018;08;03;Perjantai;1;0;1
95;03.08.2018;2018;08;04;Perjantai;0;2;2
95;03.08.2018;2018;08;05;Perjantai;4;6;10
95;03.08.2018;2018;08;06;Perjantai;5;6;11
95;03.08.2018;2018;08;07;Perjantai;3;5;8
95;03.08.2018;2018;08;08;Perjantai;2;7;9
95;03.08.2018;2018;08;09;Perjantai;4;1;5
95;03.08.2018;2018;08;10;Perjantai;0;3;3
95;03.08.2018;2018;08;11;Perjantai;3;1;4
95;03.08.2018;2018;08;12;Perjantai;2;1;3
95;03.08.2018;2018;08;13;Perjantai;8;3;11
95;03.08.2018;2018;08;14;Perjantai;11;24;35
95;03.08.2018;2018;08;15;Perjantai;23;19;42
95;03.08.2018;2018;08;16;Perjantai;16;19;35
95;03.08.2018;2018;08;17;Perjantai;17;12;29
95;03.08.2018;2018;08;18;Perjantai;13;19;32
95;03.08.2018;2018;08;19;Perjantai;19;18;37
95;03.08.2018;2018;08;20;Perjantai;14;11;25
95;03.08.2018;2018;08;21;Perjantai;8;7;15
95;03.08.2018;2018;08;22;Perjantai;1;9;10
95;03.08.2018;2018;08;23;Perjantai;4;4;8
95;04.08.2018;2018;08;00;Lauantai;0;2;2
95;04.08.2018;2018;08;01;Lauantai;0;2;2
95;04.08.2018;2018;08;02;Lauantai;1;0;1
95;04.08.2018;2018;08;03;Lauantai;0;1;1
95;04.08.2018;2018;08;04;Lauantai;1;2;3
95;04.08.2018;2018;08;05;Lauantai;0;1;1
95;04.08.2018;2018;08;06;Lauantai;6;0;6
95;04.08.2018;2018;08;07;Lauantai;3;3;6
95;04.08.2018;2018;08;08;Lauantai;5;5;10
95;04.08.2018;2018;08;09;Lauantai;9;18;27
95;04.08.2018;2018;08;10;Lauantai;15;12;27
95;04.08.2018;2018;08;11;Lauantai;12;28;40
95;04.08.2018;2018;08;12;Lauantai;28;31;59
95;04.08.2018;2018;08;13;Lauantai;18;37;55
95;04.08.2018;2018;08;14;Lauantai;25;32;57
95;04.08.2018;2018;08;15;Lauantai;21;12;33
95;04.08.2018;2018;08;16;Lauantai;22;20;42
95;04.08.2018;2018;08;17;Lauantai;20;24;44
95;04.08.2018;2018;08;18;Lauantai;14;31;45
95;04.08.2018;2018;08;19;Lauantai;24;29;53
95;04.08.2018;2018;08;20;Lauantai;14;16;30
95;04.08.2018;2018;08;21;Lauantai;6;10;16
95;04.08.2018;2018;08;22;Lauantai;3;7;10
95;04.08.2018;2018;08;23;Lauantai;1;2;3
95;05.08.2018;2018;08;00;Sunnuntai;1;1;2
95;05.08.2018;2018;08;01;Sunnuntai;2;4;6
95;05.08.2018;2018;08;02;Sunnuntai;5;4;9
95;05.08.2018;2018;08;03;Sunnuntai;2;1;3
95;05.08.2018;2018;08;04;Sunnuntai;3;0;3
95;05.08.2018;2018;08;05;Sunnuntai;1;3;4
95;05.08.2018;2018;08;06;Sunnuntai;2;3;5
95;05.08.2018;2018;08;07;Sunnuntai;5;4;9
95;05.08.2018;2018;08;08;Sunnuntai;6;4;10
95;05.08.2018;2018;08;09;Sunnuntai;10;9;19
95;05.08.2018;2018;08;10;Sunnuntai;18;20;38
95;05.08.2018;2018;08;11;Sunnuntai;28;14;42
95;05.08.2018;2018;08;12;Sunnuntai;25;20;45
95;05.08.2018;2018;08;13;Sunnuntai;19;11;30
95;05.08.2018;2018;08;14;Sunnuntai;11;16;27
95;05.08.2018;2018;08;15;Sunnuntai;19;18;37
95;05.08.2018;2018;08;16;Sunnuntai;18;12;30
95;05.08.2018;2018;08;17;Sunnuntai;26;18;44
95;05.08.2018;2018;08;18;Sunnuntai;22;15;37
95;05.08.2018;2018;08;19;Sunnuntai;27;15;42
95;05.08.2018;2018;08;20;Sunnuntai;21;16;37
95;05.08.2018;2018;08;21;Sunnuntai;0;7;7
95;05.08.2018;2018;08;22;Sunnuntai;2;3;5
95;05.08.2018;2018;08;23;Sunnuntai;2;1;3
95;06.08.2018;2018;08;00;Maanantai;0;0;0
95;06.08.2018;2018;08;01;Maanantai;0;1;1
95;06.08.2018;2018;08;02;Maanantai;1;0;1
95;06.08.2018;2018;08;03;Maanantai;0;0;0
95;06.08.2018;2018;08;04;Maanantai;2;1;3
95;06.08.2018;2018;08;05;Maanantai;8;3;11
95;06.08.2018;2018;08;06;Maanantai;12;11;23
95;06.08.2018;2018;08;07;Maanantai;21;13;34
95;06.08.2018;2018;08;08;Maanantai;8;10;18
95;06.08.2018;2018;08;09;Maanantai;4;4;8
95;06.08.2018;2018;08;10;Maanantai;8;2;10
95;06.08.2018;2018;08;11;Maanantai;6;5;11
95;06.08.2018;2018;08;12;Maanantai;4;0;4
95;06.08.2018;2018;08;13;Maanantai;5;0;5
95;06.08.2018;2018;08;14;Maanantai;3;8;11
95;06.08.2018;2018;08;15;Maanantai;16;17;33
95;06.08.2018;2018;08;16;Maanantai;25;21;46
95;06.08.2018;2018;08;17;Maanantai;12;18;30
95;06.08.2018;2018;08;18;Maanantai;10;15;25
95;06.08.2018;2018;08;19;Maanantai;16;17;33
95;06.08.2018;2018;08;20;Maanantai;9;11;20
95;06.08.2018;2018;08;21;Maanantai;6;18;24
95;06.08.2018;2018;08;22;Maanantai;6;8;14
95;06.08.2018;2018;08;23;Maanantai;1;0;1
95;07.08.2018;2018;08;00;Tiistai;6;0;6
95;07.08.2018;2018;08;01;Tiistai;1;0;1
95;07.08.2018;2018;08;02;Tiistai;1;0;1
95;07.08.2018;2018;08;03;Tiistai;0;0;0
95;07.08.2018;2018;08;04;Tiistai;1;0;1
95;07.08.2018;2018;08;05;Tiistai;11;0;11
95;07.08.2018;2018;08;06;Tiistai;32;0;32
95;07.08.2018;2018;08;07;Tiistai;30;0;30
95;07.08.2018;2018;08;08;Tiistai;25;0;25
95;07.08.2018;2018;08;09;Tiistai;35;0;35
95;07.08.2018;2018;08;10;Tiistai;25;0;25
95;07.08.2018;2018;08;11;Tiistai;40;0;40
95;07.08.2018;2018;08;12;Tiistai;24;0;24
95;07.08.2018;2018;08;13;Tiistai;31;0;31
95;07.08.2018;2018;08;14;Tiistai;42;0;42
95;07.08.2018;2018;08;15;Tiistai;42;0;42
95;07.08.2018;2018;08;16;Tiistai;48;0;48
95;07.08.2018;2018;08;17;Tiistai;22;0;22
95;07.08.2018;2018;08;18;Tiistai;32;0;32
95;07.08.2018;2018;08;19;Tiistai;33;0;33
95;07.08.2018;2018;08;20;Tiistai;29;0;29
95;07.08.2018;2018;08;21;Tiistai;18;0;18
95;07.08.2018;2018;08;22;Tiistai;5;0;5
95;07.08.2018;2018;08;23;Tiistai;4;0;4
95;08.08.2018;2018;08;00;Keskiviikko;1;1;2
95;08.08.2018;2018;08;01;Keskiviikko;0;0;0
95;08.08.2018;2018;08;02;Keskiviikko;0;0;0
95;08.08.2018;2018;08;03;Keskiviikko;1;1;2
95;08.08.2018;2018;08;04;Keskiviikko;1;0;1
95;08.08.2018;2018;08;05;Keskiviikko;6;4;10
95;08.08.2018;2018;08;06;Keskiviikko;29;20;49
95;08.08.2018;2018;08;07;Keskiviikko;34;27;61
95;08.08.2018;2018;08;08;Keskiviikko;13;26;39
95;08.08.2018;2018;08;09;Keskiviikko;14;11;25
95;08.08.2018;2018;08;10;Keskiviikko;15;11;26
95;08.08.2018;2018;08;11;Keskiviikko;21;13;34
95;08.08.2018;2018;08;12;Keskiviikko;21;13;34
95;08.08.2018;2018;08;13;Keskiviikko;22;11;33
95;08.08.2018;2018;08;14;Keskiviikko;24;11;35
95;08.08.2018;2018;08;15;Keskiviikko;37;41;78
95;08.08.2018;2018;08;16;Keskiviikko;46;51;97
95;08.08.2018;2018;08;17;Keskiviikko;31;32;63
95;08.08.2018;2018;08;18;Keskiviikko;35;26;61
95;08.08.2018;2018;08;19;Keskiviikko;29;25;54
95;08.08.2018;2018;08;20;Keskiviikko;12;12;24
95;08.08.2018;2018;08;21;Keskiviikko;8;14;22
95;08.08.2018;2018;08;22;Keskiviikko;1;5;6
95;08.08.2018;2018;08;23;Keskiviikko;1;0;1
95;09.08.2018;2018;08;00;Torstai;1;0;1
95;09.08.2018;2018;08;01;Torstai;0;0;0
95;09.08.2018;2018;08;02;Torstai;2;0;2
95;09.08.2018;2018;08;03;Torstai;1;0;1
95;09.08.2018;2018;08;04;Torstai;0;2;2
95;09.08.2018;2018;08;05;Torstai;6;1;7
95;09.08.2018;2018;08;06;Torstai;24;10;34
95;09.08.2018;2018;08;07;Torstai;23;23;46
95;09.08.2018;2018;08;08;Torstai;7;27;34
95;09.08.2018;2018;08;09;Torstai;11;4;15
95;09.08.2018;2018;08;10;Torstai;13;9;22
95;09.08.2018;2018;08;11;Torstai;13;9;22
95;09.08.2018;2018;08;12;Torstai;14;12;26
95;09.08.2018;2018;08;13;Torstai;26;13;39
95;09.08.2018;2018;08;14;Torstai;13;15;28
95;09.08.2018;2018;08;15;Torstai;32;24;56
95;09.08.2018;2018;08;16;Torstai;22;32;54
95;09.08.2018;2018;08;17;Torstai;15;24;39
95;09.08.2018;2018;08;18;Torstai;8;9;17
95;09.08.2018;2018;08;19;Torstai;19;15;34
95;09.08.2018;2018;08;20;Torstai;14;13;27
95;09.08.2018;2018;08;21;Torstai;9;6;15
95;09.08.2018;2018;08;22;Torstai;3;3;6
95;09.08.2018;2018;08;23;Torstai;2;1;3
95;10.08.2018;2018;08;00;Perjantai;3;1;4
95;10.08.2018;2018;08;01;Perjantai;0;0;0
95;10.08.2018;2018;08;02;Perjantai;0;0;0
95;10.08.2018;2018;08;03;Perjantai;0;0;0
95;10.08.2018;2018;08;04;Perjantai;2;0;2
95;10.08.2018;2018;08;05;Perjantai;11;3;14
95;10.08.2018;2018;08;06;Perjantai;16;14;30
95;10.08.2018;2018;08;07;Perjantai;24;20;44
95;10.08.2018;2018;08;08;Perjantai;13;25;38
95;10.08.2018;2018;08;09;Perjantai;16;13;29
95;10.08.2018;2018;08;10;Perjantai;20;15;35
95;10.08.2018;2018;08;11;Perjantai;24;19;43
95;10.08.2018;2018;08;12;Perjantai;20;20;40
95;10.08.2018;2018;08;13;Perjantai;47;18;65
95;10.08.2018;2018;08;14;Perjantai;29;19;48
95;10.08.2018;2018;08;15;Perjantai;36;26;62
95;10.08.2018;2018;08;16;Perjantai;29;33;62
95;10.08.2018;2018;08;17;Perjantai;23;21;44
95;10.08.2018;2018;08;18;Perjantai;19;14;33
95;10.08.2018;2018;08;19;Perjantai;12;11;23
95;10.08.2018;2018;08;20;Perjantai;7;6;13
95;10.08.2018;2018;08;21;Perjantai;0;7;7
95;10.08.2018;2018;08;22;Perjantai;0;1;1
95;10.08.2018;2018;08;23;Perjantai;3;2;5
95;11.08.2018;2018;08;00;Lauantai;1;0;1
95;11.08.2018;2018;08;01;Lauantai;0;1;1
95;11.08.2018;2018;08;02;Lauantai;0;1;1
95;11.08.2018;2018;08;03;Lauantai;0;0;0
95;11.08.2018;2018;08;04;Lauantai;2;0;2
95;11.08.2018;2018;08;05;Lauantai;0;1;1
95;11.08.2018;2018;08;06;Lauantai;1;0;1
95;11.08.2018;2018;08;07;Lauantai;4;2;6
95;11.08.2018;2018;08;08;Lauantai;12;1;13
95;11.08.2018;2018;08;09;Lauantai;12;17;29
95;11.08.2018;2018;08;10;Lauantai;17;14;31
95;11.08.2018;2018;08;11;Lauantai;20;21;41
95;11.08.2018;2018;08;12;Lauantai;12;34;46
95;11.08.2018;2018;08;13;Lauantai;18;18;36
95;11.08.2018;2018;08;14;Lauantai;9;18;27
95;11.08.2018;2018;08;15;Lauantai;15;6;21
95;11.08.2018;2018;08;16;Lauantai;13;19;32
95;11.08.2018;2018;08;17;Lauantai;10;8;18
95;11.08.2018;2018;08;18;Lauantai;7;4;11
95;11.08.2018;2018;08;19;Lauantai;6;4;10
95;11.08.2018;2018;08;20;Lauantai;3;4;7
95;11.08.2018;2018;08;21;Lauantai;6;8;14
95;11.08.2018;2018;08;22;Lauantai;0;2;2
95;11.08.2018;2018;08;23;Lauantai;1;1;2
95;12.08.2018;2018;08;00;Sunnuntai;2;0;2
95;12.08.2018;2018;08;01;Sunnuntai;0;0;0
95;12.08.2018;2018;08;02;Sunnuntai;4;0;4
95;12.08.2018;2018;08;03;Sunnuntai;0;0;0
95;12.08.2018;2018;08;04;Sunnuntai;0;0;0
95;12.08.2018;2018;08;05;Sunnuntai;0;0;0
95;12.08.2018;2018;08;06;Sunnuntai;2;0;2
95;12.08.2018;2018;08;07;Sunnuntai;3;4;7
95;12.08.2018;2018;08;08;Sunnuntai;6;6;12
95;12.08.2018;2018;08;09;Sunnuntai;6;12;18
95;12.08.2018;2018;08;10;Sunnuntai;19;21;40
95;12.08.2018;2018;08;11;Sunnuntai;21;22;43
95;12.08.2018;2018;08;12;Sunnuntai;26;15;41
95;12.08.2018;2018;08;13;Sunnuntai;18;10;28
95;12.08.2018;2018;08;14;Sunnuntai;13;23;36
95;12.08.2018;2018;08;15;Sunnuntai;14;28;42
95;12.08.2018;2018;08;16;Sunnuntai;12;24;36
95;12.08.2018;2018;08;17;Sunnuntai;22;21;43
95;12.08.2018;2018;08;18;Sunnuntai;20;20;40
95;12.08.2018;2018;08;19;Sunnuntai;21;10;31
95;12.08.2018;2018;08;20;Sunnuntai;12;21;33
95;12.08.2018;2018;08;21;Sunnuntai;5;5;10
95;12.08.2018;2018;08;22;Sunnuntai;4;2;6
95;12.08.2018;2018;08;23;Sunnuntai;0;2;2
95;13.08.2018;2018;08;00;Maanantai;0;0;0
95;13.08.2018;2018;08;01;Maanantai;0;0;0
95;13.08.2018;2018;08;02;Maanantai;0;0;0
95;13.08.2018;2018;08;03;Maanantai;0;0;0
95;13.08.2018;2018;08;04;Maanantai;1;0;1
95;13.08.2018;2018;08;05;Maanantai;5;5;10
95;13.08.2018;2018;08;06;Maanantai;19;8;27
95;13.08.2018;2018;08;07;Maanantai;9;15;24
95;13.08.2018;2018;08;08;Maanantai;8;9;17
95;13.08.2018;2018;08;09;Maanantai;2;25;27
95;13.08.2018;2018;08;10;Maanantai;3;8;11
95;13.08.2018;2018;08;11;Maanantai;8;7;15
95;13.08.2018;2018;08;12;Maanantai;5;6;11
95;13.08.2018;2018;08;13;Maanantai;8;4;12
95;13.08.2018;2018;08;14;Maanantai;10;10;20
95;13.08.2018;2018;08;15;Maanantai;28;19;47
95;13.08.2018;2018;08;16;Maanantai;33;20;53
95;13.08.2018;2018;08;17;Maanantai;14;14;28
95;13.08.2018;2018;08;18;Maanantai;6;8;14
95;13.08.2018;2018;08;19;Maanantai;7;12;19
95;13.08.2018;2018;08;20;Maanantai;8;5;13
95;13.08.2018;2018;08;21;Maanantai;3;8;11
95;13.08.2018;2018;08;22;Maanantai;2;2;4
95;13.08.2018;2018;08;23;Maanantai;0;1;1
95;14.08.2018;2018;08;00;Tiistai;0;1;1
95;14.08.2018;2018;08;01;Tiistai;0;0;0
95;14.08.2018;2018;08;02;Tiistai;0;0;0
95;14.08.2018;2018;08;03;Tiistai;0;0;0
95;14.08.2018;2018;08;04;Tiistai;2;0;2
95;14.08.2018;2018;08;05;Tiistai;8;3;11
95;14.08.2018;2018;08;06;Tiistai;32;19;51
95;14.08.2018;2018;08;07;Tiistai;25;43;68
95;14.08.2018;2018;08;08;Tiistai;21;21;42
95;14.08.2018;2018;08;09;Tiistai;20;17;37
95;14.08.2018;2018;08;10;Tiistai;19;14;33
95;14.08.2018;2018;08;11;Tiistai;9;18;27
95;14.08.2018;2018;08;12;Tiistai;14;11;25
95;14.08.2018;2018;08;13;Tiistai;9;14;23
95;14.08.2018;2018;08;14;Tiistai;27;12;39
95;14.08.2018;2018;08;15;Tiistai;35;39;74
95;14.08.2018;2018;08;16;Tiistai;32;34;66
95;14.08.2018;2018;08;17;Tiistai;19;30;49
95;14.08.2018;2018;08;18;Tiistai;25;27;52
95;14.08.2018;2018;08;19;Tiistai;23;21;44
95;14.08.2018;2018;08;20;Tiistai;8;13;21
95;14.08.2018;2018;08;21;Tiistai;5;9;14
95;14.08.2018;2018;08;22;Tiistai;3;5;8
95;14.08.2018;2018;08;23;Tiistai;0;1;1
95;15.08.2018;2018;08;00;Keskiviikko;0;1;1
95;15.08.2018;2018;08;01;Keskiviikko;0;0;0
95;15.08.2018;2018;08;02;Keskiviikko;0;0;0
95;15.08.2018;2018;08;03;Keskiviikko;0;0;0
95;15.08.2018;2018;08;04;Keskiviikko;0;0;0
95;15.08.2018;2018;08;05;Keskiviikko;10;2;12
95;15.08.2018;2018;08;06;Keskiviikko;29;15;44
95;15.08.2018;2018;08;07;Keskiviikko;34;41;75
95;15.08.2018;2018;08;08;Keskiviikko;14;26;40
95;15.08.2018;2018;08;09;Keskiviikko;21;12;33
95;15.08.2018;2018;08;10;Keskiviikko;17;11;28
95;15.08.2018;2018;08;11;Keskiviikko;7;10;17
95;15.08.2018;2018;08;12;Keskiviikko;14;16;30
95;15.08.2018;2018;08;13;Keskiviikko;24;10;34
95;15.08.2018;2018;08;14;Keskiviikko;29;20;49
95;15.08.2018;2018;08;15;Keskiviikko;41;35;76
95;15.08.2018;2018;08;16;Keskiviikko;29;42;71
95;15.08.2018;2018;08;17;Keskiviikko;12;26;38
95;15.08.2018;2018;08;18;Keskiviikko;20;18;38
95;15.08.2018;2018;08;19;Keskiviikko;15;20;35
95;15.08.2018;2018;08;20;Keskiviikko;17;8;25
95;15.08.2018;2018;08;21;Keskiviikko;3;7;10
95;15.08.2018;2018;08;22;Keskiviikko;3;1;4
95;15.08.2018;2018;08;23;Keskiviikko;0;0;0
95;16.08.2018;2018;08;00;Torstai;0;2;2
95;16.08.2018;2018;08;01;Torstai;0;1;1
95;16.08.2018;2018;08;02;Torstai;0;0;0
95;16.08.2018;2018;08;03;Torstai;0;0;0
95;16.08.2018;2018;08;04;Torstai;4;0;4
95;16.08.2018;2018;08;05;Torstai;8;5;13
95;16.08.2018;2018;08;06;Torstai;26;24;50
95;16.08.2018;2018;08;07;Torstai;31;21;52
95;16.08.2018;2018;08;08;Torstai;20;20;40
95;16.08.2018;2018;08;09;Torstai;12;21;33
95;16.08.2018;2018;08;10;Torstai;7;10;17
95;16.08.2018;2018;08;11;Torstai;14;12;26
95;16.08.2018;2018;08;12;Torstai;17;12;29
95;16.08.2018;2018;08;13;Torstai;22;11;33
95;16.08.2018;2018;08;14;Torstai;14;17;31
95;16.08.2018;2018;08;15;Torstai;30;25;55
95;16.08.2018;2018;08;16;Torstai;37;36;73
95;16.08.2018;2018;08;17;Torstai;28;28;56
95;16.08.2018;2018;08;18;Torstai;11;17;28
95;16.08.2018;2018;08;19;Torstai;9;14;23
95;16.08.2018;2018;08;20;Torstai;15;17;32
95;16.08.2018;2018;08;21;Torstai;5;8;13
95;16.08.2018;2018;08;22;Torstai;4;9;13
95;16.08.2018;2018;08;23;Torstai;1;0;1
95;17.08.2018;2018;08;00;Perjantai;0;1;1
95;17.08.2018;2018;08;01;Perjantai;1;0;1
95;17.08.2018;2018;08;02;Perjantai;0;1;1
95;17.08.2018;2018;08;03;Perjantai;0;0;0
95;17.08.2018;2018;08;04;Perjantai;3;0;3
95;17.08.2018;2018;08;05;Perjantai;12;2;14
95;17.08.2018;2018;08;06;Perjantai;18;14;32
95;17.08.2018;2018;08;07;Perjantai;20;30;50
95;17.08.2018;2018;08;08;Perjantai;22;14;36
95;17.08.2018;2018;08;09;Perjantai;9;7;16
95;17.08.2018;2018;08;10;Perjantai;14;7;21
95;17.08.2018;2018;08;11;Perjantai;8;8;16
95;17.08.2018;2018;08;12;Perjantai;10;10;20
95;17.08.2018;2018;08;13;Perjantai;17;10;27
95;17.08.2018;2018;08;14;Perjantai;20;16;36
95;17.08.2018;2018;08;15;Perjantai;28;26;54
95;17.08.2018;2018;08;16;Perjantai;22;28;50
95;17.08.2018;2018;08;17;Perjantai;5;19;24
95;17.08.2018;2018;08;18;Perjantai;10;20;30
95;17.08.2018;2018;08;19;Perjantai;9;14;23
95;17.08.2018;2018;08;20;Perjantai;0;4;4
95;17.08.2018;2018;08;21;Perjantai;3;5;8
95;17.08.2018;2018;08;22;Perjantai;2;3;5
95;17.08.2018;2018;08;23;Perjantai;0;1;1
95;18.08.2018;2018;08;00;Lauantai;0;2;2
95;18.08.2018;2018;08;01;Lauantai;0;0;0
95;18.08.2018;2018;08;02;Lauantai;0;0;0
95;18.08.2018;2018;08;03;Lauantai;0;0;0
95;18.08.2018;2018;08;04;Lauantai;2;0;2
95;18.08.2018;2018;08;05;Lauantai;1;0;1
95;18.08.2018;2018;08;06;Lauantai;1;2;3
95;18.08.2018;2018;08;07;Lauantai;2;4;6
95;18.08.2018;2018;08;08;Lauantai;9;4;13
95;18.08.2018;2018;08;09;Lauantai;12;1;13
95;18.08.2018;2018;08;10;Lauantai;9;17;26
95;18.08.2018;2018;08;11;Lauantai;9;18;27
95;18.08.2018;2018;08;12;Lauantai;26;12;38
95;18.08.2018;2018;08;13;Lauantai;23;22;45
95;18.08.2018;2018;08;14;Lauantai;6;35;41
95;18.08.2018;2018;08;15;Lauantai;27;20;47
95;18.08.2018;2018;08;16;Lauantai;17;17;34
95;18.08.2018;2018;08;17;Lauantai;10;17;27
95;18.08.2018;2018;08;18;Lauantai;15;9;24
95;18.08.2018;2018;08;19;Lauantai;15;7;22
95;18.08.2018;2018;08;20;Lauantai;15;14;29
95;18.08.2018;2018;08;21;Lauantai;6;7;13
95;18.08.2018;2018;08;22;Lauantai;1;3;4
95;18.08.2018;2018;08;23;Lauantai;2;2;4
95;19.08.2018;2018;08;00;Sunnuntai;0;2;2
95;19.08.2018;2018;08;01;Sunnuntai;0;1;1
95;19.08.2018;2018;08;02;Sunnuntai;2;0;2
95;19.08.2018;2018;08;03;Sunnuntai;0;2;2
95;19.08.2018;2018;08;04;Sunnuntai;0;0;0
95;19.08.2018;2018;08;05;Sunnuntai;2;3;5
95;19.08.2018;2018;08;06;Sunnuntai;0;1;1
95;19.08.2018;2018;08;07;Sunnuntai;2;2;4
95;19.08.2018;2018;08;08;Sunnuntai;1;4;5
95;19.08.2018;2018;08;09;Sunnuntai;4;8;12
95;19.08.2018;2018;08;10;Sunnuntai;8;8;16
95;19.08.2018;2018;08;11;Sunnuntai;12;11;23
95;19.08.2018;2018;08;12;Sunnuntai;8;9;17
95;19.08.2018;2018;08;13;Sunnuntai;8;7;15
95;19.08.2018;2018;08;14;Sunnuntai;18;13;31
95;19.08.2018;2018;08;15;Sunnuntai;16;13;29
95;19.08.2018;2018;08;16;Sunnuntai;13;11;24
95;19.08.2018;2018;08;17;Sunnuntai;8;9;17
95;19.08.2018;2018;08;18;Sunnuntai;11;7;18
95;19.08.2018;2018;08;19;Sunnuntai;6;7;13
95;19.08.2018;2018;08;20;Sunnuntai;9;13;22
95;19.08.2018;2018;08;21;Sunnuntai;7;5;12
95;19.08.2018;2018;08;22;Sunnuntai;2;3;5
95;19.08.2018;2018;08;23;Sunnuntai;0;2;2
95;20.08.2018;2018;08;00;Maanantai;3;1;4
95;20.08.2018;2018;08;01;Maanantai;0;0;0
95;20.08.2018;2018;08;02;Maanantai;1;0;1
95;20.08.2018;2018;08;03;Maanantai;2;0;2
95;20.08.2018;2018;08;04;Maanantai;2;0;2
95;20.08.2018;2018;08;05;Maanantai;12;10;22
95;20.08.2018;2018;08;06;Maanantai;30;16;46
95;20.08.2018;2018;08;07;Maanantai;21;28;49
95;20.08.2018;2018;08;08;Maanantai;9;18;27
95;20.08.2018;2018;08;09;Maanantai;19;19;38
95;20.08.2018;2018;08;10;Maanantai;12;7;19
95;20.08.2018;2018;08;11;Maanantai;14;9;23
95;20.08.2018;2018;08;12;Maanantai;10;8;18
95;20.08.2018;2018;08;13;Maanantai;12;14;26
95;20.08.2018;2018;08;14;Maanantai;22;16;38
95;20.08.2018;2018;08;15;Maanantai;19;32;51
95;20.08.2018;2018;08;16;Maanantai;42;28;70
95;20.08.2018;2018;08;17;Maanantai;5;27;32
95;20.08.2018;2018;08;18;Maanantai;9;17;26
95;20.08.2018;2018;08;19;Maanantai;13;11;24
95;20.08.2018;2018;08;20;Maanantai;13;9;22
95;20.08.2018;2018;08;21;Maanantai;8;9;17
95;20.08.2018;2018;08;22;Maanantai;3;2;5
95;20.08.2018;2018;08;23;Maanantai;0;1;1
95;21.08.2018;2018;08;00;Tiistai;0;0;0
95;21.08.2018;2018;08;01;Tiistai;0;0;0
95;21.08.2018;2018;08;02;Tiistai;0;0;0
95;21.08.2018;2018;08;03;Tiistai;1;0;1
95;21.08.2018;2018;08;04;Tiistai;0;0;0
95;21.08.2018;2018;08;05;Tiistai;17;8;25
95;21.08.2018;2018;08;06;Tiistai;31;13;44
95;21.08.2018;2018;08;07;Tiistai;29;35;64
95;21.08.2018;2018;08;08;Tiistai;20;18;38
95;21.08.2018;2018;08;09;Tiistai;12;6;18
95;21.08.2018;2018;08;10;Tiistai;6;8;14
95;21.08.2018;2018;08;11;Tiistai;15;19;34
95;21.08.2018;2018;08;12;Tiistai;9;13;22
95;21.08.2018;2018;08;13;Tiistai;16;13;29
95;21.08.2018;2018;08;14;Tiistai;20;16;36
95;21.08.2018;2018;08;15;Tiistai;22;27;49
95;21.08.2018;2018;08;16;Tiistai;31;41;72
95;21.08.2018;2018;08;17;Tiistai;13;26;39
95;21.08.2018;2018;08;18;Tiistai;11;20;31
95;21.08.2018;2018;08;19;Tiistai;10;14;24
95;21.08.2018;2018;08;20;Tiistai;8;10;18
95;21.08.2018;2018;08;21;Tiistai;7;5;12
95;21.08.2018;2018;08;22;Tiistai;2;0;2
95;21.08.2018;2018;08;23;Tiistai;1;2;3
95;22.08.2018;2018;08;00;Keskiviikko;3;0;3
95;22.08.2018;2018;08;01;Keskiviikko;0;0;0
95;22.08.2018;2018;08;02;Keskiviikko;1;0;1
95;22.08.2018;2018;08;03;Keskiviikko;0;0;0
95;22.08.2018;2018;08;04;Keskiviikko;1;0;1
95;22.08.2018;2018;08;05;Keskiviikko;14;5;19
95;22.08.2018;2018;08;06;Keskiviikko;31;16;47
95;22.08.2018;2018;08;07;Keskiviikko;31;26;57
95;22.08.2018;2018;08;08;Keskiviikko;16;21;37
95;22.08.2018;2018;08;09;Keskiviikko;16;13;29
95;22.08.2018;2018;08;10;Keskiviikko;11;14;25
95;22.08.2018;2018;08;11;Keskiviikko;16;9;25
95;22.08.2018;2018;08;12;Keskiviikko;16;11;27
95;22.08.2018;2018;08;13;Keskiviikko;22;14;36
95;22.08.2018;2018;08;14;Keskiviikko;31;23;54
95;22.08.2018;2018;08;15;Keskiviikko;23;28;51
95;22.08.2018;2018;08;16;Keskiviikko;23;48;71
95;22.08.2018;2018;08;17;Keskiviikko;8;32;40
95;22.08.2018;2018;08;18;Keskiviikko;17;11;28
95;22.08.2018;2018;08;19;Keskiviikko;12;14;26
95;22.08.2018;2018;08;20;Keskiviikko;3;6;9
95;22.08.2018;2018;08;21;Keskiviikko;3;2;5
95;22.08.2018;2018;08;22;Keskiviikko;4;4;8
95;22.08.2018;2018;08;23;Keskiviikko;0;0;0
95;23.08.2018;2018;08;00;Torstai;0;0;0
95;23.08.2018;2018;08;01;Torstai;0;0;0
95;23.08.2018;2018;08;02;Torstai;0;0;0
95;23.08.2018;2018;08;03;Torstai;0;0;0
95;23.08.2018;2018;08;04;Torstai;1;0;1
95;23.08.2018;2018;08;05;Torstai;12;6;18
95;23.08.2018;2018;08;06;Torstai;12;13;25
95;23.08.2018;2018;08;07;Torstai;10;9;19
95;23.08.2018;2018;08;08;Torstai;3;15;18
95;23.08.2018;2018;08;09;Torstai;6;8;14
95;23.08.2018;2018;08;10;Torstai;1;2;3
95;23.08.2018;2018;08;11;Torstai;1;2;3
95;23.08.2018;2018;08;12;Torstai;6;5;11
95;23.08.2018;2018;08;13;Torstai;5;10;15
95;23.08.2018;2018;08;14;Torstai;17;15;32
95;23.08.2018;2018;08;15;Torstai;26;17;43
95;23.08.2018;2018;08;16;Torstai;21;26;47
95;23.08.2018;2018;08;17;Torstai;14;21;35
95;23.08.2018;2018;08;18;Torstai;6;11;17
95;23.08.2018;2018;08;19;Torstai;8;10;18
95;23.08.2018;2018;08;20;Torstai;13;10;23
95;23.08.2018;2018;08;21;Torstai;8;3;11
95;23.08.2018;2018;08;22;Torstai;4;3;7
95;23.08.2018;2018;08;23;Torstai;1;2;3
95;24.08.2018;2018;08;00;Perjantai;1;0;1
95;24.08.2018;2018;08;01;Perjantai;0;0;0
95;24.08.2018;2018;08;02;Perjantai;0;0;0
95;24.08.2018;2018;08;03;Perjantai;1;0;1
95;24.08.2018;2018;08;04;Perjantai;0;0;0
95;24.08.2018;2018;08;05;Perjantai;8;7;15
95;24.08.2018;2018;08;06;Perjantai;10;12;22
95;24.08.2018;2018;08;07;Perjantai;11;12;23
95;24.08.2018;2018;08;08;Perjantai;7;14;21
95;24.08.2018;2018;08;09;Perjantai;3;1;4
95;24.08.2018;2018;08;10;Perjantai;5;1;6
95;24.08.2018;2018;08;11;Perjantai;2;1;3
95;24.08.2018;2018;08;12;Perjantai;2;1;3
95;24.08.2018;2018;08;13;Perjantai;13;2;15
95;24.08.2018;2018;08;14;Perjantai;12;10;22
95;24.08.2018;2018;08;15;Perjantai;11;14;25
95;24.08.2018;2018;08;16;Perjantai;14;11;25
95;24.08.2018;2018;08;17;Perjantai;5;15;20
95;24.08.2018;2018;08;18;Perjantai;17;8;25
95;24.08.2018;2018;08;19;Perjantai;4;3;7
95;24.08.2018;2018;08;20;Perjantai;1;4;5
95;24.08.2018;2018;08;21;Perjantai;2;2;4
95;24.08.2018;2018;08;22;Perjantai;0;3;3
95;24.08.2018;2018;08;23;Perjantai;0;1;1
95;25.08.2018;2018;08;00;Lauantai;0;0;0
95;25.08.2018;2018;08;01;Lauantai;0;1;1
95;25.08.2018;2018;08;02;Lauantai;0;0;0
95;25.08.2018;2018;08;03;Lauantai;0;0;0
95;25.08.2018;2018;08;04;Lauantai;1;0;1
95;25.08.2018;2018;08;05;Lauantai;0;1;1
95;25.08.2018;2018;08;06;Lauantai;0;2;2
95;25.08.2018;2018;08;07;Lauantai;0;1;1
95;25.08.2018;2018;08;08;Lauantai;1;2;3
95;25.08.2018;2018;08;09;Lauantai;3;3;6
95;25.08.2018;2018;08;10;Lauantai;4;5;9
95;25.08.2018;2018;08;11;Lauantai;13;17;30
95;25.08.2018;2018;08;12;Lauantai;18;10;28
95;25.08.2018;2018;08;13;Lauantai;22;23;45
95;25.08.2018;2018;08;14;Lauantai;17;14;31
95;25.08.2018;2018;08;15;Lauantai;14;10;24
95;25.08.2018;2018;08;16;Lauantai;21;9;30
95;25.08.2018;2018;08;17;Lauantai;10;11;21
95;25.08.2018;2018;08;18;Lauantai;15;6;21
95;25.08.2018;2018;08;19;Lauantai;10;14;24
95;25.08.2018;2018;08;20;Lauantai;6;9;15
95;25.08.2018;2018;08;21;Lauantai;2;5;7
95;25.08.2018;2018;08;22;Lauantai;1;2;3
95;25.08.2018;2018;08;23;Lauantai;2;3;5
95;26.08.2018;2018;08;00;Sunnuntai;1;1;2
95;26.08.2018;2018;08;01;Sunnuntai;1;2;3
95;26.08.2018;2018;08;02;Sunnuntai;0;0;0
95;26.08.2018;2018;08;03;Sunnuntai;2;1;3
95;26.08.2018;2018;08;04;Sunnuntai;1;1;2
95;26.08.2018;2018;08;05;Sunnuntai;0;1;1
95;26.08.2018;2018;08;06;Sunnuntai;0;1;1
95;26.08.2018;2018;08;07;Sunnuntai;4;3;7
95;26.08.2018;2018;08;08;Sunnuntai;3;4;7
95;26.08.2018;2018;08;09;Sunnuntai;21;5;26
95;26.08.2018;2018;08;10;Sunnuntai;14;14;28
95;26.08.2018;2018;08;11;Sunnuntai;21;14;35
95;26.08.2018;2018;08;12;Sunnuntai;32;23;55
95;26.08.2018;2018;08;13;Sunnuntai;22;25;47
95;26.08.2018;2018;08;14;Sunnuntai;8;14;22
95;26.08.2018;2018;08;15;Sunnuntai;8;6;14
95;26.08.2018;2018;08;16;Sunnuntai;3;2;5
95;26.08.2018;2018;08;17;Sunnuntai;5;6;11
95;26.08.2018;2018;08;18;Sunnuntai;6;6;12
95;26.08.2018;2018;08;19;Sunnuntai;7;11;18
95;26.08.2018;2018;08;20;Sunnuntai;2;5;7
95;26.08.2018;2018;08;21;Sunnuntai;6;5;11
95;26.08.2018;2018;08;22;Sunnuntai;4;3;7
95;26.08.2018;2018;08;23;Sunnuntai;1;1;2
95;27.08.2018;2018;08;00;Maanantai;0;0;0
95;27.08.2018;2018;08;01;Maanantai;0;3;3
95;27.08.2018;2018;08;02;Maanantai;0;0;0
95;27.08.2018;2018;08;03;Maanantai;0;0;0
95;27.08.2018;2018;08;04;Maanantai;2;0;2
95;27.08.2018;2018;08;05;Maanantai;8;2;10
95;27.08.2018;2018;08;06;Maanantai;20;12;32
95;27.08.2018;2018;08;07;Maanantai;21;13;34
95;27.08.2018;2018;08;08;Maanantai;8;17;25
95;27.08.2018;2018;08;09;Maanantai;6;16;22
95;27.08.2018;2018;08;10;Maanantai;7;4;11
95;27.08.2018;2018;08;11;Maanantai;7;4;11
95;27.08.2018;2018;08;12;Maanantai;13;7;20
95;27.08.2018;2018;08;13;Maanantai;6;5;11
95;27.08.2018;2018;08;14;Maanantai;11;13;24
95;27.08.2018;2018;08;15;Maanantai;23;22;45
95;27.08.2018;2018;08;16;Maanantai;24;30;54
95;27.08.2018;2018;08;17;Maanantai;12;12;24
95;27.08.2018;2018;08;18;Maanantai;14;18;32
95;27.08.2018;2018;08;19;Maanantai;21;18;39
95;27.08.2018;2018;08;20;Maanantai;17;12;29
95;27.08.2018;2018;08;21;Maanantai;4;9;13
95;27.08.2018;2018;08;22;Maanantai;3;6;9
95;27.08.2018;2018;08;23;Maanantai;1;0;1
95;28.08.2018;2018;08;00;Tiistai;0;0;0
95;28.08.2018;2018;08;01;Tiistai;0;0;0
95;28.08.2018;2018;08;02;Tiistai;0;0;0
95;28.08.2018;2018;08;03;Tiistai;0;0;0
95;28.08.2018;2018;08;04;Tiistai;0;0;0
95;28.08.2018;2018;08;05;Tiistai;10;5;15
95;28.08.2018;2018;08;06;Tiistai;27;11;38
95;28.08.2018;2018;08;07;Tiistai;24;32;56
95;28.08.2018;2018;08;08;Tiistai;17;17;34
95;28.08.2018;2018;08;09;Tiistai;8;11;19
95;28.08.2018;2018;08;10;Tiistai;16;13;29
95;28.08.2018;2018;08;11;Tiistai;21;18;39
95;28.08.2018;2018;08;12;Tiistai;8;9;17
95;28.08.2018;2018;08;13;Tiistai;12;14;26
95;28.08.2018;2018;08;14;Tiistai;26;18;44
95;28.08.2018;2018;08;15;Tiistai;26;30;56
95;28.08.2018;2018;08;16;Tiistai;30;39;69
95;28.08.2018;2018;08;17;Tiistai;11;23;34
95;28.08.2018;2018;08;18;Tiistai;7;21;28
95;28.08.2018;2018;08;19;Tiistai;10;22;32
95;28.08.2018;2018;08;20;Tiistai;10;12;22
95;28.08.2018;2018;08;21;Tiistai;2;4;6
95;28.08.2018;2018;08;22;Tiistai;4;11;15
95;28.08.2018;2018;08;23;Tiistai;0;3;3
95;29.08.2018;2018;08;00;Keskiviikko;2;0;2
95;29.08.2018;2018;08;01;Keskiviikko;0;0;0
95;29.08.2018;2018;08;02;Keskiviikko;0;1;1
95;29.08.2018;2018;08;03;Keskiviikko;2;0;2
95;29.08.2018;2018;08;04;Keskiviikko;0;0;0
95;29.08.2018;2018;08;05;Keskiviikko;10;7;17
95;29.08.2018;2018;08;06;Keskiviikko;28;14;42
95;29.08.2018;2018;08;07;Keskiviikko;25;26;51
95;29.08.2018;2018;08;08;Keskiviikko;21;20;41
95;29.08.2018;2018;08;09;Keskiviikko;6;5;11
95;29.08.2018;2018;08;10;Keskiviikko;15;15;30
95;29.08.2018;2018;08;11;Keskiviikko;16;10;26
95;29.08.2018;2018;08;12;Keskiviikko;12;15;27
95;29.08.2018;2018;08;13;Keskiviikko;26;18;44
95;29.08.2018;2018;08;14;Keskiviikko;19;20;39
95;29.08.2018;2018;08;15;Keskiviikko;24;27;51
95;29.08.2018;2018;08;16;Keskiviikko;36;38;74
95;29.08.2018;2018;08;17;Keskiviikko;15;31;46
95;29.08.2018;2018;08;18;Keskiviikko;17;19;36
95;29.08.2018;2018;08;19;Keskiviikko;12;15;27
95;29.08.2018;2018;08;20;Keskiviikko;13;17;30
95;29.08.2018;2018;08;21;Keskiviikko;7;14;21
95;29.08.2018;2018;08;22;Keskiviikko;2;3;5
95;29.08.2018;2018;08;23;Keskiviikko;2;1;3
95;30.08.2018;2018;08;00;Torstai;1;0;1
95;30.08.2018;2018;08;01;Torstai;0;0;0
95;30.08.2018;2018;08;02;Torstai;0;0;0
95;30.08.2018;2018;08;03;Torstai;0;1;1
95;30.08.2018;2018;08;04;Torstai;0;0;0
95;30.08.2018;2018;08;05;Torstai;8;1;9
95;30.08.2018;2018;08;06;Torstai;22;14;36
95;30.08.2018;2018;08;07;Torstai;26;25;51
95;30.08.2018;2018;08;08;Torstai;14;10;24
95;30.08.2018;2018;08;09;Torstai;7;16;23
95;30.08.2018;2018;08;10;Torstai;11;12;23
95;30.08.2018;2018;08;11;Torstai;13;7;20
95;30.08.2018;2018;08;12;Torstai;19;10;29
95;30.08.2018;2018;08;13;Torstai;12;11;23
95;30.08.2018;2018;08;14;Torstai;19;15;34
95;30.08.2018;2018;08;15;Torstai;28;31;59
95;30.08.2018;2018;08;16;Torstai;23;25;48
95;30.08.2018;2018;08;17;Torstai;14;22;36
95;30.08.2018;2018;08;18;Torstai;11;11;22
95;30.08.2018;2018;08;19;Torstai;8;11;19
95;30.08.2018;2018;08;20;Torstai;12;9;21
95;30.08.2018;2018;08;21;Torstai;5;7;12
95;30.08.2018;2018;08;22;Torstai;7;4;11
95;30.08.2018;2018;08;23;Torstai;1;1;2
95;31.08.2018;2018;08;00;Perjantai;0;0;0
95;31.08.2018;2018;08;01;Perjantai;0;0;0
95;31.08.2018;2018;08;02;Perjantai;0;0;0
95;31.08.2018;2018;08;03;Perjantai;0;0;0
95;31.08.2018;2018;08;04;Perjantai;0;0;0
95;31.08.2018;2018;08;05;Perjantai;7;2;9
95;31.08.2018;2018;08;06;Perjantai;19;12;31
95;31.08.2018;2018;08;07;Perjantai;12;22;34
95;31.08.2018;2018;08;08;Perjantai;11;19;30
95;31.08.2018;2018;08;09;Perjantai;12;11;23
95;31.08.2018;2018;08;10;Perjantai;10;10;20
95;31.08.2018;2018;08;11;Perjantai;15;11;26
95;31.08.2018;2018;08;12;Perjantai;13;14;27
95;31.08.2018;2018;08;13;Perjantai;27;13;40
95;31.08.2018;2018;08;14;Perjantai;19;20;39
95;31.08.2018;2018;08;15;Perjantai;15;23;38
95;31.08.2018;2018;08;16;Perjantai;19;19;38
95;31.08.2018;2018;08;17;Perjantai;13;15;28
95;31.08.2018;2018;08;18;Perjantai;14;13;27
95;31.08.2018;2018;08;19;Perjantai;10;12;22
95;31.08.2018;2018;08;20;Perjantai;15;7;22
95;31.08.2018;2018;08;21;Perjantai;6;11;17
95;31.08.2018;2018;08;22;Perjantai;4;2;6
95;31.08.2018;2018;08;23;Perjantai;2;2;4
95;01.09.2018;2018;09;00;Lauantai;0;0;0
95;01.09.2018;2018;09;01;Lauantai;0;1;1
95;01.09.2018;2018;09;02;Lauantai;0;1;1
95;01.09.2018;2018;09;03;Lauantai;0;2;2
95;01.09.2018;2018;09;04;Lauantai;2;2;4
95;01.09.2018;2018;09;05;Lauantai;0;1;1
95;01.09.2018;2018;09;06;Lauantai;3;1;4
95;01.09.2018;2018;09;07;Lauantai;0;3;3
95;01.09.2018;2018;09;08;Lauantai;4;7;11
95;01.09.2018;2018;09;09;Lauantai;8;9;17
95;01.09.2018;2018;09;10;Lauantai;14;6;20
95;01.09.2018;2018;09;11;Lauantai;16;16;32
95;01.09.2018;2018;09;12;Lauantai;30;13;43
95;01.09.2018;2018;09;13;Lauantai;18;14;32
95;01.09.2018;2018;09;14;Lauantai;13;22;35
95;01.09.2018;2018;09;15;Lauantai;17;14;31
95;01.09.2018;2018;09;16;Lauantai;22;14;36
95;01.09.2018;2018;09;17;Lauantai;8;20;28
95;01.09.2018;2018;09;18;Lauantai;13;7;20
95;01.09.2018;2018;09;19;Lauantai;10;9;19
95;01.09.2018;2018;09;20;Lauantai;5;11;16
95;01.09.2018;2018;09;21;Lauantai;2;5;7
95;01.09.2018;2018;09;22;Lauantai;3;5;8
95;01.09.2018;2018;09;23;Lauantai;2;4;6
95;02.09.2018;2018;09;00;Sunnuntai;0;1;1
95;02.09.2018;2018;09;01;Sunnuntai;0;2;2
95;02.09.2018;2018;09;02;Sunnuntai;0;1;1
95;02.09.2018;2018;09;03;Sunnuntai;1;2;3
95;02.09.2018;2018;09;04;Sunnuntai;1;0;1
95;02.09.2018;2018;09;05;Sunnuntai;0;2;2
95;02.09.2018;2018;09;06;Sunnuntai;1;0;1
95;02.09.2018;2018;09;07;Sunnuntai;3;1;4
95;02.09.2018;2018;09;08;Sunnuntai;3;3;6
95;02.09.2018;2018;09;09;Sunnuntai;3;5;8
95;02.09.2018;2018;09;10;Sunnuntai;12;16;28
95;02.09.2018;2018;09;11;Sunnuntai;15;17;32
95;02.09.2018;2018;09;12;Sunnuntai;25;20;45
95;02.09.2018;2018;09;13;Sunnuntai;22;27;49
95;02.09.2018;2018;09;14;Sunnuntai;26;22;48
95;02.09.2018;2018;09;15;Sunnuntai;24;18;42
95;02.09.2018;2018;09;16;Sunnuntai;13;20;33
95;02.09.2018;2018;09;17;Sunnuntai;13;18;31
95;02.09.2018;2018;09;18;Sunnuntai;8;15;23
95;02.09.2018;2018;09;19;Sunnuntai;18;12;30
95;02.09.2018;2018;09;20;Sunnuntai;5;8;13
95;02.09.2018;2018;09;21;Sunnuntai;5;6;11
95;02.09.2018;2018;09;22;Sunnuntai;2;3;5
95;02.09.2018;2018;09;23;Sunnuntai;0;1;1
95;03.09.2018;2018;09;00;Maanantai;0;0;0
95;03.09.2018;2018;09;01;Maanantai;0;0;0
95;03.09.2018;2018;09;02;Maanantai;0;0;0
95;03.09.2018;2018;09;03;Maanantai;0;1;1
95;03.09.2018;2018;09;04;Maanantai;0;0;0
95;03.09.2018;2018;09;05;Maanantai;8;4;12
95;03.09.2018;2018;09;06;Maanantai;27;14;41
95;03.09.2018;2018;09;07;Maanantai;30;22;52
95;03.09.2018;2018;09;08;Maanantai;21;16;37
95;03.09.2018;2018;09;09;Maanantai;9;22;31
95;03.09.2018;2018;09;10;Maanantai;7;16;23
95;03.09.2018;2018;09;11;Maanantai;16;7;23
95;03.09.2018;2018;09;12;Maanantai;18;11;29
95;03.09.2018;2018;09;13;Maanantai;10;14;24
95;03.09.2018;2018;09;14;Maanantai;26;17;43
95;03.09.2018;2018;09;15;Maanantai;32;33;65
95;03.09.2018;2018;09;16;Maanantai;37;48;85
95;03.09.2018;2018;09;17;Maanantai;21;28;49
95;03.09.2018;2018;09;18;Maanantai;18;18;36
95;03.09.2018;2018;09;19;Maanantai;11;30;41
95;03.09.2018;2018;09;20;Maanantai;12;10;22
95;03.09.2018;2018;09;21;Maanantai;6;5;11
95;03.09.2018;2018;09;22;Maanantai;0;4;4
95;03.09.2018;2018;09;23;Maanantai;0;0;0
95;04.09.2018;2018;09;00;Tiistai;0;1;1
95;04.09.2018;2018;09;01;Tiistai;0;0;0
95;04.09.2018;2018;09;02;Tiistai;0;0;0
95;04.09.2018;2018;09;03;Tiistai;0;0;0
95;04.09.2018;2018;09;04;Tiistai;0;0;0
95;04.09.2018;2018;09;05;Tiistai;12;6;18
95;04.09.2018;2018;09;06;Tiistai;29;12;41
95;04.09.2018;2018;09;07;Tiistai;30;30;60
95;04.09.2018;2018;09;08;Tiistai;19;18;37
95;04.09.2018;2018;09;09;Tiistai;12;8;20
95;04.09.2018;2018;09;10;Tiistai;19;12;31
95;04.09.2018;2018;09;11;Tiistai;11;6;17
95;04.09.2018;2018;09;12;Tiistai;15;8;23
95;04.09.2018;2018;09;13;Tiistai;17;16;33
95;04.09.2018;2018;09;14;Tiistai;28;23;51
95;04.09.2018;2018;09;15;Tiistai;34;36;70
95;04.09.2018;2018;09;16;Tiistai;28;44;72
95;04.09.2018;2018;09;17;Tiistai;20;32;52
95;04.09.2018;2018;09;18;Tiistai;21;21;42
95;04.09.2018;2018;09;19;Tiistai;20;21;41
95;04.09.2018;2018;09;20;Tiistai;7;11;18
95;04.09.2018;2018;09;21;Tiistai;3;2;5
95;04.09.2018;2018;09;22;Tiistai;1;1;2
95;04.09.2018;2018;09;23;Tiistai;0;2;2
95;05.09.2018;2018;09;00;Keskiviikko;1;0;1
95;05.09.2018;2018;09;01;Keskiviikko;0;0;0
95;05.09.2018;2018;09;02;Keskiviikko;0;0;0
95;05.09.2018;2018;09;03;Keskiviikko;0;0;0
95;05.09.2018;2018;09;04;Keskiviikko;3;0;3
95;05.09.2018;2018;09;05;Keskiviikko;11;5;16
95;05.09.2018;2018;09;06;Keskiviikko;25;13;38
95;05.09.2018;2018;09;07;Keskiviikko;32;32;64
95;05.09.2018;2018;09;08;Keskiviikko;5;24;29
95;05.09.2018;2018;09;09;Keskiviikko;10;4;14
95;05.09.2018;2018;09;10;Keskiviikko;11;15;26
95;05.09.2018;2018;09;11;Keskiviikko;15;4;19
95;05.09.2018;2018;09;12;Keskiviikko;12;14;26
95;05.09.2018;2018;09;13;Keskiviikko;20;15;35
95;05.09.2018;2018;09;14;Keskiviikko;20;16;36
95;05.09.2018;2018;09;15;Keskiviikko;33;33;66
95;05.09.2018;2018;09;16;Keskiviikko;22;36;58
95;05.09.2018;2018;09;17;Keskiviikko;15;10;25
95;05.09.2018;2018;09;18;Keskiviikko;12;19;31
95;05.09.2018;2018;09;19;Keskiviikko;18;20;38
95;05.09.2018;2018;09;20;Keskiviikko;11;18;29
95;05.09.2018;2018;09;21;Keskiviikko;1;6;7
95;05.09.2018;2018;09;22;Keskiviikko;2;4;6
95;05.09.2018;2018;09;23;Keskiviikko;1;0;1
95;06.09.2018;2018;09;00;Torstai;3;1;4
95;06.09.2018;2018;09;01;Torstai;0;0;0
95;06.09.2018;2018;09;02;Torstai;0;0;0
95;06.09.2018;2018;09;03;Torstai;0;0;0
95;06.09.2018;2018;09;04;Torstai;2;1;3
95;06.09.2018;2018;09;05;Torstai;13;5;18
95;06.09.2018;2018;09;06;Torstai;17;10;27
95;06.09.2018;2018;09;07;Torstai;22;23;45
95;06.09.2018;2018;09;08;Torstai;8;13;21
95;06.09.2018;2018;09;09;Torstai;10;14;24
95;06.09.2018;2018;09;10;Torstai;7;5;12
95;06.09.2018;2018;09;11;Torstai;6;5;11
95;06.09.2018;2018;09;12;Torstai;8;14;22
95;06.09.2018;2018;09;13;Torstai;18;14;32
95;06.09.2018;2018;09;14;Torstai;23;16;39
95;06.09.2018;2018;09;15;Torstai;23;22;45
95;06.09.2018;2018;09;16;Torstai;29;28;57
95;06.09.2018;2018;09;17;Torstai;18;16;34
95;06.09.2018;2018;09;18;Torstai;12;15;27
95;06.09.2018;2018;09;19;Torstai;8;11;19
95;06.09.2018;2018;09;20;Torstai;9;7;16
95;06.09.2018;2018;09;21;Torstai;2;6;8
95;06.09.2018;2018;09;22;Torstai;2;1;3
95;06.09.2018;2018;09;23;Torstai;0;3;3
95;07.09.2018;2018;09;00;Perjantai;0;1;1
95;07.09.2018;2018;09;01;Perjantai;0;0;0
95;07.09.2018;2018;09;02;Perjantai;1;0;1
95;07.09.2018;2018;09;03;Perjantai;0;0;0
95;07.09.2018;2018;09;04;Perjantai;1;0;1
95;07.09.2018;2018;09;05;Perjantai;9;8;17
95;07.09.2018;2018;09;06;Perjantai;13;10;23
95;07.09.2018;2018;09;07;Perjantai;25;28;53
95;07.09.2018;2018;09;08;Perjantai;6;19;25
95;07.09.2018;2018;09;09;Perjantai;3;6;9
95;07.09.2018;2018;09;10;Perjantai;11;9;20
95;07.09.2018;2018;09;11;Perjantai;9;8;17
95;07.09.2018;2018;09;12;Perjantai;7;12;19
95;07.09.2018;2018;09;13;Perjantai;26;7;33
95;07.09.2018;2018;09;14;Perjantai;21;19;40
95;07.09.2018;2018;09;15;Perjantai;20;23;43
95;07.09.2018;2018;09;16;Perjantai;23;19;42
95;07.09.2018;2018;09;17;Perjantai;11;26;37
95;07.09.2018;2018;09;18;Perjantai;11;14;25
95;07.09.2018;2018;09;19;Perjantai;14;19;33
95;07.09.2018;2018;09;20;Perjantai;14;10;24
95;07.09.2018;2018;09;21;Perjantai;5;3;8
95;07.09.2018;2018;09;22;Perjantai;1;6;7
95;07.09.2018;2018;09;23;Perjantai;2;0;2
95;08.09.2018;2018;09;00;Lauantai;0;1;1
95;08.09.2018;2018;09;01;Lauantai;0;1;1
95;08.09.2018;2018;09;02;Lauantai;3;0;3
95;08.09.2018;2018;09;03;Lauantai;0;0;0
95;08.09.2018;2018;09;04;Lauantai;1;1;2
95;08.09.2018;2018;09;05;Lauantai;1;1;2
95;08.09.2018;2018;09;06;Lauantai;3;1;4
95;08.09.2018;2018;09;07;Lauantai;3;1;4
95;08.09.2018;2018;09;08;Lauantai;2;7;9
95;08.09.2018;2018;09;09;Lauantai;5;5;10
95;08.09.2018;2018;09;10;Lauantai;11;8;19
95;08.09.2018;2018;09;11;Lauantai;16;10;26
95;08.09.2018;2018;09;12;Lauantai;16;8;24
95;08.09.2018;2018;09;13;Lauantai;19;20;39
95;08.09.2018;2018;09;14;Lauantai;7;16;23
95;08.09.2018;2018;09;15;Lauantai;10;21;31
95;08.09.2018;2018;09;16;Lauantai;12;15;27
95;08.09.2018;2018;09;17;Lauantai;12;11;23
95;08.09.2018;2018;09;18;Lauantai;7;14;21
95;08.09.2018;2018;09;19;Lauantai;6;9;15
95;08.09.2018;2018;09;20;Lauantai;7;6;13
95;08.09.2018;2018;09;21;Lauantai;7;5;12
95;08.09.2018;2018;09;22;Lauantai;0;4;4
95;08.09.2018;2018;09;23;Lauantai;0;0;0
95;09.09.2018;2018;09;00;Sunnuntai;1;3;4
95;09.09.2018;2018;09;01;Sunnuntai;0;0;0
95;09.09.2018;2018;09;02;Sunnuntai;0;2;2
95;09.09.2018;2018;09;03;Sunnuntai;0;0;0
95;09.09.2018;2018;09;04;Sunnuntai;0;0;0
95;09.09.2018;2018;09;05;Sunnuntai;1;1;2
95;09.09.2018;2018;09;06;Sunnuntai;0;0;0
95;09.09.2018;2018;09;07;Sunnuntai;1;2;3
95;09.09.2018;2018;09;08;Sunnuntai;4;4;8
95;09.09.2018;2018;09;09;Sunnuntai;2;10;12
95;09.09.2018;2018;09;10;Sunnuntai;18;7;25
95;09.09.2018;2018;09;11;Sunnuntai;10;12;22
95;09.09.2018;2018;09;12;Sunnuntai;24;17;41
95;09.09.2018;2018;09;13;Sunnuntai;15;20;35
95;09.09.2018;2018;09;14;Sunnuntai;20;18;38
95;09.09.2018;2018;09;15;Sunnuntai;16;7;23
95;09.09.2018;2018;09;16;Sunnuntai;13;23;36
95;09.09.2018;2018;09;17;Sunnuntai;11;22;33
95;09.09.2018;2018;09;18;Sunnuntai;16;13;29
95;09.09.2018;2018;09;19;Sunnuntai;8;9;17
95;09.09.2018;2018;09;20;Sunnuntai;9;6;15
95;09.09.2018;2018;09;21;Sunnuntai;6;4;10
95;09.09.2018;2018;09;22;Sunnuntai;3;1;4
95;09.09.2018;2018;09;23;Sunnuntai;0;1;1
95;10.09.2018;2018;09;00;Maanantai;0;0;0
95;10.09.2018;2018;09;01;Maanantai;0;0;0
95;10.09.2018;2018;09;02;Maanantai;0;0;0
95;10.09.2018;2018;09;03;Maanantai;0;0;0
95;10.09.2018;2018;09;04;Maanantai;1;0;1
95;10.09.2018;2018;09;05;Maanantai;11;6;17
95;10.09.2018;2018;09;06;Maanantai;21;16;37
95;10.09.2018;2018;09;07;Maanantai;20;20;40
95;10.09.2018;2018;09;08;Maanantai;12;11;23
95;10.09.2018;2018;09;09;Maanantai;13;21;34
95;10.09.2018;2018;09;10;Maanantai;17;8;25
95;10.09.2018;2018;09;11;Maanantai;15;9;24
95;10.09.2018;2018;09;12;Maanantai;11;10;21
95;10.09.2018;2018;09;13;Maanantai;9;14;23
95;10.09.2018;2018;09;14;Maanantai;15;20;35
95;10.09.2018;2018;09;15;Maanantai;31;21;52
95;10.09.2018;2018;09;16;Maanantai;32;28;60
95;10.09.2018;2018;09;17;Maanantai;18;21;39
95;10.09.2018;2018;09;18;Maanantai;11;25;36
95;10.09.2018;2018;09;19;Maanantai;16;12;28
95;10.09.2018;2018;09;20;Maanantai;12;12;24
95;10.09.2018;2018;09;21;Maanantai;3;6;9
95;10.09.2018;2018;09;22;Maanantai;2;4;6
95;10.09.2018;2018;09;23;Maanantai;1;1;2
95;11.09.2018;2018;09;00;Tiistai;0;0;0
95;11.09.2018;2018;09;01;Tiistai;0;0;0
95;11.09.2018;2018;09;02;Tiistai;0;1;1
95;11.09.2018;2018;09;03;Tiistai;1;0;1
95;11.09.2018;2018;09;04;Tiistai;0;0;0
95;11.09.2018;2018;09;05;Tiistai;7;4;11
95;11.09.2018;2018;09;06;Tiistai;18;8;26
95;11.09.2018;2018;09;07;Tiistai;19;29;48
95;11.09.2018;2018;09;08;Tiistai;11;15;26
95;11.09.2018;2018;09;09;Tiistai;7;4;11
95;11.09.2018;2018;09;10;Tiistai;7;3;10
95;11.09.2018;2018;09;11;Tiistai;8;4;12
95;11.09.2018;2018;09;12;Tiistai;11;8;19
95;11.09.2018;2018;09;13;Tiistai;10;9;19
95;11.09.2018;2018;09;14;Tiistai;17;11;28
95;11.09.2018;2018;09;15;Tiistai;23;18;41
95;11.09.2018;2018;09;16;Tiistai;13;23;36
95;11.09.2018;2018;09;17;Tiistai;5;6;11
95;11.09.2018;2018;09;18;Tiistai;5;5;10
95;11.09.2018;2018;09;19;Tiistai;1;5;6
95;11.09.2018;2018;09;20;Tiistai;4;0;4
95;11.09.2018;2018;09;21;Tiistai;1;3;4
95;11.09.2018;2018;09;22;Tiistai;3;4;7
95;11.09.2018;2018;09;23;Tiistai;1;1;2
95;12.09.2018;2018;09;00;Keskiviikko;0;0;0
95;12.09.2018;2018;09;01;Keskiviikko;0;0;0
95;12.09.2018;2018;09;02;Keskiviikko;0;0;0
95;12.09.2018;2018;09;03;Keskiviikko;0;0;0
95;12.09.2018;2018;09;04;Keskiviikko;0;1;1
95;12.09.2018;2018;09;05;Keskiviikko;3;3;6
95;12.09.2018;2018;09;06;Keskiviikko;9;8;17
95;12.09.2018;2018;09;07;Keskiviikko;13;13;26
95;12.09.2018;2018;09;08;Keskiviikko;6;11;17
95;12.09.2018;2018;09;09;Keskiviikko;4;3;7
95;12.09.2018;2018;09;10;Keskiviikko;0;5;5
95;12.09.2018;2018;09;11;Keskiviikko;2;3;5
95;12.09.2018;2018;09;12;Keskiviikko;3;4;7
95;12.09.2018;2018;09;13;Keskiviikko;6;1;7
95;12.09.2018;2018;09;14;Keskiviikko;11;5;16
95;12.09.2018;2018;09;15;Keskiviikko;15;8;23
95;12.09.2018;2018;09;16;Keskiviikko;9;4;13
95;12.09.2018;2018;09;17;Keskiviikko;1;8;9
95;12.09.2018;2018;09;18;Keskiviikko;2;10;12
95;12.09.2018;2018;09;19;Keskiviikko;0;1;1
95;12.09.2018;2018;09;20;Keskiviikko;6;1;7
95;12.09.2018;2018;09;21;Keskiviikko;4;5;9
95;12.09.2018;2018;09;22;Keskiviikko;1;2;3
95;12.09.2018;2018;09;23;Keskiviikko;0;1;1
95;13.09.2018;2018;09;00;Torstai;0;0;0
95;13.09.2018;2018;09;01;Torstai;0;0;0
95;13.09.2018;2018;09;02;Torstai;1;0;1
95;13.09.2018;2018;09;03;Torstai;0;0;0
95;13.09.2018;2018;09;04;Torstai;0;0;0
95;13.09.2018;2018;09;05;Torstai;7;5;12
95;13.09.2018;2018;09;06;Torstai;14;10;24
95;13.09.2018;2018;09;07;Torstai;16;24;40
95;13.09.2018;2018;09;08;Torstai;15;10;25
95;13.09.2018;2018;09;09;Torstai;5;27;32
95;13.09.2018;2018;09;10;Torstai;10;7;17
95;13.09.2018;2018;09;11;Torstai;9;2;11
95;13.09.2018;2018;09;12;Torstai;4;13;17
95;13.09.2018;2018;09;13;Torstai;9;8;17
95;13.09.2018;2018;09;14;Torstai;12;14;26
95;13.09.2018;2018;09;15;Torstai;21;20;41
95;13.09.2018;2018;09;16;Torstai;34;18;52
95;13.09.2018;2018;09;17;Torstai;13;25;38
95;13.09.2018;2018;09;18;Torstai;14;12;26
95;13.09.2018;2018;09;19;Torstai;10;17;27
95;13.09.2018;2018;09;20;Torstai;7;12;19
95;13.09.2018;2018;09;21;Torstai;8;9;17
95;13.09.2018;2018;09;22;Torstai;0;4;4
95;13.09.2018;2018;09;23;Torstai;0;0;0
95;14.09.2018;2018;09;00;Perjantai;0;0;0
95;14.09.2018;2018;09;01;Perjantai;0;1;1
95;14.09.2018;2018;09;02;Perjantai;0;0;0
95;14.09.2018;2018;09;03;Perjantai;0;0;0
95;14.09.2018;2018;09;04;Perjantai;0;0;0
95;14.09.2018;2018;09;05;Perjantai;5;6;11
95;14.09.2018;2018;09;06;Perjantai;14;12;26
95;14.09.2018;2018;09;07;Perjantai;15;24;39
95;14.09.2018;2018;09;08;Perjantai;10;17;27
95;14.09.2018;2018;09;09;Perjantai;10;6;16
95;14.09.2018;2018;09;10;Perjantai;11;1;12
95;14.09.2018;2018;09;11;Perjantai;15;11;26
95;14.09.2018;2018;09;12;Perjantai;9;11;20
95;14.09.2018;2018;09;13;Perjantai;22;7;29
95;14.09.2018;2018;09;14;Perjantai;18;12;30
95;14.09.2018;2018;09;15;Perjantai;8;19;27
95;14.09.2018;2018;09;16;Perjantai;9;25;34
95;14.09.2018;2018;09;17;Perjantai;7;9;16
95;14.09.2018;2018;09;18;Perjantai;5;6;11
95;14.09.2018;2018;09;19;Perjantai;3;1;4
95;14.09.2018;2018;09;20;Perjantai;4;1;5
95;14.09.2018;2018;09;21;Perjantai;2;2;4
95;14.09.2018;2018;09;22;Perjantai;1;1;2
95;14.09.2018;2018;09;23;Perjantai;0;0;0
95;15.09.2018;2018;09;00;Lauantai;0;0;0
95;15.09.2018;2018;09;01;Lauantai;1;3;4
95;15.09.2018;2018;09;02;Lauantai;1;0;1
95;15.09.2018;2018;09;03;Lauantai;0;0;0
95;15.09.2018;2018;09;04;Lauantai;1;1;2
95;15.09.2018;2018;09;05;Lauantai;1;0;1
95;15.09.2018;2018;09;06;Lauantai;3;0;3
95;15.09.2018;2018;09;07;Lauantai;2;1;3
95;15.09.2018;2018;09;08;Lauantai;0;2;2
95;15.09.2018;2018;09;09;Lauantai;5;6;11
95;15.09.2018;2018;09;10;Lauantai;7;4;11
95;15.09.2018;2018;09;11;Lauantai;11;8;19
95;15.09.2018;2018;09;12;Lauantai;5;6;11
95;15.09.2018;2018;09;13;Lauantai;7;1;8
95;15.09.2018;2018;09;14;Lauantai;0;6;6
95;15.09.2018;2018;09;15;Lauantai;1;1;2
95;15.09.2018;2018;09;16;Lauantai;2;1;3
95;15.09.2018;2018;09;17;Lauantai;3;4;7
95;15.09.2018;2018;09;18;Lauantai;4;4;8
95;15.09.2018;2018;09;19;Lauantai;5;4;9
95;15.09.2018;2018;09;20;Lauantai;1;7;8
95;15.09.2018;2018;09;21;Lauantai;1;4;5
95;15.09.2018;2018;09;22;Lauantai;5;0;5
95;15.09.2018;2018;09;23;Lauantai;0;2;2
95;16.09.2018;2018;09;00;Sunnuntai;0;0;0
95;16.09.2018;2018;09;01;Sunnuntai;0;0;0
95;16.09.2018;2018;09;02;Sunnuntai;0;1;1
95;16.09.2018;2018;09;03;Sunnuntai;2;0;2
95;16.09.2018;2018;09;04;Sunnuntai;2;1;3
95;16.09.2018;2018;09;05;Sunnuntai;0;0;0
95;16.09.2018;2018;09;06;Sunnuntai;1;1;2
95;16.09.2018;2018;09;07;Sunnuntai;3;1;4
95;16.09.2018;2018;09;08;Sunnuntai;4;2;6
95;16.09.2018;2018;09;09;Sunnuntai;5;13;18
95;16.09.2018;2018;09;10;Sunnuntai;16;10;26
95;16.09.2018;2018;09;11;Sunnuntai;18;8;26
95;16.09.2018;2018;09;12;Sunnuntai;13;16;29
95;16.09.2018;2018;09;13;Sunnuntai;15;16;31
95;16.09.2018;2018;09;14;Sunnuntai;9;14;23
95;16.09.2018;2018;09;15;Sunnuntai;7;12;19
95;16.09.2018;2018;09;16;Sunnuntai;8;6;14
95;16.09.2018;2018;09;17;Sunnuntai;5;6;11
95;16.09.2018;2018;09;18;Sunnuntai;8;5;13
95;16.09.2018;2018;09;19;Sunnuntai;5;10;15
95;16.09.2018;2018;09;20;Sunnuntai;4;3;7
95;16.09.2018;2018;09;21;Sunnuntai;2;1;3
95;16.09.2018;2018;09;22;Sunnuntai;0;2;2
95;16.09.2018;2018;09;23;Sunnuntai;1;1;2
95;17.09.2018;2018;09;00;Maanantai;0;0;0
95;17.09.2018;2018;09;01;Maanantai;0;0;0
95;17.09.2018;2018;09;02;Maanantai;0;0;0
95;17.09.2018;2018;09;03;Maanantai;0;0;0
95;17.09.2018;2018;09;04;Maanantai;0;1;1
95;17.09.2018;2018;09;05;Maanantai;12;3;15
95;17.09.2018;2018;09;06;Maanantai;14;11;25
95;17.09.2018;2018;09;07;Maanantai;26;22;48
95;17.09.2018;2018;09;08;Maanantai;9;17;26
95;17.09.2018;2018;09;09;Maanantai;11;18;29
95;17.09.2018;2018;09;10;Maanantai;11;4;15
95;17.09.2018;2018;09;11;Maanantai;7;11;18
95;17.09.2018;2018;09;12;Maanantai;17;11;28
95;17.09.2018;2018;09;13;Maanantai;13;16;29
95;17.09.2018;2018;09;14;Maanantai;19;21;40
95;17.09.2018;2018;09;15;Maanantai;29;17;46
95;17.09.2018;2018;09;16;Maanantai;28;25;53
95;17.09.2018;2018;09;17;Maanantai;18;20;38
95;17.09.2018;2018;09;18;Maanantai;5;21;26
95;17.09.2018;2018;09;19;Maanantai;6;6;12
95;17.09.2018;2018;09;20;Maanantai;4;8;12
95;17.09.2018;2018;09;21;Maanantai;0;4;4
95;17.09.2018;2018;09;22;Maanantai;0;1;1
95;17.09.2018;2018;09;23;Maanantai;0;0;0
95;18.09.2018;2018;09;00;Tiistai;0;0;0
95;18.09.2018;2018;09;01;Tiistai;0;0;0
95;18.09.2018;2018;09;02;Tiistai;0;0;0
95;18.09.2018;2018;09;03;Tiistai;0;0;0
95;18.09.2018;2018;09;04;Tiistai;1;0;1
95;18.09.2018;2018;09;05;Tiistai;9;4;13
95;18.09.2018;2018;09;06;Tiistai;16;12;28
95;18.09.2018;2018;09;07;Tiistai;19;29;48
95;18.09.2018;2018;09;08;Tiistai;12;19;31
95;18.09.2018;2018;09;09;Tiistai;6;12;18
95;18.09.2018;2018;09;10;Tiistai;9;5;14
95;18.09.2018;2018;09;11;Tiistai;8;12;20
95;18.09.2018;2018;09;12;Tiistai;4;3;7
95;18.09.2018;2018;09;13;Tiistai;12;6;18
95;18.09.2018;2018;09;14;Tiistai;20;12;32
95;18.09.2018;2018;09;15;Tiistai;29;23;52
95;18.09.2018;2018;09;16;Tiistai;24;22;46
95;18.09.2018;2018;09;17;Tiistai;12;26;38
95;18.09.2018;2018;09;18;Tiistai;14;8;22
95;18.09.2018;2018;09;19;Tiistai;8;18;26
95;18.09.2018;2018;09;20;Tiistai;3;1;4
95;18.09.2018;2018;09;21;Tiistai;1;7;8
95;18.09.2018;2018;09;22;Tiistai;1;1;2
95;18.09.2018;2018;09;23;Tiistai;0;0;0
95;19.09.2018;2018;09;00;Keskiviikko;0;2;2
95;19.09.2018;2018;09;01;Keskiviikko;0;1;1
95;19.09.2018;2018;09;02;Keskiviikko;1;0;1
95;19.09.2018;2018;09;03;Keskiviikko;0;0;0
95;19.09.2018;2018;09;04;Keskiviikko;0;0;0
95;19.09.2018;2018;09;05;Keskiviikko;12;5;17
95;19.09.2018;2018;09;06;Keskiviikko;13;9;22
95;19.09.2018;2018;09;07;Keskiviikko;19;23;42
95;19.09.2018;2018;09;08;Keskiviikko;11;21;32
95;19.09.2018;2018;09;09;Keskiviikko;6;10;16
95;19.09.2018;2018;09;10;Keskiviikko;8;2;10
95;19.09.2018;2018;09;11;Keskiviikko;6;4;10
95;19.09.2018;2018;09;12;Keskiviikko;5;9;14
95;19.09.2018;2018;09;13;Keskiviikko;7;4;11
95;19.09.2018;2018;09;14;Keskiviikko;18;9;27
95;19.09.2018;2018;09;15;Keskiviikko;22;14;36
95;19.09.2018;2018;09;16;Keskiviikko;12;18;30
95;19.09.2018;2018;09;17;Keskiviikko;3;11;14
95;19.09.2018;2018;09;18;Keskiviikko;3;8;11
95;19.09.2018;2018;09;19;Keskiviikko;1;3;4
95;19.09.2018;2018;09;20;Keskiviikko;6;2;8
95;19.09.2018;2018;09;21;Keskiviikko;5;5;10
95;19.09.2018;2018;09;22;Keskiviikko;0;0;0
95;19.09.2018;2018;09;23;Keskiviikko;0;0;0
95;20.09.2018;2018;09;00;Torstai;0;0;0
95;20.09.2018;2018;09;01;Torstai;0;1;1
95;20.09.2018;2018;09;02;Torstai;0;0;0
95;20.09.2018;2018;09;03;Torstai;0;0;0
95;20.09.2018;2018;09;04;Torstai;0;0;0
95;20.09.2018;2018;09;05;Torstai;9;4;13
95;20.09.2018;2018;09;06;Torstai;14;13;27
95;20.09.2018;2018;09;07;Torstai;19;21;40
95;20.09.2018;2018;09;08;Torstai;10;15;25
95;20.09.2018;2018;09;09;Torstai;7;21;28
95;20.09.2018;2018;09;10;Torstai;5;4;9
95;20.09.2018;2018;09;11;Torstai;7;6;13
95;20.09.2018;2018;09;12;Torstai;11;7;18
95;20.09.2018;2018;09;13;Torstai;5;9;14
95;20.09.2018;2018;09;14;Torstai;14;9;23
95;20.09.2018;2018;09;15;Torstai;20;13;33
95;20.09.2018;2018;09;16;Torstai;22;14;36
95;20.09.2018;2018;09;17;Torstai;12;16;28
95;20.09.2018;2018;09;18;Torstai;7;7;14
95;20.09.2018;2018;09;19;Torstai;4;9;13
95;20.09.2018;2018;09;20;Torstai;5;8;13
95;20.09.2018;2018;09;21;Torstai;3;3;6
95;20.09.2018;2018;09;22;Torstai;2;2;4
95;20.09.2018;2018;09;23;Torstai;0;0;0
95;21.09.2018;2018;09;00;Perjantai;0;1;1
95;21.09.2018;2018;09;01;Perjantai;0;0;0
95;21.09.2018;2018;09;02;Perjantai;0;0;0
95;21.09.2018;2018;09;03;Perjantai;0;0;0
95;21.09.2018;2018;09;04;Perjantai;0;1;1
95;21.09.2018;2018;09;05;Perjantai;9;4;13
95;21.09.2018;2018;09;06;Perjantai;10;13;23
95;21.09.2018;2018;09;07;Perjantai;14;13;27
95;21.09.2018;2018;09;08;Perjantai;11;21;32
95;21.09.2018;2018;09;09;Perjantai;8;3;11
95;21.09.2018;2018;09;10;Perjantai;8;12;20
95;21.09.2018;2018;09;11;Perjantai;8;1;9
95;21.09.2018;2018;09;12;Perjantai;9;9;18
95;21.09.2018;2018;09;13;Perjantai;24;7;31
95;21.09.2018;2018;09;14;Perjantai;10;14;24
95;21.09.2018;2018;09;15;Perjantai;18;16;34
95;21.09.2018;2018;09;16;Perjantai;9;17;26
95;21.09.2018;2018;09;17;Perjantai;17;21;38
95;21.09.2018;2018;09;18;Perjantai;6;11;17
95;21.09.2018;2018;09;19;Perjantai;5;4;9
95;21.09.2018;2018;09;20;Perjantai;1;3;4
95;21.09.2018;2018;09;21;Perjantai;1;3;4
95;21.09.2018;2018;09;22;Perjantai;3;2;5
95;21.09.2018;2018;09;23;Perjantai;0;0;0
95;22.09.2018;2018;09;00;Lauantai;0;1;1
95;22.09.2018;2018;09;01;Lauantai;0;0;0
95;22.09.2018;2018;09;02;Lauantai;0;0;0
95;22.09.2018;2018;09;03;Lauantai;0;0;0
95;22.09.2018;2018;09;04;Lauantai;1;0;1
95;22.09.2018;2018;09;05;Lauantai;0;1;1
95;22.09.2018;2018;09;06;Lauantai;2;1;3
95;22.09.2018;2018;09;07;Lauantai;2;2;4
95;22.09.2018;2018;09;08;Lauantai;2;0;2
95;22.09.2018;2018;09;09;Lauantai;1;2;3
95;22.09.2018;2018;09;10;Lauantai;0;3;3
95;22.09.2018;2018;09;11;Lauantai;4;0;4
95;22.09.2018;2018;09;12;Lauantai;5;1;6
95;22.09.2018;2018;09;13;Lauantai;3;5;8
95;22.09.2018;2018;09;14;Lauantai;2;7;9
95;22.09.2018;2018;09;15;Lauantai;11;5;16
95;22.09.2018;2018;09;16;Lauantai;7;5;12
95;22.09.2018;2018;09;17;Lauantai;8;8;16
95;22.09.2018;2018;09;18;Lauantai;2;3;5
95;22.09.2018;2018;09;19;Lauantai;1;2;3
95;22.09.2018;2018;09;20;Lauantai;1;3;4
95;22.09.2018;2018;09;21;Lauantai;1;1;2
95;22.09.2018;2018;09;22;Lauantai;1;2;3
95;22.09.2018;2018;09;23;Lauantai;0;0;0
95;23.09.2018;2018;09;00;Sunnuntai;0;0;0
95;23.09.2018;2018;09;01;Sunnuntai;5;1;6
95;23.09.2018;2018;09;02;Sunnuntai;0;0;0
95;23.09.2018;2018;09;03;Sunnuntai;0;0;0
95;23.09.2018;2018;09;04;Sunnuntai;0;1;1
95;23.09.2018;2018;09;05;Sunnuntai;0;1;1
95;23.09.2018;2018;09;06;Sunnuntai;0;0;0
95;23.09.2018;2018;09;07;Sunnuntai;2;0;2
95;23.09.2018;2018;09;08;Sunnuntai;1;3;4
95;23.09.2018;2018;09;09;Sunnuntai;4;9;13
95;23.09.2018;2018;09;10;Sunnuntai;9;8;17
95;23.09.2018;2018;09;11;Sunnuntai;8;5;13
95;23.09.2018;2018;09;12;Sunnuntai;14;8;22
95;23.09.2018;2018;09;13;Sunnuntai;21;16;37
95;23.09.2018;2018;09;14;Sunnuntai;9;4;13
95;23.09.2018;2018;09;15;Sunnuntai;9;13;22
95;23.09.2018;2018;09;16;Sunnuntai;10;6;16
95;23.09.2018;2018;09;17;Sunnuntai;6;9;15
95;23.09.2018;2018;09;18;Sunnuntai;6;8;14
95;23.09.2018;2018;09;19;Sunnuntai;10;7;17
95;23.09.2018;2018;09;20;Sunnuntai;3;2;5
95;23.09.2018;2018;09;21;Sunnuntai;4;2;6
95;23.09.2018;2018;09;22;Sunnuntai;0;3;3
95;23.09.2018;2018;09;23;Sunnuntai;0;0;0
95;24.09.2018;2018;09;00;Maanantai;0;1;1
95;24.09.2018;2018;09;01;Maanantai;0;0;0
95;24.09.2018;2018;09;02;Maanantai;0;0;0
95;24.09.2018;2018;09;03;Maanantai;0;0;0
95;24.09.2018;2018;09;04;Maanantai;0;2;2
95;24.09.2018;2018;09;05;Maanantai;6;4;10
95;24.09.2018;2018;09;06;Maanantai;16;17;33
95;24.09.2018;2018;09;07;Maanantai;15;19;34
95;24.09.2018;2018;09;08;Maanantai;10;15;25
95;24.09.2018;2018;09;09;Maanantai;10;7;17
95;24.09.2018;2018;09;10;Maanantai;14;5;19
95;24.09.2018;2018;09;11;Maanantai;7;4;11
95;24.09.2018;2018;09;12;Maanantai;10;7;17
95;24.09.2018;2018;09;13;Maanantai;11;9;20
95;24.09.2018;2018;09;14;Maanantai;13;17;30
95;24.09.2018;2018;09;15;Maanantai;15;13;28
95;24.09.2018;2018;09;16;Maanantai;14;20;34
95;24.09.2018;2018;09;17;Maanantai;11;14;25
95;24.09.2018;2018;09;18;Maanantai;8;5;13
95;24.09.2018;2018;09;19;Maanantai;2;5;7
95;24.09.2018;2018;09;20;Maanantai;2;3;5
95;24.09.2018;2018;09;21;Maanantai;3;2;5
95;24.09.2018;2018;09;22;Maanantai;1;1;2
95;24.09.2018;2018;09;23;Maanantai;0;1;1
95;25.09.2018;2018;09;00;Tiistai;0;0;0
95;25.09.2018;2018;09;01;Tiistai;0;0;0
95;25.09.2018;2018;09;02;Tiistai;0;0;0
95;25.09.2018;2018;09;03;Tiistai;0;0;0
95;25.09.2018;2018;09;04;Tiistai;1;0;1
95;25.09.2018;2018;09;05;Tiistai;9;0;9
95;25.09.2018;2018;09;06;Tiistai;20;0;20
95;25.09.2018;2018;09;07;Tiistai;34;0;34
95;25.09.2018;2018;09;08;Tiistai;22;0;22
95;25.09.2018;2018;09;09;Tiistai;13;0;13
95;25.09.2018;2018;09;10;Tiistai;10;0;10
95;25.09.2018;2018;09;11;Tiistai;14;0;14
95;25.09.2018;2018;09;12;Tiistai;5;0;5
95;25.09.2018;2018;09;13;Tiistai;13;0;13
95;25.09.2018;2018;09;14;Tiistai;22;0;22
95;25.09.2018;2018;09;15;Tiistai;36;0;36
95;25.09.2018;2018;09;16;Tiistai;32;0;32
95;25.09.2018;2018;09;17;Tiistai;27;0;27
95;25.09.2018;2018;09;18;Tiistai;15;0;15
95;25.09.2018;2018;09;19;Tiistai;18;0;18
95;25.09.2018;2018;09;20;Tiistai;3;0;3
95;25.09.2018;2018;09;21;Tiistai;6;0;6
95;25.09.2018;2018;09;22;Tiistai;1;0;1
95;25.09.2018;2018;09;23;Tiistai;0;0;0
95;26.09.2018;2018;09;00;Keskiviikko;0;1;1
95;26.09.2018;2018;09;01;Keskiviikko;0;0;0
95;26.09.2018;2018;09;02;Keskiviikko;0;0;0
95;26.09.2018;2018;09;03;Keskiviikko;0;0;0
95;26.09.2018;2018;09;04;Keskiviikko;0;0;0
95;26.09.2018;2018;09;05;Keskiviikko;6;3;9
95;26.09.2018;2018;09;06;Keskiviikko;8;10;18
95;26.09.2018;2018;09;07;Keskiviikko;13;18;31
95;26.09.2018;2018;09;08;Keskiviikko;7;7;14
95;26.09.2018;2018;09;09;Keskiviikko;8;2;10
95;26.09.2018;2018;09;10;Keskiviikko;9;2;11
95;26.09.2018;2018;09;11;Keskiviikko;8;4;12
95;26.09.2018;2018;09;12;Keskiviikko;1;6;7
95;26.09.2018;2018;09;13;Keskiviikko;5;3;8
95;26.09.2018;2018;09;14;Keskiviikko;4;4;8
95;26.09.2018;2018;09;15;Keskiviikko;11;7;18
95;26.09.2018;2018;09;16;Keskiviikko;7;5;12
95;26.09.2018;2018;09;17;Keskiviikko;5;12;17
95;26.09.2018;2018;09;18;Keskiviikko;4;5;9
95;26.09.2018;2018;09;19;Keskiviikko;7;6;13
95;26.09.2018;2018;09;20;Keskiviikko;1;7;8
95;26.09.2018;2018;09;21;Keskiviikko;5;1;6
95;26.09.2018;2018;09;22;Keskiviikko;1;0;1
95;26.09.2018;2018;09;23;Keskiviikko;0;0;0
95;27.09.2018;2018;09;00;Torstai;0;0;0
95;27.09.2018;2018;09;01;Torstai;0;0;0
95;27.09.2018;2018;09;02;Torstai;0;0;0
95;27.09.2018;2018;09;03;Torstai;0;0;0
95;27.09.2018;2018;09;04;Torstai;1;1;2
95;27.09.2018;2018;09;05;Torstai;3;1;4
95;27.09.2018;2018;09;06;Torstai;6;10;16
95;27.09.2018;2018;09;07;Torstai;7;14;21
95;27.09.2018;2018;09;08;Torstai;6;10;16
95;27.09.2018;2018;09;09;Torstai;1;1;2
95;27.09.2018;2018;09;10;Torstai;9;2;11
95;27.09.2018;2018;09;11;Torstai;4;1;5
95;27.09.2018;2018;09;12;Torstai;1;3;4
95;27.09.2018;2018;09;13;Torstai;4;2;6
95;27.09.2018;2018;09;14;Torstai;5;6;11
95;27.09.2018;2018;09;15;Torstai;13;8;21
95;27.09.2018;2018;09;16;Torstai;7;7;14
95;27.09.2018;2018;09;17;Torstai;2;11;13
95;27.09.2018;2018;09;18;Torstai;2;3;5
95;27.09.2018;2018;09;19;Torstai;4;3;7
95;27.09.2018;2018;09;20;Torstai;3;4;7
95;27.09.2018;2018;09;21;Torstai;3;1;4
95;27.09.2018;2018;09;22;Torstai;1;1;2
95;27.09.2018;2018;09;23;Torstai;0;0;0
95;28.09.2018;2018;09;00;Perjantai;0;1;1
95;28.09.2018;2018;09;01;Perjantai;0;0;0
95;28.09.2018;2018;09;02;Perjantai;1;0;1
95;28.09.2018;2018;09;03;Perjantai;0;0;0
95;28.09.2018;2018;09;04;Perjantai;0;1;1
95;28.09.2018;2018;09;05;Perjantai;5;3;8
95;28.09.2018;2018;09;06;Perjantai;13;11;24
95;28.09.2018;2018;09;07;Perjantai;12;18;30
95;28.09.2018;2018;09;08;Perjantai;12;10;22
95;28.09.2018;2018;09;09;Perjantai;3;6;9
95;28.09.2018;2018;09;10;Perjantai;15;7;22
95;28.09.2018;2018;09;11;Perjantai;13;3;16
95;28.09.2018;2018;09;12;Perjantai;5;4;9
95;28.09.2018;2018;09;13;Perjantai;8;11;19
95;28.09.2018;2018;09;14;Perjantai;15;8;23
95;28.09.2018;2018;09;15;Perjantai;15;16;31
95;28.09.2018;2018;09;16;Perjantai;8;14;22
95;28.09.2018;2018;09;17;Perjantai;8;19;27
95;28.09.2018;2018;09;18;Perjantai;5;6;11
95;28.09.2018;2018;09;19;Perjantai;4;6;10
95;28.09.2018;2018;09;20;Perjantai;2;1;3
95;28.09.2018;2018;09;21;Perjantai;3;2;5
95;28.09.2018;2018;09;22;Perjantai;2;3;5
95;28.09.2018;2018;09;23;Perjantai;1;1;2
95;29.09.2018;2018;09;00;Lauantai;0;0;0
95;29.09.2018;2018;09;01;Lauantai;0;0;0
95;29.09.2018;2018;09;02;Lauantai;0;1;1
95;29.09.2018;2018;09;03;Lauantai;0;0;0
95;29.09.2018;2018;09;04;Lauantai;0;1;1
95;29.09.2018;2018;09;05;Lauantai;0;1;1
95;29.09.2018;2018;09;06;Lauantai;0;0;0
95;29.09.2018;2018;09;07;Lauantai;0;3;3
95;29.09.2018;2018;09;08;Lauantai;3;6;9
95;29.09.2018;2018;09;09;Lauantai;5;3;8
95;29.09.2018;2018;09;10;Lauantai;3;5;8
95;29.09.2018;2018;09;11;Lauantai;3;10;13
95;29.09.2018;2018;09;12;Lauantai;9;8;17
95;29.09.2018;2018;09;13;Lauantai;9;9;18
95;29.09.2018;2018;09;14;Lauantai;7;5;12
95;29.09.2018;2018;09;15;Lauantai;4;10;14
95;29.09.2018;2018;09;16;Lauantai;4;7;11
95;29.09.2018;2018;09;17;Lauantai;2;3;5
95;29.09.2018;2018;09;18;Lauantai;3;5;8
95;29.09.2018;2018;09;19;Lauantai;5;5;10
95;29.09.2018;2018;09;20;Lauantai;3;3;6
95;29.09.2018;2018;09;21;Lauantai;2;3;5
95;29.09.2018;2018;09;22;Lauantai;0;2;2
95;29.09.2018;2018;09;23;Lauantai;0;0;0
95;30.09.2018;2018;09;00;Sunnuntai;0;1;1
95;30.09.2018;2018;09;01;Sunnuntai;0;0;0
95;30.09.2018;2018;09;02;Sunnuntai;1;2;3
95;30.09.2018;2018;09;03;Sunnuntai;0;1;1
95;30.09.2018;2018;09;04;Sunnuntai;0;0;0
95;30.09.2018;2018;09;05;Sunnuntai;1;1;2
95;30.09.2018;2018;09;06;Sunnuntai;0;1;1
95;30.09.2018;2018;09;07;Sunnuntai;2;1;3
95;30.09.2018;2018;09;08;Sunnuntai;1;1;2
95;30.09.2018;2018;09;09;Sunnuntai;0;4;4
95;30.09.2018;2018;09;10;Sunnuntai;3;5;8
95;30.09.2018;2018;09;11;Sunnuntai;9;3;12
95;30.09.2018;2018;09;12;Sunnuntai;3;8;11
95;30.09.2018;2018;09;13;Sunnuntai;5;3;8
95;30.09.2018;2018;09;14;Sunnuntai;10;11;21
95;30.09.2018;2018;09;15;Sunnuntai;9;9;18
95;30.09.2018;2018;09;16;Sunnuntai;6;4;10
95;30.09.2018;2018;09;17;Sunnuntai;7;15;22
95;30.09.2018;2018;09;18;Sunnuntai;7;7;14
95;30.09.2018;2018;09;19;Sunnuntai;6;6;12
95;30.09.2018;2018;09;20;Sunnuntai;4;2;6
95;30.09.2018;2018;09;21;Sunnuntai;1;3;4
95;30.09.2018;2018;09;22;Sunnuntai;0;0;0
95;30.09.2018;2018;09;23;Sunnuntai;0;0;0